flow_duration,protocol,TotPackets,TotBytes,tot_fwd_pkts,totlen_fwd_pkts,fwd_iat_mean,fwd_pkt_len_max,fwd_pkt_len_mean,tot_bwd_pkts,totlen_bwd_pkts,bwd_iat_mean,bwd_pkt_len_max,bwd_pkt_len_mean
299337.0,6,6,412,4,272,99779.0,74.0,68.0,2,140,0.0,74.0,70.0
317090.0,17,4,1400,4,1400,105696.66666666669,350.0,350.0,0,0,0.0,0.0,0.0
206951.0,17,2,762,2,762,0.0,381.0,381.0,0,0,0.0,0.0,0.0
302247.0,6,6,412,4,272,100749.0,74.0,68.0,2,140,0.0,74.0,70.0
299239.0,6,6,412,4,272,99746.33333333331,74.0,68.0,2,140,0.0,74.0,70.0
121727.0,6,13,1513,7,882,19932.33333333333,291.0,126.0,6,631,22847.6,293.0,105.16666666666669
13133.0,6,11,2098,6,590,2280.6,252.0,98.33333333333331,5,1508,3017.75,1236.0,301.6
17727.0,6,10,1975,5,467,4037.5,195.0,93.4,5,1508,3629.25,1236.0,301.6
117358472.0,6,231,26044,116,7952,1020508.452173913,140.0,68.55172413793103,115,18092,1020353.0789473684,284.0,157.3217391304348
252312.0,17,4,6056,4,6056,84104.0,1514.0,1514.0,0,0,0.0,0.0,0.0
103605015.0,6,33,2428,17,1288,6461832.625,139.0,75.76470588235294,16,1140,6892622.333333333,123.0,71.25
123839816.0,6,49,3234,25,1650,5159992.333333333,66.0,66.0,24,1584,5093675.739130435,66.0,66.0
3385964.0,6,128,122485,88,115543,38919.12643678161,1510.0,1312.9886363636365,40,6942,78755.84615384616,1510.0,173.55
120076044.0,17,28,13364,28,13364,4447260.888888889,501.0,477.2857142857143,0,0,0.0,0.0,0.0
318936.0,6,3,202,2,128,0.0,74.0,64.0,1,74,0.0,74.0,74.0
185680.0,17,2,604,1,75,0.0,75.0,75.0,1,529,0.0,529.0,529.0
90291544.0,6,14,2240,8,1016,12898792.0,188.0,127.0,6,1224,18025810.2,204.0,204.0
138970.0,6,2,132,1,66,0.0,66.0,66.0,1,66,0.0,66.0,66.0
153384.0,17,2,180,1,90,0.0,90.0,90.0,1,90,0.0,90.0,90.0
324.0,17,2,166,1,75,0.0,75.0,75.0,1,91,0.0,91.0,91.0
153491.0,17,2,180,1,90,0.0,90.0,90.0,1,90,0.0,90.0,90.0
31069.0,6,10,2032,5,524,6281.25,252.0,104.8,5,1508,7164.5,1236.0,301.6
4482.0,17,2,614,1,72,0.0,72.0,72.0,1,542,0.0,542.0,542.0
108118600.0,17,5,955,5,955,27029650.0,191.0,191.0,0,0,0.0,0.0,0.0
1982.0,17,4,344,2,150,0.0,75.0,75.0,2,194,0.0,103.0,97.0
206481.0,6,3,426,2,280,0.0,214.0,140.0,1,146,0.0,146.0,146.0
90529560.0,6,13,2036,8,1016,12932794.285714284,188.0,127.0,5,1020,22591394.25,204.0,204.0
169995.0,17,4,704,2,148,0.0,74.0,74.0,2,556,0.0,280.0,278.0
246834.0,6,3,337,2,214,0.0,160.0,107.0,1,123,0.0,123.0,123.0
71220.0,6,14,4740,7,653,11099.0,249.0,93.28571428571428,7,4087,11730.333333333334,1514.0,583.8571428571429
105697.0,17,2,762,2,762,0.0,381.0,381.0,0,0,0.0,0.0,0.0
1302767.0,6,4,264,2,132,0.0,66.0,66.0,2,132,0.0,66.0,66.0
33708.0,6,10,2032,5,524,8153.5,252.0,104.8,5,1508,8057.0,1236.0,301.6
470.0,17,2,508,2,508,0.0,257.0,254.0,0,0,0.0,0.0,0.0
97347.0,17,2,762,2,762,0.0,381.0,381.0,0,0,0.0,0.0,0.0
104657799.0,17,14,864,7,432,17167878.0,174.0,61.71428571428572,7,432,17166839.0,174.0,61.71428571428572
13104.0,17,2,180,1,90,0.0,90.0,90.0,1,90,0.0,90.0,90.0
232327.0,6,3,337,2,214,0.0,160.0,107.0,1,123,0.0,123.0,123.0
24315.0,6,14,4740,7,653,3933.1666666666665,249.0,93.28571428571428,7,4087,3346.833333333333,1514.0,583.8571428571429
90296167.0,6,21,1585,11,840,9024991.8,95.0,76.36363636363636,10,745,10000051.888888888,95.0,74.5
205715.0,17,2,762,2,762,0.0,381.0,381.0,0,0,0.0,0.0,0.0
28243.0,6,10,2032,5,524,6724.0,252.0,104.8,5,1508,6754.5,1236.0,301.6
30220.0,6,10,2032,5,524,7327.0,252.0,104.8,5,1508,6763.0,1236.0,301.6
109228526.0,6,30,1974,15,1026,7786592.571428572,123.0,68.4,15,948,7786526.214285715,123.0,63.2
110558424.0,6,30,1974,15,1026,7881618.428571428,123.0,68.4,15,948,7881616.071428572,123.0,63.2
319.0,17,2,174,1,79,0.0,79.0,79.0,1,95,0.0,95.0,95.0
106815645.0,6,32,2236,16,1165,7121043.0,139.0,72.8125,16,1071,7106606.0,123.0,66.9375
103480.0,17,2,286,2,286,0.0,143.0,143.0,0,0,0.0,0.0,0.0
2308.0,17,4,344,2,150,0.0,75.0,75.0,2,194,0.0,103.0,97.0
962844.0,17,10,3736,10,3736,106982.66666666669,390.0,373.6,0,0,0.0,0.0,0.0
146054.0,6,3,337,2,214,0.0,160.0,107.0,1,123,0.0,123.0,123.0
3132.0,17,2,224,1,76,0.0,76.0,76.0,1,148,0.0,148.0,148.0
194717.0,17,4,6056,4,6056,64905.66666666666,1514.0,1514.0,0,0,0.0,0.0,0.0
90041833.0,17,28,13364,28,13364,3334882.703703704,501.0,477.2857142857143,0,0,0.0,0.0,0.0
10565949.0,6,6,412,3,206,5192232.0,74.0,68.66666666666667,3,206,5192105.0,74.0,68.66666666666667
5622466.0,6,12,833,6,437,1123309.4,95.0,72.83333333333333,6,396,1027144.6,95.0,66.0
24631.0,17,2,582,1,83,0.0,83.0,83.0,1,499,0.0,499.0,499.0
36071.0,17,2,582,1,83,0.0,83.0,83.0,1,499,0.0,499.0,499.0
217393.0,6,3,426,2,280,0.0,214.0,140.0,1,146,0.0,146.0,146.0
10549441.0,6,7,478,4,272,3470048.333333333,74.0,68.0,3,206,5204978.5,74.0,68.66666666666667
90070917.0,17,27,12943,27,12943,3464266.0384615385,501.0,479.3703703703704,0,0,0.0,0.0,0.0
4480.0,17,2,602,1,72,0.0,72.0,72.0,1,530,0.0,530.0,530.0
90218156.0,6,20,1531,9,691,11246660.75,95.0,76.77777777777777,11,840,9001276.9,95.0,76.36363636363636
244976.0,6,3,337,2,214,0.0,160.0,107.0,1,123,0.0,123.0,123.0
5624118.0,6,5,336,2,134,0.0,68.0,67.0,3,202,1421151.5,70.0,67.33333333333333
102004349.0,17,13,821,7,432,17000724.833333332,174.0,61.71428571428572,6,389,16400167.8,174.0,64.83333333333333
12306.0,6,11,2098,6,590,2329.0,252.0,98.33333333333331,5,1508,2495.0,1236.0,301.6
108105649.0,17,5,955,5,955,27026412.25,191.0,191.0,0,0,0.0,0.0,0.0
146229.0,6,3,337,2,214,0.0,160.0,107.0,1,123,0.0,123.0,123.0
208865.0,6,3,426,2,280,0.0,214.0,140.0,1,146,0.0,146.0,146.0
90257911.0,6,12,1832,8,1016,12893987.285714284,188.0,127.0,4,816,30030617.666666668,204.0,204.0
2492.0,17,4,344,2,150,0.0,75.0,75.0,2,194,0.0,103.0,97.0
153326.0,17,2,180,1,90,0.0,90.0,90.0,1,90,0.0,90.0,90.0
0.0,17,1,179,1,179,0.0,179.0,179.0,0,0,0.0,0.0,0.0
57670.0,6,14,4740,7,653,9357.166666666666,249.0,93.28571428571428,7,4087,8593.5,1514.0,583.8571428571429
33952.0,6,14,4740,7,653,5143.666666666667,249.0,93.28571428571428,7,4087,5497.5,1514.0,583.8571428571429
39525.0,6,14,4740,7,653,6467.166666666667,249.0,93.28571428571428,7,4087,5809.833333333333,1514.0,583.8571428571429
2450.0,17,4,344,2,150,0.0,75.0,75.0,2,194,0.0,103.0,97.0
23098.0,6,13,1459,7,862,3667.1666666666665,271.0,123.14285714285714,6,597,4264.0,259.0,99.5
146281.0,6,3,337,2,214,0.0,160.0,107.0,1,123,0.0,123.0,123.0
90257904.0,6,14,1964,8,1016,12893986.285714284,188.0,127.0,6,948,18011485.0,204.0,158.0
110056827.0,6,30,2122,15,1017,7861201.928571428,123.0,67.8,15,1105,7133147.571428572,139.0,73.66666666666667
7317.0,17,2,614,1,72,0.0,72.0,72.0,1,542,0.0,542.0,542.0
92350835.0,6,26,1746,13,906,7677930.5,123.0,69.6923076923077,13,840,7677930.5,123.0,64.61538461538461
148801207.0,6,21,1585,10,745,13233771.444444444,95.0,74.5,11,840,14858572.2,95.0,76.36363636363636
146045.0,6,3,337,2,214,0.0,160.0,107.0,1,123,0.0,123.0,123.0
411812.0,17,2,363,1,75,0.0,75.0,75.0,1,288,0.0,288.0,288.0
12986.0,6,11,1133,6,602,1983.6,264.0,100.33333333333331,5,531,3032.0,259.0,106.2
22854432.0,17,3,1034,2,684,0.0,342.0,342.0,1,350,0.0,350.0,350.0
5622623.0,6,5,336,2,134,0.0,68.0,67.0,3,202,1523981.5,70.0,67.33333333333333
319.0,17,2,156,1,78,0.0,78.0,78.0,1,78,0.0,78.0,78.0
246179.0,6,3,337,2,214,0.0,160.0,107.0,1,123,0.0,123.0,123.0
90058000.0,17,28,13364,28,13364,3335481.4814814813,501.0,477.2857142857143,0,0,0.0,0.0,0.0
154039.0,17,2,180,1,90,0.0,90.0,90.0,1,90,0.0,90.0,90.0
238801.0,6,3,337,2,214,0.0,160.0,107.0,1,123,0.0,123.0,123.0
4130.0,17,4,809,2,144,0.0,72.0,72.0,2,665,0.0,538.0,332.5
15137.0,6,14,4740,7,653,2365.0,249.0,93.28571428571428,7,4087,2366.1666666666665,1514.0,583.8571428571429
50135.0,6,14,4740,7,653,8188.333333333333,249.0,93.28571428571428,7,4087,8196.166666666666,1514.0,583.8571428571429
219111.0,17,4,1524,4,1524,73037.0,381.0,381.0,0,0,0.0,0.0,0.0
197701.0,17,2,180,1,90,0.0,90.0,90.0,1,90,0.0,90.0,90.0
123485.0,17,4,1400,4,1400,41161.66666666666,350.0,350.0,0,0,0.0,0.0,0.0
232926.0,6,3,337,2,214,0.0,160.0,107.0,1,123,0.0,123.0,123.0
95801269.0,6,28,1876,14,982,7352735.076923077,139.0,70.14285714285714,14,894,7352731.769230769,123.0,63.85714285714285
90059595.0,17,28,13364,28,13364,3335540.5555555555,501.0,477.2857142857143,0,0,0.0,0.0,0.0
235690.0,6,3,337,2,214,0.0,160.0,107.0,1,123,0.0,123.0,123.0
102545.0,17,2,286,2,286,0.0,143.0,143.0,0,0,0.0,0.0,0.0
90021969.0,17,28,13364,28,13364,3334147.0,501.0,477.2857142857143,0,0,0.0,0.0,0.0
143996.0,17,2,180,1,90,0.0,90.0,90.0,1,90,0.0,90.0,90.0
2396.0,17,4,344,2,150,0.0,75.0,75.0,2,194,0.0,103.0,97.0
311078.0,17,4,1400,4,1400,103692.66666666669,350.0,350.0,0,0,0.0,0.0,0.0
153473.0,17,2,180,1,90,0.0,90.0,90.0,1,90,0.0,90.0,90.0
143983.0,17,2,180,1,90,0.0,90.0,90.0,1,90,0.0,90.0,90.0
125546043.0,6,37,2640,19,1392,6974780.166666667,123.0,73.26315789473684,18,1248,6785684.647058823,123.0,69.33333333333333
10524630.0,6,7,478,4,272,3462879.6666666665,74.0,68.0,3,206,5194198.0,74.0,68.66666666666667
110114282.0,6,31,2166,16,1149,7326563.6,123.0,71.8125,15,1017,7849889.214285715,123.0,67.8
2319.0,17,4,344,2,150,0.0,75.0,75.0,2,194,0.0,103.0,97.0
9870.0,17,4,823,2,163,0.0,89.0,81.5,2,660,0.0,443.0,330.0
112150.0,17,4,1400,4,1400,37383.333333333336,350.0,350.0,0,0,0.0,0.0,0.0
107476.0,17,2,286,2,286,0.0,143.0,143.0,0,0,0.0,0.0,0.0
26567.0,6,10,2032,5,524,6421.0,252.0,104.8,5,1508,6062.25,1236.0,301.6
100524.0,17,2,762,2,762,0.0,381.0,381.0,0,0,0.0,0.0,0.0
246140.0,6,3,373,2,238,0.0,172.0,119.0,1,135,0.0,135.0,135.0
47489.0,6,10,2032,5,524,11651.0,252.0,104.8,5,1508,11010.5,1236.0,301.6
90945897.0,6,21,1585,11,840,9094431.2,95.0,76.36363636363636,10,745,10104003.666666666,95.0,74.5
296744.0,6,10,1221,6,636,59348.8,298.0,106.0,4,585,93118.33333333331,379.0,146.25
106973.0,17,2,286,2,286,0.0,143.0,143.0,0,0,0.0,0.0,0.0
94386505.0,6,40,2640,20,1320,4967710.7894736845,66.0,66.0,20,1320,4953203.105263158,66.0,66.0
236475.0,6,10,1221,6,636,47295.0,298.0,106.0,4,585,76974.33333333333,379.0,146.25
51227.0,6,14,4740,7,653,7702.0,249.0,93.28571428571428,7,4087,7122.5,1514.0,583.8571428571429
123610525.0,6,49,3234,25,1650,5150438.541666667,66.0,66.0,24,1584,4937465.130434782,66.0,66.0
313200.0,17,4,1400,4,1400,104400.0,350.0,350.0,0,0,0.0,0.0,0.0
5617433.0,6,5,336,2,134,0.0,68.0,67.0,3,202,1524103.0,70.0,67.33333333333333
2847832.0,6,4,270,3,202,1423916.0,70.0,67.33333333333333,1,68,0.0,68.0,68.0
23095426.0,17,5,1718,4,1368,660455.0,342.0,342.0,1,350,0.0,350.0,350.0
914.0,17,5,550,5,550,228.5,110.0,110.0,0,0,0.0,0.0,0.0
90217980.0,6,20,1531,9,691,11247201.5,95.0,76.77777777777777,11,840,9001271.7,95.0,76.36363636363636
119559333.0,6,222,25090,111,17468,1085037.3909090909,284.0,157.36936936936937,111,7622,1085029.6272727272,140.0,68.66666666666667
2445.0,17,4,344,2,150,0.0,75.0,75.0,2,194,0.0,103.0,97.0
135139311.0,17,6,1146,6,1146,27027862.2,191.0,191.0,0,0,0.0,0.0,0.0
97359374.0,6,30,2106,15,1089,6954241.0,123.0,72.6,15,1017,6938780.071428572,123.0,67.8
135129707.0,17,6,1146,6,1146,27025941.4,191.0,191.0,0,0,0.0,0.0,0.0
320697.0,6,3,202,2,128,0.0,74.0,64.0,1,74,0.0,74.0,74.0
34945.0,6,14,4740,7,653,5704.833333333333,249.0,93.28571428571428,7,4087,5088.5,1514.0,583.8571428571429
92402393.0,6,19,1598,10,948,10265144.111111112,257.0,94.8,9,650,11548958.625,95.0,72.22222222222223
95982057.0,17,15,5138,14,4788,5770412.692307692,342.0,342.0,1,350,0.0,350.0,350.0
113254805.0,6,46,3036,23,1518,5135434.363636363,66.0,66.0,23,1518,5135425.090909091,66.0,66.0
248839.0,6,3,337,2,214,0.0,160.0,107.0,1,123,0.0,123.0,123.0
2303.0,17,4,344,2,150,0.0,75.0,75.0,2,194,0.0,103.0,97.0
95945.0,17,2,762,2,762,0.0,381.0,381.0,0,0,0.0,0.0,0.0
135133016.0,17,6,1206,6,1206,27026603.2,201.0,201.0,0,0,0.0,0.0,0.0
120434029.0,6,231,26166,116,18354,1047252.4260869564,284.0,158.22413793103448,115,7812,1038219.5350877192,140.0,67.9304347826087
5618383.0,6,4,270,2,134,0.0,68.0,67.0,2,136,0.0,70.0,68.0
511138.0,6,5,336,2,134,0.0,68.0,67.0,3,202,184087.5,70.0,67.33333333333333
308775.0,6,6,412,4,272,102925.0,74.0,68.0,2,140,0.0,74.0,70.0
42244.0,6,14,4740,7,653,5617.666666666667,249.0,93.28571428571428,7,4087,6798.5,1514.0,583.8571428571429
153403.0,17,2,180,1,90,0.0,90.0,90.0,1,90,0.0,90.0,90.0
2064965.0,17,8,1640,4,312,688187.0000000001,78.0,78.0,4,1328,688185.6666666666,332.0,332.0
41925.0,6,14,4740,7,653,6826.0,249.0,93.28571428571428,7,4087,6707.5,1514.0,583.8571428571429
119822919.0,6,21,1585,12,935,10888454.545454543,95.0,77.91666666666667,9,650,14976483.75,95.0,72.22222222222223
40275.0,6,14,4740,7,653,5751.166666666667,249.0,93.28571428571428,7,4087,6115.166666666667,1514.0,583.8571428571429
133549.0,6,2,132,1,66,0.0,66.0,66.0,1,66,0.0,66.0,66.0
6026.0,17,2,180,1,90,0.0,90.0,90.0,1,90,0.0,90.0,90.0
2376.0,17,4,344,2,150,0.0,75.0,75.0,2,194,0.0,103.0,97.0
213670.0,6,11,1132,6,556,41995.8,218.0,92.66666666666669,5,576,52486.0,304.0,115.2
155953.0,6,3,337,2,214,0.0,160.0,107.0,1,123,0.0,123.0,123.0
44533.0,6,10,2032,5,524,10955.0,252.0,104.8,5,1508,8833.5,1236.0,301.6
103185282.0,6,43,2838,22,1452,4913573.095238095,66.0,66.0,21,1386,5112000.25,66.0,66.0
2425.0,17,4,344,2,150,0.0,75.0,75.0,2,194,0.0,103.0,97.0
16797.0,17,2,180,1,90,0.0,90.0,90.0,1,90,0.0,90.0,90.0
2391.0,17,4,344,2,150,0.0,75.0,75.0,2,194,0.0,103.0,97.0
62055889.0,17,7,3171,7,3171,10342648.166666666,453.0,453.0,0,0,0.0,0.0,0.0
120075913.0,17,29,13785,29,13785,4288425.464285715,501.0,475.3448275862069,0,0,0.0,0.0,0.0
243573.0,6,3,337,2,214,0.0,160.0,107.0,1,123,0.0,123.0,123.0
920.0,17,4,438,2,148,0.0,74.0,74.0,2,290,0.0,147.0,145.0
325.0,17,2,166,1,75,0.0,75.0,75.0,1,91,0.0,91.0,91.0
17726.0,6,14,4740,7,653,2831.333333333333,249.0,93.28571428571428,7,4087,2817.0,1514.0,583.8571428571429
44764334.0,6,5,336,2,134,0.0,68.0,67.0,3,202,20975560.5,70.0,67.33333333333333
20841.0,6,14,4740,7,653,3257.1666666666665,249.0,93.28571428571428,7,4087,3330.1666666666665,1514.0,583.8571428571429
20012.0,17,2,582,1,83,0.0,83.0,83.0,1,499,0.0,499.0,499.0
296.0,17,2,156,1,78,0.0,78.0,78.0,1,78,0.0,78.0,78.0
18284.0,6,2,145,2,145,0.0,91.0,72.5,0,0,0.0,0.0,0.0
106829.0,17,2,700,2,700,0.0,350.0,350.0,0,0,0.0,0.0,0.0
304.0,17,2,164,1,82,0.0,82.0,82.0,1,82,0.0,82.0,82.0
8968.0,6,11,1133,6,602,1695.2,264.0,100.33333333333331,5,531,2027.75,259.0,106.2
3047047.0,6,156,129004,92,120138,33484.03296703297,1510.0,1305.8478260869565,64,8866,43520.333333333336,1510.0,138.53125
135131580.0,17,6,1206,6,1206,27026316.0,201.0,201.0,0,0,0.0,0.0,0.0
20989550.0,17,3,1034,2,684,0.0,342.0,342.0,1,350,0.0,350.0,350.0
40160.0,6,14,4740,7,653,6073.333333333333,249.0,93.28571428571428,7,4087,6339.0,1514.0,583.8571428571429
298.0,17,2,164,1,82,0.0,82.0,82.0,1,82,0.0,82.0,82.0
42078.0,6,14,4740,7,653,5960.833333333333,249.0,93.28571428571428,7,4087,6265.333333333333,1514.0,583.8571428571429
537320.0,17,6,2100,6,2100,107464.0,350.0,350.0,0,0,0.0,0.0,0.0
231408.0,6,12,1373,7,714,38568.0,298.0,102.0,5,659,57134.5,379.0,131.8
123840007.0,6,49,3234,25,1650,5160000.291666667,66.0,66.0,24,1584,5185757.304347826,66.0,66.0
480.0,17,2,166,1,75,0.0,75.0,75.0,1,91,0.0,91.0,91.0
221984.0,6,13,1394,7,797,36997.333333333336,253.0,113.85714285714286,6,597,42498.2,259.0,99.5
110020741.0,6,28,1860,14,966,8446530.538461538,123.0,69.0,14,894,8446530.307692308,123.0,63.85714285714285
2468.0,17,4,344,2,150,0.0,75.0,75.0,2,194,0.0,103.0,97.0
109655759.0,6,44,2904,22,1452,5221702.80952381,66.0,66.0,22,1452,5208582.047619048,66.0,66.0
313508.0,17,4,704,2,148,0.0,74.0,74.0,2,556,0.0,280.0,278.0
17669.0,6,11,1133,6,602,3533.8,264.0,100.33333333333331,5,531,3705.5,259.0,106.2
96094.0,6,14,4740,7,653,15792.333333333334,249.0,93.28571428571428,7,4087,9734.666666666666,1514.0,583.8571428571429
90257830.0,6,13,2036,8,1016,12893975.714285716,188.0,127.0,5,1020,22522385.0,204.0,204.0
2596889.0,6,2,132,1,66,0.0,66.0,66.0,1,66,0.0,66.0,66.0
13973.0,6,13,1459,7,862,2118.5,271.0,123.14285714285714,6,597,2484.4,259.0,99.5
321559.0,17,4,1400,4,1400,107186.33333333331,350.0,350.0,0,0,0.0,0.0,0.0
112463967.0,6,45,2970,23,1518,5111998.5,66.0,66.0,22,1452,5000571.428571428,66.0,66.0
326.0,17,2,208,1,72,0.0,72.0,72.0,1,136,0.0,136.0,136.0
114571015.0,6,48,3168,24,1584,4981348.478260869,66.0,66.0,24,1584,4967674.130434782,66.0,66.0
103729429.0,6,28,1860,14,966,7962589.846153846,123.0,69.0,14,894,7962585.230769231,123.0,63.85714285714285
120058591.0,17,29,13785,29,13785,4287806.821428572,501.0,475.3448275862069,0,0,0.0,0.0,0.0
2801209.0,6,2,132,1,66,0.0,66.0,66.0,1,66,0.0,66.0,66.0
40668.0,6,14,4740,7,653,6565.333333333333,249.0,93.28571428571428,7,4087,6201.0,1514.0,583.8571428571429
143892.0,17,2,180,1,90,0.0,90.0,90.0,1,90,0.0,90.0,90.0
307385.0,6,6,412,4,272,102461.66666666669,74.0,68.0,2,140,0.0,74.0,70.0
262320.0,17,2,180,1,90,0.0,90.0,90.0,1,90,0.0,90.0,90.0
33262.0,6,14,4740,7,653,4846.0,249.0,93.28571428571428,7,4087,4785.166666666667,1514.0,583.8571428571429
309763.0,17,2,180,1,90,0.0,90.0,90.0,1,90,0.0,90.0,90.0
314.0,17,2,174,1,79,0.0,79.0,79.0,1,95,0.0,95.0,95.0
284569.0,17,6,1230,3,234,142094.0,78.0,78.0,3,996,142047.5,332.0,332.0
245304.0,6,3,337,2,214,0.0,160.0,107.0,1,123,0.0,123.0,123.0
682.0,17,2,762,2,762,0.0,381.0,381.0,0,0,0.0,0.0,0.0
101975.0,17,2,286,2,286,0.0,143.0,143.0,0,0,0.0,0.0,0.0
1452143.0,6,19,7533,10,1403,161349.22222222222,583.0,140.3,9,6130,149949.25,1484.0,681.1111111111111
24727.0,6,10,2032,5,524,5195.25,252.0,104.8,5,1508,4990.0,1236.0,301.6
303.0,17,2,168,1,76,0.0,76.0,76.0,1,92,0.0,92.0,92.0
153469.0,17,2,180,1,90,0.0,90.0,90.0,1,90,0.0,90.0,90.0
4158.0,17,2,473,1,78,0.0,78.0,78.0,1,395,0.0,395.0,395.0
302529.0,6,3,202,2,128,0.0,74.0,64.0,1,74,0.0,74.0,74.0
98744.0,17,2,762,2,762,0.0,381.0,381.0,0,0,0.0,0.0,0.0
166875.0,17,2,180,1,90,0.0,90.0,90.0,1,90,0.0,90.0,90.0
146144.0,6,3,337,2,214,0.0,160.0,107.0,1,123,0.0,123.0,123.0
119555204.0,6,33,2274,17,1125,7472200.25,123.0,66.17647058823529,16,1149,7290269.2,123.0,71.8125
108111875.0,17,5,955,5,955,27027968.75,191.0,191.0,0,0,0.0,0.0,0.0
107328.0,17,2,286,2,286,0.0,143.0,143.0,0,0,0.0,0.0,0.0
795.0,17,4,438,2,148,0.0,74.0,74.0,2,290,0.0,147.0,145.0
90055001.0,17,27,12943,27,12943,3463653.8846153845,501.0,479.3703703703704,0,0,0.0,0.0,0.0
10870185.0,6,7,478,3,206,5366864.5,74.0,68.66666666666667,4,272,3577825.0,74.0,68.0
147968.0,17,2,180,1,90,0.0,90.0,90.0,1,90,0.0,90.0,90.0
99300.0,17,2,762,2,762,0.0,381.0,381.0,0,0,0.0,0.0,0.0
30101.0,6,14,4740,7,653,4851.0,249.0,93.28571428571428,7,4087,4431.833333333333,1514.0,583.8571428571429
303639.0,6,2,132,1,66,0.0,66.0,66.0,1,66,0.0,66.0,66.0
206174.0,6,3,426,2,280,0.0,214.0,140.0,1,146,0.0,146.0,146.0
328343.0,6,10,1221,6,636,65668.6,298.0,106.0,4,585,104025.66666666669,379.0,146.25
27401.0,6,10,1065,5,534,6420.75,262.0,106.8,5,531,6098.25,259.0,106.2
302417.0,6,2,132,1,66,0.0,66.0,66.0,1,66,0.0,66.0,66.0
298998.0,6,6,412,4,272,99666.0,74.0,68.0,2,140,0.0,74.0,70.0
98027.0,17,2,762,2,762,0.0,381.0,381.0,0,0,0.0,0.0,0.0
246296.0,6,3,373,2,238,0.0,172.0,119.0,1,135,0.0,135.0,135.0
90256357.0,6,14,2240,8,1016,12893765.285714284,188.0,127.0,6,1224,18014697.6,204.0,204.0
109416.0,17,2,286,2,286,0.0,143.0,143.0,0,0,0.0,0.0,0.0
121297866.0,6,218,24652,109,7428,1105887.101851852,140.0,68.14678899082568,109,17224,1115484.1296296297,374.0,158.0183486238532
70348.0,6,14,4740,7,653,11236.5,249.0,93.28571428571428,7,4087,10814.333333333334,1514.0,583.8571428571429
111284040.0,6,758,124076,376,25124,296729.73066666664,214.0,66.81914893617021,382,98952,292054.90813648293,1514.0,259.0366492146597
146955.0,6,3,337,2,214,0.0,160.0,107.0,1,123,0.0,123.0,123.0
75112.0,6,14,4740,7,653,12261.0,249.0,93.28571428571428,7,4087,11253.0,1514.0,583.8571428571429
107233656.0,6,25,1883,12,894,9748514.181818182,95.0,74.5,13,989,8917849.916666666,95.0,76.07692307692308
153508.0,17,2,180,1,90,0.0,90.0,90.0,1,90,0.0,90.0,90.0
39134.0,6,14,4740,7,653,6152.0,249.0,93.28571428571428,7,4087,6390.333333333333,1514.0,583.8571428571429
2592229.0,6,2,132,1,66,0.0,66.0,66.0,1,66,0.0,66.0,66.0
307508.0,6,6,412,4,272,102502.66666666669,74.0,68.0,2,140,0.0,74.0,70.0
233885.0,6,3,373,2,238,0.0,172.0,119.0,1,135,0.0,135.0,135.0
24856.0,6,14,4740,7,653,3969.3333333333335,249.0,93.28571428571428,7,4087,4004.8333333333335,1514.0,583.8571428571429
140312.0,6,12,1354,6,723,27290.8,253.0,120.5,6,631,27193.4,293.0,105.16666666666669
217001.0,6,3,426,2,280,0.0,214.0,140.0,1,146,0.0,146.0,146.0
108109814.0,17,5,1005,5,1005,27027453.5,201.0,201.0,0,0,0.0,0.0,0.0
5619259.0,6,5,336,2,134,0.0,68.0,67.0,3,202,1524491.0,70.0,67.33333333333333
90038755.0,17,28,13364,28,13364,3334768.703703704,501.0,477.2857142857143,0,0,0.0,0.0,0.0
505332.0,6,5,336,2,134,0.0,68.0,67.0,3,202,193556.5,70.0,67.33333333333333
108106119.0,17,5,955,5,955,27026529.75,191.0,191.0,0,0,0.0,0.0,0.0
90047849.0,17,28,13364,28,13364,3335105.5185185187,501.0,477.2857142857143,0,0,0.0,0.0,0.0
745590.0,6,2,132,1,66,0.0,66.0,66.0,1,66,0.0,66.0,66.0
113142780.0,6,36,2596,18,1348,6642766.05882353,139.0,74.88888888888889,18,1248,6642759.882352941,123.0,69.33333333333333
135148493.0,17,6,1146,6,1146,27029698.6,191.0,191.0,0,0,0.0,0.0,0.0
388443.0,6,3,204,2,136,0.0,70.0,68.0,1,68,0.0,68.0,68.0
267534.0,17,2,180,1,90,0.0,90.0,90.0,1,90,0.0,90.0,90.0
237767.0,17,2,180,1,90,0.0,90.0,90.0,1,90,0.0,90.0,90.0
1676001.0,17,18,1260,18,1260,98588.29411764706,70.0,70.0,0,0,0.0,0.0,0.0
2882345.0,6,12,2172,7,664,480336.5,252.0,94.85714285714286,5,1508,2137.75,1236.0,301.6
108102826.0,17,5,955,5,955,27025706.5,191.0,191.0,0,0,0.0,0.0,0.0
63604.99999999999,6,10,2032,5,524,14272.0,252.0,104.8,5,1508,15164.0,1236.0,301.6
246227.0,6,3,337,2,214,0.0,160.0,107.0,1,123,0.0,123.0,123.0
4463.0,17,2,762,2,762,0.0,381.0,381.0,0,0,0.0,0.0,0.0
346536.0,6,5,336,2,134,0.0,68.0,67.0,3,202,156061.0,70.0,67.33333333333333
3203072.0,6,3,204,2,136,0.0,70.0,68.0,1,68,0.0,68.0,68.0
217871.0,6,3,426,2,280,0.0,214.0,140.0,1,146,0.0,146.0,146.0
135155269.0,17,6,1146,6,1146,27031053.8,191.0,191.0,0,0,0.0,0.0,0.0
893.0,17,4,438,2,148,0.0,74.0,74.0,2,290,0.0,147.0,145.0
104861129.0,6,28,1860,14,966,8049603.846153846,123.0,69.0,14,894,8049611.384615385,123.0,63.85714285714285
118705510.0,6,33,2274,17,1125,7419094.375,123.0,66.17647058823529,16,1149,7865164.866666666,123.0,71.8125
90746544.0,6,17,1287,9,691,11336936.5,95.0,76.77777777777777,8,596,12962511.714285716,95.0,74.5
120159071.0,6,258,30166,129,8810,932383.7265625,140.0,68.29457364341086,129,21356,932405.390625,284.0,165.5503875968992
95810092.0,17,14,4796,13,4446,6228905.583333333,342.0,342.0,1,350,0.0,350.0,350.0
233055.0,6,3,337,2,214,0.0,160.0,107.0,1,123,0.0,123.0,123.0
323444.0,17,4,1400,4,1400,107814.66666666669,350.0,350.0,0,0,0.0,0.0,0.0
284553.0,17,2,363,1,79,0.0,79.0,79.0,1,284,0.0,284.0,284.0
144898.0,17,2,180,1,70,0.0,70.0,70.0,1,110,0.0,110.0,110.0
102884.0,17,2,286,2,286,0.0,143.0,143.0,0,0,0.0,0.0,0.0
20831.0,17,2,582,1,83,0.0,83.0,83.0,1,499,0.0,499.0,499.0
104880026.0,17,15,5130,15,5130,7491430.428571428,342.0,342.0,0,0,0.0,0.0,0.0
254330.0,6,3,337,2,214,0.0,160.0,107.0,1,123,0.0,123.0,123.0
102907.0,17,2,286,2,286,0.0,143.0,143.0,0,0,0.0,0.0,0.0
90032176.0,17,28,13364,28,13364,3334525.037037037,501.0,477.2857142857143,0,0,0.0,0.0,0.0
0.0,17,1,179,1,179,0.0,179.0,179.0,0,0,0.0,0.0,0.0
120435932.0,6,231,26150,116,18264,1047268.9739130436,284.0,157.44827586206895,115,7886,1047480.4210526316,140.0,68.57391304347826
206626.0,6,3,426,2,280,0.0,214.0,140.0,1,146,0.0,146.0,146.0
105153.0,17,2,700,2,700,0.0,350.0,350.0,0,0,0.0,0.0,0.0
205681.0,6,3,426,2,280,0.0,214.0,140.0,1,146,0.0,146.0,146.0
10842771.0,6,6,412,3,206,5350799.0,74.0,68.66666666666667,3,206,5178694.5,74.0,68.66666666666667
216611.0,17,2,180,1,90,0.0,90.0,90.0,1,90,0.0,90.0,90.0
144115.0,17,2,180,1,90,0.0,90.0,90.0,1,90,0.0,90.0,90.0
90230588.0,6,16,1192,8,596,12853791.857142856,95.0,74.5,8,596,12859305.142857144,95.0,74.5
0.0,17,1,44,1,44,0.0,44.0,44.0,0,0,0.0,0.0,0.0
35994.0,6,14,4740,7,653,5440.5,249.0,93.28571428571428,7,4087,5802.666666666667,1514.0,583.8571428571429
0.0,17,1,381,1,381,0.0,381.0,381.0,0,0,0.0,0.0,0.0
316815.0,6,6,412,4,272,105605.0,74.0,68.0,2,140,0.0,74.0,70.0
153436.0,17,2,180,1,90,0.0,90.0,90.0,1,90,0.0,90.0,90.0
752460.0,6,2,132,1,66,0.0,66.0,66.0,1,66,0.0,66.0,66.0
2465.0,17,4,344,2,150,0.0,75.0,75.0,2,194,0.0,103.0,97.0
337082.0,6,6,412,4,272,112360.66666666669,74.0,68.0,2,140,0.0,74.0,70.0
90315491.0,6,166,18634,83,5700,1101408.4268292682,140.0,68.67469879518072,83,12934,1098782.2073170731,284.0,155.83132530120483
2939.0,17,2,762,2,762,0.0,381.0,381.0,0,0,0.0,0.0,0.0
677248.0,17,4,883,2,156,0.0,78.0,78.0,2,727,0.0,395.0,363.5
52307.0,6,14,4740,7,653,8473.166666666666,249.0,93.28571428571428,7,4087,8557.666666666666,1514.0,583.8571428571429
61046.0,6,10,2032,5,524,14625.0,252.0,104.8,5,1508,14229.0,1236.0,301.6
303804.0,6,6,412,4,272,101268.0,74.0,68.0,2,140,0.0,74.0,70.0
105152.0,17,4,1400,4,1400,35050.666666666664,350.0,350.0,0,0,0.0,0.0,0.0
202238.0,17,4,1400,4,1400,67412.66666666667,350.0,350.0,0,0,0.0,0.0,0.0
147267.0,6,3,337,2,214,0.0,160.0,107.0,1,123,0.0,123.0,123.0
90261571.0,6,15,2168,8,1016,12894510.142857144,188.0,127.0,7,1152,15016509.833333334,204.0,164.57142857142858
320.0,17,2,174,1,79,0.0,79.0,79.0,1,95,0.0,95.0,95.0
120102334.0,6,1086,232786,554,196934,216791.7486437613,1514.0,355.4765342960289,532,35852,225773.6572504708,214.0,67.39097744360902
135136388.0,17,6,1206,6,1206,27027277.6,201.0,201.0,0,0,0.0,0.0,0.0
216536.0,6,3,426,2,280,0.0,214.0,140.0,1,146,0.0,146.0,146.0
9609.0,17,2,571,1,86,0.0,86.0,86.0,1,485,0.0,485.0,485.0
279632.0,17,2,363,1,79,0.0,79.0,79.0,1,284,0.0,284.0,284.0
201076.0,17,2,762,2,762,0.0,381.0,381.0,0,0,0.0,0.0,0.0
131476.0,6,3,337,2,214,0.0,160.0,107.0,1,123,0.0,123.0,123.0
41092.0,6,14,4740,7,653,6066.666666666667,249.0,93.28571428571428,7,4087,5698.166666666667,1514.0,583.8571428571429
60157.0,6,12,1320,7,789,10026.166666666666,253.0,112.71428571428572,5,531,10513.75,259.0,106.2
108113399.0,17,5,1005,5,1005,27028349.75,201.0,201.0,0,0,0.0,0.0,0.0
48148.0,6,14,4740,7,653,7296.166666666667,249.0,93.28571428571428,7,4087,7368.5,1514.0,583.8571428571429
2797322.0,6,2,132,1,66,0.0,66.0,66.0,1,66,0.0,66.0,66.0
37783.0,6,10,2032,5,524,8807.75,252.0,104.8,5,1508,8119.0,1236.0,301.6
153434.0,17,2,180,1,90,0.0,90.0,90.0,1,90,0.0,90.0,90.0
108464650.0,6,31,2314,16,1228,7230976.666666667,139.0,76.75,15,1086,7732035.857142857,123.0,72.4
2011.0,17,4,344,2,150,0.0,75.0,75.0,2,194,0.0,103.0,97.0
108105735.0,17,5,955,5,955,27026433.75,191.0,191.0,0,0,0.0,0.0,0.0
120129843.0,6,12,1832,8,1016,17138149.714285713,188.0,127.0,4,816,30033852.0,204.0,204.0
96000789.0,17,13,1083,7,563,16000131.5,174.0,80.42857142857143,6,520,16977553.0,174.0,86.66666666666667
46896.0,6,13,1394,7,797,7232.5,253.0,113.85714285714286,6,597,8228.2,259.0,99.5
299029.0,17,2,238,1,74,0.0,74.0,74.0,1,164,0.0,164.0,164.0
131968.0,6,2,132,1,66,0.0,66.0,66.0,1,66,0.0,66.0,66.0
17679.0,6,10,2032,5,524,3519.5,252.0,104.8,5,1508,4007.75,1236.0,301.6
120008354.0,17,28,13364,28,13364,4444753.851851852,501.0,477.2857142857143,0,0,0.0,0.0,0.0
9839.0,17,2,582,1,83,0.0,83.0,83.0,1,499,0.0,499.0,499.0
90289320.0,6,16,1192,8,596,12891424.0,95.0,74.5,8,596,12897237.57142857,95.0,74.5
23813.0,6,10,2032,5,524,5721.5,252.0,104.8,5,1508,5706.0,1236.0,301.6
90021715.0,17,27,12943,27,12943,3462373.653846154,501.0,479.3703703703704,0,0,0.0,0.0,0.0
92710157.0,6,38,2508,19,1254,5135434.555555556,66.0,66.0,19,1254,5135443.722222222,66.0,66.0
1930362.0,17,2,876,2,876,0.0,438.0,438.0,0,0,0.0,0.0,0.0
37597160.0,6,5,336,2,134,0.0,68.0,67.0,3,202,18728995.0,70.0,67.33333333333333
22261.0,17,4,823,2,163,0.0,89.0,81.5,2,660,0.0,443.0,330.0
316454.0,17,4,1400,4,1400,105484.66666666669,350.0,350.0,0,0,0.0,0.0,0.0
216967.0,6,3,426,2,280,0.0,214.0,140.0,1,146,0.0,146.0,146.0
106331934.0,6,36,2734,19,1471,5895336.611111111,139.0,77.42105263157895,17,1263,6632254.75,123.0,74.29411764705883
113641795.0,6,216,24424,108,7424,1057618.3271028036,140.0,68.74074074074075,108,17000,1054355.046728972,284.0,157.40740740740742
1473312.0,6,8,602,3,198,203436.5,66.0,66.0,5,404,343481.5,103.0,80.8
232121.0,6,3,337,2,214,0.0,160.0,107.0,1,123,0.0,123.0,123.0
76045541.0,6,9,842,9,842,9505692.625,97.0,93.55555555555556,0,0,0.0,0.0,0.0
311254.0,17,4,1400,4,1400,103751.33333333331,350.0,350.0,0,0,0.0,0.0,0.0
28511.0,6,10,2032,5,524,6765.0,252.0,104.8,5,1508,5653.75,1236.0,301.6
835.0,17,4,438,2,148,0.0,74.0,74.0,2,290,0.0,147.0,145.0
143920.0,17,2,180,1,90,0.0,90.0,90.0,1,90,0.0,90.0,90.0
21761.0,6,10,2032,5,524,4537.5,252.0,104.8,5,1508,4647.75,1236.0,301.6
2884459.0,6,3,1604,1,753,0.0,753.0,753.0,2,851,0.0,785.0,425.5
2768451.0,6,3,1604,2,851,0.0,785.0,425.5,1,753,0.0,753.0,753.0
119211.0,17,2,762,2,762,0.0,381.0,381.0,0,0,0.0,0.0,0.0
2358.0,17,4,344,2,150,0.0,75.0,75.0,2,194,0.0,103.0,97.0
301673.0,6,10,1221,6,636,60334.6,298.0,106.0,4,585,95009.66666666669,379.0,146.25
120298021.0,6,232,26228,116,7890,1038989.5130434782,140.0,68.01724137931035,116,18338,1038956.9826086956,284.0,158.08620689655172
143958.0,17,2,180,1,90,0.0,90.0,90.0,1,90,0.0,90.0,90.0
90297224.0,6,16,1192,8,596,12892091.285714284,95.0,74.5,8,596,12898771.57142857,95.0,74.5
5596.0,17,4,823,2,163,0.0,89.0,81.5,2,660,0.0,443.0,330.0
90214110.0,6,16,1192,8,596,12851989.857142856,95.0,74.5,8,596,12856965.42857143,95.0,74.5
120065449.0,17,29,13785,29,13785,4288051.75,501.0,475.3448275862069,0,0,0.0,0.0,0.0
112283760.0,6,32,2358,17,1272,7004235.25,123.0,74.82352941176471,15,1086,8004837.5,123.0,72.4
44480.0,6,14,4740,7,653,7260.5,249.0,93.28571428571428,7,4087,6634.333333333333,1514.0,583.8571428571429
308562.0,6,6,412,4,272,102854.0,74.0,68.0,2,140,0.0,74.0,70.0
120122988.0,6,13,2036,8,1016,17136866.57142857,188.0,127.0,5,1020,22520783.5,204.0,204.0
90258816.0,6,13,2036,8,1016,12894116.57142857,188.0,127.0,5,1020,22523365.25,204.0,204.0
350.0,17,2,267,1,83,0.0,83.0,83.0,1,184,0.0,184.0,184.0
191117.0,6,26,13219,14,1076,14701.307692307691,210.0,76.85714285714286,12,12143,16341.09090909091,1514.0,1011.9166666666666
66390.0,6,13,1479,7,882,11065.0,291.0,126.0,6,597,10372.0,259.0,99.5
98585.0,17,2,762,2,762,0.0,381.0,381.0,0,0,0.0,0.0,0.0
30745165.0,6,5,336,2,134,0.0,68.0,67.0,3,202,15334203.0,70.0,67.33333333333333
218946.0,6,3,426,2,280,0.0,214.0,140.0,1,146,0.0,146.0,146.0
131715.0,6,3,337,2,214,0.0,160.0,107.0,1,123,0.0,123.0,123.0
17231.0,6,14,4740,7,653,2758.6666666666665,249.0,93.28571428571428,7,4087,2736.6666666666665,1514.0,583.8571428571429
35926931.0,6,14,982,6,437,7183416.0,95.0,72.83333333333333,8,545,5131751.714285715,95.0,68.125
120000100.0,6,17,1287,9,691,15000012.5,95.0,76.77777777777777,8,596,12897221.0,95.0,74.5
284654.0,17,2,363,1,79,0.0,79.0,79.0,1,284,0.0,284.0,284.0
203732.0,17,2,180,1,90,0.0,90.0,90.0,1,90,0.0,90.0,90.0
14594.0,6,14,4740,7,653,2068.1666666666665,249.0,93.28571428571428,7,4087,2250.6666666666665,1514.0,583.8571428571429
16666139.000000002,6,5,1736,2,819,0.0,753.0,409.5,3,917,8284055.499999999,785.0,305.6666666666667
121265.0,6,3,337,2,214,0.0,160.0,107.0,1,123,0.0,123.0,123.0
2350668.0,6,49,23728,25,19797,97944.5,1514.0,791.88,24,3931,92460.17391304349,1514.0,163.79166666666666
92481038.0,17,16,5472,16,5472,6165402.533333333,342.0,342.0,0,0,0.0,0.0,0.0
104270.0,17,2,700,2,700,0.0,350.0,350.0,0,0,0.0,0.0,0.0
284751.0,17,2,363,1,79,0.0,79.0,79.0,1,284,0.0,284.0,284.0
19105.0,6,2,145,2,145,0.0,91.0,72.5,0,0,0.0,0.0,0.0
108105361.0,17,5,955,5,955,27026340.25,191.0,191.0,0,0,0.0,0.0,0.0
103036.0,17,2,286,2,286,0.0,143.0,143.0,0,0,0.0,0.0,0.0
207479.0,6,3,426,2,280,0.0,214.0,140.0,1,146,0.0,146.0,146.0
2017672.0,17,4,525,2,150,0.0,75.0,75.0,2,375,0.0,284.0,187.5
94133287.0,6,204,24076,102,17122,929883.0693069306,284.0,167.86274509803923,102,6954,929882.792079208,140.0,68.17647058823529
1055723.0,6,3,1604,1,753,0.0,753.0,753.0,2,851,0.0,785.0,425.5
26036.0,6,14,4740,7,653,4230.333333333333,249.0,93.28571428571428,7,4087,4201.333333333333,1514.0,583.8571428571429
4468.0,17,2,614,1,72,0.0,72.0,72.0,1,542,0.0,542.0,542.0
113520537.0,6,46,3036,23,1518,5159999.318181818,66.0,66.0,23,1518,5160012.909090909,66.0,66.0
108656.0,17,2,700,2,700,0.0,350.0,350.0,0,0,0.0,0.0,0.0
313753.0,6,10,1221,6,636,62750.6,298.0,106.0,4,585,99002.66666666669,379.0,146.25
2291.0,17,4,344,2,150,0.0,75.0,75.0,2,194,0.0,103.0,97.0
32096.0,6,14,4740,7,653,4982.5,249.0,93.28571428571428,7,4087,4422.666666666667,1514.0,583.8571428571429
46752.0,6,14,4740,7,653,7581.5,249.0,93.28571428571428,7,4087,7646.0,1514.0,583.8571428571429
39862.0,6,10,2032,5,524,9358.75,252.0,104.8,5,1508,9676.0,1236.0,301.6
108108196.0,17,5,1005,5,1005,27027049.0,201.0,201.0,0,0,0.0,0.0,0.0
2589429.0,6,2,132,1,66,0.0,66.0,66.0,1,66,0.0,66.0,66.0
2076730.0,6,37,15498,19,10875,115373.88888888888,1514.0,572.3684210526316,18,4623,109521.0,1514.0,256.8333333333333
355.0,17,2,267,1,83,0.0,83.0,83.0,1,184,0.0,184.0,184.0
297.0,17,2,174,1,79,0.0,79.0,79.0,1,95,0.0,95.0,95.0
39848.0,6,14,4740,7,653,5505.833333333333,249.0,93.28571428571428,7,4087,6301.0,1514.0,583.8571428571429
217714.0,6,3,426,2,280,0.0,214.0,140.0,1,146,0.0,146.0,146.0
153368.0,17,2,180,1,90,0.0,90.0,90.0,1,90,0.0,90.0,90.0
197052.0,17,2,180,1,90,0.0,90.0,90.0,1,90,0.0,90.0,90.0
257039.00000000003,6,3,337,2,214,0.0,160.0,107.0,1,123,0.0,123.0,123.0
90289740.0,6,21,1585,11,840,9024983.8,95.0,76.36363636363636,10,745,9999956.222222222,95.0,74.5
708.0,17,4,438,2,148,0.0,74.0,74.0,2,290,0.0,147.0,145.0
441776.0,6,10,967,5,390,74351.5,162.0,78.0,5,577,74322.5,349.0,115.4
120209155.0,6,212,23852,106,7292,1137074.0,140.0,68.79245283018868,106,16560,1136998.9904761906,284.0,156.2264150943396
342.0,17,2,267,1,83,0.0,83.0,83.0,1,184,0.0,184.0,184.0
37683.0,6,14,4740,7,653,6153.166666666667,249.0,93.28571428571428,7,4087,5879.5,1514.0,583.8571428571429
36834.0,6,14,4740,7,653,6016.333333333333,249.0,93.28571428571428,7,4087,6001.833333333333,1514.0,583.8571428571429
363446.0,6,6,412,4,272,121148.66666666669,74.0,68.0,2,140,0.0,74.0,70.0
2306.0,17,4,344,2,150,0.0,75.0,75.0,2,194,0.0,103.0,97.0
3631008.0,6,5,336,2,134,0.0,68.0,67.0,3,202,528593.5,70.0,67.33333333333333
135135592.0,17,6,1146,6,1146,27027118.4,191.0,191.0,0,0,0.0,0.0,0.0
2800269.0,6,2,132,1,66,0.0,66.0,66.0,1,66,0.0,66.0,66.0
2742247.0,6,3,1604,2,851,0.0,785.0,425.5,1,753,0.0,753.0,753.0
102324694.0,6,42,2772,21,1386,5105442.45,66.0,66.0,21,1386,5105441.1,66.0,66.0
205889.0,17,2,180,1,90,0.0,90.0,90.0,1,90,0.0,90.0,90.0
120299.0,17,2,180,1,70,0.0,70.0,70.0,1,110,0.0,110.0,110.0
2695830.0,6,3,1604,2,851,0.0,785.0,425.5,1,753,0.0,753.0,753.0
228103.0,17,2,180,1,90,0.0,90.0,90.0,1,90,0.0,90.0,90.0
2393.0,17,4,344,2,150,0.0,75.0,75.0,2,194,0.0,103.0,97.0
27465161.0,17,5,1710,5,1710,6866290.25,342.0,342.0,0,0,0.0,0.0,0.0
0.0,6,1,54,0,0,0.0,0.0,0.0,1,54,0.0,54.0,54.0
109779507.0,6,34,2466,17,1272,6861219.1875,123.0,74.82352941176471,17,1194,6847701.6875,123.0,70.23529411764706
2018.0,17,4,344,2,150,0.0,75.0,75.0,2,194,0.0,103.0,97.0
67851.0,6,14,4740,7,653,10163.833333333334,249.0,93.28571428571428,7,4087,10998.5,1514.0,583.8571428571429
107914.0,6,14,4740,7,653,12977.5,249.0,93.28571428571428,7,4087,17132.833333333332,1514.0,583.8571428571429
205938.0,6,3,426,2,280,0.0,214.0,140.0,1,146,0.0,146.0,146.0
100315151.0,6,28,2008,14,963,7716550.076923077,123.0,68.78571428571429,14,1045,7223591.153846154,139.0,74.64285714285714
108105677.0,17,5,955,5,955,27026419.25,191.0,191.0,0,0,0.0,0.0,0.0
201827.0,17,2,180,1,90,0.0,90.0,90.0,1,90,0.0,90.0,90.0
116527553.0,17,14,864,7,432,19394771.666666668,174.0,61.71428571428572,7,432,19398163.5,174.0,61.71428571428572
228581.0,17,2,180,1,90,0.0,90.0,90.0,1,90,0.0,90.0,90.0
232185.0,6,3,337,2,214,0.0,160.0,107.0,1,123,0.0,123.0,123.0
2383.0,17,4,344,2,150,0.0,75.0,75.0,2,194,0.0,103.0,97.0
46674.0,6,14,4740,7,653,7647.666666666667,249.0,93.28571428571428,7,4087,7633.833333333333,1514.0,583.8571428571429
15064019.0,17,6,2718,6,2718,3012803.8,453.0,453.0,0,0,0.0,0.0,0.0
247123.0,17,2,180,1,90,0.0,90.0,90.0,1,90,0.0,90.0,90.0
11711.0,6,11,2098,6,590,2168.2,252.0,98.33333333333331,5,1508,2684.0,1236.0,301.6
9263.0,17,2,582,1,83,0.0,83.0,83.0,1,499,0.0,499.0,499.0
90021781.0,17,27,12943,27,12943,3462376.1923076925,501.0,479.3703703703704,0,0,0.0,0.0,0.0
320.0,17,2,174,1,79,0.0,79.0,79.0,1,95,0.0,95.0,95.0
2332.0,17,4,344,2,150,0.0,75.0,75.0,2,194,0.0,103.0,97.0
29628.0,6,10,2032,5,524,7167.0,252.0,104.8,5,1508,6269.5,1236.0,301.6
859370.0,6,9,1096,6,625,171874.0,287.0,104.16666666666669,3,471,291775.0,331.0,157.0
120110810.0,6,14,2240,6,1224,24022162.0,204.0,204.0,8,1016,17135542.285714287,188.0,127.0
68245.0,6,13,1386,7,789,11374.166666666666,253.0,112.71428571428572,6,597,12235.4,259.0,99.5
4688.0,17,2,614,1,72,0.0,72.0,72.0,1,542,0.0,542.0,542.0
84288611.0,17,15,5130,15,5130,6020615.071428572,342.0,342.0,0,0,0.0,0.0,0.0
143880.0,17,2,180,1,90,0.0,90.0,90.0,1,90,0.0,90.0,90.0
315.0,17,2,174,1,79,0.0,79.0,79.0,1,95,0.0,95.0,95.0
113774.0,17,4,1400,4,1400,37924.66666666666,350.0,350.0,0,0,0.0,0.0,0.0
213656.0,17,2,180,1,90,0.0,90.0,90.0,1,90,0.0,90.0,90.0
2392.0,17,4,344,2,150,0.0,75.0,75.0,2,194,0.0,103.0,97.0
153438.0,17,2,180,1,90,0.0,90.0,90.0,1,90,0.0,90.0,90.0
170065.0,17,2,414,1,88,0.0,88.0,88.0,1,326,0.0,326.0,326.0
63516.0,6,14,4740,7,653,10417.833333333334,249.0,93.28571428571428,7,4087,10351.666666666666,1514.0,583.8571428571429
21539.0,6,2,145,2,145,0.0,91.0,72.5,0,0,0.0,0.0,0.0
3957.0,17,4,344,2,150,0.0,75.0,75.0,2,194,0.0,103.0,97.0
1302810.0,6,4,264,2,132,0.0,66.0,66.0,2,132,0.0,66.0,66.0
45408.0,6,10,1065,5,534,10564.0,262.0,106.8,5,531,9121.25,259.0,106.2
103218.0,17,2,286,2,286,0.0,143.0,143.0,0,0,0.0,0.0,0.0
255846.00000000003,6,10,1221,6,636,51169.2,298.0,106.0,4,585,82936.33333333333,379.0,146.25
214174.0,6,3,426,2,280,0.0,214.0,140.0,1,146,0.0,146.0,146.0
2726888.0,6,3,1777,2,951,0.0,885.0,475.5,1,826,0.0,826.0,826.0
11708.0,6,13,1459,7,862,1744.5,271.0,123.14285714285714,6,597,2077.8,259.0,99.5
302.0,17,2,164,1,82,0.0,82.0,82.0,1,82,0.0,82.0,82.0
23154.0,6,11,2098,6,590,4313.8,252.0,98.33333333333331,5,1508,5287.25,1236.0,301.6
207510.0,6,3,426,2,280,0.0,214.0,140.0,1,146,0.0,146.0,146.0
32426.000000000004,6,14,4740,7,653,4485.666666666667,249.0,93.28571428571428,7,4087,5258.833333333333,1514.0,583.8571428571429
90255706.0,6,16,2368,9,1204,11281963.25,188.0,133.77777777777777,7,1164,15015660.333333334,204.0,166.28571428571428
147968.0,17,2,180,1,90,0.0,90.0,90.0,1,90,0.0,90.0,90.0
10429421.0,6,7,478,4,272,3431231.6666666665,74.0,68.0,3,206,5146727.5,74.0,68.66666666666667
51289.0,6,10,2032,5,524,12377.0,252.0,104.8,5,1508,12475.25,1236.0,301.6
206511.0,17,2,762,2,762,0.0,381.0,381.0,0,0,0.0,0.0,0.0
3034223.0,6,168,124211,88,114629,34876.12643678161,1510.0,1302.6022727272727,80,9582,34473.84810126582,1510.0,119.775
63826.99999999999,6,10,2032,5,524,14052.75,252.0,104.8,5,1508,14352.75,1236.0,301.6
15233669.0,6,7,499,3,198,6153521.0,66.0,66.0,4,301,3960144.6666666665,103.0,75.25
23848.0,6,20,7606,11,978,2384.8,310.0,88.9090909090909,9,6628,1826.875,1514.0,736.4444444444445
325.0,17,2,174,1,79,0.0,79.0,79.0,1,95,0.0,95.0,95.0
0.0,17,1,90,1,90,0.0,90.0,90.0,0,0,0.0,0.0,0.0
2894128.0,6,2,132,1,66,0.0,66.0,66.0,1,66,0.0,66.0,66.0
1309999.0,6,4,264,2,132,0.0,66.0,66.0,2,132,0.0,66.0,66.0
103804.0,17,2,286,2,286,0.0,143.0,143.0,0,0,0.0,0.0,0.0
1084024.0,6,13,1386,7,789,180670.66666666663,253.0,112.71428571428572,6,597,215450.0,259.0,99.5
204513.0,17,2,180,1,90,0.0,90.0,90.0,1,90,0.0,90.0,90.0
94854279.0,6,183,20604,92,6294,1042354.7142857144,140.0,68.41304347826087,91,14310,1042379.8111111112,284.0,157.25274725274724
119001318.0,17,16,1212,8,606,17000188.285714287,174.0,75.75,8,606,16858201.285714287,174.0,75.75
113254981.0,6,46,3036,23,1518,5135435.818181818,66.0,66.0,23,1518,5135435.318181818,66.0,66.0
135140614.0,17,6,1206,6,1206,27028122.8,201.0,201.0,0,0,0.0,0.0,0.0
317.0,17,2,174,1,79,0.0,79.0,79.0,1,95,0.0,95.0,95.0
54959.0,6,14,4740,7,653,7954.833333333333,249.0,93.28571428571428,7,4087,8899.833333333334,1514.0,583.8571428571429
94850757.0,6,39,2574,20,1320,4975957.736842105,66.0,66.0,19,1254,5150440.777777778,66.0,66.0
2594503.0,6,2,132,1,66,0.0,66.0,66.0,1,66,0.0,66.0,66.0
284471.0,17,4,704,2,148,0.0,74.0,74.0,2,556,0.0,280.0,278.0
2424.0,17,4,344,2,150,0.0,75.0,75.0,2,194,0.0,103.0,97.0
283.0,17,2,164,1,82,0.0,82.0,82.0,1,82,0.0,82.0,82.0
149641.0,17,2,180,1,90,0.0,90.0,90.0,1,90,0.0,90.0,90.0
231985.0,17,2,180,1,90,0.0,90.0,90.0,1,90,0.0,90.0,90.0
59392.0,6,14,4740,7,653,9773.666666666666,249.0,93.28571428571428,7,4087,7344.166666666667,1514.0,583.8571428571429
144096.0,17,2,180,1,90,0.0,90.0,90.0,1,90,0.0,90.0,90.0
23622.0,6,11,2098,6,590,4416.6,252.0,98.33333333333331,5,1508,5667.25,1236.0,301.6
43282.0,6,14,4740,7,653,7082.333333333333,249.0,93.28571428571428,7,4087,6842.833333333333,1514.0,583.8571428571429
27499507.0,17,5,1710,5,1710,6874876.75,342.0,342.0,0,0,0.0,0.0,0.0
90095186.0,6,11,1644,4,816,30031367.33333333,204.0,204.0,7,828,15015505.666666666,188.0,118.28571428571428
115129840.0,6,214,24074,107,7358,1078366.79245283,140.0,68.76635514018692,107,16716,1078357.8113207547,284.0,156.22429906542055
304553.0,17,2,363,1,79,0.0,79.0,79.0,1,284,0.0,284.0,284.0
38735.0,6,10,2032,5,524,9456.0,252.0,104.8,5,1508,8178.0,1236.0,301.6
103504617.0,6,43,2838,22,1452,4928779.238095238,66.0,66.0,21,1386,5144006.5,66.0,66.0
239319.0,6,3,337,2,214,0.0,160.0,107.0,1,123,0.0,123.0,123.0
206231.0,6,3,426,2,280,0.0,214.0,140.0,1,146,0.0,146.0,146.0
90033188.0,17,27,12943,27,12943,3462814.923076923,501.0,479.3703703703704,0,0,0.0,0.0,0.0
90217335.0,6,16,1192,8,596,12853198.857142856,95.0,74.5,8,596,12858836.57142857,95.0,74.5
218883.0,6,3,426,2,280,0.0,214.0,140.0,1,146,0.0,146.0,146.0
850724.0,6,9,1196,6,725,170144.8,387.0,120.83333333333331,3,471,287511.0,331.0,157.0
18051.0,6,14,4740,7,653,2895.833333333333,249.0,93.28571428571428,7,4087,2861.5,1514.0,583.8571428571429
11238.0,17,4,823,2,163,0.0,89.0,81.5,2,660,0.0,443.0,330.0
108103857.0,17,5,1005,5,1005,27025964.25,201.0,201.0,0,0,0.0,0.0,0.0
315734.0,17,4,1400,4,1400,105244.66666666669,350.0,350.0,0,0,0.0,0.0,0.0
2796785.0,6,2,132,1,66,0.0,66.0,66.0,1,66,0.0,66.0,66.0
4425.0,17,2,626,1,72,0.0,72.0,72.0,1,554,0.0,554.0,554.0
206703.0,6,3,426,2,280,0.0,214.0,140.0,1,146,0.0,146.0,146.0
90069141.0,17,28,13364,28,13364,3335894.111111111,501.0,477.2857142857143,0,0,0.0,0.0,0.0
112754585.0,6,5,1736,2,851,0.0,785.0,425.5,3,885,55178334.0,753.0,295.0
31300.0,6,14,4740,7,653,4896.5,249.0,93.28571428571428,7,4087,3955.8333333333335,1514.0,583.8571428571429
120068326.0,6,236,26516,118,8084,1011309.9145299144,140.0,68.50847457627118,118,18432,1025329.0256410256,284.0,156.20338983050848
273181.0,6,10,1221,6,636,54636.2,298.0,106.0,4,585,85675.33333333333,379.0,146.25
96874241.0,6,165,18606,83,5700,1181393.1829268292,140.0,68.67469879518072,82,12906,1183183.3950617283,284.0,157.390243902439
111921557.0,6,385,62598,192,13042,585937.5130890053,214.0,67.92708333333333,193,49556,578685.4479166666,1514.0,256.7668393782384
10470707.0,6,7,478,4,272,3444439.0,74.0,68.0,3,206,5166522.0,74.0,68.66666666666667
325522.0,6,6,412,4,272,108507.33333333331,74.0,68.0,2,140,0.0,74.0,70.0
90257182.0,6,13,2036,8,1016,12893883.142857144,188.0,127.0,5,1020,22523065.5,204.0,204.0
61029.0,6,14,4740,7,653,9891.0,249.0,93.28571428571428,7,4087,9065.166666666666,1514.0,583.8571428571429
304337.0,6,6,412,4,272,101445.66666666669,74.0,68.0,2,140,0.0,74.0,70.0
120027832.0,17,28,13364,28,13364,4445475.259259259,501.0,477.2857142857143,0,0,0.0,0.0,0.0
160096.0,17,2,180,1,90,0.0,90.0,90.0,1,90,0.0,90.0,90.0
90256703.0,6,13,2036,8,1016,12893814.714285716,188.0,127.0,5,1020,22523107.25,204.0,204.0
118453665.0,6,386,46894,193,33860,615824.7760416666,336.0,175.44041450777203,193,13034,615824.265625,140.0,67.53367875647669
31168.0,6,10,2032,5,524,6890.5,252.0,104.8,5,1508,6617.75,1236.0,301.6
44599.0,6,14,4740,7,653,6611.833333333333,249.0,93.28571428571428,7,4087,6660.666666666667,1514.0,583.8571428571429
1343843.0,17,16,1120,16,1120,89589.53333333334,70.0,70.0,0,0,0.0,0.0,0.0
298.0,17,2,164,1,82,0.0,82.0,82.0,1,82,0.0,82.0,82.0
151916.0,17,2,414,1,88,0.0,88.0,88.0,1,326,0.0,326.0,326.0
838393.0,6,9,1118,6,586,167678.6,248.0,97.66666666666669,3,532,281353.5,392.0,177.33333333333334
1490303.0,6,18,6507,10,1598,165589.22222222222,505.0,159.8,8,4909,168935.42857142858,1510.0,613.625
206476.0,6,10,1221,6,636,41295.2,298.0,106.0,4,585,67763.66666666667,379.0,146.25
121361.0,6,3,337,2,214,0.0,160.0,107.0,1,123,0.0,123.0,123.0
1311232.0,6,4,264,2,132,0.0,66.0,66.0,2,132,0.0,66.0,66.0
120214684.0,6,42,3409,23,1900,5454499.7727272725,139.0,82.6086956521739,19,1509,6666611.055555556,123.0,79.42105263157895
4402.0,17,2,180,1,90,0.0,90.0,90.0,1,90,0.0,90.0,90.0
2334.0,17,4,344,2,150,0.0,75.0,75.0,2,194,0.0,103.0,97.0
18896.0,6,14,4740,7,653,2779.333333333333,249.0,93.28571428571428,7,4087,2532.6666666666665,1514.0,583.8571428571429
297419.0,6,6,412,4,272,99139.66666666669,74.0,68.0,2,140,0.0,74.0,70.0
207278.0,6,3,426,2,280,0.0,214.0,140.0,1,146,0.0,146.0,146.0
2441.0,17,4,344,2,150,0.0,75.0,75.0,2,194,0.0,103.0,97.0
12894.0,6,10,1067,5,536,3058.5,264.0,107.2,5,531,3041.25,259.0,106.2
90767244.0,6,211,24072,106,7218,864449.9428571429,140.0,68.09433962264151,105,16854,862881.375,284.0,160.5142857142857
135129021.0,17,6,1206,6,1206,27025804.2,201.0,201.0,0,0,0.0,0.0,0.0
1307863.0,6,4,264,2,132,0.0,66.0,66.0,2,132,0.0,66.0,66.0
135130488.0,17,6,1206,6,1206,27026097.6,201.0,201.0,0,0,0.0,0.0,0.0
79002.0,6,14,4740,7,653,12990.833333333334,249.0,93.28571428571428,7,4087,13032.0,1514.0,583.8571428571429
90538148.0,6,28,2146,15,1168,6451598.071428572,139.0,77.86666666666666,13,978,7526859.75,123.0,75.23076923076923
205631.0,6,3,426,2,280,0.0,214.0,140.0,1,146,0.0,146.0,146.0
149722530.0,6,16,2494,6,1224,23974726.6,204.0,204.0,10,1270,16635530.777777778,188.0,127.0
20001.0,6,11,1131,6,600,3828.8,262.0,100.0,5,531,4682.25,259.0,106.2
223520.0,6,3,426,2,280,0.0,214.0,140.0,1,146,0.0,146.0,146.0
866763.0,6,9,1269,6,798,173352.6,460.0,133.0,3,471,295524.0,331.0,157.0
306.0,17,2,208,1,72,0.0,72.0,72.0,1,136,0.0,136.0,136.0
5345344.0,6,5,336,2,134,0.0,68.0,67.0,3,202,1425540.5,70.0,67.33333333333333
30744.0,6,14,4740,7,653,4377.0,249.0,93.28571428571428,7,4087,4597.5,1514.0,583.8571428571429
32491854.0,6,5,336,2,134,0.0,68.0,67.0,3,202,16176297.0,70.0,67.33333333333333
108280.0,17,2,700,2,700,0.0,350.0,350.0,0,0,0.0,0.0,0.0
213314.0,6,3,426,2,280,0.0,214.0,140.0,1,146,0.0,146.0,146.0
207414.0,6,3,426,2,280,0.0,214.0,140.0,1,146,0.0,146.0,146.0
233067.0,6,3,337,2,214,0.0,160.0,107.0,1,123,0.0,123.0,123.0
90653784.0,6,15,2302,9,1204,11316404.5,188.0,133.77777777777777,6,1098,18098112.2,204.0,183.0
107039844.0,6,43,2838,22,1452,5097119.285714285,66.0,66.0,21,1386,5160004.25,66.0,66.0
135133117.0,17,6,1206,6,1206,27026623.4,201.0,201.0,0,0,0.0,0.0,0.0
120019601.0,17,29,13785,29,13785,4286414.321428572,501.0,475.3448275862069,0,0,0.0,0.0,0.0
232591.0,6,3,426,2,280,0.0,214.0,140.0,1,146,0.0,146.0,146.0
284647.0,17,2,363,1,79,0.0,79.0,79.0,1,284,0.0,284.0,284.0
207342.0,6,3,426,2,280,0.0,214.0,140.0,1,146,0.0,146.0,146.0
34236.0,6,14,4740,7,653,5386.333333333333,249.0,93.28571428571428,7,4087,3262.6666666666665,1514.0,583.8571428571429
764.0,17,4,438,2,148,0.0,74.0,74.0,2,290,0.0,147.0,145.0
330.0,17,2,166,1,75,0.0,75.0,75.0,1,91,0.0,91.0,91.0
141.0,17,2,762,2,762,0.0,381.0,381.0,0,0,0.0,0.0,0.0
4374.0,17,2,614,1,72,0.0,72.0,72.0,1,542,0.0,542.0,542.0
2406.0,17,4,344,2,150,0.0,75.0,75.0,2,194,0.0,103.0,97.0
3006237.0,6,12,2172,7,664,500942.5,252.0,94.85714285714286,5,1508,2043.0,1236.0,301.6
107746.0,17,4,1400,4,1400,35915.333333333336,350.0,350.0,0,0,0.0,0.0,0.0
509.0,17,2,508,2,508,0.0,257.0,254.0,0,0,0.0,0.0,0.0
160951.0,6,3,337,2,214,0.0,160.0,107.0,1,123,0.0,123.0,123.0
2125.0,17,2,691,1,349,0.0,349.0,349.0,1,342,0.0,342.0,342.0
422008.0,6,3,204,1,68,0.0,68.0,68.0,2,136,0.0,70.0,68.0
135355848.0,17,8,1643,7,1337,22559308.0,191.0,191.0,1,306,0.0,306.0,306.0
12312378.0,6,32,10098,16,2754,803439.2,408.0,172.125,16,7344,800819.7333333333,1514.0,459.0
207090.0,6,3,426,2,280,0.0,214.0,140.0,1,146,0.0,146.0,146.0
853629.0,6,9,1268,6,797,170725.8,459.0,132.83333333333334,3,471,288993.0,331.0,157.0
0.0,17,1,381,1,381,0.0,381.0,381.0,0,0,0.0,0.0,0.0
138557.0,6,2,132,1,66,0.0,66.0,66.0,1,66,0.0,66.0,66.0
308728.0,6,6,412,4,272,102909.33333333331,74.0,68.0,2,140,0.0,74.0,70.0
875098.0,6,10,1162,6,625,175019.6,287.0,104.16666666666669,4,537,199786.3333333333,331.0,134.25
90259585.0,6,14,2240,8,1016,12894226.42857143,188.0,127.0,6,1224,18019008.0,204.0,204.0
120065667.0,17,28,13364,28,13364,4446876.555555556,501.0,477.2857142857143,0,0,0.0,0.0,0.0
104679.0,17,2,286,2,286,0.0,143.0,143.0,0,0,0.0,0.0,0.0
105819.0,17,2,700,2,700,0.0,350.0,350.0,0,0,0.0,0.0,0.0
228471.0,17,2,180,1,90,0.0,90.0,90.0,1,90,0.0,90.0,90.0
1312212.0,6,4,264,2,132,0.0,66.0,66.0,2,132,0.0,66.0,66.0
106632795.0,6,32,2220,16,1149,7094468.533333333,123.0,71.8125,16,1071,7094465.066666666,123.0,66.9375
198805.0,17,2,180,1,90,0.0,90.0,90.0,1,90,0.0,90.0,90.0
115184539.0,6,209,23490,105,7152,1107543.6442307692,140.0,68.11428571428571,104,16338,1108243.077669903,284.0,157.09615384615384
2328.0,17,4,344,2,150,0.0,75.0,75.0,2,194,0.0,103.0,97.0
320230.0,6,6,412,4,272,106743.33333333331,74.0,68.0,2,140,0.0,74.0,70.0
120120693.0,6,312,35906,156,25314,773576.1483870968,284.0,162.26923076923077,156,10592,773576.0193548388,140.0,67.8974358974359
135131629.0,17,6,1206,6,1206,27026325.8,201.0,201.0,0,0,0.0,0.0,0.0
1354266.0,6,4,264,2,132,0.0,66.0,66.0,2,132,0.0,66.0,66.0
3298124.0,6,5,336,2,134,0.0,68.0,67.0,3,202,1525258.5,70.0,67.33333333333333
3581250.0,6,5,336,2,134,0.0,68.0,67.0,3,202,1423992.0,70.0,67.33333333333333
113992952.0,6,31,2166,16,1149,7585142.666666667,123.0,71.8125,15,1017,8126938.428571428,123.0,67.8
2408.0,17,4,344,2,150,0.0,75.0,75.0,2,194,0.0,103.0,97.0
128875430.0,6,36,2602,19,1408,7159746.111111111,139.0,74.10526315789474,17,1194,7417131.625,123.0,70.23529411764706
119120245.0,6,20,1490,10,745,13235582.777777778,95.0,74.5,10,745,13207641.777777778,95.0,74.5
120006521.0,6,18,1341,9,691,14999954.375,95.0,76.77777777777777,9,650,14999590.75,95.0,72.22222222222223
103811.0,17,2,286,2,286,0.0,143.0,143.0,0,0,0.0,0.0,0.0
108108531.0,17,5,1005,5,1005,27027132.75,201.0,201.0,0,0,0.0,0.0,0.0
97650771.0,6,26,1746,13,906,8119571.333333333,123.0,69.6923076923077,13,840,8119573.5,123.0,64.61538461538461
108106503.0,17,5,955,5,955,27026625.75,191.0,191.0,0,0,0.0,0.0,0.0
38204.0,6,14,4740,7,653,4826.666666666667,249.0,93.28571428571428,7,4087,6111.333333333333,1514.0,583.8571428571429
57813.0,6,14,4740,7,653,9137.5,249.0,93.28571428571428,7,4087,8621.833333333334,1514.0,583.8571428571429
144105.0,17,2,180,1,90,0.0,90.0,90.0,1,90,0.0,90.0,90.0
104905718.0,6,44,2904,22,1452,4995510.380952381,66.0,66.0,22,1452,4981155.380952381,66.0,66.0
3013444.0,6,11,2106,6,598,602271.8,252.0,99.66666666666669,5,1508,3840.25,1236.0,301.6
135141685.0,17,6,1206,6,1206,27028337.0,201.0,201.0,0,0,0.0,0.0,0.0
72542.0,6,14,4740,7,653,11080.333333333334,249.0,93.28571428571428,7,4087,10162.333333333334,1514.0,583.8571428571429
61243.0,6,14,4740,7,653,8411.5,249.0,93.28571428571428,7,4087,9924.666666666666,1514.0,583.8571428571429
1312509.0,6,4,264,2,132,0.0,66.0,66.0,2,132,0.0,66.0,66.0
10853.0,6,10,1067,5,536,2474.0,264.0,107.2,5,531,2021.75,259.0,106.2
510566.0,6,5,336,2,134,0.0,68.0,67.0,3,202,191137.0,70.0,67.33333333333333
1321475.0,6,4,264,2,132,0.0,66.0,66.0,2,132,0.0,66.0,66.0
16636.0,6,14,4740,7,653,2463.6666666666665,249.0,93.28571428571428,7,4087,2639.5,1514.0,583.8571428571429
875.0,17,4,438,2,148,0.0,74.0,74.0,2,290,0.0,147.0,145.0
153449.0,17,2,180,1,90,0.0,90.0,90.0,1,90,0.0,90.0,90.0
109618.0,17,2,286,2,286,0.0,143.0,143.0,0,0,0.0,0.0,0.0
90041283.0,17,28,13364,28,13364,3334862.333333333,501.0,477.2857142857143,0,0,0.0,0.0,0.0
11272.0,6,11,1132,6,556,2254.4,218.0,92.66666666666669,5,576,2334.25,304.0,115.2
47888.0,6,14,4740,7,653,7580.666666666667,249.0,93.28571428571428,7,4087,7742.166666666667,1514.0,583.8571428571429
135128951.0,17,6,1206,6,1206,27025790.2,201.0,201.0,0,0,0.0,0.0,0.0
90038847.0,17,28,13364,28,13364,3334772.111111111,501.0,477.2857142857143,0,0,0.0,0.0,0.0
441825.0,6,10,967,5,390,74413.5,162.0,78.0,5,577,74349.25,349.0,115.4
108113118.0,17,5,955,5,955,27028279.5,191.0,191.0,0,0,0.0,0.0,0.0
104233.0,17,2,286,2,286,0.0,143.0,143.0,0,0,0.0,0.0,0.0
1182236.0,6,13,3020,8,2392,168890.85714285713,1514.0,299.0,5,628,227356.75,331.0,125.6
241494.0,6,3,337,2,214,0.0,160.0,107.0,1,123,0.0,123.0,123.0
283453.0,17,4,571,2,148,0.0,74.0,74.0,2,423,0.0,280.0,211.5
153453.0,17,2,180,1,90,0.0,90.0,90.0,1,90,0.0,90.0,90.0
307194.0,6,6,412,4,272,102398.0,74.0,68.0,2,140,0.0,74.0,70.0
90964393.0,6,21,1585,11,840,9095296.0,95.0,76.36363636363636,10,745,10105981.777777778,95.0,74.5
311.0,17,2,160,1,80,0.0,80.0,80.0,1,80,0.0,80.0,80.0
286019.0,17,2,180,1,90,0.0,90.0,90.0,1,90,0.0,90.0,90.0
2402.0,17,4,344,2,150,0.0,75.0,75.0,2,194,0.0,103.0,97.0
706946.0,6,2,132,1,66,0.0,66.0,66.0,1,66,0.0,66.0,66.0
113168343.0,6,46,3036,23,1518,5144003.909090909,66.0,66.0,23,1518,5144004.045454546,66.0,66.0
50787.0,17,2,180,1,90,0.0,90.0,90.0,1,90,0.0,90.0,90.0
212312.0,6,3,426,2,280,0.0,214.0,140.0,1,146,0.0,146.0,146.0
90052737.0,17,28,13364,28,13364,3335286.5555555555,501.0,477.2857142857143,0,0,0.0,0.0,0.0
24732.0,6,14,4740,7,653,3868.1666666666665,249.0,93.28571428571428,7,4087,3990.8333333333335,1514.0,583.8571428571429
90208729.0,6,16,1192,8,596,12852834.57142857,95.0,74.5,8,596,12857616.285714284,95.0,74.5
27112.0,6,10,2032,5,524,6531.5,252.0,104.8,5,1508,6483.25,1236.0,301.6
309040.0,6,6,412,4,272,103013.33333333331,74.0,68.0,2,140,0.0,74.0,70.0
209395.0,17,2,180,1,90,0.0,90.0,90.0,1,90,0.0,90.0,90.0
139701.0,6,2,132,1,66,0.0,66.0,66.0,1,66,0.0,66.0,66.0
104074030.0,6,44,2904,22,1452,4955906.19047619,66.0,66.0,22,1452,4942784.714285715,66.0,66.0
161839.0,17,2,180,1,90,0.0,90.0,90.0,1,90,0.0,90.0,90.0
2591215.0,6,2,132,1,66,0.0,66.0,66.0,1,66,0.0,66.0,66.0
201754.0,17,2,180,1,90,0.0,90.0,90.0,1,90,0.0,90.0,90.0
2492.0,17,4,344,2,150,0.0,75.0,75.0,2,194,0.0,103.0,97.0
90016817.0,17,28,13364,28,13364,3333956.185185185,501.0,477.2857142857143,0,0,0.0,0.0,0.0
320437.0,17,4,1400,4,1400,106812.33333333331,350.0,350.0,0,0,0.0,0.0,0.0
307958.0,6,6,412,4,272,102652.66666666669,74.0,68.0,2,140,0.0,74.0,70.0
16015484.0,17,2,684,2,684,0.0,342.0,342.0,0,0,0.0,0.0,0.0
206249.0,17,2,762,2,762,0.0,381.0,381.0,0,0,0.0,0.0,0.0
2361823.0,6,3,1604,2,851,0.0,785.0,425.5,1,753,0.0,753.0,753.0
33558.0,6,14,4740,7,653,5433.333333333333,249.0,93.28571428571428,7,4087,4924.833333333333,1514.0,583.8571428571429
362816.0,6,11,1021,6,444,48825.4,162.0,74.0,5,577,60858.25,349.0,115.4
308786.0,6,6,412,4,272,102928.66666666669,74.0,68.0,2,140,0.0,74.0,70.0
2335.0,17,4,344,2,150,0.0,75.0,75.0,2,194,0.0,103.0,97.0
450.0,17,2,508,2,508,0.0,257.0,254.0,0,0,0.0,0.0,0.0
108112917.0,17,5,1005,5,1005,27028229.25,201.0,201.0,0,0,0.0,0.0,0.0
43009.0,6,14,4740,7,653,7035.5,249.0,93.28571428571428,7,4087,6798.166666666667,1514.0,583.8571428571429
29385.0,6,14,4740,7,653,4774.333333333333,249.0,93.28571428571428,7,4087,4700.833333333333,1514.0,583.8571428571429
58840.0,6,14,4740,7,653,9287.833333333334,249.0,93.28571428571428,7,4087,9427.5,1514.0,583.8571428571429
47596641.0,6,8,1940,3,887,22568996.0,753.0,295.6666666666667,5,1053,11257442.5,785.0,210.6
310114.0,6,3,202,2,128,0.0,74.0,64.0,1,74,0.0,74.0,74.0
2179079.0,6,19,6869,11,1567,217907.9,408.0,142.45454545454547,8,5302,249037.14285714287,1514.0,662.75
2381552.0,6,25,7573,14,3735,183196.3076923077,1514.0,266.7857142857143,11,3838,211992.9,1514.0,348.90909090909093
56236.0,6,14,4740,7,653,9245.666666666666,249.0,93.28571428571428,7,4087,7934.0,1514.0,583.8571428571429
102338190.0,17,14,864,7,432,17000220.333333332,174.0,61.71428571428572,7,432,17001649.333333332,174.0,61.71428571428572
108114073.0,17,5,1005,5,1005,27028518.25,201.0,201.0,0,0,0.0,0.0,0.0
301703.0,6,6,412,4,272,100567.66666666669,74.0,68.0,2,140,0.0,74.0,70.0
0.0,17,1,44,1,44,0.0,44.0,44.0,0,0,0.0,0.0,0.0
303628.0,6,2,132,1,66,0.0,66.0,66.0,1,66,0.0,66.0,66.0
209679.0,17,2,180,1,90,0.0,90.0,90.0,1,90,0.0,90.0,90.0
145924.0,6,3,337,2,214,0.0,160.0,107.0,1,123,0.0,123.0,123.0
120003161.0,6,23,1734,12,935,10909044.545454543,95.0,77.91666666666667,11,799,11970434.4,95.0,72.63636363636364
2798554.0,6,2,132,1,66,0.0,66.0,66.0,1,66,0.0,66.0,66.0
1543673.0,6,7,499,4,301,467141.0,103.0,75.25,3,198,716342.5,66.0,66.0
3345.0,17,2,359,1,75,0.0,75.0,75.0,1,284,0.0,284.0,284.0
90759435.0,6,17,1287,9,691,11339516.125,95.0,76.77777777777777,8,596,12964750.142857144,95.0,74.5
3008266.0,6,11,2106,6,598,601456.8,252.0,99.66666666666669,5,1508,1886.5,1236.0,301.6
325152.0,6,6,412,4,272,108384.0,74.0,68.0,2,140,0.0,74.0,70.0
236410.0,6,3,337,2,214,0.0,160.0,107.0,1,123,0.0,123.0,123.0
105401904.0,17,14,1126,7,563,17466674.833333332,174.0,80.42857142857143,7,563,17540500.166666668,174.0,80.42857142857143
2678471.0,6,23,6504,12,1529,243497.36363636365,357.0,127.41666666666669,11,4975,237390.3,1510.0,452.27272727272725
181277.0,17,2,180,1,90,0.0,90.0,90.0,1,90,0.0,90.0,90.0
9143.0,17,2,498,1,80,0.0,80.0,80.0,1,418,0.0,418.0,418.0
3803885.0,6,5,336,2,134,0.0,68.0,67.0,3,202,527808.5,70.0,67.33333333333333
90261505.0,6,13,2036,8,1016,12894500.714285716,188.0,127.0,5,1020,22523972.25,204.0,204.0
299.0,17,2,156,1,78,0.0,78.0,78.0,1,78,0.0,78.0,78.0
146274.0,6,3,373,2,238,0.0,172.0,119.0,1,135,0.0,135.0,135.0
108109307.0,17,5,955,5,955,27027326.75,191.0,191.0,0,0,0.0,0.0,0.0
90012586.0,17,28,13364,28,13364,3333799.4814814813,501.0,477.2857142857143,0,0,0.0,0.0,0.0
203381.0,17,2,762,2,762,0.0,381.0,381.0,0,0,0.0,0.0,0.0
38243.0,6,14,4740,7,653,5756.0,249.0,93.28571428571428,7,4087,6192.166666666667,1514.0,583.8571428571429
159214.0,6,3,337,2,214,0.0,160.0,107.0,1,123,0.0,123.0,123.0
103827.0,17,2,286,2,286,0.0,143.0,143.0,0,0,0.0,0.0,0.0
314608.0,6,3,202,2,128,0.0,74.0,64.0,1,74,0.0,74.0,74.0
100161.0,17,2,286,2,286,0.0,143.0,143.0,0,0,0.0,0.0,0.0
73053.0,6,14,4740,7,653,12024.166666666666,249.0,93.28571428571428,7,4087,10070.166666666666,1514.0,583.8571428571429
301028.0,17,2,180,1,90,0.0,90.0,90.0,1,90,0.0,90.0,90.0
42486.0,6,13,1479,7,882,6831.333333333333,291.0,126.0,6,597,7669.2,259.0,99.5
316197.0,17,4,1400,4,1400,105399.0,350.0,350.0,0,0,0.0,0.0,0.0
145.0,17,2,700,2,700,0.0,350.0,350.0,0,0,0.0,0.0,0.0
120005015.0,6,19,1436,9,691,15000626.875,95.0,76.77777777777777,10,745,13305827.888888888,95.0,74.5
228396.0,17,2,180,1,90,0.0,90.0,90.0,1,90,0.0,90.0,90.0
153430.0,17,2,180,1,90,0.0,90.0,90.0,1,90,0.0,90.0,90.0
7058.0,17,2,582,1,83,0.0,83.0,83.0,1,499,0.0,499.0,499.0
41315.0,6,14,4740,7,653,6291.333333333333,249.0,93.28571428571428,7,4087,6262.5,1514.0,583.8571428571429
36856.0,6,13,1386,7,789,5686.833333333333,253.0,112.71428571428572,6,597,5716.6,259.0,99.5
90031827.0,17,28,13364,28,13364,3334512.111111111,501.0,477.2857142857143,0,0,0.0,0.0,0.0
2323901.0,6,3,1604,2,851,0.0,785.0,425.5,1,753,0.0,753.0,753.0
307351.0,6,6,412,4,272,102450.33333333331,74.0,68.0,2,140,0.0,74.0,70.0
120123543.0,6,13,2036,5,1020,30030885.75,204.0,204.0,8,1016,17136903.85714286,188.0,127.0
18561.0,17,2,582,1,83,0.0,83.0,83.0,1,499,0.0,499.0,499.0
1252.0,17,5,550,5,550,313.0,110.0,110.0,0,0,0.0,0.0,0.0
143865.0,17,2,180,1,90,0.0,90.0,90.0,1,90,0.0,90.0,90.0
109576364.0,6,194,21886,97,15262,1139179.6979166667,284.0,157.340206185567,97,6624,1139179.75,140.0,68.28865979381443
330.0,17,2,166,1,75,0.0,75.0,75.0,1,91,0.0,91.0,91.0
1302901.0,6,4,264,2,132,0.0,66.0,66.0,2,132,0.0,66.0,66.0
515914.0,6,10,1221,6,636,103182.8,298.0,106.0,4,585,165539.33333333334,379.0,146.25
101947.0,17,2,762,2,762,0.0,381.0,381.0,0,0,0.0,0.0,0.0
1655631.0,6,23,6509,12,1529,150511.9090909091,357.0,127.41666666666669,11,4980,135547.6,1510.0,452.7272727272728
229707.0,17,2,180,1,90,0.0,90.0,90.0,1,90,0.0,90.0,90.0
119527579.0,6,272,31244,136,21972,883795.4222222222,300.0,161.55882352941177,136,9272,883795.0814814814,140.0,68.17647058823529
1383063.0,6,7,499,3,198,614262.0,66.0,66.0,4,301,455055.3333333333,103.0,75.25
120118768.0,6,214,24234,107,7284,1125359.1981132077,140.0,68.07476635514018,107,16950,1126602.7735849055,284.0,158.41121495327104
153407.0,17,2,180,1,90,0.0,90.0,90.0,1,90,0.0,90.0,90.0
2360.0,17,4,344,2,150,0.0,75.0,75.0,2,194,0.0,103.0,97.0
235417.0,6,12,1373,7,714,39236.16666666666,298.0,102.0,5,659,58189.75,379.0,131.8
1298601.0,6,4,264,2,132,0.0,66.0,66.0,2,132,0.0,66.0,66.0
246135.0,6,3,337,2,214,0.0,160.0,107.0,1,123,0.0,123.0,123.0
228384.0,17,2,180,1,90,0.0,90.0,90.0,1,90,0.0,90.0,90.0
234049.0,6,3,337,2,214,0.0,160.0,107.0,1,123,0.0,123.0,123.0
302343.0,6,2,132,1,66,0.0,66.0,66.0,1,66,0.0,66.0,66.0
236730.0,17,2,180,1,90,0.0,90.0,90.0,1,90,0.0,90.0,90.0
120236068.0,6,32,2226,17,1209,7514754.25,123.0,71.11764705882354,15,1017,7860246.285714285,123.0,67.8
14330.0,6,14,4740,7,653,2265.5,249.0,93.28571428571428,7,4087,2256.0,1514.0,583.8571428571429
116281286.0,6,30,1974,15,1026,8290399.5,123.0,68.4,15,948,8290400.214285715,123.0,63.2
121001159.0,17,15,907,8,475,17285879.85714286,174.0,59.375,7,432,16834851.333333332,174.0,61.71428571428572
2811648.0,6,2,132,1,66,0.0,66.0,66.0,1,66,0.0,66.0,66.0
415275.0,17,2,762,2,762,0.0,381.0,381.0,0,0,0.0,0.0,0.0
58300.0,6,14,4740,7,653,9476.666666666666,249.0,93.28571428571428,7,4087,9395.833333333334,1514.0,583.8571428571429
135140710.0,17,6,1206,6,1206,27028142.0,201.0,201.0,0,0,0.0,0.0,0.0
110392549.0,17,14,864,7,432,18333482.83333333,174.0,61.71428571428572,7,432,18339321.166666668,174.0,61.71428571428572
233480.0,6,3,337,2,214,0.0,160.0,107.0,1,123,0.0,123.0,123.0
107064.0,17,2,286,2,286,0.0,143.0,143.0,0,0,0.0,0.0,0.0
2328.0,17,4,344,2,150,0.0,75.0,75.0,2,194,0.0,103.0,97.0
90295405.0,6,16,1192,8,596,12892372.285714284,95.0,74.5,8,596,12897046.142857144,95.0,74.5
103019.0,17,2,286,2,286,0.0,143.0,143.0,0,0,0.0,0.0,0.0
38825513.0,6,5,336,2,134,0.0,68.0,67.0,3,202,18011932.5,70.0,67.33333333333333
2799102.0,6,2,132,1,66,0.0,66.0,66.0,1,66,0.0,66.0,66.0
110000569.0,6,29,1920,15,1026,7857183.5,123.0,68.4,14,894,7676885.307692308,123.0,63.85714285714285
206804.0,6,3,426,2,280,0.0,214.0,140.0,1,146,0.0,146.0,146.0
10426738.0,6,7,478,4,272,3430277.333333333,74.0,68.0,3,206,5145315.5,74.0,68.66666666666667
9752.0,17,2,571,1,86,0.0,86.0,86.0,1,485,0.0,485.0,485.0
110402.0,17,4,1400,4,1400,36800.66666666666,350.0,350.0,0,0,0.0,0.0,0.0
148090.0,17,2,180,1,90,0.0,90.0,90.0,1,90,0.0,90.0,90.0
2392.0,17,4,344,2,150,0.0,75.0,75.0,2,194,0.0,103.0,97.0
2448.0,17,4,344,2,150,0.0,75.0,75.0,2,194,0.0,103.0,97.0
39695.0,6,14,4740,7,653,6302.833333333333,249.0,93.28571428571428,7,4087,6303.0,1514.0,583.8571428571429
135135745.0,17,6,1146,6,1146,27027149.0,191.0,191.0,0,0,0.0,0.0,0.0
90265592.0,6,14,2240,8,1016,12895084.57142857,188.0,127.0,6,1224,18018564.8,204.0,204.0
103377.0,17,2,286,2,286,0.0,143.0,143.0,0,0,0.0,0.0,0.0
21705.0,17,2,582,1,83,0.0,83.0,83.0,1,499,0.0,499.0,499.0
803.0,17,4,438,2,148,0.0,74.0,74.0,2,290,0.0,147.0,145.0
226468.0,6,12,1373,7,714,37744.66666666666,298.0,102.0,5,659,55728.0,379.0,131.8
111183.0,17,4,1400,4,1400,37061.0,350.0,350.0,0,0,0.0,0.0,0.0
407.0,17,2,410,1,78,0.0,78.0,78.0,1,332,0.0,332.0,332.0
21114.0,6,14,4740,7,653,3336.833333333333,249.0,93.28571428571428,7,4087,3327.6666666666665,1514.0,583.8571428571429
4136.0,17,2,598,1,72,0.0,72.0,72.0,1,526,0.0,526.0,526.0
2077.0,17,4,344,2,150,0.0,75.0,75.0,2,194,0.0,103.0,97.0
55461.0,6,14,4740,7,653,9001.0,249.0,93.28571428571428,7,4087,8343.833333333334,1514.0,583.8571428571429
90044626.0,17,28,13364,28,13364,3334986.1481481483,501.0,477.2857142857143,0,0,0.0,0.0,0.0
0.0,17,1,44,1,44,0.0,44.0,44.0,0,0,0.0,0.0,0.0
120029197.0,17,28,13364,28,13364,4445525.814814814,501.0,477.2857142857143,0,0,0.0,0.0,0.0
135128975.0,17,6,1206,6,1206,27025795.0,201.0,201.0,0,0,0.0,0.0,0.0
17039.0,6,11,2098,6,590,2962.6,252.0,98.33333333333331,5,1508,2759.25,1236.0,301.6
107378318.0,6,32,2236,16,1165,7144175.6,139.0,72.8125,16,1071,7144167.333333333,123.0,66.9375
3439.0,17,2,359,1,75,0.0,75.0,75.0,1,284,0.0,284.0,284.0
153396.0,17,2,180,1,90,0.0,90.0,90.0,1,90,0.0,90.0,90.0
218029.0,6,3,426,2,280,0.0,214.0,140.0,1,146,0.0,146.0,146.0
178222.0,17,2,180,1,90,0.0,90.0,90.0,1,90,0.0,90.0,90.0
90045915.0,17,28,13364,28,13364,3335033.888888889,501.0,477.2857142857143,0,0,0.0,0.0,0.0
113733672.0,6,46,3036,23,1518,5155434.863636363,66.0,66.0,23,1518,5155437.909090909,66.0,66.0
206443.0,17,2,180,1,90,0.0,90.0,90.0,1,90,0.0,90.0,90.0
960580.0,6,12,2709,7,742,160096.66666666666,338.0,106.0,5,1967,171234.25,1514.0,393.4
52133.0,6,14,4740,7,653,7089.0,249.0,93.28571428571428,7,4087,8302.333333333334,1514.0,583.8571428571429
30575.0,6,14,4740,7,653,4930.166666666667,249.0,93.28571428571428,7,4087,4843.0,1514.0,583.8571428571429
66542.0,6,14,4740,7,653,10651.833333333334,249.0,93.28571428571428,7,4087,9808.0,1514.0,583.8571428571429
119373292.0,17,35,16705,35,16705,3510979.1764705884,501.0,477.2857142857143,0,0,0.0,0.0,0.0
108103617.0,17,5,1005,5,1005,27025904.25,201.0,201.0,0,0,0.0,0.0,0.0
125001565.0,17,15,907,8,475,17857366.42857143,174.0,59.375,7,432,17500460.5,174.0,61.71428571428572
2637.0,17,4,344,2,150,0.0,75.0,75.0,2,194,0.0,103.0,97.0
4109.0,17,4,344,2,150,0.0,75.0,75.0,2,194,0.0,103.0,97.0
44344.0,6,14,4740,7,653,7271.0,249.0,93.28571428571428,7,4087,5542.166666666667,1514.0,583.8571428571429
12388.0,17,4,823,2,163,0.0,89.0,81.5,2,660,0.0,443.0,330.0
58950.0,6,10,1065,5,534,13446.0,262.0,106.8,5,531,11716.0,259.0,106.2
118730662.0,6,218,24646,109,17156,1097366.4444444445,284.0,157.39449541284404,109,7490,1097366.861111111,140.0,68.71559633027523
111084.0,17,2,286,2,286,0.0,143.0,143.0,0,0,0.0,0.0,0.0
603021.0,6,4,508,2,238,0.0,172.0,119.0,2,270,0.0,135.0,135.0
2979079.0,6,12,2172,7,664,496303.3333333333,252.0,94.85714285714286,5,1508,2854.0,1236.0,301.6
905416.0,6,10,1333,6,796,181083.2,458.0,132.66666666666666,4,537,209939.66666666663,331.0,134.25
102007977.0,17,13,821,7,432,17001329.5,174.0,61.71428571428572,6,389,16385493.0,174.0,64.83333333333333
284245.0,17,2,365,1,80,0.0,80.0,80.0,1,285,0.0,285.0,285.0
107711.0,17,2,286,2,286,0.0,143.0,143.0,0,0,0.0,0.0,0.0
92285271.0,17,15,5130,15,5130,6591805.071428572,342.0,342.0,0,0,0.0,0.0,0.0
153506.0,17,2,180,1,90,0.0,90.0,90.0,1,90,0.0,90.0,90.0
6460.0,17,2,414,1,88,0.0,88.0,88.0,1,326,0.0,326.0,326.0
106004118.0,17,14,1126,7,563,17487086.666666668,174.0,80.42857142857143,7,563,17640522.5,174.0,80.42857142857143
914.0,17,5,550,5,550,228.5,110.0,110.0,0,0,0.0,0.0,0.0
251345.0,17,4,6056,4,6056,83781.66666666667,1514.0,1514.0,0,0,0.0,0.0,0.0
299912.0,6,6,412,4,272,99970.66666666669,74.0,68.0,2,140,0.0,74.0,70.0
228389.0,17,2,180,1,90,0.0,90.0,90.0,1,90,0.0,90.0,90.0
3629.0,17,4,625,2,163,0.0,89.0,81.5,2,462,0.0,245.0,231.0
39904.0,6,14,4740,7,653,6335.166666666667,249.0,93.28571428571428,7,4087,6181.333333333333,1514.0,583.8571428571429
90289510.0,6,19,1436,10,745,10026681.666666666,95.0,74.5,9,691,11284792.5,95.0,76.77777777777777
302.0,17,2,156,1,78,0.0,78.0,78.0,1,78,0.0,78.0,78.0
2802469.0,6,2,132,1,66,0.0,66.0,66.0,1,66,0.0,66.0,66.0
106873.0,17,2,286,2,286,0.0,143.0,143.0,0,0,0.0,0.0,0.0
294.0,17,2,164,1,82,0.0,82.0,82.0,1,82,0.0,82.0,82.0
120113719.0,6,214,24324,107,7284,1125257.783018868,140.0,68.07476635514018,107,17040,1125391.3301886793,284.0,159.25233644859813
76558.0,6,13,1493,7,862,12023.5,271.0,123.14285714285714,6,631,14246.6,293.0,105.16666666666669
10513913.0,6,7,478,4,272,3458959.333333333,74.0,68.0,3,206,5188328.0,74.0,68.66666666666667
96180852.0,6,28,2008,14,1045,7381935.307692308,139.0,74.64285714285714,14,963,7381932.538461538,123.0,68.78571428571429
31971.0,6,14,4740,7,653,5159.833333333333,249.0,93.28571428571428,7,4087,4979.166666666667,1514.0,583.8571428571429
105045944.0,6,193,21698,97,6698,1094228.5833333333,140.0,69.05154639175258,96,15000,1094848.6210526316,284.0,156.25
507836.0,6,5,336,2,134,0.0,68.0,67.0,3,202,193591.0,70.0,67.33333333333333
193930.0,17,2,180,1,90,0.0,90.0,90.0,1,90,0.0,90.0,90.0
207600.0,6,3,426,2,280,0.0,214.0,140.0,1,146,0.0,146.0,146.0
153470.0,17,2,180,1,90,0.0,90.0,90.0,1,90,0.0,90.0,90.0
130049.0,6,2,132,1,66,0.0,66.0,66.0,1,66,0.0,66.0,66.0
16644.0,6,10,2032,5,524,3927.25,252.0,104.8,5,1508,3308.75,1236.0,301.6
100378.0,17,2,286,2,286,0.0,143.0,143.0,0,0,0.0,0.0,0.0
511519.0,6,5,336,2,134,0.0,68.0,67.0,3,202,195917.0,70.0,67.33333333333333
308974.0,6,3,202,2,128,0.0,74.0,64.0,1,74,0.0,74.0,74.0
151171.0,17,2,180,1,90,0.0,90.0,90.0,1,90,0.0,90.0,90.0
5001236.0,17,4,849,2,166,0.0,83.0,83.0,2,683,0.0,499.0,341.5
106937168.0,6,43,2838,22,1452,5092232.952380952,66.0,66.0,21,1386,5160002.95,66.0,66.0
358.0,17,2,267,1,83,0.0,83.0,83.0,1,184,0.0,184.0,184.0
573000.0,6,3,198,2,132,0.0,66.0,66.0,1,66,0.0,66.0,66.0
21844.0,17,2,582,1,83,0.0,83.0,83.0,1,499,0.0,499.0,499.0
84.0,17,2,762,2,762,0.0,381.0,381.0,0,0,0.0,0.0,0.0
1853230.0,6,8,602,5,404,439157.25,103.0,80.8,3,198,205369.0,66.0,66.0
107831330.0,6,28,1860,14,966,8278982.846153846,123.0,69.0,14,894,8278983.846153846,123.0,63.85714285714285
90752109.0,6,19,1436,10,745,10078455.444444444,95.0,74.5,9,691,11341991.75,95.0,76.77777777777777
102447104.0,6,28,1992,14,963,7880546.461538462,123.0,68.78571428571429,14,1029,7272639.307692308,123.0,73.5
352.0,17,2,267,1,83,0.0,83.0,83.0,1,184,0.0,184.0,184.0
2588966.0,6,2,132,1,66,0.0,66.0,66.0,1,66,0.0,66.0,66.0
302809.0,6,6,412,4,272,100936.33333333331,74.0,68.0,2,140,0.0,74.0,70.0
2046.0,17,4,344,2,150,0.0,75.0,75.0,2,194,0.0,103.0,97.0
77258957.0,17,13,2419,13,2419,6438246.416666667,250.0,186.07692307692307,0,0,0.0,0.0,0.0
75146.0,6,14,4740,7,653,12246.833333333334,249.0,93.28571428571428,7,4087,12097.5,1514.0,583.8571428571429
32054.0,6,14,4740,7,653,5004.5,249.0,93.28571428571428,7,4087,4093.1666666666665,1514.0,583.8571428571429
316719.0,17,4,1400,4,1400,105573.0,350.0,350.0,0,0,0.0,0.0,0.0
146247.0,6,3,337,2,214,0.0,160.0,107.0,1,123,0.0,123.0,123.0
2313.0,17,4,344,2,150,0.0,75.0,75.0,2,194,0.0,103.0,97.0
44451.0,6,14,4740,7,653,7287.833333333333,249.0,93.28571428571428,7,4087,7093.666666666667,1514.0,583.8571428571429
40574.0,6,14,4740,7,653,6571.166666666667,249.0,93.28571428571428,7,4087,6554.0,1514.0,583.8571428571429
223736.0,17,2,359,1,75,0.0,75.0,75.0,1,284,0.0,284.0,284.0
4470.0,17,2,614,1,72,0.0,72.0,72.0,1,542,0.0,542.0,542.0
2030.0,17,4,344,2,150,0.0,75.0,75.0,2,194,0.0,103.0,97.0
90214725.0,6,19,1436,9,691,11244964.875,95.0,76.77777777777777,10,745,9999947.888888888,95.0,74.5
107628.0,17,2,286,2,286,0.0,143.0,143.0,0,0,0.0,0.0,0.0
205718.0,17,2,180,1,90,0.0,90.0,90.0,1,90,0.0,90.0,90.0
247299.0,6,3,337,2,214,0.0,160.0,107.0,1,123,0.0,123.0,123.0
198631.0,17,2,180,1,90,0.0,90.0,90.0,1,90,0.0,90.0,90.0
2494.0,17,4,344,2,150,0.0,75.0,75.0,2,194,0.0,103.0,97.0
32068.0,6,14,4740,7,653,5218.5,249.0,93.28571428571428,7,4087,5205.166666666667,1514.0,583.8571428571429
4599687.0,6,5,336,2,134,0.0,68.0,67.0,3,202,1421181.5,70.0,67.33333333333333
2294.0,17,4,344,2,150,0.0,75.0,75.0,2,194,0.0,103.0,97.0
90021613.0,17,28,13364,28,13364,3334133.814814815,501.0,477.2857142857143,0,0,0.0,0.0,0.0
16986.0,6,14,4740,7,653,2654.833333333333,249.0,93.28571428571428,7,4087,2624.333333333333,1514.0,583.8571428571429
108104440.0,17,5,955,5,955,27026110.0,191.0,191.0,0,0,0.0,0.0,0.0
28736.0,6,14,4679,7,596,4576.0,192.0,85.14285714285714,7,4083,4637.166666666667,1514.0,583.2857142857143
3340.0,17,2,363,1,79,0.0,79.0,79.0,1,284,0.0,284.0,284.0
20463.0,6,14,4740,7,653,3189.5,249.0,93.28571428571428,7,4087,2596.6666666666665,1514.0,583.8571428571429
108097774.0,17,5,1005,5,1005,27024443.5,201.0,201.0,0,0,0.0,0.0,0.0
206019.0,17,2,180,1,90,0.0,90.0,90.0,1,90,0.0,90.0,90.0
204883.0,17,2,180,1,90,0.0,90.0,90.0,1,90,0.0,90.0,90.0
120049384.0,17,28,13364,28,13364,4446273.481481481,501.0,477.2857142857143,0,0,0.0,0.0,0.0
582.0,17,2,508,2,508,0.0,257.0,254.0,0,0,0.0,0.0,0.0
2604317.0,6,19,6869,10,1501,289368.5555555556,408.0,150.1,9,5368,278442.125,1514.0,596.4444444444445
123250365.0,6,49,3234,25,1650,5135431.875,66.0,66.0,24,1584,4990758.0869565215,66.0,66.0
90026644.0,17,27,12943,27,12943,3462563.230769231,501.0,479.3703703703704,0,0,0.0,0.0,0.0
217813.0,6,3,426,2,280,0.0,214.0,140.0,1,146,0.0,146.0,146.0
5873.0,17,2,762,2,762,0.0,381.0,381.0,0,0,0.0,0.0,0.0
197417.0,17,2,180,1,90,0.0,90.0,90.0,1,90,0.0,90.0,90.0
90035361.0,17,28,13364,28,13364,3334643.0,501.0,477.2857142857143,0,0,0.0,0.0,0.0
20650.0,6,14,4740,7,653,3214.5,249.0,93.28571428571428,7,4087,3296.5,1514.0,583.8571428571429
296164.0,6,38,21506,20,1479,15587.578947368422,217.0,73.95,18,20027,16950.176470588234,1514.0,1112.611111111111
6667.0,17,2,582,1,83,0.0,83.0,83.0,1,499,0.0,499.0,499.0
157244.0,6,3,337,2,214,0.0,160.0,107.0,1,123,0.0,123.0,123.0
49717.0,6,10,2032,5,524,10580.5,252.0,104.8,5,1508,11095.5,1236.0,301.6
90056114.0,17,28,13364,28,13364,3335411.6296296297,501.0,477.2857142857143,0,0,0.0,0.0,0.0
38484.0,6,14,4740,7,653,6308.5,249.0,93.28571428571428,7,4087,6274.833333333333,1514.0,583.8571428571429
90302435.0,6,24,1870,13,1030,7520296.333333333,95.0,79.23076923076923,11,840,9002564.5,95.0,76.36363636363636
81.0,17,2,762,2,762,0.0,381.0,381.0,0,0,0.0,0.0,0.0
245891.0,6,3,373,2,238,0.0,172.0,119.0,1,135,0.0,135.0,135.0
18885.0,17,3,1143,3,1143,9442.5,381.0,381.0,0,0,0.0,0.0,0.0
2296.0,17,4,344,2,150,0.0,75.0,75.0,2,194,0.0,103.0,97.0
90256711.0,6,12,1832,8,1016,12893815.857142856,188.0,127.0,4,816,30029785.0,204.0,204.0
108106218.0,17,5,1005,5,1005,27026554.5,201.0,201.0,0,0,0.0,0.0,0.0
65291.0,6,14,4740,7,653,10774.333333333334,249.0,93.28571428571428,7,4087,10744.333333333334,1514.0,583.8571428571429
211618.0,17,2,180,1,90,0.0,90.0,90.0,1,90,0.0,90.0,90.0
23988.0,6,10,2032,5,524,4968.25,252.0,104.8,5,1508,5390.25,1236.0,301.6
5627819.0,6,5,336,2,134,0.0,68.0,67.0,3,202,1428418.5,70.0,67.33333333333333
307021.0,6,6,412,4,272,102340.33333333331,74.0,68.0,2,140,0.0,74.0,70.0
268809.0,6,10,1221,6,636,53761.8,298.0,106.0,4,585,83858.66666666667,379.0,146.25
5703.0,17,2,359,1,75,0.0,75.0,75.0,1,284,0.0,284.0,284.0
207109.0,6,3,426,2,280,0.0,214.0,140.0,1,146,0.0,146.0,146.0
2845745.0,6,3,204,1,68,0.0,68.0,68.0,2,136,0.0,70.0,68.0
0.0,17,1,90,1,90,0.0,90.0,90.0,0,0,0.0,0.0,0.0
125029571.0,6,34,2350,17,1125,7190279.625,123.0,66.17647058823529,17,1225,7190281.5,139.0,72.05882352941177
135129865.0,17,6,1206,6,1206,27025973.0,201.0,201.0,0,0,0.0,0.0,0.0
121000.0,6,3,373,2,238,0.0,172.0,119.0,1,135,0.0,135.0,135.0
90266641.0,6,13,2036,8,1016,12895234.42857143,188.0,127.0,5,1020,22526033.5,204.0,204.0
312070.0,6,3,202,2,128,0.0,74.0,64.0,1,74,0.0,74.0,74.0
135130424.0,17,6,1146,6,1146,27026084.8,191.0,191.0,0,0,0.0,0.0,0.0
193073.0,17,2,180,1,90,0.0,90.0,90.0,1,90,0.0,90.0,90.0
251952.0,6,3,337,2,214,0.0,160.0,107.0,1,123,0.0,123.0,123.0
240393.0,6,3,337,2,214,0.0,160.0,107.0,1,123,0.0,123.0,123.0
2449.0,17,4,344,2,150,0.0,75.0,75.0,2,194,0.0,103.0,97.0
1309033.0,6,4,264,2,132,0.0,66.0,66.0,2,132,0.0,66.0,66.0
3131864.0,6,3,1604,2,851,0.0,785.0,425.5,1,753,0.0,753.0,753.0
153716.0,17,2,180,1,90,0.0,90.0,90.0,1,90,0.0,90.0,90.0
1170178.0,6,13,3014,8,2386,167168.2857142857,1514.0,298.25,5,628,223623.5,331.0,125.6
504623.00000000006,6,5,336,2,134,0.0,68.0,67.0,3,202,193749.0,70.0,67.33333333333333
879547.0,6,10,1336,6,799,175909.4,461.0,133.16666666666666,4,537,201279.66666666663,331.0,134.25
322.0,17,2,174,1,79,0.0,79.0,79.0,1,95,0.0,95.0,95.0
236932.0,17,2,180,1,90,0.0,90.0,90.0,1,90,0.0,90.0,90.0
46682.0,6,14,4740,7,653,7655.166666666667,249.0,93.28571428571428,7,4087,7200.0,1514.0,583.8571428571429
146270.0,6,3,337,2,214,0.0,160.0,107.0,1,123,0.0,123.0,123.0
464.0,17,2,508,2,508,0.0,257.0,254.0,0,0,0.0,0.0,0.0
90176854.0,6,28,3051,14,1546,6920941.076923077,337.0,110.42857142857144,14,1505,6920915.307692308,426.0,107.5
103538741.0,6,44,2904,22,1452,4928234.285714285,66.0,66.0,22,1452,4924433.523809524,66.0,66.0
32217.000000000004,6,10,2032,5,524,7126.75,252.0,104.8,5,1508,7777.5,1236.0,301.6
39155.0,6,14,4740,7,653,6308.333333333333,249.0,93.28571428571428,7,4087,5903.5,1514.0,583.8571428571429
97640358.0,6,26,1746,13,906,8118695.25,123.0,69.6923076923077,13,840,8118692.0,123.0,64.61538461538461
147964.0,17,2,180,1,90,0.0,90.0,90.0,1,90,0.0,90.0,90.0
102302.0,17,2,286,2,286,0.0,143.0,143.0,0,0,0.0,0.0,0.0
23134431.0,17,3,1034,2,684,0.0,342.0,342.0,1,350,0.0,350.0,350.0
1187303.0,6,13,3010,8,2382,169614.7142857143,1514.0,297.75,5,628,228586.75,331.0,125.6
120227669.0,6,226,25406,113,7754,1069703.8392857143,140.0,68.61946902654867,113,17652,1066171.4107142857,284.0,156.21238938053096
30627.0,6,10,2032,5,524,5416.75,252.0,104.8,5,1508,7250.0,1236.0,301.6
15647.000000000002,6,14,4740,7,653,2365.333333333333,249.0,93.28571428571428,7,4087,2470.6666666666665,1514.0,583.8571428571429
2388.0,17,4,344,2,150,0.0,75.0,75.0,2,194,0.0,103.0,97.0
196960.0,17,2,180,1,90,0.0,90.0,90.0,1,90,0.0,90.0,90.0
285654.0,6,12,1373,7,714,47609.0,298.0,102.0,5,659,67240.5,379.0,131.8
90036174.0,17,28,13364,28,13364,3334673.111111111,501.0,477.2857142857143,0,0,0.0,0.0,0.0
349.0,17,2,267,1,83,0.0,83.0,83.0,1,184,0.0,184.0,184.0
0.0,17,1,350,1,350,0.0,350.0,350.0,0,0,0.0,0.0,0.0
90267786.0,6,12,1832,8,1016,12895398.0,188.0,127.0,4,816,30033837.33333333,204.0,204.0
303585.0,17,4,704,2,148,0.0,74.0,74.0,2,556,0.0,280.0,278.0
0.0,17,1,453,1,453,0.0,453.0,453.0,0,0,0.0,0.0,0.0
105442691.0,6,30,1990,15,1042,7516203.571428572,139.0,69.46666666666667,15,948,7516205.214285715,123.0,63.2
251362.0,17,4,6056,4,6056,83787.33333333333,1514.0,1514.0,0,0,0.0,0.0,0.0
90045892.0,17,28,13364,28,13364,3335033.037037037,501.0,477.2857142857143,0,0,0.0,0.0,0.0
1180744.0,6,13,3010,8,2382,168677.7142857143,1514.0,297.75,5,628,226172.75,331.0,125.6
9648.0,17,2,582,1,83,0.0,83.0,83.0,1,499,0.0,499.0,499.0
0.0,17,1,453,1,453,0.0,453.0,453.0,0,0,0.0,0.0,0.0
219306.0,6,3,426,2,280,0.0,214.0,140.0,1,146,0.0,146.0,146.0
258577.0,6,3,337,2,214,0.0,160.0,107.0,1,123,0.0,123.0,123.0
228207.0,17,2,180,1,90,0.0,90.0,90.0,1,90,0.0,90.0,90.0
307495.0,17,4,704,2,148,0.0,74.0,74.0,2,556,0.0,280.0,278.0
3745.0,17,4,344,2,150,0.0,75.0,75.0,2,194,0.0,103.0,97.0
123839745.0,6,48,3168,24,1584,5023246.652173913,66.0,66.0,24,1584,5274227.869565218,66.0,66.0
6866.0,17,2,582,1,83,0.0,83.0,83.0,1,499,0.0,499.0,499.0
103845.0,17,2,286,2,286,0.0,143.0,143.0,0,0,0.0,0.0,0.0
28232.0,6,10,2032,5,524,6818.75,252.0,104.8,5,1508,5214.5,1236.0,301.6
106290555.0,6,30,2106,15,1089,7592182.5,123.0,72.6,15,1017,7576727.785714285,123.0,67.8
108113343.0,17,5,1005,5,1005,27028335.75,201.0,201.0,0,0,0.0,0.0,0.0
485.0,17,2,508,2,508,0.0,257.0,254.0,0,0,0.0,0.0,0.0
336.0,17,2,174,1,79,0.0,79.0,79.0,1,95,0.0,95.0,95.0
309571.0,6,6,412,4,272,103190.33333333331,74.0,68.0,2,140,0.0,74.0,70.0
799.0,17,4,438,2,148,0.0,74.0,74.0,2,290,0.0,147.0,145.0
153499.0,17,2,180,1,90,0.0,90.0,90.0,1,90,0.0,90.0,90.0
305656.0,6,6,412,4,272,101885.33333333331,74.0,68.0,2,140,0.0,74.0,70.0
108103567.0,17,5,1005,5,1005,27025891.75,201.0,201.0,0,0,0.0,0.0,0.0
42010.0,6,10,2032,5,524,8470.75,252.0,104.8,5,1508,8737.75,1236.0,301.6
0.0,17,1,55,1,55,0.0,55.0,55.0,0,0,0.0,0.0,0.0
1468.0,17,2,762,2,762,0.0,381.0,381.0,0,0,0.0,0.0,0.0
135291.0,6,2,132,1,66,0.0,66.0,66.0,1,66,0.0,66.0,66.0
106028.0,17,2,700,2,700,0.0,350.0,350.0,0,0,0.0,0.0,0.0
319314.0,17,4,704,2,148,0.0,74.0,74.0,2,556,0.0,280.0,278.0
32885740.0,6,5,336,2,134,0.0,68.0,67.0,3,202,15053248.0,70.0,67.33333333333333
3109.0,17,2,180,1,90,0.0,90.0,90.0,1,90,0.0,90.0,90.0
45321.0,6,10,2032,5,524,9649.25,252.0,104.8,5,1508,10429.0,1236.0,301.6
90255143.0,6,13,2036,8,1016,12893591.857142856,188.0,127.0,5,1020,22522753.0,204.0,204.0
5631920.0,6,5,336,3,202,1527683.5,70.0,67.33333333333333,2,134,0.0,68.0,67.0
211528.0,17,2,180,1,90,0.0,90.0,90.0,1,90,0.0,90.0,90.0
2018.0,17,4,344,2,150,0.0,75.0,75.0,2,194,0.0,103.0,97.0
113479818.0,6,48,3168,24,1584,4933905.130434782,66.0,66.0,24,1584,4924507.652173913,66.0,66.0
34741.0,6,10,2032,5,524,7257.75,252.0,104.8,5,1508,8426.5,1236.0,301.6
94632355.0,6,39,2574,20,1320,4980632.0,66.0,66.0,19,1254,5143817.777777778,66.0,66.0
1310058.0,6,4,264,2,132,0.0,66.0,66.0,2,132,0.0,66.0,66.0
33747.0,6,10,2032,5,524,7573.75,252.0,104.8,5,1508,7341.25,1236.0,301.6
2795818.0,6,2,132,1,66,0.0,66.0,66.0,1,66,0.0,66.0,66.0
217851.0,6,3,426,2,280,0.0,214.0,140.0,1,146,0.0,146.0,146.0
90059017.0,17,28,13364,28,13364,3335519.1481481483,501.0,477.2857142857143,0,0,0.0,0.0,0.0
59942.0,6,14,4740,7,653,9790.833333333334,249.0,93.28571428571428,7,4087,9182.0,1514.0,583.8571428571429
423.0,17,2,166,1,75,0.0,75.0,75.0,1,91,0.0,91.0,91.0
120115320.0,6,226,25534,113,7754,1065117.5357142857,140.0,68.61946902654867,113,17780,1065195.9375,284.0,157.34513274336285
113618093.0,6,46,3036,23,1518,5150439.045454546,66.0,66.0,23,1518,5150443.136363637,66.0,66.0
34052.0,6,14,4740,7,653,4986.833333333333,249.0,93.28571428571428,7,4087,5536.5,1514.0,583.8571428571429
61673.0,6,14,4740,7,653,9672.166666666666,249.0,93.28571428571428,7,4087,9436.833333333334,1514.0,583.8571428571429
15045067.0,17,6,2718,6,2718,3009013.4,453.0,453.0,0,0,0.0,0.0,0.0
2805914.0,6,2,132,1,66,0.0,66.0,66.0,1,66,0.0,66.0,66.0
47816886.0,6,8,2113,3,960,22839847.5,826.0,320.0,5,1153,11259386.5,885.0,230.6
104543.0,17,2,286,2,286,0.0,143.0,143.0,0,0,0.0,0.0,0.0
135132404.0,17,6,1146,6,1146,27026480.8,191.0,191.0,0,0,0.0,0.0,0.0
153562.0,17,2,180,1,90,0.0,90.0,90.0,1,90,0.0,90.0,90.0
114330896.0,6,48,3168,24,1584,4970908.521739131,66.0,66.0,24,1584,4961508.565217392,66.0,66.0
43894.0,6,14,4740,7,653,7083.333333333333,249.0,93.28571428571428,7,4087,5814.166666666667,1514.0,583.8571428571429
295899.0,17,2,180,1,90,0.0,90.0,90.0,1,90,0.0,90.0,90.0
237463.0,6,3,373,2,238,0.0,172.0,119.0,1,135,0.0,135.0,135.0
5780.0,17,2,180,1,90,0.0,90.0,90.0,1,90,0.0,90.0,90.0
13921404.0,6,20,1607,10,975,1512997.5555555555,315.0,97.5,10,632,1512969.5555555555,78.0,63.2
299496.0,6,6,412,4,272,99832.0,74.0,68.0,2,140,0.0,74.0,70.0
107874.0,17,2,286,2,286,0.0,143.0,143.0,0,0,0.0,0.0,0.0
1526.0,17,5,550,5,550,381.5,110.0,110.0,0,0,0.0,0.0,0.0
205655.0,17,2,180,1,90,0.0,90.0,90.0,1,90,0.0,90.0,90.0
108110096.0,17,5,1005,5,1005,27027524.0,201.0,201.0,0,0,0.0,0.0,0.0
108107102.0,17,5,955,5,955,27026775.5,191.0,191.0,0,0,0.0,0.0,0.0
114723328.0,6,48,3168,24,1584,4987970.782608695,66.0,66.0,24,1584,4975998.695652174,66.0,66.0
90044722.0,17,28,13364,28,13364,3334989.703703704,501.0,477.2857142857143,0,0,0.0,0.0,0.0
912557.0,6,10,1334,6,797,182511.4,459.0,132.83333333333334,4,537,213379.0,331.0,134.25
287814.0,17,2,363,1,79,0.0,79.0,79.0,1,284,0.0,284.0,284.0
0.0,17,1,72,1,72,0.0,72.0,72.0,0,0,0.0,0.0,0.0
18377.0,6,14,4740,7,653,2507.1666666666665,249.0,93.28571428571428,7,4087,2921.833333333333,1514.0,583.8571428571429
107632.0,17,2,286,2,286,0.0,143.0,143.0,0,0,0.0,0.0,0.0
205840.0,17,2,180,1,90,0.0,90.0,90.0,1,90,0.0,90.0,90.0
184851.0,6,3,337,2,214,0.0,160.0,107.0,1,123,0.0,123.0,123.0
297.0,17,2,168,1,76,0.0,76.0,76.0,1,92,0.0,92.0,92.0
252526.0,17,4,6056,4,6056,84175.33333333333,1514.0,1514.0,0,0,0.0,0.0,0.0
198719.0,17,2,180,1,90,0.0,90.0,90.0,1,90,0.0,90.0,90.0
118818153.0,6,34,2334,17,1209,7426134.5625,123.0,71.11764705882354,17,1125,7412600.625,123.0,66.17647058823529
19099.0,6,10,2032,5,524,4533.0,252.0,104.8,5,1508,4458.75,1236.0,301.6
120174739.0,6,342,39072,171,11508,702128.5470588235,140.0,67.29824561403508,171,27564,702145.9,284.0,161.19298245614036
119215.0,17,4,1400,4,1400,39738.333333333336,350.0,350.0,0,0,0.0,0.0,0.0
99135.0,17,2,762,2,762,0.0,381.0,381.0,0,0,0.0,0.0,0.0
232822.0,6,3,337,2,214,0.0,160.0,107.0,1,123,0.0,123.0,123.0
33149.0,6,11,2098,6,590,6337.4,252.0,98.33333333333331,5,1508,7168.5,1236.0,301.6
90029138.0,17,28,13364,28,13364,3334412.5185185187,501.0,477.2857142857143,0,0,0.0,0.0,0.0
90023923.0,6,20,1490,11,840,9002392.3,95.0,76.36363636363636,9,650,11217801.125,95.0,72.22222222222223
146227.0,6,3,337,2,214,0.0,160.0,107.0,1,123,0.0,123.0,123.0
238410.0,6,3,337,2,214,0.0,160.0,107.0,1,123,0.0,123.0,123.0
90051586.0,17,27,12943,27,12943,3463522.5384615385,501.0,479.3703703703704,0,0,0.0,0.0,0.0
29307713.0,6,29,9249,16,3843,177453.66666666666,1514.0,240.1875,13,5406,2424352.75,1514.0,415.84615384615387
303640.0,6,2,132,1,66,0.0,66.0,66.0,1,66,0.0,66.0,66.0
119991.0,17,2,180,1,70,0.0,70.0,70.0,1,110,0.0,110.0,110.0
719.0,17,4,438,2,148,0.0,74.0,74.0,2,290,0.0,147.0,145.0
206057.0,6,3,426,2,280,0.0,214.0,140.0,1,146,0.0,146.0,146.0
611960.0,17,2,876,2,876,0.0,438.0,438.0,0,0,0.0,0.0,0.0
106081.0,17,2,700,2,700,0.0,350.0,350.0,0,0,0.0,0.0,0.0
6719.0,17,4,823,2,163,0.0,89.0,81.5,2,660,0.0,443.0,330.0
1162201.0,6,13,3011,8,2383,166028.7142857143,1514.0,297.875,5,628,221631.0,331.0,125.6
5009997.0,17,4,1164,2,166,0.0,83.0,83.0,2,998,0.0,499.0,499.0
207038.0,6,3,426,2,280,0.0,214.0,140.0,1,146,0.0,146.0,146.0
303086.0,6,3,202,2,128,0.0,74.0,64.0,1,74,0.0,74.0,74.0
33834.0,6,14,4740,7,653,4807.5,249.0,93.28571428571428,7,4087,5315.166666666667,1514.0,583.8571428571429
135849.0,6,2,132,1,66,0.0,66.0,66.0,1,66,0.0,66.0,66.0
2796619.0,6,2,132,1,66,0.0,66.0,66.0,1,66,0.0,66.0,66.0
220717.0,6,3,426,2,280,0.0,214.0,140.0,1,146,0.0,146.0,146.0
24127046.0,17,5,1718,4,1368,797456.0,342.0,342.0,1,350,0.0,350.0,350.0
111756242.0,6,31,2160,16,1071,7450416.133333334,123.0,66.9375,15,1089,7253922.071428572,123.0,72.6
118747.0,6,14,4740,7,653,19671.0,249.0,93.28571428571428,7,4087,17947.166666666668,1514.0,583.8571428571429
120372454.0,6,481,71044,240,16210,501667.4016736402,214.0,67.54166666666667,241,54834,501469.4791666667,1514.0,227.52697095435684
4488.0,17,2,614,1,72,0.0,72.0,72.0,1,542,0.0,542.0,542.0
209266.0,17,2,359,1,75,0.0,75.0,75.0,1,284,0.0,284.0,284.0
44443.0,6,12,1320,7,789,7407.166666666667,253.0,112.71428571428572,5,531,9249.0,259.0,106.2
97958887.0,6,189,21360,95,14934,1042115.8191489362,284.0,157.2,94,6426,1042197.4731182796,140.0,68.36170212765957
219555.0,6,3,426,2,280,0.0,214.0,140.0,1,146,0.0,146.0,146.0
120128713.0,6,13,2020,9,1204,15016089.125,188.0,133.77777777777777,4,816,30031395.33333333,204.0,204.0
51167.0,6,14,4740,7,653,8415.333333333334,249.0,93.28571428571428,7,4087,8022.5,1514.0,583.8571428571429
250757.0,6,12,1373,7,714,41792.833333333336,298.0,102.0,5,659,58549.0,379.0,131.8
197321.0,17,2,180,1,90,0.0,90.0,90.0,1,90,0.0,90.0,90.0
1040176.0,6,11,1134,6,558,208035.2,220.0,93.0,5,576,259085.25,304.0,115.2
108711902.0,6,35,2542,18,1348,6394817.764705882,139.0,74.88888888888889,17,1194,6780965.3125,123.0,70.23529411764706
135136019.0,17,6,1146,6,1146,27027203.8,191.0,191.0,0,0,0.0,0.0,0.0
21058.0,6,14,4740,7,653,3288.333333333333,249.0,93.28571428571428,7,4087,3307.0,1514.0,583.8571428571429
301718.0,6,12,1373,7,714,50286.333333333336,298.0,102.0,5,659,70928.0,379.0,131.8
90255870.0,6,12,1832,8,1016,12893695.714285716,188.0,127.0,4,816,30030477.33333333,204.0,204.0
115028405.0,6,216,24424,108,7424,1073802.61682243,140.0,68.74074074074075,108,17000,1067181.6074766356,284.0,157.40740740740742
23202.0,6,14,4740,7,653,3455.833333333333,249.0,93.28571428571428,7,4087,3708.1666666666665,1514.0,583.8571428571429
30921.0,6,10,2032,5,524,6701.75,252.0,104.8,5,1508,7421.0,1236.0,301.6
106741.0,17,2,286,2,286,0.0,143.0,143.0,0,0,0.0,0.0,0.0
70714.0,17,2,620,1,75,0.0,75.0,75.0,1,545,0.0,545.0,545.0
44713.0,6,14,4740,7,653,6160.166666666667,249.0,93.28571428571428,7,4087,7315.0,1514.0,583.8571428571429
215586.0,17,4,1400,4,1400,71862.0,350.0,350.0,0,0,0.0,0.0,0.0
160218.0,17,2,180,1,90,0.0,90.0,90.0,1,90,0.0,90.0,90.0
20591.0,17,2,582,1,83,0.0,83.0,83.0,1,499,0.0,499.0,499.0
104604295.0,6,44,2904,22,1452,4981156.904761905,66.0,66.0,22,1452,4966183.238095238,66.0,66.0
2195815.0,6,25,7610,13,2516,182984.5833333333,1034.0,193.53846153846155,12,5094,170453.72727272726,1510.0,424.5
108116101.0,17,5,1005,5,1005,27029025.25,201.0,201.0,0,0,0.0,0.0,0.0
798.0,17,4,438,2,148,0.0,74.0,74.0,2,290,0.0,147.0,145.0
3015932.0,6,12,2172,7,664,502551.5,252.0,94.85714285714286,5,1508,4287.5,1236.0,301.6
0.0,17,1,80,1,80,0.0,80.0,80.0,0,0,0.0,0.0,0.0
329.0,17,2,160,1,80,0.0,80.0,80.0,1,80,0.0,80.0,80.0
90282415.0,6,12,1832,8,1016,12897487.857142856,188.0,127.0,4,816,30039885.0,204.0,204.0
103579.0,17,2,286,2,286,0.0,143.0,143.0,0,0,0.0,0.0,0.0
1131854.0,6,20,6434,12,1921,102895.81818181818,620.0,160.08333333333334,8,4513,133164.0,1514.0,564.125
206998.0,6,3,426,2,280,0.0,214.0,140.0,1,146,0.0,146.0,146.0
117978463.0,17,15,1169,8,606,16854066.14285714,174.0,75.75,7,563,16333473.833333334,174.0,80.42857142857143
90314914.0,6,16,1192,8,596,12896299.57142857,95.0,74.5,8,596,12901067.142857144,95.0,74.5
46636.0,6,10,2032,5,524,11422.25,252.0,104.8,5,1508,9902.5,1236.0,301.6
1307666.0,6,4,264,2,132,0.0,66.0,66.0,2,132,0.0,66.0,66.0
538167.0,17,6,2100,6,2100,107633.4,350.0,350.0,0,0,0.0,0.0,0.0
121265226.0,6,34,2472,18,1332,7133248.588235294,123.0,74.0,16,1140,7404265.533333333,123.0,71.25
799.0,17,4,438,2,148,0.0,74.0,74.0,2,290,0.0,147.0,145.0
0.0,17,1,179,1,179,0.0,179.0,179.0,0,0,0.0,0.0,0.0
120329985.0,6,257,29052,129,20382,940078.0078125,284.0,158.0,128,8670,931224.6299212598,140.0,67.734375
2313.0,17,4,344,2,150,0.0,75.0,75.0,2,194,0.0,103.0,97.0
205711.0,17,2,180,1,90,0.0,90.0,90.0,1,90,0.0,90.0,90.0
309331.0,6,6,412,4,272,103110.33333333331,74.0,68.0,2,140,0.0,74.0,70.0
2297.0,17,4,344,2,150,0.0,75.0,75.0,2,194,0.0,103.0,97.0
105925724.0,6,44,2904,22,1452,5044082.095238095,66.0,66.0,22,1452,5029338.476190476,66.0,66.0
2331.0,17,6,1230,3,234,774.0,78.0,78.0,3,996,958.5,332.0,332.0
311002.0,17,4,1400,4,1400,103667.33333333331,350.0,350.0,0,0,0.0,0.0,0.0
307233.0,6,6,412,4,272,102411.0,74.0,68.0,2,140,0.0,74.0,70.0
3414.0,17,4,344,2,150,0.0,75.0,75.0,2,194,0.0,103.0,97.0
312213.0,17,4,1400,4,1400,104071.0,350.0,350.0,0,0,0.0,0.0,0.0
858487.0,6,9,1196,6,725,171697.4,387.0,120.83333333333331,3,471,292968.0,331.0,157.0
115416577.0,6,32,2236,16,1165,7680048.066666666,139.0,72.8125,16,1071,7680047.933333334,123.0,66.9375
92952363.0,6,206,24154,103,17134,909189.2156862743,284.0,166.3495145631068,103,7020,909189.0490196078,140.0,68.15533980582525
223288.0,6,3,426,2,280,0.0,214.0,140.0,1,146,0.0,146.0,146.0
2430.0,17,4,344,2,150,0.0,75.0,75.0,2,194,0.0,103.0,97.0
45171.0,6,10,2032,5,524,10346.25,252.0,104.8,5,1508,10936.5,1236.0,301.6
997014.0,6,12,1362,6,731,198001.8,253.0,121.83333333333331,6,631,198886.6,293.0,105.16666666666669
237706.0,17,2,180,1,90,0.0,90.0,90.0,1,90,0.0,90.0,90.0
1031235.0,6,11,1134,6,558,206247.0,220.0,93.0,5,576,256119.5,304.0,115.2
305878.0,6,6,412,4,272,101959.33333333331,74.0,68.0,2,140,0.0,74.0,70.0
7526613.0,6,36,9676,19,5646,418145.1666666667,1514.0,297.1578947368421,17,4030,404554.6875,1514.0,237.05882352941177
4411.0,17,2,626,1,72,0.0,72.0,72.0,1,554,0.0,554.0,554.0
316586.0,17,4,1400,4,1400,105528.66666666669,350.0,350.0,0,0,0.0,0.0,0.0
350.0,17,2,267,1,83,0.0,83.0,83.0,1,184,0.0,184.0,184.0
284292.0,17,2,363,1,79,0.0,79.0,79.0,1,284,0.0,284.0,284.0
121351.0,6,3,337,2,214,0.0,160.0,107.0,1,123,0.0,123.0,123.0
2595946.0,6,2,132,1,66,0.0,66.0,66.0,1,66,0.0,66.0,66.0
15744.000000000002,6,14,4740,7,653,2475.333333333333,249.0,93.28571428571428,7,4087,2284.1666666666665,1514.0,583.8571428571429
768.0,17,4,438,2,148,0.0,74.0,74.0,2,290,0.0,147.0,145.0
113270878.0,6,225,25266,113,7680,1011347.125,140.0,67.96460176991151,112,17586,1011179.4144144144,284.0,157.01785714285714
260451.0,6,10,1221,6,636,52090.2,298.0,106.0,4,585,81469.66666666667,379.0,146.25
153432.0,17,2,180,1,90,0.0,90.0,90.0,1,90,0.0,90.0,90.0
235462.0,6,3,337,2,214,0.0,160.0,107.0,1,123,0.0,123.0,123.0
248345.0,17,4,6056,4,6056,82781.66666666667,1514.0,1514.0,0,0,0.0,0.0,0.0
113421514.0,6,32,2236,16,1165,7547033.533333333,139.0,72.8125,16,1071,7547034.333333333,123.0,66.9375
90093711.0,6,15,2180,7,1164,15015443.0,204.0,166.28571428571428,8,1016,12870211.857142856,188.0,127.0
146187.0,6,3,337,2,214,0.0,160.0,107.0,1,123,0.0,123.0,123.0
118478998.0,6,32,2236,16,1071,7232895.866666666,123.0,66.9375,16,1165,7385973.533333333,139.0,72.8125
216349.0,17,2,180,1,90,0.0,90.0,90.0,1,90,0.0,90.0,90.0
1306956.0,6,4,264,2,132,0.0,66.0,66.0,2,132,0.0,66.0,66.0
114509700.0,6,216,24312,108,16888,1067839.9719626168,284.0,156.37037037037038,108,7424,1067449.8785046728,140.0,68.74074074074075
146850.0,6,3,373,2,238,0.0,172.0,119.0,1,135,0.0,135.0,135.0
90248280.0,6,15,2444,8,1016,12892611.42857143,188.0,127.0,7,1428,15014074.0,204.0,204.0
2059.0,17,4,344,2,150,0.0,75.0,75.0,2,194,0.0,103.0,97.0
218076.0,17,2,180,1,90,0.0,90.0,90.0,1,90,0.0,90.0,90.0
18052.0,6,14,4740,7,653,2667.833333333333,249.0,93.28571428571428,7,4087,2471.0,1514.0,583.8571428571429
2354.0,17,4,344,2,150,0.0,75.0,75.0,2,194,0.0,103.0,97.0
387197.0,6,3,1777,1,826,0.0,826.0,826.0,2,951,0.0,885.0,475.5
51575.0,17,2,180,1,90,0.0,90.0,90.0,1,90,0.0,90.0,90.0
1306968.0,6,4,264,2,132,0.0,66.0,66.0,2,132,0.0,66.0,66.0
90011186.0,17,28,13364,28,13364,3333747.6296296297,501.0,477.2857142857143,0,0,0.0,0.0,0.0
108105221.0,17,5,955,5,955,27026305.25,191.0,191.0,0,0,0.0,0.0,0.0
143854.0,17,2,180,1,90,0.0,90.0,90.0,1,90,0.0,90.0,90.0
2702624.0,6,25,7573,14,3735,207894.15384615384,1514.0,266.7857142857143,11,3838,244873.3,1514.0,348.90909090909093
108501259.0,6,28,1860,14,966,8329636.230769231,123.0,69.0,14,894,8329635.461538462,123.0,63.85714285714285
233192.0,6,10,1221,6,636,46638.4,298.0,106.0,4,585,76112.33333333333,379.0,146.25
120026.0,17,2,180,1,70,0.0,70.0,70.0,1,110,0.0,110.0,110.0
2229513.0,6,26,7676,14,2582,171501.0,1034.0,184.42857142857144,12,5094,174071.54545454544,1510.0,424.5
316122.0,6,3,202,2,128,0.0,74.0,64.0,1,74,0.0,74.0,74.0
108110649.0,17,5,1005,5,1005,27027662.25,201.0,201.0,0,0,0.0,0.0,0.0
3208108.0,6,15,2266,8,1147,458301.1428571429,581.0,143.375,7,1119,498235.1666666667,731.0,159.85714285714286
280323.0,17,2,363,1,79,0.0,79.0,79.0,1,284,0.0,284.0,284.0
2335.0,17,4,344,2,150,0.0,75.0,75.0,2,194,0.0,103.0,97.0
113876517.0,6,49,4404,29,2496,4067018.464285714,123.0,86.06896551724138,20,1908,5982650.105263158,123.0,95.4
4798223.0,6,5,336,2,134,0.0,68.0,67.0,3,202,1514048.5,70.0,67.33333333333333
44799.0,6,14,4740,7,653,7024.0,249.0,93.28571428571428,7,4087,5061.833333333333,1514.0,583.8571428571429
0.0,17,1,55,1,55,0.0,55.0,55.0,0,0,0.0,0.0,0.0
1774904.0,6,2,132,1,66,0.0,66.0,66.0,1,66,0.0,66.0,66.0
14380915.0,6,31,9412,17,3897,153016.875,1514.0,229.23529411764707,14,5515,1090382.4615384615,1514.0,393.9285714285714
49487.0,6,10,2032,5,524,12157.5,252.0,104.8,5,1508,10356.0,1236.0,301.6
206780.0,17,2,762,2,762,0.0,381.0,381.0,0,0,0.0,0.0,0.0
108106928.0,17,5,1005,5,1005,27026732.0,201.0,201.0,0,0,0.0,0.0,0.0
53199.0,6,14,4740,7,653,7957.166666666667,249.0,93.28571428571428,7,4087,8722.666666666666,1514.0,583.8571428571429
205887.0,17,2,180,1,90,0.0,90.0,90.0,1,90,0.0,90.0,90.0
205575.0,17,2,180,1,90,0.0,90.0,90.0,1,90,0.0,90.0,90.0
232637.0,6,3,337,2,214,0.0,160.0,107.0,1,123,0.0,123.0,123.0
6893.0,17,2,582,1,83,0.0,83.0,83.0,1,499,0.0,499.0,499.0
47254.0,6,14,4740,7,653,7106.833333333333,249.0,93.28571428571428,7,4087,7725.666666666667,1514.0,583.8571428571429
505801.0,6,5,336,2,134,0.0,68.0,67.0,3,202,192687.0,70.0,67.33333333333333
24629.0,6,14,4740,7,653,3584.5,249.0,93.28571428571428,7,4087,3925.0,1514.0,583.8571428571429
108107213.0,17,5,1005,5,1005,27026803.25,201.0,201.0,0,0,0.0,0.0,0.0
18521.0,6,2,145,2,145,0.0,91.0,72.5,0,0,0.0,0.0,0.0
206465.0,6,3,426,2,280,0.0,214.0,140.0,1,146,0.0,146.0,146.0
27394.0,6,10,2032,5,524,4731.0,252.0,104.8,5,1508,6380.5,1236.0,301.6
253249.0,6,12,1373,7,714,42208.16666666666,298.0,102.0,5,659,58965.25,379.0,131.8
31661.0,6,10,2032,5,524,7585.5,252.0,104.8,5,1508,7665.5,1236.0,301.6
308866.0,6,6,412,4,272,102955.33333333331,74.0,68.0,2,140,0.0,74.0,70.0
209723.0,17,2,180,1,90,0.0,90.0,90.0,1,90,0.0,90.0,90.0
35648.0,6,12,1320,6,723,6681.8,253.0,120.5,6,597,4817.2,259.0,99.5
22609.0,6,10,2032,5,524,5399.75,252.0,104.8,5,1508,5008.25,1236.0,301.6
108104108.0,17,5,1005,5,1005,27026027.0,201.0,201.0,0,0,0.0,0.0,0.0
108103615.0,17,5,1005,5,1005,27025903.75,201.0,201.0,0,0,0.0,0.0,0.0
250290.0,6,3,337,2,214,0.0,160.0,107.0,1,123,0.0,123.0,123.0
208540.0,6,3,426,2,280,0.0,214.0,140.0,1,146,0.0,146.0,146.0
145169.0,6,11,1132,6,556,29033.8,218.0,92.66666666666669,5,576,35443.25,304.0,115.2
39275.0,6,14,4740,7,653,5355.833333333333,249.0,93.28571428571428,7,4087,6073.5,1514.0,583.8571428571429
2077.0,17,4,344,2,150,0.0,75.0,75.0,2,194,0.0,103.0,97.0
90260097.0,6,12,1832,8,1016,12894299.57142857,188.0,127.0,4,816,30029052.0,204.0,204.0
118538636.0,6,211,23712,106,7292,1128939.3904761905,140.0,68.79245283018868,105,16420,1129801.4038461538,284.0,156.38095238095238
200982.0,17,4,6056,4,6056,66994.0,1514.0,1514.0,0,0,0.0,0.0,0.0
146782.0,6,3,373,2,238,0.0,172.0,119.0,1,135,0.0,135.0,135.0
83986.0,6,14,4740,7,653,13050.833333333334,249.0,93.28571428571428,7,4087,13826.666666666666,1514.0,583.8571428571429
153436.0,17,2,180,1,90,0.0,90.0,90.0,1,90,0.0,90.0,90.0
249262.0,6,3,337,2,214,0.0,160.0,107.0,1,123,0.0,123.0,123.0
5629350.0,6,4,270,2,134,0.0,68.0,67.0,2,136,0.0,70.0,68.0
7690.0,17,2,415,1,84,0.0,84.0,84.0,1,331,0.0,331.0,331.0
307251.0,6,6,412,4,272,102417.0,74.0,68.0,2,140,0.0,74.0,70.0
72079.0,6,13,1479,7,882,11670.166666666666,291.0,126.0,6,597,11075.6,259.0,99.5
90046374.0,17,27,12943,27,12943,3463322.076923077,501.0,479.3703703703704,0,0,0.0,0.0,0.0
47414.0,6,2,132,1,66,0.0,66.0,66.0,1,66,0.0,66.0,66.0
19742.0,6,10,2032,5,524,4570.5,252.0,104.8,5,1508,4630.25,1236.0,301.6
37691.0,6,10,2032,5,524,8688.0,252.0,104.8,5,1508,9094.25,1236.0,301.6
5010672.0,17,4,1164,2,166,0.0,83.0,83.0,2,998,0.0,499.0,499.0
146275.0,6,3,337,2,214,0.0,160.0,107.0,1,123,0.0,123.0,123.0
108113490.0,17,5,1005,5,1005,27028372.5,201.0,201.0,0,0,0.0,0.0,0.0
3170898.0,6,18,1536,9,962,358395.75,315.0,106.88888888888889,9,574,358411.25,78.0,63.77777777777778
53386417.0,17,4,360,2,180,0.0,90.0,90.0,2,180,0.0,90.0,90.0
228428.0,17,2,180,1,90,0.0,90.0,90.0,1,90,0.0,90.0,90.0
2380.0,17,4,344,2,150,0.0,75.0,75.0,2,194,0.0,103.0,97.0
27582.0,6,14,4740,7,653,4456.333333333333,249.0,93.28571428571428,7,4087,4048.3333333333335,1514.0,583.8571428571429
123250476.0,6,49,3234,25,1650,5135436.5,66.0,66.0,24,1584,4937672.478260869,66.0,66.0
226452.0,6,13,1394,7,797,37742.0,253.0,113.85714285714286,6,597,43945.4,259.0,99.5
24706.0,6,14,4740,7,653,3969.3333333333335,249.0,93.28571428571428,7,4087,3497.6666666666665,1514.0,583.8571428571429
18358.0,6,14,4740,7,653,2897.1666666666665,249.0,93.28571428571428,7,4087,2844.1666666666665,1514.0,583.8571428571429
216326.0,17,2,180,1,90,0.0,90.0,90.0,1,90,0.0,90.0,90.0
33653.0,6,14,4740,7,653,5483.333333333333,249.0,93.28571428571428,7,4087,4574.0,1514.0,583.8571428571429
108276.0,17,2,286,2,286,0.0,143.0,143.0,0,0,0.0,0.0,0.0
312627.0,17,4,1400,4,1400,104209.0,350.0,350.0,0,0,0.0,0.0,0.0
19723.0,6,14,4740,7,653,2858.0,249.0,93.28571428571428,7,4087,2843.833333333333,1514.0,583.8571428571429
112564797.0,6,218,24646,109,17156,1040274.4629629628,284.0,157.39449541284404,109,7490,1040274.2129629628,140.0,68.71559633027523
147069.0,6,3,373,2,238,0.0,172.0,119.0,1,135,0.0,135.0,135.0
120059045.0,17,29,13785,29,13785,4287823.035714285,501.0,475.3448275862069,0,0,0.0,0.0,0.0
250370.0,6,3,337,2,214,0.0,160.0,107.0,1,123,0.0,123.0,123.0
11791823.0,6,5,1736,2,819,0.0,753.0,409.5,3,917,5828570.5,785.0,305.6666666666667
240362.0,6,3,337,2,214,0.0,160.0,107.0,1,123,0.0,123.0,123.0
2517343.0,17,2,876,2,876,0.0,438.0,438.0,0,0,0.0,0.0,0.0
108113235.0,17,5,955,5,955,27028308.75,191.0,191.0,0,0,0.0,0.0,0.0
110917542.0,6,30,1974,15,1026,7907254.5,123.0,68.4,15,948,7907265.357142857,123.0,63.2
297.0,17,2,156,1,78,0.0,78.0,78.0,1,78,0.0,78.0,78.0
4265.0,17,2,602,1,72,0.0,72.0,72.0,1,530,0.0,530.0,530.0
34745.0,6,14,4740,7,653,5623.5,249.0,93.28571428571428,7,4087,4888.0,1514.0,583.8571428571429
108110736.0,17,5,1005,5,1005,27027684.0,201.0,201.0,0,0,0.0,0.0,0.0
9920.0,17,2,582,1,83,0.0,83.0,83.0,1,499,0.0,499.0,499.0
2179.0,17,2,180,1,90,0.0,90.0,90.0,1,90,0.0,90.0,90.0
2799990.0,6,2,132,1,66,0.0,66.0,66.0,1,66,0.0,66.0,66.0
103790.0,17,2,286,2,286,0.0,143.0,143.0,0,0,0.0,0.0,0.0
218486.0,17,2,180,1,90,0.0,90.0,90.0,1,90,0.0,90.0,90.0
234185.0,6,3,373,2,238,0.0,172.0,119.0,1,135,0.0,135.0,135.0
216441.0,17,2,180,1,90,0.0,90.0,90.0,1,90,0.0,90.0,90.0
90032011.0,17,27,12943,27,12943,3462769.653846154,501.0,479.3703703703704,0,0,0.0,0.0,0.0
232083.0,6,3,337,2,214,0.0,160.0,107.0,1,123,0.0,123.0,123.0
106151953.0,17,14,864,7,432,17667706.666666668,174.0,61.71428571428572,7,432,17666829.666666668,174.0,61.71428571428572
24607.0,6,10,2032,5,524,5102.5,252.0,104.8,5,1508,5584.25,1236.0,301.6
153424.0,17,2,180,1,90,0.0,90.0,90.0,1,90,0.0,90.0,90.0
2318.0,17,4,344,2,150,0.0,75.0,75.0,2,194,0.0,103.0,97.0
143908.0,17,2,180,1,90,0.0,90.0,90.0,1,90,0.0,90.0,90.0
120116817.0,6,274,31020,137,9338,877192.0147058824,140.0,68.16058394160584,137,21682,882785.0735294118,284.0,158.26277372262774
107036429.0,6,43,2838,22,1452,5082008.80952381,66.0,66.0,21,1386,5155450.5,66.0,66.0
113751289.0,6,36,2596,18,1348,6678545.470588235,139.0,74.88888888888889,18,1248,6678543.470588235,123.0,69.33333333333333
216680.0,6,3,426,2,280,0.0,214.0,140.0,1,146,0.0,146.0,146.0
41345.0,6,14,4740,7,653,6640.5,249.0,93.28571428571428,7,4087,6708.5,1514.0,583.8571428571429
81084031.0,17,4,804,4,804,27028010.33333333,201.0,201.0,0,0,0.0,0.0,0.0
437.0,17,2,267,1,83,0.0,83.0,83.0,1,184,0.0,184.0,184.0
47395.0,6,14,4740,7,653,7001.833333333333,249.0,93.28571428571428,7,4087,7730.333333333333,1514.0,583.8571428571429
718.0,17,4,438,2,148,0.0,74.0,74.0,2,290,0.0,147.0,145.0
16724.0,6,14,4740,7,653,2630.6666666666665,249.0,93.28571428571428,7,4087,2650.5,1514.0,583.8571428571429
124001117.0,17,15,907,8,475,17714445.285714287,174.0,59.375,7,432,17334569.166666668,174.0,61.71428571428572
232989.0,6,3,337,2,214,0.0,160.0,107.0,1,123,0.0,123.0,123.0
48333.0,6,14,4740,7,653,7930.0,249.0,93.28571428571428,7,4087,7212.166666666667,1514.0,583.8571428571429
0.0,17,1,72,1,72,0.0,72.0,72.0,0,0,0.0,0.0,0.0
138408.0,17,4,344,2,150,0.0,75.0,75.0,2,194,0.0,103.0,97.0
135135369.0,17,6,1146,6,1146,27027073.8,191.0,191.0,0,0,0.0,0.0,0.0
10566.0,6,10,2032,5,524,2417.25,252.0,104.8,5,1508,2289.75,1236.0,301.6
2371.0,17,4,344,2,150,0.0,75.0,75.0,2,194,0.0,103.0,97.0
2794611.0,6,2,132,1,66,0.0,66.0,66.0,1,66,0.0,66.0,66.0
722.0,17,4,438,2,148,0.0,74.0,74.0,2,290,0.0,147.0,145.0
2057144.0,6,23,7478,12,2450,187013.0909090909,1034.0,204.16666666666663,11,5028,175081.0,1510.0,457.09090909090907
50281.0,6,14,4740,7,653,8259.0,249.0,93.28571428571428,7,4087,6857.0,1514.0,583.8571428571429
122477.0,6,3,373,2,238,0.0,172.0,119.0,1,135,0.0,135.0,135.0
108107810.0,17,5,1005,5,1005,27026952.5,201.0,201.0,0,0,0.0,0.0,0.0
299199.0,6,6,412,4,272,99733.0,74.0,68.0,2,140,0.0,74.0,70.0
21088.0,6,14,4740,7,653,3406.0,249.0,93.28571428571428,7,4087,3374.6666666666665,1514.0,583.8571428571429
313318.0,17,2,346,1,78,0.0,78.0,78.0,1,268,0.0,268.0,268.0
216541.0,17,2,180,1,90,0.0,90.0,90.0,1,90,0.0,90.0,90.0
217706.0,6,3,426,2,280,0.0,214.0,140.0,1,146,0.0,146.0,146.0
119888691.0,6,18,2776,9,1204,14965752.0,188.0,133.77777777777777,9,1572,14980859.375,204.0,174.66666666666666
103866.0,17,2,700,2,700,0.0,350.0,350.0,0,0,0.0,0.0,0.0
252079.0,17,4,1524,4,1524,84026.33333333333,381.0,381.0,0,0,0.0,0.0,0.0
135131712.0,17,6,1206,6,1206,27026342.4,201.0,201.0,0,0,0.0,0.0,0.0
508.0,17,2,410,1,78,0.0,78.0,78.0,1,332,0.0,332.0,332.0
146135.0,6,3,337,2,214,0.0,160.0,107.0,1,123,0.0,123.0,123.0
300.0,17,2,168,1,76,0.0,76.0,76.0,1,92,0.0,92.0,92.0
30645.0,6,14,4740,7,653,4947.666666666667,249.0,93.28571428571428,7,4087,3594.0,1514.0,583.8571428571429
120002848.0,6,26,1978,14,1084,9230763.76923077,95.0,77.42857142857143,12,894,10908675.0,95.0,74.5
2125982.0,6,25,7611,13,2516,177165.16666666666,1034.0,193.53846153846155,12,5095,165791.0909090909,1510.0,424.5833333333333
210436.0,6,3,426,2,280,0.0,214.0,140.0,1,146,0.0,146.0,146.0
120002776.0,6,17,1287,8,596,17143253.714285713,95.0,74.5,9,691,14967656.75,95.0,76.77777777777777
1484.0,17,2,762,2,762,0.0,381.0,381.0,0,0,0.0,0.0,0.0
108102899.0,17,5,955,5,955,27025724.75,191.0,191.0,0,0,0.0,0.0,0.0
143912.0,17,2,180,1,90,0.0,90.0,90.0,1,90,0.0,90.0,90.0
123714571.0,6,35,2394,18,1269,7277327.705882353,123.0,70.5,17,1125,7094547.125,123.0,66.17647058823529
121001104.0,17,15,907,8,475,17285872.0,174.0,59.375,7,432,16845167.166666668,174.0,61.71428571428572
49380.0,6,14,4740,7,653,8072.666666666667,249.0,93.28571428571428,7,4087,7081.5,1514.0,583.8571428571429
61270.0,6,14,4740,7,653,9333.166666666666,249.0,93.28571428571428,7,4087,9973.666666666666,1514.0,583.8571428571429
4312.0,17,2,614,1,72,0.0,72.0,72.0,1,542,0.0,542.0,542.0
61710.0,6,10,2032,5,524,15227.75,252.0,104.8,5,1508,15113.25,1236.0,301.6
54950.0,6,14,4740,7,653,8516.0,249.0,93.28571428571428,7,4087,6692.333333333333,1514.0,583.8571428571429
123719.0,17,2,762,2,762,0.0,381.0,381.0,0,0,0.0,0.0,0.0
2046.0,17,4,344,2,150,0.0,75.0,75.0,2,194,0.0,103.0,97.0
115253520.0,6,47,3102,24,1584,5011010.869565218,66.0,66.0,23,1518,5160712.409090909,66.0,66.0
2591793.0,6,3,1777,2,951,0.0,885.0,475.5,1,826,0.0,826.0,826.0
36423.0,6,14,4740,7,653,5396.166666666667,249.0,93.28571428571428,7,4087,5494.0,1514.0,583.8571428571429
104396.0,17,2,286,2,286,0.0,143.0,143.0,0,0,0.0,0.0,0.0
234258.0,6,3,373,2,238,0.0,172.0,119.0,1,135,0.0,135.0,135.0
96669861.0,6,62,12663,31,6721,3222328.7,1514.0,216.80645161290323,31,5942,3213737.7,1514.0,191.67741935483872
307156.0,6,6,412,4,272,102385.33333333331,74.0,68.0,2,140,0.0,74.0,70.0
3000476.0,6,12,2172,7,664,499956.6666666667,252.0,94.85714285714286,5,1508,3927.0,1236.0,301.6
141331.0,6,14,4740,7,653,23421.166666666668,249.0,93.28571428571428,7,4087,23011.0,1514.0,583.8571428571429
20081.0,17,2,582,1,83,0.0,83.0,83.0,1,499,0.0,499.0,499.0
90679244.0,6,21,1585,10,745,10075471.555555556,95.0,74.5,11,840,9042971.7,95.0,76.36363636363636
37385.0,6,13,4515,6,512,7229.8,230.0,85.33333333333333,7,4003,3895.0,1514.0,571.8571428571429
2640366.0,6,25,7573,14,3735,203105.0769230769,1514.0,266.7857142857143,11,3838,238414.2,1514.0,348.90909090909093
90290282.0,6,16,1192,8,596,12890881.42857143,95.0,74.5,8,596,12897962.142857144,95.0,74.5
747273.0,6,2,132,1,66,0.0,66.0,66.0,1,66,0.0,66.0,66.0
120007979.0,6,17,1246,9,650,15000997.375,95.0,72.22222222222223,8,596,17106580.57142857,95.0,74.5
197016.0,17,2,180,1,90,0.0,90.0,90.0,1,90,0.0,90.0,90.0
33499.0,6,14,4740,7,653,5473.166666666667,249.0,93.28571428571428,7,4087,5447.0,1514.0,583.8571428571429
812.0,17,4,438,2,148,0.0,74.0,74.0,2,290,0.0,147.0,145.0
153441.0,17,2,180,1,90,0.0,90.0,90.0,1,90,0.0,90.0,90.0
0.0,17,1,44,1,44,0.0,44.0,44.0,0,0,0.0,0.0,0.0
90062814.0,17,28,13364,28,13364,3335659.777777778,501.0,477.2857142857143,0,0,0.0,0.0,0.0
116778661.0,6,48,3168,24,1584,5077333.0869565215,66.0,66.0,24,1584,5063653.434782608,66.0,66.0
10554065.0,6,7,478,4,272,3470858.0,74.0,68.0,3,206,5206191.5,74.0,68.66666666666667
90575944.0,6,27,1954,14,1045,6950783.384615385,139.0,74.64285714285714,13,909,7530013.0,123.0,69.92307692307692
280167.0,17,2,363,1,79,0.0,79.0,79.0,1,284,0.0,284.0,284.0
108255.0,17,2,286,2,286,0.0,143.0,143.0,0,0,0.0,0.0,0.0
37519.0,6,14,4740,7,653,6088.5,249.0,93.28571428571428,7,4087,5672.833333333333,1514.0,583.8571428571429
90021182.0,17,28,13364,28,13364,3334117.851851852,501.0,477.2857142857143,0,0,0.0,0.0,0.0
313922.0,17,4,1400,4,1400,104640.66666666669,350.0,350.0,0,0,0.0,0.0,0.0
1307060.0,6,4,264,2,132,0.0,66.0,66.0,2,132,0.0,66.0,66.0
120231038.0,6,216,24296,108,7424,1117065.9158878506,140.0,68.74074074074075,108,16872,1115955.6074766356,284.0,156.22222222222223
33540.0,6,14,4740,7,653,4806.333333333333,249.0,93.28571428571428,7,4087,5412.833333333333,1514.0,583.8571428571429
90756135.0,6,22,1680,12,935,8246093.727272727,95.0,77.91666666666667,10,745,10052803.555555556,95.0,74.5
90284522.0,6,21,1585,11,840,9024352.5,95.0,76.36363636363636,10,745,9948859.666666666,95.0,74.5
104374164.0,6,28,1860,14,966,8012180.384615385,123.0,69.0,14,894,8012179.153846154,123.0,63.85714285714285
10487954.0,6,7,478,4,272,3449027.0,74.0,68.0,3,206,5173414.0,74.0,68.66666666666667
168.0,17,2,3028,2,3028,0.0,1514.0,1514.0,0,0,0.0,0.0,0.0
137252.0,17,4,344,2,150,0.0,75.0,75.0,2,194,0.0,103.0,97.0
903968.0,6,12,2710,7,743,150661.33333333334,339.0,106.14285714285714,5,1967,157876.5,1514.0,393.4
1424251.0,6,4,276,2,128,0.0,74.0,64.0,2,148,0.0,74.0,74.0
2452146.0,6,25,7573,14,3735,188626.6153846153,1514.0,266.7857142857143,11,3838,219864.1,1514.0,348.90909090909093
16701.0,6,11,1131,6,600,3276.8,262.0,100.0,5,531,3847.25,259.0,106.2
145533.0,6,3,337,2,214,0.0,160.0,107.0,1,123,0.0,123.0,123.0
51362121.0,6,12,2393,6,1170,9690663.6,826.0,195.0,6,1223,9830659.8,885.0,203.8333333333333
107497.0,17,2,286,2,286,0.0,143.0,143.0,0,0,0.0,0.0,0.0
424.0,17,2,508,2,508,0.0,257.0,254.0,0,0,0.0,0.0,0.0
0.0,17,1,381,1,381,0.0,381.0,381.0,0,0,0.0,0.0,0.0
42475.0,6,14,4740,7,653,6955.333333333333,249.0,93.28571428571428,7,4087,6891.333333333333,1514.0,583.8571428571429
100549075.0,17,12,516,6,258,20000223.6,43.0,43.0,6,258,20001139.8,43.0,43.0
9345.0,6,10,1067,5,536,2150.5,264.0,107.2,5,531,2118.75,259.0,106.2
281831.0,6,10,1221,6,636,56366.2,298.0,106.0,4,585,88461.0,379.0,146.25
147899.0,17,2,180,1,90,0.0,90.0,90.0,1,90,0.0,90.0,90.0
307292.0,6,6,412,4,272,102430.66666666669,74.0,68.0,2,140,0.0,74.0,70.0
24572.0,6,10,2032,5,524,5047.0,252.0,104.8,5,1508,5494.75,1236.0,301.6
2137.0,17,4,344,2,150,0.0,75.0,75.0,2,194,0.0,103.0,97.0
341.0,17,2,267,1,83,0.0,83.0,83.0,1,184,0.0,184.0,184.0
117564260.0,6,218,24534,109,17118,1086565.148148148,284.0,157.045871559633,109,7416,1086564.9814814816,140.0,68.03669724770643
205751.0,17,2,762,2,762,0.0,381.0,381.0,0,0,0.0,0.0,0.0
228346.0,6,3,426,2,280,0.0,214.0,140.0,1,146,0.0,146.0,146.0
31109.0,6,10,2032,5,524,7497.25,252.0,104.8,5,1508,7546.5,1236.0,301.6
101722.0,17,2,762,2,762,0.0,381.0,381.0,0,0,0.0,0.0,0.0
13629.0,6,11,1131,6,600,2677.4,262.0,100.0,5,531,3190.75,259.0,106.2
120123702.0,6,15,2428,9,1204,15015462.75,188.0,133.77777777777777,6,1224,18018394.4,204.0,204.0
869033.0,6,10,1333,6,796,173806.6,458.0,132.66666666666666,4,537,198782.66666666663,331.0,134.25
3172109.0,6,18,1495,9,921,358361.0,315.0,102.33333333333331,9,574,358333.375,78.0,63.77777777777778
120124405.0,6,13,2020,9,1204,15015550.625,188.0,133.77777777777777,4,816,30031410.0,204.0,204.0
216486.0,6,3,426,2,280,0.0,214.0,140.0,1,146,0.0,146.0,146.0
108099944.0,17,5,955,5,955,27024986.0,191.0,191.0,0,0,0.0,0.0,0.0
233171.0,6,3,337,2,214,0.0,160.0,107.0,1,123,0.0,123.0,123.0
90213583.0,6,16,1192,8,596,12853084.285714284,95.0,74.5,8,596,12858418.714285716,95.0,74.5
119909449.0,6,15,2306,6,1224,23973061.0,204.0,204.0,9,1082,14988507.625,188.0,120.22222222222224
232404.0,6,3,337,2,214,0.0,160.0,107.0,1,123,0.0,123.0,123.0
1023078.0,6,11,1134,6,558,204615.6,220.0,93.0,5,576,254820.5,304.0,115.2
252062.0,6,3,337,2,214,0.0,160.0,107.0,1,123,0.0,123.0,123.0
218222.0,6,4,492,2,280,0.0,214.0,140.0,2,212,0.0,146.0,106.0
90251631.0,6,14,2240,8,1016,12893090.142857144,188.0,127.0,6,1224,18017752.4,204.0,204.0
103913.0,17,2,286,2,286,0.0,143.0,143.0,0,0,0.0,0.0,0.0
134259.0,6,10,1066,5,490,33257.5,218.0,98.0,5,576,33366.5,304.0,115.2
21850.0,17,2,582,1,83,0.0,83.0,83.0,1,499,0.0,499.0,499.0
90066532.0,17,28,13364,28,13364,3335797.4814814813,501.0,477.2857142857143,0,0,0.0,0.0,0.0
452.0,17,2,156,1,78,0.0,78.0,78.0,1,78,0.0,78.0,78.0
104289.0,17,2,762,2,762,0.0,381.0,381.0,0,0,0.0,0.0,0.0
2473.0,17,4,344,2,150,0.0,75.0,75.0,2,194,0.0,103.0,97.0
258872.0,6,3,337,2,214,0.0,160.0,107.0,1,123,0.0,123.0,123.0
3014758.0,6,11,2106,6,598,602774.4,252.0,99.66666666666669,5,1508,3456.25,1236.0,301.6
70137.0,6,10,2032,5,524,16858.5,252.0,104.8,5,1508,16478.75,1236.0,301.6
77403.0,6,10,2032,5,524,15692.25,252.0,104.8,5,1508,18703.75,1236.0,301.6
108093771.0,17,5,1005,5,1005,27023442.75,201.0,201.0,0,0,0.0,0.0,0.0
41076.0,6,10,2032,5,524,10013.25,252.0,104.8,5,1508,9517.75,1236.0,301.6
2066.0,17,4,344,2,150,0.0,75.0,75.0,2,194,0.0,103.0,97.0
1684.0,17,5,550,5,550,421.0,110.0,110.0,0,0,0.0,0.0,0.0
120249542.0,6,218,24518,109,7490,1106977.4351851852,140.0,68.71559633027523,109,17028,1105801.8333333333,284.0,156.22018348623854
118836494.0,6,35,2526,18,1332,6990382.0,123.0,74.0,17,1194,7413773.375,123.0,70.23529411764706
2387.0,17,4,344,2,150,0.0,75.0,75.0,2,194,0.0,103.0,97.0
298784.0,6,6,412,4,272,99594.66666666669,74.0,68.0,2,140,0.0,74.0,70.0
104855437.0,6,44,2904,22,1452,4993116.047619048,66.0,66.0,22,1452,4980141.285714285,66.0,66.0
358143.0,6,3,1604,2,851,0.0,785.0,425.5,1,753,0.0,753.0,753.0
216842.0,6,3,426,2,280,0.0,214.0,140.0,1,146,0.0,146.0,146.0
2305675.0,6,25,7573,14,3735,177359.61538461538,1514.0,266.7857142857143,11,3838,205612.2,1514.0,348.90909090909093
120038389.0,6,21,1585,11,840,11998937.2,95.0,76.36363636363636,10,745,13311224.0,95.0,74.5
239793.0,6,3,337,2,214,0.0,160.0,107.0,1,123,0.0,123.0,123.0
23604.0,6,10,2032,5,524,5672.0,252.0,104.8,5,1508,5328.5,1236.0,301.6
34989.0,6,10,2032,5,524,8520.5,252.0,104.8,5,1508,7333.25,1236.0,301.6
90061172.0,17,28,13364,28,13364,3335598.962962963,501.0,477.2857142857143,0,0,0.0,0.0,0.0
122688002.0,6,49,3234,25,1650,5112000.083333333,66.0,66.0,24,1584,5125768.217391305,66.0,66.0
154611.0,17,2,180,1,70,0.0,70.0,70.0,1,110,0.0,110.0,110.0
119290720.0,6,225,25500,113,7680,1065095.7142857143,140.0,67.96460176991151,112,17820,1065384.4864864864,374.0,159.10714285714286
16327.999999999998,6,11,1132,6,556,2850.0,218.0,92.66666666666669,5,576,3477.5,304.0,115.2
307356.0,6,6,412,4,272,102452.0,74.0,68.0,2,140,0.0,74.0,70.0
2325.0,17,4,344,2,150,0.0,75.0,75.0,2,194,0.0,103.0,97.0
14901.0,6,13,1459,7,862,2210.6666666666665,271.0,123.14285714285714,6,597,2734.0,259.0,99.5
37269.0,6,11,2098,6,590,5763.4,252.0,98.33333333333331,5,1508,8381.25,1236.0,301.6
305308.0,6,6,412,4,272,101769.33333333331,74.0,68.0,2,140,0.0,74.0,70.0
118097993.0,6,34,2334,17,1209,7368347.625,123.0,71.11764705882354,17,1125,7368346.8125,123.0,66.17647058823529
20180.0,17,2,582,1,83,0.0,83.0,83.0,1,499,0.0,499.0,499.0
847.0,17,4,438,2,148,0.0,74.0,74.0,2,290,0.0,147.0,145.0
26775.0,6,11,2098,6,590,5116.0,252.0,98.33333333333331,5,1508,6266.5,1236.0,301.6
108107916.0,17,5,955,5,955,27026979.0,191.0,191.0,0,0,0.0,0.0,0.0
33226.0,6,14,4740,7,653,4860.666666666667,249.0,93.28571428571428,7,4087,4993.666666666667,1514.0,583.8571428571429
120117142.0,6,12,1832,8,1016,17136400.285714287,188.0,127.0,4,816,30029336.0,204.0,204.0
120204262.0,6,228,25846,114,7820,1056538.1061946903,140.0,68.59649122807018,114,18026,1056495.6548672563,284.0,158.12280701754386
143914.0,17,2,180,1,90,0.0,90.0,90.0,1,90,0.0,90.0,90.0
108106235.0,17,5,955,5,955,27026558.75,191.0,191.0,0,0,0.0,0.0,0.0
33792.0,6,10,2032,5,524,8222.0,252.0,104.8,5,1508,7713.75,1236.0,301.6
9262.0,17,2,571,1,86,0.0,86.0,86.0,1,485,0.0,485.0,485.0
10496607.0,6,7,478,4,272,3451901.6666666665,74.0,68.0,3,206,5177676.5,74.0,68.66666666666667
14949.0,17,2,180,1,90,0.0,90.0,90.0,1,90,0.0,90.0,90.0
602986.0,6,5,336,2,134,0.0,68.0,67.0,3,202,195966.0,70.0,67.33333333333333
2042214.0,6,19,6869,11,1567,204221.4,408.0,142.45454545454547,8,5302,229751.8571428572,1514.0,662.75
122314504.0,6,48,3168,24,1584,4995162.782608695,66.0,66.0,24,1584,5212586.217391305,66.0,66.0
146621.0,6,11,1132,6,556,28786.4,218.0,92.66666666666669,5,576,36299.5,304.0,115.2
3121701.0,6,157,126911,90,118187,35075.29213483146,1510.0,1313.1888888888889,67,8724,42594.59090909091,1510.0,130.2089552238806
102076.0,17,2,762,2,762,0.0,381.0,381.0,0,0,0.0,0.0,0.0
10447223.0,6,7,478,4,272,3436636.333333333,74.0,68.0,3,206,5154808.5,74.0,68.66666666666667
1314805.0,6,4,264,2,132,0.0,66.0,66.0,2,132,0.0,66.0,66.0
22380.0,6,12,1320,6,723,4122.0,253.0,120.5,6,597,4269.2,259.0,99.5
1942.0,17,2,180,1,90,0.0,90.0,90.0,1,90,0.0,90.0,90.0
2797835.0,6,2,132,1,66,0.0,66.0,66.0,1,66,0.0,66.0,66.0
120070733.0,17,28,13364,28,13364,4447064.185185186,501.0,477.2857142857143,0,0,0.0,0.0,0.0
2654113.0,6,3,1604,2,851,0.0,785.0,425.5,1,753,0.0,753.0,753.0
103103.0,17,2,286,2,286,0.0,143.0,143.0,0,0,0.0,0.0,0.0
520267.00000000006,17,6,2100,6,2100,104053.4,350.0,350.0,0,0,0.0,0.0,0.0
320277.0,17,4,1400,4,1400,106759.0,350.0,350.0,0,0,0.0,0.0,0.0
307468.0,6,6,412,4,272,102489.33333333331,74.0,68.0,2,140,0.0,74.0,70.0
249099.0,17,2,180,1,70,0.0,70.0,70.0,1,110,0.0,110.0,110.0
1302518.0,6,4,264,2,132,0.0,66.0,66.0,2,132,0.0,66.0,66.0
1514512.0,17,6,1230,3,234,757069.5,78.0,78.0,3,996,757051.5,332.0,332.0
303.0,17,2,174,1,79,0.0,79.0,79.0,1,95,0.0,95.0,95.0
42080.0,6,14,4740,7,653,5366.833333333333,249.0,93.28571428571428,7,4087,6807.0,1514.0,583.8571428571429
207108.0,6,3,426,2,280,0.0,214.0,140.0,1,146,0.0,146.0,146.0
332.0,17,2,166,1,75,0.0,75.0,75.0,1,91,0.0,91.0,91.0
45314.0,6,14,4740,7,653,7389.333333333333,249.0,93.28571428571428,7,4087,7405.833333333333,1514.0,583.8571428571429
39724.0,6,14,4740,7,653,6372.666666666667,249.0,93.28571428571428,7,4087,5890.666666666667,1514.0,583.8571428571429
90659573.0,6,25,1924,11,840,9041753.2,95.0,76.36363636363636,14,1084,6958070.230769231,95.0,77.42857142857143
4055.0,17,2,510,1,79,0.0,79.0,79.0,1,431,0.0,431.0,431.0
120048213.0,17,28,13364,28,13364,4446230.111111111,501.0,477.2857142857143,0,0,0.0,0.0,0.0
0.0,17,1,44,1,44,0.0,44.0,44.0,0,0,0.0,0.0,0.0
14318.0,6,10,2032,5,524,3346.25,252.0,104.8,5,1508,3014.5,1236.0,301.6
144873.0,17,2,180,1,70,0.0,70.0,70.0,1,110,0.0,110.0,110.0
91351731.0,6,24,1829,13,989,7611844.916666667,95.0,76.07692307692308,11,840,9134317.1,95.0,76.36363636363636
38961.0,6,10,2032,5,524,9125.5,252.0,104.8,5,1508,9379.25,1236.0,301.6
2802187.0,6,2,132,1,66,0.0,66.0,66.0,1,66,0.0,66.0,66.0
33132.0,6,10,2032,5,524,7939.25,252.0,104.8,5,1508,7907.75,1236.0,301.6
141824.0,6,2,132,1,66,0.0,66.0,66.0,1,66,0.0,66.0,66.0
229196.0,17,4,1524,4,1524,76398.66666666667,381.0,381.0,0,0,0.0,0.0,0.0
48168.0,6,14,4740,7,653,6736.666666666667,249.0,93.28571428571428,7,4087,7256.833333333333,1514.0,583.8571428571429
2347.0,17,4,344,2,150,0.0,75.0,75.0,2,194,0.0,103.0,97.0
206098.0,6,3,426,2,280,0.0,214.0,140.0,1,146,0.0,146.0,146.0
322063.0,17,4,1400,4,1400,107354.33333333331,350.0,350.0,0,0,0.0,0.0,0.0
263713.0,6,10,1221,6,636,52742.6,298.0,106.0,4,585,82005.0,379.0,146.25
299360.0,6,6,412,4,272,99786.66666666669,74.0,68.0,2,140,0.0,74.0,70.0
120784264.0,6,229,26018,115,18198,1059511.0877192982,284.0,158.24347826086955,114,7820,1059757.7079646017,140.0,68.59649122807018
102543084.0,6,44,2904,22,1452,4883004.0,66.0,66.0,22,1452,4872711.047619048,66.0,66.0
209639.0,17,2,180,1,90,0.0,90.0,90.0,1,90,0.0,90.0,90.0
114436289.0,6,205,23158,103,7094,1121924.4019607843,140.0,68.87378640776699,102,16064,1112546.3168316833,284.0,157.49019607843138
301767.0,6,6,412,4,272,100589.0,74.0,68.0,2,140,0.0,74.0,70.0
315607.0,17,4,1400,4,1400,105202.33333333331,350.0,350.0,0,0,0.0,0.0,0.0
281014.0,17,2,363,1,79,0.0,79.0,79.0,1,284,0.0,284.0,284.0
247673.0,6,3,373,2,238,0.0,172.0,119.0,1,135,0.0,135.0,135.0
1140617.0,6,13,1386,7,789,190102.8333333333,253.0,112.71428571428572,6,597,220780.8,259.0,99.5
123829.0,6,3,337,2,214,0.0,160.0,107.0,1,123,0.0,123.0,123.0
316726.0,17,4,1400,4,1400,105575.33333333331,350.0,350.0,0,0,0.0,0.0,0.0
2329.0,17,4,344,2,150,0.0,75.0,75.0,2,194,0.0,103.0,97.0
260238.00000000003,6,3,337,2,214,0.0,160.0,107.0,1,123,0.0,123.0,123.0
58460.0,6,14,4740,7,653,9446.833333333334,249.0,93.28571428571428,7,4087,9101.0,1514.0,583.8571428571429
26440.0,6,14,4740,7,653,3760.0,249.0,93.28571428571428,7,4087,4272.666666666667,1514.0,583.8571428571429
348255.0,6,3,204,2,136,0.0,70.0,68.0,1,68,0.0,68.0,68.0
34926.0,6,14,4740,7,653,5666.166666666667,249.0,93.28571428571428,7,4087,5568.333333333333,1514.0,583.8571428571429
13785.0,6,10,2032,5,524,3046.25,252.0,104.8,5,1508,3035.5,1236.0,301.6
121001071.0,17,15,1169,8,606,17285867.285714287,174.0,75.75,7,563,16834880.0,174.0,80.42857142857143
0.0,17,1,342,1,342,0.0,342.0,342.0,0,0,0.0,0.0,0.0
16419153.000000002,6,28,9293,15,2193,1172796.642857143,408.0,146.2,13,7100,1028595.75,1514.0,546.1538461538462
155341.0,6,3,337,2,214,0.0,160.0,107.0,1,123,0.0,123.0,123.0
2476083.0,6,3,1604,2,851,0.0,785.0,425.5,1,753,0.0,753.0,753.0
124728218.0,6,31,2113,16,1165,8315214.533333333,139.0,72.8125,15,948,8344543.285714285,123.0,63.2
232832.0,6,3,373,2,238,0.0,172.0,119.0,1,135,0.0,135.0,135.0
112580781.0,6,29,1914,15,948,8041484.357142857,123.0,63.2,14,966,8047794.384615385,123.0,69.0
22998990.0,17,3,1034,2,684,0.0,342.0,342.0,1,350,0.0,350.0,350.0
957901.0,6,12,1447,6,816,190580.8,291.0,136.0,6,631,190192.8,293.0,105.16666666666669
90031330.0,17,28,13364,28,13364,3334493.703703704,501.0,477.2857142857143,0,0,0.0,0.0,0.0
842617.0,6,10,1221,6,636,168523.4,298.0,106.0,4,585,279074.0,379.0,146.25
36082.0,6,14,4740,7,653,5681.833333333333,249.0,93.28571428571428,7,4087,5101.666666666667,1514.0,583.8571428571429
280615.0,17,2,365,1,80,0.0,80.0,80.0,1,285,0.0,285.0,285.0
122155.0,6,3,373,2,238,0.0,172.0,119.0,1,135,0.0,135.0,135.0
90016235.0,17,28,13364,28,13364,3333934.6296296297,501.0,477.2857142857143,0,0,0.0,0.0,0.0
31001.0,6,10,2032,5,524,6748.0,252.0,104.8,5,1508,7481.25,1236.0,301.6
104279.0,17,2,286,2,286,0.0,143.0,143.0,0,0,0.0,0.0,0.0
90036155.0,17,28,13364,28,13364,3334672.407407407,501.0,477.2857142857143,0,0,0.0,0.0,0.0
228496.0,17,2,180,1,90,0.0,90.0,90.0,1,90,0.0,90.0,90.0
35246.0,6,14,4740,7,653,5697.833333333333,249.0,93.28571428571428,7,4087,5543.333333333333,1514.0,583.8571428571429
15012.0,6,11,1133,6,602,2665.8,264.0,100.33333333333331,5,531,3536.25,259.0,106.2
100606745.0,17,12,778,6,389,20003969.8,174.0,64.83333333333333,6,389,20089333.0,174.0,64.83333333333333
35338.0,6,14,4740,7,653,5727.5,249.0,93.28571428571428,7,4087,5182.5,1514.0,583.8571428571429
191105.0,17,2,180,1,90,0.0,90.0,90.0,1,90,0.0,90.0,90.0
412291.0,17,2,876,2,876,0.0,438.0,438.0,0,0,0.0,0.0,0.0
48194.0,6,14,4740,7,653,7748.333333333333,249.0,93.28571428571428,7,4087,7733.5,1514.0,583.8571428571429
34444.0,6,14,4740,7,653,5378.666666666667,249.0,93.28571428571428,7,4087,5451.5,1514.0,583.8571428571429
2562182.0,6,3,1777,1,826,0.0,826.0,826.0,2,951,0.0,885.0,475.5
47662.0,6,14,4740,7,653,7697.166666666667,249.0,93.28571428571428,7,4087,7305.0,1514.0,583.8571428571429
9630.0,17,2,582,1,83,0.0,83.0,83.0,1,499,0.0,499.0,499.0
148184.0,17,2,398,1,88,0.0,88.0,88.0,1,310,0.0,310.0,310.0
13264.0,6,14,4740,7,653,1937.6666666666667,249.0,93.28571428571428,7,4087,2073.833333333333,1514.0,583.8571428571429
319949.0,17,4,1400,4,1400,106649.66666666669,350.0,350.0,0,0,0.0,0.0,0.0
209622.0,17,2,180,1,90,0.0,90.0,90.0,1,90,0.0,90.0,90.0
2292.0,17,4,344,2,150,0.0,75.0,75.0,2,194,0.0,103.0,97.0
102754.0,17,2,286,2,286,0.0,143.0,143.0,0,0,0.0,0.0,0.0
300481.0,6,6,412,4,272,100160.33333333331,74.0,68.0,2,140,0.0,74.0,70.0
2414918.0,6,19,6869,10,1501,268324.22222222225,408.0,150.1,9,5368,242182.5,1514.0,596.4444444444445
110421807.0,17,14,864,7,432,18333503.83333333,174.0,61.71428571428572,7,432,18334972.166666668,174.0,61.71428571428572
6584.0,17,2,582,1,83,0.0,83.0,83.0,1,499,0.0,499.0,499.0
238919.0,6,2,132,1,66,0.0,66.0,66.0,1,66,0.0,66.0,66.0
49487.0,6,14,4740,7,653,7724.666666666667,249.0,93.28571428571428,7,4087,7944.166666666667,1514.0,583.8571428571429
40463.0,6,14,4740,7,653,6622.0,249.0,93.28571428571428,7,4087,6357.5,1514.0,583.8571428571429
281285.0,17,2,363,1,79,0.0,79.0,79.0,1,284,0.0,284.0,284.0
322944.0,17,4,1400,4,1400,107648.0,350.0,350.0,0,0,0.0,0.0,0.0
90305060.0,6,14,1043,7,542,15050843.333333334,95.0,77.42857142857143,7,501,14997254.0,95.0,71.57142857142857
32259.000000000004,6,14,4740,7,653,5212.333333333333,249.0,93.28571428571428,7,4087,4944.5,1514.0,583.8571428571429
4063.0,17,4,344,2,150,0.0,75.0,75.0,2,194,0.0,103.0,97.0
135131575.0,17,6,1206,6,1206,27026315.0,201.0,201.0,0,0,0.0,0.0,0.0
257716.0,17,4,6056,4,6056,85905.33333333333,1514.0,1514.0,0,0,0.0,0.0,0.0
92406959.0,17,11,735,6,389,18481391.8,174.0,64.83333333333333,5,346,18070917.0,174.0,69.2
3101871.0,6,157,124476,87,115554,36068.26744186047,1510.0,1328.2068965517242,70,8922,40445.34782608696,1510.0,127.45714285714286
120124781.0,6,13,2020,9,1204,15015597.625,188.0,133.77777777777777,4,816,30031160.33333333,204.0,204.0
120164977.0,6,242,27310,121,8282,994517.3083333332,140.0,68.44628099173553,121,19028,994477.9333333332,284.0,157.25619834710744
146869.0,6,3,373,2,238,0.0,172.0,119.0,1,135,0.0,135.0,135.0
0.0,17,1,218,1,218,0.0,218.0,218.0,0,0,0.0,0.0,0.0
0.0,6,1,66,1,66,0.0,66.0,66.0,0,0,0.0,0.0,0.0
207255.0,6,10,1221,6,636,41451.0,298.0,106.0,4,585,67449.33333333333,379.0,146.25
2349.0,17,4,344,2,150,0.0,75.0,75.0,2,194,0.0,103.0,97.0
20461.0,6,14,4740,7,653,3185.1666666666665,249.0,93.28571428571428,7,4087,3233.833333333333,1514.0,583.8571428571429
217774.0,6,3,426,2,280,0.0,214.0,140.0,1,146,0.0,146.0,146.0
119859153.0,17,35,16705,35,16705,3525269.205882353,501.0,477.2857142857143,0,0,0.0,0.0,0.0
1085933.0,6,13,1394,7,797,180988.8333333333,253.0,113.85714285714286,6,597,215665.2,259.0,99.5
135130873.0,17,6,1206,6,1206,27026174.6,201.0,201.0,0,0,0.0,0.0,0.0
365425.0,6,10,1221,6,636,73085.0,298.0,106.0,4,585,120655.33333333331,379.0,146.25
1301466.0,6,4,264,2,132,0.0,66.0,66.0,2,132,0.0,66.0,66.0
135135160.0,17,6,1206,6,1206,27027032.0,201.0,201.0,0,0,0.0,0.0,0.0
310779.0,17,4,622,4,622,103593.0,163.0,155.5,0,0,0.0,0.0,0.0
90729080.0,6,19,1436,9,691,11341135.0,95.0,76.77777777777777,10,745,10048887.666666666,95.0,74.5
0.0,17,1,44,1,44,0.0,44.0,44.0,0,0,0.0,0.0,0.0
16779.0,6,11,1132,6,556,3355.8,218.0,92.66666666666669,5,576,3564.0,304.0,115.2
120124325.0,6,13,2020,9,1204,15015540.625,188.0,133.77777777777777,4,816,30030971.0,204.0,204.0
34861.0,6,12,1320,6,723,6353.2,253.0,120.5,6,597,4882.8,259.0,99.5
10527555.0,6,7,478,4,272,3463679.0,74.0,68.0,3,206,5195418.0,74.0,68.66666666666667
289336.0,6,13,1439,7,714,48222.66666666666,298.0,102.0,6,725,57350.2,379.0,120.83333333333331
129881.0,6,14,4740,7,653,20854.0,249.0,93.28571428571428,7,4087,21142.83333333333,1514.0,583.8571428571429
57794.0,6,14,4740,7,653,9512.833333333334,249.0,93.28571428571428,7,4087,6098.333333333333,1514.0,583.8571428571429
904.0,17,4,438,2,148,0.0,74.0,74.0,2,290,0.0,147.0,145.0
425.0,17,2,508,2,508,0.0,257.0,254.0,0,0,0.0,0.0,0.0
417.0,17,2,410,1,78,0.0,78.0,78.0,1,332,0.0,332.0,332.0
50882.0,17,2,180,1,90,0.0,90.0,90.0,1,90,0.0,90.0,90.0
324964.0,6,6,412,4,272,108321.33333333331,74.0,68.0,2,140,0.0,74.0,70.0
206241.0,6,3,426,2,280,0.0,214.0,140.0,1,146,0.0,146.0,146.0
317721.0,17,4,1400,4,1400,105907.0,350.0,350.0,0,0,0.0,0.0,0.0
39747.0,6,10,2032,5,524,9216.75,252.0,104.8,5,1508,9659.0,1236.0,301.6
21080.0,6,10,2032,5,524,3220.75,252.0,104.8,5,1508,5009.25,1236.0,301.6
302422.0,6,2,132,1,66,0.0,66.0,66.0,1,66,0.0,66.0,66.0
123301963.0,6,48,3168,24,1584,5090679.826086956,66.0,66.0,24,1584,5205913.130434782,66.0,66.0
29023.0,6,10,2032,5,524,6858.25,252.0,104.8,5,1508,5725.75,1236.0,301.6
2629.0,17,2,762,2,762,0.0,381.0,381.0,0,0,0.0,0.0,0.0
2801377.0,6,2,132,1,66,0.0,66.0,66.0,1,66,0.0,66.0,66.0
2393543.0,6,25,7573,14,3735,184118.6923076923,1514.0,266.7857142857143,11,3838,213351.8,1514.0,348.90909090909093
53865.0,6,11,1132,6,556,10773.0,218.0,92.66666666666669,5,576,13178.25,304.0,115.2
27147.0,6,14,4740,7,653,4375.5,249.0,93.28571428571428,7,4087,4304.666666666667,1514.0,583.8571428571429
10701.0,17,4,823,2,163,0.0,89.0,81.5,2,660,0.0,443.0,330.0
15300.0,6,14,4740,7,653,2370.6666666666665,249.0,93.28571428571428,7,4087,2413.1666666666665,1514.0,583.8571428571429
90015701.0,17,28,13364,28,13364,3333914.851851852,501.0,477.2857142857143,0,0,0.0,0.0,0.0
300709.0,6,6,412,4,272,100236.33333333331,74.0,68.0,2,140,0.0,74.0,70.0
135134640.0,17,6,1146,6,1146,27026928.0,191.0,191.0,0,0,0.0,0.0,0.0
145520.0,6,3,337,2,214,0.0,160.0,107.0,1,123,0.0,123.0,123.0
135126458.0,17,6,1146,6,1146,27025291.6,191.0,191.0,0,0,0.0,0.0,0.0
272239.0,6,10,1221,6,636,54447.8,298.0,106.0,4,585,85363.0,379.0,146.25
2321.0,17,4,344,2,150,0.0,75.0,75.0,2,194,0.0,103.0,97.0
315729.0,17,4,1400,4,1400,105243.0,350.0,350.0,0,0,0.0,0.0,0.0
106684.0,17,2,286,2,286,0.0,143.0,143.0,0,0,0.0,0.0,0.0
228238.0,17,2,180,1,90,0.0,90.0,90.0,1,90,0.0,90.0,90.0
2356.0,17,4,344,2,150,0.0,75.0,75.0,2,194,0.0,103.0,97.0
120008605.0,17,13,559,7,301,20001434.166666668,43.0,43.0,6,258,20000159.4,43.0,43.0
38177.0,6,10,2032,5,524,9312.0,252.0,104.8,5,1508,9123.5,1236.0,301.6
345.0,17,2,160,1,80,0.0,80.0,80.0,1,80,0.0,80.0,80.0
191861.0,17,2,762,2,762,0.0,381.0,381.0,0,0,0.0,0.0,0.0
113520136.0,6,46,3036,23,1518,5159993.727272728,66.0,66.0,23,1518,5159995.318181818,66.0,66.0
206396.0,17,2,762,2,762,0.0,381.0,381.0,0,0,0.0,0.0,0.0
2848686.0,6,3,204,2,136,0.0,70.0,68.0,1,68,0.0,68.0,68.0
198852.0,17,2,180,1,90,0.0,90.0,90.0,1,90,0.0,90.0,90.0
90258930.0,6,16,2368,9,1204,11282366.25,188.0,133.77777777777777,7,1164,15015941.0,204.0,166.28571428571428
297820.0,6,6,412,4,272,99273.33333333331,74.0,68.0,2,140,0.0,74.0,70.0
239017.0,6,3,337,2,214,0.0,160.0,107.0,1,123,0.0,123.0,123.0
23614.0,17,2,539,1,86,0.0,86.0,86.0,1,453,0.0,453.0,453.0
15478.0,6,11,2098,6,590,2953.0,252.0,98.33333333333331,5,1508,3289.75,1236.0,301.6
90256769.0,6,12,1832,8,1016,12893824.142857144,188.0,127.0,4,816,30030081.33333333,204.0,204.0
19107.0,6,14,4740,7,653,2870.1666666666665,249.0,93.28571428571428,7,4087,3040.6666666666665,1514.0,583.8571428571429
216521.0,6,3,426,2,280,0.0,214.0,140.0,1,146,0.0,146.0,146.0
24460.0,6,10,2032,5,524,5893.0,252.0,104.8,5,1508,5882.0,1236.0,301.6
14130.0,6,14,4740,7,653,2225.0,249.0,93.28571428571428,7,4087,2222.833333333333,1514.0,583.8571428571429
120281965.0,6,17,1287,9,691,15035245.625,95.0,76.77777777777777,8,596,17104848.0,95.0,74.5
103200212.0,6,42,2772,21,1386,5159998.5,66.0,66.0,21,1386,5159997.9,66.0,66.0
4496.0,17,2,618,1,72,0.0,72.0,72.0,1,546,0.0,546.0,546.0
2334.0,17,4,344,2,150,0.0,75.0,75.0,2,194,0.0,103.0,97.0
301886.0,6,6,412,4,272,100628.66666666669,74.0,68.0,2,140,0.0,74.0,70.0
138007297.0,17,15,907,8,475,19715328.14285714,174.0,59.375,7,432,19666857.33333333,174.0,61.71428571428572
13421.0,6,10,1065,5,534,3109.5,262.0,106.8,5,531,3028.0,259.0,106.2
143904.0,17,2,180,1,90,0.0,90.0,90.0,1,90,0.0,90.0,90.0
104250.0,17,2,700,2,700,0.0,350.0,350.0,0,0,0.0,0.0,0.0
14219.0,6,14,4740,7,653,2186.6666666666665,249.0,93.28571428571428,7,4087,2182.833333333333,1514.0,583.8571428571429
143926.0,17,2,180,1,90,0.0,90.0,90.0,1,90,0.0,90.0,90.0
37916.0,6,14,4740,7,653,5891.0,249.0,93.28571428571428,7,4087,6038.0,1514.0,583.8571428571429
16152.0,6,13,1459,7,862,2613.5,271.0,123.14285714285714,6,597,2933.0,259.0,99.5
327363.0,6,6,412,4,272,109121.0,74.0,68.0,2,140,0.0,74.0,70.0
51349.0,6,14,4740,7,653,8179.5,249.0,93.28571428571428,7,4087,8026.166666666667,1514.0,583.8571428571429
34810.0,6,11,2098,6,590,5195.4,252.0,98.33333333333331,5,1508,8067.25,1236.0,301.6
233630.0,6,3,337,2,214,0.0,160.0,107.0,1,123,0.0,123.0,123.0
222512.0,17,2,180,1,90,0.0,90.0,90.0,1,90,0.0,90.0,90.0
22848.0,6,14,4740,7,653,3338.0,249.0,93.28571428571428,7,4087,3588.833333333333,1514.0,583.8571428571429
90520181.0,6,15,2444,8,1016,12931454.42857143,188.0,127.0,7,1428,15059338.5,204.0,204.0
10511888.0,6,7,478,4,272,3457076.0,74.0,68.0,3,206,5185544.5,74.0,68.66666666666667
1303174.0,6,4,264,2,132,0.0,66.0,66.0,2,132,0.0,66.0,66.0
46770.0,6,14,4740,7,653,7671.0,249.0,93.28571428571428,7,4087,6812.833333333333,1514.0,583.8571428571429
281612.0,17,2,363,1,79,0.0,79.0,79.0,1,284,0.0,284.0,284.0
146122.0,6,3,337,2,214,0.0,160.0,107.0,1,123,0.0,123.0,123.0
1729402.0,6,23,6509,12,1529,157218.36363636365,357.0,127.41666666666669,11,4980,141512.5,1510.0,452.7272727272728
0.0,6,1,54,1,54,0.0,54.0,54.0,0,0,0.0,0.0,0.0
11901.0,6,11,1133,6,602,2206.4,264.0,100.33333333333331,5,531,2137.25,259.0,106.2
113203072.0,6,34,2350,17,1225,7061692.375,139.0,72.05882352941177,17,1125,7061653.0625,123.0,66.17647058823529
94790127.0,6,193,21730,97,6550,987397.15625,140.0,67.52577319587628,96,15180,976120.8421052631,284.0,158.125
308406.0,6,6,412,4,272,102802.0,74.0,68.0,2,140,0.0,74.0,70.0
41119.0,6,14,4740,7,653,5756.0,249.0,93.28571428571428,7,4087,6718.833333333333,1514.0,583.8571428571429
16876.0,6,11,1133,6,602,3241.4,264.0,100.33333333333331,5,531,3483.5,259.0,106.2
115423222.0,6,48,3168,24,1584,5018400.956521739,66.0,66.0,24,1584,5004976.130434782,66.0,66.0
217051.0,6,3,426,2,280,0.0,214.0,140.0,1,146,0.0,146.0,146.0
39920.0,6,14,4740,7,653,6116.0,249.0,93.28571428571428,7,4087,6439.166666666667,1514.0,583.8571428571429
26518.0,6,10,1949,5,441,6411.75,169.0,88.2,5,1508,6040.25,1236.0,301.6
2429253.0,6,25,7573,14,3735,186865.6153846153,1514.0,266.7857142857143,11,3838,217257.8,1514.0,348.90909090909093
218075.0,6,10,1221,6,636,43615.0,298.0,106.0,4,585,71283.33333333333,379.0,146.25
90053023.0,17,28,13364,28,13364,3335297.1481481483,501.0,477.2857142857143,0,0,0.0,0.0,0.0
107539568.0,6,40,3348,22,1824,5110654.523809524,123.0,82.9090909090909,18,1524,6313079.235294118,123.0,84.66666666666667
38160.0,6,14,4740,7,653,6062.5,249.0,93.28571428571428,7,4087,6187.833333333333,1514.0,583.8571428571429
1392181.0,17,16,1120,16,1120,92812.06666666668,70.0,70.0,0,0,0.0,0.0,0.0
3254482.0,6,3,1604,2,851,0.0,785.0,425.5,1,753,0.0,753.0,753.0
41647.0,6,14,4740,7,653,6782.5,249.0,93.28571428571428,7,4087,4589.5,1514.0,583.8571428571429
90050600.0,17,28,13364,28,13364,3335207.407407407,501.0,477.2857142857143,0,0,0.0,0.0,0.0
284508.0,17,2,363,1,79,0.0,79.0,79.0,1,284,0.0,284.0,284.0
23877.0,6,14,4740,7,653,3582.333333333333,249.0,93.28571428571428,7,4087,3787.5,1514.0,583.8571428571429
36397.0,6,14,4740,7,653,4710.833333333333,249.0,93.28571428571428,7,4087,5275.333333333333,1514.0,583.8571428571429
251021.0,6,3,337,2,214,0.0,160.0,107.0,1,123,0.0,123.0,123.0
2426.0,17,4,344,2,150,0.0,75.0,75.0,2,194,0.0,103.0,97.0
149732352.0,17,36,17126,36,17126,4278067.2,501.0,475.72222222222223,0,0,0.0,0.0,0.0
198583.0,17,2,180,1,90,0.0,90.0,90.0,1,90,0.0,90.0,90.0
766.0,17,2,684,2,684,0.0,342.0,342.0,0,0,0.0,0.0,0.0
70441.0,6,14,4740,7,653,11419.833333333334,249.0,93.28571428571428,7,4087,10634.166666666666,1514.0,583.8571428571429
233051.0,6,3,337,2,214,0.0,160.0,107.0,1,123,0.0,123.0,123.0
37210.0,6,14,4740,7,653,6091.666666666667,249.0,93.28571428571428,7,4087,5653.666666666667,1514.0,583.8571428571429
5008390.0,17,4,849,2,166,0.0,83.0,83.0,2,683,0.0,499.0,341.5
109275199.0,6,28,1860,14,966,8389169.0,123.0,69.0,14,894,8389168.461538462,123.0,63.85714285714285
901565.0,6,12,2710,7,743,150260.83333333334,339.0,106.14285714285714,5,1967,157269.25,1514.0,393.4
12399.0,6,13,1459,7,862,1985.1666666666667,271.0,123.14285714285714,6,597,2328.0,259.0,99.5
34388.0,6,14,4740,7,653,3442.6666666666665,249.0,93.28571428571428,7,4087,5593.166666666667,1514.0,583.8571428571429
98523136.0,6,32,2506,17,1351,6157696.0,139.0,79.47058823529412,15,1155,7021918.714285715,123.0,77.0
1305448.0,6,4,264,2,132,0.0,66.0,66.0,2,132,0.0,66.0,66.0
247164.0,6,3,337,2,214,0.0,160.0,107.0,1,123,0.0,123.0,123.0
61744.0,6,14,4740,7,653,10053.0,249.0,93.28571428571428,7,4087,9571.833333333334,1514.0,583.8571428571429
1854.0,17,2,180,1,90,0.0,90.0,90.0,1,90,0.0,90.0,90.0
27363.0,6,14,4740,7,653,4381.333333333333,249.0,93.28571428571428,7,4087,3377.5,1514.0,583.8571428571429
114494604.0,6,48,3168,24,1584,4978026.260869565,66.0,66.0,24,1584,4964604.391304348,66.0,66.0
244393.0,6,3,337,2,214,0.0,160.0,107.0,1,123,0.0,123.0,123.0
0.0,17,1,179,1,179,0.0,179.0,179.0,0,0,0.0,0.0,0.0
19171.0,6,14,4740,7,653,2195.1666666666665,249.0,93.28571428571428,7,4087,3029.6666666666665,1514.0,583.8571428571429
298730.0,6,6,412,4,272,99576.66666666669,74.0,68.0,2,140,0.0,74.0,70.0
22684.0,6,10,2032,5,524,5094.25,252.0,104.8,5,1508,4971.0,1236.0,301.6
16871.0,6,10,2032,5,524,3818.5,252.0,104.8,5,1508,3643.75,1236.0,301.6
111331385.0,6,292,34856,146,24998,766319.3310344828,284.0,171.21917808219175,146,9858,766318.6068965517,140.0,67.52054794520548
192647.0,17,2,180,1,90,0.0,90.0,90.0,1,90,0.0,90.0,90.0
51559.0,6,12,1320,7,789,8593.166666666666,253.0,112.71428571428572,5,531,9281.5,259.0,106.2
28760.0,6,14,4740,7,653,3894.6666666666665,249.0,93.28571428571428,7,4087,4658.5,1514.0,583.8571428571429
135130561.0,17,6,1146,6,1146,27026112.2,191.0,191.0,0,0,0.0,0.0,0.0
2386042.0,6,2,132,1,66,0.0,66.0,66.0,1,66,0.0,66.0,66.0
173227.0,17,2,180,1,90,0.0,90.0,90.0,1,90,0.0,90.0,90.0
219170.0,6,3,426,2,280,0.0,214.0,140.0,1,146,0.0,146.0,146.0
90010984.0,17,27,12943,27,12943,3461960.923076923,501.0,479.3703703703704,0,0,0.0,0.0,0.0
207409.0,6,3,426,2,280,0.0,214.0,140.0,1,146,0.0,146.0,146.0
216867.0,6,3,426,2,280,0.0,214.0,140.0,1,146,0.0,146.0,146.0
318714.0,17,4,1400,4,1400,106238.0,350.0,350.0,0,0,0.0,0.0,0.0
302449.0,6,2,132,1,66,0.0,66.0,66.0,1,66,0.0,66.0,66.0
2021.0,17,4,344,2,150,0.0,75.0,75.0,2,194,0.0,103.0,97.0
196831.0,17,2,180,1,90,0.0,90.0,90.0,1,90,0.0,90.0,90.0
120067397.0,17,29,13785,29,13785,4288121.321428572,501.0,475.3448275862069,0,0,0.0,0.0,0.0
2080.0,17,4,344,2,150,0.0,75.0,75.0,2,194,0.0,103.0,97.0
306714.0,6,6,412,4,272,102238.0,74.0,68.0,2,140,0.0,74.0,70.0
118320771.0,6,223,25028,112,7688,1065952.8918918918,140.0,68.64285714285714,111,17340,1057543.1727272726,284.0,156.21621621621622
2331.0,17,4,344,2,150,0.0,75.0,75.0,2,194,0.0,103.0,97.0
173707.0,17,4,1524,4,1524,57902.333333333336,381.0,381.0,0,0,0.0,0.0,0.0
298501.0,6,6,412,4,272,99500.33333333331,74.0,68.0,2,140,0.0,74.0,70.0
108099881.0,17,5,955,5,955,27024970.25,191.0,191.0,0,0,0.0,0.0,0.0
4441.0,17,2,180,1,90,0.0,90.0,90.0,1,90,0.0,90.0,90.0
102481.0,17,2,286,2,286,0.0,143.0,143.0,0,0,0.0,0.0,0.0
236183.0,6,10,1221,6,636,47236.6,298.0,106.0,4,585,77646.33333333333,379.0,146.25
147774.0,6,11,1132,6,556,28963.0,218.0,92.66666666666669,5,576,36645.75,304.0,115.2
0.0,17,1,342,1,342,0.0,342.0,342.0,0,0,0.0,0.0,0.0
112054989.0,6,30,2122,15,1017,8003927.785714285,123.0,67.8,15,1105,7275258.0,139.0,73.66666666666667
300074.0,6,6,412,4,272,100024.66666666669,74.0,68.0,2,140,0.0,74.0,70.0
105017583.0,17,14,1126,7,563,17500172.333333332,174.0,80.42857142857143,7,563,17500894.833333332,174.0,80.42857142857143
127006956.0,17,15,907,8,475,18143850.85714286,174.0,59.375,7,432,17833537.833333332,174.0,61.71428571428572
108103114.0,17,5,955,5,955,27025778.5,191.0,191.0,0,0,0.0,0.0,0.0
117836401.0,6,53,4494,30,2493,4063324.172413793,123.0,83.1,23,2001,5346376.454545454,123.0,87.0
135142827.0,17,6,1206,6,1206,27028565.4,201.0,201.0,0,0,0.0,0.0,0.0
1767981.0,6,2,132,1,66,0.0,66.0,66.0,1,66,0.0,66.0,66.0
9937.0,6,10,1065,5,534,2262.0,262.0,106.8,5,531,2144.0,259.0,106.2
121125297.0,6,26,2019,12,935,11011390.636363637,95.0,77.91666666666667,14,1084,6991426.692307692,95.0,77.42857142857143
119665.0,6,12,1320,7,789,19944.166666666668,253.0,112.71428571428572,5,531,26714.75,259.0,106.2
14280168.0,17,6,653,6,653,2856033.6,122.0,108.83333333333331,0,0,0.0,0.0,0.0
6550.0,17,2,582,1,83,0.0,83.0,83.0,1,499,0.0,499.0,499.0
29674.0,6,10,2032,5,524,5748.0,252.0,104.8,5,1508,6630.25,1236.0,301.6
106830.0,17,2,286,2,286,0.0,143.0,143.0,0,0,0.0,0.0,0.0
216469.0,17,2,180,1,90,0.0,90.0,90.0,1,90,0.0,90.0,90.0
27463307.0,17,5,1710,5,1710,6865826.75,342.0,342.0,0,0,0.0,0.0,0.0
1180974.0,6,13,3000,8,2372,168710.57142857142,1514.0,296.5,5,628,227109.5,331.0,125.6
1158723.0,6,13,3010,8,2382,165531.85714285713,1514.0,297.75,5,628,220761.75,331.0,125.6
0.0,17,1,350,1,350,0.0,350.0,350.0,0,0,0.0,0.0,0.0
90252102.0,6,13,2036,8,1016,12893157.42857143,188.0,127.0,5,1020,22521867.25,204.0,204.0
120000026.0,6,17,1287,9,691,15000003.25,95.0,76.77777777777777,8,596,12898913.57142857,95.0,74.5
119001076.0,17,13,821,7,432,19833512.666666668,174.0,61.71428571428572,6,389,19916401.2,174.0,64.83333333333333
108104745.0,17,5,1005,5,1005,27026186.25,201.0,201.0,0,0,0.0,0.0,0.0
110168683.0,6,27,1806,14,966,8457908.846153846,123.0,69.0,13,840,9162594.833333334,123.0,64.61538461538461
29656.0,6,14,4740,7,653,4827.5,249.0,93.28571428571428,7,4087,4360.166666666667,1514.0,583.8571428571429
35825.0,6,14,4740,7,653,5781.666666666667,249.0,93.28571428571428,7,4087,5832.666666666667,1514.0,583.8571428571429
10036.0,6,10,1949,5,441,2295.75,169.0,88.2,5,1508,2253.25,1236.0,301.6
105332320.0,6,28,1860,14,966,8085887.692307692,123.0,69.0,14,894,8085876.0,123.0,63.85714285714285
759.0,17,4,438,2,148,0.0,74.0,74.0,2,290,0.0,147.0,145.0
90262011.0,6,13,2036,8,1016,12894573.0,188.0,127.0,5,1020,22524080.0,204.0,204.0
48228.0,6,12,1413,6,816,9443.2,291.0,136.0,6,597,7627.4,259.0,99.5
24295.0,6,10,2032,5,524,5581.25,252.0,104.8,5,1508,5750.75,1236.0,301.6
128346.0,17,2,286,2,286,0.0,143.0,143.0,0,0,0.0,0.0,0.0
27236.0,6,13,4416,6,409,5299.6,127.0,68.16666666666667,7,4007,4313.333333333333,1514.0,572.4285714285714
50333.0,6,10,2032,5,524,12305.5,252.0,104.8,5,1508,11595.5,1236.0,301.6
90927675.0,6,21,1585,11,840,9091759.0,95.0,76.36363636363636,10,745,10102491.0,95.0,74.5
228331.0,17,2,180,1,90,0.0,90.0,90.0,1,90,0.0,90.0,90.0
100678569.0,17,12,516,6,258,20000865.2,43.0,43.0,6,258,20000163.0,43.0,43.0
113731225.0,6,46,3036,23,1518,5155418.227272728,66.0,66.0,23,1518,5155417.863636363,66.0,66.0
117001126.0,17,15,1169,8,606,16714446.57142857,174.0,75.75,7,563,16167493.666666666,174.0,80.42857142857143
119696927.0,6,216,24436,108,17000,1116652.2990654206,284.0,157.40740740740742,108,7436,1116652.261682243,140.0,68.85185185185185
300.0,17,2,164,1,82,0.0,82.0,82.0,1,82,0.0,82.0,82.0
13616345.0,6,20,1607,10,975,1479449.4444444445,315.0,97.5,10,632,1479410.4444444445,78.0,63.2
167777.0,17,2,414,1,88,0.0,88.0,88.0,1,326,0.0,326.0,326.0
102899.0,17,2,286,2,286,0.0,143.0,143.0,0,0,0.0,0.0,0.0
90328133.0,6,17,1287,9,691,11281892.125,95.0,76.77777777777777,8,596,12837076.42857143,95.0,74.5
298427.0,6,6,412,4,272,99475.66666666669,74.0,68.0,2,140,0.0,74.0,70.0
224331.0,17,2,414,1,88,0.0,88.0,88.0,1,326,0.0,326.0,326.0
95839831.0,6,185,20826,93,6360,1041737.2934782607,140.0,68.38709677419355,92,14466,1042939.89010989,284.0,157.2391304347826
32497.0,17,4,820,2,156,0.0,78.0,78.0,2,664,0.0,332.0,332.0
320911.0,6,10,1221,6,636,64182.2,298.0,106.0,4,585,99278.66666666669,379.0,146.25
108792.0,17,2,286,2,286,0.0,143.0,143.0,0,0,0.0,0.0,0.0
131001128.0,17,16,1212,9,649,16375141.0,174.0,72.11111111111111,7,563,18367576.83333333,174.0,80.42857142857143
309022.0,6,6,412,4,272,103007.33333333331,74.0,68.0,2,140,0.0,74.0,70.0
108101432.0,17,5,955,5,955,27025358.0,191.0,191.0,0,0,0.0,0.0,0.0
12279.0,6,11,2098,6,590,2163.6,252.0,98.33333333333331,5,1508,2773.5,1236.0,301.6
911.0,17,5,550,5,550,227.75,110.0,110.0,0,0,0.0,0.0,0.0
90529753.0,6,13,2036,8,1016,12932821.857142856,188.0,127.0,5,1020,22591809.0,204.0,204.0
75135392.0,6,9,842,9,842,9391924.0,97.0,93.55555555555556,0,0,0.0,0.0,0.0
52718.0,6,14,4740,7,653,8522.0,249.0,93.28571428571428,7,4087,8628.666666666666,1514.0,583.8571428571429
5833816.0,6,4,270,2,134,0.0,68.0,67.0,2,136,0.0,70.0,68.0
7077.0,17,2,582,1,83,0.0,83.0,83.0,1,499,0.0,499.0,499.0
120557722.0,6,227,25690,113,7754,1050662.7589285714,140.0,68.61946902654867,114,17936,1066795.6548672563,284.0,157.33333333333334
10474567.0,6,7,478,4,272,3446408.333333333,74.0,68.0,3,206,5169551.0,74.0,68.66666666666667
201485.0,17,2,180,1,90,0.0,90.0,90.0,1,90,0.0,90.0,90.0
206508.0,17,2,180,1,90,0.0,90.0,90.0,1,90,0.0,90.0,90.0
327.0,17,2,208,1,72,0.0,72.0,72.0,1,136,0.0,136.0,136.0
6978.0,17,2,582,1,83,0.0,83.0,83.0,1,499,0.0,499.0,499.0
50063593.0,17,147,9460,73,4699,693160.8194444445,106.0,64.36986301369863,74,4761,685756.9863013698,106.0,64.33783783783784
123418257.0,6,48,3168,24,1584,5112848.217391305,66.0,66.0,24,1584,5188814.434782608,66.0,66.0
1302508.0,6,4,264,2,132,0.0,66.0,66.0,2,132,0.0,66.0,66.0
90299621.0,6,21,1585,11,840,9025330.2,95.0,76.36363636363636,10,745,10001269.222222222,95.0,74.5
211066.0,6,3,426,2,280,0.0,214.0,140.0,1,146,0.0,146.0,146.0
211237.0,17,2,180,1,90,0.0,90.0,90.0,1,90,0.0,90.0,90.0
29525.0,6,14,4740,7,653,4794.0,249.0,93.28571428571428,7,4087,4781.166666666667,1514.0,583.8571428571429
108105359.0,17,5,955,5,955,27026339.75,191.0,191.0,0,0,0.0,0.0,0.0
135130108.0,17,6,1146,6,1146,27026021.6,191.0,191.0,0,0,0.0,0.0,0.0
2017.0,17,4,344,2,150,0.0,75.0,75.0,2,194,0.0,103.0,97.0
51222.0,6,14,4740,7,653,7875.0,249.0,93.28571428571428,7,4087,7857.5,1514.0,583.8571428571429
246823.0,6,3,373,2,238,0.0,172.0,119.0,1,135,0.0,135.0,135.0
14985.0,17,2,180,1,90,0.0,90.0,90.0,1,90,0.0,90.0,90.0
32518.0,6,14,4740,7,653,5248.5,249.0,93.28571428571428,7,4087,4861.666666666667,1514.0,583.8571428571429
205594.0,17,4,6056,4,6056,68531.33333333333,1514.0,1514.0,0,0,0.0,0.0,0.0
15001.0,6,14,4740,7,653,2357.5,249.0,93.28571428571428,7,4087,2301.833333333333,1514.0,583.8571428571429
2596193.0,6,2,132,1,66,0.0,66.0,66.0,1,66,0.0,66.0,66.0
119925419.0,6,34,2419,17,1194,7495310.625,123.0,70.23529411764706,17,1225,7495243.75,139.0,72.05882352941177
202868.0,17,4,6056,4,6056,67622.66666666667,1514.0,1514.0,0,0,0.0,0.0,0.0
147830.0,17,2,180,1,90,0.0,90.0,90.0,1,90,0.0,90.0,90.0
202848.0,17,2,180,1,90,0.0,90.0,90.0,1,90,0.0,90.0,90.0
14631330.0,6,20,1607,10,975,1592448.4444444445,315.0,97.5,10,632,1592413.2222222222,78.0,63.2
1681633.0,6,23,6509,12,1529,152875.72727272726,357.0,127.41666666666669,11,4980,138244.9,1510.0,452.7272727272728
77470.0,6,14,4740,7,653,11879.5,249.0,93.28571428571428,7,4087,12175.5,1514.0,583.8571428571429
529196.0,17,6,2100,6,2100,105839.2,350.0,350.0,0,0,0.0,0.0,0.0
2464.0,17,2,762,2,762,0.0,381.0,381.0,0,0,0.0,0.0,0.0
100368.0,17,2,762,2,762,0.0,381.0,381.0,0,0,0.0,0.0,0.0
107298.0,17,2,286,2,286,0.0,143.0,143.0,0,0,0.0,0.0,0.0
5827537.0,6,4,270,2,134,0.0,68.0,67.0,2,136,0.0,70.0,68.0
298.0,17,2,156,1,78,0.0,78.0,78.0,1,78,0.0,78.0,78.0
217653.0,6,3,426,2,280,0.0,214.0,140.0,1,146,0.0,146.0,146.0
118000844.0,17,14,864,7,432,19666807.33333333,174.0,61.71428571428572,7,432,19501162.83333333,174.0,61.71428571428572
1280425.0,17,7,490,7,490,213404.16666666663,70.0,70.0,0,0,0.0,0.0,0.0
232576.0,6,3,337,2,214,0.0,160.0,107.0,1,123,0.0,123.0,123.0
40574.0,6,10,2032,5,524,9709.5,252.0,104.8,5,1508,9308.5,1236.0,301.6
8142.999999999999,6,10,2032,5,524,1803.0,252.0,104.8,5,1508,1755.5,1236.0,301.6
2453.0,17,4,344,2,150,0.0,75.0,75.0,2,194,0.0,103.0,97.0
232774.0,6,3,337,2,214,0.0,160.0,107.0,1,123,0.0,123.0,123.0
303131.0,6,2,132,1,66,0.0,66.0,66.0,1,66,0.0,66.0,66.0
94220119.0,17,12,778,6,389,18812240.8,174.0,64.83333333333333,6,389,18760941.6,174.0,64.83333333333333
51164.0,6,11,2098,6,590,9326.0,252.0,98.33333333333331,5,1508,9521.75,1236.0,301.6
5824156.0,6,5,336,2,134,0.0,68.0,67.0,3,202,1525922.0,70.0,67.33333333333333
135136562.0,17,6,1206,6,1206,27027312.4,201.0,201.0,0,0,0.0,0.0,0.0
166857.0,17,2,180,1,90,0.0,90.0,90.0,1,90,0.0,90.0,90.0
120076247.0,17,28,13364,28,13364,4447268.407407408,501.0,477.2857142857143,0,0,0.0,0.0,0.0
1307668.0,6,4,264,2,132,0.0,66.0,66.0,2,132,0.0,66.0,66.0
90365544.0,6,14,2256,7,1428,15060599.666666666,204.0,204.0,7,828,15060454.166666666,188.0,118.28571428571428
203420.0,6,12,1373,7,714,33903.333333333336,298.0,102.0,5,659,49958.25,379.0,131.8
322626.0,6,6,412,4,272,107542.0,74.0,68.0,2,140,0.0,74.0,70.0
10936243.0,6,8,544,4,272,3600076.333333333,74.0,68.0,4,272,3599974.0,74.0,68.0
166704.0,17,2,180,1,90,0.0,90.0,90.0,1,90,0.0,90.0,90.0
437377.0,6,11,1021,6,444,59622.2,162.0,74.0,5,577,73279.25,349.0,115.4
9628.0,17,2,571,1,86,0.0,86.0,86.0,1,485,0.0,485.0,485.0
316965.0,17,4,1400,4,1400,105655.0,350.0,350.0,0,0,0.0,0.0,0.0
153403.0,17,2,180,1,90,0.0,90.0,90.0,1,90,0.0,90.0,90.0
1237395.0,6,10,1334,6,797,247479.0,459.0,132.83333333333334,4,537,321556.0,331.0,134.25
120035483.0,17,28,13364,28,13364,4445758.62962963,501.0,477.2857142857143,0,0,0.0,0.0,0.0
209598.0,6,3,426,2,280,0.0,214.0,140.0,1,146,0.0,146.0,146.0
454834.0,17,6,1230,3,234,227229.5,78.0,78.0,3,996,227219.0,332.0,332.0
108105404.0,17,5,1005,5,1005,27026351.0,201.0,201.0,0,0,0.0,0.0,0.0
317.0,17,2,174,1,79,0.0,79.0,79.0,1,95,0.0,95.0,95.0
2054.0,17,4,344,2,150,0.0,75.0,75.0,2,194,0.0,103.0,97.0
238635.0,6,3,337,2,214,0.0,160.0,107.0,1,123,0.0,123.0,123.0
135141664.0,17,6,1146,6,1146,27028332.8,191.0,191.0,0,0,0.0,0.0,0.0
3332.0,17,4,344,2,150,0.0,75.0,75.0,2,194,0.0,103.0,97.0
90261213.0,6,12,1832,8,1016,12894459.0,188.0,127.0,4,816,30032034.666666668,204.0,204.0
10458472.0,6,7,478,4,272,3440657.0,74.0,68.0,3,206,5160884.5,74.0,68.66666666666667
120443532.0,6,201,22692,101,15796,1204435.32,284.0,156.3960396039604,100,6896,1206273.464646465,140.0,68.96
108107196.0,17,5,955,5,955,27026799.0,191.0,191.0,0,0,0.0,0.0,0.0
122978045.0,6,48,3168,24,1584,4987940.608695652,66.0,66.0,24,1584,5279265.478260869,66.0,66.0
133899.0,6,2,132,1,66,0.0,66.0,66.0,1,66,0.0,66.0,66.0
90051112.0,17,28,13364,28,13364,3335226.3703703703,501.0,477.2857142857143,0,0,0.0,0.0,0.0
209603.0,17,2,180,1,90,0.0,90.0,90.0,1,90,0.0,90.0,90.0
39193.0,6,14,4740,7,653,6414.333333333333,249.0,93.28571428571428,7,4087,5425.5,1514.0,583.8571428571429
69181.0,17,2,604,1,75,0.0,75.0,75.0,1,529,0.0,529.0,529.0
90058354.0,17,28,13364,28,13364,3335494.592592593,501.0,477.2857142857143,0,0,0.0,0.0,0.0
104702.0,17,2,700,2,700,0.0,350.0,350.0,0,0,0.0,0.0,0.0
119312504.0,6,221,24934,111,7622,1084659.1272727272,140.0,68.66666666666667,110,17312,1085137.5963302753,284.0,157.38181818181818
1302468.0,6,4,264,2,132,0.0,66.0,66.0,2,132,0.0,66.0,66.0
299106.0,6,6,412,4,272,99702.0,74.0,68.0,2,140,0.0,74.0,70.0
2797994.0,6,2,132,1,66,0.0,66.0,66.0,1,66,0.0,66.0,66.0
97266.0,17,2,762,2,762,0.0,381.0,381.0,0,0,0.0,0.0,0.0
68681.0,6,14,4740,7,653,11249.666666666666,249.0,93.28571428571428,7,4087,11310.333333333334,1514.0,583.8571428571429
508611.00000000006,17,2,363,1,75,0.0,75.0,75.0,1,288,0.0,288.0,288.0
29411.0,6,10,1913,5,461,7108.25,233.0,92.2,5,1452,6783.5,1224.0,290.4
1038068.0,6,11,1134,6,558,207613.6,220.0,93.0,5,576,256710.0,304.0,115.2
90949608.0,6,21,1585,11,840,9093822.1,95.0,76.36363636363636,10,745,10105062.222222222,95.0,74.5
124794958.0,6,34,2350,17,1125,7175505.625,123.0,66.17647058823529,17,1225,7175479.125,139.0,72.05882352941177
25385.0,6,14,4740,7,653,3874.6666666666665,249.0,93.28571428571428,7,4087,4029.5,1514.0,583.8571428571429
53814.0,6,14,4740,7,653,7531.833333333333,249.0,93.28571428571428,7,4087,8797.5,1514.0,583.8571428571429
110704.0,17,2,762,2,762,0.0,381.0,381.0,0,0,0.0,0.0,0.0
8718940.0,6,5,1736,3,917,4287678.0,785.0,305.6666666666667,2,819,0.0,753.0,409.5
101359779.0,17,14,1126,7,563,16893296.5,174.0,80.42857142857143,7,563,16839158.333333332,174.0,80.42857142857143
37712.0,6,14,4740,7,653,6131.333333333333,249.0,93.28571428571428,7,4087,5729.5,1514.0,583.8571428571429
198043.0,17,2,180,1,90,0.0,90.0,90.0,1,90,0.0,90.0,90.0
250052.0,6,3,337,2,214,0.0,160.0,107.0,1,123,0.0,123.0,123.0
211327.0,6,10,1221,6,636,42265.4,298.0,106.0,4,585,69154.66666666667,379.0,146.25
111059035.0,17,14,864,7,432,18501016.666666668,174.0,61.71428571428572,7,432,18500167.166666668,174.0,61.71428571428572
309536.0,17,4,1400,4,1400,103178.66666666669,350.0,350.0,0,0,0.0,0.0,0.0
32844.0,6,10,2032,5,524,7990.25,252.0,104.8,5,1508,7924.0,1236.0,301.6
152360.0,17,2,414,1,88,0.0,88.0,88.0,1,326,0.0,326.0,326.0
116409414.0,17,16,1212,8,606,16572271.285714284,174.0,75.75,8,606,16571557.142857144,174.0,75.75
27191.0,17,2,180,1,90,0.0,90.0,90.0,1,90,0.0,90.0,90.0
135131188.0,17,6,1206,6,1206,27026237.6,201.0,201.0,0,0,0.0,0.0,0.0
220532.0,17,2,180,1,90,0.0,90.0,90.0,1,90,0.0,90.0,90.0
283529.0,17,4,704,2,148,0.0,74.0,74.0,2,556,0.0,280.0,278.0
119559222.0,6,22,1639,11,799,11955922.2,95.0,72.63636363636364,11,840,9025864.1,95.0,76.36363636363636
104898.0,17,2,700,2,700,0.0,350.0,350.0,0,0,0.0,0.0,0.0
100764046.0,6,30,2260,16,1228,6703193.8,139.0,76.75,14,1032,7734469.076923077,123.0,73.71428571428571
119959466.0,6,12,1832,4,816,30030195.33333333,204.0,204.0,8,1016,17136738.285714287,188.0,127.0
123250546.0,6,49,3234,25,1650,5135439.416666667,66.0,66.0,24,1584,4977973.0869565215,66.0,66.0
1103445.0,6,13,1394,7,797,183907.5,253.0,113.85714285714286,6,597,218672.0,259.0,99.5
69602.0,6,14,4740,7,653,11304.5,249.0,93.28571428571428,7,4087,10911.833333333334,1514.0,583.8571428571429
44327.0,6,14,4740,7,653,6962.666666666667,249.0,93.28571428571428,7,4087,7198.833333333333,1514.0,583.8571428571429
120061389.0,17,28,13364,28,13364,4446718.111111111,501.0,477.2857142857143,0,0,0.0,0.0,0.0
84.0,17,2,762,2,762,0.0,381.0,381.0,0,0,0.0,0.0,0.0
14414.0,6,14,4740,7,653,2146.333333333333,249.0,93.28571428571428,7,4087,2271.833333333333,1514.0,583.8571428571429
2111537.0,6,25,7610,13,2516,175487.33333333334,1034.0,193.53846153846155,12,5094,164551.0,1510.0,424.5
205865.0,6,3,426,2,280,0.0,214.0,140.0,1,146,0.0,146.0,146.0
35210.0,6,14,4740,7,653,5572.5,249.0,93.28571428571428,7,4087,5254.5,1514.0,583.8571428571429
298226.0,6,6,412,4,272,99408.66666666669,74.0,68.0,2,140,0.0,74.0,70.0
1302323.0,6,4,264,2,132,0.0,66.0,66.0,2,132,0.0,66.0,66.0
51030.0,17,2,180,1,90,0.0,90.0,90.0,1,90,0.0,90.0,90.0
90057353.0,17,27,12943,27,12943,3463744.346153846,501.0,479.3703703703704,0,0,0.0,0.0,0.0
135115811.0,17,6,1146,6,1146,27023162.2,191.0,191.0,0,0,0.0,0.0,0.0
34513.0,6,14,4740,7,653,5626.333333333333,249.0,93.28571428571428,7,4087,5233.333333333333,1514.0,583.8571428571429
951.0,17,2,508,2,508,0.0,257.0,254.0,0,0,0.0,0.0,0.0
18285.0,6,11,2098,6,590,3469.8,252.0,98.33333333333331,5,1508,4010.0,1236.0,301.6
120019273.0,6,25,1924,14,1084,9230760.692307692,95.0,77.42857142857143,11,840,11953724.4,95.0,76.36363636363636
48311.0,6,14,4740,7,653,7903.5,249.0,93.28571428571428,7,4087,7830.333333333333,1514.0,583.8571428571429
90101313.0,6,15,2180,7,1164,15016490.5,204.0,166.28571428571428,8,1016,12871284.0,188.0,127.0
171480.0,17,2,180,1,90,0.0,90.0,90.0,1,90,0.0,90.0,90.0
20983.0,6,11,2098,6,590,3841.0,252.0,98.33333333333331,5,1508,4658.75,1236.0,301.6
127251036.0,17,14,864,7,432,18000159.0,174.0,61.71428571428572,7,432,18167389.5,174.0,61.71428571428572
318.0,17,2,174,1,79,0.0,79.0,79.0,1,95,0.0,95.0,95.0
90522962.0,6,13,2036,8,1016,12931851.714285716,188.0,127.0,5,1020,22589295.5,204.0,204.0
29248.0,6,14,4740,7,653,4455.0,249.0,93.28571428571428,7,4087,4077.3333333333335,1514.0,583.8571428571429
2381.0,17,4,344,2,150,0.0,75.0,75.0,2,194,0.0,103.0,97.0
327.0,17,2,166,1,75,0.0,75.0,75.0,1,91,0.0,91.0,91.0
108117887.0,17,5,1005,5,1005,27029471.75,201.0,201.0,0,0,0.0,0.0,0.0
238141.0,6,3,337,2,214,0.0,160.0,107.0,1,123,0.0,123.0,123.0
2341.0,17,4,344,2,150,0.0,75.0,75.0,2,194,0.0,103.0,97.0
45363.0,6,14,4740,7,653,7342.5,249.0,93.28571428571428,7,4087,5196.333333333333,1514.0,583.8571428571429
49658.0,6,14,4740,7,653,7145.833333333333,249.0,93.28571428571428,7,4087,7644.166666666667,1514.0,583.8571428571429
0.0,17,1,55,1,55,0.0,55.0,55.0,0,0,0.0,0.0,0.0
118049616.0,6,32,2236,16,1165,7869974.4,139.0,72.8125,16,1071,7855565.333333333,123.0,66.9375
2698570.0,6,2,132,1,66,0.0,66.0,66.0,1,66,0.0,66.0,66.0
217892.0,6,3,426,2,280,0.0,214.0,140.0,1,146,0.0,146.0,146.0
33954.0,6,14,4740,7,653,5131.5,249.0,93.28571428571428,7,4087,5466.833333333333,1514.0,583.8571428571429
303835.0,6,6,412,4,272,101278.33333333331,74.0,68.0,2,140,0.0,74.0,70.0
5034120.0,6,5,1736,2,819,0.0,753.0,409.5,3,917,2444113.0,785.0,305.6666666666667
9694.0,17,2,571,1,86,0.0,86.0,86.0,1,485,0.0,485.0,485.0
2352.0,17,4,344,2,150,0.0,75.0,75.0,2,194,0.0,103.0,97.0
90256999.0,6,12,1832,8,1016,12893857.0,188.0,127.0,4,816,30020300.0,204.0,204.0
90246831.0,6,14,2240,8,1016,12892404.42857143,188.0,127.0,6,1224,18016646.6,204.0,204.0
135129857.0,17,6,1206,6,1206,27025971.4,201.0,201.0,0,0,0.0,0.0,0.0
135134280.0,17,6,1146,6,1146,27026856.0,191.0,191.0,0,0,0.0,0.0,0.0
340.0,17,2,267,1,83,0.0,83.0,83.0,1,184,0.0,184.0,184.0
794.0,17,5,550,5,550,198.5,110.0,110.0,0,0,0.0,0.0,0.0
426.0,17,2,508,2,508,0.0,257.0,254.0,0,0,0.0,0.0,0.0
206420.0,6,3,426,2,280,0.0,214.0,140.0,1,146,0.0,146.0,146.0
2330.0,17,4,344,2,150,0.0,75.0,75.0,2,194,0.0,103.0,97.0
2797983.0,6,2,132,1,66,0.0,66.0,66.0,1,66,0.0,66.0,66.0
120004103.0,6,19,1436,10,786,13333184.777777778,95.0,78.6,9,650,15000144.5,95.0,72.22222222222223
1048699.0,6,13,1386,7,789,174783.16666666666,253.0,112.71428571428572,6,597,208412.0,259.0,99.5
120307850.0,6,214,24218,107,7358,1097784.8396226414,140.0,68.76635514018692,107,16860,1127226.2547169812,284.0,157.57009345794393
206539.0,6,3,426,2,280,0.0,214.0,140.0,1,146,0.0,146.0,146.0
110970077.0,6,34,2350,17,1225,6922136.75,139.0,72.05882352941177,17,1125,6922136.5,123.0,66.17647058823529
207623.0,17,2,762,2,762,0.0,381.0,381.0,0,0,0.0,0.0,0.0
9545.0,17,2,582,1,83,0.0,83.0,83.0,1,499,0.0,499.0,499.0
333554.0,17,6,2100,6,2100,66710.8,350.0,350.0,0,0,0.0,0.0,0.0
120638296.0,6,259,29924,130,21114,935180.5891472868,284.0,162.41538461538462,129,8810,934375.6640625,140.0,68.29457364341086
362.0,17,2,174,1,79,0.0,79.0,79.0,1,95,0.0,95.0,95.0
92736110.0,6,38,2508,19,1254,5151992.277777778,66.0,66.0,19,1254,5151991.611111111,66.0,66.0
119808000.0,6,20,1490,10,745,13312000.0,95.0,74.5,10,745,13284722.111111112,95.0,74.5
25898.0,6,14,4740,7,653,3750.1666666666665,249.0,93.28571428571428,7,4087,4101.666666666667,1514.0,583.8571428571429
123610598.0,6,49,3234,25,1650,5150441.583333333,66.0,66.0,24,1584,4959256.347826087,66.0,66.0
21926.0,6,14,4740,7,653,3538.6666666666665,249.0,93.28571428571428,7,4087,3393.833333333333,1514.0,583.8571428571429
51762.0,6,14,4740,7,653,8450.333333333334,249.0,93.28571428571428,7,4087,8354.833333333334,1514.0,583.8571428571429
123670482.0,6,49,3234,25,1650,5152936.75,66.0,66.0,24,1584,5013543.652173913,66.0,66.0
3549.0,17,2,334,1,79,0.0,79.0,79.0,1,255,0.0,255.0,255.0
3115806.0,6,3,1777,1,826,0.0,826.0,826.0,2,951,0.0,885.0,475.5
51078.0,17,2,180,1,90,0.0,90.0,90.0,1,90,0.0,90.0,90.0
35011.0,6,10,2032,5,524,7785.5,252.0,104.8,5,1508,8049.0,1236.0,301.6
205800.0,6,3,426,2,280,0.0,214.0,140.0,1,146,0.0,146.0,146.0
90254756.0,6,14,2240,8,1016,12893536.57142857,188.0,127.0,6,1224,18018384.6,204.0,204.0
38273.0,6,10,2032,5,524,9344.0,252.0,104.8,5,1508,9111.0,1236.0,301.6
48026.0,6,10,2032,5,524,11645.0,252.0,104.8,5,1508,11011.5,1236.0,301.6
103804.0,17,2,286,2,286,0.0,143.0,143.0,0,0,0.0,0.0,0.0
2597107.0,6,2,132,1,66,0.0,66.0,66.0,1,66,0.0,66.0,66.0
765393.0,6,6,758,3,410,290157.5,172.0,136.66666666666666,3,348,266858.0,135.0,116.0
1026846.0,6,11,1134,6,558,205369.2,220.0,93.0,5,576,254101.0,304.0,115.2
2801092.0,6,2,132,1,66,0.0,66.0,66.0,1,66,0.0,66.0,66.0
6674.0,17,2,180,1,90,0.0,90.0,90.0,1,90,0.0,90.0,90.0
2335.0,17,4,344,2,150,0.0,75.0,75.0,2,194,0.0,103.0,97.0
204321.0,17,4,6056,4,6056,68107.0,1514.0,1514.0,0,0,0.0,0.0,0.0
90016081.0,17,27,12943,27,12943,3462156.961538461,501.0,479.3703703703704,0,0,0.0,0.0,0.0
103510490.0,6,28,1860,14,966,7945728.846153846,123.0,69.0,14,894,7945732.076923077,123.0,63.85714285714285
154564.0,17,2,180,1,90,0.0,90.0,90.0,1,90,0.0,90.0,90.0
116170048.0,17,14,1126,7,563,19361674.666666668,174.0,80.42857142857143,7,563,19237544.0,174.0,80.42857142857143
209653.0,17,2,180,1,90,0.0,90.0,90.0,1,90,0.0,90.0,90.0
104178273.0,17,14,864,7,432,17334476.5,174.0,61.71428571428572,7,432,17333499.333333332,174.0,61.71428571428572
0.0,17,1,72,1,72,0.0,72.0,72.0,0,0,0.0,0.0,0.0
90038218.0,17,27,12943,27,12943,3463008.3846153845,501.0,479.3703703703704,0,0,0.0,0.0,0.0
90052579.0,17,28,13364,28,13364,3335280.703703704,501.0,477.2857142857143,0,0,0.0,0.0,0.0
103280.0,17,2,286,2,286,0.0,143.0,143.0,0,0,0.0,0.0,0.0
9903839.0,6,16,1131,8,586,1414535.4285714286,95.0,73.25,8,545,1374953.7142857143,95.0,68.125
19264.0,6,14,4740,7,653,3012.1666666666665,249.0,93.28571428571428,7,4087,2984.833333333333,1514.0,583.8571428571429
315338.0,6,2,132,1,66,0.0,66.0,66.0,1,66,0.0,66.0,66.0
341.0,17,2,267,1,83,0.0,83.0,83.0,1,184,0.0,184.0,184.0
108103888.0,17,5,1005,5,1005,27025972.0,201.0,201.0,0,0,0.0,0.0,0.0
90262428.0,6,14,2240,8,1016,12894632.57142857,188.0,127.0,6,1224,18019043.4,204.0,204.0
314712.0,17,4,1400,4,1400,104904.0,350.0,350.0,0,0,0.0,0.0,0.0
1306974.0,6,4,264,2,132,0.0,66.0,66.0,2,132,0.0,66.0,66.0
234854.0,6,3,337,2,214,0.0,160.0,107.0,1,123,0.0,123.0,123.0
111338064.0,6,32,2236,16,1165,7408139.8,139.0,72.8125,16,1071,7408132.466666667,123.0,66.9375
235624.0,6,3,337,2,214,0.0,160.0,107.0,1,123,0.0,123.0,123.0
3196589.0,17,4,1812,4,1812,1065529.6666666667,453.0,453.0,0,0,0.0,0.0,0.0
15927495.0,17,6,2052,6,2052,3185499.0,342.0,342.0,0,0,0.0,0.0,0.0
299436.0,17,2,363,1,79,0.0,79.0,79.0,1,284,0.0,284.0,284.0
90984128.0,6,21,1585,11,840,9095563.4,95.0,76.36363636363636,10,745,10107817.444444444,95.0,74.5
925.0,17,5,550,5,550,231.25,110.0,110.0,0,0,0.0,0.0,0.0
137797.0,6,2,132,1,66,0.0,66.0,66.0,1,66,0.0,66.0,66.0
298235.0,6,6,412,4,272,99411.66666666669,74.0,68.0,2,140,0.0,74.0,70.0
5701.0,17,4,344,2,150,0.0,75.0,75.0,2,194,0.0,103.0,97.0
2948193.0,6,20,6935,11,1567,294819.3,408.0,142.45454545454547,9,5368,307116.5,1514.0,596.4444444444445
48269.0,6,14,4740,7,653,7826.333333333333,249.0,93.28571428571428,7,4087,7903.833333333333,1514.0,583.8571428571429
20151.0,6,14,4740,7,653,3020.0,249.0,93.28571428571428,7,4087,3225.333333333333,1514.0,583.8571428571429
1991.0,17,4,344,2,150,0.0,75.0,75.0,2,194,0.0,103.0,97.0
144100.0,17,2,180,1,90,0.0,90.0,90.0,1,90,0.0,90.0,90.0
371.0,17,2,762,2,762,0.0,381.0,381.0,0,0,0.0,0.0,0.0
0.0,6,1,66,1,66,0.0,66.0,66.0,0,0,0.0,0.0,0.0
210100.0,6,10,1221,6,636,42020.0,298.0,106.0,4,585,68594.0,379.0,146.25
108106872.0,17,5,955,5,955,27026718.0,191.0,191.0,0,0,0.0,0.0,0.0
93042144.0,17,16,5472,16,5472,6202809.6,342.0,342.0,0,0,0.0,0.0,0.0
112793064.0,6,33,2296,17,1225,7036066.5625,139.0,72.05882352941177,16,1071,7505136.466666667,123.0,66.9375
154152.0,17,2,180,1,90,0.0,90.0,90.0,1,90,0.0,90.0,90.0
4803106.0,6,5,336,2,134,0.0,68.0,67.0,3,202,1525803.5,70.0,67.33333333333333
40918694.0,6,8,745,8,745,5845527.714285715,97.0,93.125,0,0,0.0,0.0,0.0
218530.0,6,3,426,2,280,0.0,214.0,140.0,1,146,0.0,146.0,146.0
362409.0,6,11,1021,6,444,48695.6,162.0,74.0,5,577,60603.0,349.0,115.4
2124.0,17,4,344,2,150,0.0,75.0,75.0,2,194,0.0,103.0,97.0
27241.0,6,14,4740,7,653,4363.166666666667,249.0,93.28571428571428,7,4087,3687.6666666666665,1514.0,583.8571428571429
207601.0,6,3,426,2,280,0.0,214.0,140.0,1,146,0.0,146.0,146.0
221687.0,17,2,180,1,90,0.0,90.0,90.0,1,90,0.0,90.0,90.0
213656.0,17,2,180,1,90,0.0,90.0,90.0,1,90,0.0,90.0,90.0
205911.0,6,3,426,2,280,0.0,214.0,140.0,1,146,0.0,146.0,146.0
107815.0,17,2,286,2,286,0.0,143.0,143.0,0,0,0.0,0.0,0.0
110471200.0,6,35,2542,18,1348,6498305.882352941,139.0,74.88888888888889,17,1194,6890909.125,123.0,70.23529411764706
254693.0,6,3,337,2,214,0.0,160.0,107.0,1,123,0.0,123.0,123.0
217781.0,6,3,426,2,280,0.0,214.0,140.0,1,146,0.0,146.0,146.0
72484.0,6,10,2032,5,524,16147.25,252.0,104.8,5,1508,15399.25,1236.0,301.6
120003824.0,6,18,1341,9,691,14999984.375,95.0,76.77777777777777,9,650,14998694.125,95.0,72.22222222222223
0.0,6,1,160,1,160,0.0,160.0,160.0,0,0,0.0,0.0,0.0
103592.0,17,2,286,2,286,0.0,143.0,143.0,0,0,0.0,0.0,0.0
90039239.0,17,27,12943,27,12943,3463047.653846154,501.0,479.3703703703704,0,0,0.0,0.0,0.0
1935.0,17,2,180,1,90,0.0,90.0,90.0,1,90,0.0,90.0,90.0
159132.0,6,2,128,1,74,0.0,74.0,74.0,1,54,0.0,54.0,54.0
308602.0,6,6,412,4,272,102867.33333333331,74.0,68.0,2,140,0.0,74.0,70.0
68351.0,17,2,620,1,75,0.0,75.0,75.0,1,545,0.0,545.0,545.0
24105.0,6,10,2032,5,524,3158.25,252.0,104.8,5,1508,5674.0,1236.0,301.6
18504.0,6,10,2032,5,524,4347.75,252.0,104.8,5,1508,4109.25,1236.0,301.6
135123278.0,17,6,1206,6,1206,27024655.6,201.0,201.0,0,0,0.0,0.0,0.0
43497.0,6,14,4740,7,653,6901.833333333333,249.0,93.28571428571428,7,4087,5453.0,1514.0,583.8571428571429
644039.0,17,4,883,2,156,0.0,78.0,78.0,2,727,0.0,395.0,363.5
97698339.0,6,196,22108,98,6690,998870.2268041236,140.0,68.26530612244898,98,15418,998781.525773196,284.0,157.3265306122449
105438.0,17,2,700,2,700,0.0,350.0,350.0,0,0,0.0,0.0,0.0
204766.0,17,2,762,2,762,0.0,381.0,381.0,0,0,0.0,0.0,0.0
160107.0,17,2,180,1,90,0.0,90.0,90.0,1,90,0.0,90.0,90.0
61626.0,6,14,4740,7,653,8319.0,249.0,93.28571428571428,7,4087,9780.833333333334,1514.0,583.8571428571429
263075.0,6,10,1221,6,636,52615.0,298.0,106.0,4,585,81909.66666666667,379.0,146.25
7015118.0,6,8,602,5,404,1752836.75,103.0,80.8,3,198,156204.0,66.0,66.0
135133323.0,17,6,1206,6,1206,27026664.6,201.0,201.0,0,0,0.0,0.0,0.0
144966.0,17,2,180,1,70,0.0,70.0,70.0,1,110,0.0,110.0,110.0
2113542.0,6,25,7610,13,2516,176072.91666666666,1034.0,193.53846153846155,12,5094,163916.72727272726,1510.0,424.5
233040.0,6,3,337,2,214,0.0,160.0,107.0,1,123,0.0,123.0,123.0
298509.0,6,6,412,4,272,99503.0,74.0,68.0,2,140,0.0,74.0,70.0
36405.0,6,14,4740,7,653,5319.5,249.0,93.28571428571428,7,4087,5799.833333333333,1514.0,583.8571428571429
14749789.0,6,20,1648,10,1016,1604198.4444444445,315.0,101.6,10,632,1604170.7777777778,78.0,63.2
307.0,17,2,164,1,82,0.0,82.0,82.0,1,82,0.0,82.0,82.0
20560.0,6,14,4740,7,653,2932.0,249.0,93.28571428571428,7,4087,3290.1666666666665,1514.0,583.8571428571429
2048109.0,17,8,1640,4,312,682576.3333333334,78.0,78.0,4,1328,682559.6666666666,332.0,332.0
46000.0,6,10,2032,5,524,11283.5,252.0,104.8,5,1508,8882.5,1236.0,301.6
120355440.0,6,231,26006,116,18120,1046569.0434782607,284.0,156.20689655172413,115,7886,1041725.4736842106,140.0,68.57391304347826
2304.0,17,4,344,2,150,0.0,75.0,75.0,2,194,0.0,103.0,97.0
46793948.0,6,8,2113,3,960,22201883.0,826.0,320.0,5,1153,11234053.0,885.0,230.6
114317090.0,6,349,40920,175,11772,656994.7701149426,140.0,67.26857142857143,174,29148,654850.710982659,464.0,167.51724137931035
1020328.0,6,11,1134,6,558,204065.6,220.0,93.0,5,576,254622.25,304.0,115.2
108105965.0,17,5,955,5,955,27026491.25,191.0,191.0,0,0,0.0,0.0,0.0
206681.0,6,3,426,2,280,0.0,214.0,140.0,1,146,0.0,146.0,146.0
10903965.0,6,8,544,4,272,3589208.0,74.0,68.0,4,272,3589155.0,74.0,68.0
113472146.0,6,210,23646,105,16494,1089009.7403846155,284.0,157.0857142857143,105,7152,1089009.9711538462,140.0,68.11428571428571
90529310.0,6,13,2036,8,1016,12932758.57142857,188.0,127.0,5,1020,22590833.0,204.0,204.0
103619.0,17,2,286,2,286,0.0,143.0,143.0,0,0,0.0,0.0,0.0
228273.0,17,2,180,1,90,0.0,90.0,90.0,1,90,0.0,90.0,90.0
3576338.0,6,5,336,2,134,0.0,68.0,67.0,3,202,1423571.5,70.0,67.33333333333333
5624092.0,6,5,336,2,134,0.0,68.0,67.0,3,202,1522568.0,70.0,67.33333333333333
14983.0,17,2,180,1,90,0.0,90.0,90.0,1,90,0.0,90.0,90.0
31359.0,6,14,4740,7,653,4950.5,249.0,93.28571428571428,7,4087,5018.5,1514.0,583.8571428571429
917237.0,6,12,2715,7,743,152872.83333333334,339.0,106.14285714285714,5,1972,160376.75,1514.0,394.4
224509.0,17,2,414,1,88,0.0,88.0,88.0,1,326,0.0,326.0,326.0
90257089.0,6,12,1832,8,1016,12893869.857142856,188.0,127.0,4,816,30031658.0,204.0,204.0
323110.0,6,3,202,2,128,0.0,74.0,64.0,1,74,0.0,74.0,74.0
42106.0,6,14,4740,7,653,6453.166666666667,249.0,93.28571428571428,7,4087,6707.5,1514.0,583.8571428571429
41846.0,6,10,2032,5,524,10220.25,252.0,104.8,5,1508,9906.75,1236.0,301.6
147988.0,17,2,180,1,90,0.0,90.0,90.0,1,90,0.0,90.0,90.0
10428011.0,6,7,478,4,272,3430691.333333333,74.0,68.0,3,206,5145954.0,74.0,68.66666666666667
316908.0,17,4,704,2,148,0.0,74.0,74.0,2,556,0.0,280.0,278.0
101411902.0,17,14,1126,7,563,16834309.0,174.0,80.42857142857143,7,563,16833535.5,174.0,80.42857142857143
2232.0,17,2,691,1,349,0.0,349.0,349.0,1,342,0.0,342.0,342.0
97071375.0,17,14,1126,7,563,16178562.5,174.0,80.42857142857143,7,563,16103354.666666666,174.0,80.42857142857143
32949.0,6,14,4740,7,653,5076.833333333333,249.0,93.28571428571428,7,4087,5282.5,1514.0,583.8571428571429
46376.0,6,12,1320,7,789,7729.333333333333,253.0,112.71428571428572,5,531,9172.0,259.0,106.2
32378.0,6,10,2032,5,524,5890.75,252.0,104.8,5,1508,7841.0,1236.0,301.6
90255480.0,6,12,1832,8,1016,12893640.0,188.0,127.0,4,816,30031011.0,204.0,204.0
0.0,17,1,44,1,44,0.0,44.0,44.0,0,0,0.0,0.0,0.0
33141.0,6,14,4740,7,653,4918.5,249.0,93.28571428571428,7,4087,5379.666666666667,1514.0,583.8571428571429
317.0,17,2,166,1,75,0.0,75.0,75.0,1,91,0.0,91.0,91.0
47676.0,6,14,4740,7,653,7546.166666666667,249.0,93.28571428571428,7,4087,7620.5,1514.0,583.8571428571429
284950.0,17,2,363,1,79,0.0,79.0,79.0,1,284,0.0,284.0,284.0
4356.0,17,2,614,1,72,0.0,72.0,72.0,1,542,0.0,542.0,542.0
49910.0,6,14,4740,7,653,8118.166666666667,249.0,93.28571428571428,7,4087,6512.166666666667,1514.0,583.8571428571429
691662.0,6,6,758,3,410,300996.0,172.0,136.66666666666666,3,348,229984.0,135.0,116.0
362195.0,6,11,1021,6,444,48730.8,162.0,74.0,5,577,60707.5,349.0,115.4
108110460.0,17,5,955,5,955,27027615.0,191.0,191.0,0,0,0.0,0.0,0.0
42241.0,6,14,4740,7,653,6731.666666666667,249.0,93.28571428571428,7,4087,5916.666666666667,1514.0,583.8571428571429
844.0,17,5,550,5,550,211.0,110.0,110.0,0,0,0.0,0.0,0.0
114918.0,17,2,286,2,286,0.0,143.0,143.0,0,0,0.0,0.0,0.0
207007.0,6,3,426,2,280,0.0,214.0,140.0,1,146,0.0,146.0,146.0
108107964.0,17,5,955,5,955,27026991.0,191.0,191.0,0,0,0.0,0.0,0.0
286664.0,6,10,1221,6,636,57332.8,298.0,106.0,4,585,89791.66666666667,379.0,146.25
106288.0,17,2,286,2,286,0.0,143.0,143.0,0,0,0.0,0.0,0.0
135135579.0,17,6,1206,6,1206,27027115.8,201.0,201.0,0,0,0.0,0.0,0.0
135135422.0,17,6,1206,6,1206,27027084.4,201.0,201.0,0,0,0.0,0.0,0.0
121453824.0,6,227,25606,114,17914,1074812.6017699116,284.0,157.140350877193,113,7692,1066921.017857143,140.0,68.070796460177
19912.0,6,10,2032,5,524,4760.25,252.0,104.8,5,1508,4399.0,1236.0,301.6
2420.0,17,4,344,2,150,0.0,75.0,75.0,2,194,0.0,103.0,97.0
205939.0,17,2,180,1,90,0.0,90.0,90.0,1,90,0.0,90.0,90.0
113520314.0,6,46,3036,23,1518,5160002.136363637,66.0,66.0,23,1518,5160002.818181818,66.0,66.0
316247.0,17,4,1400,4,1400,105415.66666666669,350.0,350.0,0,0,0.0,0.0,0.0
90026660.0,17,28,13364,28,13364,3334320.7407407407,501.0,477.2857142857143,0,0,0.0,0.0,0.0
159988.0,6,3,337,2,214,0.0,160.0,107.0,1,123,0.0,123.0,123.0
2800758.0,6,2,132,1,66,0.0,66.0,66.0,1,66,0.0,66.0,66.0
31071.0,17,2,539,1,86,0.0,86.0,86.0,1,453,0.0,453.0,453.0
204971.0,17,2,180,1,90,0.0,90.0,90.0,1,90,0.0,90.0,90.0
1302690.0,6,4,264,2,132,0.0,66.0,66.0,2,132,0.0,66.0,66.0
26888145.0,17,5,1718,4,1368,915489.6666666666,342.0,342.0,1,350,0.0,350.0,350.0
241671.0,6,3,337,2,214,0.0,160.0,107.0,1,123,0.0,123.0,123.0
143970.0,17,2,180,1,90,0.0,90.0,90.0,1,90,0.0,90.0,90.0
149738664.0,6,18,2622,11,1458,14973866.4,188.0,132.54545454545453,7,1164,19974701.0,204.0,166.28571428571428
1295723.0,6,4,264,2,132,0.0,66.0,66.0,2,132,0.0,66.0,66.0
104952405.0,6,44,2904,22,1452,4997733.571428572,66.0,66.0,22,1452,4981849.095238095,66.0,66.0
228274.0,17,2,180,1,90,0.0,90.0,90.0,1,90,0.0,90.0,90.0
119826378.0,17,34,16284,34,16284,3631102.363636364,501.0,478.9411764705882,0,0,0.0,0.0,0.0
103809.0,17,2,286,2,286,0.0,143.0,143.0,0,0,0.0,0.0,0.0
112535501.0,6,46,3036,23,1518,5105438.909090909,66.0,66.0,23,1518,5105438.045454546,66.0,66.0
10520611.0,6,7,478,4,272,3461387.0,74.0,68.0,3,206,5191966.0,74.0,68.66666666666667
14541.0,6,13,1459,7,862,2423.5,271.0,123.14285714285714,6,597,2495.0,259.0,99.5
135125967.0,17,6,1206,6,1206,27025193.4,201.0,201.0,0,0,0.0,0.0,0.0
90623480.0,6,18,1502,9,852,11327043.625,256.0,94.66666666666669,9,650,11326192.375,95.0,72.22222222222223
108106657.0,17,5,955,5,955,27026664.25,191.0,191.0,0,0,0.0,0.0,0.0
13119.0,6,10,2032,5,524,3117.25,252.0,104.8,5,1508,2893.75,1236.0,301.6
120000012.0,6,32,3720,17,2117,7500000.75,425.0,124.52941176470588,15,1603,7958058.714285715,361.0,106.86666666666666
302396.0,6,2,132,1,66,0.0,66.0,66.0,1,66,0.0,66.0,66.0
2316.0,17,4,344,2,150,0.0,75.0,75.0,2,194,0.0,103.0,97.0
144102.0,17,2,180,1,90,0.0,90.0,90.0,1,90,0.0,90.0,90.0
1647594.0,6,20,6434,12,1921,149781.27272727274,620.0,160.08333333333334,8,4513,191868.8571428572,1514.0,564.125
153432.0,17,2,180,1,90,0.0,90.0,90.0,1,90,0.0,90.0,90.0
135137479.0,17,6,1206,6,1206,27027495.8,201.0,201.0,0,0,0.0,0.0,0.0
90300297.0,6,16,1192,8,596,12893529.142857144,95.0,74.5,8,596,12899261.857142856,95.0,74.5
9326.0,17,2,582,1,83,0.0,83.0,83.0,1,499,0.0,499.0,499.0
301167.0,6,6,412,4,272,100389.0,74.0,68.0,2,140,0.0,74.0,70.0
71501.0,6,14,4740,7,653,11010.833333333334,249.0,93.28571428571428,7,4087,10591.833333333334,1514.0,583.8571428571429
216740.0,6,3,426,2,280,0.0,214.0,140.0,1,146,0.0,146.0,146.0
108102785.0,17,5,1005,5,1005,27025696.25,201.0,201.0,0,0,0.0,0.0,0.0
103856.0,17,2,286,2,286,0.0,143.0,143.0,0,0,0.0,0.0,0.0
113816060.0,6,48,3168,24,1584,4948524.347826087,66.0,66.0,24,1584,4936676.652173913,66.0,66.0
96064602.0,17,14,1126,7,563,15835059.666666666,174.0,80.42857142857143,7,563,15833475.5,174.0,80.42857142857143
120011602.0,6,20,1531,11,881,11999991.5,95.0,80.0909090909091,9,650,15000333.25,95.0,72.22222222222223
108106089.0,17,5,1005,5,1005,27026522.25,201.0,201.0,0,0,0.0,0.0,0.0
37116.0,6,14,4740,7,653,5659.333333333333,249.0,93.28571428571428,7,4087,5722.5,1514.0,583.8571428571429
109007377.0,17,13,821,7,432,18167896.166666668,174.0,61.71428571428572,6,389,17800158.2,174.0,64.83333333333333
1061013.0,17,6,1230,3,234,530316.5,78.0,78.0,3,996,530304.0,332.0,332.0
309281.0,17,4,704,2,148,0.0,74.0,74.0,2,556,0.0,280.0,278.0
13805.0,6,14,4740,7,653,2089.833333333333,249.0,93.28571428571428,7,4087,2162.5,1514.0,583.8571428571429
250320.0,6,10,1221,6,636,50064.0,298.0,106.0,4,585,77642.66666666667,379.0,146.25
3354526.0,6,202,164782,114,154671,29686.07079646017,1510.0,1356.7631578947369,88,10111,34699.5632183908,1510.0,114.89772727272728
207104.0,6,3,426,2,280,0.0,214.0,140.0,1,146,0.0,146.0,146.0
114170684.0,6,48,3168,24,1584,4963942.782608695,66.0,66.0,24,1584,4954545.695652174,66.0,66.0
10434180.0,6,7,478,4,272,3432623.0,74.0,68.0,3,206,5148809.0,74.0,68.66666666666667
90011669.0,17,28,13364,28,13364,3333765.5185185187,501.0,477.2857142857143,0,0,0.0,0.0,0.0
107220.0,17,2,286,2,286,0.0,143.0,143.0,0,0,0.0,0.0,0.0
2960.0,17,2,224,1,76,0.0,76.0,76.0,1,148,0.0,148.0,148.0
1475496.0,17,16,1120,16,1120,98366.4,70.0,70.0,0,0,0.0,0.0,0.0
74596249.0,6,9,842,9,842,9324531.125,97.0,93.55555555555556,0,0,0.0,0.0,0.0
31412.000000000004,6,14,4740,7,653,4782.0,249.0,93.28571428571428,7,4087,4716.0,1514.0,583.8571428571429
146247.0,6,3,337,2,214,0.0,160.0,107.0,1,123,0.0,123.0,123.0
94377085.0,6,40,2640,20,1320,4967215.0,66.0,66.0,20,1320,4949754.421052632,66.0,66.0
9568.0,17,2,507,1,86,0.0,86.0,86.0,1,421,0.0,421.0,421.0
10485008.0,6,7,478,4,272,3449360.333333333,74.0,68.0,3,206,5173914.5,74.0,68.66666666666667
99765924.0,6,34,2482,17,1288,6221884.625,139.0,75.76470588235294,17,1194,6221880.0625,123.0,70.23529411764706
3176164.0,6,18,1495,9,921,358165.375,315.0,102.33333333333331,9,574,358134.0,78.0,63.77777777777778
20977.0,6,14,4740,7,653,3388.833333333333,249.0,93.28571428571428,7,4087,3319.5,1514.0,583.8571428571429
2456.0,17,4,344,2,150,0.0,75.0,75.0,2,194,0.0,103.0,97.0
90245905.0,6,12,1832,8,1016,12892272.142857144,188.0,127.0,4,816,30027156.0,204.0,204.0
120056748.0,17,29,13785,29,13785,4287741.0,501.0,475.3448275862069,0,0,0.0,0.0,0.0
147301.0,6,3,373,2,238,0.0,172.0,119.0,1,135,0.0,135.0,135.0
9654.0,17,2,582,1,83,0.0,83.0,83.0,1,499,0.0,499.0,499.0
756367.0,6,10,1065,5,534,187942.25,262.0,106.8,5,531,188760.0,259.0,106.2
120045987.0,17,28,13364,28,13364,4446147.666666667,501.0,477.2857142857143,0,0,0.0,0.0,0.0
90307944.0,6,21,1585,11,840,9025720.7,95.0,76.36363636363636,10,745,9948119.333333334,95.0,74.5
196125.0,17,2,762,2,762,0.0,381.0,381.0,0,0,0.0,0.0,0.0
120066573.0,17,29,13785,29,13785,4288091.892857143,501.0,475.3448275862069,0,0,0.0,0.0,0.0
896.0,17,4,438,2,148,0.0,74.0,74.0,2,290,0.0,147.0,145.0
308509.0,6,6,412,4,272,102836.33333333331,74.0,68.0,2,140,0.0,74.0,70.0
242513.0,6,3,337,2,214,0.0,160.0,107.0,1,123,0.0,123.0,123.0
96114568.0,6,39,2574,20,1320,5042452.7894736845,66.0,66.0,19,1254,5150452.888888889,66.0,66.0
49277.0,6,14,4740,7,653,7898.333333333333,249.0,93.28571428571428,7,4087,7707.666666666667,1514.0,583.8571428571429
19213.0,6,14,4740,7,653,3018.5,249.0,93.28571428571428,7,4087,3068.1666666666665,1514.0,583.8571428571429
911.0,17,4,438,2,148,0.0,74.0,74.0,2,290,0.0,147.0,145.0
120048808.0,17,29,13785,29,13785,4287457.428571428,501.0,475.3448275862069,0,0,0.0,0.0,0.0
13717.0,17,4,344,2,150,0.0,75.0,75.0,2,194,0.0,103.0,97.0
120708918.0,6,242,27428,121,8294,999132.4,140.0,68.54545454545455,121,19134,999076.9416666668,284.0,158.13223140495867
113344362.0,6,47,3102,23,1518,5151996.681818182,66.0,66.0,24,1584,4928002.913043479,66.0,66.0
228190.0,17,2,180,1,90,0.0,90.0,90.0,1,90,0.0,90.0,90.0
228215.0,17,2,180,1,90,0.0,90.0,90.0,1,90,0.0,90.0,90.0
119502959.0,17,35,16705,35,16705,3514792.911764706,501.0,477.2857142857143,0,0,0.0,0.0,0.0
117553248.0,6,232,26072,116,18120,1020329.7478260868,284.0,156.20689655172413,116,7952,1020329.7130434784,140.0,68.55172413793103
119953841.0,17,35,16705,35,16705,3528054.147058824,501.0,477.2857142857143,0,0,0.0,0.0,0.0
10698195.0,6,7,536,2,132,0.0,66.0,66.0,5,404,2674548.75,103.0,80.8
27892.0,6,10,2032,5,524,6689.0,252.0,104.8,5,1508,6384.0,1236.0,301.6
135130028.0,17,6,1206,6,1206,27026005.6,201.0,201.0,0,0,0.0,0.0,0.0
298543.0,6,6,412,4,272,99514.33333333331,74.0,68.0,2,140,0.0,74.0,70.0
10511336.0,6,7,478,4,272,3458315.0,74.0,68.0,3,206,5187339.5,74.0,68.66666666666667
121298.0,6,3,337,2,214,0.0,160.0,107.0,1,123,0.0,123.0,123.0
90039341.0,17,27,12943,27,12943,3463051.576923077,501.0,479.3703703703704,0,0,0.0,0.0,0.0
320291.0,6,10,1065,5,534,79760.0,262.0,106.8,5,531,2430.0,259.0,106.2
135126598.0,17,6,1206,6,1206,27025319.6,201.0,201.0,0,0,0.0,0.0,0.0
23012418.0,17,3,1034,2,684,0.0,342.0,342.0,1,350,0.0,350.0,350.0
209475.0,6,3,426,2,280,0.0,214.0,140.0,1,146,0.0,146.0,146.0
307637.0,6,6,412,4,272,102545.66666666669,74.0,68.0,2,140,0.0,74.0,70.0
2268.0,17,2,664,1,322,0.0,322.0,322.0,1,342,0.0,342.0,342.0
42199.0,6,14,4740,7,653,6743.0,249.0,93.28571428571428,7,4087,6741.333333333333,1514.0,583.8571428571429
206096.0,17,2,180,1,90,0.0,90.0,90.0,1,90,0.0,90.0,90.0
153479.0,17,2,180,1,90,0.0,90.0,90.0,1,90,0.0,90.0,90.0
167368.0,17,2,180,1,90,0.0,90.0,90.0,1,90,0.0,90.0,90.0
860383.0,6,9,1269,6,798,172076.6,460.0,133.0,3,471,293861.5,331.0,157.0
83374.0,6,10,2032,5,524,20323.0,252.0,104.8,5,1508,20467.0,1236.0,301.6
146276.0,6,3,337,2,214,0.0,160.0,107.0,1,123,0.0,123.0,123.0
1057210.0,6,13,1386,7,789,176201.66666666666,253.0,112.71428571428572,6,597,209604.6,259.0,99.5
337.0,17,2,160,1,80,0.0,80.0,80.0,1,80,0.0,80.0,80.0
321155.0,17,4,1400,4,1400,107051.66666666669,350.0,350.0,0,0,0.0,0.0,0.0
23509.0,17,4,823,2,163,0.0,89.0,81.5,2,660,0.0,443.0,330.0
56622.0,6,14,4740,7,653,9288.0,249.0,93.28571428571428,7,4087,7898.0,1514.0,583.8571428571429
315505.0,17,4,1400,4,1400,105168.33333333331,350.0,350.0,0,0,0.0,0.0,0.0
236352.0,6,3,373,2,238,0.0,172.0,119.0,1,135,0.0,135.0,135.0
10462332.0,6,7,478,4,272,3442079.6666666665,74.0,68.0,3,206,5163017.0,74.0,68.66666666666667
318.0,17,2,160,1,80,0.0,80.0,80.0,1,80,0.0,80.0,80.0
13743.0,17,4,823,2,163,0.0,89.0,81.5,2,660,0.0,443.0,330.0
34134.0,6,13,1479,7,882,5554.0,291.0,126.0,6,597,6170.0,259.0,99.5
209508.0,17,2,180,1,90,0.0,90.0,90.0,1,90,0.0,90.0,90.0
43357.0,6,14,4740,7,653,6482.5,249.0,93.28571428571428,7,4087,6096.333333333333,1514.0,583.8571428571429
90734698.0,6,17,1287,9,691,11336481.375,95.0,76.77777777777777,8,596,12961561.57142857,95.0,74.5
108108729.0,17,5,1005,5,1005,27027182.25,201.0,201.0,0,0,0.0,0.0,0.0
47719.0,6,12,1328,6,731,9049.2,253.0,121.83333333333331,6,597,8460.2,259.0,99.5
5610444.0,6,5,336,3,200,1532779.5,68.0,66.66666666666667,2,136,0.0,70.0,68.0
300179.0,6,6,412,4,272,100059.66666666669,74.0,68.0,2,140,0.0,74.0,70.0
97563267.0,6,39,2574,20,1320,5120415.421052632,66.0,66.0,19,1254,5135631.611111111,66.0,66.0
135127988.0,17,6,1146,6,1146,27025597.6,191.0,191.0,0,0,0.0,0.0,0.0
2388.0,17,4,344,2,150,0.0,75.0,75.0,2,194,0.0,103.0,97.0
90303618.0,6,16,1192,8,596,12893596.285714284,95.0,74.5,8,596,12899514.142857144,95.0,74.5
38927.0,6,14,4740,7,653,6334.666666666667,249.0,93.28571428571428,7,4087,6228.0,1514.0,583.8571428571429
10513140.0,6,7,478,4,272,3458682.6666666665,74.0,68.0,3,206,5187942.0,74.0,68.66666666666667
108101271.0,17,5,955,5,955,27025317.75,191.0,191.0,0,0,0.0,0.0,0.0
52355.0,6,14,4740,7,653,8363.5,249.0,93.28571428571428,7,4087,6128.166666666667,1514.0,583.8571428571429
301376.0,6,6,412,4,272,100458.66666666669,74.0,68.0,2,140,0.0,74.0,70.0
26441.0,6,14,4740,7,653,3710.0,249.0,93.28571428571428,7,4087,3866.8333333333335,1514.0,583.8571428571429
54019.0,6,14,4740,7,653,8582.0,249.0,93.28571428571428,7,4087,8869.166666666666,1514.0,583.8571428571429
2603001.0,6,2,132,1,66,0.0,66.0,66.0,1,66,0.0,66.0,66.0
307802.0,17,4,704,2,148,0.0,74.0,74.0,2,556,0.0,280.0,278.0
3676.0,17,2,762,2,762,0.0,381.0,381.0,0,0,0.0,0.0,0.0
27757948.0,6,5,1736,2,819,0.0,753.0,409.5,3,917,13811891.0,785.0,305.6666666666667
3075.0,17,2,224,1,76,0.0,76.0,76.0,1,148,0.0,148.0,148.0
120123128.0,6,12,1832,8,1016,17137316.285714287,188.0,127.0,4,816,30031652.666666668,204.0,204.0
208844.0,6,10,1221,6,636,41768.8,298.0,106.0,4,585,68554.0,379.0,146.25
120053023.0,17,29,13785,29,13785,4287607.964285715,501.0,475.3448275862069,0,0,0.0,0.0,0.0
2071.0,17,4,344,2,150,0.0,75.0,75.0,2,194,0.0,103.0,97.0
239631.0,6,3,337,2,214,0.0,160.0,107.0,1,123,0.0,123.0,123.0
503077.0,6,5,336,2,134,0.0,68.0,67.0,3,202,192751.0,70.0,67.33333333333333
20788.0,6,10,2032,5,524,4973.5,252.0,104.8,5,1508,4962.5,1236.0,301.6
311.0,17,2,156,1,78,0.0,78.0,78.0,1,78,0.0,78.0,78.0
250826.0,17,8,12112,8,12112,35832.28571428572,1514.0,1514.0,0,0,0.0,0.0,0.0
120554849.0,6,31,2097,16,1149,8036989.933333334,123.0,71.8125,15,948,8046390.714285715,123.0,63.2
300.0,17,2,164,1,82,0.0,82.0,82.0,1,82,0.0,82.0,82.0
135141700.0,17,6,1146,6,1146,27028340.0,191.0,191.0,0,0,0.0,0.0,0.0
147708.0,6,3,373,2,238,0.0,172.0,119.0,1,135,0.0,135.0,135.0
120519411.0,6,233,26372,117,18420,1038960.4396551724,284.0,157.43589743589743,116,7952,1038980.6782608696,140.0,68.55172413793103
840871.0,6,9,1118,6,586,168174.2,248.0,97.66666666666669,3,532,282611.5,392.0,177.33333333333334
103571.0,17,2,286,2,286,0.0,143.0,143.0,0,0,0.0,0.0,0.0
10478005.0,6,6,412,3,206,5170627.5,74.0,68.66666666666667,3,206,5170499.0,74.0,68.66666666666667
90037289.0,17,28,13364,28,13364,3334714.407407407,501.0,477.2857142857143,0,0,0.0,0.0,0.0
3023973.0,6,12,2172,7,664,503995.5,252.0,94.85714285714286,5,1508,5797.25,1236.0,301.6
238354.0,6,6,386,4,247,79451.33333333333,85.0,61.75,2,139,0.0,85.0,69.5
808.0,17,4,438,2,148,0.0,74.0,74.0,2,290,0.0,147.0,145.0
79182.0,6,14,4740,7,653,12121.833333333334,249.0,93.28571428571428,7,4087,13011.666666666666,1514.0,583.8571428571429
26693.0,6,13,4412,6,409,5201.4,127.0,68.16666666666667,7,4003,3932.8333333333335,1514.0,571.8571428571429
26330.0,6,14,4740,7,653,3932.0,249.0,93.28571428571428,7,4087,4210.5,1514.0,583.8571428571429
303314.0,6,6,412,4,272,101104.66666666669,74.0,68.0,2,140,0.0,74.0,70.0
168231.0,17,4,704,2,148,0.0,74.0,74.0,2,556,0.0,280.0,278.0
49322.0,6,10,2032,5,524,11980.25,252.0,104.8,5,1508,11062.25,1236.0,301.6
90284420.0,6,15,1097,8,596,12897774.285714284,95.0,74.5,7,501,14999190.833333334,95.0,71.57142857142857
324.0,17,2,174,1,79,0.0,79.0,79.0,1,95,0.0,95.0,95.0
18141.0,6,14,4740,7,653,2877.0,249.0,93.28571428571428,7,4087,2887.6666666666665,1514.0,583.8571428571429
90251015.0,6,12,1832,8,1016,12893002.142857144,188.0,127.0,4,816,30028755.666666668,204.0,204.0
39460.0,6,14,4740,7,653,5970.5,249.0,93.28571428571428,7,4087,6141.666666666667,1514.0,583.8571428571429
92089991.0,6,162,18334,81,12840,1148560.6875,284.0,158.5185185185185,81,5494,1148551.3,140.0,67.82716049382717
2253.0,17,4,344,2,150,0.0,75.0,75.0,2,194,0.0,103.0,97.0
2593159.0,6,2,132,1,66,0.0,66.0,66.0,1,66,0.0,66.0,66.0
4497.0,17,2,626,1,72,0.0,72.0,72.0,1,554,0.0,554.0,554.0
195788.0,17,4,6056,4,6056,65262.66666666666,1514.0,1514.0,0,0,0.0,0.0,0.0
117263.0,17,2,700,2,700,0.0,350.0,350.0,0,0,0.0,0.0,0.0
206291.0,6,3,426,2,280,0.0,214.0,140.0,1,146,0.0,146.0,146.0
9294.0,17,2,565,1,93,0.0,93.0,93.0,1,472,0.0,472.0,472.0
1073318.0,6,13,1513,7,882,178026.33333333334,291.0,126.0,6,631,211905.6,293.0,105.16666666666669
35180317.0,6,7,2047,3,960,17515446.0,826.0,320.0,4,1087,11680409.333333334,885.0,271.75
122462190.0,6,34,2350,17,1125,7029782.25,123.0,66.17647058823529,17,1225,7029799.375,139.0,72.05882352941177
109027.0,17,2,286,2,286,0.0,143.0,143.0,0,0,0.0,0.0,0.0
108100617.0,17,5,955,5,955,27025154.25,191.0,191.0,0,0,0.0,0.0,0.0
215352.0,17,2,180,1,90,0.0,90.0,90.0,1,90,0.0,90.0,90.0
220074.0,6,4,492,2,280,0.0,214.0,140.0,2,212,0.0,146.0,106.0
120374071.0,6,33,2296,17,1225,7523379.4375,139.0,72.05882352941177,16,1071,7344753.266666667,123.0,66.9375
205703.0,17,2,762,2,762,0.0,381.0,381.0,0,0,0.0,0.0,0.0
729.0,17,4,438,2,148,0.0,74.0,74.0,2,290,0.0,147.0,145.0
2059.0,17,4,344,2,150,0.0,75.0,75.0,2,194,0.0,103.0,97.0
124715070.0,6,32,2220,16,1071,7648630.266666667,123.0,66.9375,16,1149,7648637.733333333,123.0,71.8125
1033554.0,6,11,1134,6,558,206710.8,220.0,93.0,5,576,255860.0,304.0,115.2
28224.0,6,10,2032,5,524,5776.0,252.0,104.8,5,1508,6778.25,1236.0,301.6
109978503.0,6,30,2122,15,1105,7840202.071428572,139.0,73.66666666666667,15,1017,7840197.714285715,123.0,67.8
228443.0,17,2,180,1,90,0.0,90.0,90.0,1,90,0.0,90.0,90.0
120237087.0,6,458,58190,229,15410,525280.7894736842,140.0,67.29257641921397,229,42780,527273.3947368421,336.0,186.8122270742358
292.0,17,2,156,1,78,0.0,78.0,78.0,1,78,0.0,78.0,78.0
314837.0,17,4,704,2,148,0.0,74.0,74.0,2,556,0.0,280.0,278.0
211193.0,17,2,180,1,90,0.0,90.0,90.0,1,90,0.0,90.0,90.0
90122847.0,6,10,1440,7,828,15020474.5,188.0,118.28571428571428,3,612,30045839.5,204.0,204.0
306851.0,6,6,412,4,272,102283.66666666669,74.0,68.0,2,140,0.0,74.0,70.0
52632.0,6,14,4740,7,653,8650.0,249.0,93.28571428571428,7,4087,8091.333333333333,1514.0,583.8571428571429
2295.0,17,4,344,2,150,0.0,75.0,75.0,2,194,0.0,103.0,97.0
142121.0,6,2,132,1,66,0.0,66.0,66.0,1,66,0.0,66.0,66.0
236995.0,17,2,180,1,90,0.0,90.0,90.0,1,90,0.0,90.0,90.0
120139659.0,6,13,2036,5,1020,30034914.75,204.0,204.0,8,1016,17137113.42857143,188.0,127.0
3129.0,17,2,224,1,76,0.0,76.0,76.0,1,148,0.0,148.0,148.0
16056.999999999998,6,14,4740,7,653,2561.1666666666665,249.0,93.28571428571428,7,4087,2529.833333333333,1514.0,583.8571428571429
1306936.0,6,4,264,2,132,0.0,66.0,66.0,2,132,0.0,66.0,66.0
300988.0,6,6,412,4,272,100329.33333333331,74.0,68.0,2,140,0.0,74.0,70.0
66791.0,6,11,2098,6,590,13358.2,252.0,98.33333333333331,5,1508,12032.5,1236.0,301.6
107316.0,17,2,286,2,286,0.0,143.0,143.0,0,0,0.0,0.0,0.0
2308.0,17,4,344,2,150,0.0,75.0,75.0,2,194,0.0,103.0,97.0
581748.0,6,4,508,2,238,0.0,172.0,119.0,2,270,0.0,135.0,135.0
108331581.0,6,32,2236,16,1165,7222105.4,139.0,72.8125,16,1071,7207679.933333334,123.0,66.9375
431204.0,6,3,204,2,136,0.0,70.0,68.0,1,68,0.0,68.0,68.0
852.0,17,4,438,2,148,0.0,74.0,74.0,2,290,0.0,147.0,145.0
818.0,17,4,438,2,148,0.0,74.0,74.0,2,290,0.0,147.0,145.0
23974.0,17,2,582,1,83,0.0,83.0,83.0,1,499,0.0,499.0,499.0
90285366.0,6,16,1192,8,596,12891978.42857143,95.0,74.5,8,596,12893528.714285716,95.0,74.5
17312.0,6,11,2098,6,590,3397.6,252.0,98.33333333333331,5,1508,3962.0,1236.0,301.6
823.0,17,4,438,2,148,0.0,74.0,74.0,2,290,0.0,147.0,145.0
2590803.0,6,2,132,1,66,0.0,66.0,66.0,1,66,0.0,66.0,66.0
25109.0,6,14,4740,7,653,3047.0,249.0,93.28571428571428,7,4087,4053.3333333333335,1514.0,583.8571428571429
233161.0,6,3,337,2,214,0.0,160.0,107.0,1,123,0.0,123.0,123.0
108101286.0,17,5,955,5,955,27025321.5,191.0,191.0,0,0,0.0,0.0,0.0
120685413.0,6,22,1680,11,840,12068541.3,95.0,76.36363636363636,11,840,9044570.0,95.0,76.36363636363636
284789.0,17,2,363,1,79,0.0,79.0,79.0,1,284,0.0,284.0,284.0
215404.0,6,3,426,2,280,0.0,214.0,140.0,1,146,0.0,146.0,146.0
51894.0,6,14,4740,7,653,8464.0,249.0,93.28571428571428,7,4087,7234.333333333333,1514.0,583.8571428571429
2798435.0,6,2,132,1,66,0.0,66.0,66.0,1,66,0.0,66.0,66.0
0.0,6,1,66,1,66,0.0,66.0,66.0,0,0,0.0,0.0,0.0
310447.0,17,4,1400,4,1400,103482.33333333331,350.0,350.0,0,0,0.0,0.0,0.0
315656.0,17,4,1400,4,1400,105218.66666666669,350.0,350.0,0,0,0.0,0.0,0.0
90283168.0,6,16,1192,8,596,12891356.285714284,95.0,74.5,8,596,12896643.857142856,95.0,74.5
120030674.0,6,811,154800,412,127874,291521.5790754258,1514.0,310.373786407767,399,26926,301043.6859296482,214.0,67.48370927318295
590248.0,6,4,508,2,238,0.0,172.0,119.0,2,270,0.0,135.0,135.0
90210467.0,6,16,1192,8,596,12852548.285714284,95.0,74.5,8,596,12857839.142857144,95.0,74.5
120081493.0,17,28,13364,28,13364,4447462.703703703,501.0,477.2857142857143,0,0,0.0,0.0,0.0
228431.0,17,2,180,1,90,0.0,90.0,90.0,1,90,0.0,90.0,90.0
4288.0,17,2,614,1,72,0.0,72.0,72.0,1,542,0.0,542.0,542.0
63.0,6,2,169,0,0,0.0,0.0,0.0,2,169,0.0,103.0,84.5
112634545.0,17,14,864,7,432,18666832.33333333,174.0,61.71428571428572,7,432,18668192.5,174.0,61.71428571428572
95111784.0,6,885,191022,452,161778,210890.8736141907,1514.0,357.9159292035398,433,29244,219638.7152777777,214.0,67.53810623556582
12344.0,6,10,1067,5,536,2917.75,264.0,107.2,5,531,2649.5,259.0,106.2
91845050.0,6,24,1829,13,989,7653207.75,95.0,76.07692307692308,11,840,9183933.4,95.0,76.36363636363636
2268710.0,6,2,132,1,66,0.0,66.0,66.0,1,66,0.0,66.0,66.0
29367.0,6,11,2098,6,590,5498.8,252.0,98.33333333333331,5,1508,7071.0,1236.0,301.6
1357356.0,6,4,276,2,128,0.0,74.0,64.0,2,148,0.0,74.0,74.0
228297.0,17,2,180,1,90,0.0,90.0,90.0,1,90,0.0,90.0,90.0
10470473.0,6,6,412,3,206,5167439.0,74.0,68.66666666666667,3,206,5167319.0,74.0,68.66666666666667
135126745.0,17,6,1206,6,1206,27025349.0,201.0,201.0,0,0,0.0,0.0,0.0
119992077.0,17,34,16284,34,16284,3636123.5454545454,501.0,478.9411764705882,0,0,0.0,0.0,0.0
97054.0,17,2,762,2,762,0.0,381.0,381.0,0,0,0.0,0.0,0.0
315041.0,17,4,1400,4,1400,105013.66666666669,350.0,350.0,0,0,0.0,0.0,0.0
107121.0,17,2,286,2,286,0.0,143.0,143.0,0,0,0.0,0.0,0.0
60902.0,6,14,4740,7,653,10026.5,249.0,93.28571428571428,7,4087,9648.0,1514.0,583.8571428571429
16268.999999999998,17,2,582,1,83,0.0,83.0,83.0,1,499,0.0,499.0,499.0
246040.0,6,3,337,2,214,0.0,160.0,107.0,1,123,0.0,123.0,123.0
217952.0,6,3,426,2,280,0.0,214.0,140.0,1,146,0.0,146.0,146.0
2116.0,17,2,192,1,88,0.0,88.0,88.0,1,104,0.0,104.0,104.0
2622701.0,6,25,7573,14,3735,201746.2307692308,1514.0,266.7857142857143,11,3838,236854.7,1514.0,348.90909090909093
5011464.0,17,4,376,2,152,0.0,76.0,76.0,2,224,0.0,148.0,112.0
893766.0,6,10,1221,6,636,178753.2,298.0,106.0,4,585,296379.0,379.0,146.25
70549.0,6,12,1320,7,789,11758.166666666666,253.0,112.71428571428572,5,531,15011.25,259.0,106.2
228390.0,17,2,180,1,90,0.0,90.0,90.0,1,90,0.0,90.0,90.0
120303545.0,6,256,29034,128,8756,940928.3070866142,140.0,68.40625,128,20278,940738.3543307086,284.0,158.421875
0.0,17,1,72,1,72,0.0,72.0,72.0,0,0,0.0,0.0,0.0
23616.0,6,10,2032,5,524,5674.5,252.0,104.8,5,1508,5728.25,1236.0,301.6
62570.0,6,12,1320,7,789,10428.333333333334,253.0,112.71428571428572,5,531,13636.5,259.0,106.2
2790149.0,6,2,132,1,66,0.0,66.0,66.0,1,66,0.0,66.0,66.0
105239298.0,6,43,2838,22,1452,5001113.857142857,66.0,66.0,21,1386,5105428.4,66.0,66.0
56027.0,6,14,4740,7,653,4233.5,249.0,93.28571428571428,7,4087,9114.0,1514.0,583.8571428571429
135130615.0,17,6,1206,6,1206,27026123.0,201.0,201.0,0,0,0.0,0.0,0.0
2291.0,17,4,344,2,150,0.0,75.0,75.0,2,194,0.0,103.0,97.0
90548420.0,6,15,2444,8,1016,12935488.57142857,188.0,127.0,7,1428,15064554.0,204.0,204.0
23537.0,6,14,4740,7,653,3802.6666666666665,249.0,93.28571428571428,7,4087,3733.3333333333335,1514.0,583.8571428571429
1156320.0,6,13,3011,8,2383,165188.57142857142,1514.0,297.875,5,628,220914.5,331.0,125.6
122100.0,6,3,373,2,238,0.0,172.0,119.0,1,135,0.0,135.0,135.0
657256.0,6,10,1065,5,534,164114.25,262.0,106.8,5,531,163671.25,259.0,106.2
116470353.0,6,48,3168,24,1584,5063928.391304348,66.0,66.0,24,1584,5051951.608695652,66.0,66.0
113520284.0,6,46,3036,23,1518,5159999.727272728,66.0,66.0,23,1518,5160001.727272728,66.0,66.0
816.0,17,4,438,2,148,0.0,74.0,74.0,2,290,0.0,147.0,145.0
113255067.0,6,46,3036,23,1518,5135439.2727272725,66.0,66.0,23,1518,5135430.5,66.0,66.0
321544.0,17,4,1400,4,1400,107181.33333333331,350.0,350.0,0,0,0.0,0.0,0.0
215455.0,17,2,180,1,90,0.0,90.0,90.0,1,90,0.0,90.0,90.0
123752222.0,17,14,864,7,432,17333499.166666668,174.0,61.71428571428572,7,432,17337275.333333332,174.0,61.71428571428572
302270.0,6,6,412,4,272,100756.66666666669,74.0,68.0,2,140,0.0,74.0,70.0
245746.0,6,3,373,2,238,0.0,172.0,119.0,1,135,0.0,135.0,135.0
219979.0,6,3,426,2,280,0.0,214.0,140.0,1,146,0.0,146.0,146.0
10457460.0,6,7,478,4,272,3440337.0,74.0,68.0,3,206,5160411.0,74.0,68.66666666666667
0.0,17,1,350,0,0,0.0,0.0,0.0,1,350,0.0,350.0,350.0
1143069.0,17,6,1230,3,234,571348.5,78.0,78.0,3,996,571316.0,332.0,332.0
300.0,17,2,168,1,76,0.0,76.0,76.0,1,92,0.0,92.0,92.0
90063468.0,17,27,12943,27,12943,3463979.5384615385,501.0,479.3703703703704,0,0,0.0,0.0,0.0
90280169.0,6,14,1043,7,542,15046694.833333334,95.0,77.42857142857143,7,501,14997802.0,95.0,71.57142857142857
27217.0,6,14,4740,7,653,4269.166666666667,249.0,93.28571428571428,7,4087,4017.8333333333335,1514.0,583.8571428571429
118739942.0,6,34,2482,17,1194,7421218.25,123.0,70.23529411764706,17,1288,6797191.0625,139.0,75.76470588235294
350.0,17,2,267,1,83,0.0,83.0,83.0,1,184,0.0,184.0,184.0
295.0,17,2,156,1,78,0.0,78.0,78.0,1,78,0.0,78.0,78.0
1185436.0,6,13,3014,8,2386,169348.0,1514.0,298.25,5,628,227444.25,331.0,125.6
4324363.0,6,200,168396,117,158616,37278.99137931035,1510.0,1355.6923076923076,83,9780,48965.70731707317,1510.0,117.8313253012048
864370.0,6,9,1267,6,796,172874.0,458.0,132.66666666666666,3,471,294542.5,331.0,157.0
106979363.0,17,13,821,7,432,17803273.0,174.0,61.71428571428572,6,389,17452950.0,174.0,64.83333333333333
31768.0,6,11,2098,6,590,5839.0,252.0,98.33333333333331,5,1508,6385.75,1236.0,301.6
1419947.0,17,16,1120,16,1120,94663.13333333332,70.0,70.0,0,0,0.0,0.0,0.0
108103045.0,17,5,1005,5,1005,27025761.25,201.0,201.0,0,0,0.0,0.0,0.0
209558.0,17,2,180,1,90,0.0,90.0,90.0,1,90,0.0,90.0,90.0
907873.0,6,10,1335,6,798,181574.6,460.0,133.0,4,537,210705.0,331.0,134.25
962752.0,6,13,1420,7,789,159383.0,253.0,112.71428571428572,6,631,190476.6,293.0,105.16666666666669
45044351.0,6,7,1874,5,1053,11261087.75,785.0,210.6,2,821,0.0,753.0,410.5
1059086.0,6,11,1134,6,558,211817.2,220.0,93.0,5,576,262892.5,304.0,115.2
253742.00000000003,6,3,337,2,214,0.0,160.0,107.0,1,123,0.0,123.0,123.0
107699658.0,17,14,864,7,432,17834321.166666668,174.0,61.71428571428572,7,432,17833496.333333332,174.0,61.71428571428572
135132495.0,17,6,1146,6,1146,27026499.0,191.0,191.0,0,0,0.0,0.0,0.0
120065591.0,17,28,13364,28,13364,4446873.740740741,501.0,477.2857142857143,0,0,0.0,0.0,0.0
282181.0,17,2,363,1,79,0.0,79.0,79.0,1,284,0.0,284.0,284.0
405479.0,6,4,508,2,238,0.0,172.0,119.0,2,270,0.0,135.0,135.0
108104377.0,17,5,955,5,955,27026094.25,191.0,191.0,0,0,0.0,0.0,0.0
107502.0,17,2,286,2,286,0.0,143.0,143.0,0,0,0.0,0.0,0.0
36237.0,6,10,1065,5,534,6653.0,262.0,106.8,5,531,8580.25,259.0,106.2
107580.0,17,2,286,2,286,0.0,143.0,143.0,0,0,0.0,0.0,0.0
67049.0,6,14,4740,7,653,10419.0,249.0,93.28571428571428,7,4087,10904.166666666666,1514.0,583.8571428571429
90098111.0,6,11,1644,7,828,15016351.833333334,188.0,118.28571428571428,4,816,20022438.33333333,204.0,204.0
27926.0,6,14,4740,7,653,4338.5,249.0,93.28571428571428,7,4087,4434.166666666667,1514.0,583.8571428571429
2805.0,17,4,344,2,150,0.0,75.0,75.0,2,194,0.0,103.0,97.0
303661.0,6,2,132,1,66,0.0,66.0,66.0,1,66,0.0,66.0,66.0
288394.0,17,2,180,1,90,0.0,90.0,90.0,1,90,0.0,90.0,90.0
232201.0,6,3,337,2,214,0.0,160.0,107.0,1,123,0.0,123.0,123.0
69868.0,6,10,2032,5,524,17222.75,252.0,104.8,5,1508,16649.75,1236.0,301.6
122973506.0,17,15,1038,8,606,17567643.714285713,174.0,75.75,7,432,17500154.833333332,174.0,61.71428571428572
11451257.0,6,7,499,4,301,3024881.6666666665,103.0,75.25,3,198,4603460.0,66.0,66.0
102883.0,17,2,286,2,286,0.0,143.0,143.0,0,0,0.0,0.0,0.0
115485672.0,6,1058,242382,519,35142,222930.4749034749,214.0,67.71098265895954,539,207240,214654.97583643123,1514.0,384.48979591836735
4401.0,17,2,180,1,90,0.0,90.0,90.0,1,90,0.0,90.0,90.0
20051690.0,17,3,1034,2,684,0.0,342.0,342.0,1,350,0.0,350.0,350.0
121285.0,6,3,337,2,214,0.0,160.0,107.0,1,123,0.0,123.0,123.0
50835.0,6,10,2032,5,524,12264.0,252.0,104.8,5,1508,10468.5,1236.0,301.6
95991420.0,6,173,19494,87,5964,1116179.3023255814,140.0,68.55172413793103,86,13530,1117061.6352941175,284.0,157.32558139534885
319680.0,6,10,1221,6,636,63936.0,298.0,106.0,4,585,100826.33333333331,379.0,146.25
340.0,17,2,267,1,83,0.0,83.0,83.0,1,184,0.0,184.0,184.0
2341.0,17,2,762,2,762,0.0,381.0,381.0,0,0,0.0,0.0,0.0
10050.0,6,10,1975,5,467,2276.0,195.0,93.4,5,1508,2155.5,1236.0,301.6
2363.0,17,4,344,2,150,0.0,75.0,75.0,2,194,0.0,103.0,97.0
108110018.0,17,5,1005,5,1005,27027504.5,201.0,201.0,0,0,0.0,0.0,0.0
312904.0,17,4,1400,4,1400,104301.33333333331,350.0,350.0,0,0,0.0,0.0,0.0
105050.0,17,2,700,2,700,0.0,350.0,350.0,0,0,0.0,0.0,0.0
108113051.0,17,5,955,5,955,27028262.75,191.0,191.0,0,0,0.0,0.0,0.0
18268057.0,6,27,10153,15,1819,1304861.2142857143,408.0,121.26666666666668,12,8334,1346887.181818182,1514.0,694.5
285966.0,6,10,1221,6,636,57193.2,298.0,106.0,4,585,85914.33333333333,379.0,146.25
311799.0,17,4,622,4,622,103933.0,163.0,155.5,0,0,0.0,0.0,0.0
207260.0,6,3,426,2,280,0.0,214.0,140.0,1,146,0.0,146.0,146.0
12917.0,6,11,2098,6,590,2509.4,252.0,98.33333333333331,5,1508,2511.75,1236.0,301.6
1303457.0,6,4,264,2,132,0.0,66.0,66.0,2,132,0.0,66.0,66.0
307904.0,6,6,412,4,272,102634.66666666669,74.0,68.0,2,140,0.0,74.0,70.0
106728.0,17,2,700,2,700,0.0,350.0,350.0,0,0,0.0,0.0,0.0
3050.0,17,2,224,1,76,0.0,76.0,76.0,1,148,0.0,148.0,148.0
108107070.0,17,5,1005,5,1005,27026767.5,201.0,201.0,0,0,0.0,0.0,0.0
112978971.0,6,45,2970,23,1518,5135407.7727272725,66.0,66.0,22,1452,5066024.523809524,66.0,66.0
33317.0,6,10,2032,5,524,8091.75,252.0,104.8,5,1508,6837.25,1236.0,301.6
928290.0,6,12,1354,6,723,184239.0,253.0,120.5,6,631,184655.0,293.0,105.16666666666669
49246.0,6,14,4740,7,653,7867.333333333333,249.0,93.28571428571428,7,4087,8078.5,1514.0,583.8571428571429
352733.0,6,4,508,2,238,0.0,172.0,119.0,2,270,0.0,135.0,135.0
120057413.0,17,29,13785,29,13785,4287764.75,501.0,475.3448275862069,0,0,0.0,0.0,0.0
3024.0,17,4,625,2,163,0.0,89.0,81.5,2,462,0.0,245.0,231.0
90038092.0,17,28,13364,28,13364,3334744.1481481483,501.0,477.2857142857143,0,0,0.0,0.0,0.0
2863.0,17,4,344,2,150,0.0,75.0,75.0,2,194,0.0,103.0,97.0
91700479.0,6,21,1626,12,935,8331738.0,95.0,77.91666666666667,9,691,11404135.25,95.0,76.77777777777777
302.0,17,2,168,1,76,0.0,76.0,76.0,1,92,0.0,92.0,92.0
298326.0,6,6,412,4,272,99442.0,74.0,68.0,2,140,0.0,74.0,70.0
967.0,17,4,438,2,148,0.0,74.0,74.0,2,290,0.0,147.0,145.0
123455412.0,6,48,3168,24,1584,5008632.913043479,66.0,66.0,24,1584,5259179.956521739,66.0,66.0
116780238.0,6,48,3168,24,1584,5077401.652173913,66.0,66.0,24,1584,5065410.217391305,66.0,66.0
303092.0,6,2,132,1,66,0.0,66.0,66.0,1,66,0.0,66.0,66.0
1204172.0,17,7,490,7,490,200695.3333333333,70.0,70.0,0,0,0.0,0.0,0.0
37775.0,6,14,4740,7,653,6138.833333333333,249.0,93.28571428571428,7,4087,5937.166666666667,1514.0,583.8571428571429
95399215.0,6,26,1746,13,906,7931944.833333333,123.0,69.6923076923077,13,840,7931947.75,123.0,64.61538461538461
104197494.0,17,14,1126,7,563,17333968.5,174.0,80.42857142857143,7,563,17333502.333333332,174.0,80.42857142857143
104034.0,17,2,762,2,762,0.0,381.0,381.0,0,0,0.0,0.0,0.0
197341.0,17,2,180,1,90,0.0,90.0,90.0,1,90,0.0,90.0,90.0
107237.0,17,2,286,2,286,0.0,143.0,143.0,0,0,0.0,0.0,0.0
54545.0,6,14,4740,7,653,8625.0,249.0,93.28571428571428,7,4087,8782.333333333334,1514.0,583.8571428571429
3076939.0,6,161,123700,87,114514,35778.36046511628,1510.0,1316.2528735632184,74,9186,38022.45205479452,1510.0,124.13513513513512
135138984.0,17,6,1206,6,1206,27027796.8,201.0,201.0,0,0,0.0,0.0,0.0
29962.0,6,10,2032,5,524,6379.0,252.0,104.8,5,1508,7225.0,1236.0,301.6
250501.0,6,3,337,2,214,0.0,160.0,107.0,1,123,0.0,123.0,123.0
103370.0,17,2,286,2,286,0.0,143.0,143.0,0,0,0.0,0.0,0.0
70263.0,6,14,4740,7,653,11583.0,249.0,93.28571428571428,7,4087,11567.333333333334,1514.0,583.8571428571429
43726.0,6,14,4740,7,653,6810.5,249.0,93.28571428571428,7,4087,6299.0,1514.0,583.8571428571429
90036315.0,17,28,13364,28,13364,3334678.333333333,501.0,477.2857142857143,0,0,0.0,0.0,0.0
38572.0,6,10,2032,5,524,8391.5,252.0,104.8,5,1508,9224.5,1236.0,301.6
300181.0,6,6,412,4,272,100060.33333333331,74.0,68.0,2,140,0.0,74.0,70.0
14652964.0,6,20,1607,10,975,1592752.3333333333,315.0,97.5,10,632,1593416.7777777778,78.0,63.2
28293.0,6,14,4740,7,653,4589.833333333333,249.0,93.28571428571428,7,4087,4477.166666666667,1514.0,583.8571428571429
121908.0,6,3,337,2,214,0.0,160.0,107.0,1,123,0.0,123.0,123.0
32464447.0,6,5,336,2,134,0.0,68.0,67.0,3,202,16169744.5,70.0,67.33333333333333
90024427.0,17,28,13364,28,13364,3334238.037037037,501.0,477.2857142857143,0,0,0.0,0.0,0.0
2262434.0,17,4,1368,4,1368,754144.6666666666,342.0,342.0,0,0,0.0,0.0,0.0
106085669.0,6,44,2904,22,1452,5051698.523809524,66.0,66.0,22,1452,5036825.952380952,66.0,66.0
160347.0,6,3,337,2,214,0.0,160.0,107.0,1,123,0.0,123.0,123.0
108108221.0,17,5,1005,5,1005,27027055.25,201.0,201.0,0,0,0.0,0.0,0.0
345.0,17,2,267,1,83,0.0,83.0,83.0,1,184,0.0,184.0,184.0
305200.0,6,6,412,4,272,101733.33333333331,74.0,68.0,2,140,0.0,74.0,70.0
897790.0,6,13,1386,7,789,149631.66666666666,253.0,112.71428571428572,6,597,178403.6,259.0,99.5
859514.0,6,9,1268,6,797,171902.8,459.0,132.83333333333334,3,471,293489.0,331.0,157.0
120011676.0,6,26,1978,14,1084,9230766.615384616,95.0,77.42857142857143,12,894,10909164.818181818,95.0,74.5
90015238.0,17,28,13364,28,13364,3333897.703703704,501.0,477.2857142857143,0,0,0.0,0.0,0.0
61489.0,6,10,2032,5,524,14927.5,252.0,104.8,5,1508,14094.5,1236.0,301.6
4253.0,17,2,602,1,72,0.0,72.0,72.0,1,530,0.0,530.0,530.0
813.0,17,4,438,2,148,0.0,74.0,74.0,2,290,0.0,147.0,145.0
508319.0,6,5,336,2,134,0.0,68.0,67.0,3,202,192454.5,70.0,67.33333333333333
889394.0,6,12,2718,7,743,148232.33333333334,339.0,106.14285714285714,5,1975,154199.75,1514.0,395.0
119006991.0,17,13,821,7,432,19834498.5,174.0,61.71428571428572,6,389,19800214.4,174.0,64.83333333333333
2555666.0,6,25,7573,14,3735,196589.6923076923,1514.0,266.7857142857143,11,3838,230174.4,1514.0,348.90909090909093
2417.0,17,4,344,2,150,0.0,75.0,75.0,2,194,0.0,103.0,97.0
146671.0,6,3,337,2,214,0.0,160.0,107.0,1,123,0.0,123.0,123.0
228315.0,17,2,180,1,90,0.0,90.0,90.0,1,90,0.0,90.0,90.0
135144809.0,17,6,1146,6,1146,27028961.8,191.0,191.0,0,0,0.0,0.0,0.0
33444.0,6,10,2032,5,524,7340.75,252.0,104.8,5,1508,7894.75,1236.0,301.6
75720.0,6,14,4740,7,653,12335.5,249.0,93.28571428571428,7,4087,12454.5,1514.0,583.8571428571429
92.0,17,2,762,2,762,0.0,381.0,381.0,0,0,0.0,0.0,0.0
35203.0,6,12,1413,7,882,5867.166666666667,291.0,126.0,5,531,5527.25,259.0,106.2
5005948.0,17,4,849,2,166,0.0,83.0,83.0,2,683,0.0,499.0,341.5
120051768.0,17,28,13364,28,13364,4446361.777777778,501.0,477.2857142857143,0,0,0.0,0.0,0.0
5621341.0,6,5,336,2,134,0.0,68.0,67.0,3,202,1525695.5,70.0,67.33333333333333
121212.0,6,3,337,2,214,0.0,160.0,107.0,1,123,0.0,123.0,123.0
102824.0,17,2,286,2,286,0.0,143.0,143.0,0,0,0.0,0.0,0.0
277943.0,6,13,1394,7,797,46323.833333333336,253.0,113.85714285714286,6,597,54587.0,259.0,99.5
317.0,17,2,174,1,79,0.0,79.0,79.0,1,95,0.0,95.0,95.0
206684.0,6,3,426,2,280,0.0,214.0,140.0,1,146,0.0,146.0,146.0
2598218.0,6,2,132,1,66,0.0,66.0,66.0,1,66,0.0,66.0,66.0
123272854.0,17,17,1386,9,780,15409106.75,174.0,86.66666666666667,8,606,16571567.42857143,174.0,75.75
90010735.0,17,28,13364,28,13364,3333730.925925926,501.0,477.2857142857143,0,0,0.0,0.0,0.0
205757.0,17,2,180,1,90,0.0,90.0,90.0,1,90,0.0,90.0,90.0
46657.0,6,14,4740,7,653,7461.5,249.0,93.28571428571428,7,4087,7631.833333333333,1514.0,583.8571428571429
90042878.0,17,28,13364,28,13364,3334921.407407407,501.0,477.2857142857143,0,0,0.0,0.0,0.0
219951.0,6,3,426,2,280,0.0,214.0,140.0,1,146,0.0,146.0,146.0
319798.0,17,4,1400,4,1400,106599.33333333331,350.0,350.0,0,0,0.0,0.0,0.0
781.0,17,4,438,2,148,0.0,74.0,74.0,2,290,0.0,147.0,145.0
90070030.0,17,28,13364,28,13364,3335927.037037037,501.0,477.2857142857143,0,0,0.0,0.0,0.0
2307.0,17,4,344,2,150,0.0,75.0,75.0,2,194,0.0,103.0,97.0
135127935.0,17,6,1206,6,1206,27025587.0,201.0,201.0,0,0,0.0,0.0,0.0
0.0,17,1,55,1,55,0.0,55.0,55.0,0,0,0.0,0.0,0.0
26715.0,6,14,4740,7,653,4225.333333333333,249.0,93.28571428571428,7,4087,4024.6666666666665,1514.0,583.8571428571429
228257.0,17,2,180,1,90,0.0,90.0,90.0,1,90,0.0,90.0,90.0
307726.0,6,6,412,4,272,102575.33333333331,74.0,68.0,2,140,0.0,74.0,70.0
122975345.0,6,48,3168,24,1584,4944404.739130435,66.0,66.0,24,1584,5322676.739130435,66.0,66.0
306515.0,6,6,412,4,272,102171.66666666669,74.0,68.0,2,140,0.0,74.0,70.0
0.0,17,1,55,1,55,0.0,55.0,55.0,0,0,0.0,0.0,0.0
368281.0,17,2,180,1,90,0.0,90.0,90.0,1,90,0.0,90.0,90.0
26768.0,6,10,2032,5,524,6452.75,252.0,104.8,5,1508,6011.25,1236.0,301.6
108093817.0,17,5,955,5,955,27023454.25,191.0,191.0,0,0,0.0,0.0,0.0
2067.0,17,4,344,2,150,0.0,75.0,75.0,2,194,0.0,103.0,97.0
0.0,17,1,381,1,381,0.0,381.0,381.0,0,0,0.0,0.0,0.0
101026817.0,17,12,778,6,389,20010567.2,174.0,64.83333333333333,6,389,20173349.4,174.0,64.83333333333333
304664.0,6,6,412,4,272,101554.66666666669,74.0,68.0,2,140,0.0,74.0,70.0
29658.0,6,10,2032,5,524,7186.5,252.0,104.8,5,1508,5529.0,1236.0,301.6
121411381.0,6,383,46092,192,33264,635661.6806282722,300.0,173.25,191,12828,622714.8842105264,140.0,67.16230366492147
121501.0,6,3,337,2,214,0.0,160.0,107.0,1,123,0.0,123.0,123.0
90010293.0,17,28,13364,28,13364,3333714.5555555555,501.0,477.2857142857143,0,0,0.0,0.0,0.0
153483.0,17,2,180,1,90,0.0,90.0,90.0,1,90,0.0,90.0,90.0
251466.00000000003,17,4,1524,4,1524,83822.0,381.0,381.0,0,0,0.0,0.0,0.0
145692.0,17,4,704,2,148,0.0,74.0,74.0,2,556,0.0,280.0,278.0
143913.0,17,2,180,1,90,0.0,90.0,90.0,1,90,0.0,90.0,90.0
108103194.0,17,5,1005,5,1005,27025798.5,201.0,201.0,0,0,0.0,0.0,0.0
314861.0,17,2,180,1,90,0.0,90.0,90.0,1,90,0.0,90.0,90.0
23053.0,6,14,4740,7,653,3685.6666666666665,249.0,93.28571428571428,7,4087,3538.833333333333,1514.0,583.8571428571429
2322.0,17,4,344,2,150,0.0,75.0,75.0,2,194,0.0,103.0,97.0
14867.0,6,20,7606,11,978,1486.7,310.0,88.9090909090909,9,6628,1553.0,1514.0,736.4444444444445
43676.0,6,14,4740,7,653,7153.166666666667,249.0,93.28571428571428,7,4087,6215.5,1514.0,583.8571428571429
116563647.0,6,226,25656,113,17976,1038825.9375,284.0,159.0796460176991,113,7680,1038825.8303571428,140.0,67.96460176991151
55495.0,6,14,4740,7,653,8804.0,249.0,93.28571428571428,7,4087,8942.0,1514.0,583.8571428571429
90209955.0,6,16,1192,8,596,12852227.857142856,95.0,74.5,8,596,12857765.714285716,95.0,74.5
112535291.0,6,46,3036,23,1518,5105434.090909091,66.0,66.0,23,1518,5105430.545454546,66.0,66.0
103200181.0,6,42,2772,21,1386,5159996.1,66.0,66.0,21,1386,5159991.8,66.0,66.0
120000126.0,6,24,1870,14,1084,9230778.923076924,95.0,77.42857142857143,10,786,10183991.888888888,95.0,78.6
2965218.0,6,159,125634,89,116712,33695.65909090909,1510.0,1311.370786516854,70,8922,38591.66666666666,1510.0,127.45714285714286
77056897.0,6,9,842,9,842,9632112.125,97.0,93.55555555555556,0,0,0.0,0.0,0.0
160094.0,6,3,337,2,214,0.0,160.0,107.0,1,123,0.0,123.0,123.0
19209.0,6,2,145,2,145,0.0,91.0,72.5,0,0,0.0,0.0,0.0
1307662.0,6,4,264,2,132,0.0,66.0,66.0,2,132,0.0,66.0,66.0
216717.0,6,3,426,2,280,0.0,214.0,140.0,1,146,0.0,146.0,146.0
19066.0,6,11,1133,6,602,3711.8,264.0,100.33333333333331,5,531,4542.75,259.0,106.2
420.0,17,2,410,1,78,0.0,78.0,78.0,1,332,0.0,332.0,332.0
161849.0,17,2,582,1,83,0.0,83.0,83.0,1,499,0.0,499.0,499.0
35340.0,6,10,2032,5,524,8546.5,252.0,104.8,5,1508,8081.75,1236.0,301.6
38014.0,6,10,2032,5,524,8842.0,252.0,104.8,5,1508,9179.75,1236.0,301.6
120038413.0,17,29,13785,29,13785,4287086.178571428,501.0,475.3448275862069,0,0,0.0,0.0,0.0
307151.0,6,6,412,4,272,102383.66666666669,74.0,68.0,2,140,0.0,74.0,70.0
2050.0,17,4,344,2,150,0.0,75.0,75.0,2,194,0.0,103.0,97.0
1285207.0,17,7,490,7,490,214201.16666666663,70.0,70.0,0,0,0.0,0.0,0.0
57362.0,6,14,4740,7,653,9434.0,249.0,93.28571428571428,7,4087,8873.666666666666,1514.0,583.8571428571429
3126.0,17,4,344,2,150,0.0,75.0,75.0,2,194,0.0,103.0,97.0
113578095.0,6,389,62398,195,49150,585454.0979381443,1514.0,252.05128205128204,194,13248,587354.3471502591,214.0,68.28865979381443
5001563.0,17,4,849,2,166,0.0,83.0,83.0,2,683,0.0,499.0,341.5
2494866.0,6,3,1604,1,753,0.0,753.0,753.0,2,851,0.0,785.0,425.5
131085.0,6,3,337,2,214,0.0,160.0,107.0,1,123,0.0,123.0,123.0
31872.0,6,14,4740,7,653,4667.833333333333,249.0,93.28571428571428,7,4087,4856.833333333333,1514.0,583.8571428571429
311122.0,6,6,412,4,272,103707.33333333331,74.0,68.0,2,140,0.0,74.0,70.0
590655.0,6,4,508,2,238,0.0,172.0,119.0,2,270,0.0,135.0,135.0
92401966.0,6,20,1545,10,704,10262429.444444444,95.0,70.4,10,841,10266413.888888888,154.0,84.1
147471.0,6,3,373,2,238,0.0,172.0,119.0,1,135,0.0,135.0,135.0
120287268.0,6,331,38420,166,27234,729013.7454545455,284.0,164.06024096385542,165,11186,727084.5304878049,140.0,67.7939393939394
13924882.0,6,20,1607,10,975,1512747.4444444445,315.0,97.5,10,632,1512721.7777777778,78.0,63.2
506811.0,6,5,336,2,134,0.0,68.0,67.0,3,202,192742.5,70.0,67.33333333333333
109377500.0,6,216,24554,108,17106,1020208.3457943924,284.0,158.38888888888889,108,7448,1020208.2710280374,140.0,68.96296296296296
8809900.0,17,3,1034,2,684,0.0,342.0,342.0,1,350,0.0,350.0,350.0
314802.0,17,4,1400,4,1400,104934.0,350.0,350.0,0,0,0.0,0.0,0.0
2303.0,17,4,344,2,150,0.0,75.0,75.0,2,194,0.0,103.0,97.0
19107.0,6,10,1067,5,536,4612.5,264.0,107.2,5,531,3531.0,259.0,106.2
2694342.0,6,2,132,1,66,0.0,66.0,66.0,1,66,0.0,66.0,66.0
53969.0,6,14,4740,7,653,8760.833333333334,249.0,93.28571428571428,7,4087,8334.0,1514.0,583.8571428571429
27675804.0,17,5,1710,5,1710,6918951.0,342.0,342.0,0,0,0.0,0.0,0.0
10446260.0,6,6,412,3,206,5152332.5,74.0,68.66666666666667,3,206,5152228.0,74.0,68.66666666666667
303.0,17,2,156,1,78,0.0,78.0,78.0,1,78,0.0,78.0,78.0
259743.0,17,4,6056,4,6056,86581.0,1514.0,1514.0,0,0,0.0,0.0,0.0
91478810.0,6,20,1531,10,786,10158708.333333334,95.0,78.6,10,745,10163957.555555556,95.0,74.5
307248.0,6,6,412,4,272,102416.0,74.0,68.0,2,140,0.0,74.0,70.0
78072596.0,6,9,842,9,842,9759074.5,97.0,93.55555555555556,0,0,0.0,0.0,0.0
103648.0,17,2,286,2,286,0.0,143.0,143.0,0,0,0.0,0.0,0.0
135136283.0,17,6,1146,6,1146,27027256.6,191.0,191.0,0,0,0.0,0.0,0.0
108851.0,17,2,286,2,286,0.0,143.0,143.0,0,0,0.0,0.0,0.0
1314383.0,6,4,264,2,132,0.0,66.0,66.0,2,132,0.0,66.0,66.0
298293.0,6,6,412,4,272,99431.0,74.0,68.0,2,140,0.0,74.0,70.0
143633.0,6,2,132,1,66,0.0,66.0,66.0,1,66,0.0,66.0,66.0
5624309.0,6,5,336,2,134,0.0,68.0,67.0,3,202,1422050.5,70.0,67.33333333333333
58116.0,6,10,1065,5,534,13998.0,262.0,106.8,5,531,12745.75,259.0,106.2
2550962.0,6,20,6655,11,1672,255096.2,505.0,152.0,9,4983,279114.125,1510.0,553.6666666666666
2577346.0,6,2,132,1,66,0.0,66.0,66.0,1,66,0.0,66.0,66.0
323.0,17,2,174,1,79,0.0,79.0,79.0,1,95,0.0,95.0,95.0
12984.0,17,2,684,2,684,0.0,342.0,342.0,0,0,0.0,0.0,0.0
206920.0,6,3,426,2,280,0.0,214.0,140.0,1,146,0.0,146.0,146.0
29547.0,6,14,4740,7,653,4795.166666666667,249.0,93.28571428571428,7,4087,3331.1666666666665,1514.0,583.8571428571429
286599.0,17,2,363,1,79,0.0,79.0,79.0,1,284,0.0,284.0,284.0
92032279.0,6,26,2903,13,1450,7665633.5,425.0,111.53846153846152,13,1453,7669114.333333333,338.0,111.76923076923076
1152361.0,6,13,3010,8,2382,164623.0,1514.0,297.75,5,628,219913.0,331.0,125.6
342.0,17,2,166,1,75,0.0,75.0,75.0,1,91,0.0,91.0,91.0
119068260.0,6,48,3168,24,1584,5176880.869565218,66.0,66.0,24,1584,5163458.913043479,66.0,66.0
33446.0,6,13,1386,7,789,4780.166666666667,253.0,112.71428571428572,6,597,6049.0,259.0,99.5
120546846.0,17,13,821,7,432,20091141.0,174.0,61.71428571428572,6,389,20127068.2,174.0,64.83333333333333
284912.0,17,2,363,1,79,0.0,79.0,79.0,1,284,0.0,284.0,284.0
57226.0,6,14,4740,7,653,8269.833333333334,249.0,93.28571428571428,7,4087,8994.333333333334,1514.0,583.8571428571429
9689.0,17,2,582,1,83,0.0,83.0,83.0,1,499,0.0,499.0,499.0
205974.0,17,2,762,2,762,0.0,381.0,381.0,0,0,0.0,0.0,0.0
25425.0,6,10,2032,5,524,6129.0,252.0,104.8,5,1508,5504.5,1236.0,301.6
90553161.0,6,13,2036,8,1016,12936165.857142856,188.0,127.0,5,1020,22597367.0,204.0,204.0
49938.0,6,14,4740,7,653,8148.833333333333,249.0,93.28571428571428,7,4087,7363.166666666667,1514.0,583.8571428571429
219609.0,6,4,492,2,280,0.0,214.0,140.0,2,212,0.0,146.0,106.0
14632091.0,6,20,1607,10,975,1591947.6666666667,315.0,97.5,10,632,1591917.7777777778,78.0,63.2
205729.0,17,2,180,1,90,0.0,90.0,90.0,1,90,0.0,90.0,90.0
308012.0,6,7,478,4,272,102670.66666666669,74.0,68.0,3,206,78617.0,74.0,68.66666666666667
3189231.0,6,15,2358,8,1068,455604.4285714286,580.0,133.5,7,1290,495275.5,731.0,184.28571428571428
19698.0,6,2,145,2,145,0.0,91.0,72.5,0,0,0.0,0.0,0.0
10820369.0,6,7,478,3,206,5342189.5,74.0,68.66666666666667,4,272,3561407.333333333,74.0,68.0
91828734.0,6,227,26710,114,19030,812643.6637168141,464.0,166.9298245614035,113,7680,810514.4732142857,140.0,67.96460176991151
107207.0,17,2,286,2,286,0.0,143.0,143.0,0,0,0.0,0.0,0.0
90010478.0,17,28,13364,28,13364,3333721.407407407,501.0,477.2857142857143,0,0,0.0,0.0,0.0
120358929.0,6,245,27608,123,19260,986548.5983606556,300.0,156.58536585365854,122,8348,986130.2892561984,140.0,68.42622950819673
14467665.0,6,3,448,2,132,0.0,78.0,66.0,1,316,0.0,316.0,316.0
120343029.0,6,215,24370,108,17000,1124701.2056074766,284.0,157.40740740740742,107,7370,1126651.2264150945,140.0,68.8785046728972
89236847.0,17,14,4788,14,4788,6864372.846153846,342.0,342.0,0,0,0.0,0.0,0.0
23472487.0,6,5,1736,2,819,0.0,753.0,409.5,3,917,11663659.5,785.0,305.6666666666667
120056494.0,17,29,13785,29,13785,4287731.928571428,501.0,475.3448275862069,0,0,0.0,0.0,0.0
4343.0,17,2,180,1,90,0.0,90.0,90.0,1,90,0.0,90.0,90.0
5832468.0,6,6,402,3,200,1645008.0,68.0,66.66666666666667,3,202,1423066.0,70.0,67.33333333333333
109214900.0,6,209,23506,105,7152,1050143.2692307692,140.0,68.11428571428571,104,16354,1040166.1844660194,284.0,157.25
228251.0,17,2,180,1,90,0.0,90.0,90.0,1,90,0.0,90.0,90.0
52150.0,6,14,4740,7,653,8565.0,249.0,93.28571428571428,7,4087,8396.333333333334,1514.0,583.8571428571429
309773.0,6,6,412,4,272,103257.66666666669,74.0,68.0,2,140,0.0,74.0,70.0
120047920.0,17,28,13364,28,13364,4446219.259259259,501.0,477.2857142857143,0,0,0.0,0.0,0.0
90967972.0,6,21,1585,11,840,9095859.8,95.0,76.36363636363636,10,745,10107303.111111112,95.0,74.5
38708.0,6,10,2032,5,524,8642.5,252.0,104.8,5,1508,8439.5,1236.0,301.6
0.0,17,1,44,1,44,0.0,44.0,44.0,0,0,0.0,0.0,0.0
10464785.0,6,7,478,4,272,3442742.6666666665,74.0,68.0,3,206,5163980.5,74.0,68.66666666666667
120502.0,17,2,180,1,70,0.0,70.0,70.0,1,110,0.0,110.0,110.0
210078.0,6,3,426,2,280,0.0,214.0,140.0,1,146,0.0,146.0,146.0
2311.0,17,4,344,2,150,0.0,75.0,75.0,2,194,0.0,103.0,97.0
205756.0,17,2,180,1,90,0.0,90.0,90.0,1,90,0.0,90.0,90.0
278839.0,17,4,704,2,148,0.0,74.0,74.0,2,556,0.0,280.0,278.0
206163.0,6,3,426,2,280,0.0,214.0,140.0,1,146,0.0,146.0,146.0
103384.0,17,2,286,2,286,0.0,143.0,143.0,0,0,0.0,0.0,0.0
206106.0,6,3,426,2,280,0.0,214.0,140.0,1,146,0.0,146.0,146.0
0.0,17,1,381,1,381,0.0,381.0,381.0,0,0,0.0,0.0,0.0
135131884.0,17,6,1206,6,1206,27026376.8,201.0,201.0,0,0,0.0,0.0,0.0
3384.0,17,2,346,1,78,0.0,78.0,78.0,1,268,0.0,268.0,268.0
301.0,17,2,168,1,76,0.0,76.0,76.0,1,92,0.0,92.0,92.0
104036.0,17,2,286,2,286,0.0,143.0,143.0,0,0,0.0,0.0,0.0
146961.0,6,3,373,2,238,0.0,172.0,119.0,1,135,0.0,135.0,135.0
210365.0,6,3,426,2,280,0.0,214.0,140.0,1,146,0.0,146.0,146.0
2423.0,17,4,344,2,150,0.0,75.0,75.0,2,194,0.0,103.0,97.0
328799.0,6,6,412,4,272,109599.66666666669,74.0,68.0,2,140,0.0,74.0,70.0
2582935.0,6,2,132,1,66,0.0,66.0,66.0,1,66,0.0,66.0,66.0
123839682.0,6,48,3168,24,1584,5086666.260869565,66.0,66.0,24,1584,5215300.826086956,66.0,66.0
321.0,17,2,174,1,79,0.0,79.0,79.0,1,95,0.0,95.0,95.0
9002871.0,17,4,300,4,300,3000957.0,75.0,75.0,0,0,0.0,0.0,0.0
1306965.0,6,4,264,2,132,0.0,66.0,66.0,2,132,0.0,66.0,66.0
887396.0,6,10,1162,6,625,177479.2,287.0,104.16666666666669,4,537,204921.66666666663,331.0,134.25
100091789.0,17,14,864,7,432,16667310.833333334,174.0,61.71428571428572,7,432,16666831.5,174.0,61.71428571428572
93016962.0,6,40,2640,20,1320,4895152.368421053,66.0,66.0,20,1320,4888909.736842105,66.0,66.0
90050372.0,17,28,13364,28,13364,3335198.962962963,501.0,477.2857142857143,0,0,0.0,0.0,0.0
90217036.0,6,16,1192,8,596,12853381.142857144,95.0,74.5,8,596,12858901.57142857,95.0,74.5
35252.0,6,12,1413,7,882,5875.333333333333,291.0,126.0,5,531,7280.25,259.0,106.2
228328.0,17,2,180,1,90,0.0,90.0,90.0,1,90,0.0,90.0,90.0
15035.0,17,2,180,1,90,0.0,90.0,90.0,1,90,0.0,90.0,90.0
120120674.0,6,12,1832,8,1016,17137078.714285713,188.0,127.0,4,816,30019897.33333333,204.0,204.0
121203.0,6,3,337,2,214,0.0,160.0,107.0,1,123,0.0,123.0,123.0
10463792.0,6,7,478,4,272,3442751.6666666665,74.0,68.0,3,206,5164040.5,74.0,68.66666666666667
412.0,17,2,410,1,78,0.0,78.0,78.0,1,332,0.0,332.0,332.0
312945.0,17,4,1400,4,1400,104315.0,350.0,350.0,0,0,0.0,0.0,0.0
2421.0,17,4,344,2,150,0.0,75.0,75.0,2,194,0.0,103.0,97.0
99869211.0,6,178,20328,89,14232,1132432.0227272727,374.0,159.91011235955057,89,6096,1132431.875,140.0,68.49438202247191
856943.0,6,9,1270,6,799,171388.6,461.0,133.16666666666666,3,471,292191.0,331.0,157.0
108111616.0,17,5,1005,5,1005,27027904.0,201.0,201.0,0,0,0.0,0.0,0.0
41792.0,6,10,2032,5,524,9462.0,252.0,104.8,5,1508,9834.0,1236.0,301.6
2423.0,17,4,344,2,150,0.0,75.0,75.0,2,194,0.0,103.0,97.0
30584.0,6,10,2032,5,524,7397.25,252.0,104.8,5,1508,7162.75,1236.0,301.6
120205922.0,6,257,29306,129,8810,939108.765625,140.0,68.29457364341086,128,20496,938296.5118110236,284.0,160.125
102125.0,17,2,286,2,286,0.0,143.0,143.0,0,0,0.0,0.0,0.0
5620575.0,6,4,270,2,134,0.0,68.0,67.0,2,136,0.0,70.0,68.0
120109720.0,6,14,2240,6,1224,24021944.0,204.0,204.0,8,1016,17135083.14285714,188.0,127.0
70289839.0,6,19,1334,9,640,8785077.625,95.0,71.11111111111111,10,694,7808309.666666667,95.0,69.4
64486.0,6,14,4740,7,653,10423.666666666666,249.0,93.28571428571428,7,4087,9915.0,1514.0,583.8571428571429
90764421.0,6,20,1531,11,840,9071144.8,95.0,76.36363636363636,9,691,11344620.75,95.0,76.77777777777777
90259234.0,6,12,1832,8,1016,12894176.285714284,188.0,127.0,4,816,30030852.33333333,204.0,204.0
1410652.0,6,18,6507,10,1598,156739.11111111112,505.0,159.8,8,4909,157426.14285714287,1510.0,613.625
14636298.0,6,20,1648,10,1016,1592494.3333333333,315.0,101.6,10,632,1592472.3333333333,78.0,63.2
2065.0,6,2,177,1,123,0.0,123.0,123.0,1,54,0.0,54.0,54.0
221046.0,6,3,426,2,280,0.0,214.0,140.0,1,146,0.0,146.0,146.0
90011560.0,17,28,13364,28,13364,3333761.4814814813,501.0,477.2857142857143,0,0,0.0,0.0,0.0
122719290.0,6,47,3102,23,1518,5159979.863636363,66.0,66.0,24,1584,5335609.304347826,66.0,66.0
2374.0,17,4,344,2,150,0.0,75.0,75.0,2,194,0.0,103.0,97.0
40700.0,6,10,2032,5,524,9279.75,252.0,104.8,5,1508,9642.25,1236.0,301.6
246200.0,6,3,337,2,214,0.0,160.0,107.0,1,123,0.0,123.0,123.0
204317.0,17,2,762,2,762,0.0,381.0,381.0,0,0,0.0,0.0,0.0
146187.0,6,3,337,2,214,0.0,160.0,107.0,1,123,0.0,123.0,123.0
15746.0,6,20,7606,11,978,1574.6,310.0,88.9090909090909,9,6628,1744.875,1514.0,736.4444444444445
31836.000000000004,6,14,4740,7,653,5109.333333333333,249.0,93.28571428571428,7,4087,5061.0,1514.0,583.8571428571429
209532.0,17,2,180,1,90,0.0,90.0,90.0,1,90,0.0,90.0,90.0
2387.0,17,4,344,2,150,0.0,75.0,75.0,2,194,0.0,103.0,97.0
108102408.0,17,5,1005,5,1005,27025602.0,201.0,201.0,0,0,0.0,0.0,0.0
123852.0,6,3,373,2,238,0.0,172.0,119.0,1,135,0.0,135.0,135.0
322317.0,17,4,1400,4,1400,107439.0,350.0,350.0,0,0,0.0,0.0,0.0
22698.0,6,14,4740,7,653,3592.0,249.0,93.28571428571428,7,4087,3646.1666666666665,1514.0,583.8571428571429
149495054.0,17,36,17126,36,17126,4271287.257142857,501.0,475.72222222222223,0,0,0.0,0.0,0.0
120269348.0,6,17,1287,9,691,15033668.5,95.0,76.77777777777777,8,596,17106418.57142857,95.0,74.5
121010665.0,17,15,907,8,475,17287237.85714286,174.0,59.375,7,432,16833472.666666668,174.0,61.71428571428572
31103.0,6,14,4740,7,653,4605.166666666667,249.0,93.28571428571428,7,4087,4364.166666666667,1514.0,583.8571428571429
302253.0,6,6,412,4,272,100751.0,74.0,68.0,2,140,0.0,74.0,70.0
144742.0,6,2,132,1,66,0.0,66.0,66.0,1,66,0.0,66.0,66.0
49909.0,6,14,4740,7,653,8208.333333333334,249.0,93.28571428571428,7,4087,7952.333333333333,1514.0,583.8571428571429
34710.0,6,10,2032,5,524,6969.5,252.0,104.8,5,1508,8406.0,1236.0,301.6
33729.0,6,14,4740,7,653,5254.333333333333,249.0,93.28571428571428,7,4087,5316.333333333333,1514.0,583.8571428571429
2635426.0,6,23,6507,12,1529,239584.18181818185,357.0,127.41666666666669,11,4978,230218.9,1510.0,452.54545454545456
122301.0,6,3,373,2,238,0.0,172.0,119.0,1,135,0.0,135.0,135.0
382946.0,17,2,363,1,75,0.0,75.0,75.0,1,288,0.0,288.0,288.0
4299.0,17,2,614,1,72,0.0,72.0,72.0,1,542,0.0,542.0,542.0
99339.0,17,2,762,2,762,0.0,381.0,381.0,0,0,0.0,0.0,0.0
251422.0,6,3,337,2,214,0.0,160.0,107.0,1,123,0.0,123.0,123.0
55514.0,6,14,4740,7,653,7379.5,249.0,93.28571428571428,7,4087,9093.833333333334,1514.0,583.8571428571429
143929.0,17,2,180,1,90,0.0,90.0,90.0,1,90,0.0,90.0,90.0
39345.0,6,14,4740,7,653,6432.833333333333,249.0,93.28571428571428,7,4087,6269.833333333333,1514.0,583.8571428571429
206202.0,17,4,6056,4,6056,68734.0,1514.0,1514.0,0,0,0.0,0.0,0.0
153373.0,17,2,180,1,90,0.0,90.0,90.0,1,90,0.0,90.0,90.0
13717.0,17,2,180,1,90,0.0,90.0,90.0,1,90,0.0,90.0,90.0
216420.0,17,2,180,1,90,0.0,90.0,90.0,1,90,0.0,90.0,90.0
14639540.0,6,20,1648,10,1016,1592268.2222222222,315.0,101.6,10,632,1592222.888888889,78.0,63.2
108091215.0,17,5,1005,5,1005,27022803.75,201.0,201.0,0,0,0.0,0.0,0.0
120118323.0,6,14,2240,8,1016,17097067.14285714,188.0,127.0,6,1224,18073291.8,204.0,204.0
108102940.0,17,5,1005,5,1005,27025735.0,201.0,201.0,0,0,0.0,0.0,0.0
292.0,17,2,156,1,78,0.0,78.0,78.0,1,78,0.0,78.0,78.0
148557.0,6,14,4740,7,653,18418.666666666668,249.0,93.28571428571428,7,4087,16713.666666666668,1514.0,583.8571428571429
5005909.0,17,2,168,2,168,0.0,84.0,84.0,0,0,0.0,0.0,0.0
38474.0,6,14,4740,7,653,6291.5,249.0,93.28571428571428,7,4087,6274.0,1514.0,583.8571428571429
120467066.0,6,23,1775,11,840,12046706.6,95.0,76.36363636363636,12,935,8224079.454545454,95.0,77.91666666666667
108087205.0,17,5,1005,5,1005,27021801.25,201.0,201.0,0,0,0.0,0.0,0.0
2797380.0,6,2,132,1,66,0.0,66.0,66.0,1,66,0.0,66.0,66.0
15118.0,17,2,180,1,90,0.0,90.0,90.0,1,90,0.0,90.0,90.0
894009.0,6,12,1354,6,723,177721.6,253.0,120.5,6,631,178449.8,293.0,105.16666666666669
141608.0,6,2,132,1,66,0.0,66.0,66.0,1,66,0.0,66.0,66.0
2390.0,17,4,344,2,150,0.0,75.0,75.0,2,194,0.0,103.0,97.0
64929.0,6,14,4740,7,653,10615.166666666666,249.0,93.28571428571428,7,4087,8892.666666666666,1514.0,583.8571428571429
112764345.0,6,31,2166,16,1149,7503235.866666666,123.0,71.8125,15,1017,8039182.285714285,123.0,67.8
2795190.0,6,2,132,1,66,0.0,66.0,66.0,1,66,0.0,66.0,66.0
134746.0,6,2,132,1,66,0.0,66.0,66.0,1,66,0.0,66.0,66.0
13823.0,17,2,180,1,90,0.0,90.0,90.0,1,90,0.0,90.0,90.0
2632323.0,6,3,1604,2,851,0.0,785.0,425.5,1,753,0.0,753.0,753.0
9266.0,17,2,539,1,86,0.0,86.0,86.0,1,453,0.0,453.0,453.0
108637.0,17,2,700,2,700,0.0,350.0,350.0,0,0,0.0,0.0,0.0
123763621.0,6,20,1658,9,818,11815539.25,222.0,90.88888888888889,11,840,12351083.8,95.0,76.36363636363636
2335.0,17,4,344,2,150,0.0,75.0,75.0,2,194,0.0,103.0,97.0
6012.0,17,4,823,2,163,0.0,89.0,81.5,2,660,0.0,443.0,330.0
581609.0,6,15,4815,7,742,91678.0,230.0,106.0,8,4073,82908.71428571429,1514.0,509.125
241910.0,6,3,337,2,214,0.0,160.0,107.0,1,123,0.0,123.0,123.0
1059208.0,6,3,204,2,136,0.0,70.0,68.0,1,68,0.0,68.0,68.0
498449.0,6,5,336,2,134,0.0,68.0,67.0,3,202,190645.0,70.0,67.33333333333333
135127982.0,17,6,1146,6,1146,27025596.4,191.0,191.0,0,0,0.0,0.0,0.0
216507.0,17,2,180,1,90,0.0,90.0,90.0,1,90,0.0,90.0,90.0
268176.0,6,10,1221,6,636,53635.2,298.0,106.0,4,585,84004.0,379.0,146.25
2354728.0,6,3,1604,1,753,0.0,753.0,753.0,2,851,0.0,785.0,425.5
317899.0,17,4,1400,4,1400,105966.33333333331,350.0,350.0,0,0,0.0,0.0,0.0
2113616.0,6,2,132,1,66,0.0,66.0,66.0,1,66,0.0,66.0,66.0
613.0,17,2,508,2,508,0.0,257.0,254.0,0,0,0.0,0.0,0.0
1421005.0,17,2,346,1,78,0.0,78.0,78.0,1,268,0.0,268.0,268.0
198938.0,17,2,180,1,90,0.0,90.0,90.0,1,90,0.0,90.0,90.0
108670.0,17,2,286,2,286,0.0,143.0,143.0,0,0,0.0,0.0,0.0
3245973.0,6,3,1777,2,951,0.0,885.0,475.5,1,826,0.0,826.0,826.0
5623528.0,6,5,336,2,134,0.0,68.0,67.0,3,202,1526604.0,70.0,67.33333333333333
108103633.0,17,5,1005,5,1005,27025908.25,201.0,201.0,0,0,0.0,0.0,0.0
90972730.0,6,153,17146,77,5304,1197009.605263158,140.0,68.88311688311688,76,11842,1185570.7066666668,284.0,155.81578947368422
104711086.0,17,15,5130,15,5130,7479363.285714285,342.0,342.0,0,0,0.0,0.0,0.0
2938962.0,6,12,2172,7,664,489731.5,252.0,94.85714285714286,5,1508,6232.25,1236.0,301.6
218608.0,17,2,180,1,90,0.0,90.0,90.0,1,90,0.0,90.0,90.0
30836.0,6,14,4740,7,653,4853.5,249.0,93.28571428571428,7,4087,3687.0,1514.0,583.8571428571429
25609.0,6,10,2032,5,524,4648.5,252.0,104.8,5,1508,5702.5,1236.0,301.6
21504.0,6,10,2032,5,524,5126.5,252.0,104.8,5,1508,5025.25,1236.0,301.6
3006203.0,6,11,2106,6,598,601058.4,252.0,99.66666666666669,5,1508,1895.25,1236.0,301.6
16788.0,17,2,180,1,90,0.0,90.0,90.0,1,90,0.0,90.0,90.0
246437.0,6,3,373,2,238,0.0,172.0,119.0,1,135,0.0,135.0,135.0
241846.0,6,3,373,2,238,0.0,172.0,119.0,1,135,0.0,135.0,135.0
5617195.0,6,5,336,2,134,0.0,68.0,67.0,3,202,1374067.0,70.0,67.33333333333333
135130930.0,17,6,1146,6,1146,27026186.0,191.0,191.0,0,0,0.0,0.0,0.0
3011906.0,6,11,2106,6,598,601774.2,252.0,99.66666666666669,5,1508,2740.75,1236.0,301.6
120098076.0,6,206,23314,103,7094,1169462.5,140.0,68.87378640776699,103,16220,1160407.8823529412,284.0,157.4757281553398
43730401.0,6,7,1874,5,1053,10932600.25,785.0,210.6,2,821,0.0,753.0,410.5
284120.0,17,2,363,1,79,0.0,79.0,79.0,1,284,0.0,284.0,284.0
58059.0,17,2,180,1,90,0.0,90.0,90.0,1,90,0.0,90.0,90.0
107416933.0,6,31,2160,16,1071,7161128.866666666,123.0,66.9375,15,1089,7643828.571428572,123.0,72.6
2796878.0,6,2,132,1,66,0.0,66.0,66.0,1,66,0.0,66.0,66.0
137.0,17,2,700,2,700,0.0,350.0,350.0,0,0,0.0,0.0,0.0
305819.0,17,2,1500,1,994,0.0,994.0,994.0,1,506,0.0,506.0,506.0
317216.0,17,4,1400,4,1400,105738.66666666669,350.0,350.0,0,0,0.0,0.0,0.0
206092.0,17,2,180,1,90,0.0,90.0,90.0,1,90,0.0,90.0,90.0
108093.0,17,2,286,2,286,0.0,143.0,143.0,0,0,0.0,0.0,0.0
774.0,17,4,438,2,148,0.0,74.0,74.0,2,290,0.0,147.0,145.0
146120.0,6,3,337,2,214,0.0,160.0,107.0,1,123,0.0,123.0,123.0
856.0,17,5,550,5,550,214.0,110.0,110.0,0,0,0.0,0.0,0.0
120126145.0,6,14,2224,9,1204,15015768.125,188.0,133.77777777777777,5,1020,22595669.25,204.0,204.0
100793700.0,6,28,1860,14,966,7736740.692307692,123.0,69.0,14,894,7736746.615384615,123.0,63.85714285714285
120116626.0,6,16,2632,9,1204,15014578.25,188.0,133.77777777777777,7,1428,15059211.5,204.0,204.0
28513.0,6,11,2098,6,590,5260.6,252.0,98.33333333333331,5,1508,5738.0,1236.0,301.6
153492.0,17,2,180,1,90,0.0,90.0,90.0,1,90,0.0,90.0,90.0
216945.0,6,3,426,2,280,0.0,214.0,140.0,1,146,0.0,146.0,146.0
2824.0,17,2,762,2,762,0.0,381.0,381.0,0,0,0.0,0.0,0.0
315030.0,17,4,1400,4,1400,105010.0,350.0,350.0,0,0,0.0,0.0,0.0
2018158.0,17,4,525,2,150,0.0,75.0,75.0,2,375,0.0,284.0,187.5
14909.0,6,13,1459,7,862,2348.5,271.0,123.14285714285714,6,597,2767.2,259.0,99.5
120003070.0,6,17,1246,9,650,15000383.75,95.0,72.22222222222223,8,596,17108047.85714286,95.0,74.5
1695628.0,6,4,276,2,128,0.0,74.0,64.0,2,148,0.0,74.0,74.0
2086.0,17,4,344,2,150,0.0,75.0,75.0,2,194,0.0,103.0,97.0
90013707.0,17,28,13364,28,13364,3333841.0,501.0,477.2857142857143,0,0,0.0,0.0,0.0
2418457.0,6,25,7573,14,3735,186035.15384615384,1514.0,266.7857142857143,11,3838,215916.2,1514.0,348.90909090909093
116642159.0,17,16,1212,8,606,16663165.57142857,174.0,75.75,8,606,16546462.142857144,174.0,75.75
162455.0,17,2,180,1,90,0.0,90.0,90.0,1,90,0.0,90.0,90.0
103828.0,17,2,286,2,286,0.0,143.0,143.0,0,0,0.0,0.0,0.0
313373.0,17,4,1400,4,1400,104457.66666666669,350.0,350.0,0,0,0.0,0.0,0.0
16340147.000000002,17,6,2052,6,2052,3268029.4,342.0,342.0,0,0,0.0,0.0,0.0
304.0,17,2,174,1,79,0.0,79.0,79.0,1,95,0.0,95.0,95.0
1314762.0,6,4,264,2,132,0.0,66.0,66.0,2,132,0.0,66.0,66.0
867246.0,6,10,1262,6,725,173449.2,387.0,120.83333333333331,4,537,198244.0,331.0,134.25
245577.0,6,3,337,2,214,0.0,160.0,107.0,1,123,0.0,123.0,123.0
90033881.0,17,28,13364,28,13364,3334588.185185185,501.0,477.2857142857143,0,0,0.0,0.0,0.0
2402.0,17,4,344,2,150,0.0,75.0,75.0,2,194,0.0,103.0,97.0
130330.0,6,3,337,2,214,0.0,160.0,107.0,1,123,0.0,123.0,123.0
9434.0,6,10,2032,5,524,1950.25,252.0,104.8,5,1508,2108.0,1236.0,301.6
31605575.0,6,26,7627,14,3735,195690.6923076923,1514.0,266.7857142857143,12,3892,2853600.1818181816,1514.0,324.3333333333333
122091.0,6,3,337,2,214,0.0,160.0,107.0,1,123,0.0,123.0,123.0
135130496.0,17,6,1206,6,1206,27026099.2,201.0,201.0,0,0,0.0,0.0,0.0
28355.0,6,10,2032,5,524,6190.25,252.0,104.8,5,1508,6467.25,1236.0,301.6
46538.0,6,14,4740,7,653,7295.833333333333,249.0,93.28571428571428,7,4087,7048.666666666667,1514.0,583.8571428571429
46062.0,6,14,4740,7,653,6774.333333333333,249.0,93.28571428571428,7,4087,6853.0,1514.0,583.8571428571429
120121586.0,6,14,2224,9,1204,15015198.25,188.0,133.77777777777777,5,1020,22522465.25,204.0,204.0
207319.0,6,3,426,2,280,0.0,214.0,140.0,1,146,0.0,146.0,146.0
105908416.0,17,15,1169,8,606,15000466.0,174.0,75.75,7,563,17500162.666666668,174.0,80.42857142857143
111549.0,17,2,286,2,286,0.0,143.0,143.0,0,0,0.0,0.0,0.0
325196.0,17,4,1400,4,1400,108398.66666666669,350.0,350.0,0,0,0.0,0.0,0.0
30255.0,6,10,2032,5,524,7339.0,252.0,104.8,5,1508,7236.5,1236.0,301.6
206015.0,6,3,426,2,280,0.0,214.0,140.0,1,146,0.0,146.0,146.0
90026574.0,17,28,13364,28,13364,3334317.5555555555,501.0,477.2857142857143,0,0,0.0,0.0,0.0
121200942.0,6,212,23980,106,7292,1137850.9714285715,140.0,68.79245283018868,106,16688,1146451.219047619,284.0,157.43396226415095
764.0,17,4,438,2,148,0.0,74.0,74.0,2,290,0.0,147.0,145.0
245867.0,17,4,6056,4,6056,81955.66666666667,1514.0,1514.0,0,0,0.0,0.0,0.0
9667.0,17,4,571,2,148,0.0,74.0,74.0,2,423,0.0,280.0,211.5
113167639.0,6,45,2970,23,1518,5143983.590909091,66.0,66.0,22,1452,5223631.571428572,66.0,66.0
1417910.0,17,16,1120,16,1120,94527.33333333331,70.0,70.0,0,0,0.0,0.0,0.0
216482.0,17,2,180,1,90,0.0,90.0,90.0,1,90,0.0,90.0,90.0
112198769.0,6,199,22492,100,6896,1133320.898989899,140.0,68.96,99,15596,1134315.7653061224,284.0,157.53535353535352
107795700.0,6,31,2166,16,1149,7171992.266666667,123.0,71.8125,15,1017,7684275.285714285,123.0,67.8
310206.0,17,4,1400,4,1400,103402.0,350.0,350.0,0,0,0.0,0.0,0.0
109948671.0,6,44,3714,25,2067,4581194.625,123.0,82.68,19,1647,6095658.277777778,123.0,86.6842105263158
110627188.0,6,30,1974,15,1026,7886513.5,123.0,68.4,15,948,7886512.0,123.0,63.2
144052.0,17,2,180,1,90,0.0,90.0,90.0,1,90,0.0,90.0,90.0
1181758.0,6,13,3010,8,2382,168822.57142857142,1514.0,297.75,5,628,227333.75,331.0,125.6
135138336.0,17,6,1146,6,1146,27027667.2,191.0,191.0,0,0,0.0,0.0,0.0
69554.0,6,14,4740,7,653,10952.666666666666,249.0,93.28571428571428,7,4087,10160.166666666666,1514.0,583.8571428571429
196849.0,17,2,180,1,90,0.0,90.0,90.0,1,90,0.0,90.0,90.0
505.0,17,2,508,2,508,0.0,257.0,254.0,0,0,0.0,0.0,0.0
9066.0,17,2,582,1,83,0.0,83.0,83.0,1,499,0.0,499.0,499.0
37082.0,6,14,4740,7,653,6002.833333333333,249.0,93.28571428571428,7,4087,5907.333333333333,1514.0,583.8571428571429
2252328.0,6,12,1776,4,468,749821.6666666666,262.0,117.0,8,1308,321419.5714285714,259.0,163.5
114160137.0,6,47,3102,24,1584,4951514.217391305,66.0,66.0,23,1518,5135423.318181818,66.0,66.0
4441.0,17,2,614,1,72,0.0,72.0,72.0,1,542,0.0,542.0,542.0
90256471.0,6,12,1832,8,1016,12893781.57142857,188.0,127.0,4,816,30031480.666666668,204.0,204.0
1848812.0,6,4,270,2,134,0.0,68.0,67.0,2,136,0.0,70.0,68.0
78320.0,6,12,1328,7,797,13053.333333333334,253.0,113.85714285714286,5,531,16915.0,259.0,106.2
90064108.0,17,28,13364,28,13364,3335707.703703704,501.0,477.2857142857143,0,0,0.0,0.0,0.0
94464776.0,6,40,2640,20,1320,4971830.315789473,66.0,66.0,20,1320,4955539.421052632,66.0,66.0
205621.0,17,2,180,1,90,0.0,90.0,90.0,1,90,0.0,90.0,90.0
228491.0,17,2,180,1,90,0.0,90.0,90.0,1,90,0.0,90.0,90.0
108102888.0,17,5,955,5,955,27025722.0,191.0,191.0,0,0,0.0,0.0,0.0
217122.0,17,2,180,1,90,0.0,90.0,90.0,1,90,0.0,90.0,90.0
320888.0,17,2,180,1,90,0.0,90.0,90.0,1,90,0.0,90.0,90.0
26372.0,6,12,1413,6,816,4977.2,291.0,136.0,6,597,4607.2,259.0,99.5
153431.0,17,2,180,1,90,0.0,90.0,90.0,1,90,0.0,90.0,90.0
211394.0,17,2,180,1,90,0.0,90.0,90.0,1,90,0.0,90.0,90.0
146271.0,6,3,337,2,214,0.0,160.0,107.0,1,123,0.0,123.0,123.0
858789.0,6,9,1096,6,625,171757.8,287.0,104.16666666666669,3,471,291525.5,331.0,157.0
120513972.0,6,215,24230,108,16872,1126298.8037383177,284.0,156.22222222222223,107,7358,1127142.924528302,140.0,68.76635514018692
302371.0,6,2,132,1,66,0.0,66.0,66.0,1,66,0.0,66.0,66.0
884856.0,6,10,1334,6,797,176971.2,459.0,132.83333333333334,4,537,204103.3333333333,331.0,134.25
1029981.0,6,11,1134,6,558,205996.2,220.0,93.0,5,576,256455.5,304.0,115.2
1024724.0,6,11,1134,6,558,204944.8,220.0,93.0,5,576,254061.5,304.0,115.2
332.0,17,2,166,1,75,0.0,75.0,75.0,1,91,0.0,91.0,91.0
146189.0,6,3,337,2,214,0.0,160.0,107.0,1,123,0.0,123.0,123.0
2013.0,17,2,691,1,349,0.0,349.0,349.0,1,342,0.0,342.0,342.0
105361207.0,17,14,864,7,432,17501374.833333332,174.0,61.71428571428572,7,432,17500166.333333332,174.0,61.71428571428572
90049144.0,17,28,13364,28,13364,3335153.4814814813,501.0,477.2857142857143,0,0,0.0,0.0,0.0
90302511.0,6,16,1192,8,596,12893431.285714284,95.0,74.5,8,596,12898811.714285716,95.0,74.5
104478.0,17,2,286,2,286,0.0,143.0,143.0,0,0,0.0,0.0,0.0
9518.0,17,2,571,1,86,0.0,86.0,86.0,1,485,0.0,485.0,485.0
69155.0,17,2,608,1,75,0.0,75.0,75.0,1,533,0.0,533.0,533.0
118976099.0,6,38,2710,19,1408,6609783.277777778,139.0,74.10526315789474,19,1302,6598371.333333333,123.0,68.52631578947368
720.0,17,4,438,2,148,0.0,74.0,74.0,2,290,0.0,147.0,145.0
298601.0,6,6,412,4,272,99533.66666666669,74.0,68.0,2,140,0.0,74.0,70.0
327091.0,17,4,1400,4,1400,109030.33333333331,350.0,350.0,0,0,0.0,0.0,0.0
125810717.0,6,60,12336,30,6449,3313681.620689655,1514.0,214.96666666666667,30,5887,4331239.9655172415,1514.0,196.2333333333333
310318.0,6,6,412,4,272,103439.33333333331,74.0,68.0,2,140,0.0,74.0,70.0
2388.0,17,4,344,2,150,0.0,75.0,75.0,2,194,0.0,103.0,97.0
135127820.0,17,6,1146,6,1146,27025564.0,191.0,191.0,0,0,0.0,0.0,0.0
512972.0,6,5,336,2,134,0.0,68.0,67.0,3,202,178685.5,70.0,67.33333333333333
99118844.0,17,12,778,6,389,19801029.2,174.0,64.83333333333333,6,389,19800150.8,174.0,64.83333333333333
8418532.0,17,3,1034,2,684,0.0,342.0,342.0,1,350,0.0,350.0,350.0
90948920.0,6,26,1876,13,938,7579076.666666667,95.0,72.15384615384616,13,938,7560396.25,95.0,72.15384615384616
209380.0,17,2,180,1,90,0.0,90.0,90.0,1,90,0.0,90.0,90.0
162356.0,17,2,180,1,90,0.0,90.0,90.0,1,90,0.0,90.0,90.0
42494.0,6,10,2032,5,524,10443.75,252.0,104.8,5,1508,9842.0,1236.0,301.6
90291924.0,6,14,1043,7,542,15048654.0,95.0,77.42857142857143,7,501,15000007.833333334,95.0,71.57142857142857
2074.0,17,4,344,2,150,0.0,75.0,75.0,2,194,0.0,103.0,97.0
95599.0,6,14,4740,7,653,9462.0,249.0,93.28571428571428,7,4087,15706.833333333334,1514.0,583.8571428571429
35795.0,6,14,4740,7,653,4886.666666666667,249.0,93.28571428571428,7,4087,5834.166666666667,1514.0,583.8571428571429
98282692.0,17,14,1126,7,563,16334559.166666666,174.0,80.42857142857143,7,563,16333469.0,174.0,80.42857142857143
26099.0,6,10,2032,5,524,6302.0,252.0,104.8,5,1508,6048.25,1236.0,301.6
90257158.0,6,13,2036,8,1016,12893879.714285716,188.0,127.0,5,1020,22523953.75,204.0,204.0
1186037.0,6,13,3010,8,2382,169433.85714285713,1514.0,297.75,5,628,227562.25,331.0,125.6
46577.0,6,14,4740,7,653,6458.666666666667,249.0,93.28571428571428,7,4087,7317.833333333333,1514.0,583.8571428571429
28185.0,6,14,4740,7,653,4459.833333333333,249.0,93.28571428571428,7,4087,3194.833333333333,1514.0,583.8571428571429
143936.0,17,2,180,1,90,0.0,90.0,90.0,1,90,0.0,90.0,90.0
0.0,17,1,44,1,44,0.0,44.0,44.0,0,0,0.0,0.0,0.0
32343.0,17,4,820,2,156,0.0,78.0,78.0,2,664,0.0,332.0,332.0
525.0,17,2,508,2,508,0.0,257.0,254.0,0,0,0.0,0.0,0.0
345.0,17,2,250,1,93,0.0,93.0,93.0,1,157,0.0,157.0,157.0
121188.0,6,3,373,2,238,0.0,172.0,119.0,1,135,0.0,135.0,135.0
224290.0,6,3,426,2,280,0.0,214.0,140.0,1,146,0.0,146.0,146.0
344.0,17,2,250,1,93,0.0,93.0,93.0,1,157,0.0,157.0,157.0
2089980.0,6,24,7542,12,2450,189998.18181818185,1034.0,204.16666666666663,12,5092,162351.72727272726,1510.0,424.3333333333333
155250.0,17,6,1230,3,234,77444.0,78.0,78.0,3,996,77419.0,332.0,332.0
2794089.0,6,2,132,1,66,0.0,66.0,66.0,1,66,0.0,66.0,66.0
1307993.0,6,4,264,2,132,0.0,66.0,66.0,2,132,0.0,66.0,66.0
2101214.0,6,28,12476,15,4556,150086.7142857143,1510.0,303.7333333333333,13,7920,148622.66666666666,1510.0,609.2307692307693
4313.0,17,2,602,1,72,0.0,72.0,72.0,1,530,0.0,530.0,530.0
120000293.0,6,37,4157,21,2461,6000014.65,427.0,117.1904761904762,16,1696,7848699.066666666,337.0,106.0
120129361.0,6,14,2102,6,1086,24025872.2,204.0,181.0,8,1016,17137050.57142857,188.0,127.0
797288.0,6,6,758,3,410,386995.0,172.0,136.66666666666666,3,348,282822.5,135.0,116.0
870966.0,6,9,1096,6,625,174193.2,287.0,104.16666666666669,3,471,297473.0,331.0,157.0
119728978.0,17,35,16705,35,16705,3521440.529411765,501.0,477.2857142857143,0,0,0.0,0.0,0.0
101210798.0,6,29,2052,15,1089,7213935.142857143,123.0,72.6,14,963,7768852.923076923,123.0,68.78571428571429
259181.0,6,3,337,2,214,0.0,160.0,107.0,1,123,0.0,123.0,123.0
1450.0,17,2,762,2,762,0.0,381.0,381.0,0,0,0.0,0.0,0.0
32091.0,6,20,7606,11,978,3209.1,310.0,88.9090909090909,9,6628,3027.875,1514.0,736.4444444444445
112611517.0,17,14,864,7,432,18500878.5,174.0,61.71428571428572,7,432,18666872.0,174.0,61.71428571428572
2009.0,17,4,344,2,150,0.0,75.0,75.0,2,194,0.0,103.0,97.0
143825.0,17,2,180,1,90,0.0,90.0,90.0,1,90,0.0,90.0,90.0
110777.0,17,2,286,2,286,0.0,143.0,143.0,0,0,0.0,0.0,0.0
206335.0,6,3,426,2,280,0.0,214.0,140.0,1,146,0.0,146.0,146.0
52548.0,6,14,4740,7,653,8504.833333333334,249.0,93.28571428571428,7,4087,7670.166666666667,1514.0,583.8571428571429
21185.0,6,10,2032,5,524,3501.0,252.0,104.8,5,1508,5077.75,1236.0,301.6
20733.0,6,10,2032,5,524,4257.0,252.0,104.8,5,1508,4893.5,1236.0,301.6
144016.0,17,2,180,1,90,0.0,90.0,90.0,1,90,0.0,90.0,90.0
298295.0,6,6,412,4,272,99431.66666666669,74.0,68.0,2,140,0.0,74.0,70.0
123944375.0,17,14,864,7,432,17333489.666666668,174.0,61.71428571428572,7,432,17336258.666666668,174.0,61.71428571428572
2426.0,17,2,762,2,762,0.0,381.0,381.0,0,0,0.0,0.0,0.0
326.0,17,2,166,1,75,0.0,75.0,75.0,1,91,0.0,91.0,91.0
1242219.0,6,7,499,4,301,402929.6666666667,103.0,75.25,3,198,613781.5,66.0,66.0
90040867.0,17,28,13364,28,13364,3334846.925925926,501.0,477.2857142857143,0,0,0.0,0.0,0.0
224191.0,6,3,426,2,280,0.0,214.0,140.0,1,146,0.0,146.0,146.0
94570057.0,6,24,1990,13,1191,7880037.416666667,256.0,91.6153846153846,11,799,9456642.0,95.0,72.63636363636364
74702.0,6,12,1320,6,723,13535.0,253.0,120.5,6,597,11206.2,259.0,99.5
218020.0,6,3,426,2,280,0.0,214.0,140.0,1,146,0.0,146.0,146.0
229994.0,17,2,180,1,90,0.0,90.0,90.0,1,90,0.0,90.0,90.0
2768502.0,6,3,1604,2,851,0.0,785.0,425.5,1,753,0.0,753.0,753.0
52099.0,6,14,4740,7,653,8560.666666666666,249.0,93.28571428571428,7,4087,7989.333333333332,1514.0,583.8571428571429
25056.0,6,14,4740,7,653,4048.5,249.0,93.28571428571428,7,4087,3662.3333333333335,1514.0,583.8571428571429
65974.0,17,2,180,1,90,0.0,90.0,90.0,1,90,0.0,90.0,90.0
98731.0,17,4,6056,4,6056,32910.333333333336,1514.0,1514.0,0,0,0.0,0.0,0.0
48821.0,6,14,4740,7,653,8008.833333333333,249.0,93.28571428571428,7,4087,7989.166666666667,1514.0,583.8571428571429
118739195.0,6,219,24712,110,7556,1089275.119266055,140.0,68.69090909090909,109,17156,1091808.5277777778,284.0,157.39449541284404
323.0,17,2,166,1,75,0.0,75.0,75.0,1,91,0.0,91.0,91.0
227436.0,17,2,180,1,90,0.0,90.0,90.0,1,90,0.0,90.0,90.0
120129393.0,6,242,27326,121,8208,994257.575,140.0,67.83471074380165,121,19118,994181.1833333332,284.0,158.0
2314.0,17,4,344,2,150,0.0,75.0,75.0,2,194,0.0,103.0,97.0
2334.0,17,4,344,2,150,0.0,75.0,75.0,2,194,0.0,103.0,97.0
90022561.0,17,28,13364,28,13364,3334168.925925926,501.0,477.2857142857143,0,0,0.0,0.0,0.0
52777.0,6,14,4740,7,653,8668.0,249.0,93.28571428571428,7,4087,8304.166666666666,1514.0,583.8571428571429
105532.0,17,2,286,2,286,0.0,143.0,143.0,0,0,0.0,0.0,0.0
61923.0,6,10,2032,5,524,14430.25,252.0,104.8,5,1508,14262.5,1236.0,301.6
17421.0,6,14,4740,7,653,2634.333333333333,249.0,93.28571428571428,7,4087,2628.1666666666665,1514.0,583.8571428571429
181322.0,17,2,180,1,90,0.0,90.0,90.0,1,90,0.0,90.0,90.0
135134420.0,17,6,1206,6,1206,27026884.0,201.0,201.0,0,0,0.0,0.0,0.0
327186.0,6,5,367,2,132,0.0,66.0,66.0,3,235,163593.0,103.0,78.33333333333333
10438469.0,6,7,478,4,272,3434116.333333333,74.0,68.0,3,206,5151037.0,74.0,68.66666666666667
144047.0,17,2,180,1,90,0.0,90.0,90.0,1,90,0.0,90.0,90.0
100345091.0,6,40,2640,20,1320,5281320.578947368,66.0,66.0,20,1320,5265071.842105263,66.0,66.0
58685.0,6,14,4740,7,653,9518.0,249.0,93.28571428571428,7,4087,8179.333333333333,1514.0,583.8571428571429
21207.0,6,11,1132,6,556,4194.4,218.0,92.66666666666669,5,576,4019.25,304.0,115.2
23465543.0,6,5,1736,2,819,0.0,753.0,409.5,3,917,11660476.5,785.0,305.6666666666667
2341.0,17,4,344,2,150,0.0,75.0,75.0,2,194,0.0,103.0,97.0
3375859.0,17,3,1026,3,1026,1687929.5,342.0,342.0,0,0,0.0,0.0,0.0
199763.0,17,4,6056,4,6056,66587.66666666667,1514.0,1514.0,0,0,0.0,0.0,0.0
32394.0,6,10,2032,5,524,6558.0,252.0,104.8,5,1508,7744.75,1236.0,301.6
90252003.0,6,13,2036,8,1016,12893143.285714284,188.0,127.0,5,1020,22522500.5,204.0,204.0
15281.0,6,14,4740,7,653,2348.333333333333,249.0,93.28571428571428,7,4087,2411.1666666666665,1514.0,583.8571428571429
72585.0,6,14,4740,7,653,11424.666666666666,249.0,93.28571428571428,7,4087,9457.666666666666,1514.0,583.8571428571429
22245.0,6,14,4740,7,653,3598.5,249.0,93.28571428571428,7,4087,3393.333333333333,1514.0,583.8571428571429
14376.0,6,14,4740,7,653,2059.833333333333,249.0,93.28571428571428,7,4087,2258.833333333333,1514.0,583.8571428571429
145044.0,17,2,180,1,70,0.0,70.0,70.0,1,110,0.0,110.0,110.0
110358405.0,17,14,864,7,432,18393067.5,174.0,61.71428571428572,7,432,18322956.5,174.0,61.71428571428572
1570753.0,6,19,7533,10,1403,174528.11111111112,583.0,140.3,9,6130,164037.375,1484.0,681.1111111111111
120090845.0,17,28,13364,28,13364,4447809.074074074,501.0,477.2857142857143,0,0,0.0,0.0,0.0
34526.0,6,14,4740,7,653,5056.333333333333,249.0,93.28571428571428,7,4087,5434.666666666667,1514.0,583.8571428571429
152211.0,17,4,6056,4,6056,50737.0,1514.0,1514.0,0,0,0.0,0.0,0.0
0.0,6,1,66,1,66,0.0,66.0,66.0,0,0,0.0,0.0,0.0
204873.0,17,2,180,1,90,0.0,90.0,90.0,1,90,0.0,90.0,90.0
27097378.0,17,5,1710,5,1710,6774344.5,342.0,342.0,0,0,0.0,0.0,0.0
122177.0,6,3,337,2,214,0.0,160.0,107.0,1,123,0.0,123.0,123.0
144005.0,17,2,180,1,90,0.0,90.0,90.0,1,90,0.0,90.0,90.0
147963.0,17,2,180,1,90,0.0,90.0,90.0,1,90,0.0,90.0,90.0
90228657.0,6,17,1287,8,596,12853337.0,95.0,74.5,9,691,11251544.625,95.0,76.77777777777777
184901.0,17,2,180,1,90,0.0,90.0,90.0,1,90,0.0,90.0,90.0
93008874.0,6,38,2508,19,1254,5150439.0,66.0,66.0,19,1254,5150438.0,66.0,66.0
10465533.0,6,7,478,4,272,3441442.333333333,74.0,68.0,3,206,5162038.5,74.0,68.66666666666667
9804.0,17,2,571,1,86,0.0,86.0,86.0,1,485,0.0,485.0,485.0
211247.0,17,2,180,1,90,0.0,90.0,90.0,1,90,0.0,90.0,90.0
61490.0,6,14,4740,7,653,9226.0,249.0,93.28571428571428,7,4087,8002.166666666667,1514.0,583.8571428571429
300529.0,6,6,412,4,272,100176.33333333331,74.0,68.0,2,140,0.0,74.0,70.0
146236.0,6,3,337,2,214,0.0,160.0,107.0,1,123,0.0,123.0,123.0
108111049.0,17,5,1005,5,1005,27027762.25,201.0,201.0,0,0,0.0,0.0,0.0
153471.0,17,2,180,1,90,0.0,90.0,90.0,1,90,0.0,90.0,90.0
330821.0,6,3,1604,2,851,0.0,785.0,425.5,1,753,0.0,753.0,753.0
81282.0,6,14,4740,7,653,13421.666666666666,249.0,93.28571428571428,7,4087,13338.5,1514.0,583.8571428571429
332.0,17,2,267,1,83,0.0,83.0,83.0,1,184,0.0,184.0,184.0
3360.0,17,2,363,1,79,0.0,79.0,79.0,1,284,0.0,284.0,284.0
143940.0,17,2,180,1,90,0.0,90.0,90.0,1,90,0.0,90.0,90.0
113614555.0,6,46,3036,23,1518,5150438.181818182,66.0,66.0,23,1518,5150441.045454546,66.0,66.0
90249033.0,6,12,1832,8,1016,12892719.0,188.0,127.0,4,816,30029005.666666668,204.0,204.0
2457360.0,6,25,7573,14,3735,189027.6923076923,1514.0,266.7857142857143,11,3838,217817.3,1514.0,348.90909090909093
235846.0,6,10,1221,6,636,47169.2,298.0,106.0,4,585,77373.66666666667,379.0,146.25
219538.0,6,3,426,2,280,0.0,214.0,140.0,1,146,0.0,146.0,146.0
449857.0,6,6,758,3,410,189063.0,172.0,136.66666666666666,3,348,165023.0,135.0,116.0
2445.0,17,4,344,2,150,0.0,75.0,75.0,2,194,0.0,103.0,97.0
60808.0,6,14,4740,7,653,10016.833333333334,249.0,93.28571428571428,7,4087,7991.666666666667,1514.0,583.8571428571429
197026.0,17,2,180,1,90,0.0,90.0,90.0,1,90,0.0,90.0,90.0
209619.0,17,2,180,1,90,0.0,90.0,90.0,1,90,0.0,90.0,90.0
2658048.0,6,25,7573,14,3735,204465.2307692308,1514.0,266.7857142857143,11,3838,240256.5,1514.0,348.90909090909093
107227443.0,6,32,2236,16,1165,7134105.533333333,139.0,72.8125,16,1071,7134104.466666667,123.0,66.9375
100849008.0,6,27,1800,14,894,7757616.0,123.0,63.85714285714285,13,906,7718483.25,123.0,69.6923076923077
115913150.0,6,31,2166,16,1149,7713143.933333334,123.0,71.8125,15,1017,8264080.714285715,123.0,67.8
90259534.0,6,12,1832,8,1016,12894219.142857144,188.0,127.0,4,816,30031424.0,204.0,204.0
2627600.0,6,25,7573,14,3735,202123.0769230769,1514.0,266.7857142857143,11,3838,236507.2,1514.0,348.90909090909093
242063.0,6,12,1373,7,714,40343.833333333336,298.0,102.0,5,659,59732.5,379.0,131.8
287246.0,17,4,1524,4,1524,95748.66666666669,381.0,381.0,0,0,0.0,0.0,0.0
222281.0,6,4,504,3,358,111140.5,214.0,119.33333333333331,1,146,0.0,146.0,146.0
120729770.0,6,21,1626,11,840,11999998.9,95.0,76.36363636363636,10,786,13413229.444444444,95.0,78.6
17792.0,6,14,4740,7,653,2800.333333333333,249.0,93.28571428571428,7,4087,2834.0,1514.0,583.8571428571429
325040.0,6,6,412,4,272,108346.66666666669,74.0,68.0,2,140,0.0,74.0,70.0
30758.0,6,11,2098,6,590,5968.4,252.0,98.33333333333331,5,1508,6083.0,1236.0,301.6
56397.0,6,14,4740,7,653,9290.0,249.0,93.28571428571428,7,4087,9260.666666666666,1514.0,583.8571428571429
98760202.0,6,28,1876,14,982,7580336.0,139.0,70.14285714285714,14,894,7580332.923076923,123.0,63.85714285714285
2345.0,17,4,344,2,150,0.0,75.0,75.0,2,194,0.0,103.0,97.0
105244589.0,6,202,22758,101,15796,1050294.17,284.0,156.3960396039604,101,6962,1050293.6,140.0,68.93069306930693
5829716.0,6,5,336,2,134,0.0,68.0,67.0,3,202,1523387.5,70.0,67.33333333333333
878642.0,6,9,1269,6,798,175728.4,460.0,133.0,3,471,301778.5,331.0,157.0
112463990.0,6,45,2970,23,1518,5111999.545454546,66.0,66.0,22,1452,5124372.952380952,66.0,66.0
100179.0,17,2,762,2,762,0.0,381.0,381.0,0,0,0.0,0.0,0.0
292.0,17,2,174,1,79,0.0,79.0,79.0,1,95,0.0,95.0,95.0
105003976.0,17,13,1083,6,520,17083731.8,174.0,86.66666666666667,7,563,17474175.333333332,174.0,80.42857142857143
10493100.0,6,7,478,4,272,3452173.0,74.0,68.0,3,206,5178167.5,74.0,68.66666666666667
45097.0,6,14,4740,7,653,6579.833333333333,249.0,93.28571428571428,7,4087,7231.166666666667,1514.0,583.8571428571429
103117.0,17,2,286,2,286,0.0,143.0,143.0,0,0,0.0,0.0,0.0
90037082.0,17,28,13364,28,13364,3334706.7407407407,501.0,477.2857142857143,0,0,0.0,0.0,0.0
108654234.0,6,34,2604,18,1395,6391425.529411765,123.0,77.5,16,1209,7229191.666666667,123.0,75.5625
14433.0,6,11,1131,6,600,2619.2,262.0,100.0,5,531,2867.0,259.0,106.2
304814.0,17,2,224,1,76,0.0,76.0,76.0,1,148,0.0,148.0,148.0
427136.0,6,3,1604,1,753,0.0,753.0,753.0,2,851,0.0,785.0,425.5
103998.0,17,2,286,2,286,0.0,143.0,143.0,0,0,0.0,0.0,0.0
838891.0,6,9,1118,6,586,167778.2,248.0,97.66666666666669,3,532,281736.0,392.0,177.33333333333334
18325.0,6,10,2032,5,524,4349.75,252.0,104.8,5,1508,4334.75,1236.0,301.6
144079.0,17,2,180,1,90,0.0,90.0,90.0,1,90,0.0,90.0,90.0
146912.0,6,3,373,2,238,0.0,172.0,119.0,1,135,0.0,135.0,135.0
856302.0,6,9,1268,6,797,171260.4,459.0,132.83333333333334,3,471,291767.0,331.0,157.0
42373.0,6,14,4740,7,653,6898.833333333333,249.0,93.28571428571428,7,4087,6773.333333333333,1514.0,583.8571428571429
38082.0,6,10,2032,5,524,9012.5,252.0,104.8,5,1508,8552.5,1236.0,301.6
123893751.0,17,14,864,7,432,17334184.833333332,174.0,61.71428571428572,7,432,17333492.166666668,174.0,61.71428571428572
120123826.0,6,13,2020,9,1204,15015478.25,188.0,133.77777777777777,4,816,30030603.0,204.0,204.0
103270.0,17,2,286,2,286,0.0,143.0,143.0,0,0,0.0,0.0,0.0
248293.0,6,3,373,2,238,0.0,172.0,119.0,1,135,0.0,135.0,135.0
1507.0,17,5,550,5,550,376.75,110.0,110.0,0,0,0.0,0.0,0.0
135122985.0,17,6,1206,6,1206,27024597.0,201.0,201.0,0,0,0.0,0.0,0.0
14116.0,6,10,2032,5,524,3305.75,252.0,104.8,5,1508,3301.75,1236.0,301.6
41774.0,6,14,4740,7,653,6840.666666666667,249.0,93.28571428571428,7,4087,6320.833333333333,1514.0,583.8571428571429
2488.0,17,4,344,2,150,0.0,75.0,75.0,2,194,0.0,103.0,97.0
90250866.0,6,13,2036,8,1016,12892980.857142856,188.0,127.0,5,1020,22521889.0,204.0,204.0
24422.0,6,13,1459,7,862,3949.0,271.0,123.14285714285714,6,597,4649.0,259.0,99.5
147910.0,17,2,180,1,90,0.0,90.0,90.0,1,90,0.0,90.0,90.0
179861.0,17,4,6056,4,6056,59953.66666666666,1514.0,1514.0,0,0,0.0,0.0,0.0
2038469.0,6,2,132,1,66,0.0,66.0,66.0,1,66,0.0,66.0,66.0
108113365.0,17,5,1005,5,1005,27028341.25,201.0,201.0,0,0,0.0,0.0,0.0
120276515.0,6,235,26450,118,18432,1028004.4017094016,284.0,156.20338983050848,117,8018,1028889.6551724138,140.0,68.52991452991454
302399.0,6,2,132,1,66,0.0,66.0,66.0,1,66,0.0,66.0,66.0
1301483.0,6,4,264,2,132,0.0,66.0,66.0,2,132,0.0,66.0,66.0
197581.0,17,2,180,1,90,0.0,90.0,90.0,1,90,0.0,90.0,90.0
436.0,17,2,410,1,78,0.0,78.0,78.0,1,332,0.0,332.0,332.0
146314.0,6,3,337,2,214,0.0,160.0,107.0,1,123,0.0,123.0,123.0
232063.0,6,3,373,2,238,0.0,172.0,119.0,1,135,0.0,135.0,135.0
220321.0,6,3,426,2,280,0.0,214.0,140.0,1,146,0.0,146.0,146.0
108107866.0,17,5,955,5,955,27026966.5,191.0,191.0,0,0,0.0,0.0,0.0
29861.0,6,14,4740,7,653,4669.166666666667,249.0,93.28571428571428,7,4087,4248.0,1514.0,583.8571428571429
108107263.0,17,5,955,5,955,27026815.75,191.0,191.0,0,0,0.0,0.0,0.0
121722467.0,17,14,864,7,432,17000168.166666668,174.0,61.71428571428572,7,432,19987201.5,174.0,61.71428571428572
299159.0,6,6,412,4,272,99719.66666666669,74.0,68.0,2,140,0.0,74.0,70.0
86111.0,6,10,2032,5,524,19976.0,252.0,104.8,5,1508,21192.5,1236.0,301.6
103136921.0,17,14,1126,7,563,17167688.833333332,174.0,80.42857142857143,7,563,17166879.5,174.0,80.42857142857143
135135636.0,17,6,1146,6,1146,27027127.2,191.0,191.0,0,0,0.0,0.0,0.0
503339.0,6,5,336,2,134,0.0,68.0,67.0,3,202,193458.0,70.0,67.33333333333333
135128736.0,17,6,1206,6,1206,27025747.2,201.0,201.0,0,0,0.0,0.0,0.0
497487.0,17,2,363,1,79,0.0,79.0,79.0,1,284,0.0,284.0,284.0
315323.0,17,4,1400,4,1400,105107.66666666669,350.0,350.0,0,0,0.0,0.0,0.0
205805.0,17,2,180,1,90,0.0,90.0,90.0,1,90,0.0,90.0,90.0
19677.0,6,14,4740,7,653,3128.5,249.0,93.28571428571428,7,4087,3141.0,1514.0,583.8571428571429
51496.0,6,14,4740,7,653,8462.666666666666,249.0,93.28571428571428,7,4087,6990.5,1514.0,583.8571428571429
1171012.0,6,13,3010,8,2382,167287.42857142858,1514.0,297.75,5,628,223746.25,331.0,125.6
120123726.0,6,14,2224,9,1204,15015465.75,188.0,133.77777777777777,5,1020,22523139.0,204.0,204.0
4286.0,17,2,582,1,83,0.0,83.0,83.0,1,499,0.0,499.0,499.0
155682.0,6,3,337,2,214,0.0,160.0,107.0,1,123,0.0,123.0,123.0
216430.0,17,2,180,1,90,0.0,90.0,90.0,1,90,0.0,90.0,90.0
90029214.0,17,28,13364,28,13364,3334415.333333333,501.0,477.2857142857143,0,0,0.0,0.0,0.0
149365926.0,17,35,16705,35,16705,4393115.470588235,501.0,477.2857142857143,0,0,0.0,0.0,0.0
2032.0,17,4,344,2,150,0.0,75.0,75.0,2,194,0.0,103.0,97.0
117174141.0,17,13,821,7,432,19500922.166666668,174.0,61.71428571428572,6,389,19600160.2,174.0,64.83333333333333
120000013.0,6,17,1287,9,691,15000001.625,95.0,76.77777777777777,8,596,12900559.857142856,95.0,74.5
42685.0,6,14,4740,7,653,6274.166666666667,249.0,93.28571428571428,7,4087,6923.833333333333,1514.0,583.8571428571429
10458257.0,6,6,412,3,206,5160466.5,74.0,68.66666666666667,3,206,5160340.5,74.0,68.66666666666667
22247.0,6,14,4740,7,653,3598.1666666666665,249.0,93.28571428571428,7,4087,3516.333333333333,1514.0,583.8571428571429
26326.0,6,14,4740,7,653,4264.166666666667,249.0,93.28571428571428,7,4087,3657.0,1514.0,583.8571428571429
103200809.0,6,42,2772,21,1386,5160028.25,66.0,66.0,21,1386,5160024.3,66.0,66.0
159156.0,6,2,128,1,74,0.0,74.0,74.0,1,54,0.0,54.0,54.0
120170184.0,6,234,26400,117,7944,1029900.0862068966,140.0,67.8974358974359,117,18456,1028927.4310344828,284.0,157.74358974358975
530218.0,6,5,336,2,134,0.0,68.0,67.0,3,202,203439.5,70.0,67.33333333333333
292363.0,17,2,246,1,76,0.0,76.0,76.0,1,170,0.0,170.0,170.0
1056835.0,6,3,1604,2,851,0.0,785.0,425.5,1,753,0.0,753.0,753.0
135129369.0,17,6,1146,6,1146,27025873.8,191.0,191.0,0,0,0.0,0.0,0.0
1038049.0,6,11,1134,6,558,207609.8,220.0,93.0,5,576,257133.5,304.0,115.2
135142761.0,17,6,1206,6,1206,27028552.2,201.0,201.0,0,0,0.0,0.0,0.0
1720938.0,6,23,6508,12,1529,156448.9090909091,357.0,127.41666666666669,11,4979,141460.2,1510.0,452.6363636363636
309.0,17,2,156,1,78,0.0,78.0,78.0,1,78,0.0,78.0,78.0
218937.0,6,3,426,2,280,0.0,214.0,140.0,1,146,0.0,146.0,146.0
124650787.0,6,49,3234,25,1650,5193782.791666667,66.0,66.0,24,1584,4975280.304347826,66.0,66.0
135137715.0,17,6,1206,6,1206,27027543.0,201.0,201.0,0,0,0.0,0.0,0.0
144034.0,17,2,180,1,90,0.0,90.0,90.0,1,90,0.0,90.0,90.0
0.0,17,1,179,1,179,0.0,179.0,179.0,0,0,0.0,0.0,0.0
90000804.0,17,11,735,6,389,18000160.8,174.0,64.83333333333333,5,346,17501239.75,174.0,69.2
2362.0,17,4,344,2,150,0.0,75.0,75.0,2,194,0.0,103.0,97.0
120006313.0,6,26,1978,14,1084,9230740.076923076,95.0,77.42857142857143,12,894,10885168.181818182,95.0,74.5
4598687.0,6,5,336,2,134,0.0,68.0,67.0,3,202,1423685.5,70.0,67.33333333333333
121464.0,6,3,337,2,214,0.0,160.0,107.0,1,123,0.0,123.0,123.0
34822.0,6,10,2032,5,524,8466.5,252.0,104.8,5,1508,8065.25,1236.0,301.6
108099401.0,17,5,955,5,955,27024850.25,191.0,191.0,0,0,0.0,0.0,0.0
72535105.0,6,19,1334,9,640,9066674.75,95.0,71.11111111111111,10,694,8058597.666666667,95.0,69.4
233036.0,6,3,337,2,214,0.0,160.0,107.0,1,123,0.0,123.0,123.0
10472558.0,6,7,478,4,272,3445247.333333333,74.0,68.0,3,206,5167769.0,74.0,68.66666666666667
7840.0,17,2,180,1,90,0.0,90.0,90.0,1,90,0.0,90.0,90.0
100295615.0,17,12,778,6,389,20000703.0,174.0,64.83333333333333,6,389,20000166.0,174.0,64.83333333333333
5003814.0,17,4,695,2,168,0.0,84.0,84.0,2,527,0.0,363.0,263.5
43898.0,6,14,4740,7,653,7048.666666666667,249.0,93.28571428571428,7,4087,7178.333333333333,1514.0,583.8571428571429
135158367.0,17,6,1206,6,1206,27031673.4,201.0,201.0,0,0,0.0,0.0,0.0
90253081.0,6,14,2240,8,1016,12893297.285714284,188.0,127.0,6,1224,18017533.4,204.0,204.0
154159.0,17,2,180,1,90,0.0,90.0,90.0,1,90,0.0,90.0,90.0
135125450.0,17,6,1206,6,1206,27025090.0,201.0,201.0,0,0,0.0,0.0,0.0
3396089.0,6,157,123067,87,114145,39489.40697674418,1510.0,1312.0114942528735,70,8922,44864.6231884058,1510.0,127.45714285714286
304740.0,6,6,412,4,272,101580.0,74.0,68.0,2,140,0.0,74.0,70.0
11500854.0,17,4,1368,4,1368,3833618.0,342.0,342.0,0,0,0.0,0.0,0.0
210178.0,17,2,180,1,90,0.0,90.0,90.0,1,90,0.0,90.0,90.0
17466.0,6,14,4740,7,653,2793.833333333333,249.0,93.28571428571428,7,4087,2468.0,1514.0,583.8571428571429
112464260.0,6,46,3036,23,1518,5111999.545454546,66.0,66.0,23,1518,5112000.590909091,66.0,66.0
93295781.0,6,27,1954,14,1045,7160817.615384615,139.0,74.64285714285714,13,909,7757553.666666667,123.0,69.92307692307692
153498.0,17,2,180,1,90,0.0,90.0,90.0,1,90,0.0,90.0,90.0
22622.0,6,10,2032,5,524,4868.25,252.0,104.8,5,1508,5246.0,1236.0,301.6
66062.0,6,14,4740,7,653,10698.333333333334,249.0,93.28571428571428,7,4087,10111.833333333334,1514.0,583.8571428571429
208313.0,6,3,426,2,280,0.0,214.0,140.0,1,146,0.0,146.0,146.0
190861.0,17,2,180,1,90,0.0,90.0,90.0,1,90,0.0,90.0,90.0
254956.00000000003,6,3,337,2,214,0.0,160.0,107.0,1,123,0.0,123.0,123.0
53397.0,6,13,1479,7,882,8899.5,291.0,126.0,6,597,8659.6,259.0,99.5
120059323.0,17,28,13364,28,13364,4446641.592592592,501.0,477.2857142857143,0,0,0.0,0.0,0.0
153403.0,17,2,180,1,90,0.0,90.0,90.0,1,90,0.0,90.0,90.0
96065311.0,17,12,778,6,389,19201538.4,174.0,64.83333333333333,6,389,19200154.0,174.0,64.83333333333333
9391.0,17,4,344,2,150,0.0,75.0,75.0,2,194,0.0,103.0,97.0
92824.0,6,14,4740,7,653,14749.166666666666,249.0,93.28571428571428,7,4087,15308.666666666666,1514.0,583.8571428571429
318489.0,6,6,412,4,272,106163.0,74.0,68.0,2,140,0.0,74.0,70.0
121375.0,6,3,337,2,214,0.0,160.0,107.0,1,123,0.0,123.0,123.0
300774.0,6,6,412,4,272,100258.0,74.0,68.0,2,140,0.0,74.0,70.0
82.0,17,2,762,2,762,0.0,381.0,381.0,0,0,0.0,0.0,0.0
13619347.0,6,20,1607,10,975,1478967.0,315.0,97.5,10,632,1478939.3333333333,78.0,63.2
238976.0,17,2,180,1,90,0.0,90.0,90.0,1,90,0.0,90.0,90.0
120015299.0,17,28,13364,28,13364,4445011.074074074,501.0,477.2857142857143,0,0,0.0,0.0,0.0
135145771.0,17,6,1146,6,1146,27029154.2,191.0,191.0,0,0,0.0,0.0,0.0
113520383.0,6,46,3036,23,1518,5160005.863636363,66.0,66.0,23,1518,5160006.5,66.0,66.0
135138778.0,17,6,1146,6,1146,27027755.6,191.0,191.0,0,0,0.0,0.0,0.0
20291.0,6,13,1459,7,862,3144.5,271.0,123.14285714285714,6,597,2906.8,259.0,99.5
73433.0,6,10,2032,5,524,17993.75,252.0,104.8,5,1508,18113.0,1236.0,301.6
47688.0,6,14,4740,7,653,7830.5,249.0,93.28571428571428,7,4087,7419.5,1514.0,583.8571428571429
1147.0,17,4,438,2,148,0.0,74.0,74.0,2,290,0.0,147.0,145.0
44866.0,6,14,4740,7,653,6449.666666666667,249.0,93.28571428571428,7,4087,7256.666666666667,1514.0,583.8571428571429
2320.0,17,4,344,2,150,0.0,75.0,75.0,2,194,0.0,103.0,97.0
26492.0,6,14,4740,7,653,4109.5,249.0,93.28571428571428,7,4087,4218.333333333333,1514.0,583.8571428571429
90216855.0,6,24,1829,11,840,8996590.1,95.0,76.36363636363636,13,989,7500056.333333333,95.0,76.07692307692308
104046.0,17,2,286,2,286,0.0,143.0,143.0,0,0,0.0,0.0,0.0
91483008.0,6,27,2958,14,1505,7034047.384615385,427.0,107.5,13,1453,7620135.25,360.0,111.76923076923076
2404922.0,6,3,1777,2,951,0.0,885.0,475.5,1,826,0.0,826.0,826.0
108106515.0,17,5,1005,5,1005,27026628.75,201.0,201.0,0,0,0.0,0.0,0.0
218550.0,17,2,180,1,90,0.0,90.0,90.0,1,90,0.0,90.0,90.0
1313728.0,6,4,264,2,132,0.0,66.0,66.0,2,132,0.0,66.0,66.0
0.0,6,1,66,1,66,0.0,66.0,66.0,0,0,0.0,0.0,0.0
2248.0,17,4,344,2,150,0.0,75.0,75.0,2,194,0.0,103.0,97.0
7815780.0,17,4,1376,3,1026,77178.0,342.0,342.0,1,350,0.0,350.0,350.0
24413.0,6,14,4740,7,653,3958.5,249.0,93.28571428571428,7,4087,3927.8333333333335,1514.0,583.8571428571429
21082108.0,17,3,1034,2,684,0.0,342.0,342.0,1,350,0.0,350.0,350.0
120121923.0,6,13,2020,9,1204,15015240.375,188.0,133.77777777777777,4,816,30031643.33333333,204.0,204.0
90303621.0,6,16,1192,8,596,12894015.0,95.0,74.5,8,596,12899468.142857144,95.0,74.5
120000006.0,6,17,1287,9,691,15000000.75,95.0,76.77777777777777,8,596,12897181.857142856,95.0,74.5
19849.0,17,2,582,1,83,0.0,83.0,83.0,1,499,0.0,499.0,499.0
2391.0,17,4,344,2,150,0.0,75.0,75.0,2,194,0.0,103.0,97.0
5005102.0,17,4,849,2,166,0.0,83.0,83.0,2,683,0.0,499.0,341.5
146495.0,6,3,337,2,214,0.0,160.0,107.0,1,123,0.0,123.0,123.0
309514.0,6,6,412,4,272,103171.33333333331,74.0,68.0,2,140,0.0,74.0,70.0
9065.0,17,2,539,1,86,0.0,86.0,86.0,1,453,0.0,453.0,453.0
41957.0,6,11,2098,6,590,6232.4,252.0,98.33333333333331,5,1508,9293.5,1236.0,301.6
34048.0,6,14,4740,7,653,5509.833333333333,249.0,93.28571428571428,7,4087,5432.666666666667,1514.0,583.8571428571429
1000329.0,6,12,1447,6,816,198561.8,291.0,136.0,6,631,198480.8,293.0,105.16666666666669
47190.0,6,14,4740,7,653,6944.833333333333,249.0,93.28571428571428,7,4087,6278.833333333333,1514.0,583.8571428571429
90303388.0,6,17,1287,9,691,11281691.5,95.0,76.77777777777777,8,596,12898883.285714284,95.0,74.5
90057043.0,17,28,13364,28,13364,3335446.037037037,501.0,477.2857142857143,0,0,0.0,0.0,0.0
100564123.0,17,13,821,7,432,16760687.166666666,174.0,61.71428571428572,6,389,16082691.8,174.0,64.83333333333333
2548682.0,6,2,134,1,68,0.0,68.0,68.0,1,66,0.0,66.0,66.0
9663.0,17,2,571,1,86,0.0,86.0,86.0,1,485,0.0,485.0,485.0
327107.0,6,6,412,4,272,109035.66666666669,74.0,68.0,2,140,0.0,74.0,70.0
171920.0,17,2,180,1,90,0.0,90.0,90.0,1,90,0.0,90.0,90.0
137167.0,6,2,132,1,66,0.0,66.0,66.0,1,66,0.0,66.0,66.0
228246.0,17,2,180,1,90,0.0,90.0,90.0,1,90,0.0,90.0,90.0
328.0,17,2,166,1,75,0.0,75.0,75.0,1,91,0.0,91.0,91.0
196841.0,17,2,180,1,90,0.0,90.0,90.0,1,90,0.0,90.0,90.0
206883.0,6,3,426,2,280,0.0,214.0,140.0,1,146,0.0,146.0,146.0
112824.0,6,14,4740,7,653,18618.5,249.0,93.28571428571428,7,4087,11105.833333333334,1514.0,583.8571428571429
108108114.0,17,5,955,5,955,27027028.5,191.0,191.0,0,0,0.0,0.0,0.0
29728.0,6,14,4740,7,653,4785.833333333333,249.0,93.28571428571428,7,4087,4452.833333333333,1514.0,583.8571428571429
1304497.0,17,7,490,7,490,217416.16666666663,70.0,70.0,0,0,0.0,0.0,0.0
132020335.0,17,15,1038,8,606,18860047.85714286,174.0,75.75,7,432,19972156.83333333,174.0,61.71428571428572
35447.0,6,12,1413,6,816,6815.0,291.0,136.0,6,597,5611.4,259.0,99.5
29914.0,6,10,2032,5,524,6540.0,252.0,104.8,5,1508,6921.25,1236.0,301.6
148037.0,17,2,180,1,90,0.0,90.0,90.0,1,90,0.0,90.0,90.0
302156.0,6,6,412,4,272,100718.66666666669,74.0,68.0,2,140,0.0,74.0,70.0
318288.0,17,4,1400,4,1400,106096.0,350.0,350.0,0,0,0.0,0.0,0.0
106697.0,17,2,762,2,762,0.0,381.0,381.0,0,0,0.0,0.0,0.0
93224847.0,6,40,2640,20,1320,4906570.894736842,66.0,66.0,20,1320,4895206.052631579,66.0,66.0
51640.0,6,14,4740,7,653,8486.333333333334,249.0,93.28571428571428,7,4087,8445.333333333334,1514.0,583.8571428571429
306692.0,6,6,412,4,272,102230.66666666669,74.0,68.0,2,140,0.0,74.0,70.0
2069.0,17,4,344,2,150,0.0,75.0,75.0,2,194,0.0,103.0,97.0
120419163.0,6,47,3102,23,1518,5155444.7727272725,66.0,66.0,24,1584,5222042.043478261,66.0,66.0
95942610.0,6,241,28662,121,8208,799521.75,140.0,67.83471074380165,120,20454,798492.7310924369,284.0,170.45
120130893.0,6,12,1832,8,1016,17137494.42857143,188.0,127.0,4,816,30032676.666666668,204.0,204.0
90296959.0,6,16,1192,8,596,12892254.42857143,95.0,74.5,8,596,12897843.714285716,95.0,74.5
2843513.0,6,4,270,3,202,1421756.5,70.0,67.33333333333333,1,68,0.0,68.0,68.0
2591779.0,6,2,132,1,66,0.0,66.0,66.0,1,66,0.0,66.0,66.0
326025.0,17,2,176,1,80,0.0,80.0,80.0,1,96,0.0,96.0,96.0
27993.0,6,10,2032,5,524,6756.25,252.0,104.8,5,1508,6392.25,1236.0,301.6
2083316.0,6,18,6803,10,1501,231479.5555555556,408.0,150.1,8,5302,235130.14285714287,1514.0,662.75
309338.0,17,4,1400,4,1400,103112.66666666669,350.0,350.0,0,0,0.0,0.0,0.0
2033.0,17,4,344,2,150,0.0,75.0,75.0,2,194,0.0,103.0,97.0
13344.0,6,10,1067,5,536,2041.75,264.0,107.2,5,531,3144.5,259.0,106.2
97598643.0,17,14,4796,13,4446,6228550.833333333,342.0,342.0,1,350,0.0,350.0,350.0
120479000.0,6,239,27144,120,19068,1012428.5714285716,374.0,158.9,119,8076,1012337.4322033898,140.0,67.8655462184874
120123624.0,6,15,2152,9,1204,15015453.0,188.0,133.77777777777777,6,948,18019144.8,204.0,158.0
147947.0,17,2,180,1,90,0.0,90.0,90.0,1,90,0.0,90.0,90.0
32327.0,6,14,4740,7,653,5150.333333333333,249.0,93.28571428571428,7,4087,5071.333333333333,1514.0,583.8571428571429
599784.0,6,4,508,2,238,0.0,172.0,119.0,2,270,0.0,135.0,135.0
202557.0,17,4,6056,4,6056,67519.0,1514.0,1514.0,0,0,0.0,0.0,0.0
592789.0,6,4,508,2,238,0.0,172.0,119.0,2,270,0.0,135.0,135.0
208819.0,6,10,1221,6,636,41763.8,298.0,106.0,4,585,68246.66666666667,379.0,146.25
2086.0,17,4,344,2,150,0.0,75.0,75.0,2,194,0.0,103.0,97.0
120121940.0,6,13,2036,5,1020,30030485.0,204.0,204.0,8,1016,17137020.714285713,188.0,127.0
108797.0,17,2,762,2,762,0.0,381.0,381.0,0,0,0.0,0.0,0.0
824.0,17,5,550,5,550,206.0,110.0,110.0,0,0,0.0,0.0,0.0
2066.0,17,4,344,2,150,0.0,75.0,75.0,2,194,0.0,103.0,97.0
9648.0,17,2,582,1,83,0.0,83.0,83.0,1,499,0.0,499.0,499.0
2369.0,17,4,344,2,150,0.0,75.0,75.0,2,194,0.0,103.0,97.0
51358.0,6,12,1328,7,797,8559.666666666666,253.0,113.85714285714286,5,531,10985.25,259.0,106.2
104125.0,17,2,286,2,286,0.0,143.0,143.0,0,0,0.0,0.0,0.0
45041790.0,17,9,3086,8,2736,5106173.285714285,342.0,342.0,1,350,0.0,350.0,350.0
148008.0,17,2,180,1,90,0.0,90.0,90.0,1,90,0.0,90.0,90.0
311833.0,17,4,1400,4,1400,103944.33333333331,350.0,350.0,0,0,0.0,0.0,0.0
120119420.0,6,14,2224,9,1204,15014927.5,188.0,133.77777777777777,5,1020,22589967.5,204.0,204.0
300138.0,6,6,412,4,272,100046.0,74.0,68.0,2,140,0.0,74.0,70.0
305.0,17,2,168,1,76,0.0,76.0,76.0,1,92,0.0,92.0,92.0
120123641.0,6,16,2356,9,1204,15015455.125,188.0,133.77777777777777,7,1152,15054663.5,204.0,164.57142857142858
302604.0,6,6,412,4,272,100868.0,74.0,68.0,2,140,0.0,74.0,70.0
179851.0,17,2,180,1,90,0.0,90.0,90.0,1,90,0.0,90.0,90.0
196830.0,17,2,180,1,90,0.0,90.0,90.0,1,90,0.0,90.0,90.0
108104709.0,17,5,955,5,955,27026177.25,191.0,191.0,0,0,0.0,0.0,0.0
106486265.0,6,28,1860,14,966,8174657.384615385,123.0,69.0,14,894,8174655.307692308,123.0,63.85714285714285
208319.0,6,3,426,2,280,0.0,214.0,140.0,1,146,0.0,146.0,146.0
120054231.0,17,28,13364,28,13364,4446453.0,501.0,477.2857142857143,0,0,0.0,0.0,0.0
148016.0,17,2,180,1,90,0.0,90.0,90.0,1,90,0.0,90.0,90.0
8087.0,17,2,180,1,90,0.0,90.0,90.0,1,90,0.0,90.0,90.0
209719.0,17,2,180,1,90,0.0,90.0,90.0,1,90,0.0,90.0,90.0
126015167.0,17,15,907,8,475,18002166.714285713,174.0,59.375,7,432,17666863.666666668,174.0,61.71428571428572
232992.0,6,3,337,2,214,0.0,160.0,107.0,1,123,0.0,123.0,123.0
304955.0,6,6,412,4,272,101651.66666666669,74.0,68.0,2,140,0.0,74.0,70.0
90260291.0,6,13,2036,8,1016,12894327.285714284,188.0,127.0,5,1020,22524046.0,204.0,204.0
5060.0,17,2,180,1,90,0.0,90.0,90.0,1,90,0.0,90.0,90.0
118514709.0,6,229,25928,115,7886,1039602.7105263158,140.0,68.57391304347826,114,18042,1039623.8672566372,374.0,158.26315789473685
15091.0,6,14,4740,7,653,2111.5,249.0,93.28571428571428,7,4087,2309.5,1514.0,583.8571428571429
120200864.0,6,228,25772,114,7820,1060173.9557522123,140.0,68.59649122807018,114,17952,1056522.6548672563,284.0,157.47368421052633
287554.0,17,2,359,1,75,0.0,75.0,75.0,1,284,0.0,284.0,284.0
76384.0,6,12,1320,7,789,12730.666666666666,253.0,112.71428571428572,5,531,16928.25,259.0,106.2
120000057.0,6,20,1693,11,1043,12000005.7,257.0,94.8181818181818,9,650,11345161.75,95.0,72.22222222222223
215320.0,17,2,180,1,90,0.0,90.0,90.0,1,90,0.0,90.0,90.0
10506.0,6,11,1132,6,556,1930.4,218.0,92.66666666666669,5,576,2170.25,304.0,115.2
34452.0,6,14,4740,7,653,5542.0,249.0,93.28571428571428,7,4087,5150.0,1514.0,583.8571428571429
2078.0,17,4,344,2,150,0.0,75.0,75.0,2,194,0.0,103.0,97.0
0.0,17,1,55,1,55,0.0,55.0,55.0,0,0,0.0,0.0,0.0
120006697.0,6,289,34102,145,24302,833379.8402777778,336.0,167.6,144,9800,837653.6573426573,140.0,68.05555555555556
1003574.0,17,14,5814,14,5814,77198.00000000001,501.0,415.2857142857143,0,0,0.0,0.0,0.0
91626661.0,6,28,2168,16,1233,6105624.333333333,95.0,77.0625,12,935,8304669.272727272,95.0,77.91666666666667
196887.0,17,2,180,1,90,0.0,90.0,90.0,1,90,0.0,90.0,90.0
315195.0,17,4,1400,4,1400,105065.0,350.0,350.0,0,0,0.0,0.0,0.0
525.0,17,2,508,2,508,0.0,257.0,254.0,0,0,0.0,0.0,0.0
351.0,17,2,267,1,83,0.0,83.0,83.0,1,184,0.0,184.0,184.0
41183.0,6,14,4740,7,653,6393.333333333333,249.0,93.28571428571428,7,4087,6691.166666666667,1514.0,583.8571428571429
120044171.0,17,28,13364,28,13364,4446080.407407408,501.0,477.2857142857143,0,0,0.0,0.0,0.0
44963395.0,17,9,3086,8,2736,5108658.428571428,342.0,342.0,1,350,0.0,350.0,350.0
49717.0,6,14,4740,7,653,8180.333333333333,249.0,93.28571428571428,7,4087,6545.333333333333,1514.0,583.8571428571429
234643.0,6,3,373,2,238,0.0,172.0,119.0,1,135,0.0,135.0,135.0
10467679.0,6,7,478,4,272,3443750.0,74.0,68.0,3,206,5165520.5,74.0,68.66666666666667
31314.0,6,14,4740,7,653,4723.166666666667,249.0,93.28571428571428,7,4087,4475.166666666667,1514.0,583.8571428571429
135135020.0,17,6,1206,6,1206,27027004.0,201.0,201.0,0,0,0.0,0.0,0.0
283656.0,6,10,1221,6,636,56731.2,298.0,106.0,4,585,85996.0,379.0,146.25
348.0,17,2,267,1,83,0.0,83.0,83.0,1,184,0.0,184.0,184.0
306065.0,17,4,1400,4,1400,102021.66666666669,350.0,350.0,0,0,0.0,0.0,0.0
5824384.0,6,5,336,2,134,0.0,68.0,67.0,3,202,1524771.0,70.0,67.33333333333333
38470558.0,6,33,10980,18,3951,144893.64705882352,1514.0,219.5,15,7029,2732509.0,1514.0,468.6
297858.0,6,6,412,4,272,99286.0,74.0,68.0,2,140,0.0,74.0,70.0
120099821.0,6,34,2350,17,1225,7493457.625,139.0,72.05882352941177,17,1125,7493462.125,123.0,66.17647058823529
0.0,6,1,54,1,54,0.0,54.0,54.0,0,0,0.0,0.0,0.0
102010.0,17,2,762,2,762,0.0,381.0,381.0,0,0,0.0,0.0,0.0
104535.0,17,2,700,2,700,0.0,350.0,350.0,0,0,0.0,0.0,0.0
35592.0,6,14,4740,7,653,5815.333333333333,249.0,93.28571428571428,7,4087,5697.833333333333,1514.0,583.8571428571429
153402.0,17,2,180,1,90,0.0,90.0,90.0,1,90,0.0,90.0,90.0
20004.0,17,2,582,1,83,0.0,83.0,83.0,1,499,0.0,499.0,499.0
310352.0,6,6,412,4,272,103450.66666666669,74.0,68.0,2,140,0.0,74.0,70.0
31149.0,6,14,4740,7,653,5062.166666666667,249.0,93.28571428571428,7,4087,4848.166666666667,1514.0,583.8571428571429
350.0,17,2,174,1,79,0.0,79.0,79.0,1,95,0.0,95.0,95.0
50638.0,6,14,4740,7,653,8320.166666666666,249.0,93.28571428571428,7,4087,8242.5,1514.0,583.8571428571429
853959.0,6,4,264,2,132,0.0,66.0,66.0,2,132,0.0,66.0,66.0
221047.0,6,3,426,2,280,0.0,214.0,140.0,1,146,0.0,146.0,146.0
13717924.0,6,20,1607,10,975,1490219.3333333333,315.0,97.5,10,632,1490170.4444444445,78.0,63.2
30945.0,6,14,4740,7,653,4754.333333333333,249.0,93.28571428571428,7,4087,5018.833333333333,1514.0,583.8571428571429
713409.0,6,14,4740,7,653,118644.83333333331,249.0,93.28571428571428,7,4087,118714.66666666669,1514.0,583.8571428571429
2462.0,17,4,344,2,150,0.0,75.0,75.0,2,194,0.0,103.0,97.0
100000914.0,17,11,473,6,258,20000182.8,43.0,43.0,5,215,20001271.75,43.0,43.0
108098262.0,17,5,955,5,955,27024565.5,191.0,191.0,0,0,0.0,0.0,0.0
118057111.0,6,30,1974,15,1026,8418003.214285715,123.0,68.4,15,948,8418003.57142857,123.0,63.2
357.0,17,2,166,1,75,0.0,75.0,75.0,1,91,0.0,91.0,91.0
120928630.0,17,14,864,7,432,16769382.833333334,174.0,61.71428571428572,7,432,16833856.166666668,174.0,61.71428571428572
228433.0,17,2,180,1,90,0.0,90.0,90.0,1,90,0.0,90.0,90.0
307.0,17,2,156,1,78,0.0,78.0,78.0,1,78,0.0,78.0,78.0
2398.0,17,4,344,2,150,0.0,75.0,75.0,2,194,0.0,103.0,97.0
1648526.0,6,7,499,4,301,489998.3333333333,103.0,75.25,3,198,716123.0,66.0,66.0
98922.0,17,2,762,2,762,0.0,381.0,381.0,0,0,0.0,0.0,0.0
308.0,17,2,168,1,76,0.0,76.0,76.0,1,92,0.0,92.0,92.0
108103655.0,17,5,955,5,955,27025913.75,191.0,191.0,0,0,0.0,0.0,0.0
3418.0,17,2,414,1,88,0.0,88.0,88.0,1,326,0.0,326.0,326.0
90037735.0,17,28,13364,28,13364,3334730.925925926,501.0,477.2857142857143,0,0,0.0,0.0,0.0
0.0,17,1,453,1,453,0.0,453.0,453.0,0,0,0.0,0.0,0.0
308049.0,6,6,412,4,272,102683.0,74.0,68.0,2,140,0.0,74.0,70.0
840445.0,6,9,1196,6,725,168089.0,387.0,120.83333333333331,3,471,283914.5,331.0,157.0
90262678.0,6,14,2240,8,1016,12894668.285714284,188.0,127.0,6,1224,18019528.4,204.0,204.0
2366.0,17,4,344,2,150,0.0,75.0,75.0,2,194,0.0,103.0,97.0
153350.0,17,2,180,1,90,0.0,90.0,90.0,1,90,0.0,90.0,90.0
39062.0,6,14,4740,7,653,6344.666666666667,249.0,93.28571428571428,7,4087,6261.0,1514.0,583.8571428571429
40624.0,6,14,4740,7,653,6400.833333333333,249.0,93.28571428571428,7,4087,6147.5,1514.0,583.8571428571429
207210.0,6,3,426,2,280,0.0,214.0,140.0,1,146,0.0,146.0,146.0
290733.0,17,2,246,1,76,0.0,76.0,76.0,1,170,0.0,170.0,170.0
95792428.0,17,12,778,6,389,19126702.6,174.0,64.83333333333333,6,389,19048892.4,174.0,64.83333333333333
51181.0,17,2,180,1,90,0.0,90.0,90.0,1,90,0.0,90.0,90.0
94627484.0,6,40,2640,20,1320,4980393.894736842,66.0,66.0,20,1320,4964148.0,66.0,66.0
510940.0,6,5,336,2,134,0.0,68.0,67.0,3,202,193253.0,70.0,67.33333333333333
1053139.0,6,13,1394,7,797,175523.16666666666,253.0,113.85714285714286,6,597,208351.6,259.0,99.5
112919435.0,6,31,2166,16,1149,7513581.666666667,123.0,71.8125,15,1017,8050267.571428572,123.0,67.8
333.0,17,2,160,1,80,0.0,80.0,80.0,1,80,0.0,80.0,80.0
315416.0,17,2,238,1,74,0.0,74.0,74.0,1,164,0.0,164.0,164.0
2599750.0,6,2,132,1,66,0.0,66.0,66.0,1,66,0.0,66.0,66.0
105864.0,17,3,1143,3,1143,52932.0,381.0,381.0,0,0,0.0,0.0,0.0
217931.0,6,3,426,2,280,0.0,214.0,140.0,1,146,0.0,146.0,146.0
31860.0,6,14,4740,7,653,5128.0,249.0,93.28571428571428,7,4087,5102.333333333333,1514.0,583.8571428571429
34615.0,6,14,4740,7,653,5522.166666666667,249.0,93.28571428571428,7,4087,5595.166666666667,1514.0,583.8571428571429
100146876.0,17,13,1083,7,563,16691146.0,174.0,80.42857142857143,6,520,16142052.8,174.0,86.66666666666667
23030757.0,17,3,1034,2,684,0.0,342.0,342.0,1,350,0.0,350.0,350.0
206013.0,6,3,426,2,280,0.0,214.0,140.0,1,146,0.0,146.0,146.0
64715.99999999999,6,14,4740,7,653,10660.666666666666,249.0,93.28571428571428,7,4087,9641.833333333334,1514.0,583.8571428571429
2050.0,17,4,344,2,150,0.0,75.0,75.0,2,194,0.0,103.0,97.0
117720167.0,6,47,3102,24,1584,5118256.652173913,66.0,66.0,23,1518,5143986.545454546,66.0,66.0
17024.0,6,2,145,2,145,0.0,91.0,72.5,0,0,0.0,0.0,0.0
104061941.0,17,14,864,7,432,17334706.0,174.0,61.71428571428572,7,432,17333493.833333332,174.0,61.71428571428572
974.0,17,4,438,2,148,0.0,74.0,74.0,2,290,0.0,147.0,145.0
90043349.0,17,28,13364,28,13364,3334938.851851852,501.0,477.2857142857143,0,0,0.0,0.0,0.0
8436.0,6,10,2032,5,524,1877.5,252.0,104.8,5,1508,1818.75,1236.0,301.6
326344.0,6,6,412,4,272,108781.33333333331,74.0,68.0,2,140,0.0,74.0,70.0
75885.0,17,2,180,1,90,0.0,90.0,90.0,1,90,0.0,90.0,90.0
112157167.0,6,205,23046,103,7020,1099580.068627451,140.0,68.15533980582525,102,16026,1100112.1683168316,284.0,157.11764705882354
100668.0,6,11,2098,6,590,19901.2,252.0,98.33333333333331,5,1508,24334.0,1236.0,301.6
90934557.0,17,11,735,6,389,18001088.4,174.0,64.83333333333333,5,346,20003263.25,174.0,69.2
81757.0,6,14,4740,7,653,13505.333333333334,249.0,93.28571428571428,7,4087,11985.0,1514.0,583.8571428571429
37940.0,6,10,2032,5,524,9240.0,252.0,104.8,5,1508,9191.0,1236.0,301.6
0.0,17,1,350,1,350,0.0,350.0,350.0,0,0,0.0,0.0,0.0
358.0,17,2,160,1,80,0.0,80.0,80.0,1,80,0.0,80.0,80.0
3422.0,17,2,414,1,88,0.0,88.0,88.0,1,326,0.0,326.0,326.0
101422741.0,17,14,1126,7,563,16834226.666666668,174.0,80.42857142857143,7,563,16833553.5,174.0,80.42857142857143
117031991.0,6,48,3168,24,1584,5088347.434782608,66.0,66.0,24,1584,5076372.173913044,66.0,66.0
108103739.0,17,5,1005,5,1005,27025934.75,201.0,201.0,0,0,0.0,0.0,0.0
95735.0,6,14,4740,7,653,15379.0,249.0,93.28571428571428,7,4087,15579.166666666666,1514.0,583.8571428571429
52209.0,6,14,4740,7,653,8496.666666666666,249.0,93.28571428571428,7,4087,8488.833333333334,1514.0,583.8571428571429
3452.0,17,4,407,2,144,0.0,72.0,72.0,2,263,0.0,136.0,131.5
141749.0,6,2,132,1,66,0.0,66.0,66.0,1,66,0.0,66.0,66.0
135136409.0,17,6,1206,6,1206,27027281.8,201.0,201.0,0,0,0.0,0.0,0.0
3288121.0,6,199,165309,115,155463,28843.166666666668,1510.0,1351.8521739130435,84,9846,35846.77108433735,1510.0,117.21428571428572
120699.0,17,4,1400,4,1400,40233.0,350.0,350.0,0,0,0.0,0.0,0.0
104542923.0,17,15,5130,15,5130,7467351.642857143,342.0,342.0,0,0,0.0,0.0,0.0
107554.0,17,2,286,2,286,0.0,143.0,143.0,0,0,0.0,0.0,0.0
26617.0,6,13,1479,7,882,4436.166666666667,291.0,126.0,6,597,4443.8,259.0,99.5
10429929.0,6,7,478,4,272,3431081.6666666665,74.0,68.0,3,206,5146511.5,74.0,68.66666666666667
11890.0,6,10,2032,5,524,2467.25,252.0,104.8,5,1508,2754.5,1236.0,301.6
108114254.0,17,5,955,5,955,27028563.5,191.0,191.0,0,0,0.0,0.0,0.0
201666.0,17,4,6056,4,6056,67222.0,1514.0,1514.0,0,0,0.0,0.0,0.0
44990380.0,17,9,3086,8,2736,5108818.571428572,342.0,342.0,1,350,0.0,350.0,350.0
90212589.0,6,16,1192,8,596,12853820.0,95.0,74.5,8,596,12858252.857142856,95.0,74.5
27625.0,6,10,2032,5,524,6678.75,252.0,104.8,5,1508,6326.75,1236.0,301.6
123918992.0,6,37,2640,19,1392,6884388.444444444,123.0,73.26315789473684,18,1248,6689980.411764706,123.0,69.33333333333333
146978.0,6,3,373,2,238,0.0,172.0,119.0,1,135,0.0,135.0,135.0
498532.0,6,4,270,2,134,0.0,68.0,67.0,2,136,0.0,70.0,68.0
11357.0,6,10,2032,5,524,2144.5,252.0,104.8,5,1508,2141.5,1236.0,301.6
119458534.0,6,225,25266,113,7680,1066594.0535714286,140.0,67.96460176991151,112,17586,1067928.063063063,284.0,157.01785714285714
20296.0,17,2,582,1,83,0.0,83.0,83.0,1,499,0.0,499.0,499.0
101525144.0,17,13,821,7,432,16667512.5,174.0,61.71428571428572,6,389,20000173.8,174.0,64.83333333333333
1302493.0,6,4,264,2,132,0.0,66.0,66.0,2,132,0.0,66.0,66.0
1157371.0,6,13,3011,8,2383,165338.7142857143,1514.0,297.875,5,628,221105.25,331.0,125.6
80091.0,6,14,4740,7,653,12727.0,249.0,93.28571428571428,7,4087,12332.666666666666,1514.0,583.8571428571429
72889.0,6,14,4740,7,653,11952.333333333334,249.0,93.28571428571428,7,4087,11997.833333333334,1514.0,583.8571428571429
108114881.0,17,5,955,5,955,27028720.25,191.0,191.0,0,0,0.0,0.0,0.0
13370.0,17,2,582,1,83,0.0,83.0,83.0,1,499,0.0,499.0,499.0
108107212.0,17,5,955,5,955,27026803.0,191.0,191.0,0,0,0.0,0.0,0.0
13037.0,6,14,4740,7,653,2002.1666666666667,249.0,93.28571428571428,7,4087,2039.0,1514.0,583.8571428571429
90362621.0,6,12,1848,5,1020,22590375.5,204.0,204.0,7,828,15060189.166666666,188.0,118.28571428571428
124001126.0,17,15,907,8,475,17714446.57142857,174.0,59.375,7,432,17334925.166666668,174.0,61.71428571428572
8763.0,6,10,2032,5,524,1987.25,252.0,104.8,5,1508,1958.75,1236.0,301.6
333.0,17,2,160,1,80,0.0,80.0,80.0,1,80,0.0,80.0,80.0
376.0,17,2,267,1,83,0.0,83.0,83.0,1,184,0.0,184.0,184.0
968921.0,6,12,1447,6,816,193040.6,291.0,136.0,6,631,192153.0,293.0,105.16666666666669
319745.0,17,4,704,2,148,0.0,74.0,74.0,2,556,0.0,280.0,278.0
233723.0,6,3,337,2,214,0.0,160.0,107.0,1,123,0.0,123.0,123.0
90015730.0,17,27,12943,27,12943,3462143.461538461,501.0,479.3703703703704,0,0,0.0,0.0,0.0
297540.0,6,6,412,4,272,99180.0,74.0,68.0,2,140,0.0,74.0,70.0
1020690.0,6,11,1134,6,558,204138.0,220.0,93.0,5,576,254529.25,304.0,115.2
3164898.0,6,18,1495,9,921,358097.25,315.0,102.33333333333331,9,574,358049.875,78.0,63.77777777777778
53580.0,6,14,4740,7,653,8807.166666666666,249.0,93.28571428571428,7,4087,7977.833333333333,1514.0,583.8571428571429
102500.0,17,2,286,2,286,0.0,143.0,143.0,0,0,0.0,0.0,0.0
22755341.0,6,7,499,4,301,6387628.333333333,103.0,75.25,3,198,8201789.0,66.0,66.0
103592189.0,6,30,2215,15,1128,7399011.571428572,95.0,75.2,15,1087,7379266.071428572,95.0,72.46666666666667
135132431.0,17,6,1146,6,1146,27026486.2,191.0,191.0,0,0,0.0,0.0,0.0
135129460.0,17,6,1146,6,1146,27025892.0,191.0,191.0,0,0,0.0,0.0,0.0
246242.0,6,3,337,2,214,0.0,160.0,107.0,1,123,0.0,123.0,123.0
118010898.0,6,30,1974,15,1026,8413945.214285715,123.0,68.4,15,948,8413933.357142856,123.0,63.2
233924.0,6,10,1221,6,636,46784.8,298.0,106.0,4,585,74602.66666666667,379.0,146.25
108103107.0,17,5,955,5,955,27025776.75,191.0,191.0,0,0,0.0,0.0,0.0
306.0,17,2,164,1,82,0.0,82.0,82.0,1,82,0.0,82.0,82.0
123416518.0,6,48,3168,24,1584,4987593.913043479,66.0,66.0,24,1584,5313982.260869565,66.0,66.0
156513.0,6,3,337,2,214,0.0,160.0,107.0,1,123,0.0,123.0,123.0
207313.0,6,3,426,2,280,0.0,214.0,140.0,1,146,0.0,146.0,146.0
6910.0,17,2,582,1,83,0.0,83.0,83.0,1,499,0.0,499.0,499.0
337.0,17,2,166,1,75,0.0,75.0,75.0,1,91,0.0,91.0,91.0
789.0,17,4,438,2,148,0.0,74.0,74.0,2,290,0.0,147.0,145.0
30410352.0,6,26,7627,14,3735,181324.15384615384,1514.0,266.7857142857143,12,3892,2745909.1818181816,1514.0,324.3333333333333
275280.0,17,4,1524,4,1524,91760.0,381.0,381.0,0,0,0.0,0.0,0.0
233086.0,6,3,337,2,214,0.0,160.0,107.0,1,123,0.0,123.0,123.0
155585.0,6,3,337,2,214,0.0,160.0,107.0,1,123,0.0,123.0,123.0
37894.0,6,10,2032,5,524,9240.25,252.0,104.8,5,1508,9179.25,1236.0,301.6
366.0,17,2,267,1,83,0.0,83.0,83.0,1,184,0.0,184.0,184.0
2600232.0,6,2,132,1,66,0.0,66.0,66.0,1,66,0.0,66.0,66.0
41724.0,6,10,2032,5,524,9425.0,252.0,104.8,5,1508,9874.0,1236.0,301.6
114588555.0,6,48,3168,24,1584,4982111.0869565215,66.0,66.0,24,1584,4972715.217391305,66.0,66.0
39151.0,6,10,2032,5,524,8661.75,252.0,104.8,5,1508,8390.25,1236.0,301.6
10508676.0,6,6,412,3,206,5185922.0,74.0,68.66666666666667,3,206,5185685.0,74.0,68.66666666666667
165011.0,6,10,1066,5,490,40126.75,218.0,98.0,5,576,40507.25,304.0,115.2
120242479.0,6,222,25106,111,7548,1085552.9363636365,140.0,68.0,111,17558,1086673.3272727274,284.0,158.18018018018017
14983.0,17,2,180,1,90,0.0,90.0,90.0,1,90,0.0,90.0,90.0
146123.0,6,3,337,2,214,0.0,160.0,107.0,1,123,0.0,123.0,123.0
3572326.0,6,5,336,2,134,0.0,68.0,67.0,3,202,1422413.5,70.0,67.33333333333333
97432.0,17,2,286,2,286,0.0,143.0,143.0,0,0,0.0,0.0,0.0
389840.0,6,10,1221,6,636,77968.0,298.0,106.0,4,585,124514.33333333331,379.0,146.25
120036351.0,17,29,13785,29,13785,4287012.535714285,501.0,475.3448275862069,0,0,0.0,0.0,0.0
18893.0,6,14,4740,7,653,2752.333333333333,249.0,93.28571428571428,7,4087,3015.0,1514.0,583.8571428571429
142774.0,6,2,132,1,66,0.0,66.0,66.0,1,66,0.0,66.0,66.0
103228.0,17,2,286,2,286,0.0,143.0,143.0,0,0,0.0,0.0,0.0
65048.99999999999,6,12,1328,7,797,10841.5,253.0,113.85714285714286,5,531,11652.0,259.0,106.2
1566556.0,6,2,132,1,66,0.0,66.0,66.0,1,66,0.0,66.0,66.0
2049.0,17,4,344,2,150,0.0,75.0,75.0,2,194,0.0,103.0,97.0
323.0,17,2,174,1,79,0.0,79.0,79.0,1,95,0.0,95.0,95.0
2781662.0,6,2,132,1,66,0.0,66.0,66.0,1,66,0.0,66.0,66.0
135133375.0,17,6,1146,6,1146,27026675.0,191.0,191.0,0,0,0.0,0.0,0.0
81.0,17,2,762,2,762,0.0,381.0,381.0,0,0,0.0,0.0,0.0
31239.0,6,14,4740,7,653,5072.666666666667,249.0,93.28571428571428,7,4087,4928.833333333333,1514.0,583.8571428571429
115077115.0,6,47,3102,24,1584,5003339.565217392,66.0,66.0,23,1518,5159999.7727272725,66.0,66.0
106116.0,17,2,700,2,700,0.0,350.0,350.0,0,0,0.0,0.0,0.0
36879.0,6,14,4740,7,653,3651.0,249.0,93.28571428571428,7,4087,5852.833333333333,1514.0,583.8571428571429
232934.0,6,3,337,2,214,0.0,160.0,107.0,1,123,0.0,123.0,123.0
142924.0,6,2,132,1,66,0.0,66.0,66.0,1,66,0.0,66.0,66.0
16810.0,17,2,180,1,90,0.0,90.0,90.0,1,90,0.0,90.0,90.0
1470640.0,17,16,1120,16,1120,98042.66666666669,70.0,70.0,0,0,0.0,0.0,0.0
27483.0,6,11,2098,6,590,5213.6,252.0,98.33333333333331,5,1508,6489.25,1236.0,301.6
233580.0,6,3,337,2,214,0.0,160.0,107.0,1,123,0.0,123.0,123.0
108106071.0,17,5,955,5,955,27026517.75,191.0,191.0,0,0,0.0,0.0,0.0
113994712.0,6,210,23758,105,16532,1094020.9038461538,284.0,157.44761904761904,105,7226,1094021.8846153845,140.0,68.81904761904762
208042.0,6,3,426,2,280,0.0,214.0,140.0,1,146,0.0,146.0,146.0
216731.0,6,3,426,2,280,0.0,214.0,140.0,1,146,0.0,146.0,146.0
111801240.0,17,14,864,7,432,18503914.5,174.0,61.71428571428572,7,432,18500186.0,174.0,61.71428571428572
2800929.0,6,2,132,1,66,0.0,66.0,66.0,1,66,0.0,66.0,66.0
102945.0,17,2,286,2,286,0.0,143.0,143.0,0,0,0.0,0.0,0.0
108110836.0,17,5,955,5,955,27027709.0,191.0,191.0,0,0,0.0,0.0,0.0
234500.0,6,3,337,2,214,0.0,160.0,107.0,1,123,0.0,123.0,123.0
0.0,17,1,381,1,381,0.0,381.0,381.0,0,0,0.0,0.0,0.0
36243.0,6,14,4740,7,653,5394.666666666667,249.0,93.28571428571428,7,4087,5337.166666666667,1514.0,583.8571428571429
115201013.0,6,201,22714,101,6962,1152010.13,140.0,68.93069306930693,100,15752,1153134.0505050505,284.0,157.52
306759.0,6,6,412,4,272,102253.0,74.0,68.0,2,140,0.0,74.0,70.0
103610.0,17,2,286,2,286,0.0,143.0,143.0,0,0,0.0,0.0,0.0
320339.0,6,6,412,4,272,106779.66666666669,74.0,68.0,2,140,0.0,74.0,70.0
109337352.0,6,197,22572,99,15882,1115687.2653061224,336.0,160.42424242424244,98,6690,1116610.298969072,140.0,68.26530612244898
200509.0,17,2,180,1,90,0.0,90.0,90.0,1,90,0.0,90.0,90.0
122350335.0,6,39,2770,20,1468,6439491.315789473,139.0,73.4,19,1302,6230583.333333333,123.0,68.52631578947368
120121170.0,6,12,1832,8,1016,17137317.714285713,188.0,127.0,4,816,30031007.666666668,204.0,204.0
146072.0,6,3,337,2,214,0.0,160.0,107.0,1,123,0.0,123.0,123.0
4444.0,17,2,180,1,90,0.0,90.0,90.0,1,90,0.0,90.0,90.0
26886.0,6,10,1949,5,441,5094.0,169.0,88.2,5,1508,6087.5,1236.0,301.6
99620926.0,17,14,1126,7,563,16500139.333333334,174.0,80.42857142857143,7,563,16501141.666666666,174.0,80.42857142857143
37235.0,6,10,2032,5,524,9123.75,252.0,104.8,5,1508,8409.0,1236.0,301.6
4200.0,17,2,598,1,72,0.0,72.0,72.0,1,526,0.0,526.0,526.0
143932.0,17,2,180,1,90,0.0,90.0,90.0,1,90,0.0,90.0,90.0
23456300.0,6,5,1736,2,819,0.0,753.0,409.5,3,917,11663660.5,785.0,305.6666666666667
209078.0,6,10,1221,6,636,41815.6,298.0,106.0,4,585,68452.0,379.0,146.25
206224.0,6,3,426,2,280,0.0,214.0,140.0,1,146,0.0,146.0,146.0
153429.0,17,2,180,1,90,0.0,90.0,90.0,1,90,0.0,90.0,90.0
379499.0,6,3,204,1,68,0.0,68.0,68.0,2,136,0.0,70.0,68.0
2071.0,17,4,344,2,150,0.0,75.0,75.0,2,194,0.0,103.0,97.0
119692812.0,6,224,25324,112,17624,1076374.2342342343,284.0,157.35714285714286,112,7700,1076371.2342342343,140.0,68.75
232416.0,6,3,337,2,214,0.0,160.0,107.0,1,123,0.0,123.0,123.0
132721.0,6,2,132,1,66,0.0,66.0,66.0,1,66,0.0,66.0,66.0
90302208.0,6,21,1585,11,840,9025113.4,95.0,76.36363636363636,10,745,10002163.0,95.0,74.5
104318401.0,17,14,864,7,432,17333492.0,174.0,61.71428571428572,7,432,17334351.5,174.0,61.71428571428572
80.0,17,2,762,2,762,0.0,381.0,381.0,0,0,0.0,0.0,0.0
335889.0,17,6,2100,6,2100,67177.8,350.0,350.0,0,0,0.0,0.0,0.0
5647419.0,6,5,1736,2,819,0.0,753.0,409.5,3,917,2753301.5,785.0,305.6666666666667
305613.0,6,6,412,4,272,101871.0,74.0,68.0,2,140,0.0,74.0,70.0
533035.0,17,6,2100,6,2100,106607.0,350.0,350.0,0,0,0.0,0.0,0.0
120125478.0,6,14,2224,9,1204,15015684.75,188.0,133.77777777777777,5,1020,22522448.25,204.0,204.0
135135275.0,17,6,1206,6,1206,27027055.0,201.0,201.0,0,0,0.0,0.0,0.0
33295.0,6,14,4740,7,653,4817.333333333333,249.0,93.28571428571428,7,4087,4968.833333333333,1514.0,583.8571428571429
36206.0,6,14,4740,7,653,5877.5,249.0,93.28571428571428,7,4087,5657.333333333333,1514.0,583.8571428571429
320.0,17,2,191,1,73,0.0,73.0,73.0,1,118,0.0,118.0,118.0
100299615.0,17,14,1126,7,563,16667504.666666666,174.0,80.42857142857143,7,563,16666807.0,174.0,80.42857142857143
123610646.0,6,49,3234,25,1650,5150443.583333333,66.0,66.0,24,1584,5034524.652173913,66.0,66.0
120639.0,6,3,373,2,238,0.0,172.0,119.0,1,135,0.0,135.0,135.0
143923.0,17,2,180,1,90,0.0,90.0,90.0,1,90,0.0,90.0,90.0
2387.0,17,4,344,2,150,0.0,75.0,75.0,2,194,0.0,103.0,97.0
90020660.0,17,28,13364,28,13364,3334098.5185185187,501.0,477.2857142857143,0,0,0.0,0.0,0.0
298.0,17,2,164,1,82,0.0,82.0,82.0,1,82,0.0,82.0,82.0
38602.0,6,14,4740,7,653,5786.0,249.0,93.28571428571428,7,4087,6218.166666666667,1514.0,583.8571428571429
126001154.0,17,15,907,8,475,18000164.85714286,174.0,59.375,7,432,17667387.666666668,174.0,61.71428571428572
7266033.0,17,6,1665,3,273,3628732.0,103.0,91.0,3,1392,3628443.5,545.0,464.0
208458.0,17,2,180,1,90,0.0,90.0,90.0,1,90,0.0,90.0,90.0
0.0,6,1,70,0,0,0.0,0.0,0.0,1,70,0.0,70.0,70.0
2010.0,17,4,344,2,150,0.0,75.0,75.0,2,194,0.0,103.0,97.0
15532.0,6,11,1131,6,600,3106.4,262.0,100.0,5,531,3140.75,259.0,106.2
135136886.0,17,6,1206,6,1206,27027377.2,201.0,201.0,0,0,0.0,0.0,0.0
369.0,17,2,267,1,83,0.0,83.0,83.0,1,184,0.0,184.0,184.0
125009436.0,17,15,907,8,475,17858490.85714286,174.0,59.375,7,432,17500211.666666668,174.0,61.71428571428572
153497.0,17,2,180,1,90,0.0,90.0,90.0,1,90,0.0,90.0,90.0
244265.0,6,3,337,2,214,0.0,160.0,107.0,1,123,0.0,123.0,123.0
255308.0,6,3,337,2,214,0.0,160.0,107.0,1,123,0.0,123.0,123.0
90299431.0,6,16,1192,8,596,12893474.42857143,95.0,74.5,8,596,12898783.42857143,95.0,74.5
22648190.0,6,5,1736,2,819,0.0,753.0,409.5,3,917,11253728.0,785.0,305.6666666666667
2152040.0,6,20,6935,11,1567,215204.0,408.0,142.45454545454547,9,5368,225280.75,1514.0,596.4444444444445
92808556.0,6,159,17940,80,5502,1174791.8481012655,140.0,68.775,79,12438,1176392.6538461538,284.0,157.4430379746835
90986935.0,6,172,19428,86,13530,1067903.5647058825,284.0,157.32558139534885,86,5898,1067902.9411764706,140.0,68.5813953488372
217921.0,6,3,426,2,280,0.0,214.0,140.0,1,146,0.0,146.0,146.0
218413.0,17,2,180,1,90,0.0,90.0,90.0,1,90,0.0,90.0,90.0
10498236.0,6,7,478,4,272,3454308.0,74.0,68.0,3,206,5181384.0,74.0,68.66666666666667
117000575.0,6,36,2596,18,1348,6869676.117647059,139.0,74.88888888888889,18,1248,6869679.647058823,123.0,69.33333333333333
309869.0,6,6,412,4,272,103289.66666666669,74.0,68.0,2,140,0.0,74.0,70.0
362.0,17,2,267,1,83,0.0,83.0,83.0,1,184,0.0,184.0,184.0
85.0,17,2,762,2,762,0.0,381.0,381.0,0,0,0.0,0.0,0.0
108105823.0,17,5,1005,5,1005,27026455.75,201.0,201.0,0,0,0.0,0.0,0.0
319762.0,17,4,1400,4,1400,106587.33333333331,350.0,350.0,0,0,0.0,0.0,0.0
127822485.0,17,14,864,7,432,18000153.666666668,174.0,61.71428571428572,7,432,18000923.333333332,174.0,61.71428571428572
256979.0,6,3,337,2,214,0.0,160.0,107.0,1,123,0.0,123.0,123.0
18150.0,6,11,1133,6,602,3415.6,264.0,100.33333333333331,5,531,4182.5,259.0,106.2
207148.0,6,3,426,2,280,0.0,214.0,140.0,1,146,0.0,146.0,146.0
50479.0,6,10,2032,5,524,10672.5,252.0,104.8,5,1508,10833.5,1236.0,301.6
318.0,17,2,164,1,82,0.0,82.0,82.0,1,82,0.0,82.0,82.0
302795.0,6,6,412,4,272,100931.66666666669,74.0,68.0,2,140,0.0,74.0,70.0
258885.0,6,10,1221,6,636,51777.0,298.0,106.0,4,585,80744.66666666667,379.0,146.25
21775109.0,6,33,10980,18,3951,139198.58823529413,1514.0,219.5,15,7029,1539921.2142857143,1514.0,468.6
120502756.0,6,46,3844,20,1701,5816741.157894737,123.0,85.05,26,2143,4675347.0,139.0,82.42307692307692
90043040.0,17,28,13364,28,13364,3334927.407407407,501.0,477.2857142857143,0,0,0.0,0.0,0.0
113052351.0,6,35,2542,18,1348,6638081.647058823,139.0,74.88888888888889,17,1194,7052958.875,123.0,70.23529411764706
90223246.0,6,21,1585,10,745,9996134.444444444,95.0,74.5,11,840,9000682.1,95.0,76.36363636363636
45690.0,6,14,4740,7,653,6710.833333333333,249.0,93.28571428571428,7,4087,7306.666666666667,1514.0,583.8571428571429
10462160.0,6,7,478,4,272,3441735.333333333,74.0,68.0,3,206,5162541.0,74.0,68.66666666666667
190679.0,17,2,620,1,75,0.0,75.0,75.0,1,545,0.0,545.0,545.0
22746.0,6,14,4740,7,653,3181.833333333333,249.0,93.28571428571428,7,4087,3582.333333333333,1514.0,583.8571428571429
134742.0,6,2,132,1,66,0.0,66.0,66.0,1,66,0.0,66.0,66.0
90294065.0,6,16,1192,8,596,12893366.714285716,95.0,74.5,8,596,12898289.714285716,95.0,74.5
108103806.0,17,5,955,5,955,27025951.5,191.0,191.0,0,0,0.0,0.0,0.0
120041340.0,17,29,13785,29,13785,4287190.714285715,501.0,475.3448275862069,0,0,0.0,0.0,0.0
204873.0,17,4,6056,4,6056,68291.0,1514.0,1514.0,0,0,0.0,0.0,0.0
197352.0,17,2,180,1,90,0.0,90.0,90.0,1,90,0.0,90.0,90.0
90288946.0,6,16,1192,8,596,12892288.0,95.0,74.5,8,596,12894280.57142857,95.0,74.5
130481.0,6,2,132,1,66,0.0,66.0,66.0,1,66,0.0,66.0,66.0
357.0,17,2,267,1,83,0.0,83.0,83.0,1,184,0.0,184.0,184.0
1306924.0,6,4,264,2,132,0.0,66.0,66.0,2,132,0.0,66.0,66.0
216402.0,17,2,180,1,90,0.0,90.0,90.0,1,90,0.0,90.0,90.0
217253.0,6,3,426,2,280,0.0,214.0,140.0,1,146,0.0,146.0,146.0
5627517.0,6,4,270,2,134,0.0,68.0,67.0,2,136,0.0,70.0,68.0
144980.0,17,2,180,1,70,0.0,70.0,70.0,1,110,0.0,110.0,110.0
552440.0,17,2,346,1,78,0.0,78.0,78.0,1,268,0.0,268.0,268.0
28065.0,6,10,2032,5,524,5959.5,252.0,104.8,5,1508,5978.75,1236.0,301.6
108927.0,17,2,286,2,286,0.0,143.0,143.0,0,0,0.0,0.0,0.0
208075.0,6,10,1221,6,636,41615.0,298.0,106.0,4,585,68139.66666666667,379.0,146.25
325295.0,6,5,367,2,132,0.0,66.0,66.0,3,235,162647.5,103.0,78.33333333333333
110171454.0,6,31,2166,16,1149,7344763.6,123.0,71.8125,15,1017,7854719.714285715,123.0,67.8
38198.0,6,14,4740,7,653,6123.333333333333,249.0,93.28571428571428,7,4087,5317.166666666667,1514.0,583.8571428571429
114650161.0,6,48,3168,24,1584,4984789.608695652,66.0,66.0,24,1584,4971201.608695652,66.0,66.0
299757.0,6,6,412,4,272,99919.0,74.0,68.0,2,140,0.0,74.0,70.0
24034.0,6,10,2032,5,524,5759.75,252.0,104.8,5,1508,5715.25,1236.0,301.6
534211.0,6,6,758,3,410,258246.5,172.0,136.66666666666666,3,348,194889.5,135.0,116.0
146146.0,6,3,337,2,214,0.0,160.0,107.0,1,123,0.0,123.0,123.0
248126.0,6,3,373,2,238,0.0,172.0,119.0,1,135,0.0,135.0,135.0
41085.0,6,14,4740,7,653,6317.5,249.0,93.28571428571428,7,4087,6360.0,1514.0,583.8571428571429
147165.0,6,3,373,2,238,0.0,172.0,119.0,1,135,0.0,135.0,135.0
11244661.0,17,4,1368,4,1368,3748220.3333333335,342.0,342.0,0,0,0.0,0.0,0.0
106703040.0,17,14,864,7,432,17667072.333333332,174.0,61.71428571428572,7,432,17666836.0,174.0,61.71428571428572
317.0,17,2,174,1,79,0.0,79.0,79.0,1,95,0.0,95.0,95.0
44257.0,6,14,4740,7,653,6744.333333333333,249.0,93.28571428571428,7,4087,7202.166666666667,1514.0,583.8571428571429
100005363.0,17,11,473,6,258,20001072.6,43.0,43.0,5,215,20000185.0,43.0,43.0
420946.0,6,3,1604,2,851,0.0,785.0,425.5,1,753,0.0,753.0,753.0
90537901.0,6,14,2240,8,1016,12933985.857142856,188.0,127.0,6,1224,18074878.2,204.0,204.0
90042117.0,17,28,13364,28,13364,3334893.222222222,501.0,477.2857142857143,0,0,0.0,0.0,0.0
119867356.0,17,34,16284,34,16284,3632344.121212121,501.0,478.9411764705882,0,0,0.0,0.0,0.0
32008.0,6,14,4740,7,653,4684.0,249.0,93.28571428571428,7,4087,5079.333333333333,1514.0,583.8571428571429
234454.0,6,3,337,2,214,0.0,160.0,107.0,1,123,0.0,123.0,123.0
313248.0,17,4,1400,4,1400,104416.0,350.0,350.0,0,0,0.0,0.0,0.0
120243288.0,6,21,1585,10,786,13332902.777777778,95.0,78.6,11,799,11999004.6,95.0,72.63636363636364
135108826.0,17,6,1206,6,1206,27021765.2,201.0,201.0,0,0,0.0,0.0,0.0
24209.0,6,14,4740,7,653,3844.6666666666665,249.0,93.28571428571428,7,4087,3896.6666666666665,1514.0,583.8571428571429
2718119.0,6,25,7573,14,3735,209086.0769230769,1514.0,266.7857142857143,11,3838,245798.4,1514.0,348.90909090909093
802.0,17,4,438,2,148,0.0,74.0,74.0,2,290,0.0,147.0,145.0
42803.0,6,14,4740,7,653,7015.333333333333,249.0,93.28571428571428,7,4087,6785.833333333333,1514.0,583.8571428571429
1475.0,17,2,176,1,80,0.0,80.0,80.0,1,96,0.0,96.0,96.0
162442.0,17,2,180,1,90,0.0,90.0,90.0,1,90,0.0,90.0,90.0
65403.0,6,10,2032,5,524,16124.75,252.0,104.8,5,1508,16072.25,1236.0,301.6
196928.0,17,2,180,1,90,0.0,90.0,90.0,1,90,0.0,90.0,90.0
24987.0,6,14,4740,7,653,3226.1666666666665,249.0,93.28571428571428,7,4087,3982.5,1514.0,583.8571428571429
10875251.0,6,8,544,4,272,3579806.0,74.0,68.0,4,272,3579726.0,74.0,68.0
108106004.0,17,5,955,5,955,27026501.0,191.0,191.0,0,0,0.0,0.0,0.0
140339.0,17,4,1524,4,1524,46779.66666666666,381.0,381.0,0,0,0.0,0.0,0.0
5005829.0,17,4,849,2,166,0.0,83.0,83.0,2,683,0.0,499.0,341.5
100139511.0,17,11,604,6,389,20027465.4,174.0,64.83333333333333,5,215,20002682.0,43.0,43.0
59437.0,6,12,1413,6,816,11167.2,291.0,136.0,6,597,10262.4,259.0,99.5
146080.0,6,3,337,2,214,0.0,160.0,107.0,1,123,0.0,123.0,123.0
2323.0,17,4,344,2,150,0.0,75.0,75.0,2,194,0.0,103.0,97.0
120007645.0,6,17,1246,9,650,15000955.625,95.0,72.22222222222223,8,596,17107700.85714286,95.0,74.5
247180.0,17,2,180,1,90,0.0,90.0,90.0,1,90,0.0,90.0,90.0
1829.0,17,2,664,1,322,0.0,322.0,322.0,1,342,0.0,342.0,342.0
10472129.0,6,7,478,4,272,3445253.0,74.0,68.0,3,206,5167765.5,74.0,68.66666666666667
308076.0,17,4,1400,4,1400,102692.0,350.0,350.0,0,0,0.0,0.0,0.0
102470.0,17,2,762,2,762,0.0,381.0,381.0,0,0,0.0,0.0,0.0
135128840.0,17,6,1146,6,1146,27025768.0,191.0,191.0,0,0,0.0,0.0,0.0
56558.0,6,14,4740,7,653,9217.833333333334,249.0,93.28571428571428,7,4087,9256.166666666666,1514.0,583.8571428571429
205825.0,17,2,180,1,90,0.0,90.0,90.0,1,90,0.0,90.0,90.0
108094412.0,17,5,955,5,955,27023603.0,191.0,191.0,0,0,0.0,0.0,0.0
9249.0,17,2,507,1,86,0.0,86.0,86.0,1,421,0.0,421.0,421.0
90048577.0,17,28,13364,28,13364,3335132.4814814813,501.0,477.2857142857143,0,0,0.0,0.0,0.0
10433205.0,6,7,478,4,272,3432091.0,74.0,68.0,3,206,5147992.5,74.0,68.66666666666667
201160.0,17,4,6056,4,6056,67053.33333333333,1514.0,1514.0,0,0,0.0,0.0,0.0
10465744.0,6,7,478,4,272,3441623.0,74.0,68.0,3,206,5162331.5,74.0,68.66666666666667
283909.0,17,2,363,1,79,0.0,79.0,79.0,1,284,0.0,284.0,284.0
153571.0,17,2,180,1,90,0.0,90.0,90.0,1,90,0.0,90.0,90.0
148016.0,17,2,180,1,90,0.0,90.0,90.0,1,90,0.0,90.0,90.0
206421.0,17,2,180,1,90,0.0,90.0,90.0,1,90,0.0,90.0,90.0
51023.0,17,2,180,1,90,0.0,90.0,90.0,1,90,0.0,90.0,90.0
10419751.0,6,6,412,3,206,5142062.0,74.0,68.66666666666667,3,206,5141954.5,74.0,68.66666666666667
27301.0,6,13,1459,7,862,4171.833333333333,271.0,123.14285714285714,6,597,4413.4,259.0,99.5
90766375.0,6,20,1531,11,840,9071052.6,95.0,76.36363636363636,9,691,11344500.25,95.0,76.77777777777777
32094326.000000004,17,32,2240,32,2240,1035300.8387096776,70.0,70.0,0,0,0.0,0.0,0.0
103666.0,17,2,286,2,286,0.0,143.0,143.0,0,0,0.0,0.0,0.0
197444.0,17,2,180,1,90,0.0,90.0,90.0,1,90,0.0,90.0,90.0
1679068.0,6,23,6509,12,1529,152642.54545454544,357.0,127.41666666666669,11,4980,136887.0,1510.0,452.7272727272728
93232738.0,6,170,19222,85,13390,1107351.8214285714,284.0,157.52941176470588,85,5832,1107351.511904762,140.0,68.61176470588235
5006158.0,17,4,534,2,166,0.0,83.0,83.0,2,368,0.0,184.0,184.0
205745.0,17,2,180,1,90,0.0,90.0,90.0,1,90,0.0,90.0,90.0
46895.0,6,14,4740,7,653,7425.166666666667,249.0,93.28571428571428,7,4087,7499.166666666667,1514.0,583.8571428571429
118072280.0,6,33,2290,17,1125,7379517.5,123.0,66.17647058823529,16,1165,7191435.666666667,139.0,72.8125
144637.0,17,2,180,1,70,0.0,70.0,70.0,1,110,0.0,110.0,110.0
0.0,17,1,55,1,55,0.0,55.0,55.0,0,0,0.0,0.0,0.0
9833.0,17,4,823,2,163,0.0,89.0,81.5,2,660,0.0,443.0,330.0
146012.0,6,3,337,2,214,0.0,160.0,107.0,1,123,0.0,123.0,123.0
245424.0,6,3,337,2,214,0.0,160.0,107.0,1,123,0.0,123.0,123.0
213429.0,17,2,414,1,88,0.0,88.0,88.0,1,326,0.0,326.0,326.0
51015.0,17,2,180,1,90,0.0,90.0,90.0,1,90,0.0,90.0,90.0
34310.0,6,12,1413,7,882,5718.333333333333,291.0,126.0,5,531,7480.0,259.0,106.2
90294501.0,6,19,1436,10,745,10027136.0,95.0,74.5,9,691,11286016.0,95.0,76.77777777777777
120120701.0,6,14,2224,9,1204,15015087.625,188.0,133.77777777777777,5,1020,22522796.25,204.0,204.0
5512.0,17,4,571,2,148,0.0,74.0,74.0,2,423,0.0,280.0,211.5
24959063.0,17,5,1718,4,1368,1001117.6666666666,342.0,342.0,1,350,0.0,350.0,350.0
4990844.0,17,4,849,2,166,0.0,83.0,83.0,2,683,0.0,499.0,341.5
6543.0,17,2,164,1,74,0.0,74.0,74.0,1,90,0.0,90.0,90.0
53160.0,6,14,4740,7,653,8224.0,249.0,93.28571428571428,7,4087,6823.333333333333,1514.0,583.8571428571429
90931079.0,6,25,1702,13,840,7577589.916666667,123.0,64.61538461538461,12,862,7338953.636363637,139.0,71.83333333333333
303171.0,6,6,412,4,272,101057.0,74.0,68.0,2,140,0.0,74.0,70.0
10334.0,17,4,823,2,163,0.0,89.0,81.5,2,660,0.0,443.0,330.0
29681.0,6,14,4740,7,653,4826.5,249.0,93.28571428571428,7,4087,4612.5,1514.0,583.8571428571429
90256170.0,6,13,2036,8,1016,12893738.57142857,188.0,127.0,5,1020,22519249.25,204.0,204.0
248036.0,6,3,337,2,214,0.0,160.0,107.0,1,123,0.0,123.0,123.0
233343.0,6,3,337,2,214,0.0,160.0,107.0,1,123,0.0,123.0,123.0
100054015.0,17,12,516,6,258,20000168.0,43.0,43.0,6,258,20001286.8,43.0,43.0
300220.0,6,6,412,4,272,100073.33333333331,74.0,68.0,2,140,0.0,74.0,70.0
243295.0,17,4,6056,4,6056,81098.33333333333,1514.0,1514.0,0,0,0.0,0.0,0.0
4243.0,17,2,614,1,72,0.0,72.0,72.0,1,542,0.0,542.0,542.0
13975.0,6,11,1133,6,602,2613.6,264.0,100.33333333333331,5,531,3130.25,259.0,106.2
41451.0,6,12,1413,7,882,6908.5,291.0,126.0,5,531,9256.25,259.0,106.2
2796917.0,6,2,132,1,66,0.0,66.0,66.0,1,66,0.0,66.0,66.0
114443.0,17,4,1400,4,1400,38147.66666666666,350.0,350.0,0,0,0.0,0.0,0.0
90949666.0,6,21,1585,11,840,9094450.0,95.0,76.36363636363636,10,745,10104859.0,95.0,74.5
108105500.0,17,5,955,5,955,27026375.0,191.0,191.0,0,0,0.0,0.0,0.0
2070.0,17,2,664,1,322,0.0,322.0,322.0,1,342,0.0,342.0,342.0
8420.0,6,10,2032,5,524,1891.0,252.0,104.8,5,1508,1815.0,1236.0,301.6
91059061.0,6,27,1938,14,1029,6987942.923076923,123.0,73.5,13,909,7570282.0,123.0,69.92307692307692
90271459.0,6,13,2036,8,1016,12895922.714285716,188.0,127.0,5,1020,22525551.0,204.0,204.0
54743.0,6,14,4740,7,653,8965.166666666666,249.0,93.28571428571428,7,4087,8134.833333333333,1514.0,583.8571428571429
113431076.0,6,34,2482,17,1194,7089442.25,123.0,70.23529411764706,17,1288,6595503.875,139.0,75.76470588235294
30477.0,6,14,4740,7,653,4964.833333333333,249.0,93.28571428571428,7,4087,4802.666666666667,1514.0,583.8571428571429
134448772.0,17,14,864,7,432,19166844.0,174.0,61.71428571428572,7,432,19167306.33333333,174.0,61.71428571428572
135134201.0,17,6,1146,6,1146,27026840.2,191.0,191.0,0,0,0.0,0.0,0.0
5930.0,17,4,344,2,150,0.0,75.0,75.0,2,194,0.0,103.0,97.0
69601.0,6,14,4740,7,653,9987.5,249.0,93.28571428571428,7,4087,11310.5,1514.0,583.8571428571429
108111099.0,17,5,1005,5,1005,27027774.75,201.0,201.0,0,0,0.0,0.0,0.0
144041.0,17,2,180,1,90,0.0,90.0,90.0,1,90,0.0,90.0,90.0
2355.0,17,4,344,2,150,0.0,75.0,75.0,2,194,0.0,103.0,97.0
108699884.0,6,34,2466,17,1272,6793742.75,123.0,74.82352941176471,17,1194,6780261.5,123.0,70.23529411764706
32207.0,17,4,823,2,163,0.0,89.0,81.5,2,660,0.0,443.0,330.0
281624.0,17,2,363,1,79,0.0,79.0,79.0,1,284,0.0,284.0,284.0
90888709.0,6,19,1436,10,745,10098745.444444444,95.0,74.5,9,691,11343612.75,95.0,76.77777777777777
135140581.0,17,6,1206,6,1206,27028116.2,201.0,201.0,0,0,0.0,0.0,0.0
2802360.0,6,2,132,1,66,0.0,66.0,66.0,1,66,0.0,66.0,66.0
300540.0,6,6,412,4,272,100180.0,74.0,68.0,2,140,0.0,74.0,70.0
119884684.0,6,14,2102,5,1020,29961648.25,204.0,204.0,9,1082,14985220.25,188.0,120.22222222222224
39954.0,6,14,4740,7,653,6043.666666666667,249.0,93.28571428571428,7,4087,6448.5,1514.0,583.8571428571429
4007.0,17,2,174,1,79,0.0,79.0,79.0,1,95,0.0,95.0,95.0
3660.0,17,2,414,1,88,0.0,88.0,88.0,1,326,0.0,326.0,326.0
90289663.0,6,16,1192,8,596,12892233.57142857,95.0,74.5,8,596,12897078.0,95.0,74.5
114147644.0,6,48,3168,24,1584,4962941.043478261,66.0,66.0,24,1584,4949100.521739131,66.0,66.0
116382217.0,6,31,2166,16,1149,7744414.333333333,123.0,71.8125,15,1017,8297585.0,123.0,67.8
64181.0,6,10,2032,5,524,15741.0,252.0,104.8,5,1508,14764.75,1236.0,301.6
101097.0,17,2,762,2,762,0.0,381.0,381.0,0,0,0.0,0.0,0.0
196955.0,17,2,180,1,90,0.0,90.0,90.0,1,90,0.0,90.0,90.0
2561.0,17,2,180,1,90,0.0,90.0,90.0,1,90,0.0,90.0,90.0
306736.0,6,6,412,4,272,102245.33333333331,74.0,68.0,2,140,0.0,74.0,70.0
122001132.0,17,15,907,8,475,17428733.14285714,174.0,59.375,7,432,17001663.166666668,174.0,61.71428571428572
2329.0,17,4,344,2,150,0.0,75.0,75.0,2,194,0.0,103.0,97.0
103179.0,17,2,286,2,286,0.0,143.0,143.0,0,0,0.0,0.0,0.0
109131.0,17,2,762,2,762,0.0,381.0,381.0,0,0,0.0,0.0,0.0
305505.0,6,6,412,4,272,101835.0,74.0,68.0,2,140,0.0,74.0,70.0
47882.0,6,10,2032,5,524,11759.5,252.0,104.8,5,1508,11474.25,1236.0,301.6
74729.0,6,14,4740,7,653,11368.166666666666,249.0,93.28571428571428,7,4087,12290.5,1514.0,583.8571428571429
102339104.0,17,14,864,7,432,17056517.333333332,174.0,61.71428571428572,7,432,17012134.333333332,174.0,61.71428571428572
246010.0,6,3,337,2,214,0.0,160.0,107.0,1,123,0.0,123.0,123.0
242513.0,6,3,337,2,214,0.0,160.0,107.0,1,123,0.0,123.0,123.0
2377.0,17,4,344,2,150,0.0,75.0,75.0,2,194,0.0,103.0,97.0
178179.0,17,2,180,1,90,0.0,90.0,90.0,1,90,0.0,90.0,90.0
309006.0,17,4,622,4,622,103002.0,163.0,155.5,0,0,0.0,0.0,0.0
1174990.0,6,13,3020,8,2392,167855.7142857143,1514.0,299.0,5,628,224873.5,331.0,125.6
4386.0,17,2,602,1,72,0.0,72.0,72.0,1,530,0.0,530.0,530.0
120062771.0,17,29,13785,29,13785,4287956.107142857,501.0,475.3448275862069,0,0,0.0,0.0,0.0
90017068.0,17,28,13364,28,13364,3333965.4814814813,501.0,477.2857142857143,0,0,0.0,0.0,0.0
206079.0,6,3,426,2,280,0.0,214.0,140.0,1,146,0.0,146.0,146.0
6416.0,17,4,823,2,163,0.0,89.0,81.5,2,660,0.0,443.0,330.0
108762.0,17,2,762,2,762,0.0,381.0,381.0,0,0,0.0,0.0,0.0
135133273.0,17,6,1146,6,1146,27026654.6,191.0,191.0,0,0,0.0,0.0,0.0
28187.0,6,14,4740,7,653,4542.0,249.0,93.28571428571428,7,4087,4558.666666666667,1514.0,583.8571428571429
49095.0,6,10,2032,5,524,11529.25,252.0,104.8,5,1508,12008.5,1236.0,301.6
27714793.0,17,5,1710,5,1710,6928698.25,342.0,342.0,0,0,0.0,0.0,0.0
90020209.0,17,27,12943,27,12943,3462315.730769231,501.0,479.3703703703704,0,0,0.0,0.0,0.0
108107954.0,17,5,955,5,955,27026988.5,191.0,191.0,0,0,0.0,0.0,0.0
97710.0,17,2,286,2,286,0.0,143.0,143.0,0,0,0.0,0.0,0.0
90031671.0,17,28,13364,28,13364,3334506.333333333,501.0,477.2857142857143,0,0,0.0,0.0,0.0
54521.0,6,13,1386,7,789,8776.0,253.0,112.71428571428572,6,597,9767.8,259.0,99.5
0.0,17,1,453,1,453,0.0,453.0,453.0,0,0,0.0,0.0,0.0
6925.0,17,2,582,1,83,0.0,83.0,83.0,1,499,0.0,499.0,499.0
98884208.0,6,38,3102,21,1701,4944210.4,123.0,81.0,17,1401,6166716.125,123.0,82.41176470588235
260706.0,17,2,180,1,90,0.0,90.0,90.0,1,90,0.0,90.0,90.0
2702.0,17,4,344,2,150,0.0,75.0,75.0,2,194,0.0,103.0,97.0
25653.0,6,10,2032,5,524,6175.0,252.0,104.8,5,1508,6150.75,1236.0,301.6
13015.0,6,10,1067,5,536,2848.5,264.0,107.2,5,531,2850.75,259.0,106.2
310406.0,6,6,412,4,272,103468.66666666669,74.0,68.0,2,140,0.0,74.0,70.0
141859.0,6,2,132,1,66,0.0,66.0,66.0,1,66,0.0,66.0,66.0
121006311.0,17,15,907,8,475,17286615.85714286,174.0,59.375,7,432,16833497.166666668,174.0,61.71428571428572
13071.0,6,14,4740,7,653,2023.6666666666667,249.0,93.28571428571428,7,4087,2004.3333333333333,1514.0,583.8571428571429
90035552.0,17,28,13364,28,13364,3334650.074074074,501.0,477.2857142857143,0,0,0.0,0.0,0.0
135131650.0,17,6,1146,6,1146,27026330.0,191.0,191.0,0,0,0.0,0.0,0.0
145480.0,6,3,337,2,214,0.0,160.0,107.0,1,123,0.0,123.0,123.0
251051.00000000003,6,3,337,2,214,0.0,160.0,107.0,1,123,0.0,123.0,123.0
90876593.0,6,167,18828,84,5766,1094898.7108433736,140.0,68.64285714285714,83,13062,1095578.975609756,284.0,157.3734939759036
90287920.0,6,18,1503,9,853,11280411.125,257.0,94.77777777777776,9,650,11285489.125,95.0,72.22222222222223
9397.0,17,2,582,1,83,0.0,83.0,83.0,1,499,0.0,499.0,499.0
241969.0,6,3,373,2,238,0.0,172.0,119.0,1,135,0.0,135.0,135.0
317616.0,17,4,1400,4,1400,105872.0,350.0,350.0,0,0,0.0,0.0,0.0
143896.0,17,2,180,1,90,0.0,90.0,90.0,1,90,0.0,90.0,90.0
90295395.0,6,17,1287,9,691,11280950.5,95.0,76.77777777777777,8,596,12897685.0,95.0,74.5
3172723.0,6,18,1495,9,921,358204.625,315.0,102.33333333333331,9,574,358171.25,78.0,63.77777777777778
110153627.0,6,32,2236,16,1165,7329952.4,139.0,72.8125,16,1071,7329949.133333334,123.0,66.9375
526116.0,6,3,1604,2,851,0.0,785.0,425.5,1,753,0.0,753.0,753.0
120002274.0,6,18,1341,9,691,14999996.5,95.0,76.77777777777777,9,650,14998912.625,95.0,72.22222222222223
2319.0,17,4,344,2,150,0.0,75.0,75.0,2,194,0.0,103.0,97.0
16200.0,6,14,4740,7,653,2265.833333333333,249.0,93.28571428571428,7,4087,2564.0,1514.0,583.8571428571429
2391337.0,6,3,204,2,136,0.0,70.0,68.0,1,68,0.0,68.0,68.0
120034289.0,6,819,143604,404,27194,297851.8337468983,214.0,67.31188118811882,415,116410,288810.00241545896,1514.0,280.50602409638554
120461637.0,6,221,25024,111,17468,1095105.790909091,284.0,157.36936936936937,110,7556,1096760.1376146788,140.0,68.69090909090909
216399.0,17,2,180,1,90,0.0,90.0,90.0,1,90,0.0,90.0,90.0
107826217.0,6,30,2106,15,1089,7686467.071428572,123.0,72.6,15,1017,7686465.071428572,123.0,67.8
115183194.0,6,33,2290,17,1125,7198922.4375,123.0,66.17647058823529,16,1165,7013164.933333334,139.0,72.8125
165255.0,17,2,414,1,88,0.0,88.0,88.0,1,326,0.0,326.0,326.0
209472.0,6,3,426,2,280,0.0,214.0,140.0,1,146,0.0,146.0,146.0
228440.0,17,2,180,1,90,0.0,90.0,90.0,1,90,0.0,90.0,90.0
0.0,6,1,172,1,172,0.0,172.0,172.0,0,0,0.0,0.0,0.0
1516.0,17,2,762,2,762,0.0,381.0,381.0,0,0,0.0,0.0,0.0
9949.0,17,2,582,1,83,0.0,83.0,83.0,1,499,0.0,499.0,499.0
301295.0,6,6,412,4,272,100431.66666666669,74.0,68.0,2,140,0.0,74.0,70.0
103795.0,17,2,286,2,286,0.0,143.0,143.0,0,0,0.0,0.0,0.0
2042.0,17,4,344,2,150,0.0,75.0,75.0,2,194,0.0,103.0,97.0
2076.0,17,2,684,1,342,0.0,342.0,342.0,1,342,0.0,342.0,342.0
300223.0,6,6,412,4,272,100074.33333333331,74.0,68.0,2,140,0.0,74.0,70.0
361966.0,6,11,1021,6,444,48652.4,162.0,74.0,5,577,60605.75,349.0,115.4
297577.0,17,2,246,1,76,0.0,76.0,76.0,1,170,0.0,170.0,170.0
338.0,17,2,166,1,75,0.0,75.0,75.0,1,91,0.0,91.0,91.0
21179.0,6,11,2098,6,590,3682.2,252.0,98.33333333333331,5,1508,5007.25,1236.0,301.6
9082025.0,17,3,1034,2,684,0.0,342.0,342.0,1,350,0.0,350.0,350.0
25566.0,6,14,4740,7,653,4084.0,249.0,93.28571428571428,7,4087,4039.6666666666665,1514.0,583.8571428571429
108102368.0,17,5,1005,5,1005,27025592.0,201.0,201.0,0,0,0.0,0.0,0.0
98798.0,17,2,762,2,762,0.0,381.0,381.0,0,0,0.0,0.0,0.0
147962.0,17,2,180,1,90,0.0,90.0,90.0,1,90,0.0,90.0,90.0
144730.0,17,2,180,1,70,0.0,70.0,70.0,1,110,0.0,110.0,110.0
15858.0,6,14,4740,7,653,2415.333333333333,249.0,93.28571428571428,7,4087,2505.5,1514.0,583.8571428571429
135135633.0,17,6,1146,6,1146,27027126.6,191.0,191.0,0,0,0.0,0.0,0.0
119572966.0,6,240,26976,120,18834,1003006.386554622,284.0,156.95,120,8142,1003006.462184874,140.0,67.85
119850529.0,6,15,2306,6,1224,23968864.6,204.0,204.0,9,1082,14981170.375,188.0,120.22222222222224
48445.0,6,14,4740,7,653,7896.333333333333,249.0,93.28571428571428,7,4087,7817.0,1514.0,583.8571428571429
18432.0,6,10,1067,5,536,3618.0,264.0,107.2,5,531,2945.5,259.0,106.2
44135.0,6,14,4740,7,653,6615.5,249.0,93.28571428571428,7,4087,7203.833333333333,1514.0,583.8571428571429
146340.0,6,3,337,2,214,0.0,160.0,107.0,1,123,0.0,123.0,123.0
90288226.0,6,16,1192,8,596,12892121.857142856,95.0,74.5,8,596,12896426.0,95.0,74.5
9805.0,17,2,582,1,83,0.0,83.0,83.0,1,499,0.0,499.0,499.0
104501.0,17,2,286,2,286,0.0,143.0,143.0,0,0,0.0,0.0,0.0
298097.0,6,6,412,4,272,99365.66666666669,74.0,68.0,2,140,0.0,74.0,70.0
2353.0,17,4,344,2,150,0.0,75.0,75.0,2,194,0.0,103.0,97.0
306689.0,6,6,412,4,272,102229.66666666669,74.0,68.0,2,140,0.0,74.0,70.0
205953.0,17,2,762,2,762,0.0,381.0,381.0,0,0,0.0,0.0,0.0
300315.0,6,6,412,4,272,100105.0,74.0,68.0,2,140,0.0,74.0,70.0
105111733.0,6,856,228116,414,28434,254507.82808716703,214.0,68.68115942028986,442,199682,237840.74829931973,1514.0,451.7692307692308
16726.0,17,2,180,1,90,0.0,90.0,90.0,1,90,0.0,90.0,90.0
233877.0,6,3,373,2,238,0.0,172.0,119.0,1,135,0.0,135.0,135.0
2306.0,17,4,344,2,150,0.0,75.0,75.0,2,194,0.0,103.0,97.0
241689.0,6,3,337,2,214,0.0,160.0,107.0,1,123,0.0,123.0,123.0
119967055.0,17,34,16284,34,16284,3635365.303030303,501.0,478.9411764705882,0,0,0.0,0.0,0.0
112464322.0,6,46,3036,23,1518,5112000.727272728,66.0,66.0,23,1518,5112003.454545454,66.0,66.0
131384.0,6,3,337,2,214,0.0,160.0,107.0,1,123,0.0,123.0,123.0
103312.0,17,2,286,2,286,0.0,143.0,143.0,0,0,0.0,0.0,0.0
0.0,17,1,90,1,90,0.0,90.0,90.0,0,0,0.0,0.0,0.0
47671.0,6,14,4740,7,653,7192.0,249.0,93.28571428571428,7,4087,6403.5,1514.0,583.8571428571429
18220.0,6,20,7606,11,978,1822.0,310.0,88.9090909090909,9,6628,1998.25,1514.0,736.4444444444445
90255762.0,6,12,1832,8,1016,12893680.285714284,188.0,127.0,4,816,30030428.33333333,204.0,204.0
2795901.0,6,2,132,1,66,0.0,66.0,66.0,1,66,0.0,66.0,66.0
907498.0,6,10,1332,6,795,181499.6,457.0,132.5,4,537,210613.3333333333,331.0,134.25
38762.0,6,14,4740,7,653,3940.5,249.0,93.28571428571428,7,4087,6270.333333333333,1514.0,583.8571428571429
1821579.0,6,50,39754,21,1549,91078.95,209.0,73.76190476190476,29,38205,64696.46428571428,1514.0,1317.4137931034484
90043564.0,17,28,13364,28,13364,3334946.814814815,501.0,477.2857142857143,0,0,0.0,0.0,0.0
29265.0,6,14,4740,7,653,4601.5,249.0,93.28571428571428,7,4087,4744.0,1514.0,583.8571428571429
35354.0,6,11,2098,6,590,6992.0,252.0,98.33333333333331,5,1508,5877.25,1236.0,301.6
90042178.0,17,28,13364,28,13364,3334895.4814814813,501.0,477.2857142857143,0,0,0.0,0.0,0.0
117590807.0,6,226,25496,113,17742,1047995.6875,284.0,157.00884955752213,113,7754,1047996.0446428572,140.0,68.61946902654867
101315.0,17,2,762,2,762,0.0,381.0,381.0,0,0,0.0,0.0,0.0
120052861.0,17,28,13364,28,13364,4446402.259259259,501.0,477.2857142857143,0,0,0.0,0.0,0.0
90019812.0,17,28,13364,28,13364,3334067.111111111,501.0,477.2857142857143,0,0,0.0,0.0,0.0
135153082.0,17,6,1206,6,1206,27030616.4,201.0,201.0,0,0,0.0,0.0,0.0
255054.0,6,3,337,2,214,0.0,160.0,107.0,1,123,0.0,123.0,123.0
242065.0,6,3,337,2,214,0.0,160.0,107.0,1,123,0.0,123.0,123.0
171580.0,17,2,180,1,90,0.0,90.0,90.0,1,90,0.0,90.0,90.0
5083.0,17,4,344,2,150,0.0,75.0,75.0,2,194,0.0,103.0,97.0
833.0,17,4,438,2,148,0.0,74.0,74.0,2,290,0.0,147.0,145.0
100405306.0,17,12,778,6,389,19930993.8,174.0,64.83333333333333,6,389,20048863.8,174.0,64.83333333333333
5622989.0,6,4,270,2,134,0.0,68.0,67.0,2,136,0.0,70.0,68.0
311236.0,17,4,1400,4,1400,103745.33333333331,350.0,350.0,0,0,0.0,0.0,0.0
5618046.0,6,5,336,2,134,0.0,68.0,67.0,3,202,1419766.0,70.0,67.33333333333333
103417752.0,6,513,70630,257,53438,403975.59375,570.0,207.92996108949416,256,17192,404680.11372549017,140.0,67.15625
308454.0,6,6,412,4,272,102818.0,74.0,68.0,2,140,0.0,74.0,70.0
5623755.0,6,5,336,2,134,0.0,68.0,67.0,3,202,1425158.0,70.0,67.33333333333333
5624303.0,6,5,336,2,134,0.0,68.0,67.0,3,202,1526011.5,70.0,67.33333333333333
21477.0,6,10,2032,5,524,5024.0,252.0,104.8,5,1508,5041.0,1236.0,301.6
90014974.0,6,15,1097,8,596,12859282.0,95.0,74.5,7,501,14955035.666666666,95.0,71.57142857142857
615307.0,17,3,551,2,156,0.0,78.0,78.0,1,395,0.0,395.0,395.0
4313.0,17,2,614,1,72,0.0,72.0,72.0,1,542,0.0,542.0,542.0
146067.0,6,3,337,2,214,0.0,160.0,107.0,1,123,0.0,123.0,123.0
3180027.0,6,18,1495,9,921,358499.125,315.0,102.33333333333331,9,574,357140.875,78.0,63.77777777777778
94237080.0,17,14,1126,7,563,15666788.0,174.0,80.42857142857143,7,563,15667384.5,174.0,80.42857142857143
293580.0,17,2,180,1,90,0.0,90.0,90.0,1,90,0.0,90.0,90.0
315783.0,17,4,1400,4,1400,105261.0,350.0,350.0,0,0,0.0,0.0,0.0
870559.0,6,9,1268,6,797,174111.8,459.0,132.83333333333334,3,471,297469.5,331.0,157.0
100987.0,17,2,762,2,762,0.0,381.0,381.0,0,0,0.0,0.0,0.0
209555.0,17,2,180,1,90,0.0,90.0,90.0,1,90,0.0,90.0,90.0
217972.0,6,3,426,2,280,0.0,214.0,140.0,1,146,0.0,146.0,146.0
307469.0,6,6,412,4,272,102489.66666666669,74.0,68.0,2,140,0.0,74.0,70.0
120064454.0,17,28,13364,28,13364,4446831.62962963,501.0,477.2857142857143,0,0,0.0,0.0,0.0
65641.0,6,10,2032,5,524,13897.0,252.0,104.8,5,1508,15283.0,1236.0,301.6
123455759.0,6,48,3168,24,1584,4953196.913043479,66.0,66.0,24,1584,5314628.478260869,66.0,66.0
3017236.0,6,3,204,2,136,0.0,70.0,68.0,1,68,0.0,68.0,68.0
29420.0,6,14,4740,7,653,3722.1666666666665,249.0,93.28571428571428,7,4087,4758.833333333333,1514.0,583.8571428571429
680944.0,6,4,508,2,238,0.0,172.0,119.0,2,270,0.0,135.0,135.0
95932983.0,6,26,1746,13,906,7976416.0,123.0,69.6923076923077,13,840,7976412.166666667,123.0,64.61538461538461
35995.0,6,14,4740,7,653,5147.333333333333,249.0,93.28571428571428,7,4087,5820.0,1514.0,583.8571428571429
109408704.0,6,210,23658,105,16494,1049936.673076923,284.0,157.0857142857143,105,7164,1049935.5192307692,140.0,68.22857142857143
120044219.0,17,29,13785,29,13785,4287293.535714285,501.0,475.3448275862069,0,0,0.0,0.0,0.0
221146.0,6,3,426,2,280,0.0,214.0,140.0,1,146,0.0,146.0,146.0
325704.0,6,6,412,4,272,108568.0,74.0,68.0,2,140,0.0,74.0,70.0
179879.0,17,2,180,1,90,0.0,90.0,90.0,1,90,0.0,90.0,90.0
135134146.0,17,6,1206,6,1206,27026829.2,201.0,201.0,0,0,0.0,0.0,0.0
499338.0,6,3,204,1,68,0.0,68.0,68.0,2,136,0.0,70.0,68.0
119776197.0,6,33,2290,17,1125,7485985.625,123.0,66.17647058823529,16,1165,7319370.733333333,139.0,72.8125
346087.0,6,3,204,1,68,0.0,68.0,68.0,2,136,0.0,70.0,68.0
90043032.0,17,28,13364,28,13364,3334927.111111111,501.0,477.2857142857143,0,0,0.0,0.0,0.0
196969.0,17,2,180,1,90,0.0,90.0,90.0,1,90,0.0,90.0,90.0
209550.0,17,2,180,1,90,0.0,90.0,90.0,1,90,0.0,90.0,90.0
116559.0,17,2,286,2,286,0.0,143.0,143.0,0,0,0.0,0.0,0.0
28595894.0,17,5,1718,4,1368,917373.3333333334,342.0,342.0,1,350,0.0,350.0,350.0
232802.0,6,3,337,2,214,0.0,160.0,107.0,1,123,0.0,123.0,123.0
113469.0,17,2,286,2,286,0.0,143.0,143.0,0,0,0.0,0.0,0.0
68940.0,6,14,4740,7,653,8246.666666666666,249.0,93.28571428571428,7,4087,10833.0,1514.0,583.8571428571429
90268896.0,6,13,2036,8,1016,12895556.57142857,188.0,127.0,5,1020,22523442.75,204.0,204.0
1306904.0,6,4,264,2,132,0.0,66.0,66.0,2,132,0.0,66.0,66.0
302790.0,6,6,412,4,272,100930.0,74.0,68.0,2,140,0.0,74.0,70.0
307478.0,6,6,412,4,272,102492.66666666669,74.0,68.0,2,140,0.0,74.0,70.0
90010026.0,17,28,13364,28,13364,3333704.6666666665,501.0,477.2857142857143,0,0,0.0,0.0,0.0
2397.0,17,4,344,2,150,0.0,75.0,75.0,2,194,0.0,103.0,97.0
148063.0,17,2,180,1,90,0.0,90.0,90.0,1,90,0.0,90.0,90.0
224170.0,6,13,1386,7,789,37361.66666666666,253.0,112.71428571428572,6,597,43515.8,259.0,99.5
90563590.0,6,26,1746,13,906,7528977.166666667,123.0,69.6923076923077,13,840,7528952.666666667,123.0,64.61538461538461
105061095.0,6,193,21714,97,6624,1094386.40625,140.0,68.28865979381443,96,15090,1094989.6736842103,284.0,157.1875
323375.0,17,4,1400,4,1400,107791.66666666669,350.0,350.0,0,0,0.0,0.0,0.0
42337.0,6,14,4740,7,653,6412.5,249.0,93.28571428571428,7,4087,6868.833333333333,1514.0,583.8571428571429
39842.0,6,14,4740,7,653,6518.166666666667,249.0,93.28571428571428,7,4087,6126.166666666667,1514.0,583.8571428571429
5826223.0,6,5,336,2,134,0.0,68.0,67.0,3,202,1525193.0,70.0,67.33333333333333
304813.0,6,6,412,4,272,101604.33333333331,74.0,68.0,2,140,0.0,74.0,70.0
853789.0,6,9,1096,6,625,170757.8,287.0,104.16666666666669,3,471,290478.0,331.0,157.0
29825.0,6,14,4740,7,653,4853.166666666667,249.0,93.28571428571428,7,4087,4227.666666666667,1514.0,583.8571428571429
50623.0,6,13,1386,7,789,8437.166666666666,253.0,112.71428571428572,6,597,9660.4,259.0,99.5
10965.0,6,13,1459,7,862,1697.3333333333333,271.0,123.14285714285714,6,597,2028.0,259.0,99.5
33504.0,6,14,4740,7,653,5416.333333333333,249.0,93.28571428571428,7,4087,5083.5,1514.0,583.8571428571429
120000223.0,6,22,1680,12,935,10909111.181818182,95.0,77.91666666666667,10,745,10099316.222222222,95.0,74.5
98006200.0,17,13,1083,7,563,16334366.666666666,174.0,80.42857142857143,6,520,15600120.4,174.0,86.66666666666667
316495.0,17,4,1400,4,1400,105498.33333333331,350.0,350.0,0,0,0.0,0.0,0.0
120013425.0,17,28,13364,28,13364,4444941.666666667,501.0,477.2857142857143,0,0,0.0,0.0,0.0
135148600.0,17,6,1206,6,1206,27029720.0,201.0,201.0,0,0,0.0,0.0,0.0
5828735.0,6,4,270,2,134,0.0,68.0,67.0,2,136,0.0,70.0,68.0
90266302.0,6,13,2036,8,1016,12895186.0,188.0,127.0,5,1020,22525263.0,204.0,204.0
696786.0,6,11,1021,6,444,93411.2,162.0,74.0,5,577,116583.75,349.0,115.4
101568621.0,6,189,21398,95,6566,1080517.244680851,140.0,69.11578947368422,94,14832,1083893.9462365592,284.0,157.7872340425532
228530.0,17,2,180,1,90,0.0,90.0,90.0,1,90,0.0,90.0,90.0
190822.0,17,2,180,1,90,0.0,90.0,90.0,1,90,0.0,90.0,90.0
123302087.0,6,48,3168,24,1584,5004681.0,66.0,66.0,24,1584,5291920.260869565,66.0,66.0
2395.0,17,4,344,2,150,0.0,75.0,75.0,2,194,0.0,103.0,97.0
20386.0,6,13,1459,7,862,3397.6666666666665,271.0,123.14285714285714,6,597,3713.0,259.0,99.5
760059.0,6,11,1131,6,600,151433.6,262.0,100.0,5,531,189711.25,259.0,106.2
307957.0,6,6,412,4,272,102652.33333333331,74.0,68.0,2,140,0.0,74.0,70.0
246172.0,6,3,337,2,214,0.0,160.0,107.0,1,123,0.0,123.0,123.0
217978.0,6,3,426,2,280,0.0,214.0,140.0,1,146,0.0,146.0,146.0
228505.0,17,2,180,1,90,0.0,90.0,90.0,1,90,0.0,90.0,90.0
122585968.0,6,32,2236,16,1071,7506755.533333333,123.0,66.9375,16,1165,7506775.133333334,139.0,72.8125
12662.0,6,13,1459,7,862,1997.3333333333333,271.0,123.14285714285714,6,597,2260.6,259.0,99.5
120120127.0,6,13,2020,9,1204,15015015.875,188.0,133.77777777777777,4,816,30038638.0,204.0,204.0
112355679.0,6,35,2542,18,1348,6609157.588235294,139.0,74.88888888888889,17,1194,7008704.5,123.0,70.23529411764706
196975.0,17,2,180,1,90,0.0,90.0,90.0,1,90,0.0,90.0,90.0
100187393.0,6,188,21204,94,14778,1074829.752688172,284.0,157.2127659574468,94,6426,1074970.7956989247,140.0,68.36170212765957
91844.0,6,15,4806,8,719,13008.714285714286,249.0,89.875,7,4087,14777.833333333334,1514.0,583.8571428571429
108104349.0,17,5,955,5,955,27026087.25,191.0,191.0,0,0,0.0,0.0,0.0
744539.0,6,2,132,1,66,0.0,66.0,66.0,1,66,0.0,66.0,66.0
51914.0,6,14,4740,7,653,6177.166666666667,249.0,93.28571428571428,7,4087,8516.5,1514.0,583.8571428571429
166041.0,17,2,414,1,88,0.0,88.0,88.0,1,326,0.0,326.0,326.0
82005.0,6,10,2032,5,524,18880.5,252.0,104.8,5,1508,20066.5,1236.0,301.6
36479.0,6,14,4740,7,653,5971.0,249.0,93.28571428571428,7,4087,5594.333333333333,1514.0,583.8571428571429
90058493.0,17,27,12943,27,12943,3463788.1923076925,501.0,479.3703703703704,0,0,0.0,0.0,0.0
39544.0,6,14,4740,7,653,6440.833333333333,249.0,93.28571428571428,7,4087,6103.666666666667,1514.0,583.8571428571429
120114331.0,6,15,2428,9,1204,15014291.375,188.0,133.77777777777777,6,1224,18070455.4,204.0,204.0
121412.0,6,3,337,2,214,0.0,160.0,107.0,1,123,0.0,123.0,123.0
0.0,17,1,55,1,55,0.0,55.0,55.0,0,0,0.0,0.0,0.0
40005.0,6,10,2032,5,524,8278.75,252.0,104.8,5,1508,9482.5,1236.0,301.6
58870678.0,17,9,3086,8,2736,5108663.142857143,342.0,342.0,1,350,0.0,350.0,350.0
120056382.0,6,2440,2118736,1681,2068642,70995.43809523809,1514.0,1230.602022605592,759,50094,158337.11609498682,66.0,66.0
1007599.0,6,12,1354,6,723,199267.0,253.0,120.5,6,631,200234.6,293.0,105.16666666666669
108096812.0,17,5,1005,5,1005,27024203.0,201.0,201.0,0,0,0.0,0.0,0.0
158290.0,6,3,337,2,214,0.0,160.0,107.0,1,123,0.0,123.0,123.0
3578034.0,6,5,336,2,134,0.0,68.0,67.0,3,202,1423673.0,70.0,67.33333333333333
321554.0,17,4,1400,4,1400,107184.66666666669,350.0,350.0,0,0,0.0,0.0,0.0
114360116.0,6,217,24686,109,7490,1058889.962962963,140.0,68.71559633027523,108,17196,1066179.7570093458,336.0,159.22222222222223
155079.0,6,3,337,2,214,0.0,160.0,107.0,1,123,0.0,123.0,123.0
120378263.0,6,41,3276,23,1821,5471739.227272728,123.0,79.17391304347827,18,1455,6481019.705882353,123.0,80.83333333333333
6979.0,17,2,582,1,83,0.0,83.0,83.0,1,499,0.0,499.0,499.0
146018.0,6,3,337,2,214,0.0,160.0,107.0,1,123,0.0,123.0,123.0
317801.0,17,4,1400,4,1400,105933.66666666669,350.0,350.0,0,0,0.0,0.0,0.0
228277.0,17,2,180,1,90,0.0,90.0,90.0,1,90,0.0,90.0,90.0
2842148.0,6,5,336,2,134,0.0,68.0,67.0,3,202,1421074.0,70.0,67.33333333333333
106157.0,17,2,700,2,700,0.0,350.0,350.0,0,0,0.0,0.0,0.0
11434.0,6,10,2032,5,524,2096.25,252.0,104.8,5,1508,2613.0,1236.0,301.6
228276.0,17,2,180,1,90,0.0,90.0,90.0,1,90,0.0,90.0,90.0
382974.0,6,4,492,2,280,0.0,214.0,140.0,2,212,0.0,146.0,106.0
402.0,17,2,168,1,84,0.0,84.0,84.0,1,84,0.0,84.0,84.0
315862.0,6,10,1221,6,636,63172.4,298.0,106.0,4,585,99927.66666666669,379.0,146.25
138672678.0,17,16,1343,9,780,17334084.75,174.0,86.66666666666667,7,563,18993240.83333333,174.0,80.42857142857143
389.0,17,2,208,1,72,0.0,72.0,72.0,1,136,0.0,136.0,136.0
747162.0,6,2,132,1,66,0.0,66.0,66.0,1,66,0.0,66.0,66.0
230004.0,6,10,1221,6,636,46000.8,298.0,106.0,4,585,74537.0,379.0,146.25
311480.0,6,6,412,4,272,103826.66666666669,74.0,68.0,2,140,0.0,74.0,70.0
241999.0,6,3,337,2,214,0.0,160.0,107.0,1,123,0.0,123.0,123.0
4491.0,17,2,180,1,90,0.0,90.0,90.0,1,90,0.0,90.0,90.0
90253542.0,6,12,1832,8,1016,12893363.142857144,188.0,127.0,4,816,30030572.666666668,204.0,204.0
156896.0,6,3,337,2,214,0.0,160.0,107.0,1,123,0.0,123.0,123.0
46481.0,6,14,4740,7,653,7092.666666666667,249.0,93.28571428571428,7,4087,6711.833333333333,1514.0,583.8571428571429
67006.0,6,14,4740,7,653,10725.166666666666,249.0,93.28571428571428,7,4087,11029.666666666666,1514.0,583.8571428571429
190838.0,17,2,180,1,90,0.0,90.0,90.0,1,90,0.0,90.0,90.0
234167.0,6,3,337,2,214,0.0,160.0,107.0,1,123,0.0,123.0,123.0
29993.0,6,11,2098,6,590,5204.6,252.0,98.33333333333331,5,1508,6907.75,1236.0,301.6
157054.0,6,3,337,2,214,0.0,160.0,107.0,1,123,0.0,123.0,123.0
3075103.0,6,4,270,2,134,0.0,68.0,67.0,2,136,0.0,70.0,68.0
10470559.0,6,6,412,3,206,5166031.0,74.0,68.66666666666667,3,206,5165955.0,74.0,68.66666666666667
108106174.0,17,5,1005,5,1005,27026543.5,201.0,201.0,0,0,0.0,0.0,0.0
105082186.0,17,15,5130,15,5130,7505870.428571428,342.0,342.0,0,0,0.0,0.0,0.0
20672.0,6,14,4740,7,653,2716.6666666666665,249.0,93.28571428571428,7,4087,3308.6666666666665,1514.0,583.8571428571429
145404.0,6,2,132,1,66,0.0,66.0,66.0,1,66,0.0,66.0,66.0
307350.0,6,6,412,4,272,102450.0,74.0,68.0,2,140,0.0,74.0,70.0
206647.0,17,4,6056,4,6056,68882.33333333333,1514.0,1514.0,0,0,0.0,0.0,0.0
1021493.0,6,11,1134,6,558,204298.60000000003,220.0,93.0,5,576,253823.25,304.0,115.2
94135.0,17,3,1050,3,1050,47067.5,350.0,350.0,0,0,0.0,0.0,0.0
586.0,17,2,508,2,508,0.0,257.0,254.0,0,0,0.0,0.0,0.0
32375.0,6,14,4740,7,653,5228.166666666667,249.0,93.28571428571428,7,4087,3857.0,1514.0,583.8571428571429
122975254.0,6,48,3168,24,1584,5100804.739130435,66.0,66.0,24,1584,5166277.913043479,66.0,66.0
120000011.0,6,20,1531,11,840,12000001.1,95.0,76.36363636363636,9,691,11342392.625,95.0,76.77777777777777
40167.0,6,14,4740,7,653,6545.833333333333,249.0,93.28571428571428,7,4087,6332.333333333333,1514.0,583.8571428571429
331.0,17,2,166,1,75,0.0,75.0,75.0,1,91,0.0,91.0,91.0
232779.0,6,3,337,2,214,0.0,160.0,107.0,1,123,0.0,123.0,123.0
3178391.0,6,18,1495,9,921,358213.125,315.0,102.33333333333331,9,574,358160.625,78.0,63.77777777777778
171612.0,17,2,180,1,90,0.0,90.0,90.0,1,90,0.0,90.0,90.0
315135.0,17,4,1400,4,1400,105045.0,350.0,350.0,0,0,0.0,0.0,0.0
207900.0,6,3,426,2,280,0.0,214.0,140.0,1,146,0.0,146.0,146.0
135132064.0,17,6,1206,6,1206,27026412.8,201.0,201.0,0,0,0.0,0.0,0.0
135119674.0,17,6,1146,6,1146,27023934.8,191.0,191.0,0,0,0.0,0.0,0.0
10462095.0,6,7,478,4,272,3442028.6666666665,74.0,68.0,3,206,5162952.0,74.0,68.66666666666667
311545.0,17,4,1400,4,1400,103848.33333333331,350.0,350.0,0,0,0.0,0.0,0.0
1036767.0,6,11,1134,6,558,207353.4,220.0,93.0,5,576,258461.75,304.0,115.2
43993.0,6,14,4740,7,653,7113.166666666667,249.0,93.28571428571428,7,4087,6834.5,1514.0,583.8571428571429
2456146.0,6,49,23728,25,19797,102339.41666666669,1514.0,791.88,24,3931,96626.30434782608,1514.0,163.79166666666666
90060478.0,17,28,13364,28,13364,3335573.25925926,501.0,477.2857142857143,0,0,0.0,0.0,0.0
316927.0,17,4,1400,4,1400,105642.33333333331,350.0,350.0,0,0,0.0,0.0,0.0
226755.0,6,3,426,2,280,0.0,214.0,140.0,1,146,0.0,146.0,146.0
48811.0,6,14,4740,7,653,8008.666666666667,249.0,93.28571428571428,7,4087,7349.833333333333,1514.0,583.8571428571429
60243.0,6,14,4740,7,653,9516.833333333334,249.0,93.28571428571428,7,4087,9609.0,1514.0,583.8571428571429
206082.0,17,2,762,2,762,0.0,381.0,381.0,0,0,0.0,0.0,0.0
90761825.0,6,22,1680,12,935,8244865.727272727,95.0,77.91666666666667,10,745,10053844.666666666,95.0,74.5
232992.0,6,3,337,2,214,0.0,160.0,107.0,1,123,0.0,123.0,123.0
90053808.0,17,28,13364,28,13364,3335326.222222222,501.0,477.2857142857143,0,0,0.0,0.0,0.0
239655.0,6,3,337,2,214,0.0,160.0,107.0,1,123,0.0,123.0,123.0
23399.0,6,14,4740,7,653,3500.5,249.0,93.28571428571428,7,4087,3318.333333333333,1514.0,583.8571428571429
146258.0,6,3,337,2,214,0.0,160.0,107.0,1,123,0.0,123.0,123.0
2596090.0,6,2,132,1,66,0.0,66.0,66.0,1,66,0.0,66.0,66.0
40749.0,17,2,582,1,83,0.0,83.0,83.0,1,499,0.0,499.0,499.0
21010.0,6,11,2098,6,590,4202.0,252.0,98.33333333333331,5,1508,4960.0,1236.0,301.6
590262.0,6,5,526,3,280,295131.0,160.0,93.33333333333331,2,246,0.0,123.0,123.0
499782.0,6,4,270,2,134,0.0,68.0,67.0,2,136,0.0,70.0,68.0
102991.0,17,2,286,2,286,0.0,143.0,143.0,0,0,0.0,0.0,0.0
100362852.0,17,12,516,6,258,20000146.8,43.0,43.0,6,258,20000174.2,43.0,43.0
129001167.0,17,15,907,8,475,18428738.14285714,174.0,59.375,7,432,18167821.83333333,174.0,61.71428571428572
2179506.0,6,24,7544,12,2450,198136.9090909091,1034.0,204.16666666666663,12,5094,170260.72727272726,1510.0,424.5
92152.0,6,14,4740,7,653,15238.333333333334,249.0,93.28571428571428,7,4087,15047.333333333334,1514.0,583.8571428571429
30489.0,6,14,4740,7,653,4958.5,249.0,93.28571428571428,7,4087,4640.666666666667,1514.0,583.8571428571429
120018142.0,17,29,13785,29,13785,4286362.214285715,501.0,475.3448275862069,0,0,0.0,0.0,0.0
204665.0,17,2,762,2,762,0.0,381.0,381.0,0,0,0.0,0.0,0.0
119720303.0,6,248,27976,124,19496,971575.162601626,284.0,157.2258064516129,124,8480,971576.8048780488,140.0,68.38709677419355
2790345.0,6,2,132,1,66,0.0,66.0,66.0,1,66,0.0,66.0,66.0
143929.0,17,2,180,1,90,0.0,90.0,90.0,1,90,0.0,90.0,90.0
120004183.0,6,16,1192,8,596,17143454.714285713,95.0,74.5,8,596,17106464.42857143,95.0,74.5
877550.0,6,9,1196,6,725,175510.0,387.0,120.83333333333331,3,471,300920.0,331.0,157.0
10465819.0,6,7,478,4,272,3442747.0,74.0,68.0,3,206,5164026.5,74.0,68.66666666666667
310044.0,6,6,412,4,272,103348.0,74.0,68.0,2,140,0.0,74.0,70.0
108104980.0,17,5,955,5,955,27026245.0,191.0,191.0,0,0,0.0,0.0,0.0
100563482.0,17,13,821,7,432,16666809.166666666,174.0,61.71428571428572,6,389,20016411.0,174.0,64.83333333333333
2643645.0,6,3,1777,1,826,0.0,826.0,826.0,2,951,0.0,885.0,475.5
2324.0,17,4,344,2,150,0.0,75.0,75.0,2,194,0.0,103.0,97.0
161120.0,6,2,128,1,74,0.0,74.0,74.0,1,54,0.0,54.0,54.0
122023.0,6,3,337,2,214,0.0,160.0,107.0,1,123,0.0,123.0,123.0
312368.0,6,6,412,4,272,104122.66666666669,74.0,68.0,2,140,0.0,74.0,70.0
135113277.0,17,6,1146,6,1146,27022655.4,191.0,191.0,0,0,0.0,0.0,0.0
90061930.0,17,28,13364,28,13364,3335627.037037037,501.0,477.2857142857143,0,0,0.0,0.0,0.0
10454508.0,6,7,478,4,272,3439351.6666666665,74.0,68.0,3,206,5158918.5,74.0,68.66666666666667
304.0,17,2,168,1,76,0.0,76.0,76.0,1,92,0.0,92.0,92.0
108114025.0,17,5,955,5,955,27028506.25,191.0,191.0,0,0,0.0,0.0,0.0
234980.0,6,3,337,2,214,0.0,160.0,107.0,1,123,0.0,123.0,123.0
320645.0,17,4,1400,4,1400,106881.66666666669,350.0,350.0,0,0,0.0,0.0,0.0
196881.0,17,2,180,1,90,0.0,90.0,90.0,1,90,0.0,90.0,90.0
103084142.0,17,14,864,7,432,17168106.333333332,174.0,61.71428571428572,7,432,17166835.0,174.0,61.71428571428572
307703.0,6,6,412,4,272,102567.66666666669,74.0,68.0,2,140,0.0,74.0,70.0
90261463.0,6,12,1832,8,1016,12894494.714285716,188.0,127.0,4,816,30031992.666666668,204.0,204.0
307902.0,17,2,180,1,90,0.0,90.0,90.0,1,90,0.0,90.0,90.0
353101.0,6,4,508,2,238,0.0,172.0,119.0,2,270,0.0,135.0,135.0
302451.0,6,6,412,4,272,100817.0,74.0,68.0,2,140,0.0,74.0,70.0
28500.0,6,14,4740,7,653,4330.333333333333,249.0,93.28571428571428,7,4087,3681.8333333333335,1514.0,583.8571428571429
63612.0,6,13,1479,7,882,10149.166666666666,291.0,126.0,6,597,12000.8,259.0,99.5
103020738.0,6,44,2904,22,1452,4905749.428571428,66.0,66.0,22,1452,4895456.476190476,66.0,66.0
3074422.0,6,156,121612,87,112756,35749.09302325582,1510.0,1296.0459770114942,69,8856,40679.25,1510.0,128.34782608695653
42641.0,6,14,4740,7,653,6977.166666666667,249.0,93.28571428571428,7,4087,6877.666666666667,1514.0,583.8571428571429
100099150.0,6,179,20278,90,6174,1124709.5505617978,140.0,68.6,89,14104,1125568.4886363635,284.0,158.47191011235955
260938.0,6,3,337,2,214,0.0,160.0,107.0,1,123,0.0,123.0,123.0
42519.0,6,10,2032,5,524,10391.5,252.0,104.8,5,1508,8943.5,1236.0,301.6
120535407.0,6,315,37994,158,27336,767741.4458598726,464.0,173.0126582278481,157,10658,765984.2948717949,140.0,67.88535031847134
92016283.0,6,38,2508,19,1254,5112001.5,66.0,66.0,19,1254,5112000.444444444,66.0,66.0
109342.0,17,2,286,2,286,0.0,143.0,143.0,0,0,0.0,0.0,0.0
143958.0,17,2,180,1,90,0.0,90.0,90.0,1,90,0.0,90.0,90.0
35745356.0,6,5,336,2,134,0.0,68.0,67.0,3,202,17807677.0,70.0,67.33333333333333
90259408.0,6,12,1832,8,1016,12894201.142857144,188.0,127.0,4,816,30031539.33333333,204.0,204.0
516.0,17,2,508,2,508,0.0,257.0,254.0,0,0,0.0,0.0,0.0
90588918.0,6,32,2352,16,1212,6039261.2,123.0,75.75,16,1140,6025599.666666667,123.0,71.25
411.0,17,2,410,1,78,0.0,78.0,78.0,1,332,0.0,332.0,332.0
135135207.0,17,6,1206,6,1206,27027041.4,201.0,201.0,0,0,0.0,0.0,0.0
3007453.0,6,12,2172,7,664,501031.3333333333,252.0,94.85714285714286,5,1508,2480.5,1236.0,301.6
51363.0,6,14,4740,7,653,8079.666666666667,249.0,93.28571428571428,7,4087,7118.0,1514.0,583.8571428571429
99319835.0,6,192,21918,96,15360,1043206.4315789472,284.0,160.0,96,6558,1043205.9578947368,140.0,68.3125
228514.0,17,2,180,1,90,0.0,90.0,90.0,1,90,0.0,90.0,90.0
21656.0,6,10,2032,5,524,5152.75,252.0,104.8,5,1508,5121.5,1236.0,301.6
451.0,17,2,410,1,78,0.0,78.0,78.0,1,332,0.0,332.0,332.0
146234.0,6,3,337,2,214,0.0,160.0,107.0,1,123,0.0,123.0,123.0
6992.0,17,4,823,2,163,0.0,89.0,81.5,2,660,0.0,443.0,330.0
34376.0,6,2,145,2,145,0.0,91.0,72.5,0,0,0.0,0.0,0.0
1513505.0,6,4,276,2,128,0.0,74.0,64.0,2,148,0.0,74.0,74.0
114535248.0,6,182,20682,91,14454,1270221.6333333333,284.0,158.83516483516485,91,6228,1270222.0333333334,140.0,68.43956043956044
18434.0,6,10,2032,5,524,2928.25,252.0,104.8,5,1508,4343.0,1236.0,301.6
111235.0,17,2,286,2,286,0.0,143.0,143.0,0,0,0.0,0.0,0.0
14801.0,17,4,823,2,163,0.0,89.0,81.5,2,660,0.0,443.0,330.0
826.0,17,4,438,2,148,0.0,74.0,74.0,2,290,0.0,147.0,145.0
5832753.0,6,5,336,2,134,0.0,68.0,67.0,3,202,1469268.5,70.0,67.33333333333333
90258982.0,6,12,1832,8,1016,12894140.285714284,188.0,127.0,4,816,30031465.0,204.0,204.0
10865207.0,6,7,478,3,206,5364442.5,74.0,68.66666666666667,4,272,3576239.0,74.0,68.0
241432.0,6,3,337,2,214,0.0,160.0,107.0,1,123,0.0,123.0,123.0
120000049.0,6,17,1287,9,691,15000006.125,95.0,76.77777777777777,8,596,12899397.0,95.0,74.5
107375.0,17,2,286,2,286,0.0,143.0,143.0,0,0,0.0,0.0,0.0
313.0,17,2,174,1,79,0.0,79.0,79.0,1,95,0.0,95.0,95.0
84171.0,6,10,2032,5,524,14933.25,252.0,104.8,5,1508,18792.75,1236.0,301.6
98305022.0,6,30,2254,15,1086,7021757.928571428,123.0,72.4,15,1168,6472400.857142857,139.0,77.86666666666666
311796.0,6,6,412,4,272,103932.0,74.0,68.0,2,140,0.0,74.0,70.0
117497326.0,6,34,2350,17,1225,7330102.1875,139.0,72.05882352941177,17,1125,7330102.125,123.0,66.17647058823529
391722.0,6,3,1604,1,753,0.0,753.0,753.0,2,851,0.0,785.0,425.5
315044.0,17,4,1400,4,1400,105014.66666666669,350.0,350.0,0,0,0.0,0.0,0.0
350.0,17,2,267,1,83,0.0,83.0,83.0,1,184,0.0,184.0,184.0
121203.0,6,3,337,2,214,0.0,160.0,107.0,1,123,0.0,123.0,123.0
14070451.0,17,6,2052,6,2052,2814090.2,342.0,342.0,0,0,0.0,0.0,0.0
107843604.0,6,28,1860,14,966,8295661.846153846,123.0,69.0,14,894,8279032.769230769,123.0,63.85714285714285
120122645.0,6,14,2240,6,1224,24024529.0,204.0,204.0,8,1016,17097980.14285714,188.0,127.0
104794477.0,17,14,864,7,432,17333489.166666668,174.0,61.71428571428572,7,432,17334998.5,174.0,61.71428571428572
233255.0,6,3,337,2,214,0.0,160.0,107.0,1,123,0.0,123.0,123.0
243093.0,6,4,439,2,238,0.0,172.0,119.0,2,201,0.0,135.0,100.5
250163.00000000003,17,4,6056,4,6056,83387.66666666667,1514.0,1514.0,0,0,0.0,0.0,0.0
123615766.0,17,14,864,7,432,17334371.5,174.0,61.71428571428572,7,432,19976079.666666668,174.0,61.71428571428572
104966419.0,17,14,864,7,432,17494403.166666668,174.0,61.71428571428572,7,432,17427572.166666668,174.0,61.71428571428572
105099258.0,17,15,5130,15,5130,7507089.857142857,342.0,342.0,0,0,0.0,0.0,0.0
18860.0,6,10,1067,5,536,4524.5,264.0,107.2,5,531,3571.0,259.0,106.2
35369.0,6,14,4740,7,653,5641.833333333333,249.0,93.28571428571428,7,4087,5473.333333333333,1514.0,583.8571428571429
90258324.0,6,13,2036,8,1016,12894046.285714284,188.0,127.0,5,1020,22523466.25,204.0,204.0
39899.0,6,14,4740,7,653,6420.666666666667,249.0,93.28571428571428,7,4087,6289.0,1514.0,583.8571428571429
206456.0,6,3,426,2,280,0.0,214.0,140.0,1,146,0.0,146.0,146.0
205777.0,17,2,180,1,90,0.0,90.0,90.0,1,90,0.0,90.0,90.0
124321088.0,6,37,2656,19,1408,6906727.111111111,139.0,74.10526315789474,18,1248,6712916.176470588,123.0,69.33333333333333
90744226.0,6,20,1531,11,840,9069645.5,95.0,76.36363636363636,9,691,11342531.5,95.0,76.77777777777777
229224.0,17,2,762,2,762,0.0,381.0,381.0,0,0,0.0,0.0,0.0
103086.0,17,2,286,2,286,0.0,143.0,143.0,0,0,0.0,0.0,0.0
310.0,17,2,174,1,79,0.0,79.0,79.0,1,95,0.0,95.0,95.0
90015738.0,17,28,13364,28,13364,3333916.222222222,501.0,477.2857142857143,0,0,0.0,0.0,0.0
109678.0,6,12,1320,7,789,18279.666666666668,253.0,112.71428571428572,5,531,24326.5,259.0,106.2
510964.0,6,5,336,2,134,0.0,68.0,67.0,3,202,195404.0,70.0,67.33333333333333
90529662.0,6,26,1746,13,906,7526151.5,123.0,69.6923076923077,13,840,7526152.833333333,123.0,64.61538461538461
90258564.0,6,13,2036,8,1016,12894080.57142857,188.0,127.0,5,1020,22523286.5,204.0,204.0
308276.0,6,6,412,4,272,102758.66666666669,74.0,68.0,2,140,0.0,74.0,70.0
602928.0,6,3,236,3,236,301464.0,91.0,78.66666666666667,0,0,0.0,0.0,0.0
794.0,17,2,762,2,762,0.0,381.0,381.0,0,0,0.0,0.0,0.0
312841.0,17,4,1400,4,1400,104280.33333333331,350.0,350.0,0,0,0.0,0.0,0.0
284881.0,17,4,704,2,148,0.0,74.0,74.0,2,556,0.0,280.0,278.0
1314532.0,6,4,264,2,132,0.0,66.0,66.0,2,132,0.0,66.0,66.0
3324874.0,17,3,1026,3,1026,1662437.0,342.0,342.0,0,0,0.0,0.0,0.0
90670480.0,6,15,2302,9,1204,11319324.125,188.0,133.77777777777777,6,1098,18101601.6,204.0,183.0
305638.0,6,6,412,4,272,101879.33333333331,74.0,68.0,2,140,0.0,74.0,70.0
303869.0,6,6,412,4,272,101289.66666666669,74.0,68.0,2,140,0.0,74.0,70.0
328.0,17,2,160,1,80,0.0,80.0,80.0,1,80,0.0,80.0,80.0
109228768.0,17,14,864,7,432,18168365.166666668,174.0,61.71428571428572,7,432,18166831.33333333,174.0,61.71428571428572
327.0,17,2,166,1,75,0.0,75.0,75.0,1,91,0.0,91.0,91.0
207390.0,6,3,426,2,280,0.0,214.0,140.0,1,146,0.0,146.0,146.0
111145304.0,6,30,1974,15,1026,7924331.714285715,123.0,68.4,15,948,7924336.785714285,123.0,63.2
2575747.0,6,2,132,1,66,0.0,66.0,66.0,1,66,0.0,66.0,66.0
51251.0,6,14,4740,7,653,7144.0,249.0,93.28571428571428,7,4087,6658.666666666667,1514.0,583.8571428571429
51911124.0,6,8,1307,8,1307,7415874.857142857,172.0,163.375,0,0,0.0,0.0,0.0
29786.0,6,10,2032,5,524,5818.75,252.0,104.8,5,1508,7176.25,1236.0,301.6
36504.0,6,10,2032,5,524,8693.25,252.0,104.8,5,1508,8383.25,1236.0,301.6
139453.0,6,2,132,1,66,0.0,66.0,66.0,1,66,0.0,66.0,66.0
245547.0,6,3,337,2,214,0.0,160.0,107.0,1,123,0.0,123.0,123.0
66465.0,6,14,4740,7,653,9278.833333333334,249.0,93.28571428571428,7,4087,10877.5,1514.0,583.8571428571429
30944.0,6,10,2032,5,524,7493.0,252.0,104.8,5,1508,7480.75,1236.0,301.6
59699.0,6,10,2032,5,524,13942.75,252.0,104.8,5,1508,13221.5,1236.0,301.6
122687757.0,6,48,3168,24,1584,5146336.826086956,66.0,66.0,24,1584,5061981.739130435,66.0,66.0
64058.00000000001,6,13,1386,7,789,10676.333333333334,253.0,112.71428571428572,6,597,9890.2,259.0,99.5
196831.0,17,2,180,1,90,0.0,90.0,90.0,1,90,0.0,90.0,90.0
103494.0,17,2,286,2,286,0.0,143.0,143.0,0,0,0.0,0.0,0.0
70559192.0,6,8,1307,8,1307,10079884.57142857,172.0,163.375,0,0,0.0,0.0,0.0
92544590.0,6,27,1954,14,1045,7102198.384615385,139.0,74.64285714285714,13,909,7694051.0,123.0,69.92307692307692
3507504.0,6,202,177552,122,167969,28987.636363636364,1510.0,1376.795081967213,80,9583,40482.07594936709,1510.0,119.7875
120034401.0,17,28,13364,28,13364,4445718.555555556,501.0,477.2857142857143,0,0,0.0,0.0,0.0
14730650.0,6,20,1689,10,1057,1603569.888888889,315.0,105.7,10,632,1603515.5555555555,78.0,63.2
8354279.0,17,3,1034,2,684,0.0,342.0,342.0,1,350,0.0,350.0,350.0
326.0,17,2,164,1,82,0.0,82.0,82.0,1,82,0.0,82.0,82.0
34114.0,6,13,1394,7,797,5419.666666666667,253.0,113.85714285714286,6,597,6100.8,259.0,99.5
306097.0,6,6,412,4,272,102032.33333333331,74.0,68.0,2,140,0.0,74.0,70.0
96361248.0,17,12,778,6,389,19200194.6,174.0,64.83333333333333,6,389,19201206.6,174.0,64.83333333333333
241643.0,6,3,337,2,214,0.0,160.0,107.0,1,123,0.0,123.0,123.0
120120038.0,6,16,2648,8,1632,17160005.42857143,204.0,204.0,8,1016,17098284.714285713,188.0,127.0
307961.0,17,2,180,1,90,0.0,90.0,90.0,1,90,0.0,90.0,90.0
0.0,17,1,55,1,55,0.0,55.0,55.0,0,0,0.0,0.0,0.0
239969.0,6,3,337,2,214,0.0,160.0,107.0,1,123,0.0,123.0,123.0
113805953.0,6,32,2358,17,1272,7112872.0625,123.0,74.82352941176471,15,1086,8113558.285714285,123.0,72.4
108107254.0,17,5,955,5,955,27026813.5,191.0,191.0,0,0,0.0,0.0,0.0
216402.0,17,2,180,1,90,0.0,90.0,90.0,1,90,0.0,90.0,90.0
110044.0,17,4,1400,4,1400,36681.333333333336,350.0,350.0,0,0,0.0,0.0,0.0
114842857.0,6,403,64266,202,13702,569735.815920398,214.0,67.83168316831683,201,50564,574110.775,1514.0,251.5621890547264
281304.0,17,2,363,1,79,0.0,79.0,79.0,1,284,0.0,284.0,284.0
5621223.0,6,4,270,2,134,0.0,68.0,67.0,2,136,0.0,70.0,68.0
140107.0,17,4,571,2,148,0.0,74.0,74.0,2,423,0.0,280.0,211.5
90055821.0,17,28,13364,28,13364,3335400.777777778,501.0,477.2857142857143,0,0,0.0,0.0,0.0
135127537.0,17,6,1146,6,1146,27025507.4,191.0,191.0,0,0,0.0,0.0,0.0
228269.0,17,2,180,1,90,0.0,90.0,90.0,1,90,0.0,90.0,90.0
217192.0,6,3,426,2,280,0.0,214.0,140.0,1,146,0.0,146.0,146.0
108105622.0,17,5,1005,5,1005,27026405.5,201.0,201.0,0,0,0.0,0.0,0.0
320926.0,6,7,478,4,272,106975.33333333331,74.0,68.0,3,206,79725.0,74.0,68.66666666666667
1155252.0,6,13,3000,8,2372,165036.0,1514.0,296.5,5,628,220634.25,331.0,125.6
23067.0,6,13,1459,7,862,3230.5,271.0,123.14285714285714,6,597,3917.0,259.0,99.5
312602.0,17,4,1400,4,1400,104200.66666666669,350.0,350.0,0,0,0.0,0.0,0.0
301155.0,6,6,412,4,272,100385.0,74.0,68.0,2,140,0.0,74.0,70.0
90053042.0,17,28,13364,28,13364,3335297.851851852,501.0,477.2857142857143,0,0,0.0,0.0,0.0
120001075.0,6,25,1924,14,1084,9230851.923076924,95.0,77.42857142857143,11,840,9147946.1,95.0,76.36363636363636
93643017.0,6,39,2574,20,1320,4928566.368421053,66.0,66.0,19,1254,5160000.333333333,66.0,66.0
90527095.0,6,14,2240,8,1016,12932442.142857144,188.0,127.0,6,1224,18072430.2,204.0,204.0
46717.0,6,10,2032,5,524,10163.5,252.0,104.8,5,1508,9777.0,1236.0,301.6
100117.0,17,4,6056,4,6056,33372.333333333336,1514.0,1514.0,0,0,0.0,0.0,0.0
99720.0,6,12,1328,7,797,16620.0,253.0,113.85714285714286,5,531,21470.0,259.0,106.2
135131692.0,17,6,1146,6,1146,27026338.4,191.0,191.0,0,0,0.0,0.0,0.0
103591337.0,6,44,2904,22,1452,4932920.80952381,66.0,66.0,22,1452,4919939.285714285,66.0,66.0
2327819.0,6,3,1777,2,951,0.0,885.0,475.5,1,826,0.0,826.0,826.0
103000988.0,17,13,1083,7,563,17166831.333333332,174.0,80.42857142857143,6,520,16600822.8,174.0,86.66666666666667
9215.0,17,2,498,1,80,0.0,80.0,80.0,1,418,0.0,418.0,418.0
3005301.0,6,11,2106,6,598,600844.8,252.0,99.66666666666669,5,1508,1870.75,1236.0,301.6
103050.0,17,2,286,2,286,0.0,143.0,143.0,0,0,0.0,0.0,0.0
103529.0,17,2,286,2,286,0.0,143.0,143.0,0,0,0.0,0.0,0.0
0.0,17,1,381,1,381,0.0,381.0,381.0,0,0,0.0,0.0,0.0
190779.0,17,2,180,1,90,0.0,90.0,90.0,1,90,0.0,90.0,90.0
207931.0,17,2,180,1,90,0.0,90.0,90.0,1,90,0.0,90.0,90.0
135129331.0,17,6,1146,6,1146,27025866.2,191.0,191.0,0,0,0.0,0.0,0.0
92880274.0,6,38,2508,19,1254,5160000.055555556,66.0,66.0,19,1254,5160001.444444444,66.0,66.0
2416.0,17,4,344,2,150,0.0,75.0,75.0,2,194,0.0,103.0,97.0
2803474.0,6,2,132,1,66,0.0,66.0,66.0,1,66,0.0,66.0,66.0
115077819.0,6,34,2350,17,1225,7178875.375,139.0,72.05882352941177,17,1125,7178875.875,123.0,66.17647058823529
50468.0,6,14,4740,7,653,8287.0,249.0,93.28571428571428,7,4087,7044.833333333333,1514.0,583.8571428571429
2486.0,17,4,344,2,150,0.0,75.0,75.0,2,194,0.0,103.0,97.0
147911.0,17,2,180,1,90,0.0,90.0,90.0,1,90,0.0,90.0,90.0
320559.0,17,4,1400,4,1400,106853.0,350.0,350.0,0,0,0.0,0.0,0.0
388648.0,6,6,412,4,272,129549.33333333331,74.0,68.0,2,140,0.0,74.0,70.0
284323.0,17,2,414,1,88,0.0,88.0,88.0,1,326,0.0,326.0,326.0
114264753.0,17,14,864,7,432,19000169.0,174.0,61.71428571428572,7,432,19002574.5,174.0,61.71428571428572
49549.0,6,14,4740,7,653,8092.166666666667,249.0,93.28571428571428,7,4087,7818.666666666667,1514.0,583.8571428571429
207032.0,6,3,426,2,280,0.0,214.0,140.0,1,146,0.0,146.0,146.0
302147.0,6,6,412,4,272,100715.66666666669,74.0,68.0,2,140,0.0,74.0,70.0
92000804.0,17,11,735,6,389,18400160.8,174.0,64.83333333333333,5,346,20055685.75,174.0,69.2
171739.0,17,2,180,1,90,0.0,90.0,90.0,1,90,0.0,90.0,90.0
0.0,6,1,66,1,66,0.0,66.0,66.0,0,0,0.0,0.0,0.0
102780.0,17,2,286,2,286,0.0,143.0,143.0,0,0,0.0,0.0,0.0
311.0,17,2,164,1,82,0.0,82.0,82.0,1,82,0.0,82.0,82.0
236273.0,6,3,373,2,238,0.0,172.0,119.0,1,135,0.0,135.0,135.0
304102.0,6,3,202,2,128,0.0,74.0,64.0,1,74,0.0,74.0,74.0
10432396.0,6,6,412,3,206,5148038.5,74.0,68.66666666666667,3,206,5147927.5,74.0,68.66666666666667
0.0,17,1,179,1,179,0.0,179.0,179.0,0,0,0.0,0.0,0.0
1040258.0,6,13,1386,7,789,173376.33333333334,253.0,112.71428571428572,6,597,206285.0,259.0,99.5
2043.0,17,4,344,2,150,0.0,75.0,75.0,2,194,0.0,103.0,97.0
91421623.0,6,24,1829,13,989,7617974.083333333,95.0,76.07692307692308,11,840,9141016.5,95.0,76.36363636363636
120351620.0,6,253,28682,127,20070,955171.5873015872,284.0,158.03149606299212,126,8612,954562.296,140.0,68.34920634920636
219429.0,6,3,426,2,280,0.0,214.0,140.0,1,146,0.0,146.0,146.0
52732.0,6,14,4740,7,653,8582.333333333334,249.0,93.28571428571428,7,4087,7700.5,1514.0,583.8571428571429
2818696.0,6,2,132,1,66,0.0,66.0,66.0,1,66,0.0,66.0,66.0
49409.0,6,14,4740,7,653,7563.833333333333,249.0,93.28571428571428,7,4087,8005.833333333333,1514.0,583.8571428571429
260310.0,6,3,337,2,214,0.0,160.0,107.0,1,123,0.0,123.0,123.0
162295.0,17,2,180,1,90,0.0,90.0,90.0,1,90,0.0,90.0,90.0
6689.0,17,2,582,1,83,0.0,83.0,83.0,1,499,0.0,499.0,499.0
102719.0,17,2,286,2,286,0.0,143.0,143.0,0,0,0.0,0.0,0.0
216430.0,17,2,180,1,90,0.0,90.0,90.0,1,90,0.0,90.0,90.0
209994.0,6,10,1221,6,636,41998.8,298.0,106.0,4,585,68565.33333333333,379.0,146.25
50937.0,6,12,1427,6,796,9757.4,271.0,132.66666666666666,6,631,8813.6,293.0,105.16666666666669
90295662.0,6,14,1043,7,542,15049277.0,95.0,77.42857142857143,7,501,14997141.5,95.0,71.57142857142857
209033.0,6,10,1221,6,636,41806.6,298.0,106.0,4,585,68523.0,379.0,146.25
319.0,17,2,174,1,79,0.0,79.0,79.0,1,95,0.0,95.0,95.0
66203.0,6,2,132,1,66,0.0,66.0,66.0,1,66,0.0,66.0,66.0
302674.0,6,6,412,4,272,100891.33333333331,74.0,68.0,2,140,0.0,74.0,70.0
116462555.0,6,48,3168,24,1584,5063589.347826087,66.0,66.0,24,1584,5051748.695652174,66.0,66.0
26739.0,6,14,4740,7,653,3711.0,249.0,93.28571428571428,7,4087,3730.5,1514.0,583.8571428571429
94685980.0,6,184,21184,92,6294,1031493.1648351648,140.0,68.41304347826087,92,14890,1031550.10989011,300.0,161.84782608695653
207283.0,6,3,426,2,280,0.0,214.0,140.0,1,146,0.0,146.0,146.0
120234753.0,6,212,23992,106,7304,1137248.5714285714,140.0,68.90566037735849,106,16688,1138243.5714285714,284.0,157.43396226415095
848856.0,6,9,1096,6,625,169771.2,287.0,104.16666666666669,3,471,286582.5,331.0,157.0
22892.0,6,14,4740,7,653,3377.0,249.0,93.28571428571428,7,4087,3678.1666666666665,1514.0,583.8571428571429
2179.0,17,2,762,2,762,0.0,381.0,381.0,0,0,0.0,0.0,0.0
120126238.0,6,13,2020,9,1204,15015779.75,188.0,133.77777777777777,4,816,30033252.666666668,204.0,204.0
332.0,17,2,191,1,73,0.0,73.0,73.0,1,118,0.0,118.0,118.0
90033049.0,17,28,13364,28,13364,3334557.3703703703,501.0,477.2857142857143,0,0,0.0,0.0,0.0
313614.0,17,4,1400,4,1400,104538.0,350.0,350.0,0,0,0.0,0.0,0.0
108108942.0,17,5,1005,5,1005,27027235.5,201.0,201.0,0,0,0.0,0.0,0.0
1035499.0,6,11,1134,6,558,207099.8,220.0,93.0,5,576,256867.75,304.0,115.2
103153.0,17,2,286,2,286,0.0,143.0,143.0,0,0,0.0,0.0,0.0
2320.0,17,4,344,2,150,0.0,75.0,75.0,2,194,0.0,103.0,97.0
147964.0,17,2,180,1,90,0.0,90.0,90.0,1,90,0.0,90.0,90.0
2803605.0,6,2,132,1,66,0.0,66.0,66.0,1,66,0.0,66.0,66.0
119694492.0,6,212,23980,106,16688,1137896.8952380952,284.0,157.43396226415095,106,7292,1137897.2571428572,140.0,68.79245283018868
100179304.0,17,14,1388,7,694,16669869.666666666,174.0,99.14285714285714,7,694,16669866.0,174.0,99.14285714285714
153559.0,17,2,180,1,90,0.0,90.0,90.0,1,90,0.0,90.0,90.0
2743673.0,6,3,204,2,136,0.0,70.0,68.0,1,68,0.0,68.0,68.0
507878.00000000006,6,4,270,2,134,0.0,68.0,67.0,2,136,0.0,70.0,68.0
32122.0,6,14,4740,7,653,5187.333333333333,249.0,93.28571428571428,7,4087,4885.166666666667,1514.0,583.8571428571429
505433.0,6,5,336,2,134,0.0,68.0,67.0,3,202,192810.0,70.0,67.33333333333333
53545.0,6,14,4740,7,653,8555.833333333334,249.0,93.28571428571428,7,4087,6519.0,1514.0,583.8571428571429
209061.0,6,10,1221,6,636,41812.2,298.0,106.0,4,585,68840.0,379.0,146.25
49906.0,6,14,4740,7,653,8191.166666666667,249.0,93.28571428571428,7,4087,6822.666666666667,1514.0,583.8571428571429
7762.0,17,4,823,2,163,0.0,89.0,81.5,2,660,0.0,443.0,330.0
90044921.0,17,27,12943,27,12943,3463266.1923076925,501.0,479.3703703703704,0,0,0.0,0.0,0.0
315738.0,17,4,1400,4,1400,105246.0,350.0,350.0,0,0,0.0,0.0,0.0
2789781.0,17,2,876,2,876,0.0,438.0,438.0,0,0,0.0,0.0,0.0
26073.0,6,14,4740,7,653,3605.0,249.0,93.28571428571428,7,4087,4208.833333333333,1514.0,583.8571428571429
21622.0,17,2,582,1,83,0.0,83.0,83.0,1,499,0.0,499.0,499.0
237985.0,6,3,337,2,214,0.0,160.0,107.0,1,123,0.0,123.0,123.0
27031.0,6,10,2032,5,524,6229.5,252.0,104.8,5,1508,6054.0,1236.0,301.6
100957020.0,17,13,1214,7,694,16826170.0,174.0,99.14285714285714,6,520,16235541.4,174.0,86.66666666666667
421826.0,6,3,1604,2,851,0.0,785.0,425.5,1,753,0.0,753.0,753.0
0.0,6,1,172,1,172,0.0,172.0,172.0,0,0,0.0,0.0,0.0
38604.0,6,14,4740,7,653,5706.333333333333,249.0,93.28571428571428,7,4087,5837.0,1514.0,583.8571428571429
16907.0,17,2,180,1,90,0.0,90.0,90.0,1,90,0.0,90.0,90.0
249761.0,6,3,337,2,214,0.0,160.0,107.0,1,123,0.0,123.0,123.0
46259.0,6,14,4740,7,653,7562.333333333333,249.0,93.28571428571428,7,4087,7357.0,1514.0,583.8571428571429
829414.0,6,9,1118,6,586,165882.8,248.0,97.66666666666669,3,532,278427.0,392.0,177.33333333333334
228720.0,17,2,180,1,90,0.0,90.0,90.0,1,90,0.0,90.0,90.0
102627.0,17,2,286,2,286,0.0,143.0,143.0,0,0,0.0,0.0,0.0
34082.0,6,14,4740,7,653,5257.166666666667,249.0,93.28571428571428,7,4087,5540.666666666667,1514.0,583.8571428571429
310175.0,6,6,412,4,272,103391.66666666669,74.0,68.0,2,140,0.0,74.0,70.0
101013.0,17,2,762,2,762,0.0,381.0,381.0,0,0,0.0,0.0,0.0
120001916.0,6,17,1287,8,596,17143130.85714286,95.0,74.5,9,691,14968041.875,95.0,76.77777777777777
208030.0,6,3,426,2,280,0.0,214.0,140.0,1,146,0.0,146.0,146.0
4003.0,17,4,704,2,148,0.0,74.0,74.0,2,556,0.0,280.0,278.0
253041.00000000003,17,8,12112,8,12112,36148.71428571428,1514.0,1514.0,0,0,0.0,0.0,0.0
216649.0,6,3,426,2,280,0.0,214.0,140.0,1,146,0.0,146.0,146.0
2290.0,17,4,344,2,150,0.0,75.0,75.0,2,194,0.0,103.0,97.0
713.0,17,4,438,2,148,0.0,74.0,74.0,2,290,0.0,147.0,145.0
272016.0,6,4,439,2,238,0.0,172.0,119.0,2,201,0.0,135.0,100.5
31461.000000000004,6,14,4740,7,653,5133.5,249.0,93.28571428571428,7,4087,4851.333333333333,1514.0,583.8571428571429
196795.0,17,2,180,1,90,0.0,90.0,90.0,1,90,0.0,90.0,90.0
5830362.0,6,5,336,2,134,0.0,68.0,67.0,3,202,1526346.5,70.0,67.33333333333333
34788.0,6,14,4740,7,653,5486.666666666667,249.0,93.28571428571428,7,4087,5611.0,1514.0,583.8571428571429
0.0,6,1,172,1,172,0.0,172.0,172.0,0,0,0.0,0.0,0.0
100150455.0,17,14,864,7,432,16668068.833333334,174.0,61.71428571428572,7,432,16666808.666666666,174.0,61.71428571428572
84377.0,6,14,4740,7,653,13943.333333333334,249.0,93.28571428571428,7,4087,12421.666666666666,1514.0,583.8571428571429
100565517.0,17,12,516,6,258,20001915.2,43.0,43.0,6,258,20000183.0,43.0,43.0
108107479.0,17,5,1005,5,1005,27026869.75,201.0,201.0,0,0,0.0,0.0,0.0
81857.0,6,10,2032,5,524,19061.75,252.0,104.8,5,1508,19580.5,1236.0,301.6
13623.0,6,14,4740,7,653,2099.5,249.0,93.28571428571428,7,4087,2118.833333333333,1514.0,583.8571428571429
2053.0,17,4,344,2,150,0.0,75.0,75.0,2,194,0.0,103.0,97.0
95780661.0,17,14,4796,13,4446,6228484.916666667,342.0,342.0,1,350,0.0,350.0,350.0
2309.0,17,4,344,2,150,0.0,75.0,75.0,2,194,0.0,103.0,97.0
472481.0,6,3,204,2,136,0.0,70.0,68.0,1,68,0.0,68.0,68.0
11392954.0,17,4,1368,4,1368,3797651.3333333335,342.0,342.0,0,0,0.0,0.0,0.0
215245.0,6,10,1221,6,636,43049.0,298.0,106.0,4,585,70682.0,379.0,146.25
303241.0,6,10,1221,6,636,60648.2,298.0,106.0,4,585,95625.33333333331,379.0,146.25
306.0,17,2,174,1,79,0.0,79.0,79.0,1,95,0.0,95.0,95.0
2660073.0,6,3,1777,1,826,0.0,826.0,826.0,2,951,0.0,885.0,475.5
1186439.0,6,13,3008,8,2380,169491.2857142857,1514.0,297.5,5,628,227594.75,331.0,125.6
819.0,17,4,438,2,148,0.0,74.0,74.0,2,290,0.0,147.0,145.0
400.0,17,2,300,1,80,0.0,80.0,80.0,1,220,0.0,220.0,220.0
211492.0,17,2,614,1,72,0.0,72.0,72.0,1,542,0.0,542.0,542.0
120003931.0,6,20,1531,10,786,13333770.111111112,95.0,78.6,10,745,10003540.222222222,95.0,74.5
14644938.0,6,20,1605,10,973,1592933.2222222222,315.0,97.3,10,632,1592907.3333333333,78.0,63.2
300150.0,6,6,412,4,272,100050.0,74.0,68.0,2,140,0.0,74.0,70.0
33722.0,6,10,2032,5,524,7987.0,252.0,104.8,5,1508,8179.25,1236.0,301.6
9593.0,6,10,1067,5,536,2094.75,264.0,107.2,5,531,2118.25,259.0,106.2
263227.0,6,10,1221,6,636,52645.4,298.0,106.0,4,585,81981.66666666667,379.0,146.25
90096179.0,6,12,1848,5,1020,22523432.25,204.0,204.0,7,828,14969140.0,188.0,118.28571428571428
107465.0,17,2,286,2,286,0.0,143.0,143.0,0,0,0.0,0.0,0.0
119579568.0,6,23,1862,11,968,11957956.8,223.0,88.0,12,894,10847558.090909092,95.0,74.5
213531.0,17,2,180,1,90,0.0,90.0,90.0,1,90,0.0,90.0,90.0
90310102.0,6,17,1287,9,691,11282662.25,95.0,76.77777777777777,8,596,12901055.57142857,95.0,74.5
120279819.0,6,336,40714,168,11384,715272.3293413174,140.0,67.76190476190476,168,29330,715331.8802395209,336.0,174.58333333333334
95650667.0,17,14,4796,13,4446,6228844.333333333,342.0,342.0,1,350,0.0,350.0,350.0
49769.0,6,13,1386,7,789,7645.833333333333,253.0,112.71428571428572,6,597,8551.6,259.0,99.5
422.0,17,2,410,1,78,0.0,78.0,78.0,1,332,0.0,332.0,332.0
9491.0,17,2,582,1,83,0.0,83.0,83.0,1,499,0.0,499.0,499.0
28339.0,6,2,145,2,145,0.0,91.0,72.5,0,0,0.0,0.0,0.0
116897890.0,6,47,3102,24,1584,5069069.869565218,66.0,66.0,23,1518,5150438.727272728,66.0,66.0
71120663.0,6,9,842,9,842,8890082.875,97.0,93.55555555555556,0,0,0.0,0.0,0.0
2846700.0,6,3,204,2,136,0.0,70.0,68.0,1,68,0.0,68.0,68.0
2328.0,17,4,344,2,150,0.0,75.0,75.0,2,194,0.0,103.0,97.0
39434.0,6,14,4740,7,653,5596.166666666667,249.0,93.28571428571428,7,4087,6395.833333333333,1514.0,583.8571428571429
113734110.0,6,46,3036,23,1518,5155443.363636363,66.0,66.0,23,1518,5155451.363636363,66.0,66.0
5625712.0,6,5,336,2,134,0.0,68.0,67.0,3,202,1525061.5,70.0,67.33333333333333
115785753.0,6,67,6171,27,2700,4453281.192307692,123.0,100.0,40,3471,2968853.358974359,123.0,86.775
143888.0,17,2,180,1,90,0.0,90.0,90.0,1,90,0.0,90.0,90.0
232987.0,6,3,337,2,214,0.0,160.0,107.0,1,123,0.0,123.0,123.0
101406731.0,6,28,2008,14,963,7800517.769230769,123.0,68.78571428571429,14,1045,7014061.230769231,139.0,74.64285714285714
90006111.0,6,18,1341,10,745,10000679.0,95.0,74.5,8,596,12788165.57142857,95.0,74.5
122165.0,6,3,373,2,238,0.0,172.0,119.0,1,135,0.0,135.0,135.0
108101151.0,17,5,1005,5,1005,27025287.75,201.0,201.0,0,0,0.0,0.0,0.0
305162.0,6,6,412,4,272,101720.66666666669,74.0,68.0,2,140,0.0,74.0,70.0
9229.0,17,2,582,1,83,0.0,83.0,83.0,1,499,0.0,499.0,499.0
216751.0,6,3,426,2,280,0.0,214.0,140.0,1,146,0.0,146.0,146.0
7168.0,17,4,823,2,163,0.0,89.0,81.5,2,660,0.0,443.0,330.0
234571.0,6,3,337,2,214,0.0,160.0,107.0,1,123,0.0,123.0,123.0
103957959.0,6,34,2482,17,1288,6484507.3125,139.0,75.76470588235294,17,1194,6484568.0625,123.0,70.23529411764706
2358.0,17,4,344,2,150,0.0,75.0,75.0,2,194,0.0,103.0,97.0
216552.0,6,3,426,2,280,0.0,214.0,140.0,1,146,0.0,146.0,146.0
102068.0,17,2,286,2,286,0.0,143.0,143.0,0,0,0.0,0.0,0.0
1204.0,17,2,267,1,83,0.0,83.0,83.0,1,184,0.0,184.0,184.0
10014.0,6,10,1067,5,536,2335.5,264.0,107.2,5,531,2228.75,259.0,106.2
10521713.0,6,7,478,4,272,3460413.333333333,74.0,68.0,3,206,5190508.5,74.0,68.66666666666667
120123292.0,6,470,57960,235,15732,509821.8076923077,140.0,66.94468085106384,235,42228,509841.3931623932,374.0,179.6936170212766
22521.0,6,10,2032,5,524,4823.5,252.0,104.8,5,1508,5342.25,1236.0,301.6
4756.0,17,4,344,2,150,0.0,75.0,75.0,2,194,0.0,103.0,97.0
108110465.0,17,5,955,5,955,27027616.25,191.0,191.0,0,0,0.0,0.0,0.0
120030066.0,6,18,1341,9,691,14998293.125,95.0,76.77777777777777,9,650,14997637.375,95.0,72.22222222222223
90257783.0,6,13,2036,8,1016,12893969.0,188.0,127.0,5,1020,22523538.75,204.0,204.0
153516.0,17,2,180,1,90,0.0,90.0,90.0,1,90,0.0,90.0,90.0
0.0,6,1,66,0,0,0.0,0.0,0.0,1,66,0.0,66.0,66.0
15753.0,6,10,2032,5,524,3446.75,252.0,104.8,5,1508,3781.25,1236.0,301.6
2030.0,17,4,344,2,150,0.0,75.0,75.0,2,194,0.0,103.0,97.0
44092.0,6,14,4740,7,653,7162.666666666667,249.0,93.28571428571428,7,4087,6962.5,1514.0,583.8571428571429
232544.0,6,3,337,2,214,0.0,160.0,107.0,1,123,0.0,123.0,123.0
12119.0,17,4,823,2,163,0.0,89.0,81.5,2,660,0.0,443.0,330.0
106752918.0,6,360,45384,180,33282,595183.1173184358,480.0,184.9,180,12102,595183.3072625698,140.0,67.23333333333333
19337.0,6,14,4740,7,653,2836.0,249.0,93.28571428571428,7,4087,2565.833333333333,1514.0,583.8571428571429
233018.0,6,3,337,2,214,0.0,160.0,107.0,1,123,0.0,123.0,123.0
135130009.0,17,6,1146,6,1146,27026001.8,191.0,191.0,0,0,0.0,0.0,0.0
216649.0,6,3,426,2,280,0.0,214.0,140.0,1,146,0.0,146.0,146.0
147128.0,6,3,373,2,238,0.0,172.0,119.0,1,135,0.0,135.0,135.0
13142.0,6,10,1065,5,534,2493.0,262.0,106.8,5,531,2932.0,259.0,106.2
146171.0,6,3,337,2,214,0.0,160.0,107.0,1,123,0.0,123.0,123.0
47609190.0,6,8,2113,3,960,22347568.0,826.0,320.0,5,1153,11259031.0,885.0,230.6
20380.0,6,14,4740,7,653,3222.5,249.0,93.28571428571428,7,4087,3075.833333333333,1514.0,583.8571428571429
0.0,17,1,438,1,438,0.0,438.0,438.0,0,0,0.0,0.0,0.0
120175045.0,6,487,58954,244,16326,494547.5102880658,140.0,66.90983606557377,243,42628,492285.1570247934,336.0,175.4238683127572
121380.0,6,3,337,2,214,0.0,160.0,107.0,1,123,0.0,123.0,123.0
38680.0,6,10,2032,5,524,9362.5,252.0,104.8,5,1508,8826.75,1236.0,301.6
103710730.0,17,14,1126,7,563,17285121.666666668,174.0,80.42857142857143,7,563,17235623.5,174.0,80.42857142857143
48699.0,6,14,4740,7,653,7692.333333333333,249.0,93.28571428571428,7,4087,7873.333333333333,1514.0,583.8571428571429
149339.0,17,2,414,1,88,0.0,88.0,88.0,1,326,0.0,326.0,326.0
51751.0,6,14,4740,7,653,7542.666666666667,249.0,93.28571428571428,7,4087,7540.166666666667,1514.0,583.8571428571429
16830.0,17,2,180,1,90,0.0,90.0,90.0,1,90,0.0,90.0,90.0
208679.0,6,3,426,2,280,0.0,214.0,140.0,1,146,0.0,146.0,146.0
251062.0,17,4,6056,4,6056,83687.33333333333,1514.0,1514.0,0,0,0.0,0.0,0.0
894312.0,6,5,1742,3,921,447156.0,785.0,307.0,2,821,0.0,753.0,410.5
232906.0,6,3,373,2,238,0.0,172.0,119.0,1,135,0.0,135.0,135.0
32138.0,6,14,4740,7,653,5105.0,249.0,93.28571428571428,7,4087,2861.6666666666665,1514.0,583.8571428571429
209413.0,17,2,180,1,90,0.0,90.0,90.0,1,90,0.0,90.0,90.0
25120.0,6,13,1386,7,789,3718.6666666666665,253.0,112.71428571428572,6,597,4132.8,259.0,99.5
109503575.0,17,16,1212,8,606,15620496.57142857,174.0,75.75,8,606,15478222.142857144,174.0,75.75
31066.0,6,10,2032,5,524,6873.75,252.0,104.8,5,1508,6912.0,1236.0,301.6
211316.0,6,10,1221,6,636,42263.2,298.0,106.0,4,585,69103.33333333333,379.0,146.25
319973.0,17,4,1400,4,1400,106657.66666666669,350.0,350.0,0,0,0.0,0.0,0.0
135140573.0,17,6,1146,6,1146,27028114.6,191.0,191.0,0,0,0.0,0.0,0.0
2319.0,17,4,344,2,150,0.0,75.0,75.0,2,194,0.0,103.0,97.0
35578.0,6,10,2032,5,524,8671.25,252.0,104.8,5,1508,8425.5,1236.0,301.6
281442.0,17,2,363,1,79,0.0,79.0,79.0,1,284,0.0,284.0,284.0
108117032.0,17,5,955,5,955,27029258.0,191.0,191.0,0,0,0.0,0.0,0.0
147905.0,17,2,180,1,90,0.0,90.0,90.0,1,90,0.0,90.0,90.0
135126639.0,17,6,1146,6,1146,27025327.8,191.0,191.0,0,0,0.0,0.0,0.0
297248.0,6,6,412,4,272,99082.66666666669,74.0,68.0,2,140,0.0,74.0,70.0
123840089.0,6,49,3234,25,1650,5160003.708333333,66.0,66.0,24,1584,5101939.347826087,66.0,66.0
240951.0,6,3,337,2,214,0.0,160.0,107.0,1,123,0.0,123.0,123.0
925408.0,6,13,1420,7,789,153592.5,253.0,112.71428571428572,6,631,184862.8,293.0,105.16666666666669
2021.0,17,4,344,2,150,0.0,75.0,75.0,2,194,0.0,103.0,97.0
110927518.0,6,189,21270,95,6566,1179861.0531914893,140.0,69.11578947368422,94,14704,1183889.258064516,284.0,156.4255319148936
2056.0,17,4,344,2,150,0.0,75.0,75.0,2,194,0.0,103.0,97.0
108108975.0,17,5,955,5,955,27027243.75,191.0,191.0,0,0,0.0,0.0,0.0
42593.0,6,10,2032,5,524,10425.25,252.0,104.8,5,1508,10338.5,1236.0,301.6
2590302.0,6,2,132,1,66,0.0,66.0,66.0,1,66,0.0,66.0,66.0
108093987.0,17,5,955,5,955,27023496.75,191.0,191.0,0,0,0.0,0.0,0.0
309734.0,6,6,412,4,272,103244.66666666669,74.0,68.0,2,140,0.0,74.0,70.0
147380.0,6,3,373,2,238,0.0,172.0,119.0,1,135,0.0,135.0,135.0
14407.0,17,2,762,2,762,0.0,381.0,381.0,0,0,0.0,0.0,0.0
45009.0,6,10,2032,5,524,9389.0,252.0,104.8,5,1508,9398.75,1236.0,301.6
503395.00000000006,6,3,1604,2,851,0.0,785.0,425.5,1,753,0.0,753.0,753.0
115761246.0,6,47,3102,24,1584,5019433.608695652,66.0,66.0,23,1518,5155448.7727272725,66.0,66.0
222682.0,6,4,504,3,358,111341.0,214.0,119.33333333333331,1,146,0.0,146.0,146.0
33001.0,6,14,4740,7,653,5316.166666666667,249.0,93.28571428571428,7,4087,5361.0,1514.0,583.8571428571429
39046.0,6,2,132,1,66,0.0,66.0,66.0,1,66,0.0,66.0,66.0
382594.0,6,10,1221,6,636,76518.8,298.0,106.0,4,585,126163.33333333331,379.0,146.25
43582.0,6,14,4740,7,653,6175.333333333333,249.0,93.28571428571428,7,4087,5934.833333333333,1514.0,583.8571428571429
2007501.0,6,25,7610,13,2516,167291.75,1034.0,193.53846153846155,12,5094,155329.18181818182,1510.0,424.5
120397546.0,6,231,26112,116,18226,1046935.1826086956,374.0,157.1206896551724,115,7886,1037752.5087719298,140.0,68.57391304347826
2451852.0,6,25,7573,14,3735,188604.0,1514.0,266.7857142857143,11,3838,219989.2,1514.0,348.90909090909093
38093.0,6,14,4740,7,653,5866.0,249.0,93.28571428571428,7,4087,6083.5,1514.0,583.8571428571429
4569.0,17,2,614,1,72,0.0,72.0,72.0,1,542,0.0,542.0,542.0
30576.0,6,10,2032,5,524,6918.25,252.0,104.8,5,1508,5342.5,1236.0,301.6
120062674.0,6,286,33920,143,9734,840452.2394366197,140.0,68.06993006993007,143,24186,839634.1197183098,284.0,169.13286713286712
99723.0,17,2,762,2,762,0.0,381.0,381.0,0,0,0.0,0.0,0.0
219573.0,6,3,426,2,280,0.0,214.0,140.0,1,146,0.0,146.0,146.0
104765160.0,17,13,952,7,563,17460860.0,174.0,80.42857142857143,6,389,19972227.0,174.0,64.83333333333333
90308474.0,6,14,1043,7,542,15051412.333333334,95.0,77.42857142857143,7,501,15000980.166666666,95.0,71.57142857142857
27748.0,6,10,2032,5,524,6722.25,252.0,104.8,5,1508,6646.75,1236.0,301.6
14689.0,6,13,1459,7,862,2448.1666666666665,271.0,123.14285714285714,6,597,2343.8,259.0,99.5
959704.0,6,12,1354,6,723,190127.8,253.0,120.5,6,631,190819.6,293.0,105.16666666666669
29204.0,6,14,4740,7,653,4747.166666666667,249.0,93.28571428571428,7,4087,4640.5,1514.0,583.8571428571429
117123962.0,6,48,3168,24,1584,5092346.173913044,66.0,66.0,24,1584,5078914.739130435,66.0,66.0
114642457.0,6,30,1974,15,1026,8173306.428571428,123.0,68.4,15,948,8173310.071428572,123.0,63.2
35680.0,6,14,4740,7,653,5823.166666666667,249.0,93.28571428571428,7,4087,5808.333333333333,1514.0,583.8571428571429
27953.0,6,14,4740,7,653,4536.833333333333,249.0,93.28571428571428,7,4087,4304.666666666667,1514.0,583.8571428571429
325.0,17,2,160,1,80,0.0,80.0,80.0,1,80,0.0,80.0,80.0
28389.0,6,14,4740,7,653,4548.5,249.0,93.28571428571428,7,4087,4537.5,1514.0,583.8571428571429
215963.0,6,10,1221,6,636,43192.6,298.0,106.0,4,585,70949.0,379.0,146.25
228512.0,17,2,180,1,90,0.0,90.0,90.0,1,90,0.0,90.0,90.0
33320.0,6,14,4740,7,653,5432.833333333333,249.0,93.28571428571428,7,4087,4541.666666666667,1514.0,583.8571428571429
398.0,17,2,410,1,78,0.0,78.0,78.0,1,332,0.0,332.0,332.0
834361.0,6,9,1118,6,586,166872.2,248.0,97.66666666666669,3,532,280898.5,392.0,177.33333333333334
854966.0,6,9,1096,6,625,170993.2,287.0,104.16666666666669,3,471,289582.0,331.0,157.0
397.0,17,2,762,2,762,0.0,381.0,381.0,0,0,0.0,0.0,0.0
872.0,17,4,820,2,156,0.0,78.0,78.0,2,664,0.0,332.0,332.0
108107563.0,17,5,955,5,955,27026890.75,191.0,191.0,0,0,0.0,0.0,0.0
9739.0,17,2,582,1,83,0.0,83.0,83.0,1,499,0.0,499.0,499.0
46788335.0,6,8,1940,3,887,22410113.0,753.0,295.6666666666667,5,1053,11003163.25,785.0,210.6
32414562.0,6,27,8493,15,1839,2315325.8571428573,408.0,122.6,12,6654,2635667.636363636,1514.0,554.5
214800.0,17,2,180,1,90,0.0,90.0,90.0,1,90,0.0,90.0,90.0
90253110.0,6,12,1832,8,1016,12893301.42857143,188.0,127.0,4,816,30028859.0,204.0,204.0
108929.0,17,2,700,2,700,0.0,350.0,350.0,0,0,0.0,0.0,0.0
313993.0,6,6,412,4,272,104664.33333333331,74.0,68.0,2,140,0.0,74.0,70.0
283887.0,17,2,363,1,79,0.0,79.0,79.0,1,284,0.0,284.0,284.0
45074.0,6,10,2032,5,524,9658.0,252.0,104.8,5,1508,10701.0,1236.0,301.6
2029.0,17,4,344,2,150,0.0,75.0,75.0,2,194,0.0,103.0,97.0
8137.999999999999,17,2,684,2,684,0.0,342.0,342.0,0,0,0.0,0.0,0.0
387.0,17,2,152,1,76,0.0,76.0,76.0,1,76,0.0,76.0,76.0
319642.0,6,6,412,4,272,106547.33333333331,74.0,68.0,2,140,0.0,74.0,70.0
551081.0,6,14,4740,7,653,91126.16666666669,249.0,93.28571428571428,7,4087,90643.33333333331,1514.0,583.8571428571429
297994.0,6,6,412,4,272,99331.33333333331,74.0,68.0,2,140,0.0,74.0,70.0
238010.0,17,2,180,1,90,0.0,90.0,90.0,1,90,0.0,90.0,90.0
107705.0,17,2,286,2,286,0.0,143.0,143.0,0,0,0.0,0.0,0.0
90296951.0,6,16,1192,8,596,12893530.142857144,95.0,74.5,8,596,12898469.142857144,95.0,74.5
218794.0,6,3,426,2,280,0.0,214.0,140.0,1,146,0.0,146.0,146.0
147320.0,6,3,373,2,238,0.0,172.0,119.0,1,135,0.0,135.0,135.0
4438.0,17,2,180,1,90,0.0,90.0,90.0,1,90,0.0,90.0,90.0
2798119.0,6,2,132,1,66,0.0,66.0,66.0,1,66,0.0,66.0,66.0
90023282.0,17,28,13364,28,13364,3334195.6296296297,501.0,477.2857142857143,0,0,0.0,0.0,0.0
59537.0,6,14,4740,7,653,9095.833333333334,249.0,93.28571428571428,7,4087,9465.666666666666,1514.0,583.8571428571429
31657.0,6,14,4740,7,653,4860.0,249.0,93.28571428571428,7,4087,4845.833333333333,1514.0,583.8571428571429
45045736.0,17,9,3086,8,2736,5107871.0,342.0,342.0,1,350,0.0,350.0,350.0
301467.0,6,6,412,4,272,100489.0,74.0,68.0,2,140,0.0,74.0,70.0
4297.0,17,2,626,1,72,0.0,72.0,72.0,1,554,0.0,554.0,554.0
7854.0,17,4,344,2,150,0.0,75.0,75.0,2,194,0.0,103.0,97.0
238117.0,6,3,373,2,238,0.0,172.0,119.0,1,135,0.0,135.0,135.0
210901.0,6,3,426,2,280,0.0,214.0,140.0,1,146,0.0,146.0,146.0
2389.0,17,4,344,2,150,0.0,75.0,75.0,2,194,0.0,103.0,97.0
284656.0,17,2,363,1,79,0.0,79.0,79.0,1,284,0.0,284.0,284.0
2585.0,17,4,344,2,150,0.0,75.0,75.0,2,194,0.0,103.0,97.0
451.0,17,2,508,2,508,0.0,257.0,254.0,0,0,0.0,0.0,0.0
298.0,17,2,168,1,76,0.0,76.0,76.0,1,92,0.0,92.0,92.0
100632452.0,6,62,5635,25,2454,4192998.875,123.0,98.16,37,3181,2795277.611111111,139.0,85.97297297297297
146623.0,6,3,337,2,214,0.0,160.0,107.0,1,123,0.0,123.0,123.0
216819.0,6,3,426,2,280,0.0,214.0,140.0,1,146,0.0,146.0,146.0
120000019.0,6,24,1870,14,1084,9230770.692307692,95.0,77.42857142857143,10,786,10030510.777777778,95.0,78.6
98361.0,17,2,762,2,762,0.0,381.0,381.0,0,0,0.0,0.0,0.0
8252931.999999999,17,3,1034,2,684,0.0,342.0,342.0,1,350,0.0,350.0,350.0
53325.0,6,10,2032,5,524,13003.5,252.0,104.8,5,1508,13024.25,1236.0,301.6
1033251.0,6,11,1134,6,558,206650.2,220.0,93.0,5,576,255177.0,304.0,115.2
312694.0,17,4,1400,4,1400,104231.33333333331,350.0,350.0,0,0,0.0,0.0,0.0
110861128.0,6,44,2904,22,1452,5279101.333333333,66.0,66.0,22,1452,5264127.285714285,66.0,66.0
10431638.0,6,6,412,3,206,5147091.0,74.0,68.66666666666667,3,206,5147007.5,74.0,68.66666666666667
54467.0,6,14,4740,7,653,8304.5,249.0,93.28571428571428,7,4087,8544.5,1514.0,583.8571428571429
63329.0,6,10,2032,5,524,14904.0,252.0,104.8,5,1508,14217.0,1236.0,301.6
103696.0,17,2,286,2,286,0.0,143.0,143.0,0,0,0.0,0.0,0.0
120101852.0,6,216,24530,108,7424,1096659.0373831776,140.0,68.74074074074075,108,17106,1114762.9906542057,374.0,158.38888888888889
2376.0,17,4,344,2,150,0.0,75.0,75.0,2,194,0.0,103.0,97.0
241932.0,6,3,337,2,214,0.0,160.0,107.0,1,123,0.0,123.0,123.0
22925.0,6,11,1133,6,602,4298.2,264.0,100.33333333333331,5,531,4565.0,259.0,106.2
135069.0,6,2,132,1,66,0.0,66.0,66.0,1,66,0.0,66.0,66.0
805.0,17,4,438,2,148,0.0,74.0,74.0,2,290,0.0,147.0,145.0
103265.0,17,2,762,2,762,0.0,381.0,381.0,0,0,0.0,0.0,0.0
0.0,17,1,44,1,44,0.0,44.0,44.0,0,0,0.0,0.0,0.0
5010361.0,17,4,629,2,156,0.0,78.0,78.0,2,473,0.0,268.0,236.5
50563.0,6,14,4740,7,653,8175.833333333333,249.0,93.28571428571428,7,4087,7281.666666666667,1514.0,583.8571428571429
113733947.0,6,46,3036,23,1518,5155439.7727272725,66.0,66.0,23,1518,5155447.136363637,66.0,66.0
90090449.0,6,12,1848,5,1020,22522034.0,204.0,204.0,7,828,14970198.0,188.0,118.28571428571428
147183.0,6,3,337,2,214,0.0,160.0,107.0,1,123,0.0,123.0,123.0
120966.0,6,14,4740,7,653,20003.666666666668,249.0,93.28571428571428,7,4087,18964.0,1514.0,583.8571428571429
60117.0,6,14,4740,7,653,9797.166666666666,249.0,93.28571428571428,7,4087,9812.666666666666,1514.0,583.8571428571429
300598.0,6,3,202,2,128,0.0,74.0,64.0,1,74,0.0,74.0,74.0
107093794.0,6,43,2838,22,1452,5099691.904761905,66.0,66.0,21,1386,5160023.5,66.0,66.0
4546.0,17,2,602,1,72,0.0,72.0,72.0,1,530,0.0,530.0,530.0
111006438.0,6,754,104244,377,25104,295087.1117021277,140.0,66.58885941644563,377,79140,293032.1489361702,554.0,209.92042440318303
2898690.0,6,3,1604,1,753,0.0,753.0,753.0,2,851,0.0,785.0,425.5
41046.0,6,14,4740,7,653,6598.0,249.0,93.28571428571428,7,4087,6123.333333333333,1514.0,583.8571428571429
217490.0,6,3,426,2,280,0.0,214.0,140.0,1,146,0.0,146.0,146.0
44749.0,6,14,4740,7,653,6533.5,249.0,93.28571428571428,7,4087,6839.333333333333,1514.0,583.8571428571429
211261.0,17,2,180,1,90,0.0,90.0,90.0,1,90,0.0,90.0,90.0
95196919.0,17,14,1126,7,563,15835170.666666666,174.0,80.42857142857143,7,563,15833471.0,174.0,80.42857142857143
233498.0,6,3,337,2,214,0.0,160.0,107.0,1,123,0.0,123.0,123.0
104080775.0,6,44,2904,22,1452,4956227.380952381,66.0,66.0,22,1452,4941251.857142857,66.0,66.0
297168.0,17,2,614,1,72,0.0,72.0,72.0,1,542,0.0,542.0,542.0
49681328.0,6,8,2113,3,960,23512557.5,826.0,320.0,5,1153,11725005.25,885.0,230.6
212143.0,6,10,1221,6,636,42428.6,298.0,106.0,4,585,69079.33333333333,379.0,146.25
92379583.0,17,16,5472,16,5472,6158638.866666666,342.0,342.0,0,0,0.0,0.0,0.0
1309083.0,17,7,490,7,490,218180.5,70.0,70.0,0,0,0.0,0.0,0.0
5621129.0,6,4,270,2,134,0.0,68.0,67.0,2,136,0.0,70.0,68.0
7462.0,17,2,614,1,72,0.0,72.0,72.0,1,542,0.0,542.0,542.0
108178125.0,6,32,2384,16,1244,7211875.0,139.0,77.75,16,1140,7197420.0,123.0,71.25
90032702.0,17,28,13364,28,13364,3334544.5185185187,501.0,477.2857142857143,0,0,0.0,0.0,0.0
29444.0,6,14,4740,7,653,4784.333333333333,249.0,93.28571428571428,7,4087,4718.833333333333,1514.0,583.8571428571429
239546.0,6,3,337,2,214,0.0,160.0,107.0,1,123,0.0,123.0,123.0
18911.0,6,14,4740,7,653,3043.0,249.0,93.28571428571428,7,4087,2324.5,1514.0,583.8571428571429
47594.0,6,14,4740,7,653,7800.166666666667,249.0,93.28571428571428,7,4087,7603.833333333333,1514.0,583.8571428571429
1691483.0,6,23,6509,12,1529,153771.18181818182,357.0,127.41666666666669,11,4980,138122.2,1510.0,452.7272727272728
123839654.0,6,48,3168,24,1584,5113924.869565218,66.0,66.0,24,1584,5183503.130434782,66.0,66.0
299363.0,6,6,412,4,272,99787.66666666669,74.0,68.0,2,140,0.0,74.0,70.0
196759.0,17,2,180,1,90,0.0,90.0,90.0,1,90,0.0,90.0,90.0
123416338.0,6,48,3168,24,1584,5118619.434782608,66.0,66.0,24,1584,5182945.260869565,66.0,66.0
49157.0,6,14,4740,7,653,7630.666666666667,249.0,93.28571428571428,7,4087,6207.833333333333,1514.0,583.8571428571429
26300.0,6,14,4740,7,653,3710.8333333333335,249.0,93.28571428571428,7,4087,4244.666666666667,1514.0,583.8571428571429
1302520.0,6,4,264,2,132,0.0,66.0,66.0,2,132,0.0,66.0,66.0
59397.0,6,14,4740,7,653,8001.166666666667,249.0,93.28571428571428,7,4087,8995.333333333334,1514.0,583.8571428571429
2801464.0,6,2,132,1,66,0.0,66.0,66.0,1,66,0.0,66.0,66.0
228225.0,17,2,180,1,90,0.0,90.0,90.0,1,90,0.0,90.0,90.0
90042048.0,17,28,13364,28,13364,3334890.6666666665,501.0,477.2857142857143,0,0,0.0,0.0,0.0
90205251.0,6,16,1192,8,596,12852360.0,95.0,74.5,8,596,12857096.42857143,95.0,74.5
42097.0,6,14,4740,7,653,6896.833333333333,249.0,93.28571428571428,7,4087,6874.833333333333,1514.0,583.8571428571429
9220.0,17,2,539,1,86,0.0,86.0,86.0,1,453,0.0,453.0,453.0
2913.0,17,4,344,2,150,0.0,75.0,75.0,2,194,0.0,103.0,97.0
228244.0,17,2,180,1,90,0.0,90.0,90.0,1,90,0.0,90.0,90.0
298242.0,6,6,412,4,272,99414.0,74.0,68.0,2,140,0.0,74.0,70.0
2575614.0,6,2,132,1,66,0.0,66.0,66.0,1,66,0.0,66.0,66.0
108711451.0,6,34,2482,17,1288,6780950.125,139.0,75.76470588235294,17,1194,6780679.625,123.0,70.23529411764706
0.0,17,1,381,1,381,0.0,381.0,381.0,0,0,0.0,0.0,0.0
327.0,17,2,164,1,82,0.0,82.0,82.0,1,82,0.0,82.0,82.0
120112604.0,6,15,2164,9,1204,14993994.75,188.0,133.77777777777777,6,960,18017787.6,204.0,160.0
210904.0,6,10,1221,6,636,42180.8,298.0,106.0,4,585,69440.66666666667,379.0,146.25
10435353.0,6,7,478,4,272,3432623.333333333,74.0,68.0,3,206,5148838.5,74.0,68.66666666666667
108103236.0,17,5,1005,5,1005,27025809.0,201.0,201.0,0,0,0.0,0.0,0.0
19132.0,17,2,582,1,83,0.0,83.0,83.0,1,499,0.0,499.0,499.0
27998.0,6,14,4740,7,653,4114.333333333333,249.0,93.28571428571428,7,4087,4227.333333333333,1514.0,583.8571428571429
55652.0,6,14,4740,7,653,8707.666666666666,249.0,93.28571428571428,7,4087,8937.166666666666,1514.0,583.8571428571429
19858.0,6,10,2032,5,524,4732.0,252.0,104.8,5,1508,4739.0,1236.0,301.6
307408.0,6,6,412,4,272,102469.33333333331,74.0,68.0,2,140,0.0,74.0,70.0
209468.0,17,2,180,1,90,0.0,90.0,90.0,1,90,0.0,90.0,90.0
105474.0,17,2,286,2,286,0.0,143.0,143.0,0,0,0.0,0.0,0.0
114804430.0,6,48,3168,24,1584,4991496.956521739,66.0,66.0,24,1584,4979519.782608695,66.0,66.0
37942796.0,17,9,3078,9,3078,4742849.5,342.0,342.0,0,0,0.0,0.0,0.0
2342.0,17,4,344,2,150,0.0,75.0,75.0,2,194,0.0,103.0,97.0
305973.0,6,6,412,4,272,101991.0,74.0,68.0,2,140,0.0,74.0,70.0
98844230.0,6,30,2122,15,1105,7060302.142857143,139.0,73.66666666666667,15,1017,7044849.714285715,123.0,67.8
58854.0,6,14,4740,7,653,9534.0,249.0,93.28571428571428,7,4087,8573.0,1514.0,583.8571428571429
10490882.0,6,6,412,3,206,5176990.0,74.0,68.66666666666667,3,206,5176861.5,74.0,68.66666666666667
35335.0,6,14,4740,7,653,5521.5,249.0,93.28571428571428,7,4087,3766.5,1514.0,583.8571428571429
108110817.0,17,5,1005,5,1005,27027704.25,201.0,201.0,0,0,0.0,0.0,0.0
90289736.0,6,17,1287,9,691,11280633.75,95.0,76.77777777777777,8,596,12767757.857142856,95.0,74.5
212221.0,6,10,1221,6,636,42444.2,298.0,106.0,4,585,69878.0,379.0,146.25
298795.0,6,6,412,4,272,99598.33333333331,74.0,68.0,2,140,0.0,74.0,70.0
47222.0,6,10,2032,5,524,10717.0,252.0,104.8,5,1508,11025.5,1236.0,301.6
306101.0,6,6,412,4,272,102033.66666666669,74.0,68.0,2,140,0.0,74.0,70.0
153410.0,17,2,180,1,90,0.0,90.0,90.0,1,90,0.0,90.0,90.0
362.0,17,2,267,1,83,0.0,83.0,83.0,1,184,0.0,184.0,184.0
284854.0,17,2,363,1,79,0.0,79.0,79.0,1,284,0.0,284.0,284.0
293758.0,17,4,1524,4,1524,97919.33333333331,381.0,381.0,0,0,0.0,0.0,0.0
120140511.0,6,218,24646,109,7490,1104700.8148148148,140.0,68.71559633027523,109,17156,1104932.0185185184,284.0,157.39449541284404
52380.0,6,14,4740,7,653,8603.166666666666,249.0,93.28571428571428,7,4087,8195.666666666666,1514.0,583.8571428571429
10762.0,6,10,1065,5,534,2349.75,262.0,106.8,5,531,2472.5,259.0,106.2
135130286.0,17,6,1146,6,1146,27026057.2,191.0,191.0,0,0,0.0,0.0,0.0
109198432.0,6,38,2964,20,1578,5747285.894736842,123.0,78.9,18,1386,6410715.823529412,123.0,77.0
218024.0,6,10,1221,6,636,43604.8,298.0,106.0,4,585,71522.0,379.0,146.25
106816.0,17,2,700,2,700,0.0,350.0,350.0,0,0,0.0,0.0,0.0
103218.0,17,2,286,2,286,0.0,143.0,143.0,0,0,0.0,0.0,0.0
2574600.0,6,2,132,1,66,0.0,66.0,66.0,1,66,0.0,66.0,66.0
2806788.0,6,2,132,1,66,0.0,66.0,66.0,1,66,0.0,66.0,66.0
834370.0,6,10,1065,5,534,208404.75,262.0,106.8,5,531,208380.25,259.0,106.2
153460.0,17,2,180,1,90,0.0,90.0,90.0,1,90,0.0,90.0,90.0
0.0,17,1,55,1,55,0.0,55.0,55.0,0,0,0.0,0.0,0.0
10464556.0,6,7,478,4,272,3442868.6666666665,74.0,68.0,3,206,5164017.0,74.0,68.66666666666667
100765519.0,17,11,604,6,389,20153103.8,174.0,64.83333333333333,5,215,20000937.25,43.0,43.0
3078957.0,6,4,270,2,134,0.0,68.0,67.0,2,136,0.0,70.0,68.0
305238.0,6,6,412,4,272,101746.0,74.0,68.0,2,140,0.0,74.0,70.0
118697614.0,6,293,34058,147,9998,812997.3561643836,140.0,68.01360544217687,146,24060,816209.9034482759,284.0,164.7945205479452
3133711.0,6,3,204,2,136,0.0,70.0,68.0,1,68,0.0,68.0,68.0
120014926.0,17,29,13785,29,13785,4286247.357142857,501.0,475.3448275862069,0,0,0.0,0.0,0.0
15369.0,6,12,1393,6,796,2895.4,271.0,132.66666666666666,6,597,2821.6,259.0,99.5
165778.0,17,2,414,1,88,0.0,88.0,88.0,1,326,0.0,326.0,326.0
2559754.0,6,3,1604,1,753,0.0,753.0,753.0,2,851,0.0,785.0,425.5
121673491.0,17,14,864,7,432,17000933.666666668,174.0,61.71428571428572,7,432,17000184.0,174.0,61.71428571428572
22778.0,6,10,2032,5,524,5321.0,252.0,104.8,5,1508,4604.25,1236.0,301.6
120094104.0,6,230,25994,115,7812,1046300.649122807,140.0,67.9304347826087,115,18182,1047390.2192982456,284.0,158.10434782608695
10491327.0,6,7,478,4,272,3451490.0,74.0,68.0,3,206,5177128.0,74.0,68.66666666666667
153447.0,17,2,180,1,90,0.0,90.0,90.0,1,90,0.0,90.0,90.0
1813412.0,6,11,3185,5,441,451968.25,169.0,88.2,6,2744,362453.8,1236.0,457.3333333333333
5004499.0,17,4,849,2,166,0.0,83.0,83.0,2,683,0.0,499.0,341.5
10500867.0,6,7,478,4,272,3453234.6666666665,74.0,68.0,3,206,5179691.5,74.0,68.66666666666667
113703131.0,6,48,3168,24,1584,4943614.391304348,66.0,66.0,24,1584,4931636.043478261,66.0,66.0
2351.0,17,4,344,2,150,0.0,75.0,75.0,2,194,0.0,103.0,97.0
632992.0,6,11,1131,6,600,126542.2,262.0,100.0,5,531,157925.0,259.0,106.2
2308.0,17,4,344,2,150,0.0,75.0,75.0,2,194,0.0,103.0,97.0
108105932.0,17,5,1005,5,1005,27026483.0,201.0,201.0,0,0,0.0,0.0,0.0
3561366.0,6,5,336,2,134,0.0,68.0,67.0,3,202,1424418.5,70.0,67.33333333333333
16016708.000000002,17,2,684,2,684,0.0,342.0,342.0,0,0,0.0,0.0,0.0
113252229.0,6,46,3036,23,1518,5135443.863636363,66.0,66.0,23,1518,5135451.636363637,66.0,66.0
105563914.0,17,14,1126,7,563,17593985.666666668,174.0,80.42857142857143,7,563,17519161.833333332,174.0,80.42857142857143
81.0,17,2,762,2,762,0.0,381.0,381.0,0,0,0.0,0.0,0.0
840786.0,6,9,1118,6,586,168157.2,248.0,97.66666666666669,3,532,282530.0,392.0,177.33333333333334
113536058.0,6,31,2166,16,1149,7555381.4,123.0,71.8125,15,1017,8095095.071428572,123.0,67.8
222878.0,6,13,1386,7,789,37146.333333333336,253.0,112.71428571428572,6,597,43336.8,259.0,99.5
90295375.0,6,16,1192,8,596,12892541.285714284,95.0,74.5,8,596,12898737.142857144,95.0,74.5
6791.0,17,4,823,2,163,0.0,89.0,81.5,2,660,0.0,443.0,330.0
306659.0,6,3,202,2,128,0.0,74.0,64.0,1,74,0.0,74.0,74.0
104153451.0,6,43,3676,25,2083,4330737.666666667,139.0,83.32,18,1593,6113746.764705882,123.0,88.5
96650.0,17,2,762,2,762,0.0,381.0,381.0,0,0,0.0,0.0,0.0
108105673.0,17,5,1005,5,1005,27026418.25,201.0,201.0,0,0,0.0,0.0,0.0
103287461.0,6,63,10320,32,5193,3327478.290322581,1514.0,162.28125,31,5127,3435716.566666667,1514.0,165.38709677419354
1303560.0,6,4,264,2,132,0.0,66.0,66.0,2,132,0.0,66.0,66.0
108699744.0,6,34,2466,17,1272,6780238.9375,123.0,74.82352941176471,17,1194,6780243.5,123.0,70.23529411764706
646751.0,6,10,1221,6,636,129350.2,298.0,106.0,4,585,214736.3333333333,379.0,146.25
120203265.0,6,39,2886,20,1515,6315109.0,123.0,75.75,19,1371,6665953.388888889,123.0,72.15789473684211
118001294.0,17,15,1169,8,606,16857327.714285713,174.0,75.75,7,563,16334256.666666666,174.0,80.42857142857143
2368.0,17,4,344,2,150,0.0,75.0,75.0,2,194,0.0,103.0,97.0
106919.0,17,2,286,2,286,0.0,143.0,143.0,0,0,0.0,0.0,0.0
308014.0,6,6,412,4,272,102671.33333333331,74.0,68.0,2,140,0.0,74.0,70.0
120053607.0,17,28,13364,28,13364,4446429.888888889,501.0,477.2857142857143,0,0,0.0,0.0,0.0
10902174.0,6,8,544,4,272,3587237.6666666665,74.0,68.0,4,272,3587155.333333333,74.0,68.0
120219708.0,6,230,25978,115,7886,1047312.5175438595,140.0,68.57391304347826,115,18092,1047400.298245614,284.0,157.3217391304348
2631.0,17,2,762,2,762,0.0,381.0,381.0,0,0,0.0,0.0,0.0
119648715.0,6,258,29154,129,20418,933074.875,284.0,158.27906976744185,129,8736,933074.8125,140.0,67.72093023255815
319.0,17,2,174,1,79,0.0,79.0,79.0,1,95,0.0,95.0,95.0
53913.0,6,14,4740,7,653,8614.666666666666,249.0,93.28571428571428,7,4087,8847.333333333334,1514.0,583.8571428571429
105086.0,17,2,700,2,700,0.0,350.0,350.0,0,0,0.0,0.0,0.0
1637227.0,6,7,499,4,301,491917.0,103.0,75.25,3,198,716089.5,66.0,66.0
40335.0,6,10,2032,5,524,9837.25,252.0,104.8,5,1508,7936.75,1236.0,301.6
92999.0,6,12,1328,7,797,15499.833333333334,253.0,113.85714285714286,5,531,17826.0,259.0,106.2
367554.0,6,3,202,2,128,0.0,74.0,64.0,1,74,0.0,74.0,74.0
1969.0,17,4,344,2,150,0.0,75.0,75.0,2,194,0.0,103.0,97.0
108491774.0,6,754,150326,379,125058,287015.2751322751,1514.0,329.9683377308707,375,25268,289504.0294117647,214.0,67.38133333333333
17353.0,6,13,1459,7,862,2714.833333333333,271.0,123.14285714285714,6,597,3172.0,259.0,99.5
146394.0,6,3,337,2,214,0.0,160.0,107.0,1,123,0.0,123.0,123.0
27382794.0,17,5,1718,4,1368,807277.3333333334,342.0,342.0,1,350,0.0,350.0,350.0
41388.0,6,10,2032,5,524,9296.0,252.0,104.8,5,1508,7665.75,1236.0,301.6
5829785.0,6,5,336,2,134,0.0,68.0,67.0,3,202,1523532.0,70.0,67.33333333333333
47635.0,6,10,2032,5,524,10023.5,252.0,104.8,5,1508,11413.25,1236.0,301.6
108114980.0,17,5,955,5,955,27028745.0,191.0,191.0,0,0,0.0,0.0,0.0
441.0,17,2,508,2,508,0.0,257.0,254.0,0,0,0.0,0.0,0.0
98955991.0,6,185,20826,93,6360,1075608.597826087,140.0,68.38709677419355,92,14466,1076203.2087912087,284.0,157.2391304347826
90051181.0,17,28,13364,28,13364,3335228.925925926,501.0,477.2857142857143,0,0,0.0,0.0,0.0
574401.0,6,4,508,2,238,0.0,172.0,119.0,2,270,0.0,135.0,135.0
159962.0,6,2,128,1,74,0.0,74.0,74.0,1,54,0.0,54.0,54.0
2781013.0,6,2,132,1,66,0.0,66.0,66.0,1,66,0.0,66.0,66.0
121002690.0,6,33,2280,17,1209,7562668.125,123.0,71.11764705882354,16,1071,7386706.733333333,123.0,66.9375
299839.0,6,6,412,4,272,99946.33333333331,74.0,68.0,2,140,0.0,74.0,70.0
205916.0,6,10,1221,6,636,41183.2,298.0,106.0,4,585,67448.0,379.0,146.25
147980.0,17,2,180,1,90,0.0,90.0,90.0,1,90,0.0,90.0,90.0
181315.0,17,2,180,1,90,0.0,90.0,90.0,1,90,0.0,90.0,90.0
2002.0,17,4,344,2,150,0.0,75.0,75.0,2,194,0.0,103.0,97.0
296016.0,17,2,180,1,90,0.0,90.0,90.0,1,90,0.0,90.0,90.0
4367086.0,6,205,166791,116,156615,37974.66086956522,1510.0,1350.1293103448277,89,10176,45382.28409090909,1510.0,114.3370786516854
81637.0,6,10,2032,5,524,20176.25,252.0,104.8,5,1508,17526.75,1236.0,301.6
44420.0,6,10,2032,5,524,10280.25,252.0,104.8,5,1508,10796.75,1236.0,301.6
38248.0,6,14,4740,7,653,6266.5,249.0,93.28571428571428,7,4087,4977.0,1514.0,583.8571428571429
49870324.0,6,8,2113,3,960,23602193.5,826.0,320.0,5,1153,11778596.0,885.0,230.6
120251278.0,6,19,1395,10,745,13332950.333333334,95.0,74.5,9,650,14999999.125,95.0,72.22222222222223
121610.0,6,3,373,2,238,0.0,172.0,119.0,1,135,0.0,135.0,135.0
2862434.0,6,11,2106,6,598,571853.2,252.0,99.66666666666669,5,1508,2468.0,1236.0,301.6
191460.0,17,2,180,1,90,0.0,90.0,90.0,1,90,0.0,90.0,90.0
0.0,6,1,66,1,66,0.0,66.0,66.0,0,0,0.0,0.0,0.0
1408258.0,17,7,490,7,490,234709.66666666663,70.0,70.0,0,0,0.0,0.0,0.0
121004880.0,6,29,1936,15,1042,8643205.714285715,139.0,69.46666666666667,14,894,8523347.538461538,123.0,63.85714285714285
103346.0,17,2,286,2,286,0.0,143.0,143.0,0,0,0.0,0.0,0.0
32254.0,6,10,2032,5,524,7253.25,252.0,104.8,5,1508,7817.0,1236.0,301.6
293888.0,17,2,180,1,90,0.0,90.0,90.0,1,90,0.0,90.0,90.0
146185.0,6,3,337,2,214,0.0,160.0,107.0,1,123,0.0,123.0,123.0
0.0,6,1,66,1,66,0.0,66.0,66.0,0,0,0.0,0.0,0.0
15127.0,17,2,180,1,90,0.0,90.0,90.0,1,90,0.0,90.0,90.0
33464.0,6,14,4740,7,653,4692.5,249.0,93.28571428571428,7,4087,5419.833333333333,1514.0,583.8571428571429
91416466.0,6,22,1680,12,935,8309945.090909091,95.0,77.91666666666667,10,745,10157086.777777778,95.0,74.5
99539.0,17,2,762,2,762,0.0,381.0,381.0,0,0,0.0,0.0,0.0
319444.0,17,4,1400,4,1400,106481.33333333331,350.0,350.0,0,0,0.0,0.0,0.0
1179124.0,6,13,3010,8,2382,168446.2857142857,1514.0,297.75,5,628,225865.25,331.0,125.6
217938.0,6,3,426,2,280,0.0,214.0,140.0,1,146,0.0,146.0,146.0
44596.0,6,14,4740,7,653,7159.833333333333,249.0,93.28571428571428,7,4087,7298.333333333333,1514.0,583.8571428571429
2392.0,17,4,344,2,150,0.0,75.0,75.0,2,194,0.0,103.0,97.0
42427.0,6,14,4740,7,653,6955.333333333333,249.0,93.28571428571428,7,4087,6801.0,1514.0,583.8571428571429
3241.0,17,4,344,2,150,0.0,75.0,75.0,2,194,0.0,103.0,97.0
624081.0,17,4,629,3,234,145196.5,78.0,78.0,1,395,0.0,395.0,395.0
112253015.0,6,37,2788,19,1471,6236278.611111111,139.0,77.42105263157895,18,1317,6590396.117647059,123.0,73.16666666666667
135131790.0,17,6,1206,6,1206,27026358.0,201.0,201.0,0,0,0.0,0.0,0.0
143874.0,17,2,180,1,90,0.0,90.0,90.0,1,90,0.0,90.0,90.0
120489978.0,17,14,995,7,432,17000165.666666668,174.0,61.71428571428572,7,563,19823691.5,174.0,80.42857142857143
49485.0,6,14,4740,7,653,7998.0,249.0,93.28571428571428,7,4087,7588.0,1514.0,583.8571428571429
243089.0,6,3,373,2,238,0.0,172.0,119.0,1,135,0.0,135.0,135.0
90093026.0,6,15,2180,7,1164,15015122.0,204.0,166.28571428571428,8,1016,12870094.0,188.0,127.0
120113774.0,6,12,1832,8,1016,17136193.285714287,188.0,127.0,4,816,30030719.0,204.0,204.0
93391918.0,17,12,778,6,389,18678383.6,174.0,64.83333333333333,6,389,18524285.8,174.0,64.83333333333333
8631806.0,17,3,1034,2,684,0.0,342.0,342.0,1,350,0.0,350.0,350.0
90022480.0,17,27,12943,27,12943,3462403.076923077,501.0,479.3703703703704,0,0,0.0,0.0,0.0
14608.0,6,11,2098,6,590,2385.0,252.0,98.33333333333331,5,1508,2977.0,1236.0,301.6
393.0,17,2,267,1,83,0.0,83.0,83.0,1,184,0.0,184.0,184.0
233139.0,6,3,337,2,214,0.0,160.0,107.0,1,123,0.0,123.0,123.0
126218986.0,6,32,2242,17,1225,7888686.625,139.0,72.05882352941177,15,1017,8286993.785714285,123.0,67.8
614861.0,6,4,508,2,238,0.0,172.0,119.0,2,270,0.0,135.0,135.0
0.0,17,1,55,1,55,0.0,55.0,55.0,0,0,0.0,0.0,0.0
135130374.0,17,6,1206,6,1206,27026074.8,201.0,201.0,0,0,0.0,0.0,0.0
103197.0,17,2,286,2,286,0.0,143.0,143.0,0,0,0.0,0.0,0.0
32876.0,6,14,4740,7,653,4054.8333333333335,249.0,93.28571428571428,7,4087,5032.666666666667,1514.0,583.8571428571429
2497.0,17,4,438,2,148,0.0,74.0,74.0,2,290,0.0,147.0,145.0
90693957.0,6,21,1585,10,745,10077106.333333334,95.0,74.5,11,840,9044569.6,95.0,76.36363636363636
22245.0,6,10,2032,5,524,5134.25,252.0,104.8,5,1508,4611.25,1236.0,301.6
121790.0,6,3,337,2,214,0.0,160.0,107.0,1,123,0.0,123.0,123.0
18390.0,6,10,1067,5,536,2686.5,264.0,107.2,5,531,4399.0,259.0,106.2
280981.0,17,2,414,1,88,0.0,88.0,88.0,1,326,0.0,326.0,326.0
209413.0,17,2,180,1,90,0.0,90.0,90.0,1,90,0.0,90.0,90.0
280249.0,17,2,363,1,79,0.0,79.0,79.0,1,284,0.0,284.0,284.0
103642.0,17,2,286,2,286,0.0,143.0,143.0,0,0,0.0,0.0,0.0
284884.0,17,2,363,1,79,0.0,79.0,79.0,1,284,0.0,284.0,284.0
73563.0,6,10,1066,5,490,17347.75,218.0,98.0,5,576,18182.75,304.0,115.2
108105276.0,17,5,955,5,955,27026319.0,191.0,191.0,0,0,0.0,0.0,0.0
107799.0,17,2,286,2,286,0.0,143.0,143.0,0,0,0.0,0.0,0.0
120383069.0,6,225,25484,113,17870,1074848.830357143,284.0,158.141592920354,112,7614,1075655.3423423425,140.0,67.98214285714286
153562.0,17,2,180,1,90,0.0,90.0,90.0,1,90,0.0,90.0,90.0
108109143.0,17,5,955,5,955,27027285.75,191.0,191.0,0,0,0.0,0.0,0.0
118938647.0,6,35,2526,18,1332,6983673.823529412,123.0,74.0,17,1194,7420152.4375,123.0,70.23529411764706
218435.0,6,3,426,2,280,0.0,214.0,140.0,1,146,0.0,146.0,146.0
118398931.0,6,241,27260,121,8282,986657.7583333332,140.0,68.44628099173553,120,18978,987336.1008403362,300.0,158.15
105162.0,17,4,1400,4,1400,35054.0,350.0,350.0,0,0,0.0,0.0,0.0
16799131.0,6,26,7627,14,3735,213384.6153846153,1514.0,266.7857142857143,12,3892,1506555.0909090908,1514.0,324.3333333333333
17215.0,6,2,145,2,145,0.0,91.0,72.5,0,0,0.0,0.0,0.0
3008313.0,6,11,2106,6,598,601490.4,252.0,99.66666666666669,5,1508,1858.5,1236.0,301.6
307134.0,6,6,412,4,272,102378.0,74.0,68.0,2,140,0.0,74.0,70.0
205726.0,17,2,359,1,75,0.0,75.0,75.0,1,284,0.0,284.0,284.0
299780.0,6,6,412,4,272,99926.66666666669,74.0,68.0,2,140,0.0,74.0,70.0
3004650.0,6,12,2172,7,664,500574.8333333333,252.0,94.85714285714286,5,1508,2148.25,1236.0,301.6
2873.0,17,5,550,5,550,718.25,110.0,110.0,0,0,0.0,0.0,0.0
90033050.0,17,28,13364,28,13364,3334557.407407407,501.0,477.2857142857143,0,0,0.0,0.0,0.0
242346.0,6,3,337,2,214,0.0,160.0,107.0,1,123,0.0,123.0,123.0
4475.0,17,2,598,1,72,0.0,72.0,72.0,1,526,0.0,526.0,526.0
111415.0,17,2,286,2,286,0.0,143.0,143.0,0,0,0.0,0.0,0.0
369021.0,6,4,508,2,238,0.0,172.0,119.0,2,270,0.0,135.0,135.0
112979697.0,6,45,2970,23,1518,5135440.7727272725,66.0,66.0,22,1452,4970204.333333333,66.0,66.0
104297.0,17,2,286,2,286,0.0,143.0,143.0,0,0,0.0,0.0,0.0
116734301.0,6,210,23758,105,16532,1120376.7692307692,284.0,157.44761904761904,105,7226,1120377.0961538462,140.0,68.81904761904762
3572.0,17,4,344,2,150,0.0,75.0,75.0,2,194,0.0,103.0,97.0
113603544.0,6,30,1990,15,1042,8099088.857142857,139.0,69.46666666666667,15,948,8099108.214285715,123.0,63.2
135136030.0,17,6,1206,6,1206,27027206.0,201.0,201.0,0,0,0.0,0.0,0.0
2322142.0,6,25,7589,14,3751,178626.3076923077,1514.0,267.92857142857144,11,3838,207218.3,1514.0,348.90909090909093
207164.0,6,3,426,2,280,0.0,214.0,140.0,1,146,0.0,146.0,146.0
108103067.0,17,5,1005,5,1005,27025766.75,201.0,201.0,0,0,0.0,0.0,0.0
60689.0,6,10,2032,5,524,13192.25,252.0,104.8,5,1508,13208.25,1236.0,301.6
22027.0,17,2,582,1,83,0.0,83.0,83.0,1,499,0.0,499.0,499.0
198769.0,17,2,180,1,90,0.0,90.0,90.0,1,90,0.0,90.0,90.0
120460682.0,17,14,864,7,432,19842653.0,174.0,61.71428571428572,7,432,20050092.83333333,174.0,61.71428571428572
444736.0,17,2,363,1,75,0.0,75.0,75.0,1,288,0.0,288.0,288.0
120157152.0,6,13,2036,5,1020,30039288.0,204.0,204.0,8,1016,17137533.42857143,188.0,127.0
244762.0,6,12,1373,7,714,40793.66666666666,298.0,102.0,5,659,60132.75,379.0,131.8
1869.0,17,2,939,1,590,0.0,590.0,590.0,1,349,0.0,349.0,349.0
2484276.0,6,25,7573,14,3735,191098.15384615384,1514.0,266.7857142857143,11,3838,220961.6,1514.0,348.90909090909093
49959.0,6,14,4740,7,653,7844.166666666667,249.0,93.28571428571428,7,4087,7702.5,1514.0,583.8571428571429
146028.0,6,3,337,2,214,0.0,160.0,107.0,1,123,0.0,123.0,123.0
310155.0,6,6,412,4,272,103385.0,74.0,68.0,2,140,0.0,74.0,70.0
135006937.0,17,17,1255,9,649,16875867.125,174.0,72.11111111111111,8,606,16428713.42857143,174.0,75.75
90015959.0,17,28,13364,28,13364,3333924.407407407,501.0,477.2857142857143,0,0,0.0,0.0,0.0
14153.0,6,14,4740,7,653,2057.1666666666665,249.0,93.28571428571428,7,4087,2216.833333333333,1514.0,583.8571428571429
109211145.0,6,31,2182,16,1165,7266353.8,139.0,72.8125,15,1017,7785375.5,123.0,67.8
121419247.0,6,420,53988,210,14156,572134.062200957,140.0,67.4095238095238,210,39832,580873.4258373206,480.0,189.67619047619047
279962.0,6,10,1221,6,636,55992.4,298.0,106.0,4,585,87932.66666666667,379.0,146.25
166063.0,17,2,414,1,88,0.0,88.0,88.0,1,326,0.0,326.0,326.0
143946.0,17,2,180,1,90,0.0,90.0,90.0,1,90,0.0,90.0,90.0
134007135.0,17,15,907,8,475,19143876.42857143,174.0,59.375,7,432,19000199.666666668,174.0,61.71428571428572
240903.0,6,3,337,2,214,0.0,160.0,107.0,1,123,0.0,123.0,123.0
19209.0,6,11,1132,6,556,2962.2,218.0,92.66666666666669,5,576,4499.0,304.0,115.2
107174405.0,6,44,2904,22,1452,5103543.095238095,66.0,66.0,22,1452,5093258.80952381,66.0,66.0
2799499.0,6,2,132,1,66,0.0,66.0,66.0,1,66,0.0,66.0,66.0
305743.0,6,3,202,2,128,0.0,74.0,64.0,1,74,0.0,74.0,74.0
120062563.0,17,28,13364,28,13364,4446761.592592592,501.0,477.2857142857143,0,0,0.0,0.0,0.0
117157237.0,6,32,2088,16,1086,7796090.933333334,123.0,67.875,16,1002,7796090.466666667,123.0,62.625
120281859.0,6,218,24672,109,7490,1106290.9074074074,140.0,68.71559633027523,109,17182,1106099.8055555555,390.0,157.63302752293578
83283077.0,17,14,4796,13,4446,6235844.833333333,342.0,342.0,1,350,0.0,350.0,350.0
28250377.0,6,4,264,2,132,0.0,66.0,66.0,2,132,0.0,66.0,66.0
3336222.0,6,192,161682,115,152298,29265.105263157893,1510.0,1324.3304347826088,77,9384,39885.89473684211,1510.0,121.87012987012989
26988.0,6,11,1131,6,600,5130.2,262.0,100.0,5,531,6427.75,259.0,106.2
49232.0,6,14,4740,7,653,6592.333333333333,249.0,93.28571428571428,7,4087,7875.5,1514.0,583.8571428571429
38622.0,6,14,4740,7,653,6157.333333333333,249.0,93.28571428571428,7,4087,6227.333333333333,1514.0,583.8571428571429
110049235.0,6,35,2542,18,1348,6473484.411764706,139.0,74.88888888888889,17,1194,6864562.0,123.0,70.23529411764706
39314.0,6,14,4740,7,653,6419.666666666667,249.0,93.28571428571428,7,4087,6379.0,1514.0,583.8571428571429
265551.0,6,12,1373,7,714,44258.5,298.0,102.0,5,659,60862.0,379.0,131.8
115005239.0,17,13,821,7,432,19167539.83333333,174.0,61.71428571428572,6,389,19000158.2,174.0,64.83333333333333
44628.0,6,14,4740,7,653,7255.666666666667,249.0,93.28571428571428,7,4087,5894.0,1514.0,583.8571428571429
32319.0,6,10,2032,5,524,7823.5,252.0,104.8,5,1508,6812.5,1236.0,301.6
37915.0,6,14,4740,7,653,6196.833333333333,249.0,93.28571428571428,7,4087,6032.5,1514.0,583.8571428571429
209522.0,17,2,180,1,90,0.0,90.0,90.0,1,90,0.0,90.0,90.0
119751015.0,17,34,16284,34,16284,3628818.636363636,501.0,478.9411764705882,0,0,0.0,0.0,0.0
96178540.0,6,26,1746,13,906,7996876.5,123.0,69.6923076923077,13,840,7996877.333333333,123.0,64.61538461538461
196975.0,17,2,180,1,90,0.0,90.0,90.0,1,90,0.0,90.0,90.0
31925.000000000004,6,14,4740,7,653,5212.166666666667,249.0,93.28571428571428,7,4087,4220.833333333333,1514.0,583.8571428571429
108398529.0,17,14,864,7,432,18000219.333333332,174.0,61.71428571428572,7,432,18000474.5,174.0,61.71428571428572
16153.0,6,10,2032,5,524,3816.5,252.0,104.8,5,1508,3780.5,1236.0,301.6
105135236.0,6,253,30280,127,8604,834406.6349206349,140.0,67.74803149606299,126,21676,832674.192,390.0,172.03174603174602
17013045.0,6,22,7083,13,1707,1417753.75,408.0,131.30769230769232,9,5376,1611131.625,1514.0,597.3333333333334
46184.0,6,10,2032,5,524,11240.25,252.0,104.8,5,1508,8891.25,1236.0,301.6
92815.0,6,13,1386,7,789,15469.166666666666,253.0,112.71428571428572,6,597,17714.0,259.0,99.5
110270.0,17,4,1400,4,1400,36756.66666666666,350.0,350.0,0,0,0.0,0.0,0.0
24691.0,6,14,4740,7,653,3373.333333333333,249.0,93.28571428571428,7,4087,3865.6666666666665,1514.0,583.8571428571429
232178.0,6,3,337,2,214,0.0,160.0,107.0,1,123,0.0,123.0,123.0
119649811.0,17,34,16284,34,16284,3625751.8484848486,501.0,478.9411764705882,0,0,0.0,0.0,0.0
361436.0,17,2,180,1,90,0.0,90.0,90.0,1,90,0.0,90.0,90.0
25097.0,6,14,4740,7,653,4060.3333333333335,249.0,93.28571428571428,7,4087,3891.6666666666665,1514.0,583.8571428571429
209523.0,17,2,180,1,90,0.0,90.0,90.0,1,90,0.0,90.0,90.0
1242754.0,6,7,499,4,301,379933.6666666667,103.0,75.25,3,198,610870.5,66.0,66.0
247020.0,6,3,373,2,238,0.0,172.0,119.0,1,135,0.0,135.0,135.0
103524.0,17,2,286,2,286,0.0,143.0,143.0,0,0,0.0,0.0,0.0
43596.0,6,14,4740,7,653,7112.166666666667,249.0,93.28571428571428,7,4087,6258.0,1514.0,583.8571428571429
113733852.0,6,46,3036,23,1518,5155443.045454546,66.0,66.0,23,1518,5155441.181818182,66.0,66.0
27040.0,6,10,1066,5,490,6194.75,218.0,98.0,5,576,6553.25,304.0,115.2
10528423.0,6,7,478,4,272,3464000.333333333,74.0,68.0,3,206,5195879.0,74.0,68.66666666666667
77945.0,6,10,2032,5,524,19268.75,252.0,104.8,5,1508,14051.75,1236.0,301.6
84535559.0,17,14,4788,14,4788,6502735.307692308,342.0,342.0,0,0,0.0,0.0,0.0
3205.0,17,4,344,2,150,0.0,75.0,75.0,2,194,0.0,103.0,97.0
90093338.0,6,12,1848,5,1020,22522745.25,204.0,204.0,7,828,15015073.0,188.0,118.28571428571428
320122.0,17,4,1400,4,1400,106707.33333333331,350.0,350.0,0,0,0.0,0.0,0.0
1595650.0,6,5,657,4,534,531883.3333333334,160.0,133.5,1,123,0.0,123.0,123.0
153518.0,17,2,180,1,90,0.0,90.0,90.0,1,90,0.0,90.0,90.0
1306957.0,6,4,264,2,132,0.0,66.0,66.0,2,132,0.0,66.0,66.0
121346.0,6,3,337,2,214,0.0,160.0,107.0,1,123,0.0,123.0,123.0
3004432.0,6,11,2106,6,598,600716.8,252.0,99.66666666666669,5,1508,1689.25,1236.0,301.6
293399.0,17,2,246,1,76,0.0,76.0,76.0,1,170,0.0,170.0,170.0
241338.0,6,3,337,2,214,0.0,160.0,107.0,1,123,0.0,123.0,123.0
118941820.0,6,38,2848,20,1531,6249336.105263158,139.0,76.55,18,1317,6984553.529411765,123.0,73.16666666666667
66115.0,17,2,180,1,90,0.0,90.0,90.0,1,90,0.0,90.0,90.0
22626.0,6,14,4740,7,653,3519.5,249.0,93.28571428571428,7,4087,3577.833333333333,1514.0,583.8571428571429
79574.0,17,4,820,2,156,0.0,78.0,78.0,2,664,0.0,332.0,332.0
304450.0,17,4,704,2,148,0.0,74.0,74.0,2,556,0.0,280.0,278.0
304881.0,6,6,412,4,272,101627.0,74.0,68.0,2,140,0.0,74.0,70.0
2414.0,17,4,344,2,150,0.0,75.0,75.0,2,194,0.0,103.0,97.0
216629.0,6,3,426,2,280,0.0,214.0,140.0,1,146,0.0,146.0,146.0
306826.0,6,6,412,4,272,102275.33333333331,74.0,68.0,2,140,0.0,74.0,70.0
3010695.0,6,12,2172,7,664,501624.1666666667,252.0,94.85714285714286,5,1508,1946.5,1236.0,301.6
943263.0,6,10,1334,6,797,188652.6,459.0,132.83333333333334,4,537,223528.0,331.0,134.25
1308646.0,6,4,264,2,132,0.0,66.0,66.0,2,132,0.0,66.0,66.0
3494.0,17,4,571,2,148,0.0,74.0,74.0,2,423,0.0,280.0,211.5
146052.0,6,3,337,2,214,0.0,160.0,107.0,1,123,0.0,123.0,123.0
535855.0,6,14,4740,7,653,89191.66666666664,249.0,93.28571428571428,7,4087,88989.66666666667,1514.0,583.8571428571429
108458279.0,6,186,20982,93,14548,1176554.9673913044,284.0,156.43010752688173,93,6434,1176555.0760869563,140.0,69.18279569892474
135130371.0,17,6,1206,6,1206,27026074.2,201.0,201.0,0,0,0.0,0.0,0.0
358448.0,17,2,180,1,90,0.0,90.0,90.0,1,90,0.0,90.0,90.0
196745.0,17,2,180,1,90,0.0,90.0,90.0,1,90,0.0,90.0,90.0
341.0,17,2,267,1,83,0.0,83.0,83.0,1,184,0.0,184.0,184.0
561212.0,6,10,1221,6,636,112242.4,298.0,106.0,4,585,181674.66666666663,379.0,146.25
292073.0,17,2,180,1,90,0.0,90.0,90.0,1,90,0.0,90.0,90.0
123610501.0,6,49,3234,25,1650,5150437.541666667,66.0,66.0,24,1584,5169637.695652174,66.0,66.0
119960.0,17,2,180,1,70,0.0,70.0,70.0,1,110,0.0,110.0,110.0
120161538.0,6,230,25978,115,7886,1046827.6228070176,140.0,68.57391304347826,115,18092,1046897.394736842,284.0,157.3217391304348
90546.0,6,10,2032,5,524,22307.25,252.0,104.8,5,1508,19398.75,1236.0,301.6
10431445.0,6,6,412,3,206,5147361.5,74.0,68.66666666666667,3,206,5147238.0,74.0,68.66666666666667
120096470.0,6,14,2274,6,1194,24019294.0,199.0,199.0,8,1080,17080176.0,204.0,135.0
322.0,17,2,168,1,76,0.0,76.0,76.0,1,92,0.0,92.0,92.0
101203189.0,17,14,864,7,432,16834610.666666668,174.0,61.71428571428572,7,432,16833486.666666668,174.0,61.71428571428572
9371.0,17,2,507,1,86,0.0,86.0,86.0,1,421,0.0,421.0,421.0
305.0,17,2,168,1,76,0.0,76.0,76.0,1,92,0.0,92.0,92.0
35115.0,6,14,4740,7,653,5484.666666666667,249.0,93.28571428571428,7,4087,5659.166666666667,1514.0,583.8571428571429
90291556.0,6,15,1097,8,596,12898793.714285716,95.0,74.5,7,501,14999022.5,95.0,71.57142857142857
90074842.0,17,28,13364,28,13364,3336105.25925926,501.0,477.2857142857143,0,0,0.0,0.0,0.0
19793.0,6,10,2032,5,524,4701.25,252.0,104.8,5,1508,4287.75,1236.0,301.6
2338.0,17,4,344,2,150,0.0,75.0,75.0,2,194,0.0,103.0,97.0
304847.0,17,2,180,1,90,0.0,90.0,90.0,1,90,0.0,90.0,90.0
28550.0,6,14,4740,7,653,4584.333333333333,249.0,93.28571428571428,7,4087,3182.6666666666665,1514.0,583.8571428571429
35347.0,6,10,2032,5,524,6325.75,252.0,104.8,5,1508,7697.25,1236.0,301.6
127017078.0,17,15,907,8,475,18145296.85714286,174.0,59.375,7,432,17833496.833333332,174.0,61.71428571428572
2795685.0,6,2,132,1,66,0.0,66.0,66.0,1,66,0.0,66.0,66.0
441256.0,6,10,967,5,390,74203.75,162.0,78.0,5,577,74134.0,349.0,115.4
120070050.0,17,29,13785,29,13785,4288216.071428572,501.0,475.3448275862069,0,0,0.0,0.0,0.0
313.0,17,2,164,1,82,0.0,82.0,82.0,1,82,0.0,82.0,82.0
363579.0,6,11,1021,6,444,48898.2,162.0,74.0,5,577,60993.25,349.0,115.4
90527074.0,6,14,2240,8,1016,12932439.142857144,188.0,127.0,6,1224,18072675.4,204.0,204.0
42917.0,6,10,2032,5,524,10414.0,252.0,104.8,5,1508,10296.5,1236.0,301.6
154383.0,6,11,1132,6,556,30876.6,218.0,92.66666666666669,5,576,37888.5,304.0,115.2
266175.0,17,2,180,1,90,0.0,90.0,90.0,1,90,0.0,90.0,90.0
233030.0,6,3,337,2,214,0.0,160.0,107.0,1,123,0.0,123.0,123.0
47922.0,6,14,4740,7,653,7482.0,249.0,93.28571428571428,7,4087,6720.833333333333,1514.0,583.8571428571429
15269.0,6,14,4740,7,653,2247.5,249.0,93.28571428571428,7,4087,2406.833333333333,1514.0,583.8571428571429
135137670.0,17,6,1146,6,1146,27027534.0,191.0,191.0,0,0,0.0,0.0,0.0
23593.0,6,14,4740,7,653,3806.0,249.0,93.28571428571428,7,4087,3635.6666666666665,1514.0,583.8571428571429
128844987.0,6,37,2656,19,1408,7158054.833333333,139.0,74.10526315789474,18,1248,6979081.705882353,123.0,69.33333333333333
287237.0,17,2,180,1,90,0.0,90.0,90.0,1,90,0.0,90.0,90.0
2494.0,17,4,344,2,150,0.0,75.0,75.0,2,194,0.0,103.0,97.0
173942.0,6,3,337,2,214,0.0,160.0,107.0,1,123,0.0,123.0,123.0
1456098.0,6,19,7533,10,1403,161788.66666666666,583.0,140.3,9,6130,149796.125,1484.0,681.1111111111111
2488785.0,6,19,6869,10,1501,276531.6666666667,408.0,150.1,9,5368,245947.375,1514.0,596.4444444444445
315961.0,17,4,704,2,148,0.0,74.0,74.0,2,556,0.0,280.0,278.0
119995830.0,6,1052,247200,541,212512,222214.5,1514.0,392.8133086876155,511,34688,234815.5098039216,214.0,67.8825831702544
116076290.0,6,48,3168,24,1584,5046795.217391305,66.0,66.0,24,1584,5034820.391304348,66.0,66.0
605230.0,6,4,508,2,238,0.0,172.0,119.0,2,270,0.0,135.0,135.0
90256316.0,6,12,1876,8,1080,12893759.42857143,204.0,135.0,4,796,30030857.0,199.0,199.0
20678.0,6,10,1067,5,536,4623.25,264.0,107.2,5,531,4280.75,259.0,106.2
206150.0,17,2,180,1,90,0.0,90.0,90.0,1,90,0.0,90.0,90.0
47528.0,6,14,4740,7,653,7096.666666666667,249.0,93.28571428571428,7,4087,5932.333333333333,1514.0,583.8571428571429
41688.0,6,14,4740,7,653,5696.666666666667,249.0,93.28571428571428,7,4087,6760.166666666667,1514.0,583.8571428571429
892166.0,6,12,2710,7,742,148694.33333333334,338.0,106.0,5,1968,154084.0,1514.0,393.6
135136229.0,17,6,1206,6,1206,27027245.8,201.0,201.0,0,0,0.0,0.0,0.0
16612748.0,6,7,499,3,198,6654261.0,66.0,66.0,4,301,4365168.333333333,103.0,75.25
162320.0,17,2,180,1,90,0.0,90.0,90.0,1,90,0.0,90.0,90.0
312971.0,17,4,1400,4,1400,104323.66666666669,350.0,350.0,0,0,0.0,0.0,0.0
31040.0,6,14,4740,7,653,4783.333333333333,249.0,93.28571428571428,7,4087,4881.333333333333,1514.0,583.8571428571429
26891.0,6,14,4740,7,653,3269.333333333333,249.0,93.28571428571428,7,4087,4306.0,1514.0,583.8571428571429
135127373.0,17,6,1206,6,1206,27025474.6,201.0,201.0,0,0,0.0,0.0,0.0
27617.0,6,10,2032,5,524,6692.5,252.0,104.8,5,1508,6684.75,1236.0,301.6
119947.0,17,2,180,1,70,0.0,70.0,70.0,1,110,0.0,110.0,110.0
28534.0,6,14,4740,7,653,4307.0,249.0,93.28571428571428,7,4087,4540.5,1514.0,583.8571428571429
100742077.0,6,28,1860,14,966,7732790.076923077,123.0,69.0,14,894,7732795.615384615,123.0,63.85714285714285
55213.0,6,13,1459,7,862,8940.833333333334,271.0,123.14285714285714,6,597,9015.4,259.0,99.5
92191990.0,17,16,5472,16,5472,6146132.666666667,342.0,342.0,0,0,0.0,0.0,0.0
114790890.0,6,47,3102,24,1584,4990896.956521739,66.0,66.0,23,1518,5151999.318181818,66.0,66.0
117809341.0,6,32,2220,16,1149,7853956.066666666,123.0,71.8125,16,1071,7839527.6,123.0,66.9375
318.0,17,2,174,1,79,0.0,79.0,79.0,1,95,0.0,95.0,95.0
306.0,17,2,174,1,79,0.0,79.0,79.0,1,95,0.0,95.0,95.0
108107361.0,17,5,955,5,955,27026840.25,191.0,191.0,0,0,0.0,0.0,0.0
289.0,17,2,174,1,79,0.0,79.0,79.0,1,95,0.0,95.0,95.0
5617487.0,6,5,336,2,134,0.0,68.0,67.0,3,202,1419930.0,70.0,67.33333333333333
308524.0,6,6,412,4,272,102841.33333333331,74.0,68.0,2,140,0.0,74.0,70.0
2880632.0,6,11,2106,6,598,575919.6,252.0,99.66666666666669,5,1508,1830.75,1236.0,301.6
309355.0,17,4,1400,4,1400,103118.33333333331,350.0,350.0,0,0,0.0,0.0,0.0
3502138.0,6,216,164811,113,153711,30795.25,1510.0,1360.274336283186,103,11100,31291.186274509804,1510.0,107.76699029126212
23637.0,6,14,4740,7,653,3129.833333333333,249.0,93.28571428571428,7,4087,3521.833333333333,1514.0,583.8571428571429
303520.0,6,6,412,4,272,101173.33333333331,74.0,68.0,2,140,0.0,74.0,70.0
1156805.0,17,2,602,1,72,0.0,72.0,72.0,1,530,0.0,530.0,530.0
208453.0,6,12,1373,7,714,34742.166666666664,298.0,102.0,5,659,51224.0,379.0,131.8
284533.0,17,2,363,1,79,0.0,79.0,79.0,1,284,0.0,284.0,284.0
107004.0,17,2,286,2,286,0.0,143.0,143.0,0,0,0.0,0.0,0.0
72409.0,6,12,1328,7,797,12068.166666666666,253.0,113.85714285714286,5,531,14951.75,259.0,106.2
148218.0,17,2,180,1,90,0.0,90.0,90.0,1,90,0.0,90.0,90.0
67553.0,6,14,4740,7,653,11090.833333333334,249.0,93.28571428571428,7,4087,10999.333333333334,1514.0,583.8571428571429
107316.0,17,2,286,2,286,0.0,143.0,143.0,0,0,0.0,0.0,0.0
30288.0,6,10,2032,5,524,7274.75,252.0,104.8,5,1508,7296.25,1236.0,301.6
5624464.0,6,5,336,2,134,0.0,68.0,67.0,3,202,1409237.0,70.0,67.33333333333333
0.0,17,1,453,1,453,0.0,453.0,453.0,0,0,0.0,0.0,0.0
153446.0,17,2,180,1,90,0.0,90.0,90.0,1,90,0.0,90.0,90.0
110286946.0,17,14,864,7,432,18333494.166666668,174.0,61.71428571428572,7,432,18337127.166666668,174.0,61.71428571428572
108114468.0,17,5,1005,5,1005,27028617.0,201.0,201.0,0,0,0.0,0.0,0.0
113618042.0,6,46,3036,23,1518,5150438.045454546,66.0,66.0,23,1518,5150440.5,66.0,66.0
115298890.0,6,213,24152,107,7358,1087725.3773584906,140.0,68.76635514018692,106,16794,1088161.7142857143,390.0,158.43396226415095
23530.0,6,10,2032,5,524,5325.0,252.0,104.8,5,1508,5635.5,1236.0,301.6
135133756.0,17,6,1146,6,1146,27026751.2,191.0,191.0,0,0,0.0,0.0,0.0
5009978.0,17,4,376,2,152,0.0,76.0,76.0,2,224,0.0,148.0,112.0
41931355.0,6,26,7627,14,3735,191998.2307692308,1514.0,266.7857142857143,12,3892,3793242.363636364,1514.0,324.3333333333333
331.0,17,2,166,1,75,0.0,75.0,75.0,1,91,0.0,91.0,91.0
319325.0,6,6,412,4,272,106441.66666666669,74.0,68.0,2,140,0.0,74.0,70.0
310735.0,6,2,132,1,66,0.0,66.0,66.0,1,66,0.0,66.0,66.0
17607.0,6,14,4740,7,653,2609.333333333333,249.0,93.28571428571428,7,4087,2740.5,1514.0,583.8571428571429
108108709.0,17,5,955,5,955,27027177.25,191.0,191.0,0,0,0.0,0.0,0.0
303538.0,6,6,412,4,272,101179.33333333331,74.0,68.0,2,140,0.0,74.0,70.0
27025.0,6,14,4740,7,653,4093.5,249.0,93.28571428571428,7,4087,4308.833333333333,1514.0,583.8571428571429
90255630.0,6,13,2036,8,1016,12893661.42857143,188.0,127.0,5,1020,22523416.75,204.0,204.0
108108458.0,17,5,1005,5,1005,27027114.5,201.0,201.0,0,0,0.0,0.0,0.0
7144.0,17,2,582,1,83,0.0,83.0,83.0,1,499,0.0,499.0,499.0
20335.0,6,10,2032,5,524,4860.0,252.0,104.8,5,1508,4083.5,1236.0,301.6
2027.0,17,4,344,2,150,0.0,75.0,75.0,2,194,0.0,103.0,97.0
2573341.0,6,2,132,1,66,0.0,66.0,66.0,1,66,0.0,66.0,66.0
90258679.0,6,13,2036,8,1016,12894097.0,188.0,127.0,5,1020,22523572.0,204.0,204.0
99714132.0,6,26,1746,13,906,8291531.416666667,123.0,69.6923076923077,13,840,8291536.0,123.0,64.61538461538461
2064.0,17,4,344,2,150,0.0,75.0,75.0,2,194,0.0,103.0,97.0
11158.0,6,11,1132,6,556,2231.6,218.0,92.66666666666669,5,576,2200.5,304.0,115.2
220511.0,6,3,426,2,280,0.0,214.0,140.0,1,146,0.0,146.0,146.0
209504.0,17,2,180,1,90,0.0,90.0,90.0,1,90,0.0,90.0,90.0
0.0,6,1,172,1,172,0.0,172.0,172.0,0,0,0.0,0.0,0.0
105789.0,17,2,762,2,762,0.0,381.0,381.0,0,0,0.0,0.0,0.0
206210.0,6,3,426,2,280,0.0,214.0,140.0,1,146,0.0,146.0,146.0
128157197.0,17,13,821,8,475,18308171.0,174.0,59.375,5,346,16751116.25,174.0,69.2
14652685.0,6,19,1553,9,921,1791876.125,315.0,102.33333333333331,10,632,1592449.2222222222,78.0,63.2
2325.0,17,4,344,2,150,0.0,75.0,75.0,2,194,0.0,103.0,97.0
90257172.0,6,13,2036,8,1016,12893881.714285716,188.0,127.0,5,1020,22523283.0,204.0,204.0
114291404.0,6,48,3168,24,1584,4969191.478260869,66.0,66.0,24,1584,4955518.913043479,66.0,66.0
421.0,17,2,160,1,80,0.0,80.0,80.0,1,80,0.0,80.0,80.0
109287031.0,6,33,2428,17,1288,6830439.4375,139.0,75.76470588235294,16,1140,7271379.266666667,123.0,71.25
30773.0,6,14,4740,7,653,4910.833333333333,249.0,93.28571428571428,7,4087,4943.5,1514.0,583.8571428571429
2777721.0,6,3,1604,2,851,0.0,785.0,425.5,1,753,0.0,753.0,753.0
14982.0,6,12,1217,6,612,2765.8,262.0,102.0,6,605,2441.0,259.0,100.83333333333331
744924.0,6,2,132,1,66,0.0,66.0,66.0,1,66,0.0,66.0,66.0
2449.0,17,4,344,2,150,0.0,75.0,75.0,2,194,0.0,103.0,97.0
108104255.0,17,5,955,5,955,27026063.75,191.0,191.0,0,0,0.0,0.0,0.0
112790089.0,6,34,2350,17,1225,7035894.375,139.0,72.05882352941177,17,1125,7035891.4375,123.0,66.17647058823529
885184.0,6,4,492,2,280,0.0,214.0,140.0,2,212,0.0,146.0,106.0
2352.0,17,4,344,2,150,0.0,75.0,75.0,2,194,0.0,103.0,97.0
18389.0,6,14,4740,7,653,2887.333333333333,249.0,93.28571428571428,7,4087,2925.833333333333,1514.0,583.8571428571429
147918.0,17,2,180,1,90,0.0,90.0,90.0,1,90,0.0,90.0,90.0
103200263.0,6,42,2772,21,1386,5160000.45,66.0,66.0,21,1386,5159999.85,66.0,66.0
128934.0,6,2,132,1,66,0.0,66.0,66.0,1,66,0.0,66.0,66.0
31544.000000000004,6,10,2032,5,524,7225.5,252.0,104.8,5,1508,7344.75,1236.0,301.6
2421.0,17,4,344,2,150,0.0,75.0,75.0,2,194,0.0,103.0,97.0
205848.0,17,2,180,1,90,0.0,90.0,90.0,1,90,0.0,90.0,90.0
0.0,17,1,55,1,55,0.0,55.0,55.0,0,0,0.0,0.0,0.0
41380.0,6,10,2032,5,524,10091.0,252.0,104.8,5,1508,9507.25,1236.0,301.6
307788.0,6,6,412,4,272,102596.0,74.0,68.0,2,140,0.0,74.0,70.0
100172337.0,17,13,821,7,432,16666802.833333334,174.0,61.71428571428572,6,389,20006133.0,174.0,64.83333333333333
115347059.0,6,48,3168,24,1584,5015089.521739131,66.0,66.0,24,1584,5001418.565217392,66.0,66.0
2739352.0,6,3,204,2,136,0.0,70.0,68.0,1,68,0.0,68.0,68.0
113002.0,17,2,286,2,286,0.0,143.0,143.0,0,0,0.0,0.0,0.0
1716232.0,6,22,6443,11,1463,171623.2,357.0,133.0,11,4980,140655.7,1510.0,452.7272727272728
2805635.0,6,2,132,1,66,0.0,66.0,66.0,1,66,0.0,66.0,66.0
207081.0,6,3,426,2,280,0.0,214.0,140.0,1,146,0.0,146.0,146.0
1301467.0,6,4,264,2,132,0.0,66.0,66.0,2,132,0.0,66.0,66.0
2669634.0,6,23,6525,12,1537,242694.0,357.0,128.08333333333334,11,4988,236096.9,1510.0,453.45454545454544
2421.0,17,4,344,2,150,0.0,75.0,75.0,2,194,0.0,103.0,97.0
315851.0,17,4,1400,4,1400,105283.66666666669,350.0,350.0,0,0,0.0,0.0,0.0
10460655.0,6,7,478,4,272,3441543.333333333,74.0,68.0,3,206,5162213.5,74.0,68.66666666666667
106764.0,17,2,286,2,286,0.0,143.0,143.0,0,0,0.0,0.0,0.0
216229.0,6,10,1221,6,636,43245.8,298.0,106.0,4,585,71236.0,379.0,146.25
48192.0,6,14,4740,7,653,7525.166666666667,249.0,93.28571428571428,7,4087,6923.0,1514.0,583.8571428571429
90255847.0,6,13,2036,8,1016,12893692.42857143,188.0,127.0,5,1020,22523133.5,204.0,204.0
146809.0,6,3,373,2,238,0.0,172.0,119.0,1,135,0.0,135.0,135.0
56858.0,6,10,2032,5,524,13974.5,252.0,104.8,5,1508,13408.0,1236.0,301.6
527366.0,17,6,2100,6,2100,105473.2,350.0,350.0,0,0,0.0,0.0,0.0
12998.0,6,11,2098,6,590,2265.0,252.0,98.33333333333331,5,1508,2959.5,1236.0,301.6
1471787.0,17,16,1120,16,1120,98119.13333333332,70.0,70.0,0,0,0.0,0.0,0.0
108105261.0,17,5,1005,5,1005,27026315.25,201.0,201.0,0,0,0.0,0.0,0.0
205740.0,17,2,180,1,90,0.0,90.0,90.0,1,90,0.0,90.0,90.0
71100575.0,6,22,1537,11,789,7108947.8,95.0,71.72727272727273,11,748,7108866.2,95.0,68.0
111830021.0,6,30,1974,15,1026,7972439.785714285,123.0,68.4,15,948,7972436.285714285,123.0,63.2
196980.0,17,2,180,1,90,0.0,90.0,90.0,1,90,0.0,90.0,90.0
94138.0,6,11,1132,6,556,18097.8,218.0,92.66666666666669,5,576,23328.5,304.0,115.2
6925.0,17,2,582,1,83,0.0,83.0,83.0,1,499,0.0,499.0,499.0
103192.0,17,2,286,2,286,0.0,143.0,143.0,0,0,0.0,0.0,0.0
120382285.0,6,262,29816,131,8868,919510.0,140.0,67.69465648854961,131,20948,919626.6230769232,284.0,159.9083969465649
117824557.0,6,29,1914,15,948,8416039.785714285,123.0,63.2,14,966,8278701.076923077,123.0,69.0
37578.0,6,10,2032,5,524,9138.25,252.0,104.8,5,1508,8114.5,1236.0,301.6
281089.0,17,2,180,1,90,0.0,90.0,90.0,1,90,0.0,90.0,90.0
66836.0,6,14,4740,7,653,10546.166666666666,249.0,93.28571428571428,7,4087,10861.833333333334,1514.0,583.8571428571429
39890.0,6,14,4740,7,653,6539.666666666667,249.0,93.28571428571428,7,4087,6415.666666666667,1514.0,583.8571428571429
3007578.0,6,11,2106,6,598,601306.2,252.0,99.66666666666669,5,1508,1821.5,1236.0,301.6
307972.0,6,6,412,4,272,102657.33333333331,74.0,68.0,2,140,0.0,74.0,70.0
3023883.0,6,2,132,1,66,0.0,66.0,66.0,1,66,0.0,66.0,66.0
3005200.0,6,11,2106,6,598,600276.6,252.0,99.66666666666669,5,1508,2759.0,1236.0,301.6
233417.0,6,3,373,2,238,0.0,172.0,119.0,1,135,0.0,135.0,135.0
265245.0,6,10,1221,6,636,53049.0,298.0,106.0,4,585,81795.33333333333,379.0,146.25
197233.0,17,2,180,1,90,0.0,90.0,90.0,1,90,0.0,90.0,90.0
338.0,17,2,166,1,75,0.0,75.0,75.0,1,91,0.0,91.0,91.0
35696.0,6,14,4740,7,653,5748.0,249.0,93.28571428571428,7,4087,5672.666666666667,1514.0,583.8571428571429
299785.0,6,6,412,4,272,99928.33333333331,74.0,68.0,2,140,0.0,74.0,70.0
0.0,6,1,54,0,0,0.0,0.0,0.0,1,54,0.0,54.0,54.0
524.0,17,2,508,2,508,0.0,257.0,254.0,0,0,0.0,0.0,0.0
9252.0,17,4,823,2,163,0.0,89.0,81.5,2,660,0.0,443.0,330.0
90255251.0,6,13,2036,8,1016,12893607.285714284,188.0,127.0,5,1020,22522904.75,204.0,204.0
108105208.0,17,5,955,5,955,27026302.0,191.0,191.0,0,0,0.0,0.0,0.0
45404.0,6,14,4740,7,653,7396.5,249.0,93.28571428571428,7,4087,7299.833333333333,1514.0,583.8571428571429
127554730.0,6,33,2280,17,1209,7972170.625,123.0,71.11764705882354,16,1071,7824107.066666666,123.0,66.9375
2357.0,17,4,344,2,150,0.0,75.0,75.0,2,194,0.0,103.0,97.0
16439229.000000002,17,6,2052,6,2052,3287845.8,342.0,342.0,0,0,0.0,0.0,0.0
307491.0,6,3,202,2,128,0.0,74.0,64.0,1,74,0.0,74.0,74.0
43037.0,6,14,4740,7,653,6549.5,249.0,93.28571428571428,7,4087,6978.166666666667,1514.0,583.8571428571429
111758772.0,6,30,1974,15,1026,7968167.285714285,123.0,68.4,15,948,7968168.357142857,123.0,63.2
122010181.0,17,15,1169,8,606,17430025.85714286,174.0,75.75,7,563,17000181.5,174.0,80.42857142857143
240253.0,17,4,6056,4,6056,80084.33333333333,1514.0,1514.0,0,0,0.0,0.0,0.0
42269.0,6,14,4740,7,653,5732.0,249.0,93.28571428571428,7,4087,6226.5,1514.0,583.8571428571429
5626023.0,6,4,270,2,134,0.0,68.0,67.0,2,136,0.0,70.0,68.0
137065.0,6,2,132,1,66,0.0,66.0,66.0,1,66,0.0,66.0,66.0
120160771.0,6,222,25122,111,7548,1075404.7181818185,140.0,68.0,111,17574,1084867.018181818,284.0,158.32432432432432
37877.0,6,14,4740,7,653,6182.666666666667,249.0,93.28571428571428,7,4087,5419.666666666667,1514.0,583.8571428571429
241785.0,6,3,337,2,214,0.0,160.0,107.0,1,123,0.0,123.0,123.0
63150.0,6,14,4740,7,653,10386.166666666666,249.0,93.28571428571428,7,4087,10352.833333333334,1514.0,583.8571428571429
510584.00000000006,6,5,336,2,134,0.0,68.0,67.0,3,202,194716.5,70.0,67.33333333333333
120012948.0,17,28,13364,28,13364,4444924.0,501.0,477.2857142857143,0,0,0.0,0.0,0.0
47570.0,6,14,4740,7,653,7754.666666666667,249.0,93.28571428571428,7,4087,7638.666666666667,1514.0,583.8571428571429
90287060.0,6,16,1192,8,596,12891321.714285716,95.0,74.5,8,596,12897097.857142856,95.0,74.5
90070133.0,17,28,13364,28,13364,3335930.851851852,501.0,477.2857142857143,0,0,0.0,0.0,0.0
121163431.0,6,222,25106,111,7622,1084677.4636363636,140.0,68.66666666666667,111,17484,1093855.3454545457,284.0,157.51351351351352
5622879.0,6,5,336,2,134,0.0,68.0,67.0,3,202,1423104.5,70.0,67.33333333333333
2615200.0,6,3,204,1,68,0.0,68.0,68.0,2,136,0.0,70.0,68.0
280315.0,17,2,180,1,90,0.0,90.0,90.0,1,90,0.0,90.0,90.0
1395896.0,6,7,499,3,198,613852.0,66.0,66.0,4,301,458603.6666666667,103.0,75.25
1308742.0,6,4,264,2,132,0.0,66.0,66.0,2,132,0.0,66.0,66.0
71022.0,6,14,4740,7,653,10396.166666666666,249.0,93.28571428571428,7,4087,11394.5,1514.0,583.8571428571429
2358511.0,6,25,7573,14,3735,181423.92307692303,1514.0,266.7857142857143,11,3838,209964.3,1514.0,348.90909090909093
35331.0,6,10,2032,5,524,7907.5,252.0,104.8,5,1508,8521.0,1236.0,301.6
40079.0,6,14,4740,7,653,5880.333333333333,249.0,93.28571428571428,7,4087,6483.666666666667,1514.0,583.8571428571429
184646.0,17,4,1400,4,1400,61548.66666666666,350.0,350.0,0,0,0.0,0.0,0.0
120452333.0,6,23,1775,10,745,10156334.0,95.0,74.5,13,1030,10016723.083333334,95.0,79.23076923076923
302462.0,6,2,132,1,66,0.0,66.0,66.0,1,66,0.0,66.0,66.0
211983.0,17,2,608,1,75,0.0,75.0,75.0,1,533,0.0,533.0,533.0
879212.0,6,10,1336,6,799,175842.4,461.0,133.16666666666666,4,537,201213.3333333333,331.0,134.25
56957.0,6,14,4740,7,653,9381.0,249.0,93.28571428571428,7,4087,9327.5,1514.0,583.8571428571429
31949.0,6,13,1386,7,789,5324.833333333333,253.0,112.71428571428572,6,597,5222.4,259.0,99.5
135126139.0,17,6,1146,6,1146,27025227.8,191.0,191.0,0,0,0.0,0.0,0.0
108096966.0,17,5,1005,5,1005,27024241.5,201.0,201.0,0,0,0.0,0.0,0.0
1827.0,17,2,684,1,342,0.0,342.0,342.0,1,342,0.0,342.0,342.0
106214209.0,6,30,2106,15,1089,7586729.214285715,123.0,72.6,15,1017,7571281.857142857,123.0,67.8
299.0,17,2,164,1,82,0.0,82.0,82.0,1,82,0.0,82.0,82.0
330.0,17,2,174,1,79,0.0,79.0,79.0,1,95,0.0,95.0,95.0
695327.0,6,6,758,3,410,302671.5,172.0,136.66666666666666,3,348,227785.0,135.0,116.0
172818.0,6,10,1065,5,534,42641.75,262.0,106.8,5,531,2746.0,259.0,106.2
736.0,17,4,438,2,148,0.0,74.0,74.0,2,290,0.0,147.0,145.0
153679.0,17,2,180,1,90,0.0,90.0,90.0,1,90,0.0,90.0,90.0
102059727.0,6,421,56176,211,42094,485998.7,390.0,199.4976303317536,210,14082,487178.014354067,140.0,67.05714285714286
135134598.0,17,6,1206,6,1206,27026919.6,201.0,201.0,0,0,0.0,0.0,0.0
1555065.0,6,4,276,2,128,0.0,74.0,64.0,2,148,0.0,74.0,74.0
101622.0,17,2,700,2,700,0.0,350.0,350.0,0,0,0.0,0.0,0.0
118274480.0,6,209,23618,105,7152,1137254.6153846155,140.0,68.11428571428571,104,16466,1128136.9417475727,284.0,158.32692307692307
304869.0,6,6,412,4,272,101623.0,74.0,68.0,2,140,0.0,74.0,70.0
7289.0,17,2,582,1,83,0.0,83.0,83.0,1,499,0.0,499.0,499.0
90258456.0,6,14,2102,8,1016,12894065.142857144,188.0,127.0,6,1086,18019266.4,204.0,181.0
39023.0,6,14,4740,7,653,5888.0,249.0,93.28571428571428,7,4087,5705.833333333333,1514.0,583.8571428571429
23769.0,6,14,4740,7,653,3840.6666666666665,249.0,93.28571428571428,7,4087,3500.6666666666665,1514.0,583.8571428571429
300247.0,6,6,412,4,272,100082.33333333331,74.0,68.0,2,140,0.0,74.0,70.0
301.0,17,2,168,1,76,0.0,76.0,76.0,1,92,0.0,92.0,92.0
6949.0,17,2,582,1,83,0.0,83.0,83.0,1,499,0.0,499.0,499.0
1847.0,17,5,550,5,550,461.75,110.0,110.0,0,0,0.0,0.0,0.0
139770.0,6,2,132,1,66,0.0,66.0,66.0,1,66,0.0,66.0,66.0
99044910.0,17,12,778,6,389,19801001.4,174.0,64.83333333333333,6,389,19800251.8,174.0,64.83333333333333
311070.0,6,6,412,4,272,103690.0,74.0,68.0,2,140,0.0,74.0,70.0
54142.0,6,13,1479,7,882,9023.666666666666,291.0,126.0,6,597,8904.0,259.0,99.5
299930.0,17,2,246,1,76,0.0,76.0,76.0,1,170,0.0,170.0,170.0
118881809.0,6,34,2334,17,1209,7416622.6875,123.0,71.11764705882354,17,1125,7416623.75,123.0,66.17647058823529
90075257.0,17,28,13364,28,13364,3336120.6296296297,501.0,477.2857142857143,0,0,0.0,0.0,0.0
90528723.0,6,16,2372,8,1016,12932674.714285716,188.0,127.0,8,1356,12909237.57142857,204.0,169.5
37274.0,6,10,2032,5,524,8307.5,252.0,104.8,5,1508,8656.5,1236.0,301.6
2499230.0,6,25,7573,14,3735,192248.4615384616,1514.0,266.7857142857143,11,3838,224413.0,1514.0,348.90909090909093
131394405.0,17,15,1169,8,606,16018529.714285716,174.0,75.75,7,563,21061410.666666668,174.0,80.42857142857143
209459.0,17,2,180,1,90,0.0,90.0,90.0,1,90,0.0,90.0,90.0
135128370.0,17,6,1146,6,1146,27025674.0,191.0,191.0,0,0,0.0,0.0,0.0
375792.0,17,2,363,1,75,0.0,75.0,75.0,1,288,0.0,288.0,288.0
2338.0,17,4,344,2,150,0.0,75.0,75.0,2,194,0.0,103.0,97.0
121914.0,6,3,373,2,238,0.0,172.0,119.0,1,135,0.0,135.0,135.0
135115868.0,17,6,1206,6,1206,27023173.6,201.0,201.0,0,0,0.0,0.0,0.0
216365.0,6,3,426,2,280,0.0,214.0,140.0,1,146,0.0,146.0,146.0
22203.0,6,11,2098,6,590,4044.2,252.0,98.33333333333331,5,1508,3957.75,1236.0,301.6
90290399.0,6,16,1192,8,596,12892050.142857144,95.0,74.5,8,596,12897771.142857144,95.0,74.5
33801.0,6,10,1066,5,490,7777.5,218.0,98.0,5,576,8089.0,304.0,115.2
113610905.0,6,46,3036,23,1518,5150440.045454546,66.0,66.0,23,1518,5150454.590909091,66.0,66.0
307821.0,6,6,412,4,272,102607.0,74.0,68.0,2,140,0.0,74.0,70.0
126001405.0,17,15,907,8,475,18000200.714285713,174.0,59.375,7,432,17667599.166666668,174.0,61.71428571428572
2427.0,17,4,344,2,150,0.0,75.0,75.0,2,194,0.0,103.0,97.0
502207.0,17,3,1026,3,1026,251103.50000000003,342.0,342.0,0,0,0.0,0.0,0.0
280621.0,17,2,365,1,80,0.0,80.0,80.0,1,285,0.0,285.0,285.0
2490.0,17,4,344,2,150,0.0,75.0,75.0,2,194,0.0,103.0,97.0
162300.0,17,2,180,1,90,0.0,90.0,90.0,1,90,0.0,90.0,90.0
90032370.0,17,28,13364,28,13364,3334532.222222222,501.0,477.2857142857143,0,0,0.0,0.0,0.0
209558.0,17,2,180,1,90,0.0,90.0,90.0,1,90,0.0,90.0,90.0
248300.0,17,4,1524,4,1524,82766.66666666667,381.0,381.0,0,0,0.0,0.0,0.0
2790281.0,6,2,132,1,66,0.0,66.0,66.0,1,66,0.0,66.0,66.0
208353.0,6,3,426,2,280,0.0,214.0,140.0,1,146,0.0,146.0,146.0
60744.0,6,10,2032,5,524,14531.25,252.0,104.8,5,1508,13938.0,1236.0,301.6
43039.0,6,10,2032,5,524,9461.5,252.0,104.8,5,1508,10213.0,1236.0,301.6
317639.0,17,4,1400,4,1400,105879.66666666669,350.0,350.0,0,0,0.0,0.0,0.0
446.0,17,2,410,1,78,0.0,78.0,78.0,1,332,0.0,332.0,332.0
121662.0,6,3,337,2,214,0.0,160.0,107.0,1,123,0.0,123.0,123.0
108108861.0,17,5,1005,5,1005,27027215.25,201.0,201.0,0,0,0.0,0.0,0.0
113520302.0,6,46,3036,23,1518,5160002.590909091,66.0,66.0,23,1518,5160002.636363637,66.0,66.0
102423.0,17,2,286,2,286,0.0,143.0,143.0,0,0,0.0,0.0,0.0
143934.0,17,2,180,1,90,0.0,90.0,90.0,1,90,0.0,90.0,90.0
297748.0,6,6,412,4,272,99249.33333333331,74.0,68.0,2,140,0.0,74.0,70.0
303050.0,6,6,412,4,272,101016.66666666669,74.0,68.0,2,140,0.0,74.0,70.0
39323.0,6,14,4740,7,653,5613.833333333333,249.0,93.28571428571428,7,4087,6011.666666666667,1514.0,583.8571428571429
3010197.0,6,12,2172,7,664,501606.6666666667,252.0,94.85714285714286,5,1508,2772.25,1236.0,301.6
106905.0,6,2,132,1,66,0.0,66.0,66.0,1,66,0.0,66.0,66.0
250804.00000000003,17,4,6056,4,6056,83601.33333333334,1514.0,1514.0,0,0,0.0,0.0,0.0
103339.0,17,2,286,2,286,0.0,143.0,143.0,0,0,0.0,0.0,0.0
19515.0,6,10,2032,5,524,4576.75,252.0,104.8,5,1508,4665.25,1236.0,301.6
103908.0,17,2,286,2,286,0.0,143.0,143.0,0,0,0.0,0.0,0.0
319181.0,6,2,132,1,66,0.0,66.0,66.0,1,66,0.0,66.0,66.0
16822.0,6,10,2032,5,524,3117.0,252.0,104.8,5,1508,3754.25,1236.0,301.6
46579473.0,6,7,1874,3,887,21900278.5,753.0,295.6666666666667,4,987,14670598.666666666,785.0,246.75
64766.00000000001,6,14,4740,7,653,10487.5,249.0,93.28571428571428,7,4087,10601.333333333334,1514.0,583.8571428571429
90024380.0,17,27,12943,27,12943,3462476.153846154,501.0,479.3703703703704,0,0,0.0,0.0,0.0
19995022.0,17,3,1034,2,684,0.0,342.0,342.0,1,350,0.0,350.0,350.0
141684.0,17,4,704,2,148,0.0,74.0,74.0,2,556,0.0,280.0,278.0
0.0,17,1,44,1,44,0.0,44.0,44.0,0,0,0.0,0.0,0.0
794.0,17,4,438,2,148,0.0,74.0,74.0,2,290,0.0,147.0,145.0
298353.0,6,6,412,4,272,99451.0,74.0,68.0,2,140,0.0,74.0,70.0
31303.0,6,14,4740,7,653,4072.1666666666665,249.0,93.28571428571428,7,4087,5039.0,1514.0,583.8571428571429
208099.0,17,2,762,2,762,0.0,381.0,381.0,0,0,0.0,0.0,0.0
123839750.0,6,48,3168,24,1584,5014673.478260869,66.0,66.0,24,1584,5282941.0869565215,66.0,66.0
205743.0,17,2,180,1,90,0.0,90.0,90.0,1,90,0.0,90.0,90.0
120014243.0,6,35,2473,18,1348,7059661.352941177,139.0,74.88888888888889,17,1125,7421481.0625,123.0,66.17647058823529
119789065.0,6,19,1436,10,786,13304801.888888888,95.0,78.6,9,650,14973259.375,95.0,72.22222222222223
503579.0,6,5,336,2,134,0.0,68.0,67.0,3,202,192314.5,70.0,67.33333333333333
302.0,17,2,174,1,79,0.0,79.0,79.0,1,95,0.0,95.0,95.0
2022.0,17,4,344,2,150,0.0,75.0,75.0,2,194,0.0,103.0,97.0
113618008.0,6,46,3036,23,1518,5150437.2727272725,66.0,66.0,23,1518,5150438.454545454,66.0,66.0
48194.0,6,14,4740,7,653,7694.166666666667,249.0,93.28571428571428,7,4087,7367.833333333333,1514.0,583.8571428571429
126001606.0,17,15,907,7,432,17668545.333333332,174.0,61.71428571428572,8,475,18000172.714285713,174.0,59.375
90030640.0,17,28,13364,28,13364,3334468.1481481483,501.0,477.2857142857143,0,0,0.0,0.0,0.0
144558.0,17,2,180,1,70,0.0,70.0,70.0,1,110,0.0,110.0,110.0
320.0,17,2,174,1,79,0.0,79.0,79.0,1,95,0.0,95.0,95.0
23494.0,6,10,1949,5,441,5648.75,169.0,88.2,5,1508,5265.0,1236.0,301.6
108107587.0,17,5,1005,5,1005,27026896.75,201.0,201.0,0,0,0.0,0.0,0.0
90756768.0,6,22,1680,12,935,8246891.454545454,95.0,77.91666666666667,10,745,10051440.777777778,95.0,74.5
297425.0,6,6,412,4,272,99141.66666666669,74.0,68.0,2,140,0.0,74.0,70.0
26050.0,6,14,4740,7,653,4220.0,249.0,93.28571428571428,7,4087,4151.0,1514.0,583.8571428571429
311310.0,17,4,1400,4,1400,103770.0,350.0,350.0,0,0,0.0,0.0,0.0
0.0,17,1,55,1,55,0.0,55.0,55.0,0,0,0.0,0.0,0.0
23054.0,6,12,1413,7,882,3842.3333333333335,291.0,126.0,5,531,3543.75,259.0,106.2
203502.0,17,4,6056,4,6056,67834.0,1514.0,1514.0,0,0,0.0,0.0,0.0
315.0,17,2,174,1,79,0.0,79.0,79.0,1,95,0.0,95.0,95.0
43077.0,6,10,2032,5,524,10329.5,252.0,104.8,5,1508,8036.5,1236.0,301.6
37368.0,6,14,4740,7,653,5951.833333333333,249.0,93.28571428571428,7,4087,5799.5,1514.0,583.8571428571429
50884.0,17,2,180,1,90,0.0,90.0,90.0,1,90,0.0,90.0,90.0
250093.0,17,2,180,1,90,0.0,90.0,90.0,1,90,0.0,90.0,90.0
145521.0,17,2,180,1,70,0.0,70.0,70.0,1,110,0.0,110.0,110.0
324.0,17,2,174,1,79,0.0,79.0,79.0,1,95,0.0,95.0,95.0
4362.0,17,2,598,1,72,0.0,72.0,72.0,1,526,0.0,526.0,526.0
228647.0,17,2,180,1,90,0.0,90.0,90.0,1,90,0.0,90.0,90.0
58013.0,6,14,4740,7,653,9547.666666666666,249.0,93.28571428571428,7,4087,9524.5,1514.0,583.8571428571429
115096316.0,6,48,3168,24,1584,5004187.652173913,66.0,66.0,24,1584,4990576.652173913,66.0,66.0
308934.0,6,3,202,2,128,0.0,74.0,64.0,1,74,0.0,74.0,74.0
1028650.0,6,11,1134,6,558,205730.0,220.0,93.0,5,576,256126.0,304.0,115.2
2461.0,17,4,344,2,150,0.0,75.0,75.0,2,194,0.0,103.0,97.0
6709.0,17,2,582,1,83,0.0,83.0,83.0,1,499,0.0,499.0,499.0
316.0,17,2,174,1,79,0.0,79.0,79.0,1,95,0.0,95.0,95.0
104916951.0,17,15,5130,15,5130,7494067.928571428,342.0,342.0,0,0,0.0,0.0,0.0
90056235.0,17,28,13364,28,13364,3335416.111111111,501.0,477.2857142857143,0,0,0.0,0.0,0.0
0.0,17,1,44,1,44,0.0,44.0,44.0,0,0,0.0,0.0,0.0
147954.0,17,2,180,1,90,0.0,90.0,90.0,1,90,0.0,90.0,90.0
18173.0,6,20,7606,11,978,1817.3,310.0,88.9090909090909,9,6628,2118.75,1514.0,736.4444444444445
39625.0,6,14,4740,7,653,6455.333333333333,249.0,93.28571428571428,7,4087,6426.666666666667,1514.0,583.8571428571429
120232290.0,6,24,1829,11,840,11999216.9,95.0,76.36363636363636,13,989,9999162.916666666,95.0,76.07692307692308
5634393.0,6,4,270,2,134,0.0,68.0,67.0,2,136,0.0,70.0,68.0
113520208.0,6,46,3036,23,1518,5159997.181818182,66.0,66.0,23,1518,5159998.2727272725,66.0,66.0
120123909.0,6,15,2428,9,1204,15015488.625,188.0,133.77777777777777,6,1224,18072847.0,204.0,204.0
149089165.0,6,20,1490,11,840,14908916.5,95.0,76.36363636363636,9,650,14883754.125,95.0,72.22222222222223
2304.0,17,4,344,2,150,0.0,75.0,75.0,2,194,0.0,103.0,97.0
119570314.0,6,33,2290,17,1125,7473144.625,123.0,66.17647058823529,16,1165,7291303.4,139.0,72.8125
28220.0,6,10,1067,5,536,6544.75,264.0,107.2,5,531,4729.75,259.0,106.2
62810.00000000001,6,14,4740,7,653,9687.5,249.0,93.28571428571428,7,4087,9446.166666666666,1514.0,583.8571428571429
33310.0,6,10,2032,5,524,7312.0,252.0,104.8,5,1508,7386.25,1236.0,301.6
146256.0,6,3,337,2,214,0.0,160.0,107.0,1,123,0.0,123.0,123.0
2048411.0,17,6,1230,3,234,1024020.5,78.0,78.0,3,996,1023997.0,332.0,332.0
362681.0,6,11,1021,6,444,48698.6,162.0,74.0,5,577,60792.75,349.0,115.4
235206.0,17,2,180,1,90,0.0,90.0,90.0,1,90,0.0,90.0,90.0
97430872.0,17,14,1126,7,563,16167435.5,174.0,80.42857142857143,7,563,16166798.666666666,174.0,80.42857142857143
209648.0,17,2,180,1,90,0.0,90.0,90.0,1,90,0.0,90.0,90.0
48634706.0,6,8,1307,8,1307,6947815.142857143,172.0,163.375,0,0,0.0,0.0,0.0
10465491.0,6,7,478,4,272,3441395.6666666665,74.0,68.0,3,206,5161962.5,74.0,68.66666666666667
109182524.0,17,14,1126,7,563,18170468.83333333,174.0,80.42857142857143,7,563,18170459.5,174.0,80.42857142857143
144042.0,17,2,180,1,90,0.0,90.0,90.0,1,90,0.0,90.0,90.0
2691.0,17,4,344,2,150,0.0,75.0,75.0,2,194,0.0,103.0,97.0
2104.0,17,4,344,2,150,0.0,75.0,75.0,2,194,0.0,103.0,97.0
14657806.0,6,20,1607,10,975,1595834.5555555555,315.0,97.5,10,632,1595805.6666666667,78.0,63.2
357.0,17,2,174,1,79,0.0,79.0,79.0,1,95,0.0,95.0,95.0
539447.0,17,6,2100,6,2100,107889.4,350.0,350.0,0,0,0.0,0.0,0.0
14662815.0,6,20,1607,10,975,1592887.0,315.0,97.5,10,632,1593075.5555555555,78.0,63.2
146134.0,6,3,337,2,214,0.0,160.0,107.0,1,123,0.0,123.0,123.0
268650.0,6,10,1221,6,636,53730.0,298.0,106.0,4,585,83112.33333333333,379.0,146.25
39684.0,6,14,4740,7,653,5738.166666666667,249.0,93.28571428571428,7,4087,6462.166666666667,1514.0,583.8571428571429
135140063.0,17,6,1206,6,1206,27028012.6,201.0,201.0,0,0,0.0,0.0,0.0
119779969.0,6,26,1937,14,1043,9213843.76923077,95.0,74.5,12,894,10865920.454545457,95.0,74.5
3576520.0,6,5,336,2,134,0.0,68.0,67.0,3,202,1423600.5,70.0,67.33333333333333
147752.0,6,3,373,2,238,0.0,172.0,119.0,1,135,0.0,135.0,135.0
28234.0,6,20,7606,11,978,2823.4,310.0,88.9090909090909,9,6628,3361.75,1514.0,736.4444444444445
153485.0,17,2,180,1,90,0.0,90.0,90.0,1,90,0.0,90.0,90.0
321.0,17,2,174,1,79,0.0,79.0,79.0,1,95,0.0,95.0,95.0
2066.0,17,2,180,1,90,0.0,90.0,90.0,1,90,0.0,90.0,90.0
90256434.0,6,13,2036,8,1016,12893776.285714284,188.0,127.0,5,1020,22523170.5,204.0,204.0
32267.0,6,10,2032,5,524,7817.0,252.0,104.8,5,1508,6826.25,1236.0,301.6
1314456.0,6,4,264,2,132,0.0,66.0,66.0,2,132,0.0,66.0,66.0
92982.0,6,14,4740,7,653,15335.333333333334,249.0,93.28571428571428,7,4087,14241.0,1514.0,583.8571428571429
244246.0,6,10,1221,6,636,48849.2,298.0,106.0,4,585,80229.33333333333,379.0,146.25
1555.0,17,5,550,5,550,388.75,110.0,110.0,0,0,0.0,0.0,0.0
107558.0,17,2,286,2,286,0.0,143.0,143.0,0,0,0.0,0.0,0.0
2188304.0,6,19,6869,11,1567,218830.4,408.0,142.45454545454547,8,5302,251030.14285714287,1514.0,662.75
146466.0,6,3,337,2,214,0.0,160.0,107.0,1,123,0.0,123.0,123.0
37773.0,6,10,2032,5,524,7607.0,252.0,104.8,5,1508,8861.5,1236.0,301.6
23549.0,6,10,2032,5,524,5007.0,252.0,104.8,5,1508,5631.5,1236.0,301.6
120363584.0,6,204,23104,102,7040,1183562.8613861387,140.0,69.01960784313725,102,16064,1183661.188118812,284.0,157.49019607843138
307.0,17,2,156,1,78,0.0,78.0,78.0,1,78,0.0,78.0,78.0
12847.0,6,13,1459,7,862,1922.1666666666667,271.0,123.14285714285714,6,597,2336.2,259.0,99.5
153368.0,17,2,180,1,90,0.0,90.0,90.0,1,90,0.0,90.0,90.0
4470.0,17,2,598,1,72,0.0,72.0,72.0,1,526,0.0,526.0,526.0
90048257.0,17,28,13364,28,13364,3335120.6296296297,501.0,477.2857142857143,0,0,0.0,0.0,0.0
114401380.0,6,223,25352,112,7614,1030643.0630630632,140.0,67.98214285714286,111,17738,1030714.8454545456,284.0,159.80180180180182
49625.0,6,14,4740,7,653,7260.5,249.0,93.28571428571428,7,4087,6863.5,1514.0,583.8571428571429
144076.0,17,2,180,1,90,0.0,90.0,90.0,1,90,0.0,90.0,90.0
166508.0,6,3,337,2,214,0.0,160.0,107.0,1,123,0.0,123.0,123.0
216589.0,6,3,426,2,280,0.0,214.0,140.0,1,146,0.0,146.0,146.0
146115.0,6,3,337,2,214,0.0,160.0,107.0,1,123,0.0,123.0,123.0
1169959.0,6,13,3008,8,2380,167137.0,1514.0,297.5,5,628,223614.5,331.0,125.6
242896.0,6,3,337,2,214,0.0,160.0,107.0,1,123,0.0,123.0,123.0
24718826.0,17,5,1718,4,1368,889373.6666666666,342.0,342.0,1,350,0.0,350.0,350.0
107206.0,17,2,286,2,286,0.0,143.0,143.0,0,0,0.0,0.0,0.0
232955.0,6,3,337,2,214,0.0,160.0,107.0,1,123,0.0,123.0,123.0
120075820.0,17,28,13364,28,13364,4447252.592592592,501.0,477.2857142857143,0,0,0.0,0.0,0.0
27278.0,6,10,2032,5,524,6205.75,252.0,104.8,5,1508,6540.75,1236.0,301.6
10464317.0,6,6,412,3,206,5164261.5,74.0,68.66666666666667,3,206,5164164.5,74.0,68.66666666666667
297354.0,6,6,412,4,272,99118.0,74.0,68.0,2,140,0.0,74.0,70.0
94345020.0,6,40,2640,20,1320,4965527.368421053,66.0,66.0,20,1320,4949275.52631579,66.0,66.0
405014.0,6,4,508,2,238,0.0,172.0,119.0,2,270,0.0,135.0,135.0
128819256.0,6,35,2394,18,1269,7577603.294117647,123.0,70.5,17,1125,7413682.375,123.0,66.17647058823529
32789.0,6,14,4740,7,653,5298.833333333333,249.0,93.28571428571428,7,4087,5326.833333333333,1514.0,583.8571428571429
128866750.0,6,38,2716,20,1468,6782460.52631579,139.0,73.4,18,1248,6980352.470588235,123.0,69.33333333333333
301.0,17,2,156,1,78,0.0,78.0,78.0,1,78,0.0,78.0,78.0
138065.0,17,4,1524,4,1524,46021.66666666666,381.0,381.0,0,0,0.0,0.0,0.0
213610.0,17,2,180,1,90,0.0,90.0,90.0,1,90,0.0,90.0,90.0
1315600.0,6,4,264,2,132,0.0,66.0,66.0,2,132,0.0,66.0,66.0
207060.0,6,3,426,2,280,0.0,214.0,140.0,1,146,0.0,146.0,146.0
157680.0,17,2,414,1,88,0.0,88.0,88.0,1,326,0.0,326.0,326.0
113344328.0,6,46,3036,23,1518,5152002.863636363,66.0,66.0,23,1518,5152000.0,66.0,66.0
24343516.0,17,5,1718,4,1368,811205.0,342.0,342.0,1,350,0.0,350.0,350.0
2521496.0,6,3,1604,2,851,0.0,785.0,425.5,1,753,0.0,753.0,753.0
2416.0,17,4,344,2,150,0.0,75.0,75.0,2,194,0.0,103.0,97.0
144179.0,17,2,180,1,90,0.0,90.0,90.0,1,90,0.0,90.0,90.0
120025376.0,17,29,13785,29,13785,4286620.571428572,501.0,475.3448275862069,0,0,0.0,0.0,0.0
138571.0,6,11,1132,6,556,27714.2,218.0,92.66666666666669,5,576,34206.5,304.0,115.2
305638.0,17,4,1524,4,1524,101879.33333333331,381.0,381.0,0,0,0.0,0.0,0.0
217595.0,6,10,1221,6,636,43519.0,298.0,106.0,4,585,71670.33333333333,379.0,146.25
90012948.0,17,28,13364,28,13364,3333812.888888889,501.0,477.2857142857143,0,0,0.0,0.0,0.0
1166925.0,6,13,3004,8,2376,166703.57142857142,1514.0,297.0,5,628,222797.0,331.0,125.6
44371.0,6,13,1394,7,797,7395.166666666667,253.0,113.85714285714286,6,597,7149.8,259.0,99.5
5620527.0,6,5,336,2,134,0.0,68.0,67.0,3,202,1425329.0,70.0,67.33333333333333
27067559.0,17,5,1710,5,1710,6766889.75,342.0,342.0,0,0,0.0,0.0,0.0
156910.0,6,12,1328,7,797,26151.666666666668,253.0,113.85714285714286,5,531,38052.25,259.0,106.2
196827.0,17,2,180,1,90,0.0,90.0,90.0,1,90,0.0,90.0,90.0
216454.0,17,2,180,1,90,0.0,90.0,90.0,1,90,0.0,90.0,90.0
15615.0,17,4,823,2,163,0.0,89.0,81.5,2,660,0.0,443.0,330.0
2015.0,17,4,344,2,150,0.0,75.0,75.0,2,194,0.0,103.0,97.0
146288.0,6,3,337,2,214,0.0,160.0,107.0,1,123,0.0,123.0,123.0
3170006.0,6,18,1495,9,921,357381.875,315.0,102.33333333333331,9,574,357328.875,78.0,63.77777777777778
107176.0,17,2,286,2,286,0.0,143.0,143.0,0,0,0.0,0.0,0.0
17255.0,6,12,1393,6,796,3314.6,271.0,132.66666666666666,6,597,2955.6,259.0,99.5
197039.0,17,2,180,1,90,0.0,90.0,90.0,1,90,0.0,90.0,90.0
90940839.0,6,20,1490,10,745,10104537.666666666,95.0,74.5,10,745,10076142.888888888,95.0,74.5
5005398.0,17,4,849,2,166,0.0,83.0,83.0,2,683,0.0,499.0,341.5
148081.0,6,3,337,2,214,0.0,160.0,107.0,1,123,0.0,123.0,123.0
875520.0,6,10,1336,6,799,175104.0,461.0,133.16666666666666,4,537,200964.0,331.0,134.25
311045.0,6,6,412,4,272,103681.66666666669,74.0,68.0,2,140,0.0,74.0,70.0
41315.0,6,14,4740,7,653,6763.5,249.0,93.28571428571428,7,4087,5538.166666666667,1514.0,583.8571428571429
26900599.0,17,5,1710,5,1710,6725149.75,342.0,342.0,0,0,0.0,0.0,0.0
120004045.0,6,28,3009,14,1503,9230764.615384616,424.0,107.35714285714286,14,1506,9228640.076923076,336.0,107.57142857142856
306483.0,6,6,412,4,272,102161.0,74.0,68.0,2,140,0.0,74.0,70.0
22724.0,6,10,2032,5,524,3858.0,252.0,104.8,5,1508,4882.0,1236.0,301.6
47690.0,6,14,4740,7,653,7680.166666666667,249.0,93.28571428571428,7,4087,7240.166666666667,1514.0,583.8571428571429
1303121.0,6,4,264,2,132,0.0,66.0,66.0,2,132,0.0,66.0,66.0
11885.0,6,10,2032,5,524,2408.0,252.0,104.8,5,1508,2586.0,1236.0,301.6
209939.0,6,4,492,2,280,0.0,214.0,140.0,2,212,0.0,146.0,106.0
148390.0,17,2,414,1,88,0.0,88.0,88.0,1,326,0.0,326.0,326.0
281323.0,17,2,363,1,79,0.0,79.0,79.0,1,284,0.0,284.0,284.0
10480839.0,6,7,478,4,272,3448081.6666666665,74.0,68.0,3,206,5172004.5,74.0,68.66666666666667
307629.0,17,4,704,2,148,0.0,74.0,74.0,2,556,0.0,280.0,278.0
2438.0,17,4,344,2,150,0.0,75.0,75.0,2,194,0.0,103.0,97.0
359.0,17,2,267,1,83,0.0,83.0,83.0,1,184,0.0,184.0,184.0
33930.0,6,14,4740,7,653,4574.166666666667,249.0,93.28571428571428,7,4087,5218.166666666667,1514.0,583.8571428571429
0.0,6,1,66,1,66,0.0,66.0,66.0,0,0,0.0,0.0,0.0
91317418.0,17,12,778,6,389,18201791.4,174.0,64.83333333333333,6,389,18200198.6,174.0,64.83333333333333
108006.0,17,2,286,2,286,0.0,143.0,143.0,0,0,0.0,0.0,0.0
217619.0,6,3,426,2,280,0.0,214.0,140.0,1,146,0.0,146.0,146.0
135133084.0,17,6,1146,6,1146,27026616.8,191.0,191.0,0,0,0.0,0.0,0.0
90279849.0,6,16,1192,8,596,12891127.0,95.0,74.5,8,596,12896617.857142856,95.0,74.5
121452.0,6,3,337,2,214,0.0,160.0,107.0,1,123,0.0,123.0,123.0
140239.0,6,2,132,1,66,0.0,66.0,66.0,1,66,0.0,66.0,66.0
2357.0,17,4,344,2,150,0.0,75.0,75.0,2,194,0.0,103.0,97.0
114630.0,17,4,1400,4,1400,38210.0,350.0,350.0,0,0,0.0,0.0,0.0
106861.0,17,2,286,2,286,0.0,143.0,143.0,0,0,0.0,0.0,0.0
228531.0,17,2,180,1,90,0.0,90.0,90.0,1,90,0.0,90.0,90.0
90064176.0,17,28,13364,28,13364,3335710.222222222,501.0,477.2857142857143,0,0,0.0,0.0,0.0
113344436.0,6,46,3036,23,1518,5152007.681818182,66.0,66.0,23,1518,5152007.863636363,66.0,66.0
103148.0,17,2,286,2,286,0.0,143.0,143.0,0,0,0.0,0.0,0.0
350.0,17,2,250,1,93,0.0,93.0,93.0,1,157,0.0,157.0,157.0
2194.0,17,4,344,2,150,0.0,75.0,75.0,2,194,0.0,103.0,97.0
135138807.0,17,6,1206,6,1206,27027761.4,201.0,201.0,0,0,0.0,0.0,0.0
319530.0,6,6,412,4,272,106510.0,74.0,68.0,2,140,0.0,74.0,70.0
279184.0,17,2,359,1,75,0.0,75.0,75.0,1,284,0.0,284.0,284.0
303.0,17,2,168,1,76,0.0,76.0,76.0,1,92,0.0,92.0,92.0
309672.0,6,6,412,4,272,103224.0,74.0,68.0,2,140,0.0,74.0,70.0
307504.0,6,6,412,4,272,102501.33333333331,74.0,68.0,2,140,0.0,74.0,70.0
90058093.0,17,28,13364,28,13364,3335484.925925926,501.0,477.2857142857143,0,0,0.0,0.0,0.0
90069645.0,6,12,1848,5,1020,22517051.5,204.0,204.0,7,828,15011355.166666666,188.0,118.28571428571428
311985.0,6,6,412,4,272,103995.0,74.0,68.0,2,140,0.0,74.0,70.0
2711338.0,6,3,1604,2,851,0.0,785.0,425.5,1,753,0.0,753.0,753.0
299572.0,6,6,412,4,272,99857.33333333331,74.0,68.0,2,140,0.0,74.0,70.0
1307996.0,6,4,264,2,132,0.0,66.0,66.0,2,132,0.0,66.0,66.0
29885.0,6,14,4740,7,653,4790.333333333333,249.0,93.28571428571428,7,4087,4830.833333333333,1514.0,583.8571428571429
120049650.0,17,28,13364,28,13364,4446283.333333333,501.0,477.2857142857143,0,0,0.0,0.0,0.0
63375.0,6,14,4740,7,653,10373.0,249.0,93.28571428571428,7,4087,10154.833333333334,1514.0,583.8571428571429
234275.0,6,3,337,2,214,0.0,160.0,107.0,1,123,0.0,123.0,123.0
95079902.0,6,174,19666,87,13702,1103079.220930233,284.0,157.49425287356323,87,5964,1103079.1279069767,140.0,68.55172413793103
351.0,17,2,267,1,83,0.0,83.0,83.0,1,184,0.0,184.0,184.0
196768.0,17,2,180,1,90,0.0,90.0,90.0,1,90,0.0,90.0,90.0
90255922.0,6,13,2036,8,1016,12893703.142857144,188.0,127.0,5,1020,22523368.25,204.0,204.0
228320.0,17,2,180,1,90,0.0,90.0,90.0,1,90,0.0,90.0,90.0
108104228.0,17,5,955,5,955,27026057.0,191.0,191.0,0,0,0.0,0.0,0.0
10203.0,6,11,2098,6,590,1922.4,252.0,98.33333333333331,5,1508,2262.0,1236.0,301.6
135130272.0,17,6,1206,6,1206,27026054.4,201.0,201.0,0,0,0.0,0.0,0.0
94484025.0,6,40,2640,20,1320,4972843.421052632,66.0,66.0,20,1320,4961469.631578947,66.0,66.0
120287878.0,6,222,25270,111,7622,1086177.2545454546,140.0,68.66666666666667,111,17648,1086180.0818181818,284.0,158.99099099099098
218272.0,6,3,426,2,280,0.0,214.0,140.0,1,146,0.0,146.0,146.0
260448.0,6,10,1221,6,636,52089.6,298.0,106.0,4,585,81071.33333333333,379.0,146.25
3487549.0,6,7,923,4,753,1090475.0,571.0,188.25,3,170,1636164.0,62.0,56.66666666666666
3017118.0,6,11,2106,6,598,603263.0,252.0,99.66666666666669,5,1508,4609.25,1236.0,301.6
238853.0,6,3,426,2,280,0.0,214.0,140.0,1,146,0.0,146.0,146.0
121204072.0,17,14,864,7,432,17000870.5,174.0,61.71428571428572,7,432,17000228.5,174.0,61.71428571428572
204884.0,17,2,180,1,90,0.0,90.0,90.0,1,90,0.0,90.0,90.0
30699.0,6,13,1386,7,789,4674.833333333333,253.0,112.71428571428572,6,597,5602.6,259.0,99.5
137612.0,6,3,337,2,214,0.0,160.0,107.0,1,123,0.0,123.0,123.0
208197.0,17,4,1524,4,1524,69399.0,381.0,381.0,0,0,0.0,0.0,0.0
4234.0,17,2,626,1,72,0.0,72.0,72.0,1,554,0.0,554.0,554.0
55186.0,6,14,4740,7,653,8459.666666666666,249.0,93.28571428571428,7,4087,8856.833333333334,1514.0,583.8571428571429
216797.0,6,3,426,2,280,0.0,214.0,140.0,1,146,0.0,146.0,146.0
216798.0,6,3,426,2,280,0.0,214.0,140.0,1,146,0.0,146.0,146.0
58808.0,6,14,4740,7,653,9623.666666666666,249.0,93.28571428571428,7,4087,9653.666666666666,1514.0,583.8571428571429
117357214.0,6,30,1974,15,1026,8367282.214285715,123.0,68.4,15,948,8367283.642857143,123.0,63.2
107866.0,17,2,286,2,286,0.0,143.0,143.0,0,0,0.0,0.0,0.0
108104594.0,17,5,955,5,955,27026148.5,191.0,191.0,0,0,0.0,0.0,0.0
103412.0,17,2,286,2,286,0.0,143.0,143.0,0,0,0.0,0.0,0.0
120760624.0,6,31,3663,16,2024,7999964.666666667,425.0,126.5,15,1639,8625030.642857144,335.0,109.26666666666668
91201357.0,6,27,2073,12,935,8291032.454545454,95.0,77.91666666666667,15,1138,6494931.571428572,95.0,75.86666666666666
135128751.0,17,6,1146,6,1146,27025750.2,191.0,191.0,0,0,0.0,0.0,0.0
299638.0,6,6,412,4,272,99879.33333333331,74.0,68.0,2,140,0.0,74.0,70.0
347.0,17,2,267,1,83,0.0,83.0,83.0,1,184,0.0,184.0,184.0
117637066.0,6,33,2290,17,1125,7352316.625,123.0,66.17647058823529,16,1165,7162444.6,139.0,72.8125
10418888.0,6,6,412,3,206,5141454.0,74.0,68.66666666666667,3,206,5141344.0,74.0,68.66666666666667
58445.0,6,14,4740,7,653,8488.166666666666,249.0,93.28571428571428,7,4087,9410.833333333334,1514.0,583.8571428571429
298287.0,6,6,412,4,272,99429.0,74.0,68.0,2,140,0.0,74.0,70.0
2800289.0,6,2,132,1,66,0.0,66.0,66.0,1,66,0.0,66.0,66.0
23626.0,6,10,2032,5,524,4664.25,252.0,104.8,5,1508,5011.25,1236.0,301.6
12324675.0,6,28,9301,15,2193,880333.9285714285,408.0,146.2,13,7108,712477.75,1514.0,546.7692307692307
92359381.0,17,16,5472,16,5472,6157292.066666666,342.0,342.0,0,0,0.0,0.0,0.0
2374.0,17,4,344,2,150,0.0,75.0,75.0,2,194,0.0,103.0,97.0
2594892.0,6,2,132,1,66,0.0,66.0,66.0,1,66,0.0,66.0,66.0
233330.0,6,3,373,2,238,0.0,172.0,119.0,1,135,0.0,135.0,135.0
101160559.0,6,210,23752,105,16600,970628.6826923076,284.0,158.0952380952381,105,7152,970629.0192307692,140.0,68.11428571428571
282401.0,6,10,1221,6,636,56480.2,298.0,106.0,4,585,88281.33333333333,379.0,146.25
805.0,17,4,438,2,148,0.0,74.0,74.0,2,290,0.0,147.0,145.0
20714.0,17,2,582,1,83,0.0,83.0,83.0,1,499,0.0,499.0,499.0
34320.0,6,10,2032,5,524,6743.75,252.0,104.8,5,1508,7948.25,1236.0,301.6
69946.0,6,10,2032,5,524,15036.0,252.0,104.8,5,1508,16044.75,1236.0,301.6
278.0,17,2,156,1,78,0.0,78.0,78.0,1,78,0.0,78.0,78.0
93266704.0,6,40,2640,20,1320,4908773.894736842,66.0,66.0,20,1320,4894273.315789473,66.0,66.0
35720.0,6,13,4416,6,409,6074.4,127.0,68.16666666666667,7,4007,5711.833333333333,1514.0,572.4285714285714
23608.0,6,11,2098,6,590,4647.0,252.0,98.33333333333331,5,1508,5666.25,1236.0,301.6
112478145.0,6,240,27516,120,19374,943386.3697478992,284.0,161.45,120,8142,943386.319327731,140.0,67.85
876.0,17,4,820,2,156,0.0,78.0,78.0,2,664,0.0,332.0,332.0
65640.0,6,14,4740,7,653,10723.166666666666,249.0,93.28571428571428,7,4087,10801.833333333334,1514.0,583.8571428571429
9044.0,17,2,582,1,83,0.0,83.0,83.0,1,499,0.0,499.0,499.0
120122490.0,6,2435,2147674,751,49578,159866.52133333334,78.0,66.01597869507323,1684,2098096,70931.33155080213,1514.0,1245.9002375296911
2790059.0,6,2,132,1,66,0.0,66.0,66.0,1,66,0.0,66.0,66.0
169651.0,6,13,1386,7,789,28275.166666666668,253.0,112.71428571428572,6,597,20207.8,259.0,99.5
90004.0,6,13,1386,7,789,15000.666666666666,253.0,112.71428571428572,6,597,16719.8,259.0,99.5
108095748.0,17,5,1005,5,1005,27023937.0,201.0,201.0,0,0,0.0,0.0,0.0
3477578.0,17,3,1026,3,1026,1738789.0,342.0,342.0,0,0,0.0,0.0,0.0
0.0,6,1,66,1,66,0.0,66.0,66.0,0,0,0.0,0.0,0.0
215294.0,17,2,180,1,90,0.0,90.0,90.0,1,90,0.0,90.0,90.0
90027294.0,17,28,13364,28,13364,3334344.222222222,501.0,477.2857142857143,0,0,0.0,0.0,0.0
119966053.0,17,35,16705,35,16705,3528413.323529412,501.0,477.2857142857143,0,0,0.0,0.0,0.0
119981.0,17,2,180,1,70,0.0,70.0,70.0,1,110,0.0,110.0,110.0
149645.0,17,2,180,1,90,0.0,90.0,90.0,1,90,0.0,90.0,90.0
13031.0,6,11,2098,6,590,2189.6,252.0,98.33333333333331,5,1508,2923.5,1236.0,301.6
91470.0,6,10,2032,5,524,18890.25,252.0,104.8,5,1508,21869.25,1236.0,301.6
90227746.0,6,16,1192,8,596,12855002.57142857,95.0,74.5,8,596,12860326.42857143,95.0,74.5
111998419.0,6,34,2488,18,1348,6575434.411764706,139.0,74.88888888888889,16,1140,7452159.2,123.0,71.25
90255134.0,6,13,1898,8,1016,12893590.57142857,188.0,127.0,5,882,22523127.25,204.0,176.4
1309806.0,6,4,264,2,132,0.0,66.0,66.0,2,132,0.0,66.0,66.0
3079513.0,6,4,270,2,134,0.0,68.0,67.0,2,136,0.0,70.0,68.0
110492479.0,6,32,2220,16,1149,7351774.466666667,123.0,71.8125,16,1071,7351752.8,123.0,66.9375
21920.0,17,2,180,1,90,0.0,90.0,90.0,1,90,0.0,90.0,90.0
171972.0,17,2,180,1,90,0.0,90.0,90.0,1,90,0.0,90.0,90.0
55951.0,6,14,4740,7,653,8978.166666666666,249.0,93.28571428571428,7,4087,7669.666666666667,1514.0,583.8571428571429
23458.0,6,14,4740,7,653,2945.5,249.0,93.28571428571428,7,4087,3750.0,1514.0,583.8571428571429
98159549.0,6,40,2640,20,1320,5166292.052631579,66.0,66.0,20,1320,5150261.736842105,66.0,66.0
135135778.0,17,6,1206,6,1206,27027155.6,201.0,201.0,0,0,0.0,0.0,0.0
2929.0,17,2,224,1,76,0.0,76.0,76.0,1,148,0.0,148.0,148.0
42213.0,6,14,4740,7,653,5931.0,249.0,93.28571428571428,7,4087,6485.833333333333,1514.0,583.8571428571429
608.0,17,2,508,2,508,0.0,257.0,254.0,0,0,0.0,0.0,0.0
851846.0,6,9,1096,6,625,170369.2,287.0,104.16666666666669,3,471,288125.5,331.0,157.0
120509403.0,17,14,864,7,432,16833496.166666668,174.0,61.71428571428572,7,432,16834316.0,174.0,61.71428571428572
275389.0,6,10,1221,6,636,55077.8,298.0,106.0,4,585,86235.0,379.0,146.25
502210.00000000006,6,5,336,2,134,0.0,68.0,67.0,3,202,192015.5,70.0,67.33333333333333
305267.0,6,3,202,2,128,0.0,74.0,64.0,1,74,0.0,74.0,74.0
90008430.0,17,28,13364,28,13364,3333645.5555555555,501.0,477.2857142857143,0,0,0.0,0.0,0.0
221762.0,6,10,1221,6,636,44352.4,298.0,106.0,4,585,72387.0,379.0,146.25
192958.0,17,4,1524,4,1524,64319.333333333336,381.0,381.0,0,0,0.0,0.0,0.0
14645995.0,6,20,1648,10,1016,1592385.7777777778,315.0,101.6,10,632,1592361.7777777778,78.0,63.2
250019.0,6,3,337,2,214,0.0,160.0,107.0,1,123,0.0,123.0,123.0
196975.0,17,2,180,1,90,0.0,90.0,90.0,1,90,0.0,90.0,90.0
135140606.0,17,6,1146,6,1146,27028121.2,191.0,191.0,0,0,0.0,0.0,0.0
108103699.0,17,5,955,5,955,27025924.75,191.0,191.0,0,0,0.0,0.0,0.0
213817.0,6,10,1221,6,636,42763.4,298.0,106.0,4,585,69892.0,379.0,146.25
153420.0,17,2,180,1,90,0.0,90.0,90.0,1,90,0.0,90.0,90.0
1415802.0,17,16,1120,16,1120,94386.8,70.0,70.0,0,0,0.0,0.0,0.0
493449.0,6,4,270,2,134,0.0,68.0,67.0,2,136,0.0,70.0,68.0
15095.0,6,11,2098,6,590,2700.4,252.0,98.33333333333331,5,1508,3433.75,1236.0,301.6
105460.0,17,2,700,2,700,0.0,350.0,350.0,0,0,0.0,0.0,0.0
108103107.0,17,5,1005,5,1005,27025776.75,201.0,201.0,0,0,0.0,0.0,0.0
17453.0,17,2,582,1,83,0.0,83.0,83.0,1,499,0.0,499.0,499.0
8008288.0,17,2,684,2,684,0.0,342.0,342.0,0,0,0.0,0.0,0.0
242035.0,6,3,337,2,214,0.0,160.0,107.0,1,123,0.0,123.0,123.0
117543465.0,6,37,2788,19,1471,6530192.5,139.0,77.42105263157895,18,1317,6901564.294117647,123.0,73.16666666666667
2189729.0,6,25,7610,13,2516,182477.41666666663,1034.0,193.53846153846155,12,5094,170385.63636363635,1510.0,424.5
104194.0,17,2,700,2,700,0.0,350.0,350.0,0,0,0.0,0.0,0.0
135135639.0,17,6,1206,6,1206,27027127.8,201.0,201.0,0,0,0.0,0.0,0.0
121515817.0,6,207,23470,104,16376,1179765.213592233,284.0,157.46153846153845,103,7094,1170967.31372549,140.0,68.87378640776699
191006.0,17,2,180,1,90,0.0,90.0,90.0,1,90,0.0,90.0,90.0
298055.0,6,6,412,4,272,99351.66666666669,74.0,68.0,2,140,0.0,74.0,70.0
391.0,17,2,410,1,78,0.0,78.0,78.0,1,332,0.0,332.0,332.0
859679.0,6,9,1196,6,725,171935.8,387.0,120.83333333333331,3,471,292022.0,331.0,157.0
55553.0,6,10,2032,5,524,13668.25,252.0,104.8,5,1508,12390.25,1236.0,301.6
233928.0,6,3,373,2,238,0.0,172.0,119.0,1,135,0.0,135.0,135.0
233537.0,6,3,337,2,214,0.0,160.0,107.0,1,123,0.0,123.0,123.0
0.0,6,1,54,0,0,0.0,0.0,0.0,1,54,0.0,54.0,54.0
90278801.0,6,16,1192,8,596,12890949.57142857,95.0,74.5,8,596,12895317.42857143,95.0,74.5
120044405.0,17,29,13785,29,13785,4287300.178571428,501.0,475.3448275862069,0,0,0.0,0.0,0.0
40068.0,6,14,4740,7,653,6544.666666666667,249.0,93.28571428571428,7,4087,6427.833333333333,1514.0,583.8571428571429
46441.0,6,14,4740,7,653,7510.833333333333,249.0,93.28571428571428,7,4087,7600.666666666667,1514.0,583.8571428571429
3007625.0,6,168,133062,91,124135,30000.344444444443,1510.0,1364.1208791208792,77,8927,35529.17105263158,1510.0,115.93506493506491
318.0,17,2,174,1,79,0.0,79.0,79.0,1,95,0.0,95.0,95.0
90009612.0,17,28,13364,28,13364,3333689.333333333,501.0,477.2857142857143,0,0,0.0,0.0,0.0
323916.0,6,6,412,4,272,107972.0,74.0,68.0,2,140,0.0,74.0,70.0
110342774.0,17,14,864,7,432,18334161.33333333,174.0,61.71428571428572,7,432,18333490.166666668,174.0,61.71428571428572
104451.0,17,2,700,2,700,0.0,350.0,350.0,0,0,0.0,0.0,0.0
2688.0,17,4,438,2,148,0.0,74.0,74.0,2,290,0.0,147.0,145.0
119993656.0,6,18,1466,9,816,13234330.25,220.0,90.66666666666669,9,650,14968109.5,95.0,72.22222222222223
97057939.0,17,14,1126,7,563,16167786.666666666,174.0,80.42857142857143,7,563,16166815.166666666,174.0,80.42857142857143
135127872.0,17,6,1206,6,1206,27025574.4,201.0,201.0,0,0,0.0,0.0,0.0
301127.0,6,6,412,4,272,100375.66666666669,74.0,68.0,2,140,0.0,74.0,70.0
91648581.0,6,160,18112,80,5502,1136528.7974683545,140.0,68.775,80,12610,1149679.493670886,284.0,157.625
13339.0,6,11,2098,6,590,2640.0,252.0,98.33333333333331,5,1508,2900.75,1236.0,301.6
120003675.0,6,21,1585,10,745,13333741.666666666,95.0,74.5,11,840,11975671.9,95.0,76.36363636363636
90057174.0,17,28,13364,28,13364,3335450.888888889,501.0,477.2857142857143,0,0,0.0,0.0,0.0
90050829.0,17,28,13364,28,13364,3335215.888888889,501.0,477.2857142857143,0,0,0.0,0.0,0.0
239147.0,6,3,337,2,214,0.0,160.0,107.0,1,123,0.0,123.0,123.0
307947.0,6,6,412,4,272,102649.0,74.0,68.0,2,140,0.0,74.0,70.0
2304.0,17,4,344,2,150,0.0,75.0,75.0,2,194,0.0,103.0,97.0
205586.0,17,2,180,1,90,0.0,90.0,90.0,1,90,0.0,90.0,90.0
205850.0,17,2,180,1,90,0.0,90.0,90.0,1,90,0.0,90.0,90.0
97647570.0,6,26,1746,13,906,8119315.916666667,123.0,69.6923076923077,13,840,8119306.333333333,123.0,64.61538461538461
25809.0,6,14,4740,7,653,3662.0,249.0,93.28571428571428,7,4087,3138.5,1514.0,583.8571428571429
528.0,17,2,166,1,75,0.0,75.0,75.0,1,91,0.0,91.0,91.0
2025.0,17,4,344,2,150,0.0,75.0,75.0,2,194,0.0,103.0,97.0
302386.0,6,2,132,1,66,0.0,66.0,66.0,1,66,0.0,66.0,66.0
302427.0,6,2,132,1,66,0.0,66.0,66.0,1,66,0.0,66.0,66.0
23527.0,6,14,4740,7,653,3607.8333333333335,249.0,93.28571428571428,7,4087,3717.8333333333335,1514.0,583.8571428571429
313610.0,17,4,1400,4,1400,104536.66666666669,350.0,350.0,0,0,0.0,0.0,0.0
10899283.0,6,8,544,4,272,3587596.333333333,74.0,68.0,4,272,3587522.6666666665,74.0,68.0
302377.0,6,2,132,1,66,0.0,66.0,66.0,1,66,0.0,66.0,66.0
242686.0,6,3,337,2,214,0.0,160.0,107.0,1,123,0.0,123.0,123.0
99950710.0,6,24,1500,12,783,9066806.363636363,123.0,65.25,12,717,9066791.727272728,123.0,59.75
222621.0,6,4,492,2,280,0.0,214.0,140.0,2,212,0.0,146.0,106.0
10138.0,6,10,2032,5,524,2207.0,252.0,104.8,5,1508,2170.75,1236.0,301.6
2838998.0,6,3,204,2,136,0.0,70.0,68.0,1,68,0.0,68.0,68.0
95671333.0,17,14,4796,13,4446,6229574.166666667,342.0,342.0,1,350,0.0,350.0,350.0
845.0,17,4,438,2,148,0.0,74.0,74.0,2,290,0.0,147.0,145.0
90389205.0,6,12,1848,7,828,15064867.5,188.0,118.28571428571428,5,1020,15090183.25,204.0,204.0
5619425.0,6,4,270,2,134,0.0,68.0,67.0,2,136,0.0,70.0,68.0
214942.0,6,10,1221,6,636,42988.4,298.0,106.0,4,585,70830.66666666667,379.0,146.25
304838.0,6,6,412,4,272,101612.66666666669,74.0,68.0,2,140,0.0,74.0,70.0
296569.0,17,2,180,1,90,0.0,90.0,90.0,1,90,0.0,90.0,90.0
106165932.0,17,14,864,7,432,17666854.5,174.0,61.71428571428572,7,432,17668035.5,174.0,61.71428571428572
1520.0,17,2,762,2,762,0.0,381.0,381.0,0,0,0.0,0.0,0.0
75085761.0,6,9,842,9,842,9385720.125,97.0,93.55555555555556,0,0,0.0,0.0,0.0
143810.0,17,2,180,1,90,0.0,90.0,90.0,1,90,0.0,90.0,90.0
5004903.0,17,4,849,2,166,0.0,83.0,83.0,2,683,0.0,499.0,341.5
206916.0,6,3,426,2,280,0.0,214.0,140.0,1,146,0.0,146.0,146.0
862797.0,6,9,1268,6,797,172559.4,459.0,132.83333333333334,3,471,295146.0,331.0,157.0
315336.0,6,6,412,4,272,105112.0,74.0,68.0,2,140,0.0,74.0,70.0
437250.0,17,4,360,2,140,0.0,70.0,70.0,2,220,0.0,110.0,110.0
130380.0,6,3,337,2,214,0.0,160.0,107.0,1,123,0.0,123.0,123.0
109145139.0,17,14,864,7,432,18167808.166666668,174.0,61.71428571428572,7,432,18166844.33333333,174.0,61.71428571428572
2350.0,17,4,344,2,150,0.0,75.0,75.0,2,194,0.0,103.0,97.0
135139060.0,17,6,1146,6,1146,27027812.0,191.0,191.0,0,0,0.0,0.0,0.0
2248.0,17,4,344,2,150,0.0,75.0,75.0,2,194,0.0,103.0,97.0
93606732.0,6,28,2146,15,1168,6670775.214285715,139.0,77.86666666666666,13,978,7782576.833333333,123.0,75.23076923076923
146308.0,6,3,337,2,214,0.0,160.0,107.0,1,123,0.0,123.0,123.0
90345626.0,6,11,1644,7,828,15057604.333333334,188.0,118.28571428571428,4,816,20109065.0,204.0,204.0
101706.0,17,2,762,2,762,0.0,381.0,381.0,0,0,0.0,0.0,0.0
40400.0,6,11,2098,6,590,6524.0,252.0,98.33333333333331,5,1508,9783.5,1236.0,301.6
114885591.0,6,44,3460,24,1897,4985643.826086956,139.0,79.04166666666667,20,1563,6035253.47368421,123.0,78.15
90045930.0,17,27,12943,27,12943,3463305.0,501.0,479.3703703703704,0,0,0.0,0.0,0.0
119567130.0,6,248,27848,124,19368,970341.0325203252,284.0,156.19354838709677,124,8480,970341.3089430894,140.0,68.38709677419355
205923.0,17,2,180,1,90,0.0,90.0,90.0,1,90,0.0,90.0,90.0
114845762.0,6,48,3168,24,1584,4993294.0,66.0,66.0,24,1584,4983898.347826087,66.0,66.0
178196.0,17,2,180,1,90,0.0,90.0,90.0,1,90,0.0,90.0,90.0
146450.0,6,3,337,2,214,0.0,160.0,107.0,1,123,0.0,123.0,123.0
19313.0,6,10,2032,5,524,4601.75,252.0,104.8,5,1508,4464.25,1236.0,301.6
33128.0,6,14,4740,7,653,5169.166666666667,249.0,93.28571428571428,7,4087,5338.5,1514.0,583.8571428571429
267030.0,17,4,1400,4,1400,89010.0,350.0,350.0,0,0,0.0,0.0,0.0
46486.0,6,14,4740,7,653,5877.666666666667,249.0,93.28571428571428,7,4087,6359.5,1514.0,583.8571428571429
102409.0,17,2,286,2,286,0.0,143.0,143.0,0,0,0.0,0.0,0.0
117023766.0,6,47,3102,24,1584,5078603.260869565,66.0,66.0,23,1518,5105439.0,66.0,66.0
3281.0,17,2,359,1,75,0.0,75.0,75.0,1,284,0.0,284.0,284.0
13717492.0,17,6,2052,6,2052,2743498.4,342.0,342.0,0,0,0.0,0.0,0.0
101613.0,17,2,286,2,286,0.0,143.0,143.0,0,0,0.0,0.0,0.0
739440.0,6,10,1065,5,534,184677.5,262.0,106.8,5,531,184394.0,259.0,106.2
90974420.0,6,186,21104,93,14744,986511.9021739132,300.0,158.53763440860214,93,6360,986395.75,140.0,68.38709677419355
197338.0,17,2,180,1,90,0.0,90.0,90.0,1,90,0.0,90.0,90.0
23696.0,6,10,2032,5,524,5708.25,252.0,104.8,5,1508,5293.25,1236.0,301.6
2427.0,17,2,508,2,508,0.0,257.0,254.0,0,0,0.0,0.0,0.0
2042814.0,6,2,132,1,66,0.0,66.0,66.0,1,66,0.0,66.0,66.0
207039.0,6,3,426,2,280,0.0,214.0,140.0,1,146,0.0,146.0,146.0
119496013.0,6,224,25380,112,17692,1074602.7567567567,284.0,157.96428571428572,112,7688,1074602.5945945946,140.0,68.64285714285714
331824.0,6,6,412,4,272,110608.0,74.0,68.0,2,140,0.0,74.0,70.0
105089.0,17,4,1400,4,1400,35029.666666666664,350.0,350.0,0,0,0.0,0.0,0.0
108108424.0,17,5,955,5,955,27027106.0,191.0,191.0,0,0,0.0,0.0,0.0
90733950.0,6,17,1287,9,691,11334466.875,95.0,76.77777777777777,8,596,12961265.857142856,95.0,74.5
849412.0,6,9,1267,6,796,169882.4,458.0,132.66666666666666,3,471,288378.5,331.0,157.0
15778.0,6,10,2032,5,524,3349.5,252.0,104.8,5,1508,3574.5,1236.0,301.6
116343631.0,6,215,24268,108,7424,1087323.6542056077,140.0,68.74074074074075,107,16844,1087883.216981132,284.0,157.42056074766356
18985.0,6,14,4740,7,653,2919.6666666666665,249.0,93.28571428571428,7,4087,3038.333333333333,1514.0,583.8571428571429
320.0,17,2,174,1,79,0.0,79.0,79.0,1,95,0.0,95.0,95.0
135133612.0,17,6,1146,6,1146,27026722.4,191.0,191.0,0,0,0.0,0.0,0.0
49415.0,6,14,4740,7,653,7633.166666666667,249.0,93.28571428571428,7,4087,8098.833333333333,1514.0,583.8571428571429
120121564.0,6,15,2428,9,1204,15015195.5,188.0,133.77777777777777,6,1224,18018014.6,204.0,204.0
309167.0,6,6,412,4,272,103055.66666666669,74.0,68.0,2,140,0.0,74.0,70.0
29391.0,6,10,2032,5,524,6999.0,252.0,104.8,5,1508,6452.5,1236.0,301.6
135130343.0,17,6,1206,6,1206,27026068.6,201.0,201.0,0,0,0.0,0.0,0.0
28172.0,6,10,2032,5,524,6737.0,252.0,104.8,5,1508,6706.75,1236.0,301.6
96149556.0,6,59,12236,30,6442,3315501.9310344825,1514.0,214.7333333333333,29,5794,3423680.785714286,1514.0,199.79310344827587
70000.0,6,14,4740,7,653,11306.666666666666,249.0,93.28571428571428,7,4087,11212.333333333334,1514.0,583.8571428571429
120670056.0,6,33,2280,17,1209,7541878.5,123.0,71.11764705882354,16,1071,7365187.866666666,123.0,66.9375
1024438.0,6,11,1134,6,558,204887.6,220.0,93.0,5,576,255313.75,304.0,115.2
38284.0,6,14,4740,7,653,6248.666666666667,249.0,93.28571428571428,7,4087,5820.0,1514.0,583.8571428571429
36713.0,6,10,2032,5,524,8841.0,252.0,104.8,5,1508,8539.75,1236.0,301.6
309170.0,6,3,202,2,128,0.0,74.0,64.0,1,74,0.0,74.0,74.0
2010.0,17,4,344,2,150,0.0,75.0,75.0,2,194,0.0,103.0,97.0
55403.0,6,14,4740,7,653,8206.666666666666,249.0,93.28571428571428,7,4087,9096.166666666666,1514.0,583.8571428571429
197466.0,17,4,6056,4,6056,65822.0,1514.0,1514.0,0,0,0.0,0.0,0.0
842.0,17,4,438,2,148,0.0,74.0,74.0,2,290,0.0,147.0,145.0
39824.0,6,14,4740,7,653,5625.833333333333,249.0,93.28571428571428,7,4087,6503.666666666667,1514.0,583.8571428571429
216853.0,17,2,180,1,90,0.0,90.0,90.0,1,90,0.0,90.0,90.0
303218.0,6,6,412,4,272,101072.66666666669,74.0,68.0,2,140,0.0,74.0,70.0
206458.0,17,2,762,2,762,0.0,381.0,381.0,0,0,0.0,0.0,0.0
196927.0,17,2,180,1,90,0.0,90.0,90.0,1,90,0.0,90.0,90.0
217731.0,6,3,426,2,280,0.0,214.0,140.0,1,146,0.0,146.0,146.0
1175097.0,6,4,545,3,410,587548.5,172.0,136.66666666666666,1,135,0.0,135.0,135.0
2667.0,17,4,344,2,150,0.0,75.0,75.0,2,194,0.0,103.0,97.0
300.0,17,2,164,1,82,0.0,82.0,82.0,1,82,0.0,82.0,82.0
110778.0,17,2,286,2,286,0.0,143.0,143.0,0,0,0.0,0.0,0.0
110968689.0,6,37,2788,19,1471,6152936.277777778,139.0,77.42105263157895,18,1317,6514875.0,123.0,73.16666666666667
229608.0,17,4,1524,4,1524,76536.0,381.0,381.0,0,0,0.0,0.0,0.0
146040.0,6,3,337,2,214,0.0,160.0,107.0,1,123,0.0,123.0,123.0
108244.0,17,2,286,2,286,0.0,143.0,143.0,0,0,0.0,0.0,0.0
108098728.0,17,5,1005,5,1005,27024682.0,201.0,201.0,0,0,0.0,0.0,0.0
239675.0,6,3,373,2,238,0.0,172.0,119.0,1,135,0.0,135.0,135.0
104639.0,17,2,700,2,700,0.0,350.0,350.0,0,0,0.0,0.0,0.0
49368.0,6,10,2032,5,524,12039.25,252.0,104.8,5,1508,11666.75,1236.0,301.6
101560456.0,17,13,821,7,432,16667471.666666666,174.0,61.71428571428572,6,389,20000196.0,174.0,64.83333333333333
328.0,17,2,166,1,75,0.0,75.0,75.0,1,91,0.0,91.0,91.0
1012144.0,6,2,140,2,140,0.0,70.0,70.0,0,0,0.0,0.0,0.0
135134343.0,17,6,1146,6,1146,27026868.6,191.0,191.0,0,0,0.0,0.0,0.0
122286059.0,6,31,2050,16,1102,8152403.933333334,139.0,68.875,15,948,8006896.785714285,123.0,63.2
121617.0,6,3,337,2,214,0.0,160.0,107.0,1,123,0.0,123.0,123.0
217569.0,6,3,426,2,280,0.0,214.0,140.0,1,146,0.0,146.0,146.0
204937.0,17,2,180,1,90,0.0,90.0,90.0,1,90,0.0,90.0,90.0
304179.0,6,6,412,4,272,101393.0,74.0,68.0,2,140,0.0,74.0,70.0
4290.0,17,2,602,1,72,0.0,72.0,72.0,1,530,0.0,530.0,530.0
114483007.0,6,48,3168,24,1584,4977522.043478261,66.0,66.0,24,1584,4968120.043478261,66.0,66.0
249663.0,17,4,6056,4,6056,83221.0,1514.0,1514.0,0,0,0.0,0.0,0.0
5497.0,17,4,344,2,150,0.0,75.0,75.0,2,194,0.0,103.0,97.0
409.0,17,2,410,1,78,0.0,78.0,78.0,1,332,0.0,332.0,332.0
316381.0,17,4,1400,4,1400,105460.33333333331,350.0,350.0,0,0,0.0,0.0,0.0
135128968.0,17,6,1206,6,1206,27025793.6,201.0,201.0,0,0,0.0,0.0,0.0
120025.0,17,2,180,1,70,0.0,70.0,70.0,1,110,0.0,110.0,110.0
10309.0,6,2,177,1,123,0.0,123.0,123.0,1,54,0.0,54.0,54.0
143892.0,17,2,180,1,90,0.0,90.0,90.0,1,90,0.0,90.0,90.0
2599053.0,6,2,132,1,66,0.0,66.0,66.0,1,66,0.0,66.0,66.0
77346.0,6,14,4740,7,653,11935.333333333334,249.0,93.28571428571428,7,4087,12672.0,1514.0,583.8571428571429
67531.0,6,14,4740,7,653,11087.666666666666,249.0,93.28571428571428,7,4087,10506.0,1514.0,583.8571428571429
39826.0,6,10,2032,5,524,9734.25,252.0,104.8,5,1508,9482.0,1236.0,301.6
5014136.0,17,4,1164,2,166,0.0,83.0,83.0,2,998,0.0,499.0,499.0
110706989.0,6,30,1990,15,1042,7892226.642857143,139.0,69.46666666666667,15,948,7892226.357142857,123.0,63.2
23326.0,6,10,1065,5,534,5400.75,262.0,106.8,5,531,5173.0,259.0,106.2
90015265.0,17,28,13364,28,13364,3333898.703703704,501.0,477.2857142857143,0,0,0.0,0.0,0.0
115708077.0,6,47,3102,24,1584,5030775.173913044,66.0,66.0,23,1518,5143998.818181818,66.0,66.0
108108076.0,17,5,1005,5,1005,27027019.0,201.0,201.0,0,0,0.0,0.0,0.0
308312.0,6,6,412,4,272,102770.66666666669,74.0,68.0,2,140,0.0,74.0,70.0
170509.0,6,10,1065,5,534,42202.25,262.0,106.8,5,531,3006.5,259.0,106.2
148015.0,17,2,180,1,90,0.0,90.0,90.0,1,90,0.0,90.0,90.0
149073.0,17,2,414,1,88,0.0,88.0,88.0,1,326,0.0,326.0,326.0
14082.0,6,14,4740,7,653,2236.0,249.0,93.28571428571428,7,4087,2211.333333333333,1514.0,583.8571428571429
308511.0,6,6,412,4,272,102837.0,74.0,68.0,2,140,0.0,74.0,70.0
216980.0,6,3,426,2,280,0.0,214.0,140.0,1,146,0.0,146.0,146.0
90249283.0,6,13,2036,8,1016,12892754.714285716,188.0,127.0,5,1020,22521765.0,204.0,204.0
108681484.0,6,32,2220,16,1149,7231052.133333334,123.0,71.8125,16,1071,7231052.4,123.0,66.9375
10518998.0,6,7,478,4,272,3461000.333333333,74.0,68.0,3,206,5191359.0,74.0,68.66666666666667
5767890.0,6,38,3291,17,1386,360493.125,170.0,81.52941176470588,21,1905,266241.6,497.0,90.71428571428572
304109.0,6,6,412,4,272,101369.66666666669,74.0,68.0,2,140,0.0,74.0,70.0
11913.0,6,11,2098,6,590,2223.2,252.0,98.33333333333331,5,1508,2486.25,1236.0,301.6
54933.0,6,14,4740,7,653,9033.0,249.0,93.28571428571428,7,4087,7292.5,1514.0,583.8571428571429
1561416.0,6,19,7533,10,1403,173490.66666666666,583.0,140.3,9,6130,163802.125,1484.0,681.1111111111111
12025.0,6,11,1131,6,600,2097.8,262.0,100.0,5,531,2664.25,259.0,106.2
3052625.0,6,3,204,2,136,0.0,70.0,68.0,1,68,0.0,68.0,68.0
202948.0,6,10,1221,6,636,40589.6,298.0,106.0,4,585,66482.33333333333,379.0,146.25
108120775.0,17,5,955,5,955,27030193.75,191.0,191.0,0,0,0.0,0.0,0.0
9416.0,17,2,539,1,86,0.0,86.0,86.0,1,453,0.0,453.0,453.0
302225.0,6,6,412,4,272,100741.66666666669,74.0,68.0,2,140,0.0,74.0,70.0
116203826.0,17,16,1212,8,606,16577845.42857143,174.0,75.75,8,606,16576193.142857144,174.0,75.75
118344677.0,6,279,32414,140,22944,851400.5539568345,284.0,163.88571428571427,139,9470,852153.0724637681,140.0,68.12949640287769
38103.0,6,14,4740,7,653,6157.833333333333,249.0,93.28571428571428,7,4087,6139.833333333333,1514.0,583.8571428571429
113520005.0,6,46,3036,23,1518,5159989.0,66.0,66.0,23,1518,5159987.5,66.0,66.0
90287860.0,6,21,1585,11,840,9023894.3,95.0,76.36363636363636,10,745,10001456.333333334,95.0,74.5
419.0,17,2,508,2,508,0.0,257.0,254.0,0,0,0.0,0.0,0.0
330.0,17,2,166,1,75,0.0,75.0,75.0,1,91,0.0,91.0,91.0
10466178.0,6,7,478,4,272,3443077.333333333,74.0,68.0,3,206,5164493.5,74.0,68.66666666666667
34612.0,6,14,4740,7,653,5458.0,249.0,93.28571428571428,7,4087,5520.0,1514.0,583.8571428571429
14896.0,17,2,180,1,90,0.0,90.0,90.0,1,90,0.0,90.0,90.0
813.0,17,2,762,2,762,0.0,381.0,381.0,0,0,0.0,0.0,0.0
1120386.0,6,6,406,2,134,0.0,68.0,67.0,4,272,333433.6666666667,70.0,68.0
95802485.0,6,174,19650,87,5964,1113982.3837209302,140.0,68.55172413793103,87,13686,1111561.5813953488,284.0,157.31034482758622
854.0,17,5,550,5,550,213.5,110.0,110.0,0,0,0.0,0.0,0.0
112492321.0,6,30,1990,15,1042,8019751.428571428,139.0,69.46666666666667,15,948,8019751.428571428,123.0,63.2
103538527.0,6,33,2497,16,1209,6902568.466666667,123.0,75.5625,17,1288,6457597.4375,139.0,75.76470588235294
120240.0,6,12,1320,7,789,20040.0,253.0,112.71428571428572,5,531,27633.25,259.0,106.2
37820.0,6,14,4740,7,653,5785.5,249.0,93.28571428571428,7,4087,5608.166666666667,1514.0,583.8571428571429
103122.0,17,2,286,2,286,0.0,143.0,143.0,0,0,0.0,0.0,0.0
238125.0,6,3,426,2,280,0.0,214.0,140.0,1,146,0.0,146.0,146.0
65262.0,6,14,4740,7,653,10743.166666666666,249.0,93.28571428571428,7,4087,9169.0,1514.0,583.8571428571429
354070.0,6,3,204,2,136,0.0,70.0,68.0,1,68,0.0,68.0,68.0
316583.0,17,4,1400,4,1400,105527.66666666669,350.0,350.0,0,0,0.0,0.0,0.0
149763.0,17,2,180,1,90,0.0,90.0,90.0,1,90,0.0,90.0,90.0
215517.0,17,2,180,1,90,0.0,90.0,90.0,1,90,0.0,90.0,90.0
16745.0,6,14,4740,7,653,2560.333333333333,249.0,93.28571428571428,7,4087,2624.0,1514.0,583.8571428571429
209409.0,6,12,1373,7,714,34901.5,298.0,102.0,5,659,51188.75,379.0,131.8
118923612.0,6,36,2596,18,1348,6982799.294117647,139.0,74.88888888888889,18,1248,6982799.94117647,123.0,69.33333333333333
304191.0,6,6,412,4,272,101397.0,74.0,68.0,2,140,0.0,74.0,70.0
228154.0,17,2,180,1,90,0.0,90.0,90.0,1,90,0.0,90.0,90.0
41268.0,6,10,2032,5,524,10044.25,252.0,104.8,5,1508,9621.75,1236.0,301.6
153511.0,17,2,180,1,90,0.0,90.0,90.0,1,90,0.0,90.0,90.0
116532463.0,6,48,3168,24,1584,5066628.826086956,66.0,66.0,24,1584,5053208.869565218,66.0,66.0
108106669.0,17,5,1005,5,1005,27026667.25,201.0,201.0,0,0,0.0,0.0,0.0
90021322.0,17,28,13364,28,13364,3334123.037037037,501.0,477.2857142857143,0,0,0.0,0.0,0.0
149765.0,17,4,704,2,148,0.0,74.0,74.0,2,556,0.0,280.0,278.0
115265162.0,6,48,3168,24,1584,5011528.782608695,66.0,66.0,24,1584,4998196.217391305,66.0,66.0
14979.0,6,11,1133,6,602,2519.8,264.0,100.33333333333331,5,531,3176.75,259.0,106.2
116101.0,17,4,1400,4,1400,38700.333333333336,350.0,350.0,0,0,0.0,0.0,0.0
255670.0,17,4,1400,4,1400,85223.33333333333,350.0,350.0,0,0,0.0,0.0,0.0
97084945.0,6,184,20866,92,14572,1064502.8241758242,374.0,158.3913043478261,92,6294,1064500.3846153845,140.0,68.41304347826087
2843262.0,6,160,126681,86,117952,29874.235294117647,1510.0,1371.5348837209303,74,8729,34785.53424657534,1510.0,117.95945945945944
18817.0,6,2,145,2,145,0.0,91.0,72.5,0,0,0.0,0.0,0.0
120321511.0,6,220,24868,110,7556,1096301.3027522936,140.0,68.69090909090909,110,17312,1096220.7981651376,284.0,157.38181818181818
18173.0,6,14,4740,7,653,2759.0,249.0,93.28571428571428,7,4087,2896.0,1514.0,583.8571428571429
108103409.0,17,5,1005,5,1005,27025852.25,201.0,201.0,0,0,0.0,0.0,0.0
104463.0,17,2,286,2,286,0.0,143.0,143.0,0,0,0.0,0.0,0.0
145096.0,17,2,180,1,70,0.0,70.0,70.0,1,110,0.0,110.0,110.0
14638.0,6,14,4740,7,653,2319.333333333333,249.0,93.28571428571428,7,4087,2298.6666666666665,1514.0,583.8571428571429
325.0,17,2,174,1,79,0.0,79.0,79.0,1,95,0.0,95.0,95.0
315163.0,17,4,1400,4,1400,105054.33333333331,350.0,350.0,0,0,0.0,0.0,0.0
1045837.0,6,11,1134,6,558,209167.4,220.0,93.0,5,576,260348.75,304.0,115.2
42769.0,6,14,4740,7,653,6016.666666666667,249.0,93.28571428571428,7,4087,6769.666666666667,1514.0,583.8571428571429
21558.0,6,10,2032,5,524,4344.5,252.0,104.8,5,1508,4873.5,1236.0,301.6
120014639.0,6,20,1615,10,745,13333332.222222222,95.0,74.5,10,870,13333951.333333334,220.0,87.0
115130388.0,6,48,3168,24,1584,5005669.043478261,66.0,66.0,24,1584,4991995.826086956,66.0,66.0
138454.0,6,2,132,1,66,0.0,66.0,66.0,1,66,0.0,66.0,66.0
314.0,17,2,164,1,82,0.0,82.0,82.0,1,82,0.0,82.0,82.0
8863.0,17,4,438,2,148,0.0,74.0,74.0,2,290,0.0,147.0,145.0
113386196.0,6,34,2350,17,1225,7073126.375,139.0,72.05882352941177,17,1125,7073134.9375,123.0,66.17647058823529
1307874.0,17,7,490,7,490,217979.0,70.0,70.0,0,0,0.0,0.0,0.0
146280.0,6,3,337,2,214,0.0,160.0,107.0,1,123,0.0,123.0,123.0
317.0,17,2,174,1,79,0.0,79.0,79.0,1,95,0.0,95.0,95.0
25660.0,6,10,2032,5,524,6186.0,252.0,104.8,5,1508,5418.75,1236.0,301.6
2044.0,17,4,344,2,150,0.0,75.0,75.0,2,194,0.0,103.0,97.0
23131.0,6,10,2032,5,524,5537.5,252.0,104.8,5,1508,5192.0,1236.0,301.6
10497483.0,6,7,478,4,272,3453685.333333333,74.0,68.0,3,206,5180448.0,74.0,68.66666666666667
234517.0,6,3,373,2,238,0.0,172.0,119.0,1,135,0.0,135.0,135.0
22438.0,6,14,4740,7,653,3612.6666666666665,249.0,93.28571428571428,7,4087,3551.833333333333,1514.0,583.8571428571429
10881045.0,6,8,544,4,272,3581585.0,74.0,68.0,4,272,3581511.333333333,74.0,68.0
135134795.0,17,6,1206,6,1206,27026959.0,201.0,201.0,0,0,0.0,0.0,0.0
205782.0,17,2,180,1,90,0.0,90.0,90.0,1,90,0.0,90.0,90.0
543298.0,6,5,1736,2,819,0.0,753.0,409.5,3,917,199389.5,785.0,305.6666666666667
1175776.0,6,13,3004,8,2376,167968.0,1514.0,297.0,5,628,224986.0,331.0,125.6
144610.0,17,2,180,1,70,0.0,70.0,70.0,1,110,0.0,110.0,110.0
876938.0,6,10,1336,6,799,175387.6,461.0,133.16666666666666,4,537,200443.66666666663,331.0,134.25
291252.0,6,10,1221,6,636,58250.4,298.0,106.0,4,585,90103.66666666669,379.0,146.25
863220.0,6,9,1196,6,725,172644.0,387.0,120.83333333333331,3,471,293778.5,331.0,157.0
120233694.0,6,19,1395,10,745,13332916.222222222,95.0,74.5,9,650,14998747.375,95.0,72.22222222222223
113168250.0,6,46,3036,23,1518,5144000.590909091,66.0,66.0,23,1518,5143999.318181818,66.0,66.0
5002144.0,17,4,629,2,156,0.0,78.0,78.0,2,473,0.0,268.0,236.5
14640056.0,6,20,1607,10,975,1592780.888888889,315.0,97.5,10,632,1592760.3333333333,78.0,63.2
144771.0,17,2,180,1,70,0.0,70.0,70.0,1,110,0.0,110.0,110.0
3783171.0,6,5,336,2,134,0.0,68.0,67.0,3,202,1529405.0,70.0,67.33333333333333
2077.0,17,4,344,2,150,0.0,75.0,75.0,2,194,0.0,103.0,97.0
33178.0,6,10,2032,5,524,7628.0,252.0,104.8,5,1508,6838.5,1236.0,301.6
24967.0,6,14,4740,7,653,3716.3333333333335,249.0,93.28571428571428,7,4087,4023.6666666666665,1514.0,583.8571428571429
120037293.0,6,23,1734,11,840,12003729.3,95.0,76.36363636363636,12,894,10889651.545454543,95.0,74.5
333.0,17,2,174,1,79,0.0,79.0,79.0,1,95,0.0,95.0,95.0
0.0,17,1,179,1,179,0.0,179.0,179.0,0,0,0.0,0.0,0.0
503241.00000000006,6,5,336,2,134,0.0,68.0,67.0,3,202,192210.5,70.0,67.33333333333333
4077.0,17,2,582,1,83,0.0,83.0,83.0,1,499,0.0,499.0,499.0
54639.0,6,14,4740,7,653,8509.5,249.0,93.28571428571428,7,4087,8965.333333333334,1514.0,583.8571428571429
135139606.0,17,6,1206,6,1206,27027921.2,201.0,201.0,0,0,0.0,0.0,0.0
41850.0,6,14,4740,7,653,4387.5,249.0,93.28571428571428,7,4087,6712.5,1514.0,583.8571428571429
135118215.0,17,6,1146,6,1146,27023643.0,191.0,191.0,0,0,0.0,0.0,0.0
5831137.0,6,5,336,2,134,0.0,68.0,67.0,3,202,1523789.0,70.0,67.33333333333333
2198.0,17,4,344,2,150,0.0,75.0,75.0,2,194,0.0,103.0,97.0
149071772.0,6,20,1490,11,840,14907177.2,95.0,76.36363636363636,9,650,14918872.25,95.0,72.22222222222223
207517.0,6,3,426,2,280,0.0,214.0,140.0,1,146,0.0,146.0,146.0
23414.0,6,14,4740,7,653,3570.6666666666665,249.0,93.28571428571428,7,4087,3373.0,1514.0,583.8571428571429
119968494.0,6,237,26816,119,18732,1016682.1525423728,284.0,157.41176470588235,118,8084,1020326.47008547,140.0,68.50847457627118
60919.0,6,10,1065,5,534,14387.25,262.0,106.8,5,531,13406.5,259.0,106.2
121065183.0,6,228,25846,114,7820,1055979.7876106196,140.0,68.59649122807018,114,18026,1055013.389380531,284.0,158.12280701754386
352.0,17,2,267,1,83,0.0,83.0,83.0,1,184,0.0,184.0,184.0
2460.0,17,4,344,2,150,0.0,75.0,75.0,2,194,0.0,103.0,97.0
58909.0,6,10,1065,5,534,13944.5,262.0,106.8,5,531,14175.25,259.0,106.2
108292583.0,17,14,864,7,432,18000952.666666668,174.0,61.71428571428572,7,432,18000161.5,174.0,61.71428571428572
313817.0,17,4,1400,4,1400,104605.66666666669,350.0,350.0,0,0,0.0,0.0,0.0
146895.0,6,3,373,2,238,0.0,172.0,119.0,1,135,0.0,135.0,135.0
315073.0,6,3,202,2,128,0.0,74.0,64.0,1,74,0.0,74.0,74.0
21673.0,6,14,4740,7,653,3479.1666666666665,249.0,93.28571428571428,7,4087,3004.0,1514.0,583.8571428571429
872471.0,6,9,1269,6,798,174494.2,460.0,133.0,3,471,297120.5,331.0,157.0
35511.0,6,14,4740,7,653,5318.833333333333,249.0,93.28571428571428,7,4087,5360.166666666667,1514.0,583.8571428571429
90288869.0,6,16,1192,8,596,12891992.714285716,95.0,74.5,8,596,12896575.714285716,95.0,74.5
3163173.0,6,14,4740,7,653,526167.5,249.0,93.28571428571428,7,4087,527058.6666666666,1514.0,583.8571428571429
120026741.0,17,29,13785,29,13785,4286669.321428572,501.0,475.3448275862069,0,0,0.0,0.0,0.0
91383096.0,6,22,1680,12,935,8307022.727272727,95.0,77.91666666666667,10,745,10152571.222222222,95.0,74.5
0.0,17,1,179,1,179,0.0,179.0,179.0,0,0,0.0,0.0,0.0
316437.0,6,6,412,4,272,105479.0,74.0,68.0,2,140,0.0,74.0,70.0
9163.0,17,2,539,1,86,0.0,86.0,86.0,1,453,0.0,453.0,453.0
103244301.0,6,15,2340,15,2340,7374592.928571428,156.0,156.0,0,0,0.0,0.0,0.0
21458.0,17,2,582,1,83,0.0,83.0,83.0,1,499,0.0,499.0,499.0
5694.0,17,4,823,2,163,0.0,89.0,81.5,2,660,0.0,443.0,330.0
815.0,17,4,438,2,148,0.0,74.0,74.0,2,290,0.0,147.0,145.0
92990.0,17,2,762,2,762,0.0,381.0,381.0,0,0,0.0,0.0,0.0
10515067.0,6,7,478,4,272,3459507.6666666665,74.0,68.0,3,206,5189192.5,74.0,68.66666666666667
142168.0,6,2,132,1,66,0.0,66.0,66.0,1,66,0.0,66.0,66.0
110096846.0,6,28,1860,14,966,8452370.76923077,123.0,69.0,14,894,8452368.923076924,123.0,63.85714285714285
8730.0,6,10,1066,5,490,2016.25,218.0,98.0,5,576,1979.5,304.0,115.2
201651.0,17,2,180,1,90,0.0,90.0,90.0,1,90,0.0,90.0,90.0
90059597.0,17,28,13364,28,13364,3335540.6296296297,501.0,477.2857142857143,0,0,0.0,0.0,0.0
120122582.0,6,15,2290,9,1204,15015322.75,188.0,133.77777777777777,6,1086,18027238.4,204.0,181.0
5370291.0,6,16,2322,7,1093,500607.0,581.0,156.14285714285714,9,1229,644271.25,733.0,136.55555555555554
2432.0,17,2,762,2,762,0.0,381.0,381.0,0,0,0.0,0.0,0.0
56620.0,6,10,1065,5,534,13939.75,262.0,106.8,5,531,2266.75,259.0,106.2
144264.0,17,4,704,2,148,0.0,74.0,74.0,2,556,0.0,280.0,278.0
142767.0,17,4,571,2,148,0.0,74.0,74.0,2,423,0.0,276.0,211.5
1152932.0,6,13,3010,8,2382,164704.57142857142,1514.0,297.75,5,628,220048.25,331.0,125.6
2794555.0,6,2,132,1,66,0.0,66.0,66.0,1,66,0.0,66.0,66.0
44038.0,6,14,4740,7,653,7147.5,249.0,93.28571428571428,7,4087,7069.833333333333,1514.0,583.8571428571429
110985075.0,6,30,1974,15,1026,7912102.071428572,123.0,68.4,15,948,7912092.285714285,123.0,63.2
108123662.0,17,5,1005,5,1005,27030915.5,201.0,201.0,0,0,0.0,0.0,0.0
74533.0,6,12,1328,7,797,12422.166666666666,253.0,113.85714285714286,5,531,16945.0,259.0,106.2
217569.0,6,3,426,2,280,0.0,214.0,140.0,1,146,0.0,146.0,146.0
10514237.0,6,7,478,4,272,3459163.6666666665,74.0,68.0,3,206,5188643.5,74.0,68.66666666666667
10879.0,6,13,1459,7,862,1643.1666666666667,271.0,123.14285714285714,6,597,2023.0,259.0,99.5
298341.0,6,6,412,4,272,99447.0,74.0,68.0,2,140,0.0,74.0,70.0
45127.0,6,10,2032,5,524,9476.5,252.0,104.8,5,1508,10715.5,1236.0,301.6
90255431.0,6,14,2240,8,1016,12893633.0,188.0,127.0,6,1224,18018516.4,204.0,204.0
0.0,17,1,72,1,72,0.0,72.0,72.0,0,0,0.0,0.0,0.0
371208.0,6,10,1221,6,636,74241.6,298.0,106.0,4,585,105254.33333333331,379.0,146.25
44389.0,6,14,4740,7,653,6819.0,249.0,93.28571428571428,7,4087,7258.5,1514.0,583.8571428571429
147980.0,17,2,180,1,90,0.0,90.0,90.0,1,90,0.0,90.0,90.0
108746.0,17,2,286,2,286,0.0,143.0,143.0,0,0,0.0,0.0,0.0
113610366.0,6,46,3036,23,1518,5150434.454545454,66.0,66.0,23,1518,5150438.636363637,66.0,66.0
2796212.0,6,2,132,1,66,0.0,66.0,66.0,1,66,0.0,66.0,66.0
100200282.0,17,12,778,6,389,20040056.4,174.0,64.83333333333333,6,389,19844548.4,174.0,64.83333333333333
52864.0,6,14,4740,7,653,8016.833333333333,249.0,93.28571428571428,7,4087,8245.833333333334,1514.0,583.8571428571429
46011.0,6,14,4740,7,653,6873.333333333333,249.0,93.28571428571428,7,4087,5901.5,1514.0,583.8571428571429
103630.0,17,2,286,2,286,0.0,143.0,143.0,0,0,0.0,0.0,0.0
108105208.0,17,5,955,5,955,27026302.0,191.0,191.0,0,0,0.0,0.0,0.0
44981.0,6,10,2032,5,524,10945.75,252.0,104.8,5,1508,10770.25,1236.0,301.6
10463833.0,6,7,478,4,272,3442318.333333333,74.0,68.0,3,206,5163410.0,74.0,68.66666666666667
3192.0,17,2,363,1,79,0.0,79.0,79.0,1,284,0.0,284.0,284.0
34063.0,6,14,4740,7,653,5552.0,249.0,93.28571428571428,7,4087,5542.5,1514.0,583.8571428571429
4414.0,17,2,614,1,72,0.0,72.0,72.0,1,542,0.0,542.0,542.0
29089.0,6,10,2032,5,524,6990.5,252.0,104.8,5,1508,6381.0,1236.0,301.6
344749.0,17,4,704,2,148,0.0,74.0,74.0,2,556,0.0,280.0,278.0
1306996.0,6,4,264,2,132,0.0,66.0,66.0,2,132,0.0,66.0,66.0
144545.0,17,2,180,1,70,0.0,70.0,70.0,1,110,0.0,110.0,110.0
236898.0,6,3,337,2,214,0.0,160.0,107.0,1,123,0.0,123.0,123.0
406790.0,6,3,1604,1,753,0.0,753.0,753.0,2,851,0.0,785.0,425.5
102367.0,17,2,286,2,286,0.0,143.0,143.0,0,0,0.0,0.0,0.0
90018894.0,17,27,12943,27,12943,3462265.153846154,501.0,479.3703703703704,0,0,0.0,0.0,0.0
19305.0,17,2,180,1,90,0.0,90.0,90.0,1,90,0.0,90.0,90.0
40277.0,6,14,4740,7,653,6543.333333333333,249.0,93.28571428571428,7,4087,6073.666666666667,1514.0,583.8571428571429
120579730.0,6,229,25800,115,17980,1057716.929824561,284.0,156.34782608695653,114,7820,1048786.6194690266,140.0,68.59649122807018
123602.0,6,13,1394,7,797,20600.33333333333,253.0,113.85714285714286,6,597,22447.6,259.0,99.5
108118658.0,17,5,955,5,955,27029664.5,191.0,191.0,0,0,0.0,0.0,0.0
103747.0,17,2,286,2,286,0.0,143.0,143.0,0,0,0.0,0.0,0.0
108112014.0,17,5,1005,5,1005,27028003.5,201.0,201.0,0,0,0.0,0.0,0.0
56008.0,6,14,4740,7,653,9209.5,249.0,93.28571428571428,7,4087,8189.0,1514.0,583.8571428571429
8983.0,17,2,582,1,83,0.0,83.0,83.0,1,499,0.0,499.0,499.0
140971.0,6,2,132,1,66,0.0,66.0,66.0,1,66,0.0,66.0,66.0
24626.0,6,11,2098,6,590,4023.0,252.0,98.33333333333331,5,1508,5918.5,1236.0,301.6
14999.0,6,14,4740,7,653,2380.0,249.0,93.28571428571428,7,4087,2105.1666666666665,1514.0,583.8571428571429
109506.0,17,4,1400,4,1400,36502.0,350.0,350.0,0,0,0.0,0.0,0.0
14637359.0,6,20,1648,10,1016,1592558.7777777778,315.0,101.6,10,632,1592532.6666666667,78.0,63.2
254270.0,6,3,426,2,280,0.0,214.0,140.0,1,146,0.0,146.0,146.0
120073593.0,6,240,27120,120,8142,1002096.3697478992,140.0,67.85,120,18978,1001688.8823529412,284.0,158.15
36251.0,6,14,4740,7,653,5646.833333333333,249.0,93.28571428571428,7,4087,5897.333333333333,1514.0,583.8571428571429
135135392.0,17,6,1146,6,1146,27027078.4,191.0,191.0,0,0,0.0,0.0,0.0
90308174.0,6,16,1192,8,596,12893375.57142857,95.0,74.5,8,596,12899761.142857144,95.0,74.5
307419.0,6,6,412,4,272,102473.0,74.0,68.0,2,140,0.0,74.0,70.0
121953.0,6,4,439,2,238,0.0,172.0,119.0,2,201,0.0,135.0,100.5
44068.0,6,14,4740,7,653,7224.666666666667,249.0,93.28571428571428,7,4087,6620.5,1514.0,583.8571428571429
63429.0,17,2,180,1,90,0.0,90.0,90.0,1,90,0.0,90.0,90.0
120089719.0,17,28,13364,28,13364,4447767.37037037,501.0,477.2857142857143,0,0,0.0,0.0,0.0
293.0,17,2,164,1,82,0.0,82.0,82.0,1,82,0.0,82.0,82.0
37559.0,6,14,4740,7,653,5776.666666666667,249.0,93.28571428571428,7,4087,5965.0,1514.0,583.8571428571429
25566.0,6,14,4740,7,653,4120.166666666667,249.0,93.28571428571428,7,4087,4104.666666666667,1514.0,583.8571428571429
108107572.0,17,5,955,5,955,27026893.0,191.0,191.0,0,0,0.0,0.0,0.0
135129665.0,17,6,1146,6,1146,27025933.0,191.0,191.0,0,0,0.0,0.0,0.0
217220.0,6,3,426,2,280,0.0,214.0,140.0,1,146,0.0,146.0,146.0
24075466.0,17,3,1034,2,684,0.0,342.0,342.0,1,350,0.0,350.0,350.0
45219.0,6,14,4740,7,653,7069.166666666667,249.0,93.28571428571428,7,4087,7145.0,1514.0,583.8571428571429
116316576.0,17,14,864,7,432,19333806.5,174.0,61.71428571428572,7,432,19333493.83333333,174.0,61.71428571428572
120060770.0,17,28,13364,28,13364,4446695.185185186,501.0,477.2857142857143,0,0,0.0,0.0,0.0
2591926.0,6,2,132,1,66,0.0,66.0,66.0,1,66,0.0,66.0,66.0
102569781.0,17,14,864,7,432,17001401.333333332,174.0,61.71428571428572,7,432,17000156.333333332,174.0,61.71428571428572
20067.0,17,2,582,1,83,0.0,83.0,83.0,1,499,0.0,499.0,499.0
507727.00000000006,6,5,336,2,134,0.0,68.0,67.0,3,202,193166.0,70.0,67.33333333333333
90364948.0,6,12,1848,5,1020,22590957.75,204.0,204.0,7,828,15059720.666666666,188.0,118.28571428571428
0.0,6,1,160,1,160,0.0,160.0,160.0,0,0,0.0,0.0,0.0
153419.0,17,2,180,1,90,0.0,90.0,90.0,1,90,0.0,90.0,90.0
108102666.0,17,5,1005,5,1005,27025666.5,201.0,201.0,0,0,0.0,0.0,0.0
216245.0,17,2,180,1,90,0.0,90.0,90.0,1,90,0.0,90.0,90.0
23241.0,6,14,4740,7,653,3753.0,249.0,93.28571428571428,7,4087,3290.833333333333,1514.0,583.8571428571429
245836.0,6,3,337,2,214,0.0,160.0,107.0,1,123,0.0,123.0,123.0
209994.0,17,2,180,1,90,0.0,90.0,90.0,1,90,0.0,90.0,90.0
90293277.0,6,19,1436,10,745,10027327.777777778,95.0,74.5,9,691,11283162.125,95.0,76.77777777777777
135134066.0,17,6,1206,6,1206,27026813.2,201.0,201.0,0,0,0.0,0.0,0.0
108103619.0,17,5,1005,5,1005,27025904.75,201.0,201.0,0,0,0.0,0.0,0.0
31360.0,6,10,2032,5,524,6594.25,252.0,104.8,5,1508,5875.5,1236.0,301.6
121352.0,6,3,337,2,214,0.0,160.0,107.0,1,123,0.0,123.0,123.0
298262.0,6,6,412,4,272,99420.66666666669,74.0,68.0,2,140,0.0,74.0,70.0
14958.0,17,2,180,1,90,0.0,90.0,90.0,1,90,0.0,90.0,90.0
316149.0,17,4,1400,4,1400,105383.0,350.0,350.0,0,0,0.0,0.0,0.0
2334.0,17,4,344,2,150,0.0,75.0,75.0,2,194,0.0,103.0,97.0
119049018.0,6,48,3168,24,1584,5176044.260869565,66.0,66.0,24,1584,5166647.434782608,66.0,66.0
763.0,17,4,438,2,148,0.0,74.0,74.0,2,290,0.0,147.0,145.0
70106.0,6,14,4740,7,653,11459.166666666666,249.0,93.28571428571428,7,4087,11504.0,1514.0,583.8571428571429
12029013.0,17,5,2265,5,2265,3007253.25,453.0,453.0,0,0,0.0,0.0,0.0
22284.0,6,10,2032,5,524,4782.0,252.0,104.8,5,1508,5256.5,1236.0,301.6
19593.0,6,10,2032,5,524,4671.75,252.0,104.8,5,1508,4172.25,1236.0,301.6
10456084.0,6,7,478,4,272,3440016.0,74.0,68.0,3,206,5159924.0,74.0,68.66666666666667
153360.0,17,2,180,1,90,0.0,90.0,90.0,1,90,0.0,90.0,90.0
44179.0,6,10,2032,5,524,10593.5,252.0,104.8,5,1508,8865.25,1236.0,301.6
345929.0,17,2,180,1,90,0.0,90.0,90.0,1,90,0.0,90.0,90.0
219372.0,6,4,492,2,280,0.0,214.0,140.0,2,212,0.0,146.0,106.0
238011.0,17,2,180,1,90,0.0,90.0,90.0,1,90,0.0,90.0,90.0
35579.0,6,14,4740,7,653,4917.166666666667,249.0,93.28571428571428,7,4087,5386.833333333333,1514.0,583.8571428571429
108083947.0,17,5,1005,5,1005,27020986.75,201.0,201.0,0,0,0.0,0.0,0.0
103168.0,17,2,286,2,286,0.0,143.0,143.0,0,0,0.0,0.0,0.0
8588.0,6,11,2098,6,590,1639.8,252.0,98.33333333333331,5,1508,1874.0,1236.0,301.6
26164.0,6,14,4740,7,653,4183.333333333333,249.0,93.28571428571428,7,4087,4126.0,1514.0,583.8571428571429
108112295.0,17,5,1005,5,1005,27028073.75,201.0,201.0,0,0,0.0,0.0,0.0
10726.0,6,10,1067,5,536,2501.5,264.0,107.2,5,531,2121.25,259.0,106.2
249810.0,17,4,6056,4,6056,83270.0,1514.0,1514.0,0,0,0.0,0.0,0.0
159367.0,6,3,337,2,214,0.0,160.0,107.0,1,123,0.0,123.0,123.0
157831.0,17,2,180,1,90,0.0,90.0,90.0,1,90,0.0,90.0,90.0
336.0,17,2,166,1,75,0.0,75.0,75.0,1,91,0.0,91.0,91.0
232249.0,6,3,337,2,214,0.0,160.0,107.0,1,123,0.0,123.0,123.0
303052.0,6,2,132,1,66,0.0,66.0,66.0,1,66,0.0,66.0,66.0
120124123.0,6,15,2428,9,1204,15015515.375,188.0,133.77777777777777,6,1224,18072545.6,204.0,204.0
869937.0,6,9,1096,6,625,173987.4,287.0,104.16666666666669,3,471,297124.0,331.0,157.0
9763.0,17,2,582,1,83,0.0,83.0,83.0,1,499,0.0,499.0,499.0
96175516.0,6,55,12138,30,6559,3316397.103448276,1514.0,218.63333333333333,25,5579,3996284.9583333335,1514.0,223.16
108115612.0,17,5,1005,5,1005,27028903.0,201.0,201.0,0,0,0.0,0.0,0.0
241404.0,6,3,337,2,214,0.0,160.0,107.0,1,123,0.0,123.0,123.0
1321340.0,6,4,264,2,132,0.0,66.0,66.0,2,132,0.0,66.0,66.0
221238.0,17,2,414,1,88,0.0,88.0,88.0,1,326,0.0,326.0,326.0
113168173.0,6,46,3036,23,1518,5143996.727272728,66.0,66.0,23,1518,5143996.318181818,66.0,66.0
122230074.0,6,216,24440,108,7350,1092555.1495327102,140.0,68.05555555555556,108,17090,1125022.906542056,284.0,158.24074074074073
108105348.0,17,5,1005,5,1005,27026337.0,201.0,201.0,0,0,0.0,0.0,0.0
135133638.0,17,6,1206,6,1206,27026727.6,201.0,201.0,0,0,0.0,0.0,0.0
216878.0,6,3,426,2,280,0.0,214.0,140.0,1,146,0.0,146.0,146.0
34571.0,6,2,145,2,145,0.0,91.0,72.5,0,0,0.0,0.0,0.0
109160.0,17,2,762,2,762,0.0,381.0,381.0,0,0,0.0,0.0,0.0
64325.99999999999,6,14,4740,7,653,10536.666666666666,249.0,93.28571428571428,7,4087,8987.5,1514.0,583.8571428571429
1163163.0,6,13,3003,8,2375,166166.14285714287,1514.0,296.875,5,628,221854.25,331.0,125.6
3156.0,17,2,762,2,762,0.0,381.0,381.0,0,0,0.0,0.0,0.0
1746975.0,17,8,1640,4,312,582199.6666666666,78.0,78.0,4,1328,582185.6666666666,332.0,332.0
14602.0,6,10,1067,5,536,3304.25,264.0,107.2,5,531,2925.25,259.0,106.2
90191946.0,6,14,1964,8,1016,12884563.714285716,188.0,127.0,6,948,18005628.0,204.0,158.0
108407.0,17,2,286,2,286,0.0,143.0,143.0,0,0,0.0,0.0,0.0
120300160.0,6,650,121070,331,99498,364545.9393939394,1514.0,300.59818731117826,319,21572,375371.0534591195,214.0,67.62382445141066
216060.0,6,3,426,2,280,0.0,214.0,140.0,1,146,0.0,146.0,146.0
90019354.0,17,28,13364,28,13364,3334050.1481481483,501.0,477.2857142857143,0,0,0.0,0.0,0.0
1156655.0,6,13,3000,8,2372,165236.42857142858,1514.0,296.5,5,628,220970.75,331.0,125.6
222231.0,6,3,426,2,280,0.0,214.0,140.0,1,146,0.0,146.0,146.0
4515.0,17,2,614,1,72,0.0,72.0,72.0,1,542,0.0,542.0,542.0
16413.0,17,4,823,2,163,0.0,89.0,81.5,2,660,0.0,443.0,330.0
101397380.0,17,13,821,7,432,16899563.333333332,174.0,61.71428571428572,6,389,16516612.6,174.0,64.83333333333333
144880.0,17,2,180,1,70,0.0,70.0,70.0,1,110,0.0,110.0,110.0
146189.0,6,3,337,2,214,0.0,160.0,107.0,1,123,0.0,123.0,123.0
321205.0,17,4,1400,4,1400,107068.33333333331,350.0,350.0,0,0,0.0,0.0,0.0
130593.0,6,3,337,2,214,0.0,160.0,107.0,1,123,0.0,123.0,123.0
122001303.0,17,15,907,8,475,17428757.57142857,174.0,59.375,7,432,16996998.166666668,174.0,61.71428571428572
319637.0,6,3,1604,1,753,0.0,753.0,753.0,2,851,0.0,785.0,425.5
306632.0,6,6,412,4,272,102210.66666666669,74.0,68.0,2,140,0.0,74.0,70.0
306969.0,6,6,412,4,272,102323.0,74.0,68.0,2,140,0.0,74.0,70.0
311432.0,6,6,412,4,272,103810.66666666669,74.0,68.0,2,140,0.0,74.0,70.0
2234767.0,6,19,6869,10,1501,248307.44444444444,408.0,150.1,9,5368,235702.125,1514.0,596.4444444444445
10820017.0,6,7,478,3,206,5341978.5,74.0,68.66666666666667,4,272,3561246.6666666665,74.0,68.0
47425.0,6,10,1065,5,534,11387.25,262.0,106.8,5,531,9803.0,259.0,106.2
1308353.0,17,7,490,7,490,218058.8333333333,70.0,70.0,0,0,0.0,0.0,0.0
145341.0,6,3,337,2,214,0.0,160.0,107.0,1,123,0.0,123.0,123.0
309632.0,6,6,412,4,272,103210.66666666669,74.0,68.0,2,140,0.0,74.0,70.0
302359.0,6,2,132,1,66,0.0,66.0,66.0,1,66,0.0,66.0,66.0
306142.0,6,6,412,4,272,102047.33333333331,74.0,68.0,2,140,0.0,74.0,70.0
302462.0,6,2,132,1,66,0.0,66.0,66.0,1,66,0.0,66.0,66.0
90040203.0,17,28,13364,28,13364,3334822.333333333,501.0,477.2857142857143,0,0,0.0,0.0,0.0
223672.0,6,3,426,2,280,0.0,214.0,140.0,1,146,0.0,146.0,146.0
228205.0,17,2,180,1,90,0.0,90.0,90.0,1,90,0.0,90.0,90.0
1883526.0,6,23,6509,12,1529,171229.63636363635,357.0,127.41666666666669,11,4980,157374.8,1510.0,452.7272727272728
24065.0,6,14,4740,7,653,3896.1666666666665,249.0,93.28571428571428,7,4087,3290.333333333333,1514.0,583.8571428571429
108101780.0,17,5,955,5,955,27025445.0,191.0,191.0,0,0,0.0,0.0,0.0
47589.0,6,14,4740,7,653,7536.333333333333,249.0,93.28571428571428,7,4087,6804.5,1514.0,583.8571428571429
99766.0,17,2,762,2,762,0.0,381.0,381.0,0,0,0.0,0.0,0.0
120120985.0,6,14,2224,9,1204,15015123.125,188.0,133.77777777777777,5,1020,22522644.0,204.0,204.0
4960.0,17,4,344,2,150,0.0,75.0,75.0,2,194,0.0,103.0,97.0
93130284.0,6,40,2640,20,1320,4901593.894736842,66.0,66.0,20,1320,4890215.842105263,66.0,66.0
20735.0,6,14,4740,7,653,3296.333333333333,249.0,93.28571428571428,7,4087,2882.0,1514.0,583.8571428571429
49326.0,6,10,2032,5,524,10143.25,252.0,104.8,5,1508,11469.0,1236.0,301.6
90290938.0,6,16,1192,8,596,12892154.142857144,95.0,74.5,8,596,12897764.57142857,95.0,74.5
90254572.0,6,12,1832,8,1016,12893510.285714284,188.0,127.0,4,816,30029755.33333333,204.0,204.0
152099.0,17,2,414,1,88,0.0,88.0,88.0,1,326,0.0,326.0,326.0
113834128.0,6,33,2296,17,1225,7101131.8125,139.0,72.05882352941177,16,1071,7574541.733333333,123.0,66.9375
99615.0,17,2,762,2,762,0.0,381.0,381.0,0,0,0.0,0.0,0.0
328.0,17,2,166,1,75,0.0,75.0,75.0,1,91,0.0,91.0,91.0
211789.0,6,3,426,2,280,0.0,214.0,140.0,1,146,0.0,146.0,146.0
23584.0,6,14,4740,7,653,3343.1666666666665,249.0,93.28571428571428,7,4087,3789.5,1514.0,583.8571428571429
309796.0,6,6,412,4,272,103265.33333333331,74.0,68.0,2,140,0.0,74.0,70.0
49623.0,6,14,4740,7,653,8150.5,249.0,93.28571428571428,7,4087,7511.333333333333,1514.0,583.8571428571429
137541.0,6,2,132,1,66,0.0,66.0,66.0,1,66,0.0,66.0,66.0
97628517.0,6,40,2640,20,1320,5138343.0,66.0,66.0,20,1320,5121798.52631579,66.0,66.0
207256.0,6,3,426,2,280,0.0,214.0,140.0,1,146,0.0,146.0,146.0
198658.0,17,2,180,1,90,0.0,90.0,90.0,1,90,0.0,90.0,90.0
97743.0,17,2,762,2,762,0.0,381.0,381.0,0,0,0.0,0.0,0.0
1437822.0,6,7,499,4,301,474753.0,103.0,75.25,3,198,614005.5,66.0,66.0
302099.0,6,6,412,4,272,100699.66666666669,74.0,68.0,2,140,0.0,74.0,70.0
10931916.0,6,8,544,4,272,3598723.0,74.0,68.0,4,272,3590827.333333333,74.0,68.0
2222132.0,6,25,7611,13,2516,185177.66666666663,1034.0,193.53846153846155,12,5095,173113.36363636365,1510.0,424.5833333333333
120124347.0,6,13,2036,5,1020,30031086.75,204.0,204.0,8,1016,17136984.14285714,188.0,127.0
108729.0,17,2,286,2,286,0.0,143.0,143.0,0,0,0.0,0.0,0.0
143864.0,17,2,180,1,90,0.0,90.0,90.0,1,90,0.0,90.0,90.0
233385.0,6,3,337,2,214,0.0,160.0,107.0,1,123,0.0,123.0,123.0
2003.0,17,4,344,2,150,0.0,75.0,75.0,2,194,0.0,103.0,97.0
120000046.0,6,23,2029,13,989,10000003.833333334,95.0,76.07692307692308,10,1040,11020777.222222222,222.0,104.0
1055976.0,6,13,1386,7,789,175996.0,253.0,112.71428571428572,6,597,209551.6,259.0,99.5
1875.0,17,4,344,2,150,0.0,75.0,75.0,2,194,0.0,103.0,97.0
16055982.0,17,6,2052,6,2052,3211196.4,342.0,342.0,0,0,0.0,0.0,0.0
33975.0,6,14,4740,7,653,5312.166666666667,249.0,93.28571428571428,7,4087,5139.666666666667,1514.0,583.8571428571429
15830.0,6,10,2032,5,524,3063.0,252.0,104.8,5,1508,3660.5,1236.0,301.6
14135104.0,17,6,2052,6,2052,2827020.8,342.0,342.0,0,0,0.0,0.0,0.0
146253.0,6,3,337,2,214,0.0,160.0,107.0,1,123,0.0,123.0,123.0
92113649.0,6,38,2508,19,1254,5105431.277777778,66.0,66.0,19,1254,5105433.166666667,66.0,66.0
108113471.0,17,5,1005,5,1005,27028367.75,201.0,201.0,0,0,0.0,0.0,0.0
323021.0,17,4,1400,4,1400,107673.66666666669,350.0,350.0,0,0,0.0,0.0,0.0
1435837.0,17,16,1120,16,1120,95722.46666666666,70.0,70.0,0,0,0.0,0.0,0.0
297585.0,6,6,412,4,272,99195.0,74.0,68.0,2,140,0.0,74.0,70.0
5835135.0,6,5,336,2,134,0.0,68.0,67.0,3,202,1523792.5,70.0,67.33333333333333
1635211.0,6,7,499,4,301,484591.6666666667,103.0,75.25,3,198,717261.0,66.0,66.0
310795.0,17,4,1400,4,1400,103598.33333333331,350.0,350.0,0,0,0.0,0.0,0.0
320.0,17,2,174,1,79,0.0,79.0,79.0,1,95,0.0,95.0,95.0
33707284.0,6,5,336,2,134,0.0,68.0,67.0,3,202,16780970.0,70.0,67.33333333333333
205846.0,17,2,762,2,762,0.0,381.0,381.0,0,0,0.0,0.0,0.0
54277.0,6,12,1328,7,797,9046.166666666666,253.0,113.85714285714286,5,531,11802.0,259.0,106.2
143885.0,17,2,180,1,90,0.0,90.0,90.0,1,90,0.0,90.0,90.0
251249.0,6,3,337,2,214,0.0,160.0,107.0,1,123,0.0,123.0,123.0
135129428.0,17,6,1146,6,1146,27025885.6,191.0,191.0,0,0,0.0,0.0,0.0
123001234.0,17,15,907,8,475,17571604.85714286,174.0,59.375,7,432,17167600.833333332,174.0,61.71428571428572
308108.0,6,6,412,4,272,102702.66666666669,74.0,68.0,2,140,0.0,74.0,70.0
241699.0,17,2,762,2,762,0.0,381.0,381.0,0,0,0.0,0.0,0.0
135134872.0,17,6,1146,6,1146,27026974.4,191.0,191.0,0,0,0.0,0.0,0.0
167668.0,17,2,180,1,90,0.0,90.0,90.0,1,90,0.0,90.0,90.0
90528900.0,6,15,2444,8,1016,12932700.0,188.0,127.0,7,1428,15060449.0,204.0,204.0
1245.0,17,2,762,2,762,0.0,381.0,381.0,0,0,0.0,0.0,0.0
90257590.0,6,12,1832,8,1016,12893941.42857143,188.0,127.0,4,816,30029700.33333333,204.0,204.0
314952.0,17,4,1400,4,1400,104984.0,350.0,350.0,0,0,0.0,0.0,0.0
277444.0,17,2,363,1,79,0.0,79.0,79.0,1,284,0.0,284.0,284.0
31513.0,6,10,2032,5,524,7536.25,252.0,104.8,5,1508,7088.0,1236.0,301.6
409.0,17,2,410,1,78,0.0,78.0,78.0,1,332,0.0,332.0,332.0
26168.0,6,10,2032,5,524,6332.5,252.0,104.8,5,1508,6165.75,1236.0,301.6
207726.0,6,3,426,2,280,0.0,214.0,140.0,1,146,0.0,146.0,146.0
2344.0,17,4,344,2,150,0.0,75.0,75.0,2,194,0.0,103.0,97.0
42549.0,6,14,4740,7,653,6969.333333333333,249.0,93.28571428571428,7,4087,6956.666666666667,1514.0,583.8571428571429
2233279.0,6,26,7677,15,2648,159519.92857142858,1034.0,176.53333333333333,11,5029,192182.1,1510.0,457.1818181818182
3574057.0,6,5,336,2,134,0.0,68.0,67.0,3,202,1421798.0,70.0,67.33333333333333
0.0,6,1,60,1,60,0.0,60.0,60.0,0,0,0.0,0.0,0.0
115975480.0,6,48,3168,24,1584,5042412.173913044,66.0,66.0,24,1584,5029113.652173913,66.0,66.0
13933194.0,6,20,1607,10,975,1514426.5555555555,315.0,97.5,10,632,1514357.7777777778,78.0,63.2
2346902.0,6,25,7573,14,3735,180530.92307692303,1514.0,266.7857142857143,11,3838,209080.1,1514.0,348.90909090909093
117636397.0,6,330,39756,165,28644,715982.1646341464,284.0,173.6,165,11112,715982.4512195121,140.0,67.34545454545454
228256.0,17,2,180,1,90,0.0,90.0,90.0,1,90,0.0,90.0,90.0
5617394.0,6,4,270,2,134,0.0,68.0,67.0,2,136,0.0,70.0,68.0
108102165.0,17,5,1005,5,1005,27025541.25,201.0,201.0,0,0,0.0,0.0,0.0
152681.0,17,2,414,1,88,0.0,88.0,88.0,1,326,0.0,326.0,326.0
1207983.0,17,7,490,7,490,201330.5,70.0,70.0,0,0,0.0,0.0,0.0
235127.0,6,3,373,2,238,0.0,172.0,119.0,1,135,0.0,135.0,135.0
51933.0,6,10,2032,5,524,11491.5,252.0,104.8,5,1508,10902.5,1236.0,301.6
153550.0,17,2,180,1,90,0.0,90.0,90.0,1,90,0.0,90.0,90.0
218592.0,6,3,426,2,280,0.0,214.0,140.0,1,146,0.0,146.0,146.0
135121082.0,17,6,1206,6,1206,27024216.4,201.0,201.0,0,0,0.0,0.0,0.0
24409.0,6,11,1132,6,556,4378.0,218.0,92.66666666666669,5,576,5479.0,304.0,115.2
434631.0,6,3,1604,2,851,0.0,785.0,425.5,1,753,0.0,753.0,753.0
2873187.0,6,3,204,2,134,0.0,68.0,67.0,1,70,0.0,70.0,70.0
242715.0,6,3,337,2,214,0.0,160.0,107.0,1,123,0.0,123.0,123.0
315883.0,6,6,412,4,272,105294.33333333331,74.0,68.0,2,140,0.0,74.0,70.0
30871.0,6,10,2032,5,524,7502.75,252.0,104.8,5,1508,6700.5,1236.0,301.6
544146.0,17,6,2100,6,2100,108829.2,350.0,350.0,0,0,0.0,0.0,0.0
10515254.0,6,7,478,4,272,3457896.333333333,74.0,68.0,3,206,5186766.5,74.0,68.66666666666667
109005285.0,17,13,821,7,432,18167547.5,174.0,61.71428571428572,6,389,17716747.2,174.0,64.83333333333333
103707.0,17,2,286,2,286,0.0,143.0,143.0,0,0,0.0,0.0,0.0
217689.0,6,3,426,2,280,0.0,214.0,140.0,1,146,0.0,146.0,146.0
250631.0,17,4,6056,4,6056,83543.66666666667,1514.0,1514.0,0,0,0.0,0.0,0.0
135127064.0,17,6,1146,6,1146,27025412.8,191.0,191.0,0,0,0.0,0.0,0.0
5615980.0,6,4,270,2,134,0.0,68.0,67.0,2,136,0.0,70.0,68.0
64727.99999999999,6,10,1065,5,534,13928.5,262.0,106.8,5,531,12786.5,259.0,106.2
96681643.0,6,26,1746,13,906,8039723.666666667,123.0,69.6923076923077,13,840,8039726.25,123.0,64.61538461538461
827.0,17,4,438,2,148,0.0,74.0,74.0,2,290,0.0,147.0,145.0
48719.0,6,14,4740,7,653,7649.666666666667,249.0,93.28571428571428,7,4087,7126.0,1514.0,583.8571428571429
19714.0,6,10,1065,5,534,4405.0,262.0,106.8,5,531,3326.75,259.0,106.2
108097576.0,17,5,1005,5,1005,27024394.0,201.0,201.0,0,0,0.0,0.0,0.0
212568.0,6,10,1221,6,636,42513.6,298.0,106.0,4,585,69604.33333333333,379.0,146.25
294198.0,6,6,412,4,272,98066.0,74.0,68.0,2,140,0.0,74.0,70.0
114101116.0,6,48,3168,24,1584,4960918.0869565215,66.0,66.0,24,1584,4948935.521739131,66.0,66.0
6741.0,17,2,582,1,83,0.0,83.0,83.0,1,499,0.0,499.0,499.0
44569.0,6,10,2032,5,524,10902.5,252.0,104.8,5,1508,9656.25,1236.0,301.6
2143.0,17,4,344,2,150,0.0,75.0,75.0,2,194,0.0,103.0,97.0
285751.0,6,10,1221,6,636,57150.2,298.0,106.0,4,585,89911.0,379.0,146.25
206308.0,17,2,762,2,762,0.0,381.0,381.0,0,0,0.0,0.0,0.0
206877.0,17,2,762,2,762,0.0,381.0,381.0,0,0,0.0,0.0,0.0
5621707.0,6,4,270,2,134,0.0,68.0,67.0,2,136,0.0,70.0,68.0
305.0,17,2,164,1,82,0.0,82.0,82.0,1,82,0.0,82.0,82.0
2337.0,17,4,344,2,150,0.0,75.0,75.0,2,194,0.0,103.0,97.0
146118.0,6,3,337,2,214,0.0,160.0,107.0,1,123,0.0,123.0,123.0
2592619.0,6,2,132,1,66,0.0,66.0,66.0,1,66,0.0,66.0,66.0
130823.0,6,3,337,2,214,0.0,160.0,107.0,1,123,0.0,123.0,123.0
109087962.0,17,14,864,7,432,18166823.5,174.0,61.71428571428572,7,432,18167940.666666668,174.0,61.71428571428572
153404.0,17,2,180,1,90,0.0,90.0,90.0,1,90,0.0,90.0,90.0
3070114.0,6,20,7614,11,986,306920.9,310.0,89.63636363636364,9,6628,8321.875,1514.0,736.4444444444445
205283.0,17,2,762,2,762,0.0,381.0,381.0,0,0,0.0,0.0,0.0
1904463.0,17,20,7488,20,7488,100234.8947368421,390.0,374.4,0,0,0.0,0.0,0.0
38143.0,6,14,4740,7,653,5780.166666666667,249.0,93.28571428571428,7,4087,5998.833333333333,1514.0,583.8571428571429
204660.0,17,2,762,2,762,0.0,381.0,381.0,0,0,0.0,0.0,0.0
30275.0,6,11,2098,6,590,3097.6,252.0,98.33333333333331,5,1508,7251.0,1236.0,301.6
2788456.0,6,2,132,1,66,0.0,66.0,66.0,1,66,0.0,66.0,66.0
123610530.0,6,49,3234,25,1650,5150438.75,66.0,66.0,24,1584,5198127.478260869,66.0,66.0
104377777.0,6,30,2122,15,1017,7455555.5,123.0,67.8,15,1105,7183057.642857143,139.0,73.66666666666667
208796.0,6,3,426,2,280,0.0,214.0,140.0,1,146,0.0,146.0,146.0
19289.0,6,11,1132,6,556,3429.0,218.0,92.66666666666669,5,576,4554.75,304.0,115.2
25401.0,6,10,2032,5,524,5640.0,252.0,104.8,5,1508,5857.5,1236.0,301.6
243303.0,17,2,180,1,70,0.0,70.0,70.0,1,110,0.0,110.0,110.0
107081569.0,6,221,24870,111,7548,973468.8090909092,140.0,68.0,110,17322,978163.1192660552,300.0,157.47272727272727
107580.0,17,2,286,2,286,0.0,143.0,143.0,0,0,0.0,0.0,0.0
146486.0,6,3,337,2,214,0.0,160.0,107.0,1,123,0.0,123.0,123.0
108302187.0,17,14,864,7,432,18000186.333333332,174.0,61.71428571428572,7,432,18001148.166666668,174.0,61.71428571428572
42838.0,6,14,4740,7,653,6744.833333333333,249.0,93.28571428571428,7,4087,6625.166666666667,1514.0,583.8571428571429
194778.0,17,2,180,1,90,0.0,90.0,90.0,1,90,0.0,90.0,90.0
90215287.0,6,16,1192,8,596,12851517.285714284,95.0,74.5,8,596,12857127.57142857,95.0,74.5
2069.0,17,4,344,2,150,0.0,75.0,75.0,2,194,0.0,103.0,97.0
4806456.0,6,5,336,2,134,0.0,68.0,67.0,3,202,1526980.0,70.0,67.33333333333333
90016308.0,17,27,12943,27,12943,3462165.6923076925,501.0,479.3703703703704,0,0,0.0,0.0,0.0
98442.0,17,2,762,2,762,0.0,381.0,381.0,0,0,0.0,0.0,0.0
14852.0,6,11,2098,6,590,2970.4,252.0,98.33333333333331,5,1508,2394.0,1236.0,301.6
36925.0,6,14,4740,7,653,5984.166666666667,249.0,93.28571428571428,7,4087,5995.333333333333,1514.0,583.8571428571429
106902778.0,6,33,2412,17,1272,6668614.0625,123.0,74.82352941176471,16,1140,7113189.866666666,123.0,71.25
216896.0,6,3,426,2,280,0.0,214.0,140.0,1,146,0.0,146.0,146.0
161140.0,6,2,128,1,74,0.0,74.0,74.0,1,54,0.0,54.0,54.0
117690728.0,17,15,1169,8,606,16812961.14285714,174.0,75.75,7,563,16307710.833333334,174.0,80.42857142857143
313433.0,17,2,876,2,876,0.0,438.0,438.0,0,0,0.0,0.0,0.0
2078.0,17,4,344,2,150,0.0,75.0,75.0,2,194,0.0,103.0,97.0
108101975.0,17,5,1005,5,1005,27025493.75,201.0,201.0,0,0,0.0,0.0,0.0
146932.0,6,3,373,2,238,0.0,172.0,119.0,1,135,0.0,135.0,135.0
27996.0,6,11,2098,6,590,5423.2,252.0,98.33333333333331,5,1508,6628.75,1236.0,301.6
13190.0,17,2,180,1,90,0.0,90.0,90.0,1,90,0.0,90.0,90.0
2779685.0,6,2,132,1,66,0.0,66.0,66.0,1,66,0.0,66.0,66.0
162197.0,6,10,1066,5,490,39632.75,218.0,98.0,5,576,40271.5,304.0,115.2
2140.0,17,4,344,2,150,0.0,75.0,75.0,2,194,0.0,103.0,97.0
90295087.0,6,17,1287,9,691,11280484.875,95.0,76.77777777777777,8,596,12831704.142857144,95.0,74.5
68063.0,6,14,4740,7,653,11100.666666666666,249.0,93.28571428571428,7,4087,9198.333333333334,1514.0,583.8571428571429
203606.0,17,6,9084,6,9084,40721.2,1514.0,1514.0,0,0,0.0,0.0,0.0
35136.0,6,10,2032,5,524,8436.5,252.0,104.8,5,1508,8170.5,1236.0,301.6
83430.0,6,11,2098,6,590,16502.8,252.0,98.33333333333331,5,1508,20192.75,1236.0,301.6
166770.0,6,11,1131,6,600,32935.6,262.0,100.0,5,531,2895.75,259.0,106.2
120043845.0,17,28,13364,28,13364,4446068.333333333,501.0,477.2857142857143,0,0,0.0,0.0,0.0
1221179.0,17,7,490,7,490,203529.8333333333,70.0,70.0,0,0,0.0,0.0,0.0
33633.0,6,14,4740,7,653,5452.0,249.0,93.28571428571428,7,4087,5148.333333333333,1514.0,583.8571428571429
469849.0,6,5,336,2,134,0.0,68.0,67.0,3,202,195106.0,70.0,67.33333333333333
3993.0,17,4,704,2,148,0.0,74.0,74.0,2,556,0.0,280.0,278.0
232759.0,6,7,440,4,247,77586.33333333333,85.0,61.75,3,193,12277.5,85.0,64.33333333333333
120055984.0,17,29,13785,29,13785,4287713.714285715,501.0,475.3448275862069,0,0,0.0,0.0,0.0
20807.0,6,10,2032,5,524,4986.5,252.0,104.8,5,1508,4626.25,1236.0,301.6
108103982.0,17,5,955,5,955,27025995.5,191.0,191.0,0,0,0.0,0.0,0.0
782.0,17,4,438,2,148,0.0,74.0,74.0,2,290,0.0,147.0,145.0
138351.0,6,2,132,1,66,0.0,66.0,66.0,1,66,0.0,66.0,66.0
1107199.0,6,13,1394,7,797,184533.16666666663,253.0,113.85714285714286,6,597,218706.6,259.0,99.5
141889.0,17,2,176,1,80,0.0,80.0,80.0,1,96,0.0,96.0,96.0
197360.0,17,2,180,1,90,0.0,90.0,90.0,1,90,0.0,90.0,90.0
862235.0,6,9,1269,6,798,172447.0,460.0,133.0,3,471,293236.5,331.0,157.0
119560083.0,6,19,1395,10,745,13279158.444444444,95.0,74.5,9,650,14938394.5,95.0,72.22222222222223
205942.0,6,3,426,2,280,0.0,214.0,140.0,1,146,0.0,146.0,146.0
108106325.0,17,5,955,5,955,27026581.25,191.0,191.0,0,0,0.0,0.0,0.0
25352.0,6,10,2032,5,524,6107.25,252.0,104.8,5,1508,6084.0,1236.0,301.6
117262647.0,6,213,23918,107,7358,1106251.3867924528,140.0,68.76635514018692,106,16560,1107032.6761904762,284.0,156.2264150943396
32026.0,6,10,2032,5,524,7670.75,252.0,104.8,5,1508,7418.25,1236.0,301.6
92487.0,17,2,286,2,286,0.0,143.0,143.0,0,0,0.0,0.0,0.0
44723.0,6,10,2032,5,524,10729.5,252.0,104.8,5,1508,8316.75,1236.0,301.6
135132171.0,17,6,1146,6,1146,27026434.2,191.0,191.0,0,0,0.0,0.0,0.0
2113612.0,6,25,7609,13,2516,176134.33333333334,1034.0,193.53846153846155,12,5093,164527.72727272726,1510.0,424.4166666666667
228416.0,17,2,180,1,90,0.0,90.0,90.0,1,90,0.0,90.0,90.0
310007.0,17,4,704,2,148,0.0,74.0,74.0,2,556,0.0,280.0,278.0
254626.00000000003,6,10,1221,6,636,50925.2,298.0,106.0,4,585,79492.0,379.0,146.25
105000864.0,17,13,821,7,432,17500144.0,174.0,61.71428571428572,6,389,17000161.8,174.0,64.83333333333333
80628.0,6,10,2032,5,524,19942.0,252.0,104.8,5,1508,19927.5,1236.0,301.6
122687955.0,6,49,3234,25,1650,5111998.125,66.0,66.0,24,1584,4929958.217391305,66.0,66.0
113860512.0,6,34,2334,17,1209,7116282.0,123.0,71.11764705882354,17,1125,7102762.25,123.0,66.17647058823529
116183306.0,6,220,24740,110,7556,1065273.4403669725,140.0,68.69090909090909,110,17184,1058307.3027522936,284.0,156.21818181818182
5626452.0,6,5,336,2,134,0.0,68.0,67.0,3,202,1425543.5,70.0,67.33333333333333
184866.0,17,2,180,1,90,0.0,90.0,90.0,1,90,0.0,90.0,90.0
171699.0,17,2,180,1,90,0.0,90.0,90.0,1,90,0.0,90.0,90.0
313997.0,17,4,1400,4,1400,104665.66666666669,350.0,350.0,0,0,0.0,0.0,0.0
2035.0,17,4,344,2,150,0.0,75.0,75.0,2,194,0.0,103.0,97.0
378918.0,17,2,363,1,75,0.0,75.0,75.0,1,288,0.0,288.0,288.0
243117.0,6,3,337,2,214,0.0,160.0,107.0,1,123,0.0,123.0,123.0
28457.0,6,14,4740,7,653,4620.5,249.0,93.28571428571428,7,4087,4025.8333333333335,1514.0,583.8571428571429
105436.0,17,2,762,2,762,0.0,381.0,381.0,0,0,0.0,0.0,0.0
105154332.0,17,14,864,7,432,17501457.166666668,174.0,61.71428571428572,7,432,17500157.0,174.0,61.71428571428572
58623.0,6,14,4740,7,653,9646.666666666666,249.0,93.28571428571428,7,4087,9029.666666666666,1514.0,583.8571428571429
527.0,17,2,508,2,508,0.0,257.0,254.0,0,0,0.0,0.0,0.0
35131213.0,6,8,1940,3,887,17541225.5,753.0,295.6666666666667,5,1053,8744366.75,785.0,210.6
36185.0,6,10,2032,5,524,8274.5,252.0,104.8,5,1508,7718.25,1236.0,301.6
313404.0,17,4,1400,4,1400,104468.0,350.0,350.0,0,0,0.0,0.0,0.0
140039.0,6,2,132,1,66,0.0,66.0,66.0,1,66,0.0,66.0,66.0
102199733.0,6,173,19584,87,13686,1188368.988372093,284.0,157.31034482758622,86,5898,1178033.7882352942,140.0,68.5813953488372
234146.0,6,3,373,2,238,0.0,172.0,119.0,1,135,0.0,135.0,135.0
5615637.0,6,4,270,2,134,0.0,68.0,67.0,2,136,0.0,70.0,68.0
2974.0,17,2,224,1,76,0.0,76.0,76.0,1,148,0.0,148.0,148.0
164056.0,6,3,337,2,214,0.0,160.0,107.0,1,123,0.0,123.0,123.0
304574.0,6,3,202,2,128,0.0,74.0,64.0,1,74,0.0,74.0,74.0
91679988.0,6,26,1746,13,906,7622001.333333333,123.0,69.6923076923077,13,840,7621974.583333333,123.0,64.61538461538461
47111.0,6,10,2032,5,524,10974.25,252.0,104.8,5,1508,11108.75,1236.0,301.6
228325.0,17,2,180,1,90,0.0,90.0,90.0,1,90,0.0,90.0,90.0
297539.0,6,6,412,4,272,99179.66666666669,74.0,68.0,2,140,0.0,74.0,70.0
317.0,17,2,174,1,79,0.0,79.0,79.0,1,95,0.0,95.0,95.0
146172.0,6,3,337,2,214,0.0,160.0,107.0,1,123,0.0,123.0,123.0
90259968.0,6,12,1832,8,1016,12894281.142857144,188.0,127.0,4,816,30032703.666666668,204.0,204.0
322832.0,6,6,412,4,272,107610.66666666669,74.0,68.0,2,140,0.0,74.0,70.0
1018721.0,6,11,1134,6,558,203744.2,220.0,93.0,5,576,254162.5,304.0,115.2
579914.0,6,11,1287,6,636,115982.8,298.0,106.0,5,651,140967.5,379.0,130.2
318638.0,17,4,1400,4,1400,106212.66666666669,350.0,350.0,0,0,0.0,0.0,0.0
135369845.0,17,8,1713,7,1407,22561640.83333333,201.0,201.0,1,306,0.0,306.0,306.0
122314683.0,6,48,3168,24,1584,5025813.913043479,66.0,66.0,24,1584,5181944.434782608,66.0,66.0
90254936.0,6,13,2036,8,1016,12893562.285714284,188.0,127.0,5,1020,22522778.75,204.0,204.0
37315.0,6,14,4740,7,653,6063.0,249.0,93.28571428571428,7,4087,4838.0,1514.0,583.8571428571429
5010966.0,17,4,849,2,166,0.0,83.0,83.0,2,683,0.0,499.0,341.5
440545.0,6,10,967,5,390,74042.25,162.0,78.0,5,577,73996.0,349.0,115.4
135131566.0,17,6,1206,6,1206,27026313.2,201.0,201.0,0,0,0.0,0.0,0.0
90018857.0,17,28,13364,28,13364,3334031.7407407407,501.0,477.2857142857143,0,0,0.0,0.0,0.0
1029709.0,6,11,1134,6,558,205941.8,220.0,93.0,5,576,256479.75,304.0,115.2
90022933.0,17,27,12943,27,12943,3462420.5,501.0,479.3703703703704,0,0,0.0,0.0,0.0
108113309.0,17,5,955,5,955,27028327.25,191.0,191.0,0,0,0.0,0.0,0.0
209394.0,17,2,180,1,90,0.0,90.0,90.0,1,90,0.0,90.0,90.0
206475.0,6,3,426,2,280,0.0,214.0,140.0,1,146,0.0,146.0,146.0
90260265.0,6,12,1832,8,1016,12894323.57142857,188.0,127.0,4,816,30031337.33333333,204.0,204.0
344366.0,6,3,204,1,68,0.0,68.0,68.0,2,136,0.0,70.0,68.0
301.0,17,2,168,1,76,0.0,76.0,76.0,1,92,0.0,92.0,92.0
1187732.0,6,13,3010,8,2382,169676.0,1514.0,297.75,5,628,227867.5,331.0,125.6
45200.0,6,14,4740,7,653,7408.333333333333,249.0,93.28571428571428,7,4087,6474.166666666667,1514.0,583.8571428571429
299.0,17,2,156,1,78,0.0,78.0,78.0,1,78,0.0,78.0,78.0
3010029.0,6,11,2106,6,598,601793.2,252.0,99.66666666666669,5,1508,2309.75,1236.0,301.6
2786.0,17,4,344,2,150,0.0,75.0,75.0,2,194,0.0,103.0,97.0
53203.0,6,14,4740,7,653,8332.166666666666,249.0,93.28571428571428,7,4087,8622.5,1514.0,583.8571428571429
10476681.0,6,7,478,4,272,3446700.0,74.0,68.0,3,206,5169907.5,74.0,68.66666666666667
135130705.0,17,6,1206,6,1206,27026141.0,201.0,201.0,0,0,0.0,0.0,0.0
122055347.0,6,35,2457,18,1332,7179726.294117647,123.0,74.0,17,1125,7414971.6875,123.0,66.17647058823529
108085627.0,17,5,955,5,955,27021406.75,191.0,191.0,0,0,0.0,0.0,0.0
108101626.0,17,5,955,5,955,27025406.5,191.0,191.0,0,0,0.0,0.0,0.0
93085697.0,17,12,778,6,389,18600164.8,174.0,64.83333333333333,6,389,18600953.4,174.0,64.83333333333333
120032259.0,17,29,13785,29,13785,4286866.392857143,501.0,475.3448275862069,0,0,0.0,0.0,0.0
146141.0,6,3,337,2,214,0.0,160.0,107.0,1,123,0.0,123.0,123.0
107421.0,17,2,286,2,286,0.0,143.0,143.0,0,0,0.0,0.0,0.0
236242.0,17,2,359,1,75,0.0,75.0,75.0,1,284,0.0,284.0,284.0
311521.0,17,4,1400,4,1400,103840.33333333331,350.0,350.0,0,0,0.0,0.0,0.0
90299591.0,6,16,1192,8,596,12893755.285714284,95.0,74.5,8,596,12899478.0,95.0,74.5
10878413.0,6,8,544,4,272,3580699.6666666665,74.0,68.0,4,272,3580627.0,74.0,68.0
299798.0,6,6,412,4,272,99932.66666666669,74.0,68.0,2,140,0.0,74.0,70.0
20973.0,6,10,2032,5,524,5003.5,252.0,104.8,5,1508,4946.5,1236.0,301.6
120040115.0,6,19,1395,10,745,13332393.333333334,95.0,74.5,9,650,14999095.875,95.0,72.22222222222223
300988.0,6,6,412,4,272,100329.33333333331,74.0,68.0,2,140,0.0,74.0,70.0
221001.0,17,2,180,1,90,0.0,90.0,90.0,1,90,0.0,90.0,90.0
106275133.0,17,16,1666,8,905,15143042.42857143,394.0,113.125,8,761,15143636.714285716,250.0,95.125
146999.0,6,3,373,2,238,0.0,172.0,119.0,1,135,0.0,135.0,135.0
153451.0,17,2,180,1,90,0.0,90.0,90.0,1,90,0.0,90.0,90.0
363581.0,6,11,1021,6,444,49445.2,162.0,74.0,5,577,61013.25,349.0,115.4
229565.0,17,2,180,1,90,0.0,90.0,90.0,1,90,0.0,90.0,90.0
228326.0,17,2,180,1,90,0.0,90.0,90.0,1,90,0.0,90.0,90.0
26534.0,6,10,2032,5,524,6392.0,252.0,104.8,5,1508,6307.75,1236.0,301.6
210708.0,6,3,426,2,280,0.0,214.0,140.0,1,146,0.0,146.0,146.0
335.0,17,2,166,1,75,0.0,75.0,75.0,1,91,0.0,91.0,91.0
219711.0,6,10,1221,6,636,43942.2,298.0,106.0,4,585,71840.66666666667,379.0,146.25
876995.0,6,10,1336,6,799,175399.0,461.0,133.16666666666666,4,537,201423.0,331.0,134.25
321.0,17,2,174,1,79,0.0,79.0,79.0,1,95,0.0,95.0,95.0
63260.0,6,10,2032,5,524,15575.5,252.0,104.8,5,1508,12400.5,1236.0,301.6
206137.0,17,2,180,1,90,0.0,90.0,90.0,1,90,0.0,90.0,90.0
228302.0,17,2,180,1,90,0.0,90.0,90.0,1,90,0.0,90.0,90.0
108108591.0,17,5,955,5,955,27027147.75,191.0,191.0,0,0,0.0,0.0,0.0
4500.0,17,2,762,2,762,0.0,381.0,381.0,0,0,0.0,0.0,0.0
303227.0,6,6,412,4,272,101075.66666666669,74.0,68.0,2,140,0.0,74.0,70.0
11828.0,6,10,2032,5,524,2741.5,252.0,104.8,5,1508,2512.0,1236.0,301.6
312046.0,17,4,1400,4,1400,104015.33333333331,350.0,350.0,0,0,0.0,0.0,0.0
43194.0,6,14,4740,7,653,6865.666666666667,249.0,93.28571428571428,7,4087,7064.333333333333,1514.0,583.8571428571429
134286.0,6,13,1394,7,797,21501.166666666668,253.0,113.85714285714286,6,597,24838.2,259.0,99.5
120123588.0,6,16,2632,9,1204,15015448.5,188.0,133.77777777777777,7,1428,15015420.5,204.0,204.0
149726403.0,17,36,17126,36,17126,4277897.228571429,501.0,475.72222222222223,0,0,0.0,0.0,0.0
91008781.0,6,21,1585,11,840,9100121.5,95.0,76.36363636363636,10,745,10111600.222222222,95.0,74.5
107110398.0,6,32,2352,16,1140,7140666.4,123.0,71.25,16,1212,6474893.533333333,123.0,75.75
96166917.0,6,59,12275,30,6485,3316100.5862068967,1514.0,216.16666666666663,29,5790,3424934.1428571427,1514.0,199.6551724137931
363610.0,6,3,1604,2,851,0.0,785.0,425.5,1,753,0.0,753.0,753.0
26692.0,6,14,4740,7,653,4266.666666666667,249.0,93.28571428571428,7,4087,3914.0,1514.0,583.8571428571429
55331.0,6,14,4740,7,653,8970.833333333334,249.0,93.28571428571428,7,4087,8987.166666666666,1514.0,583.8571428571429
92815589.0,6,745,149998,368,24806,252903.5122615804,214.0,67.40760869565217,377,125192,244065.9361702128,1514.0,332.0742705570292
285.0,17,2,174,1,79,0.0,79.0,79.0,1,95,0.0,95.0,95.0
94735.0,17,2,286,2,286,0.0,143.0,143.0,0,0,0.0,0.0,0.0
90527991.0,6,15,2168,8,1016,12932570.142857144,188.0,127.0,7,1152,15054665.833333334,204.0,164.57142857142858
42960.0,6,14,4740,7,653,6939.0,249.0,93.28571428571428,7,4087,6068.666666666667,1514.0,583.8571428571429
14866.0,6,14,4740,7,653,2180.5,249.0,93.28571428571428,7,4087,2338.833333333333,1514.0,583.8571428571429
2318.0,17,4,344,2,150,0.0,75.0,75.0,2,194,0.0,103.0,97.0
237531.0,17,2,180,1,90,0.0,90.0,90.0,1,90,0.0,90.0,90.0
289552.0,6,10,1221,6,636,57910.4,298.0,106.0,4,585,89471.33333333333,379.0,146.25
120002918.0,6,22,1680,12,935,10909090.727272728,95.0,77.91666666666667,10,745,13332791.888888888,95.0,74.5
103682.0,17,2,286,2,286,0.0,143.0,143.0,0,0,0.0,0.0,0.0
302673.0,6,6,412,4,272,100891.0,74.0,68.0,2,140,0.0,74.0,70.0
207702.0,6,3,426,2,280,0.0,214.0,140.0,1,146,0.0,146.0,146.0
104747033.0,6,28,1876,14,982,8040867.461538462,139.0,70.14285714285714,14,894,8040868.461538462,123.0,63.85714285714285
40383.0,6,14,4740,7,653,5884.833333333333,249.0,93.28571428571428,7,4087,6592.5,1514.0,583.8571428571429
197292.0,17,2,180,1,90,0.0,90.0,90.0,1,90,0.0,90.0,90.0
135130291.0,17,6,1206,6,1206,27026058.2,201.0,201.0,0,0,0.0,0.0,0.0
2009.0,17,4,344,2,150,0.0,75.0,75.0,2,194,0.0,103.0,97.0
108106459.0,17,5,955,5,955,27026614.75,191.0,191.0,0,0,0.0,0.0,0.0
108101685.0,17,5,955,5,955,27025421.25,191.0,191.0,0,0,0.0,0.0,0.0
123839668.0,6,48,3168,24,1584,4963526.173913044,66.0,66.0,24,1584,5333863.695652174,66.0,66.0
153425.0,17,2,180,1,90,0.0,90.0,90.0,1,90,0.0,90.0,90.0
38611.0,6,14,4740,7,653,6142.333333333333,249.0,93.28571428571428,7,4087,5531.333333333333,1514.0,583.8571428571429
96731674.0,6,39,2574,20,1320,5091126.315789473,66.0,66.0,19,1254,5159989.555555556,66.0,66.0
143896.0,17,2,180,1,90,0.0,90.0,90.0,1,90,0.0,90.0,90.0
104936909.0,17,13,1214,7,694,17489484.833333332,174.0,99.14285714285714,6,520,16913919.4,174.0,86.66666666666667
37178.0,6,13,1386,7,789,6196.333333333333,253.0,112.71428571428572,6,597,6690.0,259.0,99.5
29174.0,6,11,2098,6,590,5769.6,252.0,98.33333333333331,5,1508,6792.25,1236.0,301.6
955.0,17,4,438,2,148,0.0,74.0,74.0,2,290,0.0,147.0,145.0
120174171.0,6,698,112342,347,23272,347324.1936416185,214.0,67.06628242074927,351,89070,342016.9942857143,1514.0,253.7606837606837
105676.0,17,2,700,2,700,0.0,350.0,350.0,0,0,0.0,0.0,0.0
438607.0,6,11,1021,6,444,58955.0,162.0,74.0,5,577,73514.75,349.0,115.4
117467754.0,17,14,864,7,432,19500841.166666668,174.0,61.71428571428572,7,432,19500217.0,174.0,61.71428571428572
114440012.0,6,28,1929,15,1089,8174286.571428572,123.0,72.6,13,840,8877892.083333334,123.0,64.61538461538461
120043499.0,17,28,13364,28,13364,4446055.518518519,501.0,477.2857142857143,0,0,0.0,0.0,0.0
220545.0,6,3,426,2,280,0.0,214.0,140.0,1,146,0.0,146.0,146.0
2588961.0,6,2,132,1,66,0.0,66.0,66.0,1,66,0.0,66.0,66.0
90524603.0,6,14,2240,8,1016,12932086.142857144,188.0,127.0,6,1224,18071957.0,204.0,204.0
206700.0,17,2,620,1,75,0.0,75.0,75.0,1,545,0.0,545.0,545.0
765.0,17,2,762,2,762,0.0,381.0,381.0,0,0,0.0,0.0,0.0
90080695.0,6,10,1440,7,828,15013449.166666666,188.0,118.28571428571428,3,612,30031726.5,204.0,204.0
39775.0,6,10,2032,5,524,8103.75,252.0,104.8,5,1508,9382.0,1236.0,301.6
210831.0,6,3,426,2,280,0.0,214.0,140.0,1,146,0.0,146.0,146.0
4115.0,17,2,602,1,72,0.0,72.0,72.0,1,530,0.0,530.0,530.0
69935.0,17,2,620,1,75,0.0,75.0,75.0,1,545,0.0,545.0,545.0
144186.0,6,10,1975,5,467,35808.25,195.0,93.4,5,1508,35807.5,1236.0,301.6
106004.0,17,2,286,2,286,0.0,143.0,143.0,0,0,0.0,0.0,0.0
91968671.0,17,16,5472,16,5472,6131244.733333333,342.0,342.0,0,0,0.0,0.0,0.0
324464.0,17,4,1400,4,1400,108154.66666666669,350.0,350.0,0,0,0.0,0.0,0.0
153390.0,17,2,180,1,90,0.0,90.0,90.0,1,90,0.0,90.0,90.0
2474.0,17,4,344,2,150,0.0,75.0,75.0,2,194,0.0,103.0,97.0
2133556.0,6,24,7544,12,2450,193959.63636363635,1034.0,204.16666666666663,12,5094,165749.18181818182,1510.0,424.5
120122657.0,6,13,2020,9,1204,15015332.125,188.0,133.77777777777777,4,816,30031293.0,204.0,204.0
146174.0,6,3,337,2,214,0.0,160.0,107.0,1,123,0.0,123.0,123.0
186473.0,17,2,604,1,75,0.0,75.0,75.0,1,529,0.0,529.0,529.0
42895.0,6,14,4740,7,653,7018.166666666667,249.0,93.28571428571428,7,4087,6836.166666666667,1514.0,583.8571428571429
28481.0,6,14,4740,7,653,3949.0,249.0,93.28571428571428,7,4087,4438.5,1514.0,583.8571428571429
11589.0,6,10,1065,5,534,2523.0,262.0,106.8,5,531,2552.0,259.0,106.2
211506.0,6,10,1221,6,636,42301.2,298.0,106.0,4,585,68634.66666666667,379.0,146.25
2301.0,17,4,344,2,150,0.0,75.0,75.0,2,194,0.0,103.0,97.0
135137558.0,17,6,1146,6,1146,27027511.6,191.0,191.0,0,0,0.0,0.0,0.0
108108170.0,17,5,1005,5,1005,27027042.5,201.0,201.0,0,0,0.0,0.0,0.0
129503.0,6,2,132,1,66,0.0,66.0,66.0,1,66,0.0,66.0,66.0
71276.0,6,14,4740,7,653,11568.5,249.0,93.28571428571428,7,4087,11104.666666666666,1514.0,583.8571428571429
100901071.0,17,14,4796,13,4446,6228726.166666667,342.0,342.0,1,350,0.0,350.0,350.0
108107027.0,17,5,1005,5,1005,27026756.75,201.0,201.0,0,0,0.0,0.0,0.0
5612096.0,6,5,336,2,134,0.0,68.0,67.0,3,202,1424384.5,70.0,67.33333333333333
121428152.0,6,211,23930,106,16778,1156458.5904761904,284.0,158.28301886792454,105,7152,1147708.1634615385,140.0,68.11428571428571
335628.0,17,2,180,1,90,0.0,90.0,90.0,1,90,0.0,90.0,90.0
267866.0,6,10,1221,6,636,53573.2,298.0,106.0,4,585,83896.0,379.0,146.25
47004.0,6,14,4740,7,653,7522.5,249.0,93.28571428571428,7,4087,6773.166666666667,1514.0,583.8571428571429
34113.0,6,12,1393,6,796,6297.2,271.0,132.66666666666666,6,597,5944.6,259.0,99.5
2367.0,17,4,344,2,150,0.0,75.0,75.0,2,194,0.0,103.0,97.0
617693.0,6,2,132,1,66,0.0,66.0,66.0,1,66,0.0,66.0,66.0
0.0,6,1,66,1,66,0.0,66.0,66.0,0,0,0.0,0.0,0.0
40836.0,6,14,4740,7,653,6225.166666666667,249.0,93.28571428571428,7,4087,5556.5,1514.0,583.8571428571429
506591.0,6,5,336,2,134,0.0,68.0,67.0,3,202,193974.5,70.0,67.33333333333333
216612.0,17,2,180,1,90,0.0,90.0,90.0,1,90,0.0,90.0,90.0
44059.0,6,14,4740,7,653,6844.333333333333,249.0,93.28571428571428,7,4087,7143.333333333333,1514.0,583.8571428571429
44540.0,6,2,132,1,66,0.0,66.0,66.0,1,66,0.0,66.0,66.0
117505003.0,6,222,25084,111,17536,1066270.481818182,374.0,157.981981981982,111,7548,1066269.9,140.0,68.0
42368.0,6,14,4740,7,653,6835.666666666667,249.0,93.28571428571428,7,4087,6876.833333333333,1514.0,583.8571428571429
396347.0,6,10,1221,6,636,79269.4,298.0,106.0,4,585,126662.33333333331,379.0,146.25
312150.0,6,6,412,4,272,104050.0,74.0,68.0,2,140,0.0,74.0,70.0
319.0,17,2,174,1,79,0.0,79.0,79.0,1,95,0.0,95.0,95.0
43976.0,6,14,4740,7,653,7220.166666666667,249.0,93.28571428571428,7,4087,5185.333333333333,1514.0,583.8571428571429
157835.0,17,2,180,1,90,0.0,90.0,90.0,1,90,0.0,90.0,90.0
107685.0,17,2,286,2,286,0.0,143.0,143.0,0,0,0.0,0.0,0.0
317465.0,17,4,1400,4,1400,105821.66666666669,350.0,350.0,0,0,0.0,0.0,0.0
2594627.0,6,2,132,1,66,0.0,66.0,66.0,1,66,0.0,66.0,66.0
2576457.0,6,2,132,1,66,0.0,66.0,66.0,1,66,0.0,66.0,66.0
2134896.0,6,18,6803,10,1501,237210.66666666663,408.0,150.1,8,5302,242829.0,1514.0,662.75
14612.0,6,11,2098,6,590,2496.0,252.0,98.33333333333331,5,1508,3339.75,1236.0,301.6
34287.0,6,14,4740,7,653,5035.333333333333,249.0,93.28571428571428,7,4087,5523.666666666667,1514.0,583.8571428571429
37026078.0,6,7,1874,3,887,18402383.5,753.0,295.6666666666667,4,987,12295249.666666666,785.0,246.75
3583398.0,17,4,360,2,140,0.0,70.0,70.0,2,220,0.0,110.0,110.0
2647376.0,6,25,7573,14,3735,203644.3076923077,1514.0,266.7857142857143,11,3838,239243.8,1514.0,348.90909090909093
232829.0,6,3,373,2,238,0.0,172.0,119.0,1,135,0.0,135.0,135.0
162303.0,17,2,180,1,90,0.0,90.0,90.0,1,90,0.0,90.0,90.0
90253988.0,6,12,1832,8,1016,12893426.857142856,188.0,127.0,4,816,30029851.33333333,204.0,204.0
320.0,17,2,166,1,75,0.0,75.0,75.0,1,91,0.0,91.0,91.0
303.0,17,2,164,1,82,0.0,82.0,82.0,1,82,0.0,82.0,82.0
13239.0,6,11,1133,6,602,2425.6,264.0,100.33333333333331,5,531,2782.75,259.0,106.2
146914.0,6,3,337,2,214,0.0,160.0,107.0,1,123,0.0,123.0,123.0
94954647.0,6,159,17940,80,5502,1201957.5569620254,140.0,68.775,79,12438,1191951.1025641025,284.0,157.4430379746835
48200.0,6,14,4740,7,653,7904.5,249.0,93.28571428571428,7,4087,7015.0,1514.0,583.8571428571429
234131.0,6,3,373,2,238,0.0,172.0,119.0,1,135,0.0,135.0,135.0
153416.0,17,2,180,1,90,0.0,90.0,90.0,1,90,0.0,90.0,90.0
120001239.0,17,14,864,7,432,20000206.5,174.0,61.71428571428572,7,432,16668552.166666666,174.0,61.71428571428572
306124.0,6,3,202,2,128,0.0,74.0,64.0,1,74,0.0,74.0,74.0
213662.0,17,2,180,1,90,0.0,90.0,90.0,1,90,0.0,90.0,90.0
36829.0,6,14,4740,7,653,6014.5,249.0,93.28571428571428,7,4087,5524.833333333333,1514.0,583.8571428571429
20193.0,6,14,4740,7,653,3212.333333333333,249.0,93.28571428571428,7,4087,3142.1666666666665,1514.0,583.8571428571429
111819171.0,17,13,821,7,432,18609844.33333333,174.0,61.71428571428572,6,389,18452385.4,174.0,64.83333333333333
1593585.0,17,4,360,2,140,0.0,70.0,70.0,2,220,0.0,110.0,110.0
43906.0,6,14,4740,7,653,7183.5,249.0,93.28571428571428,7,4087,6925.833333333333,1514.0,583.8571428571429
398.0,17,2,410,1,78,0.0,78.0,78.0,1,332,0.0,332.0,332.0
218012.0,6,3,426,2,280,0.0,214.0,140.0,1,146,0.0,146.0,146.0
5253.0,17,4,344,2,150,0.0,75.0,75.0,2,194,0.0,103.0,97.0
25092.0,6,14,4740,7,653,3816.5,249.0,93.28571428571428,7,4087,3967.5,1514.0,583.8571428571429
37124.0,6,10,2032,5,524,8003.75,252.0,104.8,5,1508,9028.0,1236.0,301.6
2828.0,17,2,224,1,76,0.0,76.0,76.0,1,148,0.0,148.0,148.0
146298.0,6,3,337,2,214,0.0,160.0,107.0,1,123,0.0,123.0,123.0
322.0,17,2,166,1,75,0.0,75.0,75.0,1,91,0.0,91.0,91.0
23004396.0,17,3,1034,2,684,0.0,342.0,342.0,1,350,0.0,350.0,350.0
281104.0,17,2,414,1,88,0.0,88.0,88.0,1,326,0.0,326.0,326.0
217862.0,6,3,426,2,280,0.0,214.0,140.0,1,146,0.0,146.0,146.0
18540.0,6,11,2098,6,590,3407.6,252.0,98.33333333333331,5,1508,4006.0,1236.0,301.6
4252.0,17,2,614,1,72,0.0,72.0,72.0,1,542,0.0,542.0,542.0
67269.0,6,14,4740,7,653,11085.166666666666,249.0,93.28571428571428,7,4087,10479.166666666666,1514.0,583.8571428571429
110990555.0,6,30,1990,15,1042,7912476.214285715,139.0,69.46666666666667,15,948,7912473.214285715,123.0,63.2
196957.0,17,2,180,1,90,0.0,90.0,90.0,1,90,0.0,90.0,90.0
1020747.0,6,11,1134,6,558,204149.4,220.0,93.0,5,576,254776.75,304.0,115.2
120000989.0,6,16,1192,8,596,17142998.42857143,95.0,74.5,8,596,17106139.57142857,95.0,74.5
206306.0,6,3,426,2,280,0.0,214.0,140.0,1,146,0.0,146.0,146.0
12066.0,6,10,1065,5,534,2639.25,262.0,106.8,5,531,2799.0,259.0,106.2
302436.0,6,2,132,1,66,0.0,66.0,66.0,1,66,0.0,66.0,66.0
6647.0,17,4,823,2,163,0.0,89.0,81.5,2,660,0.0,443.0,330.0
120024731.0,17,28,13364,28,13364,4445360.407407408,501.0,477.2857142857143,0,0,0.0,0.0,0.0
90254998.0,6,12,1832,8,1016,12893571.142857144,188.0,127.0,4,816,30028173.0,204.0,204.0
64650.0,6,12,1320,6,723,11897.0,253.0,120.5,6,597,11413.2,259.0,99.5
2276479.0,6,49,23728,25,19797,94853.29166666669,1514.0,791.88,24,3931,89721.82608695653,1514.0,163.79166666666666
43733.0,6,10,2032,5,524,9924.5,252.0,104.8,5,1508,10281.25,1236.0,301.6
90256856.0,6,14,1964,8,1016,12893836.57142857,188.0,127.0,6,948,18018175.0,204.0,158.0
121347901.0,6,227,25796,114,18116,1073875.2300884956,284.0,158.91228070175438,113,7680,1065040.107142857,140.0,67.96460176991151
232626.0,6,3,337,2,214,0.0,160.0,107.0,1,123,0.0,123.0,123.0
119162045.0,17,14,864,7,432,19834415.0,174.0,61.71428571428572,7,432,19666884.5,174.0,61.71428571428572
90767258.0,6,19,1436,10,745,10079943.555555556,95.0,74.5,9,691,11344528.25,95.0,76.77777777777777
9585.0,17,2,582,1,83,0.0,83.0,83.0,1,499,0.0,499.0,499.0
341531.0,17,4,704,2,148,0.0,74.0,74.0,2,556,0.0,280.0,278.0
90263936.0,6,12,1832,8,1016,12894848.0,188.0,127.0,4,816,30033014.666666668,204.0,204.0
22432.0,6,10,2032,5,524,4734.75,252.0,104.8,5,1508,4917.25,1236.0,301.6
50766.0,17,2,180,1,90,0.0,90.0,90.0,1,90,0.0,90.0,90.0
185945.0,17,2,180,1,90,0.0,90.0,90.0,1,90,0.0,90.0,90.0
0.0,6,1,60,1,60,0.0,60.0,60.0,0,0,0.0,0.0,0.0
11581600.0,6,5,1736,2,819,0.0,753.0,409.5,3,917,4499241.5,785.0,305.6666666666667
99104838.0,17,12,778,6,389,19800161.8,174.0,64.83333333333333,6,389,19801358.2,174.0,64.83333333333333
110981.0,17,2,286,2,286,0.0,143.0,143.0,0,0,0.0,0.0,0.0
108098269.0,17,5,955,5,955,27024567.25,191.0,191.0,0,0,0.0,0.0,0.0
2335515.0,6,49,23728,25,19797,97313.125,1514.0,791.88,24,3931,91379.30434782608,1514.0,163.79166666666666
42825.0,6,14,4740,7,653,6982.333333333333,249.0,93.28571428571428,7,4087,6451.166666666667,1514.0,583.8571428571429
23179.0,6,10,2032,5,524,4855.0,252.0,104.8,5,1508,5531.75,1236.0,301.6
2471.0,17,4,344,2,150,0.0,75.0,75.0,2,194,0.0,103.0,97.0
232905.0,6,3,337,2,214,0.0,160.0,107.0,1,123,0.0,123.0,123.0
298830.0,6,6,412,4,272,99610.0,74.0,68.0,2,140,0.0,74.0,70.0
59928.0,6,10,2032,5,524,14742.25,252.0,104.8,5,1508,12924.75,1236.0,301.6
305925.0,6,6,412,4,272,101975.0,74.0,68.0,2,140,0.0,74.0,70.0
646520.0,6,2,132,1,66,0.0,66.0,66.0,1,66,0.0,66.0,66.0
19811.0,6,10,2032,5,524,4650.25,252.0,104.8,5,1508,4566.5,1236.0,301.6
12672.0,6,11,2098,6,590,2328.0,252.0,98.33333333333331,5,1508,2483.5,1236.0,301.6
316.0,17,2,174,1,79,0.0,79.0,79.0,1,95,0.0,95.0,95.0
28012.0,6,10,2032,5,524,6760.75,252.0,104.8,5,1508,6241.0,1236.0,301.6
50391.0,6,11,2098,6,590,8865.2,252.0,98.33333333333331,5,1508,11984.25,1236.0,301.6
135134421.0,17,6,1206,6,1206,27026884.2,201.0,201.0,0,0,0.0,0.0,0.0
2323.0,17,4,344,2,150,0.0,75.0,75.0,2,194,0.0,103.0,97.0
196781.0,17,2,180,1,90,0.0,90.0,90.0,1,90,0.0,90.0,90.0
181256.0,17,2,180,1,90,0.0,90.0,90.0,1,90,0.0,90.0,90.0
108606.0,17,2,286,2,286,0.0,143.0,143.0,0,0,0.0,0.0,0.0
50996.0,17,2,180,1,90,0.0,90.0,90.0,1,90,0.0,90.0,90.0
103113.0,17,2,286,2,286,0.0,143.0,143.0,0,0,0.0,0.0,0.0
849300.0,6,9,1196,6,725,169860.0,387.0,120.83333333333331,3,471,286748.5,331.0,157.0
313055.0,17,4,1400,4,1400,104351.66666666669,350.0,350.0,0,0,0.0,0.0,0.0
31863204.0,6,5,336,2,134,0.0,68.0,67.0,3,202,15862394.5,70.0,67.33333333333333
30175.0,6,10,2032,5,524,6010.5,252.0,104.8,5,1508,6833.25,1236.0,301.6
110247539.0,6,207,23412,104,7086,1070364.4563106797,140.0,68.13461538461539,103,16326,1071873.862745098,284.0,158.50485436893203
302299.0,6,6,412,4,272,100766.33333333331,74.0,68.0,2,140,0.0,74.0,70.0
120073918.0,17,29,13785,29,13785,4288354.214285715,501.0,475.3448275862069,0,0,0.0,0.0,0.0
322786.0,17,4,1400,4,1400,107595.33333333331,350.0,350.0,0,0,0.0,0.0,0.0
120094685.0,17,28,13364,28,13364,4447951.296296297,501.0,477.2857142857143,0,0,0.0,0.0,0.0
157820.0,17,2,180,1,90,0.0,90.0,90.0,1,90,0.0,90.0,90.0
440680.0,6,11,1021,6,444,59333.6,162.0,74.0,5,577,73980.0,349.0,115.4
38245.0,6,14,4740,7,653,5928.166666666667,249.0,93.28571428571428,7,4087,6141.166666666667,1514.0,583.8571428571429
55511.0,6,2,132,1,66,0.0,66.0,66.0,1,66,0.0,66.0,66.0
19021.0,6,14,4740,7,653,2726.1666666666665,249.0,93.28571428571428,7,4087,3008.333333333333,1514.0,583.8571428571429
160295.0,6,2,128,1,74,0.0,74.0,74.0,1,54,0.0,54.0,54.0
146071.0,6,3,337,2,214,0.0,160.0,107.0,1,123,0.0,123.0,123.0
1519.0,17,2,192,1,88,0.0,88.0,88.0,1,104,0.0,104.0,104.0
30636.0,6,14,4740,7,653,4980.0,249.0,93.28571428571428,7,4087,4921.5,1514.0,583.8571428571429
54624.0,6,14,4740,7,653,8976.166666666666,249.0,93.28571428571428,7,4087,7585.333333333333,1514.0,583.8571428571429
21036.0,6,14,4740,7,653,3253.1666666666665,249.0,93.28571428571428,7,4087,3239.1666666666665,1514.0,583.8571428571429
102482916.0,17,14,1126,7,563,17000152.833333332,174.0,80.42857142857143,7,563,17000821.666666668,174.0,80.42857142857143
301587.0,6,6,412,4,272,100529.0,74.0,68.0,2,140,0.0,74.0,70.0
2366.0,17,4,344,2,150,0.0,75.0,75.0,2,194,0.0,103.0,97.0
402462.0,6,4,508,2,238,0.0,172.0,119.0,2,270,0.0,135.0,135.0
20854175.0,17,3,1034,2,684,0.0,342.0,342.0,1,350,0.0,350.0,350.0
275303.0,17,2,238,1,74,0.0,74.0,74.0,1,164,0.0,164.0,164.0
311097.0,17,4,1400,4,1400,103699.0,350.0,350.0,0,0,0.0,0.0,0.0
3652.0,17,2,333,1,87,0.0,87.0,87.0,1,246,0.0,246.0,246.0
35823.0,6,14,4740,7,653,5654.333333333333,249.0,93.28571428571428,7,4087,5390.833333333333,1514.0,583.8571428571429
15997.999999999998,6,13,1459,7,862,2460.333333333333,271.0,123.14285714285714,6,597,2863.0,259.0,99.5
10467023.0,6,7,478,4,272,3443784.333333333,74.0,68.0,3,206,5165552.5,74.0,68.66666666666667
139826.0,6,11,1132,6,556,27965.2,218.0,92.66666666666669,5,576,34273.75,304.0,115.2
1302523.0,6,4,264,2,132,0.0,66.0,66.0,2,132,0.0,66.0,66.0
108673352.0,6,34,2466,17,1272,6792084.5,123.0,74.82352941176471,17,1194,6778563.6875,123.0,70.23529411764706
134550.0,6,2,132,1,66,0.0,66.0,66.0,1,66,0.0,66.0,66.0
21479.0,6,14,4740,7,653,3371.0,249.0,93.28571428571428,7,4087,3440.5,1514.0,583.8571428571429
826.0,17,4,438,2,148,0.0,74.0,74.0,2,290,0.0,147.0,145.0
2360.0,17,4,344,2,150,0.0,75.0,75.0,2,194,0.0,103.0,97.0
2360657.0,6,23,4355,12,1447,214605.18181818185,311.0,120.58333333333331,11,2908,215341.9,1514.0,264.3636363636364
368.0,17,2,160,1,80,0.0,80.0,80.0,1,80,0.0,80.0,80.0
90259553.0,6,12,1832,8,1016,12894221.857142856,188.0,127.0,4,816,30031270.0,204.0,204.0
1039318.0,6,11,1134,6,558,207863.60000000003,220.0,93.0,5,576,254548.25,304.0,115.2
143958.0,17,2,180,1,90,0.0,90.0,90.0,1,90,0.0,90.0,90.0
5004820.0,17,4,534,2,166,0.0,83.0,83.0,2,368,0.0,184.0,184.0
114456048.0,6,48,3168,24,1584,4976349.913043479,66.0,66.0,24,1584,4962925.695652174,66.0,66.0
135128341.0,17,6,1206,6,1206,27025668.2,201.0,201.0,0,0,0.0,0.0,0.0
30717.0,6,14,4740,7,653,4957.0,249.0,93.28571428571428,7,4087,4984.166666666667,1514.0,583.8571428571429
97000803.0,17,13,1083,7,563,16166800.5,174.0,80.42857142857143,6,520,15397986.2,174.0,86.66666666666667
93544554.0,17,12,778,6,389,18601047.8,174.0,64.83333333333333,6,389,18600152.4,174.0,64.83333333333333
273332.0,17,2,180,1,90,0.0,90.0,90.0,1,90,0.0,90.0,90.0
101889338.0,6,32,2236,16,1165,6778231.333333333,139.0,72.8125,16,1071,6778231.533333333,123.0,66.9375
44080.0,6,14,4740,7,653,6808.166666666667,249.0,93.28571428571428,7,4087,6890.5,1514.0,583.8571428571429
110322310.0,6,18,1437,9,787,13790288.75,191.0,87.44444444444444,9,650,13756532.5,95.0,72.22222222222223
170249.0,17,2,1500,1,994,0.0,994.0,994.0,1,506,0.0,506.0,506.0
312991.0,17,4,1400,4,1400,104330.33333333331,350.0,350.0,0,0,0.0,0.0,0.0
119575856.0,6,20,1490,10,745,13286206.222222222,95.0,74.5,10,745,13258064.111111112,95.0,74.5
28678.0,6,10,2032,5,524,5351.75,252.0,104.8,5,1508,6876.25,1236.0,301.6
3013474.0,6,12,2172,7,664,502071.6666666667,252.0,94.85714285714286,5,1508,3908.5,1236.0,301.6
308385.0,6,6,412,4,272,102795.0,74.0,68.0,2,140,0.0,74.0,70.0
304612.0,6,6,412,4,272,101537.33333333331,74.0,68.0,2,140,0.0,74.0,70.0
96896504.0,6,189,21286,95,6492,1030813.8723404256,140.0,68.33684210526316,94,14794,1030887.2688172044,284.0,157.38297872340425
34489.0,6,10,2032,5,524,7199.75,252.0,104.8,5,1508,8334.75,1236.0,301.6
119751254.0,17,35,16705,35,16705,3522095.705882353,501.0,477.2857142857143,0,0,0.0,0.0,0.0
115934912.0,17,16,1212,8,606,16539138.857142856,174.0,75.75,8,606,16447829.857142856,174.0,75.75
104987.0,17,2,286,2,286,0.0,143.0,143.0,0,0,0.0,0.0,0.0
438655.0,6,3,1604,2,851,0.0,785.0,425.5,1,753,0.0,753.0,753.0
27922.0,6,14,4740,7,653,3397.5,249.0,93.28571428571428,7,4087,4390.666666666667,1514.0,583.8571428571429
247801.0,6,3,337,2,214,0.0,160.0,107.0,1,123,0.0,123.0,123.0
90400522.0,6,15,2460,8,1632,12913516.714285716,204.0,204.0,7,828,15020738.166666666,188.0,118.28571428571428
0.0,17,1,381,1,381,0.0,381.0,381.0,0,0,0.0,0.0,0.0
32667.0,6,13,1459,7,862,4608.333333333333,271.0,123.14285714285714,6,597,4269.2,259.0,99.5
4320269.0,6,169,149411,104,140819,41944.35922330097,1510.0,1354.0288461538462,65,8592,62586.265625,1510.0,132.1846153846154
145019.0,17,2,180,1,70,0.0,70.0,70.0,1,110,0.0,110.0,110.0
98426.0,17,2,762,2,762,0.0,381.0,381.0,0,0,0.0,0.0,0.0
219170.0,6,3,426,2,280,0.0,214.0,140.0,1,146,0.0,146.0,146.0
325.0,17,2,174,1,79,0.0,79.0,79.0,1,95,0.0,95.0,95.0
165870.0,17,2,180,1,90,0.0,90.0,90.0,1,90,0.0,90.0,90.0
298353.0,17,2,246,1,76,0.0,76.0,76.0,1,170,0.0,170.0,170.0
2323.0,17,4,344,2,150,0.0,75.0,75.0,2,194,0.0,103.0,97.0
108102423.0,17,5,955,5,955,27025605.75,191.0,191.0,0,0,0.0,0.0,0.0
2596268.0,6,2,132,1,66,0.0,66.0,66.0,1,66,0.0,66.0,66.0
161105.0,6,2,128,1,74,0.0,74.0,74.0,1,54,0.0,54.0,54.0
42449.0,6,13,1386,7,789,6864.0,253.0,112.71428571428572,6,597,7919.4,259.0,99.5
90491828.0,6,219,25500,110,7482,830200.256880734,140.0,68.01818181818182,109,18018,828249.1666666666,336.0,165.30275229357798
2045.0,17,4,344,2,150,0.0,75.0,75.0,2,194,0.0,103.0,97.0
298363.0,6,6,412,4,272,99454.33333333331,74.0,68.0,2,140,0.0,74.0,70.0
34886.0,17,2,582,1,83,0.0,83.0,83.0,1,499,0.0,499.0,499.0
98910.0,17,2,762,2,762,0.0,381.0,381.0,0,0,0.0,0.0,0.0
21202.0,6,14,4740,7,653,3408.0,249.0,93.28571428571428,7,4087,3387.0,1514.0,583.8571428571429
333.0,17,2,250,1,93,0.0,93.0,93.0,1,157,0.0,157.0,157.0
90040252.0,17,28,13364,28,13364,3334824.1481481483,501.0,477.2857142857143,0,0,0.0,0.0,0.0
509260.00000000006,6,4,270,2,134,0.0,68.0,67.0,2,136,0.0,70.0,68.0
120063024.0,17,29,13785,29,13785,4287965.142857143,501.0,475.3448275862069,0,0,0.0,0.0,0.0
113309541.0,6,45,2970,23,1518,5150433.681818182,66.0,66.0,22,1452,4941250.380952381,66.0,66.0
121314.0,6,3,337,2,214,0.0,160.0,107.0,1,123,0.0,123.0,123.0
228111.0,17,2,180,1,90,0.0,90.0,90.0,1,90,0.0,90.0,90.0
307028.0,6,6,412,4,272,102342.66666666669,74.0,68.0,2,140,0.0,74.0,70.0
270646.0,6,12,1373,7,714,45107.66666666666,298.0,102.0,5,659,63113.5,379.0,131.8
143942.0,17,2,180,1,90,0.0,90.0,90.0,1,90,0.0,90.0,90.0
31362.0,6,14,4740,7,653,5051.333333333333,249.0,93.28571428571428,7,4087,5088.166666666667,1514.0,583.8571428571429
322047.0,17,4,1400,4,1400,107349.0,350.0,350.0,0,0,0.0,0.0,0.0
108100425.0,17,5,1005,5,1005,27025106.25,201.0,201.0,0,0,0.0,0.0,0.0
118604014.0,6,34,2334,17,1209,7399937.875,123.0,71.11764705882354,17,1125,7399937.5,123.0,66.17647058823529
21172.0,6,10,1949,5,441,5073.5,169.0,88.2,5,1508,4002.75,1236.0,301.6
494217.0,6,5,336,2,134,0.0,68.0,67.0,3,202,195104.5,70.0,67.33333333333333
215964.0,6,10,1221,6,636,43192.8,298.0,106.0,4,585,70639.33333333333,379.0,146.25
24141.0,6,10,2032,5,524,5751.0,252.0,104.8,5,1508,5770.0,1236.0,301.6
15092.0,6,10,1067,5,536,3608.25,264.0,107.2,5,531,2894.25,259.0,106.2
90016076.0,17,28,13364,28,13364,3333928.7407407407,501.0,477.2857142857143,0,0,0.0,0.0,0.0
233061.0,6,3,337,2,214,0.0,160.0,107.0,1,123,0.0,123.0,123.0
99146026.0,17,14,1126,7,563,16500136.5,174.0,80.42857142857143,7,563,16500572.166666666,174.0,80.42857142857143
216624.0,17,2,180,1,90,0.0,90.0,90.0,1,90,0.0,90.0,90.0
28620.0,6,14,4740,7,653,4472.166666666667,249.0,93.28571428571428,7,4087,4522.333333333333,1514.0,583.8571428571429
27194801.0,17,5,1710,5,1710,6798700.25,342.0,342.0,0,0,0.0,0.0,0.0
116386579.0,6,48,3168,24,1584,5060286.043478261,66.0,66.0,24,1584,5047023.0,66.0,66.0
105355601.0,17,12,778,6,389,17201394.8,174.0,64.83333333333333,6,389,19933482.2,174.0,64.83333333333333
10434615.0,6,7,478,4,272,3432817.6666666665,74.0,68.0,3,206,5149133.0,74.0,68.66666666666667
102810.0,17,2,286,2,286,0.0,143.0,143.0,0,0,0.0,0.0,0.0
90045907.0,17,28,13364,28,13364,3335033.592592593,501.0,477.2857142857143,0,0,0.0,0.0,0.0
135137051.0,17,6,1146,6,1146,27027410.2,191.0,191.0,0,0,0.0,0.0,0.0
626965.0,6,4,508,2,238,0.0,172.0,119.0,2,270,0.0,135.0,135.0
229543.0,6,3,426,2,280,0.0,214.0,140.0,1,146,0.0,146.0,146.0
228296.0,17,2,180,1,90,0.0,90.0,90.0,1,90,0.0,90.0,90.0
24220.0,6,10,2032,5,524,5822.25,252.0,104.8,5,1508,4757.25,1236.0,301.6
3076619.0,6,4,270,2,134,0.0,68.0,67.0,2,136,0.0,70.0,68.0
15409.0,6,10,2032,5,524,2651.5,252.0,104.8,5,1508,3597.75,1236.0,301.6
90097528.0,6,12,1848,5,1020,22523802.5,204.0,204.0,7,828,14971137.5,188.0,118.28571428571428
54565.0,6,14,4740,7,653,8945.166666666666,249.0,93.28571428571428,7,4087,8919.666666666666,1514.0,583.8571428571429
50900.0,6,14,4740,7,653,8003.333333333333,249.0,93.28571428571428,7,4087,7390.666666666667,1514.0,583.8571428571429
57090.0,6,14,4740,7,653,9295.333333333334,249.0,93.28571428571428,7,4087,8192.0,1514.0,583.8571428571429
46356.0,6,2,145,2,145,0.0,91.0,72.5,0,0,0.0,0.0,0.0
135135392.0,17,6,1146,6,1146,27027078.4,191.0,191.0,0,0,0.0,0.0,0.0
204622.0,17,2,180,1,90,0.0,90.0,90.0,1,90,0.0,90.0,90.0
108098872.0,17,5,955,5,955,27024718.0,191.0,191.0,0,0,0.0,0.0,0.0
488811.0,17,2,363,1,79,0.0,79.0,79.0,1,284,0.0,284.0,284.0
27569935.0,17,5,1710,5,1710,6892483.75,342.0,342.0,0,0,0.0,0.0,0.0
54058.0,6,14,4740,7,653,8893.333333333334,249.0,93.28571428571428,7,4087,8655.666666666666,1514.0,583.8571428571429
105362332.0,6,226,26322,113,18642,938811.1785714284,284.0,164.97345132743362,113,7680,938814.75,140.0,67.96460176991151
196849.0,17,2,180,1,90,0.0,90.0,90.0,1,90,0.0,90.0,90.0
3762565.0,6,5,336,2,134,0.0,68.0,67.0,3,202,1526058.5,70.0,67.33333333333333
29586.0,6,11,2098,6,590,5642.8,252.0,98.33333333333331,5,1508,7138.0,1236.0,301.6
5622680.0,6,4,270,2,134,0.0,68.0,67.0,2,136,0.0,70.0,68.0
3517.0,17,4,344,2,150,0.0,75.0,75.0,2,194,0.0,103.0,97.0
61787.0,6,14,4740,7,653,10062.333333333334,249.0,93.28571428571428,7,4087,10022.5,1514.0,583.8571428571429
37191.0,6,10,2032,5,524,8897.0,252.0,104.8,5,1508,8958.0,1236.0,301.6
832.0,17,4,438,2,148,0.0,74.0,74.0,2,290,0.0,147.0,145.0
60344.0,6,10,2032,5,524,14863.75,252.0,104.8,5,1508,13562.0,1236.0,301.6
2021112.0,17,4,525,2,150,0.0,75.0,75.0,2,375,0.0,284.0,187.5
10494098.0,6,7,478,4,272,3452385.6666666665,74.0,68.0,3,206,5178445.0,74.0,68.66666666666667
120120037.0,6,13,2036,8,1016,17136792.14285714,188.0,127.0,5,1020,22516293.75,204.0,204.0
156010.0,6,11,1132,6,556,30710.4,218.0,92.66666666666669,5,576,37658.25,304.0,115.2
90060129.0,17,28,13364,28,13364,3335560.333333333,501.0,477.2857142857143,0,0,0.0,0.0,0.0
108103017.0,17,5,1005,5,1005,27025754.25,201.0,201.0,0,0,0.0,0.0,0.0
16843.0,17,2,180,1,90,0.0,90.0,90.0,1,90,0.0,90.0,90.0
108122260.0,17,5,1005,5,1005,27030565.0,201.0,201.0,0,0,0.0,0.0,0.0
11699.0,17,4,823,2,163,0.0,89.0,81.5,2,660,0.0,443.0,330.0
120949956.0,6,254,28706,127,8678,936993.1428571428,140.0,68.33070866141732,127,20028,955233.8492063492,300.0,157.7007874015748
96099152.0,6,3005,601264,1503,520036,63980.79360852197,381.0,345.99866932801064,1502,81228,63983.05529646902,66.0,54.07989347536618
159804.0,6,10,1066,5,490,39170.75,218.0,98.0,5,576,37717.5,304.0,115.2
37984.0,6,10,2032,5,524,9243.25,252.0,104.8,5,1508,9206.75,1236.0,301.6
141695.0,17,4,704,2,148,0.0,74.0,74.0,2,556,0.0,280.0,278.0
1302075.0,6,4,264,2,132,0.0,66.0,66.0,2,132,0.0,66.0,66.0
2609034.0,6,2,132,1,66,0.0,66.0,66.0,1,66,0.0,66.0,66.0
32682223.0,6,5,336,2,134,0.0,68.0,67.0,3,202,14950154.0,70.0,67.33333333333333
220445.0,6,4,492,2,280,0.0,214.0,140.0,2,212,0.0,146.0,106.0
5385.0,17,2,180,1,90,0.0,90.0,90.0,1,90,0.0,90.0,90.0
141441.0,6,2,132,1,66,0.0,66.0,66.0,1,66,0.0,66.0,66.0
766.0,17,4,438,2,148,0.0,74.0,74.0,2,290,0.0,147.0,145.0
20113.0,6,10,2032,5,524,4813.25,252.0,104.8,5,1508,4456.5,1236.0,301.6
8398.0,6,10,1067,5,536,1838.0,264.0,107.2,5,531,1868.0,259.0,106.2
29782.0,6,14,4740,7,653,4501.5,249.0,93.28571428571428,7,4087,3891.6666666666665,1514.0,583.8571428571429
303764.0,6,6,412,4,272,101254.66666666669,74.0,68.0,2,140,0.0,74.0,70.0
2113.0,17,4,344,2,150,0.0,75.0,75.0,2,194,0.0,103.0,97.0
90289374.0,6,24,1829,13,989,7520051.583333333,95.0,76.07692307692308,11,840,9001227.4,95.0,76.36363636363636
4452.0,17,2,614,1,72,0.0,72.0,72.0,1,542,0.0,542.0,542.0
38852.0,6,10,2032,5,524,9493.75,252.0,104.8,5,1508,7621.5,1236.0,301.6
1247777.0,6,7,499,3,198,613896.0,66.0,66.0,4,301,391181.0,103.0,75.25
120173963.0,6,32,2242,17,1225,7510872.6875,139.0,72.05882352941177,15,1017,7855205.142857143,123.0,67.8
54268.0,6,10,2032,5,524,13120.0,252.0,104.8,5,1508,13246.5,1236.0,301.6
41240.0,6,14,4740,7,653,6196.166666666667,249.0,93.28571428571428,7,4087,6185.166666666667,1514.0,583.8571428571429
173257.0,17,4,6056,4,6056,57752.333333333336,1514.0,1514.0,0,0,0.0,0.0,0.0
325913.0,17,4,1400,4,1400,108637.66666666669,350.0,350.0,0,0,0.0,0.0,0.0
5312.0,17,4,344,2,150,0.0,75.0,75.0,2,194,0.0,103.0,97.0
190931.0,17,2,180,1,90,0.0,90.0,90.0,1,90,0.0,90.0,90.0
10471876.0,6,6,412,3,206,5168183.5,74.0,68.66666666666667,3,206,5168078.0,74.0,68.66666666666667
23263.0,6,10,2032,5,524,5077.5,252.0,104.8,5,1508,4988.5,1236.0,301.6
238571.0,6,3,426,2,280,0.0,214.0,140.0,1,146,0.0,146.0,146.0
858191.0,6,9,1096,6,625,171638.2,287.0,104.16666666666669,3,471,291143.0,331.0,157.0
222261.0,6,10,1221,6,636,44452.2,298.0,106.0,4,585,72754.66666666667,379.0,146.25
12675.0,6,10,1065,5,534,2915.5,262.0,106.8,5,531,2822.5,259.0,106.2
104571898.0,17,14,1126,7,563,17415681.166666668,174.0,80.42857142857143,7,563,17401963.833333332,174.0,80.42857142857143
2160433.0,6,24,6933,13,1996,180036.08333333334,477.0,153.53846153846155,11,4937,185403.6,1510.0,448.8181818181818
99095307.0,6,29,2062,15,1017,7078206.357142857,123.0,67.8,14,1045,6854598.846153846,139.0,74.64285714285714
15976785.0,17,6,2052,6,2052,3195357.0,342.0,342.0,0,0,0.0,0.0,0.0
196984.0,17,2,180,1,90,0.0,90.0,90.0,1,90,0.0,90.0,90.0
112689295.0,17,14,864,7,432,18667733.5,174.0,61.71428571428572,7,432,18666880.166666668,174.0,61.71428571428572
203730.0,17,4,6056,4,6056,67910.0,1514.0,1514.0,0,0,0.0,0.0,0.0
90048757.0,17,28,13364,28,13364,3335139.1481481483,501.0,477.2857142857143,0,0,0.0,0.0,0.0
118648169.0,6,206,23214,103,16108,1161107.0784313723,284.0,156.38834951456312,103,7106,1161106.1176470588,140.0,68.99029126213593
105647.0,17,2,700,2,700,0.0,350.0,350.0,0,0,0.0,0.0,0.0
90014134.0,17,28,13364,28,13364,3333856.814814815,501.0,477.2857142857143,0,0,0.0,0.0,0.0
219006.0,6,3,426,2,280,0.0,214.0,140.0,1,146,0.0,146.0,146.0
34930.0,6,14,4740,7,653,5389.833333333333,249.0,93.28571428571428,7,4087,5640.833333333333,1514.0,583.8571428571429
606321.0,17,2,346,1,78,0.0,78.0,78.0,1,268,0.0,268.0,268.0
44724.0,6,14,4740,7,653,6591.666666666667,249.0,93.28571428571428,7,4087,6786.0,1514.0,583.8571428571429
9328.0,17,4,823,2,163,0.0,89.0,81.5,2,660,0.0,443.0,330.0
298843.0,6,6,412,4,272,99614.33333333331,74.0,68.0,2,140,0.0,74.0,70.0
90015200.0,17,28,13364,28,13364,3333896.296296296,501.0,477.2857142857143,0,0,0.0,0.0,0.0
37518.0,6,14,4740,7,653,6121.166666666667,249.0,93.28571428571428,7,4087,6108.0,1514.0,583.8571428571429
10520339.0,6,7,478,4,272,3461241.6666666665,74.0,68.0,3,206,5191744.5,74.0,68.66666666666667
18329.0,6,14,4740,7,653,2882.6666666666665,249.0,93.28571428571428,7,4087,2920.1666666666665,1514.0,583.8571428571429
114895689.0,6,34,2334,17,1209,7167453.25,123.0,71.11764705882354,17,1125,7167480.0625,123.0,66.17647058823529
135137876.0,17,6,1206,6,1206,27027575.2,201.0,201.0,0,0,0.0,0.0,0.0
1168904.0,6,13,3011,8,2383,166986.2857142857,1514.0,297.875,5,628,223421.25,331.0,125.6
228134.0,17,2,180,1,90,0.0,90.0,90.0,1,90,0.0,90.0,90.0
148005.0,17,2,180,1,90,0.0,90.0,90.0,1,90,0.0,90.0,90.0
2842117.0,6,12,2172,7,664,473441.5,252.0,94.85714285714286,5,1508,2061.25,1236.0,301.6
36757.0,6,14,4740,7,653,4848.5,249.0,93.28571428571428,7,4087,5393.0,1514.0,583.8571428571429
217460.0,6,3,426,2,280,0.0,214.0,140.0,1,146,0.0,146.0,146.0
107609423.0,6,29,1983,15,1017,7686387.357142857,123.0,67.8,14,966,8260885.384615385,123.0,69.0
104181595.0,6,210,24382,105,17230,999773.2596153846,284.0,164.0952380952381,105,7152,999772.5769230768,140.0,68.11428571428571
7945.000000000001,17,4,823,2,163,0.0,89.0,81.5,2,660,0.0,443.0,330.0
28682.0,6,14,4740,7,653,4586.5,249.0,93.28571428571428,7,4087,4269.166666666667,1514.0,583.8571428571429
90027464.0,17,28,13364,28,13364,3334350.5185185187,501.0,477.2857142857143,0,0,0.0,0.0,0.0
219919.0,6,12,1373,7,714,36653.16666666666,298.0,102.0,5,659,54198.0,379.0,131.8
31755.0,6,10,2032,5,524,7549.5,252.0,104.8,5,1508,7258.0,1236.0,301.6
1023171.0,6,11,1134,6,558,204634.2,220.0,93.0,5,576,254486.75,304.0,115.2
135127132.0,17,6,1146,6,1146,27025426.4,191.0,191.0,0,0,0.0,0.0,0.0
309742.0,6,6,412,4,272,103247.33333333331,74.0,68.0,2,140,0.0,74.0,70.0
54511.0,6,14,4740,7,653,8441.0,249.0,93.28571428571428,7,4087,6866.5,1514.0,583.8571428571429
50525.0,6,14,4740,7,653,7355.833333333333,249.0,93.28571428571428,7,4087,8172.166666666667,1514.0,583.8571428571429
2536846.0,6,25,7573,14,3735,195142.0,1514.0,266.7857142857143,11,3838,227919.1,1514.0,348.90909090909093
48803.0,6,14,4740,7,653,6786.666666666667,249.0,93.28571428571428,7,4087,7549.166666666667,1514.0,583.8571428571429
44051.0,6,14,4740,7,653,7161.666666666667,249.0,93.28571428571428,7,4087,7150.666666666667,1514.0,583.8571428571429
46359.0,6,14,4740,7,653,7602.0,249.0,93.28571428571428,7,4087,7224.666666666667,1514.0,583.8571428571429
216475.0,17,2,180,1,90,0.0,90.0,90.0,1,90,0.0,90.0,90.0
29774.0,6,10,2032,5,524,6885.5,252.0,104.8,5,1508,6797.0,1236.0,301.6
82222.0,6,11,2098,6,590,16264.6,252.0,98.33333333333331,5,1508,20069.75,1236.0,301.6
93388371.0,17,16,5472,16,5472,6225891.4,342.0,342.0,0,0,0.0,0.0,0.0
91000876.0,17,13,1083,7,563,15166812.666666666,174.0,80.42857142857143,6,520,14200701.8,174.0,86.66666666666667
205497.0,17,2,762,2,762,0.0,381.0,381.0,0,0,0.0,0.0,0.0
90762307.0,6,19,1436,10,745,10078363.111111112,95.0,74.5,9,691,11344545.625,95.0,76.77777777777777
2296.0,17,2,508,2,508,0.0,257.0,254.0,0,0,0.0,0.0,0.0
204920.0,17,4,6056,4,6056,68306.66666666667,1514.0,1514.0,0,0,0.0,0.0,0.0
206424.0,6,3,426,2,280,0.0,214.0,140.0,1,146,0.0,146.0,146.0
108711655.0,6,32,2236,16,1165,7247443.666666667,139.0,72.8125,16,1071,7233024.933333334,123.0,66.9375
68483.0,6,14,4740,7,653,10900.833333333334,249.0,93.28571428571428,7,4087,10750.833333333334,1514.0,583.8571428571429
64784.99999999999,6,14,4740,7,653,10638.666666666666,249.0,93.28571428571428,7,4087,10623.833333333334,1514.0,583.8571428571429
48702.0,6,14,4740,7,653,5627.5,249.0,93.28571428571428,7,4087,7062.666666666667,1514.0,583.8571428571429
306924.0,6,6,412,4,272,102308.0,74.0,68.0,2,140,0.0,74.0,70.0
256589.0,6,3,337,2,214,0.0,160.0,107.0,1,123,0.0,123.0,123.0
2588908.0,6,2,132,1,66,0.0,66.0,66.0,1,66,0.0,66.0,66.0
308373.0,17,2,246,1,76,0.0,76.0,76.0,1,170,0.0,170.0,170.0
2049798.0,6,2,132,1,66,0.0,66.0,66.0,1,66,0.0,66.0,66.0
89.0,17,2,762,2,762,0.0,381.0,381.0,0,0,0.0,0.0,0.0
90023040.0,17,28,13364,28,13364,3334186.6666666665,501.0,477.2857142857143,0,0,0.0,0.0,0.0
103279.0,17,2,286,2,286,0.0,143.0,143.0,0,0,0.0,0.0,0.0
206112.0,6,3,426,2,280,0.0,214.0,140.0,1,146,0.0,146.0,146.0
17106.0,6,11,2098,6,590,3311.8,252.0,98.33333333333331,5,1508,3718.5,1236.0,301.6
25923.0,6,10,2032,5,524,6268.25,252.0,104.8,5,1508,5343.5,1236.0,301.6
19581.0,6,2,145,2,145,0.0,91.0,72.5,0,0,0.0,0.0,0.0
302599.0,6,6,412,4,272,100866.33333333331,74.0,68.0,2,140,0.0,74.0,70.0
2794682.0,6,2,132,1,66,0.0,66.0,66.0,1,66,0.0,66.0,66.0
5827732.0,6,5,336,2,134,0.0,68.0,67.0,3,202,1523615.5,70.0,67.33333333333333
52075.0,6,14,4740,7,653,8078.333333333333,249.0,93.28571428571428,7,4087,7688.833333333333,1514.0,583.8571428571429
29428.0,6,14,4740,7,653,3619.6666666666665,249.0,93.28571428571428,7,4087,4769.0,1514.0,583.8571428571429
53916.0,6,10,2032,5,524,13268.25,252.0,104.8,5,1508,12756.25,1236.0,301.6
101577733.0,17,14,1126,7,563,16929622.166666668,174.0,80.42857142857143,7,563,16814646.166666668,174.0,80.42857142857143
107067.0,17,2,286,2,286,0.0,143.0,143.0,0,0,0.0,0.0,0.0
301103.0,17,4,6056,4,6056,100367.66666666669,1514.0,1514.0,0,0,0.0,0.0,0.0
121007367.0,17,15,907,8,475,17286766.714285713,174.0,59.375,7,432,16833500.333333332,174.0,61.71428571428572
43673.0,6,14,4740,7,653,7075.333333333333,249.0,93.28571428571428,7,4087,7140.0,1514.0,583.8571428571429
35796.0,6,14,4740,7,653,5784.833333333333,249.0,93.28571428571428,7,4087,5602.0,1514.0,583.8571428571429
2994.0,17,2,224,1,76,0.0,76.0,76.0,1,148,0.0,148.0,148.0
315923.0,17,4,1400,4,1400,105307.66666666669,350.0,350.0,0,0,0.0,0.0,0.0
216798.0,6,3,426,2,280,0.0,214.0,140.0,1,146,0.0,146.0,146.0
205953.0,6,3,426,2,280,0.0,214.0,140.0,1,146,0.0,146.0,146.0
345721.0,17,2,335,1,88,0.0,88.0,88.0,1,247,0.0,247.0,247.0
26231.0,6,10,2032,5,524,6323.5,252.0,104.8,5,1508,6296.25,1236.0,301.6
211754.0,6,10,1221,6,636,42350.8,298.0,106.0,4,585,69533.33333333333,379.0,146.25
2114.0,17,2,691,1,349,0.0,349.0,349.0,1,342,0.0,342.0,342.0
97357718.0,17,11,735,6,389,19471543.6,174.0,64.83333333333333,5,346,19337945.5,174.0,69.2
3408165.0,6,5,336,2,134,0.0,68.0,67.0,3,202,1525940.5,70.0,67.33333333333333
135131105.0,17,6,1146,6,1146,27026221.0,191.0,191.0,0,0,0.0,0.0,0.0
135131510.0,17,6,1146,6,1146,27026302.0,191.0,191.0,0,0,0.0,0.0,0.0
108101749.0,17,5,955,5,955,27025437.25,191.0,191.0,0,0,0.0,0.0,0.0
304458.0,17,4,622,4,622,101486.0,163.0,155.5,0,0,0.0,0.0,0.0
318983.0,17,4,1400,4,1400,106327.66666666669,350.0,350.0,0,0,0.0,0.0,0.0
229839.0,6,3,426,2,280,0.0,214.0,140.0,1,146,0.0,146.0,146.0
0.0,17,1,350,1,350,0.0,350.0,350.0,0,0,0.0,0.0,0.0
46585272.0,6,8,1940,3,887,21914923.0,753.0,295.6666666666667,5,1053,11516166.25,785.0,210.6
50763.0,17,2,180,1,90,0.0,90.0,90.0,1,90,0.0,90.0,90.0
4572.0,17,2,626,1,72,0.0,72.0,72.0,1,554,0.0,554.0,554.0
108127314.0,17,5,1005,5,1005,27031828.5,201.0,201.0,0,0,0.0,0.0,0.0
90063566.0,17,28,13364,28,13364,3335687.6296296297,501.0,477.2857142857143,0,0,0.0,0.0,0.0
197223.0,17,2,180,1,90,0.0,90.0,90.0,1,90,0.0,90.0,90.0
17671.0,6,11,2098,6,590,3469.6,252.0,98.33333333333331,5,1508,3777.5,1236.0,301.6
247299.0,6,3,337,2,214,0.0,160.0,107.0,1,123,0.0,123.0,123.0
135138202.0,17,6,1206,6,1206,27027640.4,201.0,201.0,0,0,0.0,0.0,0.0
5625342.0,6,5,336,2,134,0.0,68.0,67.0,3,202,1524585.5,70.0,67.33333333333333
750105.0,6,2,132,1,66,0.0,66.0,66.0,1,66,0.0,66.0,66.0
298903.0,6,3,202,2,128,0.0,74.0,64.0,1,74,0.0,74.0,74.0
8771.0,6,11,2098,6,590,1521.6,252.0,98.33333333333331,5,1508,1909.0,1236.0,301.6
122130.0,6,3,337,2,214,0.0,160.0,107.0,1,123,0.0,123.0,123.0
20826.0,6,11,2098,6,590,3943.6,252.0,98.33333333333331,5,1508,4929.25,1236.0,301.6
135144113.0,17,6,1146,6,1146,27028822.6,191.0,191.0,0,0,0.0,0.0,0.0
299.0,17,2,174,1,79,0.0,79.0,79.0,1,95,0.0,95.0,95.0
112727.0,17,2,286,2,286,0.0,143.0,143.0,0,0,0.0,0.0,0.0
326.0,17,2,166,1,75,0.0,75.0,75.0,1,91,0.0,91.0,91.0
28820.0,6,14,4740,7,653,4678.833333333333,249.0,93.28571428571428,7,4087,4164.666666666667,1514.0,583.8571428571429
0.0,17,1,350,1,350,0.0,350.0,350.0,0,0,0.0,0.0,0.0
883856.0,6,12,2709,7,742,147309.33333333334,338.0,106.0,5,1967,152802.5,1514.0,393.4
58768013.0,17,9,3086,8,2736,5110031.571428572,342.0,342.0,1,350,0.0,350.0,350.0
350345.0,17,4,704,2,148,0.0,74.0,74.0,2,556,0.0,280.0,278.0
1302246.0,6,4,264,2,132,0.0,66.0,66.0,2,132,0.0,66.0,66.0
110715.0,17,2,286,2,286,0.0,143.0,143.0,0,0,0.0,0.0,0.0
89258.0,6,2,132,1,66,0.0,66.0,66.0,1,66,0.0,66.0,66.0
108098642.0,6,32,2220,16,1149,7206576.133333334,123.0,71.8125,16,1071,7192157.0,123.0,66.9375
22970.0,6,14,4740,7,653,3459.1666666666665,249.0,93.28571428571428,7,4087,3406.6666666666665,1514.0,583.8571428571429
36009.0,6,14,4740,7,653,5746.833333333333,249.0,93.28571428571428,7,4087,5117.0,1514.0,583.8571428571429
2851350.0,6,11,2106,6,598,569815.6,252.0,99.66666666666669,5,1508,3572.5,1236.0,301.6
45556.0,6,14,4740,7,653,7408.0,249.0,93.28571428571428,7,4087,6806.166666666667,1514.0,583.8571428571429
46557.0,6,11,2098,6,590,8270.8,252.0,98.33333333333331,5,1508,10943.75,1236.0,301.6
1995.0,17,2,684,1,342,0.0,342.0,342.0,1,342,0.0,342.0,342.0
39202.0,6,14,4740,7,653,6044.0,249.0,93.28571428571428,7,4087,5812.5,1514.0,583.8571428571429
349.0,17,2,267,1,83,0.0,83.0,83.0,1,184,0.0,184.0,184.0
103480.0,17,2,286,2,286,0.0,143.0,143.0,0,0,0.0,0.0,0.0
1631726.0,6,20,6434,12,1921,148338.72727272726,620.0,160.08333333333334,8,4513,191589.2857142857,1514.0,564.125
92713758.0,6,38,2508,19,1254,5135437.777777778,66.0,66.0,19,1254,5135480.444444444,66.0,66.0
216352.0,17,2,180,1,90,0.0,90.0,90.0,1,90,0.0,90.0,90.0
18985.0,6,11,1133,6,602,3525.2,264.0,100.33333333333331,5,531,4128.75,259.0,106.2
0.0,17,1,218,1,218,0.0,218.0,218.0,0,0,0.0,0.0,0.0
60681.0,6,14,4740,7,653,9969.166666666666,249.0,93.28571428571428,7,4087,8749.666666666666,1514.0,583.8571428571429
1159030.0,6,13,3010,8,2382,165575.7142857143,1514.0,297.75,5,628,221561.5,331.0,125.6
125754436.0,6,63,5482,36,3058,3592983.885714285,139.0,84.94444444444444,27,2424,4444305.615384615,123.0,89.77777777777777
143985.0,17,2,180,1,90,0.0,90.0,90.0,1,90,0.0,90.0,90.0
196923.0,17,2,180,1,90,0.0,90.0,90.0,1,90,0.0,90.0,90.0
300.0,17,2,156,1,78,0.0,78.0,78.0,1,78,0.0,78.0,78.0
90956268.0,6,21,1585,11,840,9095118.8,95.0,76.36363636363636,10,745,10105631.555555556,95.0,74.5
628068.0,6,4,508,2,238,0.0,172.0,119.0,2,270,0.0,135.0,135.0
5000870.0,17,4,849,2,166,0.0,83.0,83.0,2,683,0.0,499.0,341.5
100903.0,17,2,286,2,286,0.0,143.0,143.0,0,0,0.0,0.0,0.0
59944.0,6,14,4740,7,653,9859.0,249.0,93.28571428571428,7,4087,9442.5,1514.0,583.8571428571429
121321.0,6,3,337,2,214,0.0,160.0,107.0,1,123,0.0,123.0,123.0
213585.0,17,2,180,1,90,0.0,90.0,90.0,1,90,0.0,90.0,90.0
120210486.0,6,30,1990,15,1042,8570963.285714285,139.0,69.46666666666667,15,948,8571033.357142856,123.0,63.2
14638340.0,6,20,1648,10,1016,1592758.111111111,315.0,101.6,10,632,1592714.7777777778,78.0,63.2
47809.0,6,10,2032,5,524,11253.25,252.0,104.8,5,1508,10836.0,1236.0,301.6
2460.0,17,4,344,2,150,0.0,75.0,75.0,2,194,0.0,103.0,97.0
244656.0,6,3,337,2,214,0.0,160.0,107.0,1,123,0.0,123.0,123.0
90246147.0,6,13,2036,8,1016,12892306.714285716,188.0,127.0,5,1020,22514648.75,204.0,204.0
42190.0,6,14,4740,7,653,6417.166666666667,249.0,93.28571428571428,7,4087,6785.833333333333,1514.0,583.8571428571429
32911.0,6,13,1394,7,797,5431.833333333333,253.0,113.85714285714286,6,597,5750.6,259.0,99.5
123840044.0,6,49,3234,25,1650,5160001.833333333,66.0,66.0,24,1584,5107168.695652174,66.0,66.0
113962367.0,6,48,3168,24,1584,4954885.521739131,66.0,66.0,24,1584,4945487.652173913,66.0,66.0
6262.0,17,2,762,2,762,0.0,381.0,381.0,0,0,0.0,0.0,0.0
298437.0,6,6,412,4,272,99479.0,74.0,68.0,2,140,0.0,74.0,70.0
321572.0,6,6,412,4,272,107190.66666666669,74.0,68.0,2,140,0.0,74.0,70.0
96945117.0,6,193,21820,97,15262,1009844.96875,284.0,157.340206185567,96,6558,1009567.0315789472,140.0,68.3125
120293474.0,6,223,25262,111,17574,1086300.6454545455,284.0,158.32432432432432,112,7688,1081775.2342342343,140.0,68.64285714285714
2359.0,17,4,344,2,150,0.0,75.0,75.0,2,194,0.0,103.0,97.0
135122292.0,17,6,1206,6,1206,27024458.4,201.0,201.0,0,0,0.0,0.0,0.0
233009.0,6,3,337,2,214,0.0,160.0,107.0,1,123,0.0,123.0,123.0
266275.0,6,10,1221,6,636,53255.0,298.0,106.0,4,585,82803.0,379.0,146.25
1172038.0,6,13,3009,8,2381,167434.0,1514.0,297.625,5,628,224872.5,331.0,125.6
748178.0,6,2,132,1,66,0.0,66.0,66.0,1,66,0.0,66.0,66.0
307491.0,6,6,412,4,272,102497.0,74.0,68.0,2,140,0.0,74.0,70.0
1104757.0,6,13,1394,7,797,184126.16666666663,253.0,113.85714285714286,6,597,217917.8,259.0,99.5
90043136.0,17,28,13364,28,13364,3334930.962962963,501.0,477.2857142857143,0,0,0.0,0.0,0.0
290094.0,6,10,1221,6,636,58018.8,298.0,106.0,4,585,90511.33333333331,379.0,146.25
51160.0,6,14,4740,7,653,7945.333333333333,249.0,93.28571428571428,7,4087,6715.666666666667,1514.0,583.8571428571429
90017239.0,17,28,13364,28,13364,3333971.814814815,501.0,477.2857142857143,0,0,0.0,0.0,0.0
104208.0,17,2,286,2,286,0.0,143.0,143.0,0,0,0.0,0.0,0.0
135131151.0,17,6,1206,6,1206,27026230.2,201.0,201.0,0,0,0.0,0.0,0.0
2821521.0,6,11,2106,6,598,564121.2,252.0,99.66666666666669,5,1508,5053.0,1236.0,301.6
90534129.0,6,14,2240,8,1016,12933447.0,188.0,127.0,6,1224,18074237.2,204.0,204.0
120123817.0,6,15,2290,9,1204,15015477.125,188.0,133.77777777777777,6,1086,18019108.6,204.0,181.0
102530.0,17,2,762,2,762,0.0,381.0,381.0,0,0,0.0,0.0,0.0
151.0,17,2,700,2,700,0.0,350.0,350.0,0,0,0.0,0.0,0.0
15077.0,6,13,1459,7,862,2339.833333333333,271.0,123.14285714285714,6,597,2562.6,259.0,99.5
46067.0,6,2,132,1,66,0.0,66.0,66.0,1,66,0.0,66.0,66.0
0.0,17,1,90,1,90,0.0,90.0,90.0,0,0,0.0,0.0,0.0
4186.0,17,2,614,1,72,0.0,72.0,72.0,1,542,0.0,542.0,542.0
252248.00000000003,6,3,337,2,214,0.0,160.0,107.0,1,123,0.0,123.0,123.0
120458732.0,6,251,28370,126,19824,963669.856,284.0,157.33333333333334,125,8546,963080.7177419356,140.0,68.368
108119976.0,17,5,1005,5,1005,27029994.0,201.0,201.0,0,0,0.0,0.0,0.0
104307.0,17,2,700,2,700,0.0,350.0,350.0,0,0,0.0,0.0,0.0
153450.0,17,2,180,1,90,0.0,90.0,90.0,1,90,0.0,90.0,90.0
2068.0,17,4,344,2,150,0.0,75.0,75.0,2,194,0.0,103.0,97.0
217942.0,6,3,426,2,280,0.0,214.0,140.0,1,146,0.0,146.0,146.0
4226.0,17,2,582,1,83,0.0,83.0,83.0,1,499,0.0,499.0,499.0
28107.0,6,13,1386,7,789,4610.833333333333,253.0,112.71428571428572,6,597,4281.8,259.0,99.5
198690.0,17,2,180,1,90,0.0,90.0,90.0,1,90,0.0,90.0,90.0
103168035.0,6,41,2706,21,1386,5158401.75,66.0,66.0,20,1320,5138949.736842105,66.0,66.0
297523.0,6,6,412,4,272,99174.33333333331,74.0,68.0,2,140,0.0,74.0,70.0
510746.00000000006,6,5,336,2,134,0.0,68.0,67.0,3,202,195112.5,70.0,67.33333333333333
237637.0,6,3,373,2,238,0.0,172.0,119.0,1,135,0.0,135.0,135.0
13344.0,6,11,2098,6,590,2469.2,252.0,98.33333333333331,5,1508,2831.75,1236.0,301.6
24721867.0,17,5,1718,4,1368,980703.6666666666,342.0,342.0,1,350,0.0,350.0,350.0
120013673.0,17,28,13364,28,13364,4444950.851851852,501.0,477.2857142857143,0,0,0.0,0.0,0.0
90276563.0,6,15,1097,8,596,12896651.857142856,95.0,74.5,7,501,14998384.5,95.0,71.57142857142857
104051.0,17,2,286,2,286,0.0,143.0,143.0,0,0,0.0,0.0,0.0
233192.0,17,4,1524,4,1524,77730.66666666667,381.0,381.0,0,0,0.0,0.0,0.0
10374.0,6,10,1975,5,467,2318.0,195.0,93.4,5,1508,2024.25,1236.0,301.6
312386.0,17,4,1400,4,1400,104128.66666666669,350.0,350.0,0,0,0.0,0.0,0.0
207673.0,17,2,762,2,762,0.0,381.0,381.0,0,0,0.0,0.0,0.0
36079.0,6,14,4740,7,653,5569.166666666667,249.0,93.28571428571428,7,4087,5727.666666666667,1514.0,583.8571428571429
90285044.0,6,15,1097,8,596,12897863.42857143,95.0,74.5,7,501,14999022.666666666,95.0,71.57142857142857
59536.0,6,14,4740,7,653,9483.166666666666,249.0,93.28571428571428,7,4087,6381.0,1514.0,583.8571428571429
120003393.0,6,18,1341,9,691,14999772.625,95.0,76.77777777777777,9,650,14998491.5,95.0,72.22222222222223
36358.0,6,14,4740,7,653,5937.166666666667,249.0,93.28571428571428,7,4087,5686.166666666667,1514.0,583.8571428571429
104539297.0,6,44,2904,22,1452,4978061.761904762,66.0,66.0,22,1452,4963589.285714285,66.0,66.0
90048334.0,17,28,13364,28,13364,3335123.4814814813,501.0,477.2857142857143,0,0,0.0,0.0,0.0
14631786.0,6,20,1607,10,975,1592364.6666666667,315.0,97.5,10,632,1592334.2222222222,78.0,63.2
1307996.0,6,4,264,2,132,0.0,66.0,66.0,2,132,0.0,66.0,66.0
293872.0,6,10,1221,6,636,58774.4,298.0,106.0,4,585,92134.33333333331,379.0,146.25
9350.0,17,2,582,1,83,0.0,83.0,83.0,1,499,0.0,499.0,499.0
1698888.0,6,40,23531,21,1550,84944.4,222.0,73.80952380952381,19,21981,94092.11111111112,1514.0,1156.8947368421052
108110021.0,17,5,955,5,955,27027505.25,191.0,191.0,0,0,0.0,0.0,0.0
208411.0,6,3,426,2,280,0.0,214.0,140.0,1,146,0.0,146.0,146.0
279709.0,17,2,180,1,90,0.0,90.0,90.0,1,90,0.0,90.0,90.0
35298.0,6,14,4740,7,653,5723.166666666667,249.0,93.28571428571428,7,4087,5660.166666666667,1514.0,583.8571428571429
34686.0,6,2,145,2,145,0.0,91.0,72.5,0,0,0.0,0.0,0.0
691.0,17,4,438,2,148,0.0,74.0,74.0,2,290,0.0,147.0,145.0
46232.0,6,14,4740,7,653,5030.833333333333,249.0,93.28571428571428,7,4087,7416.5,1514.0,583.8571428571429
26714.0,6,10,2032,5,524,6032.75,252.0,104.8,5,1508,4884.5,1236.0,301.6
90024821.0,17,28,13364,28,13364,3334252.6296296297,501.0,477.2857142857143,0,0,0.0,0.0,0.0
113255099.0,6,46,3036,23,1518,5135442.863636363,66.0,66.0,23,1518,5135448.363636363,66.0,66.0
57962.0,6,14,4740,7,653,8799.0,249.0,93.28571428571428,7,4087,9516.0,1514.0,583.8571428571429
127920891.0,6,50,4188,28,2310,4737810.777777778,123.0,82.5,22,1878,5605537.571428572,123.0,85.36363636363636
118188744.0,6,48,3168,24,1584,5138641.043478261,66.0,66.0,24,1584,5125176.478260869,66.0,66.0
9517.0,17,2,571,1,86,0.0,86.0,86.0,1,485,0.0,485.0,485.0
111607.0,17,4,1400,4,1400,37202.333333333336,350.0,350.0,0,0,0.0,0.0,0.0
102370256.0,17,14,1126,7,563,17001348.5,174.0,80.42857142857143,7,563,17000141.333333332,174.0,80.42857142857143
190827.0,17,2,180,1,90,0.0,90.0,90.0,1,90,0.0,90.0,90.0
192922.0,17,2,180,1,90,0.0,90.0,90.0,1,90,0.0,90.0,90.0
2495.0,17,4,344,2,150,0.0,75.0,75.0,2,194,0.0,103.0,97.0
216431.0,17,2,180,1,90,0.0,90.0,90.0,1,90,0.0,90.0,90.0
157868.0,17,2,180,1,90,0.0,90.0,90.0,1,90,0.0,90.0,90.0
34921.0,6,14,4740,7,653,5696.166666666667,249.0,93.28571428571428,7,4087,5565.666666666667,1514.0,583.8571428571429
1740913.0,6,23,6509,12,1529,158264.81818181818,357.0,127.41666666666669,11,4980,143517.9,1510.0,452.7272727272728
23474.0,6,10,2032,5,524,5644.75,252.0,104.8,5,1508,5631.75,1236.0,301.6
147927.0,17,2,180,1,90,0.0,90.0,90.0,1,90,0.0,90.0,90.0
246457.0,6,3,337,2,214,0.0,160.0,107.0,1,123,0.0,123.0,123.0
306548.0,6,6,412,4,272,102182.66666666669,74.0,68.0,2,140,0.0,74.0,70.0
44466.0,6,14,4740,7,653,7286.0,249.0,93.28571428571428,7,4087,7142.0,1514.0,583.8571428571429
204652.0,17,2,762,2,762,0.0,381.0,381.0,0,0,0.0,0.0,0.0
2112.0,17,4,344,2,150,0.0,75.0,75.0,2,194,0.0,103.0,97.0
104229912.0,6,30,2106,15,1089,7429564.428571428,123.0,72.6,15,1017,7429558.0,123.0,67.8
27093695.0,17,5,1710,5,1710,6773423.75,342.0,342.0,0,0,0.0,0.0,0.0
242761.0,6,3,337,2,214,0.0,160.0,107.0,1,123,0.0,123.0,123.0
205979.0,17,2,180,1,90,0.0,90.0,90.0,1,90,0.0,90.0,90.0
99289464.0,6,186,21026,93,14654,1076778.2173913044,300.0,157.56989247311827,93,6372,1076777.7282608696,140.0,68.51612903225806
336.0,17,2,166,1,75,0.0,75.0,75.0,1,91,0.0,91.0,91.0
135130690.0,17,6,1146,6,1146,27026138.0,191.0,191.0,0,0,0.0,0.0,0.0
107932.0,17,2,286,2,286,0.0,143.0,143.0,0,0,0.0,0.0,0.0
112979735.0,6,45,2970,23,1518,5135442.5,66.0,66.0,22,1452,5025998.904761905,66.0,66.0
115398351.0,17,14,864,7,432,19168355.166666668,174.0,61.71428571428572,7,432,19166824.33333333,174.0,61.71428571428572
112665813.0,6,48,3168,24,1584,4898513.608695652,66.0,66.0,24,1584,4889730.869565218,66.0,66.0
31749.0,6,14,4740,7,653,4958.5,249.0,93.28571428571428,7,4087,4743.833333333333,1514.0,583.8571428571429
204564.0,17,2,762,2,762,0.0,381.0,381.0,0,0,0.0,0.0,0.0
35625.0,6,10,2032,5,524,8407.25,252.0,104.8,5,1508,8581.5,1236.0,301.6
264416.0,6,10,1221,6,636,52883.2,298.0,106.0,4,585,87204.66666666666,379.0,146.25
0.0,6,1,66,1,66,0.0,66.0,66.0,0,0,0.0,0.0,0.0
216594.0,6,3,426,2,280,0.0,214.0,140.0,1,146,0.0,146.0,146.0
90212251.0,6,16,1192,8,596,12852401.42857143,95.0,74.5,8,596,12856702.285714284,95.0,74.5
5816251.0,6,5,336,2,134,0.0,68.0,67.0,3,202,1526438.5,70.0,67.33333333333333
94603847.0,6,40,2640,20,1320,4979149.842105263,66.0,66.0,20,1320,4962604.52631579,66.0,66.0
101662.0,17,2,762,2,762,0.0,381.0,381.0,0,0,0.0,0.0,0.0
303126.0,6,2,132,1,66,0.0,66.0,66.0,1,66,0.0,66.0,66.0
599517.0,17,3,551,2,156,0.0,78.0,78.0,1,395,0.0,395.0,395.0
3781031.0,6,5,336,2,134,0.0,68.0,67.0,3,202,1525960.0,70.0,67.33333333333333
376.0,17,2,216,1,84,0.0,84.0,84.0,1,132,0.0,132.0,132.0
14495.0,6,10,1066,5,490,3394.25,218.0,98.0,5,576,3407.0,304.0,115.2
14051.0,6,10,2032,5,524,2838.5,252.0,104.8,5,1508,3234.75,1236.0,301.6
153480.0,17,2,180,1,90,0.0,90.0,90.0,1,90,0.0,90.0,90.0
242802.0,17,4,1400,4,1400,80934.0,350.0,350.0,0,0,0.0,0.0,0.0
120125902.0,6,13,2020,9,1204,15015737.75,188.0,133.77777777777777,4,816,30031152.0,204.0,204.0
265627.0,6,12,1373,7,714,44271.16666666666,298.0,102.0,5,659,62364.25,379.0,131.8
1165282.0,6,13,3013,8,2385,166468.85714285713,1514.0,298.125,5,628,223198.5,331.0,125.6
110231799.0,6,197,22170,99,6768,1124814.275510204,140.0,68.36363636363636,98,15402,1095020.7113402062,284.0,157.16326530612244
69584.0,6,14,4740,7,653,11488.333333333334,249.0,93.28571428571428,7,4087,10775.333333333334,1514.0,583.8571428571429
307244.0,6,6,412,4,272,102414.66666666669,74.0,68.0,2,140,0.0,74.0,70.0
336.0,17,2,166,1,75,0.0,75.0,75.0,1,91,0.0,91.0,91.0
96774.0,6,14,4740,7,653,15033.333333333334,249.0,93.28571428571428,7,4087,15919.0,1514.0,583.8571428571429
65775.0,6,10,2032,5,524,15955.75,252.0,104.8,5,1508,12803.0,1236.0,301.6
16582.0,6,10,1067,5,536,3967.5,264.0,107.2,5,531,3541.0,259.0,106.2
31824.0,6,10,2032,5,524,7687.75,252.0,104.8,5,1508,7737.75,1236.0,301.6
14098.0,6,14,4740,7,653,2193.833333333333,249.0,93.28571428571428,7,4087,2210.0,1514.0,583.8571428571429
122978364.0,6,48,3168,24,1584,5051989.565217392,66.0,66.0,24,1584,5215218.260869565,66.0,66.0
513423.0,6,5,336,2,134,0.0,68.0,67.0,3,202,194897.5,70.0,67.33333333333333
2599419.0,6,2,132,1,66,0.0,66.0,66.0,1,66,0.0,66.0,66.0
424176.0,17,2,363,1,75,0.0,75.0,75.0,1,288,0.0,288.0,288.0
427445.0,6,15,1717,8,1042,61063.57142857143,253.0,130.25,7,675,70166.33333333333,259.0,96.42857142857144
1024969.0,6,11,1134,6,558,204993.8,220.0,93.0,5,576,255331.75,304.0,115.2
1297432.0,6,4,264,2,132,0.0,66.0,66.0,2,132,0.0,66.0,66.0
2481665.0,6,3,1604,1,753,0.0,753.0,753.0,2,851,0.0,785.0,425.5
120124325.0,6,14,2240,6,1224,24024865.0,204.0,204.0,8,1016,17098656.285714287,188.0,127.0
300114.0,6,6,412,4,272,100038.0,74.0,68.0,2,140,0.0,74.0,70.0
204095.0,17,2,762,2,762,0.0,381.0,381.0,0,0,0.0,0.0,0.0
114479733.0,6,214,24090,107,16806,1077967.9811320754,284.0,157.06542056074767,107,7284,1077967.5849056605,140.0,68.07476635514018
22983.0,6,14,4740,7,653,3663.0,249.0,93.28571428571428,7,4087,3596.5,1514.0,583.8571428571429
21398.0,6,11,1132,6,556,3833.4,218.0,92.66666666666669,5,576,5146.25,304.0,115.2
120197300.0,6,18,1341,9,691,14999067.625,95.0,76.77777777777777,9,650,14999066.0,95.0,72.22222222222223
12965.0,6,10,2032,5,524,2915.75,252.0,104.8,5,1508,2517.5,1236.0,301.6
30973.0,6,2,145,2,145,0.0,91.0,72.5,0,0,0.0,0.0,0.0
22966.0,6,14,4740,7,653,3369.833333333333,249.0,93.28571428571428,7,4087,3617.3333333333335,1514.0,583.8571428571429
90259491.0,6,14,1964,8,1016,12894213.0,188.0,127.0,6,948,18016887.0,204.0,158.0
858.0,17,2,762,2,762,0.0,381.0,381.0,0,0,0.0,0.0,0.0
5004930.0,17,4,849,2,166,0.0,83.0,83.0,2,683,0.0,499.0,341.5
108465303.0,6,43,2838,22,1452,5165001.857142857,66.0,66.0,21,1386,5160033.15,66.0,66.0
119716464.0,17,35,16705,35,16705,3521072.470588235,501.0,477.2857142857143,0,0,0.0,0.0,0.0
302284.0,6,6,412,4,272,100761.33333333331,74.0,68.0,2,140,0.0,74.0,70.0
120737902.0,6,19,1477,9,732,15092237.75,95.0,81.33333333333333,10,745,13303851.888888888,95.0,74.5
209975.0,6,3,426,2,280,0.0,214.0,140.0,1,146,0.0,146.0,146.0
207069.0,6,3,426,2,280,0.0,214.0,140.0,1,146,0.0,146.0,146.0
34137.0,6,14,4740,7,653,5466.0,249.0,93.28571428571428,7,4087,5245.5,1514.0,583.8571428571429
108130618.0,17,5,955,5,955,27032654.5,191.0,191.0,0,0,0.0,0.0,0.0
28484.0,6,14,4740,7,653,4042.3333333333335,249.0,93.28571428571428,7,4087,4241.333333333333,1514.0,583.8571428571429
13622071.0,6,19,1553,9,921,1663977.625,315.0,102.33333333333331,10,632,1479054.888888889,78.0,63.2
232780.0,6,3,337,2,214,0.0,160.0,107.0,1,123,0.0,123.0,123.0
274144.0,6,10,1221,6,636,54828.8,298.0,106.0,4,585,83570.0,379.0,146.25
121171.0,6,3,337,2,214,0.0,160.0,107.0,1,123,0.0,123.0,123.0
120110554.0,6,214,24218,107,7358,1125517.79245283,140.0,68.76635514018692,107,16860,1125953.9150943395,284.0,157.57009345794393
24205.0,6,14,4740,7,653,3835.5,249.0,93.28571428571428,7,4087,3764.5,1514.0,583.8571428571429
205955.0,17,2,762,2,762,0.0,381.0,381.0,0,0,0.0,0.0,0.0
451.0,17,2,508,2,508,0.0,257.0,254.0,0,0,0.0,0.0,0.0
113074451.0,6,31,2182,16,1165,7523880.133333334,139.0,72.8125,15,1017,8061328.142857143,123.0,67.8
135140960.0,17,6,1146,6,1146,27028192.0,191.0,191.0,0,0,0.0,0.0,0.0
107941135.0,6,28,1860,14,966,8286538.769230769,123.0,69.0,14,894,8286562.923076923,123.0,63.85714285714285
79969.0,6,14,4740,7,653,12639.666666666666,249.0,93.28571428571428,7,4087,11915.333333333334,1514.0,583.8571428571429
236594.0,6,3,337,2,214,0.0,160.0,107.0,1,123,0.0,123.0,123.0
200586.0,17,2,180,1,90,0.0,90.0,90.0,1,90,0.0,90.0,90.0
209506.0,17,2,180,1,90,0.0,90.0,90.0,1,90,0.0,90.0,90.0
10460464.0,6,7,478,4,272,3441080.6666666665,74.0,68.0,3,206,5161517.5,74.0,68.66666666666667
23820.0,6,10,2032,5,524,5666.5,252.0,104.8,5,1508,5602.5,1236.0,301.6
115470715.0,6,216,24424,108,17000,1077153.1028037383,284.0,157.40740740740742,108,7424,1077153.4485981308,140.0,68.74074074074075
303152.0,6,2,132,1,66,0.0,66.0,66.0,1,66,0.0,66.0,66.0
31128.0,6,10,2032,5,524,6363.0,252.0,104.8,5,1508,7462.0,1236.0,301.6
2081.0,17,4,344,2,150,0.0,75.0,75.0,2,194,0.0,103.0,97.0
123257925.0,6,48,3168,25,1650,5135746.875,66.0,66.0,23,1518,5135445.7727272725,66.0,66.0
321491.0,17,2,180,1,90,0.0,90.0,90.0,1,90,0.0,90.0,90.0
275213.0,17,4,1524,4,1524,91737.66666666669,381.0,381.0,0,0,0.0,0.0,0.0
2025.0,17,4,344,2,150,0.0,75.0,75.0,2,194,0.0,103.0,97.0
113735758.0,6,46,3036,23,1518,5155443.045454546,66.0,66.0,23,1518,5155600.5,66.0,66.0
107859917.0,6,28,1860,14,966,8280313.846153846,123.0,69.0,14,894,8280314.076923077,123.0,63.85714285714285
774.0,17,4,438,2,148,0.0,74.0,74.0,2,290,0.0,147.0,145.0
340.0,17,2,267,1,83,0.0,83.0,83.0,1,184,0.0,184.0,184.0
298663.0,6,6,412,4,272,99554.33333333331,74.0,68.0,2,140,0.0,74.0,70.0
90257834.0,6,12,1832,8,1016,12893976.285714284,188.0,127.0,4,816,30031672.0,204.0,204.0
329920.0,6,10,1221,6,636,65984.0,298.0,106.0,4,585,104359.33333333331,379.0,146.25
18246.0,6,11,1133,6,602,3304.4,264.0,100.33333333333331,5,531,4107.5,259.0,106.2
248282.0,6,3,337,2,214,0.0,160.0,107.0,1,123,0.0,123.0,123.0
301772.0,6,6,412,4,272,100590.66666666669,74.0,68.0,2,140,0.0,74.0,70.0
320.0,17,2,168,1,76,0.0,76.0,76.0,1,92,0.0,92.0,92.0
233411.0,6,3,373,2,238,0.0,172.0,119.0,1,135,0.0,135.0,135.0
249184.0,6,3,337,2,214,0.0,160.0,107.0,1,123,0.0,123.0,123.0
205027.0,17,3,1143,3,1143,102513.5,381.0,381.0,0,0,0.0,0.0,0.0
205991.0,17,2,762,2,762,0.0,381.0,381.0,0,0,0.0,0.0,0.0
2758153.0,6,3,1604,2,851,0.0,785.0,425.5,1,753,0.0,753.0,753.0
103458.0,17,2,286,2,286,0.0,143.0,143.0,0,0,0.0,0.0,0.0
126666577.0,17,14,864,7,432,17834292.0,174.0,61.71428571428572,7,432,17833535.5,174.0,61.71428571428572
323.0,17,2,174,1,79,0.0,79.0,79.0,1,95,0.0,95.0,95.0
530584.0,6,5,336,2,134,0.0,68.0,67.0,3,202,209148.5,70.0,67.33333333333333
120021905.0,6,22,1680,11,840,12002190.5,95.0,76.36363636363636,11,840,8978304.1,95.0,76.36363636363636
2275.0,17,4,344,2,150,0.0,75.0,75.0,2,194,0.0,103.0,97.0
349.0,17,2,267,1,83,0.0,83.0,83.0,1,184,0.0,184.0,184.0
218021.0,6,3,426,2,280,0.0,214.0,140.0,1,146,0.0,146.0,146.0
120585604.0,6,439,52710,220,38034,550619.196347032,336.0,172.88181818181818,219,14676,545756.7660550459,140.0,67.01369863013699
109076.0,17,2,286,2,286,0.0,143.0,143.0,0,0,0.0,0.0,0.0
38716.0,6,14,4740,7,653,5984.0,249.0,93.28571428571428,7,4087,5709.166666666667,1514.0,583.8571428571429
178094.0,17,4,1524,4,1524,59364.66666666666,381.0,381.0,0,0,0.0,0.0,0.0
1175112.0,6,13,3000,8,2372,167873.14285714287,1514.0,296.5,5,628,225601.25,331.0,125.6
307223.0,6,6,412,4,272,102407.66666666669,74.0,68.0,2,140,0.0,74.0,70.0
90363192.0,6,12,1848,7,828,15060532.0,188.0,118.28571428571428,5,1020,15083854.25,204.0,204.0
2306.0,17,4,344,2,150,0.0,75.0,75.0,2,194,0.0,103.0,97.0
41024.0,6,14,4740,7,653,6667.666666666667,249.0,93.28571428571428,7,4087,6302.833333333333,1514.0,583.8571428571429
108512.0,17,2,286,2,286,0.0,143.0,143.0,0,0,0.0,0.0,0.0
1427838.0,17,16,1120,16,1120,95189.2,70.0,70.0,0,0,0.0,0.0,0.0
20246.0,6,14,4740,7,653,3196.1666666666665,249.0,93.28571428571428,7,4087,3239.833333333333,1514.0,583.8571428571429
186167.0,17,2,180,1,90,0.0,90.0,90.0,1,90,0.0,90.0,90.0
314936.0,17,4,1400,4,1400,104978.66666666669,350.0,350.0,0,0,0.0,0.0,0.0
120466585.0,6,243,28086,122,19804,995591.611570248,300.0,162.327868852459,121,8282,986593.8333333334,140.0,68.44628099173553
47077.0,6,14,4740,7,653,6677.666666666667,249.0,93.28571428571428,7,4087,7198.166666666667,1514.0,583.8571428571429
3696.0,17,4,344,2,150,0.0,75.0,75.0,2,194,0.0,103.0,97.0
105088.0,17,2,700,2,700,0.0,350.0,350.0,0,0,0.0,0.0,0.0
104373726.0,6,32,2236,16,1165,6943869.133333334,139.0,72.8125,16,1071,6943869.4,123.0,66.9375
1291600.0,6,4,264,2,132,0.0,66.0,66.0,2,132,0.0,66.0,66.0
298.0,17,2,156,1,78,0.0,78.0,78.0,1,78,0.0,78.0,78.0
311960.0,6,6,412,4,272,103986.66666666669,74.0,68.0,2,140,0.0,74.0,70.0
1066934.0,6,3,204,2,136,0.0,70.0,68.0,1,68,0.0,68.0,68.0
1075976.0,6,13,1386,7,789,179329.33333333334,253.0,112.71428571428572,6,597,211775.8,259.0,99.5
12934742.0,17,20,7552,20,7552,680775.8947368421,394.0,377.6,0,0,0.0,0.0,0.0
205885.0,6,3,426,2,280,0.0,214.0,140.0,1,146,0.0,146.0,146.0
19254.0,6,20,7606,11,978,1925.4,310.0,88.9090909090909,9,6628,2072.875,1514.0,736.4444444444445
2093827.0,6,18,6803,10,1501,232647.44444444444,408.0,150.1,8,5302,236845.8571428572,1514.0,662.75
303863.0,6,6,412,4,272,101287.66666666669,74.0,68.0,2,140,0.0,74.0,70.0
6782.0,17,4,823,2,163,0.0,89.0,81.5,2,660,0.0,443.0,330.0
90555160.0,6,16,2510,8,1016,12936451.42857143,188.0,127.0,8,1494,12913530.42857143,204.0,186.75
5627947.0,6,4,270,2,134,0.0,68.0,67.0,2,136,0.0,70.0,68.0
0.0,17,1,453,1,453,0.0,453.0,453.0,0,0,0.0,0.0,0.0
232422.0,6,3,337,2,214,0.0,160.0,107.0,1,123,0.0,123.0,123.0
509414.00000000006,6,5,336,2,134,0.0,68.0,67.0,3,202,193368.0,70.0,67.33333333333333
304052.0,6,6,412,4,272,101350.66666666669,74.0,68.0,2,140,0.0,74.0,70.0
5677.0,17,2,239,1,82,0.0,82.0,82.0,1,157,0.0,157.0,157.0
90031819.0,17,28,13364,28,13364,3334511.814814815,501.0,477.2857142857143,0,0,0.0,0.0,0.0
125888199.0,17,14,864,7,432,17666840.5,174.0,61.71428571428572,7,432,17667947.166666668,174.0,61.71428571428572
110728.0,17,2,286,2,286,0.0,143.0,143.0,0,0,0.0,0.0,0.0
2144466.0,6,19,6869,11,1567,214446.6,408.0,142.45454545454547,8,5302,244488.8571428572,1514.0,662.75
27972.0,6,14,4740,7,653,4549.333333333333,249.0,93.28571428571428,7,4087,4469.166666666667,1514.0,583.8571428571429
317898.0,17,4,1400,4,1400,105966.0,350.0,350.0,0,0,0.0,0.0,0.0
232185.0,6,3,337,2,214,0.0,160.0,107.0,1,123,0.0,123.0,123.0
330.0,17,2,160,1,80,0.0,80.0,80.0,1,80,0.0,80.0,80.0
829.0,17,4,438,2,148,0.0,74.0,74.0,2,290,0.0,147.0,145.0
50794.0,17,2,180,1,90,0.0,90.0,90.0,1,90,0.0,90.0,90.0
149403379.0,17,36,17126,36,17126,4268667.971428571,501.0,475.72222222222223,0,0,0.0,0.0,0.0
14370.0,6,11,1132,6,556,2619.4,218.0,92.66666666666669,5,576,3109.0,304.0,115.2
1745331.0,6,2,132,1,66,0.0,66.0,66.0,1,66,0.0,66.0,66.0
118064078.0,6,227,25578,114,7820,1044814.849557522,140.0,68.59649122807018,113,17758,1045004.9107142856,374.0,157.1504424778761
313651.0,17,4,1524,4,1524,104550.33333333331,381.0,381.0,0,0,0.0,0.0,0.0
90206913.0,6,17,1287,8,596,12852871.57142857,95.0,74.5,9,691,11250299.5,95.0,76.77777777777777
309578.0,6,6,412,4,272,103192.66666666669,74.0,68.0,2,140,0.0,74.0,70.0
59001.0,6,10,2032,5,524,14514.25,252.0,104.8,5,1508,12725.25,1236.0,301.6
301.0,17,2,164,1,82,0.0,82.0,82.0,1,82,0.0,82.0,82.0
57381.0,6,10,2032,5,524,14127.25,252.0,104.8,5,1508,11819.25,1236.0,301.6
322218.0,6,6,412,4,272,107406.0,74.0,68.0,2,140,0.0,74.0,70.0
242626.0,6,3,337,2,214,0.0,160.0,107.0,1,123,0.0,123.0,123.0
245869.0,6,3,337,2,214,0.0,160.0,107.0,1,123,0.0,123.0,123.0
2591208.0,6,2,132,1,66,0.0,66.0,66.0,1,66,0.0,66.0,66.0
26634.0,6,14,4740,7,653,4295.5,249.0,93.28571428571428,7,4087,4200.666666666667,1514.0,583.8571428571429
499375.0,6,5,336,2,134,0.0,68.0,67.0,3,202,191133.0,70.0,67.33333333333333
90326796.0,6,16,1192,8,596,12897018.57142857,95.0,74.5,8,596,12903148.0,95.0,74.5
281423.0,17,2,363,1,79,0.0,79.0,79.0,1,284,0.0,284.0,284.0
6192.0,17,2,447,1,84,0.0,84.0,84.0,1,363,0.0,363.0,363.0
67067.0,6,14,4740,7,653,10882.166666666666,249.0,93.28571428571428,7,4087,10373.166666666666,1514.0,583.8571428571429
17291.0,6,14,4740,7,653,2761.333333333333,249.0,93.28571428571428,7,4087,2745.1666666666665,1514.0,583.8571428571429
26893.0,6,14,4740,7,653,4269.5,249.0,93.28571428571428,7,4087,4340.333333333333,1514.0,583.8571428571429
37647.0,6,14,4740,7,653,5744.666666666667,249.0,93.28571428571428,7,4087,6135.5,1514.0,583.8571428571429
3080629.0,6,3,204,2,134,0.0,68.0,67.0,1,70,0.0,70.0,70.0
15461.0,6,14,4740,7,653,2430.0,249.0,93.28571428571428,7,4087,2440.833333333333,1514.0,583.8571428571429
2581113.0,6,2,132,1,66,0.0,66.0,66.0,1,66,0.0,66.0,66.0
21565.0,17,2,582,1,83,0.0,83.0,83.0,1,499,0.0,499.0,499.0
15121.0,6,14,4740,7,653,2286.1666666666665,249.0,93.28571428571428,7,4087,2384.6666666666665,1514.0,583.8571428571429
90166865.0,6,25,2810,13,1454,7496781.583333333,338.0,111.84615384615384,12,1356,8178312.818181818,426.0,113.0
35866.0,6,14,4740,7,653,5460.0,249.0,93.28571428571428,7,4087,4115.5,1514.0,583.8571428571429
143957.0,17,2,180,1,90,0.0,90.0,90.0,1,90,0.0,90.0,90.0
115017702.0,6,48,3168,24,1584,5000769.652173913,66.0,66.0,24,1584,4988790.478260869,66.0,66.0
35523.0,6,14,4740,7,653,5652.0,249.0,93.28571428571428,7,4087,4966.166666666667,1514.0,583.8571428571429
3169910.0,6,18,1495,9,921,358421.75,315.0,102.33333333333331,9,574,358387.0,78.0,63.77777777777778
55865.0,6,14,4740,7,653,9188.666666666666,249.0,93.28571428571428,7,4087,8737.0,1514.0,583.8571428571429
2341.0,17,4,344,2,150,0.0,75.0,75.0,2,194,0.0,103.0,97.0
13016.0,17,2,180,1,90,0.0,90.0,90.0,1,90,0.0,90.0,90.0
56641.0,6,10,2032,5,524,13920.0,252.0,104.8,5,1508,13502.0,1236.0,301.6
206210.0,6,3,426,2,280,0.0,214.0,140.0,1,146,0.0,146.0,146.0
413183.0,17,2,363,1,75,0.0,75.0,75.0,1,288,0.0,288.0,288.0
9446.0,17,2,566,1,83,0.0,83.0,83.0,1,483,0.0,483.0,483.0
114790824.0,6,47,3102,24,1584,4977494.347826087,66.0,66.0,23,1518,5150442.681818182,66.0,66.0
36869.0,6,14,4740,7,653,5908.166666666667,249.0,93.28571428571428,7,4087,6014.333333333333,1514.0,583.8571428571429
120123782.0,6,14,2240,6,1224,24024756.4,204.0,204.0,8,1016,17135172.0,188.0,127.0
1642.0,17,2,762,2,762,0.0,381.0,381.0,0,0,0.0,0.0,0.0
31918.000000000004,6,10,2032,5,524,7664.0,252.0,104.8,5,1508,7770.25,1236.0,301.6
90394779.0,6,13,2052,6,1224,18073079.2,204.0,204.0,7,828,15020030.333333334,188.0,118.28571428571428
4272.0,17,4,704,2,148,0.0,74.0,74.0,2,556,0.0,280.0,278.0
764769.0,17,6,1230,3,234,382195.0,78.0,78.0,3,996,382181.0,332.0,332.0
95267751.0,6,31,2298,16,1212,6336796.0,123.0,75.75,15,1086,6789418.0,123.0,72.4
207741.0,6,3,426,2,280,0.0,214.0,140.0,1,146,0.0,146.0,146.0
2106969.0,6,51,43784,20,1463,110893.1052631579,201.0,73.15,31,42321,69925.9,1514.0,1365.1935483870968
315414.0,17,4,1400,4,1400,105138.0,350.0,350.0,0,0,0.0,0.0,0.0
1045107.0,6,11,1134,6,558,209021.4,220.0,93.0,5,576,259705.75,304.0,115.2
108105178.0,17,5,955,5,955,27026294.5,191.0,191.0,0,0,0.0,0.0,0.0
144619.0,6,2,132,1,66,0.0,66.0,66.0,1,66,0.0,66.0,66.0
113613141.0,6,46,3036,23,1518,5150433.0,66.0,66.0,23,1518,5150433.0,66.0,66.0
153530.0,17,2,180,1,90,0.0,90.0,90.0,1,90,0.0,90.0,90.0
319954.0,17,4,1400,4,1400,106651.33333333331,350.0,350.0,0,0,0.0,0.0,0.0
5617362.0,6,5,336,2,134,0.0,68.0,67.0,3,202,1523998.0,70.0,67.33333333333333
33534.0,6,14,4740,7,653,4826.166666666667,249.0,93.28571428571428,7,4087,5434.166666666667,1514.0,583.8571428571429
1168040.0,6,13,3001,8,2373,166862.85714285713,1514.0,296.625,5,628,223106.75,331.0,125.6
316543.0,17,4,1400,4,1400,105514.33333333331,350.0,350.0,0,0,0.0,0.0,0.0
1552797.0,6,5,367,2,132,0.0,66.0,66.0,3,235,776398.5,103.0,78.33333333333333
143905.0,17,2,180,1,90,0.0,90.0,90.0,1,90,0.0,90.0,90.0
123250532.0,6,49,3234,25,1650,5135438.833333333,66.0,66.0,24,1584,5052018.0,66.0,66.0
110832442.0,6,35,2526,18,1332,6519555.411764706,123.0,74.0,17,1194,6913500.875,123.0,70.23529411764706
105211570.0,17,14,1126,7,563,17453544.333333332,174.0,80.42857142857143,7,563,17508776.166666668,174.0,80.42857142857143
55459.0,6,10,2032,5,524,12671.0,252.0,104.8,5,1508,10030.25,1236.0,301.6
123610493.0,6,49,3234,25,1650,5150437.208333333,66.0,66.0,24,1584,5023654.130434782,66.0,66.0
121563.0,6,3,337,2,214,0.0,160.0,107.0,1,123,0.0,123.0,123.0
114500943.0,17,16,1212,8,606,16285842.142857144,174.0,75.75,8,606,16286662.714285716,174.0,75.75
25908.0,6,10,2032,5,524,5241.5,252.0,104.8,5,1508,5909.75,1236.0,301.6
244940.0,6,3,337,2,214,0.0,160.0,107.0,1,123,0.0,123.0,123.0
310051.0,6,6,412,4,272,103350.33333333331,74.0,68.0,2,140,0.0,74.0,70.0
139181.0,6,12,1447,6,816,26743.0,291.0,136.0,6,631,26696.0,293.0,105.16666666666669
120045320.0,6,22,1639,12,894,10908506.454545457,95.0,74.5,10,745,13332945.333333334,95.0,74.5
37698.0,6,14,4740,7,653,6159.666666666667,249.0,93.28571428571428,7,4087,5812.333333333333,1514.0,583.8571428571429
120403149.0,6,239,27054,120,18978,1011791.1680672268,284.0,158.15,119,8076,1011559.1779661016,140.0,67.8655462184874
118945451.0,6,34,2350,17,1225,7434090.6875,139.0,72.05882352941177,17,1125,7420562.3125,123.0,66.17647058823529
3188094.0,6,3,1604,2,851,0.0,785.0,425.5,1,753,0.0,753.0,753.0
6640.0,17,2,582,1,83,0.0,83.0,83.0,1,499,0.0,499.0,499.0
106216172.0,6,28,1860,14,966,8153818.076923077,123.0,69.0,14,894,8153863.230769231,123.0,63.85714285714285
29420.0,6,14,4740,7,653,4504.666666666667,249.0,93.28571428571428,7,4087,4341.5,1514.0,583.8571428571429
510138.0,6,5,336,2,134,0.0,68.0,67.0,3,202,195156.0,70.0,67.33333333333333
146247.0,6,3,337,2,214,0.0,160.0,107.0,1,123,0.0,123.0,123.0
56323.0,6,10,2032,5,524,13821.75,252.0,104.8,5,1508,13292.25,1236.0,301.6
292190.0,6,10,1221,6,636,58438.0,298.0,106.0,4,585,91965.0,379.0,146.25
228322.0,17,2,180,1,90,0.0,90.0,90.0,1,90,0.0,90.0,90.0
18119.0,6,11,1131,6,600,3487.8,262.0,100.0,5,531,4314.25,259.0,106.2
36830392.0,6,19,1375,9,681,4602141.75,95.0,75.66666666666667,10,694,4061293.777777778,95.0,69.4
135130170.0,17,6,1146,6,1146,27026034.0,191.0,191.0,0,0,0.0,0.0,0.0
4962.0,17,2,508,2,508,0.0,257.0,254.0,0,0,0.0,0.0,0.0
250585.0,17,4,6056,4,6056,83528.33333333333,1514.0,1514.0,0,0,0.0,0.0,0.0
32365.0,6,10,2032,5,524,7881.25,252.0,104.8,5,1508,6850.25,1236.0,301.6
58711.0,6,13,1386,7,789,8537.666666666666,253.0,112.71428571428572,6,597,10723.8,259.0,99.5
41271.0,6,14,4740,7,653,6761.166666666667,249.0,93.28571428571428,7,4087,3814.1666666666665,1514.0,583.8571428571429
120134953.0,6,254,28642,127,8678,946905.5317460316,140.0,68.33070866141732,127,19964,946890.5555555556,284.0,157.1968503937008
910828.0,6,12,2710,7,743,151804.66666666666,339.0,106.14285714285714,5,1967,158779.0,1514.0,393.4
198033.0,17,2,762,2,762,0.0,381.0,381.0,0,0,0.0,0.0,0.0
2946.0,17,4,438,2,148,0.0,74.0,74.0,2,290,0.0,147.0,145.0
131025042.0,17,17,1255,9,649,16378130.25,174.0,72.11111111111111,8,606,15865458.285714284,174.0,75.75
33429.0,6,14,4740,7,653,5252.833333333333,249.0,93.28571428571428,7,4087,4641.0,1514.0,583.8571428571429
108107691.0,17,5,1005,5,1005,27026922.75,201.0,201.0,0,0,0.0,0.0,0.0
147324.0,6,3,373,2,238,0.0,172.0,119.0,1,135,0.0,135.0,135.0
61197.0,6,14,4740,7,653,10018.666666666666,249.0,93.28571428571428,7,4087,9233.333333333334,1514.0,583.8571428571429
1160323.0,6,13,3009,8,2381,165760.42857142858,1514.0,297.625,5,628,221589.0,331.0,125.6
102391925.0,6,42,3616,24,2023,4451822.826086956,139.0,84.29166666666667,18,1593,6009714.529411765,123.0,88.5
107899.0,17,2,286,2,286,0.0,143.0,143.0,0,0,0.0,0.0,0.0
404232.0,6,3,1604,2,851,0.0,785.0,425.5,1,753,0.0,753.0,753.0
1169549.0,6,13,3020,8,2392,167078.42857142858,1514.0,299.0,5,628,224252.0,331.0,125.6
104417215.0,6,44,2904,22,1452,4972248.333333333,66.0,66.0,22,1452,4959130.285714285,66.0,66.0
228609.0,17,2,180,1,90,0.0,90.0,90.0,1,90,0.0,90.0,90.0
872.0,17,4,820,2,156,0.0,78.0,78.0,2,664,0.0,332.0,332.0
17485721.0,6,27,9227,14,2127,1345055.4615384615,408.0,151.92857142857142,13,7100,1041549.6666666666,1514.0,546.1538461538462
20967.0,6,11,2098,6,590,3841.6,252.0,98.33333333333331,5,1508,4086.5,1236.0,301.6
17251.0,6,14,4740,7,653,2646.333333333333,249.0,93.28571428571428,7,4087,2690.833333333333,1514.0,583.8571428571429
105522.0,17,2,700,2,700,0.0,350.0,350.0,0,0,0.0,0.0,0.0
135139500.0,17,6,1206,6,1206,27027900.0,201.0,201.0,0,0,0.0,0.0,0.0
13837.0,6,10,2032,5,524,3206.75,252.0,104.8,5,1508,3207.25,1236.0,301.6
18235.0,6,11,1133,6,602,3634.8,264.0,100.33333333333331,5,531,4199.75,259.0,106.2
121043426.0,6,216,24514,108,7424,1121489.5420560748,140.0,68.74074074074075,108,17090,1125756.6074766356,284.0,158.24074074074073
10106.0,6,11,2098,6,590,1879.2,252.0,98.33333333333331,5,1508,2281.25,1236.0,301.6
3585657.0,6,176,132955,92,123109,39402.82417582418,1510.0,1338.141304347826,84,9846,39438.22891566265,1510.0,117.21428571428572
120046559.0,17,28,13364,28,13364,4446168.851851852,501.0,477.2857142857143,0,0,0.0,0.0,0.0
121265.0,6,3,337,2,214,0.0,160.0,107.0,1,123,0.0,123.0,123.0
38493.0,6,14,4740,7,653,5667.333333333333,249.0,93.28571428571428,7,4087,6280.0,1514.0,583.8571428571429
302320.0,6,6,412,4,272,100773.33333333331,74.0,68.0,2,140,0.0,74.0,70.0
106833695.0,6,28,1860,14,966,8201367.153846154,123.0,69.0,14,894,8201350.846153846,123.0,63.85714285714285
92969667.0,6,26,1746,13,906,7729469.916666667,123.0,69.6923076923077,13,840,7729469.5,123.0,64.61538461538461
80.0,17,2,762,2,762,0.0,381.0,381.0,0,0,0.0,0.0,0.0
0.0,6,1,54,0,0,0.0,0.0,0.0,1,54,0.0,54.0,54.0
762601.0,6,11,1131,6,600,152183.0,262.0,100.0,5,531,189656.5,259.0,106.2
92206476.0,17,14,1126,7,563,15333461.5,174.0,80.42857142857143,7,563,15334213.166666666,174.0,80.42857142857143
93383.0,6,2,132,1,66,0.0,66.0,66.0,1,66,0.0,66.0,66.0
200687.0,17,4,6056,4,6056,66895.66666666667,1514.0,1514.0,0,0,0.0,0.0,0.0
156896.0,17,4,1400,4,1400,52298.66666666666,350.0,350.0,0,0,0.0,0.0,0.0
90527800.0,6,15,2444,8,1016,12932542.857142856,188.0,127.0,7,1428,15060755.333333334,204.0,204.0
120071093.0,17,28,13364,28,13364,4447077.518518519,501.0,477.2857142857143,0,0,0.0,0.0,0.0
103218.0,17,2,286,2,286,0.0,143.0,143.0,0,0,0.0,0.0,0.0
135130226.0,17,6,1146,6,1146,27026045.2,191.0,191.0,0,0,0.0,0.0,0.0
787.0,17,4,438,2,148,0.0,74.0,74.0,2,290,0.0,147.0,145.0
37805.0,6,14,4740,7,653,5705.833333333333,249.0,93.28571428571428,7,4087,6165.833333333333,1514.0,583.8571428571429
37138.0,6,14,4740,7,653,6019.0,249.0,93.28571428571428,7,4087,5612.666666666667,1514.0,583.8571428571429
90255279.0,6,16,2368,9,1204,11281909.875,188.0,133.77777777777777,7,1164,15015148.0,204.0,166.28571428571428
258774.0,6,10,1221,6,636,51754.8,298.0,106.0,4,585,80372.0,379.0,146.25
123441025.0,6,32,2226,17,1209,7715064.0625,123.0,71.11764705882354,15,1017,8088469.857142857,123.0,67.8
304345.0,6,6,412,4,272,101448.33333333331,74.0,68.0,2,140,0.0,74.0,70.0
108107995.0,17,5,955,5,955,27026998.75,191.0,191.0,0,0,0.0,0.0,0.0
122786167.0,17,14,864,7,432,17166857.333333332,174.0,61.71428571428572,7,432,17168115.833333332,174.0,61.71428571428572
458118.0,6,11,1021,6,444,62880.4,162.0,74.0,5,577,78395.75,349.0,115.4
4597857.0,6,18,1540,8,908,613951.1428571428,315.0,113.5,10,632,477484.1111111111,78.0,63.2
55341.0,6,11,2098,6,590,11068.2,252.0,98.33333333333331,5,1508,10691.75,1236.0,301.6
211972.0,6,10,1221,6,636,42394.4,298.0,106.0,4,585,69698.33333333333,379.0,146.25
228505.0,17,2,180,1,90,0.0,90.0,90.0,1,90,0.0,90.0,90.0
1302502.0,6,4,264,2,132,0.0,66.0,66.0,2,132,0.0,66.0,66.0
303839.0,6,6,412,4,272,101279.66666666669,74.0,68.0,2,140,0.0,74.0,70.0
120076675.0,17,28,13364,28,13364,4447284.259259259,501.0,477.2857142857143,0,0,0.0,0.0,0.0
312.0,17,2,156,1,78,0.0,78.0,78.0,1,78,0.0,78.0,78.0
364038.0,6,4,508,2,238,0.0,172.0,119.0,2,270,0.0,135.0,135.0
101784.0,17,2,762,2,762,0.0,381.0,381.0,0,0,0.0,0.0,0.0
146154.0,6,3,337,2,214,0.0,160.0,107.0,1,123,0.0,123.0,123.0
143932.0,17,2,180,1,90,0.0,90.0,90.0,1,90,0.0,90.0,90.0
97619373.0,6,33,2560,17,1351,6087724.6875,139.0,79.47058823529412,16,1209,6493569.2,123.0,75.5625
107034430.0,6,168,18968,84,13128,1286978.2409638555,284.0,156.28571428571428,84,5840,1286977.8072289156,140.0,69.52380952380952
206533.0,17,2,180,1,90,0.0,90.0,90.0,1,90,0.0,90.0,90.0
94660931.0,17,12,778,6,389,18932186.2,174.0,64.83333333333333,6,389,18879961.6,174.0,64.83333333333333
9570.0,17,2,582,1,83,0.0,83.0,83.0,1,499,0.0,499.0,499.0
143908.0,17,2,180,1,90,0.0,90.0,90.0,1,90,0.0,90.0,90.0
1869.0,17,2,939,1,590,0.0,590.0,590.0,1,349,0.0,349.0,349.0
21593.0,6,14,4740,7,653,3444.1666666666665,249.0,93.28571428571428,7,4087,3409.0,1514.0,583.8571428571429
90057566.0,17,28,13364,28,13364,3335465.407407407,501.0,477.2857142857143,0,0,0.0,0.0,0.0
220656.0,6,3,426,2,280,0.0,214.0,140.0,1,146,0.0,146.0,146.0
8505985.0,17,3,1034,2,684,0.0,342.0,342.0,1,350,0.0,350.0,350.0
236284.0,6,3,373,2,238,0.0,172.0,119.0,1,135,0.0,135.0,135.0
297800.0,6,7,478,4,272,99266.66666666669,74.0,68.0,3,206,73996.0,74.0,68.66666666666667
206962.0,6,3,426,2,280,0.0,214.0,140.0,1,146,0.0,146.0,146.0
208306.0,17,2,762,2,762,0.0,381.0,381.0,0,0,0.0,0.0,0.0
102134.0,17,2,286,2,286,0.0,143.0,143.0,0,0,0.0,0.0,0.0
2058.0,17,4,344,2,150,0.0,75.0,75.0,2,194,0.0,103.0,97.0
109347.0,17,2,762,2,762,0.0,381.0,381.0,0,0,0.0,0.0,0.0
9449.0,17,2,539,1,86,0.0,86.0,86.0,1,453,0.0,453.0,453.0
104775551.0,17,15,5130,15,5130,7483967.928571428,342.0,342.0,0,0,0.0,0.0,0.0
318.0,17,2,160,1,80,0.0,80.0,80.0,1,80,0.0,80.0,80.0
124771073.0,6,43,3723,25,2130,5198794.708333333,123.0,85.2,18,1593,6751102.529411765,123.0,88.5
82972192.0,17,14,4796,13,4446,6236665.416666667,342.0,342.0,1,350,0.0,350.0,350.0
111000930.0,17,15,1169,8,606,15857275.714285716,174.0,75.75,7,563,15167554.166666666,174.0,80.42857142857143
155366.0,6,3,337,2,214,0.0,160.0,107.0,1,123,0.0,123.0,123.0
246336.0,6,3,337,2,214,0.0,160.0,107.0,1,123,0.0,123.0,123.0
70345.0,6,14,4740,7,653,11192.166666666666,249.0,93.28571428571428,7,4087,7335.333333333333,1514.0,583.8571428571429
300933.0,6,6,412,4,272,100311.0,74.0,68.0,2,140,0.0,74.0,70.0
90057468.0,17,28,13364,28,13364,3335461.777777778,501.0,477.2857142857143,0,0,0.0,0.0,0.0
158333.0,6,3,337,2,214,0.0,160.0,107.0,1,123,0.0,123.0,123.0
51733308.0,6,8,2113,3,960,24539503.5,826.0,320.0,5,1153,12238106.25,885.0,230.6
1909146.0,6,19,6869,11,1567,190914.6,408.0,142.45454545454547,8,5302,222615.7142857143,1514.0,662.75
98411.0,6,14,4740,7,653,15210.666666666666,249.0,93.28571428571428,7,4087,15652.5,1514.0,583.8571428571429
32707.0,6,14,4740,7,653,5277.5,249.0,93.28571428571428,7,4087,5255.333333333333,1514.0,583.8571428571429
100742.0,6,12,1328,6,731,19754.8,253.0,121.83333333333331,6,597,18650.8,259.0,99.5
92020788.0,17,16,5472,16,5472,6134719.2,342.0,342.0,0,0,0.0,0.0,0.0
108100664.0,17,5,1005,5,1005,27025166.0,201.0,201.0,0,0,0.0,0.0,0.0
108110486.0,17,5,1005,5,1005,27027621.5,201.0,201.0,0,0,0.0,0.0,0.0
1419193.0,17,16,1120,16,1120,94612.86666666668,70.0,70.0,0,0,0.0,0.0,0.0
108106617.0,17,5,955,5,955,27026654.25,191.0,191.0,0,0,0.0,0.0,0.0
44325.0,6,14,4740,7,653,7064.333333333333,249.0,93.28571428571428,7,4087,7239.0,1514.0,583.8571428571429
35908.0,6,14,4740,7,653,4292.0,249.0,93.28571428571428,7,4087,4919.333333333333,1514.0,583.8571428571429
98277069.0,6,34,2614,17,1263,6142290.6875,123.0,74.29411764705883,17,1351,5661761.3125,139.0,79.47058823529412
299.0,17,2,156,1,78,0.0,78.0,78.0,1,78,0.0,78.0,78.0
111032768.0,6,30,1974,15,1026,7915496.357142857,123.0,68.4,15,948,7915487.857142857,123.0,63.2
228342.0,17,2,180,1,90,0.0,90.0,90.0,1,90,0.0,90.0,90.0
228446.0,17,2,180,1,90,0.0,90.0,90.0,1,90,0.0,90.0,90.0
120186.0,17,2,180,1,70,0.0,70.0,70.0,1,110,0.0,110.0,110.0
122366595.0,6,214,24214,107,7370,1127202.4622641508,140.0,68.8785046728972,107,16844,1136831.5,284.0,157.42056074766356
4732.0,17,4,813,2,144,0.0,72.0,72.0,2,669,0.0,542.0,334.5
34794.0,6,10,2032,5,524,7959.75,252.0,104.8,5,1508,6628.5,1236.0,301.6
2351.0,17,4,344,2,150,0.0,75.0,75.0,2,194,0.0,103.0,97.0
2296.0,17,4,344,2,150,0.0,75.0,75.0,2,194,0.0,103.0,97.0
93082349.0,6,364,58842,182,12308,512872.1602209945,214.0,67.62637362637362,182,46534,514240.72375690605,1514.0,255.6813186813187
121162811.0,6,228,26090,114,7820,1055719.2920353983,140.0,68.59649122807018,114,18270,1064974.7345132744,336.0,160.26315789473685
1866229.0,17,6,1230,3,234,932933.0,78.0,78.0,3,996,932904.0,332.0,332.0
62250.0,6,14,4740,7,653,9252.0,249.0,93.28571428571428,7,4087,10150.0,1514.0,583.8571428571429
114914349.0,6,26,1978,12,935,10446759.0,95.0,77.91666666666667,14,1043,8819439.846153846,95.0,74.5
135137309.0,17,6,1206,6,1206,27027461.8,201.0,201.0,0,0,0.0,0.0,0.0
153534.0,17,2,180,1,90,0.0,90.0,90.0,1,90,0.0,90.0,90.0
114689718.0,6,48,3168,24,1584,4986509.478260869,66.0,66.0,24,1584,4973072.391304348,66.0,66.0
330.0,17,2,174,1,79,0.0,79.0,79.0,1,95,0.0,95.0,95.0
19713.0,6,14,4740,7,653,3176.5,249.0,93.28571428571428,7,4087,3013.0,1514.0,583.8571428571429
15041253.0,17,6,2718,6,2718,3008250.6,453.0,453.0,0,0,0.0,0.0,0.0
319.0,17,2,174,1,79,0.0,79.0,79.0,1,95,0.0,95.0,95.0
311612.0,17,4,622,4,622,103870.66666666669,163.0,155.5,0,0,0.0,0.0,0.0
108112710.0,17,5,1005,5,1005,27028177.5,201.0,201.0,0,0,0.0,0.0,0.0
10522408.0,6,7,478,4,272,3460008.0,74.0,68.0,3,206,5189939.5,74.0,68.66666666666667
0.0,6,1,66,1,66,0.0,66.0,66.0,0,0,0.0,0.0,0.0
241878.0,6,3,337,2,214,0.0,160.0,107.0,1,123,0.0,123.0,123.0
43643.0,6,14,4740,7,653,7110.333333333333,249.0,93.28571428571428,7,4087,7049.666666666667,1514.0,583.8571428571429
46261.0,6,14,4740,7,653,7537.166666666667,249.0,93.28571428571428,7,4087,7493.666666666667,1514.0,583.8571428571429
90259109.0,6,12,1832,8,1016,12894158.42857143,188.0,127.0,4,816,30031324.0,204.0,204.0
4374.0,17,2,614,1,72,0.0,72.0,72.0,1,542,0.0,542.0,542.0
128006779.0,17,15,907,8,475,18286682.71428572,174.0,59.375,7,432,18000197.5,174.0,61.71428571428572
206344.0,17,2,180,1,90,0.0,90.0,90.0,1,90,0.0,90.0,90.0
238796.0,6,10,1221,6,636,47759.2,298.0,106.0,4,585,72654.0,379.0,146.25
282084.0,17,2,180,1,90,0.0,90.0,90.0,1,90,0.0,90.0,90.0
345.0,17,2,160,1,80,0.0,80.0,80.0,1,80,0.0,80.0,80.0
299.0,17,2,164,1,82,0.0,82.0,82.0,1,82,0.0,82.0,82.0
115987575.0,17,17,1779,9,911,14478580.0,174.0,101.22222222222224,8,868,14996804.714285716,174.0,108.5
134840.0,6,3,337,2,214,0.0,160.0,107.0,1,123,0.0,123.0,123.0
28431.0,6,14,4740,7,653,4405.833333333333,249.0,93.28571428571428,7,4087,4301.833333333333,1514.0,583.8571428571429
13615340.0,6,20,1607,10,975,1478716.0,315.0,97.5,10,632,1478701.4444444445,78.0,63.2
119973471.0,6,24,1788,12,894,10884440.545454543,95.0,74.5,12,894,10891814.909090908,95.0,74.5
104749421.0,17,14,1126,7,563,17448116.833333332,174.0,80.42857142857143,7,563,17431556.166666668,174.0,80.42857142857143
10419758.0,6,7,478,4,272,3427678.333333333,74.0,68.0,3,206,5141404.0,74.0,68.66666666666667
30841.0,6,14,4740,7,653,4843.333333333333,249.0,93.28571428571428,7,4087,4866.333333333333,1514.0,583.8571428571429
26221.0,6,11,2098,6,590,4952.8,252.0,98.33333333333331,5,1508,6188.5,1236.0,301.6
262135.0,6,10,1221,6,636,52427.0,298.0,106.0,4,585,81508.0,379.0,146.25
510604.0,6,5,336,2,134,0.0,68.0,67.0,3,202,193246.0,70.0,67.33333333333333
216391.0,17,2,180,1,90,0.0,90.0,90.0,1,90,0.0,90.0,90.0
305.0,17,2,174,1,79,0.0,79.0,79.0,1,95,0.0,95.0,95.0
1302595.0,6,4,264,2,132,0.0,66.0,66.0,2,132,0.0,66.0,66.0
120001143.0,17,15,1169,8,606,17143020.42857143,174.0,75.75,7,563,17520525.666666668,174.0,80.42857142857143
501495.0,6,5,336,2,134,0.0,68.0,67.0,3,202,194280.0,70.0,67.33333333333333
303118.0,6,2,132,1,66,0.0,66.0,66.0,1,66,0.0,66.0,66.0
113609601.0,6,46,3036,23,1518,5150439.7727272725,66.0,66.0,23,1518,5150444.227272728,66.0,66.0
91063446.0,6,23,1578,11,732,8957227.7,123.0,66.54545454545455,12,846,8278452.818181818,123.0,70.5
90016378.0,17,28,13364,28,13364,3333939.925925926,501.0,477.2857142857143,0,0,0.0,0.0,0.0
2285.0,17,4,344,2,150,0.0,75.0,75.0,2,194,0.0,103.0,97.0
2360.0,17,4,344,2,150,0.0,75.0,75.0,2,194,0.0,103.0,97.0
5049.0,17,2,180,1,90,0.0,90.0,90.0,1,90,0.0,90.0,90.0
789.0,17,4,438,2,148,0.0,74.0,74.0,2,290,0.0,147.0,145.0
1207979.0,17,7,490,7,490,201329.8333333333,70.0,70.0,0,0,0.0,0.0,0.0
90048708.0,17,28,13364,28,13364,3335137.333333333,501.0,477.2857142857143,0,0,0.0,0.0,0.0
90093376.0,6,10,1440,7,828,15015562.666666666,188.0,118.28571428571428,3,612,30031556.5,204.0,204.0
2592107.0,6,2,132,1,66,0.0,66.0,66.0,1,66,0.0,66.0,66.0
122378.0,6,3,373,2,238,0.0,172.0,119.0,1,135,0.0,135.0,135.0
307478.0,6,6,412,4,272,102492.66666666669,74.0,68.0,2,140,0.0,74.0,70.0
135128773.0,17,6,1206,6,1206,27025754.6,201.0,201.0,0,0,0.0,0.0,0.0
233661.0,17,2,180,1,90,0.0,90.0,90.0,1,90,0.0,90.0,90.0
221314.0,17,2,180,1,90,0.0,90.0,90.0,1,90,0.0,90.0,90.0
90284509.0,6,12,1832,8,1016,12897787.0,188.0,127.0,4,816,30040399.666666668,204.0,204.0
0.0,17,1,350,1,350,0.0,350.0,350.0,0,0,0.0,0.0,0.0
1979.0,17,2,180,1,90,0.0,90.0,90.0,1,90,0.0,90.0,90.0
15705.0,6,14,4740,7,653,2360.833333333333,249.0,93.28571428571428,7,4087,2474.0,1514.0,583.8571428571429
82412.0,17,2,700,2,700,0.0,350.0,350.0,0,0,0.0,0.0,0.0
105166793.0,17,15,5130,15,5130,7511913.785714285,342.0,342.0,0,0,0.0,0.0,0.0
284545.0,17,2,363,1,79,0.0,79.0,79.0,1,284,0.0,284.0,284.0
122714410.0,6,31,2113,16,1165,8180960.666666667,139.0,72.8125,15,948,8036645.785714285,123.0,63.2
2420.0,17,4,344,2,150,0.0,75.0,75.0,2,194,0.0,103.0,97.0
90051286.0,17,27,12943,27,12943,3463511.0,501.0,479.3703703703704,0,0,0.0,0.0,0.0
90089566.0,6,12,1848,5,1020,22521788.5,204.0,204.0,7,828,15014565.166666666,188.0,118.28571428571428
19641.0,6,10,2032,5,524,4628.5,252.0,104.8,5,1508,4107.25,1236.0,301.6
90051668.0,17,28,13364,28,13364,3335246.962962963,501.0,477.2857142857143,0,0,0.0,0.0,0.0
205689.0,17,2,180,1,90,0.0,90.0,90.0,1,90,0.0,90.0,90.0
120125049.0,6,13,2036,8,1016,17137343.714285713,188.0,127.0,5,1020,22523946.5,204.0,204.0
135129749.0,17,6,1146,6,1146,27025949.8,191.0,191.0,0,0,0.0,0.0,0.0
90026631.0,17,28,13364,28,13364,3334319.6666666665,501.0,477.2857142857143,0,0,0.0,0.0,0.0
2875305.0,6,4,270,2,134,0.0,68.0,67.0,2,136,0.0,70.0,68.0
2393.0,17,4,344,2,150,0.0,75.0,75.0,2,194,0.0,103.0,97.0
100283649.0,6,28,1860,14,966,7697522.846153846,123.0,69.0,14,894,7697533.846153846,123.0,63.85714285714285
28919.0,6,14,4740,7,653,4311.0,249.0,93.28571428571428,7,4087,3453.0,1514.0,583.8571428571429
21861939.0,6,6,1981,4,1087,7287313.0,885.0,271.75,2,894,0.0,826.0,447.0
47688.0,6,14,4740,7,653,7819.166666666667,249.0,93.28571428571428,7,4087,7737.166666666667,1514.0,583.8571428571429
103095684.0,17,14,1126,7,563,17167244.833333332,174.0,80.42857142857143,7,563,17166824.166666668,174.0,80.42857142857143
1307459.0,6,4,264,2,132,0.0,66.0,66.0,2,132,0.0,66.0,66.0
29919.0,6,10,2032,5,524,6517.0,252.0,104.8,5,1508,7231.0,1236.0,301.6
117466916.0,17,8,1788,7,1482,19577819.33333333,336.0,211.7142857142857,1,306,0.0,306.0,306.0
108099029.0,17,5,1005,5,1005,27024757.25,201.0,201.0,0,0,0.0,0.0,0.0
12211617.0,6,33,8878,17,4676,763226.0625,1514.0,275.05882352941177,16,4202,609069.0666666667,1514.0,262.625
108104476.0,17,5,1005,5,1005,27026119.0,201.0,201.0,0,0,0.0,0.0,0.0
102975.0,17,2,286,2,286,0.0,143.0,143.0,0,0,0.0,0.0,0.0
146160.0,6,3,337,2,214,0.0,160.0,107.0,1,123,0.0,123.0,123.0
205882.0,6,3,426,2,280,0.0,214.0,140.0,1,146,0.0,146.0,146.0
18101.0,6,14,4740,7,653,2581.1666666666665,249.0,93.28571428571428,7,4087,2880.333333333333,1514.0,583.8571428571429
148034.0,17,2,180,1,90,0.0,90.0,90.0,1,90,0.0,90.0,90.0
191137.0,17,2,180,1,90,0.0,90.0,90.0,1,90,0.0,90.0,90.0
146198.0,6,3,337,2,214,0.0,160.0,107.0,1,123,0.0,123.0,123.0
118488302.0,6,35,2542,18,1348,6969900.117647059,139.0,74.88888888888889,17,1194,7391976.1875,123.0,70.23529411764706
10790769.0,17,4,1368,4,1368,3596923.0,342.0,342.0,0,0,0.0,0.0,0.0
17152.0,6,10,1066,5,490,3029.75,218.0,98.0,5,576,4085.0,304.0,115.2
47812102.0,6,8,1938,3,886,22605173.5,752.0,295.3333333333333,5,1052,11259767.25,784.0,210.4
119516.0,6,14,4740,7,653,16124.833333333334,249.0,93.28571428571428,7,4087,18723.33333333333,1514.0,583.8571428571429
336801.0,6,6,412,4,272,112267.0,74.0,68.0,2,140,0.0,74.0,70.0
1012668.0,6,13,1386,7,789,168778.0,253.0,112.71428571428572,6,597,201749.0,259.0,99.5
10872819.0,6,8,544,4,272,3578846.6666666665,74.0,68.0,4,272,3578782.0,74.0,68.0
0.0,17,1,381,1,381,0.0,381.0,381.0,0,0,0.0,0.0,0.0
21769.0,6,10,2032,5,524,4070.5,252.0,104.8,5,1508,4933.75,1236.0,301.6
2369.0,17,4,344,2,150,0.0,75.0,75.0,2,194,0.0,103.0,97.0
40963.0,6,14,4740,7,653,6676.666666666667,249.0,93.28571428571428,7,4087,6360.333333333333,1514.0,583.8571428571429
362007.0,6,10,967,5,390,60681.25,162.0,78.0,5,577,60612.5,349.0,115.4
859478.0,6,9,1269,6,798,171895.6,460.0,133.0,3,471,291967.0,331.0,157.0
90222514.0,6,19,1436,9,691,11246653.875,95.0,76.77777777777777,10,745,10000700.111111112,95.0,74.5
11627.0,6,11,2098,6,590,1794.2,252.0,98.33333333333331,5,1508,2741.0,1236.0,301.6
79.0,17,2,762,2,762,0.0,381.0,381.0,0,0,0.0,0.0,0.0
60834.0,6,14,4740,7,653,9044.333333333334,249.0,93.28571428571428,7,4087,9546.5,1514.0,583.8571428571429
58259.0,6,14,4740,7,653,8649.166666666666,249.0,93.28571428571428,7,4087,9493.5,1514.0,583.8571428571429
127001185.0,17,15,907,8,475,18143026.42857143,174.0,59.375,7,432,17834153.833333332,174.0,61.71428571428572
228258.0,17,2,180,1,90,0.0,90.0,90.0,1,90,0.0,90.0,90.0
122530380.0,6,49,3234,25,1650,5105432.5,66.0,66.0,24,1584,5043150.565217392,66.0,66.0
300741.0,6,6,412,4,272,100247.0,74.0,68.0,2,140,0.0,74.0,70.0
120123847.0,6,16,2490,10,1392,13347094.111111112,188.0,139.2,6,1098,18102768.0,204.0,183.0
108110030.0,17,5,1005,5,1005,27027507.5,201.0,201.0,0,0,0.0,0.0,0.0
90289836.0,6,369,49520,185,37228,490705.6304347826,336.0,201.23243243243243,184,12292,487547.3387978142,140.0,66.80434782608695
2023.0,17,4,344,2,150,0.0,75.0,75.0,2,194,0.0,103.0,97.0
19230.0,6,10,2032,5,524,4588.75,252.0,104.8,5,1508,4547.75,1236.0,301.6
108103918.0,17,5,1005,5,1005,27025979.5,201.0,201.0,0,0,0.0,0.0,0.0
196956.0,17,2,180,1,90,0.0,90.0,90.0,1,90,0.0,90.0,90.0
9630.0,17,2,571,1,86,0.0,86.0,86.0,1,485,0.0,485.0,485.0
135127433.0,17,6,1146,6,1146,27025486.6,191.0,191.0,0,0,0.0,0.0,0.0
120170.0,17,2,180,1,70,0.0,70.0,70.0,1,110,0.0,110.0,110.0
44269.0,6,14,4740,7,653,7256.666666666667,249.0,93.28571428571428,7,4087,6982.0,1514.0,583.8571428571429
241303.0,6,3,337,2,214,0.0,160.0,107.0,1,123,0.0,123.0,123.0
299146.0,6,6,412,4,272,99715.33333333331,74.0,68.0,2,140,0.0,74.0,70.0
846814.0,6,9,1269,6,798,169362.8,460.0,133.0,3,471,287100.5,331.0,157.0
251332.0,6,3,373,2,238,0.0,172.0,119.0,1,135,0.0,135.0,135.0
125012057.0,17,15,907,8,475,17858865.285714287,174.0,59.375,7,432,17666825.166666668,174.0,61.71428571428572
32947.0,6,10,2032,5,524,7878.25,252.0,104.8,5,1508,7187.75,1236.0,301.6
107583.0,17,2,286,2,286,0.0,143.0,143.0,0,0,0.0,0.0,0.0
135142808.0,17,6,1206,6,1206,27028561.6,201.0,201.0,0,0,0.0,0.0,0.0
120312401.0,6,230,25994,115,7886,1048232.1666666666,140.0,68.57391304347826,115,18108,1048231.2894736842,284.0,157.4608695652174
2674335.0,6,25,7573,14,3735,205718.0769230769,1514.0,266.7857142857143,11,3838,241028.9,1514.0,348.90909090909093
403551.0,6,4,508,2,238,0.0,172.0,119.0,2,270,0.0,135.0,135.0
2362.0,17,4,344,2,150,0.0,75.0,75.0,2,194,0.0,103.0,97.0
3098038.0,6,3,1602,2,850,0.0,784.0,425.0,1,752,0.0,752.0,752.0
60673.0,6,14,4740,7,653,9837.666666666666,249.0,93.28571428571428,7,4087,9574.0,1514.0,583.8571428571429
44161.0,6,14,4740,7,653,6778.333333333333,249.0,93.28571428571428,7,4087,6852.666666666667,1514.0,583.8571428571429
325299.0,17,4,1400,4,1400,108433.0,350.0,350.0,0,0,0.0,0.0,0.0
2323.0,17,4,344,2,150,0.0,75.0,75.0,2,194,0.0,103.0,97.0
108093599.0,17,5,955,5,955,27023399.75,191.0,191.0,0,0,0.0,0.0,0.0
284230.0,17,2,363,1,79,0.0,79.0,79.0,1,284,0.0,284.0,284.0
333.0,17,2,762,2,762,0.0,381.0,381.0,0,0,0.0,0.0,0.0
114300445.0,6,33,2296,17,1225,7130276.9375,139.0,72.05882352941177,16,1071,7605628.4,123.0,66.9375
5618139.0,6,5,336,2,134,0.0,68.0,67.0,3,202,1523711.5,70.0,67.33333333333333
1320017.0,6,4,264,2,132,0.0,66.0,66.0,2,132,0.0,66.0,66.0
237495.0,6,3,373,2,238,0.0,172.0,119.0,1,135,0.0,135.0,135.0
682.0,17,2,762,2,762,0.0,381.0,381.0,0,0,0.0,0.0,0.0
108119071.0,17,5,955,5,955,27029767.75,191.0,191.0,0,0,0.0,0.0,0.0
27304910.0,17,5,1710,5,1710,6826227.5,342.0,342.0,0,0,0.0,0.0,0.0
299328.0,6,6,412,4,272,99776.0,74.0,68.0,2,140,0.0,74.0,70.0
103477658.0,6,44,2904,22,1452,4927507.523809524,66.0,66.0,22,1452,4914277.714285715,66.0,66.0
97176617.0,6,40,2640,20,1320,5114558.7894736845,66.0,66.0,20,1320,5098105.210526316,66.0,66.0
120147325.0,6,31,2107,16,1002,8009821.666666667,123.0,62.625,15,1105,7853364.785714285,139.0,73.66666666666667
2600253.0,6,2,132,1,66,0.0,66.0,66.0,1,66,0.0,66.0,66.0
2393.0,17,4,344,2,150,0.0,75.0,75.0,2,194,0.0,103.0,97.0
101978282.0,6,31,3251,16,1653,6798552.133333334,425.0,103.3125,15,1598,7269233.785714285,333.0,106.53333333333332
1313918.0,6,4,264,2,132,0.0,66.0,66.0,2,132,0.0,66.0,66.0
294625.0,6,6,412,4,272,98208.33333333331,74.0,68.0,2,140,0.0,74.0,70.0
318733.0,6,3,1604,1,753,0.0,753.0,753.0,2,851,0.0,785.0,425.5
2278.0,17,4,344,2,150,0.0,75.0,75.0,2,194,0.0,103.0,97.0
90761366.0,6,23,1885,12,853,8246995.545454546,95.0,71.08333333333333,11,1032,9075017.6,191.0,93.8181818181818
63382.99999999999,17,2,762,2,762,0.0,381.0,381.0,0,0,0.0,0.0,0.0
119794722.0,17,35,16705,35,16705,3523374.1764705884,501.0,477.2857142857143,0,0,0.0,0.0,0.0
108111032.0,17,5,1005,5,1005,27027758.0,201.0,201.0,0,0,0.0,0.0,0.0
23641.0,6,14,4740,7,653,3062.0,249.0,93.28571428571428,7,4087,3810.6666666666665,1514.0,583.8571428571429
117380465.0,17,14,864,7,432,19501322.166666668,174.0,61.71428571428572,7,432,19500196.5,174.0,61.71428571428572
90292646.0,6,17,1287,9,691,11280975.875,95.0,76.77777777777777,8,596,12898340.142857144,95.0,74.5
119599338.0,6,20,1490,10,745,13288815.333333334,95.0,74.5,10,745,13259424.444444444,95.0,74.5
31577.0,6,14,4740,7,653,4914.666666666667,249.0,93.28571428571428,7,4087,4965.166666666667,1514.0,583.8571428571429
87318.0,6,14,4740,7,653,14267.833333333334,249.0,93.28571428571428,7,4087,13551.666666666666,1514.0,583.8571428571429
8391.0,17,2,582,1,83,0.0,83.0,83.0,1,499,0.0,499.0,499.0
2420.0,17,4,344,2,150,0.0,75.0,75.0,2,194,0.0,103.0,97.0
107050831.0,17,14,864,7,432,17833530.833333332,174.0,61.71428571428572,7,432,17833578.5,174.0,61.71428571428572
22970.0,6,14,4740,7,653,3054.1666666666665,249.0,93.28571428571428,7,4087,3643.0,1514.0,583.8571428571429
1972.0,17,4,344,2,150,0.0,75.0,75.0,2,194,0.0,103.0,97.0
1419.0,17,5,550,5,550,354.75,110.0,110.0,0,0,0.0,0.0,0.0
338995.0,6,3,204,2,136,0.0,70.0,68.0,1,68,0.0,68.0,68.0
29941.0,6,2,177,1,123,0.0,123.0,123.0,1,54,0.0,54.0,54.0
103422.0,17,2,762,2,762,0.0,381.0,381.0,0,0,0.0,0.0,0.0
315536.0,17,4,1400,4,1400,105178.66666666669,350.0,350.0,0,0,0.0,0.0,0.0
745.0,17,4,438,2,148,0.0,74.0,74.0,2,290,0.0,147.0,145.0
100304869.0,17,13,821,7,432,16666802.666666666,174.0,61.71428571428572,6,389,20000983.4,174.0,64.83333333333333
322830.0,17,4,1400,4,1400,107610.0,350.0,350.0,0,0,0.0,0.0,0.0
121243234.0,6,228,25952,114,7820,1056589.4867256638,140.0,68.59649122807018,114,18132,1065671.6548672563,284.0,159.05263157894737
351.0,17,2,267,1,83,0.0,83.0,83.0,1,184,0.0,184.0,184.0
8946971.0,17,3,1034,2,684,0.0,342.0,342.0,1,350,0.0,350.0,350.0
411.0,17,2,410,1,78,0.0,78.0,78.0,1,332,0.0,332.0,332.0
108104973.0,17,5,955,5,955,27026243.25,191.0,191.0,0,0,0.0,0.0,0.0
21722.0,6,10,2032,5,524,5182.5,252.0,104.8,5,1508,5042.0,1236.0,301.6
105088.0,17,2,700,2,700,0.0,350.0,350.0,0,0,0.0,0.0,0.0
90747117.0,6,19,1597,9,650,11343389.625,95.0,72.22222222222223,10,947,10050001.333333334,256.0,94.7
153375.0,17,2,180,1,90,0.0,90.0,90.0,1,90,0.0,90.0,90.0
1377125.0,6,2,132,1,66,0.0,66.0,66.0,1,66,0.0,66.0,66.0
116777112.0,17,14,864,7,432,19333504.0,174.0,61.71428571428572,7,432,19334309.5,174.0,61.71428571428572
33739.0,6,14,4740,7,653,5436.5,249.0,93.28571428571428,7,4087,5135.5,1514.0,583.8571428571429
228417.0,17,2,180,1,90,0.0,90.0,90.0,1,90,0.0,90.0,90.0
47557.0,6,14,4740,7,653,7689.333333333333,249.0,93.28571428571428,7,4087,7258.5,1514.0,583.8571428571429
768.0,17,4,438,2,148,0.0,74.0,74.0,2,290,0.0,147.0,145.0
103765.0,17,2,286,2,286,0.0,143.0,143.0,0,0,0.0,0.0,0.0
108363.0,17,2,286,2,286,0.0,143.0,143.0,0,0,0.0,0.0,0.0
303.0,17,2,156,1,78,0.0,78.0,78.0,1,78,0.0,78.0,78.0
41192.0,6,10,2032,5,524,10062.25,252.0,104.8,5,1508,8704.75,1236.0,301.6
123953578.0,6,32,2236,16,1071,7597801.8,123.0,66.9375,16,1165,7597792.933333334,139.0,72.8125
204670.0,17,2,762,2,762,0.0,381.0,381.0,0,0,0.0,0.0,0.0
310.0,17,2,174,1,79,0.0,79.0,79.0,1,95,0.0,95.0,95.0
155162.0,6,3,337,2,214,0.0,160.0,107.0,1,123,0.0,123.0,123.0
108120307.0,17,5,955,5,955,27030076.75,191.0,191.0,0,0,0.0,0.0,0.0
121393.0,6,3,337,2,214,0.0,160.0,107.0,1,123,0.0,123.0,123.0
25492.0,6,10,2032,5,524,5607.5,252.0,104.8,5,1508,5902.0,1236.0,301.6
118832709.0,6,35,2526,18,1332,6990159.352941177,123.0,74.0,17,1194,7413535.875,123.0,70.23529411764706
98209857.0,6,188,21204,94,14778,1053705.838709677,284.0,157.2127659574468,94,6426,1053705.752688172,140.0,68.36170212765957
109472217.0,6,33,2296,17,1225,6828510.125,139.0,72.05882352941177,16,1071,7283747.4,123.0,66.9375
120097569.0,6,260,29848,130,8876,924632.6434108528,140.0,68.27692307692308,130,20972,924639.3023255814,284.0,161.3230769230769
95031168.0,17,12,778,6,389,19000166.6,174.0,64.83333333333333,6,389,19000929.8,174.0,64.83333333333333
2801436.0,6,2,132,1,66,0.0,66.0,66.0,1,66,0.0,66.0,66.0
36989.0,6,10,2032,5,524,7856.0,252.0,104.8,5,1508,7051.25,1236.0,301.6
39599.0,6,14,4740,7,653,6314.5,249.0,93.28571428571428,7,4087,4837.0,1514.0,583.8571428571429
400.0,17,2,410,1,78,0.0,78.0,78.0,1,332,0.0,332.0,332.0
202013.0,6,10,1066,5,490,49096.75,218.0,98.0,5,576,50025.25,304.0,115.2
90261650.0,6,13,2036,8,1016,12894521.42857143,188.0,127.0,5,1020,22524299.5,204.0,204.0
299.0,17,2,174,1,79,0.0,79.0,79.0,1,95,0.0,95.0,95.0
120752706.0,6,445,71830,223,56808,543931.1081081082,1514.0,254.7443946188341,222,15022,541631.0814479638,214.0,67.66666666666667
34462.0,6,10,2032,5,524,7908.25,252.0,104.8,5,1508,7919.0,1236.0,301.6
120124828.0,6,13,2036,8,1016,17098242.85714286,188.0,127.0,5,1020,22592280.0,204.0,204.0
93901391.0,6,211,24030,106,7218,894298.9619047618,140.0,68.09433962264151,105,16812,892876.6923076923,390.0,160.11428571428573
119467307.0,6,25,1883,12,894,10838075.181818182,95.0,74.5,13,989,9944174.666666666,95.0,76.07692307692308
107314.0,17,2,286,2,286,0.0,143.0,143.0,0,0,0.0,0.0,0.0
18565.0,6,14,4740,7,653,2716.0,249.0,93.28571428571428,7,4087,2954.5,1514.0,583.8571428571429
321610.0,6,6,412,4,272,107203.33333333331,74.0,68.0,2,140,0.0,74.0,70.0
158616.0,17,4,1400,4,1400,52872.0,350.0,350.0,0,0,0.0,0.0,0.0
46184.0,6,14,4740,7,653,5339.833333333333,249.0,93.28571428571428,7,4087,7542.166666666667,1514.0,583.8571428571429
10532413.0,6,7,478,4,272,3463348.6666666665,74.0,68.0,3,206,5194977.5,74.0,68.66666666666667
300584.0,6,6,412,4,272,100194.66666666669,74.0,68.0,2,140,0.0,74.0,70.0
30582.0,6,13,4515,6,512,5811.8,230.0,85.33333333333333,7,4003,4879.0,1514.0,571.8571428571429
321042.0,17,4,1400,4,1400,107014.0,350.0,350.0,0,0,0.0,0.0,0.0
1344513.0,17,16,1120,16,1120,89634.2,70.0,70.0,0,0,0.0,0.0,0.0
309.0,17,2,174,1,79,0.0,79.0,79.0,1,95,0.0,95.0,95.0
4185267.0,6,5,336,2,134,0.0,68.0,67.0,3,202,800082.0,70.0,67.33333333333333
135134771.0,17,6,1146,6,1146,27026954.2,191.0,191.0,0,0,0.0,0.0,0.0
103420.0,17,2,286,2,286,0.0,143.0,143.0,0,0,0.0,0.0,0.0
279313.0,17,2,180,1,90,0.0,90.0,90.0,1,90,0.0,90.0,90.0
120500921.0,6,223,25246,112,17624,1085593.8828828828,284.0,157.35714285714286,111,7622,1086011.2636363637,140.0,68.66666666666667
1705765.0,6,4,276,2,128,0.0,74.0,64.0,2,148,0.0,74.0,74.0
300472.0,6,6,412,4,272,100157.33333333331,74.0,68.0,2,140,0.0,74.0,70.0
90293545.0,6,16,1192,8,596,12892129.285714284,95.0,74.5,8,596,12897867.857142856,95.0,74.5
120151730.0,6,13,2036,8,1016,17141139.85714286,188.0,127.0,5,1020,22529105.25,204.0,204.0
121218.0,6,3,337,2,214,0.0,160.0,107.0,1,123,0.0,123.0,123.0
295.0,17,2,174,1,79,0.0,79.0,79.0,1,95,0.0,95.0,95.0
12148.0,6,10,2032,5,524,2502.5,252.0,104.8,5,1508,2721.0,1236.0,301.6
854948.0,6,9,1096,6,625,170989.6,287.0,104.16666666666669,3,471,289680.5,331.0,157.0
135127819.0,17,6,1146,6,1146,27025563.8,191.0,191.0,0,0,0.0,0.0,0.0
4230.0,17,4,344,2,150,0.0,75.0,75.0,2,194,0.0,103.0,97.0
122260.0,6,3,373,2,238,0.0,172.0,119.0,1,135,0.0,135.0,135.0
223840.0,6,3,426,2,280,0.0,214.0,140.0,1,146,0.0,146.0,146.0
90754781.0,6,22,1680,12,935,8245777.909090909,95.0,77.91666666666667,10,745,10053668.111111112,95.0,74.5
142232.0,6,3,337,2,214,0.0,160.0,107.0,1,123,0.0,123.0,123.0
108101149.0,17,5,1005,5,1005,27025287.25,201.0,201.0,0,0,0.0,0.0,0.0
1306259.0,6,4,264,2,132,0.0,66.0,66.0,2,132,0.0,66.0,66.0
4599214.0,6,5,336,2,134,0.0,68.0,67.0,3,202,1526112.0,70.0,67.33333333333333
115432352.0,6,48,3168,24,1584,5018797.913043479,66.0,66.0,24,1584,5009400.478260869,66.0,66.0
36527.0,6,10,2032,5,524,8886.25,252.0,104.8,5,1508,8614.5,1236.0,301.6
90021648.0,17,27,12943,27,12943,3462371.076923077,501.0,479.3703703703704,0,0,0.0,0.0,0.0
296.0,17,2,156,1,78,0.0,78.0,78.0,1,78,0.0,78.0,78.0
44336.0,6,10,2032,5,524,10334.25,252.0,104.8,5,1508,10777.5,1236.0,301.6
42975.0,6,2,132,1,66,0.0,66.0,66.0,1,66,0.0,66.0,66.0
47049.0,6,14,4740,7,653,6953.5,249.0,93.28571428571428,7,4087,6913.333333333333,1514.0,583.8571428571429
90022793.0,17,28,13364,28,13364,3334177.5185185187,501.0,477.2857142857143,0,0,0.0,0.0,0.0
61386.0,6,14,4740,7,653,9661.833333333334,249.0,93.28571428571428,7,4087,10086.333333333334,1514.0,583.8571428571429
250498.0,17,4,6056,4,6056,83499.33333333333,1514.0,1514.0,0,0,0.0,0.0,0.0
316537.0,17,4,704,2,148,0.0,74.0,74.0,2,556,0.0,280.0,278.0
104887650.0,17,14,4788,14,4788,8068280.769230769,342.0,342.0,0,0,0.0,0.0,0.0
321789.0,6,6,412,4,272,107263.0,74.0,68.0,2,140,0.0,74.0,70.0
108241281.0,17,16,1212,8,606,15440338.285714284,174.0,75.75,8,606,15403851.57142857,174.0,75.75
121001227.0,17,15,907,8,475,17285889.57142857,174.0,59.375,7,432,16834446.166666668,174.0,61.71428571428572
53485.0,6,14,4740,7,653,8405.333333333334,249.0,93.28571428571428,7,4087,8343.166666666666,1514.0,583.8571428571429
213654.0,17,2,180,1,90,0.0,90.0,90.0,1,90,0.0,90.0,90.0
30685.0,6,14,4740,7,653,4949.666666666667,249.0,93.28571428571428,7,4087,4891.833333333333,1514.0,583.8571428571429
120055090.0,17,28,13364,28,13364,4446484.814814814,501.0,477.2857142857143,0,0,0.0,0.0,0.0
13764.0,6,14,4740,7,653,2163.333333333333,249.0,93.28571428571428,7,4087,2102.833333333333,1514.0,583.8571428571429
372.0,17,2,267,1,83,0.0,83.0,83.0,1,184,0.0,184.0,184.0
27670.0,6,14,4740,7,653,4363.833333333333,249.0,93.28571428571428,7,4087,4476.333333333333,1514.0,583.8571428571429
35521.0,6,13,1394,7,797,5669.833333333333,253.0,113.85714285714286,6,597,6762.6,259.0,99.5
210041.0,6,3,426,2,280,0.0,214.0,140.0,1,146,0.0,146.0,146.0
90014925.0,6,19,1436,10,786,10001658.333333334,95.0,78.6,9,650,11215253.75,95.0,72.22222222222223
12970578.0,17,20,7568,20,7568,682662.0,394.0,378.4,0,0,0.0,0.0,0.0
15118.0,6,11,2098,6,590,2150.4,252.0,98.33333333333331,5,1508,3385.75,1236.0,301.6
228292.0,17,2,180,1,90,0.0,90.0,90.0,1,90,0.0,90.0,90.0
51090.0,17,2,180,1,90,0.0,90.0,90.0,1,90,0.0,90.0,90.0
90741540.0,6,22,1680,12,894,8246682.0,95.0,74.5,10,786,10081488.777777778,95.0,78.6
119401188.0,6,295,33666,148,23668,812252.9795918367,284.0,159.9189189189189,147,9998,803711.506849315,140.0,68.01360544217687
119545996.0,17,34,16284,34,16284,3622605.93939394,501.0,478.9411764705882,0,0,0.0,0.0,0.0
105319.0,17,2,286,2,286,0.0,143.0,143.0,0,0,0.0,0.0,0.0
299148.0,6,6,412,4,272,99716.0,74.0,68.0,2,140,0.0,74.0,70.0
120252135.0,6,214,24074,107,7358,1116671.3773584906,140.0,68.76635514018692,107,16716,1116754.150943396,284.0,156.22429906542055
108107105.0,17,5,955,5,955,27026776.25,191.0,191.0,0,0,0.0,0.0,0.0
10412579.0,6,6,412,3,206,5138421.5,74.0,68.66666666666667,3,206,5138326.5,74.0,68.66666666666667
217828.0,6,3,426,2,280,0.0,214.0,140.0,1,146,0.0,146.0,146.0
3004572.0,6,11,2106,6,598,600740.8,252.0,99.66666666666669,5,1508,1804.5,1236.0,301.6
751263.0,6,2,132,1,66,0.0,66.0,66.0,1,66,0.0,66.0,66.0
90255536.0,6,14,2240,8,1016,12893648.0,188.0,127.0,6,1224,18018145.0,204.0,204.0
66434.0,6,10,2032,5,524,16365.5,252.0,104.8,5,1508,15326.0,1236.0,301.6
41705.0,6,14,4740,7,653,6840.666666666667,249.0,93.28571428571428,7,4087,5780.833333333333,1514.0,583.8571428571429
70566.0,6,13,1386,7,789,11761.0,253.0,112.71428571428572,6,597,13527.4,259.0,99.5
13637848.0,6,20,1607,10,975,1481771.4444444445,315.0,97.5,10,632,1481748.0,78.0,63.2
90245777.0,6,12,1832,8,1016,12892253.857142856,188.0,127.0,4,816,30027439.0,204.0,204.0
103330.0,17,2,286,2,286,0.0,143.0,143.0,0,0,0.0,0.0,0.0
197299.0,17,2,180,1,90,0.0,90.0,90.0,1,90,0.0,90.0,90.0
41075121.0,6,8,1307,8,1307,5867874.428571428,172.0,163.375,0,0,0.0,0.0,0.0
90271433.0,6,12,1832,8,1016,12895919.0,188.0,127.0,4,816,30036364.33333333,204.0,204.0
108457.0,17,2,286,2,286,0.0,143.0,143.0,0,0,0.0,0.0,0.0
113309731.0,6,45,2970,23,1518,5150442.318181818,66.0,66.0,22,1452,5016430.80952381,66.0,66.0
1275429.0,17,7,490,7,490,212571.5,70.0,70.0,0,0,0.0,0.0,0.0
102696083.0,6,252,29336,126,20798,819834.232,284.0,165.06349206349208,126,8538,819834.648,140.0,67.76190476190476
123455780.0,6,48,3168,24,1584,4995144.913043479,66.0,66.0,24,1584,5272673.347826087,66.0,66.0
16311.0,6,14,4740,7,653,2281.333333333333,249.0,93.28571428571428,7,4087,2582.6666666666665,1514.0,583.8571428571429
504871.0,6,5,336,2,134,0.0,68.0,67.0,3,202,194570.5,70.0,67.33333333333333
338005.0,17,2,180,1,90,0.0,90.0,90.0,1,90,0.0,90.0,90.0
90301544.0,6,24,1829,13,989,7520516.666666667,95.0,76.07692307692308,11,840,9001578.7,95.0,76.36363636363636
5618791.0,6,4,270,2,134,0.0,68.0,67.0,2,136,0.0,70.0,68.0
120089.0,17,2,180,1,70,0.0,70.0,70.0,1,110,0.0,110.0,110.0
114458.0,17,2,700,2,700,0.0,350.0,350.0,0,0,0.0,0.0,0.0
135123463.0,17,6,1146,6,1146,27024692.6,191.0,191.0,0,0,0.0,0.0,0.0
39330.0,6,10,2032,5,524,9306.75,252.0,104.8,5,1508,9550.75,1236.0,301.6
46580163.0,6,8,1940,3,887,22143828.0,753.0,295.6666666666667,5,1053,11208284.5,785.0,210.6
16005669.999999998,17,6,2052,6,2052,3201134.0,342.0,342.0,0,0,0.0,0.0,0.0
104947712.0,17,15,5130,15,5130,7496265.142857143,342.0,342.0,0,0,0.0,0.0,0.0
196965.0,17,2,180,1,90,0.0,90.0,90.0,1,90,0.0,90.0,90.0
10468363.0,6,7,478,4,272,3444122.333333333,74.0,68.0,3,206,5166077.0,74.0,68.66666666666667
122687746.0,6,48,3168,24,1584,5138106.260869565,66.0,66.0,24,1584,5070217.260869565,66.0,66.0
49843.0,6,14,4740,7,653,8150.5,249.0,93.28571428571428,7,4087,7697.166666666667,1514.0,583.8571428571429
107495895.0,17,14,864,7,432,17833507.0,174.0,61.71428571428572,7,432,17834815.166666668,174.0,61.71428571428572
393.0,17,2,160,1,80,0.0,80.0,80.0,1,80,0.0,80.0,80.0
247218.0,17,2,180,1,90,0.0,90.0,90.0,1,90,0.0,90.0,90.0
31143.0,6,10,2032,5,524,7097.75,252.0,104.8,5,1508,6835.25,1236.0,301.6
45971.0,6,14,4740,7,653,7485.833333333333,249.0,93.28571428571428,7,4087,7362.166666666667,1514.0,583.8571428571429
2792640.0,6,2,132,1,66,0.0,66.0,66.0,1,66,0.0,66.0,66.0
113462306.0,6,31,2182,16,1165,7564153.733333333,139.0,72.8125,15,1017,8089000.071428572,123.0,67.8
2333.0,17,4,344,2,150,0.0,75.0,75.0,2,194,0.0,103.0,97.0
153431.0,17,2,180,1,90,0.0,90.0,90.0,1,90,0.0,90.0,90.0
246130.0,6,3,337,2,214,0.0,160.0,107.0,1,123,0.0,123.0,123.0
146313.0,6,3,337,2,214,0.0,160.0,107.0,1,123,0.0,123.0,123.0
97096174.0,6,26,1746,13,906,8073340.916666667,123.0,69.6923076923077,13,840,8073319.583333333,123.0,64.61538461538461
206853.0,17,2,762,2,762,0.0,381.0,381.0,0,0,0.0,0.0,0.0
74129.0,6,14,4740,7,653,12182.833333333334,249.0,93.28571428571428,7,4087,12033.0,1514.0,583.8571428571429
105752814.0,6,43,2838,21,1386,5160004.1,66.0,66.0,22,1452,5035835.666666667,66.0,66.0
121165822.0,6,25,1924,12,935,11015074.727272728,95.0,77.91666666666667,13,989,7576495.416666667,95.0,76.07692307692308
10009.0,17,4,823,2,163,0.0,89.0,81.5,2,660,0.0,443.0,330.0
22022.0,17,2,582,1,83,0.0,83.0,83.0,1,499,0.0,499.0,499.0
2471044.0,6,25,7573,14,3735,190080.3076923077,1514.0,266.7857142857143,11,3838,221111.2,1514.0,348.90909090909093
205224.0,6,10,1065,5,534,50456.0,262.0,106.8,5,531,2859.75,259.0,106.2
246949.0,6,3,373,2,238,0.0,172.0,119.0,1,135,0.0,135.0,135.0
37330.0,6,14,4740,7,653,6099.0,249.0,93.28571428571428,7,4087,6060.833333333333,1514.0,583.8571428571429
302483.0,6,2,132,1,66,0.0,66.0,66.0,1,66,0.0,66.0,66.0
123730607.0,6,49,3234,25,1650,5155441.958333333,66.0,66.0,24,1584,5105539.434782608,66.0,66.0
13926983.0,17,6,2052,6,2052,2785396.6,342.0,342.0,0,0,0.0,0.0,0.0
2433.0,17,4,344,2,150,0.0,75.0,75.0,2,194,0.0,103.0,97.0
97896774.0,6,40,2640,20,1320,5152461.7894736845,66.0,66.0,20,1320,5138119.368421053,66.0,66.0
209637.0,17,2,762,2,762,0.0,381.0,381.0,0,0,0.0,0.0,0.0
302393.0,6,6,412,4,272,100797.66666666669,74.0,68.0,2,140,0.0,74.0,70.0
1037191.0,6,11,1134,6,558,207438.2,220.0,93.0,5,576,258086.0,304.0,115.2
78.0,17,2,762,2,762,0.0,381.0,381.0,0,0,0.0,0.0,0.0
113798933.0,17,14,864,7,432,18833568.5,174.0,61.71428571428572,7,432,18834175.5,174.0,61.71428571428572
2028.0,17,4,344,2,150,0.0,75.0,75.0,2,194,0.0,103.0,97.0
45001.0,6,14,4740,7,653,7350.5,249.0,93.28571428571428,7,4087,6710.666666666667,1514.0,583.8571428571429
877016.0,6,9,1268,6,797,175403.2,459.0,132.83333333333334,3,471,300703.0,331.0,157.0
11064.0,6,10,1065,5,534,2473.0,262.0,106.8,5,531,2160.0,259.0,106.2
102880066.0,6,41,2706,21,1386,5144003.3,66.0,66.0,20,1320,5056423.47368421,66.0,66.0
107914035.0,6,28,1876,14,982,8284460.461538462,139.0,70.14285714285714,14,894,8284459.230769231,123.0,63.85714285714285
1320456.0,6,4,264,2,132,0.0,66.0,66.0,2,132,0.0,66.0,66.0
120346650.0,6,247,28366,124,20026,978428.048780488,300.0,161.5,123,8340,977894.9098360656,140.0,67.8048780487805
107841040.0,6,28,1860,14,966,8295464.615384615,123.0,69.0,14,894,8278842.615384615,123.0,63.85714285714285
135135093.0,17,6,1146,6,1146,27027018.6,191.0,191.0,0,0,0.0,0.0,0.0
307641.0,6,6,412,4,272,102547.0,74.0,68.0,2,140,0.0,74.0,70.0
143900.0,17,4,344,2,150,0.0,75.0,75.0,2,194,0.0,103.0,97.0
101441724.0,17,14,864,7,432,16833510.166666668,174.0,61.71428571428572,7,432,16834703.166666668,174.0,61.71428571428572
2600733.0,6,2,132,1,66,0.0,66.0,66.0,1,66,0.0,66.0,66.0
211986.0,17,2,762,2,762,0.0,381.0,381.0,0,0,0.0,0.0,0.0
323145.0,17,4,1400,4,1400,107715.0,350.0,350.0,0,0,0.0,0.0,0.0
109789591.0,6,28,1860,14,966,8428748.23076923,123.0,69.0,14,894,8428738.846153846,123.0,63.85714285714285
22578.0,6,14,4740,7,653,3428.0,249.0,93.28571428571428,7,4087,3554.5,1514.0,583.8571428571429
10539445.0,6,7,478,4,272,3467758.0,74.0,68.0,3,206,5201534.5,74.0,68.66666666666667
57417.0,6,14,4740,7,653,9407.5,249.0,93.28571428571428,7,4087,8112.333333333333,1514.0,583.8571428571429
305.0,17,2,174,1,79,0.0,79.0,79.0,1,95,0.0,95.0,95.0
93166237.0,6,176,19884,88,13842,1068401.9425287356,284.0,157.29545454545453,88,6042,1068402.2988505748,140.0,68.6590909090909
100659961.0,17,14,1126,7,563,16667404.833333334,174.0,80.42857142857143,7,563,16666804.5,174.0,80.42857142857143
146322.0,6,3,337,2,214,0.0,160.0,107.0,1,123,0.0,123.0,123.0
252944.0,6,10,1221,6,636,50588.8,298.0,106.0,4,585,78546.66666666667,379.0,146.25
232347.0,6,3,337,2,214,0.0,160.0,107.0,1,123,0.0,123.0,123.0
46303.0,6,11,2098,6,590,9157.6,252.0,98.33333333333331,5,1508,11282.0,1236.0,301.6
108108059.0,17,5,1005,5,1005,27027014.75,201.0,201.0,0,0,0.0,0.0,0.0
153091.0,6,2,132,1,66,0.0,66.0,66.0,1,66,0.0,66.0,66.0
2144.0,17,4,344,2,150,0.0,75.0,75.0,2,194,0.0,103.0,97.0
2142440.0,6,26,7677,14,2582,164803.07692307694,1034.0,184.42857142857144,12,5095,166892.63636363635,1510.0,424.5833333333333
56355.0,6,14,4740,7,653,8990.0,249.0,93.28571428571428,7,4087,8500.833333333334,1514.0,583.8571428571429
0.0,17,1,55,1,55,0.0,55.0,55.0,0,0,0.0,0.0,0.0
100939065.0,6,189,21398,95,6492,1073819.8404255318,140.0,68.33684210526316,94,14906,1074265.7741935484,284.0,158.5744680851064
307665.0,6,3,202,2,128,0.0,74.0,64.0,1,74,0.0,74.0,74.0
308857.0,6,6,412,4,272,102952.33333333331,74.0,68.0,2,140,0.0,74.0,70.0
19927.0,17,2,582,1,83,0.0,83.0,83.0,1,499,0.0,499.0,499.0
328637.0,6,6,412,4,272,109545.66666666669,74.0,68.0,2,140,0.0,74.0,70.0
30235.0,6,14,4740,7,653,3783.5,249.0,93.28571428571428,7,4087,4855.0,1514.0,583.8571428571429
90767280.0,6,179,20160,90,6162,1019857.0786516854,140.0,68.46666666666667,89,13998,1019548.4545454546,284.0,157.2808988764045
90025681.0,17,28,13364,28,13364,3334284.4814814813,501.0,477.2857142857143,0,0,0.0,0.0,0.0
2431.0,17,4,344,2,150,0.0,75.0,75.0,2,194,0.0,103.0,97.0
90302085.0,6,16,1192,8,596,12893640.857142856,95.0,74.5,8,596,12899014.285714284,95.0,74.5
3004502.0,6,12,2172,7,664,500692.5,252.0,94.85714285714286,5,1508,1850.25,1236.0,301.6
94339673.0,6,40,2640,20,1320,4965245.947368421,66.0,66.0,20,1320,4953870.157894737,66.0,66.0
104299191.0,6,30,2106,15,1089,7434532.5,123.0,72.6,15,1017,7434531.5,123.0,67.8
122011028.0,17,15,907,8,475,17430146.85714286,174.0,59.375,7,432,17166864.833333332,174.0,61.71428571428572
15442.0,6,10,2032,5,524,3698.25,252.0,104.8,5,1508,3532.0,1236.0,301.6
5622584.0,6,5,336,2,134,0.0,68.0,67.0,3,202,1523161.5,70.0,67.33333333333333
16124.0,6,13,1459,7,862,2172.5,271.0,123.14285714285714,6,597,2991.2,259.0,99.5
8212082.000000001,17,3,1034,2,684,0.0,342.0,342.0,1,350,0.0,350.0,350.0
41645.0,6,10,2032,5,524,9585.0,252.0,104.8,5,1508,9336.25,1236.0,301.6
250432.0,17,2,359,1,75,0.0,75.0,75.0,1,284,0.0,284.0,284.0
228264.0,17,2,180,1,90,0.0,90.0,90.0,1,90,0.0,90.0,90.0
7051969.0,6,35,14896,15,3230,503712.0714285714,1034.0,215.3333333333333,20,11666,354644.0,1510.0,583.3
251166.0,6,3,337,2,214,0.0,160.0,107.0,1,123,0.0,123.0,123.0
143153.0,17,4,344,2,150,0.0,75.0,75.0,2,194,0.0,103.0,97.0
302389.0,6,2,132,1,66,0.0,66.0,66.0,1,66,0.0,66.0,66.0
10877591.0,6,7,478,3,206,5370221.5,74.0,68.66666666666667,4,272,3580082.333333333,74.0,68.0
204312.0,17,2,180,1,90,0.0,90.0,90.0,1,90,0.0,90.0,90.0
40849.0,6,2,132,1,66,0.0,66.0,66.0,1,66,0.0,66.0,66.0
107845.0,17,2,286,2,286,0.0,143.0,143.0,0,0,0.0,0.0,0.0
40749.0,6,10,2032,5,524,9956.5,252.0,104.8,5,1508,9251.0,1236.0,301.6
29548.0,6,14,4740,7,653,4484.5,249.0,93.28571428571428,7,4087,4363.833333333333,1514.0,583.8571428571429
302399.0,6,6,412,4,272,100799.66666666669,74.0,68.0,2,140,0.0,74.0,70.0
107334.0,17,2,286,2,286,0.0,143.0,143.0,0,0,0.0,0.0,0.0
90292826.0,6,16,1192,8,596,12892621.142857144,95.0,74.5,8,596,12897066.42857143,95.0,74.5
1261651.0,17,5,961,3,234,630641.5,78.0,78.0,2,727,0.0,395.0,363.5
42797.0,6,10,2032,5,524,8700.75,252.0,104.8,5,1508,9340.0,1236.0,301.6
92016411.0,6,38,2508,19,1254,5112004.833333333,66.0,66.0,19,1254,5112009.333333333,66.0,66.0
125001353.0,17,15,907,8,475,17857336.14285714,174.0,59.375,7,432,17500901.5,174.0,61.71428571428572
108100766.0,17,5,955,5,955,27025191.5,191.0,191.0,0,0,0.0,0.0,0.0
3172158.0,6,18,1495,9,921,358115.375,315.0,102.33333333333331,9,574,358083.5,78.0,63.77777777777778
83887.0,6,11,2098,6,590,16650.0,252.0,98.33333333333331,5,1508,17977.25,1236.0,301.6
9573.0,6,10,1067,5,536,2187.0,264.0,107.2,5,531,2099.0,259.0,106.2
2410.0,17,4,344,2,150,0.0,75.0,75.0,2,194,0.0,103.0,97.0
135134661.0,17,6,1146,6,1146,27026932.2,191.0,191.0,0,0,0.0,0.0,0.0
2400.0,17,4,344,2,150,0.0,75.0,75.0,2,194,0.0,103.0,97.0
322714.0,17,4,1400,4,1400,107571.33333333331,350.0,350.0,0,0,0.0,0.0,0.0
301708.0,17,2,180,1,90,0.0,90.0,90.0,1,90,0.0,90.0,90.0
214562.0,6,10,1221,6,636,42912.4,298.0,106.0,4,585,70678.0,379.0,146.25
111002152.0,6,36,2596,18,1348,6516851.05882353,139.0,74.88888888888889,18,1248,6516848.588235294,123.0,69.33333333333333
1050542.0,6,13,1394,7,797,175090.33333333334,253.0,113.85714285714286,6,597,206049.4,259.0,99.5
2593711.0,6,2,132,1,66,0.0,66.0,66.0,1,66,0.0,66.0,66.0
303.0,17,2,168,1,76,0.0,76.0,76.0,1,92,0.0,92.0,92.0
35819.0,6,14,4740,7,653,5733.666666666667,249.0,93.28571428571428,7,4087,5753.666666666667,1514.0,583.8571428571429
215491.0,17,2,180,1,90,0.0,90.0,90.0,1,90,0.0,90.0,90.0
2950197.0,6,3,1777,1,826,0.0,826.0,826.0,2,951,0.0,885.0,475.5
103885243.0,6,31,2314,16,1228,6911292.866666666,139.0,76.75,15,1086,7404960.0,123.0,72.4
3007362.0,6,12,2172,7,664,501050.6666666667,252.0,94.85714285714286,5,1508,2040.25,1236.0,301.6
95368644.0,6,40,2640,20,1320,5019402.315789473,66.0,66.0,20,1320,5004901.52631579,66.0,66.0
33133.0,6,14,4740,7,653,5402.5,249.0,93.28571428571428,7,4087,5064.333333333333,1514.0,583.8571428571429
2150954.0,17,3,1026,3,1026,1075477.0,342.0,342.0,0,0,0.0,0.0,0.0
120077587.0,17,29,13785,29,13785,4288485.25,501.0,475.3448275862069,0,0,0.0,0.0,0.0
41763.0,6,14,4740,7,653,5664.333333333333,249.0,93.28571428571428,7,4087,6008.5,1514.0,583.8571428571429
26386202.0,17,4,1376,3,1026,1327151.5,342.0,342.0,1,350,0.0,350.0,350.0
1605.0,17,2,762,2,762,0.0,381.0,381.0,0,0,0.0,0.0,0.0
120009483.0,6,21,1585,11,840,11999988.2,95.0,76.36363636363636,10,745,13332487.888888888,95.0,74.5
103145.0,17,2,286,2,286,0.0,143.0,143.0,0,0,0.0,0.0,0.0
108103806.0,17,5,1005,5,1005,27025951.5,201.0,201.0,0,0,0.0,0.0,0.0
1700699.0,17,2,876,2,876,0.0,438.0,438.0,0,0,0.0,0.0,0.0
90032601.0,17,27,12943,27,12943,3462792.346153846,501.0,479.3703703703704,0,0,0.0,0.0,0.0
503881.0,6,5,336,2,134,0.0,68.0,67.0,3,202,193333.5,70.0,67.33333333333333
122076.0,6,3,337,2,214,0.0,160.0,107.0,1,123,0.0,123.0,123.0
300125.0,6,6,412,4,272,100041.66666666669,74.0,68.0,2,140,0.0,74.0,70.0
2334.0,17,4,344,2,150,0.0,75.0,75.0,2,194,0.0,103.0,97.0
123610654.0,6,49,3234,25,1650,5150443.916666667,66.0,66.0,24,1584,5099286.565217392,66.0,66.0
90286412.0,6,16,1192,8,596,12892025.285714284,95.0,74.5,8,596,12897129.857142856,95.0,74.5
114777981.0,6,47,3102,24,1584,4978379.434782608,66.0,66.0,23,1518,5135434.727272728,66.0,66.0
37387.0,6,14,4740,7,653,5630.666666666667,249.0,93.28571428571428,7,4087,5414.333333333333,1514.0,583.8571428571429
22495.0,17,4,823,2,163,0.0,89.0,81.5,2,660,0.0,443.0,330.0
850426.0,6,9,1267,6,796,170085.2,458.0,132.66666666666666,3,471,288873.5,331.0,157.0
264793.0,6,12,1373,7,714,44132.16666666666,298.0,102.0,5,659,62179.0,379.0,131.8
4069.0,17,4,344,2,150,0.0,75.0,75.0,2,194,0.0,103.0,97.0
438.0,17,2,508,2,508,0.0,257.0,254.0,0,0,0.0,0.0,0.0
275767.0,17,2,238,1,74,0.0,74.0,74.0,1,164,0.0,164.0,164.0
106561.0,17,2,700,2,700,0.0,350.0,350.0,0,0,0.0,0.0,0.0
116116372.0,6,30,2122,15,1017,8293996.857142857,123.0,67.8,15,1105,7580810.642857143,139.0,73.66666666666667
90258528.0,6,12,1832,8,1016,12894075.42857143,188.0,127.0,4,816,30031782.0,204.0,204.0
104864.0,17,2,286,2,286,0.0,143.0,143.0,0,0,0.0,0.0,0.0
34376.0,6,10,2032,5,524,8316.75,252.0,104.8,5,1508,8311.75,1236.0,301.6
486064.0,6,3,1604,1,753,0.0,753.0,753.0,2,851,0.0,785.0,425.5
55758.0,6,14,4740,7,653,9172.333333333334,249.0,93.28571428571428,7,4087,8812.0,1514.0,583.8571428571429
90254801.0,6,13,2036,8,1016,12893543.0,188.0,127.0,5,1020,22523219.25,204.0,204.0
118403549.0,6,209,23618,105,7226,1138495.6634615385,140.0,68.81904761904762,104,16392,1130552.5922330096,284.0,157.6153846153846
56631.0,6,14,4740,7,653,7929.0,249.0,93.28571428571428,7,4087,8271.166666666666,1514.0,583.8571428571429
38657.0,6,14,4740,7,653,5991.166666666667,249.0,93.28571428571428,7,4087,5571.833333333333,1514.0,583.8571428571429
311711.0,17,4,704,2,148,0.0,74.0,74.0,2,556,0.0,280.0,278.0
846240.0,6,9,1118,6,586,169248.0,248.0,97.66666666666669,3,532,285339.5,392.0,177.33333333333334
102706.0,17,2,762,2,762,0.0,381.0,381.0,0,0,0.0,0.0,0.0
90040457.0,17,26,12458,26,12458,3601618.28,501.0,479.1538461538461,0,0,0.0,0.0,0.0
846779.0,6,9,1196,6,725,169355.8,387.0,120.83333333333331,3,471,287133.0,331.0,157.0
596811.0,17,3,551,2,156,0.0,78.0,78.0,1,395,0.0,395.0,395.0
2024.0,17,4,344,2,150,0.0,75.0,75.0,2,194,0.0,103.0,97.0
212936.0,6,3,426,2,280,0.0,214.0,140.0,1,146,0.0,146.0,146.0
120462247.0,6,26,2019,12,935,10951113.363636363,95.0,77.91666666666667,14,1084,6957348.769230769,95.0,77.42857142857143
90356553.0,6,27,1932,14,963,6950504.076923077,123.0,68.78571428571429,13,969,6679637.5,123.0,74.53846153846153
153522.0,17,2,180,1,90,0.0,90.0,90.0,1,90,0.0,90.0,90.0
307.0,17,2,168,1,76,0.0,76.0,76.0,1,92,0.0,92.0,92.0
144720.0,17,2,180,1,70,0.0,70.0,70.0,1,110,0.0,110.0,110.0
108101026.0,17,5,955,5,955,27025256.5,191.0,191.0,0,0,0.0,0.0,0.0
233700.0,6,3,373,2,238,0.0,172.0,119.0,1,135,0.0,135.0,135.0
120254203.0,6,328,38090,164,11046,732689.1472392638,140.0,67.35365853658537,164,27044,733463.0858895705,300.0,164.90243902439025
2077.0,17,4,344,2,150,0.0,75.0,75.0,2,194,0.0,103.0,97.0
102437714.0,17,14,864,7,432,17001126.5,174.0,61.71428571428572,7,432,17000159.833333332,174.0,61.71428571428572
26335.0,6,10,2032,5,524,6341.0,252.0,104.8,5,1508,6001.0,1236.0,301.6
2979987.0,6,161,126249,90,117261,33483.0,1510.0,1302.9,71,8988,38264.31428571429,1510.0,126.59154929577464
1844.0,17,4,344,2,150,0.0,75.0,75.0,2,194,0.0,103.0,97.0
90012156.0,17,28,13364,28,13364,3333783.5555555555,501.0,477.2857142857143,0,0,0.0,0.0,0.0
196993.0,17,2,180,1,90,0.0,90.0,90.0,1,90,0.0,90.0,90.0
90529675.0,6,14,2240,8,1016,12932810.714285716,188.0,127.0,6,1224,18072790.4,204.0,204.0
90529790.0,6,15,2444,8,1016,12932827.142857144,188.0,127.0,7,1428,15061084.666666666,204.0,204.0
312.0,17,2,174,1,79,0.0,79.0,79.0,1,95,0.0,95.0,95.0
23434.0,6,10,2032,5,524,5614.0,252.0,104.8,5,1508,5633.75,1236.0,301.6
120125299.0,6,14,2240,6,1224,24025059.8,204.0,204.0,8,1016,17098436.57142857,188.0,127.0
65932796.99999999,6,4,268,2,132,0.0,66.0,66.0,2,136,0.0,70.0,68.0
2395.0,17,4,344,2,150,0.0,75.0,75.0,2,194,0.0,103.0,97.0
191261.0,17,4,6056,4,6056,63753.66666666666,1514.0,1514.0,0,0,0.0,0.0,0.0
149832136.0,17,36,17126,36,17126,4280918.171428571,501.0,475.72222222222223,0,0,0.0,0.0,0.0
877489.0,6,10,1334,6,797,175497.8,459.0,132.83333333333334,4,537,201306.3333333333,331.0,134.25
135143973.0,17,6,1206,6,1206,27028794.6,201.0,201.0,0,0,0.0,0.0,0.0
14641686.0,6,20,1607,10,975,1592474.3333333333,315.0,97.5,10,632,1592444.6666666667,78.0,63.2
120248682.0,17,14,864,7,432,20041447.0,174.0,61.71428571428572,7,432,19965873.33333333,174.0,61.71428571428572
899147.0,6,10,1336,6,799,179829.4,461.0,133.16666666666666,4,537,208811.3333333333,331.0,134.25
143922.0,17,2,180,1,90,0.0,90.0,90.0,1,90,0.0,90.0,90.0
16825.0,17,2,180,1,90,0.0,90.0,90.0,1,90,0.0,90.0,90.0
1109597.0,6,13,1386,7,789,184932.8333333333,253.0,112.71428571428572,6,597,219646.4,259.0,99.5
166526.0,17,2,180,1,90,0.0,90.0,90.0,1,90,0.0,90.0,90.0
2431.0,17,4,344,2,150,0.0,75.0,75.0,2,194,0.0,103.0,97.0
2821478.0,6,2,132,1,66,0.0,66.0,66.0,1,66,0.0,66.0,66.0
22230.0,6,20,7606,11,978,2223.0,310.0,88.9090909090909,9,6628,2343.75,1514.0,736.4444444444445
205917.0,17,2,180,1,90,0.0,90.0,90.0,1,90,0.0,90.0,90.0
135131052.0,17,6,1206,6,1206,27026210.4,201.0,201.0,0,0,0.0,0.0,0.0
276238.0,17,2,346,1,78,0.0,78.0,78.0,1,268,0.0,268.0,268.0
857.0,17,4,438,2,148,0.0,74.0,74.0,2,290,0.0,147.0,145.0
103437.0,17,2,286,2,286,0.0,143.0,143.0,0,0,0.0,0.0,0.0
310025.0,17,4,1400,4,1400,103341.66666666669,350.0,350.0,0,0,0.0,0.0,0.0
49369.0,6,10,2032,5,524,10179.75,252.0,104.8,5,1508,12080.75,1236.0,301.6
30025.0,6,14,4740,7,653,4573.333333333333,249.0,93.28571428571428,7,4087,4103.0,1514.0,583.8571428571429
102001030.0,17,13,821,7,432,17000171.666666668,174.0,61.71428571428572,6,389,16401734.2,174.0,64.83333333333333
2989890.0,6,3,204,2,136,0.0,70.0,68.0,1,68,0.0,68.0,68.0
217935.0,6,3,426,2,280,0.0,214.0,140.0,1,146,0.0,146.0,146.0
115771872.0,6,34,2482,17,1194,7235742.0,123.0,70.23529411764706,17,1288,6598097.0625,139.0,75.76470588235294
2307.0,17,4,344,2,150,0.0,75.0,75.0,2,194,0.0,103.0,97.0
44765.0,6,12,1393,6,796,8747.4,271.0,132.66666666666666,6,597,6498.4,259.0,99.5
114430969.0,6,48,3168,24,1584,4975259.521739131,66.0,66.0,24,1584,4965863.695652174,66.0,66.0
329.0,17,2,166,1,75,0.0,75.0,75.0,1,91,0.0,91.0,91.0
65643.0,6,14,4740,7,653,7724.0,249.0,93.28571428571428,7,4087,10578.666666666666,1514.0,583.8571428571429
298846.0,6,6,412,4,272,99615.33333333331,74.0,68.0,2,140,0.0,74.0,70.0
205623.0,17,2,180,1,90,0.0,90.0,90.0,1,90,0.0,90.0,90.0
51841.0,6,14,4740,7,653,8534.5,249.0,93.28571428571428,7,4087,7604.5,1514.0,583.8571428571429
10895.0,17,2,539,1,86,0.0,86.0,86.0,1,453,0.0,453.0,453.0
297261.0,6,6,412,4,272,99087.0,74.0,68.0,2,140,0.0,74.0,70.0
4449.0,17,2,602,1,72,0.0,72.0,72.0,1,530,0.0,530.0,530.0
3270225.0,6,18,1536,9,962,370457.0,315.0,106.88888888888889,9,574,370423.25,78.0,63.77777777777778
208804.0,6,3,426,2,280,0.0,214.0,140.0,1,146,0.0,146.0,146.0
126750.0,6,2,132,1,66,0.0,66.0,66.0,1,66,0.0,66.0,66.0
28472.0,6,10,2032,5,524,6907.25,252.0,104.8,5,1508,4778.5,1236.0,301.6
217827.0,6,3,426,2,280,0.0,214.0,140.0,1,146,0.0,146.0,146.0
48957.0,6,14,4740,7,653,7936.666666666667,249.0,93.28571428571428,7,4087,7783.0,1514.0,583.8571428571429
308930.0,6,6,412,4,272,102976.66666666669,74.0,68.0,2,140,0.0,74.0,70.0
108107984.0,17,5,955,5,955,27026996.0,191.0,191.0,0,0,0.0,0.0,0.0
297140.0,6,6,412,4,272,99046.66666666669,74.0,68.0,2,140,0.0,74.0,70.0
46310.0,6,14,4740,7,653,7563.333333333333,249.0,93.28571428571428,7,4087,6073.666666666667,1514.0,583.8571428571429
3235479.0,6,3,1604,2,851,0.0,785.0,425.5,1,753,0.0,753.0,753.0
20628.0,6,10,2032,5,524,4520.5,252.0,104.8,5,1508,4552.5,1236.0,301.6
468351.0,6,10,1221,6,636,93670.2,298.0,106.0,4,585,155002.33333333334,379.0,146.25
302022.0,6,6,412,4,272,100674.0,74.0,68.0,2,140,0.0,74.0,70.0
90288803.0,6,16,1192,8,596,12891994.714285716,95.0,74.5,8,596,12896935.42857143,95.0,74.5
55242.0,6,14,4740,7,653,8252.166666666666,249.0,93.28571428571428,7,4087,9045.666666666666,1514.0,583.8571428571429
34617.0,6,14,4740,7,653,5637.333333333333,249.0,93.28571428571428,7,4087,5596.166666666667,1514.0,583.8571428571429
101189.0,17,2,762,2,762,0.0,381.0,381.0,0,0,0.0,0.0,0.0
221534.0,17,2,180,1,90,0.0,90.0,90.0,1,90,0.0,90.0,90.0
9319.0,17,2,582,1,83,0.0,83.0,83.0,1,499,0.0,499.0,499.0
101886.0,17,2,700,2,700,0.0,350.0,350.0,0,0,0.0,0.0,0.0
389842.0,6,3,1604,1,753,0.0,753.0,753.0,2,851,0.0,785.0,425.5
315749.0,6,6,412,4,272,105249.66666666669,74.0,68.0,2,140,0.0,74.0,70.0
275833.0,17,2,180,1,90,0.0,90.0,90.0,1,90,0.0,90.0,90.0
138754.0,6,2,132,1,66,0.0,66.0,66.0,1,66,0.0,66.0,66.0
2495011.0,6,32,10926,18,3951,146765.35294117648,1514.0,219.5,14,6975,171588.23076923078,1514.0,498.2142857142857
120162766.0,6,212,23996,106,7218,1136649.7428571428,140.0,68.09433962264151,106,16778,1136604.7333333334,284.0,158.28301886792454
403378.0,6,4,508,2,238,0.0,172.0,119.0,2,270,0.0,135.0,135.0
143208.0,17,4,344,2,150,0.0,75.0,75.0,2,194,0.0,103.0,97.0
97562159.0,6,196,22156,98,15466,1003565.1958762888,300.0,157.81632653061226,98,6690,1003564.4845360824,140.0,68.26530612244898
107227.0,17,2,286,2,286,0.0,143.0,143.0,0,0,0.0,0.0,0.0
120034657.0,6,254,29468,127,8678,950215.3253968254,140.0,68.33070866141732,127,20790,947962.238095238,284.0,163.7007874015748
90035840.0,17,27,12943,27,12943,3462916.923076923,501.0,479.3703703703704,0,0,0.0,0.0,0.0
197039.0,17,2,180,1,90,0.0,90.0,90.0,1,90,0.0,90.0,90.0
144032.0,17,2,180,1,90,0.0,90.0,90.0,1,90,0.0,90.0,90.0
760.0,17,4,438,2,148,0.0,74.0,74.0,2,290,0.0,147.0,145.0
120325138.0,17,13,821,6,389,20067209.2,174.0,64.83333333333333,7,432,20027705.33333333,174.0,61.71428571428572
18347.0,6,10,2032,5,524,4359.75,252.0,104.8,5,1508,4116.25,1236.0,301.6
48108.0,6,14,4740,7,653,7891.0,249.0,93.28571428571428,7,4087,7697.5,1514.0,583.8571428571429
103354.0,17,2,762,2,762,0.0,381.0,381.0,0,0,0.0,0.0,0.0
93477.0,6,14,4740,7,653,15083.833333333334,249.0,93.28571428571428,7,4087,14433.333333333334,1514.0,583.8571428571429
205806.0,17,2,180,1,90,0.0,90.0,90.0,1,90,0.0,90.0,90.0
3510.0,17,4,571,2,148,0.0,74.0,74.0,2,423,0.0,280.0,211.5
103584.0,17,2,286,2,286,0.0,143.0,143.0,0,0,0.0,0.0,0.0
41355.0,6,14,4740,7,653,6691.0,249.0,93.28571428571428,7,4087,5887.0,1514.0,583.8571428571429
317122.0,6,6,412,4,272,105707.33333333331,74.0,68.0,2,140,0.0,74.0,70.0
2565092.0,6,32,10926,18,3951,150887.76470588235,1514.0,219.5,14,6975,177248.53846153847,1514.0,498.2142857142857
3089311.0,6,12,2172,7,664,509784.1666666667,252.0,94.85714285714286,5,1508,21689.75,1236.0,301.6
305.0,17,2,156,1,78,0.0,78.0,78.0,1,78,0.0,78.0,78.0
241851.0,6,3,373,2,238,0.0,172.0,119.0,1,135,0.0,135.0,135.0
15102.0,17,2,180,1,90,0.0,90.0,90.0,1,90,0.0,90.0,90.0
299899.0,6,6,412,4,272,99966.33333333331,74.0,68.0,2,140,0.0,74.0,70.0
1851.0,17,2,180,1,90,0.0,90.0,90.0,1,90,0.0,90.0,90.0
1030858.0,6,11,1134,6,558,206171.6,220.0,93.0,5,576,256775.5,304.0,115.2
103445.0,17,2,700,2,700,0.0,350.0,350.0,0,0,0.0,0.0,0.0
304125.0,6,6,412,4,272,101375.0,74.0,68.0,2,140,0.0,74.0,70.0
927882.0,6,12,1427,6,796,184949.4,271.0,132.66666666666666,6,631,183792.0,293.0,105.16666666666669
1423817.0,17,16,1120,16,1120,94921.13333333332,70.0,70.0,0,0,0.0,0.0,0.0
2386.0,17,4,344,2,150,0.0,75.0,75.0,2,194,0.0,103.0,97.0
16904.0,17,2,180,1,90,0.0,90.0,90.0,1,90,0.0,90.0,90.0
14998.0,17,2,180,1,90,0.0,90.0,90.0,1,90,0.0,90.0,90.0
10523547.0,6,7,478,4,272,3462238.333333333,74.0,68.0,3,206,5193270.5,74.0,68.66666666666667
10486261.0,6,7,478,4,272,3449867.0,74.0,68.0,3,206,5174678.5,74.0,68.66666666666667
318856.0,17,4,1400,4,1400,106285.33333333331,350.0,350.0,0,0,0.0,0.0,0.0
9534282.0,6,5,1734,2,818,0.0,752.0,409.0,3,916,3470374.0,784.0,305.3333333333333
111144548.0,6,213,23918,107,7358,1048533.4716981133,140.0,68.76635514018692,106,16560,1048738.2476190475,284.0,156.2264150943396
104001149.0,17,13,821,7,432,17333524.833333332,174.0,61.71428571428572,6,389,20056019.2,174.0,64.83333333333333
19038.0,6,14,4740,7,653,2929.333333333333,249.0,93.28571428571428,7,4087,2885.6666666666665,1514.0,583.8571428571429
1558.0,17,2,762,2,762,0.0,381.0,381.0,0,0,0.0,0.0,0.0
315987.0,17,4,1400,4,1400,105329.0,350.0,350.0,0,0,0.0,0.0,0.0
71823.0,6,14,4740,7,653,11526.333333333334,249.0,93.28571428571428,7,4087,10649.833333333334,1514.0,583.8571428571429
108762701.0,6,36,2734,19,1471,6042372.277777778,139.0,77.42105263157895,17,1263,6784834.1875,123.0,74.29411764705883
108102093.0,17,5,1005,5,1005,27025523.25,201.0,201.0,0,0,0.0,0.0,0.0
2048.0,17,4,344,2,150,0.0,75.0,75.0,2,194,0.0,103.0,97.0
120612398.0,6,236,26734,118,8084,1023940.0256410256,140.0,68.50847457627118,118,18650,1029874.5128205128,284.0,158.05084745762713
106468.0,17,2,286,2,286,0.0,143.0,143.0,0,0,0.0,0.0,0.0
37965.0,6,14,4740,7,653,6201.333333333333,249.0,93.28571428571428,7,4087,5335.833333333333,1514.0,583.8571428571429
22696.0,6,10,2032,5,524,5413.0,252.0,104.8,5,1508,5178.25,1236.0,301.6
892943.0,6,2,132,1,66,0.0,66.0,66.0,1,66,0.0,66.0,66.0
589301.0,6,5,526,3,280,294650.5,160.0,93.33333333333331,2,246,0.0,123.0,123.0
120108441.0,6,254,29108,127,8604,946825.9365079365,140.0,67.74803149606299,127,20504,946794.261904762,284.0,161.4488188976378
102017142.0,17,14,864,7,432,16834207.5,174.0,61.71428571428572,7,432,16833502.5,174.0,61.71428571428572
197243.0,17,2,180,1,90,0.0,90.0,90.0,1,90,0.0,90.0,90.0
120122159.0,6,13,2036,8,1016,17137497.714285713,188.0,127.0,5,1020,22523160.25,204.0,204.0
0.0,17,1,90,1,90,0.0,90.0,90.0,0,0,0.0,0.0,0.0
700.0,17,2,508,2,508,0.0,257.0,254.0,0,0,0.0,0.0,0.0
146108.0,6,4,439,2,238,0.0,172.0,119.0,2,201,0.0,135.0,100.5
302007.0,6,6,412,4,272,100669.0,74.0,68.0,2,140,0.0,74.0,70.0
197070.0,17,2,180,1,90,0.0,90.0,90.0,1,90,0.0,90.0,90.0
317542.0,17,4,1400,4,1400,105847.33333333331,350.0,350.0,0,0,0.0,0.0,0.0
117565373.0,6,48,3168,24,1584,5111537.956521739,66.0,66.0,24,1584,5099566.826086956,66.0,66.0
107839440.0,17,14,864,7,432,17833427.166666668,174.0,61.71428571428572,7,432,17833517.0,174.0,61.71428571428572
42213.0,6,14,4740,7,653,6778.666666666667,249.0,93.28571428571428,7,4087,6892.833333333333,1514.0,583.8571428571429
122978191.0,6,48,3168,24,1584,5124381.391304348,66.0,66.0,24,1584,5142837.391304348,66.0,66.0
24177.0,6,10,2032,5,524,5568.25,252.0,104.8,5,1508,5400.5,1236.0,301.6
2328.0,17,4,344,2,150,0.0,75.0,75.0,2,194,0.0,103.0,97.0
1849.0,17,2,192,1,88,0.0,88.0,88.0,1,104,0.0,104.0,104.0
1081341.0,6,13,1386,7,789,180223.5,253.0,112.71428571428572,6,597,214495.0,259.0,99.5
108100408.0,17,5,955,5,955,27025102.0,191.0,191.0,0,0,0.0,0.0,0.0
105151256.0,6,44,2904,22,1452,5007202.666666667,66.0,66.0,22,1452,4994090.714285715,66.0,66.0
307.0,17,2,164,1,82,0.0,82.0,82.0,1,82,0.0,82.0,82.0
106410671.0,6,44,2904,22,1452,5067174.80952381,66.0,66.0,22,1452,5052478.142857143,66.0,66.0
146067.0,6,3,337,2,214,0.0,160.0,107.0,1,123,0.0,123.0,123.0
2220.0,17,4,344,2,150,0.0,75.0,75.0,2,194,0.0,103.0,97.0
120118648.0,6,12,1832,8,1016,17136558.285714287,188.0,127.0,4,816,30030152.0,204.0,204.0
135136608.0,17,6,1146,6,1146,27027321.6,191.0,191.0,0,0,0.0,0.0,0.0
27610.0,6,14,4740,7,653,4440.5,249.0,93.28571428571428,7,4087,4415.333333333333,1514.0,583.8571428571429
44954329.0,17,9,3086,8,2736,5107694.428571428,342.0,342.0,1,350,0.0,350.0,350.0
100182840.0,17,11,604,6,389,20036568.0,174.0,64.83333333333333,5,215,20000151.75,43.0,43.0
2596725.0,6,2,132,1,66,0.0,66.0,66.0,1,66,0.0,66.0,66.0
582902.0,17,2,346,1,78,0.0,78.0,78.0,1,268,0.0,268.0,268.0
162358.0,17,2,180,1,90,0.0,90.0,90.0,1,90,0.0,90.0,90.0
147068.0,6,3,373,2,238,0.0,172.0,119.0,1,135,0.0,135.0,135.0
124031974.0,17,14,864,7,432,20671995.666666668,174.0,61.71428571428572,7,432,17333497.0,174.0,61.71428571428572
25177.0,6,14,4740,7,653,3823.3333333333335,249.0,93.28571428571428,7,4087,4056.3333333333335,1514.0,583.8571428571429
105118.0,17,2,762,2,762,0.0,381.0,381.0,0,0,0.0,0.0,0.0
51469.0,6,14,4740,7,653,8150.666666666667,249.0,93.28571428571428,7,4087,8355.333333333334,1514.0,583.8571428571429
108104998.0,17,5,955,5,955,27026249.5,191.0,191.0,0,0,0.0,0.0,0.0
135141825.0,17,6,1206,6,1206,27028365.0,201.0,201.0,0,0,0.0,0.0,0.0
315364.0,6,3,202,2,128,0.0,74.0,64.0,1,74,0.0,74.0,74.0
437437.0,6,10,967,5,390,73305.0,162.0,78.0,5,577,73234.5,349.0,115.4
122705.0,6,3,373,2,238,0.0,172.0,119.0,1,135,0.0,135.0,135.0
42830.0,6,14,4740,7,653,6814.5,249.0,93.28571428571428,7,4087,5190.833333333333,1514.0,583.8571428571429
108107069.0,17,5,955,5,955,27026767.25,191.0,191.0,0,0,0.0,0.0,0.0
59374.0,6,12,1328,7,797,9895.666666666666,253.0,113.85714285714286,5,531,10675.25,259.0,106.2
1060954.0,17,6,1230,3,234,530288.0,78.0,78.0,3,996,530255.5,332.0,332.0
122012178.0,17,15,907,8,475,17430311.14285714,174.0,59.375,7,432,17000166.5,174.0,61.71428571428572
171656.0,17,2,180,1,90,0.0,90.0,90.0,1,90,0.0,90.0,90.0
147150.0,17,4,704,2,148,0.0,74.0,74.0,2,556,0.0,280.0,278.0
26862.0,6,20,7606,11,978,2686.2,310.0,88.9090909090909,9,6628,3059.75,1514.0,736.4444444444445
103264.0,17,2,286,2,286,0.0,143.0,143.0,0,0,0.0,0.0,0.0
91169176.0,6,18,1382,10,786,10125266.111111112,95.0,78.6,8,596,12877126.0,95.0,74.5
311735.0,17,4,1400,4,1400,103911.66666666669,350.0,350.0,0,0,0.0,0.0,0.0
58800222.0,17,9,3086,8,2736,5114490.0,342.0,342.0,1,350,0.0,350.0,350.0
16254.999999999998,6,13,1459,7,862,2172.833333333333,271.0,123.14285714285714,6,597,3027.6,259.0,99.5
30974.0,6,14,4740,7,653,4965.5,249.0,93.28571428571428,7,4087,3899.6666666666665,1514.0,583.8571428571429
29838.0,6,14,4740,7,653,4852.166666666667,249.0,93.28571428571428,7,4087,4819.833333333333,1514.0,583.8571428571429
9715.0,17,4,823,2,163,0.0,89.0,81.5,2,660,0.0,443.0,330.0
127864849.0,17,17,1386,8,606,16571568.42857143,174.0,75.75,9,780,15956056.375,174.0,86.66666666666667
108107876.0,17,5,1005,5,1005,27026969.0,201.0,201.0,0,0,0.0,0.0,0.0
2351.0,17,4,344,2,150,0.0,75.0,75.0,2,194,0.0,103.0,97.0
108103323.0,17,5,1005,5,1005,27025830.75,201.0,201.0,0,0,0.0,0.0,0.0
2428.0,17,4,344,2,150,0.0,75.0,75.0,2,194,0.0,103.0,97.0
33221.0,6,10,2032,5,524,7989.0,252.0,104.8,5,1508,7839.5,1236.0,301.6
90052639.0,17,28,13364,28,13364,3335282.925925926,501.0,477.2857142857143,0,0,0.0,0.0,0.0
90255374.0,6,13,2036,8,1016,12893624.857142856,188.0,127.0,5,1020,22523320.0,204.0,204.0
93008518.0,6,38,2508,19,1254,5150434.222222222,66.0,66.0,19,1254,5150435.555555556,66.0,66.0
20023.0,17,2,582,1,83,0.0,83.0,83.0,1,499,0.0,499.0,499.0
116308376.0,6,393,45984,197,32752,593410.081632653,336.0,166.253807106599,196,13232,591812.1948717949,140.0,67.51020408163265
91717526.0,6,268,31012,134,9004,686972.090225564,140.0,67.19402985074628,134,22008,683374.4812030075,284.0,164.23880597014926
119400297.0,6,902,188048,444,30044,269482.58690744924,214.0,67.66666666666667,458,158004,261260.9146608315,1514.0,344.9868995633188
105141546.0,6,261,29766,131,8868,808781.1230769231,140.0,67.69465648854961,130,20898,812433.6124031008,284.0,160.75384615384615
329.0,17,2,166,1,75,0.0,75.0,75.0,1,91,0.0,91.0,91.0
18898.0,6,14,4740,7,653,2718.6666666666665,249.0,93.28571428571428,7,4087,3018.833333333333,1514.0,583.8571428571429
63557.0,6,14,4740,7,653,10352.5,249.0,93.28571428571428,7,4087,7650.0,1514.0,583.8571428571429
54126.0,6,14,4740,7,653,8900.166666666666,249.0,93.28571428571428,7,4087,7837.833333333333,1514.0,583.8571428571429
55961.0,6,10,2032,5,524,12081.0,252.0,104.8,5,1508,13428.5,1236.0,301.6
46635.0,6,12,1328,7,797,7772.5,253.0,113.85714285714286,5,531,9354.5,259.0,106.2
330.0,17,2,166,1,75,0.0,75.0,75.0,1,91,0.0,91.0,91.0
196956.0,17,2,180,1,90,0.0,90.0,90.0,1,90,0.0,90.0,90.0
1507.0,17,5,550,5,550,376.75,110.0,110.0,0,0,0.0,0.0,0.0
1655306.0,6,20,7599,11,1469,165530.6,583.0,133.54545454545453,9,6130,175128.875,1484.0,681.1111111111111
120176012.0,6,252,28690,126,20078,959677.544,284.0,159.34920634920636,126,8612,959677.232,140.0,68.34920634920636
321741.0,17,4,1400,4,1400,107247.0,350.0,350.0,0,0,0.0,0.0,0.0
90018746.0,17,28,13364,28,13364,3334027.6296296297,501.0,477.2857142857143,0,0,0.0,0.0,0.0
21394.0,6,14,4740,7,653,2733.333333333333,249.0,93.28571428571428,7,4087,3427.833333333333,1514.0,583.8571428571429
120274591.0,6,221,25040,111,17484,1093405.3727272728,284.0,157.51351351351352,110,7556,1094153.3486238532,140.0,68.69090909090909
90525228.0,6,13,2036,8,1016,12932175.42857143,188.0,127.0,5,1020,22589973.5,204.0,204.0
47243153.0,6,9,1479,9,1479,5905394.125,172.0,164.33333333333334,0,0,0.0,0.0,0.0
103529.0,17,2,286,2,286,0.0,143.0,143.0,0,0,0.0,0.0,0.0
286516.0,6,10,1221,6,636,57303.2,298.0,106.0,4,585,88431.66666666667,379.0,146.25
763.0,17,4,438,2,148,0.0,74.0,74.0,2,290,0.0,147.0,145.0
51116.0,6,14,4740,7,653,8373.5,249.0,93.28571428571428,7,4087,8087.666666666667,1514.0,583.8571428571429
207384.0,17,2,180,1,90,0.0,90.0,90.0,1,90,0.0,90.0,90.0
1688868.0,6,22,6443,12,1529,153533.45454545456,357.0,127.41666666666669,10,4914,153888.88888888888,1510.0,491.4
146084.0,6,3,337,2,214,0.0,160.0,107.0,1,123,0.0,123.0,123.0
90214110.0,6,16,1192,8,596,12853445.142857144,95.0,74.5,8,596,12858489.42857143,95.0,74.5
36531645.0,6,24,7256,13,3681,191668.75,1514.0,283.15384615384613,11,3575,3632406.7,1514.0,325.0
3172.0,17,2,224,1,76,0.0,76.0,76.0,1,148,0.0,148.0,148.0
345.0,17,2,250,1,93,0.0,93.0,93.0,1,157,0.0,157.0,157.0
20313.0,6,20,7606,11,978,2031.3,310.0,88.9090909090909,9,6628,2011.375,1514.0,736.4444444444445
2344.0,17,4,344,2,150,0.0,75.0,75.0,2,194,0.0,103.0,97.0
207094.0,6,3,426,2,280,0.0,214.0,140.0,1,146,0.0,146.0,146.0
2303.0,17,4,344,2,150,0.0,75.0,75.0,2,194,0.0,103.0,97.0
492748.0,6,5,336,2,134,0.0,68.0,67.0,3,202,191734.0,70.0,67.33333333333333
306860.0,6,6,412,4,272,102286.66666666669,74.0,68.0,2,140,0.0,74.0,70.0
53780.0,6,14,4740,7,653,8787.166666666666,249.0,93.28571428571428,7,4087,7788.666666666667,1514.0,583.8571428571429
106367749.0,6,44,2904,22,1452,5065130.904761905,66.0,66.0,22,1452,5050393.238095238,66.0,66.0
169149.0,17,2,414,1,88,0.0,88.0,88.0,1,326,0.0,326.0,326.0
6871774.0,6,26,7692,14,2590,528598.0,1034.0,185.0,12,5102,597625.9090909091,1510.0,425.1666666666667
94495.0,6,14,4740,7,653,15624.5,249.0,93.28571428571428,7,4087,15053.0,1514.0,583.8571428571429
284430.0,17,2,363,1,79,0.0,79.0,79.0,1,284,0.0,284.0,284.0
217564.0,6,3,426,2,280,0.0,214.0,140.0,1,146,0.0,146.0,146.0
9822.0,17,2,571,1,86,0.0,86.0,86.0,1,485,0.0,485.0,485.0
102830.0,17,2,286,2,286,0.0,143.0,143.0,0,0,0.0,0.0,0.0
25937.0,6,14,4740,7,653,4212.666666666667,249.0,93.28571428571428,7,4087,3693.1666666666665,1514.0,583.8571428571429
108099644.0,17,5,955,5,955,27024911.0,191.0,191.0,0,0,0.0,0.0,0.0
44417.0,6,14,4740,7,653,6617.333333333333,249.0,93.28571428571428,7,4087,7249.5,1514.0,583.8571428571429
104382.0,17,2,286,2,286,0.0,143.0,143.0,0,0,0.0,0.0,0.0
282606.0,17,2,363,1,79,0.0,79.0,79.0,1,284,0.0,284.0,284.0
46892.0,6,14,4740,7,653,6973.666666666667,249.0,93.28571428571428,7,4087,7671.166666666667,1514.0,583.8571428571429
53035.0,6,14,4740,7,653,8504.0,249.0,93.28571428571428,7,4087,8615.5,1514.0,583.8571428571429
2323.0,17,4,344,2,150,0.0,75.0,75.0,2,194,0.0,103.0,97.0
113493444.0,6,30,1990,15,1042,8091243.857142857,139.0,69.46666666666667,15,948,8091244.571428572,123.0,63.2
822.0,17,4,438,2,148,0.0,74.0,74.0,2,290,0.0,147.0,145.0
122352.0,6,3,373,2,238,0.0,172.0,119.0,1,135,0.0,135.0,135.0
84802.0,6,14,4740,7,653,13775.0,249.0,93.28571428571428,7,4087,13995.333333333334,1514.0,583.8571428571429
90092432.0,17,28,13364,28,13364,3336756.7407407407,501.0,477.2857142857143,0,0,0.0,0.0,0.0
302773.0,6,6,412,4,272,100924.33333333331,74.0,68.0,2,140,0.0,74.0,70.0
47895.0,6,14,4740,7,653,6518.333333333333,249.0,93.28571428571428,7,4087,7715.833333333333,1514.0,583.8571428571429
302198.0,6,6,412,4,272,100732.66666666669,74.0,68.0,2,140,0.0,74.0,70.0
305467.0,6,6,412,4,272,101822.33333333331,74.0,68.0,2,140,0.0,74.0,70.0
233260.0,6,3,373,2,238,0.0,172.0,119.0,1,135,0.0,135.0,135.0
120004868.0,6,36,3646,19,1898,6666621.166666667,426.0,99.89473684210526,17,1748,7452801.4375,357.0,102.82352941176472
29620.0,6,14,4740,7,653,3615.1666666666665,249.0,93.28571428571428,7,4087,4693.166666666667,1514.0,583.8571428571429
111082.0,17,2,286,2,286,0.0,143.0,143.0,0,0,0.0,0.0,0.0
90669323.0,6,27,2232,12,894,8220394.727272727,95.0,74.5,15,1338,6461703.571428572,254.0,89.2
135145691.0,17,6,1206,6,1206,27029138.2,201.0,201.0,0,0,0.0,0.0,0.0
339.0,17,2,267,1,83,0.0,83.0,83.0,1,184,0.0,184.0,184.0
108107438.0,17,5,955,5,955,27026859.5,191.0,191.0,0,0,0.0,0.0,0.0
232873.0,6,3,337,2,214,0.0,160.0,107.0,1,123,0.0,123.0,123.0
105923.0,17,2,286,2,286,0.0,143.0,143.0,0,0,0.0,0.0,0.0
121455.0,6,3,337,2,214,0.0,160.0,107.0,1,123,0.0,123.0,123.0
312833.0,17,4,1400,4,1400,104277.66666666669,350.0,350.0,0,0,0.0,0.0,0.0
46612.0,6,14,4740,7,653,6448.666666666667,249.0,93.28571428571428,7,4087,7456.5,1514.0,583.8571428571429
100286376.0,6,174,19650,87,13686,1163619.1046511629,284.0,157.31034482758622,87,5964,1163618.8023255814,140.0,68.55172413793103
316119.0,17,4,704,2,148,0.0,74.0,74.0,2,556,0.0,280.0,278.0
41136.0,6,14,4740,7,653,6732.166666666667,249.0,93.28571428571428,7,4087,6224.5,1514.0,583.8571428571429
15024656.0,17,6,2718,6,2718,3004931.2,453.0,453.0,0,0,0.0,0.0,0.0
3916.0,17,4,344,2,150,0.0,75.0,75.0,2,194,0.0,103.0,97.0
110075634.0,17,14,864,7,432,18333510.83333333,174.0,61.71428571428572,7,432,18334548.5,174.0,61.71428571428572
100336656.0,17,12,778,6,389,20001340.8,174.0,64.83333333333333,6,389,20000166.6,174.0,64.83333333333333
116572528.0,6,230,25978,115,18092,1020678.052631579,284.0,157.3217391304348,115,7886,1020677.5789473684,140.0,68.57391304347826
143822.0,17,2,180,1,90,0.0,90.0,90.0,1,90,0.0,90.0,90.0
90051310.0,17,28,13364,28,13364,3335233.703703704,501.0,477.2857142857143,0,0,0.0,0.0,0.0
90029262.0,17,27,12943,27,12943,3462663.923076923,501.0,479.3703703703704,0,0,0.0,0.0,0.0
135130763.0,17,6,1146,6,1146,27026152.6,191.0,191.0,0,0,0.0,0.0,0.0
34166.0,6,14,4740,7,653,5493.166666666667,249.0,93.28571428571428,7,4087,5562.333333333333,1514.0,583.8571428571429
215037.0,6,10,1221,6,636,43007.4,298.0,106.0,4,585,70399.66666666667,379.0,146.25
27709429.0,17,5,1710,5,1710,6927357.25,342.0,342.0,0,0,0.0,0.0,0.0
22375.0,6,11,2098,6,590,4321.6,252.0,98.33333333333331,5,1508,3864.25,1236.0,301.6
91562458.0,17,16,5472,16,5472,6104163.866666666,342.0,342.0,0,0,0.0,0.0,0.0
0.0,17,1,381,1,381,0.0,381.0,381.0,0,0,0.0,0.0,0.0
120067295.0,17,28,13364,28,13364,4446936.851851852,501.0,477.2857142857143,0,0,0.0,0.0,0.0
2185481.0,6,26,7675,15,2648,156105.7857142857,1034.0,176.53333333333333,11,5027,188182.5,1510.0,457.0
90009721.0,17,28,13364,28,13364,3333693.3703703703,501.0,477.2857142857143,0,0,0.0,0.0,0.0
135137666.0,17,6,1206,6,1206,27027533.2,201.0,201.0,0,0,0.0,0.0,0.0
105280.0,17,2,286,2,286,0.0,143.0,143.0,0,0,0.0,0.0,0.0
103474.0,17,2,762,2,762,0.0,381.0,381.0,0,0,0.0,0.0,0.0
90254802.0,6,12,1832,8,1016,12893543.142857144,188.0,127.0,4,816,30029817.33333333,204.0,204.0
31284.0,6,10,2032,5,524,7115.5,252.0,104.8,5,1508,7407.0,1236.0,301.6
233155.0,6,3,337,2,214,0.0,160.0,107.0,1,123,0.0,123.0,123.0
314312.0,6,3,202,2,128,0.0,74.0,64.0,1,74,0.0,74.0,74.0
124012094.0,17,15,907,8,475,17716013.42857143,174.0,59.375,7,432,17333510.166666668,174.0,61.71428571428572
100001095.0,17,13,1083,7,563,16666849.166666666,174.0,80.42857142857143,6,520,16001305.8,174.0,86.66666666666667
214805.0,6,10,1221,6,636,42961.0,298.0,106.0,4,585,70551.33333333333,379.0,146.25
49111.0,6,14,4740,7,653,7177.833333333333,249.0,93.28571428571428,7,4087,7740.166666666667,1514.0,583.8571428571429
20883.0,6,14,4740,7,653,3234.1666666666665,249.0,93.28571428571428,7,4087,3284.5,1514.0,583.8571428571429
116764264.0,6,45,3630,24,1944,5076707.130434782,123.0,81.0,21,1686,5827410.2,123.0,80.28571428571429
99044476.0,6,267,33126,134,9066,744695.3082706766,140.0,67.65671641791045,133,24060,742455.9090909091,336.0,180.9022556390977
41598.0,6,10,2032,5,524,8778.5,252.0,104.8,5,1508,9998.0,1236.0,301.6
16171.999999999998,6,14,4740,7,653,2199.6666666666665,249.0,93.28571428571428,7,4087,2561.6666666666665,1514.0,583.8571428571429
209670.0,17,2,180,1,90,0.0,90.0,90.0,1,90,0.0,90.0,90.0
1584993.0,6,20,7599,11,1469,158499.3,583.0,133.54545454545453,9,6130,166633.375,1484.0,681.1111111111111
305434.0,6,6,412,4,272,101811.33333333331,74.0,68.0,2,140,0.0,74.0,70.0
46789.0,6,14,4740,7,653,7262.666666666667,249.0,93.28571428571428,7,4087,7511.0,1514.0,583.8571428571429
34380518.0,6,27,7681,15,3789,170979.7857142857,1514.0,252.6,12,3892,3105834.1818181816,1514.0,324.3333333333333
29272.0,6,10,2032,5,524,5788.75,252.0,104.8,5,1508,6910.25,1236.0,301.6
108104665.0,17,5,955,5,955,27026166.25,191.0,191.0,0,0,0.0,0.0,0.0
133881.0,6,2,132,1,66,0.0,66.0,66.0,1,66,0.0,66.0,66.0
90582595.0,6,27,1954,14,1045,6951273.461538462,139.0,74.64285714285714,13,909,7530544.75,123.0,69.92307692307692
167923.0,17,4,571,2,148,0.0,74.0,74.0,2,423,0.0,276.0,211.5
9677.0,17,2,571,1,86,0.0,86.0,86.0,1,485,0.0,485.0,485.0
3463.0,17,4,344,2,150,0.0,75.0,75.0,2,194,0.0,103.0,97.0
123730012.0,6,49,3234,25,1650,5155417.166666667,66.0,66.0,24,1584,5041227.782608695,66.0,66.0
3484.0,17,4,344,2,150,0.0,75.0,75.0,2,194,0.0,103.0,97.0
300434.0,6,6,412,4,272,100144.66666666669,74.0,68.0,2,140,0.0,74.0,70.0
14617.0,6,10,2032,5,524,3332.25,252.0,104.8,5,1508,3427.75,1236.0,301.6
48344.0,6,14,4740,7,653,7709.333333333333,249.0,93.28571428571428,7,4087,7629.0,1514.0,583.8571428571429
10680.0,6,10,2032,5,524,2466.25,252.0,104.8,5,1508,2034.5,1236.0,301.6
29959.0,6,14,4740,7,653,4873.833333333333,249.0,93.28571428571428,7,4087,4852.5,1514.0,583.8571428571429
29470.0,6,10,2032,5,524,5590.0,252.0,104.8,5,1508,6970.5,1236.0,301.6
116332813.0,6,48,3168,24,1584,5057948.391304348,66.0,66.0,24,1584,5044278.478260869,66.0,66.0
121755.0,6,4,439,2,238,0.0,172.0,119.0,2,201,0.0,135.0,100.5
1022517.0,6,11,1134,6,558,204503.4,220.0,93.0,5,576,254794.5,304.0,115.2
90578347.0,6,27,1954,14,1045,6950970.0,139.0,74.64285714285714,13,909,7530220.583333333,123.0,69.92307692307692
14742.0,6,13,1459,7,862,2457.0,271.0,123.14285714285714,6,597,2380.6,259.0,99.5
119370174.0,6,19,1395,10,745,13258725.0,95.0,74.5,9,650,14919937.0,95.0,72.22222222222223
5623715.0,6,5,336,2,134,0.0,68.0,67.0,3,202,1525236.0,70.0,67.33333333333333
207006.0,6,3,426,2,280,0.0,214.0,140.0,1,146,0.0,146.0,146.0
237350.0,6,3,373,2,238,0.0,172.0,119.0,1,135,0.0,135.0,135.0
96189.0,6,2,132,1,66,0.0,66.0,66.0,1,66,0.0,66.0,66.0
308216.0,6,6,412,4,272,102738.66666666669,74.0,68.0,2,140,0.0,74.0,70.0
2271.0,17,4,344,2,150,0.0,75.0,75.0,2,194,0.0,103.0,97.0
90213825.0,6,16,1192,8,596,12851815.857142856,95.0,74.5,8,596,12856924.285714284,95.0,74.5
236833.0,17,2,180,1,90,0.0,90.0,90.0,1,90,0.0,90.0,90.0
90003893.0,17,28,13364,28,13364,3333477.5185185187,501.0,477.2857142857143,0,0,0.0,0.0,0.0
47811310.0,6,8,1940,3,887,22816221.5,753.0,295.6666666666667,5,1053,11259597.0,785.0,210.6
10680.0,6,10,1067,5,536,2350.75,264.0,107.2,5,531,2463.5,259.0,106.2
5962.0,17,2,231,1,78,0.0,78.0,78.0,1,153,0.0,153.0,153.0
90758394.0,6,22,1680,12,935,8245788.181818182,95.0,77.91666666666667,10,745,10052942.333333334,95.0,74.5
134286.0,6,2,132,1,66,0.0,66.0,66.0,1,66,0.0,66.0,66.0
246229.0,6,3,337,2,214,0.0,160.0,107.0,1,123,0.0,123.0,123.0
53991.0,6,10,2032,5,524,13012.0,252.0,104.8,5,1508,12969.75,1236.0,301.6
18807.0,6,10,2032,5,524,4424.75,252.0,104.8,5,1508,3347.5,1236.0,301.6
62070.0,6,14,4740,7,653,9663.666666666666,249.0,93.28571428571428,7,4087,10053.0,1514.0,583.8571428571429
90531739.0,6,13,2036,8,1016,12933105.57142857,188.0,127.0,5,1020,22592190.5,204.0,204.0
422705.0,6,4,508,2,238,0.0,172.0,119.0,2,270,0.0,135.0,135.0
207877.0,6,3,426,2,280,0.0,214.0,140.0,1,146,0.0,146.0,146.0
233114.0,6,3,337,2,214,0.0,160.0,107.0,1,123,0.0,123.0,123.0
97408783.0,6,25,1686,13,840,8117361.5,123.0,64.61538461538461,12,846,7947694.272727272,123.0,70.5
62487.0,6,14,4740,7,653,9911.333333333334,249.0,93.28571428571428,7,4087,10222.666666666666,1514.0,583.8571428571429
206166.0,6,3,426,2,280,0.0,214.0,140.0,1,146,0.0,146.0,146.0
74186.0,6,14,4740,7,653,11660.833333333334,249.0,93.28571428571428,7,4087,11851.833333333334,1514.0,583.8571428571429
120207208.0,6,220,24756,110,7482,1095228.1926605504,140.0,68.01818181818182,110,17274,1095210.266055046,284.0,157.03636363636363
51033.0,17,2,180,1,90,0.0,90.0,90.0,1,90,0.0,90.0,90.0
38801.0,6,14,4740,7,653,6299.166666666667,249.0,93.28571428571428,7,4087,4446.333333333333,1514.0,583.8571428571429
135136399.0,17,6,1146,6,1146,27027279.8,191.0,191.0,0,0,0.0,0.0,0.0
34449.0,6,14,4740,7,653,4711.5,249.0,93.28571428571428,7,4087,4594.5,1514.0,583.8571428571429
37333.0,6,10,2032,5,524,9002.75,252.0,104.8,5,1508,9049.25,1236.0,301.6
308580.0,6,6,412,4,272,102860.0,74.0,68.0,2,140,0.0,74.0,70.0
90946790.0,6,21,1585,11,840,9093686.6,95.0,76.36363636363636,10,745,10104169.666666666,95.0,74.5
32668.000000000004,6,14,4740,7,653,5294.166666666667,249.0,93.28571428571428,7,4087,5269.833333333333,1514.0,583.8571428571429
120050587.0,17,29,13785,29,13785,4287520.964285715,501.0,475.3448275862069,0,0,0.0,0.0,0.0
205743.0,17,2,180,1,90,0.0,90.0,90.0,1,90,0.0,90.0,90.0
108097382.0,6,203,23058,102,16170,1070271.108910891,284.0,158.52941176470588,101,6888,1070704.41,140.0,68.1980198019802
90032482.0,17,28,13364,28,13364,3334536.3703703703,501.0,477.2857142857143,0,0,0.0,0.0,0.0
108102777.0,17,5,955,5,955,27025694.25,191.0,191.0,0,0,0.0,0.0,0.0
959172.0,6,12,1362,6,731,191674.4,253.0,121.83333333333331,6,631,191081.6,293.0,105.16666666666669
207328.0,17,2,180,1,90,0.0,90.0,90.0,1,90,0.0,90.0,90.0
90947645.0,6,21,1585,11,840,9094475.3,95.0,76.36363636363636,10,745,10104080.444444444,95.0,74.5
242877.0,6,3,426,2,280,0.0,214.0,140.0,1,146,0.0,146.0,146.0
45102.0,6,10,2032,5,524,11051.5,252.0,104.8,5,1508,10756.75,1236.0,301.6
48000.0,6,14,4740,7,653,7821.333333333333,249.0,93.28571428571428,7,4087,7864.0,1514.0,583.8571428571429
219279.0,6,4,504,3,358,109639.5,214.0,119.33333333333331,1,146,0.0,146.0,146.0
239179.0,17,2,180,1,90,0.0,90.0,90.0,1,90,0.0,90.0,90.0
90014736.0,17,28,13364,28,13364,3333879.111111111,501.0,477.2857142857143,0,0,0.0,0.0,0.0
114096290.0,6,48,3168,24,1584,4960708.260869565,66.0,66.0,24,1584,4951309.130434782,66.0,66.0
4238.0,17,2,598,1,72,0.0,72.0,72.0,1,526,0.0,526.0,526.0
120247525.0,6,296,35480,148,9990,812364.7074829933,140.0,67.5,148,25490,805437.5918367347,284.0,172.22972972972974
232351.0,6,3,337,2,214,0.0,160.0,107.0,1,123,0.0,123.0,123.0
51422.0,6,14,4740,7,653,7551.5,249.0,93.28571428571428,7,4087,8352.833333333334,1514.0,583.8571428571429
339.0,17,2,166,1,75,0.0,75.0,75.0,1,91,0.0,91.0,91.0
149560624.0,6,27,2032,14,1043,9213854.76923077,95.0,74.5,13,989,12439981.583333334,95.0,76.07692307692308
363501.0,6,11,1021,6,444,48857.0,162.0,74.0,5,577,60987.5,349.0,115.4
25879.0,6,14,4740,7,653,3740.6666666666665,249.0,93.28571428571428,7,4087,4170.833333333333,1514.0,583.8571428571429
10481180.0,6,7,478,4,272,3446717.333333333,74.0,68.0,3,206,5169962.5,74.0,68.66666666666667
109128351.0,17,14,864,7,432,18168060.166666668,174.0,61.71428571428572,7,432,18166864.5,174.0,61.71428571428572
49410.0,6,10,2032,5,524,11326.0,252.0,104.8,5,1508,11230.25,1236.0,301.6
113168306.0,6,46,3036,23,1518,5144002.590909091,66.0,66.0,23,1518,5144002.545454546,66.0,66.0
2831838.0,6,12,2172,7,664,471744.5,252.0,94.85714285714286,5,1508,2921.5,1236.0,301.6
291506.0,17,2,180,1,90,0.0,90.0,90.0,1,90,0.0,90.0,90.0
197168.0,17,2,180,1,90,0.0,90.0,90.0,1,90,0.0,90.0,90.0
114261282.0,6,30,1990,15,1042,8146091.928571428,139.0,69.46666666666667,15,948,8146101.714285715,123.0,63.2
310638.0,17,4,1400,4,1400,103546.0,350.0,350.0,0,0,0.0,0.0,0.0
25901.0,6,11,1133,6,602,4777.0,264.0,100.33333333333331,5,531,5861.25,259.0,106.2
307110.0,6,6,412,4,272,102370.0,74.0,68.0,2,140,0.0,74.0,70.0
186676.0,17,4,6056,4,6056,62225.333333333336,1514.0,1514.0,0,0,0.0,0.0,0.0
386.0,17,2,508,2,508,0.0,257.0,254.0,0,0,0.0,0.0,0.0
23134308.0,17,3,1034,2,684,0.0,342.0,342.0,1,350,0.0,350.0,350.0
90049573.0,17,28,13364,28,13364,3335169.3703703703,501.0,477.2857142857143,0,0,0.0,0.0,0.0
125870844.0,6,34,2350,17,1125,7242836.1875,123.0,66.17647058823529,17,1225,7242838.125,139.0,72.05882352941177
2750920.0,6,3,1777,1,826,0.0,826.0,826.0,2,951,0.0,885.0,475.5
2539597.0,6,5,336,2,134,0.0,68.0,67.0,3,202,530260.5,70.0,67.33333333333333
941536.0,17,2,473,1,78,0.0,78.0,78.0,1,395,0.0,395.0,395.0
143973.0,17,2,180,1,90,0.0,90.0,90.0,1,90,0.0,90.0,90.0
22729.0,6,20,7606,11,978,2272.9,310.0,88.9090909090909,9,6628,2606.5,1514.0,736.4444444444445
298970.0,6,6,412,4,272,99656.66666666669,74.0,68.0,2,140,0.0,74.0,70.0
110173586.0,6,32,2220,16,1149,7330499.133333334,123.0,71.8125,16,1071,7330504.4,123.0,66.9375
27206994.0,17,5,1710,5,1710,6801748.5,342.0,342.0,0,0,0.0,0.0,0.0
120122989.0,6,13,2020,9,1204,15015373.625,188.0,133.77777777777777,4,816,30030396.666666668,204.0,204.0
90017265.0,17,27,12943,27,12943,3462202.5,501.0,479.3703703703704,0,0,0.0,0.0,0.0
800.0,17,4,438,2,148,0.0,74.0,74.0,2,290,0.0,147.0,145.0
47944.0,6,10,2032,5,524,11563.75,252.0,104.8,5,1508,8448.0,1236.0,301.6
114638479.0,6,48,3168,24,1584,4984281.695652174,66.0,66.0,24,1584,4974884.304347826,66.0,66.0
306705.0,6,6,412,4,272,102235.0,74.0,68.0,2,140,0.0,74.0,70.0
49474.0,6,13,1428,7,797,7317.833333333333,253.0,113.85714285714286,6,631,8774.8,293.0,105.16666666666669
94062701.0,6,30,2122,15,1105,6703351.928571428,139.0,73.66666666666667,15,1017,6703350.571428572,123.0,67.8
760.0,17,4,438,2,148,0.0,74.0,74.0,2,290,0.0,147.0,145.0
104674663.0,17,15,5130,15,5130,7476761.642857143,342.0,342.0,0,0,0.0,0.0,0.0
121421.0,6,3,337,2,214,0.0,160.0,107.0,1,123,0.0,123.0,123.0
333253.0,17,4,704,2,148,0.0,74.0,74.0,2,556,0.0,280.0,278.0
137794.0,6,2,132,1,66,0.0,66.0,66.0,1,66,0.0,66.0,66.0
90037825.0,17,28,13364,28,13364,3334734.25925926,501.0,477.2857142857143,0,0,0.0,0.0,0.0
128563.0,17,2,604,1,75,0.0,75.0,75.0,1,529,0.0,529.0,529.0
2394.0,17,4,344,2,150,0.0,75.0,75.0,2,194,0.0,103.0,97.0
7533.0,17,4,344,2,150,0.0,75.0,75.0,2,194,0.0,103.0,97.0
21845155.0,6,26,7627,14,3735,200112.84615384616,1514.0,266.7857142857143,12,3892,1966341.3636363635,1514.0,324.3333333333333
311253.0,17,4,622,4,622,103751.0,163.0,155.5,0,0,0.0,0.0,0.0
227313.0,6,3,426,2,280,0.0,214.0,140.0,1,146,0.0,146.0,146.0
10442927.0,6,6,412,3,206,5151642.5,74.0,68.66666666666667,3,206,5151510.5,74.0,68.66666666666667
90029792.0,17,28,13364,28,13364,3334436.7407407407,501.0,477.2857142857143,0,0,0.0,0.0,0.0
107122.0,17,2,286,2,286,0.0,143.0,143.0,0,0,0.0,0.0,0.0
120080114.0,17,28,13364,28,13364,4447411.62962963,501.0,477.2857142857143,0,0,0.0,0.0,0.0
31754.0,6,14,4740,7,653,4200.5,249.0,93.28571428571428,7,4087,5157.166666666667,1514.0,583.8571428571429
146097.0,6,3,337,2,214,0.0,160.0,107.0,1,123,0.0,123.0,123.0
196867.0,17,2,180,1,90,0.0,90.0,90.0,1,90,0.0,90.0,90.0
120276528.0,6,18,1382,9,691,14999997.25,95.0,76.77777777777777,9,691,15033733.125,95.0,76.77777777777777
2599843.0,6,2,132,1,66,0.0,66.0,66.0,1,66,0.0,66.0,66.0
45949.0,6,14,4740,7,653,6971.833333333333,249.0,93.28571428571428,7,4087,7269.5,1514.0,583.8571428571429
91048727.0,6,25,2805,13,1408,7587393.916666667,426.0,108.3076923076923,12,1397,8258075.454545454,335.0,116.41666666666669
209564.0,17,2,180,1,90,0.0,90.0,90.0,1,90,0.0,90.0,90.0
29181.0,6,14,4740,7,653,4367.666666666667,249.0,93.28571428571428,7,4087,4723.0,1514.0,583.8571428571429
135136546.0,17,6,1146,6,1146,27027309.2,191.0,191.0,0,0,0.0,0.0,0.0
608081.0,6,4,508,2,238,0.0,172.0,119.0,2,270,0.0,135.0,135.0
103162.0,17,2,286,2,286,0.0,143.0,143.0,0,0,0.0,0.0,0.0
39071.0,6,14,4740,7,653,6383.333333333333,249.0,93.28571428571428,7,4087,6123.833333333333,1514.0,583.8571428571429
103287960.0,6,31,2160,16,1071,6885864.0,123.0,66.9375,15,1089,7199072.5,123.0,72.6
27028327.0,17,5,1710,5,1710,6757081.75,342.0,342.0,0,0,0.0,0.0,0.0
2021846.0,17,4,525,2,150,0.0,75.0,75.0,2,375,0.0,284.0,187.5
120394882.0,6,227,25780,114,18026,1065441.4336283186,284.0,158.12280701754386,113,7754,1065655.767857143,140.0,68.61946902654867
52373.0,6,12,1320,6,723,9973.4,253.0,120.5,6,597,7647.0,259.0,99.5
858106.0,6,9,1096,6,625,171621.2,287.0,104.16666666666669,3,471,292801.0,331.0,157.0
2350.0,17,4,344,2,150,0.0,75.0,75.0,2,194,0.0,103.0,97.0
3007587.0,6,12,2172,7,664,501123.3333333333,252.0,94.85714285714286,5,1508,2543.0,1236.0,301.6
135326.0,6,2,132,1,66,0.0,66.0,66.0,1,66,0.0,66.0,66.0
90260471.0,6,13,1898,8,1016,12894353.0,188.0,127.0,5,882,22525051.5,204.0,176.4
34735.0,6,14,4740,7,653,5105.833333333333,249.0,93.28571428571428,7,4087,5531.333333333333,1514.0,583.8571428571429
155777.0,6,3,337,2,214,0.0,160.0,107.0,1,123,0.0,123.0,123.0
2977556.0,6,11,2106,6,598,595226.8,252.0,99.66666666666669,5,1508,1864.5,1236.0,301.6
90528498.0,6,14,2102,8,1016,12932642.57142857,188.0,127.0,6,1086,18073681.4,204.0,181.0
239372.0,17,2,180,1,90,0.0,90.0,90.0,1,90,0.0,90.0,90.0
1161592.0,6,13,3010,8,2382,165941.7142857143,1514.0,297.75,5,628,221386.5,331.0,125.6
41378.0,6,14,4740,7,653,6737.833333333333,249.0,93.28571428571428,7,4087,6393.833333333333,1514.0,583.8571428571429
442662.0,6,11,1021,6,444,59850.8,162.0,74.0,5,577,74610.0,349.0,115.4
2479.0,17,4,344,2,150,0.0,75.0,75.0,2,194,0.0,103.0,97.0
26242408.0,6,26,7627,14,3735,205398.92307692303,1514.0,266.7857142857143,12,3892,2366116.090909091,1514.0,324.3333333333333
18449.0,6,20,7606,11,978,1844.9,310.0,88.9090909090909,9,6628,2078.625,1514.0,736.4444444444445
13414.0,6,11,1131,6,600,2477.0,262.0,100.0,5,531,2632.5,259.0,106.2
90261814.0,6,13,2036,8,1016,12894544.857142856,188.0,127.0,5,1020,22524082.25,204.0,204.0
101405703.0,17,14,864,7,432,16834459.166666668,174.0,61.71428571428572,7,432,16833497.333333332,174.0,61.71428571428572
38228.0,6,14,4740,7,653,6255.0,249.0,93.28571428571428,7,4087,5719.333333333333,1514.0,583.8571428571429
122200.0,6,3,373,2,238,0.0,172.0,119.0,1,135,0.0,135.0,135.0
784258.0,17,2,86,1,43,0.0,43.0,43.0,1,43,0.0,43.0,43.0
46604.0,6,14,4740,7,653,7313.0,249.0,93.28571428571428,7,4087,6975.166666666667,1514.0,583.8571428571429
216468.0,17,2,180,1,90,0.0,90.0,90.0,1,90,0.0,90.0,90.0
1708379.0,6,4,276,2,128,0.0,74.0,64.0,2,148,0.0,74.0,74.0
232567.0,6,3,337,2,214,0.0,160.0,107.0,1,123,0.0,123.0,123.0
2093027.0,6,25,7611,13,2516,174418.91666666666,1034.0,193.53846153846155,12,5095,162480.0,1510.0,424.5833333333333
854.0,17,4,438,2,148,0.0,74.0,74.0,2,290,0.0,147.0,145.0
309.0,17,2,174,1,79,0.0,79.0,79.0,1,95,0.0,95.0,95.0
312828.0,17,4,1400,4,1400,104276.0,350.0,350.0,0,0,0.0,0.0,0.0
108106184.0,17,5,1005,5,1005,27026546.0,201.0,201.0,0,0,0.0,0.0,0.0
196944.0,17,2,180,1,90,0.0,90.0,90.0,1,90,0.0,90.0,90.0
120002428.0,6,20,1490,10,745,13333603.111111112,95.0,74.5,10,745,13304166.0,95.0,74.5
60210.0,6,14,4740,7,653,9911.166666666666,249.0,93.28571428571428,7,4087,9013.0,1514.0,583.8571428571429
19372.0,6,14,4740,7,653,2769.833333333333,249.0,93.28571428571428,7,4087,2820.0,1514.0,583.8571428571429
14110.0,6,10,1066,5,490,2483.25,218.0,98.0,5,576,3301.75,304.0,115.2
202717.0,17,2,762,2,762,0.0,381.0,381.0,0,0,0.0,0.0,0.0
120135457.0,6,15,2444,7,1428,20022576.166666668,204.0,204.0,8,1016,17098668.42857143,188.0,127.0
5618190.0,6,4,270,2,134,0.0,68.0,67.0,2,136,0.0,70.0,68.0
10429673.0,6,6,412,3,206,5144737.0,74.0,68.66666666666667,3,206,5144647.5,74.0,68.66666666666667
34439.0,6,2,145,2,145,0.0,91.0,72.5,0,0,0.0,0.0,0.0
120158253.0,6,220,24884,110,7556,1085444.1926605504,140.0,68.69090909090909,110,17328,1094831.8990825687,284.0,157.52727272727273
33969.0,6,10,2032,5,524,8159.75,252.0,104.8,5,1508,8234.5,1236.0,301.6
183340.0,17,4,344,2,150,0.0,75.0,75.0,2,194,0.0,103.0,97.0
319337.0,6,6,412,4,272,106445.66666666669,74.0,68.0,2,140,0.0,74.0,70.0
2332.0,17,4,344,2,150,0.0,75.0,75.0,2,194,0.0,103.0,97.0
42207.0,6,14,4740,7,653,6902.666666666667,249.0,93.28571428571428,7,4087,6572.5,1514.0,583.8571428571429
866251.0,6,9,1267,6,796,173250.2,458.0,132.66666666666666,3,471,296741.5,331.0,157.0
108104224.0,17,5,955,5,955,27026056.0,191.0,191.0,0,0,0.0,0.0,0.0
119796651.0,6,590,73492,295,19692,407364.5272108844,140.0,66.75254237288135,295,53800,407401.99659863947,336.0,182.3728813559322
1584.0,17,2,180,1,90,0.0,90.0,90.0,1,90,0.0,90.0,90.0
24589730.0,17,4,1376,3,1026,1518592.0,342.0,342.0,1,350,0.0,350.0,350.0
318471.0,17,4,1400,4,1400,106157.0,350.0,350.0,0,0,0.0,0.0,0.0
5323569.0,6,6,396,6,396,1064713.8,66.0,66.0,0,0,0.0,0.0,0.0
25605.0,6,10,2032,5,524,6165.5,252.0,104.8,5,1508,5055.75,1236.0,301.6
222051.0,17,2,180,1,90,0.0,90.0,90.0,1,90,0.0,90.0,90.0
2929.0,17,2,224,1,76,0.0,76.0,76.0,1,148,0.0,148.0,148.0
90293445.0,6,21,1585,11,840,9024311.2,95.0,76.36363636363636,10,745,10001807.444444444,95.0,74.5
16878.0,17,2,180,1,90,0.0,90.0,90.0,1,90,0.0,90.0,90.0
33559.0,6,10,2032,5,524,8103.0,252.0,104.8,5,1508,7834.75,1236.0,301.6
312646.0,6,3,202,2,128,0.0,74.0,64.0,1,74,0.0,74.0,74.0
301125.0,6,6,412,4,272,100375.0,74.0,68.0,2,140,0.0,74.0,70.0
1530582.0,6,4,276,2,128,0.0,74.0,64.0,2,148,0.0,74.0,74.0
344.0,17,2,166,1,75,0.0,75.0,75.0,1,91,0.0,91.0,91.0
135130498.0,17,6,1206,6,1206,27026099.6,201.0,201.0,0,0,0.0,0.0,0.0
2623989.0,6,25,7573,14,3735,201845.3076923077,1514.0,266.7857142857143,11,3838,237811.9,1514.0,348.90909090909093
2028.0,17,4,344,2,150,0.0,75.0,75.0,2,194,0.0,103.0,97.0
135122401.0,17,6,1146,6,1146,27024480.2,191.0,191.0,0,0,0.0,0.0,0.0
16958.0,17,2,180,1,90,0.0,90.0,90.0,1,90,0.0,90.0,90.0
115374598.0,6,229,25850,115,7898,1012057.8771929824,140.0,68.67826086956522,114,17952,1011782.814159292,284.0,157.47368421052633
3008857.0,6,12,2172,7,664,501327.3333333333,252.0,94.85714285714286,5,1508,2040.0,1236.0,301.6
1164821.0,6,13,3001,8,2373,166403.0,1514.0,296.625,5,628,223051.75,331.0,125.6
4509.0,17,4,344,2,150,0.0,75.0,75.0,2,194,0.0,103.0,97.0
28882.0,6,14,4740,7,653,4693.5,249.0,93.28571428571428,7,4087,4377.333333333333,1514.0,583.8571428571429
119537032.0,6,1048,254988,538,220354,222601.5493482309,1514.0,409.5799256505576,510,34634,234393.70530451863,214.0,67.90980392156862
135130270.0,17,6,1206,6,1206,27026054.0,201.0,201.0,0,0,0.0,0.0,0.0
219842.0,6,10,1221,6,636,43968.4,298.0,106.0,4,585,72254.66666666667,379.0,146.25
122417716.0,6,32,2226,17,1209,7651107.25,123.0,71.11764705882354,15,1017,8015338.642857143,123.0,67.8
843.0,17,4,438,2,148,0.0,74.0,74.0,2,290,0.0,147.0,145.0
126884600.0,6,32,2226,17,1209,7930287.5,123.0,71.11764705882354,15,1017,8334454.071428572,123.0,67.8
121180089.0,17,15,1038,7,432,17500165.333333332,174.0,61.71428571428572,8,606,17292129.0,174.0,75.75
107314.0,17,2,286,2,286,0.0,143.0,143.0,0,0,0.0,0.0,0.0
2043.0,17,4,344,2,150,0.0,75.0,75.0,2,194,0.0,103.0,97.0
2031.0,17,4,344,2,150,0.0,75.0,75.0,2,194,0.0,103.0,97.0
302757.0,17,2,224,1,76,0.0,76.0,76.0,1,148,0.0,148.0,148.0
105388922.0,6,173,19596,87,13686,1222945.1279069767,284.0,157.31034482758622,86,5910,1237330.988235294,140.0,68.72093023255815
0.0,6,1,66,1,66,0.0,66.0,66.0,0,0,0.0,0.0,0.0
55525.0,6,14,4740,7,653,9132.5,249.0,93.28571428571428,7,4087,6637.5,1514.0,583.8571428571429
34049.0,6,10,2032,5,524,8178.5,252.0,104.8,5,1508,7842.25,1236.0,301.6
108115677.0,17,5,955,5,955,27028919.25,191.0,191.0,0,0,0.0,0.0,0.0
135137350.0,17,6,1146,6,1146,27027470.0,191.0,191.0,0,0,0.0,0.0,0.0
10557283.0,6,7,478,4,272,3473746.6666666665,74.0,68.0,3,206,5209241.5,74.0,68.66666666666667
30640.0,6,14,4740,7,653,4985.0,249.0,93.28571428571428,7,4087,4974.166666666667,1514.0,583.8571428571429
2575996.0,6,2,132,1,66,0.0,66.0,66.0,1,66,0.0,66.0,66.0
108104878.0,17,5,955,5,955,27026219.5,191.0,191.0,0,0,0.0,0.0,0.0
75165.0,6,14,4740,7,653,12392.0,249.0,93.28571428571428,7,4087,12052.5,1514.0,583.8571428571429
39804.0,6,10,2032,5,524,9713.75,252.0,104.8,5,1508,9385.5,1236.0,301.6
120123442.0,6,13,2020,9,1204,15015430.25,188.0,133.77777777777777,4,816,30030513.33333333,204.0,204.0
41975.0,6,14,4740,7,653,6873.0,249.0,93.28571428571428,7,4087,6729.0,1514.0,583.8571428571429
127377242.0,17,17,1386,9,780,15922155.25,174.0,86.66666666666667,8,606,16714440.142857144,174.0,75.75
135131578.0,17,6,1206,6,1206,27026315.6,201.0,201.0,0,0,0.0,0.0,0.0
207020.0,6,3,426,2,280,0.0,214.0,140.0,1,146,0.0,146.0,146.0
2019.0,17,5,550,5,550,504.75,110.0,110.0,0,0,0.0,0.0,0.0
207195.0,6,3,426,2,280,0.0,214.0,140.0,1,146,0.0,146.0,146.0
107635.0,17,2,286,2,286,0.0,143.0,143.0,0,0,0.0,0.0,0.0
120419590.0,6,229,25944,115,18198,1056312.1929824562,284.0,158.24347826086955,114,7746,1057506.442477876,140.0,67.94736842105263
205722.0,17,2,180,1,90,0.0,90.0,90.0,1,90,0.0,90.0,90.0
10457886.0,6,7,478,4,272,3440884.333333333,74.0,68.0,3,206,5161209.5,74.0,68.66666666666667
32003.0,6,10,2032,5,524,6850.75,252.0,104.8,5,1508,6773.75,1236.0,301.6
108114137.0,17,5,955,5,955,27028534.25,191.0,191.0,0,0,0.0,0.0,0.0
153420.0,17,2,180,1,90,0.0,90.0,90.0,1,90,0.0,90.0,90.0
2331.0,17,4,344,2,150,0.0,75.0,75.0,2,194,0.0,103.0,97.0
119860836.0,6,14,2102,5,1020,29964236.0,204.0,204.0,9,1082,14982399.75,188.0,120.22222222222224
123449320.0,6,38,2901,18,1386,6674348.529411765,123.0,77.0,20,1515,6497201.0,123.0,75.75
14879.0,6,14,4740,7,653,2257.5,249.0,93.28571428571428,7,4087,2267.6666666666665,1514.0,583.8571428571429
13325135.0,6,19,6869,10,1501,1480570.5555555555,408.0,150.1,9,5368,1596129.75,1514.0,596.4444444444445
108119707.0,17,5,955,5,955,27029926.75,191.0,191.0,0,0,0.0,0.0,0.0
34325.0,6,13,1386,7,789,5133.833333333333,253.0,112.71428571428572,6,597,5194.2,259.0,99.5
209677.0,17,2,180,1,90,0.0,90.0,90.0,1,90,0.0,90.0,90.0
196942.0,17,2,180,1,90,0.0,90.0,90.0,1,90,0.0,90.0,90.0
740.0,17,4,438,2,148,0.0,74.0,74.0,2,290,0.0,147.0,145.0
212603.0,6,3,426,2,280,0.0,214.0,140.0,1,146,0.0,146.0,146.0
245639.0,6,3,337,2,214,0.0,160.0,107.0,1,123,0.0,123.0,123.0
208115.0,6,3,426,2,280,0.0,214.0,140.0,1,146,0.0,146.0,146.0
2617540.0,6,2,132,1,66,0.0,66.0,66.0,1,66,0.0,66.0,66.0
228273.0,17,2,180,1,90,0.0,90.0,90.0,1,90,0.0,90.0,90.0
29803.0,6,14,4740,7,653,4856.666666666667,249.0,93.28571428571428,7,4087,4830.5,1514.0,583.8571428571429
17265.0,17,2,180,1,90,0.0,90.0,90.0,1,90,0.0,90.0,90.0
29593.0,6,14,4740,7,653,4481.666666666667,249.0,93.28571428571428,7,4087,4796.333333333333,1514.0,583.8571428571429
13883.0,6,10,1065,5,534,3237.5,262.0,106.8,5,531,3253.0,259.0,106.2
35539940.0,6,5,336,2,134,0.0,68.0,67.0,3,202,17706074.0,70.0,67.33333333333333
108112665.0,17,5,955,5,955,27028166.25,191.0,191.0,0,0,0.0,0.0,0.0
156380.0,17,2,180,1,90,0.0,90.0,90.0,1,90,0.0,90.0,90.0
112233397.0,6,219,24600,110,7556,1029664.1926605504,140.0,68.69090909090909,109,17044,1029581.3055555556,284.0,156.36697247706422
205753.0,17,2,180,1,90,0.0,90.0,90.0,1,90,0.0,90.0,90.0
197073.0,17,2,180,1,90,0.0,90.0,90.0,1,90,0.0,90.0,90.0
32516.000000000004,6,13,1386,7,789,5311.333333333333,253.0,112.71428571428572,6,597,6113.8,259.0,99.5
90912660.0,6,20,1490,10,745,10101406.666666666,95.0,74.5,10,745,10073597.555555556,95.0,74.5
197108.0,17,2,180,1,90,0.0,90.0,90.0,1,90,0.0,90.0,90.0
90090364.0,6,11,1644,4,816,30029336.666666668,204.0,204.0,7,828,15014677.5,188.0,118.28571428571428
280737.0,17,4,1400,4,1400,93579.0,350.0,350.0,0,0,0.0,0.0,0.0
23748.0,6,10,2032,5,524,4643.5,252.0,104.8,5,1508,5647.25,1236.0,301.6
45686.0,6,14,4740,7,653,7488.166666666667,249.0,93.28571428571428,7,4087,7474.5,1514.0,583.8571428571429
15023.0,6,11,1132,6,556,2762.0,218.0,92.66666666666669,5,576,3411.0,304.0,115.2
300329.0,6,6,412,4,272,100109.66666666669,74.0,68.0,2,140,0.0,74.0,70.0
106974.0,17,2,286,2,286,0.0,143.0,143.0,0,0,0.0,0.0,0.0
2430.0,17,4,344,2,150,0.0,75.0,75.0,2,194,0.0,103.0,97.0
120194087.0,6,19,1436,9,691,14998451.875,95.0,76.77777777777777,10,745,13331972.888888888,95.0,74.5
120181089.0,6,230,26084,115,7886,1046999.0087719298,140.0,68.57391304347826,115,18198,1046761.8333333334,284.0,158.24347826086955
2376.0,17,4,344,2,150,0.0,75.0,75.0,2,194,0.0,103.0,97.0
169954.0,17,2,180,1,90,0.0,90.0,90.0,1,90,0.0,90.0,90.0
14686.0,17,2,180,1,90,0.0,90.0,90.0,1,90,0.0,90.0,90.0
115278907.0,6,48,3168,24,1584,5012126.391304348,66.0,66.0,24,1584,4998696.478260869,66.0,66.0
179825.0,17,2,180,1,90,0.0,90.0,90.0,1,90,0.0,90.0,90.0
120017448.0,17,28,13364,28,13364,4445090.666666667,501.0,477.2857142857143,0,0,0.0,0.0,0.0
94054206.0,6,206,23986,103,16966,919989.6274509804,300.0,164.71844660194174,103,7020,919990.0392156864,140.0,68.15533980582525
113225177.0,6,31,2166,16,1149,7534708.8,123.0,71.8125,15,1017,8072898.714285715,123.0,67.8
109628.0,17,2,286,2,286,0.0,143.0,143.0,0,0,0.0,0.0,0.0
146911.0,6,3,373,2,238,0.0,172.0,119.0,1,135,0.0,135.0,135.0
54452.0,6,14,4740,7,653,8874.166666666666,249.0,93.28571428571428,7,4087,7484.833333333333,1514.0,583.8571428571429
2394.0,17,4,344,2,150,0.0,75.0,75.0,2,194,0.0,103.0,97.0
90015001.0,17,27,12943,27,12943,3462115.423076923,501.0,479.3703703703704,0,0,0.0,0.0,0.0
21952.0,6,14,4740,7,653,3538.333333333333,249.0,93.28571428571428,7,4087,3431.0,1514.0,583.8571428571429
36936.0,6,14,4740,7,653,5870.0,249.0,93.28571428571428,7,4087,5579.5,1514.0,583.8571428571429
3403641.0,6,7,923,4,753,1062547.3333333333,571.0,188.25,3,170,1593669.5,62.0,56.66666666666666
5822182.0,6,5,336,2,134,0.0,68.0,67.0,3,202,1474516.5,70.0,67.33333333333333
90305248.0,6,19,1436,10,745,10029046.555555556,95.0,74.5,9,691,11287103.5,95.0,76.77777777777777
319408.0,17,4,1400,4,1400,106469.33333333331,350.0,350.0,0,0,0.0,0.0,0.0
38916.0,6,14,4740,7,653,5355.833333333333,249.0,93.28571428571428,7,4087,6345.333333333333,1514.0,583.8571428571429
57313.0,6,14,4740,7,653,9376.833333333334,249.0,93.28571428571428,7,4087,9357.666666666666,1514.0,583.8571428571429
1306988.0,6,4,264,2,132,0.0,66.0,66.0,2,132,0.0,66.0,66.0
1301295.0,6,4,264,2,132,0.0,66.0,66.0,2,132,0.0,66.0,66.0
217974.0,6,3,426,2,280,0.0,214.0,140.0,1,146,0.0,146.0,146.0
108117236.0,17,5,955,5,955,27029309.0,191.0,191.0,0,0,0.0,0.0,0.0
120004968.0,6,19,1677,10,1027,13333885.333333334,340.0,102.7,9,650,14969399.375,95.0,72.22222222222223
11178.0,6,10,2032,5,524,2565.25,252.0,104.8,5,1508,2204.25,1236.0,301.6
146123.0,6,3,337,2,214,0.0,160.0,107.0,1,123,0.0,123.0,123.0
2342.0,17,4,344,2,150,0.0,75.0,75.0,2,194,0.0,103.0,97.0
29312.0,6,14,4740,7,653,4731.166666666667,249.0,93.28571428571428,7,4087,3996.3333333333335,1514.0,583.8571428571429
196861.0,17,2,180,1,90,0.0,90.0,90.0,1,90,0.0,90.0,90.0
103355.0,17,2,286,2,286,0.0,143.0,143.0,0,0,0.0,0.0,0.0
321212.0,6,7,478,4,272,107070.66666666669,74.0,68.0,3,206,84610.5,74.0,68.66666666666667
90742857.0,6,29,3108,15,1561,6478732.285714285,427.0,104.06666666666666,14,1547,6979192.538461538,337.0,110.5
1051224.0,6,13,1386,7,789,175204.0,253.0,112.71428571428572,6,597,209068.4,259.0,99.5
90256374.0,6,16,2368,9,1204,11282046.75,188.0,133.77777777777777,7,1164,15015454.5,204.0,166.28571428571428
220040.0,6,13,1386,7,789,36673.333333333336,253.0,112.71428571428572,6,597,42825.6,259.0,99.5
14849656.0,6,20,1607,10,975,1591368.5555555555,315.0,97.5,10,632,1597983.888888889,78.0,63.2
144844.0,17,2,180,1,70,0.0,70.0,70.0,1,110,0.0,110.0,110.0
511259.0,6,5,336,2,134,0.0,68.0,67.0,3,202,196146.5,70.0,67.33333333333333
49169.0,6,14,4740,7,653,8074.5,249.0,93.28571428571428,7,4087,6286.0,1514.0,583.8571428571429
30796.0,6,14,4740,7,653,3965.8333333333335,249.0,93.28571428571428,7,4087,4331.333333333333,1514.0,583.8571428571429
97222760.0,17,14,1126,7,563,16166808.833333334,174.0,80.42857142857143,7,563,16167745.5,174.0,80.42857142857143
1301576.0,6,4,264,2,132,0.0,66.0,66.0,2,132,0.0,66.0,66.0
28421.0,6,10,2032,5,524,5628.5,252.0,104.8,5,1508,6236.0,1236.0,301.6
213750.0,17,2,180,1,90,0.0,90.0,90.0,1,90,0.0,90.0,90.0
304104.0,6,6,412,4,272,101368.0,74.0,68.0,2,140,0.0,74.0,70.0
107895.0,17,2,286,2,286,0.0,143.0,143.0,0,0,0.0,0.0,0.0
303642.0,6,2,132,1,66,0.0,66.0,66.0,1,66,0.0,66.0,66.0
90294598.0,6,16,1192,8,596,12892224.285714284,95.0,74.5,8,596,12898814.285714284,95.0,74.5
121348.0,6,3,337,2,214,0.0,160.0,107.0,1,123,0.0,123.0,123.0
102042.0,17,2,762,2,762,0.0,381.0,381.0,0,0,0.0,0.0,0.0
90056590.0,17,27,12943,27,12943,3463715.0,501.0,479.3703703703704,0,0,0.0,0.0,0.0
1914663.0,6,4,276,2,128,0.0,74.0,64.0,2,148,0.0,74.0,74.0
92391292.0,6,27,2073,15,1138,6598802.571428572,95.0,75.86666666666666,12,935,8398051.363636363,95.0,77.91666666666667
2347.0,17,4,344,2,150,0.0,75.0,75.0,2,194,0.0,103.0,97.0
20275.0,6,14,4740,7,653,3117.1666666666665,249.0,93.28571428571428,7,4087,3242.5,1514.0,583.8571428571429
146262.0,6,3,337,2,214,0.0,160.0,107.0,1,123,0.0,123.0,123.0
28634.0,6,10,2032,5,524,6429.75,252.0,104.8,5,1508,6918.5,1236.0,301.6
5005530.0,17,4,629,2,156,0.0,78.0,78.0,2,473,0.0,268.0,236.5
1315633.0,6,4,264,2,132,0.0,66.0,66.0,2,132,0.0,66.0,66.0
24634.0,6,14,4740,7,653,3019.1666666666665,249.0,93.28571428571428,7,4087,3966.5,1514.0,583.8571428571429
35151.0,6,13,4416,6,409,6891.4,127.0,68.16666666666667,7,4007,5698.5,1514.0,572.4285714285714
97915585.0,6,40,2640,20,1320,5153451.842105263,66.0,66.0,20,1320,5136908.263157895,66.0,66.0
108105022.0,17,5,1005,5,1005,27026255.5,201.0,201.0,0,0,0.0,0.0,0.0
2775312.0,6,2,132,1,66,0.0,66.0,66.0,1,66,0.0,66.0,66.0
135138949.0,17,6,1146,6,1146,27027789.8,191.0,191.0,0,0,0.0,0.0,0.0
561.0,17,2,508,2,508,0.0,257.0,254.0,0,0,0.0,0.0,0.0
135122128.0,17,6,1206,6,1206,27024425.6,201.0,201.0,0,0,0.0,0.0,0.0
218127.0,6,3,426,2,280,0.0,214.0,140.0,1,146,0.0,146.0,146.0
147922.0,17,2,180,1,90,0.0,90.0,90.0,1,90,0.0,90.0,90.0
146176.0,6,3,337,2,214,0.0,160.0,107.0,1,123,0.0,123.0,123.0
153439.0,17,2,180,1,90,0.0,90.0,90.0,1,90,0.0,90.0,90.0
48886.0,6,14,4740,7,653,6101.833333333333,249.0,93.28571428571428,7,4087,7720.833333333333,1514.0,583.8571428571429
298156.0,6,6,412,4,272,99385.33333333331,74.0,68.0,2,140,0.0,74.0,70.0
1212301.0,17,7,490,7,490,202050.16666666663,70.0,70.0,0,0,0.0,0.0,0.0
2023.0,17,4,344,2,150,0.0,75.0,75.0,2,194,0.0,103.0,97.0
659845.0,6,4,492,2,280,0.0,214.0,140.0,2,212,0.0,146.0,106.0
108111575.0,17,5,955,5,955,27027893.75,191.0,191.0,0,0,0.0,0.0,0.0
2352.0,17,4,344,2,150,0.0,75.0,75.0,2,194,0.0,103.0,97.0
588151.0,6,3,198,2,132,0.0,66.0,66.0,1,66,0.0,66.0,66.0
298202.0,6,6,412,4,272,99400.66666666669,74.0,68.0,2,140,0.0,74.0,70.0
249776.0,6,6,386,4,247,83258.66666666667,85.0,61.75,2,139,0.0,85.0,69.5
312028.0,17,4,622,4,622,104009.33333333331,163.0,155.5,0,0,0.0,0.0,0.0
814.0,17,4,438,2,148,0.0,74.0,74.0,2,290,0.0,147.0,145.0
90338640.0,6,16,2140,8,1080,12905520.0,204.0,135.0,8,1060,12877064.285714284,199.0,132.5
926602.0,6,10,1334,6,797,185320.4,459.0,132.83333333333334,4,537,216942.3333333333,331.0,134.25
118901146.0,6,34,2334,17,1209,7418543.5625,123.0,71.11764705882354,17,1125,7418548.625,123.0,66.17647058823529
50218.0,6,14,4740,7,653,7967.5,249.0,93.28571428571428,7,4087,8235.5,1514.0,583.8571428571429
21257.0,6,20,7606,11,978,2125.7,310.0,88.9090909090909,9,6628,2364.125,1514.0,736.4444444444445
90255282.0,6,12,1832,8,1016,12893611.714285716,188.0,127.0,4,816,30030849.666666668,204.0,204.0
2366414.0,6,2,132,1,66,0.0,66.0,66.0,1,66,0.0,66.0,66.0
2047.0,17,4,344,2,150,0.0,75.0,75.0,2,194,0.0,103.0,97.0
47334.0,6,12,1320,6,723,8935.0,253.0,120.5,6,597,8358.8,259.0,99.5
108103752.0,17,5,1005,5,1005,27025938.0,201.0,201.0,0,0,0.0,0.0,0.0
102529.0,17,2,286,2,286,0.0,143.0,143.0,0,0,0.0,0.0,0.0
115170713.0,6,48,3168,24,1584,5007422.304347826,66.0,66.0,24,1584,4998024.260869565,66.0,66.0
761.0,17,4,438,2,148,0.0,74.0,74.0,2,290,0.0,147.0,145.0
2015.0,17,4,344,2,150,0.0,75.0,75.0,2,194,0.0,103.0,97.0
135009762.0,17,17,1255,9,649,16876220.25,174.0,72.11111111111111,8,606,16428714.0,174.0,75.75
3511.0,17,4,344,2,150,0.0,75.0,75.0,2,194,0.0,103.0,97.0
10420262.0,6,6,412,3,206,5141434.5,74.0,68.66666666666667,3,206,5141347.5,74.0,68.66666666666667
208293.0,17,2,762,2,762,0.0,381.0,381.0,0,0,0.0,0.0,0.0
90260245.0,6,13,2036,8,1016,12894320.714285716,188.0,127.0,5,1020,22523963.0,204.0,204.0
1573456.0,6,5,367,2,132,0.0,66.0,66.0,3,235,786728.0,103.0,78.33333333333333
108084085.0,17,5,1005,5,1005,27021021.25,201.0,201.0,0,0,0.0,0.0,0.0
11242181.0,17,4,1368,4,1368,3747393.6666666665,342.0,342.0,0,0,0.0,0.0,0.0
318816.0,6,6,412,4,272,106272.0,74.0,68.0,2,140,0.0,74.0,70.0
317023.0,17,4,1400,4,1400,105674.33333333331,350.0,350.0,0,0,0.0,0.0,0.0
357797.0,6,6,412,4,272,119265.66666666669,74.0,68.0,2,140,0.0,74.0,70.0
35322.0,6,10,2032,5,524,7810.5,252.0,104.8,5,1508,8568.0,1236.0,301.6
1302534.0,6,4,264,2,132,0.0,66.0,66.0,2,132,0.0,66.0,66.0
300.0,17,2,164,1,82,0.0,82.0,82.0,1,82,0.0,82.0,82.0
320.0,17,2,174,1,79,0.0,79.0,79.0,1,95,0.0,95.0,95.0
299697.0,6,6,412,4,272,99899.0,74.0,68.0,2,140,0.0,74.0,70.0
1071418.0,6,11,1134,6,558,214283.6,220.0,93.0,5,576,266515.25,304.0,115.2
196908.0,17,2,180,1,90,0.0,90.0,90.0,1,90,0.0,90.0,90.0
319058.0,17,2,620,1,75,0.0,75.0,75.0,1,545,0.0,545.0,545.0
207298.0,17,2,762,2,762,0.0,381.0,381.0,0,0,0.0,0.0,0.0
90003297.0,17,28,13364,28,13364,3333455.4444444445,501.0,477.2857142857143,0,0,0.0,0.0,0.0
108102185.0,17,5,1005,5,1005,27025546.25,201.0,201.0,0,0,0.0,0.0,0.0
90517669.0,6,27,1938,14,1029,6946284.615384615,123.0,73.5,13,909,7525152.833333333,123.0,69.92307692307692
34834.0,6,10,2032,5,524,7738.25,252.0,104.8,5,1508,5880.5,1236.0,301.6
38729.0,6,10,2032,5,524,8908.75,252.0,104.8,5,1508,9315.75,1236.0,301.6
10476452.0,6,8,602,5,404,1714604.75,103.0,80.8,3,198,1958846.0,66.0,66.0
153369.0,17,2,180,1,90,0.0,90.0,90.0,1,90,0.0,90.0,90.0
81020.0,6,14,4740,7,653,12903.166666666666,249.0,93.28571428571428,7,4087,13241.666666666666,1514.0,583.8571428571429
298556.0,6,6,412,4,272,99518.66666666669,74.0,68.0,2,140,0.0,74.0,70.0
371.0,17,2,267,1,83,0.0,83.0,83.0,1,184,0.0,184.0,184.0
321378.0,17,4,1400,4,1400,107126.0,350.0,350.0,0,0,0.0,0.0,0.0
10427348.0,6,6,412,3,206,5146061.0,74.0,68.66666666666667,3,206,5145949.5,74.0,68.66666666666667
207981.0,6,10,1221,6,636,41596.2,298.0,106.0,4,585,68075.66666666667,379.0,146.25
108111120.0,17,5,955,5,955,27027780.0,191.0,191.0,0,0,0.0,0.0,0.0
14301471.0,17,6,2052,6,2052,2860294.2,342.0,342.0,0,0,0.0,0.0,0.0
90096809.0,6,12,1848,5,1020,22523612.25,204.0,204.0,7,828,14970812.166666666,188.0,118.28571428571428
298194.0,6,6,412,4,272,99398.0,74.0,68.0,2,140,0.0,74.0,70.0
93831655.0,6,27,1948,14,963,7217819.615384615,123.0,68.78571428571429,13,985,7160540.583333333,139.0,75.76923076923077
79809.0,6,14,4740,7,653,13150.5,249.0,93.28571428571428,7,4087,11045.666666666666,1514.0,583.8571428571429
1314530.0,6,4,264,2,132,0.0,66.0,66.0,2,132,0.0,66.0,66.0
33705908.0,6,5,336,2,134,0.0,68.0,67.0,3,202,15542414.0,70.0,67.33333333333333
90007962.0,17,11,735,6,389,18001592.4,174.0,64.83333333333333,5,346,19759565.5,174.0,69.2
319690.0,17,4,1400,4,1400,106563.33333333331,350.0,350.0,0,0,0.0,0.0,0.0
90068477.0,17,28,13364,28,13364,3335869.5185185187,501.0,477.2857142857143,0,0,0.0,0.0,0.0
47426.0,6,14,4740,7,653,7383.166666666667,249.0,93.28571428571428,7,4087,7346.333333333333,1514.0,583.8571428571429
15657.0,6,10,2032,5,524,3699.75,252.0,104.8,5,1508,3537.75,1236.0,301.6
31681.0,6,14,4740,7,653,5144.0,249.0,93.28571428571428,7,4087,5105.166666666667,1514.0,583.8571428571429
107714.0,17,2,286,2,286,0.0,143.0,143.0,0,0,0.0,0.0,0.0
48545.0,6,10,2032,5,524,11898.75,252.0,104.8,5,1508,8921.75,1236.0,301.6
3474.0,17,2,359,1,75,0.0,75.0,75.0,1,284,0.0,284.0,284.0
1471930.0,17,16,1120,16,1120,98128.66666666669,70.0,70.0,0,0,0.0,0.0,0.0
156300.0,6,3,337,2,214,0.0,160.0,107.0,1,123,0.0,123.0,123.0
2375.0,17,4,344,2,150,0.0,75.0,75.0,2,194,0.0,103.0,97.0
119877.0,17,2,180,1,70,0.0,70.0,70.0,1,110,0.0,110.0,110.0
206233.0,17,2,180,1,90,0.0,90.0,90.0,1,90,0.0,90.0,90.0
90064568.0,17,28,13364,28,13364,3335724.7407407407,501.0,477.2857142857143,0,0,0.0,0.0,0.0
318.0,17,2,174,1,79,0.0,79.0,79.0,1,95,0.0,95.0,95.0
32386.0,6,10,2032,5,524,7002.5,252.0,104.8,5,1508,7676.25,1236.0,301.6
283713.0,17,2,363,1,79,0.0,79.0,79.0,1,284,0.0,284.0,284.0
2400.0,17,4,344,2,150,0.0,75.0,75.0,2,194,0.0,103.0,97.0
24241.0,6,10,2032,5,524,5796.25,252.0,104.8,5,1508,4947.75,1236.0,301.6
90037072.0,17,27,12943,27,12943,3462964.3076923075,501.0,479.3703703703704,0,0,0.0,0.0,0.0
5629622.0,6,5,336,2,134,0.0,68.0,67.0,3,202,1529799.0,70.0,67.33333333333333
513534.00000000006,6,5,336,2,134,0.0,68.0,67.0,3,202,192776.0,70.0,67.33333333333333
79.0,17,2,762,2,762,0.0,381.0,381.0,0,0,0.0,0.0,0.0
2315.0,17,4,344,2,150,0.0,75.0,75.0,2,194,0.0,103.0,97.0
151.0,17,2,700,2,700,0.0,350.0,350.0,0,0,0.0,0.0,0.0
2454.0,17,4,344,2,150,0.0,75.0,75.0,2,194,0.0,103.0,97.0
222343.0,6,10,1221,6,636,44468.6,298.0,106.0,4,585,72870.0,379.0,146.25
108108961.0,17,5,955,5,955,27027240.25,191.0,191.0,0,0,0.0,0.0,0.0
1306998.0,6,4,264,2,132,0.0,66.0,66.0,2,132,0.0,66.0,66.0
5833780.0,6,5,336,2,134,0.0,68.0,67.0,3,202,1524982.5,70.0,67.33333333333333
13158.0,6,13,1459,7,862,2114.1666666666665,271.0,123.14285714285714,6,597,2237.0,259.0,99.5
17557.0,17,2,582,1,83,0.0,83.0,83.0,1,499,0.0,499.0,499.0
829314.0,6,9,1118,6,586,165862.8,248.0,97.66666666666669,3,532,278391.5,392.0,177.33333333333334
99122381.0,17,12,778,6,389,19800176.2,174.0,64.83333333333333,6,389,19800939.6,174.0,64.83333333333333
115716865.0,6,48,3168,24,1584,5031168.043478261,66.0,66.0,24,1584,5019191.695652174,66.0,66.0
3008589.0,6,11,2106,6,598,601543.2,252.0,99.66666666666669,5,1508,1883.75,1236.0,301.6
155843.0,6,3,337,2,214,0.0,160.0,107.0,1,123,0.0,123.0,123.0
90256669.0,6,12,1832,8,1016,12893809.857142856,188.0,127.0,4,816,30030478.666666668,204.0,204.0
1499289.0,6,20,6434,12,1921,136299.0,620.0,160.08333333333334,8,4513,175967.2857142857,1514.0,564.125
90266866.0,6,13,2036,8,1016,12895266.57142857,188.0,127.0,5,1020,22525744.5,204.0,204.0
5631427.0,6,5,336,2,134,0.0,68.0,67.0,3,202,1527545.0,70.0,67.33333333333333
294.0,17,2,156,1,78,0.0,78.0,78.0,1,78,0.0,78.0,78.0
320.0,17,2,168,1,76,0.0,76.0,76.0,1,92,0.0,92.0,92.0
36618.0,6,14,4740,7,653,5980.5,249.0,93.28571428571428,7,4087,5607.833333333333,1514.0,583.8571428571429
90906929.0,6,26,2019,15,1179,6493352.071428572,95.0,78.6,11,840,9044238.7,95.0,76.36363636363636
31522.0,6,10,2032,5,524,7256.75,252.0,104.8,5,1508,7075.0,1236.0,301.6
102686.0,17,2,762,2,762,0.0,381.0,381.0,0,0,0.0,0.0,0.0
2914.0,17,2,762,2,762,0.0,381.0,381.0,0,0,0.0,0.0,0.0
169830.0,17,2,180,1,90,0.0,90.0,90.0,1,90,0.0,90.0,90.0
116427710.0,6,48,3168,24,1584,5062074.347826087,66.0,66.0,24,1584,5050095.782608695,66.0,66.0
2582951.0,6,2,132,1,66,0.0,66.0,66.0,1,66,0.0,66.0,66.0
104774320.0,17,15,5130,15,5130,7483880.0,342.0,342.0,0,0,0.0,0.0,0.0
108136652.0,17,5,955,5,955,27034163.0,191.0,191.0,0,0,0.0,0.0,0.0
304720.0,6,6,412,4,272,101573.33333333331,74.0,68.0,2,140,0.0,74.0,70.0
300424.0,6,6,412,4,272,100141.33333333331,74.0,68.0,2,140,0.0,74.0,70.0
863536.0,6,9,1270,6,799,172707.2,461.0,133.16666666666666,3,471,293976.0,331.0,157.0
1315511.0,6,4,264,2,132,0.0,66.0,66.0,2,132,0.0,66.0,66.0
105091312.0,17,14,864,7,432,17500164.333333332,174.0,61.71428571428572,7,432,17501068.333333332,174.0,61.71428571428572
2346.0,17,4,344,2,150,0.0,75.0,75.0,2,194,0.0,103.0,97.0
21381.0,6,14,4740,7,653,3372.5,249.0,93.28571428571428,7,4087,3342.1666666666665,1514.0,583.8571428571429
103723.0,17,2,700,2,700,0.0,350.0,350.0,0,0,0.0,0.0,0.0
106753.0,17,2,762,2,762,0.0,381.0,381.0,0,0,0.0,0.0,0.0
128126733.0,17,14,995,7,432,19166868.83333333,174.0,61.71428571428572,7,563,18993552.666666668,174.0,80.42857142857143
15663.0,6,10,2032,5,524,3668.75,252.0,104.8,5,1508,3506.25,1236.0,301.6
2423.0,17,4,344,2,150,0.0,75.0,75.0,2,194,0.0,103.0,97.0
44023.0,6,13,1479,7,882,7131.0,291.0,126.0,6,597,5685.0,259.0,99.5
108109023.0,17,5,1005,5,1005,27027255.75,201.0,201.0,0,0,0.0,0.0,0.0
36575801.0,6,5,336,2,134,0.0,68.0,67.0,3,202,18219707.5,70.0,67.33333333333333
120349993.0,6,212,23852,106,7292,1138386.1047619048,140.0,68.79245283018868,106,16560,1137133.5047619047,284.0,156.2264150943396
108104887.0,17,5,1005,5,1005,27026221.75,201.0,201.0,0,0,0.0,0.0,0.0
215460.0,17,2,180,1,90,0.0,90.0,90.0,1,90,0.0,90.0,90.0
10865208.0,6,7,478,3,206,5364342.0,74.0,68.66666666666667,4,272,3576158.333333333,74.0,68.0
135143360.0,17,6,1206,6,1206,27028672.0,201.0,201.0,0,0,0.0,0.0,0.0
82798.0,6,10,2032,5,524,18328.25,252.0,104.8,5,1508,20462.75,1236.0,301.6
505898.0,6,4,270,2,134,0.0,68.0,67.0,2,136,0.0,70.0,68.0
156102.0,6,2,132,1,66,0.0,66.0,66.0,1,66,0.0,66.0,66.0
3004429.0,6,12,2172,7,664,500689.0,252.0,94.85714285714286,5,1508,1941.25,1236.0,301.6
104852263.0,17,14,4788,14,4788,8065558.692307692,342.0,342.0,0,0,0.0,0.0,0.0
308047.0,6,6,412,4,272,102682.33333333331,74.0,68.0,2,140,0.0,74.0,70.0
108109388.0,17,5,955,5,955,27027347.0,191.0,191.0,0,0,0.0,0.0,0.0
26284.0,6,14,4740,7,653,4236.333333333333,249.0,93.28571428571428,7,4087,4068.8333333333335,1514.0,583.8571428571429
99411449.0,6,26,1746,13,906,8266285.25,123.0,69.6923076923077,13,840,8266279.916666667,123.0,64.61538461538461
143896.0,17,2,180,1,90,0.0,90.0,90.0,1,90,0.0,90.0,90.0
203775.0,17,4,6056,4,6056,67925.0,1514.0,1514.0,0,0,0.0,0.0,0.0
114302636.0,17,14,864,7,432,19000205.33333333,174.0,61.71428571428572,7,432,19001238.166666668,174.0,61.71428571428572
120175.0,17,2,180,1,70,0.0,70.0,70.0,1,110,0.0,110.0,110.0
311347.0,6,6,412,4,272,103782.33333333331,74.0,68.0,2,140,0.0,74.0,70.0
145076.0,17,2,180,1,70,0.0,70.0,70.0,1,110,0.0,110.0,110.0
219607.0,6,3,426,2,280,0.0,214.0,140.0,1,146,0.0,146.0,146.0
31094.0,6,14,4740,7,653,3371.333333333333,249.0,93.28571428571428,7,4087,4850.666666666667,1514.0,583.8571428571429
102653.0,17,2,286,2,286,0.0,143.0,143.0,0,0,0.0,0.0,0.0
243912.0,6,3,337,2,214,0.0,160.0,107.0,1,123,0.0,123.0,123.0
190907.0,17,2,180,1,90,0.0,90.0,90.0,1,90,0.0,90.0,90.0
90057731.0,17,28,13364,28,13364,3335471.5185185187,501.0,477.2857142857143,0,0,0.0,0.0,0.0
52189.0,6,14,4740,7,653,7565.0,249.0,93.28571428571428,7,4087,6580.0,1514.0,583.8571428571429
99759269.0,6,683,96942,342,22794,292549.1759530792,140.0,66.64912280701755,341,74148,292748.7970588235,480.0,217.44281524926689
105634.0,17,2,700,2,700,0.0,350.0,350.0,0,0,0.0,0.0,0.0
109813.0,17,4,1400,4,1400,36604.333333333336,350.0,350.0,0,0,0.0,0.0,0.0
302013.0,6,6,412,4,272,100671.0,74.0,68.0,2,140,0.0,74.0,70.0
90761178.0,6,19,1436,10,745,10079835.555555556,95.0,74.5,9,691,11344699.75,95.0,76.77777777777777
5827000.0,6,4,270,2,134,0.0,68.0,67.0,2,136,0.0,70.0,68.0
228308.0,17,2,180,1,90,0.0,90.0,90.0,1,90,0.0,90.0,90.0
135135724.0,17,6,1206,6,1206,27027144.8,201.0,201.0,0,0,0.0,0.0,0.0
321.0,17,2,164,1,82,0.0,82.0,82.0,1,82,0.0,82.0,82.0
10769426.0,17,4,1368,4,1368,3589808.6666666665,342.0,342.0,0,0,0.0,0.0,0.0
153439.0,17,2,180,1,90,0.0,90.0,90.0,1,90,0.0,90.0,90.0
404507.0,6,4,508,2,238,0.0,172.0,119.0,2,270,0.0,135.0,135.0
118938885.0,6,38,2710,19,1408,6595733.833333333,139.0,74.10526315789474,19,1302,6595730.444444444,123.0,68.52631578947368
25242.0,6,14,4740,7,653,2647.6666666666665,249.0,93.28571428571428,7,4087,3918.1666666666665,1514.0,583.8571428571429
13692.0,6,14,4740,7,653,2134.833333333333,249.0,93.28571428571428,7,4087,2143.5,1514.0,583.8571428571429
146257.0,6,3,337,2,214,0.0,160.0,107.0,1,123,0.0,123.0,123.0
100772004.0,6,33,2428,17,1288,6284761.75,139.0,75.76470588235294,16,1140,6703754.733333333,123.0,71.25
10580791.0,6,7,478,4,272,3481512.6666666665,74.0,68.0,3,206,5222172.5,74.0,68.66666666666667
29720.0,6,14,4740,7,653,4672.0,249.0,93.28571428571428,7,4087,4736.0,1514.0,583.8571428571429
53131.0,6,14,4740,7,653,7912.666666666667,249.0,93.28571428571428,7,4087,8046.666666666667,1514.0,583.8571428571429
328.0,17,2,166,1,75,0.0,75.0,75.0,1,91,0.0,91.0,91.0
323623.0,17,4,1400,4,1400,107874.33333333331,350.0,350.0,0,0,0.0,0.0,0.0
362.0,17,2,267,1,83,0.0,83.0,83.0,1,184,0.0,184.0,184.0
90748263.0,6,17,1287,8,637,12964037.57142857,95.0,79.625,9,650,11307501.25,95.0,72.22222222222223
214110.0,6,3,426,2,280,0.0,214.0,140.0,1,146,0.0,146.0,146.0
104725.0,17,2,286,2,286,0.0,143.0,143.0,0,0,0.0,0.0,0.0
197231.0,17,2,180,1,90,0.0,90.0,90.0,1,90,0.0,90.0,90.0
348.0,17,2,166,1,75,0.0,75.0,75.0,1,91,0.0,91.0,91.0
207885.0,6,10,1221,6,636,41577.0,298.0,106.0,4,585,68448.0,379.0,146.25
90297898.0,6,16,1192,8,596,12893154.57142857,95.0,74.5,8,596,12897883.285714284,95.0,74.5
824.0,17,4,438,2,148,0.0,74.0,74.0,2,290,0.0,147.0,145.0
107100.0,17,2,286,2,286,0.0,143.0,143.0,0,0,0.0,0.0,0.0
226048.0,6,13,1386,7,789,37674.66666666666,253.0,112.71428571428572,6,597,32953.0,259.0,99.5
117606538.0,6,48,3168,24,1584,5113327.739130435,66.0,66.0,24,1584,5100116.695652174,66.0,66.0
312.0,17,2,174,1,79,0.0,79.0,79.0,1,95,0.0,95.0,95.0
236453.0,6,3,337,2,214,0.0,160.0,107.0,1,123,0.0,123.0,123.0
267.0,17,3,1050,3,1050,133.5,350.0,350.0,0,0,0.0,0.0,0.0
228281.0,17,2,180,1,90,0.0,90.0,90.0,1,90,0.0,90.0,90.0
81.0,17,2,762,2,762,0.0,381.0,381.0,0,0,0.0,0.0,0.0
170094.0,17,2,602,1,72,0.0,72.0,72.0,1,530,0.0,530.0,530.0
43803.0,6,14,4740,7,653,6822.5,249.0,93.28571428571428,7,4087,5340.5,1514.0,583.8571428571429
343.0,17,2,250,1,93,0.0,93.0,93.0,1,157,0.0,157.0,157.0
133481.0,6,2,132,1,66,0.0,66.0,66.0,1,66,0.0,66.0,66.0
5621464.0,6,4,270,2,134,0.0,68.0,67.0,2,136,0.0,70.0,68.0
4457.0,17,2,614,1,72,0.0,72.0,72.0,1,542,0.0,542.0,542.0
191337.0,17,2,180,1,90,0.0,90.0,90.0,1,90,0.0,90.0,90.0
216129.0,6,3,426,2,280,0.0,214.0,140.0,1,146,0.0,146.0,146.0
135130924.0,17,6,1206,6,1206,27026184.8,201.0,201.0,0,0,0.0,0.0,0.0
233091.0,6,3,337,2,214,0.0,160.0,107.0,1,123,0.0,123.0,123.0
32069.0,6,14,4740,7,653,5225.666666666667,249.0,93.28571428571428,7,4087,5206.833333333333,1514.0,583.8571428571429
90675262.0,6,21,1585,10,745,10075029.111111112,95.0,74.5,11,840,9042636.4,95.0,76.36363636363636
502318.00000000006,6,5,336,2,134,0.0,68.0,67.0,3,202,198091.0,70.0,67.33333333333333
42311.0,6,10,2032,5,524,9773.75,252.0,104.8,5,1508,9597.5,1236.0,301.6
44227.0,6,14,4740,7,653,7204.833333333333,249.0,93.28571428571428,7,4087,6848.5,1514.0,583.8571428571429
0.0,6,1,66,1,66,0.0,66.0,66.0,0,0,0.0,0.0,0.0
125036384.0,6,32,2173,16,1071,7670130.266666667,123.0,66.9375,16,1102,8335592.533333333,139.0,68.875
860257.0,6,9,1196,6,725,172051.4,387.0,120.83333333333331,3,471,292435.0,331.0,157.0
97295042.0,6,33,2428,17,1288,6067459.125,139.0,75.76470588235294,16,1140,6471942.666666667,123.0,71.25
216670.0,6,3,426,2,280,0.0,214.0,140.0,1,146,0.0,146.0,146.0
29560.0,6,10,2032,5,524,4779.5,252.0,104.8,5,1508,6479.5,1236.0,301.6
889.0,17,5,550,5,550,222.25,110.0,110.0,0,0,0.0,0.0,0.0
197182.0,17,2,180,1,90,0.0,90.0,90.0,1,90,0.0,90.0,90.0
124237.0,6,3,373,2,238,0.0,172.0,119.0,1,135,0.0,135.0,135.0
120121356.0,6,14,2224,9,1204,15015169.5,188.0,133.77777777777777,5,1020,22523193.25,204.0,204.0
9390.0,17,2,582,1,83,0.0,83.0,83.0,1,499,0.0,499.0,499.0
312739.0,17,4,1400,4,1400,104246.33333333331,350.0,350.0,0,0,0.0,0.0,0.0
153574.0,17,2,180,1,90,0.0,90.0,90.0,1,90,0.0,90.0,90.0
65487.0,6,14,4740,7,653,9889.0,249.0,93.28571428571428,7,4087,9738.166666666666,1514.0,583.8571428571429
2415.0,17,4,344,2,150,0.0,75.0,75.0,2,194,0.0,103.0,97.0
108097461.0,17,5,955,5,955,27024365.25,191.0,191.0,0,0,0.0,0.0,0.0
104995.0,6,12,1413,6,816,20474.0,291.0,136.0,6,597,19105.6,259.0,99.5
108101365.0,17,5,1005,5,1005,27025341.25,201.0,201.0,0,0,0.0,0.0,0.0
120024257.0,17,29,13785,29,13785,4286580.607142857,501.0,475.3448275862069,0,0,0.0,0.0,0.0
235298.0,6,3,337,2,214,0.0,160.0,107.0,1,123,0.0,123.0,123.0
40115.0,6,14,4740,7,653,6427.5,249.0,93.28571428571428,7,4087,5821.666666666667,1514.0,583.8571428571429
95172563.0,17,12,778,6,389,18800808.6,174.0,64.83333333333333,6,389,19000205.6,174.0,64.83333333333333
117906399.0,6,36,2596,18,1348,6922961.411764706,139.0,74.88888888888889,18,1248,6922961.294117647,123.0,69.33333333333333
15008.0,17,2,180,1,90,0.0,90.0,90.0,1,90,0.0,90.0,90.0
2801466.0,6,2,132,1,66,0.0,66.0,66.0,1,66,0.0,66.0,66.0
6269232.0,6,121,115957,37,2611,174145.33333333334,215.0,70.56756756756756,84,113346,75411.43373493975,1514.0,1349.357142857143
62186.0,6,14,4740,7,653,10082.0,249.0,93.28571428571428,7,4087,10086.666666666666,1514.0,583.8571428571429
302839.0,6,6,412,4,272,100946.33333333331,74.0,68.0,2,140,0.0,74.0,70.0
514736.0,6,10,1221,6,636,102947.2,298.0,106.0,4,585,170601.0,379.0,146.25
120161932.0,6,250,28844,125,8546,962422.9758064516,140.0,68.368,125,20298,962410.4354838708,374.0,162.384
237883.0,6,3,373,2,238,0.0,172.0,119.0,1,135,0.0,135.0,135.0
10535535.0,6,6,412,3,206,5199941.0,74.0,68.66666666666667,3,206,5199862.5,74.0,68.66666666666667
4347.0,17,2,602,1,72,0.0,72.0,72.0,1,530,0.0,530.0,530.0
2146.0,17,4,344,2,150,0.0,75.0,75.0,2,194,0.0,103.0,97.0
20299.0,17,2,582,1,83,0.0,83.0,83.0,1,499,0.0,499.0,499.0
200832.0,17,4,6056,4,6056,66944.0,1514.0,1514.0,0,0,0.0,0.0,0.0
2594330.0,6,2,132,1,66,0.0,66.0,66.0,1,66,0.0,66.0,66.0
0.0,6,1,66,1,66,0.0,66.0,66.0,0,0,0.0,0.0,0.0
74415.0,6,14,4740,7,653,11941.333333333334,249.0,93.28571428571428,7,4087,11166.666666666666,1514.0,583.8571428571429
101490.0,17,2,762,2,762,0.0,381.0,381.0,0,0,0.0,0.0,0.0
90043261.0,17,27,12943,27,12943,3463202.346153846,501.0,479.3703703703704,0,0,0.0,0.0,0.0
272733.0,6,3,337,2,214,0.0,160.0,107.0,1,123,0.0,123.0,123.0
0.0,6,1,66,1,66,0.0,66.0,66.0,0,0,0.0,0.0,0.0
61939.0,6,14,4740,7,653,10201.5,249.0,93.28571428571428,7,4087,9331.5,1514.0,583.8571428571429
23907.0,6,10,2032,5,524,5658.75,252.0,104.8,5,1508,5706.75,1236.0,301.6
10486326.0,6,7,478,4,272,3449839.0,74.0,68.0,3,206,5165471.5,74.0,68.66666666666667
99924880.0,17,12,778,6,389,19984976.0,174.0,64.83333333333333,6,389,19943635.8,174.0,64.83333333333333
47334.0,6,14,4740,7,653,7546.833333333333,249.0,93.28571428571428,7,4087,7744.0,1514.0,583.8571428571429
135127763.0,17,6,1146,6,1146,27025552.6,191.0,191.0,0,0,0.0,0.0,0.0
1162017.0,6,13,3010,8,2382,166002.42857142858,1514.0,297.75,5,628,221604.5,331.0,125.6
205853.0,17,2,180,1,90,0.0,90.0,90.0,1,90,0.0,90.0,90.0
304599.0,6,6,412,4,272,101533.0,74.0,68.0,2,140,0.0,74.0,70.0
3561.0,17,2,363,1,79,0.0,79.0,79.0,1,284,0.0,284.0,284.0
104329.0,17,2,762,2,762,0.0,381.0,381.0,0,0,0.0,0.0,0.0
312763.0,6,6,412,4,272,104254.33333333331,74.0,68.0,2,140,0.0,74.0,70.0
90049923.0,17,26,12406,26,12406,3601996.92,501.0,477.1538461538461,0,0,0.0,0.0,0.0
135130423.0,17,6,1206,6,1206,27026084.6,201.0,201.0,0,0,0.0,0.0,0.0
20247.0,6,11,2098,6,590,3818.2,252.0,98.33333333333331,5,1508,4251.25,1236.0,301.6
42023.0,6,14,4740,7,653,6879.0,249.0,93.28571428571428,7,4087,6375.166666666667,1514.0,583.8571428571429
106956.0,17,2,286,2,286,0.0,143.0,143.0,0,0,0.0,0.0,0.0
310229.0,6,6,412,4,272,103409.66666666669,74.0,68.0,2,140,0.0,74.0,70.0
0.0,6,1,66,1,66,0.0,66.0,66.0,0,0,0.0,0.0,0.0
192008.0,17,2,762,2,762,0.0,381.0,381.0,0,0,0.0,0.0,0.0
300190.0,6,6,412,4,272,100063.33333333331,74.0,68.0,2,140,0.0,74.0,70.0
108104753.0,17,5,955,5,955,27026188.25,191.0,191.0,0,0,0.0,0.0,0.0
336509.0,17,4,571,2,148,0.0,74.0,74.0,2,423,0.0,276.0,211.5
852435.0,6,9,1267,6,796,170487.0,458.0,132.66666666666666,3,471,289903.5,331.0,157.0
90219378.0,6,16,1192,8,596,12854286.142857144,95.0,74.5,8,596,12859076.0,95.0,74.5
2017.0,17,4,344,2,150,0.0,75.0,75.0,2,194,0.0,103.0,97.0
90030091.0,17,28,13364,28,13364,3334447.814814815,501.0,477.2857142857143,0,0,0.0,0.0,0.0
26837.0,6,14,4740,7,653,3444.6666666666665,249.0,93.28571428571428,7,4087,4125.333333333333,1514.0,583.8571428571429
238572.0,6,3,337,2,214,0.0,160.0,107.0,1,123,0.0,123.0,123.0
120241484.0,6,214,24218,107,7284,1127588.783018868,140.0,68.07476635514018,107,16934,1126587.1698113207,284.0,158.26168224299064
24379.0,6,14,4740,7,653,3702.6666666666665,249.0,93.28571428571428,7,4087,3833.5,1514.0,583.8571428571429
19777.0,6,14,4740,7,653,3165.333333333333,249.0,93.28571428571428,7,4087,3156.6666666666665,1514.0,583.8571428571429
10475122.0,6,7,478,4,272,3446118.333333333,74.0,68.0,3,206,5169061.0,74.0,68.66666666666667
3612.0,17,4,571,2,148,0.0,74.0,74.0,2,423,0.0,280.0,211.5
153428.0,17,2,180,1,90,0.0,90.0,90.0,1,90,0.0,90.0,90.0
48470.0,6,14,4740,7,653,6723.0,249.0,93.28571428571428,7,4087,5938.333333333333,1514.0,583.8571428571429
153533.0,17,2,180,1,90,0.0,90.0,90.0,1,90,0.0,90.0,90.0
135129658.0,17,6,1206,6,1206,27025931.6,201.0,201.0,0,0,0.0,0.0,0.0
102068.0,17,2,762,2,762,0.0,381.0,381.0,0,0,0.0,0.0,0.0
20035.0,6,14,4740,7,653,3218.0,249.0,93.28571428571428,7,4087,3200.833333333333,1514.0,583.8571428571429
93017190.0,6,38,2508,19,1254,5150439.388888889,66.0,66.0,19,1254,5150436.444444444,66.0,66.0
59668.0,6,14,4740,7,653,9823.833333333334,249.0,93.28571428571428,7,4087,8015.0,1514.0,583.8571428571429
122196492.0,6,31,2097,16,1149,8146432.8,123.0,71.8125,15,948,8164627.642857143,123.0,63.2
90006681.0,17,28,13364,28,13364,3333580.777777778,501.0,477.2857142857143,0,0,0.0,0.0,0.0
147023.0,17,4,704,2,148,0.0,74.0,74.0,2,556,0.0,280.0,278.0
113320583.0,6,48,3168,24,1584,4926981.869565218,66.0,66.0,24,1584,4917575.695652174,66.0,66.0
107767.0,17,2,286,2,286,0.0,143.0,143.0,0,0,0.0,0.0,0.0
37565.0,6,10,2032,5,524,9178.25,252.0,104.8,5,1508,9046.75,1236.0,301.6
110646080.0,6,33,2428,17,1288,6915380.0,139.0,75.76470588235294,16,1140,7361983.6,123.0,71.25
2338.0,17,4,344,2,150,0.0,75.0,75.0,2,194,0.0,103.0,97.0
106477.0,17,2,286,2,286,0.0,143.0,143.0,0,0,0.0,0.0,0.0
8624.0,6,10,2032,5,524,1923.0,252.0,104.8,5,1508,1875.5,1236.0,301.6
103455.0,17,2,700,2,700,0.0,350.0,350.0,0,0,0.0,0.0,0.0
101386450.0,6,532,64804,266,17778,381965.04905660375,140.0,66.83458646616542,266,47026,379482.8867924528,464.0,176.78947368421052
107839909.0,6,28,1860,14,966,8279638.307692308,123.0,69.0,14,894,8279621.0,123.0,63.85714285714285
309898.0,6,6,412,4,272,103299.33333333331,74.0,68.0,2,140,0.0,74.0,70.0
2831020.0,6,11,2106,6,598,565913.4,252.0,99.66666666666669,5,1508,2588.75,1236.0,301.6
225928.0,17,2,180,1,90,0.0,90.0,90.0,1,90,0.0,90.0,90.0
37360.0,6,14,4740,7,653,6047.666666666667,249.0,93.28571428571428,7,4087,5682.666666666667,1514.0,583.8571428571429
44497.0,6,13,1479,7,882,7201.5,291.0,126.0,6,597,7847.4,259.0,99.5
5826990.0,6,4,270,2,134,0.0,68.0,67.0,2,136,0.0,70.0,68.0
1951.0,17,4,344,2,150,0.0,75.0,75.0,2,194,0.0,103.0,97.0
90257599.0,6,14,2240,8,1016,12893942.714285716,188.0,127.0,6,1224,18018542.8,204.0,204.0
122630.0,6,14,4740,7,653,20313.33333333333,249.0,93.28571428571428,7,4087,19235.0,1514.0,583.8571428571429
308206.0,6,6,412,4,272,102735.33333333331,74.0,68.0,2,140,0.0,74.0,70.0
110124744.0,17,14,864,7,432,18334837.83333333,174.0,61.71428571428572,7,432,18333490.83333333,174.0,61.71428571428572
145125.0,17,2,180,1,70,0.0,70.0,70.0,1,110,0.0,110.0,110.0
32471.0,6,10,2032,5,524,7636.5,252.0,104.8,5,1508,6912.0,1236.0,301.6
22435.0,17,4,823,2,163,0.0,89.0,81.5,2,660,0.0,443.0,330.0
10518952.0,6,7,478,4,272,3460692.0,74.0,68.0,3,206,5190892.0,74.0,68.66666666666667
142087.0,6,2,132,1,66,0.0,66.0,66.0,1,66,0.0,66.0,66.0
112535525.0,6,46,3036,23,1518,5105437.7727272725,66.0,66.0,23,1518,5105435.954545454,66.0,66.0
3404.0,17,4,344,2,150,0.0,75.0,75.0,2,194,0.0,103.0,97.0
108105057.0,17,5,1005,5,1005,27026264.25,201.0,201.0,0,0,0.0,0.0,0.0
23802.0,6,10,2032,5,524,5630.0,252.0,104.8,5,1508,5651.75,1236.0,301.6
11000.0,6,10,1067,5,536,2575.25,264.0,107.2,5,531,2249.75,259.0,106.2
108109365.0,17,5,955,5,955,27027341.25,191.0,191.0,0,0,0.0,0.0,0.0
196878.0,17,2,180,1,90,0.0,90.0,90.0,1,90,0.0,90.0,90.0
5005590.0,17,4,849,2,166,0.0,83.0,83.0,2,683,0.0,499.0,341.5
253363.0,6,3,337,2,214,0.0,160.0,107.0,1,123,0.0,123.0,123.0
1301036.0,6,4,264,2,132,0.0,66.0,66.0,2,132,0.0,66.0,66.0
113640635.0,6,31,2166,16,1149,7561648.4,123.0,71.8125,15,1017,8101769.642857143,123.0,67.8
35478.0,6,14,4740,7,653,5513.666666666667,249.0,93.28571428571428,7,4087,3002.6666666666665,1514.0,583.8571428571429
298070.0,6,6,412,4,272,99356.66666666669,74.0,68.0,2,140,0.0,74.0,70.0
143921.0,17,2,180,1,90,0.0,90.0,90.0,1,90,0.0,90.0,90.0
16898.0,17,2,180,1,90,0.0,90.0,90.0,1,90,0.0,90.0,90.0
308633.0,6,6,412,4,272,102877.66666666669,74.0,68.0,2,140,0.0,74.0,70.0
301.0,17,2,164,1,82,0.0,82.0,82.0,1,82,0.0,82.0,82.0
284765.0,17,2,363,1,79,0.0,79.0,79.0,1,284,0.0,284.0,284.0
148356.0,6,3,373,2,238,0.0,172.0,119.0,1,135,0.0,135.0,135.0
2551927.0,6,5,336,2,134,0.0,68.0,67.0,3,202,1144308.0,70.0,67.33333333333333
143872.0,17,2,180,1,90,0.0,90.0,90.0,1,90,0.0,90.0,90.0
37662.0,6,10,2032,5,524,7545.0,252.0,104.8,5,1508,8781.75,1236.0,301.6
312.0,17,2,164,1,74,0.0,74.0,74.0,1,90,0.0,90.0,90.0
11775.0,6,10,1065,5,534,2477.25,262.0,106.8,5,531,2611.75,259.0,106.2
113168375.0,6,46,3036,23,1518,5144004.636363637,66.0,66.0,23,1518,5143999.454545454,66.0,66.0
890946.0,6,12,2714,7,742,148491.0,338.0,106.0,5,1972,154514.0,1514.0,394.4
1985.0,17,4,344,2,150,0.0,75.0,75.0,2,194,0.0,103.0,97.0
162324.0,17,2,180,1,90,0.0,90.0,90.0,1,90,0.0,90.0,90.0
15040.0,17,2,180,1,90,0.0,90.0,90.0,1,90,0.0,90.0,90.0
708.0,17,4,438,2,148,0.0,74.0,74.0,2,290,0.0,147.0,145.0
34857.0,6,2,145,2,145,0.0,91.0,72.5,0,0,0.0,0.0,0.0
228051.0,17,2,180,1,90,0.0,90.0,90.0,1,90,0.0,90.0,90.0
90016123.0,17,28,13364,28,13364,3333930.4814814813,501.0,477.2857142857143,0,0,0.0,0.0,0.0
106316487.0,6,184,20888,92,14594,1165933.89010989,284.0,158.6304347826087,92,6294,1165933.6923076925,140.0,68.41304347826087
320466.0,17,4,1400,4,1400,106822.0,350.0,350.0,0,0,0.0,0.0,0.0
118317118.0,17,15,1169,8,606,16879741.285714287,174.0,75.75,7,563,19177300.0,174.0,80.42857142857143
261092.0,17,4,1400,4,1400,87030.66666666667,350.0,350.0,0,0,0.0,0.0,0.0
2336.0,17,2,762,2,762,0.0,381.0,381.0,0,0,0.0,0.0,0.0
321084.0,17,4,1400,4,1400,107028.0,350.0,350.0,0,0,0.0,0.0,0.0
34233.0,6,10,2032,5,524,8335.5,252.0,104.8,5,1508,8165.75,1236.0,301.6
228383.0,17,2,180,1,90,0.0,90.0,90.0,1,90,0.0,90.0,90.0
98476994.0,6,30,2106,15,1089,7034071.0,123.0,72.6,15,1017,7018620.428571428,123.0,67.8
135126898.0,17,6,1206,6,1206,27025379.6,201.0,201.0,0,0,0.0,0.0,0.0
153443.0,17,2,180,1,90,0.0,90.0,90.0,1,90,0.0,90.0,90.0
14931.0,17,2,180,1,90,0.0,90.0,90.0,1,90,0.0,90.0,90.0
52515.0,6,14,4740,7,653,8589.0,249.0,93.28571428571428,7,4087,7085.666666666667,1514.0,583.8571428571429
10460688.0,6,7,478,4,272,3441506.0,74.0,68.0,3,206,5162121.5,74.0,68.66666666666667
2870989.0,6,4,270,2,134,0.0,68.0,67.0,2,136,0.0,70.0,68.0
12972516.0,6,21,7017,12,1641,1179319.6363636365,408.0,136.75,9,5376,1106966.375,1514.0,597.3333333333334
136957.0,6,2,132,1,66,0.0,66.0,66.0,1,66,0.0,66.0,66.0
242201.0,6,3,337,2,214,0.0,160.0,107.0,1,123,0.0,123.0,123.0
90288608.0,6,16,2372,8,1016,12898372.57142857,188.0,127.0,8,1356,12872843.57142857,204.0,169.5
43340.0,6,13,1386,7,789,6951.666666666667,253.0,112.71428571428572,6,597,7733.2,259.0,99.5
509866.00000000006,6,5,336,2,134,0.0,68.0,67.0,3,202,191800.5,70.0,67.33333333333333
206727.0,17,2,762,2,762,0.0,381.0,381.0,0,0,0.0,0.0,0.0
1584.0,17,4,438,2,148,0.0,74.0,74.0,2,290,0.0,147.0,145.0
114680.0,17,2,286,2,286,0.0,143.0,143.0,0,0,0.0,0.0,0.0
3101.0,17,4,344,2,150,0.0,75.0,75.0,2,194,0.0,103.0,97.0
10559690.0,6,7,478,4,272,3459260.6666666665,74.0,68.0,3,206,5188784.5,74.0,68.66666666666667
308739.0,6,6,412,4,272,102913.0,74.0,68.0,2,140,0.0,74.0,70.0
107285.0,17,2,286,2,286,0.0,143.0,143.0,0,0,0.0,0.0,0.0
236243.0,6,3,337,2,214,0.0,160.0,107.0,1,123,0.0,123.0,123.0
1546767.0,6,20,7599,11,1469,154676.7,583.0,133.54545454545453,9,6130,160922.875,1484.0,681.1111111111111
333085.0,6,6,412,4,272,111028.33333333331,74.0,68.0,2,140,0.0,74.0,70.0
4301.0,17,2,614,1,72,0.0,72.0,72.0,1,542,0.0,542.0,542.0
135133128.0,17,6,1206,6,1206,27026625.6,201.0,201.0,0,0,0.0,0.0,0.0
100345611.0,17,13,821,7,432,16666801.666666666,174.0,61.71428571428572,6,389,20000915.8,174.0,64.83333333333333
322548.0,17,4,1400,4,1400,107516.0,350.0,350.0,0,0,0.0,0.0,0.0
3005037.0,6,11,2106,6,598,600812.8,252.0,99.66666666666669,5,1508,1706.5,1236.0,301.6
120119856.0,6,14,2240,8,1016,17136874.285714287,188.0,127.0,6,1224,18016576.8,204.0,204.0
25203873.0,17,5,1718,4,1368,769562.0,342.0,342.0,1,350,0.0,350.0,350.0
135133888.0,17,6,1206,6,1206,27026777.6,201.0,201.0,0,0,0.0,0.0,0.0
2283081.0,6,49,23728,25,19797,95128.375,1514.0,791.88,24,3931,90063.56521739131,1514.0,163.79166666666666
1183565.0,6,13,3020,8,2392,169080.7142857143,1514.0,299.0,5,628,227010.75,331.0,125.6
90091548.0,6,14,1980,7,1152,15014864.666666666,204.0,164.57142857142858,7,828,14970023.833333334,188.0,118.28571428571428
105937583.0,6,30,2106,15,1089,7551540.285714285,123.0,72.6,15,1017,7551542.142857143,123.0,67.8
334212.0,17,4,1400,4,1400,111404.0,350.0,350.0,0,0,0.0,0.0,0.0
818.0,17,4,438,2,148,0.0,74.0,74.0,2,290,0.0,147.0,145.0
1160912.0,6,13,3005,8,2377,165844.57142857142,1514.0,297.125,5,628,222080.75,331.0,125.6
51496.0,6,10,2032,5,524,12434.25,252.0,104.8,5,1508,12104.25,1236.0,301.6
120123308.0,6,14,2224,9,1204,15015413.5,188.0,133.77777777777777,5,1020,22522788.25,204.0,204.0
3586.0,17,4,344,2,150,0.0,75.0,75.0,2,194,0.0,103.0,97.0
16833.0,6,14,4740,7,653,2689.5,249.0,93.28571428571428,7,4087,2578.1666666666665,1514.0,583.8571428571429
278299.0,6,10,1221,6,636,55659.8,298.0,106.0,4,585,86886.66666666667,379.0,146.25
359.0,17,2,267,1,83,0.0,83.0,83.0,1,184,0.0,184.0,184.0
443699.0,6,10,967,5,390,74886.5,162.0,78.0,5,577,74807.25,349.0,115.4
5627175.0,6,5,336,2,134,0.0,68.0,67.0,3,202,1424067.5,70.0,67.33333333333333
114689063.0,6,47,3102,24,1584,4974657.173913044,66.0,66.0,23,1518,5135431.045454546,66.0,66.0
108100627.0,17,5,955,5,955,27025156.75,191.0,191.0,0,0,0.0,0.0,0.0
306399.0,6,6,412,4,272,102133.0,74.0,68.0,2,140,0.0,74.0,70.0
2404.0,17,4,344,2,150,0.0,75.0,75.0,2,194,0.0,103.0,97.0
680.0,17,2,762,2,762,0.0,381.0,381.0,0,0,0.0,0.0,0.0
241570.0,6,3,337,2,214,0.0,160.0,107.0,1,123,0.0,123.0,123.0
206038.0,17,2,180,1,90,0.0,90.0,90.0,1,90,0.0,90.0,90.0
144007.0,17,2,180,1,90,0.0,90.0,90.0,1,90,0.0,90.0,90.0
146282.0,6,3,337,2,214,0.0,160.0,107.0,1,123,0.0,123.0,123.0
47368.0,6,14,4740,7,653,7364.333333333333,249.0,93.28571428571428,7,4087,6977.833333333333,1514.0,583.8571428571429
90015037.0,17,27,12943,27,12943,3462116.8076923075,501.0,479.3703703703704,0,0,0.0,0.0,0.0
2080.0,17,4,344,2,150,0.0,75.0,75.0,2,194,0.0,103.0,97.0
104644.0,17,4,1400,4,1400,34881.333333333336,350.0,350.0,0,0,0.0,0.0,0.0
27041539.0,17,5,1710,5,1710,6760384.75,342.0,342.0,0,0,0.0,0.0,0.0
44754.0,6,10,2032,5,524,10857.25,252.0,104.8,5,1508,8771.25,1236.0,301.6
120124110.0,6,16,2648,8,1632,17160587.14285714,204.0,204.0,8,1016,17137373.85714286,188.0,127.0
2444.0,17,4,344,2,150,0.0,75.0,75.0,2,194,0.0,103.0,97.0
134885.0,6,11,1132,6,556,26977.0,218.0,92.66666666666669,5,576,33102.75,304.0,115.2
18649.0,6,10,2032,5,524,4439.0,252.0,104.8,5,1508,4108.75,1236.0,301.6
6054.0,17,2,180,1,90,0.0,90.0,90.0,1,90,0.0,90.0,90.0
39253.0,6,10,2032,5,524,9585.5,252.0,104.8,5,1508,9071.75,1236.0,301.6
2781675.0,6,2,132,1,66,0.0,66.0,66.0,1,66,0.0,66.0,66.0
233075.0,6,3,337,2,214,0.0,160.0,107.0,1,123,0.0,123.0,123.0
14680.0,17,2,180,1,90,0.0,90.0,90.0,1,90,0.0,90.0,90.0
240234.0,17,2,180,1,90,0.0,90.0,90.0,1,90,0.0,90.0,90.0
98742.0,17,2,762,2,762,0.0,381.0,381.0,0,0,0.0,0.0,0.0
108106403.0,17,5,1005,5,1005,27026600.75,201.0,201.0,0,0,0.0,0.0,0.0
14790.0,6,10,1065,5,534,3301.5,262.0,106.8,5,531,3353.25,259.0,106.2
60427.0,6,14,4740,7,653,9715.5,249.0,93.28571428571428,7,4087,9675.333333333334,1514.0,583.8571428571429
128006627.0,6,32,2226,17,1209,8000414.1875,123.0,71.11764705882354,15,1017,8415373.357142856,123.0,67.8
32758.000000000004,6,14,4740,7,653,5304.833333333333,249.0,93.28571428571428,7,4087,4534.333333333333,1514.0,583.8571428571429
108333100.0,6,28,1860,14,966,8316711.0,123.0,69.0,14,894,8316714.538461538,123.0,63.85714285714285
90280549.0,6,16,1192,8,596,12891268.57142857,95.0,74.5,8,596,12895404.57142857,95.0,74.5
120083306.0,6,228,25862,114,7820,1055317.7168141592,140.0,68.59649122807018,114,18042,1061302.0353982302,300.0,158.26315789473685
118431952.0,6,33,2290,17,1125,7401997.0,123.0,66.17647058823529,16,1165,7215391.333333333,139.0,72.8125
90255972.0,6,13,2036,8,1016,12893710.285714284,188.0,127.0,5,1020,22522666.5,204.0,204.0
11405.0,6,10,2032,5,524,2623.5,252.0,104.8,5,1508,2589.75,1236.0,301.6
102923001.0,6,18,1463,9,650,12865375.125,95.0,72.22222222222223,9,813,12833817.75,217.0,90.33333333333331
3050265.0,6,3,204,2,136,0.0,70.0,68.0,1,68,0.0,68.0,68.0
324571.0,17,2,180,1,90,0.0,90.0,90.0,1,90,0.0,90.0,90.0
10456638.0,6,7,478,4,272,3439988.333333333,74.0,68.0,3,206,5159858.0,74.0,68.66666666666667
120007756.0,6,26,1978,14,1084,9230768.76923077,95.0,77.42857142857143,12,894,10884497.636363637,95.0,74.5
45208.0,6,13,1386,7,789,7323.833333333333,253.0,112.71428571428572,6,597,8314.8,259.0,99.5
2026.0,17,4,344,2,150,0.0,75.0,75.0,2,194,0.0,103.0,97.0
5172.0,17,2,614,1,72,0.0,72.0,72.0,1,542,0.0,542.0,542.0
19282.0,6,14,4740,7,653,3016.0,249.0,93.28571428571428,7,4087,2400.6666666666665,1514.0,583.8571428571429
121334.0,6,3,337,2,214,0.0,160.0,107.0,1,123,0.0,123.0,123.0
1279177.0,17,7,490,7,490,213196.16666666663,70.0,70.0,0,0,0.0,0.0,0.0
300.0,17,2,164,1,82,0.0,82.0,82.0,1,82,0.0,82.0,82.0
31027.0,6,10,2032,5,524,6379.0,252.0,104.8,5,1508,7356.25,1236.0,301.6
2398.0,17,4,344,2,150,0.0,75.0,75.0,2,194,0.0,103.0,97.0
107530.0,17,2,700,2,700,0.0,350.0,350.0,0,0,0.0,0.0,0.0
108101820.0,17,5,1005,5,1005,27025455.0,201.0,201.0,0,0,0.0,0.0,0.0
5014595.0,17,4,849,2,166,0.0,83.0,83.0,2,683,0.0,499.0,341.5
119853144.0,17,35,16705,35,16705,3525092.470588235,501.0,477.2857142857143,0,0,0.0,0.0,0.0
108105430.0,17,5,955,5,955,27026357.5,191.0,191.0,0,0,0.0,0.0,0.0
217164.0,6,3,426,2,280,0.0,214.0,140.0,1,146,0.0,146.0,146.0
21198.0,6,14,4740,7,653,3313.5,249.0,93.28571428571428,7,4087,3394.1666666666665,1514.0,583.8571428571429
25725.0,6,14,4740,7,653,4070.6666666666665,249.0,93.28571428571428,7,4087,4114.166666666667,1514.0,583.8571428571429
108106447.0,17,5,955,5,955,27026611.75,191.0,191.0,0,0,0.0,0.0,0.0
228284.0,17,2,180,1,90,0.0,90.0,90.0,1,90,0.0,90.0,90.0
414.0,17,2,410,1,78,0.0,78.0,78.0,1,332,0.0,332.0,332.0
365708.0,17,2,180,1,90,0.0,90.0,90.0,1,90,0.0,90.0,90.0
218146.0,6,3,426,2,280,0.0,214.0,140.0,1,146,0.0,146.0,146.0
108103282.0,17,5,955,5,955,27025820.5,191.0,191.0,0,0,0.0,0.0,0.0
108098478.0,17,5,955,5,955,27024619.5,191.0,191.0,0,0,0.0,0.0,0.0
323538.0,17,4,1400,4,1400,107846.0,350.0,350.0,0,0,0.0,0.0,0.0
40962.0,6,12,1413,7,882,6827.0,291.0,126.0,5,531,9359.5,259.0,106.2
267998.0,6,12,1373,7,714,44666.333333333336,298.0,102.0,5,659,63017.0,379.0,131.8
120843537.0,6,33,2296,17,1225,7552721.0625,139.0,72.05882352941177,16,1071,7376173.466666667,123.0,66.9375
31927.0,6,14,4740,7,653,5139.166666666667,249.0,93.28571428571428,7,4087,5031.166666666667,1514.0,583.8571428571429
2462.0,17,4,344,2,150,0.0,75.0,75.0,2,194,0.0,103.0,97.0
6663729.0,6,5,1736,2,819,0.0,753.0,409.5,3,917,3265339.5,785.0,305.6666666666667
216432.0,17,2,180,1,90,0.0,90.0,90.0,1,90,0.0,90.0,90.0
42959.0,6,13,1479,7,882,6996.0,291.0,126.0,6,597,6318.6,259.0,99.5
1480752.0,17,16,1120,16,1120,98716.8,70.0,70.0,0,0,0.0,0.0,0.0
121994217.0,17,14,1257,8,737,17427745.285714287,174.0,92.125,6,520,16356744.2,174.0,86.66666666666667
90048356.0,17,28,13364,28,13364,3335124.296296296,501.0,477.2857142857143,0,0,0.0,0.0,0.0
294696.0,6,6,412,4,272,98232.0,74.0,68.0,2,140,0.0,74.0,70.0
309630.0,17,4,1400,4,1400,103210.0,350.0,350.0,0,0,0.0,0.0,0.0
90532611.0,6,14,2240,8,1016,12933230.142857144,188.0,127.0,6,1224,18071334.8,204.0,204.0
108107602.0,17,5,1005,5,1005,27026900.5,201.0,201.0,0,0,0.0,0.0,0.0
207370.0,6,3,426,2,280,0.0,214.0,140.0,1,146,0.0,146.0,146.0
120109611.0,6,15,2444,7,1428,20018268.5,204.0,204.0,8,1016,17135156.285714287,188.0,127.0
91438122.0,6,24,1829,13,989,7618794.833333333,95.0,76.07692307692308,11,840,9143087.9,95.0,76.36363636363636
135135621.0,17,6,1146,6,1146,27027124.2,191.0,191.0,0,0,0.0,0.0,0.0
2309.0,17,4,344,2,150,0.0,75.0,75.0,2,194,0.0,103.0,97.0
100005262.0,17,12,778,6,389,19938508.6,174.0,64.83333333333333,6,389,19968859.2,174.0,64.83333333333333
204524.0,17,2,762,2,762,0.0,381.0,381.0,0,0,0.0,0.0,0.0
245461.0,6,3,373,2,238,0.0,172.0,119.0,1,135,0.0,135.0,135.0
54493.0,6,14,4740,7,653,8621.833333333334,249.0,93.28571428571428,7,4087,8770.0,1514.0,583.8571428571429
2321.0,17,4,344,2,150,0.0,75.0,75.0,2,194,0.0,103.0,97.0
37679.0,6,10,2032,5,524,9145.5,252.0,104.8,5,1508,7650.0,1236.0,301.6
1120.0,17,2,508,2,508,0.0,257.0,254.0,0,0,0.0,0.0,0.0
103115.0,17,2,762,2,762,0.0,381.0,381.0,0,0,0.0,0.0,0.0
318687.0,17,4,1400,4,1400,106229.0,350.0,350.0,0,0,0.0,0.0,0.0
62677337.0,6,19,1334,9,640,7834437.75,95.0,71.11111111111111,10,694,6961749.333333333,95.0,69.4
335.0,17,2,166,1,75,0.0,75.0,75.0,1,91,0.0,91.0,91.0
108101215.0,17,5,955,5,955,27025303.75,191.0,191.0,0,0,0.0,0.0,0.0
90041722.0,17,28,13364,28,13364,3334878.592592593,501.0,477.2857142857143,0,0,0.0,0.0,0.0
35975.0,6,2,145,2,145,0.0,91.0,72.5,0,0,0.0,0.0,0.0
218201.0,6,3,426,2,280,0.0,214.0,140.0,1,146,0.0,146.0,146.0
108108874.0,17,5,1005,5,1005,27027218.5,201.0,201.0,0,0,0.0,0.0,0.0
108102689.0,17,5,1005,5,1005,27025672.25,201.0,201.0,0,0,0.0,0.0,0.0
2408.0,17,4,344,2,150,0.0,75.0,75.0,2,194,0.0,103.0,97.0
845350.0,6,9,1118,6,586,169070.0,248.0,97.66666666666669,3,532,284773.5,392.0,177.33333333333334
42576.0,6,14,4740,7,653,6973.833333333333,249.0,93.28571428571428,7,4087,6943.0,1514.0,583.8571428571429
117546035.0,6,31,2182,16,1165,7822014.133333334,139.0,72.8125,15,1017,8380728.857142857,123.0,67.8
121506.0,6,4,439,2,238,0.0,172.0,119.0,2,201,0.0,135.0,100.5
990955.0,17,6,1230,3,234,495293.0,78.0,78.0,3,996,495271.0,332.0,332.0
1797.0,17,2,192,1,88,0.0,88.0,88.0,1,104,0.0,104.0,104.0
90289297.0,6,16,1192,8,596,12892203.714285716,95.0,74.5,8,596,12896721.0,95.0,74.5
851980.0,6,9,1270,6,799,170396.0,461.0,133.16666666666666,3,471,289647.0,331.0,157.0
54141.0,6,14,4740,7,653,8451.666666666666,249.0,93.28571428571428,7,4087,7979.333333333333,1514.0,583.8571428571429
758.0,17,4,438,2,148,0.0,74.0,74.0,2,290,0.0,147.0,145.0
2339.0,17,4,344,2,150,0.0,75.0,75.0,2,194,0.0,103.0,97.0
143877.0,17,2,180,1,90,0.0,90.0,90.0,1,90,0.0,90.0,90.0
311258.0,17,4,1400,4,1400,103752.66666666669,350.0,350.0,0,0,0.0,0.0,0.0
103430.0,17,2,286,2,286,0.0,143.0,143.0,0,0,0.0,0.0,0.0
7024.0,17,2,582,1,83,0.0,83.0,83.0,1,499,0.0,499.0,499.0
14652031.0,6,19,1553,9,921,1793140.75,315.0,102.33333333333331,10,632,1593870.5555555555,78.0,63.2
2593486.0,6,2,132,1,66,0.0,66.0,66.0,1,66,0.0,66.0,66.0
871863.0,6,9,1269,6,798,174372.6,460.0,133.0,3,471,298126.5,331.0,157.0
108103179.0,17,5,955,5,955,27025794.75,191.0,191.0,0,0,0.0,0.0,0.0
39780.0,6,10,2032,5,524,9094.25,252.0,104.8,5,1508,9693.75,1236.0,301.6
216091.0,17,2,414,1,88,0.0,88.0,88.0,1,326,0.0,326.0,326.0
16016627.0,17,2,684,2,684,0.0,342.0,342.0,0,0,0.0,0.0,0.0
90258586.0,6,13,2036,8,1016,12894083.714285716,188.0,127.0,5,1020,22523340.5,204.0,204.0
285385.0,6,10,1221,6,636,57077.0,298.0,106.0,4,585,89344.33333333333,379.0,146.25
151568.0,17,2,414,1,88,0.0,88.0,88.0,1,326,0.0,326.0,326.0
319382.0,17,4,1400,4,1400,106460.66666666669,350.0,350.0,0,0,0.0,0.0,0.0
3177685.0,6,18,1577,9,1003,358342.75,315.0,111.44444444444444,9,574,358284.125,78.0,63.77777777777778
114539189.0,6,48,3168,24,1584,4979964.739130435,66.0,66.0,24,1584,4966297.608695652,66.0,66.0
90258793.0,6,13,2036,8,1016,12894113.285714284,188.0,127.0,5,1020,22524176.5,204.0,204.0
68264.0,6,10,2032,5,524,16242.0,252.0,104.8,5,1508,16686.0,1236.0,301.6
113168046.0,6,46,3036,23,1518,5143990.954545454,66.0,66.0,23,1518,5143989.590909091,66.0,66.0
123331219.0,6,48,3168,24,1584,5189400.739130435,66.0,66.0,24,1584,5108460.695652174,66.0,66.0
23511.0,6,10,2032,5,524,5657.25,252.0,104.8,5,1508,5212.5,1236.0,301.6
120006586.0,6,28,3015,14,1505,9230757.461538462,426.0,107.5,14,1510,9229797.076923076,362.0,107.85714285714286
151851.0,17,2,414,1,88,0.0,88.0,88.0,1,326,0.0,326.0,326.0
15159996.0,17,6,2718,6,2718,3031999.2,453.0,453.0,0,0,0.0,0.0,0.0
90746773.0,6,24,1829,13,989,7558276.25,95.0,76.07692307692308,11,840,9046864.5,95.0,76.36363636363636
90256690.0,6,13,2036,8,1016,12893812.857142856,188.0,127.0,5,1020,22522675.25,204.0,204.0
4319.0,17,2,614,1,72,0.0,72.0,72.0,1,542,0.0,542.0,542.0
270632.0,17,4,1524,4,1524,90210.66666666669,381.0,381.0,0,0,0.0,0.0,0.0
18216.0,6,10,2032,5,524,3412.0,252.0,104.8,5,1508,4065.5,1236.0,301.6
20369.0,6,14,4740,7,653,3049.6666666666665,249.0,93.28571428571428,7,4087,3251.333333333333,1514.0,583.8571428571429
28479.0,6,10,2032,5,524,6907.0,252.0,104.8,5,1508,6124.25,1236.0,301.6
42191302.0,6,4,1670,3,917,21095651.0,785.0,305.6666666666667,1,753,0.0,753.0,753.0
99595987.0,17,12,778,6,389,19801040.4,174.0,64.83333333333333,6,389,19800159.6,174.0,64.83333333333333
50776.0,17,2,180,1,90,0.0,90.0,90.0,1,90,0.0,90.0,90.0
118038553.0,6,32,2220,16,1149,7869236.866666666,123.0,71.8125,16,1071,7854832.4,123.0,66.9375
50125.0,6,10,2032,5,524,8969.5,252.0,104.8,5,1508,12105.0,1236.0,301.6
78936.0,6,14,4740,7,653,12536.0,249.0,93.28571428571428,7,4087,11982.166666666666,1514.0,583.8571428571429
121889468.0,6,34,2551,18,1411,7169968.705882353,139.0,78.38888888888889,16,1140,7875531.866666666,123.0,71.25
114229406.0,6,48,3168,24,1584,4966495.913043479,66.0,66.0,24,1584,4957103.173913044,66.0,66.0
2329.0,17,4,344,2,150,0.0,75.0,75.0,2,194,0.0,103.0,97.0
2386.0,17,4,344,2,150,0.0,75.0,75.0,2,194,0.0,103.0,97.0
113733715.0,6,46,3036,23,1518,5155438.045454546,66.0,66.0,23,1518,5155436.818181818,66.0,66.0
307449.0,6,6,412,4,272,102483.0,74.0,68.0,2,140,0.0,74.0,70.0
31117.0,6,14,4740,7,653,4795.5,249.0,93.28571428571428,7,4087,5045.5,1514.0,583.8571428571429
300701.0,6,6,412,4,272,100233.66666666669,74.0,68.0,2,140,0.0,74.0,70.0
31535.0,6,14,4740,7,653,4900.333333333333,249.0,93.28571428571428,7,4087,5070.333333333333,1514.0,583.8571428571429
1326594.0,6,4,264,2,132,0.0,66.0,66.0,2,132,0.0,66.0,66.0
14640888.0,6,20,1689,10,1057,1592623.3333333333,315.0,105.7,10,632,1592600.111111111,78.0,63.2
120093641.0,17,29,13785,29,13785,4289058.607142857,501.0,475.3448275862069,0,0,0.0,0.0,0.0
1026706.0,6,11,1134,6,558,205341.2,220.0,93.0,5,576,256097.5,304.0,115.2
24558.0,6,10,2032,5,524,4594.0,252.0,104.8,5,1508,5786.0,1236.0,301.6
103395057.0,6,44,2904,22,1452,4923574.142857143,66.0,66.0,22,1452,4909860.666666667,66.0,66.0
90258660.0,6,14,1964,8,1016,12894094.285714284,188.0,127.0,6,948,18011713.8,204.0,158.0
83.0,17,2,762,2,762,0.0,381.0,381.0,0,0,0.0,0.0,0.0
206136.0,6,3,426,2,280,0.0,214.0,140.0,1,146,0.0,146.0,146.0
34805.0,6,14,4740,7,653,5644.666666666667,249.0,93.28571428571428,7,4087,5664.5,1514.0,583.8571428571429
364.0,17,2,160,1,80,0.0,80.0,80.0,1,80,0.0,80.0,80.0
49644.0,6,14,4740,7,653,8100.833333333333,249.0,93.28571428571428,7,4087,7915.833333333333,1514.0,583.8571428571429
90262158.0,6,14,1964,8,1016,12894594.0,188.0,127.0,6,948,18019659.4,204.0,158.0
18789.0,6,20,7606,11,978,1878.9,310.0,88.9090909090909,9,6628,2016.875,1514.0,736.4444444444445
135132832.0,17,6,1206,6,1206,27026566.4,201.0,201.0,0,0,0.0,0.0,0.0
59422.0,6,12,1413,7,882,9903.666666666666,291.0,126.0,5,531,12260.75,259.0,106.2
123250491.0,6,49,3234,25,1650,5135437.125,66.0,66.0,24,1584,4927672.826086956,66.0,66.0
120131984.0,6,14,2224,9,1204,15016498.0,188.0,133.77777777777777,5,1020,22531698.0,204.0,204.0
496327.0,6,5,336,2,134,0.0,68.0,67.0,3,202,195217.0,70.0,67.33333333333333
106442.0,17,2,700,2,700,0.0,350.0,350.0,0,0,0.0,0.0,0.0
94005990.0,6,184,20632,92,14338,1030667.6043956043,284.0,155.84782608695653,92,6294,1030667.10989011,140.0,68.41304347826087
133549.0,6,2,132,1,66,0.0,66.0,66.0,1,66,0.0,66.0,66.0
105812.0,17,2,700,2,700,0.0,350.0,350.0,0,0,0.0,0.0,0.0
69939.0,6,14,4740,7,653,11530.5,249.0,93.28571428571428,7,4087,11515.5,1514.0,583.8571428571429
6601.0,17,2,582,1,83,0.0,83.0,83.0,1,499,0.0,499.0,499.0
10477045.0,6,7,478,4,272,3446613.333333333,74.0,68.0,3,206,5169771.5,74.0,68.66666666666667
38901.0,6,14,4740,7,653,6079.666666666667,249.0,93.28571428571428,7,4087,6012.333333333333,1514.0,583.8571428571429
17737.0,6,2,145,2,145,0.0,91.0,72.5,0,0,0.0,0.0,0.0
316773.0,6,6,412,4,272,105591.0,74.0,68.0,2,140,0.0,74.0,70.0
73638.0,6,14,4740,7,653,11599.0,249.0,93.28571428571428,7,4087,11607.0,1514.0,583.8571428571429
1842064.0,17,2,896,2,896,0.0,453.0,448.0,0,0,0.0,0.0,0.0
738275.0,17,2,876,2,876,0.0,438.0,438.0,0,0,0.0,0.0,0.0
96821379.0,6,39,2574,20,1320,5095847.052631579,66.0,66.0,19,1254,5159975.444444444,66.0,66.0
332.0,17,2,166,1,75,0.0,75.0,75.0,1,91,0.0,91.0,91.0
90525144.0,6,14,2240,8,1016,12932163.42857143,188.0,127.0,6,1224,18070139.0,204.0,204.0
315525.0,6,10,1221,6,636,63105.0,298.0,106.0,4,585,99810.33333333331,379.0,146.25
20687.0,6,14,4740,7,653,3272.1666666666665,249.0,93.28571428571428,7,4087,2958.5,1514.0,583.8571428571429
9608.0,17,2,582,1,83,0.0,83.0,83.0,1,499,0.0,499.0,499.0
43335.0,6,10,2032,5,524,9263.25,252.0,104.8,5,1508,10557.25,1236.0,301.6
90772141.0,6,18,1341,9,691,11346517.625,95.0,76.77777777777777,9,650,11307501.75,95.0,72.22222222222223
125166291.0,17,15,1169,7,563,17486328.833333332,174.0,80.42857142857143,8,606,17858073.0,174.0,75.75
218152.0,6,3,426,2,280,0.0,214.0,140.0,1,146,0.0,146.0,146.0
5629517.0,6,5,336,2,134,0.0,68.0,67.0,3,202,1425896.5,70.0,67.33333333333333
10495857.0,6,7,478,4,272,3451405.0,74.0,68.0,3,206,5177006.0,74.0,68.66666666666667
8815.0,17,2,498,1,80,0.0,80.0,80.0,1,418,0.0,418.0,418.0
326.0,17,2,174,1,79,0.0,79.0,79.0,1,95,0.0,95.0,95.0
210950.0,6,3,426,2,280,0.0,214.0,140.0,1,146,0.0,146.0,146.0
103963.0,17,2,762,2,762,0.0,381.0,381.0,0,0,0.0,0.0,0.0
509453.00000000006,6,5,336,2,134,0.0,68.0,67.0,3,202,195794.5,70.0,67.33333333333333
153446.0,17,2,180,1,90,0.0,90.0,90.0,1,90,0.0,90.0,90.0
32116.0,6,14,4740,7,653,5189.0,249.0,93.28571428571428,7,4087,5141.333333333333,1514.0,583.8571428571429
209469.0,17,2,180,1,90,0.0,90.0,90.0,1,90,0.0,90.0,90.0
90256922.0,6,13,2036,8,1016,12893846.0,188.0,127.0,5,1020,22523262.0,204.0,204.0
8189.999999999999,17,4,344,2,150,0.0,75.0,75.0,2,194,0.0,103.0,97.0
214841.0,6,10,1221,6,636,42968.2,298.0,106.0,4,585,70327.66666666667,379.0,146.25
116529116.0,6,214,24202,107,16844,1097301.3301886793,284.0,157.42056074766356,107,7358,1097300.9811320754,140.0,68.76635514018692
146063.0,6,3,337,2,214,0.0,160.0,107.0,1,123,0.0,123.0,123.0
37989.0,6,10,2032,5,524,9249.75,252.0,104.8,5,1508,9223.5,1236.0,301.6
25269.0,6,14,4740,7,653,3846.1666666666665,249.0,93.28571428571428,7,4087,4002.0,1514.0,583.8571428571429
194808.0,17,4,1524,4,1524,64936.0,381.0,381.0,0,0,0.0,0.0,0.0
10441133.0,6,7,478,4,272,3434781.6666666665,74.0,68.0,3,206,5152018.5,74.0,68.66666666666667
2434.0,17,4,344,2,150,0.0,75.0,75.0,2,194,0.0,103.0,97.0
44204.0,6,10,2032,5,524,10357.0,252.0,104.8,5,1508,8954.0,1236.0,301.6
228222.0,17,2,180,1,90,0.0,90.0,90.0,1,90,0.0,90.0,90.0
30778.0,6,10,2032,5,524,7040.0,252.0,104.8,5,1508,6839.0,1236.0,301.6
247044.0,17,2,180,1,90,0.0,90.0,90.0,1,90,0.0,90.0,90.0
42328.0,6,14,4740,7,653,6851.166666666667,249.0,93.28571428571428,7,4087,5838.166666666667,1514.0,583.8571428571429
260059.0,6,10,1221,6,636,52011.8,298.0,106.0,4,585,81164.66666666667,379.0,146.25
251763.00000000003,6,3,373,2,238,0.0,172.0,119.0,1,135,0.0,135.0,135.0
135128535.0,17,6,1206,6,1206,27025707.0,201.0,201.0,0,0,0.0,0.0,0.0
123007378.0,17,15,1169,8,606,17572482.57142857,174.0,75.75,7,563,17166830.666666668,174.0,80.42857142857143
236281.0,6,3,337,2,214,0.0,160.0,107.0,1,123,0.0,123.0,123.0
113298368.0,6,48,3168,24,1584,4926016.0,66.0,66.0,24,1584,4920356.782608695,66.0,66.0
15235.0,17,2,180,1,90,0.0,90.0,90.0,1,90,0.0,90.0,90.0
257702.0,6,3,337,2,214,0.0,160.0,107.0,1,123,0.0,123.0,123.0
398010.0,6,3,204,2,136,0.0,70.0,68.0,1,68,0.0,68.0,68.0
310371.0,17,4,1400,4,1400,103457.0,350.0,350.0,0,0,0.0,0.0,0.0
180125.0,17,2,762,2,762,0.0,381.0,381.0,0,0,0.0,0.0,0.0
2476.0,17,4,344,2,150,0.0,75.0,75.0,2,194,0.0,103.0,97.0
135127932.0,17,6,1146,6,1146,27025586.4,191.0,191.0,0,0,0.0,0.0,0.0
31871026.0,6,5,336,2,134,0.0,68.0,67.0,3,202,14534470.5,70.0,67.33333333333333
355.0,17,2,160,1,80,0.0,80.0,80.0,1,80,0.0,80.0,80.0
2480.0,17,2,762,2,762,0.0,381.0,381.0,0,0,0.0,0.0,0.0
233448.0,17,2,180,1,90,0.0,90.0,90.0,1,90,0.0,90.0,90.0
104520365.0,17,14,1126,7,563,17333494.5,174.0,80.42857142857143,7,563,17334002.0,174.0,80.42857142857143
146140.0,6,3,337,2,214,0.0,160.0,107.0,1,123,0.0,123.0,123.0
146151.0,6,4,439,2,238,0.0,172.0,119.0,2,201,0.0,135.0,100.5
108096744.0,17,5,955,5,955,27024186.0,191.0,191.0,0,0,0.0,0.0,0.0
82.0,17,2,762,2,762,0.0,381.0,381.0,0,0,0.0,0.0,0.0
5806003.0,6,5,336,2,134,0.0,68.0,67.0,3,202,1523940.5,70.0,67.33333333333333
147344.0,6,3,373,2,238,0.0,172.0,119.0,1,135,0.0,135.0,135.0
65340.99999999999,6,14,4740,7,653,9865.333333333334,249.0,93.28571428571428,7,4087,9486.0,1514.0,583.8571428571429
385152.0,6,3,204,2,136,0.0,70.0,68.0,1,68,0.0,68.0,68.0
26379.0,6,14,4740,7,653,3916.3333333333335,249.0,93.28571428571428,7,4087,4089.0,1514.0,583.8571428571429
301257.0,6,6,412,4,272,100419.0,74.0,68.0,2,140,0.0,74.0,70.0
3002189.0,6,12,2172,7,664,500309.0,252.0,94.85714285714286,5,1508,1819.75,1236.0,301.6
299018.0,17,2,246,1,76,0.0,76.0,76.0,1,170,0.0,170.0,170.0
105545262.0,6,43,2838,22,1452,5012852.428571428,66.0,66.0,21,1386,5135452.7,66.0,66.0
217839.0,6,3,426,2,280,0.0,214.0,140.0,1,146,0.0,146.0,146.0
1209549.0,17,7,490,7,490,201591.5,70.0,70.0,0,0,0.0,0.0,0.0
102746.0,17,2,286,2,286,0.0,143.0,143.0,0,0,0.0,0.0,0.0
2371.0,17,4,344,2,150,0.0,75.0,75.0,2,194,0.0,103.0,97.0
207332.0,6,3,426,2,280,0.0,214.0,140.0,1,146,0.0,146.0,146.0
91045254.0,6,153,17416,77,12178,1197963.8684210526,284.0,158.15584415584416,76,5238,1210879.4533333334,140.0,68.92105263157895
304370.0,6,6,412,4,272,101456.66666666669,74.0,68.0,2,140,0.0,74.0,70.0
3051806.0,6,4,270,3,202,1525903.0,70.0,67.33333333333333,1,68,0.0,68.0,68.0
245636.0,17,2,180,1,90,0.0,90.0,90.0,1,90,0.0,90.0,90.0
9481.0,17,4,344,2,150,0.0,75.0,75.0,2,194,0.0,103.0,97.0
403624.0,6,4,508,2,238,0.0,172.0,119.0,2,270,0.0,135.0,135.0
85.0,17,2,762,2,762,0.0,381.0,381.0,0,0,0.0,0.0,0.0
2416.0,17,4,344,2,150,0.0,75.0,75.0,2,194,0.0,103.0,97.0
196969.0,17,2,180,1,90,0.0,90.0,90.0,1,90,0.0,90.0,90.0
2663745.0,6,25,7573,14,3735,204903.4615384616,1514.0,266.7857142857143,11,3838,239406.8,1514.0,348.90909090909093
1302507.0,6,4,264,2,132,0.0,66.0,66.0,2,132,0.0,66.0,66.0
105744486.0,17,15,1169,8,606,15001017.714285716,174.0,75.75,7,563,17500181.833333332,174.0,80.42857142857143
196991.0,17,2,180,1,90,0.0,90.0,90.0,1,90,0.0,90.0,90.0
35365.0,6,14,4740,7,653,5449.0,249.0,93.28571428571428,7,4087,5468.333333333333,1514.0,583.8571428571429
2382024.0,6,23,7202,13,3681,198502.0,1514.0,283.15384615384613,10,3521,235286.44444444444,1514.0,352.1
3367.0,17,2,414,1,88,0.0,88.0,88.0,1,326,0.0,326.0,326.0
283719.0,17,4,704,2,148,0.0,74.0,74.0,2,556,0.0,280.0,278.0
2564323.0,6,25,7573,14,3735,197255.6153846153,1514.0,266.7857142857143,11,3838,231294.1,1514.0,348.90909090909093
42231.0,6,14,4740,7,653,6780.666666666667,249.0,93.28571428571428,7,4087,6836.666666666667,1514.0,583.8571428571429
333107.0,17,6,1230,3,234,166363.0,78.0,78.0,3,996,166346.0,332.0,332.0
105790.0,17,2,700,2,700,0.0,350.0,350.0,0,0,0.0,0.0,0.0
45840.0,6,12,1328,7,797,7640.0,253.0,113.85714285714286,5,531,10101.75,259.0,106.2
203622.0,17,2,180,1,90,0.0,90.0,90.0,1,90,0.0,90.0,90.0
127534835.0,6,32,2242,17,1225,7970927.1875,139.0,72.05882352941177,15,1017,8380878.571428572,123.0,67.8
149722995.0,6,16,2494,6,1224,23970670.4,204.0,204.0,10,1270,16635729.444444444,188.0,127.0
108110337.0,17,5,1005,5,1005,27027584.25,201.0,201.0,0,0,0.0,0.0,0.0
286531.0,17,2,363,1,79,0.0,79.0,79.0,1,284,0.0,284.0,284.0
120150461.0,6,910,192286,448,30234,268792.97762863536,214.0,67.48660714285714,462,162052,258340.96746203903,1514.0,350.7619047619048
108113653.0,17,5,955,5,955,27028413.25,191.0,191.0,0,0,0.0,0.0,0.0
3021350.0,6,3,204,2,136,0.0,70.0,68.0,1,68,0.0,68.0,68.0
146701.0,6,3,337,2,214,0.0,160.0,107.0,1,123,0.0,123.0,123.0
90251710.0,6,12,1832,8,1016,12893101.42857143,188.0,127.0,4,816,30029802.33333333,204.0,204.0
60523.0,6,14,4740,7,653,8737.0,249.0,93.28571428571428,7,4087,9292.166666666666,1514.0,583.8571428571429
92710067.0,6,38,2508,19,1254,5135438.055555556,66.0,66.0,19,1254,5135438.833333333,66.0,66.0
2009.0,17,4,344,2,150,0.0,75.0,75.0,2,194,0.0,103.0,97.0
9725.0,17,2,582,1,83,0.0,83.0,83.0,1,499,0.0,499.0,499.0
4456.0,17,2,614,1,72,0.0,72.0,72.0,1,542,0.0,542.0,542.0
323.0,17,2,174,1,79,0.0,79.0,79.0,1,95,0.0,95.0,95.0
22061.0,6,10,2032,5,524,4914.25,252.0,104.8,5,1508,5162.5,1236.0,301.6
103907.0,17,2,700,2,700,0.0,350.0,350.0,0,0,0.0,0.0,0.0
90283118.0,6,16,1192,8,596,12891659.57142857,95.0,74.5,8,596,12896574.857142856,95.0,74.5
302722.0,6,6,412,4,272,100907.33333333331,74.0,68.0,2,140,0.0,74.0,70.0
821.0,17,4,438,2,148,0.0,74.0,74.0,2,290,0.0,147.0,145.0
2757.0,17,2,762,2,762,0.0,381.0,381.0,0,0,0.0,0.0,0.0
42254.0,6,10,1065,5,534,9299.5,262.0,106.8,5,531,5538.5,259.0,106.2
308281.0,6,6,412,4,272,102760.33333333331,74.0,68.0,2,140,0.0,74.0,70.0
90018461.0,17,28,13364,28,13364,3334017.074074074,501.0,477.2857142857143,0,0,0.0,0.0,0.0
40512.0,6,10,2032,5,524,8467.5,252.0,104.8,5,1508,9853.25,1236.0,301.6
302995.0,6,6,412,4,272,100998.33333333331,74.0,68.0,2,140,0.0,74.0,70.0
209355.0,17,2,180,1,90,0.0,90.0,90.0,1,90,0.0,90.0,90.0
1771769.0,6,2,132,1,66,0.0,66.0,66.0,1,66,0.0,66.0,66.0
3179166.0,6,18,1495,9,921,358384.25,315.0,102.33333333333331,9,574,358359.375,78.0,63.77777777777778
108110852.0,17,5,955,5,955,27027713.0,191.0,191.0,0,0,0.0,0.0,0.0
4269.0,17,2,614,1,72,0.0,72.0,72.0,1,542,0.0,542.0,542.0
155138.0,6,3,337,2,214,0.0,160.0,107.0,1,123,0.0,123.0,123.0
16939.0,6,14,4740,7,653,2517.5,249.0,93.28571428571428,7,4087,2686.5,1514.0,583.8571428571429
107396.0,17,2,286,2,286,0.0,143.0,143.0,0,0,0.0,0.0,0.0
102453.0,17,2,286,2,286,0.0,143.0,143.0,0,0,0.0,0.0,0.0
3183.0,17,2,224,1,76,0.0,76.0,76.0,1,148,0.0,148.0,148.0
33770.0,17,2,507,1,86,0.0,86.0,86.0,1,421,0.0,421.0,421.0
142027.0,17,4,704,2,148,0.0,74.0,74.0,2,556,0.0,280.0,278.0
120438235.0,6,245,27794,123,19446,987198.6475409836,284.0,158.09756097560975,122,8348,978209.0909090908,140.0,68.42622950819673
280969.0,17,4,704,2,148,0.0,74.0,74.0,2,556,0.0,280.0,278.0
343.0,17,2,267,1,83,0.0,83.0,83.0,1,184,0.0,184.0,184.0
294.0,17,2,174,1,79,0.0,79.0,79.0,1,95,0.0,95.0,95.0
122005511.0,17,15,1169,8,606,17429358.714285713,174.0,75.75,7,563,17000145.166666668,174.0,80.42857142857143
597121.0,17,3,551,2,156,0.0,78.0,78.0,1,395,0.0,395.0,395.0
1309436.0,6,4,264,2,132,0.0,66.0,66.0,2,132,0.0,66.0,66.0
3168.0,17,2,224,1,76,0.0,76.0,76.0,1,148,0.0,148.0,148.0
318.0,17,2,174,1,79,0.0,79.0,79.0,1,95,0.0,95.0,95.0
287324.0,6,10,1221,6,636,57464.8,298.0,106.0,4,585,90039.33333333333,379.0,146.25
2341.0,17,4,344,2,150,0.0,75.0,75.0,2,194,0.0,103.0,97.0
1057099.0,6,11,1134,6,558,211419.8,220.0,93.0,5,576,262312.25,304.0,115.2
102919.0,17,2,286,2,286,0.0,143.0,143.0,0,0,0.0,0.0,0.0
135130815.0,17,6,1146,6,1146,27026163.0,191.0,191.0,0,0,0.0,0.0,0.0
3189674.0,6,3,1604,2,851,0.0,785.0,425.5,1,753,0.0,753.0,753.0
90048137.0,17,28,13364,28,13364,3335116.185185185,501.0,477.2857142857143,0,0,0.0,0.0,0.0
35147.0,6,14,4740,7,653,5484.5,249.0,93.28571428571428,7,4087,5672.5,1514.0,583.8571428571429
148076.0,17,2,180,1,90,0.0,90.0,90.0,1,90,0.0,90.0,90.0
30659.0,6,14,4740,7,653,4570.0,249.0,93.28571428571428,7,4087,4827.833333333333,1514.0,583.8571428571429
748.0,17,4,438,2,148,0.0,74.0,74.0,2,290,0.0,147.0,145.0
2164765.0,6,18,6803,10,1501,240529.44444444444,408.0,150.1,8,5302,246248.7142857143,1514.0,662.75
9594.0,17,2,582,1,83,0.0,83.0,83.0,1,499,0.0,499.0,499.0
1794426.0,6,5,367,2,132,0.0,66.0,66.0,3,235,897213.0,103.0,78.33333333333333
90256205.0,6,13,2036,8,1016,12893743.57142857,188.0,127.0,5,1020,22522579.5,204.0,204.0
307869.0,6,6,412,4,272,102623.0,74.0,68.0,2,140,0.0,74.0,70.0
90301619.0,6,16,1192,8,596,12893155.57142857,95.0,74.5,8,596,12898430.285714284,95.0,74.5
323505.0,17,4,1400,4,1400,107835.0,350.0,350.0,0,0,0.0,0.0,0.0
109092102.0,6,199,22492,100,6896,1101940.4242424243,140.0,68.96,99,15596,1102640.8469387756,284.0,157.53535353535352
107055657.0,6,32,2236,16,1165,7122637.333333333,139.0,72.8125,16,1071,7122653.4,123.0,66.9375
153444.0,17,2,180,1,90,0.0,90.0,90.0,1,90,0.0,90.0,90.0
471131.0,6,3,1604,2,851,0.0,785.0,425.5,1,753,0.0,753.0,753.0
135132331.0,17,6,1206,6,1206,27026466.2,201.0,201.0,0,0,0.0,0.0,0.0
108100422.0,17,5,1005,5,1005,27025105.5,201.0,201.0,0,0,0.0,0.0,0.0
383412.0,17,2,363,1,75,0.0,75.0,75.0,1,288,0.0,288.0,288.0
837446.0,6,9,1118,6,586,167489.2,248.0,97.66666666666669,3,532,280799.0,392.0,177.33333333333334
161170.0,17,4,820,2,156,0.0,78.0,78.0,2,664,0.0,332.0,332.0
23177.0,6,14,4740,7,653,2741.333333333333,249.0,93.28571428571428,7,4087,3725.1666666666665,1514.0,583.8571428571429
276421.0,6,10,1221,6,636,55284.2,298.0,106.0,4,585,86314.0,379.0,146.25
103514.0,17,2,286,2,286,0.0,143.0,143.0,0,0,0.0,0.0,0.0
216670.0,6,3,426,2,280,0.0,214.0,140.0,1,146,0.0,146.0,146.0
13307.0,6,10,2032,5,524,3069.5,252.0,104.8,5,1508,2646.25,1236.0,301.6
107807437.0,6,43,2838,22,1452,5133675.19047619,66.0,66.0,21,1386,5160000.4,66.0,66.0
502664.0,6,5,336,2,134,0.0,68.0,67.0,3,202,193279.0,70.0,67.33333333333333
146194.0,6,3,337,2,214,0.0,160.0,107.0,1,123,0.0,123.0,123.0
2008786.0,17,4,525,2,150,0.0,75.0,75.0,2,375,0.0,284.0,187.5
310838.0,17,4,1400,4,1400,103612.66666666669,350.0,350.0,0,0,0.0,0.0,0.0
111028867.0,6,31,2166,16,1149,7387522.2,123.0,71.8125,15,1017,7915203.785714285,123.0,67.8
2841430.0,6,3,1777,2,951,0.0,885.0,475.5,1,826,0.0,826.0,826.0
215679.0,17,2,180,1,90,0.0,90.0,90.0,1,90,0.0,90.0,90.0
298697.0,6,6,412,4,272,99565.66666666669,74.0,68.0,2,140,0.0,74.0,70.0
171573.0,17,2,180,1,90,0.0,90.0,90.0,1,90,0.0,90.0,90.0
27466.0,6,12,1413,7,882,4577.666666666667,291.0,126.0,5,531,5907.5,259.0,106.2
106668.0,17,2,700,2,700,0.0,350.0,350.0,0,0,0.0,0.0,0.0
108107595.0,17,5,1005,5,1005,27026898.75,201.0,201.0,0,0,0.0,0.0,0.0
108104365.0,17,5,955,5,955,27026091.25,191.0,191.0,0,0,0.0,0.0,0.0
4258.0,17,2,614,1,72,0.0,72.0,72.0,1,542,0.0,542.0,542.0
314847.0,17,4,1400,4,1400,104949.0,350.0,350.0,0,0,0.0,0.0,0.0
123309708.0,6,48,3168,24,1584,4937391.956521739,66.0,66.0,24,1584,5351891.391304348,66.0,66.0
0.0,6,1,172,1,172,0.0,172.0,172.0,0,0,0.0,0.0,0.0
248423.0,6,3,337,2,214,0.0,160.0,107.0,1,123,0.0,123.0,123.0
1303904.0,6,4,264,2,132,0.0,66.0,66.0,2,132,0.0,66.0,66.0
120127770.0,6,14,2240,6,1224,24025554.0,204.0,204.0,8,1016,17098906.0,188.0,127.0
205167.0,17,2,762,2,762,0.0,381.0,381.0,0,0,0.0,0.0,0.0
298370.0,6,6,412,4,272,99456.66666666669,74.0,68.0,2,140,0.0,74.0,70.0
299633.0,6,6,412,4,272,99877.66666666669,74.0,68.0,2,140,0.0,74.0,70.0
389.0,17,2,152,1,76,0.0,76.0,76.0,1,76,0.0,76.0,76.0
263234.0,6,10,1221,6,636,52646.8,298.0,106.0,4,585,81974.0,379.0,146.25
52316.0,6,14,4740,7,653,7580.0,249.0,93.28571428571428,7,4087,8251.5,1514.0,583.8571428571429
205967.0,6,3,426,2,280,0.0,214.0,140.0,1,146,0.0,146.0,146.0
2590850.0,6,2,132,1,66,0.0,66.0,66.0,1,66,0.0,66.0,66.0
48580.0,17,3,1143,3,1143,24290.0,381.0,381.0,0,0,0.0,0.0,0.0
117245086.0,6,219,24728,110,7482,1075642.990825688,140.0,68.01818181818182,109,17246,1076047.0648148148,284.0,158.22018348623854
148028.0,17,2,180,1,90,0.0,90.0,90.0,1,90,0.0,90.0,90.0
120013044.0,17,29,13785,29,13785,4286180.142857143,501.0,475.3448275862069,0,0,0.0,0.0,0.0
135132139.0,17,6,1206,6,1206,27026427.8,201.0,201.0,0,0,0.0,0.0,0.0
681.0,17,2,762,2,762,0.0,381.0,381.0,0,0,0.0,0.0,0.0
97828.0,6,13,1386,7,789,16304.666666666666,253.0,112.71428571428572,6,597,15860.4,259.0,99.5
304772.0,17,2,346,1,78,0.0,78.0,78.0,1,268,0.0,268.0,268.0
1127970.0,6,13,1386,7,789,187995.0,253.0,112.71428571428572,6,597,224053.4,259.0,99.5
4508.0,17,2,614,1,72,0.0,72.0,72.0,1,542,0.0,542.0,542.0
2962.0,17,4,344,2,150,0.0,75.0,75.0,2,194,0.0,103.0,97.0
135129624.0,17,6,1146,6,1146,27025924.8,191.0,191.0,0,0,0.0,0.0,0.0
305.0,17,2,174,1,79,0.0,79.0,79.0,1,95,0.0,95.0,95.0
112422.0,17,2,286,2,286,0.0,143.0,143.0,0,0,0.0,0.0,0.0
3336427.0,6,7,923,4,753,1040114.0,571.0,188.25,3,170,1560525.5,62.0,56.66666666666666
228372.0,17,2,180,1,90,0.0,90.0,90.0,1,90,0.0,90.0,90.0
160503.0,6,3,337,2,214,0.0,160.0,107.0,1,123,0.0,123.0,123.0
22745.0,6,11,2098,6,590,3390.2,252.0,98.33333333333331,5,1508,5274.0,1236.0,301.6
2857673.0,6,12,2172,7,664,476128.6666666667,252.0,94.85714285714286,5,1508,3635.5,1236.0,301.6
496.0,17,2,267,1,83,0.0,83.0,83.0,1,184,0.0,184.0,184.0
56687.0,6,14,4740,7,653,7331.166666666667,249.0,93.28571428571428,7,4087,9174.0,1514.0,583.8571428571429
46069.0,6,10,1065,5,534,11058.75,262.0,106.8,5,531,10351.5,259.0,106.2
40065.0,6,10,2032,5,524,9798.75,252.0,104.8,5,1508,9728.0,1236.0,301.6
1054142.0,6,13,1394,7,797,175690.33333333334,253.0,113.85714285714286,6,597,207601.6,259.0,99.5
2057.0,17,4,344,2,150,0.0,75.0,75.0,2,194,0.0,103.0,97.0
62099.0,6,14,4740,7,653,10177.833333333334,249.0,93.28571428571428,7,4087,9121.833333333334,1514.0,583.8571428571429
29107325.0,17,5,1718,4,1368,1789909.0,342.0,342.0,1,350,0.0,350.0,350.0
106438163.0,17,14,864,7,432,17667491.166666668,174.0,61.71428571428572,7,432,17666835.166666668,174.0,61.71428571428572
2425107.0,6,3,1777,2,951,0.0,885.0,475.5,1,826,0.0,826.0,826.0
91033334.0,6,174,19830,87,13866,1056022.1046511629,284.0,159.3793103448276,87,5964,1056012.6627906978,140.0,68.55172413793103
2309.0,17,4,344,2,150,0.0,75.0,75.0,2,194,0.0,103.0,97.0
209902.0,6,3,426,2,280,0.0,214.0,140.0,1,146,0.0,146.0,146.0
306326.0,6,6,412,4,272,102108.66666666669,74.0,68.0,2,140,0.0,74.0,70.0
302156.0,6,6,412,4,272,100718.66666666669,74.0,68.0,2,140,0.0,74.0,70.0
51727.0,6,14,4740,7,653,7831.166666666667,249.0,93.28571428571428,7,4087,8483.0,1514.0,583.8571428571429
2820695.0,6,2,132,1,66,0.0,66.0,66.0,1,66,0.0,66.0,66.0
207002.0,6,3,426,2,280,0.0,214.0,140.0,1,146,0.0,146.0,146.0
206589.0,6,3,426,2,280,0.0,214.0,140.0,1,146,0.0,146.0,146.0
14660072.0,6,20,1607,10,975,1592909.6666666667,315.0,97.5,10,632,1592822.888888889,78.0,63.2
30239.0,6,14,4740,7,653,4401.833333333333,249.0,93.28571428571428,7,4087,3961.8333333333335,1514.0,583.8571428571429
18914.0,6,13,1386,7,789,2664.6666666666665,253.0,112.71428571428572,6,597,3291.0,259.0,99.5
39134.0,6,14,4740,7,653,6362.166666666667,249.0,93.28571428571428,7,4087,6152.333333333333,1514.0,583.8571428571429
5099.0,17,2,180,1,90,0.0,90.0,90.0,1,90,0.0,90.0,90.0
32654.000000000004,6,10,2032,5,524,6684.5,252.0,104.8,5,1508,7756.5,1236.0,301.6
44817.0,6,14,4740,7,653,6675.333333333333,249.0,93.28571428571428,7,4087,6928.0,1514.0,583.8571428571429
3059499.0,6,4,270,3,202,1529749.5,70.0,67.33333333333333,1,68,0.0,68.0,68.0
22765.0,6,10,2032,5,524,4527.75,252.0,104.8,5,1508,5103.25,1236.0,301.6
120040031.0,17,29,13785,29,13785,4287143.964285715,501.0,475.3448275862069,0,0,0.0,0.0,0.0
35227.0,6,13,1479,7,882,5871.166666666667,291.0,126.0,6,597,5174.6,259.0,99.5
113450.0,6,14,4740,7,653,18656.166666666668,249.0,93.28571428571428,7,4087,17307.0,1514.0,583.8571428571429
119960039.0,17,34,16284,34,16284,3635152.696969697,501.0,478.9411764705882,0,0,0.0,0.0,0.0
206185.0,6,3,426,2,280,0.0,214.0,140.0,1,146,0.0,146.0,146.0
172026.0,17,2,180,1,90,0.0,90.0,90.0,1,90,0.0,90.0,90.0
90018612.0,17,28,13364,28,13364,3334022.6666666665,501.0,477.2857142857143,0,0,0.0,0.0,0.0
115264993.0,17,14,864,7,432,19184002.666666668,174.0,61.71428571428572,7,432,19078491.83333333,174.0,61.71428571428572
2337.0,17,4,344,2,150,0.0,75.0,75.0,2,194,0.0,103.0,97.0
90257893.0,6,13,2036,8,1016,12893984.714285716,188.0,127.0,5,1020,22523175.5,204.0,204.0
50714.0,6,14,4740,7,653,8097.666666666667,249.0,93.28571428571428,7,4087,8316.666666666666,1514.0,583.8571428571429
252549.00000000003,6,10,1221,6,636,50509.8,298.0,106.0,4,585,78342.0,379.0,146.25
1303387.0,6,4,264,2,132,0.0,66.0,66.0,2,132,0.0,66.0,66.0
120002958.0,6,22,1639,11,799,12000295.8,95.0,72.63636363636364,11,840,9026144.8,95.0,76.36363636363636
205835.0,17,2,180,1,90,0.0,90.0,90.0,1,90,0.0,90.0,90.0
1098708.0,6,11,1134,6,558,219741.6,220.0,93.0,5,576,273559.0,304.0,115.2
490032.0,6,3,1604,2,851,0.0,785.0,425.5,1,753,0.0,753.0,753.0
103985.0,17,2,286,2,286,0.0,143.0,143.0,0,0,0.0,0.0,0.0
102160817.0,17,14,1126,7,563,17000152.333333332,174.0,80.42857142857143,7,563,17001578.833333332,174.0,80.42857142857143
444422.0,17,2,363,1,79,0.0,79.0,79.0,1,284,0.0,284.0,284.0
214581.0,6,10,1221,6,636,42916.2,298.0,106.0,4,585,70234.66666666667,379.0,146.25
312101.0,17,4,1400,4,1400,104033.66666666669,350.0,350.0,0,0,0.0,0.0,0.0
48895.0,6,14,4740,7,653,7768.833333333333,249.0,93.28571428571428,7,4087,7972.666666666667,1514.0,583.8571428571429
90243182.0,6,460,89504,231,15616,392313.8608695652,214.0,67.6017316017316,229,73888,392221.7982456141,1514.0,322.6550218340612
120732540.0,6,19,1477,10,786,13333323.0,95.0,78.6,9,691,15090141.125,95.0,76.77777777777777
54006.0,6,14,4740,7,653,8869.833333333334,249.0,93.28571428571428,7,4087,8424.166666666666,1514.0,583.8571428571429
281791.0,17,2,363,1,79,0.0,79.0,79.0,1,284,0.0,284.0,284.0
108106451.0,17,5,1005,5,1005,27026612.75,201.0,201.0,0,0,0.0,0.0,0.0
216535.0,17,2,180,1,90,0.0,90.0,90.0,1,90,0.0,90.0,90.0
503.0,17,2,508,2,508,0.0,257.0,254.0,0,0,0.0,0.0,0.0
1321457.0,6,4,264,2,132,0.0,66.0,66.0,2,132,0.0,66.0,66.0
2486.0,17,4,344,2,150,0.0,75.0,75.0,2,194,0.0,103.0,97.0
5424.0,17,2,762,2,762,0.0,381.0,381.0,0,0,0.0,0.0,0.0
303095.0,6,2,132,1,66,0.0,66.0,66.0,1,66,0.0,66.0,66.0
21448.0,17,2,582,1,83,0.0,83.0,83.0,1,499,0.0,499.0,499.0
22737.0,6,14,4740,7,653,3325.6666666666665,249.0,93.28571428571428,7,4087,3435.6666666666665,1514.0,583.8571428571429
90033828.0,17,27,12943,27,12943,3462839.5384615385,501.0,479.3703703703704,0,0,0.0,0.0,0.0
287.0,17,2,164,1,82,0.0,82.0,82.0,1,82,0.0,82.0,82.0
1721513.0,17,18,1260,18,1260,101265.4705882353,70.0,70.0,0,0,0.0,0.0,0.0
17744.0,6,11,2098,6,590,3435.6,252.0,98.33333333333331,5,1508,2945.0,1236.0,301.6
13857.0,6,11,2098,6,590,2319.0,252.0,98.33333333333331,5,1508,3213.75,1236.0,301.6
8247220.0,17,3,1034,2,684,0.0,342.0,342.0,1,350,0.0,350.0,350.0
21186.0,6,10,2032,5,524,5070.0,252.0,104.8,5,1508,5003.5,1236.0,301.6
90521881.0,6,13,2036,8,1016,12931697.285714284,188.0,127.0,5,1020,22588704.5,204.0,204.0
146306.0,6,3,337,2,214,0.0,160.0,107.0,1,123,0.0,123.0,123.0
849745.0,6,9,1268,6,797,169949.0,459.0,132.83333333333334,3,471,288592.5,331.0,157.0
31605.0,6,14,4740,7,653,4499.5,249.0,93.28571428571428,7,4087,4731.833333333333,1514.0,583.8571428571429
284347.0,17,2,363,1,79,0.0,79.0,79.0,1,284,0.0,284.0,284.0
113610642.0,6,46,3036,23,1518,5150437.7727272725,66.0,66.0,23,1518,5150441.454545454,66.0,66.0
50022.0,6,14,4740,7,653,7526.666666666667,249.0,93.28571428571428,7,4087,7053.0,1514.0,583.8571428571429
527437.0,17,6,2100,6,2100,105487.4,350.0,350.0,0,0,0.0,0.0,0.0
216620.0,6,3,426,2,280,0.0,214.0,140.0,1,146,0.0,146.0,146.0
99000775.0,17,13,1083,7,563,16500129.166666666,174.0,80.42857142857143,6,520,15800776.4,174.0,86.66666666666667
56842.0,6,14,4740,7,653,8993.5,249.0,93.28571428571428,7,4087,8572.833333333334,1514.0,583.8571428571429
124001160.0,17,15,907,8,475,17714451.42857143,174.0,59.375,7,432,17310461.5,174.0,61.71428571428572
2795002.0,6,2,132,1,66,0.0,66.0,66.0,1,66,0.0,66.0,66.0
120198744.0,6,226,25624,113,7754,1065916.9464285714,140.0,68.61946902654867,113,17870,1063170.5625,284.0,158.141592920354
4553.0,17,4,344,2,150,0.0,75.0,75.0,2,194,0.0,103.0,97.0
299503.0,6,6,412,4,272,99834.33333333331,74.0,68.0,2,140,0.0,74.0,70.0
45401.0,6,14,4740,7,653,6240.333333333333,249.0,93.28571428571428,7,4087,7425.5,1514.0,583.8571428571429
106938.0,17,2,700,2,700,0.0,350.0,350.0,0,0,0.0,0.0,0.0
298501.0,6,6,412,4,272,99500.33333333331,74.0,68.0,2,140,0.0,74.0,70.0
18035.0,6,11,2098,6,590,3211.8,252.0,98.33333333333331,5,1508,4190.5,1236.0,301.6
11183.0,6,10,1065,5,534,2621.25,262.0,106.8,5,531,2031.25,259.0,106.2
108104824.0,17,5,1005,5,1005,27026206.0,201.0,201.0,0,0,0.0,0.0,0.0
10429185.0,6,6,412,3,206,5146717.5,74.0,68.66666666666667,3,206,5146599.0,74.0,68.66666666666667
402.0,17,2,410,1,78,0.0,78.0,78.0,1,332,0.0,332.0,332.0
206918.0,17,2,762,2,762,0.0,381.0,381.0,0,0,0.0,0.0,0.0
208488.0,6,3,426,2,280,0.0,214.0,140.0,1,146,0.0,146.0,146.0
305.0,17,2,168,1,76,0.0,76.0,76.0,1,92,0.0,92.0,92.0
3180175.0,6,18,1495,9,921,358129.25,315.0,102.33333333333331,9,574,358120.25,78.0,63.77777777777778
211016.0,17,4,6056,4,6056,70338.66666666667,1514.0,1514.0,0,0,0.0,0.0,0.0
228233.0,17,2,180,1,90,0.0,90.0,90.0,1,90,0.0,90.0,90.0
9283.0,17,2,539,1,86,0.0,86.0,86.0,1,453,0.0,453.0,453.0
111596143.0,6,30,1974,15,1026,7955712.642857143,123.0,68.4,15,948,7955710.857142857,123.0,63.2
320.0,17,2,174,1,79,0.0,79.0,79.0,1,95,0.0,95.0,95.0
209785.0,17,2,180,1,90,0.0,90.0,90.0,1,90,0.0,90.0,90.0
135134261.0,17,6,1146,6,1146,27026852.2,191.0,191.0,0,0,0.0,0.0,0.0
306122.0,6,6,412,4,272,102040.66666666669,74.0,68.0,2,140,0.0,74.0,70.0
256108.0,6,3,337,2,214,0.0,160.0,107.0,1,123,0.0,123.0,123.0
6913.0,17,2,582,1,83,0.0,83.0,83.0,1,499,0.0,499.0,499.0
102307.0,17,2,286,2,286,0.0,143.0,143.0,0,0,0.0,0.0,0.0
19931.0,17,2,582,1,83,0.0,83.0,83.0,1,499,0.0,499.0,499.0
3125.0,17,4,344,2,150,0.0,75.0,75.0,2,194,0.0,103.0,97.0
29484.0,6,10,2032,5,524,6949.75,252.0,104.8,5,1508,6829.5,1236.0,301.6
144886.0,17,2,180,1,70,0.0,70.0,70.0,1,110,0.0,110.0,110.0
3780338.0,6,5,336,2,134,0.0,68.0,67.0,3,202,1525914.0,70.0,67.33333333333333
43735.0,6,14,4740,7,653,7158.666666666667,249.0,93.28571428571428,7,4087,6285.833333333333,1514.0,583.8571428571429
384139.0,6,4,508,2,238,0.0,172.0,119.0,2,270,0.0,135.0,135.0
349140.0,6,6,412,4,272,116380.0,74.0,68.0,2,140,0.0,74.0,70.0
3215133.0,6,3,1604,1,753,0.0,753.0,753.0,2,851,0.0,785.0,425.5
358.0,17,2,267,1,83,0.0,83.0,83.0,1,184,0.0,184.0,184.0
860027.0,6,9,1096,6,625,172005.4,287.0,104.16666666666669,3,471,293626.5,331.0,157.0
90416395.0,6,21,1585,11,840,9036672.3,95.0,76.36363636363636,10,745,10015679.111111112,95.0,74.5
305092.0,6,6,412,4,272,101697.33333333331,74.0,68.0,2,140,0.0,74.0,70.0
41823.0,6,11,2098,6,590,6915.0,252.0,98.33333333333331,5,1508,9319.0,1236.0,301.6
127001842.0,17,14,864,7,432,18000175.833333332,174.0,61.71428571428572,7,432,18000807.166666668,174.0,61.71428571428572
204808.0,17,2,180,1,90,0.0,90.0,90.0,1,90,0.0,90.0,90.0
209395.0,6,3,426,2,280,0.0,214.0,140.0,1,146,0.0,146.0,146.0
534.0,17,2,508,2,508,0.0,257.0,254.0,0,0,0.0,0.0,0.0
120040093.0,6,19,1395,10,745,13333240.444444444,95.0,74.5,9,650,14998997.25,95.0,72.22222222222223
149005.0,6,2,132,1,66,0.0,66.0,66.0,1,66,0.0,66.0,66.0
120395856.0,6,287,33536,144,23802,841929.0629370629,374.0,165.29166666666666,143,9734,840591.5422535212,140.0,68.06993006993007
104078.0,17,2,286,2,286,0.0,143.0,143.0,0,0,0.0,0.0,0.0
4188.0,17,5,550,5,550,1047.0,110.0,110.0,0,0,0.0,0.0,0.0
19979.0,6,14,4740,7,653,3219.333333333333,249.0,93.28571428571428,7,4087,2786.0,1514.0,583.8571428571429
209453.0,17,2,180,1,90,0.0,90.0,90.0,1,90,0.0,90.0,90.0
1337306.0,17,2,876,2,876,0.0,438.0,438.0,0,0,0.0,0.0,0.0
100875.0,17,2,762,2,762,0.0,381.0,381.0,0,0,0.0,0.0,0.0
1309223.0,6,4,264,2,132,0.0,66.0,66.0,2,132,0.0,66.0,66.0
135132511.0,17,6,1206,6,1206,27026502.2,201.0,201.0,0,0,0.0,0.0,0.0
333.0,17,2,166,1,75,0.0,75.0,75.0,1,91,0.0,91.0,91.0
403141.0,6,4,508,2,238,0.0,172.0,119.0,2,270,0.0,135.0,135.0
2391.0,17,4,344,2,150,0.0,75.0,75.0,2,194,0.0,103.0,97.0
437077.0,6,11,1021,6,444,58645.6,162.0,74.0,5,577,73178.0,349.0,115.4
103885.0,17,2,286,2,286,0.0,143.0,143.0,0,0,0.0,0.0,0.0
313512.0,6,6,412,4,272,104504.0,74.0,68.0,2,140,0.0,74.0,70.0
47564.0,6,10,2032,5,524,11656.25,252.0,104.8,5,1508,10660.0,1236.0,301.6
90525972.0,6,14,2240,8,1016,12932281.714285716,188.0,127.0,6,1224,18072938.2,204.0,204.0
47816297.0,6,8,2113,3,960,22691246.5,826.0,320.0,5,1153,11234238.5,885.0,230.6
305795.0,6,6,412,4,272,101931.66666666669,74.0,68.0,2,140,0.0,74.0,70.0
228224.0,17,2,180,1,90,0.0,90.0,90.0,1,90,0.0,90.0,90.0
303111.0,6,2,132,1,66,0.0,66.0,66.0,1,66,0.0,66.0,66.0
794.0,17,4,438,2,148,0.0,74.0,74.0,2,290,0.0,147.0,145.0
119948101.0,6,25,1883,12,894,10882666.545454543,95.0,74.5,13,989,9982495.833333334,95.0,76.07692307692308
297620.0,6,6,412,4,272,99206.66666666669,74.0,68.0,2,140,0.0,74.0,70.0
179724.0,17,2,180,1,90,0.0,90.0,90.0,1,90,0.0,90.0,90.0
59595.0,6,10,2032,5,524,14429.25,252.0,104.8,5,1508,13319.75,1236.0,301.6
1319191.0,6,4,264,2,132,0.0,66.0,66.0,2,132,0.0,66.0,66.0
120978983.0,6,35,2542,18,1348,7116410.764705882,139.0,74.88888888888889,17,1194,6924184.5,123.0,70.23529411764706
240325.0,17,2,180,1,90,0.0,90.0,90.0,1,90,0.0,90.0,90.0
120123753.0,6,17,2572,8,1368,17160536.14285714,204.0,171.0,9,1204,14994952.0,188.0,133.77777777777777
216860.0,6,3,426,2,280,0.0,214.0,140.0,1,146,0.0,146.0,146.0
95000635.0,17,11,735,6,389,19000127.0,174.0,64.83333333333333,5,346,18751744.0,174.0,69.2
90262642.0,6,13,2036,8,1016,12894663.142857144,188.0,127.0,5,1020,22524600.75,204.0,204.0
76698010.0,17,14,4788,14,4788,5899846.923076923,342.0,342.0,0,0,0.0,0.0,0.0
27306993.0,17,5,1710,5,1710,6826748.25,342.0,342.0,0,0,0.0,0.0,0.0
312930.0,17,4,1400,4,1400,104310.0,350.0,350.0,0,0,0.0,0.0,0.0
121978.0,6,2,132,1,66,0.0,66.0,66.0,1,66,0.0,66.0,66.0
2124307.0,6,25,7609,13,2516,177025.58333333334,1034.0,193.53846153846155,12,5093,164236.72727272726,1510.0,424.4166666666667
107390504.0,6,44,2904,22,1452,5113833.523809524,66.0,66.0,22,1452,5098092.285714285,66.0,66.0
37597.0,6,14,4740,7,653,5535.166666666667,249.0,93.28571428571428,7,4087,5457.833333333333,1514.0,583.8571428571429
18318.0,6,14,4740,7,653,2651.833333333333,249.0,93.28571428571428,7,4087,2913.5,1514.0,583.8571428571429
261352.0,6,10,1221,6,636,52270.4,298.0,106.0,4,585,81493.0,379.0,146.25
104836.0,6,14,4740,7,653,17344.333333333332,249.0,93.28571428571428,7,4087,17334.166666666668,1514.0,583.8571428571429
233193.0,6,3,373,2,238,0.0,172.0,119.0,1,135,0.0,135.0,135.0
56480.0,6,14,4740,7,653,6902.833333333333,249.0,93.28571428571428,7,4087,9219.666666666666,1514.0,583.8571428571429
144451.0,17,2,180,1,90,0.0,90.0,90.0,1,90,0.0,90.0,90.0
143901.0,17,2,180,1,90,0.0,90.0,90.0,1,90,0.0,90.0,90.0
25746.0,6,14,4740,7,653,4120.166666666667,249.0,93.28571428571428,7,4087,4151.666666666667,1514.0,583.8571428571429
20795.0,6,11,1132,6,556,4159.0,218.0,92.66666666666669,5,576,4625.25,304.0,115.2
3350704.0,6,5,336,2,134,0.0,68.0,67.0,3,202,529467.0,70.0,67.33333333333333
108103265.0,17,5,955,5,955,27025816.25,191.0,191.0,0,0,0.0,0.0,0.0
84.0,17,2,762,2,762,0.0,381.0,381.0,0,0,0.0,0.0,0.0
146313.0,6,3,337,2,214,0.0,160.0,107.0,1,123,0.0,123.0,123.0
108122925.0,17,5,1005,5,1005,27030731.25,201.0,201.0,0,0,0.0,0.0,0.0
228156.0,17,2,180,1,90,0.0,90.0,90.0,1,90,0.0,90.0,90.0
130971.0,6,15,4806,8,719,18323.14285714286,249.0,89.875,7,4087,20996.0,1514.0,583.8571428571429
4628.0,17,2,762,2,762,0.0,381.0,381.0,0,0,0.0,0.0,0.0
217666.0,6,3,426,2,280,0.0,214.0,140.0,1,146,0.0,146.0,146.0
103216270.0,6,42,2772,21,1386,5160800.6,66.0,66.0,21,1386,5160801.45,66.0,66.0
153456.0,17,2,180,1,90,0.0,90.0,90.0,1,90,0.0,90.0,90.0
317.0,17,2,174,1,79,0.0,79.0,79.0,1,95,0.0,95.0,95.0
287795.0,17,2,359,1,75,0.0,75.0,75.0,1,284,0.0,284.0,284.0
115073185.0,6,34,2334,17,1209,7178587.6875,123.0,71.11764705882354,17,1125,7178587.25,123.0,66.17647058823529
90762781.0,6,22,1680,12,894,8246979.727272727,95.0,74.5,10,786,10083315.333333334,95.0,78.6
176563.0,17,4,704,2,148,0.0,74.0,74.0,2,556,0.0,280.0,278.0
1173622.0,6,13,3000,8,2372,167660.2857142857,1514.0,296.5,5,628,224536.5,331.0,125.6
120119119.0,6,412,53656,206,13830,578164.4634146341,140.0,67.13592233009709,206,39826,585885.3414634146,336.0,193.33009708737865
10478816.0,6,6,412,3,206,5169483.5,74.0,68.66666666666667,3,206,5169408.5,74.0,68.66666666666667
135136485.0,17,6,1146,6,1146,27027297.0,191.0,191.0,0,0,0.0,0.0,0.0
42725.0,6,14,4570,8,680,6103.571428571428,210.0,85.0,6,3890,7138.0,1514.0,648.3333333333334
196883.0,17,2,180,1,90,0.0,90.0,90.0,1,90,0.0,90.0,90.0
104232211.0,17,15,5130,15,5130,7445157.928571428,342.0,342.0,0,0,0.0,0.0,0.0
205804.0,17,2,180,1,90,0.0,90.0,90.0,1,90,0.0,90.0,90.0
122381.0,6,3,373,2,238,0.0,172.0,119.0,1,135,0.0,135.0,135.0
90023803.0,17,27,12943,27,12943,3462453.961538461,501.0,479.3703703703704,0,0,0.0,0.0,0.0
10799.0,17,2,684,2,684,0.0,342.0,342.0,0,0,0.0,0.0,0.0
1320470.0,6,4,264,2,132,0.0,66.0,66.0,2,132,0.0,66.0,66.0
228393.0,17,2,180,1,90,0.0,90.0,90.0,1,90,0.0,90.0,90.0
108104337.0,17,5,955,5,955,27026084.25,191.0,191.0,0,0,0.0,0.0,0.0
135132397.0,17,6,1146,6,1146,27026479.4,191.0,191.0,0,0,0.0,0.0,0.0
2789472.0,6,2,132,1,66,0.0,66.0,66.0,1,66,0.0,66.0,66.0
14030.0,6,11,1131,6,600,2305.0,262.0,100.0,5,531,3204.0,259.0,106.2
2482.0,17,4,344,2,150,0.0,75.0,75.0,2,194,0.0,103.0,97.0
10455592.0,6,7,478,4,272,3439754.333333333,74.0,68.0,3,206,5159529.5,74.0,68.66666666666667
90296360.0,6,16,1192,8,596,12892445.42857143,95.0,74.5,8,596,12898229.857142856,95.0,74.5
34504.0,6,14,4740,7,653,5627.0,249.0,93.28571428571428,7,4087,5493.333333333333,1514.0,583.8571428571429
90308283.0,6,17,1287,9,691,11282280.125,95.0,76.77777777777777,8,596,12834325.714285716,95.0,74.5
7969.0,17,4,823,2,163,0.0,89.0,81.5,2,660,0.0,443.0,330.0
135135767.0,17,6,1206,6,1206,27027153.4,201.0,201.0,0,0,0.0,0.0,0.0
108113190.0,17,5,1005,5,1005,27028297.5,201.0,201.0,0,0,0.0,0.0,0.0
875.0,17,5,550,5,550,218.75,110.0,110.0,0,0,0.0,0.0,0.0
21393.0,6,14,4740,7,653,3440.333333333333,249.0,93.28571428571428,7,4087,3235.6666666666665,1514.0,583.8571428571429
228472.0,17,2,180,1,90,0.0,90.0,90.0,1,90,0.0,90.0,90.0
327.0,17,2,166,1,75,0.0,75.0,75.0,1,91,0.0,91.0,91.0
210034.0,6,3,426,2,280,0.0,214.0,140.0,1,146,0.0,146.0,146.0
105347.0,17,2,286,2,286,0.0,143.0,143.0,0,0,0.0,0.0,0.0
102244644.0,6,297,36636,149,10056,690842.1891891892,140.0,67.48993288590604,148,26580,688554.5510204082,300.0,179.59459459459458
90299453.0,6,21,1585,11,840,9025094.4,95.0,76.36363636363636,10,745,10001107.888888888,95.0,74.5
146384.0,17,2,180,1,90,0.0,90.0,90.0,1,90,0.0,90.0,90.0
119623097.0,6,22,1963,12,1259,10870536.454545457,257.0,104.91666666666669,10,704,13285610.555555556,95.0,70.4
44632.0,6,14,4740,7,653,7259.833333333333,249.0,93.28571428571428,7,4087,7096.833333333333,1514.0,583.8571428571429
63429.0,6,14,4740,7,653,10256.5,249.0,93.28571428571428,7,4087,5232.333333333333,1514.0,583.8571428571429
27187893.0,17,5,1710,5,1710,6796973.25,342.0,342.0,0,0,0.0,0.0,0.0
90254592.0,6,13,2036,8,1016,12893513.142857144,188.0,127.0,5,1020,22520936.25,204.0,204.0
123001391.0,17,15,907,8,475,17571627.285714287,174.0,59.375,7,432,17168136.0,174.0,61.71428571428572
16511.0,6,14,4740,7,653,2118.5,249.0,93.28571428571428,7,4087,2620.1666666666665,1514.0,583.8571428571429
23773.0,6,14,4740,7,653,3739.6666666666665,249.0,93.28571428571428,7,4087,3766.6666666666665,1514.0,583.8571428571429
2294.0,17,4,344,2,150,0.0,75.0,75.0,2,194,0.0,103.0,97.0
39368.0,6,14,4740,7,653,6425.5,249.0,93.28571428571428,7,4087,6428.666666666667,1514.0,583.8571428571429
53326.0,6,10,2032,5,524,13075.0,252.0,104.8,5,1508,10828.25,1236.0,301.6
116301333.0,6,215,24300,108,7350,1086928.3457943923,140.0,68.05555555555556,107,16950,1087376.424528302,284.0,158.41121495327104
102894282.0,6,190,21426,95,6492,1085846.5106382978,140.0,68.33684210526316,95,14934,1086029.914893617,284.0,157.2
2444.0,17,4,344,2,150,0.0,75.0,75.0,2,194,0.0,103.0,97.0
90258031.0,6,12,1832,8,1016,12894004.42857143,188.0,127.0,4,816,30031248.0,204.0,204.0
224951.0,6,3,426,2,280,0.0,214.0,140.0,1,146,0.0,146.0,146.0
440.0,17,2,166,1,75,0.0,75.0,75.0,1,91,0.0,91.0,91.0
90040971.0,17,28,13364,28,13364,3334850.777777778,501.0,477.2857142857143,0,0,0.0,0.0,0.0
120901654.0,6,35,2589,17,1194,7241506.9375,123.0,70.23529411764706,18,1395,6524485.529411765,123.0,77.5
508.0,17,2,508,2,508,0.0,257.0,254.0,0,0,0.0,0.0,0.0
11924.0,6,10,2032,5,524,2656.0,252.0,104.8,5,1508,2433.25,1236.0,301.6
12771.0,6,10,2032,5,524,2098.5,252.0,104.8,5,1508,2934.75,1236.0,301.6
196908.0,17,2,180,1,90,0.0,90.0,90.0,1,90,0.0,90.0,90.0
10451362.0,6,7,478,4,272,3437150.0,74.0,68.0,3,206,5155603.0,74.0,68.66666666666667
14632982.0,6,20,1607,10,975,1592731.111111111,315.0,97.5,10,632,1592707.7777777778,78.0,63.2
299434.0,6,6,412,4,272,99811.33333333331,74.0,68.0,2,140,0.0,74.0,70.0
14636415.0,6,20,1648,10,1016,1592606.0,315.0,101.6,10,632,1592582.3333333333,78.0,63.2
35933.0,6,14,4740,7,653,5614.833333333333,249.0,93.28571428571428,7,4087,5849.666666666667,1514.0,583.8571428571429
2834957.0,6,3,1604,1,753,0.0,753.0,753.0,2,851,0.0,785.0,425.5
47496.0,6,14,4740,7,653,7029.5,249.0,93.28571428571428,7,4087,7651.0,1514.0,583.8571428571429
81685.0,6,15,4806,8,719,11537.42857142857,249.0,89.875,7,4087,13086.166666666666,1514.0,583.8571428571429
14969.0,17,2,180,1,90,0.0,90.0,90.0,1,90,0.0,90.0,90.0
270409.0,6,10,1221,6,636,54081.8,298.0,106.0,4,585,84727.66666666667,379.0,146.25
304590.0,6,3,202,2,128,0.0,74.0,64.0,1,74,0.0,74.0,74.0
0.0,6,1,66,1,66,0.0,66.0,66.0,0,0,0.0,0.0,0.0
143856.0,17,2,180,1,90,0.0,90.0,90.0,1,90,0.0,90.0,90.0
1300794.0,6,4,264,2,132,0.0,66.0,66.0,2,132,0.0,66.0,66.0
224573.0,6,3,426,2,280,0.0,214.0,140.0,1,146,0.0,146.0,146.0
97587.0,17,2,762,2,762,0.0,381.0,381.0,0,0,0.0,0.0,0.0
16996.0,17,2,180,1,90,0.0,90.0,90.0,1,90,0.0,90.0,90.0
217290.0,17,2,180,1,90,0.0,90.0,90.0,1,90,0.0,90.0,90.0
2975570.0,6,2,132,1,66,0.0,66.0,66.0,1,66,0.0,66.0,66.0
19631.0,6,14,4740,7,653,2964.6666666666665,249.0,93.28571428571428,7,4087,3134.6666666666665,1514.0,583.8571428571429
113168197.0,6,46,3036,23,1518,5143996.818181818,66.0,66.0,23,1518,5143997.909090909,66.0,66.0
165842.0,17,6,1230,3,234,82726.0,78.0,78.0,3,996,82713.0,332.0,332.0
153466.0,17,2,180,1,90,0.0,90.0,90.0,1,90,0.0,90.0,90.0
4644.0,17,4,344,2,150,0.0,75.0,75.0,2,194,0.0,103.0,97.0
121710592.0,17,14,864,7,432,17000163.166666668,174.0,61.71428571428572,7,432,17000814.666666668,174.0,61.71428571428572
62931.0,6,14,4740,7,653,7919.333333333333,249.0,93.28571428571428,7,4087,10055.166666666666,1514.0,583.8571428571429
36946.0,6,14,4740,7,653,5875.333333333333,249.0,93.28571428571428,7,4087,5894.0,1514.0,583.8571428571429
310934.0,17,4,1400,4,1400,103644.66666666669,350.0,350.0,0,0,0.0,0.0,0.0
313537.0,6,3,202,2,128,0.0,74.0,64.0,1,74,0.0,74.0,74.0
75062505.0,6,9,842,9,842,9382813.125,97.0,93.55555555555556,0,0,0.0,0.0,0.0
63760.0,6,14,4740,7,653,10324.833333333334,249.0,93.28571428571428,7,4087,9845.333333333334,1514.0,583.8571428571429
144975.0,17,2,180,1,70,0.0,70.0,70.0,1,110,0.0,110.0,110.0
153433.0,17,2,180,1,90,0.0,90.0,90.0,1,90,0.0,90.0,90.0
106423.0,17,2,286,2,286,0.0,143.0,143.0,0,0,0.0,0.0,0.0
207335.0,6,3,426,2,280,0.0,214.0,140.0,1,146,0.0,146.0,146.0
876000.0,6,10,1336,6,799,175200.0,461.0,133.16666666666666,4,537,201137.0,331.0,134.25
22956106.0,17,3,1034,2,684,0.0,342.0,342.0,1,350,0.0,350.0,350.0
2509.0,17,4,344,2,150,0.0,75.0,75.0,2,194,0.0,103.0,97.0
17594.0,6,11,2098,6,590,3254.8,252.0,98.33333333333331,5,1508,4137.25,1236.0,301.6
43671.0,6,10,2032,5,524,10689.75,252.0,104.8,5,1508,10131.0,1236.0,301.6
145047.0,6,2,132,1,66,0.0,66.0,66.0,1,66,0.0,66.0,66.0
220326.0,17,2,180,1,90,0.0,90.0,90.0,1,90,0.0,90.0,90.0
459.0,17,2,166,1,75,0.0,75.0,75.0,1,91,0.0,91.0,91.0
247846.0,6,10,1221,6,636,49569.2,298.0,106.0,4,585,77137.66666666667,379.0,146.25
197130.0,17,2,180,1,90,0.0,90.0,90.0,1,90,0.0,90.0,90.0
48800.0,6,14,4740,7,653,8004.0,249.0,93.28571428571428,7,4087,6971.333333333333,1514.0,583.8571428571429
112535496.0,6,46,3036,23,1518,5105437.136363637,66.0,66.0,23,1518,5105436.909090909,66.0,66.0
196827.0,17,2,180,1,90,0.0,90.0,90.0,1,90,0.0,90.0,90.0
90300687.0,6,17,1287,9,691,11281841.75,95.0,76.77777777777777,8,596,12899609.57142857,95.0,74.5
201112.0,17,4,6056,4,6056,67037.33333333333,1514.0,1514.0,0,0,0.0,0.0,0.0
207550.0,6,3,426,2,280,0.0,214.0,140.0,1,146,0.0,146.0,146.0
324.0,17,2,160,1,80,0.0,80.0,80.0,1,80,0.0,80.0,80.0
90258595.0,6,16,2368,9,1204,11282324.375,188.0,133.77777777777777,7,1164,15015647.666666666,204.0,166.28571428571428
102787.0,17,2,286,2,286,0.0,143.0,143.0,0,0,0.0,0.0,0.0
38910.0,6,14,4740,7,653,6330.333333333333,249.0,93.28571428571428,7,4087,6240.666666666667,1514.0,583.8571428571429
2972970.0,6,12,2172,7,664,495272.0,252.0,94.85714285714286,5,1508,1877.25,1236.0,301.6
952158.0,17,2,414,1,88,0.0,88.0,88.0,1,326,0.0,326.0,326.0
108105110.0,17,5,955,5,955,27026277.5,191.0,191.0,0,0,0.0,0.0,0.0
51090.0,17,2,180,1,90,0.0,90.0,90.0,1,90,0.0,90.0,90.0
1032042.0,6,11,1134,6,558,206408.4,220.0,93.0,5,576,256661.5,304.0,115.2
148303.0,6,3,337,2,214,0.0,160.0,107.0,1,123,0.0,123.0,123.0
108106780.0,17,5,955,5,955,27026695.0,191.0,191.0,0,0,0.0,0.0,0.0
108704438.0,6,32,2236,16,1165,7232548.2,139.0,72.8125,16,1071,7232550.133333334,123.0,66.9375
213611.0,17,2,180,1,90,0.0,90.0,90.0,1,90,0.0,90.0,90.0
121001161.0,17,15,907,8,475,17285880.14285714,174.0,59.375,7,432,16834163.0,174.0,61.71428571428572
98334224.0,17,12,778,6,389,19602935.8,174.0,64.83333333333333,6,389,19600161.4,174.0,64.83333333333333
47615.0,6,14,4740,7,653,7815.5,249.0,93.28571428571428,7,4087,7063.5,1514.0,583.8571428571429
251177.0,6,3,373,2,238,0.0,172.0,119.0,1,135,0.0,135.0,135.0
67618.0,6,14,4740,7,653,10574.5,249.0,93.28571428571428,7,4087,8464.333333333334,1514.0,583.8571428571429
135140069.0,17,6,1206,6,1206,27028013.8,201.0,201.0,0,0,0.0,0.0,0.0
204886.0,17,2,180,1,90,0.0,90.0,90.0,1,90,0.0,90.0,90.0
249667.0,6,3,337,2,214,0.0,160.0,107.0,1,123,0.0,123.0,123.0
108111608.0,17,5,1005,5,1005,27027902.0,201.0,201.0,0,0,0.0,0.0,0.0
120123574.0,6,15,2444,7,1428,20020595.666666668,204.0,204.0,8,1016,17137185.285714287,188.0,127.0
5822586.0,6,5,336,2,134,0.0,68.0,67.0,3,202,1526350.5,70.0,67.33333333333333
298055.0,6,6,412,4,272,99351.66666666669,74.0,68.0,2,140,0.0,74.0,70.0
99646.0,17,2,762,2,762,0.0,381.0,381.0,0,0,0.0,0.0,0.0
243101.0,6,3,337,2,214,0.0,160.0,107.0,1,123,0.0,123.0,123.0
206248.0,6,3,426,2,280,0.0,214.0,140.0,1,146,0.0,146.0,146.0
266997.0,6,10,1221,6,636,53399.4,298.0,106.0,4,585,83227.66666666667,379.0,146.25
144902.0,17,2,180,1,70,0.0,70.0,70.0,1,110,0.0,110.0,110.0
10479306.0,6,7,478,4,272,3445970.333333333,74.0,68.0,3,206,5168845.5,74.0,68.66666666666667
90529388.0,6,14,2240,8,1016,12932769.714285716,188.0,127.0,6,1224,18073252.4,204.0,204.0
144.0,17,2,700,2,700,0.0,350.0,350.0,0,0,0.0,0.0,0.0
241235.0,17,2,180,1,90,0.0,90.0,90.0,1,90,0.0,90.0,90.0
108109393.0,17,5,1005,5,1005,27027348.25,201.0,201.0,0,0,0.0,0.0,0.0
90028078.0,17,27,12943,27,12943,3462618.3846153845,501.0,479.3703703703704,0,0,0.0,0.0,0.0
206116.0,6,3,426,2,280,0.0,214.0,140.0,1,146,0.0,146.0,146.0
108111336.0,17,5,1005,5,1005,27027834.0,201.0,201.0,0,0,0.0,0.0,0.0
104687.0,17,2,286,2,286,0.0,143.0,143.0,0,0,0.0,0.0,0.0
38649.0,6,14,4740,7,653,5841.0,249.0,93.28571428571428,7,4087,6290.166666666667,1514.0,583.8571428571429
22834.0,6,14,4740,7,653,3531.333333333333,249.0,93.28571428571428,7,4087,3669.3333333333335,1514.0,583.8571428571429
132114.0,6,3,337,2,214,0.0,160.0,107.0,1,123,0.0,123.0,123.0
121660.0,6,3,337,2,214,0.0,160.0,107.0,1,123,0.0,123.0,123.0
228384.0,17,2,180,1,90,0.0,90.0,90.0,1,90,0.0,90.0,90.0
314006.0,6,3,1604,1,753,0.0,753.0,753.0,2,851,0.0,785.0,425.5
118442391.0,6,48,3942,27,2187,4547170.269230769,123.0,81.0,21,1755,5911326.1,123.0,83.57142857142857
35176.0,6,14,4740,7,653,5717.833333333333,249.0,93.28571428571428,7,4087,4864.0,1514.0,583.8571428571429
1681052.0,17,18,1260,18,1260,98885.41176470587,70.0,70.0,0,0,0.0,0.0,0.0
135137872.0,17,6,1146,6,1146,27027574.4,191.0,191.0,0,0,0.0,0.0,0.0
232890.0,6,3,373,2,238,0.0,172.0,119.0,1,135,0.0,135.0,135.0
34693.0,6,10,2032,5,524,8359.0,252.0,104.8,5,1508,8232.75,1236.0,301.6
118357395.0,6,34,2350,17,1225,7383844.375,139.0,72.05882352941177,17,1125,7383845.5,123.0,66.17647058823529
426218.0,6,3,1604,1,753,0.0,753.0,753.0,2,851,0.0,785.0,425.5
90291059.0,6,16,1192,8,596,12892796.57142857,95.0,74.5,8,596,12897239.285714284,95.0,74.5
146286.0,6,3,337,2,214,0.0,160.0,107.0,1,123,0.0,123.0,123.0
2589588.0,6,2,132,1,66,0.0,66.0,66.0,1,66,0.0,66.0,66.0
10412.0,17,2,582,1,83,0.0,83.0,83.0,1,499,0.0,499.0,499.0
1586.0,17,2,762,2,762,0.0,381.0,381.0,0,0,0.0,0.0,0.0
1299164.0,6,4,264,2,132,0.0,66.0,66.0,2,132,0.0,66.0,66.0
280323.0,17,2,363,1,79,0.0,79.0,79.0,1,284,0.0,284.0,284.0
314556.0,6,6,412,4,272,104852.0,74.0,68.0,2,140,0.0,74.0,70.0
107179.0,17,2,286,2,286,0.0,143.0,143.0,0,0,0.0,0.0,0.0
2414.0,17,4,344,2,150,0.0,75.0,75.0,2,194,0.0,103.0,97.0
3362887.0,6,167,124901,91,115243,37365.41111111111,1510.0,1266.4065934065934,76,9658,40696.17333333333,1510.0,127.07894736842104
117274589.0,6,261,29834,131,8942,902112.223076923,140.0,68.25954198473282,130,20892,901046.3255813952,300.0,160.7076923076923
860360.0,6,9,1270,6,799,172072.0,461.0,133.16666666666666,3,471,292337.5,331.0,157.0
2153821.0,6,19,6869,11,1567,215382.1,408.0,142.45454545454547,8,5302,244446.7142857143,1514.0,662.75
90289045.0,6,19,1436,10,745,10027607.666666666,95.0,74.5,9,691,11285516.25,95.0,76.77777777777777
308548.0,17,4,1400,4,1400,102849.33333333331,350.0,350.0,0,0,0.0,0.0,0.0
68.0,6,2,169,0,0,0.0,0.0,0.0,2,169,0.0,103.0,84.5
211349.0,17,2,180,1,90,0.0,90.0,90.0,1,90,0.0,90.0,90.0
218020.0,6,3,426,2,280,0.0,214.0,140.0,1,146,0.0,146.0,146.0
28164.0,6,10,2032,5,524,6810.75,252.0,104.8,5,1508,6462.0,1236.0,301.6
153608.0,17,2,180,1,90,0.0,90.0,90.0,1,90,0.0,90.0,90.0
144835.0,17,2,180,1,70,0.0,70.0,70.0,1,110,0.0,110.0,110.0
44723.0,6,14,4740,7,653,6825.166666666667,249.0,93.28571428571428,7,4087,6719.333333333333,1514.0,583.8571428571429
38809.0,6,12,1413,6,816,7364.4,291.0,136.0,6,597,6504.2,259.0,99.5
91770143.0,6,161,18162,81,5568,1147126.7875,140.0,68.74074074074075,80,12594,1148490.1392405063,284.0,157.425
307248.0,6,6,412,4,272,102416.0,74.0,68.0,2,140,0.0,74.0,70.0
311331.0,17,4,1524,4,1524,103777.0,381.0,381.0,0,0,0.0,0.0,0.0
41771.0,6,13,1479,7,882,6848.333333333333,291.0,126.0,6,597,6526.6,259.0,99.5
120131246.0,6,13,2020,9,1204,15016405.75,188.0,133.77777777777777,4,816,30030149.0,204.0,204.0
1244648.0,6,7,499,3,198,614780.0,66.0,66.0,4,301,380980.0,103.0,75.25
89877.0,6,10,1065,5,534,21920.75,262.0,106.8,5,531,3554.25,259.0,106.2
146283.0,6,3,337,2,214,0.0,160.0,107.0,1,123,0.0,123.0,123.0
10502624.0,6,7,478,4,272,3455710.333333333,74.0,68.0,3,206,5183449.5,74.0,68.66666666666667
258924.0,6,2,132,1,66,0.0,66.0,66.0,1,66,0.0,66.0,66.0
27510.0,6,14,4740,7,653,4459.333333333333,249.0,93.28571428571428,7,4087,4444.833333333333,1514.0,583.8571428571429
135139057.0,17,6,1206,6,1206,27027811.4,201.0,201.0,0,0,0.0,0.0,0.0
205880.0,17,2,180,1,90,0.0,90.0,90.0,1,90,0.0,90.0,90.0
153443.0,17,2,180,1,90,0.0,90.0,90.0,1,90,0.0,90.0,90.0
138359.0,6,2,132,1,66,0.0,66.0,66.0,1,66,0.0,66.0,66.0
2301.0,17,4,344,2,150,0.0,75.0,75.0,2,194,0.0,103.0,97.0
24685.0,6,14,4740,7,653,3915.5,249.0,93.28571428571428,7,4087,3590.833333333333,1514.0,583.8571428571429
299896.0,6,6,412,4,272,99965.33333333331,74.0,68.0,2,140,0.0,74.0,70.0
120161587.0,6,242,27310,121,8282,994461.25,140.0,68.44628099173553,121,19028,994507.7083333334,284.0,157.25619834710744
108109315.0,17,5,955,5,955,27027328.75,191.0,191.0,0,0,0.0,0.0,0.0
90061202.0,17,28,13364,28,13364,3335600.074074074,501.0,477.2857142857143,0,0,0.0,0.0,0.0
13409.0,6,10,2032,5,524,2647.75,252.0,104.8,5,1508,3110.5,1236.0,301.6
90776454.0,6,17,1287,9,691,11341256.625,95.0,76.77777777777777,8,596,12965268.857142856,95.0,74.5
2298.0,17,4,344,2,150,0.0,75.0,75.0,2,194,0.0,103.0,97.0
574628.0,6,4,508,2,238,0.0,172.0,119.0,2,270,0.0,135.0,135.0
61980.0,6,10,2032,5,524,15191.5,252.0,104.8,5,1508,15177.0,1236.0,301.6
14054521.0,17,6,2052,6,2052,2810904.2,342.0,342.0,0,0,0.0,0.0,0.0
105602.0,17,2,700,2,700,0.0,350.0,350.0,0,0,0.0,0.0,0.0
103279.0,17,2,286,2,286,0.0,143.0,143.0,0,0,0.0,0.0,0.0
42591.0,6,14,4740,7,653,6933.333333333333,249.0,93.28571428571428,7,4087,6549.166666666667,1514.0,583.8571428571429
146186.0,6,3,337,2,214,0.0,160.0,107.0,1,123,0.0,123.0,123.0
43307.0,6,14,4740,7,653,6928.5,249.0,93.28571428571428,7,4087,6988.833333333333,1514.0,583.8571428571429
0.0,17,1,72,1,72,0.0,72.0,72.0,0,0,0.0,0.0,0.0
123610531.0,6,49,3234,25,1650,5150438.791666667,66.0,66.0,24,1584,5169250.782608695,66.0,66.0
160439.0,6,3,337,2,214,0.0,160.0,107.0,1,123,0.0,123.0,123.0
1512.0,17,2,192,1,88,0.0,88.0,88.0,1,104,0.0,104.0,104.0
34114.0,6,14,4740,7,653,4405.666666666667,249.0,93.28571428571428,7,4087,5387.666666666667,1514.0,583.8571428571429
120303996.0,6,240,27386,120,8154,1004031.512605042,140.0,67.95,120,19232,1004166.2941176472,284.0,160.26666666666668
2354.0,17,4,344,2,150,0.0,75.0,75.0,2,194,0.0,103.0,97.0
1468224.0,17,16,1120,16,1120,97881.6,70.0,70.0,0,0,0.0,0.0,0.0
32681320.0,6,5,336,2,134,0.0,68.0,67.0,3,202,14950893.0,70.0,67.33333333333333
106083.0,17,2,700,2,700,0.0,350.0,350.0,0,0,0.0,0.0,0.0
100288.0,17,2,762,2,762,0.0,381.0,381.0,0,0,0.0,0.0,0.0
9300.0,17,4,823,2,163,0.0,89.0,81.5,2,660,0.0,443.0,330.0
120437170.0,6,225,25484,113,17870,1075331.875,284.0,158.141592920354,112,7614,1075770.954954955,140.0,67.98214285714286
166788.0,17,2,180,1,90,0.0,90.0,90.0,1,90,0.0,90.0,90.0
10883793.0,6,8,544,4,272,3580724.0,74.0,68.0,4,272,3580632.333333333,74.0,68.0
312.0,17,2,174,1,79,0.0,79.0,79.0,1,95,0.0,95.0,95.0
108099249.0,17,5,1005,5,1005,27024812.25,201.0,201.0,0,0,0.0,0.0,0.0
30903.0,6,14,4740,7,653,4959.5,249.0,93.28571428571428,7,4087,4754.833333333333,1514.0,583.8571428571429
39848965.0,6,5,336,2,134,0.0,68.0,67.0,3,202,19857137.5,70.0,67.33333333333333
232240.0,6,2,132,1,66,0.0,66.0,66.0,1,66,0.0,66.0,66.0
15930.0,6,10,1067,5,536,3822.25,264.0,107.2,5,531,3702.25,259.0,106.2
108106903.0,17,5,1005,5,1005,27026725.75,201.0,201.0,0,0,0.0,0.0,0.0
15768.0,6,14,4740,7,653,2506.333333333333,249.0,93.28571428571428,7,4087,2495.5,1514.0,583.8571428571429
102001001.0,17,13,821,7,432,17000166.833333332,174.0,61.71428571428572,6,389,16600773.6,174.0,64.83333333333333
104782127.0,6,44,2904,22,1452,4989625.095238095,66.0,66.0,22,1452,4974889.19047619,66.0,66.0
92790714.0,6,40,2640,20,1320,4883721.7894736845,66.0,66.0,20,1320,4872342.684210527,66.0,66.0
1056483.0,6,3,1604,1,753,0.0,753.0,753.0,2,851,0.0,785.0,425.5
14940.0,17,2,180,1,90,0.0,90.0,90.0,1,90,0.0,90.0,90.0
123455973.0,6,48,3168,24,1584,5095011.782608695,66.0,66.0,24,1584,5172825.478260869,66.0,66.0
119961514.0,6,34,3461,17,1754,7482001.375,360.0,103.17647058823528,17,1707,7487500.75,425.0,100.41176470588236
120469222.0,6,21,1585,11,840,9043351.2,95.0,76.36363636363636,10,745,13379836.777777778,95.0,74.5
0.0,17,1,453,1,453,0.0,453.0,453.0,0,0,0.0,0.0,0.0
23361.0,6,10,2032,5,524,5626.5,252.0,104.8,5,1508,5470.5,1236.0,301.6
228307.0,17,2,180,1,90,0.0,90.0,90.0,1,90,0.0,90.0,90.0
18088.0,6,10,2032,5,524,4251.75,252.0,104.8,5,1508,3416.25,1236.0,301.6
15954.0,6,10,2032,5,524,3780.5,252.0,104.8,5,1508,3597.75,1236.0,301.6
297950.0,6,6,412,4,272,99316.66666666669,74.0,68.0,2,140,0.0,74.0,70.0
16881.0,6,10,1067,5,536,3317.25,264.0,107.2,5,531,3503.25,259.0,106.2
19673.0,6,14,4740,7,653,2976.6666666666665,249.0,93.28571428571428,7,4087,2974.6666666666665,1514.0,583.8571428571429
99649155.0,17,12,778,6,389,19917441.2,174.0,64.83333333333333,6,389,19898045.6,174.0,64.83333333333333
324900.0,17,4,1400,4,1400,108300.0,350.0,350.0,0,0,0.0,0.0,0.0
338087.0,17,2,180,1,90,0.0,90.0,90.0,1,90,0.0,90.0,90.0
90342905.0,6,16,1192,8,596,12899473.714285716,95.0,74.5,8,596,12904978.57142857,95.0,74.5
90004809.0,17,27,12943,27,12943,3461723.423076923,501.0,479.3703703703704,0,0,0.0,0.0,0.0
3235121.0,6,147,130731,92,122799,35550.78021978022,1510.0,1334.7717391304348,55,7932,54312.16666666666,1510.0,144.21818181818182
68798.0,6,14,4740,7,653,11339.166666666666,249.0,93.28571428571428,7,4087,11068.166666666666,1514.0,583.8571428571429
209544.0,17,2,180,1,90,0.0,90.0,90.0,1,90,0.0,90.0,90.0
209427.0,6,3,426,2,280,0.0,214.0,140.0,1,146,0.0,146.0,146.0
47601004.0,6,7,1874,3,887,22628783.0,753.0,295.6666666666667,4,987,15011880.666666666,785.0,246.75
16041187.999999998,17,6,2052,6,2052,3208237.6,342.0,342.0,0,0,0.0,0.0,0.0
305816.0,17,4,704,2,148,0.0,74.0,74.0,2,556,0.0,280.0,278.0
135138865.0,17,6,1206,6,1206,27027773.0,201.0,201.0,0,0,0.0,0.0,0.0
153506.0,17,2,180,1,90,0.0,90.0,90.0,1,90,0.0,90.0,90.0
2590674.0,6,2,132,1,66,0.0,66.0,66.0,1,66,0.0,66.0,66.0
500188.0,6,5,336,2,134,0.0,68.0,67.0,3,202,196347.0,70.0,67.33333333333333
309800.0,6,6,412,4,272,103266.66666666669,74.0,68.0,2,140,0.0,74.0,70.0
104974.0,17,2,762,2,762,0.0,381.0,381.0,0,0,0.0,0.0,0.0
153644.0,17,2,180,1,90,0.0,90.0,90.0,1,90,0.0,90.0,90.0
108105031.0,17,5,1005,5,1005,27026257.75,201.0,201.0,0,0,0.0,0.0,0.0
108105384.0,17,5,955,5,955,27026346.0,191.0,191.0,0,0,0.0,0.0,0.0
312509.0,17,2,180,1,90,0.0,90.0,90.0,1,90,0.0,90.0,90.0
2703.0,17,4,344,2,150,0.0,75.0,75.0,2,194,0.0,103.0,97.0
300021.0,6,6,412,4,272,100007.0,74.0,68.0,2,140,0.0,74.0,70.0
7414763.0,6,16,1131,8,586,1057849.2857142857,95.0,73.25,8,545,951942.0,95.0,68.125
9082.0,17,2,582,1,83,0.0,83.0,83.0,1,499,0.0,499.0,499.0
105675.0,17,2,700,2,700,0.0,350.0,350.0,0,0,0.0,0.0,0.0
41189081.0,6,26,7627,14,3735,177526.0,1514.0,266.7857142857143,12,3892,3725851.8181818174,1514.0,324.3333333333333
45508.0,6,14,4740,7,653,6523.5,249.0,93.28571428571428,7,4087,7440.666666666667,1514.0,583.8571428571429
315465.0,17,4,1400,4,1400,105155.0,350.0,350.0,0,0,0.0,0.0,0.0
100543.0,6,10,2032,5,524,24905.25,252.0,104.8,5,1508,23668.5,1236.0,301.6
135129173.0,17,6,1146,6,1146,27025834.6,191.0,191.0,0,0,0.0,0.0,0.0
19969.0,6,10,2032,5,524,4533.75,252.0,104.8,5,1508,4297.0,1236.0,301.6
317254.0,17,4,1400,4,1400,105751.33333333331,350.0,350.0,0,0,0.0,0.0,0.0
133548484.0,17,15,1038,8,606,19078354.85714286,174.0,75.75,7,432,19166834.0,174.0,61.71428571428572
3725.0,17,4,344,2,150,0.0,75.0,75.0,2,194,0.0,103.0,97.0
90278731.0,6,16,1192,8,596,12890623.142857144,95.0,74.5,8,596,12895428.857142856,95.0,74.5
2802560.0,6,2,132,1,66,0.0,66.0,66.0,1,66,0.0,66.0,66.0
1303199.0,6,4,264,2,132,0.0,66.0,66.0,2,132,0.0,66.0,66.0
120117122.0,6,13,2020,9,1204,15014640.25,188.0,133.77777777777777,4,816,30028820.33333333,204.0,204.0
9977.0,17,4,823,2,163,0.0,89.0,81.5,2,660,0.0,443.0,330.0
37574.0,6,14,4740,7,653,6141.666666666667,249.0,93.28571428571428,7,4087,6099.166666666667,1514.0,583.8571428571429
302461.0,6,2,132,1,66,0.0,66.0,66.0,1,66,0.0,66.0,66.0
46940.0,6,14,4740,7,653,7349.666666666667,249.0,93.28571428571428,7,4087,7588.333333333333,1514.0,583.8571428571429
7887.999999999999,17,4,704,2,148,0.0,74.0,74.0,2,556,0.0,280.0,278.0
90054056.0,17,27,12943,27,12943,3463617.5384615385,501.0,479.3703703703704,0,0,0.0,0.0,0.0
90046895.0,17,28,13364,28,13364,3335070.185185185,501.0,477.2857142857143,0,0,0.0,0.0,0.0
101113863.0,17,12,778,6,389,19973608.0,174.0,64.83333333333333,6,389,20190986.6,174.0,64.83333333333333
0.0,17,1,44,1,44,0.0,44.0,44.0,0,0,0.0,0.0,0.0
2276.0,17,4,344,2,150,0.0,75.0,75.0,2,194,0.0,103.0,97.0
24915.0,6,14,4740,7,653,3865.1666666666665,249.0,93.28571428571428,7,4087,4016.6666666666665,1514.0,583.8571428571429
228365.0,17,2,180,1,90,0.0,90.0,90.0,1,90,0.0,90.0,90.0
135132355.0,17,6,1206,6,1206,27026471.0,201.0,201.0,0,0,0.0,0.0,0.0
299747.0,6,6,412,4,272,99915.66666666669,74.0,68.0,2,140,0.0,74.0,70.0
3166109.0,6,18,1495,9,921,358135.625,315.0,102.33333333333331,9,574,358114.875,78.0,63.77777777777778
35935.0,6,14,4740,7,653,5805.833333333333,249.0,93.28571428571428,7,4087,5666.666666666667,1514.0,583.8571428571429
73983.0,6,14,4740,7,653,11336.833333333334,249.0,93.28571428571428,7,4087,12049.166666666666,1514.0,583.8571428571429
216281.0,17,2,180,1,90,0.0,90.0,90.0,1,90,0.0,90.0,90.0
135124541.0,17,6,1206,6,1206,27024908.2,201.0,201.0,0,0,0.0,0.0,0.0
300951.0,6,6,412,4,272,100317.0,74.0,68.0,2,140,0.0,74.0,70.0
433.0,17,2,166,1,75,0.0,75.0,75.0,1,91,0.0,91.0,91.0
213745.0,17,2,180,1,90,0.0,90.0,90.0,1,90,0.0,90.0,90.0
11447.0,6,11,1133,6,602,2289.4,264.0,100.33333333333331,5,531,2250.25,259.0,106.2
121431724.0,6,23,1775,12,935,8308971.454545454,95.0,77.91666666666667,11,840,12138825.4,95.0,76.36363636363636
365065.0,6,11,1021,6,444,49151.8,162.0,74.0,5,577,60852.75,349.0,115.4
153539.0,17,2,180,1,90,0.0,90.0,90.0,1,90,0.0,90.0,90.0
121325.0,6,3,337,2,214,0.0,160.0,107.0,1,123,0.0,123.0,123.0
153439.0,17,2,180,1,90,0.0,90.0,90.0,1,90,0.0,90.0,90.0
308104.0,6,6,412,4,272,102701.33333333331,74.0,68.0,2,140,0.0,74.0,70.0
575701.0,6,4,508,2,238,0.0,172.0,119.0,2,270,0.0,135.0,135.0
48528.0,6,14,4740,7,653,7629.833333333333,249.0,93.28571428571428,7,4087,7188.666666666667,1514.0,583.8571428571429
120128050.0,6,17,2852,9,1836,15016006.25,204.0,204.0,8,1016,17098527.42857143,188.0,127.0
205708.0,17,2,180,1,90,0.0,90.0,90.0,1,90,0.0,90.0,90.0
1173439.0,6,13,3008,8,2380,167634.14285714287,1514.0,297.5,5,628,224424.75,331.0,125.6
228279.0,17,2,180,1,90,0.0,90.0,90.0,1,90,0.0,90.0,90.0
1483932.0,17,16,1120,16,1120,98928.8,70.0,70.0,0,0,0.0,0.0,0.0
106955.0,17,2,286,2,286,0.0,143.0,143.0,0,0,0.0,0.0,0.0
90038846.0,17,28,13364,28,13364,3334772.074074074,501.0,477.2857142857143,0,0,0.0,0.0,0.0
878260.0,6,10,1334,6,797,175652.0,459.0,132.83333333333334,4,537,200754.0,331.0,134.25
27562.0,6,10,2032,5,524,6545.75,252.0,104.8,5,1508,6512.0,1236.0,301.6
6297.0,17,4,823,2,163,0.0,89.0,81.5,2,660,0.0,443.0,330.0
39552.0,6,10,2032,5,524,9661.0,252.0,104.8,5,1508,9194.25,1236.0,301.6
90303676.0,6,21,1585,11,840,9026104.2,95.0,76.36363636363636,10,745,10001699.666666666,95.0,74.5
2399.0,17,4,344,2,150,0.0,75.0,75.0,2,194,0.0,103.0,97.0
204755.0,17,2,762,2,762,0.0,381.0,381.0,0,0,0.0,0.0,0.0
115156844.0,6,48,3168,24,1584,5006819.304347826,66.0,66.0,24,1584,4993551.956521739,66.0,66.0
306571.0,6,6,412,4,272,102190.33333333331,74.0,68.0,2,140,0.0,74.0,70.0
2372.0,17,4,344,2,150,0.0,75.0,75.0,2,194,0.0,103.0,97.0
14909201.0,17,8,2800,8,2800,2129885.8571428573,350.0,350.0,0,0,0.0,0.0,0.0
300320.0,6,6,412,4,272,100106.66666666669,74.0,68.0,2,140,0.0,74.0,70.0
121423.0,6,3,337,2,214,0.0,160.0,107.0,1,123,0.0,123.0,123.0
46591.0,6,14,4740,7,653,7580.333333333333,249.0,93.28571428571428,7,4087,6097.333333333333,1514.0,583.8571428571429
90053686.0,17,27,12943,27,12943,3463603.3076923075,501.0,479.3703703703704,0,0,0.0,0.0,0.0
297960.0,6,6,412,4,272,99320.0,74.0,68.0,2,140,0.0,74.0,70.0
28430.0,6,10,2032,5,524,6364.0,252.0,104.8,5,1508,6298.25,1236.0,301.6
103247.0,17,2,286,2,286,0.0,143.0,143.0,0,0,0.0,0.0,0.0
104969535.0,17,14,864,7,432,17494922.5,174.0,61.71428571428572,7,432,17452510.166666668,174.0,61.71428571428572
306997.0,6,6,412,4,272,102332.33333333331,74.0,68.0,2,140,0.0,74.0,70.0
59627935.0,17,9,3086,8,2736,5215797.142857143,342.0,342.0,1,350,0.0,350.0,350.0
204228.0,17,2,762,2,762,0.0,381.0,381.0,0,0,0.0,0.0,0.0
298411.0,6,6,412,4,272,99470.33333333331,74.0,68.0,2,140,0.0,74.0,70.0
54636.0,6,13,1394,7,797,9106.0,253.0,113.85714285714286,6,597,9805.0,259.0,99.5
219654.0,6,3,426,2,280,0.0,214.0,140.0,1,146,0.0,146.0,146.0
108108008.0,17,5,955,5,955,27027002.0,191.0,191.0,0,0,0.0,0.0,0.0
120330379.0,6,231,26224,116,18338,1046351.1217391304,284.0,158.08620689655172,115,7886,1046426.8596491228,140.0,68.57391304347826
217795.0,6,3,426,2,280,0.0,214.0,140.0,1,146,0.0,146.0,146.0
105877.0,17,2,286,2,286,0.0,143.0,143.0,0,0,0.0,0.0,0.0
18656.0,6,14,4740,7,653,2570.833333333333,249.0,93.28571428571428,7,4087,2635.833333333333,1514.0,583.8571428571429
33995.0,6,14,4740,7,653,5402.5,249.0,93.28571428571428,7,4087,5478.666666666667,1514.0,583.8571428571429
113241170.0,6,29,1920,15,1026,8088655.0,123.0,68.4,14,894,7926139.923076923,123.0,63.85714285714285
391.0,17,2,410,1,78,0.0,78.0,78.0,1,332,0.0,332.0,332.0
316865.0,17,4,1400,4,1400,105621.66666666669,350.0,350.0,0,0,0.0,0.0,0.0
3008767.0,6,12,2172,7,664,501357.1666666667,252.0,94.85714285714286,5,1508,2550.0,1236.0,301.6
384.0,17,2,208,1,72,0.0,72.0,72.0,1,136,0.0,136.0,136.0
107242688.0,6,36,2596,18,1348,6296367.176470588,139.0,74.88888888888889,18,1248,6296367.470588235,123.0,69.33333333333333
301145.0,6,6,412,4,272,100381.66666666669,74.0,68.0,2,140,0.0,74.0,70.0
2595660.0,6,2,132,1,66,0.0,66.0,66.0,1,66,0.0,66.0,66.0
46331.0,6,14,4740,7,653,6942.666666666667,249.0,93.28571428571428,7,4087,7410.166666666667,1514.0,583.8571428571429
1807.0,17,2,192,1,88,0.0,88.0,88.0,1,104,0.0,104.0,104.0
144816.0,17,2,180,1,70,0.0,70.0,70.0,1,110,0.0,110.0,110.0
8443486.0,17,3,1034,2,684,0.0,342.0,342.0,1,350,0.0,350.0,350.0
120064242.0,17,29,13785,29,13785,4288008.642857143,501.0,475.3448275862069,0,0,0.0,0.0,0.0
26423.0,6,10,2032,5,524,6162.0,252.0,104.8,5,1508,4698.75,1236.0,301.6
236668.0,6,3,337,2,214,0.0,160.0,107.0,1,123,0.0,123.0,123.0
153500.0,17,2,180,1,90,0.0,90.0,90.0,1,90,0.0,90.0,90.0
228161.0,17,2,180,1,90,0.0,90.0,90.0,1,90,0.0,90.0,90.0
205878.0,17,2,180,1,90,0.0,90.0,90.0,1,90,0.0,90.0,90.0
217748.0,6,12,1373,7,714,36291.333333333336,298.0,102.0,5,659,53596.0,379.0,131.8
2449.0,17,4,344,2,150,0.0,75.0,75.0,2,194,0.0,103.0,97.0
33924.0,6,10,2032,5,524,8242.25,252.0,104.8,5,1508,7807.25,1236.0,301.6
367916.0,6,11,1021,6,444,49956.4,162.0,74.0,5,577,62118.25,349.0,115.4
2323.0,17,4,344,2,150,0.0,75.0,75.0,2,194,0.0,103.0,97.0
153415.0,17,2,180,1,90,0.0,90.0,90.0,1,90,0.0,90.0,90.0
26277.0,6,14,4740,7,653,4220.333333333333,249.0,93.28571428571428,7,4087,4000.5,1514.0,583.8571428571429
299716.0,6,6,412,4,272,99905.33333333331,74.0,68.0,2,140,0.0,74.0,70.0
52699.0,6,14,4740,7,653,8656.333333333334,249.0,93.28571428571428,7,4087,6794.333333333333,1514.0,583.8571428571429
91398953.0,6,24,1829,13,989,7614605.25,95.0,76.07692307692308,11,840,9138278.2,95.0,76.36363636363636
321.0,17,2,166,1,75,0.0,75.0,75.0,1,91,0.0,91.0,91.0
49220.0,6,14,4740,7,653,7737.166666666667,249.0,93.28571428571428,7,4087,5003.166666666667,1514.0,583.8571428571429
2799033.0,6,2,132,1,66,0.0,66.0,66.0,1,66,0.0,66.0,66.0
120129646.0,6,13,2036,5,1020,30032411.5,204.0,204.0,8,1016,17136886.285714287,188.0,127.0
321348.0,17,4,1400,4,1400,107116.0,350.0,350.0,0,0,0.0,0.0,0.0
297371.0,6,6,412,4,272,99123.66666666669,74.0,68.0,2,140,0.0,74.0,70.0
235152.0,6,3,337,2,214,0.0,160.0,107.0,1,123,0.0,123.0,123.0
4241.0,17,2,626,1,72,0.0,72.0,72.0,1,554,0.0,554.0,554.0
3289157.0,6,3,1604,1,753,0.0,753.0,753.0,2,851,0.0,785.0,425.5
90041580.0,17,27,12943,27,12943,3463137.6923076925,501.0,479.3703703703704,0,0,0.0,0.0,0.0
1302538.0,6,4,264,2,132,0.0,66.0,66.0,2,132,0.0,66.0,66.0
16717.0,6,14,4740,7,653,2363.833333333333,249.0,93.28571428571428,7,4087,2645.0,1514.0,583.8571428571429
2106.0,17,4,344,2,150,0.0,75.0,75.0,2,194,0.0,103.0,97.0
1304811.0,6,4,264,2,132,0.0,66.0,66.0,2,132,0.0,66.0,66.0
44155.0,6,10,2032,5,524,10381.0,252.0,104.8,5,1508,10392.75,1236.0,301.6
117343357.0,6,191,21604,96,6632,1235193.2315789473,140.0,69.08333333333333,95,14972,1237383.7765957448,284.0,157.6
21539.0,17,2,582,1,83,0.0,83.0,83.0,1,499,0.0,499.0,499.0
135132758.0,17,6,1206,6,1206,27026551.6,201.0,201.0,0,0,0.0,0.0,0.0
6609.0,17,2,565,1,93,0.0,93.0,93.0,1,472,0.0,472.0,472.0
110940278.0,6,30,1990,15,1042,7908893.714285715,139.0,69.46666666666667,15,948,7908889.857142857,123.0,63.2
75695.0,6,12,1320,6,723,11092.2,253.0,120.5,6,597,14888.6,259.0,99.5
18946.0,6,20,7606,11,978,1894.6,310.0,88.9090909090909,9,6628,2078.0,1514.0,736.4444444444445
109105.0,17,2,286,2,286,0.0,143.0,143.0,0,0,0.0,0.0,0.0
188478.0,17,2,180,1,90,0.0,90.0,90.0,1,90,0.0,90.0,90.0
153547.0,17,2,180,1,90,0.0,90.0,90.0,1,90,0.0,90.0,90.0
306830.0,6,3,202,2,128,0.0,74.0,64.0,1,74,0.0,74.0,74.0
336344.0,17,4,704,2,148,0.0,74.0,74.0,2,556,0.0,280.0,278.0
120319100.0,6,234,26416,117,7944,1030018.8448275862,140.0,67.8974358974359,117,18472,1030093.9568965518,284.0,157.8803418803419
300112.0,6,6,412,4,272,100037.33333333331,74.0,68.0,2,140,0.0,74.0,70.0
18313.0,6,14,4740,7,653,2272.5,249.0,93.28571428571428,7,4087,2921.833333333333,1514.0,583.8571428571429
847831.0,6,9,1096,6,625,169566.2,287.0,104.16666666666669,3,471,286247.5,331.0,157.0
2372.0,17,4,344,2,150,0.0,75.0,75.0,2,194,0.0,103.0,97.0
170012.0,6,10,1066,5,490,38931.5,218.0,98.0,5,576,40576.0,304.0,115.2
207609.0,6,3,426,2,280,0.0,214.0,140.0,1,146,0.0,146.0,146.0
120000350.0,6,17,1287,9,691,15000043.75,95.0,76.77777777777777,8,596,12897405.714285716,95.0,74.5
28413.0,6,14,4740,7,653,2663.6666666666665,249.0,93.28571428571428,7,4087,4323.0,1514.0,583.8571428571429
19075.0,6,14,4740,7,653,3068.6666666666665,249.0,93.28571428571428,7,4087,2995.6666666666665,1514.0,583.8571428571429
208896.0,17,2,180,1,90,0.0,90.0,90.0,1,90,0.0,90.0,90.0
233335.0,6,3,337,2,214,0.0,160.0,107.0,1,123,0.0,123.0,123.0
45097.0,6,10,2032,5,524,10832.75,252.0,104.8,5,1508,10689.5,1236.0,301.6
2284402.0,6,3,1777,2,951,0.0,885.0,475.5,1,826,0.0,826.0,826.0
2205070.0,6,2,132,1,66,0.0,66.0,66.0,1,66,0.0,66.0,66.0
416124.0,6,3,1604,2,851,0.0,785.0,425.5,1,753,0.0,753.0,753.0
42391.0,6,14,4740,7,653,6445.333333333333,249.0,93.28571428571428,7,4087,6869.833333333333,1514.0,583.8571428571429
1304122.0,6,4,264,2,132,0.0,66.0,66.0,2,132,0.0,66.0,66.0
2474.0,17,2,762,2,762,0.0,381.0,381.0,0,0,0.0,0.0,0.0
283149.0,17,2,180,1,90,0.0,90.0,90.0,1,90,0.0,90.0,90.0
135129812.0,17,6,1146,6,1146,27025962.4,191.0,191.0,0,0,0.0,0.0,0.0
162206.0,17,2,180,1,90,0.0,90.0,90.0,1,90,0.0,90.0,90.0
213585.0,17,2,180,1,90,0.0,90.0,90.0,1,90,0.0,90.0,90.0
153418.0,17,2,180,1,90,0.0,90.0,90.0,1,90,0.0,90.0,90.0
219675.0,6,3,426,2,280,0.0,214.0,140.0,1,146,0.0,146.0,146.0
108100245.0,17,5,955,5,955,27025061.25,191.0,191.0,0,0,0.0,0.0,0.0
38621808.0,6,5,336,2,134,0.0,68.0,67.0,3,202,19238854.5,70.0,67.33333333333333
302383.0,6,2,132,1,66,0.0,66.0,66.0,1,66,0.0,66.0,66.0
120007742.0,17,15,907,7,432,16680255.0,174.0,61.71428571428572,8,475,17143000.57142857,174.0,59.375
1922.0,17,2,192,1,88,0.0,88.0,88.0,1,104,0.0,104.0,104.0
220815.0,17,2,414,1,88,0.0,88.0,88.0,1,326,0.0,326.0,326.0
307432.0,6,6,412,4,272,102477.33333333331,74.0,68.0,2,140,0.0,74.0,70.0
40786.0,6,10,2032,5,524,7982.25,252.0,104.8,5,1508,9202.25,1236.0,301.6
143861.0,17,2,180,1,90,0.0,90.0,90.0,1,90,0.0,90.0,90.0
218187.0,6,3,426,2,280,0.0,214.0,140.0,1,146,0.0,146.0,146.0
144193.0,17,2,180,1,90,0.0,90.0,90.0,1,90,0.0,90.0,90.0
113251785.0,6,46,3036,23,1518,5135437.7727272725,66.0,66.0,23,1518,5135438.954545454,66.0,66.0
203017.0,17,4,6056,4,6056,67672.33333333333,1514.0,1514.0,0,0,0.0,0.0,0.0
135133524.0,17,6,1146,6,1146,27026704.8,191.0,191.0,0,0,0.0,0.0,0.0
135127996.0,17,6,1206,6,1206,27025599.2,201.0,201.0,0,0,0.0,0.0,0.0
205706.0,17,2,180,1,90,0.0,90.0,90.0,1,90,0.0,90.0,90.0
2784082.0,6,2,132,1,66,0.0,66.0,66.0,1,66,0.0,66.0,66.0
230365.0,6,13,1386,7,789,38394.16666666666,253.0,112.71428571428572,6,597,44455.0,259.0,99.5
220524.0,17,2,180,1,90,0.0,90.0,90.0,1,90,0.0,90.0,90.0
148064.0,17,2,180,1,90,0.0,90.0,90.0,1,90,0.0,90.0,90.0
1028641.0,6,11,1134,6,558,205728.2,220.0,93.0,5,576,255202.75,304.0,115.2
272929.0,17,4,6056,4,6056,90976.33333333331,1514.0,1514.0,0,0,0.0,0.0,0.0
155133.0,6,3,337,2,214,0.0,160.0,107.0,1,123,0.0,123.0,123.0
50594.0,6,14,4740,7,653,8262.5,249.0,93.28571428571428,7,4087,8293.5,1514.0,583.8571428571429
690.0,17,2,762,2,762,0.0,381.0,381.0,0,0,0.0,0.0,0.0
4434.0,17,2,598,1,72,0.0,72.0,72.0,1,526,0.0,526.0,526.0
13947581.0,17,6,2052,6,2052,2789516.2,342.0,342.0,0,0,0.0,0.0,0.0
2791.0,17,4,344,2,150,0.0,75.0,75.0,2,194,0.0,103.0,97.0
219592.0,6,3,426,2,280,0.0,214.0,140.0,1,146,0.0,146.0,146.0
129996.0,6,2,132,1,66,0.0,66.0,66.0,1,66,0.0,66.0,66.0
308799.0,6,6,412,4,272,102933.0,74.0,68.0,2,140,0.0,74.0,70.0
361.0,17,2,174,1,79,0.0,79.0,79.0,1,95,0.0,95.0,95.0
1221220.0,6,13,3010,8,2382,174460.0,1514.0,297.75,5,628,236498.25,331.0,125.6
844307.0,6,9,1118,6,586,168861.4,248.0,97.66666666666669,3,532,284331.5,392.0,177.33333333333334
27865.0,6,10,2032,5,524,6194.25,252.0,104.8,5,1508,6697.25,1236.0,301.6
52532.0,6,11,2098,6,590,9876.8,252.0,98.33333333333331,5,1508,12519.0,1236.0,301.6
233615.0,6,3,373,2,238,0.0,172.0,119.0,1,135,0.0,135.0,135.0
2923554.0,6,3,1604,2,851,0.0,785.0,425.5,1,753,0.0,753.0,753.0
27833.0,6,11,2098,6,590,5240.6,252.0,98.33333333333331,5,1508,6601.0,1236.0,301.6
90293506.0,6,27,1885,14,963,6945618.076923077,123.0,68.78571428571429,13,922,7524356.083333333,139.0,70.92307692307692
16832.0,17,2,180,1,90,0.0,90.0,90.0,1,90,0.0,90.0,90.0
99393918.0,17,12,778,6,389,19878783.6,174.0,64.83333333333333,6,389,19835388.8,174.0,64.83333333333333
2649.0,17,4,344,2,150,0.0,75.0,75.0,2,194,0.0,103.0,97.0
135134214.0,17,6,1146,6,1146,27026842.8,191.0,191.0,0,0,0.0,0.0,0.0
120018280.0,17,28,13364,28,13364,4445121.481481481,501.0,477.2857142857143,0,0,0.0,0.0,0.0
25524.0,6,10,2032,5,524,6163.0,252.0,104.8,5,1508,6074.75,1236.0,301.6
118234622.0,17,16,1212,8,606,16857288.714285713,174.0,75.75,8,606,16858283.85714286,174.0,75.75
39899.0,6,10,2032,5,524,9194.0,252.0,104.8,5,1508,9418.5,1236.0,301.6
1395826.0,17,16,1120,16,1120,93055.06666666668,70.0,70.0,0,0,0.0,0.0,0.0
1046344.0,6,13,1386,7,789,174390.66666666666,253.0,112.71428571428572,6,597,206520.6,259.0,99.5
206871.0,6,3,426,2,280,0.0,214.0,140.0,1,146,0.0,146.0,146.0
299.0,17,2,164,1,82,0.0,82.0,82.0,1,82,0.0,82.0,82.0
17357.0,6,11,2098,6,590,3359.0,252.0,98.33333333333331,5,1508,4078.0,1236.0,301.6
308.0,17,2,164,1,82,0.0,82.0,82.0,1,82,0.0,82.0,82.0
231375.0,17,2,180,1,90,0.0,90.0,90.0,1,90,0.0,90.0,90.0
120082997.0,6,373,43712,187,31140,645607.5107526882,464.0,166.524064171123,186,12572,643543.0432432432,140.0,67.59139784946237
113733971.0,6,46,3036,23,1518,5155440.590909091,66.0,66.0,23,1518,5155444.227272728,66.0,66.0
316021.0,17,4,1400,4,1400,105340.33333333331,350.0,350.0,0,0,0.0,0.0,0.0
2438.0,17,4,344,2,150,0.0,75.0,75.0,2,194,0.0,103.0,97.0
108104076.0,17,5,955,5,955,27026019.0,191.0,191.0,0,0,0.0,0.0,0.0
751.0,17,4,438,2,148,0.0,74.0,74.0,2,290,0.0,147.0,145.0
120128144.0,6,14,2240,8,1016,17137605.714285713,188.0,127.0,6,1224,18018500.6,204.0,204.0
44480.0,6,10,2032,5,524,9861.75,252.0,104.8,5,1508,10951.5,1236.0,301.6
2258.0,17,4,344,2,150,0.0,75.0,75.0,2,194,0.0,103.0,97.0
410.0,17,2,410,1,78,0.0,78.0,78.0,1,332,0.0,332.0,332.0
41313.0,6,14,4740,7,653,6425.833333333333,249.0,93.28571428571428,7,4087,5422.166666666667,1514.0,583.8571428571429
108116515.0,17,5,955,5,955,27029128.75,191.0,191.0,0,0,0.0,0.0,0.0
33911.0,6,10,2032,5,524,8074.5,252.0,104.8,5,1508,7998.25,1236.0,301.6
0.0,6,1,172,1,172,0.0,172.0,172.0,0,0,0.0,0.0,0.0
114444789.0,17,14,864,7,432,19047647.0,174.0,61.71428571428572,7,432,18987939.0,174.0,61.71428571428572
313934.0,17,4,704,2,148,0.0,74.0,74.0,2,556,0.0,280.0,278.0
32995.0,6,10,2032,5,524,7820.75,252.0,104.8,5,1508,7990.75,1236.0,301.6
135127674.0,17,6,1146,6,1146,27025534.8,191.0,191.0,0,0,0.0,0.0,0.0
301362.0,6,6,412,4,272,100454.0,74.0,68.0,2,140,0.0,74.0,70.0
310101.0,6,6,412,4,272,103367.0,74.0,68.0,2,140,0.0,74.0,70.0
428380.0,6,3,204,2,136,0.0,70.0,68.0,1,68,0.0,68.0,68.0
17443927.0,6,24,8683,13,1719,1453660.5833333333,408.0,132.23076923076923,11,6964,1331968.8,1514.0,633.0909090909091
207719.0,6,10,1221,6,636,41543.8,298.0,106.0,4,585,68058.66666666667,379.0,146.25
2781096.0,6,2,132,1,66,0.0,66.0,66.0,1,66,0.0,66.0,66.0
97322106.0,17,13,1083,6,520,15600143.6,174.0,86.66666666666667,7,563,16167506.166666666,174.0,80.42857142857143
51529.0,6,11,1131,6,600,9706.0,262.0,100.0,5,531,10130.25,259.0,106.2
90022026.0,17,28,13364,28,13364,3334149.111111111,501.0,477.2857142857143,0,0,0.0,0.0,0.0
34037.0,6,10,2032,5,524,5919.75,252.0,104.8,5,1508,7831.5,1236.0,301.6
107217.0,6,13,1386,7,789,17869.5,253.0,112.71428571428572,6,597,18999.6,259.0,99.5
309774.0,17,4,1400,4,1400,103258.0,350.0,350.0,0,0,0.0,0.0,0.0
11381.0,17,2,150,2,150,0.0,75.0,75.0,0,0,0.0,0.0,0.0
208436.0,6,3,426,2,280,0.0,214.0,140.0,1,146,0.0,146.0,146.0
106707.0,17,2,286,2,286,0.0,143.0,143.0,0,0,0.0,0.0,0.0
36858.0,6,14,4740,7,653,5864.0,249.0,93.28571428571428,7,4087,5366.333333333333,1514.0,583.8571428571429
16070.999999999998,6,14,4740,7,653,2569.5,249.0,93.28571428571428,7,4087,2542.6666666666665,1514.0,583.8571428571429
13144.0,6,11,1132,6,556,2415.6,218.0,92.66666666666669,5,576,2498.5,304.0,115.2
16765.0,17,2,180,1,90,0.0,90.0,90.0,1,90,0.0,90.0,90.0
108105078.0,17,5,1005,5,1005,27026269.5,201.0,201.0,0,0,0.0,0.0,0.0
317265.0,17,4,1400,4,1400,105755.0,350.0,350.0,0,0,0.0,0.0,0.0
123305749.0,6,48,3168,24,1584,5075466.869565218,66.0,66.0,24,1584,5221296.391304348,66.0,66.0
148127.0,17,2,180,1,90,0.0,90.0,90.0,1,90,0.0,90.0,90.0
753.0,17,2,508,2,508,0.0,257.0,254.0,0,0,0.0,0.0,0.0
298547.0,6,6,412,4,272,99515.66666666669,74.0,68.0,2,140,0.0,74.0,70.0
120000044.0,6,18,1382,10,786,13333338.222222222,95.0,78.6,8,596,12898086.285714284,95.0,74.5
2361.0,17,4,344,2,150,0.0,75.0,75.0,2,194,0.0,103.0,97.0
13968.0,6,11,2098,6,590,1940.6,252.0,98.33333333333331,5,1508,3101.0,1236.0,301.6
111378660.0,6,212,23958,106,16740,1058795.1333333333,284.0,157.9245283018868,106,7218,1058793.2571428572,140.0,68.09433962264151
99527622.0,6,374,49818,187,37254,533938.0107526882,336.0,199.2192513368984,187,12564,533938.1451612903,140.0,67.18716577540107
0.0,6,1,66,1,66,0.0,66.0,66.0,0,0,0.0,0.0,0.0
120296103.0,6,241,27334,121,19118,1002467.525,284.0,158.0,120,8216,1002300.0924369748,140.0,68.46666666666667
100145259.0,17,14,864,7,432,16668740.333333334,174.0,61.71428571428572,7,432,16666811.333333334,174.0,61.71428571428572
22550.0,6,14,4740,7,653,3582.333333333333,249.0,93.28571428571428,7,4087,3533.6666666666665,1514.0,583.8571428571429
59384.0,6,14,4740,7,653,9340.333333333334,249.0,93.28571428571428,7,4087,8821.666666666666,1514.0,583.8571428571429
2782328.0,6,2,132,1,66,0.0,66.0,66.0,1,66,0.0,66.0,66.0
5867.0,17,2,180,1,90,0.0,90.0,90.0,1,90,0.0,90.0,90.0
344.0,17,2,250,1,93,0.0,93.0,93.0,1,157,0.0,157.0,157.0
1309071.0,6,4,264,2,132,0.0,66.0,66.0,2,132,0.0,66.0,66.0
0.0,17,1,381,1,381,0.0,381.0,381.0,0,0,0.0,0.0,0.0
95022874.0,17,12,778,6,389,19000186.2,174.0,64.83333333333333,6,389,19000796.6,174.0,64.83333333333333
31448.0,6,10,2032,5,524,5592.0,252.0,104.8,5,1508,7577.75,1236.0,301.6
120121017.0,6,15,2428,9,1204,15015127.125,188.0,133.77777777777777,6,1224,18017976.4,204.0,204.0
108105498.0,17,5,955,5,955,27026374.5,191.0,191.0,0,0,0.0,0.0,0.0
2794984.0,6,2,132,1,66,0.0,66.0,66.0,1,66,0.0,66.0,66.0
147953.0,17,2,180,1,90,0.0,90.0,90.0,1,90,0.0,90.0,90.0
146276.0,6,3,337,2,214,0.0,160.0,107.0,1,123,0.0,123.0,123.0
19614.0,6,10,2032,5,524,4464.75,252.0,104.8,5,1508,4533.75,1236.0,301.6
336.0,17,2,166,1,75,0.0,75.0,75.0,1,91,0.0,91.0,91.0
70714.0,6,10,2032,5,524,16184.25,252.0,104.8,5,1508,16679.5,1236.0,301.6
312073.0,6,12,1373,7,714,52012.16666666666,298.0,102.0,5,659,71150.75,379.0,131.8
69561.0,17,2,608,1,75,0.0,75.0,75.0,1,533,0.0,533.0,533.0
113254859.0,6,46,3036,23,1518,5135436.136363637,66.0,66.0,23,1518,5135436.545454546,66.0,66.0
1082810.0,6,13,1386,7,789,180468.3333333333,253.0,112.71428571428572,6,597,215511.6,259.0,99.5
359.0,17,2,267,1,83,0.0,83.0,83.0,1,184,0.0,184.0,184.0
303153.0,6,6,412,4,272,101051.0,74.0,68.0,2,140,0.0,74.0,70.0
120042012.0,6,18,1341,9,691,14999197.5,95.0,76.77777777777777,9,650,15000032.0,95.0,72.22222222222223
26144.0,6,10,2032,5,524,5013.5,252.0,104.8,5,1508,6001.25,1236.0,301.6
116804686.0,6,48,3168,24,1584,5078464.608695652,66.0,66.0,24,1584,5069067.478260869,66.0,66.0
135144337.0,17,6,1146,6,1146,27028867.4,191.0,191.0,0,0,0.0,0.0,0.0
27296194.0,17,5,1710,5,1710,6824048.5,342.0,342.0,0,0,0.0,0.0,0.0
315446.0,6,3,202,2,128,0.0,74.0,64.0,1,74,0.0,74.0,74.0
10523897.0,6,7,478,4,272,3460756.333333333,74.0,68.0,3,206,5191019.0,74.0,68.66666666666667
143882.0,17,2,180,1,90,0.0,90.0,90.0,1,90,0.0,90.0,90.0
120159237.0,6,240,27104,120,8216,1002836.6218487396,140.0,68.46666666666667,120,18888,1002911.4705882352,284.0,157.4
107780.0,17,2,286,2,286,0.0,143.0,143.0,0,0,0.0,0.0,0.0
153471.0,17,2,180,1,90,0.0,90.0,90.0,1,90,0.0,90.0,90.0
12859.0,6,14,4740,7,653,1967.3333333333333,249.0,93.28571428571428,7,4087,2006.5,1514.0,583.8571428571429
883.0,17,4,438,2,148,0.0,74.0,74.0,2,290,0.0,147.0,145.0
120122464.0,6,14,2224,9,1204,15015308.0,188.0,133.77777777777777,5,1020,22522880.0,204.0,204.0
2326.0,17,4,344,2,150,0.0,75.0,75.0,2,194,0.0,103.0,97.0
122071.0,6,3,373,2,238,0.0,172.0,119.0,1,135,0.0,135.0,135.0
102120621.0,17,14,864,7,432,16993618.0,174.0,61.71428571428572,7,432,16923357.333333332,174.0,61.71428571428572
18136.0,6,10,1065,5,534,4068.0,262.0,106.8,5,531,2585.75,259.0,106.2
1044993.0,6,13,1386,7,789,174165.5,253.0,112.71428571428572,6,597,206892.8,259.0,99.5
111263114.0,17,16,1212,8,606,15857285.0,174.0,75.75,8,606,15860574.285714284,174.0,75.75
113714460.0,6,48,3168,24,1584,4944106.956521739,66.0,66.0,24,1584,4932135.478260869,66.0,66.0
62724.0,6,14,4740,7,653,10285.833333333334,249.0,93.28571428571428,7,4087,10284.333333333334,1514.0,583.8571428571429
90268092.0,6,14,1043,7,542,15044682.0,95.0,77.42857142857143,7,501,14996058.0,95.0,71.57142857142857
108108707.0,17,5,955,5,955,27027176.75,191.0,191.0,0,0,0.0,0.0,0.0
321710.0,6,6,412,4,272,107236.66666666669,74.0,68.0,2,140,0.0,74.0,70.0
103053.0,17,2,286,2,286,0.0,143.0,143.0,0,0,0.0,0.0,0.0
18117.0,6,14,4740,7,653,2720.6666666666665,249.0,93.28571428571428,7,4087,2683.5,1514.0,583.8571428571429
156658.0,17,2,180,1,90,0.0,90.0,90.0,1,90,0.0,90.0,90.0
356.0,17,2,267,1,83,0.0,83.0,83.0,1,184,0.0,184.0,184.0
284885.0,17,2,363,1,79,0.0,79.0,79.0,1,284,0.0,284.0,284.0
2367.0,17,4,344,2,150,0.0,75.0,75.0,2,194,0.0,103.0,97.0
26805576.0,17,5,1710,5,1710,6701394.0,342.0,342.0,0,0,0.0,0.0,0.0
2791607.0,6,2,132,1,66,0.0,66.0,66.0,1,66,0.0,66.0,66.0
39026.0,6,11,2098,6,590,7514.2,252.0,98.33333333333331,5,1508,7601.5,1236.0,301.6
301834.0,6,6,412,4,272,100611.33333333331,74.0,68.0,2,140,0.0,74.0,70.0
955372.0,6,13,1493,7,862,159157.16666666666,271.0,123.14285714285714,6,631,190418.4,293.0,105.16666666666669
867085.0,6,9,1096,6,625,173417.0,287.0,104.16666666666669,3,471,295770.0,331.0,157.0
90036977.0,17,28,13364,28,13364,3334702.851851852,501.0,477.2857142857143,0,0,0.0,0.0,0.0
135133518.0,17,6,1146,6,1146,27026703.6,191.0,191.0,0,0,0.0,0.0,0.0
113051413.0,6,48,3168,24,1584,4915278.826086956,66.0,66.0,24,1584,4905882.434782608,66.0,66.0
47690.0,6,14,4740,7,653,7600.0,249.0,93.28571428571428,7,4087,7544.833333333333,1514.0,583.8571428571429
305972.0,6,3,202,2,128,0.0,74.0,64.0,1,74,0.0,74.0,74.0
108113646.0,17,5,955,5,955,27028411.5,191.0,191.0,0,0,0.0,0.0,0.0
228402.0,17,2,180,1,90,0.0,90.0,90.0,1,90,0.0,90.0,90.0
1301527.0,6,4,264,2,132,0.0,66.0,66.0,2,132,0.0,66.0,66.0
847758.0,6,9,1096,6,625,169551.6,287.0,104.16666666666669,3,471,286059.5,331.0,157.0
123839794.0,6,48,3168,24,1584,5138279.695652174,66.0,66.0,24,1584,5159311.782608695,66.0,66.0
6963.0,17,2,582,1,83,0.0,83.0,83.0,1,499,0.0,499.0,499.0
108109419.0,17,5,1005,5,1005,27027354.75,201.0,201.0,0,0,0.0,0.0,0.0
52819.0,6,14,4740,7,653,7298.333333333333,249.0,93.28571428571428,7,4087,8667.833333333334,1514.0,583.8571428571429
14267819.0,17,6,2052,6,2052,2853563.8,342.0,342.0,0,0,0.0,0.0,0.0
209652.0,17,2,180,1,90,0.0,90.0,90.0,1,90,0.0,90.0,90.0
200111.0,17,2,180,1,90,0.0,90.0,90.0,1,90,0.0,90.0,90.0
90292373.0,6,16,1192,8,596,12892943.0,95.0,74.5,8,596,12896687.0,95.0,74.5
4409.0,17,4,344,2,150,0.0,75.0,75.0,2,194,0.0,103.0,97.0
49250.0,6,14,4740,7,653,7311.166666666667,249.0,93.28571428571428,7,4087,7964.5,1514.0,583.8571428571429
90283282.0,6,15,1097,8,596,12897611.714285716,95.0,74.5,7,501,15000015.5,95.0,71.57142857142857
2029452.0,17,4,525,2,150,0.0,75.0,75.0,2,375,0.0,284.0,187.5
107085.0,17,2,286,2,286,0.0,143.0,143.0,0,0,0.0,0.0,0.0
2326.0,17,4,344,2,150,0.0,75.0,75.0,2,194,0.0,103.0,97.0
105067374.0,6,44,2904,22,1452,5003208.285714285,66.0,66.0,22,1452,4987459.476190476,66.0,66.0
143971.0,17,2,180,1,90,0.0,90.0,90.0,1,90,0.0,90.0,90.0
2530.0,17,4,344,2,150,0.0,75.0,75.0,2,194,0.0,103.0,97.0
20925.0,6,11,2098,6,590,3548.4,252.0,98.33333333333331,5,1508,5013.5,1236.0,301.6
502105.0,6,5,336,2,134,0.0,68.0,67.0,3,202,193017.5,70.0,67.33333333333333
9596.0,17,2,571,1,86,0.0,86.0,86.0,1,485,0.0,485.0,485.0
301952.0,6,6,412,4,272,100650.66666666669,74.0,68.0,2,140,0.0,74.0,70.0
129664138.0,6,33,2280,16,1071,7978458.2,123.0,66.9375,17,1209,7479803.875,123.0,71.11764705882354
135132016.0,17,6,1206,6,1206,27026403.2,201.0,201.0,0,0,0.0,0.0,0.0
39779.0,6,14,4740,7,653,6148.666666666667,249.0,93.28571428571428,7,4087,6225.333333333333,1514.0,583.8571428571429
104001225.0,17,13,821,7,432,17333537.5,174.0,61.71428571428572,6,389,16800888.2,174.0,64.83333333333333
353.0,17,2,248,1,84,0.0,84.0,84.0,1,164,0.0,164.0,164.0
1306933.0,6,4,264,2,132,0.0,66.0,66.0,2,132,0.0,66.0,66.0
108549.0,17,2,286,2,286,0.0,143.0,143.0,0,0,0.0,0.0,0.0
17639.0,6,14,4740,7,653,2693.6666666666665,249.0,93.28571428571428,7,4087,2496.833333333333,1514.0,583.8571428571429
119475827.0,6,217,24596,109,17172,1106257.6574074074,284.0,157.54128440366972,108,7424,1106988.4672897195,140.0,68.74074074074075
145077.0,17,2,180,1,70,0.0,70.0,70.0,1,110,0.0,110.0,110.0
143177.0,17,4,344,2,150,0.0,75.0,75.0,2,194,0.0,103.0,97.0
315519.0,17,4,1400,4,1400,105173.0,350.0,350.0,0,0,0.0,0.0,0.0
303062.0,6,6,412,4,272,101020.66666666669,74.0,68.0,2,140,0.0,74.0,70.0
90010785.0,6,15,1097,8,596,12858683.57142857,95.0,74.5,7,501,14952833.833333334,95.0,71.57142857142857
123001153.0,17,15,907,8,475,17571593.285714287,174.0,59.375,7,432,17167396.5,174.0,61.71428571428572
9007449.0,17,2,160,2,160,0.0,80.0,80.0,0,0,0.0,0.0,0.0
160317.0,6,2,128,1,74,0.0,74.0,74.0,1,54,0.0,54.0,54.0
111054157.0,6,194,21854,97,6698,1148086.7291666667,140.0,69.05154639175258,97,15156,1148292.4375,284.0,156.24742268041237
90257123.0,6,14,1964,8,1016,12893874.714285716,188.0,127.0,6,948,18018702.0,204.0,158.0
6259.0,17,2,447,1,84,0.0,84.0,84.0,1,363,0.0,363.0,363.0
4427.0,17,2,602,1,72,0.0,72.0,72.0,1,530,0.0,530.0,530.0
120124230.0,6,13,2080,9,1284,15015528.75,204.0,142.66666666666666,4,796,30031012.0,199.0,199.0
186168.0,6,2,132,1,66,0.0,66.0,66.0,1,66,0.0,66.0,66.0
170431.0,6,11,1132,6,556,33844.2,218.0,92.66666666666669,5,576,42375.75,304.0,115.2
108104055.0,17,5,1005,5,1005,27026013.75,201.0,201.0,0,0,0.0,0.0,0.0
241404.0,6,3,337,2,214,0.0,160.0,107.0,1,123,0.0,123.0,123.0
139323.0,6,2,132,1,66,0.0,66.0,66.0,1,66,0.0,66.0,66.0
1709456.0,6,23,6509,12,1529,155405.0909090909,357.0,127.41666666666669,11,4980,140679.1,1510.0,452.7272727272728
103634.0,17,2,286,2,286,0.0,143.0,143.0,0,0,0.0,0.0,0.0
646018.0,6,4,508,2,238,0.0,172.0,119.0,2,270,0.0,135.0,135.0
123693024.0,17,14,1126,7,563,17333500.333333332,174.0,80.42857142857143,7,563,17334648.333333332,174.0,80.42857142857143
32552.0,6,14,4740,7,653,4685.5,249.0,93.28571428571428,7,4087,4558.833333333333,1514.0,583.8571428571429
2970155.0,6,12,2172,7,664,494867.0,252.0,94.85714285714286,5,1508,3017.25,1236.0,301.6
297958.0,6,6,412,4,272,99319.33333333331,74.0,68.0,2,140,0.0,74.0,70.0
2309665.0,6,3,1777,2,951,0.0,885.0,475.5,1,826,0.0,826.0,826.0
10472926.0,6,7,478,4,272,3443877.0,74.0,68.0,3,206,5165678.5,74.0,68.66666666666667
112899582.0,6,30,1974,15,1026,8048826.714285715,123.0,68.4,15,948,8048821.642857143,123.0,63.2
182453.0,17,4,1524,4,1524,60817.66666666666,381.0,381.0,0,0,0.0,0.0,0.0
90047311.0,17,28,13364,28,13364,3335085.592592593,501.0,477.2857142857143,0,0,0.0,0.0,0.0
1165005.0,6,13,3008,8,2380,166429.2857142857,1514.0,297.5,5,628,223100.75,331.0,125.6
3396.0,17,2,414,1,88,0.0,88.0,88.0,1,326,0.0,326.0,326.0
90008887.0,17,28,13364,28,13364,3333662.4814814813,501.0,477.2857142857143,0,0,0.0,0.0,0.0
91172630.0,17,12,778,6,389,18200228.8,174.0,64.83333333333333,6,389,18201603.0,174.0,64.83333333333333
135136941.0,17,6,1146,6,1146,27027388.2,191.0,191.0,0,0,0.0,0.0,0.0
108128360.0,17,5,1005,5,1005,27032090.0,201.0,201.0,0,0,0.0,0.0,0.0
3155373.0,6,18,1495,9,921,357356.375,315.0,102.33333333333331,9,574,357328.125,78.0,63.77777777777778
2528370.0,6,51,23848,26,19851,101134.8,1514.0,763.5,25,3997,95835.58333333331,1514.0,159.88
196958.0,17,2,180,1,90,0.0,90.0,90.0,1,90,0.0,90.0,90.0
2501.0,17,4,344,2,150,0.0,75.0,75.0,2,194,0.0,103.0,97.0
317926.0,17,4,1400,4,1400,105975.33333333331,350.0,350.0,0,0,0.0,0.0,0.0
218534.0,6,3,426,2,280,0.0,214.0,140.0,1,146,0.0,146.0,146.0
1181766.0,6,13,3010,8,2382,168823.7142857143,1514.0,297.75,5,628,226489.5,331.0,125.6
90037377.0,17,28,13364,28,13364,3334717.6666666665,501.0,477.2857142857143,0,0,0.0,0.0,0.0
2877529.0,6,12,2172,7,664,479472.3333333333,252.0,94.85714285714286,5,1508,1877.75,1236.0,301.6
0.0,17,1,381,1,381,0.0,381.0,381.0,0,0,0.0,0.0,0.0
301633.0,6,6,412,4,272,100544.33333333331,74.0,68.0,2,140,0.0,74.0,70.0
34253.0,6,14,4740,7,653,5593.166666666667,249.0,93.28571428571428,7,4087,5456.5,1514.0,583.8571428571429
221341.0,17,2,414,1,88,0.0,88.0,88.0,1,326,0.0,326.0,326.0
212891.0,6,10,1221,6,636,42578.2,298.0,106.0,4,585,69013.66666666667,379.0,146.25
115072710.0,6,48,3168,24,1584,5003161.304347826,66.0,66.0,24,1584,4989706.0,66.0,66.0
326023.0,6,6,412,4,272,108674.33333333331,74.0,68.0,2,140,0.0,74.0,70.0
143937.0,17,2,180,1,90,0.0,90.0,90.0,1,90,0.0,90.0,90.0
249385.0,6,3,337,2,214,0.0,160.0,107.0,1,123,0.0,123.0,123.0
2807319.0,6,2,132,1,66,0.0,66.0,66.0,1,66,0.0,66.0,66.0
0.0,6,1,66,1,66,0.0,66.0,66.0,0,0,0.0,0.0,0.0
103436.0,17,2,286,2,286,0.0,143.0,143.0,0,0,0.0,0.0,0.0
81318.0,6,14,4740,7,653,13430.666666666666,249.0,93.28571428571428,7,4087,12270.166666666666,1514.0,583.8571428571429
250402.0,6,3,337,2,214,0.0,160.0,107.0,1,123,0.0,123.0,123.0
310990.0,17,4,1400,4,1400,103663.33333333331,350.0,350.0,0,0,0.0,0.0,0.0
103711.0,6,11,2098,6,590,20009.8,252.0,98.33333333333331,5,1508,25237.5,1236.0,301.6
18746.0,6,14,4740,7,653,2998.0,249.0,93.28571428571428,7,4087,3002.6666666666665,1514.0,583.8571428571429
121310.0,6,3,337,2,214,0.0,160.0,107.0,1,123,0.0,123.0,123.0
206290.0,6,3,426,2,280,0.0,214.0,140.0,1,146,0.0,146.0,146.0
503794.0,6,5,336,2,134,0.0,68.0,67.0,3,202,191353.0,70.0,67.33333333333333
98105999.0,17,12,778,6,389,19600196.4,174.0,64.83333333333333,6,389,19600968.2,174.0,64.83333333333333
91903670.0,6,24,1829,13,989,7657609.333333333,95.0,76.07692307692308,11,840,9189758.0,95.0,76.36363636363636
2418.0,17,4,344,2,150,0.0,75.0,75.0,2,194,0.0,103.0,97.0
14542.0,6,10,2032,5,524,3267.75,252.0,104.8,5,1508,3439.0,1236.0,301.6
2357.0,17,4,344,2,150,0.0,75.0,75.0,2,194,0.0,103.0,97.0
35335.0,6,10,2032,5,524,8190.25,252.0,104.8,5,1508,8563.5,1236.0,301.6
5828635.0,6,5,336,2,134,0.0,68.0,67.0,3,202,1524790.0,70.0,67.33333333333333
340.0,17,2,160,1,80,0.0,80.0,80.0,1,80,0.0,80.0,80.0
118171461.0,6,48,3168,24,1584,5137889.608695652,66.0,66.0,24,1584,5124837.826086956,66.0,66.0
115596443.0,6,48,3168,24,1584,5025932.304347826,66.0,66.0,24,1584,5016535.0869565215,66.0,66.0
299293.0,6,6,412,4,272,99764.33333333331,74.0,68.0,2,140,0.0,74.0,70.0
108112543.0,17,5,955,5,955,27028135.75,191.0,191.0,0,0,0.0,0.0,0.0
246432.0,6,3,337,2,214,0.0,160.0,107.0,1,123,0.0,123.0,123.0
28120430.0,6,544,512515,147,9869,192605.68493150684,213.0,67.1360544217687,397,502646,71000.11363636363,1514.0,1266.110831234257
206994.0,6,3,426,2,280,0.0,214.0,140.0,1,146,0.0,146.0,146.0
241586.0,17,4,1524,4,1524,80528.66666666667,381.0,381.0,0,0,0.0,0.0,0.0
156081.0,6,3,337,2,214,0.0,160.0,107.0,1,123,0.0,123.0,123.0
115611494.0,17,16,1212,8,606,16428747.285714284,174.0,75.75,8,606,16429597.285714284,174.0,75.75
3585195.0,6,11,1134,6,558,717039.0,220.0,93.0,5,576,895002.5,304.0,115.2
304.0,17,2,168,1,76,0.0,76.0,76.0,1,92,0.0,92.0,92.0
302826.0,17,2,180,1,90,0.0,90.0,90.0,1,90,0.0,90.0,90.0
1046737.0,6,10,1221,6,636,209347.4,298.0,106.0,4,585,347723.6666666667,379.0,146.25
51776.0,6,10,2032,5,524,12618.25,252.0,104.8,5,1508,12255.75,1236.0,301.6
64343.0,6,14,4740,7,653,10138.0,249.0,93.28571428571428,7,4087,10535.0,1514.0,583.8571428571429
41012.0,6,14,4740,7,653,6009.0,249.0,93.28571428571428,7,4087,6325.333333333333,1514.0,583.8571428571429
23463.0,6,14,4740,7,653,3788.8333333333335,249.0,93.28571428571428,7,4087,3769.5,1514.0,583.8571428571429
364832.0,6,3,1604,2,851,0.0,785.0,425.5,1,753,0.0,753.0,753.0
94883865.0,6,28,2403,15,1299,6776913.571428572,256.0,86.6,13,1104,7906197.0,210.0,84.92307692307692
983084.0,17,6,1230,3,234,491350.5,78.0,78.0,3,996,491337.5,332.0,332.0
408617.0,6,3,1604,1,753,0.0,753.0,753.0,2,851,0.0,785.0,425.5
1032451.0,6,11,1134,6,558,206490.2,220.0,93.0,5,576,255846.75,304.0,115.2
2580972.0,6,147,120410,83,112341,27744.182926829268,1510.0,1353.5060240963855,64,8069,36108.60317460317,1510.0,126.078125
99465.0,17,2,762,2,762,0.0,381.0,381.0,0,0,0.0,0.0,0.0
153443.0,17,2,180,1,90,0.0,90.0,90.0,1,90,0.0,90.0,90.0
90789838.0,6,18,1341,9,691,11348729.75,95.0,76.77777777777777,9,650,11306252.25,95.0,72.22222222222223
315279.0,6,12,1373,7,714,52546.5,298.0,102.0,5,659,74108.25,379.0,131.8
2021601.0,17,4,525,2,150,0.0,75.0,75.0,2,375,0.0,284.0,187.5
206493.0,17,2,180,1,90,0.0,90.0,90.0,1,90,0.0,90.0,90.0
307729.0,6,6,412,4,272,102576.33333333331,74.0,68.0,2,140,0.0,74.0,70.0
90044622.0,17,28,13364,28,13364,3334986.0,501.0,477.2857142857143,0,0,0.0,0.0,0.0
103162.0,17,2,286,2,286,0.0,143.0,143.0,0,0,0.0,0.0,0.0
144631.0,6,2,132,1,66,0.0,66.0,66.0,1,66,0.0,66.0,66.0
101179093.0,17,14,1126,7,563,16833487.833333332,174.0,80.42857142857143,7,563,16834666.0,174.0,80.42857142857143
29281.0,6,14,4740,7,653,4505.5,249.0,93.28571428571428,7,4087,4045.1666666666665,1514.0,583.8571428571429
104942935.0,17,14,1126,7,563,17463995.833333332,174.0,80.42857142857143,7,563,17243237.833333332,174.0,80.42857142857143
228481.0,17,2,180,1,90,0.0,90.0,90.0,1,90,0.0,90.0,90.0
219686.0,6,3,426,2,280,0.0,214.0,140.0,1,146,0.0,146.0,146.0
15593.0,17,2,582,1,83,0.0,83.0,83.0,1,499,0.0,499.0,499.0
12080.0,6,13,1459,7,862,2013.3333333333333,271.0,123.14285714285714,6,597,2118.6,259.0,99.5
97415328.0,17,14,1126,7,563,16166798.333333334,174.0,80.42857142857143,7,563,16167960.833333334,174.0,80.42857142857143
318090.0,17,4,1400,4,1400,106030.0,350.0,350.0,0,0,0.0,0.0,0.0
143929.0,17,2,180,1,90,0.0,90.0,90.0,1,90,0.0,90.0,90.0
216341.0,17,2,180,1,90,0.0,90.0,90.0,1,90,0.0,90.0,90.0
218001.0,6,3,426,2,280,0.0,214.0,140.0,1,146,0.0,146.0,146.0
5684.0,17,4,344,2,150,0.0,75.0,75.0,2,194,0.0,103.0,97.0
270134.0,6,10,1221,6,636,54026.8,298.0,106.0,4,585,84635.33333333333,379.0,146.25
1048161.0,6,13,1394,7,797,174693.5,253.0,113.85714285714286,6,597,207725.8,259.0,99.5
147924.0,17,2,180,1,90,0.0,90.0,90.0,1,90,0.0,90.0,90.0
97675173.0,6,27,1816,14,894,7513474.846153846,123.0,63.85714285714285,13,922,7824101.0,139.0,70.92307692307692
114382285.0,6,48,3168,24,1584,4973142.826086956,66.0,66.0,24,1584,4961165.434782608,66.0,66.0
105212064.0,6,29,2068,15,1105,7499739.071428572,139.0,73.66666666666667,14,963,8076641.769230769,123.0,68.78571428571429
19844.0,6,11,2098,6,590,3581.8,252.0,98.33333333333331,5,1508,4706.75,1236.0,301.6
6195013.0,6,111,109501,33,2339,193594.15625,219.0,70.87878787878788,78,107162,80352.79220779221,1514.0,1373.871794871795
121582246.0,6,55,5233,34,3064,3684310.484848485,139.0,90.11764705882354,21,2169,5701285.85,123.0,103.28571428571428
20637.0,6,10,2032,5,524,3396.0,252.0,104.8,5,1508,4655.25,1236.0,301.6
2794991.0,6,2,132,1,66,0.0,66.0,66.0,1,66,0.0,66.0,66.0
8527874.0,17,4,1376,3,1026,949935.5,342.0,342.0,1,350,0.0,350.0,350.0
95993.0,17,4,820,2,156,0.0,78.0,78.0,2,664,0.0,332.0,332.0
3561120.0,6,5,336,2,134,0.0,68.0,67.0,3,202,1525427.0,70.0,67.33333333333333
80513.0,6,14,4740,7,653,12900.333333333334,249.0,93.28571428571428,7,4087,13242.5,1514.0,583.8571428571429
90284388.0,6,17,1287,8,637,12897769.714285716,95.0,79.625,9,650,11249263.875,95.0,72.22222222222223
860312.0,6,10,1335,6,798,172062.4,460.0,133.0,4,537,195915.66666666663,331.0,134.25
1840906.0,17,6,1230,3,234,920268.5,78.0,78.0,3,996,920237.5,332.0,332.0
322775.0,17,4,1400,4,1400,107591.66666666669,350.0,350.0,0,0,0.0,0.0,0.0
105755505.0,6,29,2068,15,1105,7538535.714285715,139.0,73.66666666666667,14,963,8118421.923076923,123.0,68.78571428571429
866116.0,6,9,1267,6,796,173223.2,458.0,132.66666666666666,3,471,296831.0,331.0,157.0
45120847.0,17,9,3086,8,2736,5121820.0,342.0,342.0,1,350,0.0,350.0,350.0
63625.0,6,10,2032,5,524,15641.5,252.0,104.8,5,1508,14559.25,1236.0,301.6
443611.0,6,10,1221,6,636,88722.2,298.0,106.0,4,585,138512.66666666666,379.0,146.25
357.0,17,2,166,1,75,0.0,75.0,75.0,1,91,0.0,91.0,91.0
120006992.0,17,15,1169,8,606,17143856.0,174.0,75.75,7,563,16666804.0,174.0,80.42857142857143
103559.0,17,2,286,2,286,0.0,143.0,143.0,0,0,0.0,0.0,0.0
2845072.0,6,3,1604,2,851,0.0,785.0,425.5,1,753,0.0,753.0,753.0
743215.0,6,2,132,1,66,0.0,66.0,66.0,1,66,0.0,66.0,66.0
117225801.0,6,605,96332,300,20170,392059.53511705686,214.0,67.23333333333333,305,76162,384865.50657894736,1514.0,249.71147540983603
124309109.0,6,33,2280,17,1209,7769319.3125,123.0,71.11764705882354,16,1071,7607258.0,123.0,66.9375
21669.0,6,14,4740,7,653,3195.0,249.0,93.28571428571428,7,4087,3475.5,1514.0,583.8571428571429
118812937.0,6,38,2848,20,1531,6242550.052631579,139.0,76.55,18,1317,6976966.117647059,123.0,73.16666666666667
20350.0,6,2,145,2,145,0.0,91.0,72.5,0,0,0.0,0.0,0.0
508970.00000000006,6,5,336,2,134,0.0,68.0,67.0,3,202,195866.0,70.0,67.33333333333333
143875.0,17,2,180,1,90,0.0,90.0,90.0,1,90,0.0,90.0,90.0
2806589.0,6,2,132,1,66,0.0,66.0,66.0,1,66,0.0,66.0,66.0
120168645.0,6,228,25676,114,7820,1056183.9203539824,140.0,68.59649122807018,114,17856,1056220.353982301,300.0,156.6315789473684
120330070.0,6,231,26166,116,18354,1046348.4347826086,284.0,158.22413793103448,115,7812,1046490.6842105264,140.0,67.9304347826087
121566.0,6,3,337,2,214,0.0,160.0,107.0,1,123,0.0,123.0,123.0
64801.0,6,14,4740,7,653,10667.166666666666,249.0,93.28571428571428,7,4087,10375.666666666666,1514.0,583.8571428571429
90011333.0,17,28,13364,28,13364,3333753.074074074,501.0,477.2857142857143,0,0,0.0,0.0,0.0
40971.0,6,14,4740,7,653,6642.166666666667,249.0,93.28571428571428,7,4087,6633.833333333333,1514.0,583.8571428571429
95504814.0,6,39,2574,20,1320,5010731.0,66.0,66.0,19,1254,5150432.5,66.0,66.0
113251674.0,6,46,3036,23,1518,5135435.909090909,66.0,66.0,23,1518,5135432.818181818,66.0,66.0
92708051.0,6,37,2442,19,1254,5150447.277777778,66.0,66.0,18,1188,5353389.705882353,66.0,66.0
25216.0,6,10,2032,5,524,5746.75,252.0,104.8,5,1508,5815.5,1236.0,301.6
116902908.0,6,48,3168,24,1584,5082735.130434782,66.0,66.0,24,1584,5069312.652173913,66.0,66.0
10461028.0,6,7,478,4,272,3441633.333333333,74.0,68.0,3,206,5162340.5,74.0,68.66666666666667
90285798.0,6,16,1192,8,596,12892190.57142857,95.0,74.5,8,596,12896022.857142856,95.0,74.5
2413.0,17,4,344,2,150,0.0,75.0,75.0,2,194,0.0,103.0,97.0
1227990.0,17,7,490,7,490,204665.0,70.0,70.0,0,0,0.0,0.0,0.0
315936.0,6,3,202,2,128,0.0,74.0,64.0,1,74,0.0,74.0,74.0
113764329.0,6,220,24884,110,17328,1041723.4220183486,284.0,157.52727272727273,110,7556,1041723.6146788992,140.0,68.69090909090909
146409.0,6,3,337,2,214,0.0,160.0,107.0,1,123,0.0,123.0,123.0
155352.0,6,3,337,2,214,0.0,160.0,107.0,1,123,0.0,123.0,123.0
219268.0,6,3,426,2,280,0.0,214.0,140.0,1,146,0.0,146.0,146.0
120000062.0,6,20,1531,11,840,12000006.2,95.0,76.36363636363636,9,691,11340707.625,95.0,76.77777777777777
204785.0,17,4,6056,4,6056,68261.66666666667,1514.0,1514.0,0,0,0.0,0.0,0.0
1171659.0,6,13,3019,8,2391,167379.85714285713,1514.0,298.875,5,628,224773.25,331.0,125.6
215258.0,6,10,1221,6,636,43051.6,298.0,106.0,4,585,69758.0,379.0,146.25
323398.0,17,4,1400,4,1400,107799.33333333331,350.0,350.0,0,0,0.0,0.0,0.0
2591232.0,6,2,132,1,66,0.0,66.0,66.0,1,66,0.0,66.0,66.0
2216105.0,6,23,4355,12,1447,201464.0909090909,311.0,120.58333333333331,11,2908,200962.8,1514.0,264.3636363636364
41434.0,6,14,4740,7,653,6736.666666666667,249.0,93.28571428571428,7,4087,6732.666666666667,1514.0,583.8571428571429
90332363.0,6,16,1192,8,596,12897174.57142857,95.0,74.5,8,596,12903527.57142857,95.0,74.5
254784.0,6,10,1221,6,636,50956.8,298.0,106.0,4,585,79454.66666666667,379.0,146.25
113264785.0,6,46,3036,23,1518,5135892.454545454,66.0,66.0,23,1518,5135896.818181818,66.0,66.0
16312.0,6,10,2032,5,524,3853.0,252.0,104.8,5,1508,3439.25,1236.0,301.6
250450.0,17,4,6056,4,6056,83483.33333333333,1514.0,1514.0,0,0,0.0,0.0,0.0
38634.0,6,10,2032,5,524,8470.75,252.0,104.8,5,1508,8856.75,1236.0,301.6
34859.0,6,10,2032,5,524,7205.75,252.0,104.8,5,1508,7805.0,1236.0,301.6
142886.0,17,4,344,2,150,0.0,75.0,75.0,2,194,0.0,103.0,97.0
232779.0,6,3,337,2,214,0.0,160.0,107.0,1,123,0.0,123.0,123.0
500477.0,6,4,270,2,134,0.0,68.0,67.0,2,136,0.0,70.0,68.0
271179.0,17,2,180,1,90,0.0,90.0,90.0,1,90,0.0,90.0,90.0
1109979.0,6,13,1394,7,797,184996.5,253.0,113.85714285714286,6,597,219781.2,259.0,99.5
2004.0,17,4,344,2,150,0.0,75.0,75.0,2,194,0.0,103.0,97.0
123456201.0,6,49,3234,25,1650,5144008.375,66.0,66.0,24,1584,4958528.739130435,66.0,66.0
3746102.0,6,4,270,2,136,0.0,70.0,68.0,2,134,0.0,68.0,67.0
26633.0,6,10,2032,5,524,4615.5,252.0,104.8,5,1508,4992.5,1236.0,301.6
45106.0,6,14,4740,7,653,6582.0,249.0,93.28571428571428,7,4087,5501.0,1514.0,583.8571428571429
298250.0,6,6,412,4,272,99416.66666666669,74.0,68.0,2,140,0.0,74.0,70.0
352.0,17,2,267,1,83,0.0,83.0,83.0,1,184,0.0,184.0,184.0
204547.0,17,2,762,2,762,0.0,381.0,381.0,0,0,0.0,0.0,0.0
114830378.0,6,48,3168,24,1584,4992625.130434782,66.0,66.0,24,1584,4980643.913043479,66.0,66.0
284543.0,17,2,363,1,79,0.0,79.0,79.0,1,284,0.0,284.0,284.0
2214.0,17,4,344,2,150,0.0,75.0,75.0,2,194,0.0,103.0,97.0
208386.0,6,3,426,2,280,0.0,214.0,140.0,1,146,0.0,146.0,146.0
10511817.0,6,7,478,4,272,3458682.6666666665,74.0,68.0,3,206,5187891.5,74.0,68.66666666666667
108067.0,6,15,4806,8,719,15337.42857142857,249.0,89.875,7,4087,17635.833333333332,1514.0,583.8571428571429
237503.0,6,3,373,2,238,0.0,172.0,119.0,1,135,0.0,135.0,135.0
100548055.0,6,30,2122,15,1105,7166572.357142857,139.0,73.66666666666667,15,1017,7166573.0,123.0,67.8
1771759.0,6,2,132,1,66,0.0,66.0,66.0,1,66,0.0,66.0,66.0
323.0,17,2,166,1,75,0.0,75.0,75.0,1,91,0.0,91.0,91.0
303635.0,6,2,132,1,66,0.0,66.0,66.0,1,66,0.0,66.0,66.0
61191.0,6,11,2098,6,590,12079.2,252.0,98.33333333333331,5,1508,1774.25,1236.0,301.6
18951.0,6,14,4740,7,653,2793.1666666666665,249.0,93.28571428571428,7,4087,2777.1666666666665,1514.0,583.8571428571429
194321.0,17,4,6056,4,6056,64773.66666666666,1514.0,1514.0,0,0,0.0,0.0,0.0
120241824.0,6,228,25718,114,7820,1057308.6194690266,140.0,68.59649122807018,114,17898,1056787.539823009,284.0,157.0
308044.0,6,6,412,4,272,102681.33333333331,74.0,68.0,2,140,0.0,74.0,70.0
335.0,17,2,166,1,75,0.0,75.0,75.0,1,91,0.0,91.0,91.0
40632.0,6,14,4740,7,653,6664.0,249.0,93.28571428571428,7,4087,6113.666666666667,1514.0,583.8571428571429
91387547.0,6,24,1829,13,989,7615166.916666667,95.0,76.07692307692308,11,840,9136285.0,95.0,76.36363636363636
101048172.0,17,14,1126,7,563,16668052.666666666,174.0,80.42857142857143,7,563,16666795.666666666,174.0,80.42857142857143
123456064.0,6,49,3234,25,1650,5144002.666666667,66.0,66.0,24,1584,4951821.173913044,66.0,66.0
216510.0,17,2,180,1,90,0.0,90.0,90.0,1,90,0.0,90.0,90.0
2588197.0,6,2,132,1,66,0.0,66.0,66.0,1,66,0.0,66.0,66.0
303161.0,6,2,132,1,66,0.0,66.0,66.0,1,66,0.0,66.0,66.0
147847.0,17,2,180,1,90,0.0,90.0,90.0,1,90,0.0,90.0,90.0
90532188.0,6,14,2240,8,1016,12933169.714285716,188.0,127.0,6,1224,18073590.6,204.0,204.0
231603.0,6,3,337,2,214,0.0,160.0,107.0,1,123,0.0,123.0,123.0
102324537.0,6,42,2772,21,1386,5105438.15,66.0,66.0,21,1386,5105439.05,66.0,66.0
153471.0,17,2,180,1,90,0.0,90.0,90.0,1,90,0.0,90.0,90.0
2800864.0,6,2,132,1,66,0.0,66.0,66.0,1,66,0.0,66.0,66.0
1166528.0,6,13,3000,8,2372,166646.85714285713,1514.0,296.5,5,628,222666.75,331.0,125.6
314063.0,6,6,412,4,272,104687.66666666669,74.0,68.0,2,140,0.0,74.0,70.0
90258252.0,6,14,2240,8,1016,12894036.0,188.0,127.0,6,1224,18018711.4,204.0,204.0
2162.0,17,4,344,2,150,0.0,75.0,75.0,2,194,0.0,103.0,97.0
1110402.0,6,13,1394,7,797,185067.0,253.0,113.85714285714286,6,597,219241.8,259.0,99.5
148082.0,17,2,180,1,90,0.0,90.0,90.0,1,90,0.0,90.0,90.0
91202139.0,6,25,1924,11,840,9095004.7,95.0,76.36363636363636,14,1084,6998985.615384615,95.0,77.42857142857143
680246.0,6,14,4740,7,653,113127.0,249.0,93.28571428571428,7,4087,113002.83333333331,1514.0,583.8571428571429
123306995.0,6,48,3168,24,1584,4953576.608695652,66.0,66.0,24,1584,5339067.608695652,66.0,66.0
115365548.0,6,48,3168,24,1584,5015893.391304348,66.0,66.0,24,1584,5006497.347826087,66.0,66.0
281522.0,17,2,363,1,79,0.0,79.0,79.0,1,284,0.0,284.0,284.0
1309815.0,6,4,264,2,132,0.0,66.0,66.0,2,132,0.0,66.0,66.0
101021.0,6,14,4740,7,653,15214.833333333334,249.0,93.28571428571428,7,4087,15965.833333333334,1514.0,583.8571428571429
143828.0,17,2,180,1,90,0.0,90.0,90.0,1,90,0.0,90.0,90.0
135139586.0,17,6,1206,6,1206,27027917.2,201.0,201.0,0,0,0.0,0.0,0.0
31775.0,6,10,2032,5,524,7713.0,252.0,104.8,5,1508,6446.25,1236.0,301.6
119996.0,17,2,180,1,70,0.0,70.0,70.0,1,110,0.0,110.0,110.0
110898010.0,6,32,2236,16,1165,7393200.666666667,139.0,72.8125,16,1071,7378370.266666667,123.0,66.9375
327.0,17,2,166,1,75,0.0,75.0,75.0,1,91,0.0,91.0,91.0
1309055.0,6,4,264,2,132,0.0,66.0,66.0,2,132,0.0,66.0,66.0
2292.0,17,4,344,2,150,0.0,75.0,75.0,2,194,0.0,103.0,97.0
0.0,6,1,172,1,172,0.0,172.0,172.0,0,0,0.0,0.0,0.0
46937.0,6,14,4740,7,653,7696.666666666667,249.0,93.28571428571428,7,4087,7643.833333333333,1514.0,583.8571428571429
3050020.0,6,11,2106,6,598,609825.8,252.0,99.66666666666669,5,1508,2268.25,1236.0,301.6
108104162.0,17,5,1005,5,1005,27026040.5,201.0,201.0,0,0,0.0,0.0,0.0
247115.0,17,2,180,1,90,0.0,90.0,90.0,1,90,0.0,90.0,90.0
233052.0,6,3,337,2,214,0.0,160.0,107.0,1,123,0.0,123.0,123.0
295.0,17,2,156,1,78,0.0,78.0,78.0,1,78,0.0,78.0,78.0
325.0,17,2,166,1,75,0.0,75.0,75.0,1,91,0.0,91.0,91.0
40411.0,6,14,4740,7,653,5671.333333333333,249.0,93.28571428571428,7,4087,6590.333333333333,1514.0,583.8571428571429
228100.0,17,2,180,1,90,0.0,90.0,90.0,1,90,0.0,90.0,90.0
237295.0,17,2,180,1,90,0.0,90.0,90.0,1,90,0.0,90.0,90.0
135138530.0,17,6,1206,6,1206,27027706.0,201.0,201.0,0,0,0.0,0.0,0.0
232925.0,6,3,337,2,214,0.0,160.0,107.0,1,123,0.0,123.0,123.0
207626.0,6,3,426,2,280,0.0,214.0,140.0,1,146,0.0,146.0,146.0
2344.0,17,4,344,2,150,0.0,75.0,75.0,2,194,0.0,103.0,97.0
297865.0,6,6,412,4,272,99288.33333333331,74.0,68.0,2,140,0.0,74.0,70.0
1312242.0,6,4,264,2,132,0.0,66.0,66.0,2,132,0.0,66.0,66.0
29571.0,6,14,4740,7,653,4673.166666666667,249.0,93.28571428571428,7,4087,4770.5,1514.0,583.8571428571429
200908.0,17,4,6056,4,6056,66969.33333333333,1514.0,1514.0,0,0,0.0,0.0,0.0
10822898.0,6,7,478,3,206,5343420.0,74.0,68.66666666666667,4,272,3562201.333333333,74.0,68.0
90258851.0,6,12,1832,8,1016,12894121.57142857,188.0,127.0,4,816,30026323.33333333,204.0,204.0
2403.0,17,4,344,2,150,0.0,75.0,75.0,2,194,0.0,103.0,97.0
108104493.0,17,5,955,5,955,27026123.25,191.0,191.0,0,0,0.0,0.0,0.0
307709.0,6,6,412,4,272,102569.66666666669,74.0,68.0,2,140,0.0,74.0,70.0
121402.0,6,3,337,2,214,0.0,160.0,107.0,1,123,0.0,123.0,123.0
19282.0,6,10,2032,5,524,4276.5,252.0,104.8,5,1508,4087.5,1236.0,301.6
299779.0,6,6,412,4,272,99926.33333333331,74.0,68.0,2,140,0.0,74.0,70.0
331.0,17,2,208,1,72,0.0,72.0,72.0,1,136,0.0,136.0,136.0
2662020.0,6,3,204,2,136,0.0,70.0,68.0,1,68,0.0,68.0,68.0
90260172.0,6,13,2036,8,1016,12894310.285714284,188.0,127.0,5,1020,22523373.0,204.0,204.0
23915.0,6,10,2032,5,524,5766.75,252.0,104.8,5,1508,5691.75,1236.0,301.6
90236257.0,6,26,1746,13,906,7501707.25,123.0,69.6923076923077,13,840,7501707.166666667,123.0,64.61538461538461
840360.0,6,9,1096,6,625,168072.0,287.0,104.16666666666669,3,471,283695.5,331.0,157.0
2065.0,17,4,344,2,150,0.0,75.0,75.0,2,194,0.0,103.0,97.0
108098281.0,17,5,955,5,955,27024570.25,191.0,191.0,0,0,0.0,0.0,0.0
231313.0,6,12,1373,7,714,38552.16666666666,298.0,102.0,5,659,55440.5,379.0,131.8
90089824.0,6,10,1440,7,828,15014970.666666666,188.0,118.28571428571428,3,612,30029886.0,204.0,204.0
217892.0,6,3,426,2,280,0.0,214.0,140.0,1,146,0.0,146.0,146.0
719611.0,6,14,4740,7,653,119655.33333333331,249.0,93.28571428571428,7,4087,119571.5,1514.0,583.8571428571429
27886.0,6,14,4740,7,653,4521.333333333333,249.0,93.28571428571428,7,4087,3953.6666666666665,1514.0,583.8571428571429
62580.0,6,14,4740,7,653,10311.0,249.0,93.28571428571428,7,4087,9339.666666666666,1514.0,583.8571428571429
166898.0,6,3,337,2,214,0.0,160.0,107.0,1,123,0.0,123.0,123.0
120003474.0,6,20,1531,11,881,11999996.5,95.0,80.0909090909091,9,650,14941833.625,95.0,72.22222222222223
0.0,6,1,66,1,66,0.0,66.0,66.0,0,0,0.0,0.0,0.0
0.0,6,1,66,1,66,0.0,66.0,66.0,0,0,0.0,0.0,0.0
90010530.0,6,15,1097,8,596,12858647.142857144,95.0,74.5,7,501,14951432.333333334,95.0,71.57142857142857
120203919.0,6,980,219884,499,187250,240940.92570281125,1514.0,375.250501002004,481,32634,249976.27916666667,214.0,67.84615384615384
119555345.0,6,230,25994,115,18182,1046844.3157894736,284.0,158.10434782608695,115,7812,1046836.7280701754,140.0,67.9304347826087
146110.0,6,3,337,2,214,0.0,160.0,107.0,1,123,0.0,123.0,123.0
33002.0,6,10,2032,5,524,8032.0,252.0,104.8,5,1508,6726.25,1236.0,301.6
1700.0,17,2,762,2,762,0.0,381.0,381.0,0,0,0.0,0.0,0.0
406.0,17,2,410,1,78,0.0,78.0,78.0,1,332,0.0,332.0,332.0
299.0,17,2,156,1,78,0.0,78.0,78.0,1,78,0.0,78.0,78.0
4184.0,17,2,538,1,81,0.0,81.0,81.0,1,457,0.0,457.0,457.0
92984347.0,6,39,2574,20,1320,4893913.0,66.0,66.0,19,1254,5160046.611111111,66.0,66.0
90529427.0,6,14,2240,8,1016,12932775.285714284,188.0,127.0,6,1224,18073020.0,204.0,204.0
215050.0,6,10,1221,6,636,43010.0,298.0,106.0,4,585,70648.0,379.0,146.25
437868.0,6,11,1021,6,444,58829.6,162.0,74.0,5,577,73322.75,349.0,115.4
14869.0,6,14,4740,7,653,2208.833333333333,249.0,93.28571428571428,7,4087,2331.0,1514.0,583.8571428571429
56610.0,6,12,1320,7,789,9435.0,253.0,112.71428571428572,5,531,10596.0,259.0,106.2
135138349.0,17,6,1206,6,1206,27027669.8,201.0,201.0,0,0,0.0,0.0,0.0
41089.0,6,10,2032,5,524,10040.75,252.0,104.8,5,1508,8318.75,1236.0,301.6
130651.0,6,3,337,2,214,0.0,160.0,107.0,1,123,0.0,123.0,123.0
135126223.0,17,6,1206,6,1206,27025244.6,201.0,201.0,0,0,0.0,0.0,0.0
90307028.0,6,16,1192,8,596,12893515.0,95.0,74.5,8,596,12899249.42857143,95.0,74.5
55582.0,6,14,4740,7,653,8714.666666666666,249.0,93.28571428571428,7,4087,7494.0,1514.0,583.8571428571429
65054.0,6,14,4740,7,653,10723.5,249.0,93.28571428571428,7,4087,9537.833333333334,1514.0,583.8571428571429
45394.0,6,14,4740,7,653,6516.833333333333,249.0,93.28571428571428,7,4087,6865.5,1514.0,583.8571428571429
14603.0,6,13,1459,7,862,2433.833333333333,271.0,123.14285714285714,6,597,2127.8,259.0,99.5
1090.0,17,2,508,2,508,0.0,257.0,254.0,0,0,0.0,0.0,0.0
141658.0,6,2,132,1,66,0.0,66.0,66.0,1,66,0.0,66.0,66.0
6581.0,17,4,823,2,163,0.0,89.0,81.5,2,660,0.0,443.0,330.0
91911963.0,6,27,2073,15,1138,6564330.428571428,95.0,75.86666666666666,12,935,8354937.363636363,95.0,77.91666666666667
27691942.0,17,5,1710,5,1710,6922985.5,342.0,342.0,0,0,0.0,0.0,0.0
145477.0,6,3,337,2,214,0.0,160.0,107.0,1,123,0.0,123.0,123.0
90004607.0,6,20,1617,11,799,9000460.7,95.0,72.63636363636364,9,818,11213504.25,222.0,90.88888888888889
15626.000000000002,6,14,4740,7,653,2459.1666666666665,249.0,93.28571428571428,7,4087,2408.5,1514.0,583.8571428571429
303655.0,6,2,132,1,66,0.0,66.0,66.0,1,66,0.0,66.0,66.0
2346.0,17,4,344,2,150,0.0,75.0,75.0,2,194,0.0,103.0,97.0
103489.0,17,2,286,2,286,0.0,143.0,143.0,0,0,0.0,0.0,0.0
111749169.0,6,30,1974,15,1026,7966641.357142857,123.0,68.4,15,948,7966642.071428572,123.0,63.2
120011.0,17,2,180,1,70,0.0,70.0,70.0,1,110,0.0,110.0,110.0
12192.0,6,13,1459,7,862,1951.8333333333333,271.0,123.14285714285714,6,597,1894.6,259.0,99.5
10460745.0,6,7,478,4,272,3441369.0,74.0,68.0,3,206,5161925.0,74.0,68.66666666666667
30594.0,6,14,4740,7,653,4717.666666666667,249.0,93.28571428571428,7,4087,4951.666666666667,1514.0,583.8571428571429
197033.0,17,2,180,1,90,0.0,90.0,90.0,1,90,0.0,90.0,90.0
120000111.0,6,20,1490,11,799,12000011.1,95.0,72.63636363636364,9,691,11246277.5,95.0,76.77777777777777
102852321.0,17,14,864,7,432,17001307.666666668,174.0,61.71428571428572,7,432,17000153.0,174.0,61.71428571428572
40498.0,6,14,4740,7,653,5644.666666666667,249.0,93.28571428571428,7,4087,6582.333333333333,1514.0,583.8571428571429
10523006.0,6,7,478,4,272,3462479.0,74.0,68.0,3,206,5192338.0,74.0,68.66666666666667
90043908.0,17,28,13364,28,13364,3334959.5555555555,501.0,477.2857142857143,0,0,0.0,0.0,0.0
1174802.0,6,13,3019,8,2391,167828.85714285713,1514.0,298.875,5,628,224783.5,331.0,125.6
206865.0,6,3,426,2,280,0.0,214.0,140.0,1,146,0.0,146.0,146.0
507824.00000000006,6,4,270,2,134,0.0,68.0,67.0,2,136,0.0,70.0,68.0
204398.0,17,2,180,1,90,0.0,90.0,90.0,1,90,0.0,90.0,90.0
14261.0,6,14,4740,7,653,2206.6666666666665,249.0,93.28571428571428,7,4087,2242.0,1514.0,583.8571428571429
1314772.0,6,4,264,2,132,0.0,66.0,66.0,2,132,0.0,66.0,66.0
135139690.0,17,6,1206,6,1206,27027938.0,201.0,201.0,0,0,0.0,0.0,0.0
45692979.0,17,9,3086,8,2736,5107440.714285715,342.0,342.0,1,350,0.0,350.0,350.0
100542.0,17,2,762,2,762,0.0,381.0,381.0,0,0,0.0,0.0,0.0
111774402.0,6,34,2334,17,1209,6972411.125,123.0,71.11764705882354,17,1125,6972408.5625,123.0,66.17647058823529
29264.0,6,11,2098,6,590,4532.0,252.0,98.33333333333331,5,1508,6732.25,1236.0,301.6
120018933.0,17,28,13364,28,13364,4445145.666666667,501.0,477.2857142857143,0,0,0.0,0.0,0.0
589024.0,17,4,629,3,234,184193.5,78.0,78.0,1,395,0.0,395.0,395.0
108086914.0,17,5,1005,5,1005,27021728.5,201.0,201.0,0,0,0.0,0.0,0.0
242318.0,6,3,337,2,214,0.0,160.0,107.0,1,123,0.0,123.0,123.0
1573424.0,6,20,7599,11,1469,157342.4,583.0,133.54545454545453,9,6130,165000.375,1484.0,681.1111111111111
90262674.0,6,12,1832,8,1016,12894667.714285716,188.0,127.0,4,816,30033049.666666668,204.0,204.0
319861.0,17,4,1400,4,1400,106620.33333333331,350.0,350.0,0,0,0.0,0.0,0.0
90096482.0,6,11,1644,7,828,15016080.333333334,188.0,118.28571428571428,4,816,20021480.33333333,204.0,204.0
31907.0,6,12,1413,6,816,6242.6,291.0,136.0,6,597,5804.2,259.0,99.5
463218.0,6,3,204,2,136,0.0,70.0,68.0,1,68,0.0,68.0,68.0
317.0,17,2,208,1,72,0.0,72.0,72.0,1,136,0.0,136.0,136.0
233156.0,6,3,337,2,214,0.0,160.0,107.0,1,123,0.0,123.0,123.0
44981.0,6,14,4740,7,653,7320.333333333333,249.0,93.28571428571428,7,4087,5696.166666666667,1514.0,583.8571428571429
25733.0,6,14,4740,7,653,3974.0,249.0,93.28571428571428,7,4087,3724.5,1514.0,583.8571428571429
319.0,17,2,174,1,79,0.0,79.0,79.0,1,95,0.0,95.0,95.0
104058.0,17,2,286,2,286,0.0,143.0,143.0,0,0,0.0,0.0,0.0
2452.0,17,4,344,2,150,0.0,75.0,75.0,2,194,0.0,103.0,97.0
35138.0,6,14,4740,7,653,5451.666666666667,249.0,93.28571428571428,7,4087,4459.5,1514.0,583.8571428571429
309795.0,6,6,412,4,272,103265.0,74.0,68.0,2,140,0.0,74.0,70.0
36808.0,6,10,2032,5,524,8369.0,252.0,104.8,5,1508,8553.25,1236.0,301.6
103397213.0,6,30,2106,15,1089,7370103.285714285,123.0,72.6,15,1017,7370102.642857143,123.0,67.8
0.0,6,1,66,1,66,0.0,66.0,66.0,0,0,0.0,0.0,0.0
1029341.0,6,11,1134,6,558,205868.2,220.0,93.0,5,576,255607.5,304.0,115.2
158786.0,6,10,1066,5,490,38080.75,218.0,98.0,5,576,39485.25,304.0,115.2
121230.0,6,3,337,2,214,0.0,160.0,107.0,1,123,0.0,123.0,123.0
35475.0,6,10,2032,5,524,8387.25,252.0,104.8,5,1508,8611.5,1236.0,301.6
5627209.0,6,5,336,2,134,0.0,68.0,67.0,3,202,1474736.0,70.0,67.33333333333333
209563.0,17,2,180,1,90,0.0,90.0,90.0,1,90,0.0,90.0,90.0
90030271.0,17,28,13364,28,13364,3334454.4814814813,501.0,477.2857142857143,0,0,0.0,0.0,0.0
197055.0,17,2,180,1,90,0.0,90.0,90.0,1,90,0.0,90.0,90.0
120291096.0,6,224,25328,112,7688,1072585.4054054054,140.0,68.64285714285714,112,17640,1076256.063063063,284.0,157.5
122314618.0,6,48,3168,24,1584,4927123.869565218,66.0,66.0,24,1584,5280632.739130435,66.0,66.0
250858.00000000003,6,3,337,2,214,0.0,160.0,107.0,1,123,0.0,123.0,123.0
2451807.0,6,3,204,2,136,0.0,70.0,68.0,1,68,0.0,68.0,68.0
284767.0,17,4,704,2,148,0.0,74.0,74.0,2,556,0.0,280.0,278.0
85452.0,6,14,4740,7,653,13870.166666666666,249.0,93.28571428571428,7,4087,13960.166666666666,1514.0,583.8571428571429
2799.0,17,2,762,2,762,0.0,381.0,381.0,0,0,0.0,0.0,0.0
17149.0,6,13,1459,7,862,2524.1666666666665,271.0,123.14285714285714,6,597,3195.4,259.0,99.5
90746719.0,6,17,1287,9,691,11337709.625,95.0,76.77777777777777,8,596,12963091.42857143,95.0,74.5
3025164.0,6,12,2172,7,664,503955.3333333333,252.0,94.85714285714286,5,1508,6205.75,1236.0,301.6
108720.0,17,2,286,2,286,0.0,143.0,143.0,0,0,0.0,0.0,0.0
2361.0,17,4,344,2,150,0.0,75.0,75.0,2,194,0.0,103.0,97.0
316530.0,17,4,571,2,148,0.0,74.0,74.0,2,423,0.0,280.0,211.5
119537944.0,6,25,1883,14,1084,9195038.615384616,95.0,77.42857142857143,11,799,11906693.5,95.0,72.63636363636364
311670.0,17,4,1400,4,1400,103890.0,350.0,350.0,0,0,0.0,0.0,0.0
305984.0,6,6,412,4,272,101994.66666666669,74.0,68.0,2,140,0.0,74.0,70.0
125492241.0,17,14,864,7,432,17667444.5,174.0,61.71428571428572,7,432,17666831.833333332,174.0,61.71428571428572
1000434.0,17,4,820,2,156,0.0,78.0,78.0,2,664,0.0,332.0,332.0
62961.0,6,10,2032,5,524,13342.5,252.0,104.8,5,1508,14683.25,1236.0,301.6
227469.0,17,2,180,1,90,0.0,90.0,90.0,1,90,0.0,90.0,90.0
284461.0,17,2,363,1,79,0.0,79.0,79.0,1,284,0.0,284.0,284.0
28134.0,6,10,2032,5,524,6783.75,252.0,104.8,5,1508,6728.25,1236.0,301.6
206589.0,6,3,426,2,280,0.0,214.0,140.0,1,146,0.0,146.0,146.0
60151.0,6,10,2032,5,524,14755.75,252.0,104.8,5,1508,13127.75,1236.0,301.6
27072.0,6,14,4740,7,653,4382.333333333333,249.0,93.28571428571428,7,4087,4373.666666666667,1514.0,583.8571428571429
249500.0,17,4,6056,4,6056,83166.66666666667,1514.0,1514.0,0,0,0.0,0.0,0.0
232856.0,6,3,337,2,214,0.0,160.0,107.0,1,123,0.0,123.0,123.0
30911.0,6,14,4740,7,653,4978.0,249.0,93.28571428571428,7,4087,4232.5,1514.0,583.8571428571429
2295.0,17,4,344,2,150,0.0,75.0,75.0,2,194,0.0,103.0,97.0
3065097.0,6,3,1604,2,851,0.0,785.0,425.5,1,753,0.0,753.0,753.0
44911.0,6,14,4740,7,653,7280.0,249.0,93.28571428571428,7,4087,7349.0,1514.0,583.8571428571429
90699685.0,6,15,2302,9,1204,11317606.375,188.0,133.77777777777777,6,1098,18107791.8,204.0,183.0
106954.0,17,2,286,2,286,0.0,143.0,143.0,0,0,0.0,0.0,0.0
115778289.0,6,48,3168,24,1584,5033838.652173913,66.0,66.0,24,1584,5024439.695652174,66.0,66.0
2600123.0,6,53,23956,28,19959,96300.85185185184,1514.0,712.8214285714286,25,3997,99272.33333333331,1514.0,159.88
146227.0,6,3,337,2,214,0.0,160.0,107.0,1,123,0.0,123.0,123.0
90293666.0,6,21,1585,11,840,9024162.0,95.0,76.36363636363636,10,745,10000137.222222222,95.0,74.5
135132191.0,17,6,1206,6,1206,27026438.2,201.0,201.0,0,0,0.0,0.0,0.0
204170.0,17,4,6056,4,6056,68056.66666666667,1514.0,1514.0,0,0,0.0,0.0,0.0
90750740.0,6,24,1829,13,989,7558744.083333333,95.0,76.07692307692308,11,840,9046861.1,95.0,76.36363636363636
119585621.0,6,212,23884,106,16666,1136860.1809523809,284.0,157.2264150943396,106,7218,1136861.8,140.0,68.09433962264151
29956.0,6,10,2032,5,524,7186.75,252.0,104.8,5,1508,6819.25,1236.0,301.6
121540248.0,6,221,24896,111,17340,1104911.3454545457,284.0,156.21621621621622,110,7556,1096143.990825688,140.0,68.69090909090909
2257619.0,6,19,6869,10,1501,250846.5555555556,408.0,150.1,9,5368,239305.875,1514.0,596.4444444444445
90014804.0,17,28,13364,28,13364,3333881.6296296297,501.0,477.2857142857143,0,0,0.0,0.0,0.0
108001774.0,17,21,5844,9,1171,13500221.75,506.0,130.11111111111111,12,4673,9770009.0,1214.0,389.4166666666667
1023851.0,6,11,1134,6,558,204770.2,220.0,93.0,5,576,255390.0,304.0,115.2
120526.0,6,3,337,2,214,0.0,160.0,107.0,1,123,0.0,123.0,123.0
38267.0,6,10,2032,5,524,9325.75,252.0,104.8,5,1508,8916.25,1236.0,301.6
2595757.0,6,2,132,1,66,0.0,66.0,66.0,1,66,0.0,66.0,66.0
117986594.0,6,31,2097,16,1071,7865772.933333334,123.0,66.9375,15,1026,8412038.785714285,123.0,68.4
153374.0,17,2,180,1,90,0.0,90.0,90.0,1,90,0.0,90.0,90.0
147995.0,17,2,180,1,90,0.0,90.0,90.0,1,90,0.0,90.0,90.0
95239869.0,6,28,2008,14,1045,7326143.769230769,139.0,74.64285714285714,14,963,7309489.0,123.0,68.78571428571429
311671.0,6,12,1373,7,714,51945.16666666666,298.0,102.0,5,659,73597.75,379.0,131.8
2491.0,17,4,344,2,150,0.0,75.0,75.0,2,194,0.0,103.0,97.0
223427.0,6,12,1373,7,714,37237.833333333336,298.0,102.0,5,659,54911.75,379.0,131.8
10865430.0,6,8,544,4,272,3574993.333333333,74.0,68.0,4,272,3574891.0,74.0,68.0
29903.0,6,14,4740,7,653,4174.5,249.0,93.28571428571428,7,4087,4568.333333333333,1514.0,583.8571428571429
553635.0,17,2,876,2,876,0.0,438.0,438.0,0,0,0.0,0.0,0.0
90289850.0,6,16,1192,8,596,12891854.57142857,95.0,74.5,8,596,12896788.714285716,95.0,74.5
232879.0,6,3,337,2,214,0.0,160.0,107.0,1,123,0.0,123.0,123.0
1033240.0,6,4,270,2,134,0.0,68.0,67.0,2,136,0.0,70.0,68.0
15464.0,6,10,1065,5,534,3433.5,262.0,106.8,5,531,3553.75,259.0,106.2
33182.0,6,14,4740,7,653,3863.0,249.0,93.28571428571428,7,4087,5348.666666666667,1514.0,583.8571428571429
2428.0,17,4,344,2,150,0.0,75.0,75.0,2,194,0.0,103.0,97.0
42989.0,6,14,4740,7,653,6472.833333333333,249.0,93.28571428571428,7,4087,6436.166666666667,1514.0,583.8571428571429
2593319.0,6,2,132,1,66,0.0,66.0,66.0,1,66,0.0,66.0,66.0
309144.0,17,4,1400,4,1400,103048.0,350.0,350.0,0,0,0.0,0.0,0.0
517.0,17,2,508,2,508,0.0,257.0,254.0,0,0,0.0,0.0,0.0
116448854.0,6,31,2097,16,1071,7763256.933333334,123.0,66.9375,15,1026,8302277.214285715,123.0,68.4
10966495.0,6,8,544,4,272,3609680.0,74.0,68.0,4,272,3609607.0,74.0,68.0
126401217.0,6,31,2034,16,1086,8426747.8,123.0,67.875,15,948,8299884.0,123.0,63.2
220863.0,17,2,414,1,88,0.0,88.0,88.0,1,326,0.0,326.0,326.0
26225.0,6,10,2032,5,524,6307.5,252.0,104.8,5,1508,6298.75,1236.0,301.6
119000928.0,17,15,1169,8,606,17000132.57142857,174.0,75.75,7,563,16501316.0,174.0,80.42857142857143
33688.0,6,10,2032,5,524,7750.5,252.0,104.8,5,1508,8137.75,1236.0,301.6
107531.0,17,2,286,2,286,0.0,143.0,143.0,0,0,0.0,0.0,0.0
148304140.0,6,24,1829,11,840,11907410.0,95.0,76.36363636363636,13,989,12340630.583333334,95.0,76.07692307692308
246302.0,6,3,337,2,214,0.0,160.0,107.0,1,123,0.0,123.0,123.0
13619415.0,6,20,1605,10,973,1479225.6666666667,315.0,97.3,10,632,1479191.7777777778,78.0,63.2
96858868.0,6,177,20044,89,14014,1100668.9545454546,284.0,157.46067415730337,88,6030,1101398.735632184,140.0,68.52272727272727
90531992.0,6,14,2240,8,1016,12933141.714285716,188.0,127.0,6,1224,18073270.2,204.0,204.0
43247.0,6,10,2032,5,524,9949.0,252.0,104.8,5,1508,10507.5,1236.0,301.6
363.0,17,2,267,1,83,0.0,83.0,83.0,1,184,0.0,184.0,184.0
22397.0,6,10,778,5,379,4414.25,107.0,75.8,5,399,5397.5,127.0,79.8
107842837.0,6,28,1876,14,982,8279007.615384615,139.0,70.14285714285714,14,894,8279012.538461538,123.0,63.85714285714285
90255460.0,6,13,2036,8,1016,12893637.142857144,188.0,127.0,5,1020,22522611.0,204.0,204.0
10505450.0,6,7,478,4,272,3454556.0,74.0,68.0,3,206,5181729.0,74.0,68.66666666666667
33686.0,6,10,2032,5,524,8044.75,252.0,104.8,5,1508,7858.75,1236.0,301.6
280546.0,17,2,363,1,79,0.0,79.0,79.0,1,284,0.0,284.0,284.0
120120310.0,6,14,2224,9,1204,15015038.75,188.0,133.77777777777777,5,1020,22522542.5,204.0,204.0
48230.0,6,14,4740,7,653,7917.166666666667,249.0,93.28571428571428,7,4087,6541.5,1514.0,583.8571428571429
90048116.0,17,27,12943,27,12943,3463389.076923077,501.0,479.3703703703704,0,0,0.0,0.0,0.0
0.0,17,1,350,1,350,0.0,350.0,350.0,0,0,0.0,0.0,0.0
241789.0,6,3,337,2,214,0.0,160.0,107.0,1,123,0.0,123.0,123.0
98863658.0,6,32,2374,17,1288,6178978.625,139.0,75.76470588235294,15,1086,6332900.857142857,123.0,72.4
120061168.0,6,276,32360,138,9404,870362.7445255475,140.0,68.14492753623189,138,22956,870433.3868613138,284.0,166.34782608695653
11971.0,6,13,1459,7,862,1819.6666666666667,271.0,123.14285714285714,6,597,2186.4,259.0,99.5
3005289.0,6,12,2172,7,664,500754.0,252.0,94.85714285714286,5,1508,1652.5,1236.0,301.6
2795125.0,6,2,132,1,66,0.0,66.0,66.0,1,66,0.0,66.0,66.0
1315047.0,6,4,264,2,132,0.0,66.0,66.0,2,132,0.0,66.0,66.0
112556352.0,6,30,1990,15,1042,8024334.857142857,139.0,69.46666666666667,15,948,8024335.714285715,123.0,63.2
3359644.0,6,162,136755,96,128097,35364.673684210524,1510.0,1334.34375,66,8658,46896.47692307692,1510.0,131.1818181818182
108115259.0,17,5,1005,5,1005,27028814.75,201.0,201.0,0,0,0.0,0.0,0.0
2785651.0,6,2,132,1,66,0.0,66.0,66.0,1,66,0.0,66.0,66.0
21290.0,6,14,4740,7,653,3249.333333333333,249.0,93.28571428571428,7,4087,2959.5,1514.0,583.8571428571429
152515.0,17,2,414,1,88,0.0,88.0,88.0,1,326,0.0,326.0,326.0
123839961.0,6,49,3234,25,1650,5159998.375,66.0,66.0,24,1584,4981203.0869565215,66.0,66.0
144642.0,17,2,180,1,70,0.0,70.0,70.0,1,110,0.0,110.0,110.0
114413811.0,6,30,1974,15,1026,8156997.928571428,123.0,68.4,15,948,8156968.857142857,123.0,63.2
90301202.0,6,16,1192,8,596,12893045.857142856,95.0,74.5,8,596,12899342.42857143,95.0,74.5
108105842.0,17,5,1005,5,1005,27026460.5,201.0,201.0,0,0,0.0,0.0,0.0
33623.0,6,14,4740,7,653,5314.833333333333,249.0,93.28571428571428,7,4087,5257.5,1514.0,583.8571428571429
119854135.0,6,16,2234,7,1152,19975300.83333333,204.0,164.57142857142858,9,1082,14981626.0,188.0,120.22222222222224
75256.0,6,10,2032,5,524,17848.25,252.0,104.8,5,1508,15280.75,1236.0,301.6
92592799.0,6,38,2508,19,1254,5144029.888888889,66.0,66.0,19,1254,5144029.555555556,66.0,66.0
5620120.0,6,5,336,2,134,0.0,68.0,67.0,3,202,1519326.0,70.0,67.33333333333333
135135772.0,17,6,1146,6,1146,27027154.4,191.0,191.0,0,0,0.0,0.0,0.0
278553.0,6,10,1221,6,636,55710.6,298.0,106.0,4,585,91981.33333333331,379.0,146.25
228585.0,17,2,180,1,90,0.0,90.0,90.0,1,90,0.0,90.0,90.0
217685.0,6,3,426,2,280,0.0,214.0,140.0,1,146,0.0,146.0,146.0
120000037.0,6,22,1680,12,935,10909094.272727272,95.0,77.91666666666667,10,745,10000932.444444444,95.0,74.5
196882.0,17,2,180,1,90,0.0,90.0,90.0,1,90,0.0,90.0,90.0
100762.0,17,2,762,2,762,0.0,381.0,381.0,0,0,0.0,0.0,0.0
108107539.0,17,5,955,5,955,27026884.75,191.0,191.0,0,0,0.0,0.0,0.0
108109532.0,17,5,955,5,955,27027383.0,191.0,191.0,0,0,0.0,0.0,0.0
1479884.0,17,16,1120,16,1120,98658.93333333332,70.0,70.0,0,0,0.0,0.0,0.0
549847.0,6,12,2212,6,694,109776.4,233.0,115.66666666666669,6,1518,109597.2,1224.0,253.0
8371.0,6,10,2032,5,524,1836.75,252.0,104.8,5,1508,1846.75,1236.0,301.6
26912.0,6,14,4740,7,653,3328.333333333333,249.0,93.28571428571428,7,4087,4349.833333333333,1514.0,583.8571428571429
509865.0,6,5,336,2,134,0.0,68.0,67.0,3,202,197084.0,70.0,67.33333333333333
44911.0,6,14,4740,7,653,7364.0,249.0,93.28571428571428,7,4087,6963.333333333333,1514.0,583.8571428571429
207090.0,6,3,426,2,280,0.0,214.0,140.0,1,146,0.0,146.0,146.0
4491.0,17,2,614,1,72,0.0,72.0,72.0,1,542,0.0,542.0,542.0
148624.0,17,2,414,1,88,0.0,88.0,88.0,1,326,0.0,326.0,326.0
328.0,17,2,208,1,72,0.0,72.0,72.0,1,136,0.0,136.0,136.0
327.0,17,2,166,1,75,0.0,75.0,75.0,1,91,0.0,91.0,91.0
120254.0,6,3,373,2,238,0.0,172.0,119.0,1,135,0.0,135.0,135.0
111932618.0,6,30,1974,15,1026,7979749.857142857,123.0,68.4,15,948,7979757.214285715,123.0,63.2
233742.0,6,3,373,2,238,0.0,172.0,119.0,1,135,0.0,135.0,135.0
120123163.0,6,15,2444,7,1428,20020527.166666668,204.0,204.0,8,1016,17098097.14285714,188.0,127.0
1301491.0,6,4,264,2,132,0.0,66.0,66.0,2,132,0.0,66.0,66.0
90281841.0,6,12,1832,8,1016,12897405.857142856,188.0,127.0,4,816,30037162.0,204.0,204.0
209602.0,17,2,180,1,90,0.0,90.0,90.0,1,90,0.0,90.0,90.0
130006452.0,17,15,907,8,475,18572350.285714287,174.0,59.375,7,432,18333502.5,174.0,61.71428571428572
213831.0,17,2,180,1,90,0.0,90.0,90.0,1,90,0.0,90.0,90.0
801.0,17,4,438,2,148,0.0,74.0,74.0,2,290,0.0,147.0,145.0
467922.0,6,3,1604,2,851,0.0,785.0,425.5,1,753,0.0,753.0,753.0
90251575.0,6,12,1832,8,1016,12893082.142857144,188.0,127.0,4,816,30030100.666666668,204.0,204.0
28704.0,6,14,4740,7,653,4312.166666666667,249.0,93.28571428571428,7,4087,4093.6666666666665,1514.0,583.8571428571429
13447.0,6,11,2098,6,590,2299.4,252.0,98.33333333333331,5,1508,2979.25,1236.0,301.6
196931.0,17,2,180,1,90,0.0,90.0,90.0,1,90,0.0,90.0,90.0
167207.0,17,2,180,1,90,0.0,90.0,90.0,1,90,0.0,90.0,90.0
108109150.0,17,5,1005,5,1005,27027287.5,201.0,201.0,0,0,0.0,0.0,0.0
75978.0,6,14,4740,7,653,12533.333333333334,249.0,93.28571428571428,7,4087,11628.166666666666,1514.0,583.8571428571429
281410.0,17,2,363,1,79,0.0,79.0,79.0,1,284,0.0,284.0,284.0
107697200.0,6,43,2838,22,1452,5128425.0,66.0,66.0,21,1386,5160000.5,66.0,66.0
303703.0,6,6,412,4,272,101234.33333333331,74.0,68.0,2,140,0.0,74.0,70.0
82933209.0,17,14,4796,13,4446,6240364.5,342.0,342.0,1,350,0.0,350.0,350.0
145558.0,17,2,180,1,90,0.0,90.0,90.0,1,90,0.0,90.0,90.0
318289.0,17,4,1400,4,1400,106096.33333333331,350.0,350.0,0,0,0.0,0.0,0.0
1187533.0,6,13,3010,8,2382,169647.57142857142,1514.0,297.75,5,628,227953.5,331.0,125.6
2053.0,17,4,344,2,150,0.0,75.0,75.0,2,194,0.0,103.0,97.0
90030011.0,17,28,13364,28,13364,3334444.851851852,501.0,477.2857142857143,0,0,0.0,0.0,0.0
9388.0,17,2,582,1,83,0.0,83.0,83.0,1,499,0.0,499.0,499.0
204770.0,6,10,1221,6,636,40954.0,298.0,106.0,4,585,66841.66666666667,379.0,146.25
2905997.0,6,11,2106,6,598,580989.2,252.0,99.66666666666669,5,1508,3070.5,1236.0,301.6
9600.0,17,2,571,1,86,0.0,86.0,86.0,1,485,0.0,485.0,485.0
146182.0,6,3,337,2,214,0.0,160.0,107.0,1,123,0.0,123.0,123.0
223979.0,6,3,426,2,280,0.0,214.0,140.0,1,146,0.0,146.0,146.0
106629745.0,6,44,2904,22,1452,5077606.904761905,66.0,66.0,22,1452,5063318.0,66.0,66.0
3012927.0,6,11,2106,6,598,602401.4,252.0,99.66666666666669,5,1508,3223.0,1236.0,301.6
322632.0,17,4,1400,4,1400,107544.0,350.0,350.0,0,0,0.0,0.0,0.0
101939.0,17,2,286,2,286,0.0,143.0,143.0,0,0,0.0,0.0,0.0
103662.0,17,2,286,2,286,0.0,143.0,143.0,0,0,0.0,0.0,0.0
13599383.0,6,19,1553,9,921,1661396.875,315.0,102.33333333333331,10,632,1476774.888888889,78.0,63.2
107215409.0,17,14,864,7,432,17834193.5,174.0,61.71428571428572,7,432,17833531.833333332,174.0,61.71428571428572
143.0,17,2,700,2,700,0.0,350.0,350.0,0,0,0.0,0.0,0.0
197185.0,17,2,180,1,90,0.0,90.0,90.0,1,90,0.0,90.0,90.0
103676.0,17,2,286,2,286,0.0,143.0,143.0,0,0,0.0,0.0,0.0
39361.0,6,10,2032,5,524,9560.0,252.0,104.8,5,1508,9440.0,1236.0,301.6
100346081.0,17,14,1126,7,563,16666832.166666666,174.0,80.42857142857143,7,563,16667698.166666666,174.0,80.42857142857143
21675.0,6,11,2098,6,590,4039.2,252.0,98.33333333333331,5,1508,5041.0,1236.0,301.6
109256883.0,6,32,2236,16,1165,7269406.133333334,139.0,72.8125,16,1071,7269403.466666667,123.0,66.9375
91653379.0,6,25,1924,14,1084,7046589.923076923,95.0,77.42857142857143,11,840,9137114.2,95.0,76.36363636363636
103880371.0,6,28,1860,14,966,7974196.384615385,123.0,69.0,14,894,7974195.153846154,123.0,63.85714285714285
153469.0,17,2,180,1,90,0.0,90.0,90.0,1,90,0.0,90.0,90.0
90037239.0,17,28,13364,28,13364,3334712.5555555555,501.0,477.2857142857143,0,0,0.0,0.0,0.0
216835.0,6,3,426,2,280,0.0,214.0,140.0,1,146,0.0,146.0,146.0
1301820.0,6,4,264,2,132,0.0,66.0,66.0,2,132,0.0,66.0,66.0
310292.0,6,6,412,4,272,103430.66666666669,74.0,68.0,2,140,0.0,74.0,70.0
66356.0,6,13,1386,7,789,10877.166666666666,253.0,112.71428571428572,6,597,12192.4,259.0,99.5
135135620.0,17,6,1206,6,1206,27027124.0,201.0,201.0,0,0,0.0,0.0,0.0
228643.0,17,2,180,1,90,0.0,90.0,90.0,1,90,0.0,90.0,90.0
206510.0,6,3,426,2,280,0.0,214.0,140.0,1,146,0.0,146.0,146.0
31515.0,6,10,2032,5,524,7643.0,252.0,104.8,5,1508,7244.5,1236.0,301.6
90035687.0,17,28,13364,28,13364,3334655.074074074,501.0,477.2857142857143,0,0,0.0,0.0,0.0
120226773.0,6,218,24518,109,7490,1105684.4351851852,140.0,68.71559633027523,109,17028,1105628.6666666667,284.0,156.22018348623854
26689391.0,17,5,1710,5,1710,6672347.75,342.0,342.0,0,0,0.0,0.0,0.0
228268.0,17,2,180,1,90,0.0,90.0,90.0,1,90,0.0,90.0,90.0
122225.0,6,3,373,2,238,0.0,172.0,119.0,1,135,0.0,135.0,135.0
108101090.0,17,5,1005,5,1005,27025272.5,201.0,201.0,0,0,0.0,0.0,0.0
153550.0,17,2,180,1,90,0.0,90.0,90.0,1,90,0.0,90.0,90.0
19883.0,17,2,582,1,83,0.0,83.0,83.0,1,499,0.0,499.0,499.0
108676.0,17,2,286,2,286,0.0,143.0,143.0,0,0,0.0,0.0,0.0
90013449.0,17,28,13364,28,13364,3333831.4444444445,501.0,477.2857142857143,0,0,0.0,0.0,0.0
44160.0,6,10,2032,5,524,10057.25,252.0,104.8,5,1508,9413.75,1236.0,301.6
303124.0,6,2,132,1,66,0.0,66.0,66.0,1,66,0.0,66.0,66.0
17093.0,6,11,2098,6,590,2703.0,252.0,98.33333333333331,5,1508,3687.5,1236.0,301.6
90051680.0,17,28,13364,28,13364,3335247.407407407,501.0,477.2857142857143,0,0,0.0,0.0,0.0
135139462.0,17,6,1146,6,1146,27027892.4,191.0,191.0,0,0,0.0,0.0,0.0
3374.0,17,2,414,1,88,0.0,88.0,88.0,1,326,0.0,326.0,326.0
233820.0,6,3,373,2,238,0.0,172.0,119.0,1,135,0.0,135.0,135.0
26827.0,6,10,2032,5,524,6489.0,252.0,104.8,5,1508,5669.5,1236.0,301.6
68838.0,17,2,180,1,90,0.0,90.0,90.0,1,90,0.0,90.0,90.0
96965356.0,6,183,20694,92,14466,1065553.362637363,284.0,157.2391304347826,91,6228,1054527.111111111,140.0,68.43956043956044
840573.0,6,9,1118,6,586,168114.6,248.0,97.66666666666669,3,532,282452.5,392.0,177.33333333333334
146087.0,6,3,337,2,214,0.0,160.0,107.0,1,123,0.0,123.0,123.0
10480844.0,6,7,478,4,272,3446782.6666666665,74.0,68.0,3,206,5170051.0,74.0,68.66666666666667
2351.0,17,4,344,2,150,0.0,75.0,75.0,2,194,0.0,103.0,97.0
326.0,17,2,166,1,75,0.0,75.0,75.0,1,91,0.0,91.0,91.0
39094.0,6,10,2032,5,524,9477.25,252.0,104.8,5,1508,9504.0,1236.0,301.6
457224.0,6,3,204,1,68,0.0,68.0,68.0,2,136,0.0,70.0,68.0
319930.0,6,6,412,4,272,106643.33333333331,74.0,68.0,2,140,0.0,74.0,70.0
304564.0,6,6,412,4,272,101521.33333333331,74.0,68.0,2,140,0.0,74.0,70.0
108107719.0,17,5,955,5,955,27026929.75,191.0,191.0,0,0,0.0,0.0,0.0
228287.0,17,2,180,1,90,0.0,90.0,90.0,1,90,0.0,90.0,90.0
13429.0,6,10,2032,5,524,3043.5,252.0,104.8,5,1508,3147.5,1236.0,301.6
10990.0,6,10,1975,5,467,2467.5,195.0,93.4,5,1508,2181.25,1236.0,301.6
7435.0,6,11,2098,6,590,1406.8,252.0,98.33333333333331,5,1508,1663.5,1236.0,301.6
362.0,17,2,267,1,83,0.0,83.0,83.0,1,184,0.0,184.0,184.0
107424.0,17,2,286,2,286,0.0,143.0,143.0,0,0,0.0,0.0,0.0
247235.0,6,3,373,2,238,0.0,172.0,119.0,1,135,0.0,135.0,135.0
46911.0,6,14,4740,7,653,7653.833333333333,249.0,93.28571428571428,7,4087,7592.833333333333,1514.0,583.8571428571429
305231.0,6,6,412,4,272,101743.66666666669,74.0,68.0,2,140,0.0,74.0,70.0
122624.0,6,3,373,2,238,0.0,172.0,119.0,1,135,0.0,135.0,135.0
115481361.0,6,35,2542,18,1348,6780322.588235294,139.0,74.88888888888889,17,1194,7204093.75,123.0,70.23529411764706
51033.0,6,10,2032,5,524,12535.25,252.0,104.8,5,1508,12461.5,1236.0,301.6
35697.0,6,14,4740,7,653,5824.5,249.0,93.28571428571428,7,4087,4809.833333333333,1514.0,583.8571428571429
307047.0,6,6,412,4,272,102349.0,74.0,68.0,2,140,0.0,74.0,70.0
104279.0,17,2,286,2,286,0.0,143.0,143.0,0,0,0.0,0.0,0.0
10360.0,6,10,1067,5,536,2172.5,264.0,107.2,5,531,2311.5,259.0,106.2
209764.0,17,2,180,1,90,0.0,90.0,90.0,1,90,0.0,90.0,90.0
215489.0,6,10,1221,6,636,43097.8,298.0,106.0,4,585,70519.0,379.0,146.25
143027.0,17,2,363,1,75,0.0,75.0,75.0,1,288,0.0,288.0,288.0
155227.0,6,3,337,2,214,0.0,160.0,107.0,1,123,0.0,123.0,123.0
196970.0,17,2,180,1,90,0.0,90.0,90.0,1,90,0.0,90.0,90.0
0.0,6,1,66,1,66,0.0,66.0,66.0,0,0,0.0,0.0,0.0
18651.0,6,20,7606,11,978,1865.1,310.0,88.9090909090909,9,6628,1929.625,1514.0,736.4444444444445
76061.0,6,14,4740,7,653,12466.166666666666,249.0,93.28571428571428,7,4087,12143.166666666666,1514.0,583.8571428571429
120027255.0,17,29,13785,29,13785,4286687.678571428,501.0,475.3448275862069,0,0,0.0,0.0,0.0
153485.0,17,2,180,1,90,0.0,90.0,90.0,1,90,0.0,90.0,90.0
122687985.0,6,49,3234,25,1650,5111999.375,66.0,66.0,24,1584,4972912.608695652,66.0,66.0
90256235.0,6,12,1832,8,1016,12893747.857142856,188.0,127.0,4,816,30030443.33333333,204.0,204.0
108103321.0,17,5,955,5,955,27025830.25,191.0,191.0,0,0,0.0,0.0,0.0
20472.0,17,4,344,2,150,0.0,75.0,75.0,2,194,0.0,103.0,97.0
102281132.0,17,14,1126,7,563,17020368.0,174.0,80.42857142857143,7,563,16977602.166666668,174.0,80.42857142857143
102981.0,17,2,286,2,286,0.0,143.0,143.0,0,0,0.0,0.0,0.0
61078.0,6,14,4740,7,653,9948.0,249.0,93.28571428571428,7,4087,9958.666666666666,1514.0,583.8571428571429
49513.0,6,10,2032,5,524,12122.0,252.0,104.8,5,1508,11738.75,1236.0,301.6
21300.0,6,14,4740,7,653,3393.333333333333,249.0,93.28571428571428,7,4087,2982.1666666666665,1514.0,583.8571428571429
75633.0,17,2,180,1,90,0.0,90.0,90.0,1,90,0.0,90.0,90.0
118646569.0,6,230,26010,115,18198,1038867.254385965,284.0,158.24347826086955,115,7812,1038866.9561403508,140.0,67.9304347826087
108104698.0,17,5,955,5,955,27026174.5,191.0,191.0,0,0,0.0,0.0,0.0
2589130.0,6,2,132,1,66,0.0,66.0,66.0,1,66,0.0,66.0,66.0
103576.0,17,2,286,2,286,0.0,143.0,143.0,0,0,0.0,0.0,0.0
119926940.0,17,35,16705,35,16705,3527262.9411764704,501.0,477.2857142857143,0,0,0.0,0.0,0.0
7507.0,17,4,823,2,163,0.0,89.0,81.5,2,660,0.0,443.0,330.0
17858.0,6,14,4740,7,653,2855.833333333333,249.0,93.28571428571428,7,4087,2476.0,1514.0,583.8571428571429
36038.0,6,14,4740,7,653,5880.0,249.0,93.28571428571428,7,4087,5749.666666666667,1514.0,583.8571428571429
761.0,17,4,438,2,148,0.0,74.0,74.0,2,290,0.0,147.0,145.0
113695366.0,6,46,3036,23,1518,5167960.318181818,66.0,66.0,23,1518,5167959.681818182,66.0,66.0
120000305.0,6,25,1924,14,1084,9230792.692307692,95.0,77.42857142857143,11,840,9138159.8,95.0,76.36363636363636
303142.0,6,6,412,4,272,101047.33333333331,74.0,68.0,2,140,0.0,74.0,70.0
120381819.0,6,227,25668,114,17914,1065325.831858407,284.0,157.140350877193,113,7754,1056275.4375,140.0,68.61946902654867
108107869.0,17,5,955,5,955,27026967.25,191.0,191.0,0,0,0.0,0.0,0.0
13618236.0,6,20,1607,10,975,1478874.3333333333,315.0,97.5,10,632,1478810.7777777778,78.0,63.2
108031837.0,6,34,2736,16,1278,7202095.266666667,123.0,79.875,18,1458,5767307.882352941,123.0,81.0
120390481.0,6,215,24336,108,17052,1125144.6822429907,284.0,157.88888888888889,107,7284,1116384.3962264152,140.0,68.07476635514018
39184.0,6,10,2032,5,524,8642.0,252.0,104.8,5,1508,8765.75,1236.0,301.6
97683.0,17,2,762,2,762,0.0,381.0,381.0,0,0,0.0,0.0,0.0
110189.0,17,4,1400,4,1400,36729.66666666666,350.0,350.0,0,0,0.0,0.0,0.0
106322.0,17,2,762,2,762,0.0,381.0,381.0,0,0,0.0,0.0,0.0
0.0,17,1,892,1,892,0.0,892.0,892.0,0,0,0.0,0.0,0.0
319285.0,17,4,1400,4,1400,106428.33333333331,350.0,350.0,0,0,0.0,0.0,0.0
214162.0,6,10,1221,6,636,42832.4,298.0,106.0,4,585,70082.66666666667,379.0,146.25
148118.0,17,2,180,1,90,0.0,90.0,90.0,1,90,0.0,90.0,90.0
122975267.0,6,48,3168,24,1584,5097582.260869565,66.0,66.0,24,1584,5169497.826086956,66.0,66.0
1280664.0,17,7,490,7,490,213444.0,70.0,70.0,0,0,0.0,0.0,0.0
119707342.0,6,220,24884,110,17402,1096257.8073394496,284.0,158.2,110,7482,1096258.2018348624,140.0,68.01818181818182
120264281.0,6,424,52568,212,14214,566008.7393364928,140.0,67.04716981132076,212,38354,569928.9289099526,554.0,180.91509433962264
6345.0,17,2,565,1,93,0.0,93.0,93.0,1,472,0.0,472.0,472.0
2026724.0,17,4,525,2,150,0.0,75.0,75.0,2,375,0.0,284.0,187.5
2333.0,17,4,344,2,150,0.0,75.0,75.0,2,194,0.0,103.0,97.0
122012063.0,17,15,907,8,475,17430294.714285713,174.0,59.375,7,432,17000220.833333332,174.0,61.71428571428572
496956.0,6,5,336,2,134,0.0,68.0,67.0,3,202,188619.5,70.0,67.33333333333333
234574.0,6,3,337,2,214,0.0,160.0,107.0,1,123,0.0,123.0,123.0
301287.0,6,6,412,4,272,100429.0,74.0,68.0,2,140,0.0,74.0,70.0
27427.0,6,10,2032,5,524,6635.0,252.0,104.8,5,1508,6554.75,1236.0,301.6
17163.0,17,2,180,1,90,0.0,90.0,90.0,1,90,0.0,90.0,90.0
143899.0,17,2,180,1,90,0.0,90.0,90.0,1,90,0.0,90.0,90.0
108108689.0,17,5,955,5,955,27027172.25,191.0,191.0,0,0,0.0,0.0,0.0
2354.0,17,4,344,2,150,0.0,75.0,75.0,2,194,0.0,103.0,97.0
206487.0,6,3,426,2,280,0.0,214.0,140.0,1,146,0.0,146.0,146.0
90299449.0,6,16,1192,8,596,12893956.0,95.0,74.5,8,596,12899373.42857143,95.0,74.5
216538.0,17,2,180,1,90,0.0,90.0,90.0,1,90,0.0,90.0,90.0
123839791.0,6,49,3234,25,1650,5159991.291666667,66.0,66.0,24,1584,5119426.0,66.0,66.0
320643.0,17,4,1400,4,1400,106881.0,350.0,350.0,0,0,0.0,0.0,0.0
2595479.0,6,2,132,1,66,0.0,66.0,66.0,1,66,0.0,66.0,66.0
149012.0,6,3,373,2,238,0.0,172.0,119.0,1,135,0.0,135.0,135.0
9954.0,17,2,571,1,86,0.0,86.0,86.0,1,485,0.0,485.0,485.0
111189.0,17,2,286,2,286,0.0,143.0,143.0,0,0,0.0,0.0,0.0
131311.0,6,3,337,2,214,0.0,160.0,107.0,1,123,0.0,123.0,123.0
298621.0,6,6,412,4,272,99540.33333333331,74.0,68.0,2,140,0.0,74.0,70.0
22708.0,17,2,582,1,83,0.0,83.0,83.0,1,499,0.0,499.0,499.0
151434.0,17,2,414,1,88,0.0,88.0,88.0,1,326,0.0,326.0,326.0
307798.0,6,6,412,4,272,102599.33333333331,74.0,68.0,2,140,0.0,74.0,70.0
99373433.0,17,12,778,6,389,19800170.2,174.0,64.83333333333333,6,389,19801010.8,174.0,64.83333333333333
122222.0,6,3,373,2,238,0.0,172.0,119.0,1,135,0.0,135.0,135.0
143993.0,17,2,180,1,90,0.0,90.0,90.0,1,90,0.0,90.0,90.0
299.0,17,2,164,1,82,0.0,82.0,82.0,1,82,0.0,82.0,82.0
120031640.0,17,29,13785,29,13785,4286844.285714285,501.0,475.3448275862069,0,0,0.0,0.0,0.0
116403152.0,6,207,23396,104,7086,1130127.6893203885,140.0,68.13461538461539,103,16310,1131069.9019607843,284.0,158.3495145631068
205979.0,6,3,426,2,280,0.0,214.0,140.0,1,146,0.0,146.0,146.0
90892.0,6,14,4740,7,653,15036.5,249.0,93.28571428571428,7,4087,14258.333333333334,1514.0,583.8571428571429
108107802.0,17,5,955,5,955,27026950.5,191.0,191.0,0,0,0.0,0.0,0.0
303679.0,6,2,132,1,66,0.0,66.0,66.0,1,66,0.0,66.0,66.0
120064307.0,17,28,13364,28,13364,4446826.185185186,501.0,477.2857142857143,0,0,0.0,0.0,0.0
16849.0,17,2,180,1,90,0.0,90.0,90.0,1,90,0.0,90.0,90.0
0.0,17,1,179,1,179,0.0,179.0,179.0,0,0,0.0,0.0,0.0
116352163.0,6,221,24950,111,7548,1057746.9363636365,140.0,68.0,110,17402,1058027.0550458715,284.0,158.2
36262.0,6,14,4740,7,653,4839.666666666667,249.0,93.28571428571428,7,4087,5907.333333333333,1514.0,583.8571428571429
2379.0,17,4,344,2,150,0.0,75.0,75.0,2,194,0.0,103.0,97.0
120321982.0,6,19,1436,11,840,12032198.2,95.0,76.36363636363636,8,596,17089206.714285713,95.0,74.5
307332.0,6,6,412,4,272,102444.0,74.0,68.0,2,140,0.0,74.0,70.0
10516228.0,6,6,412,3,206,5187391.0,74.0,68.66666666666667,3,206,5187275.0,74.0,68.66666666666667
90000855.0,17,28,13364,28,13364,3333365.0,501.0,477.2857142857143,0,0,0.0,0.0,0.0
2595.0,17,4,344,2,150,0.0,75.0,75.0,2,194,0.0,103.0,97.0
678.0,17,5,550,5,550,169.5,110.0,110.0,0,0,0.0,0.0,0.0
107429760.0,6,44,2904,22,1452,5115702.857142857,66.0,66.0,22,1452,5102585.380952381,66.0,66.0
258758.0,6,10,1221,6,636,51751.6,298.0,106.0,4,585,80881.33333333333,379.0,146.25
108106475.0,17,5,955,5,955,27026618.75,191.0,191.0,0,0,0.0,0.0,0.0
276285.0,17,2,346,1,78,0.0,78.0,78.0,1,268,0.0,268.0,268.0
847.0,17,4,438,2,148,0.0,74.0,74.0,2,290,0.0,147.0,145.0
5621162.0,6,5,336,2,134,0.0,68.0,67.0,3,202,1524954.0,70.0,67.33333333333333
4608355.0,6,20,1607,10,975,477796.1111111111,315.0,97.5,10,632,477820.1111111111,78.0,63.2
701.0,17,4,438,2,148,0.0,74.0,74.0,2,290,0.0,147.0,145.0
322788.0,17,4,1400,4,1400,107596.0,350.0,350.0,0,0,0.0,0.0,0.0
144054.0,17,2,180,1,90,0.0,90.0,90.0,1,90,0.0,90.0,90.0
0.0,17,1,55,1,55,0.0,55.0,55.0,0,0,0.0,0.0,0.0
207423.0,6,3,426,2,280,0.0,214.0,140.0,1,146,0.0,146.0,146.0
132946.0,6,2,132,1,66,0.0,66.0,66.0,1,66,0.0,66.0,66.0
90253579.0,6,12,1832,8,1016,12893368.42857143,188.0,127.0,4,816,30029865.0,204.0,204.0
2097284.0,6,24,7544,12,2450,190248.2727272728,1034.0,204.16666666666663,12,5094,163286.0909090909,1510.0,424.5
990937.0,6,12,1447,6,816,197147.4,291.0,136.0,6,631,197861.2,293.0,105.16666666666669
223802.0,17,2,762,2,762,0.0,381.0,381.0,0,0,0.0,0.0,0.0
206002.0,6,3,426,2,280,0.0,214.0,140.0,1,146,0.0,146.0,146.0
167713.0,17,2,414,1,88,0.0,88.0,88.0,1,326,0.0,326.0,326.0
108106739.0,17,5,955,5,955,27026684.75,191.0,191.0,0,0,0.0,0.0,0.0
108113373.0,17,5,955,5,955,27028343.25,191.0,191.0,0,0,0.0,0.0,0.0
24824103.0,6,15,1036,8,545,3546300.4285714286,95.0,68.125,7,491,4106339.0,95.0,70.14285714285714
90202104.0,6,27,2073,12,935,8178670.636363637,95.0,77.91666666666667,15,1138,6428363.285714285,95.0,75.86666666666666
322.0,17,2,174,1,79,0.0,79.0,79.0,1,95,0.0,95.0,95.0
1298783.0,6,4,264,2,132,0.0,66.0,66.0,2,132,0.0,66.0,66.0
24291.0,6,10,2032,5,524,5823.75,252.0,104.8,5,1508,5773.5,1236.0,301.6
302369.0,6,2,132,1,66,0.0,66.0,66.0,1,66,0.0,66.0,66.0
26116.0,6,14,4740,7,653,3663.8333333333335,249.0,93.28571428571428,7,4087,3588.833333333333,1514.0,583.8571428571429
105390.0,17,2,762,2,762,0.0,381.0,381.0,0,0,0.0,0.0,0.0
478529.0,6,5,336,3,202,191614.5,70.0,67.33333333333333,2,134,0.0,68.0,67.0
1030.0,17,4,438,2,148,0.0,74.0,74.0,2,290,0.0,147.0,145.0
135120588.0,17,6,1206,6,1206,27024117.6,201.0,201.0,0,0,0.0,0.0,0.0
311960.0,6,6,412,4,272,103986.66666666669,74.0,68.0,2,140,0.0,74.0,70.0
481107.0,6,4,270,2,134,0.0,68.0,67.0,2,136,0.0,70.0,68.0
10541284.0,6,7,478,4,272,3468549.0,74.0,68.0,3,206,5202671.0,74.0,68.66666666666667
2323.0,17,4,344,2,150,0.0,75.0,75.0,2,194,0.0,103.0,97.0
119907591.0,17,14,864,7,432,19929719.666666668,174.0,61.71428571428572,7,432,19957967.166666668,174.0,61.71428571428572
218437.0,6,3,426,2,280,0.0,214.0,140.0,1,146,0.0,146.0,146.0
1033275.0,6,11,1134,6,558,206655.0,220.0,93.0,5,576,255936.75,304.0,115.2
316.0,17,2,166,1,75,0.0,75.0,75.0,1,91,0.0,91.0,91.0
456300.0,6,3,204,1,68,0.0,68.0,68.0,2,136,0.0,70.0,68.0
13844.0,6,11,1133,6,602,2193.0,264.0,100.33333333333331,5,531,3257.25,259.0,106.2
217640.0,6,3,426,2,280,0.0,214.0,140.0,1,146,0.0,146.0,146.0
2054512.0,6,18,6803,10,1501,228279.11111111112,408.0,150.1,8,5302,231684.57142857145,1514.0,662.75
95320705.0,17,12,778,6,389,19000762.8,174.0,64.83333333333333,6,389,19000173.8,174.0,64.83333333333333
182505.0,17,4,1524,4,1524,60835.0,381.0,381.0,0,0,0.0,0.0,0.0
90531758.0,6,14,2240,8,1016,12933108.285714284,188.0,127.0,6,1224,18073653.2,204.0,204.0
216431.0,17,2,180,1,90,0.0,90.0,90.0,1,90,0.0,90.0,90.0
146903.0,6,3,337,2,214,0.0,160.0,107.0,1,123,0.0,123.0,123.0
14366695.0,17,6,2052,6,2052,2873339.0,342.0,342.0,0,0,0.0,0.0,0.0
90014508.0,17,28,13364,28,13364,3333870.6666666665,501.0,477.2857142857143,0,0,0.0,0.0,0.0
29947.0,6,10,2032,5,524,6821.0,252.0,104.8,5,1508,7219.5,1236.0,301.6
120078660.0,17,29,13785,29,13785,4288523.571428572,501.0,475.3448275862069,0,0,0.0,0.0,0.0
90033018.0,17,27,12943,27,12943,3462808.3846153845,501.0,479.3703703703704,0,0,0.0,0.0,0.0
22170.0,6,14,4740,7,653,3574.1666666666665,249.0,93.28571428571428,7,4087,3573.0,1514.0,583.8571428571429
105065.0,6,14,4740,7,653,15802.833333333334,249.0,93.28571428571428,7,4087,17216.666666666668,1514.0,583.8571428571429
322729.0,6,6,412,4,272,107576.33333333331,74.0,68.0,2,140,0.0,74.0,70.0
328.0,17,2,174,1,79,0.0,79.0,79.0,1,95,0.0,95.0,95.0
60812067.0,6,5,1736,2,819,0.0,753.0,409.5,3,917,30406033.5,785.0,305.6666666666667
104395827.0,17,14,864,7,432,17372818.666666668,174.0,61.71428571428572,7,432,17374104.166666668,174.0,61.71428571428572
197317.0,17,2,180,1,90,0.0,90.0,90.0,1,90,0.0,90.0,90.0
120427677.0,6,225,25356,113,17668,1075247.1160714286,284.0,156.35398230088495,112,7688,1075652.207207207,140.0,68.64285714285714
482035.0,6,10,1221,6,636,96407.0,298.0,106.0,4,585,153508.66666666666,379.0,146.25
110618344.0,6,32,2236,16,1165,7360156.133333334,139.0,72.8125,16,1071,7360155.2,123.0,66.9375
10934546.0,6,8,544,4,272,3599376.6666666665,74.0,68.0,4,272,3599315.6666666665,74.0,68.0
330.0,17,2,267,1,83,0.0,83.0,83.0,1,184,0.0,184.0,184.0
120739128.0,6,37,2725,18,1317,6514877.05882353,123.0,73.16666666666667,19,1408,6707638.666666667,139.0,74.10526315789474
120211772.0,6,224,25508,112,7688,1075656.963963964,140.0,68.64285714285714,112,17820,1075660.6126126123,374.0,159.10714285714286
100611309.0,6,27,1806,14,966,7739331.461538462,123.0,69.0,13,840,7534074.916666667,123.0,64.61538461538461
58635.0,6,10,2032,5,524,14427.0,252.0,104.8,5,1508,14415.25,1236.0,301.6
123577.0,6,4,439,2,238,0.0,172.0,119.0,2,201,0.0,135.0,100.5
41516.0,6,10,2032,5,524,9777.5,252.0,104.8,5,1508,8445.0,1236.0,301.6
39313.0,6,14,4740,7,653,5709.5,249.0,93.28571428571428,7,4087,5814.166666666667,1514.0,583.8571428571429
16922.0,6,11,2098,6,590,3264.6,252.0,98.33333333333331,5,1508,3415.75,1236.0,301.6
4609.0,17,2,614,1,72,0.0,72.0,72.0,1,542,0.0,542.0,542.0
22386.0,6,14,4740,7,653,2872.833333333333,249.0,93.28571428571428,7,4087,3521.333333333333,1514.0,583.8571428571429
205795.0,6,3,426,2,280,0.0,214.0,140.0,1,146,0.0,146.0,146.0
247353.0,17,4,6056,4,6056,82451.0,1514.0,1514.0,0,0,0.0,0.0,0.0
190927.0,17,2,180,1,90,0.0,90.0,90.0,1,90,0.0,90.0,90.0
120007819.0,17,28,13364,28,13364,4444734.037037037,501.0,477.2857142857143,0,0,0.0,0.0,0.0
135131775.0,17,6,1206,6,1206,27026355.0,201.0,201.0,0,0,0.0,0.0,0.0
112213273.0,6,213,23950,107,7284,1058615.783018868,140.0,68.07476635514018,106,16666,1058670.4285714286,284.0,157.2264150943396
116514938.0,6,224,25264,112,17650,1047746.1981981982,300.0,157.58928571428572,112,7614,1047744.3783783783,140.0,67.98214285714286
123301416.0,6,48,3168,24,1584,5009408.565217392,66.0,66.0,24,1584,5287163.130434782,66.0,66.0
36127.0,6,14,4740,7,653,5820.0,249.0,93.28571428571428,7,4087,5881.666666666667,1514.0,583.8571428571429
304434.0,6,6,412,4,272,101478.0,74.0,68.0,2,140,0.0,74.0,70.0
843233.0,6,9,1096,6,625,168646.6,287.0,104.16666666666669,3,471,285301.0,331.0,157.0
5625324.0,6,5,336,2,134,0.0,68.0,67.0,3,202,1422692.0,70.0,67.33333333333333
38569.0,6,14,4740,7,653,6165.0,249.0,93.28571428571428,7,4087,6292.5,1514.0,583.8571428571429
309321.0,17,4,704,2,148,0.0,74.0,74.0,2,556,0.0,280.0,278.0
108095455.0,17,5,1005,5,1005,27023863.75,201.0,201.0,0,0,0.0,0.0,0.0
39108.0,6,11,2098,6,590,7017.0,252.0,98.33333333333331,5,1508,8454.5,1236.0,301.6
48377.0,6,10,2032,5,524,10695.5,252.0,104.8,5,1508,11618.25,1236.0,301.6
216447.0,17,2,180,1,90,0.0,90.0,90.0,1,90,0.0,90.0,90.0
68541.0,6,14,4740,7,653,11147.833333333334,249.0,93.28571428571428,7,4087,11216.666666666666,1514.0,583.8571428571429
339.0,17,2,267,1,83,0.0,83.0,83.0,1,184,0.0,184.0,184.0
207833.0,6,3,426,2,280,0.0,214.0,140.0,1,146,0.0,146.0,146.0
106184.0,17,2,286,2,286,0.0,143.0,143.0,0,0,0.0,0.0,0.0
37472.0,6,10,2032,5,524,9130.5,252.0,104.8,5,1508,9104.0,1236.0,301.6
109934816.0,6,30,1990,15,1042,7837068.285714285,139.0,69.46666666666667,15,948,7837068.5,123.0,63.2
90258582.0,6,13,2036,8,1016,12894083.142857144,188.0,127.0,5,1020,22519008.25,204.0,204.0
42684.0,6,14,4740,7,653,6668.0,249.0,93.28571428571428,7,4087,6687.333333333333,1514.0,583.8571428571429
216499.0,17,2,762,2,762,0.0,381.0,381.0,0,0,0.0,0.0,0.0
885295.0,6,10,1334,6,797,177059.0,459.0,132.83333333333334,4,537,203268.3333333333,331.0,134.25
90771152.0,6,19,1436,10,745,10080273.666666666,95.0,74.5,9,691,11344868.75,95.0,76.77777777777777
43539.0,6,14,4740,7,653,6286.333333333333,249.0,93.28571428571428,7,4087,7110.5,1514.0,583.8571428571429
302848.0,6,6,412,4,272,100949.33333333331,74.0,68.0,2,140,0.0,74.0,70.0
215838.0,17,2,180,1,90,0.0,90.0,90.0,1,90,0.0,90.0,90.0
2500.0,17,4,438,2,148,0.0,74.0,74.0,2,290,0.0,147.0,145.0
101175041.0,17,14,864,7,432,16834120.5,174.0,61.71428571428572,7,432,16833512.666666668,174.0,61.71428571428572
2592267.0,6,2,132,1,66,0.0,66.0,66.0,1,66,0.0,66.0,66.0
3041974.0,6,151,117549,84,108827,36650.2891566265,1510.0,1295.559523809524,67,8722,41418.181818181816,1510.0,130.17910447761193
146007.0,17,4,1524,4,1524,48669.0,381.0,381.0,0,0,0.0,0.0,0.0
302209.0,6,6,412,4,272,100736.33333333331,74.0,68.0,2,140,0.0,74.0,70.0
26879.0,6,14,4740,7,653,4327.666666666667,249.0,93.28571428571428,7,4087,4358.666666666667,1514.0,583.8571428571429
49152753.0,6,7,2047,5,1153,12288188.25,885.0,230.6,2,894,0.0,826.0,447.0
36897.0,6,14,4740,7,653,5914.166666666667,249.0,93.28571428571428,7,4087,5913.833333333333,1514.0,583.8571428571429
2443.0,17,4,344,2,150,0.0,75.0,75.0,2,194,0.0,103.0,97.0
35607090.0,6,26,7627,14,3735,189542.3076923077,1514.0,266.7857142857143,12,3892,3217376.1818181816,1514.0,324.3333333333333
115602.0,17,4,1400,4,1400,38534.0,350.0,350.0,0,0,0.0,0.0,0.0
118893631.0,6,34,2334,17,1209,7417360.5,123.0,71.11764705882354,17,1125,7417356.4375,123.0,66.17647058823529
283622.0,17,2,363,1,79,0.0,79.0,79.0,1,284,0.0,284.0,284.0
2322.0,17,4,344,2,150,0.0,75.0,75.0,2,194,0.0,103.0,97.0
90060094.0,6,27,1954,14,1045,6911080.692307692,139.0,74.64285714285714,13,909,7487005.916666667,123.0,69.92307692307692
209462.0,17,2,180,1,90,0.0,90.0,90.0,1,90,0.0,90.0,90.0
1774558.0,6,2,132,1,66,0.0,66.0,66.0,1,66,0.0,66.0,66.0
96072326.0,17,14,1126,7,563,16000706.5,174.0,80.42857142857143,7,563,16000143.833333334,174.0,80.42857142857143
2067.0,17,4,344,2,150,0.0,75.0,75.0,2,194,0.0,103.0,97.0
108121564.0,17,5,1005,5,1005,27030391.0,201.0,201.0,0,0,0.0,0.0,0.0
146241.0,6,3,337,2,214,0.0,160.0,107.0,1,123,0.0,123.0,123.0
807.0,17,4,438,2,148,0.0,74.0,74.0,2,290,0.0,147.0,145.0
2322.0,17,4,344,2,150,0.0,75.0,75.0,2,194,0.0,103.0,97.0
2598771.0,6,2,132,1,66,0.0,66.0,66.0,1,66,0.0,66.0,66.0
52335.0,6,14,4740,7,653,8575.333333333334,249.0,93.28571428571428,7,4087,7980.333333333333,1514.0,583.8571428571429
90058063.0,17,28,13364,28,13364,3335483.814814815,501.0,477.2857142857143,0,0,0.0,0.0,0.0
108723.0,17,2,700,2,700,0.0,350.0,350.0,0,0,0.0,0.0,0.0
2354376.0,6,49,23728,25,19797,98099.0,1514.0,791.88,24,3931,92684.95652173914,1514.0,163.79166666666666
108106209.0,17,5,1005,5,1005,27026552.25,201.0,201.0,0,0,0.0,0.0,0.0
149152697.0,17,36,17126,36,17126,4261505.628571428,501.0,475.72222222222223,0,0,0.0,0.0,0.0
8968.0,17,2,582,1,83,0.0,83.0,83.0,1,499,0.0,499.0,499.0
308690.0,6,6,412,4,272,102896.66666666669,74.0,68.0,2,140,0.0,74.0,70.0
279909.0,17,4,704,2,148,0.0,74.0,74.0,2,556,0.0,280.0,278.0
103523464.0,17,14,864,7,432,17161808.0,174.0,61.71428571428572,7,432,17166826.5,174.0,61.71428571428572
470.0,17,2,160,1,80,0.0,80.0,80.0,1,80,0.0,80.0,80.0
39856.0,6,10,2032,5,524,9742.0,252.0,104.8,5,1508,9685.5,1236.0,301.6
239130.0,17,2,180,1,90,0.0,90.0,90.0,1,90,0.0,90.0,90.0
123258190.0,17,14,864,7,432,17333500.5,174.0,61.71428571428572,7,432,17333478.0,174.0,61.71428571428572
1303871.0,6,22,6856,12,2989,118533.72727272728,1514.0,249.0833333333333,10,3867,119292.77777777778,1514.0,386.7
4530.0,17,2,602,1,72,0.0,72.0,72.0,1,530,0.0,530.0,530.0
47518.0,6,14,4740,7,653,7332.333333333333,249.0,93.28571428571428,7,4087,7681.166666666667,1514.0,583.8571428571429
0.0,17,1,381,1,381,0.0,381.0,381.0,0,0,0.0,0.0,0.0
213667.0,17,2,180,1,90,0.0,90.0,90.0,1,90,0.0,90.0,90.0
209064.0,6,3,426,2,280,0.0,214.0,140.0,1,146,0.0,146.0,146.0
228142.0,17,2,180,1,90,0.0,90.0,90.0,1,90,0.0,90.0,90.0
90024043.0,17,27,12943,27,12943,3462463.1923076925,501.0,479.3703703703704,0,0,0.0,0.0,0.0
1182777.0,6,13,3010,8,2382,168968.14285714287,1514.0,297.75,5,628,226880.0,331.0,125.6
329986.0,6,3,204,2,136,0.0,70.0,68.0,1,68,0.0,68.0,68.0
113094402.0,6,214,24074,107,7358,1059184.3301886793,140.0,68.76635514018692,107,16716,1058971.424528302,284.0,156.22429906542055
30047.0,6,14,4740,7,653,4581.5,249.0,93.28571428571428,7,4087,4738.833333333333,1514.0,583.8571428571429
40221.0,6,10,2032,5,524,9286.75,252.0,104.8,5,1508,9582.25,1236.0,301.6
108105162.0,17,5,1005,5,1005,27026290.5,201.0,201.0,0,0,0.0,0.0,0.0
135126932.0,17,6,1206,6,1206,27025386.4,201.0,201.0,0,0,0.0,0.0,0.0
10489738.0,6,7,478,4,272,3451215.0,74.0,68.0,3,206,5176702.5,74.0,68.66666666666667
160700.0,6,13,1394,7,797,26783.33333333333,253.0,113.85714285714286,6,597,29795.2,259.0,99.5
90303581.0,6,23,1775,12,935,8204949.181818182,95.0,77.91666666666667,11,840,9001590.5,95.0,76.36363636363636
90007942.0,6,15,1097,8,596,12858277.42857143,95.0,74.5,7,501,14953285.0,95.0,71.57142857142857
135997105.0,17,14,864,7,432,19333496.83333333,174.0,61.71428571428572,7,432,20096519.666666668,174.0,61.71428571428572
426842.0,17,2,363,1,75,0.0,75.0,75.0,1,288,0.0,288.0,288.0
2340.0,17,4,344,2,150,0.0,75.0,75.0,2,194,0.0,103.0,97.0
121426958.0,17,14,995,7,432,17333500.166666668,174.0,61.71428571428572,7,563,19672535.666666668,174.0,80.42857142857143
75670.0,6,12,1328,6,731,13078.0,253.0,121.83333333333331,6,597,14645.8,259.0,99.5
128010074.0,17,15,907,8,475,18287153.42857143,174.0,59.375,7,432,18000188.333333332,174.0,61.71428571428572
90056456.0,17,28,13364,28,13364,3335424.296296296,501.0,477.2857142857143,0,0,0.0,0.0,0.0
25579.0,6,10,2032,5,524,5616.0,252.0,104.8,5,1508,5769.25,1236.0,301.6
51181.0,17,2,180,1,90,0.0,90.0,90.0,1,90,0.0,90.0,90.0
196946.0,17,2,180,1,90,0.0,90.0,90.0,1,90,0.0,90.0,90.0
162181.0,17,2,180,1,90,0.0,90.0,90.0,1,90,0.0,90.0,90.0
315.0,17,2,156,1,78,0.0,78.0,78.0,1,78,0.0,78.0,78.0
0.0,17,1,347,1,347,0.0,347.0,347.0,0,0,0.0,0.0,0.0
24817.0,6,14,4740,7,653,3607.0,249.0,93.28571428571428,7,4087,3925.3333333333335,1514.0,583.8571428571429
213911.0,6,3,426,2,280,0.0,214.0,140.0,1,146,0.0,146.0,146.0
3304.0,17,2,346,1,78,0.0,78.0,78.0,1,268,0.0,268.0,268.0
202179.0,17,4,6056,4,6056,67393.0,1514.0,1514.0,0,0,0.0,0.0,0.0
35931.0,6,14,4740,7,653,5497.0,249.0,93.28571428571428,7,4087,5042.166666666667,1514.0,583.8571428571429
205631.0,6,3,426,2,280,0.0,214.0,140.0,1,146,0.0,146.0,146.0
339.0,17,2,160,1,80,0.0,80.0,80.0,1,80,0.0,80.0,80.0
2598214.0,6,2,132,1,66,0.0,66.0,66.0,1,66,0.0,66.0,66.0
108110524.0,17,5,1005,5,1005,27027631.0,201.0,201.0,0,0,0.0,0.0,0.0
16707954.999999998,6,5,1909,2,892,0.0,826.0,446.0,3,1017,7055566.0,885.0,339.0
337.0,17,2,191,1,73,0.0,73.0,73.0,1,118,0.0,118.0,118.0
302404.0,6,2,132,1,66,0.0,66.0,66.0,1,66,0.0,66.0,66.0
196957.0,17,2,180,1,90,0.0,90.0,90.0,1,90,0.0,90.0,90.0
224171.0,6,10,1221,6,636,44834.2,298.0,106.0,4,585,73587.0,379.0,146.25
3128706.0,6,7,923,4,753,974366.6666666666,571.0,188.25,3,170,1461909.5,62.0,56.66666666666666
102660.0,17,2,286,2,286,0.0,143.0,143.0,0,0,0.0,0.0,0.0
90052689.0,17,28,13364,28,13364,3335284.777777778,501.0,477.2857142857143,0,0,0.0,0.0,0.0
217820.0,6,3,426,2,280,0.0,214.0,140.0,1,146,0.0,146.0,146.0
120048520.0,17,28,13364,28,13364,4446241.481481481,501.0,477.2857142857143,0,0,0.0,0.0,0.0
50925.0,17,2,180,1,90,0.0,90.0,90.0,1,90,0.0,90.0,90.0
153447.0,17,2,180,1,90,0.0,90.0,90.0,1,90,0.0,90.0,90.0
120536.0,6,14,4740,7,653,12916.833333333334,249.0,93.28571428571428,7,4087,18788.666666666668,1514.0,583.8571428571429
206100.0,6,3,426,2,280,0.0,214.0,140.0,1,146,0.0,146.0,146.0
243423.0,6,3,337,2,214,0.0,160.0,107.0,1,123,0.0,123.0,123.0
507001.00000000006,6,5,336,2,134,0.0,68.0,67.0,3,202,195037.0,70.0,67.33333333333333
90288534.0,6,19,1436,10,745,10026446.555555556,95.0,74.5,9,691,11285200.25,95.0,76.77777777777777
53329.0,6,2,132,1,66,0.0,66.0,66.0,1,66,0.0,66.0,66.0
62068.0,6,14,4740,7,653,9632.833333333334,249.0,93.28571428571428,7,4087,10130.666666666666,1514.0,583.8571428571429
90284826.0,6,16,1192,8,596,12891930.285714284,95.0,74.5,8,596,12896143.0,95.0,74.5
299621.0,17,2,180,1,90,0.0,90.0,90.0,1,90,0.0,90.0,90.0
107515.0,17,2,286,2,286,0.0,143.0,143.0,0,0,0.0,0.0,0.0
209974.0,6,10,1221,6,636,41994.8,298.0,106.0,4,585,68534.66666666667,379.0,146.25
108108048.0,17,5,1005,5,1005,27027012.0,201.0,201.0,0,0,0.0,0.0,0.0
120154533.0,6,15,2152,9,1204,15019316.625,188.0,133.77777777777777,6,948,18018886.2,204.0,158.0
246099.0,6,3,337,2,214,0.0,160.0,107.0,1,123,0.0,123.0,123.0
48153.0,6,12,1393,6,796,7516.0,271.0,132.66666666666666,6,597,8108.0,259.0,99.5
45025.0,6,14,4740,7,653,7340.0,249.0,93.28571428571428,7,4087,6539.0,1514.0,583.8571428571429
0.0,17,1,72,1,72,0.0,72.0,72.0,0,0,0.0,0.0,0.0
2598407.0,6,2,132,1,66,0.0,66.0,66.0,1,66,0.0,66.0,66.0
119904.0,17,2,180,1,70,0.0,70.0,70.0,1,110,0.0,110.0,110.0
27353970.0,17,5,1710,5,1710,6838492.5,342.0,342.0,0,0,0.0,0.0,0.0
53771.0,6,10,2032,5,524,13178.5,252.0,104.8,5,1508,12857.0,1236.0,301.6
106778885.0,6,43,2838,22,1452,5069835.523809524,66.0,66.0,21,1386,5155447.4,66.0,66.0
3174440.0,6,18,1495,9,921,358367.125,315.0,102.33333333333331,9,574,356754.75,78.0,63.77777777777778
348113.0,6,3,1604,2,851,0.0,785.0,425.5,1,753,0.0,753.0,753.0
113166657.0,6,252,29102,126,8612,898712.68,140.0,68.34920634920636,126,20490,898765.824,284.0,162.61904761904762
166025.0,6,14,4740,7,653,26897.83333333333,249.0,93.28571428571428,7,4087,18070.666666666668,1514.0,583.8571428571429
33099.0,6,10,2032,5,524,8039.25,252.0,104.8,5,1508,7633.0,1236.0,301.6
258814.0,6,10,1221,6,636,51762.8,298.0,106.0,4,585,80847.66666666667,379.0,146.25
22584.0,17,2,582,1,83,0.0,83.0,83.0,1,499,0.0,499.0,499.0
252129.0,6,3,337,2,214,0.0,160.0,107.0,1,123,0.0,123.0,123.0
298005.0,6,6,412,4,272,99335.0,74.0,68.0,2,140,0.0,74.0,70.0
252507.0,6,3,373,2,238,0.0,172.0,119.0,1,135,0.0,135.0,135.0
300.0,17,2,168,1,76,0.0,76.0,76.0,1,92,0.0,92.0,92.0
2375.0,17,4,344,2,150,0.0,75.0,75.0,2,194,0.0,103.0,97.0
330.0,17,2,166,1,75,0.0,75.0,75.0,1,91,0.0,91.0,91.0
345.0,17,2,267,1,83,0.0,83.0,83.0,1,184,0.0,184.0,184.0
103490.0,17,2,286,2,286,0.0,143.0,143.0,0,0,0.0,0.0,0.0
42749.0,6,14,4740,7,653,6420.0,249.0,93.28571428571428,7,4087,6755.5,1514.0,583.8571428571429
254148.0,6,3,337,2,214,0.0,160.0,107.0,1,123,0.0,123.0,123.0
316240.0,17,4,1400,4,1400,105413.33333333331,350.0,350.0,0,0,0.0,0.0,0.0
1191445.0,17,6,1230,3,234,595533.5,78.0,78.0,3,996,595519.5,332.0,332.0
196887.0,17,2,180,1,90,0.0,90.0,90.0,1,90,0.0,90.0,90.0
120983.0,6,3,337,2,214,0.0,160.0,107.0,1,123,0.0,123.0,123.0
42049.0,6,14,4740,7,653,6855.5,249.0,93.28571428571428,7,4087,6484.833333333333,1514.0,583.8571428571429
299.0,17,2,164,1,82,0.0,82.0,82.0,1,82,0.0,82.0,82.0
73747.0,6,13,1420,7,789,11644.5,253.0,112.71428571428572,6,631,12637.6,293.0,105.16666666666669
42873.0,6,10,2032,5,524,6097.25,252.0,104.8,5,1508,9487.75,1236.0,301.6
2825245.0,6,3,1604,2,851,0.0,785.0,425.5,1,753,0.0,753.0,753.0
1303220.0,6,4,264,2,132,0.0,66.0,66.0,2,132,0.0,66.0,66.0
108103867.0,17,5,955,5,955,27025966.75,191.0,191.0,0,0,0.0,0.0,0.0
118285525.0,6,217,24516,109,17166,1095236.3425925926,300.0,157.4862385321101,108,7350,1095815.953271028,140.0,68.05555555555556
90291485.0,6,21,1585,11,840,9024937.5,95.0,76.36363636363636,10,745,9945548.777777778,95.0,74.5
318689.0,17,4,1400,4,1400,106229.66666666669,350.0,350.0,0,0,0.0,0.0,0.0
90297320.0,6,16,1192,8,596,12893131.285714284,95.0,74.5,8,596,12898175.857142856,95.0,74.5
108101005.0,17,5,1005,5,1005,27025251.25,201.0,201.0,0,0,0.0,0.0,0.0
112208320.0,6,29,1930,15,948,8014880.0,123.0,63.2,14,982,7846692.076923077,139.0,70.14285714285714
93200544.0,6,750,152044,380,127032,245343.5725593668,1514.0,334.29473684210524,370,25012,251992.50406504064,214.0,67.6
1956.0,17,4,344,2,150,0.0,75.0,75.0,2,194,0.0,103.0,97.0
39054.0,6,10,2032,5,524,8850.0,252.0,104.8,5,1508,7078.5,1236.0,301.6
109000993.0,17,13,821,7,432,18166832.166666668,174.0,61.71428571428572,6,389,19899637.4,174.0,64.83333333333333
210441.0,6,14,4740,7,653,34025.0,249.0,93.28571428571428,7,4087,34653.333333333336,1514.0,583.8571428571429
40799.0,6,14,4740,7,653,5691.666666666667,249.0,93.28571428571428,7,4087,6391.0,1514.0,583.8571428571429
112337856.0,17,14,864,7,432,18667037.166666668,174.0,61.71428571428572,7,432,18667969.83333333,174.0,61.71428571428572
314.0,17,2,174,1,79,0.0,79.0,79.0,1,95,0.0,95.0,95.0
219352.0,6,3,426,2,280,0.0,214.0,140.0,1,146,0.0,146.0,146.0
10288.0,6,11,2098,6,590,1830.8,252.0,98.33333333333331,5,1508,2337.75,1236.0,301.6
181710.0,17,2,180,1,90,0.0,90.0,90.0,1,90,0.0,90.0,90.0
39627.0,6,10,2032,5,524,9685.0,252.0,104.8,5,1508,9681.5,1236.0,301.6
2291.0,17,4,344,2,150,0.0,75.0,75.0,2,194,0.0,103.0,97.0
272308.0,6,10,1221,6,636,54461.6,298.0,106.0,4,585,84981.33333333333,379.0,146.25
316911.0,17,4,1400,4,1400,105637.0,350.0,350.0,0,0,0.0,0.0,0.0
21753.0,6,10,2032,5,524,5205.75,252.0,104.8,5,1508,5176.75,1236.0,301.6
332.0,17,2,166,1,75,0.0,75.0,75.0,1,91,0.0,91.0,91.0
196750.0,17,2,180,1,90,0.0,90.0,90.0,1,90,0.0,90.0,90.0
319901.0,17,4,1400,4,1400,106633.66666666669,350.0,350.0,0,0,0.0,0.0,0.0
336713.0,17,4,704,2,148,0.0,74.0,74.0,2,556,0.0,280.0,278.0
307891.0,6,6,412,4,272,102630.33333333331,74.0,68.0,2,140,0.0,74.0,70.0
90202956.0,6,16,1192,8,596,12852182.142857144,95.0,74.5,8,596,12856811.142857144,95.0,74.5
103187.0,17,2,286,2,286,0.0,143.0,143.0,0,0,0.0,0.0,0.0
108113154.0,17,5,1005,5,1005,27028288.5,201.0,201.0,0,0,0.0,0.0,0.0
31862582.0,6,5,336,2,134,0.0,68.0,67.0,3,202,15860204.5,70.0,67.33333333333333
120246598.0,6,228,25628,114,7820,1056894.1061946903,140.0,68.59649122807018,114,17808,1039461.8230088496,284.0,156.21052631578948
5633800.0,6,5,336,2,134,0.0,68.0,67.0,3,202,1424282.0,70.0,67.33333333333333
3132.0,17,2,224,1,76,0.0,76.0,76.0,1,148,0.0,148.0,148.0
18750369.0,6,5,1736,2,819,0.0,753.0,409.5,3,917,7976135.5,785.0,305.6666666666667
120284026.0,6,409,49016,205,35256,589627.5784313725,300.0,171.98048780487804,204,13760,588050.921182266,140.0,67.45098039215686
90030785.0,17,28,13364,28,13364,3334473.5185185187,501.0,477.2857142857143,0,0,0.0,0.0,0.0
113251641.0,6,46,3036,23,1518,5135436.5,66.0,66.0,23,1518,5135436.7727272725,66.0,66.0
3166.0,17,2,224,1,76,0.0,76.0,76.0,1,148,0.0,148.0,148.0
2079.0,17,4,344,2,150,0.0,75.0,75.0,2,194,0.0,103.0,97.0
301.0,17,2,174,1,79,0.0,79.0,79.0,1,95,0.0,95.0,95.0
902.0,17,4,438,2,148,0.0,74.0,74.0,2,290,0.0,147.0,145.0
207116.0,6,3,426,2,280,0.0,214.0,140.0,1,146,0.0,146.0,146.0
100074532.0,17,12,778,6,389,19958912.6,174.0,64.83333333333333,6,389,19983119.8,174.0,64.83333333333333
70625.0,6,13,1386,7,789,11770.833333333334,253.0,112.71428571428572,6,597,13302.4,259.0,99.5
94829430.0,6,185,20916,93,14622,1030754.6739130436,284.0,157.2258064516129,92,6294,1030676.6483516484,140.0,68.41304347826087
90257000.0,6,16,2423,9,1284,11282125.0,204.0,142.66666666666666,7,1139,15015527.666666666,199.0,162.71428571428572
5623105.0,6,4,270,2,134,0.0,68.0,67.0,2,136,0.0,70.0,68.0
15022576.0,6,5,370,5,370,3755644.0,74.0,74.0,0,0,0.0,0.0,0.0
90034073.0,17,28,13364,28,13364,3334595.296296296,501.0,477.2857142857143,0,0,0.0,0.0,0.0
50602.0,6,10,2032,5,524,12435.25,252.0,104.8,5,1508,10802.0,1236.0,301.6
10883062.0,6,8,544,4,272,3582170.0,74.0,68.0,4,272,3582109.333333333,74.0,68.0
381571.0,6,12,1373,7,714,63595.16666666666,298.0,102.0,5,659,93934.75,379.0,131.8
197272.0,17,2,180,1,90,0.0,90.0,90.0,1,90,0.0,90.0,90.0
10478102.0,6,7,478,4,272,3447320.6666666665,74.0,68.0,3,206,5170856.5,74.0,68.66666666666667
30144.0,6,14,4740,7,653,4472.0,249.0,93.28571428571428,7,4087,4888.5,1514.0,583.8571428571429
15996983.0,6,27,9215,14,2115,1230537.1538461538,408.0,151.07142857142858,13,7100,1000838.0,1514.0,546.1538461538462
119882094.0,6,779,138322,384,25862,312955.6553524804,214.0,67.34895833333333,395,112460,304220.35532994923,1514.0,284.7088607594937
120207625.0,6,18,1341,9,691,14998885.125,95.0,76.77777777777777,9,650,14998913.625,95.0,72.22222222222223
90053909.0,17,28,13364,28,13364,3335329.962962963,501.0,477.2857142857143,0,0,0.0,0.0,0.0
90036396.0,17,28,13364,28,13364,3334681.333333333,501.0,477.2857142857143,0,0,0.0,0.0,0.0
3263989.0,6,7,923,4,753,1019366.0,571.0,188.25,3,170,1529594.0,62.0,56.66666666666666
2568412.0,6,3,1604,2,851,0.0,785.0,425.5,1,753,0.0,753.0,753.0
30104.0,6,11,2098,6,590,5874.6,252.0,98.33333333333331,5,1508,6274.75,1236.0,301.6
2699131.0,6,3,1604,1,753,0.0,753.0,753.0,2,851,0.0,785.0,425.5
0.0,6,1,66,1,66,0.0,66.0,66.0,0,0,0.0,0.0,0.0
39495.0,6,14,4740,7,653,6414.333333333333,249.0,93.28571428571428,7,4087,6396.166666666667,1514.0,583.8571428571429
120053119.0,17,29,13785,29,13785,4287611.392857143,501.0,475.3448275862069,0,0,0.0,0.0,0.0
307898.0,6,6,412,4,272,102632.66666666669,74.0,68.0,2,140,0.0,74.0,70.0
113710455.0,6,48,3168,24,1584,4943932.826086956,66.0,66.0,24,1584,4935481.739130435,66.0,66.0
266676.0,6,10,1221,6,636,53335.2,298.0,106.0,4,585,81679.66666666667,379.0,146.25
2655541.0,6,25,7573,14,3735,204272.38461538465,1514.0,266.7857142857143,11,3838,239933.5,1514.0,348.90909090909093
103152.0,17,2,286,2,286,0.0,143.0,143.0,0,0,0.0,0.0,0.0
109135.0,17,2,286,2,286,0.0,143.0,143.0,0,0,0.0,0.0,0.0
120115796.0,6,13,2036,8,1016,17136471.714285713,188.0,127.0,5,1020,22525630.0,204.0,204.0
362.0,17,2,267,1,83,0.0,83.0,83.0,1,184,0.0,184.0,184.0
102103.0,17,2,700,2,700,0.0,350.0,350.0,0,0,0.0,0.0,0.0
147216.0,6,3,373,2,238,0.0,172.0,119.0,1,135,0.0,135.0,135.0
90528047.0,6,16,2372,8,1016,12932578.142857144,188.0,127.0,8,1356,12903999.142857144,204.0,169.5
302650.0,6,6,412,4,272,100883.33333333331,74.0,68.0,2,140,0.0,74.0,70.0
31045.0,6,14,4740,7,653,4587.833333333333,249.0,93.28571428571428,7,4087,4903.5,1514.0,583.8571428571429
2059354.0,6,25,7610,13,2516,171612.83333333334,1034.0,193.53846153846155,12,5094,160210.54545454544,1510.0,424.5
142359.0,17,4,704,2,148,0.0,74.0,74.0,2,556,0.0,280.0,278.0
196894.0,17,2,180,1,90,0.0,90.0,90.0,1,90,0.0,90.0,90.0
319098.0,17,4,1400,4,1400,106366.0,350.0,350.0,0,0,0.0,0.0,0.0
30799.0,6,14,4740,7,653,4988.5,249.0,93.28571428571428,7,4087,3835.3333333333335,1514.0,583.8571428571429
11367.0,6,11,2098,6,590,2072.6,252.0,98.33333333333331,5,1508,1991.25,1236.0,301.6
111188.0,17,4,1400,4,1400,37062.66666666666,350.0,350.0,0,0,0.0,0.0,0.0
24670.0,6,14,4740,7,653,3944.1666666666665,249.0,93.28571428571428,7,4087,2893.833333333333,1514.0,583.8571428571429
99863370.0,6,24,1500,12,783,9058868.818181818,123.0,65.25,12,717,9058867.818181818,123.0,59.75
153564.0,17,2,180,1,90,0.0,90.0,90.0,1,90,0.0,90.0,90.0
127214858.0,6,44,3316,22,1602,5582361.952380952,123.0,72.81818181818181,22,1714,5582370.714285715,139.0,77.9090909090909
135156249.0,17,6,1206,6,1206,27031249.8,201.0,201.0,0,0,0.0,0.0,0.0
2485146.0,6,25,7573,14,3735,191165.0769230769,1514.0,266.7857142857143,11,3838,222386.0,1514.0,348.90909090909093
153419.0,17,2,180,1,90,0.0,90.0,90.0,1,90,0.0,90.0,90.0
107387.0,17,2,286,2,286,0.0,143.0,143.0,0,0,0.0,0.0,0.0
135134945.0,17,6,1146,6,1146,27026989.0,191.0,191.0,0,0,0.0,0.0,0.0
51322.0,6,14,4740,7,653,7919.666666666667,249.0,93.28571428571428,7,4087,8273.833333333334,1514.0,583.8571428571429
118013432.0,6,47,3102,24,1584,5131007.652173913,66.0,66.0,23,1518,5160001.0,66.0,66.0
90035425.0,17,28,13364,28,13364,3334645.3703703703,501.0,477.2857142857143,0,0,0.0,0.0,0.0
146490.0,6,3,337,2,214,0.0,160.0,107.0,1,123,0.0,123.0,123.0
245507.0,6,10,1221,6,636,49101.4,298.0,106.0,4,585,80996.33333333333,379.0,146.25
2802022.0,6,2,132,1,66,0.0,66.0,66.0,1,66,0.0,66.0,66.0
107857747.0,6,28,1860,14,966,8280132.076923077,123.0,69.0,14,894,8280133.538461538,123.0,63.85714285714285
91862408.0,6,178,20110,89,6096,1043891.0,140.0,68.49438202247191,89,14014,1041527.2727272728,284.0,157.46067415730337
13710510.0,17,2,180,1,90,0.0,90.0,90.0,1,90,0.0,90.0,90.0
108114655.0,17,5,1005,5,1005,27028663.75,201.0,201.0,0,0,0.0,0.0,0.0
202340.0,17,2,762,2,762,0.0,381.0,381.0,0,0,0.0,0.0,0.0
301420.0,6,6,412,4,272,100473.33333333331,74.0,68.0,2,140,0.0,74.0,70.0
102989.0,17,2,762,2,762,0.0,381.0,381.0,0,0,0.0,0.0,0.0
110865823.0,6,36,2596,18,1348,6521519.0,139.0,74.88888888888889,18,1248,6508786.882352941,123.0,69.33333333333333
228261.0,17,2,180,1,90,0.0,90.0,90.0,1,90,0.0,90.0,90.0
10478872.0,6,7,478,4,272,3447546.6666666665,74.0,68.0,3,206,5171244.0,74.0,68.66666666666667
90216105.0,6,16,1192,8,596,12853719.142857144,95.0,74.5,8,596,12858766.57142857,95.0,74.5
12095.0,6,13,1459,7,862,1861.3333333333333,271.0,123.14285714285714,6,597,2262.2,259.0,99.5
315238.0,17,4,1400,4,1400,105079.33333333331,350.0,350.0,0,0,0.0,0.0,0.0
75405.0,6,25,12139,13,1023,6283.75,211.0,78.6923076923077,12,11116,6273.0,1514.0,926.3333333333334
74603827.0,6,9,842,9,842,9325478.375,97.0,93.55555555555556,0,0,0.0,0.0,0.0
90003006.0,17,28,13364,28,13364,3333444.6666666665,501.0,477.2857142857143,0,0,0.0,0.0,0.0
543.0,17,2,508,2,508,0.0,257.0,254.0,0,0,0.0,0.0,0.0
137532.0,6,2,132,1,66,0.0,66.0,66.0,1,66,0.0,66.0,66.0
10438.0,17,4,344,2,150,0.0,75.0,75.0,2,194,0.0,103.0,97.0
141038.0,6,2,132,1,66,0.0,66.0,66.0,1,66,0.0,66.0,66.0
114828457.0,6,48,3168,24,1584,4992541.608695652,66.0,66.0,24,1584,4978862.956521739,66.0,66.0
119947985.0,17,34,16284,34,16284,3634787.424242424,501.0,478.9411764705882,0,0,0.0,0.0,0.0
260991.0,6,10,1221,6,636,52198.2,298.0,106.0,4,585,81612.66666666667,379.0,146.25
103500.0,17,2,286,2,286,0.0,143.0,143.0,0,0,0.0,0.0,0.0
10439833.0,6,7,478,4,272,3432786.333333333,74.0,68.0,3,206,5149062.0,74.0,68.66666666666667
135137389.0,17,6,1206,6,1206,27027477.8,201.0,201.0,0,0,0.0,0.0,0.0
16841.0,17,2,180,1,90,0.0,90.0,90.0,1,90,0.0,90.0,90.0
120116617.0,6,214,24106,107,7284,1115621.283018868,140.0,68.07476635514018,107,16822,1125422.150943396,284.0,157.21495327102804
292792.0,17,4,1524,4,1524,97597.33333333331,381.0,381.0,0,0,0.0,0.0,0.0
5683.0,17,2,762,2,762,0.0,381.0,381.0,0,0,0.0,0.0,0.0
145230.0,17,2,180,1,70,0.0,70.0,70.0,1,110,0.0,110.0,110.0
3041.0,17,2,224,1,76,0.0,76.0,76.0,1,148,0.0,148.0,148.0
5095.0,17,4,344,2,150,0.0,75.0,75.0,2,194,0.0,103.0,97.0
10740.0,6,10,1067,5,536,2417.0,264.0,107.2,5,531,2425.25,259.0,106.2
2000.0,17,4,344,2,150,0.0,75.0,75.0,2,194,0.0,103.0,97.0
232901.0,6,3,337,2,214,0.0,160.0,107.0,1,123,0.0,123.0,123.0
303014.0,6,6,412,4,272,101004.66666666669,74.0,68.0,2,140,0.0,74.0,70.0
171533.0,17,2,180,1,90,0.0,90.0,90.0,1,90,0.0,90.0,90.0
122525649.0,6,213,24008,107,16716,1155902.349056604,284.0,156.22429906542055,106,7292,1138375.3333333333,140.0,68.79245283018868
3006921.0,6,11,2106,6,598,601215.8,252.0,99.66666666666669,5,1508,1544.25,1236.0,301.6
323413.0,17,4,1400,4,1400,107804.33333333331,350.0,350.0,0,0,0.0,0.0,0.0
1311769.0,6,4,264,2,132,0.0,66.0,66.0,2,132,0.0,66.0,66.0
28165.0,6,14,4740,7,653,3903.8333333333335,249.0,93.28571428571428,7,4087,4485.5,1514.0,583.8571428571429
307992.0,17,4,1400,4,1400,102664.0,350.0,350.0,0,0,0.0,0.0,0.0
167828.0,17,2,414,1,88,0.0,88.0,88.0,1,326,0.0,326.0,326.0
307141.0,6,6,412,4,272,102380.33333333331,74.0,68.0,2,140,0.0,74.0,70.0
301984.0,6,6,412,4,272,100661.33333333331,74.0,68.0,2,140,0.0,74.0,70.0
103649172.0,6,44,2904,22,1452,4935674.857142857,66.0,66.0,22,1452,4922492.238095238,66.0,66.0
1321100.0,17,7,490,7,490,220183.3333333333,70.0,70.0,0,0,0.0,0.0,0.0
209559.0,17,2,180,1,90,0.0,90.0,90.0,1,90,0.0,90.0,90.0
143913.0,17,2,180,1,90,0.0,90.0,90.0,1,90,0.0,90.0,90.0
153456.0,17,2,180,1,90,0.0,90.0,90.0,1,90,0.0,90.0,90.0
2328.0,17,4,344,2,150,0.0,75.0,75.0,2,194,0.0,103.0,97.0
1975609.0,6,27,11985,14,4295,151969.92307692306,1510.0,306.7857142857143,13,7690,139247.08333333334,1510.0,591.5384615384615
298160.0,6,6,412,4,272,99386.66666666669,74.0,68.0,2,140,0.0,74.0,70.0
12908.0,6,10,2032,5,524,2648.5,252.0,104.8,5,1508,2976.5,1236.0,301.6
90039747.0,17,28,13364,28,13364,3334805.4444444445,501.0,477.2857142857143,0,0,0.0,0.0,0.0
401358.0,6,10,1221,6,636,80271.6,298.0,106.0,4,585,132579.66666666666,379.0,146.25
42920.0,6,10,2032,5,524,9505.25,252.0,104.8,5,1508,7784.0,1236.0,301.6
80.0,17,2,700,2,700,0.0,350.0,350.0,0,0,0.0,0.0,0.0
144864.0,6,2,132,1,66,0.0,66.0,66.0,1,66,0.0,66.0,66.0
323508.0,17,2,180,1,90,0.0,90.0,90.0,1,90,0.0,90.0,90.0
3008533.0,6,12,2172,7,664,501329.0,252.0,94.85714285714286,5,1508,2329.25,1236.0,301.6
305278.0,6,6,412,4,272,101759.33333333331,74.0,68.0,2,140,0.0,74.0,70.0
135133760.0,17,6,1206,6,1206,27026752.0,201.0,201.0,0,0,0.0,0.0,0.0
120001573.0,17,14,864,8,475,17143081.85714286,174.0,59.375,6,389,20000983.8,174.0,64.83333333333333
2421616.0,6,2,132,1,66,0.0,66.0,66.0,1,66,0.0,66.0,66.0
112721585.0,6,36,2596,18,1348,6617974.352941177,139.0,74.88888888888889,18,1248,6617975.176470588,123.0,69.33333333333333
2024.0,17,4,344,2,150,0.0,75.0,75.0,2,194,0.0,103.0,97.0
39559.0,6,14,4740,7,653,5497.666666666667,249.0,93.28571428571428,7,4087,5128.5,1514.0,583.8571428571429
2964.0,17,2,224,1,76,0.0,76.0,76.0,1,148,0.0,148.0,148.0
156134.0,6,13,1386,7,789,26022.33333333333,253.0,112.71428571428572,6,597,28633.8,259.0,99.5
111461976.0,6,32,2220,16,1149,7416408.266666667,123.0,71.8125,16,1071,7416403.0,123.0,66.9375
232392.0,6,3,337,2,214,0.0,160.0,107.0,1,123,0.0,123.0,123.0
2861574.0,6,3,1777,1,826,0.0,826.0,826.0,2,951,0.0,885.0,475.5
297833.0,6,6,412,4,272,99277.66666666669,74.0,68.0,2,140,0.0,74.0,70.0
115470239.0,6,48,3168,24,1584,5020445.173913044,66.0,66.0,24,1584,5011048.0869565215,66.0,66.0
201125.0,17,4,6056,4,6056,67041.66666666667,1514.0,1514.0,0,0,0.0,0.0,0.0
5010218.0,17,4,849,2,166,0.0,83.0,83.0,2,683,0.0,499.0,341.5
326215.0,17,4,704,2,148,0.0,74.0,74.0,2,556,0.0,280.0,278.0
104370.0,17,2,700,2,700,0.0,350.0,350.0,0,0,0.0,0.0,0.0
2849006.0,6,3,204,2,136,0.0,70.0,68.0,1,68,0.0,68.0,68.0
100006440.0,17,14,864,7,432,16667740.0,174.0,61.71428571428572,7,432,16666844.833333334,174.0,61.71428571428572
98990.0,17,2,762,2,762,0.0,381.0,381.0,0,0,0.0,0.0,0.0
92132878.0,6,212,24874,106,17656,875395.5142857142,300.0,166.56603773584905,106,7218,875394.7047619048,140.0,68.09433962264151
144875.0,17,2,180,1,70,0.0,70.0,70.0,1,110,0.0,110.0,110.0
899.0,17,5,550,5,550,224.75,110.0,110.0,0,0,0.0,0.0,0.0
3247619.0,6,208,160575,111,149870,29523.80909090909,1510.0,1350.1801801801803,97,10705,30581.322916666668,1510.0,110.36082474226804
120021864.0,17,29,13785,29,13785,4286495.142857143,501.0,475.3448275862069,0,0,0.0,0.0,0.0
112388017.0,6,35,2526,18,1332,6598363.705882353,123.0,74.0,17,1194,7010759.875,123.0,70.23529411764706
108103047.0,17,5,955,5,955,27025761.75,191.0,191.0,0,0,0.0,0.0,0.0
250344.0,6,3,337,2,214,0.0,160.0,107.0,1,123,0.0,123.0,123.0
1155108.0,6,13,3011,8,2383,165015.42857142858,1514.0,297.875,5,628,220586.5,331.0,125.6
119779302.0,17,16,1212,8,606,17111328.85714286,174.0,75.75,8,606,17080421.85714286,174.0,75.75
1306244.0,6,4,264,2,132,0.0,66.0,66.0,2,132,0.0,66.0,66.0
153392.0,17,2,180,1,90,0.0,90.0,90.0,1,90,0.0,90.0,90.0
1894.0,17,2,176,1,80,0.0,80.0,80.0,1,96,0.0,96.0,96.0
217374.0,6,3,426,2,280,0.0,214.0,140.0,1,146,0.0,146.0,146.0
310104.0,6,6,412,4,272,103368.0,74.0,68.0,2,140,0.0,74.0,70.0
304190.0,6,3,202,2,128,0.0,74.0,64.0,1,74,0.0,74.0,74.0
2402094.0,6,26,7627,14,3735,184776.4615384616,1514.0,266.7857142857143,12,3892,193968.18181818185,1514.0,324.3333333333333
90008642.0,17,27,12943,27,12943,3461870.846153846,501.0,479.3703703703704,0,0,0.0,0.0,0.0
1172.0,17,4,438,2,148,0.0,74.0,74.0,2,290,0.0,147.0,145.0
181114.0,6,11,1132,6,556,35690.0,218.0,92.66666666666669,5,576,44983.75,304.0,115.2
50875.0,17,2,180,1,90,0.0,90.0,90.0,1,90,0.0,90.0,90.0
148452.0,6,3,337,2,214,0.0,160.0,107.0,1,123,0.0,123.0,123.0
156756.0,6,3,337,2,214,0.0,160.0,107.0,1,123,0.0,123.0,123.0
216598.0,6,3,426,2,280,0.0,214.0,140.0,1,146,0.0,146.0,146.0
294141.0,6,6,412,4,272,98047.0,74.0,68.0,2,140,0.0,74.0,70.0
14651251.0,6,20,1607,10,975,1592846.111111111,315.0,97.5,10,632,1592841.2222222222,78.0,63.2
262571.0,17,2,180,1,90,0.0,90.0,90.0,1,90,0.0,90.0,90.0
98054710.0,6,27,1869,14,963,7542670.0,123.0,68.78571428571429,13,906,8153045.833333333,123.0,69.6923076923077
247819.0,6,3,337,2,214,0.0,160.0,107.0,1,123,0.0,123.0,123.0
44693.0,6,14,4740,7,653,7318.5,249.0,93.28571428571428,7,4087,6602.833333333333,1514.0,583.8571428571429
269188.0,17,2,180,1,90,0.0,90.0,90.0,1,90,0.0,90.0,90.0
1849425.0,6,20,7599,11,1469,184942.5,583.0,133.54545454545453,9,6130,197972.625,1484.0,681.1111111111111
90210959.0,6,16,1192,8,596,12851029.142857144,95.0,74.5,8,596,12856530.42857143,95.0,74.5
48835991.0,6,8,1940,3,887,23044409.5,753.0,295.6666666666667,5,1053,11514837.0,785.0,210.6
143968.0,17,2,180,1,90,0.0,90.0,90.0,1,90,0.0,90.0,90.0
19816.0,6,10,2032,5,524,4518.5,252.0,104.8,5,1508,4350.75,1236.0,301.6
355.0,17,2,214,1,75,0.0,75.0,75.0,1,139,0.0,139.0,139.0
99728746.0,6,23,1440,12,717,9066249.636363637,123.0,59.75,11,723,8952668.1,123.0,65.72727272727273
301.0,17,2,164,1,82,0.0,82.0,82.0,1,82,0.0,82.0,82.0
314104.0,17,2,180,1,90,0.0,90.0,90.0,1,90,0.0,90.0,90.0
90306924.0,6,21,1585,11,840,9025923.6,95.0,76.36363636363636,10,745,9949062.888888888,95.0,74.5
0.0,17,1,72,1,72,0.0,72.0,72.0,0,0,0.0,0.0,0.0
329115.0,6,10,1102,5,570,81991.25,298.0,114.0,5,532,81926.5,260.0,106.4
312208.0,17,4,1400,4,1400,104069.33333333331,350.0,350.0,0,0,0.0,0.0,0.0
36197.0,6,11,2098,6,590,5854.0,252.0,98.33333333333331,5,1508,8262.0,1236.0,301.6
2083951.0,6,18,6803,10,1501,231550.11111111112,408.0,150.1,8,5302,234909.2857142857,1514.0,662.75
216508.0,17,2,180,1,90,0.0,90.0,90.0,1,90,0.0,90.0,90.0
26728.0,6,14,4740,7,653,4348.166666666667,249.0,93.28571428571428,7,4087,4313.5,1514.0,583.8571428571429
101466.0,17,2,762,2,762,0.0,381.0,381.0,0,0,0.0,0.0,0.0
305599.0,6,6,412,4,272,101866.33333333331,74.0,68.0,2,140,0.0,74.0,70.0
2103563.0,6,24,7544,12,2450,187994.45454545456,1034.0,204.16666666666663,12,5094,164185.63636363635,1510.0,424.5
153390.0,17,2,180,1,90,0.0,90.0,90.0,1,90,0.0,90.0,90.0
317149.0,17,4,1400,4,1400,105716.33333333331,350.0,350.0,0,0,0.0,0.0,0.0
28815.0,6,10,2032,5,524,5849.5,252.0,104.8,5,1508,6911.0,1236.0,301.6
91218697.0,6,160,17968,80,12466,1151941.6329113925,284.0,155.825,80,5502,1151942.5316455695,140.0,68.775
216602.0,6,3,426,2,280,0.0,214.0,140.0,1,146,0.0,146.0,146.0
110133044.0,6,33,2428,17,1288,6869836.3125,139.0,75.76470588235294,16,1140,7327826.666666667,123.0,71.25
311123.0,6,6,412,4,272,103707.66666666669,74.0,68.0,2,140,0.0,74.0,70.0
306424.0,6,6,412,4,272,102141.33333333331,74.0,68.0,2,140,0.0,74.0,70.0
109209759.0,6,32,2220,16,1149,7266236.4,123.0,71.8125,16,1071,7266222.666666667,123.0,66.9375
10513474.0,6,6,412,3,206,5188174.5,74.0,68.66666666666667,3,206,5188051.0,74.0,68.66666666666667
108661262.0,6,32,2220,16,1149,7229696.066666666,123.0,71.8125,16,1071,7229695.4,123.0,66.9375
90502566.0,6,13,2036,8,1016,12928938.0,188.0,127.0,5,1020,22582411.25,204.0,204.0
2446.0,17,4,344,2,150,0.0,75.0,75.0,2,194,0.0,103.0,97.0
14704.0,6,14,4740,7,653,2079.5,249.0,93.28571428571428,7,4087,2230.0,1514.0,583.8571428571429
101017416.0,17,13,1083,7,563,16836236.0,174.0,80.42857142857143,6,520,16200167.4,174.0,86.66666666666667
2032.0,17,4,344,2,150,0.0,75.0,75.0,2,194,0.0,103.0,97.0
233040.0,6,3,337,2,214,0.0,160.0,107.0,1,123,0.0,123.0,123.0
309253.0,17,4,1400,4,1400,103084.33333333331,350.0,350.0,0,0,0.0,0.0,0.0
28500.0,6,13,1479,7,882,4637.833333333333,291.0,126.0,6,597,5177.2,259.0,99.5
73231.0,6,10,2032,5,524,18079.0,252.0,104.8,5,1508,17799.5,1236.0,301.6
509586.0,6,5,336,2,134,0.0,68.0,67.0,3,202,195441.5,70.0,67.33333333333333
8009708.0,17,2,684,2,684,0.0,342.0,342.0,0,0,0.0,0.0,0.0
4378.0,17,2,602,1,72,0.0,72.0,72.0,1,530,0.0,530.0,530.0
105051952.0,17,15,5130,15,5130,7503710.857142857,342.0,342.0,0,0,0.0,0.0,0.0
21377.0,17,2,582,1,83,0.0,83.0,83.0,1,499,0.0,499.0,499.0
90064436.0,17,28,13364,28,13364,3335719.851851852,501.0,477.2857142857143,0,0,0.0,0.0,0.0
149916152.0,17,35,16705,35,16705,4409298.588235294,501.0,477.2857142857143,0,0,0.0,0.0,0.0
14314.0,6,13,1459,7,862,2318.0,271.0,123.14285714285714,6,597,2444.6,259.0,99.5
25368.0,17,2,180,1,90,0.0,90.0,90.0,1,90,0.0,90.0,90.0
4213.0,17,2,614,1,72,0.0,72.0,72.0,1,542,0.0,542.0,542.0
29248493.0,17,5,1718,4,1368,1810398.6666666667,342.0,342.0,1,350,0.0,350.0,350.0
146241.0,6,3,337,2,214,0.0,160.0,107.0,1,123,0.0,123.0,123.0
18183.0,6,10,2032,5,524,4327.0,252.0,104.8,5,1508,3971.75,1236.0,301.6
10440700.0,6,7,478,4,272,3434729.0,74.0,68.0,3,206,5151948.0,74.0,68.66666666666667
40870.0,6,10,2032,5,524,9982.75,252.0,104.8,5,1508,9789.0,1236.0,301.6
418276.0,6,3,1604,1,753,0.0,753.0,753.0,2,851,0.0,785.0,425.5
121738479.0,6,47,3102,23,1518,5160001.5,66.0,66.0,24,1584,5292965.608695652,66.0,66.0
203547.0,6,10,1221,6,636,40709.4,298.0,106.0,4,585,66519.0,379.0,146.25
2038307.0,17,6,1230,3,234,1018961.0,78.0,78.0,3,996,1018947.5,332.0,332.0
283570.0,17,2,363,1,79,0.0,79.0,79.0,1,284,0.0,284.0,284.0
200181.0,17,2,762,2,762,0.0,381.0,381.0,0,0,0.0,0.0,0.0
135137258.0,17,6,1146,6,1146,27027451.6,191.0,191.0,0,0,0.0,0.0,0.0
308.0,17,2,164,1,82,0.0,82.0,82.0,1,82,0.0,82.0,82.0
15165.0,6,10,1066,5,490,3618.75,218.0,98.0,5,576,2005.0,304.0,115.2
876.0,17,4,438,2,148,0.0,74.0,74.0,2,290,0.0,147.0,145.0
352.0,17,2,174,1,79,0.0,79.0,79.0,1,95,0.0,95.0,95.0
153395.0,17,2,180,1,90,0.0,90.0,90.0,1,90,0.0,90.0,90.0
1498517.0,6,2,132,1,66,0.0,66.0,66.0,1,66,0.0,66.0,66.0
160966.0,17,2,180,1,90,0.0,90.0,90.0,1,90,0.0,90.0,90.0
299112.0,6,6,412,4,272,99704.0,74.0,68.0,2,140,0.0,74.0,70.0
2029.0,17,4,344,2,150,0.0,75.0,75.0,2,194,0.0,103.0,97.0
114196147.0,6,47,3102,24,1584,4965038.608695652,66.0,66.0,23,1518,5160019.227272728,66.0,66.0
331.0,17,2,267,1,83,0.0,83.0,83.0,1,184,0.0,184.0,184.0
2380.0,17,4,344,2,150,0.0,75.0,75.0,2,194,0.0,103.0,97.0
106922.0,17,2,286,2,286,0.0,143.0,143.0,0,0,0.0,0.0,0.0
121776.0,6,3,337,2,214,0.0,160.0,107.0,1,123,0.0,123.0,123.0
33351.0,6,11,2098,6,590,5433.8,252.0,98.33333333333331,5,1508,7236.5,1236.0,301.6
593069.0,6,4,508,2,238,0.0,172.0,119.0,2,270,0.0,135.0,135.0
204342.0,17,2,762,2,762,0.0,381.0,381.0,0,0,0.0,0.0,0.0
499360.0,6,5,336,2,134,0.0,68.0,67.0,3,202,191543.0,70.0,67.33333333333333
210430.0,17,2,414,1,88,0.0,88.0,88.0,1,326,0.0,326.0,326.0
116295416.0,17,14,864,7,432,19334432.83333333,174.0,61.71428571428572,7,432,19333505.83333333,174.0,61.71428571428572
116423084.0,6,35,2542,18,1348,6835708.94117647,139.0,74.88888888888889,17,1194,7262939.4375,123.0,70.23529411764706
10665.0,6,10,1067,5,536,2503.25,264.0,107.2,5,531,2449.75,259.0,106.2
491.0,17,2,267,1,83,0.0,83.0,83.0,1,184,0.0,184.0,184.0
51117.0,17,2,180,1,90,0.0,90.0,90.0,1,90,0.0,90.0,90.0
113520269.0,6,46,3036,23,1518,5160000.954545454,66.0,66.0,23,1518,5160000.590909091,66.0,66.0
12658.0,6,11,1132,6,556,2215.8,218.0,92.66666666666669,5,576,2590.25,304.0,115.2
404151.0,6,4,508,2,238,0.0,172.0,119.0,2,270,0.0,135.0,135.0
45561.0,6,10,2032,5,524,11178.75,252.0,104.8,5,1508,10915.0,1236.0,301.6
90263405.0,6,13,2036,8,1016,12894772.142857144,188.0,127.0,5,1020,22523234.0,204.0,204.0
54794.0,6,14,4740,7,653,8702.166666666666,249.0,93.28571428571428,7,4087,7458.0,1514.0,583.8571428571429
90053600.0,17,27,12943,27,12943,3463600.0,501.0,479.3703703703704,0,0,0.0,0.0,0.0
413.0,17,2,410,1,78,0.0,78.0,78.0,1,332,0.0,332.0,332.0
298211.0,6,6,412,4,272,99403.66666666669,74.0,68.0,2,140,0.0,74.0,70.0
46390.0,6,14,4740,7,653,7417.333333333333,249.0,93.28571428571428,7,4087,5486.0,1514.0,583.8571428571429
347826.0,17,2,582,1,83,0.0,83.0,83.0,1,499,0.0,499.0,499.0
102137.0,17,2,286,2,286,0.0,143.0,143.0,0,0,0.0,0.0,0.0
50232.0,6,14,4740,7,653,8249.833333333334,249.0,93.28571428571428,7,4087,7898.166666666667,1514.0,583.8571428571429
23393610.0,6,29,9249,16,3843,156220.86666666667,1514.0,240.1875,13,5406,1931441.6666666667,1514.0,415.84615384615387
213678.0,17,2,180,1,90,0.0,90.0,90.0,1,90,0.0,90.0,90.0
305251.0,17,4,571,2,148,0.0,74.0,74.0,2,423,0.0,280.0,211.5
112036818.0,6,31,2182,16,1165,7454732.4,139.0,72.8125,15,1017,7987211.642857143,123.0,67.8
302628.0,17,2,180,1,90,0.0,90.0,90.0,1,90,0.0,90.0,90.0
62602.00000000001,6,14,4740,7,653,10155.166666666666,249.0,93.28571428571428,7,4087,10155.666666666666,1514.0,583.8571428571429
2891046.0,6,3,1777,2,951,0.0,885.0,475.5,1,826,0.0,826.0,826.0
18808.0,6,14,4740,7,653,2960.333333333333,249.0,93.28571428571428,7,4087,2981.5,1514.0,583.8571428571429
0.0,6,1,172,1,172,0.0,172.0,172.0,0,0,0.0,0.0,0.0
123839950.0,6,49,3234,25,1650,5159997.916666667,66.0,66.0,24,1584,5108495.260869565,66.0,66.0
100935.0,17,2,762,2,762,0.0,381.0,381.0,0,0,0.0,0.0,0.0
6017616.0,6,3,272,0,0,0.0,0.0,0.0,3,272,3008808.0,103.0,90.66666666666669
5836458.0,6,5,336,2,134,0.0,68.0,67.0,3,202,1527839.5,70.0,67.33333333333333
144069.0,17,2,180,1,90,0.0,90.0,90.0,1,90,0.0,90.0,90.0
24193.0,6,10,2032,5,524,5649.0,252.0,104.8,5,1508,5799.25,1236.0,301.6
51135.0,17,2,180,1,90,0.0,90.0,90.0,1,90,0.0,90.0,90.0
7048452.0,6,34,8929,18,4974,414614.82352941175,1514.0,276.3333333333333,16,3955,398277.6,1514.0,247.1875
216901.0,6,3,426,2,280,0.0,214.0,140.0,1,146,0.0,146.0,146.0
29512.0,6,10,2032,5,524,7018.5,252.0,104.8,5,1508,7010.0,1236.0,301.6
4684.0,17,2,180,1,90,0.0,90.0,90.0,1,90,0.0,90.0,90.0
91108.0,6,12,1447,6,816,17204.6,291.0,136.0,6,631,17209.4,293.0,105.16666666666669
197021.0,17,2,180,1,90,0.0,90.0,90.0,1,90,0.0,90.0,90.0
1041773.0,6,11,1134,6,558,208354.6,220.0,93.0,5,576,258829.5,304.0,115.2
26105.0,6,10,2032,5,524,6088.0,252.0,104.8,5,1508,5755.25,1236.0,301.6
850293.0,6,9,1118,6,586,170058.6,248.0,97.66666666666669,3,532,286937.0,392.0,177.33333333333334
2387.0,17,4,344,2,150,0.0,75.0,75.0,2,194,0.0,103.0,97.0
120037042.0,17,28,13364,28,13364,4445816.37037037,501.0,477.2857142857143,0,0,0.0,0.0,0.0
135136617.0,17,6,1206,6,1206,27027323.4,201.0,201.0,0,0,0.0,0.0,0.0
90020263.0,17,28,13364,28,13364,3334083.814814815,501.0,477.2857142857143,0,0,0.0,0.0,0.0
2058.0,17,4,344,2,150,0.0,75.0,75.0,2,194,0.0,103.0,97.0
90094395.0,6,13,2052,6,1224,18018635.2,204.0,204.0,7,828,15015331.833333334,188.0,118.28571428571428
2344.0,17,4,344,2,150,0.0,75.0,75.0,2,194,0.0,103.0,97.0
192537.0,17,2,180,1,90,0.0,90.0,90.0,1,90,0.0,90.0,90.0
107232336.0,6,35,2526,18,1332,6307784.470588235,123.0,74.0,17,1194,6689213.375,123.0,70.23529411764706
239722.0,6,3,337,2,214,0.0,160.0,107.0,1,123,0.0,123.0,123.0
3254.0,17,2,363,1,79,0.0,79.0,79.0,1,284,0.0,284.0,284.0
311957.0,6,3,202,2,128,0.0,74.0,64.0,1,74,0.0,74.0,74.0
329.0,17,2,208,1,72,0.0,72.0,72.0,1,136,0.0,136.0,136.0
14398.0,6,11,1132,6,556,2879.6,218.0,92.66666666666669,5,576,2810.75,304.0,115.2
123008658.0,17,15,1169,8,606,17572665.42857143,174.0,75.75,7,563,17166813.5,174.0,80.42857142857143
228381.0,17,2,180,1,90,0.0,90.0,90.0,1,90,0.0,90.0,90.0
302144.0,17,2,180,1,90,0.0,90.0,90.0,1,90,0.0,90.0,90.0
119944964.0,17,35,16705,35,16705,3527793.0588235296,501.0,477.2857142857143,0,0,0.0,0.0,0.0
377803.0,6,3,202,2,128,0.0,74.0,64.0,1,74,0.0,74.0,74.0
120005200.0,6,23,1734,12,935,10909038.454545457,95.0,77.91666666666667,11,799,11971930.7,95.0,72.63636363636364
205843.0,17,2,180,1,90,0.0,90.0,90.0,1,90,0.0,90.0,90.0
120106035.0,6,15,2428,9,1204,15013254.375,188.0,133.77777777777777,6,1224,18018025.2,204.0,204.0
618.0,17,2,508,2,508,0.0,257.0,254.0,0,0,0.0,0.0,0.0
153458.0,17,2,180,1,90,0.0,90.0,90.0,1,90,0.0,90.0,90.0
218077.0,6,3,426,2,280,0.0,214.0,140.0,1,146,0.0,146.0,146.0
858414.0,6,9,1196,6,725,171682.8,387.0,120.83333333333331,3,471,291381.0,331.0,157.0
145800.0,6,3,337,2,214,0.0,160.0,107.0,1,123,0.0,123.0,123.0
217354.0,6,3,426,2,280,0.0,214.0,140.0,1,146,0.0,146.0,146.0
13721980.0,17,1455,619756,917,576874,14975.25,1434.0,629.0883315158125,538,42882,25547.22905027933,351.0,79.70631970260223
30390.0,6,14,4740,7,653,4941.333333333333,249.0,93.28571428571428,7,4087,4553.833333333333,1514.0,583.8571428571429
524962.0,6,3,1604,1,753,0.0,753.0,753.0,2,851,0.0,785.0,425.5
206400.0,17,2,180,1,90,0.0,90.0,90.0,1,90,0.0,90.0,90.0
2433.0,17,4,344,2,150,0.0,75.0,75.0,2,194,0.0,103.0,97.0
2350.0,17,4,344,2,150,0.0,75.0,75.0,2,194,0.0,103.0,97.0
121166974.0,6,226,25656,113,7680,1065303.9107142857,140.0,67.96460176991151,113,17976,1074524.044642857,284.0,159.0796460176991
199158.0,17,4,1524,4,1524,66386.0,381.0,381.0,0,0,0.0,0.0,0.0
107033.0,17,2,286,2,286,0.0,143.0,143.0,0,0,0.0,0.0,0.0
116596417.0,6,48,3168,24,1584,5069409.434782608,66.0,66.0,24,1584,5055948.217391305,66.0,66.0
44715.0,6,14,4740,7,653,7088.666666666667,249.0,93.28571428571428,7,4087,5762.666666666667,1514.0,583.8571428571429
105661.0,17,2,286,2,286,0.0,143.0,143.0,0,0,0.0,0.0,0.0
135129337.0,17,6,1206,6,1206,27025867.4,201.0,201.0,0,0,0.0,0.0,0.0
30562.0,6,10,2032,5,524,6625.5,252.0,104.8,5,1508,6820.5,1236.0,301.6
205758.0,17,2,180,1,90,0.0,90.0,90.0,1,90,0.0,90.0,90.0
38542.0,6,10,2032,5,524,9326.5,252.0,104.8,5,1508,8888.25,1236.0,301.6
90062334.0,17,28,13364,28,13364,3335642.0,501.0,477.2857142857143,0,0,0.0,0.0,0.0
90383591.0,6,25,1686,13,840,7531965.916666667,123.0,64.61538461538461,12,846,7289334.454545454,123.0,70.5
120001834.0,6,17,1246,9,650,15000229.25,95.0,72.22222222222223,8,596,17106217.714285713,95.0,74.5
120123602.0,6,14,2224,9,1204,15015450.25,188.0,133.77777777777777,5,1020,22528225.0,204.0,204.0
90026797.0,17,28,13364,28,13364,3334325.814814815,501.0,477.2857142857143,0,0,0.0,0.0,0.0
3320234.0,6,15,4814,8,727,473963.8571428572,249.0,90.875,7,4087,5853.833333333333,1514.0,583.8571428571429
108108297.0,17,5,1005,5,1005,27027074.25,201.0,201.0,0,0,0.0,0.0,0.0
2781963.0,6,4,492,2,280,0.0,214.0,140.0,2,212,0.0,146.0,106.0
324645.0,6,5,367,2,132,0.0,66.0,66.0,3,235,162322.5,103.0,78.33333333333333
2064.0,17,4,344,2,150,0.0,75.0,75.0,2,194,0.0,103.0,97.0
121227906.0,6,228,25808,114,7820,1056294.8230088495,140.0,68.59649122807018,114,17988,1065527.8407079645,336.0,157.78947368421052
113614086.0,6,46,3036,23,1518,5150442.181818182,66.0,66.0,23,1518,5150443.545454546,66.0,66.0
41819.0,6,14,4740,7,653,6659.833333333333,249.0,93.28571428571428,7,4087,6731.5,1514.0,583.8571428571429
196985.0,17,2,180,1,90,0.0,90.0,90.0,1,90,0.0,90.0,90.0
1171570.0,6,13,3020,8,2392,167367.14285714287,1514.0,299.0,5,628,223984.5,331.0,125.6
90022504.0,17,28,13364,28,13364,3334166.814814815,501.0,477.2857142857143,0,0,0.0,0.0,0.0
207088.0,6,3,426,2,280,0.0,214.0,140.0,1,146,0.0,146.0,146.0
43568.0,6,14,4740,7,653,6992.5,249.0,93.28571428571428,7,4087,6890.833333333333,1514.0,583.8571428571429
90029363.0,17,28,13364,28,13364,3334420.851851852,501.0,477.2857142857143,0,0,0.0,0.0,0.0
3265045.0,6,3,1602,2,850,0.0,784.0,425.0,1,752,0.0,752.0,752.0
232852.0,6,10,1221,6,636,46570.4,298.0,106.0,4,585,76787.33333333333,379.0,146.25
90914915.0,6,20,1490,10,745,10101657.222222222,95.0,74.5,10,745,10073882.888888888,95.0,74.5
303879.0,6,3,202,2,128,0.0,74.0,64.0,1,74,0.0,74.0,74.0
20144.0,6,14,4740,7,653,3075.5,249.0,93.28571428571428,7,4087,3129.0,1514.0,583.8571428571429
119301822.0,17,16,1212,8,606,17000907.85714286,174.0,75.75,8,606,17000162.714285713,174.0,75.75
100651.0,17,2,762,2,762,0.0,381.0,381.0,0,0,0.0,0.0,0.0
119869863.0,6,17,2434,10,1270,13318873.666666666,188.0,127.0,7,1164,19970105.666666668,204.0,166.28571428571428
51502.0,6,10,2032,5,524,10473.5,252.0,104.8,5,1508,10520.25,1236.0,301.6
201418.0,17,4,6056,4,6056,67139.33333333333,1514.0,1514.0,0,0,0.0,0.0,0.0
120068731.0,17,28,13364,28,13364,4446990.037037037,501.0,477.2857142857143,0,0,0.0,0.0,0.0
4140.0,17,4,344,2,150,0.0,75.0,75.0,2,194,0.0,103.0,97.0
107752.0,17,2,286,2,286,0.0,143.0,143.0,0,0,0.0,0.0,0.0
314.0,17,2,174,1,79,0.0,79.0,79.0,1,95,0.0,95.0,95.0
209235.0,6,3,426,2,280,0.0,214.0,140.0,1,146,0.0,146.0,146.0
33388.0,6,10,2032,5,524,7290.25,252.0,104.8,5,1508,8017.0,1236.0,301.6
67230.0,6,14,4740,7,653,10450.5,249.0,93.28571428571428,7,4087,10952.666666666666,1514.0,583.8571428571429
1321542.0,6,4,264,2,132,0.0,66.0,66.0,2,132,0.0,66.0,66.0
309885.0,6,3,202,2,128,0.0,74.0,64.0,1,74,0.0,74.0,74.0
114537316.0,6,208,23408,104,16248,1109923.8834951457,284.0,156.23076923076923,104,7160,1109923.990291262,140.0,68.84615384615384
3414.0,17,2,382,1,88,0.0,88.0,88.0,1,294,0.0,294.0,294.0
2799757.0,6,2,132,1,66,0.0,66.0,66.0,1,66,0.0,66.0,66.0
1787645.0,6,23,6509,12,1529,162513.18181818182,357.0,127.41666666666669,11,4980,148189.9,1510.0,452.7272727272728
104848.0,17,2,286,2,286,0.0,143.0,143.0,0,0,0.0,0.0,0.0
147395.0,6,3,373,2,238,0.0,172.0,119.0,1,135,0.0,135.0,135.0
233131.0,6,3,337,2,214,0.0,160.0,107.0,1,123,0.0,123.0,123.0
228967.0,17,2,180,1,90,0.0,90.0,90.0,1,90,0.0,90.0,90.0
143942.0,17,2,180,1,90,0.0,90.0,90.0,1,90,0.0,90.0,90.0
149676.0,17,2,180,1,90,0.0,90.0,90.0,1,90,0.0,90.0,90.0
297187.0,6,6,412,4,272,99062.33333333331,74.0,68.0,2,140,0.0,74.0,70.0
113731815.0,6,46,3036,23,1518,5155440.818181818,66.0,66.0,23,1518,5155438.363636363,66.0,66.0
16810.0,17,2,180,1,90,0.0,90.0,90.0,1,90,0.0,90.0,90.0
0.0,6,1,172,1,172,0.0,172.0,172.0,0,0,0.0,0.0,0.0
0.0,17,1,313,1,313,0.0,313.0,313.0,0,0,0.0,0.0,0.0
103116039.0,17,14,1126,7,563,17167983.0,174.0,80.42857142857143,7,563,17166839.5,174.0,80.42857142857143
222381.0,17,2,180,1,90,0.0,90.0,90.0,1,90,0.0,90.0,90.0
53724.0,6,14,4740,7,653,7925.5,249.0,93.28571428571428,7,4087,8402.333333333334,1514.0,583.8571428571429
314756.0,6,6,412,4,272,104918.66666666669,74.0,68.0,2,140,0.0,74.0,70.0
63163.0,6,14,4740,7,653,10132.0,249.0,93.28571428571428,7,4087,8178.666666666667,1514.0,583.8571428571429
3052917.0,6,3,204,2,136,0.0,70.0,68.0,1,68,0.0,68.0,68.0
39704.0,6,14,4740,7,653,6449.0,249.0,93.28571428571428,7,4087,6211.166666666667,1514.0,583.8571428571429
135120366.0,17,6,1206,6,1206,27024073.2,201.0,201.0,0,0,0.0,0.0,0.0
48837.0,6,14,4740,7,653,7186.0,249.0,93.28571428571428,7,4087,8002.833333333333,1514.0,583.8571428571429
2947.0,17,4,625,2,163,0.0,89.0,81.5,2,462,0.0,245.0,231.0
5010162.0,17,4,376,2,152,0.0,76.0,76.0,2,224,0.0,148.0,112.0
144423.0,6,2,132,1,66,0.0,66.0,66.0,1,66,0.0,66.0,66.0
3000063.0,6,3,1604,1,753,0.0,753.0,753.0,2,851,0.0,785.0,425.5
97617302.0,17,14,1126,7,563,16166773.0,174.0,80.42857142857143,7,563,16167424.333333334,174.0,80.42857142857143
55277.0,6,12,1320,7,789,9212.833333333334,253.0,112.71428571428572,5,531,9914.0,259.0,106.2
2145180.0,6,10,1221,6,636,429036.0,298.0,106.0,4,585,711264.0,379.0,146.25
36137.0,6,14,4740,7,653,5056.0,249.0,93.28571428571428,7,4087,5459.333333333333,1514.0,583.8571428571429
98330.0,17,2,762,2,762,0.0,381.0,381.0,0,0,0.0,0.0,0.0
12835.0,6,11,2098,6,590,1864.0,252.0,98.33333333333331,5,1508,2915.75,1236.0,301.6
854424.0,6,9,1268,6,797,170884.8,459.0,132.83333333333334,3,471,290894.5,331.0,157.0
1046342.0,6,11,1134,6,558,209268.4,220.0,93.0,5,576,258465.5,304.0,115.2
5620168.0,6,5,336,2,134,0.0,68.0,67.0,3,202,1524216.0,70.0,67.33333333333333
120167187.0,6,230,26010,115,7812,1046819.7192982456,140.0,67.9304347826087,115,18198,1046834.947368421,284.0,158.24347826086955
24572.0,6,14,4740,7,653,3883.8333333333335,249.0,93.28571428571428,7,4087,3687.8333333333335,1514.0,583.8571428571429
113848251.0,6,32,2220,16,1149,7576219.466666667,123.0,71.8125,16,1071,7576219.4,123.0,66.9375
196883.0,17,2,180,1,90,0.0,90.0,90.0,1,90,0.0,90.0,90.0
25110.0,6,14,4740,7,653,4027.5,249.0,93.28571428571428,7,4087,3633.6666666666665,1514.0,583.8571428571429
2370.0,17,4,344,2,150,0.0,75.0,75.0,2,194,0.0,103.0,97.0
24356.0,6,14,4740,7,653,3645.1666666666665,249.0,93.28571428571428,7,4087,3877.6666666666665,1514.0,583.8571428571429
13776.0,17,4,344,2,150,0.0,75.0,75.0,2,194,0.0,103.0,97.0
4892.0,17,4,344,2,150,0.0,75.0,75.0,2,194,0.0,103.0,97.0
144891.0,17,2,180,1,70,0.0,70.0,70.0,1,110,0.0,110.0,110.0
108107097.0,17,5,955,5,955,27026774.25,191.0,191.0,0,0,0.0,0.0,0.0
2832176.0,6,3,1604,1,753,0.0,753.0,753.0,2,851,0.0,785.0,425.5
108584945.0,17,14,864,7,432,18000172.166666668,174.0,61.71428571428572,7,432,18000861.166666668,174.0,61.71428571428572
13783822.0,6,10,1221,6,636,2756764.4,298.0,106.0,4,585,4593293.666666667,379.0,146.25
234436.0,6,3,337,2,214,0.0,160.0,107.0,1,123,0.0,123.0,123.0
95015184.0,6,180,20332,90,14170,1065169.8539325842,284.0,157.44444444444446,90,6162,1065168.573033708,140.0,68.46666666666667
42986.0,6,14,4740,7,653,6349.333333333333,249.0,93.28571428571428,7,4087,6807.166666666667,1514.0,583.8571428571429
783.0,17,4,438,2,148,0.0,74.0,74.0,2,290,0.0,147.0,145.0
26395.0,6,14,4740,7,653,4270.0,249.0,93.28571428571428,7,4087,4217.5,1514.0,583.8571428571429
27880.0,6,14,4740,7,653,4500.0,249.0,93.28571428571428,7,4087,3897.6666666666665,1514.0,583.8571428571429
2379.0,17,4,344,2,150,0.0,75.0,75.0,2,194,0.0,103.0,97.0
610634.0,17,2,346,1,78,0.0,78.0,78.0,1,268,0.0,268.0,268.0
50160.0,6,14,4740,7,653,8201.5,249.0,93.28571428571428,7,4087,6499.833333333333,1514.0,583.8571428571429
120428198.0,6,508,67388,254,17072,472768.4822134387,140.0,67.21259842519684,254,50316,475961.9841897233,426.0,198.0944881889764
20042.0,17,2,582,1,83,0.0,83.0,83.0,1,499,0.0,499.0,499.0
228162.0,17,2,180,1,90,0.0,90.0,90.0,1,90,0.0,90.0,90.0
306105.0,6,6,412,4,272,102035.0,74.0,68.0,2,140,0.0,74.0,70.0
289662.0,17,4,1400,4,1400,96554.0,350.0,350.0,0,0,0.0,0.0,0.0
241398.0,6,3,337,2,214,0.0,160.0,107.0,1,123,0.0,123.0,123.0
215122.0,17,2,180,1,90,0.0,90.0,90.0,1,90,0.0,90.0,90.0
100091781.0,17,12,516,6,258,20001469.6,43.0,43.0,6,258,20000179.8,43.0,43.0
155898.0,6,3,337,2,214,0.0,160.0,107.0,1,123,0.0,123.0,123.0
108106733.0,17,5,1005,5,1005,27026683.25,201.0,201.0,0,0,0.0,0.0,0.0
143926.0,17,2,180,1,90,0.0,90.0,90.0,1,90,0.0,90.0,90.0
228184.0,17,2,180,1,90,0.0,90.0,90.0,1,90,0.0,90.0,90.0
90052380.0,17,28,13364,28,13364,3335273.333333333,501.0,477.2857142857143,0,0,0.0,0.0,0.0
210262.0,6,3,426,2,280,0.0,214.0,140.0,1,146,0.0,146.0,146.0
85.0,17,2,762,2,762,0.0,381.0,381.0,0,0,0.0,0.0,0.0
120294709.0,6,216,24312,108,7350,1116510.308411215,140.0,68.05555555555556,108,16962,1116577.831775701,284.0,157.05555555555554
228532.0,17,2,180,1,90,0.0,90.0,90.0,1,90,0.0,90.0,90.0
120122288.0,6,13,2020,9,1204,15015286.0,188.0,133.77777777777777,4,816,30030745.666666668,204.0,204.0
99381310.0,6,46,3960,26,2190,3975252.4,123.0,84.23076923076923,20,1770,5219212.47368421,123.0,88.5
12610.0,17,4,823,2,163,0.0,89.0,81.5,2,660,0.0,443.0,330.0
90298545.0,6,16,1192,8,596,12892086.57142857,95.0,74.5,8,596,12898442.42857143,95.0,74.5
232896.0,6,3,337,2,214,0.0,160.0,107.0,1,123,0.0,123.0,123.0
293.0,17,2,164,1,82,0.0,82.0,82.0,1,82,0.0,82.0,82.0
34503.0,6,10,2032,5,524,8374.0,252.0,104.8,5,1508,8307.25,1236.0,301.6
235597.0,6,3,373,2,238,0.0,172.0,119.0,1,135,0.0,135.0,135.0
97096051.0,6,173,19510,87,5964,1129023.8488372094,140.0,68.55172413793103,86,13546,1130219.8470588236,284.0,157.51162790697674
20770.0,6,11,1131,6,600,3862.4,262.0,100.0,5,531,4798.25,259.0,106.2
135130341.0,17,6,1206,6,1206,27026068.2,201.0,201.0,0,0,0.0,0.0,0.0
199270.0,17,2,180,1,90,0.0,90.0,90.0,1,90,0.0,90.0,90.0
219493.0,6,3,426,2,280,0.0,214.0,140.0,1,146,0.0,146.0,146.0
32868.0,6,14,4740,7,653,5332.5,249.0,93.28571428571428,7,4087,5289.666666666667,1514.0,583.8571428571429
2597043.0,6,2,132,1,66,0.0,66.0,66.0,1,66,0.0,66.0,66.0
16219.0,6,10,2032,5,524,3780.75,252.0,104.8,5,1508,3793.5,1236.0,301.6
135143560.0,17,6,1146,6,1146,27028712.0,191.0,191.0,0,0,0.0,0.0,0.0
233135.0,6,3,337,2,214,0.0,160.0,107.0,1,123,0.0,123.0,123.0
135134739.0,17,6,1146,6,1146,27026947.8,191.0,191.0,0,0,0.0,0.0,0.0
303.0,17,2,168,1,76,0.0,76.0,76.0,1,92,0.0,92.0,92.0
1653946.0,6,8,602,3,198,204768.0,66.0,66.0,5,404,388785.25,103.0,80.8
45245.0,6,14,4740,7,653,7043.666666666667,249.0,93.28571428571428,7,4087,6929.333333333333,1514.0,583.8571428571429
114593312.0,6,48,3168,24,1584,4982317.913043479,66.0,66.0,24,1584,4968643.565217392,66.0,66.0
90254409.0,6,12,1832,8,1016,12893487.0,188.0,127.0,4,816,30030470.666666668,204.0,204.0
108104025.0,17,5,955,5,955,27026006.25,191.0,191.0,0,0,0.0,0.0,0.0
2135082.0,6,25,7610,13,2516,177923.5,1034.0,193.53846153846155,12,5094,165796.0909090909,1510.0,424.5
105885.0,17,2,286,2,286,0.0,143.0,143.0,0,0,0.0,0.0,0.0
74651521.0,6,9,842,9,842,9331440.125,97.0,93.55555555555556,0,0,0.0,0.0,0.0
108107671.0,17,5,1005,5,1005,27026917.75,201.0,201.0,0,0,0.0,0.0,0.0
147232.0,6,3,373,2,238,0.0,172.0,119.0,1,135,0.0,135.0,135.0
23542.0,6,10,2032,5,524,5365.75,252.0,104.8,5,1508,5460.25,1236.0,301.6
309731.0,17,4,1400,4,1400,103243.66666666669,350.0,350.0,0,0,0.0,0.0,0.0
241303.0,6,3,337,2,214,0.0,160.0,107.0,1,123,0.0,123.0,123.0
306439.0,17,4,1400,4,1400,102146.33333333331,350.0,350.0,0,0,0.0,0.0,0.0
148121.0,17,2,180,1,90,0.0,90.0,90.0,1,90,0.0,90.0,90.0
50722.0,6,14,4740,7,653,8333.5,249.0,93.28571428571428,7,4087,7494.833333333333,1514.0,583.8571428571429
228267.0,17,2,180,1,90,0.0,90.0,90.0,1,90,0.0,90.0,90.0
1302469.0,6,4,264,2,132,0.0,66.0,66.0,2,132,0.0,66.0,66.0
41329.0,6,11,2098,6,590,8147.4,252.0,98.33333333333331,5,1508,7833.5,1236.0,301.6
104819355.0,17,15,5130,15,5130,7487096.785714285,342.0,342.0,0,0,0.0,0.0,0.0
206979.0,6,3,426,2,280,0.0,214.0,140.0,1,146,0.0,146.0,146.0
90292479.0,6,19,1436,10,745,10027800.0,95.0,74.5,9,691,11285611.75,95.0,76.77777777777777
114286996.0,6,48,3168,24,1584,4968999.826086956,66.0,66.0,24,1584,4955541.173913044,66.0,66.0
47266.0,6,14,4740,7,653,7755.333333333333,249.0,93.28571428571428,7,4087,6438.0,1514.0,583.8571428571429
335.0,17,2,248,1,84,0.0,84.0,84.0,1,164,0.0,164.0,164.0
108108497.0,17,5,1005,5,1005,27027124.25,201.0,201.0,0,0,0.0,0.0,0.0
0.0,17,1,90,1,90,0.0,90.0,90.0,0,0,0.0,0.0,0.0
108111059.0,17,5,1005,5,1005,27027764.75,201.0,201.0,0,0,0.0,0.0,0.0
1167140.0,6,13,3012,8,2384,166734.2857142857,1514.0,298.0,5,628,223683.25,331.0,125.6
220303.0,6,3,426,2,280,0.0,214.0,140.0,1,146,0.0,146.0,146.0
216103.0,6,3,426,2,280,0.0,214.0,140.0,1,146,0.0,146.0,146.0
49413.0,6,14,4740,7,653,8107.0,249.0,93.28571428571428,7,4087,7837.166666666667,1514.0,583.8571428571429
119660768.0,17,34,16284,34,16284,3626083.878787879,501.0,478.9411764705882,0,0,0.0,0.0,0.0
102174367.0,17,14,1126,7,563,17000159.0,174.0,80.42857142857143,7,563,17000754.666666668,174.0,80.42857142857143
301444.0,6,6,412,4,272,100481.33333333331,74.0,68.0,2,140,0.0,74.0,70.0
8128.0,17,2,582,1,83,0.0,83.0,83.0,1,499,0.0,499.0,499.0
307571.0,17,4,1400,4,1400,102523.66666666669,350.0,350.0,0,0,0.0,0.0,0.0
33381.0,6,14,4740,7,653,5008.666666666667,249.0,93.28571428571428,7,4087,4327.5,1514.0,583.8571428571429
120010624.0,17,28,13364,28,13364,4444837.925925926,501.0,477.2857142857143,0,0,0.0,0.0,0.0
135137293.0,17,6,1146,6,1146,27027458.6,191.0,191.0,0,0,0.0,0.0,0.0
3005259.0,6,12,2172,7,664,500615.1666666667,252.0,94.85714285714286,5,1508,2025.0,1236.0,301.6
306232.0,6,6,412,4,272,102077.33333333331,74.0,68.0,2,140,0.0,74.0,70.0
309397.0,17,4,1400,4,1400,103132.33333333331,350.0,350.0,0,0,0.0,0.0,0.0
33254.0,6,14,4740,7,653,4379.666666666667,249.0,93.28571428571428,7,4087,4848.166666666667,1514.0,583.8571428571429
4352.0,17,2,610,1,72,0.0,72.0,72.0,1,538,0.0,538.0,538.0
97255.0,17,2,762,2,762,0.0,381.0,381.0,0,0,0.0,0.0,0.0
298.0,17,2,164,1,82,0.0,82.0,82.0,1,82,0.0,82.0,82.0
309.0,17,2,174,1,79,0.0,79.0,79.0,1,95,0.0,95.0,95.0
29574.0,6,14,4740,7,653,3467.833333333333,249.0,93.28571428571428,7,4087,4799.833333333333,1514.0,583.8571428571429
103761960.0,6,43,2838,22,1452,4941032.952380952,66.0,66.0,21,1386,5156004.95,66.0,66.0
135139474.0,17,6,1206,6,1206,27027894.8,201.0,201.0,0,0,0.0,0.0,0.0
36201304.0,6,7,1874,3,887,18027568.0,753.0,295.6666666666667,4,987,12018827.666666666,785.0,246.75
103457578.0,17,14,864,7,432,17166823.5,174.0,61.71428571428572,7,432,17168096.333333332,174.0,61.71428571428572
198925.0,17,4,1400,4,1400,66308.33333333333,350.0,350.0,0,0,0.0,0.0,0.0
50869.0,6,10,2032,5,524,12176.0,252.0,104.8,5,1508,12435.0,1236.0,301.6
90255053.0,6,12,1832,8,1016,12893579.0,188.0,127.0,4,816,30031008.33333333,204.0,204.0
2466.0,17,4,344,2,150,0.0,75.0,75.0,2,194,0.0,103.0,97.0
153526.0,17,2,180,1,90,0.0,90.0,90.0,1,90,0.0,90.0,90.0
102982.0,17,2,286,2,286,0.0,143.0,143.0,0,0,0.0,0.0,0.0
120041439.0,17,28,13364,28,13364,4445979.222222222,501.0,477.2857142857143,0,0,0.0,0.0,0.0
1502583.0,17,2,876,2,876,0.0,438.0,438.0,0,0,0.0,0.0,0.0
305.0,17,2,168,1,76,0.0,76.0,76.0,1,92,0.0,92.0,92.0
20197.0,6,10,1810,5,358,4575.0,130.0,71.6,5,1452,4805.25,1224.0,290.4
196983.0,17,2,180,1,90,0.0,90.0,90.0,1,90,0.0,90.0,90.0
100937.0,17,2,762,2,762,0.0,381.0,381.0,0,0,0.0,0.0,0.0
49386.0,6,14,4740,7,653,8017.5,249.0,93.28571428571428,7,4087,7372.5,1514.0,583.8571428571429
122975347.0,6,48,3168,24,1584,5080856.304347826,66.0,66.0,24,1584,5186253.260869565,66.0,66.0
2822611.0,6,3,1604,1,753,0.0,753.0,753.0,2,851,0.0,785.0,425.5
206686.0,6,10,1221,6,636,41337.2,298.0,106.0,4,585,67704.33333333333,379.0,146.25
103217.0,17,2,762,2,762,0.0,381.0,381.0,0,0,0.0,0.0,0.0
309784.0,17,4,1400,4,1400,103261.33333333331,350.0,350.0,0,0,0.0,0.0,0.0
5622316.0,6,5,336,2,134,0.0,68.0,67.0,3,202,1524171.0,70.0,67.33333333333333
8161.0,17,4,344,2,150,0.0,75.0,75.0,2,194,0.0,103.0,97.0
2735174.0,6,25,7573,14,3735,210398.0,1514.0,266.7857142857143,11,3838,245593.8,1514.0,348.90909090909093
228388.0,17,2,180,1,90,0.0,90.0,90.0,1,90,0.0,90.0,90.0
2368.0,17,4,344,2,150,0.0,75.0,75.0,2,194,0.0,103.0,97.0
312703.0,17,4,1524,4,1524,104234.33333333331,381.0,381.0,0,0,0.0,0.0,0.0
108109130.0,17,5,1005,5,1005,27027282.5,201.0,201.0,0,0,0.0,0.0,0.0
0.0,17,1,90,1,90,0.0,90.0,90.0,0,0,0.0,0.0,0.0
58781529.0,17,9,3086,8,2736,5109661.571428572,342.0,342.0,1,350,0.0,350.0,350.0
343.0,17,2,166,1,75,0.0,75.0,75.0,1,91,0.0,91.0,91.0
120110990.0,17,29,13785,29,13785,4289678.214285715,501.0,475.3448275862069,0,0,0.0,0.0,0.0
222065.0,6,10,1221,6,636,44413.0,298.0,106.0,4,585,72746.0,379.0,146.25
18302.0,6,2,145,2,145,0.0,91.0,72.5,0,0,0.0,0.0,0.0
507615.00000000006,6,5,336,2,134,0.0,68.0,67.0,3,202,194781.5,70.0,67.33333333333333
18640.0,6,14,4740,7,653,2584.833333333333,249.0,93.28571428571428,7,4087,2968.6666666666665,1514.0,583.8571428571429
328.0,17,2,166,1,75,0.0,75.0,75.0,1,91,0.0,91.0,91.0
119671781.0,6,214,24090,107,16732,1126949.9622641508,284.0,156.37383177570092,107,7358,1126950.0094339622,140.0,68.76635514018692
206497.0,6,3,426,2,280,0.0,214.0,140.0,1,146,0.0,146.0,146.0
300328.0,6,6,412,4,272,100109.33333333331,74.0,68.0,2,140,0.0,74.0,70.0
108118462.0,17,5,1005,5,1005,27029615.5,201.0,201.0,0,0,0.0,0.0,0.0
2075.0,17,4,344,2,150,0.0,75.0,75.0,2,194,0.0,103.0,97.0
7818.0,6,10,2032,5,524,1729.5,252.0,104.8,5,1508,1705.25,1236.0,301.6
307536.0,6,6,412,4,272,102512.0,74.0,68.0,2,140,0.0,74.0,70.0
309837.0,17,4,1400,4,1400,103279.0,350.0,350.0,0,0,0.0,0.0,0.0
5012007.0,17,4,1164,2,166,0.0,83.0,83.0,2,998,0.0,499.0,499.0
2036.0,17,4,344,2,150,0.0,75.0,75.0,2,194,0.0,103.0,97.0
234860.0,6,3,337,2,214,0.0,160.0,107.0,1,123,0.0,123.0,123.0
206257.0,6,3,426,2,280,0.0,214.0,140.0,1,146,0.0,146.0,146.0
206280.0,17,2,762,2,762,0.0,381.0,381.0,0,0,0.0,0.0,0.0
341981.0,6,2,132,1,66,0.0,66.0,66.0,1,66,0.0,66.0,66.0
781.0,17,4,438,2,148,0.0,74.0,74.0,2,290,0.0,147.0,145.0
96822756.0,6,29,2068,15,1105,6900489.857142857,139.0,73.66666666666667,14,963,7431296.769230769,123.0,68.78571428571429
90915785.0,6,160,18144,80,12642,1148108.9620253164,300.0,158.025,80,5502,1148108.329113924,140.0,68.775
90547384.0,6,16,2648,8,1016,12935340.57142857,188.0,127.0,8,1632,12910586.42857143,204.0,204.0
216908.0,17,2,180,1,90,0.0,90.0,90.0,1,90,0.0,90.0,90.0
2045.0,17,4,344,2,150,0.0,75.0,75.0,2,194,0.0,103.0,97.0
146085.0,6,3,337,2,214,0.0,160.0,107.0,1,123,0.0,123.0,123.0
314904.0,6,3,202,2,128,0.0,74.0,64.0,1,74,0.0,74.0,74.0
3144370.0,6,237,182157,125,170468,25357.822580645163,1510.0,1363.744,112,11689,25619.76576576577,1510.0,104.36607142857144
120402605.0,6,231,26150,116,18338,1046979.1739130436,284.0,158.08620689655172,115,7812,1049478.99122807,140.0,67.9304347826087
311380.0,6,6,412,4,272,103793.33333333331,74.0,68.0,2,140,0.0,74.0,70.0
92624787.0,6,40,2640,20,1320,4874988.7894736845,66.0,66.0,20,1320,4863612.842105263,66.0,66.0
122975256.0,6,48,3168,24,1584,5038890.956521739,66.0,66.0,24,1584,5228185.608695652,66.0,66.0
6360930.0,6,9,1059,5,827,1538918.75,571.0,165.4,4,232,2052143.6666666667,62.0,58.0
1963.0,17,2,684,1,342,0.0,342.0,342.0,1,342,0.0,342.0,342.0
314.0,17,2,164,1,82,0.0,82.0,82.0,1,82,0.0,82.0,82.0
153412.0,17,2,180,1,90,0.0,90.0,90.0,1,90,0.0,90.0,90.0
15047.0,17,2,180,1,90,0.0,90.0,90.0,1,90,0.0,90.0,90.0
354.0,17,2,166,1,75,0.0,75.0,75.0,1,91,0.0,91.0,91.0
70142.0,17,2,608,1,75,0.0,75.0,75.0,1,533,0.0,533.0,533.0
26988.0,6,20,7606,11,978,2698.8,310.0,88.9090909090909,9,6628,2873.0,1514.0,736.4444444444445
90534452.0,6,13,2036,8,1016,12933493.142857144,188.0,127.0,5,1020,22592124.25,204.0,204.0
43026.0,6,14,4740,7,653,5366.5,249.0,93.28571428571428,7,4087,7018.333333333333,1514.0,583.8571428571429
280115.0,6,3,337,2,214,0.0,160.0,107.0,1,123,0.0,123.0,123.0
51655.0,6,14,4740,7,653,7919.666666666667,249.0,93.28571428571428,7,4087,7111.5,1514.0,583.8571428571429
54833.0,6,13,1386,7,789,8315.666666666666,253.0,112.71428571428572,6,597,6196.4,259.0,99.5
510719.00000000006,6,5,336,2,134,0.0,68.0,67.0,3,202,196422.5,70.0,67.33333333333333
738216.0,6,14,4740,7,653,122662.83333333331,249.0,93.28571428571428,7,4087,122727.83333333331,1514.0,583.8571428571429
713.0,17,4,438,2,148,0.0,74.0,74.0,2,290,0.0,147.0,145.0
281516.0,17,4,1524,4,1524,93838.66666666669,381.0,381.0,0,0,0.0,0.0,0.0
101496.0,17,2,286,2,286,0.0,143.0,143.0,0,0,0.0,0.0,0.0
119578361.0,17,14,864,7,432,19832672.0,174.0,61.71428571428572,7,432,19833490.83333333,174.0,61.71428571428572
2977083.0,6,3,1604,1,753,0.0,753.0,753.0,2,851,0.0,785.0,425.5
1308194.0,6,4,264,2,132,0.0,66.0,66.0,2,132,0.0,66.0,66.0
1158693.0,6,13,3010,8,2382,165527.57142857142,1514.0,297.75,5,628,221507.5,331.0,125.6
122156.0,6,3,373,2,238,0.0,172.0,119.0,1,135,0.0,135.0,135.0
90527539.0,6,16,2372,8,1016,12932505.57142857,188.0,127.0,8,1356,12904007.57142857,204.0,169.5
234424.0,6,3,337,2,214,0.0,160.0,107.0,1,123,0.0,123.0,123.0
104287.0,17,2,286,2,286,0.0,143.0,143.0,0,0,0.0,0.0,0.0
143736.0,6,3,337,2,214,0.0,160.0,107.0,1,123,0.0,123.0,123.0
90302445.0,6,16,1192,8,596,12893206.42857143,95.0,74.5,8,596,12899522.714285716,95.0,74.5
305032.0,6,10,1221,6,636,61006.4,298.0,106.0,4,585,95916.33333333331,379.0,146.25
97790.0,17,2,762,2,762,0.0,381.0,381.0,0,0,0.0,0.0,0.0
2434.0,17,4,344,2,150,0.0,75.0,75.0,2,194,0.0,103.0,97.0
135136562.0,17,6,1146,6,1146,27027312.4,191.0,191.0,0,0,0.0,0.0,0.0
2440.0,17,4,344,2,150,0.0,75.0,75.0,2,194,0.0,103.0,97.0
108114423.0,17,5,1005,5,1005,27028605.75,201.0,201.0,0,0,0.0,0.0,0.0
35934.0,6,14,4740,7,653,5861.0,249.0,93.28571428571428,7,4087,5520.333333333333,1514.0,583.8571428571429
130241.0,6,3,337,2,214,0.0,160.0,107.0,1,123,0.0,123.0,123.0
90061993.0,6,12,1848,5,1020,22515207.0,204.0,204.0,7,828,15010148.833333334,188.0,118.28571428571428
20088.0,6,14,4740,7,653,3101.333333333333,249.0,93.28571428571428,7,4087,2837.0,1514.0,583.8571428571429
227887.0,17,2,180,1,90,0.0,90.0,90.0,1,90,0.0,90.0,90.0
90363472.0,6,14,2256,7,1428,15060336.833333334,204.0,204.0,7,828,15012313.5,188.0,118.28571428571428
105372.0,17,2,286,2,286,0.0,143.0,143.0,0,0,0.0,0.0,0.0
153382.0,17,2,180,1,90,0.0,90.0,90.0,1,90,0.0,90.0,90.0
2135636.0,6,25,7610,13,2516,177969.66666666666,1034.0,193.53846153846155,12,5094,166610.27272727274,1510.0,424.5
206317.0,6,3,426,2,280,0.0,214.0,140.0,1,146,0.0,146.0,146.0
10437134.0,6,7,478,4,272,3432630.333333333,74.0,68.0,3,206,5148799.5,74.0,68.66666666666667
239698.0,6,12,1373,7,714,39949.66666666666,298.0,102.0,5,659,59190.25,379.0,131.8
278058.0,17,4,704,2,148,0.0,74.0,74.0,2,556,0.0,280.0,278.0
66348.0,6,14,4740,7,653,10743.0,249.0,93.28571428571428,7,4087,10915.333333333334,1514.0,583.8571428571429
204547.0,17,2,762,2,762,0.0,381.0,381.0,0,0,0.0,0.0,0.0
90475783.0,6,20,1490,11,840,9043101.8,95.0,76.36363636363636,9,650,11300495.0,95.0,72.22222222222223
120213.0,17,2,180,1,70,0.0,70.0,70.0,1,110,0.0,110.0,110.0
20577.0,6,14,4740,7,653,3076.333333333333,249.0,93.28571428571428,7,4087,3293.6666666666665,1514.0,583.8571428571429
125899.0,6,3,373,2,238,0.0,172.0,119.0,1,135,0.0,135.0,135.0
30870.0,6,14,4740,7,653,5020.166666666667,249.0,93.28571428571428,7,4087,5002.166666666667,1514.0,583.8571428571429
337.0,17,2,160,1,80,0.0,80.0,80.0,1,80,0.0,80.0,80.0
1302391.0,6,4,264,2,132,0.0,66.0,66.0,2,132,0.0,66.0,66.0
3657865.0,17,3,1026,3,1026,1828932.5,342.0,342.0,0,0,0.0,0.0,0.0
285828.0,17,2,180,1,90,0.0,90.0,90.0,1,90,0.0,90.0,90.0
206157.0,6,3,426,2,280,0.0,214.0,140.0,1,146,0.0,146.0,146.0
56555.0,6,14,4740,7,653,8611.833333333334,249.0,93.28571428571428,7,4087,8728.0,1514.0,583.8571428571429
90258658.0,6,16,2368,9,1204,11282332.25,188.0,133.77777777777777,7,1164,15015115.666666666,204.0,166.28571428571428
103839881.0,6,43,2838,22,1452,4944744.523809524,66.0,66.0,21,1386,5143998.35,66.0,66.0
398.0,17,2,160,1,80,0.0,80.0,80.0,1,80,0.0,80.0,80.0
153451.0,17,2,180,1,90,0.0,90.0,90.0,1,90,0.0,90.0,90.0
90258669.0,6,12,1832,8,1016,12894095.57142857,188.0,127.0,4,816,30031575.33333333,204.0,204.0
99041.0,17,2,762,2,762,0.0,381.0,381.0,0,0,0.0,0.0,0.0
307809.0,6,6,412,4,272,102603.0,74.0,68.0,2,140,0.0,74.0,70.0
90041704.0,17,28,13364,28,13364,3334877.925925926,501.0,477.2857142857143,0,0,0.0,0.0,0.0
280673.0,6,10,1221,6,636,56134.6,298.0,106.0,4,585,88007.0,379.0,146.25
121781305.0,17,21,5844,8,1128,14572075.714285716,506.0,141.0,13,4716,10122852.25,1214.0,362.7692307692308
133679520.0,17,14,864,7,432,18967727.5,174.0,61.71428571428572,7,432,19001472.666666668,174.0,61.71428571428572
232827.0,6,3,337,2,214,0.0,160.0,107.0,1,123,0.0,123.0,123.0
2598984.0,6,2,132,1,66,0.0,66.0,66.0,1,66,0.0,66.0,66.0
90215937.0,6,22,1680,10,786,9997540.444444444,95.0,78.6,12,894,8182824.090909091,95.0,74.5
90101398.0,6,12,1848,5,1020,22525009.5,204.0,204.0,7,828,15016703.5,188.0,118.28571428571428
2488.0,17,4,344,2,150,0.0,75.0,75.0,2,194,0.0,103.0,97.0
8419285.0,17,3,1034,2,684,0.0,342.0,342.0,1,350,0.0,350.0,350.0
1303570.0,6,4,264,2,132,0.0,66.0,66.0,2,132,0.0,66.0,66.0
153488.0,17,2,180,1,90,0.0,90.0,90.0,1,90,0.0,90.0,90.0
239590.0,6,3,337,2,214,0.0,160.0,107.0,1,123,0.0,123.0,123.0
108105412.0,17,5,1005,5,1005,27026353.0,201.0,201.0,0,0,0.0,0.0,0.0
319234.0,17,4,1400,4,1400,106411.33333333331,350.0,350.0,0,0,0.0,0.0,0.0
98206787.0,6,192,21664,96,15106,1031488.9368421052,284.0,157.35416666666666,96,6558,1031490.1157894736,140.0,68.3125
851486.0,6,9,1096,6,625,170297.2,287.0,104.16666666666669,3,471,289465.0,331.0,157.0
32958.0,6,13,1479,7,882,5493.0,291.0,126.0,6,597,5200.6,259.0,99.5
558.0,17,2,508,2,508,0.0,257.0,254.0,0,0,0.0,0.0,0.0
123480465.0,6,32,2226,17,1209,7717529.0625,123.0,71.11764705882354,15,1017,8092001.071428572,123.0,67.8
106112844.0,6,44,2904,22,1452,5052992.571428572,66.0,66.0,22,1452,5040018.523809524,66.0,66.0
120449986.0,6,221,25040,111,17558,1094999.8727272728,284.0,158.18018018018017,110,7482,1095593.889908257,140.0,68.01818181818182
213617.0,17,2,180,1,90,0.0,90.0,90.0,1,90,0.0,90.0,90.0
298056.0,6,6,412,4,272,99352.0,74.0,68.0,2,140,0.0,74.0,70.0
0.0,17,1,90,1,90,0.0,90.0,90.0,0,0,0.0,0.0,0.0
250024.00000000003,17,4,6056,4,6056,83341.33333333333,1514.0,1514.0,0,0,0.0,0.0,0.0
4276.0,17,2,598,1,72,0.0,72.0,72.0,1,526,0.0,526.0,526.0
161119.0,17,2,180,1,90,0.0,90.0,90.0,1,90,0.0,90.0,90.0
2111.0,17,2,939,1,590,0.0,590.0,590.0,1,349,0.0,349.0,349.0
364.0,17,2,267,1,83,0.0,83.0,83.0,1,184,0.0,184.0,184.0
206238.0,6,3,426,2,280,0.0,214.0,140.0,1,146,0.0,146.0,146.0
24067073.0,17,5,1718,4,1368,804650.6666666666,342.0,342.0,1,350,0.0,350.0,350.0
37068.0,6,14,4740,7,653,4867.0,249.0,93.28571428571428,7,4087,5864.666666666667,1514.0,583.8571428571429
24622.0,6,10,2032,5,524,5732.75,252.0,104.8,5,1508,5995.5,1236.0,301.6
118033587.0,6,30,1974,15,1026,8415563.642857144,123.0,68.4,15,948,8415560.714285715,123.0,63.2
35831812.0,17,8,1256,4,306,11943826.0,89.0,76.5,4,950,11892918.0,443.0,237.5
540.0,17,2,508,2,508,0.0,257.0,254.0,0,0,0.0,0.0,0.0
2525981.0,6,32,10926,18,3951,148587.11764705885,1514.0,219.5,14,6975,174980.23076923078,1514.0,498.2142857142857
1593936.0,6,42,29907,20,1488,83891.36842105263,214.0,74.4,22,28419,75721.76190476191,1514.0,1291.7727272727273
65766.0,6,14,4740,7,653,10835.833333333334,249.0,93.28571428571428,7,4087,10823.0,1514.0,583.8571428571429
2590569.0,6,2,132,1,66,0.0,66.0,66.0,1,66,0.0,66.0,66.0
38333.0,6,14,4740,7,653,5820.0,249.0,93.28571428571428,7,4087,5975.833333333333,1514.0,583.8571428571429
14736706.0,6,20,1607,10,975,1604227.0,315.0,97.5,10,632,1604206.6666666667,78.0,63.2
111154.0,17,2,762,2,762,0.0,381.0,381.0,0,0,0.0,0.0,0.0
309696.0,17,4,1400,4,1400,103232.0,350.0,350.0,0,0,0.0,0.0,0.0
15378670.0,17,6,2052,6,2052,3075734.0,342.0,342.0,0,0,0.0,0.0,0.0
2378.0,17,4,344,2,150,0.0,75.0,75.0,2,194,0.0,103.0,97.0
302471.0,6,2,132,1,66,0.0,66.0,66.0,1,66,0.0,66.0,66.0
1040758.0,6,11,1134,6,558,208151.6,220.0,93.0,5,576,259207.5,304.0,115.2
30746.0,6,10,2032,5,524,7449.5,252.0,104.8,5,1508,6936.75,1236.0,301.6
1353752.0,17,16,1120,16,1120,90250.13333333332,70.0,70.0,0,0,0.0,0.0,0.0
90288524.0,6,16,1192,8,596,12891989.42857143,95.0,74.5,8,596,12896637.714285716,95.0,74.5
768197.0,6,14,4740,7,653,127803.16666666669,249.0,93.28571428571428,7,4087,127851.66666666669,1514.0,583.8571428571429
232145.0,6,3,337,2,214,0.0,160.0,107.0,1,123,0.0,123.0,123.0
90260718.0,6,12,1832,8,1016,12894388.285714284,188.0,127.0,4,816,30032418.0,204.0,204.0
196935.0,17,2,180,1,90,0.0,90.0,90.0,1,90,0.0,90.0,90.0
310855.0,17,4,1400,4,1400,103618.33333333331,350.0,350.0,0,0,0.0,0.0,0.0
216372.0,17,2,180,1,90,0.0,90.0,90.0,1,90,0.0,90.0,90.0
156373.0,17,2,180,1,90,0.0,90.0,90.0,1,90,0.0,90.0,90.0
114501070.0,6,214,24234,107,16950,1078156.6320754718,284.0,158.41121495327104,107,7284,1078156.5849056605,140.0,68.07476635514018
103009267.0,17,14,864,7,432,17168211.166666668,174.0,61.71428571428572,7,432,17000171.833333332,174.0,61.71428571428572
3187191.0,6,18,1495,9,921,358374.5,315.0,102.33333333333331,9,574,358193.375,78.0,63.77777777777778
95033167.0,6,40,2640,20,1320,5001745.631578947,66.0,66.0,20,1320,4987253.47368421,66.0,66.0
90021873.0,17,27,12943,27,12943,3462379.730769231,501.0,479.3703703703704,0,0,0.0,0.0,0.0
120069831.0,6,304,34864,152,10254,793496.059602649,140.0,67.46052631578948,152,24610,790021.3509933775,300.0,161.9078947368421
234234.0,6,3,373,2,238,0.0,172.0,119.0,1,135,0.0,135.0,135.0
40352.0,6,14,4740,7,653,5320.0,249.0,93.28571428571428,7,4087,5994.833333333333,1514.0,583.8571428571429
90668457.0,6,25,1924,11,840,9042098.6,95.0,76.36363636363636,14,1084,6957943.384615385,95.0,77.42857142857143
5010671.0,17,4,376,2,152,0.0,76.0,76.0,2,224,0.0,148.0,112.0
321490.0,6,6,412,4,272,107163.33333333331,74.0,68.0,2,140,0.0,74.0,70.0
217877.0,6,3,426,2,280,0.0,214.0,140.0,1,146,0.0,146.0,146.0
104005866.0,6,29,2052,15,1089,7428990.428571428,123.0,72.6,14,963,7983815.153846154,123.0,68.78571428571429
323.0,17,2,166,1,75,0.0,75.0,75.0,1,91,0.0,91.0,91.0
209624.0,17,2,180,1,90,0.0,90.0,90.0,1,90,0.0,90.0,90.0
1306940.0,6,4,264,2,132,0.0,66.0,66.0,2,132,0.0,66.0,66.0
137007594.0,17,15,907,8,475,19572513.42857143,174.0,59.375,7,432,19500165.83333333,174.0,61.71428571428572
245699.0,6,3,337,2,214,0.0,160.0,107.0,1,123,0.0,123.0,123.0
290222.0,17,2,363,1,79,0.0,79.0,79.0,1,284,0.0,284.0,284.0
51143.0,6,10,2032,5,524,12548.5,252.0,104.8,5,1508,11000.75,1236.0,301.6
90764262.0,6,19,1436,10,745,10079641.444444444,95.0,74.5,9,691,11343712.25,95.0,76.77777777777777
0.0,17,1,55,1,55,0.0,55.0,55.0,0,0,0.0,0.0,0.0
3020.0,17,2,224,1,76,0.0,76.0,76.0,1,148,0.0,148.0,148.0
322.0,17,2,174,1,79,0.0,79.0,79.0,1,95,0.0,95.0,95.0
42848.0,6,10,2032,5,524,10473.0,252.0,104.8,5,1508,8019.5,1236.0,301.6
9291.0,17,2,582,1,83,0.0,83.0,83.0,1,499,0.0,499.0,499.0
135140127.0,17,6,1206,6,1206,27028025.4,201.0,201.0,0,0,0.0,0.0,0.0
99041.0,17,2,762,2,762,0.0,381.0,381.0,0,0,0.0,0.0,0.0
209373.0,17,2,180,1,90,0.0,90.0,90.0,1,90,0.0,90.0,90.0
112990863.0,6,32,2220,16,1149,7518333.266666667,123.0,71.8125,16,1071,7518332.866666666,123.0,66.9375
135132604.0,17,6,1146,6,1146,27026520.8,191.0,191.0,0,0,0.0,0.0,0.0
31510.000000000004,6,10,2032,5,524,6414.25,252.0,104.8,5,1508,6883.75,1236.0,301.6
90018107.0,17,28,13364,28,13364,3334003.962962963,501.0,477.2857142857143,0,0,0.0,0.0,0.0
47968.0,6,14,4740,7,653,7879.5,249.0,93.28571428571428,7,4087,6247.666666666667,1514.0,583.8571428571429
108107557.0,17,5,955,5,955,27026889.25,191.0,191.0,0,0,0.0,0.0,0.0
3223357.0,6,210,173015,119,162707,27316.58474576272,1510.0,1367.2857142857142,91,10308,32512.566666666666,1510.0,113.27472527472528
306991.0,6,6,412,4,272,102330.33333333331,74.0,68.0,2,140,0.0,74.0,70.0
52786.0,6,14,4740,7,653,7068.333333333333,249.0,93.28571428571428,7,4087,8130.0,1514.0,583.8571428571429
446.0,17,2,508,2,508,0.0,257.0,254.0,0,0,0.0,0.0,0.0
120010371.0,17,28,13364,28,13364,4444828.555555556,501.0,477.2857142857143,0,0,0.0,0.0,0.0
312912.0,17,4,1400,4,1400,104304.0,350.0,350.0,0,0,0.0,0.0,0.0
101916.0,17,4,1400,4,1400,33972.0,350.0,350.0,0,0,0.0,0.0,0.0
40281.0,6,10,1067,5,536,9340.75,264.0,107.2,5,531,9594.5,259.0,106.2
90761711.0,6,19,1436,10,745,10079102.0,95.0,74.5,9,691,11343841.625,95.0,76.77777777777777
310.0,17,2,174,1,79,0.0,79.0,79.0,1,95,0.0,95.0,95.0
90528399.0,6,14,2240,8,1016,12932628.42857143,188.0,127.0,6,1224,18073492.6,204.0,204.0
4857.0,17,2,363,1,79,0.0,79.0,79.0,1,284,0.0,284.0,284.0
91263880.0,6,25,1924,14,1084,7017163.307692308,95.0,77.42857142857143,11,840,9095553.8,95.0,76.36363636363636
108008959.0,6,29,2202,14,1074,8308381.461538462,95.0,76.71428571428571,15,1128,7697613.571428572,95.0,75.2
122978365.0,6,48,3168,24,1584,5143159.0869565215,66.0,66.0,24,1584,5124057.391304348,66.0,66.0
302.0,17,2,156,1,78,0.0,78.0,78.0,1,78,0.0,78.0,78.0
120070234.0,17,29,13785,29,13785,4288222.642857143,501.0,475.3448275862069,0,0,0.0,0.0,0.0
112025686.0,17,14,864,7,432,18644318.166666668,174.0,61.71428571428572,7,432,18453457.33333333,174.0,61.71428571428572
153358.0,17,2,180,1,90,0.0,90.0,90.0,1,90,0.0,90.0,90.0
732.0,17,4,438,2,148,0.0,74.0,74.0,2,290,0.0,147.0,145.0
118905227.0,6,38,2710,19,1408,6593864.722222222,139.0,74.10526315789474,19,1302,6593863.444444444,123.0,68.52631578947368
246206.0,6,3,373,2,238,0.0,172.0,119.0,1,135,0.0,135.0,135.0
120071619.0,17,29,13785,29,13785,4288272.107142857,501.0,475.3448275862069,0,0,0.0,0.0,0.0
216624.0,6,3,426,2,280,0.0,214.0,140.0,1,146,0.0,146.0,146.0
2048669.0,17,8,1640,4,312,682760.3333333334,78.0,78.0,4,1328,682752.0,332.0,332.0
15030.0,6,14,4740,7,653,2327.333333333333,249.0,93.28571428571428,7,4087,2300.0,1514.0,583.8571428571429
149508.0,6,13,1394,7,797,24918.0,253.0,113.85714285714286,6,597,28427.6,259.0,99.5
361106.0,6,11,1021,6,444,48488.8,162.0,74.0,5,577,60440.75,349.0,115.4
33579.0,6,14,4740,7,653,5199.0,249.0,93.28571428571428,7,4087,4865.333333333333,1514.0,583.8571428571429
206276.0,6,3,426,2,280,0.0,214.0,140.0,1,146,0.0,146.0,146.0
120043253.0,17,29,13785,29,13785,4287259.035714285,501.0,475.3448275862069,0,0,0.0,0.0,0.0
16091265.0,17,10,3500,10,3500,1787918.3333333333,350.0,350.0,0,0,0.0,0.0,0.0
113520267.0,6,46,3036,23,1518,5159995.0,66.0,66.0,23,1518,5160000.454545454,66.0,66.0
14980.0,17,2,180,1,90,0.0,90.0,90.0,1,90,0.0,90.0,90.0
46956.0,6,10,2032,5,524,11511.75,252.0,104.8,5,1508,11157.25,1236.0,301.6
147986.0,17,2,180,1,90,0.0,90.0,90.0,1,90,0.0,90.0,90.0
32885.0,6,14,4740,7,653,5336.166666666667,249.0,93.28571428571428,7,4087,5339.333333333333,1514.0,583.8571428571429
215351.0,17,2,180,1,90,0.0,90.0,90.0,1,90,0.0,90.0,90.0
249952.0,17,4,6056,4,6056,83317.33333333333,1514.0,1514.0,0,0,0.0,0.0,0.0
302053.0,6,6,412,4,272,100684.33333333331,74.0,68.0,2,140,0.0,74.0,70.0
138281.0,6,2,132,1,66,0.0,66.0,66.0,1,66,0.0,66.0,66.0
2317.0,17,4,344,2,150,0.0,75.0,75.0,2,194,0.0,103.0,97.0
2465.0,17,4,344,2,150,0.0,75.0,75.0,2,194,0.0,103.0,97.0
3000.0,17,2,224,1,76,0.0,76.0,76.0,1,148,0.0,148.0,148.0
816.0,17,5,550,5,550,204.0,110.0,110.0,0,0,0.0,0.0,0.0
120120869.0,6,222,24978,111,7548,1084650.190909091,140.0,68.0,111,17430,1084560.018181818,284.0,157.02702702702703
90284704.0,6,15,1097,8,596,12897814.857142856,95.0,74.5,7,501,14999027.333333334,95.0,71.57142857142857
109251363.0,6,28,1860,14,966,8387334.230769231,123.0,69.0,14,894,8387334.0,123.0,63.85714285714285
225889.0,17,2,180,1,90,0.0,90.0,90.0,1,90,0.0,90.0,90.0
100425427.0,17,14,1126,7,563,16710891.0,174.0,80.42857142857143,7,563,16686144.0,174.0,80.42857142857143
123284486.0,17,15,1038,7,432,17333493.333333332,174.0,61.71428571428572,8,606,17554921.85714286,174.0,75.75
28952.0,6,13,1479,7,882,4825.333333333333,291.0,126.0,6,597,4916.2,259.0,99.5
1022344.0,6,11,1134,6,558,204468.8,220.0,93.0,5,576,254904.75,304.0,115.2
35464.0,6,14,4740,7,653,5790.0,249.0,93.28571428571428,7,4087,4334.833333333333,1514.0,583.8571428571429
147960.0,17,2,180,1,90,0.0,90.0,90.0,1,90,0.0,90.0,90.0
4597300.0,6,5,336,2,134,0.0,68.0,67.0,3,202,1525333.5,70.0,67.33333333333333
2286.0,17,4,344,2,150,0.0,75.0,75.0,2,194,0.0,103.0,97.0
249059.0,17,2,180,1,70,0.0,70.0,70.0,1,110,0.0,110.0,110.0
221450.0,6,12,1373,7,714,36908.333333333336,298.0,102.0,5,659,54307.0,379.0,131.8
120160115.0,6,230,25850,115,7886,1046776.6403508772,140.0,68.57391304347826,115,17964,1046830.3859649122,284.0,156.2086956521739
112146498.0,6,35,2542,18,1348,6596852.823529412,139.0,74.88888888888889,17,1194,6995639.0,123.0,70.23529411764706
117850228.0,6,48,3168,24,1584,5123922.956521739,66.0,66.0,24,1584,5110501.260869565,66.0,66.0
162278.0,17,2,180,1,90,0.0,90.0,90.0,1,90,0.0,90.0,90.0
77746.0,6,14,4740,7,653,12837.833333333334,249.0,93.28571428571428,7,4087,11344.0,1514.0,583.8571428571429
106548.0,17,2,286,2,286,0.0,143.0,143.0,0,0,0.0,0.0,0.0
16365.999999999998,6,14,4740,7,653,2568.833333333333,249.0,93.28571428571428,7,4087,2588.833333333333,1514.0,583.8571428571429
108107820.0,17,5,1005,5,1005,27026955.0,201.0,201.0,0,0,0.0,0.0,0.0
895424.0,6,11,2644,7,743,149237.33333333334,339.0,106.14285714285714,4,1901,206584.3333333333,1514.0,475.25
47557.0,6,14,4740,7,653,7198.5,249.0,93.28571428571428,7,4087,7732.666666666667,1514.0,583.8571428571429
949456.0,6,5,1742,3,921,474728.0,785.0,307.0,2,821,0.0,753.0,410.5
120297888.0,6,17,1287,9,691,15037236.0,95.0,76.77777777777777,8,596,17107353.85714286,95.0,74.5
90164.0,6,14,4740,7,653,14176.333333333334,249.0,93.28571428571428,7,4087,14592.666666666666,1514.0,583.8571428571429
22155.0,17,2,447,1,84,0.0,84.0,84.0,1,363,0.0,363.0,363.0
111633900.0,6,34,2350,17,1225,6977118.75,139.0,72.05882352941177,17,1125,6963590.3125,123.0,66.17647058823529
180947.0,6,11,1132,6,556,36189.4,218.0,92.66666666666669,5,576,44982.75,304.0,115.2
26396.0,6,10,2032,5,524,5718.75,252.0,104.8,5,1508,6334.25,1236.0,301.6
307765.0,6,6,412,4,272,102588.33333333331,74.0,68.0,2,140,0.0,74.0,70.0
104579.0,17,2,700,2,700,0.0,350.0,350.0,0,0,0.0,0.0,0.0
1554281.0,6,8,602,5,404,388464.25,103.0,80.8,3,198,153619.5,66.0,66.0
2069993.0,6,25,7610,13,2516,172499.41666666666,1034.0,193.53846153846155,12,5094,160466.63636363635,1510.0,424.5
266057.0,17,4,1400,4,1400,88685.66666666667,350.0,350.0,0,0,0.0,0.0,0.0
847054.0,6,9,1118,6,586,169410.8,248.0,97.66666666666669,3,532,287211.5,392.0,177.33333333333334
90253030.0,6,16,2368,9,1204,11281628.75,188.0,133.77777777777777,7,1164,15014619.666666666,204.0,166.28571428571428
135153602.0,17,6,1146,6,1146,27030720.4,191.0,191.0,0,0,0.0,0.0,0.0
41092.0,6,14,4740,7,653,6599.333333333333,249.0,93.28571428571428,7,4087,6398.5,1514.0,583.8571428571429
153432.0,17,2,180,1,90,0.0,90.0,90.0,1,90,0.0,90.0,90.0
144008.0,17,2,180,1,90,0.0,90.0,90.0,1,90,0.0,90.0,90.0
113520421.0,6,46,3036,23,1518,5159995.7727272725,66.0,66.0,23,1518,5160004.636363637,66.0,66.0
299378.0,6,6,412,4,272,99792.66666666669,74.0,68.0,2,140,0.0,74.0,70.0
0.0,6,1,66,1,66,0.0,66.0,66.0,0,0,0.0,0.0,0.0
482069.0,17,2,363,1,79,0.0,79.0,79.0,1,284,0.0,284.0,284.0
509836.0,6,5,336,2,134,0.0,68.0,67.0,3,202,193535.0,70.0,67.33333333333333
104833.0,17,2,286,2,286,0.0,143.0,143.0,0,0,0.0,0.0,0.0
84109.0,6,12,1354,6,723,15455.8,253.0,120.5,6,631,14249.8,293.0,105.16666666666669
4835.0,17,2,762,2,762,0.0,381.0,381.0,0,0,0.0,0.0,0.0
415.0,17,2,508,2,508,0.0,257.0,254.0,0,0,0.0,0.0,0.0
2722288.0,6,3,1604,1,753,0.0,753.0,753.0,2,851,0.0,785.0,425.5
10518828.0,6,7,478,4,272,3460819.0,74.0,68.0,3,206,5191098.5,74.0,68.66666666666667
97315674.0,6,20,1770,10,904,10812097.666666666,254.0,90.4,10,866,10812387.555555556,216.0,86.6
1423986.0,17,16,1120,16,1120,94932.4,70.0,70.0,0,0,0.0,0.0,0.0
136674.0,6,2,132,1,66,0.0,66.0,66.0,1,66,0.0,66.0,66.0
0.0,6,1,54,0,0,0.0,0.0,0.0,1,54,0.0,54.0,54.0
5623441.0,6,4,270,2,134,0.0,68.0,67.0,2,136,0.0,70.0,68.0
311858.0,6,6,412,4,272,103952.66666666669,74.0,68.0,2,140,0.0,74.0,70.0
36175.0,6,14,4740,7,653,5870.666666666667,249.0,93.28571428571428,7,4087,5765.333333333333,1514.0,583.8571428571429
30701.0,6,10,2032,5,524,7463.5,252.0,104.8,5,1508,5062.0,1236.0,301.6
911355.0,6,12,2718,7,743,151892.5,339.0,106.14285714285714,5,1975,159721.0,1514.0,395.0
120207581.0,6,18,1341,9,691,14998918.5,95.0,76.77777777777777,9,650,14998924.5,95.0,72.22222222222223
32708.0,6,14,4740,7,653,5121.666666666667,249.0,93.28571428571428,7,4087,4413.0,1514.0,583.8571428571429
1731998.0,6,23,6509,12,1529,157454.36363636365,357.0,127.41666666666669,11,4980,142669.0,1510.0,452.7272727272728
3016259.0,6,12,2172,7,664,502524.5,252.0,94.85714285714286,5,1508,4036.75,1236.0,301.6
9139.0,6,11,2098,6,590,1664.4,252.0,98.33333333333331,5,1508,2017.25,1236.0,301.6
317798.0,17,4,1400,4,1400,105932.66666666669,350.0,350.0,0,0,0.0,0.0,0.0
118274770.0,6,48,3168,24,1584,5142381.304347826,66.0,66.0,24,1584,5132981.695652174,66.0,66.0
244149.0,6,3,337,2,214,0.0,160.0,107.0,1,123,0.0,123.0,123.0
28445.0,6,14,4740,7,653,3967.6666666666665,249.0,93.28571428571428,7,4087,4422.666666666667,1514.0,583.8571428571429
171454.0,17,2,180,1,90,0.0,90.0,90.0,1,90,0.0,90.0,90.0
233008.0,6,3,337,2,214,0.0,160.0,107.0,1,123,0.0,123.0,123.0
113998311.0,6,48,3168,24,1584,4956448.304347826,66.0,66.0,24,1584,4942782.478260869,66.0,66.0
1181818.0,6,13,3010,8,2382,168831.14285714287,1514.0,297.75,5,628,226454.5,331.0,125.6
14715.0,6,20,7606,11,978,1471.5,310.0,88.9090909090909,9,6628,1617.25,1514.0,736.4444444444445
196864.0,17,2,180,1,90,0.0,90.0,90.0,1,90,0.0,90.0,90.0
149753407.0,17,35,16705,35,16705,4404511.970588235,501.0,477.2857142857143,0,0,0.0,0.0,0.0
284300.0,17,2,363,1,79,0.0,79.0,79.0,1,284,0.0,284.0,284.0
90255246.0,6,13,2036,8,1016,12893606.57142857,188.0,127.0,5,1020,22522921.0,204.0,204.0
15012.0,6,14,4740,7,653,2323.6666666666665,249.0,93.28571428571428,7,4087,2270.0,1514.0,583.8571428571429
116350570.0,6,29,1914,15,948,8310755.0,123.0,63.2,14,966,8455407.307692308,123.0,69.0
59980.0,6,14,4740,7,653,9250.333333333334,249.0,93.28571428571428,7,4087,9861.5,1514.0,583.8571428571429
214369.0,17,3,1050,3,1050,107184.5,350.0,350.0,0,0,0.0,0.0,0.0
237747.0,17,2,180,1,90,0.0,90.0,90.0,1,90,0.0,90.0,90.0
2126.0,17,4,344,2,150,0.0,75.0,75.0,2,194,0.0,103.0,97.0
216913.0,6,3,426,2,280,0.0,214.0,140.0,1,146,0.0,146.0,146.0
135129586.0,17,6,1206,6,1206,27025917.2,201.0,201.0,0,0,0.0,0.0,0.0
120124534.0,6,15,2444,7,1428,20020755.666666668,204.0,204.0,8,1016,17137252.42857143,188.0,127.0
23108073.0,17,3,1034,2,684,0.0,342.0,342.0,1,350,0.0,350.0,350.0
299668.0,6,6,412,4,272,99889.33333333331,74.0,68.0,2,140,0.0,74.0,70.0
35482.0,6,14,4740,7,653,5743.5,249.0,93.28571428571428,7,4087,5397.333333333333,1514.0,583.8571428571429
225782.0,17,2,180,1,90,0.0,90.0,90.0,1,90,0.0,90.0,90.0
306208.0,6,6,412,4,272,102069.33333333331,74.0,68.0,2,140,0.0,74.0,70.0
228275.0,17,2,180,1,90,0.0,90.0,90.0,1,90,0.0,90.0,90.0
5617766.0,6,4,270,2,134,0.0,68.0,67.0,2,136,0.0,70.0,68.0
1514849.0,6,7,499,4,301,485529.0,103.0,75.25,3,198,716262.5,66.0,66.0
113610965.0,6,48,3168,24,1584,4936697.869565218,66.0,66.0,24,1584,4932477.608695652,66.0,66.0
9064353.0,17,4,1812,4,1812,3021451.0,453.0,453.0,0,0,0.0,0.0,0.0
307388.0,6,6,412,4,272,102462.66666666669,74.0,68.0,2,140,0.0,74.0,70.0
145078.0,17,2,180,1,70,0.0,70.0,70.0,1,110,0.0,110.0,110.0
15986.0,6,14,4740,7,653,2539.1666666666665,249.0,93.28571428571428,7,4087,2531.6666666666665,1514.0,583.8571428571429
135135307.0,17,6,1146,6,1146,27027061.4,191.0,191.0,0,0,0.0,0.0,0.0
108104281.0,17,5,955,5,955,27026070.25,191.0,191.0,0,0,0.0,0.0,0.0
100234873.0,6,33,2428,17,1288,6251198.6875,139.0,75.76470588235294,16,1140,6667945.933333334,123.0,71.25
242396.0,6,3,337,2,214,0.0,160.0,107.0,1,123,0.0,123.0,123.0
121127827.0,6,238,26754,119,8150,1010836.906779661,140.0,68.4873949579832,119,18604,1020488.8305084746,284.0,156.3361344537815
90263076.0,6,12,1832,8,1016,12894725.142857144,188.0,127.0,4,816,30033767.33333333,204.0,204.0
112609844.0,6,30,1974,15,1026,8028139.571428572,123.0,68.4,15,948,8028134.428571428,123.0,63.2
205648.0,6,10,1221,6,636,41129.6,298.0,106.0,4,585,67467.33333333333,379.0,146.25
885988.0,6,10,1262,6,725,177197.6,387.0,120.83333333333331,4,537,203455.0,331.0,134.25
246660.0,6,3,337,2,214,0.0,160.0,107.0,1,123,0.0,123.0,123.0
121773.0,6,3,337,2,214,0.0,160.0,107.0,1,123,0.0,123.0,123.0
12258.0,6,10,1067,5,536,2896.5,264.0,107.2,5,531,2637.25,259.0,106.2
298338.0,6,6,412,4,272,99446.0,74.0,68.0,2,140,0.0,74.0,70.0
146152.0,6,3,337,2,214,0.0,160.0,107.0,1,123,0.0,123.0,123.0
103193.0,17,2,286,2,286,0.0,143.0,143.0,0,0,0.0,0.0,0.0
321751.0,6,6,412,4,272,107250.33333333331,74.0,68.0,2,140,0.0,74.0,70.0
228558.0,17,2,180,1,90,0.0,90.0,90.0,1,90,0.0,90.0,90.0
156274.0,17,2,180,1,90,0.0,90.0,90.0,1,90,0.0,90.0,90.0
26458.0,6,14,4683,7,596,4249.166666666667,192.0,85.14285714285714,7,4087,4211.166666666667,1514.0,583.8571428571429
120008543.0,6,23,1734,12,935,10909090.545454543,95.0,77.91666666666667,11,799,12000471.9,95.0,72.63636363636364
10526629.0,6,7,478,4,272,3463355.6666666665,74.0,68.0,3,206,5194948.5,74.0,68.66666666666667
40284.0,6,14,4740,7,653,6593.833333333333,249.0,93.28571428571428,7,4087,5787.333333333333,1514.0,583.8571428571429
18274.0,6,11,1132,6,556,2997.6,218.0,92.66666666666669,5,576,3942.5,304.0,115.2
120060611.0,17,28,13364,28,13364,4446689.296296297,501.0,477.2857142857143,0,0,0.0,0.0,0.0
93482306.0,6,40,2640,20,1320,4920121.368421053,66.0,66.0,20,1320,4903831.52631579,66.0,66.0
2876997.0,6,3,1604,1,753,0.0,753.0,753.0,2,851,0.0,785.0,425.5
135130698.0,17,6,1146,6,1146,27026139.6,191.0,191.0,0,0,0.0,0.0,0.0
247166.0,17,2,180,1,90,0.0,90.0,90.0,1,90,0.0,90.0,90.0
37866.0,6,10,2032,5,524,7119.75,252.0,104.8,5,1508,8290.0,1236.0,301.6
820.0,17,4,438,2,148,0.0,74.0,74.0,2,290,0.0,147.0,145.0
121787041.0,6,31,2034,16,1086,8119136.066666666,123.0,67.875,15,948,7970486.714285715,123.0,63.2
0.0,6,1,66,1,66,0.0,66.0,66.0,0,0,0.0,0.0,0.0
228282.0,17,2,180,1,90,0.0,90.0,90.0,1,90,0.0,90.0,90.0
205659.0,17,2,180,1,90,0.0,90.0,90.0,1,90,0.0,90.0,90.0
27085.0,6,14,4740,7,653,3921.1666666666665,249.0,93.28571428571428,7,4087,4255.833333333333,1514.0,583.8571428571429
108097802.0,17,5,1005,5,1005,27024450.5,201.0,201.0,0,0,0.0,0.0,0.0
12962.0,6,12,1393,6,796,2247.6,271.0,132.66666666666666,6,597,2375.0,259.0,99.5
20431.0,17,4,823,2,163,0.0,89.0,81.5,2,660,0.0,443.0,330.0
119813896.0,17,35,16705,35,16705,3523938.117647059,501.0,477.2857142857143,0,0,0.0,0.0,0.0
196926.0,17,2,180,1,90,0.0,90.0,90.0,1,90,0.0,90.0,90.0
122008407.0,17,15,1169,8,606,17429772.42857143,174.0,75.75,7,563,17000153.333333332,174.0,80.42857142857143
222128.0,6,3,426,2,280,0.0,214.0,140.0,1,146,0.0,146.0,146.0
100038883.0,17,14,864,7,432,16667265.166666666,174.0,61.71428571428572,7,432,16666806.0,174.0,61.71428571428572
208062.0,6,3,426,2,280,0.0,214.0,140.0,1,146,0.0,146.0,146.0
33742.0,6,10,2032,5,524,8150.5,252.0,104.8,5,1508,7216.0,1236.0,301.6
108105670.0,17,5,1005,5,1005,27026417.5,201.0,201.0,0,0,0.0,0.0,0.0
72978.0,6,14,4740,7,653,9701.0,249.0,93.28571428571428,7,4087,11125.833333333334,1514.0,583.8571428571429
1635659.0,17,6,1039,4,312,545095.0,78.0,78.0,2,727,0.0,395.0,363.5
9406.0,17,2,539,1,86,0.0,86.0,86.0,1,453,0.0,453.0,453.0
251556.0,6,3,337,2,214,0.0,160.0,107.0,1,123,0.0,123.0,123.0
343.0,17,2,250,1,93,0.0,93.0,93.0,1,157,0.0,157.0,157.0
216355.0,17,2,180,1,90,0.0,90.0,90.0,1,90,0.0,90.0,90.0
90269683.0,6,12,1832,8,1016,12895669.0,188.0,127.0,4,816,30035061.33333333,204.0,204.0
232442.0,6,3,337,2,214,0.0,160.0,107.0,1,123,0.0,123.0,123.0
62396.0,6,14,4740,7,653,9769.0,249.0,93.28571428571428,7,4087,8571.166666666666,1514.0,583.8571428571429
108554224.0,6,32,2220,16,1149,7222568.933333334,123.0,71.8125,16,1071,7222569.4,123.0,66.9375
120255161.0,6,47,3102,23,1518,5105433.545454546,66.0,66.0,24,1584,5219090.608695652,66.0,66.0
120000230.0,6,18,1382,10,786,13333358.888888888,95.0,78.6,8,596,12898395.714285716,95.0,74.5
22481221.0,6,26,7627,14,3735,203939.4615384616,1514.0,266.7857142857143,12,3892,2025144.4545454544,1514.0,324.3333333333333
406446.0,6,3,204,2,136,0.0,70.0,68.0,1,68,0.0,68.0,68.0
205853.0,6,3,426,2,280,0.0,214.0,140.0,1,146,0.0,146.0,146.0
102887.0,17,2,286,2,286,0.0,143.0,143.0,0,0,0.0,0.0,0.0
90021047.0,17,27,12943,27,12943,3462347.961538461,501.0,479.3703703703704,0,0,0.0,0.0,0.0
2408.0,17,4,344,2,150,0.0,75.0,75.0,2,194,0.0,103.0,97.0
215434.0,17,2,180,1,90,0.0,90.0,90.0,1,90,0.0,90.0,90.0
428.0,17,2,166,1,75,0.0,75.0,75.0,1,91,0.0,91.0,91.0
10455663.0,6,7,478,4,272,3439336.0,74.0,68.0,3,206,5158910.5,74.0,68.66666666666667
123775887.0,6,49,3234,25,1650,5157328.625,66.0,66.0,24,1584,4966118.869565218,66.0,66.0
299068.0,6,6,412,4,272,99689.33333333331,74.0,68.0,2,140,0.0,74.0,70.0
224404.0,6,10,1221,6,636,44880.8,298.0,106.0,4,585,73683.0,379.0,146.25
4559.0,17,2,180,1,90,0.0,90.0,90.0,1,90,0.0,90.0,90.0
107824216.0,6,28,1860,14,966,8294170.461538462,123.0,69.0,14,894,8277533.461538462,123.0,63.85714285714285
135133208.0,17,6,1146,6,1146,27026641.6,191.0,191.0,0,0,0.0,0.0,0.0
2307.0,17,4,344,2,150,0.0,75.0,75.0,2,194,0.0,103.0,97.0
2589052.0,6,3,1604,2,851,0.0,785.0,425.5,1,753,0.0,753.0,753.0
350.0,17,2,174,1,79,0.0,79.0,79.0,1,95,0.0,95.0,95.0
220318.0,6,3,426,2,280,0.0,214.0,140.0,1,146,0.0,146.0,146.0
225412.0,17,4,1524,4,1524,75137.33333333333,381.0,381.0,0,0,0.0,0.0,0.0
2019.0,17,4,344,2,150,0.0,75.0,75.0,2,194,0.0,103.0,97.0
42567.0,6,2,132,1,66,0.0,66.0,66.0,1,66,0.0,66.0,66.0
40540.0,6,10,2032,5,524,9073.0,252.0,104.8,5,1508,9782.75,1236.0,301.6
228392.0,17,2,180,1,90,0.0,90.0,90.0,1,90,0.0,90.0,90.0
10452895.0,6,6,412,3,206,5157902.0,74.0,68.66666666666667,3,206,5157815.0,74.0,68.66666666666667
20009.0,6,19,7540,11,978,2000.9,310.0,88.9090909090909,8,6562,2460.428571428572,1514.0,820.25
1035819.0,6,11,1134,6,558,207163.8,220.0,93.0,5,576,256578.25,304.0,115.2
216792.0,17,2,180,1,90,0.0,90.0,90.0,1,90,0.0,90.0,90.0
120036019.0,17,28,13364,28,13364,4445778.481481481,501.0,477.2857142857143,0,0,0.0,0.0,0.0
2387.0,17,4,344,2,150,0.0,75.0,75.0,2,194,0.0,103.0,97.0
221119.0,17,2,414,1,88,0.0,88.0,88.0,1,326,0.0,326.0,326.0
104155662.0,6,44,2904,22,1452,4959793.428571428,66.0,66.0,22,1452,4944109.523809524,66.0,66.0
3361.0,17,2,180,1,90,0.0,90.0,90.0,1,90,0.0,90.0,90.0
2121823.0,6,25,7610,13,2516,176818.58333333334,1034.0,193.53846153846155,12,5094,164075.72727272726,1510.0,424.5
32603.0,6,14,4740,7,653,5297.166666666667,249.0,93.28571428571428,7,4087,4032.0,1514.0,583.8571428571429
228272.0,17,2,180,1,90,0.0,90.0,90.0,1,90,0.0,90.0,90.0
145529.0,6,3,337,2,214,0.0,160.0,107.0,1,123,0.0,123.0,123.0
1159267.0,6,13,3010,8,2382,165609.57142857142,1514.0,297.75,5,628,220913.0,331.0,125.6
12039.0,6,2,132,1,66,0.0,66.0,66.0,1,66,0.0,66.0,66.0
105115214.0,17,15,5130,15,5130,7508229.571428572,342.0,342.0,0,0,0.0,0.0,0.0
302203.0,6,7,478,4,272,100734.33333333331,74.0,68.0,3,206,75930.5,74.0,68.66666666666667
97283018.0,17,14,1126,7,563,16187353.0,174.0,80.42857142857143,7,563,16188044.166666666,174.0,80.42857142857143
9710.0,17,2,571,1,86,0.0,86.0,86.0,1,485,0.0,485.0,485.0
0.0,6,1,54,0,0,0.0,0.0,0.0,1,54,0.0,54.0,54.0
5225.0,17,2,180,1,90,0.0,90.0,90.0,1,90,0.0,90.0,90.0
90210203.0,6,16,1192,8,596,12852442.857142856,95.0,74.5,8,596,12857902.42857143,95.0,74.5
23847.0,6,14,4740,7,653,3849.3333333333335,249.0,93.28571428571428,7,4087,3773.8333333333335,1514.0,583.8571428571429
107314.0,17,2,700,2,700,0.0,350.0,350.0,0,0,0.0,0.0,0.0
109289.0,17,2,286,2,286,0.0,143.0,143.0,0,0,0.0,0.0,0.0
90302072.0,6,19,1436,10,745,10027945.888888888,95.0,74.5,9,691,11286525.125,95.0,76.77777777777777
2800497.0,6,2,132,1,66,0.0,66.0,66.0,1,66,0.0,66.0,66.0
302091.0,6,6,412,4,272,100697.0,74.0,68.0,2,140,0.0,74.0,70.0
311352.0,17,4,1400,4,1400,103784.0,350.0,350.0,0,0,0.0,0.0,0.0
55475.0,6,14,4740,7,653,8355.166666666666,249.0,93.28571428571428,7,4087,8651.333333333334,1514.0,583.8571428571429
113168293.0,6,46,3036,23,1518,5144002.136363637,66.0,66.0,23,1518,5144002.363636363,66.0,66.0
2793696.0,6,2,132,1,66,0.0,66.0,66.0,1,66,0.0,66.0,66.0
95438545.0,6,30,2122,15,1105,6817038.928571428,139.0,73.66666666666667,15,1017,6801577.0,123.0,67.8
135131456.0,17,6,1146,6,1146,27026291.2,191.0,191.0,0,0,0.0,0.0,0.0
306506.0,6,6,412,4,272,102168.66666666669,74.0,68.0,2,140,0.0,74.0,70.0
103341030.0,6,28,1860,14,966,7932707.692307692,123.0,69.0,14,894,7932658.307692308,123.0,63.85714285714285
492125.0,6,5,336,2,134,0.0,68.0,67.0,3,202,196987.0,70.0,67.33333333333333
10445638.0,6,7,478,4,272,3436274.6666666665,74.0,68.0,3,206,5154321.0,74.0,68.66666666666667
108095219.0,17,5,1005,5,1005,27023804.75,201.0,201.0,0,0,0.0,0.0,0.0
217920.0,6,3,426,2,280,0.0,214.0,140.0,1,146,0.0,146.0,146.0
873180.0,6,10,1335,6,798,174636.0,460.0,133.0,4,537,200192.3333333333,331.0,134.25
196960.0,17,2,180,1,90,0.0,90.0,90.0,1,90,0.0,90.0,90.0
1304217.0,6,4,264,2,132,0.0,66.0,66.0,2,132,0.0,66.0,66.0
120125675.0,6,14,2086,9,1204,15015709.375,188.0,133.77777777777777,5,882,22523664.25,204.0,176.4
108104352.0,17,5,955,5,955,27026088.0,191.0,191.0,0,0,0.0,0.0,0.0
101745.0,17,2,286,2,286,0.0,143.0,143.0,0,0,0.0,0.0,0.0
298256.0,6,6,412,4,272,99418.66666666669,74.0,68.0,2,140,0.0,74.0,70.0
26141.0,6,10,2032,5,524,6293.0,252.0,104.8,5,1508,5672.25,1236.0,301.6
1175496.0,6,13,3012,8,2384,167928.0,1514.0,298.0,5,628,224974.75,331.0,125.6
133026.0,6,3,337,2,214,0.0,160.0,107.0,1,123,0.0,123.0,123.0
108720885.0,6,32,2220,16,1149,7233666.533333333,123.0,71.8125,16,1071,7233667.4,123.0,66.9375
90289995.0,6,16,1192,8,596,12891397.0,95.0,74.5,8,596,12896828.857142856,95.0,74.5
2584457.0,6,2,132,1,66,0.0,66.0,66.0,1,66,0.0,66.0,66.0
299504.0,6,6,412,4,272,99834.66666666669,74.0,68.0,2,140,0.0,74.0,70.0
108106205.0,17,5,1005,5,1005,27026551.25,201.0,201.0,0,0,0.0,0.0,0.0
3373444.0,6,7,923,4,753,1052539.0,571.0,188.25,3,170,1578623.5,62.0,56.66666666666666
320982.0,17,4,1400,4,1400,106994.0,350.0,350.0,0,0,0.0,0.0,0.0
54428.0,6,14,4740,7,653,8730.166666666666,249.0,93.28571428571428,7,4087,7607.166666666667,1514.0,583.8571428571429
120319493.0,6,222,24962,111,7622,1086458.3,140.0,68.66666666666667,111,17340,1086343.690909091,284.0,156.21621621621622
1565.0,17,2,180,1,90,0.0,90.0,90.0,1,90,0.0,90.0,90.0
90294669.0,6,16,1192,8,596,12892729.42857143,95.0,74.5,8,596,12897824.857142856,95.0,74.5
310450.0,6,6,412,4,272,103483.33333333331,74.0,68.0,2,140,0.0,74.0,70.0
798.0,17,4,438,2,148,0.0,74.0,74.0,2,290,0.0,147.0,145.0
105007658.0,17,14,864,7,432,17501158.666666668,174.0,61.71428571428572,7,432,17500157.5,174.0,61.71428571428572
325140.0,6,6,412,4,272,108380.0,74.0,68.0,2,140,0.0,74.0,70.0
46780536.0,6,8,1940,3,887,22241978.5,753.0,295.6666666666667,5,1053,11002985.5,785.0,210.6
298873.0,6,6,412,4,272,99624.33333333331,74.0,68.0,2,140,0.0,74.0,70.0
228209.0,17,2,180,1,90,0.0,90.0,90.0,1,90,0.0,90.0,90.0
50459.0,6,14,4740,7,653,7733.166666666667,249.0,93.28571428571428,7,4087,7169.666666666667,1514.0,583.8571428571429
106019652.0,17,14,864,7,432,17666869.166666668,174.0,61.71428571428572,7,432,17668044.833333332,174.0,61.71428571428572
54941.0,6,13,1479,7,882,8941.333333333334,291.0,126.0,6,597,9928.4,259.0,99.5
41142.0,6,10,2032,5,524,10028.75,252.0,104.8,5,1508,8439.5,1236.0,301.6
2384.0,17,4,344,2,150,0.0,75.0,75.0,2,194,0.0,103.0,97.0
104497235.0,17,14,1126,7,563,17416205.833333332,174.0,80.42857142857143,7,563,17386864.5,174.0,80.42857142857143
120120978.0,6,16,2494,9,1204,15015122.25,188.0,133.77777777777777,7,1290,15062563.833333334,204.0,184.28571428571428
105277712.0,6,30,2122,15,1105,7519836.571428572,139.0,73.66666666666667,15,1017,7504399.857142857,123.0,67.8
16656.0,6,11,1132,6,556,2755.4,218.0,92.66666666666669,5,576,3851.0,304.0,115.2
1307234.0,6,4,264,2,132,0.0,66.0,66.0,2,132,0.0,66.0,66.0
306551.0,6,6,412,4,272,102183.66666666669,74.0,68.0,2,140,0.0,74.0,70.0
41167.0,6,10,2032,5,524,10063.75,252.0,104.8,5,1508,9981.0,1236.0,301.6
21747.0,6,10,2032,5,524,5195.0,252.0,104.8,5,1508,5149.5,1236.0,301.6
108136774.0,17,14,864,7,432,18000162.333333332,174.0,61.71428571428572,7,432,18001171.5,174.0,61.71428571428572
37990.0,6,14,4740,7,653,6199.666666666667,249.0,93.28571428571428,7,4087,6048.166666666667,1514.0,583.8571428571429
345.0,17,2,160,1,80,0.0,80.0,80.0,1,80,0.0,80.0,80.0
143957.0,17,2,180,1,90,0.0,90.0,90.0,1,90,0.0,90.0,90.0
21244596.0,6,4,264,2,132,0.0,66.0,66.0,2,132,0.0,66.0,66.0
123852039.0,6,49,3234,25,1650,5160501.625,66.0,66.0,24,1584,5077408.826086956,66.0,66.0
197257.0,17,2,180,1,90,0.0,90.0,90.0,1,90,0.0,90.0,90.0
120124766.0,6,14,2224,9,1204,15015595.75,188.0,133.77777777777777,5,1020,22523167.75,204.0,204.0
90285604.0,6,16,1192,8,596,12891671.285714284,95.0,74.5,8,596,12896666.857142856,95.0,74.5
90302393.0,6,16,1192,8,596,12893648.857142856,95.0,74.5,8,596,12899003.0,95.0,74.5
2289.0,17,4,344,2,150,0.0,75.0,75.0,2,194,0.0,103.0,97.0
0.0,17,1,44,1,44,0.0,44.0,44.0,0,0,0.0,0.0,0.0
145031.0,17,2,180,1,70,0.0,70.0,70.0,1,110,0.0,110.0,110.0
1091.0,17,2,508,2,508,0.0,257.0,254.0,0,0,0.0,0.0,0.0
90060958.0,17,28,13364,28,13364,3335591.037037037,501.0,477.2857142857143,0,0,0.0,0.0,0.0
32681470.0,6,5,336,2,134,0.0,68.0,67.0,3,202,14950711.0,70.0,67.33333333333333
34214.0,6,14,4740,7,653,5255.5,249.0,93.28571428571428,7,4087,5374.833333333333,1514.0,583.8571428571429
41429.0,6,10,2032,5,524,10143.5,252.0,104.8,5,1508,8352.0,1236.0,301.6
90066512.0,17,28,13364,28,13364,3335796.7407407407,501.0,477.2857142857143,0,0,0.0,0.0,0.0
11970.0,17,2,571,1,86,0.0,86.0,86.0,1,485,0.0,485.0,485.0
16835.0,17,2,180,1,90,0.0,90.0,90.0,1,90,0.0,90.0,90.0
113716865.0,6,53,4642,30,2572,3914221.3103448274,139.0,85.73333333333333,23,2070,5159655.090909091,123.0,90.0
146348.0,6,3,337,2,214,0.0,160.0,107.0,1,123,0.0,123.0,123.0
2388.0,17,4,344,2,150,0.0,75.0,75.0,2,194,0.0,103.0,97.0
90292988.0,6,21,1585,11,799,9024256.9,95.0,72.63636363636364,10,786,10031105.222222222,95.0,78.6
112979900.0,6,45,2970,23,1518,5135450.0,66.0,66.0,22,1452,5054347.857142857,66.0,66.0
120033293.0,6,17,1246,9,650,15004161.625,95.0,72.22222222222223,8,596,12852823.42857143,95.0,74.5
36496.0,6,10,2032,5,524,8753.5,252.0,104.8,5,1508,8337.25,1236.0,301.6
105187973.0,17,14,864,7,432,17500877.333333332,174.0,61.71428571428572,7,432,17500172.0,174.0,61.71428571428572
90048167.0,17,28,13364,28,13364,3335117.296296296,501.0,477.2857142857143,0,0,0.0,0.0,0.0
143945.0,17,2,180,1,90,0.0,90.0,90.0,1,90,0.0,90.0,90.0
212727.0,17,2,180,1,90,0.0,90.0,90.0,1,90,0.0,90.0,90.0
62822988.0,17,11,3770,10,3420,4552347.888888889,342.0,342.0,1,350,0.0,350.0,350.0
303105.0,6,2,132,1,66,0.0,66.0,66.0,1,66,0.0,66.0,66.0
20349.0,6,14,4740,7,653,2854.5,249.0,93.28571428571428,7,4087,3190.6666666666665,1514.0,583.8571428571429
128880045.0,6,35,2542,18,1348,7581179.117647059,139.0,74.88888888888889,17,1194,7417324.625,123.0,70.23529411764706
303752.0,6,6,412,4,272,101250.66666666669,74.0,68.0,2,140,0.0,74.0,70.0
205943.0,6,3,426,2,280,0.0,214.0,140.0,1,146,0.0,146.0,146.0
120365656.0,6,253,28592,127,19980,955282.984126984,284.0,157.3228346456693,126,8612,954604.208,140.0,68.34920634920636
90094378.0,6,16,2246,8,1230,12870260.142857144,204.0,153.75,8,1016,12869893.0,188.0,127.0
124930452.0,6,31,2113,16,1165,8328696.8,139.0,72.8125,15,948,8416158.642857144,123.0,63.2
6547.0,17,4,823,2,163,0.0,89.0,81.5,2,660,0.0,443.0,330.0
120147448.0,6,208,23642,104,7160,1158574.2718446602,140.0,68.84615384615384,104,16482,1158361.2621359224,374.0,158.48076923076923
205944.0,6,3,426,2,280,0.0,214.0,140.0,1,146,0.0,146.0,146.0
309296.0,6,6,412,4,272,103098.66666666669,74.0,68.0,2,140,0.0,74.0,70.0
48158.0,6,14,4740,7,653,7884.166666666667,249.0,93.28571428571428,7,4087,6155.666666666667,1514.0,583.8571428571429
117001459.0,17,13,821,7,432,19500243.166666668,174.0,61.71428571428572,6,389,19401414.4,174.0,64.83333333333333
20808.0,6,14,4740,7,653,3224.5,249.0,93.28571428571428,7,4087,3042.333333333333,1514.0,583.8571428571429
90286017.0,6,33,3441,17,1747,5639893.0625,424.0,102.76470588235294,16,1694,6000762.466666667,336.0,105.875
123306878.0,6,48,3168,24,1584,5029316.869565218,66.0,66.0,24,1584,5264016.347826087,66.0,66.0
2532746.0,6,3,204,1,68,0.0,68.0,68.0,2,136,0.0,70.0,68.0
852531.0,6,9,1096,6,625,170506.2,287.0,104.16666666666669,3,471,288483.5,331.0,157.0
304856.0,6,6,412,4,272,101618.66666666669,74.0,68.0,2,140,0.0,74.0,70.0
304058.0,6,6,412,4,272,101352.66666666669,74.0,68.0,2,140,0.0,74.0,70.0
2298.0,17,4,344,2,150,0.0,75.0,75.0,2,194,0.0,103.0,97.0
33809.0,6,10,2032,5,524,7008.5,252.0,104.8,5,1508,8016.5,1236.0,301.6
118550267.0,6,222,24962,111,17340,1075774.2454545454,284.0,156.21621621621622,111,7622,1075773.9,140.0,68.66666666666667
328.0,17,2,174,1,79,0.0,79.0,79.0,1,95,0.0,95.0,95.0
38211.0,6,14,4740,7,653,5147.5,249.0,93.28571428571428,7,4087,6202.5,1514.0,583.8571428571429
20918.0,17,2,582,1,83,0.0,83.0,83.0,1,499,0.0,499.0,499.0
39720.0,6,10,2032,5,524,9695.0,252.0,104.8,5,1508,9666.25,1236.0,301.6
108109361.0,17,5,1005,5,1005,27027340.25,201.0,201.0,0,0,0.0,0.0,0.0
2016.0,17,4,344,2,150,0.0,75.0,75.0,2,194,0.0,103.0,97.0
50442.0,6,14,4740,7,653,8159.833333333333,249.0,93.28571428571428,7,4087,6686.666666666667,1514.0,583.8571428571429
31076185.0,6,26,7627,14,3735,190392.4615384616,1514.0,266.7857142857143,12,3892,2806502.272727273,1514.0,324.3333333333333
43598.0,6,10,2032,5,524,10602.25,252.0,104.8,5,1508,10379.0,1236.0,301.6
60651.0,6,10,2032,5,524,13531.75,252.0,104.8,5,1508,14125.75,1236.0,301.6
24110.0,6,10,2032,5,524,5487.0,252.0,104.8,5,1508,5730.25,1236.0,301.6
146164.0,6,3,337,2,214,0.0,160.0,107.0,1,123,0.0,123.0,123.0
141678.0,6,2,132,1,66,0.0,66.0,66.0,1,66,0.0,66.0,66.0
122050.0,6,3,337,2,214,0.0,160.0,107.0,1,123,0.0,123.0,123.0
0.0,6,1,66,1,66,0.0,66.0,66.0,0,0,0.0,0.0,0.0
310043.0,17,4,1400,4,1400,103347.66666666669,350.0,350.0,0,0,0.0,0.0,0.0
504274.0,6,5,336,2,134,0.0,68.0,67.0,3,202,193724.5,70.0,67.33333333333333
2329.0,17,4,344,2,150,0.0,75.0,75.0,2,194,0.0,103.0,97.0
27402500.0,17,5,1710,5,1710,6850625.0,342.0,342.0,0,0,0.0,0.0,0.0
2336.0,17,4,344,2,150,0.0,75.0,75.0,2,194,0.0,103.0,97.0
94349664.0,6,18,1470,9,650,11788598.25,95.0,72.22222222222223,9,820,11792846.5,224.0,91.11111111111111
198907.0,17,2,180,1,90,0.0,90.0,90.0,1,90,0.0,90.0,90.0
2423.0,17,4,344,2,150,0.0,75.0,75.0,2,194,0.0,103.0,97.0
304323.0,6,6,412,4,272,101441.0,74.0,68.0,2,140,0.0,74.0,70.0
318.0,17,2,208,1,72,0.0,72.0,72.0,1,136,0.0,136.0,136.0
1918.0,17,2,180,1,90,0.0,90.0,90.0,1,90,0.0,90.0,90.0
322515.0,17,4,1400,4,1400,107505.0,350.0,350.0,0,0,0.0,0.0,0.0
23257110.0,6,5,1736,2,819,0.0,753.0,409.5,3,917,11559576.0,785.0,305.6666666666667
90027393.0,17,28,13364,28,13364,3334347.888888889,501.0,477.2857142857143,0,0,0.0,0.0,0.0
861686.0,6,9,1270,6,799,172337.2,461.0,133.16666666666666,3,471,293034.5,331.0,157.0
243754.0,6,3,337,2,214,0.0,160.0,107.0,1,123,0.0,123.0,123.0
300.0,17,2,164,1,82,0.0,82.0,82.0,1,82,0.0,82.0,82.0
108109703.0,17,5,1005,5,1005,27027425.75,201.0,201.0,0,0,0.0,0.0,0.0
147892.0,6,4,439,2,238,0.0,172.0,119.0,2,201,0.0,135.0,100.5
135135926.0,17,6,1146,6,1146,27027185.2,191.0,191.0,0,0,0.0,0.0,0.0
143939.0,17,2,180,1,90,0.0,90.0,90.0,1,90,0.0,90.0,90.0
15156.0,6,10,2032,5,524,3560.25,252.0,104.8,5,1508,3116.0,1236.0,301.6
5826955.0,6,6,402,3,200,1564395.0,68.0,66.66666666666667,3,202,1522933.0,70.0,67.33333333333333
37046.0,6,11,2098,6,590,7027.4,252.0,98.33333333333331,5,1508,8949.75,1236.0,301.6
12230.0,6,10,2032,5,524,2743.75,252.0,104.8,5,1508,2741.0,1236.0,301.6
164866.0,17,2,414,1,88,0.0,88.0,88.0,1,326,0.0,326.0,326.0
120003759.0,6,17,1287,9,691,15000469.875,95.0,76.77777777777777,8,596,12857889.285714284,95.0,74.5
67466.0,6,14,4740,7,653,10604.333333333334,249.0,93.28571428571428,7,4087,10645.833333333334,1514.0,583.8571428571429
147221.0,17,4,704,2,148,0.0,74.0,74.0,2,556,0.0,280.0,278.0
122978619.0,6,48,3168,24,1584,5100261.304347826,66.0,66.0,24,1584,5167106.652173913,66.0,66.0
298466.0,6,6,412,4,272,99488.66666666669,74.0,68.0,2,140,0.0,74.0,70.0
90523769.0,6,14,2240,8,1016,12931967.0,188.0,127.0,6,1224,18071927.8,204.0,204.0
26733240.0,6,5,1736,2,819,0.0,753.0,409.5,3,917,13300191.5,785.0,305.6666666666667
98427.0,17,2,614,1,72,0.0,72.0,72.0,1,542,0.0,542.0,542.0
120682998.0,6,22,1680,11,840,12068299.8,95.0,76.36363636363636,11,840,9043872.1,95.0,76.36363636363636
90257288.0,6,13,2036,8,1016,12893898.285714284,188.0,127.0,5,1020,22523816.5,204.0,204.0
135196.0,6,2,132,1,66,0.0,66.0,66.0,1,66,0.0,66.0,66.0
299588.0,6,6,412,4,272,99862.66666666669,74.0,68.0,2,140,0.0,74.0,70.0
119292468.0,6,47,3102,24,1584,5186617.217391305,66.0,66.0,23,1518,5111995.045454546,66.0,66.0
101503648.0,17,14,864,7,432,16833845.333333332,174.0,61.71428571428572,7,432,16833484.666666668,174.0,61.71428571428572
356012.0,6,4,508,2,238,0.0,172.0,119.0,2,270,0.0,135.0,135.0
21338.0,6,14,4740,7,653,3389.0,249.0,93.28571428571428,7,4087,3426.333333333333,1514.0,583.8571428571429
113811483.0,6,48,3168,24,1584,4948325.347826087,66.0,66.0,24,1584,4938928.521739131,66.0,66.0
26100.0,6,14,4740,7,653,3852.5,249.0,93.28571428571428,7,4087,4215.333333333333,1514.0,583.8571428571429
29193.0,6,14,4740,7,653,4706.666666666667,249.0,93.28571428571428,7,4087,4729.0,1514.0,583.8571428571429
16097.0,6,11,1131,6,600,2820.2,262.0,100.0,5,531,3677.0,259.0,106.2
106855148.0,6,31,2182,16,1165,7110012.133333334,139.0,72.8125,15,1017,7617868.785714285,123.0,67.8
1035889.0,6,13,1394,7,797,172648.16666666666,253.0,113.85714285714286,6,597,205484.4,259.0,99.5
108124535.0,17,5,1005,5,1005,27031133.75,201.0,201.0,0,0,0.0,0.0,0.0
3413.0,17,2,762,2,762,0.0,381.0,381.0,0,0,0.0,0.0,0.0
294.0,17,2,168,1,76,0.0,76.0,76.0,1,92,0.0,92.0,92.0
4356.0,17,4,344,2,150,0.0,75.0,75.0,2,194,0.0,103.0,97.0
69452.0,6,14,4740,7,653,11315.833333333334,249.0,93.28571428571428,7,4087,11423.666666666666,1514.0,583.8571428571429
146708.0,6,4,439,2,238,0.0,172.0,119.0,2,201,0.0,135.0,100.5
94037275.0,6,174,19650,87,13686,1090953.8953488371,284.0,157.31034482758622,87,5964,1090954.8837209302,140.0,68.55172413793103
146158.0,6,3,337,2,214,0.0,160.0,107.0,1,123,0.0,123.0,123.0
202841.0,17,2,762,2,762,0.0,381.0,381.0,0,0,0.0,0.0,0.0
302730.0,6,3,202,2,128,0.0,74.0,64.0,1,74,0.0,74.0,74.0
119314475.0,17,16,1212,8,606,17000846.0,174.0,75.75,8,606,17000132.714285713,174.0,75.75
516452.0,6,5,336,2,134,0.0,68.0,67.0,3,202,195896.5,70.0,67.33333333333333
14700.0,6,11,1131,6,600,2554.2,262.0,100.0,5,531,3011.75,259.0,106.2
37504.0,6,14,4740,7,653,5385.166666666667,249.0,93.28571428571428,7,4087,6111.5,1514.0,583.8571428571429
3716100.0,6,5,336,2,134,0.0,68.0,67.0,3,202,467797.0,70.0,67.33333333333333
260600.0,6,10,1221,6,636,52120.0,298.0,106.0,4,585,80987.66666666667,379.0,146.25
4036.0,17,2,582,1,83,0.0,83.0,83.0,1,499,0.0,499.0,499.0
90253485.0,6,13,2036,8,1016,12893355.0,188.0,127.0,5,1020,22522258.0,204.0,204.0
466131.0,6,6,758,3,410,214806.0,172.0,136.66666666666666,3,348,173408.5,135.0,116.0
311519.0,17,4,1400,4,1400,103839.66666666669,350.0,350.0,0,0,0.0,0.0,0.0
2196.0,17,2,180,1,90,0.0,90.0,90.0,1,90,0.0,90.0,90.0
108106177.0,17,5,1005,5,1005,27026544.25,201.0,201.0,0,0,0.0,0.0,0.0
120051422.0,17,28,13364,28,13364,4446348.962962963,501.0,477.2857142857143,0,0,0.0,0.0,0.0
835.0,17,5,550,5,550,208.75,110.0,110.0,0,0,0.0,0.0,0.0
54480.0,6,14,4740,7,653,8451.666666666666,249.0,93.28571428571428,7,4087,8157.0,1514.0,583.8571428571429
228214.0,17,2,180,1,90,0.0,90.0,90.0,1,90,0.0,90.0,90.0
116771053.0,6,48,3168,24,1584,5077002.304347826,66.0,66.0,24,1584,5063330.0869565215,66.0,66.0
90235746.0,6,13,2036,8,1016,12890820.857142856,188.0,127.0,5,1020,22517780.25,204.0,204.0
277267.0,17,2,363,1,79,0.0,79.0,79.0,1,284,0.0,284.0,284.0
2422.0,17,4,344,2,150,0.0,75.0,75.0,2,194,0.0,103.0,97.0
90288882.0,6,24,2715,13,1453,7524073.5,360.0,111.76923076923076,11,1262,9000241.4,426.0,114.72727272727272
1082176.0,6,13,1386,7,789,180362.66666666663,253.0,112.71428571428572,6,597,212773.6,259.0,99.5
0.0,17,1,381,1,381,0.0,381.0,381.0,0,0,0.0,0.0,0.0
121009742.0,17,15,907,8,475,17287106.0,174.0,59.375,7,432,16833497.333333332,174.0,61.71428571428572
48805.0,6,14,4740,7,653,7394.333333333333,249.0,93.28571428571428,7,4087,7767.0,1514.0,583.8571428571429
119474359.0,6,211,23852,106,7230,1137851.0380952382,140.0,68.20754716981132,105,16622,1138826.875,284.0,158.3047619047619
90242583.0,6,14,1043,7,542,15006276.333333334,95.0,77.42857142857143,7,501,15000463.333333334,95.0,71.57142857142857
35373.0,6,14,4740,7,653,5635.5,249.0,93.28571428571428,7,4087,5756.833333333333,1514.0,583.8571428571429
90050093.0,17,27,12943,27,12943,3463465.1153846155,501.0,479.3703703703704,0,0,0.0,0.0,0.0
1594545.0,6,2,132,1,66,0.0,66.0,66.0,1,66,0.0,66.0,66.0
2358451.0,6,49,23728,25,19797,98268.79166666669,1514.0,791.88,24,3931,92785.1304347826,1514.0,163.79166666666666
120027411.0,17,28,13364,28,13364,4445459.666666667,501.0,477.2857142857143,0,0,0.0,0.0,0.0
120126020.0,6,14,2224,9,1204,15015752.5,188.0,133.77777777777777,5,1020,22523145.25,204.0,204.0
308.0,17,2,174,1,79,0.0,79.0,79.0,1,95,0.0,95.0,95.0
107008.0,17,2,286,2,286,0.0,143.0,143.0,0,0,0.0,0.0,0.0
38841.0,6,14,4740,7,653,6349.166666666667,249.0,93.28571428571428,7,4087,6037.666666666667,1514.0,583.8571428571429
18275.0,17,4,823,2,163,0.0,89.0,81.5,2,660,0.0,443.0,330.0
18112.0,17,2,180,1,90,0.0,90.0,90.0,1,90,0.0,90.0,90.0
49783.0,6,14,4740,7,653,7248.333333333333,249.0,93.28571428571428,7,4087,8121.666666666667,1514.0,583.8571428571429
1212601.0,6,13,3011,8,2383,173228.7142857143,1514.0,297.875,5,628,234240.75,331.0,125.6
77.0,17,2,762,2,762,0.0,381.0,381.0,0,0,0.0,0.0,0.0
36917.0,6,10,2032,5,524,8527.75,252.0,104.8,5,1508,6341.5,1236.0,301.6
206220.0,6,3,426,2,280,0.0,214.0,140.0,1,146,0.0,146.0,146.0
146180.0,6,3,337,2,214,0.0,160.0,107.0,1,123,0.0,123.0,123.0
23013120.0,17,3,1034,2,684,0.0,342.0,342.0,1,350,0.0,350.0,350.0
103667.0,17,2,286,2,286,0.0,143.0,143.0,0,0,0.0,0.0,0.0
2372.0,17,4,344,2,150,0.0,75.0,75.0,2,194,0.0,103.0,97.0
120000182.0,6,25,1924,14,1084,9230783.23076923,95.0,77.42857142857143,11,840,9045849.0,95.0,76.36363636363636
3989.000000000001,17,4,704,2,148,0.0,74.0,74.0,2,556,0.0,280.0,278.0
43712.0,6,14,4740,7,653,7115.666666666667,249.0,93.28571428571428,7,4087,6641.333333333333,1514.0,583.8571428571429
135143515.0,17,6,1206,6,1206,27028703.0,201.0,201.0,0,0,0.0,0.0,0.0
72274.0,6,14,4740,7,653,11915.0,249.0,93.28571428571428,7,4087,11294.666666666666,1514.0,583.8571428571429
217767.0,6,3,426,2,280,0.0,214.0,140.0,1,146,0.0,146.0,146.0
205757.0,17,2,762,2,762,0.0,381.0,381.0,0,0,0.0,0.0,0.0
46502.0,6,14,4740,7,653,5906.333333333333,249.0,93.28571428571428,7,4087,7486.0,1514.0,583.8571428571429
66075.0,6,11,2098,6,590,13031.8,252.0,98.33333333333331,5,1508,15966.5,1236.0,301.6
235501.0,6,3,337,2,214,0.0,160.0,107.0,1,123,0.0,123.0,123.0
21242.0,6,10,2032,5,524,5096.5,252.0,104.8,5,1508,5014.75,1236.0,301.6
103341035.0,6,208,23564,104,16466,1001122.8252427184,284.0,158.32692307692307,104,7098,1001194.8155339806,140.0,68.25
32973.0,6,14,4740,7,653,4890.5,249.0,93.28571428571428,7,4087,4483.0,1514.0,583.8571428571429
35393.0,6,14,4740,7,653,5463.666666666667,249.0,93.28571428571428,7,4087,4185.666666666667,1514.0,583.8571428571429
4706391.0,6,27,7766,13,2524,392199.25,1034.0,194.15384615384616,14,5242,338732.23076923075,1510.0,374.4285714285714
17522.0,6,11,1133,6,602,2951.6,264.0,100.33333333333331,5,531,4142.75,259.0,106.2
2601503.0,6,2,132,1,66,0.0,66.0,66.0,1,66,0.0,66.0,66.0
262559.0,6,10,1221,6,636,52511.8,298.0,106.0,4,585,82084.33333333333,379.0,146.25
2777465.0,6,2,132,1,66,0.0,66.0,66.0,1,66,0.0,66.0,66.0
145677.0,6,3,337,2,214,0.0,160.0,107.0,1,123,0.0,123.0,123.0
249318.0,6,3,337,2,214,0.0,160.0,107.0,1,123,0.0,123.0,123.0
306722.0,6,6,412,4,272,102240.66666666669,74.0,68.0,2,140,0.0,74.0,70.0
2034.0,17,4,344,2,150,0.0,75.0,75.0,2,194,0.0,103.0,97.0
298885.0,6,6,412,4,272,99628.33333333331,74.0,68.0,2,140,0.0,74.0,70.0
312234.0,17,4,1400,4,1400,104078.0,350.0,350.0,0,0,0.0,0.0,0.0
27109.0,6,10,2032,5,524,5941.25,252.0,104.8,5,1508,6510.25,1236.0,301.6
7403.0,17,2,582,1,83,0.0,83.0,83.0,1,499,0.0,499.0,499.0
51292.0,6,14,4740,7,653,8428.5,249.0,93.28571428571428,7,4087,7990.333333333333,1514.0,583.8571428571429
310500.0,6,3,202,2,128,0.0,74.0,64.0,1,74,0.0,74.0,74.0
2476.0,17,4,344,2,150,0.0,75.0,75.0,2,194,0.0,103.0,97.0
143950.0,17,2,180,1,90,0.0,90.0,90.0,1,90,0.0,90.0,90.0
90036003.0,17,27,12943,27,12943,3462923.1923076925,501.0,479.3703703703704,0,0,0.0,0.0,0.0
108697635.0,6,33,2428,17,1288,6780120.125,139.0,75.76470588235294,16,1140,7232130.0,123.0,71.25
120299813.0,6,230,25850,115,7886,1048055.9385964912,140.0,68.57391304347826,115,17964,1047996.1315789474,284.0,156.2086956521739
278032.0,17,2,363,1,79,0.0,79.0,79.0,1,284,0.0,284.0,284.0
1032237.0,6,11,1134,6,558,206447.4,220.0,93.0,5,576,257032.75,304.0,115.2
2060.0,17,4,344,2,150,0.0,75.0,75.0,2,194,0.0,103.0,97.0
142059.0,17,4,344,2,150,0.0,75.0,75.0,2,194,0.0,103.0,97.0
228291.0,17,2,180,1,90,0.0,90.0,90.0,1,90,0.0,90.0,90.0
192252.0,17,2,180,1,90,0.0,90.0,90.0,1,90,0.0,90.0,90.0
117115570.0,6,64,13009,32,6469,3770103.7741935486,1514.0,202.15625,32,6540,3771287.677419354,1514.0,204.375
205961.0,6,3,426,2,280,0.0,214.0,140.0,1,146,0.0,146.0,146.0
90259656.0,6,12,1832,8,1016,12894236.57142857,188.0,127.0,4,816,30030904.33333333,204.0,204.0
32315528.0,6,26,7627,14,3735,202331.0,1514.0,266.7857142857143,12,3892,2918122.8181818184,1514.0,324.3333333333333
24755211.0,17,5,1718,4,1368,1014406.0,342.0,342.0,1,350,0.0,350.0,350.0
121088.0,6,3,337,2,214,0.0,160.0,107.0,1,123,0.0,123.0,123.0
103154.0,17,2,286,2,286,0.0,143.0,143.0,0,0,0.0,0.0,0.0
330.0,17,2,214,1,75,0.0,75.0,75.0,1,139,0.0,139.0,139.0
247432.0,6,3,337,2,214,0.0,160.0,107.0,1,123,0.0,123.0,123.0
311495.0,6,6,412,4,272,103831.66666666669,74.0,68.0,2,140,0.0,74.0,70.0
135130757.0,17,6,1146,6,1146,27026151.4,191.0,191.0,0,0,0.0,0.0,0.0
306470.0,6,6,412,4,272,102156.66666666669,74.0,68.0,2,140,0.0,74.0,70.0
2485.0,17,4,344,2,150,0.0,75.0,75.0,2,194,0.0,103.0,97.0
107443.0,17,2,286,2,286,0.0,143.0,143.0,0,0,0.0,0.0,0.0
58802.0,6,14,4740,7,653,9064.5,249.0,93.28571428571428,7,4087,8878.166666666666,1514.0,583.8571428571429
217827.0,6,3,426,2,280,0.0,214.0,140.0,1,146,0.0,146.0,146.0
304059.0,6,6,412,4,272,101353.0,74.0,68.0,2,140,0.0,74.0,70.0
219327.0,6,3,426,2,280,0.0,214.0,140.0,1,146,0.0,146.0,146.0
146344.0,6,3,337,2,214,0.0,160.0,107.0,1,123,0.0,123.0,123.0
857605.0,6,9,1267,6,796,171521.0,458.0,132.66666666666666,3,471,292529.0,331.0,157.0
39824.0,6,14,4740,7,653,6400.833333333333,249.0,93.28571428571428,7,4087,5917.0,1514.0,583.8571428571429
232864.0,6,3,337,2,214,0.0,160.0,107.0,1,123,0.0,123.0,123.0
1153316.0,17,6,1230,3,234,576475.0,78.0,78.0,3,996,576455.5,332.0,332.0
2453.0,17,4,344,2,150,0.0,75.0,75.0,2,194,0.0,103.0,97.0
3605.0,17,2,363,1,79,0.0,79.0,79.0,1,284,0.0,284.0,284.0
107832897.0,6,28,1860,14,966,8279115.538461538,123.0,69.0,14,894,8279066.076923077,123.0,63.85714285714285
135123298.0,17,6,1206,6,1206,27024659.6,201.0,201.0,0,0,0.0,0.0,0.0
112009642.0,17,13,821,7,432,18668273.666666668,174.0,61.71428571428572,6,389,18400181.2,174.0,64.83333333333333
90226336.0,6,21,1585,10,745,9997320.555555556,95.0,74.5,11,840,9001102.0,95.0,76.36363636363636
102468.0,17,2,286,2,286,0.0,143.0,143.0,0,0,0.0,0.0,0.0
21052.0,6,14,4740,7,653,3371.833333333333,249.0,93.28571428571428,7,4087,3168.6666666666665,1514.0,583.8571428571429
95000978.0,17,11,735,6,389,19000195.6,174.0,64.83333333333333,5,346,18751592.25,174.0,69.2
36512.0,6,14,4740,7,653,5552.0,249.0,93.28571428571428,7,4087,5949.0,1514.0,583.8571428571429
197016.0,17,2,180,1,90,0.0,90.0,90.0,1,90,0.0,90.0,90.0
220039.0,6,3,426,2,280,0.0,214.0,140.0,1,146,0.0,146.0,146.0
14945.0,17,2,180,1,90,0.0,90.0,90.0,1,90,0.0,90.0,90.0
108735192.0,6,32,2220,16,1149,7249012.8,123.0,71.8125,16,1071,7234596.266666667,123.0,66.9375
489595.0,17,2,363,1,79,0.0,79.0,79.0,1,284,0.0,284.0,284.0
120000057.0,6,22,1680,12,935,10909096.090909092,95.0,77.91666666666667,10,745,10001617.111111112,95.0,74.5
280433.0,6,3,337,2,214,0.0,160.0,107.0,1,123,0.0,123.0,123.0
2467.0,17,4,344,2,150,0.0,75.0,75.0,2,194,0.0,103.0,97.0
121379.0,6,3,337,2,214,0.0,160.0,107.0,1,123,0.0,123.0,123.0
228158.0,17,2,180,1,90,0.0,90.0,90.0,1,90,0.0,90.0,90.0
216447.0,17,2,180,1,90,0.0,90.0,90.0,1,90,0.0,90.0,90.0
135132295.0,17,6,1206,6,1206,27026459.0,201.0,201.0,0,0,0.0,0.0,0.0
120042268.0,17,29,13785,29,13785,4287223.857142857,501.0,475.3448275862069,0,0,0.0,0.0,0.0
28294.0,6,14,4740,7,653,2883.5,249.0,93.28571428571428,7,4087,4583.333333333333,1514.0,583.8571428571429
108115729.0,17,5,955,5,955,27028932.25,191.0,191.0,0,0,0.0,0.0,0.0
47611460.0,6,7,2047,3,960,22483755.5,826.0,320.0,4,1087,15013429.666666666,885.0,271.75
203291.0,17,4,6056,4,6056,67763.66666666667,1514.0,1514.0,0,0,0.0,0.0,0.0
207268.0,6,3,426,2,280,0.0,214.0,140.0,1,146,0.0,146.0,146.0
158784.0,6,3,337,2,214,0.0,160.0,107.0,1,123,0.0,123.0,123.0
155599.0,6,3,337,2,214,0.0,160.0,107.0,1,123,0.0,123.0,123.0
102948.0,17,3,1143,3,1143,51474.0,381.0,381.0,0,0,0.0,0.0,0.0
213642.0,17,2,180,1,90,0.0,90.0,90.0,1,90,0.0,90.0,90.0
240285.0,6,3,337,2,214,0.0,160.0,107.0,1,123,0.0,123.0,123.0
1303576.0,6,4,264,2,132,0.0,66.0,66.0,2,132,0.0,66.0,66.0
108106541.0,17,5,1005,5,1005,27026635.25,201.0,201.0,0,0,0.0,0.0,0.0
59410.0,6,10,2032,5,524,14615.25,252.0,104.8,5,1508,11619.5,1236.0,301.6
207025.0,6,3,426,2,280,0.0,214.0,140.0,1,146,0.0,146.0,146.0
2423.0,17,4,344,2,150,0.0,75.0,75.0,2,194,0.0,103.0,97.0
346.0,17,2,267,1,83,0.0,83.0,83.0,1,184,0.0,184.0,184.0
232944.0,6,3,337,2,214,0.0,160.0,107.0,1,123,0.0,123.0,123.0
5623689.0,6,5,336,2,134,0.0,68.0,67.0,3,202,1422881.0,70.0,67.33333333333333
52427.0,6,10,2032,5,524,11164.5,252.0,104.8,5,1508,11373.75,1236.0,301.6
304498.0,6,6,412,4,272,101499.33333333331,74.0,68.0,2,140,0.0,74.0,70.0
108109617.0,17,5,1005,5,1005,27027404.25,201.0,201.0,0,0,0.0,0.0,0.0
103223.0,17,2,286,2,286,0.0,143.0,143.0,0,0,0.0,0.0,0.0
52997.0,6,14,4740,7,653,8657.666666666666,249.0,93.28571428571428,7,4087,8451.333333333334,1514.0,583.8571428571429
110986.0,17,2,286,2,286,0.0,143.0,143.0,0,0,0.0,0.0,0.0
104212.0,17,2,700,2,700,0.0,350.0,350.0,0,0,0.0,0.0,0.0
37054.0,6,14,4740,7,653,6055.5,249.0,93.28571428571428,7,4087,5882.833333333333,1514.0,583.8571428571429
0.0,17,1,381,1,381,0.0,381.0,381.0,0,0,0.0,0.0,0.0
90043729.0,17,28,13364,28,13364,3334952.925925926,501.0,477.2857142857143,0,0,0.0,0.0,0.0
967106.0,17,2,346,1,78,0.0,78.0,78.0,1,268,0.0,268.0,268.0
39962.0,6,2,132,1,66,0.0,66.0,66.0,1,66,0.0,66.0,66.0
316340.0,17,4,1400,4,1400,105446.66666666669,350.0,350.0,0,0,0.0,0.0,0.0
90287636.0,6,19,1436,10,745,10026537.555555556,95.0,74.5,9,691,11285289.5,95.0,76.77777777777777
135125893.0,17,6,1206,6,1206,27025178.6,201.0,201.0,0,0,0.0,0.0,0.0
18390.0,6,14,4740,7,653,2920.0,249.0,93.28571428571428,7,4087,2928.1666666666665,1514.0,583.8571428571429
14640889.0,6,20,1607,10,975,1592582.6666666667,315.0,97.5,10,632,1592554.111111111,78.0,63.2
306944.0,6,6,412,4,272,102314.66666666669,74.0,68.0,2,140,0.0,74.0,70.0
5625891.0,6,5,336,2,134,0.0,68.0,67.0,3,202,1424507.0,70.0,67.33333333333333
210352.0,17,2,180,1,90,0.0,90.0,90.0,1,90,0.0,90.0,90.0
92016285.0,6,38,2508,19,1254,5112001.388888889,66.0,66.0,19,1254,5112001.833333333,66.0,66.0
301837.0,6,6,412,4,272,100612.33333333331,74.0,68.0,2,140,0.0,74.0,70.0
340345.0,6,2,132,1,66,0.0,66.0,66.0,1,66,0.0,66.0,66.0
205268.0,17,2,180,1,90,0.0,90.0,90.0,1,90,0.0,90.0,90.0
240534.0,6,3,337,2,214,0.0,160.0,107.0,1,123,0.0,123.0,123.0
284298.0,17,2,363,1,79,0.0,79.0,79.0,1,284,0.0,284.0,284.0
20321.0,6,14,4740,7,653,2949.333333333333,249.0,93.28571428571428,7,4087,3245.6666666666665,1514.0,583.8571428571429
131790.0,6,14,4740,7,653,20059.166666666668,249.0,93.28571428571428,7,4087,19327.83333333333,1514.0,583.8571428571429
10556697.0,6,7,478,4,272,3458512.333333333,74.0,68.0,3,206,5187652.0,74.0,68.66666666666667
206065.0,6,3,426,2,280,0.0,214.0,140.0,1,146,0.0,146.0,146.0
106373.0,17,2,286,2,286,0.0,143.0,143.0,0,0,0.0,0.0,0.0
32114.0,6,14,4740,7,653,5108.0,249.0,93.28571428571428,7,4087,5173.666666666667,1514.0,583.8571428571429
2373.0,17,4,344,2,150,0.0,75.0,75.0,2,194,0.0,103.0,97.0
119099457.0,6,20,1490,10,745,13233273.0,95.0,74.5,10,745,13203633.666666666,95.0,74.5
299.0,17,2,156,1,78,0.0,78.0,78.0,1,78,0.0,78.0,78.0
101184383.0,6,188,21310,94,14884,1085797.494623656,374.0,158.3404255319149,94,6426,1085797.1505376345,140.0,68.36170212765957
107634.0,17,2,286,2,286,0.0,143.0,143.0,0,0,0.0,0.0,0.0
90023401.0,17,28,13364,28,13364,3334200.037037037,501.0,477.2857142857143,0,0,0.0,0.0,0.0
20424.0,6,11,2098,6,590,3949.0,252.0,98.33333333333331,5,1508,4819.5,1236.0,301.6
91621627.0,6,272,31836,136,9198,672590.637037037,140.0,67.63235294117646,136,22638,678594.074074074,300.0,166.4558823529412
122314779.0,6,48,3168,24,1584,5099579.0,66.0,66.0,24,1584,5108188.130434782,66.0,66.0
83764407.0,17,27,11367,27,11367,3221707.961538461,453.0,421.0,0,0,0.0,0.0,0.0
262965.0,6,10,1221,6,636,52593.0,298.0,106.0,4,585,81456.33333333333,379.0,146.25
303622.0,6,2,132,1,66,0.0,66.0,66.0,1,66,0.0,66.0,66.0
115685349.0,6,46,3976,26,2206,4627413.96,139.0,84.84615384615384,20,1770,6077316.52631579,123.0,88.5
115827889.0,6,48,3168,24,1584,5035995.173913044,66.0,66.0,24,1584,5024022.130434782,66.0,66.0
5004663.0,17,2,168,2,168,0.0,84.0,84.0,0,0,0.0,0.0,0.0
121471.0,6,3,337,2,214,0.0,160.0,107.0,1,123,0.0,123.0,123.0
90773078.0,6,22,1680,12,935,8248388.545454546,95.0,77.91666666666667,10,745,10054570.111111112,95.0,74.5
135118861.0,17,6,1206,6,1206,27023772.2,201.0,201.0,0,0,0.0,0.0,0.0
122616788.0,6,49,3234,24,1584,4896600.347826087,66.0,66.0,25,1650,5109022.208333333,66.0,66.0
54946.0,6,14,4740,7,653,8103.166666666667,249.0,93.28571428571428,7,4087,5757.833333333333,1514.0,583.8571428571429
90312184.0,6,16,1192,8,596,12895669.285714284,95.0,74.5,8,596,12901262.285714284,95.0,74.5
91891631.0,6,24,1829,13,989,7657278.833333333,95.0,76.07692307692308,11,840,9188662.3,95.0,76.36363636363636
22332.0,6,13,1386,7,789,3527.1666666666665,253.0,112.71428571428572,6,597,4162.6,259.0,99.5
27406.0,6,10,2032,5,524,6618.0,252.0,104.8,5,1508,6497.25,1236.0,301.6
135125061.0,17,6,1146,6,1146,27025012.2,191.0,191.0,0,0,0.0,0.0,0.0
8007486.999999999,17,2,684,2,684,0.0,342.0,342.0,0,0,0.0,0.0,0.0
206279.0,6,3,426,2,280,0.0,214.0,140.0,1,146,0.0,146.0,146.0
204790.0,17,2,762,2,762,0.0,381.0,381.0,0,0,0.0,0.0,0.0
26722.0,6,14,4740,7,653,4334.833333333333,249.0,93.28571428571428,7,4087,3339.5,1514.0,583.8571428571429
90277117.0,6,12,1832,8,1016,12896731.0,188.0,127.0,4,816,30038122.0,204.0,204.0
135130576.0,17,6,1206,6,1206,27026115.2,201.0,201.0,0,0,0.0,0.0,0.0
22224.0,6,14,4740,7,653,3543.333333333333,249.0,93.28571428571428,7,4087,3567.333333333333,1514.0,583.8571428571429
22325.0,6,14,4740,7,653,3313.0,249.0,93.28571428571428,7,4087,3105.333333333333,1514.0,583.8571428571429
106487.0,17,2,700,2,700,0.0,350.0,350.0,0,0,0.0,0.0,0.0
5627546.0,6,5,336,2,134,0.0,68.0,67.0,3,202,1424370.5,70.0,67.33333333333333
25013875.0,17,5,1718,4,1368,1758480.6666666667,342.0,342.0,1,350,0.0,350.0,350.0
9412.0,6,10,2032,5,524,2084.0,252.0,104.8,5,1508,2112.0,1236.0,301.6
216860.0,6,3,426,2,280,0.0,214.0,140.0,1,146,0.0,146.0,146.0
90258948.0,6,13,2036,8,1016,12894135.42857143,188.0,127.0,5,1020,22523320.75,204.0,204.0
90529921.0,6,14,2240,8,1016,12932845.857142856,188.0,127.0,6,1224,18072763.4,204.0,204.0
110769.0,17,2,286,2,286,0.0,143.0,143.0,0,0,0.0,0.0,0.0
147884.0,17,2,180,1,90,0.0,90.0,90.0,1,90,0.0,90.0,90.0
2961125.0,6,11,2106,6,598,592039.6,252.0,99.66666666666669,5,1508,2402.0,1236.0,301.6
143794.0,6,2,132,1,66,0.0,66.0,66.0,1,66,0.0,66.0,66.0
2590368.0,6,2,132,1,66,0.0,66.0,66.0,1,66,0.0,66.0,66.0
51141.0,17,2,180,1,90,0.0,90.0,90.0,1,90,0.0,90.0,90.0
951123.0,6,2,132,1,66,0.0,66.0,66.0,1,66,0.0,66.0,66.0
273013.0,17,4,1524,4,1524,91004.33333333331,381.0,381.0,0,0,0.0,0.0,0.0
4432.0,17,2,582,1,83,0.0,83.0,83.0,1,499,0.0,499.0,499.0
40289.0,6,14,4740,7,653,6536.833333333333,249.0,93.28571428571428,7,4087,6390.0,1514.0,583.8571428571429
3006442.0,6,11,2106,6,598,600535.4,252.0,99.66666666666669,5,1508,2389.0,1236.0,301.6
233291.0,6,3,337,2,214,0.0,160.0,107.0,1,123,0.0,123.0,123.0
68039186.0,6,8,1307,8,1307,9719883.714285716,172.0,163.375,0,0,0.0,0.0,0.0
58329.0,17,2,180,1,90,0.0,90.0,90.0,1,90,0.0,90.0,90.0
120281831.0,6,226,25550,113,7680,1066603.0535714286,140.0,67.96460176991151,113,17870,1066706.375,284.0,158.141592920354
747.0,17,2,762,2,762,0.0,381.0,381.0,0,0,0.0,0.0,0.0
22167.0,6,11,1132,6,556,3978.4,218.0,92.66666666666669,5,576,3243.75,304.0,115.2
231567.0,6,13,1394,7,797,38594.5,253.0,113.85714285714286,6,597,45091.8,259.0,99.5
1240334.0,17,7,490,7,490,206722.3333333333,70.0,70.0,0,0,0.0,0.0,0.0
90273105.0,6,14,1043,7,542,15045517.5,95.0,77.42857142857143,7,501,14998556.666666666,95.0,71.57142857142857
5827300.0,6,5,336,2,134,0.0,68.0,67.0,3,202,1522796.0,70.0,67.33333333333333
120012322.0,17,14,864,7,432,20002053.666666668,174.0,61.71428571428572,7,432,16666806.333333334,174.0,61.71428571428572
102989.0,17,2,286,2,286,0.0,143.0,143.0,0,0,0.0,0.0,0.0
92533126.0,17,12,778,6,389,18506625.2,174.0,64.83333333333333,6,389,18404609.2,174.0,64.83333333333333
5615439.0,6,4,270,2,134,0.0,68.0,67.0,2,136,0.0,70.0,68.0
232828.0,6,3,337,2,214,0.0,160.0,107.0,1,123,0.0,123.0,123.0
111258701.0,6,251,28782,126,20310,890069.608,374.0,161.1904761904762,125,8472,888818.6451612903,140.0,67.776
122687745.0,6,48,3168,24,1584,5043075.0869565215,66.0,66.0,24,1584,5165257.173913044,66.0,66.0
500.0,17,2,166,1,75,0.0,75.0,75.0,1,91,0.0,91.0,91.0
53746.0,6,14,4740,7,653,8609.166666666666,249.0,93.28571428571428,7,4087,8735.0,1514.0,583.8571428571429
108107076.0,17,5,955,5,955,27026769.0,191.0,191.0,0,0,0.0,0.0,0.0
114195413.0,6,30,1990,15,1042,8140958.571428572,139.0,69.46666666666667,15,948,8140961.5,123.0,63.2
120027614.0,17,29,13785,29,13785,4286700.5,501.0,475.3448275862069,0,0,0.0,0.0,0.0
116666429.0,6,206,23218,103,16198,1141679.6666666667,284.0,157.2621359223301,103,7020,1141679.7352941176,140.0,68.15533980582525
712.0,17,4,438,2,148,0.0,74.0,74.0,2,290,0.0,147.0,145.0
46786517.0,6,8,1940,3,887,22044947.5,753.0,295.6666666666667,5,1053,11004061.5,785.0,210.6
297510.0,17,2,180,1,90,0.0,90.0,90.0,1,90,0.0,90.0,90.0
135137254.0,17,6,1146,6,1146,27027450.8,191.0,191.0,0,0,0.0,0.0,0.0
108117137.0,17,5,1005,5,1005,27029284.25,201.0,201.0,0,0,0.0,0.0,0.0
34707.0,6,10,2032,5,524,8040.25,252.0,104.8,5,1508,7785.5,1236.0,301.6
120230864.0,6,222,25090,112,7688,1083160.936936937,140.0,68.64285714285714,110,17402,1087138.7889908256,284.0,158.2
108116584.0,17,5,1005,5,1005,27029146.0,201.0,201.0,0,0,0.0,0.0,0.0
239410.0,17,2,180,1,90,0.0,90.0,90.0,1,90,0.0,90.0,90.0
135133745.0,17,6,1146,6,1146,27026749.0,191.0,191.0,0,0,0.0,0.0,0.0
38450.0,6,14,4740,7,653,6283.166666666667,249.0,93.28571428571428,7,4087,5914.333333333333,1514.0,583.8571428571429
100034116.0,17,12,516,6,258,20000231.4,43.0,43.0,6,258,20001205.8,43.0,43.0
31248.0,6,14,4740,7,653,4746.833333333333,249.0,93.28571428571428,7,4087,5065.333333333333,1514.0,583.8571428571429
206052.0,17,2,180,1,90,0.0,90.0,90.0,1,90,0.0,90.0,90.0
241346.0,6,3,337,2,214,0.0,160.0,107.0,1,123,0.0,123.0,123.0
58168.0,6,10,2032,5,524,14135.0,252.0,104.8,5,1508,12881.25,1236.0,301.6
294072.0,6,6,412,4,272,98024.0,74.0,68.0,2,140,0.0,74.0,70.0
10472805.0,6,7,478,4,272,3445428.0,74.0,68.0,3,206,5168036.0,74.0,68.66666666666667
2049.0,17,4,344,2,150,0.0,75.0,75.0,2,194,0.0,103.0,97.0
90764125.0,6,19,1436,10,745,10079786.333333334,95.0,74.5,9,691,11343985.625,95.0,76.77777777777777
106306.0,17,2,700,2,700,0.0,350.0,350.0,0,0,0.0,0.0,0.0
303484.0,6,6,412,4,272,101161.33333333331,74.0,68.0,2,140,0.0,74.0,70.0
113618919.0,6,46,3036,23,1518,5150440.636363637,66.0,66.0,23,1518,5150421.5,66.0,66.0
118515734.0,6,220,24756,110,17200,1085327.5321100918,284.0,156.36363636363637,110,7556,1085327.2844036696,140.0,68.69090909090909
200000.0,6,10,1221,6,636,40000.0,298.0,106.0,4,585,65345.0,379.0,146.25
14446.0,6,10,2032,5,524,3384.75,252.0,104.8,5,1508,2973.0,1236.0,301.6
98081548.0,6,40,2640,20,1320,5162186.736842105,66.0,66.0,20,1320,5145943.631578947,66.0,66.0
12796.0,6,11,2098,6,590,2264.6,252.0,98.33333333333331,5,1508,2949.25,1236.0,301.6
102723.0,17,2,286,2,286,0.0,143.0,143.0,0,0,0.0,0.0,0.0
49065.0,6,14,4740,7,653,7546.333333333333,249.0,93.28571428571428,7,4087,7460.166666666667,1514.0,583.8571428571429
112436657.0,6,212,23958,106,16740,1068775.5142857144,284.0,157.9245283018868,106,7218,1068774.6761904762,140.0,68.09433962264151
196893.0,17,2,180,1,90,0.0,90.0,90.0,1,90,0.0,90.0,90.0
35397.0,6,10,2032,5,524,8609.25,252.0,104.8,5,1508,7181.75,1236.0,301.6
2801731.0,6,2,132,1,66,0.0,66.0,66.0,1,66,0.0,66.0,66.0
9782196.0,6,183,173092,53,3662,188119.15384615384,210.0,69.09433962264151,130,169430,75721.72868217055,1514.0,1303.3076923076924
120004961.0,6,23,1734,11,840,12000496.1,95.0,76.36363636363636,12,894,10886501.636363637,95.0,74.5
43903.0,6,14,4740,7,653,6923.5,249.0,93.28571428571428,7,4087,7096.166666666667,1514.0,583.8571428571429
108107315.0,17,5,955,5,955,27026828.75,191.0,191.0,0,0,0.0,0.0,0.0
10032.0,6,10,2032,5,524,2108.0,252.0,104.8,5,1508,2260.0,1236.0,301.6
119837212.0,17,14,864,7,432,19972868.666666668,174.0,61.71428571428572,7,432,19883665.5,174.0,61.71428571428572
33117.0,6,11,1132,6,556,3464.8,218.0,92.66666666666669,5,576,7999.0,304.0,115.2
108115507.0,17,5,955,5,955,27028876.75,191.0,191.0,0,0,0.0,0.0,0.0
39548.0,6,14,4740,7,653,6453.666666666667,249.0,93.28571428571428,7,4087,6135.166666666667,1514.0,583.8571428571429
32558.0,6,14,4740,7,653,5302.666666666667,249.0,93.28571428571428,7,4087,4780.166666666667,1514.0,583.8571428571429
311166.0,17,4,1400,4,1400,103722.0,350.0,350.0,0,0,0.0,0.0,0.0
93305817.0,6,25,1924,14,1084,7176506.538461538,95.0,77.42857142857143,11,840,9330112.2,95.0,76.36363636363636
46586554.0,6,8,2113,3,960,22317109.0,826.0,320.0,5,1153,10951910.25,885.0,230.6
9481.0,17,2,582,1,83,0.0,83.0,83.0,1,499,0.0,499.0,499.0
107139.0,17,2,286,2,286,0.0,143.0,143.0,0,0,0.0,0.0,0.0
153426.0,17,2,180,1,90,0.0,90.0,90.0,1,90,0.0,90.0,90.0
120515908.0,6,207,23374,104,16354,1170057.359223301,284.0,157.25,103,7020,1161247.4215686277,140.0,68.15533980582525
38558.0,6,14,4740,7,653,6251.0,249.0,93.28571428571428,7,4087,5446.666666666667,1514.0,583.8571428571429
120008014.0,6,17,1287,8,596,17144002.0,95.0,74.5,9,691,14969477.125,95.0,76.77777777777777
888.0,17,4,438,2,148,0.0,74.0,74.0,2,290,0.0,147.0,145.0
14238.0,6,10,2032,5,524,2448.75,252.0,104.8,5,1508,3269.0,1236.0,301.6
121568.0,6,3,337,2,214,0.0,160.0,107.0,1,123,0.0,123.0,123.0
870805.0,6,9,1118,6,586,174161.0,248.0,97.66666666666669,3,532,297532.0,392.0,177.33333333333334
391601.0,6,3,1604,2,851,0.0,785.0,425.5,1,753,0.0,753.0,753.0
117255032.0,6,48,3168,24,1584,5098044.869565218,66.0,66.0,24,1584,5084832.173913044,66.0,66.0
90050564.0,17,27,12943,27,12943,3463483.230769231,501.0,479.3703703703704,0,0,0.0,0.0,0.0
32682162.0,6,5,336,2,134,0.0,68.0,67.0,3,202,14950618.5,70.0,67.33333333333333
90524943.0,6,14,2240,8,1016,12932134.714285716,188.0,127.0,6,1224,18072755.4,204.0,204.0
107382.0,17,2,286,2,286,0.0,143.0,143.0,0,0,0.0,0.0,0.0
90294256.0,6,16,1320,8,765,12899179.42857143,223.0,95.625,8,555,12855370.285714284,95.0,69.375
90308814.0,6,16,1192,8,596,12894208.42857143,95.0,74.5,8,596,12899688.42857143,95.0,74.5
237330.0,6,3,337,2,214,0.0,160.0,107.0,1,123,0.0,123.0,123.0
620972.0,6,4,508,2,238,0.0,172.0,119.0,2,270,0.0,135.0,135.0
1307006.0,6,4,264,2,132,0.0,66.0,66.0,2,132,0.0,66.0,66.0
17589.0,6,11,2098,6,590,2925.4,252.0,98.33333333333331,5,1508,3885.5,1236.0,301.6
294486.0,17,2,180,1,90,0.0,90.0,90.0,1,90,0.0,90.0,90.0
29721.0,6,14,4740,7,653,4819.166666666667,249.0,93.28571428571428,7,4087,2906.6666666666665,1514.0,583.8571428571429
2397169.0,6,49,23728,25,19797,99882.04166666669,1514.0,791.88,24,3931,94446.43478260867,1514.0,163.79166666666666
146682.0,6,3,337,2,214,0.0,160.0,107.0,1,123,0.0,123.0,123.0
108709785.0,6,32,2220,16,1149,7247319.0,123.0,71.8125,16,1071,7232889.6,123.0,66.9375
146287.0,6,3,337,2,214,0.0,160.0,107.0,1,123,0.0,123.0,123.0
2600654.0,6,2,132,1,66,0.0,66.0,66.0,1,66,0.0,66.0,66.0
95992140.0,6,220,25078,110,7482,880523.3669724771,140.0,68.01818181818182,110,17596,880422.1284403669,284.0,159.96363636363637
90260265.0,6,12,1832,8,1016,12894323.57142857,188.0,127.0,4,816,30031488.0,204.0,204.0
90256383.0,6,13,2036,8,1016,12893769.0,188.0,127.0,5,1020,22522472.5,204.0,204.0
36578.0,6,14,4740,7,653,5820.666666666667,249.0,93.28571428571428,7,4087,5639.666666666667,1514.0,583.8571428571429
2179537.0,6,20,6935,11,1567,217953.7,408.0,142.45454545454547,9,5368,228970.375,1514.0,596.4444444444445
120007893.0,6,55,4762,32,2692,3871222.35483871,139.0,84.125,23,2070,4990994.454545454,123.0,90.0
209550.0,17,2,180,1,90,0.0,90.0,90.0,1,90,0.0,90.0,90.0
35818.0,6,14,4740,7,653,5680.166666666667,249.0,93.28571428571428,7,4087,5720.333333333333,1514.0,583.8571428571429
126346338.0,6,33,2280,17,1209,7896646.125,123.0,71.11764705882354,16,1071,7742891.4,123.0,66.9375
2595608.0,6,2,132,1,66,0.0,66.0,66.0,1,66,0.0,66.0,66.0
41768.0,6,10,2032,5,524,9939.0,252.0,104.8,5,1508,10021.0,1236.0,301.6
1169020.0,6,13,3000,8,2372,167002.85714285713,1514.0,296.5,5,628,223348.0,331.0,125.6
14698.0,6,11,1131,6,600,2166.8,262.0,100.0,5,531,3348.25,259.0,106.2
52044.0,6,14,4740,7,653,8200.0,249.0,93.28571428571428,7,4087,8380.666666666666,1514.0,583.8571428571429
91434156.0,6,24,1829,13,989,7618234.583333333,95.0,76.07692307692308,11,840,9142809.3,95.0,76.36363636363636
91973729.0,17,16,5472,16,5472,6131581.933333334,342.0,342.0,0,0,0.0,0.0,0.0
27443493.0,17,5,1710,5,1710,6860873.25,342.0,342.0,0,0,0.0,0.0,0.0
35815.0,6,11,1131,6,600,5967.8,262.0,100.0,5,531,7206.25,259.0,106.2
108102304.0,17,5,955,5,955,27025576.0,191.0,191.0,0,0,0.0,0.0,0.0
135143086.0,17,6,1146,6,1146,27028617.2,191.0,191.0,0,0,0.0,0.0,0.0
107226.0,17,2,286,2,286,0.0,143.0,143.0,0,0,0.0,0.0,0.0
160501.0,17,4,820,2,156,0.0,78.0,78.0,2,664,0.0,332.0,332.0
90023495.0,17,28,13364,28,13364,3334203.5185185187,501.0,477.2857142857143,0,0,0.0,0.0,0.0
90252396.0,6,13,2036,8,1016,12893199.42857143,188.0,127.0,5,1020,22522377.75,204.0,204.0
24918.0,6,14,4740,7,653,3615.6666666666665,249.0,93.28571428571428,7,4087,3965.6666666666665,1514.0,583.8571428571429
302413.0,6,2,132,1,66,0.0,66.0,66.0,1,66,0.0,66.0,66.0
96000805.0,17,13,1083,7,563,16000134.166666666,174.0,80.42857142857143,6,520,15200447.0,174.0,86.66666666666667
90025.0,6,14,4740,7,653,14882.5,249.0,93.28571428571428,7,4087,14565.0,1514.0,583.8571428571429
205790.0,6,3,426,2,280,0.0,214.0,140.0,1,146,0.0,146.0,146.0
226204.0,6,13,1394,7,797,37700.66666666666,253.0,113.85714285714286,6,597,43553.4,259.0,99.5
50749.0,6,14,4740,7,653,8333.333333333334,249.0,93.28571428571428,7,4087,7235.333333333333,1514.0,583.8571428571429
759.0,17,5,550,5,550,189.75,110.0,110.0,0,0,0.0,0.0,0.0
2400.0,17,4,344,2,150,0.0,75.0,75.0,2,194,0.0,103.0,97.0
2395.0,17,4,344,2,150,0.0,75.0,75.0,2,194,0.0,103.0,97.0
209548.0,17,2,180,1,90,0.0,90.0,90.0,1,90,0.0,90.0,90.0
90257251.0,6,13,2036,8,1016,12893893.0,188.0,127.0,5,1020,22523502.25,204.0,204.0
47703.0,6,14,4740,7,653,7412.5,249.0,93.28571428571428,7,4087,7406.0,1514.0,583.8571428571429
29384.0,6,14,4740,7,653,4634.5,249.0,93.28571428571428,7,4087,3639.8333333333335,1514.0,583.8571428571429
113567896.0,6,48,3168,24,1584,4937734.608695652,66.0,66.0,24,1584,4928336.521739131,66.0,66.0
119240568.0,6,34,2334,17,1209,7452535.5,123.0,71.11764705882354,17,1125,7439008.125,123.0,66.17647058823529
356.0,17,2,267,1,83,0.0,83.0,83.0,1,184,0.0,184.0,184.0
302317.0,6,6,412,4,272,100772.33333333331,74.0,68.0,2,140,0.0,74.0,70.0
155778.0,6,3,337,2,214,0.0,160.0,107.0,1,123,0.0,123.0,123.0
148198.0,17,2,180,1,90,0.0,90.0,90.0,1,90,0.0,90.0,90.0
317337.0,17,4,704,2,148,0.0,74.0,74.0,2,556,0.0,280.0,278.0
48983.0,6,14,4740,7,653,7269.0,249.0,93.28571428571428,7,4087,7704.833333333333,1514.0,583.8571428571429
1031853.0,6,11,1134,6,558,206370.6,220.0,93.0,5,576,256705.25,304.0,115.2
319312.0,6,6,412,4,272,106437.33333333331,74.0,68.0,2,140,0.0,74.0,70.0
62346.0,6,14,4740,7,653,7804.666666666667,249.0,93.28571428571428,7,4087,10184.5,1514.0,583.8571428571429
33928.0,6,11,2098,6,590,6565.6,252.0,98.33333333333331,5,1508,7058.0,1236.0,301.6
119702074.0,17,35,16705,35,16705,3520649.2352941176,501.0,477.2857142857143,0,0,0.0,0.0,0.0
96900639.0,6,187,21048,94,6426,1041942.3548387096,140.0,68.36170212765957,93,14622,1043293.6847826086,284.0,157.2258064516129
90067523.0,17,28,13364,28,13364,3335834.185185185,501.0,477.2857142857143,0,0,0.0,0.0,0.0
1302937.0,6,4,264,2,132,0.0,66.0,66.0,2,132,0.0,66.0,66.0
7195.0,17,2,582,1,83,0.0,83.0,83.0,1,499,0.0,499.0,499.0
145922.0,6,3,337,2,214,0.0,160.0,107.0,1,123,0.0,123.0,123.0
97769164.0,6,25,1686,13,840,8147430.333333333,123.0,64.61538461538461,12,846,7960597.272727272,123.0,70.5
108098223.0,17,5,1005,5,1005,27024555.75,201.0,201.0,0,0,0.0,0.0,0.0
2597841.0,6,2,132,1,66,0.0,66.0,66.0,1,66,0.0,66.0,66.0
92497.0,6,14,4740,7,653,14754.666666666666,249.0,93.28571428571428,7,4087,15235.833333333334,1514.0,583.8571428571429
10456756.0,6,7,478,4,272,3440356.333333333,74.0,68.0,3,206,5160418.0,74.0,68.66666666666667
2794567.0,6,2,132,1,66,0.0,66.0,66.0,1,66,0.0,66.0,66.0
302218.0,6,6,412,4,272,100739.33333333331,74.0,68.0,2,140,0.0,74.0,70.0
858360.0,6,9,1096,6,625,171672.0,287.0,104.16666666666669,3,471,292933.0,331.0,157.0
34953.0,6,14,4740,7,653,5260.0,249.0,93.28571428571428,7,4087,5511.333333333333,1514.0,583.8571428571429
1035484.0,6,11,1134,6,558,207096.8,220.0,93.0,5,576,256563.0,304.0,115.2
135133800.0,17,6,1146,6,1146,27026760.0,191.0,191.0,0,0,0.0,0.0,0.0
28542748.0,6,29,10285,17,1951,1783921.75,408.0,114.76470588235294,12,8334,2272895.727272727,1514.0,694.5
1230813.0,6,11,1134,6,558,246162.6,220.0,93.0,5,576,306925.0,304.0,115.2
298149.0,6,6,412,4,272,99383.0,74.0,68.0,2,140,0.0,74.0,70.0
1174712.0,6,13,3010,8,2382,167816.0,1514.0,297.75,5,628,225498.75,331.0,125.6
120121491.0,6,15,2152,9,1204,15015186.375,188.0,133.77777777777777,6,948,18017644.2,204.0,158.0
321787.0,17,4,1400,4,1400,107262.33333333331,350.0,350.0,0,0,0.0,0.0,0.0
111901327.0,6,30,1990,15,1042,7977522.285714285,139.0,69.46666666666667,15,948,7977523.857142857,123.0,63.2
1314691.0,6,4,264,2,132,0.0,66.0,66.0,2,132,0.0,66.0,66.0
147397.0,17,4,704,2,148,0.0,74.0,74.0,2,556,0.0,280.0,278.0
2015.0,17,4,344,2,150,0.0,75.0,75.0,2,194,0.0,103.0,97.0
112255572.0,6,31,2113,16,1071,7483704.8,123.0,66.9375,15,1042,8002412.214285715,139.0,69.46666666666667
348.0,17,2,267,1,83,0.0,83.0,83.0,1,184,0.0,184.0,184.0
130243.0,6,3,337,2,214,0.0,160.0,107.0,1,123,0.0,123.0,123.0
209686.0,17,2,180,1,90,0.0,90.0,90.0,1,90,0.0,90.0,90.0
3055444.0,6,3,1604,1,753,0.0,753.0,753.0,2,851,0.0,785.0,425.5
119538270.0,6,21,1585,12,935,10867115.454545457,95.0,77.91666666666667,9,650,11284606.375,95.0,72.22222222222223
42239.0,6,14,4740,7,653,6806.666666666667,249.0,93.28571428571428,7,4087,5637.0,1514.0,583.8571428571429
60570.0,6,10,2032,5,524,14923.0,252.0,104.8,5,1508,12223.5,1236.0,301.6
206358.0,17,2,762,2,762,0.0,381.0,381.0,0,0,0.0,0.0,0.0
47643.0,6,14,4740,7,653,7799.0,249.0,93.28571428571428,7,4087,4725.5,1514.0,583.8571428571429
90260158.0,6,12,1832,8,1016,12894308.285714284,188.0,127.0,4,816,30031475.33333333,204.0,204.0
206141.0,17,2,180,1,90,0.0,90.0,90.0,1,90,0.0,90.0,90.0
308560.0,6,6,412,4,272,102853.33333333331,74.0,68.0,2,140,0.0,74.0,70.0
146194.0,6,3,337,2,214,0.0,160.0,107.0,1,123,0.0,123.0,123.0
43983.0,6,14,4740,7,653,7123.0,249.0,93.28571428571428,7,4087,5778.166666666667,1514.0,583.8571428571429
317584.0,6,3,202,2,128,0.0,74.0,64.0,1,74,0.0,74.0,74.0
255078.00000000003,6,10,1221,6,636,51015.6,298.0,106.0,4,585,79466.33333333333,379.0,146.25
1303600.0,6,4,264,2,132,0.0,66.0,66.0,2,132,0.0,66.0,66.0
324166.0,17,2,238,1,74,0.0,74.0,74.0,1,164,0.0,164.0,164.0
228589.0,17,2,180,1,90,0.0,90.0,90.0,1,90,0.0,90.0,90.0
32111.0,6,10,2032,5,524,6156.25,252.0,104.8,5,1508,7529.25,1236.0,301.6
270835.0,6,10,1221,6,636,54167.0,298.0,106.0,4,585,84891.66666666667,379.0,146.25
297921.0,6,6,412,4,272,99307.0,74.0,68.0,2,140,0.0,74.0,70.0
524433.0,17,6,2100,6,2100,104886.6,350.0,350.0,0,0,0.0,0.0,0.0
50801.0,6,14,4740,7,653,8304.333333333334,249.0,93.28571428571428,7,4087,7942.166666666667,1514.0,583.8571428571429
90960897.0,6,21,1585,11,840,9095474.4,95.0,76.36363636363636,10,745,10105925.555555556,95.0,74.5
238278.0,6,3,373,2,238,0.0,172.0,119.0,1,135,0.0,135.0,135.0
90024011.0,17,28,13364,28,13364,3334222.6296296297,501.0,477.2857142857143,0,0,0.0,0.0,0.0
113254859.0,6,46,3036,23,1518,5135438.909090909,66.0,66.0,23,1518,5135430.954545454,66.0,66.0
29576.0,6,14,4740,7,653,4776.666666666667,249.0,93.28571428571428,7,4087,4645.333333333333,1514.0,583.8571428571429
236043.0,6,3,337,2,214,0.0,160.0,107.0,1,123,0.0,123.0,123.0
23831.0,6,14,4740,7,653,3801.5,249.0,93.28571428571428,7,4087,3471.1666666666665,1514.0,583.8571428571429
37801.0,6,11,2098,6,590,5480.6,252.0,98.33333333333331,5,1508,9139.5,1236.0,301.6
336939.0,6,12,1373,7,714,56156.5,298.0,102.0,5,659,82604.25,379.0,131.8
218555.0,6,3,426,2,280,0.0,214.0,140.0,1,146,0.0,146.0,146.0
60894.0,6,14,4740,7,653,9490.5,249.0,93.28571428571428,7,4087,9476.0,1514.0,583.8571428571429
10458656.0,6,7,478,4,272,3440624.0,74.0,68.0,3,206,5160843.5,74.0,68.66666666666667
206005.0,6,3,426,2,280,0.0,214.0,140.0,1,146,0.0,146.0,146.0
127531286.0,6,34,2334,17,1125,7346625.875,123.0,66.17647058823529,17,1209,7346646.5625,123.0,71.11764705882354
298209.0,6,6,412,4,272,99403.0,74.0,68.0,2,140,0.0,74.0,70.0
297.0,17,2,168,1,76,0.0,76.0,76.0,1,92,0.0,92.0,92.0
10475210.0,6,7,478,4,272,3444576.333333333,74.0,68.0,3,206,5166763.0,74.0,68.66666666666667
20727.0,17,2,582,1,83,0.0,83.0,83.0,1,499,0.0,499.0,499.0
103506.0,17,2,286,2,286,0.0,143.0,143.0,0,0,0.0,0.0,0.0
1759932.0,6,20,7599,11,1469,175993.2,583.0,133.54545454545453,9,6130,188293.5,1484.0,681.1111111111111
149293235.0,6,22,1680,10,745,13286895.0,95.0,74.5,12,935,13553496.090909092,95.0,77.91666666666667
307.0,17,2,168,1,76,0.0,76.0,76.0,1,92,0.0,92.0,92.0
0.0,6,1,66,1,66,0.0,66.0,66.0,0,0,0.0,0.0,0.0
180048.0,6,11,1132,6,556,36009.6,218.0,92.66666666666669,5,576,44497.25,304.0,115.2
108103404.0,17,5,955,5,955,27025851.0,191.0,191.0,0,0,0.0,0.0,0.0
0.0,17,1,90,1,90,0.0,90.0,90.0,0,0,0.0,0.0,0.0
8496195.0,17,3,1034,2,684,0.0,342.0,342.0,1,350,0.0,350.0,350.0
2577072.0,6,28,9195,16,3843,171804.8,1514.0,240.1875,12,5352,210457.0909090909,1514.0,446.0
281595.0,17,2,363,1,79,0.0,79.0,79.0,1,284,0.0,284.0,284.0
121330.0,6,3,337,2,214,0.0,160.0,107.0,1,123,0.0,123.0,123.0
104568780.0,17,14,1126,7,563,17333485.666666668,174.0,80.42857142857143,7,563,17335472.0,174.0,80.42857142857143
297757.0,6,6,412,4,272,99252.33333333331,74.0,68.0,2,140,0.0,74.0,70.0
209530.0,17,2,180,1,90,0.0,90.0,90.0,1,90,0.0,90.0,90.0
104574.0,17,2,700,2,700,0.0,350.0,350.0,0,0,0.0,0.0,0.0
300243.0,6,6,412,4,272,100081.0,74.0,68.0,2,140,0.0,74.0,70.0
40500.0,6,14,4740,7,653,6626.166666666667,249.0,93.28571428571428,7,4087,5757.833333333333,1514.0,583.8571428571429
2003530.0,17,4,525,2,150,0.0,75.0,75.0,2,375,0.0,284.0,187.5
50046.0,6,14,4740,7,653,8214.333333333334,249.0,93.28571428571428,7,4087,7452.166666666667,1514.0,583.8571428571429
76344.0,6,11,1131,6,600,14911.6,262.0,100.0,5,531,15946.0,259.0,106.2
119540854.0,6,254,28928,127,8678,948736.9365079365,140.0,68.33070866141732,127,20250,946709.1587301588,284.0,159.4488188976378
64280.00000000001,6,10,2032,5,524,15838.5,252.0,104.8,5,1508,13110.25,1236.0,301.6
2430.0,17,4,344,2,150,0.0,75.0,75.0,2,194,0.0,103.0,97.0
118027680.0,6,31,2182,16,1165,7868512.0,139.0,72.8125,15,1017,8415766.642857144,123.0,67.8
204860.0,17,2,762,2,762,0.0,381.0,381.0,0,0,0.0,0.0,0.0
114451282.0,6,48,3168,24,1584,4976142.695652174,66.0,66.0,24,1584,4963650.956521739,66.0,66.0
298200.0,6,6,412,4,272,99400.0,74.0,68.0,2,140,0.0,74.0,70.0
1304250.0,6,4,264,2,132,0.0,66.0,66.0,2,132,0.0,66.0,66.0
228604.0,17,2,180,1,90,0.0,90.0,90.0,1,90,0.0,90.0,90.0
93481927.0,17,15,5130,15,5130,6677280.5,342.0,342.0,0,0,0.0,0.0,0.0
2313.0,17,4,344,2,150,0.0,75.0,75.0,2,194,0.0,103.0,97.0
229032.0,6,3,426,2,280,0.0,214.0,140.0,1,146,0.0,146.0,146.0
300429.0,6,6,412,4,272,100143.0,74.0,68.0,2,140,0.0,74.0,70.0
108104547.0,17,5,955,5,955,27026136.75,191.0,191.0,0,0,0.0,0.0,0.0
120491682.0,6,215,24390,108,17106,1126090.4859813084,284.0,158.38888888888889,107,7284,1127015.4716981133,140.0,68.07476635514018
317153.0,17,4,1400,4,1400,105717.66666666669,350.0,350.0,0,0,0.0,0.0,0.0
90758876.0,6,19,1436,10,745,10079184.444444444,95.0,74.5,9,691,11344162.125,95.0,76.77777777777777
322429.0,17,4,1400,4,1400,107476.33333333331,350.0,350.0,0,0,0.0,0.0,0.0
208570.0,6,3,426,2,280,0.0,214.0,140.0,1,146,0.0,146.0,146.0
2396.0,17,4,344,2,150,0.0,75.0,75.0,2,194,0.0,103.0,97.0
90297157.0,6,14,1043,7,542,15049526.166666666,95.0,77.42857142857143,7,501,15000530.666666666,95.0,71.57142857142857
579179.0,6,4,508,2,238,0.0,172.0,119.0,2,270,0.0,135.0,135.0
223055.0,6,3,426,2,280,0.0,214.0,140.0,1,146,0.0,146.0,146.0
108101383.0,17,5,955,5,955,27025345.75,191.0,191.0,0,0,0.0,0.0,0.0
22653.0,6,14,4740,7,653,3614.1666666666665,249.0,93.28571428571428,7,4087,3564.0,1514.0,583.8571428571429
1388169.0,17,16,1120,16,1120,92544.6,70.0,70.0,0,0,0.0,0.0,0.0
1018589.0,6,11,2023,6,515,203551.60000000003,169.0,85.83333333333333,5,1508,3042.5,1236.0,301.6
2887.0,17,2,224,1,76,0.0,76.0,76.0,1,148,0.0,148.0,148.0
220571.0,17,2,180,1,90,0.0,90.0,90.0,1,90,0.0,90.0,90.0
108101149.0,17,5,955,5,955,27025287.25,191.0,191.0,0,0,0.0,0.0,0.0
23120369.0,17,3,1034,2,684,0.0,342.0,342.0,1,350,0.0,350.0,350.0
10457069.0,6,6,412,3,206,5160588.0,74.0,68.66666666666667,3,206,5160463.5,74.0,68.66666666666667
27688.0,6,14,4740,7,653,4488.166666666667,249.0,93.28571428571428,7,4087,4142.666666666667,1514.0,583.8571428571429
99301522.0,17,14,1126,7,563,16500136.666666666,174.0,80.42857142857143,7,563,16500841.333333334,174.0,80.42857142857143
108111697.0,17,5,1005,5,1005,27027924.25,201.0,201.0,0,0,0.0,0.0,0.0
113731829.0,6,46,3036,23,1518,5155438.454545454,66.0,66.0,23,1518,5155442.454545454,66.0,66.0
107502.0,17,2,286,2,286,0.0,143.0,143.0,0,0,0.0,0.0,0.0
8442.0,17,2,602,1,72,0.0,72.0,72.0,1,530,0.0,530.0,530.0
15591.0,6,11,1131,6,600,2915.4,262.0,100.0,5,531,3570.0,259.0,106.2
746825.0,6,2,132,1,66,0.0,66.0,66.0,1,66,0.0,66.0,66.0
310948.0,6,6,412,4,272,103649.33333333331,74.0,68.0,2,140,0.0,74.0,70.0
10574839.0,6,7,478,4,272,3478390.6666666665,74.0,68.0,3,206,5217493.0,74.0,68.66666666666667
108105429.0,17,5,1005,5,1005,27026357.25,201.0,201.0,0,0,0.0,0.0,0.0
108102253.0,17,5,1005,5,1005,27025563.25,201.0,201.0,0,0,0.0,0.0,0.0
148960.0,6,15,4806,8,719,20247.14285714286,249.0,89.875,7,4087,23795.0,1514.0,583.8571428571429
203909.0,17,2,762,2,762,0.0,381.0,381.0,0,0,0.0,0.0,0.0
104673.0,17,2,286,2,286,0.0,143.0,143.0,0,0,0.0,0.0,0.0
90256753.0,6,12,1832,8,1016,12893821.857142856,188.0,127.0,4,816,30030698.666666668,204.0,204.0
207251.0,6,3,426,2,280,0.0,214.0,140.0,1,146,0.0,146.0,146.0
328.0,17,2,250,1,93,0.0,93.0,93.0,1,157,0.0,157.0,157.0
20061.0,6,14,4740,7,653,3067.5,249.0,93.28571428571428,7,4087,3136.1666666666665,1514.0,583.8571428571429
135136355.0,17,6,1146,6,1146,27027271.0,191.0,191.0,0,0,0.0,0.0,0.0
2599725.0,6,2,132,1,66,0.0,66.0,66.0,1,66,0.0,66.0,66.0
2080.0,17,4,344,2,150,0.0,75.0,75.0,2,194,0.0,103.0,97.0
2326.0,17,4,344,2,150,0.0,75.0,75.0,2,194,0.0,103.0,97.0
108690474.0,6,33,2428,17,1288,6793154.625,139.0,75.76470588235294,16,1140,7231624.733333333,123.0,71.25
210156.0,17,2,414,1,88,0.0,88.0,88.0,1,326,0.0,326.0,326.0
20456.0,17,2,582,1,83,0.0,83.0,83.0,1,499,0.0,499.0,499.0
779.0,17,2,762,2,762,0.0,381.0,381.0,0,0,0.0,0.0,0.0
19063.0,6,13,1459,7,862,3012.6666666666665,271.0,123.14285714285714,6,597,3649.8,259.0,99.5
120012669.0,6,17,1246,9,650,15001583.625,95.0,72.22222222222223,8,596,17106933.85714286,95.0,74.5
10484572.0,6,7,478,4,272,3448229.6666666665,74.0,68.0,3,206,5172203.5,74.0,68.66666666666667
46798.0,6,14,4740,7,653,6605.166666666667,249.0,93.28571428571428,7,4087,7072.833333333333,1514.0,583.8571428571429
2290.0,17,4,344,2,150,0.0,75.0,75.0,2,194,0.0,103.0,97.0
152657.0,17,2,414,1,88,0.0,88.0,88.0,1,326,0.0,326.0,326.0
47174.0,6,14,4740,7,653,7678.5,249.0,93.28571428571428,7,4087,7689.333333333333,1514.0,583.8571428571429
181392.0,17,2,762,2,762,0.0,381.0,381.0,0,0,0.0,0.0,0.0
302.0,17,2,156,1,78,0.0,78.0,78.0,1,78,0.0,78.0,78.0
36161.0,6,14,4740,7,653,5743.333333333333,249.0,93.28571428571428,7,4087,5411.166666666667,1514.0,583.8571428571429
101433.0,17,2,286,2,286,0.0,143.0,143.0,0,0,0.0,0.0,0.0
228171.0,17,2,180,1,90,0.0,90.0,90.0,1,90,0.0,90.0,90.0
196956.0,17,2,180,1,90,0.0,90.0,90.0,1,90,0.0,90.0,90.0
59645.0,6,14,4740,7,653,8809.5,249.0,93.28571428571428,7,4087,9565.333333333334,1514.0,583.8571428571429
92259584.0,17,12,778,6,389,18400164.4,174.0,64.83333333333333,6,389,18401171.8,174.0,64.83333333333333
2627992.0,6,25,7573,14,3735,202153.2307692308,1514.0,266.7857142857143,11,3838,237855.5,1514.0,348.90909090909093
71143963.0,6,9,842,9,842,8892995.375,97.0,93.55555555555556,0,0,0.0,0.0,0.0
58902.0,6,10,2032,5,524,14485.0,252.0,104.8,5,1508,14441.0,1236.0,301.6
12747.0,6,14,4740,7,653,1877.1666666666667,249.0,93.28571428571428,7,4087,1991.0,1514.0,583.8571428571429
3347.0,17,2,762,2,762,0.0,381.0,381.0,0,0,0.0,0.0,0.0
20897.0,6,20,7606,11,978,2089.7,310.0,88.9090909090909,9,6628,2314.25,1514.0,736.4444444444445
5539542.0,6,5,336,2,134,0.0,68.0,67.0,3,202,1532987.0,70.0,67.33333333333333
90290075.0,6,16,1192,8,596,12891985.285714284,95.0,74.5,8,596,12897218.0,95.0,74.5
320990.0,17,4,1400,4,1400,106996.66666666669,350.0,350.0,0,0,0.0,0.0,0.0
298341.0,17,4,1524,4,1524,99447.0,381.0,381.0,0,0,0.0,0.0,0.0
13615628.0,6,20,1607,10,975,1479193.6666666667,315.0,97.5,10,632,1479028.5555555555,78.0,63.2
2792047.0,6,2,132,1,66,0.0,66.0,66.0,1,66,0.0,66.0,66.0
90040174.0,17,27,12943,27,12943,3463083.6153846155,501.0,479.3703703703704,0,0,0.0,0.0,0.0
203296.0,6,10,1221,6,636,40659.2,298.0,106.0,4,585,66531.66666666667,379.0,146.25
222092.0,6,10,1221,6,636,44418.4,298.0,106.0,4,585,72778.33333333333,379.0,146.25
122911016.0,17,14,864,7,432,17333491.333333332,174.0,61.71428571428572,7,432,17334391.166666668,174.0,61.71428571428572
42383.0,6,14,4740,7,653,6871.666666666667,249.0,93.28571428571428,7,4087,6839.166666666667,1514.0,583.8571428571429
14128257.0,6,18,1536,9,962,1727689.125,315.0,106.88888888888889,9,574,1727642.125,78.0,63.77777777777778
120036290.0,17,28,13364,28,13364,4445788.518518519,501.0,477.2857142857143,0,0,0.0,0.0,0.0
388.0,17,2,156,1,78,0.0,78.0,78.0,1,78,0.0,78.0,78.0
114698474.0,6,48,3168,24,1584,4986890.173913044,66.0,66.0,24,1584,4977494.478260869,66.0,66.0
3007492.0,6,11,2106,6,598,601305.4,252.0,99.66666666666669,5,1508,1967.5,1236.0,301.6
303642.0,6,2,132,1,66,0.0,66.0,66.0,1,66,0.0,66.0,66.0
90011666.0,17,27,12943,27,12943,3461987.153846154,501.0,479.3703703703704,0,0,0.0,0.0,0.0
366875.0,6,10,967,5,390,61906.0,162.0,78.0,5,577,61829.5,349.0,115.4
120122688.0,6,15,2428,9,1204,15015336.0,188.0,133.77777777777777,6,1224,18073637.2,204.0,204.0
2599901.0,6,2,132,1,66,0.0,66.0,66.0,1,66,0.0,66.0,66.0
836087.0,6,6,758,3,410,412348.5,172.0,136.66666666666666,3,348,295767.5,135.0,116.0
30895.0,6,14,4740,7,653,4419.666666666667,249.0,93.28571428571428,7,4087,4147.5,1514.0,583.8571428571429
5265.0,17,2,762,2,762,0.0,381.0,381.0,0,0,0.0,0.0,0.0
285748.0,17,4,571,2,148,0.0,74.0,74.0,2,423,0.0,280.0,211.5
104013.0,6,14,4740,7,653,17068.666666666668,249.0,93.28571428571428,7,4087,16009.5,1514.0,583.8571428571429
12307.0,17,4,823,2,163,0.0,89.0,81.5,2,660,0.0,443.0,330.0
2365.0,17,4,344,2,150,0.0,75.0,75.0,2,194,0.0,103.0,97.0
103122043.0,6,43,2838,22,1452,4899043.523809524,66.0,66.0,21,1386,5135425.05,66.0,66.0
276761.0,17,2,180,1,90,0.0,90.0,90.0,1,90,0.0,90.0,90.0
228570.0,17,2,180,1,90,0.0,90.0,90.0,1,90,0.0,90.0,90.0
3576073.0,6,5,336,2,134,0.0,68.0,67.0,3,202,1424594.0,70.0,67.33333333333333
311.0,17,2,174,1,79,0.0,79.0,79.0,1,95,0.0,95.0,95.0
2352.0,17,4,344,2,150,0.0,75.0,75.0,2,194,0.0,103.0,97.0
114644809.0,6,47,3102,24,1584,4972585.956521739,66.0,66.0,23,1518,5135446.590909091,66.0,66.0
306459.0,6,6,412,4,272,102153.0,74.0,68.0,2,140,0.0,74.0,70.0
90539230.0,6,13,2036,8,1016,12934175.714285716,188.0,127.0,5,1020,22592183.0,204.0,204.0
186862.0,6,3,337,2,214,0.0,160.0,107.0,1,123,0.0,123.0,123.0
120279630.0,6,297,35520,149,10130,807053.4864864865,140.0,67.98657718120805,148,25390,806033.9795918367,336.0,171.55405405405406
216623.0,17,2,180,1,90,0.0,90.0,90.0,1,90,0.0,90.0,90.0
101787.0,17,2,286,2,286,0.0,143.0,143.0,0,0,0.0,0.0,0.0
94973560.0,6,169,19066,85,5758,1130637.619047619,140.0,67.74117647058823,84,13308,1131753.6746987952,284.0,158.42857142857142
135132859.0,17,6,1206,6,1206,27026571.8,201.0,201.0,0,0,0.0,0.0,0.0
228379.0,17,2,180,1,90,0.0,90.0,90.0,1,90,0.0,90.0,90.0
3805.0,17,4,344,2,150,0.0,75.0,75.0,2,194,0.0,103.0,97.0
494546.0,6,3,1604,1,753,0.0,753.0,753.0,2,851,0.0,785.0,425.5
215761.0,6,12,1373,7,714,35960.166666666664,298.0,102.0,5,659,52597.75,379.0,131.8
211880.0,6,10,1221,6,636,42376.0,298.0,106.0,4,585,69344.0,379.0,146.25
15031.0,17,2,180,1,90,0.0,90.0,90.0,1,90,0.0,90.0,90.0
451.0,17,2,166,1,75,0.0,75.0,75.0,1,91,0.0,91.0,91.0
218156.0,6,10,1221,6,636,43631.2,298.0,106.0,4,585,71585.0,379.0,146.25
240704.0,6,12,1373,7,714,40117.333333333336,298.0,102.0,5,659,58803.25,379.0,131.8
1306947.0,6,4,264,2,132,0.0,66.0,66.0,2,132,0.0,66.0,66.0
312.0,17,2,174,1,79,0.0,79.0,79.0,1,95,0.0,95.0,95.0
213770.0,17,2,180,1,90,0.0,90.0,90.0,1,90,0.0,90.0,90.0
104111577.0,17,15,5130,15,5130,7436541.214285715,342.0,342.0,0,0,0.0,0.0,0.0
2157.0,17,4,344,2,150,0.0,75.0,75.0,2,194,0.0,103.0,97.0
120154397.0,6,226,25566,113,7680,1065479.044642857,140.0,67.96460176991151,113,17886,1057302.169642857,284.0,158.28318584070797
143947.0,17,2,180,1,90,0.0,90.0,90.0,1,90,0.0,90.0,90.0
3643442.0,17,2,876,2,876,0.0,438.0,438.0,0,0,0.0,0.0,0.0
299973.0,6,6,412,4,272,99991.0,74.0,68.0,2,140,0.0,74.0,70.0
3015533.0,6,11,2106,6,598,602934.0,252.0,99.66666666666669,5,1508,3758.5,1236.0,301.6
5622887.0,6,5,336,2,134,0.0,68.0,67.0,3,202,1425438.5,70.0,67.33333333333333
1956.0,17,2,180,1,90,0.0,90.0,90.0,1,90,0.0,90.0,90.0
5602.0,17,2,231,1,78,0.0,78.0,78.0,1,153,0.0,153.0,153.0
19215.0,6,2,145,2,145,0.0,91.0,72.5,0,0,0.0,0.0,0.0
321055.0,6,6,412,4,272,107018.33333333331,74.0,68.0,2,140,0.0,74.0,70.0
134604.0,6,2,132,1,66,0.0,66.0,66.0,1,66,0.0,66.0,66.0
92591801.0,6,37,2442,19,1254,5143988.944444444,66.0,66.0,18,1188,5099238.470588235,66.0,66.0
53430.0,6,14,4740,7,653,8738.166666666666,249.0,93.28571428571428,7,4087,8395.666666666666,1514.0,583.8571428571429
6401.0,17,4,823,2,163,0.0,89.0,81.5,2,660,0.0,443.0,330.0
108110603.0,17,5,1005,5,1005,27027650.75,201.0,201.0,0,0,0.0,0.0,0.0
1010710.0,6,10,1334,6,797,202142.0,459.0,132.83333333333334,4,537,245155.0,331.0,134.25
709254.0,6,10,1065,5,534,177148.5,262.0,106.8,5,531,176649.75,259.0,106.2
21937.0,6,14,4740,7,653,3530.833333333333,249.0,93.28571428571428,7,4087,3147.0,1514.0,583.8571428571429
144611.0,6,2,132,1,66,0.0,66.0,66.0,1,66,0.0,66.0,66.0
108102734.0,17,5,955,5,955,27025683.5,191.0,191.0,0,0,0.0,0.0,0.0
148898.0,17,2,414,1,88,0.0,88.0,88.0,1,326,0.0,326.0,326.0
325887.0,17,4,1400,4,1400,108629.0,350.0,350.0,0,0,0.0,0.0,0.0
19459.0,6,14,4740,7,653,2939.1666666666665,249.0,93.28571428571428,7,4087,3000.333333333333,1514.0,583.8571428571429
48510.0,6,14,4740,7,653,7955.0,249.0,93.28571428571428,7,4087,7663.166666666667,1514.0,583.8571428571429
306453.0,6,6,412,4,272,102151.0,74.0,68.0,2,140,0.0,74.0,70.0
93371280.0,17,12,778,6,389,18602272.2,174.0,64.83333333333333,6,389,18600157.6,174.0,64.83333333333333
108107497.0,17,5,955,5,955,27026874.25,191.0,191.0,0,0,0.0,0.0,0.0
108967507.0,17,16,1212,8,606,15544084.0,174.0,75.75,8,606,15536745.42857143,174.0,75.75
1023737.0,6,11,1134,6,558,204747.4,220.0,93.0,5,576,254392.75,304.0,115.2
205264.0,17,2,762,2,762,0.0,381.0,381.0,0,0,0.0,0.0,0.0
43296.0,6,14,4740,7,653,5422.166666666667,249.0,93.28571428571428,7,4087,6369.166666666667,1514.0,583.8571428571429
14631741.0,6,20,1607,10,975,1592582.111111111,315.0,97.5,10,632,1592553.888888889,78.0,63.2
46972.0,6,14,4740,7,653,7712.833333333333,249.0,93.28571428571428,7,4087,6587.333333333333,1514.0,583.8571428571429
50986.0,6,14,4740,7,653,8048.333333333333,249.0,93.28571428571428,7,4087,8155.166666666667,1514.0,583.8571428571429
436.0,17,2,508,2,508,0.0,257.0,254.0,0,0,0.0,0.0,0.0
90292018.0,6,16,1192,8,596,12892597.57142857,95.0,74.5,8,596,12898366.285714284,95.0,74.5
115609722.0,6,220,24884,110,17402,1058665.9174311927,284.0,158.2,110,7482,1058665.5779816513,140.0,68.01818181818182
183971.0,17,2,180,1,90,0.0,90.0,90.0,1,90,0.0,90.0,90.0
90285954.0,6,16,1192,8,596,12891038.142857144,95.0,74.5,8,596,12896552.0,95.0,74.5
3166661.0,6,18,1495,9,921,358531.125,315.0,102.33333333333331,9,574,358502.875,78.0,63.77777777777778
218136.0,6,3,426,2,280,0.0,214.0,140.0,1,146,0.0,146.0,146.0
56063.0,6,12,1320,6,723,10155.2,253.0,120.5,6,597,10164.8,259.0,99.5
146296.0,6,3,337,2,214,0.0,160.0,107.0,1,123,0.0,123.0,123.0
370510.0,6,10,1221,6,636,74102.0,298.0,106.0,4,585,122279.0,379.0,146.25
125004839.0,17,15,907,8,475,17857834.14285714,174.0,59.375,7,432,17500159.5,174.0,61.71428571428572
89460.0,6,14,4740,7,653,14470.333333333334,249.0,93.28571428571428,7,4087,13841.333333333334,1514.0,583.8571428571429
108113396.0,17,5,955,5,955,27028349.0,191.0,191.0,0,0,0.0,0.0,0.0
120121854.0,6,13,2036,8,1016,17137428.57142857,188.0,127.0,5,1020,22522356.25,204.0,204.0
120036673.0,6,40,3157,20,1563,6317719.631578947,123.0,78.15,20,1594,6306625.578947368,139.0,79.7
216822.0,6,3,426,2,280,0.0,214.0,140.0,1,146,0.0,146.0,146.0
153440.0,17,2,180,1,90,0.0,90.0,90.0,1,90,0.0,90.0,90.0
32759.000000000004,6,11,2098,6,590,6387.2,252.0,98.33333333333331,5,1508,7445.5,1236.0,301.6
90298364.0,6,16,1192,8,596,12893067.57142857,95.0,74.5,8,596,12896862.57142857,95.0,74.5
113633669.0,6,48,3168,24,1584,4940594.304347826,66.0,66.0,24,1584,4928747.0869565215,66.0,66.0
55358.0,6,14,4740,7,653,7927.0,249.0,93.28571428571428,7,4087,8902.333333333334,1514.0,583.8571428571429
120064998.0,17,29,13785,29,13785,4288035.642857143,501.0,475.3448275862069,0,0,0.0,0.0,0.0
2050475.0,17,6,1230,3,234,1025043.0,78.0,78.0,3,996,1025039.5,332.0,332.0
4751.0,17,2,762,2,762,0.0,381.0,381.0,0,0,0.0,0.0,0.0
206174.0,17,2,762,2,762,0.0,381.0,381.0,0,0,0.0,0.0,0.0
417.0,17,2,762,2,762,0.0,381.0,381.0,0,0,0.0,0.0,0.0
121336.0,6,3,337,2,214,0.0,160.0,107.0,1,123,0.0,123.0,123.0
345.0,17,2,267,1,83,0.0,83.0,83.0,1,184,0.0,184.0,184.0
103454433.0,6,44,2904,22,1452,4926401.571428572,66.0,66.0,22,1452,4914288.904761905,66.0,66.0
768.0,17,4,438,2,148,0.0,74.0,74.0,2,290,0.0,147.0,145.0
190766.0,17,2,180,1,90,0.0,90.0,90.0,1,90,0.0,90.0,90.0
103422881.0,6,42,2772,21,1386,5155440.45,66.0,66.0,21,1386,5155435.5,66.0,66.0
107222.0,17,2,286,2,286,0.0,143.0,143.0,0,0,0.0,0.0,0.0
2005061.0,17,8,1640,4,312,668232.0,78.0,78.0,4,1328,668218.9999999999,332.0,332.0
105198654.0,6,195,22222,98,15598,1084522.206185567,336.0,159.16326530612244,97,6624,1086327.8333333333,140.0,68.28865979381443
52250.0,6,14,4740,7,653,8304.166666666666,249.0,93.28571428571428,7,4087,8526.0,1514.0,583.8571428571429
665.0,17,2,762,2,762,0.0,381.0,381.0,0,0,0.0,0.0,0.0
312040.0,17,4,704,2,148,0.0,74.0,74.0,2,556,0.0,280.0,278.0
154.0,17,3,1050,3,1050,77.0,350.0,350.0,0,0,0.0,0.0,0.0
234373.0,17,2,359,1,75,0.0,75.0,75.0,1,284,0.0,284.0,284.0
120009815.0,6,33,2280,17,1209,7500613.4375,123.0,71.11764705882354,16,1071,7321395.666666667,123.0,66.9375
148404.0,6,3,373,2,238,0.0,172.0,119.0,1,135,0.0,135.0,135.0
90259223.0,6,14,2240,8,1016,12894174.714285716,188.0,127.0,6,1224,18018884.6,204.0,204.0
119855967.0,6,14,2102,5,1020,29962967.5,204.0,204.0,9,1082,14981859.625,188.0,120.22222222222224
310397.0,6,3,202,2,128,0.0,74.0,64.0,1,74,0.0,74.0,74.0
136931.0,6,2,132,1,66,0.0,66.0,66.0,1,66,0.0,66.0,66.0
108104897.0,17,5,1005,5,1005,27026224.25,201.0,201.0,0,0,0.0,0.0,0.0
2836.0,6,3,235,1,66,0.0,66.0,66.0,2,169,0.0,103.0,84.5
302381.0,6,2,132,1,66,0.0,66.0,66.0,1,66,0.0,66.0,66.0
32152.0,6,10,2032,5,524,7693.5,252.0,104.8,5,1508,7776.0,1236.0,301.6
29683.0,6,14,4740,7,653,4795.833333333333,249.0,93.28571428571428,7,4087,4651.5,1514.0,583.8571428571429
116008890.0,17,13,821,7,432,19334815.0,174.0,61.71428571428572,6,389,19200169.2,174.0,64.83333333333333
103295.0,17,2,286,2,286,0.0,143.0,143.0,0,0,0.0,0.0,0.0
109000.0,17,2,286,2,286,0.0,143.0,143.0,0,0,0.0,0.0,0.0
109256252.0,6,28,1860,14,966,8387715.153846154,123.0,69.0,14,894,8387714.769230769,123.0,63.85714285714285
59198.0,6,14,4740,7,653,8335.166666666666,249.0,93.28571428571428,7,4087,8008.0,1514.0,583.8571428571429
113353741.0,6,217,24426,109,7490,1049571.6759259258,140.0,68.71559633027523,108,16936,1049683.5887850467,300.0,156.8148148148148
327016.0,6,6,412,4,272,109005.33333333331,74.0,68.0,2,140,0.0,74.0,70.0
90284800.0,6,19,1436,10,745,10026978.0,95.0,74.5,9,691,11285135.5,95.0,76.77777777777777
705.0,17,4,438,2,148,0.0,74.0,74.0,2,290,0.0,147.0,145.0
108113451.0,17,5,1005,5,1005,27028362.75,201.0,201.0,0,0,0.0,0.0,0.0
37492.0,6,14,4740,7,653,6119.833333333333,249.0,93.28571428571428,7,4087,5521.0,1514.0,583.8571428571429
90258899.0,6,12,1832,8,1016,12894128.42857143,188.0,127.0,4,816,30031351.666666668,204.0,204.0
90303316.0,6,21,1585,11,840,9024725.9,95.0,76.36363636363636,10,745,10001887.111111112,95.0,74.5
502258.0,6,4,270,2,134,0.0,68.0,67.0,2,136,0.0,70.0,68.0
107857190.0,6,28,1860,14,966,8280104.846153846,123.0,69.0,14,894,8280102.615384615,123.0,63.85714285714285
1248186.0,17,7,490,7,490,208031.0,70.0,70.0,0,0,0.0,0.0,0.0
120191772.0,6,216,24424,108,7424,1115672.3177570093,140.0,68.74074074074075,108,17000,1115786.7289719626,284.0,157.40740740740742
92927842.0,6,29,2184,15,1152,6637703.0,123.0,76.8,14,1032,7131663.153846154,123.0,73.71428571428571
120000054.0,6,28,2168,16,1233,8000003.6,95.0,77.0625,12,935,8267367.545454546,95.0,77.91666666666667
307.0,17,2,174,1,79,0.0,79.0,79.0,1,95,0.0,95.0,95.0
119853050.0,6,16,2510,7,1428,19975128.33333333,204.0,204.0,9,1082,14981469.25,188.0,120.22222222222224
112418713.0,6,32,2220,16,1149,7480184.2,123.0,71.8125,16,1071,7480173.866666666,123.0,66.9375
2124.0,17,4,344,2,150,0.0,75.0,75.0,2,194,0.0,103.0,97.0
145809.0,17,4,571,2,148,0.0,74.0,74.0,2,423,0.0,276.0,211.5
322.0,17,2,166,1,75,0.0,75.0,75.0,1,91,0.0,91.0,91.0
836619.0,6,9,1096,6,625,167323.8,287.0,104.16666666666669,3,471,282006.5,331.0,157.0
216489.0,17,2,180,1,90,0.0,90.0,90.0,1,90,0.0,90.0,90.0
94752925.0,6,39,2574,20,1320,4986978.421052632,66.0,66.0,19,1254,5160003.611111111,66.0,66.0
1032044.0,6,11,1134,6,558,206408.8,220.0,93.0,5,576,257235.25,304.0,115.2
216527.0,17,2,180,1,90,0.0,90.0,90.0,1,90,0.0,90.0,90.0
5623122.0,6,5,336,2,134,0.0,68.0,67.0,3,202,1423925.0,70.0,67.33333333333333
2773892.0,6,23,4355,12,1447,252172.0,311.0,120.58333333333331,11,2908,255761.1,1514.0,264.3636363636364
213629.0,17,2,180,1,90,0.0,90.0,90.0,1,90,0.0,90.0,90.0
17201.0,6,10,2032,5,524,3782.5,252.0,104.8,5,1508,4042.75,1236.0,301.6
233420.0,6,3,337,2,214,0.0,160.0,107.0,1,123,0.0,123.0,123.0
2323.0,17,4,344,2,150,0.0,75.0,75.0,2,194,0.0,103.0,97.0
108115211.0,17,5,955,5,955,27028802.75,191.0,191.0,0,0,0.0,0.0,0.0
312855.0,17,4,1400,4,1400,104285.0,350.0,350.0,0,0,0.0,0.0,0.0
849376.0,6,9,1118,6,586,169875.2,248.0,97.66666666666669,3,532,286843.5,392.0,177.33333333333334
53081.0,6,10,2032,5,524,13033.75,252.0,104.8,5,1508,11340.0,1236.0,301.6
120123720.0,6,14,2224,9,1204,15015465.0,188.0,133.77777777777777,5,1020,22591088.5,204.0,204.0
90095056.0,6,11,1644,4,816,30030908.33333333,204.0,204.0,7,828,15015375.5,188.0,118.28571428571428
322771.0,17,4,1400,4,1400,107590.33333333331,350.0,350.0,0,0,0.0,0.0,0.0
15034.0,6,14,4740,7,653,2228.0,249.0,93.28571428571428,7,4087,2370.333333333333,1514.0,583.8571428571429
90917302.0,6,170,19206,85,13374,1079750.369047619,284.0,157.34117647058824,85,5832,1079786.2857142857,140.0,68.61176470588235
5623812.0,6,4,270,2,134,0.0,68.0,67.0,2,136,0.0,70.0,68.0
380816.0,6,3,1604,2,851,0.0,785.0,425.5,1,753,0.0,753.0,753.0
312992.0,17,4,1400,4,1400,104330.66666666669,350.0,350.0,0,0,0.0,0.0,0.0
108319721.0,6,32,2236,16,1165,7206935.733333333,139.0,72.8125,16,1071,7206933.666666667,123.0,66.9375
33967.0,6,11,2098,6,590,6456.6,252.0,98.33333333333331,5,1508,7130.5,1236.0,301.6
114810106.0,6,35,2542,18,1348,6740842.117647059,139.0,74.88888888888889,17,1194,7162807.6875,123.0,70.23529411764706
45918.0,6,10,2032,5,524,10952.0,252.0,104.8,5,1508,9936.75,1236.0,301.6
135134949.0,17,6,1206,6,1206,27026989.8,201.0,201.0,0,0,0.0,0.0,0.0
49344.0,6,14,4740,7,653,7927.333333333333,249.0,93.28571428571428,7,4087,7162.5,1514.0,583.8571428571429
6793.0,17,2,582,1,83,0.0,83.0,83.0,1,499,0.0,499.0,499.0
233035.0,6,3,337,2,214,0.0,160.0,107.0,1,123,0.0,123.0,123.0
3576357.0,6,5,336,2,134,0.0,68.0,67.0,3,202,1423403.5,70.0,67.33333333333333
513047.00000000006,17,2,876,2,876,0.0,438.0,438.0,0,0,0.0,0.0,0.0
297647.0,6,6,412,4,272,99215.66666666669,74.0,68.0,2,140,0.0,74.0,70.0
90040196.0,17,28,13364,28,13364,3334822.074074074,501.0,477.2857142857143,0,0,0.0,0.0,0.0
49648.0,6,14,4740,7,653,8163.833333333333,249.0,93.28571428571428,7,4087,7230.833333333333,1514.0,583.8571428571429
107055.0,17,2,700,2,700,0.0,350.0,350.0,0,0,0.0,0.0,0.0
2012.0,17,4,344,2,150,0.0,75.0,75.0,2,194,0.0,103.0,97.0
606853.0,17,2,346,1,78,0.0,78.0,78.0,1,268,0.0,268.0,268.0
217610.0,6,3,426,2,280,0.0,214.0,140.0,1,146,0.0,146.0,146.0
52250.0,6,14,4740,7,653,7631.666666666667,249.0,93.28571428571428,7,4087,7096.0,1514.0,583.8571428571429
59723165.0,6,8,1307,8,1307,8531880.714285715,172.0,163.375,0,0,0.0,0.0,0.0
108109839.0,17,5,1005,5,1005,27027459.75,201.0,201.0,0,0,0.0,0.0,0.0
103203183.0,17,14,1126,7,563,17173896.333333332,174.0,80.42857142857143,7,563,17173895.166666668,174.0,80.42857142857143
746586.0,6,2,132,1,66,0.0,66.0,66.0,1,66,0.0,66.0,66.0
7301.0,17,2,582,1,83,0.0,83.0,83.0,1,499,0.0,499.0,499.0
2371.0,17,4,344,2,150,0.0,75.0,75.0,2,194,0.0,103.0,97.0
103896.0,17,2,286,2,286,0.0,143.0,143.0,0,0,0.0,0.0,0.0
90269736.0,6,13,2036,8,1016,12895676.57142857,188.0,127.0,5,1020,22525936.25,204.0,204.0
96265182.0,6,177,19938,89,6096,1093853.875,140.0,68.49438202247191,88,13842,1097068.08045977,284.0,157.29545454545453
28903.0,6,14,4740,7,653,4152.833333333333,249.0,93.28571428571428,7,4087,4685.333333333333,1514.0,583.8571428571429
15744.999999999998,6,10,2032,5,524,3429.5,252.0,104.8,5,1508,3696.0,1236.0,301.6
216545.0,17,2,180,1,90,0.0,90.0,90.0,1,90,0.0,90.0,90.0
90298206.0,6,17,1287,9,691,11281043.125,95.0,76.77777777777777,8,596,12899535.42857143,95.0,74.5
43845.0,6,14,4740,7,653,7187.833333333333,249.0,93.28571428571428,7,4087,6870.5,1514.0,583.8571428571429
90258339.0,6,16,2368,9,1204,11282292.375,188.0,133.77777777777777,7,1164,15015617.666666666,204.0,166.28571428571428
145926.0,6,2,132,1,66,0.0,66.0,66.0,1,66,0.0,66.0,66.0
495023.0,6,5,336,2,134,0.0,68.0,67.0,3,202,192860.0,70.0,67.33333333333333
43337.0,6,12,1320,6,723,7749.8,253.0,120.5,6,597,7670.2,259.0,99.5
120015898.0,17,28,13364,28,13364,4445033.259259259,501.0,477.2857142857143,0,0,0.0,0.0,0.0
298189.0,6,6,412,4,272,99396.33333333331,74.0,68.0,2,140,0.0,74.0,70.0
345.0,17,2,267,1,83,0.0,83.0,83.0,1,184,0.0,184.0,184.0
217129.0,17,2,180,1,90,0.0,90.0,90.0,1,90,0.0,90.0,90.0
216483.0,17,2,180,1,90,0.0,90.0,90.0,1,90,0.0,90.0,90.0
96000835.0,17,13,1083,7,563,16000139.166666666,174.0,80.42857142857143,6,520,15400910.2,174.0,86.66666666666667
120123940.0,6,13,2020,9,1204,15015492.5,188.0,133.77777777777777,4,816,30030863.0,204.0,204.0
197365.0,17,2,180,1,90,0.0,90.0,90.0,1,90,0.0,90.0,90.0
1131754.0,6,13,3020,8,2392,161679.14285714287,1514.0,299.0,5,628,214759.25,331.0,125.6
108101260.0,17,5,955,5,955,27025315.0,191.0,191.0,0,0,0.0,0.0,0.0
199182.0,17,4,6056,4,6056,66394.0,1514.0,1514.0,0,0,0.0,0.0,0.0
41385.0,6,14,4740,7,653,6728.666666666667,249.0,93.28571428571428,7,4087,6733.166666666667,1514.0,583.8571428571429
5503803.0,6,5,336,3,202,1523533.0,70.0,67.33333333333333,2,134,0.0,68.0,67.0
232704.0,6,3,426,2,280,0.0,214.0,140.0,1,146,0.0,146.0,146.0
120800054.0,6,47,3102,23,1518,5143999.045454546,66.0,66.0,24,1584,5252164.347826087,66.0,66.0
202911.0,17,4,1400,4,1400,67637.0,350.0,350.0,0,0,0.0,0.0,0.0
135130884.0,17,6,1146,6,1146,27026176.8,191.0,191.0,0,0,0.0,0.0,0.0
24255.0,17,3,1143,3,1143,12127.5,381.0,381.0,0,0,0.0,0.0,0.0
26062.0,6,10,2032,5,524,6216.75,252.0,104.8,5,1508,6173.0,1236.0,301.6
28794449.0,6,5,1736,2,819,0.0,753.0,409.5,3,917,14327969.5,785.0,305.6666666666667
108101250.0,17,5,1005,5,1005,27025312.5,201.0,201.0,0,0,0.0,0.0,0.0
5010261.0,17,4,376,2,152,0.0,76.0,76.0,2,224,0.0,148.0,112.0
14663.0,6,11,2098,6,590,2737.4,252.0,98.33333333333331,5,1508,2925.0,1236.0,301.6
332.0,17,2,166,1,75,0.0,75.0,75.0,1,91,0.0,91.0,91.0
220857.0,17,2,414,1,88,0.0,88.0,88.0,1,326,0.0,326.0,326.0
27017.0,6,10,2032,5,524,6501.5,252.0,104.8,5,1508,6339.25,1236.0,301.6
245032.0,6,3,337,2,214,0.0,160.0,107.0,1,123,0.0,123.0,123.0
102984.0,17,2,286,2,286,0.0,143.0,143.0,0,0,0.0,0.0,0.0
191227.0,17,2,180,1,90,0.0,90.0,90.0,1,90,0.0,90.0,90.0
46859.0,6,10,2032,5,524,11112.0,252.0,104.8,5,1508,7781.25,1236.0,301.6
50886.0,6,14,4740,7,653,7051.0,249.0,93.28571428571428,7,4087,8237.666666666666,1514.0,583.8571428571429
135154182.0,17,6,1146,6,1146,27030836.4,191.0,191.0,0,0,0.0,0.0,0.0
102913.0,17,2,286,2,286,0.0,143.0,143.0,0,0,0.0,0.0,0.0
2076.0,17,4,344,2,150,0.0,75.0,75.0,2,194,0.0,103.0,97.0
1046095.0,6,11,1134,6,558,209219.0,220.0,93.0,5,576,260954.5,304.0,115.2
14929.0,6,11,1133,6,602,2985.8,264.0,100.33333333333331,5,531,3020.25,259.0,106.2
388.0,17,2,410,1,78,0.0,78.0,78.0,1,332,0.0,332.0,332.0
40474.0,6,14,4740,7,653,6536.666666666667,249.0,93.28571428571428,7,4087,4953.5,1514.0,583.8571428571429
90013780.0,17,27,12943,27,12943,3462068.461538461,501.0,479.3703703703704,0,0,0.0,0.0,0.0
227382.0,6,3,426,2,280,0.0,214.0,140.0,1,146,0.0,146.0,146.0
15696.000000000002,6,14,4740,7,653,2452.333333333333,249.0,93.28571428571428,7,4087,2478.833333333333,1514.0,583.8571428571429
111007802.0,17,13,821,7,432,18501300.33333333,174.0,61.71428571428572,6,389,18200155.8,174.0,64.83333333333333
90967476.0,6,21,1585,11,840,9095476.3,95.0,76.36363636363636,10,745,10105879.0,95.0,74.5
44517.0,6,10,2032,5,524,10809.5,252.0,104.8,5,1508,9943.5,1236.0,301.6
46292.0,6,10,2032,5,524,11332.5,252.0,104.8,5,1508,10843.25,1236.0,301.6
102847.0,17,2,286,2,286,0.0,143.0,143.0,0,0,0.0,0.0,0.0
237664.0,6,3,337,2,214,0.0,160.0,107.0,1,123,0.0,123.0,123.0
147944.0,17,2,180,1,90,0.0,90.0,90.0,1,90,0.0,90.0,90.0
107531.0,17,2,286,2,286,0.0,143.0,143.0,0,0,0.0,0.0,0.0
21059.0,6,14,4740,7,653,3378.6666666666665,249.0,93.28571428571428,7,4087,3373.0,1514.0,583.8571428571429
191059.0,17,2,180,1,90,0.0,90.0,90.0,1,90,0.0,90.0,90.0
360.0,17,2,166,1,75,0.0,75.0,75.0,1,91,0.0,91.0,91.0
280897.0,6,10,1221,6,636,56179.4,298.0,106.0,4,585,87878.0,379.0,146.25
2099.0,17,4,344,2,150,0.0,75.0,75.0,2,194,0.0,103.0,97.0
500885.0,6,5,336,2,134,0.0,68.0,67.0,3,202,191551.5,70.0,67.33333333333333
207254.0,6,3,426,2,280,0.0,214.0,140.0,1,146,0.0,146.0,146.0
125610831.0,17,14,864,7,432,17666828.0,174.0,61.71428571428572,7,432,17668307.5,174.0,61.71428571428572
27049921.0,17,5,1710,5,1710,6762480.25,342.0,342.0,0,0,0.0,0.0,0.0
9090.0,17,4,823,2,163,0.0,89.0,81.5,2,660,0.0,443.0,330.0
395161.0,6,3,204,2,136,0.0,70.0,68.0,1,68,0.0,68.0,68.0
192866.0,17,2,180,1,90,0.0,90.0,90.0,1,90,0.0,90.0,90.0
330693.0,6,6,412,4,272,110231.0,74.0,68.0,2,140,0.0,74.0,70.0
232915.0,6,3,337,2,214,0.0,160.0,107.0,1,123,0.0,123.0,123.0
90290140.0,6,19,1436,10,745,10026751.555555556,95.0,74.5,9,691,11285098.625,95.0,76.77777777777777
109280999.0,17,14,864,7,432,18166822.5,174.0,61.71428571428572,7,432,18168093.166666668,174.0,61.71428571428572
100436.0,17,2,762,2,762,0.0,381.0,381.0,0,0,0.0,0.0,0.0
119281369.0,6,453,56186,227,40974,527793.6681415929,300.0,180.5022026431718,226,15212,527079.1066666667,140.0,67.30973451327434
147926.0,17,2,180,1,90,0.0,90.0,90.0,1,90,0.0,90.0,90.0
90539676.0,6,15,2444,8,1016,12934239.42857143,188.0,127.0,7,1428,15063000.5,204.0,204.0
301269.0,6,3,202,2,128,0.0,74.0,64.0,1,74,0.0,74.0,74.0
56540.0,6,14,4740,7,653,8047.166666666667,249.0,93.28571428571428,7,4087,9272.333333333334,1514.0,583.8571428571429
4409.0,17,2,614,1,72,0.0,72.0,72.0,1,542,0.0,542.0,542.0
110066173.0,6,28,1860,14,966,8450908.846153846,123.0,69.0,14,894,8450898.538461538,123.0,63.85714285714285
2055.0,17,4,344,2,150,0.0,75.0,75.0,2,194,0.0,103.0,97.0
24387.0,6,14,4740,7,653,3803.5,249.0,93.28571428571428,7,4087,3925.0,1514.0,583.8571428571429
245842.0,6,3,337,2,214,0.0,160.0,107.0,1,123,0.0,123.0,123.0
196835.0,17,2,180,1,90,0.0,90.0,90.0,1,90,0.0,90.0,90.0
49703.0,6,14,4740,7,653,8178.333333333333,249.0,93.28571428571428,7,4087,5811.5,1514.0,583.8571428571429
171684.0,17,2,180,1,90,0.0,90.0,90.0,1,90,0.0,90.0,90.0
101109111.0,17,14,864,7,432,16834467.0,174.0,61.71428571428572,7,432,16833486.833333332,174.0,61.71428571428572
29305.0,17,2,582,1,83,0.0,83.0,83.0,1,499,0.0,499.0,499.0
108105070.0,17,5,1005,5,1005,27026267.5,201.0,201.0,0,0,0.0,0.0,0.0
205791.0,17,2,180,1,90,0.0,90.0,90.0,1,90,0.0,90.0,90.0
284204.0,17,2,363,1,79,0.0,79.0,79.0,1,284,0.0,284.0,284.0
149495561.0,17,36,17126,36,17126,4271301.742857143,501.0,475.72222222222223,0,0,0.0,0.0,0.0
108706706.0,6,32,2220,16,1149,7232713.466666667,123.0,71.8125,16,1071,7232713.0,123.0,66.9375
329847.0,6,6,412,4,272,109949.0,74.0,68.0,2,140,0.0,74.0,70.0
313030.0,17,4,1400,4,1400,104343.33333333331,350.0,350.0,0,0,0.0,0.0,0.0
1302377.0,6,4,264,2,132,0.0,66.0,66.0,2,132,0.0,66.0,66.0
90055297.0,17,28,13364,28,13364,3335381.3703703703,501.0,477.2857142857143,0,0,0.0,0.0,0.0
276805.0,6,10,1221,6,636,55361.0,298.0,106.0,4,585,86818.0,379.0,146.25
90260370.0,6,14,2240,8,1016,12894338.57142857,188.0,127.0,6,1224,18018788.6,204.0,204.0
315367.0,17,4,1400,4,1400,105122.33333333331,350.0,350.0,0,0,0.0,0.0,0.0
119513222.0,6,216,24312,108,16962,1114923.6822429907,284.0,157.05555555555554,108,7350,1114935.0560747664,140.0,68.05555555555556
209429.0,17,2,180,1,90,0.0,90.0,90.0,1,90,0.0,90.0,90.0
459684.0,6,12,1373,7,714,76614.0,298.0,102.0,5,659,109253.75,379.0,131.8
10034.0,17,2,582,1,83,0.0,83.0,83.0,1,499,0.0,499.0,499.0
90026052.0,17,28,13364,28,13364,3334298.222222222,501.0,477.2857142857143,0,0,0.0,0.0,0.0
155919.0,17,2,180,1,90,0.0,90.0,90.0,1,90,0.0,90.0,90.0
205813.0,17,2,180,1,90,0.0,90.0,90.0,1,90,0.0,90.0,90.0
62008.0,6,10,2032,5,524,15035.5,252.0,104.8,5,1508,15229.5,1236.0,301.6
226152.0,6,3,426,2,280,0.0,214.0,140.0,1,146,0.0,146.0,146.0
90092551.0,6,10,1440,7,828,15015425.166666666,188.0,118.28571428571428,3,612,30028626.0,204.0,204.0
107410.0,17,2,286,2,286,0.0,143.0,143.0,0,0,0.0,0.0,0.0
358.0,17,2,267,1,83,0.0,83.0,83.0,1,184,0.0,184.0,184.0
1177905.0,6,13,3000,8,2372,168272.14285714287,1514.0,296.5,5,628,226298.0,331.0,125.6
37344.0,6,14,4740,7,653,6068.666666666667,249.0,93.28571428571428,7,4087,6056.166666666667,1514.0,583.8571428571429
16922.0,6,10,1810,5,358,3486.0,130.0,71.6,5,1452,3944.5,1224.0,290.4
60723433.0,6,4,1670,2,819,0.0,753.0,409.5,2,851,0.0,785.0,425.5
14802.0,6,10,2032,5,524,3393.0,252.0,104.8,5,1508,3421.5,1236.0,301.6
1289897.0,6,4,492,2,280,0.0,214.0,140.0,2,212,0.0,146.0,106.0
9066801.0,17,4,1812,4,1812,3022267.0,453.0,453.0,0,0,0.0,0.0,0.0
2627975.0,6,25,7573,14,3735,202151.92307692303,1514.0,266.7857142857143,11,3838,236629.2,1514.0,348.90909090909093
58448.0,6,14,4740,7,653,9007.666666666666,249.0,93.28571428571428,7,4087,7731.166666666667,1514.0,583.8571428571429
324.0,17,2,174,1,79,0.0,79.0,79.0,1,95,0.0,95.0,95.0
102980671.0,6,42,2772,21,1386,5135438.45,66.0,66.0,21,1386,5135430.45,66.0,66.0
118654777.0,17,15,1169,8,606,16950682.42857143,174.0,75.75,7,563,18657293.166666668,174.0,80.42857142857143
20422.0,6,14,4740,7,653,3289.0,249.0,93.28571428571428,7,4087,3222.1666666666665,1514.0,583.8571428571429
92057.0,17,2,762,2,762,0.0,381.0,381.0,0,0,0.0,0.0,0.0
99025.0,17,2,762,2,762,0.0,381.0,381.0,0,0,0.0,0.0,0.0
91140597.0,6,24,1829,11,840,9114059.7,95.0,76.36363636363636,13,989,7574393.0,95.0,76.07692307692308
118690497.0,6,48,3168,24,1584,5160456.391304348,66.0,66.0,24,1584,5147192.652173913,66.0,66.0
295.0,17,2,156,1,78,0.0,78.0,78.0,1,78,0.0,78.0,78.0
2357847.0,6,3,1604,1,753,0.0,753.0,753.0,2,851,0.0,785.0,425.5
3119683.0,6,3,1604,2,851,0.0,785.0,425.5,1,753,0.0,753.0,753.0
207582.0,6,3,426,2,280,0.0,214.0,140.0,1,146,0.0,146.0,146.0
108102365.0,17,5,955,5,955,27025591.25,191.0,191.0,0,0,0.0,0.0,0.0
205807.0,6,3,426,2,280,0.0,214.0,140.0,1,146,0.0,146.0,146.0
26868.0,6,14,4740,7,653,3535.1666666666665,249.0,93.28571428571428,7,4087,4342.833333333333,1514.0,583.8571428571429
44439.0,6,14,4740,7,653,6935.666666666667,249.0,93.28571428571428,7,4087,7133.333333333333,1514.0,583.8571428571429
16289.000000000002,6,13,1459,7,862,2714.833333333333,271.0,123.14285714285714,6,597,2192.4,259.0,99.5
2329.0,17,4,344,2,150,0.0,75.0,75.0,2,194,0.0,103.0,97.0
90261015.0,6,12,1832,8,1016,12894430.714285716,188.0,127.0,4,816,30033416.666666668,204.0,204.0
135146577.0,17,6,1206,6,1206,27029315.4,201.0,201.0,0,0,0.0,0.0,0.0
110285508.0,6,214,24138,107,16854,1038398.7452830188,300.0,157.51401869158877,107,7284,1038398.6509433964,140.0,68.07476635514018
316474.0,17,4,1400,4,1400,105491.33333333331,350.0,350.0,0,0,0.0,0.0,0.0
303606.0,6,2,132,1,66,0.0,66.0,66.0,1,66,0.0,66.0,66.0
16867.0,17,2,180,1,90,0.0,90.0,90.0,1,90,0.0,90.0,90.0
56864.0,6,14,4740,7,653,9320.333333333334,249.0,93.28571428571428,7,4087,9160.833333333334,1514.0,583.8571428571429
309754.0,17,4,704,2,148,0.0,74.0,74.0,2,556,0.0,280.0,278.0
3054372.0,6,3,204,2,136,0.0,70.0,68.0,1,68,0.0,68.0,68.0
90530961.0,6,14,2240,8,1016,12932994.42857143,188.0,127.0,6,1224,18072501.2,204.0,204.0
245129.0,6,3,337,2,214,0.0,160.0,107.0,1,123,0.0,123.0,123.0
100425268.0,17,14,1126,7,563,16667368.833333334,174.0,80.42857142857143,7,563,16666709.5,174.0,80.42857142857143
124797740.0,17,14,864,7,432,17666829.166666668,174.0,61.71428571428572,7,432,17501828.0,174.0,61.71428571428572
1035471.0,6,11,1134,6,558,207094.2,220.0,93.0,5,576,256159.5,304.0,115.2
112591102.0,6,30,1974,15,1026,8027616.0,123.0,68.4,15,948,8027595.357142857,123.0,63.2
0.0,17,1,44,1,44,0.0,44.0,44.0,0,0,0.0,0.0,0.0
82457.0,6,14,4740,7,653,13625.333333333334,249.0,93.28571428571428,7,4087,12331.5,1514.0,583.8571428571429
90036158.0,17,27,12943,27,12943,3462929.153846154,501.0,479.3703703703704,0,0,0.0,0.0,0.0
124679126.0,6,34,2334,17,1125,7168288.125,123.0,66.17647058823529,17,1209,7168302.3125,123.0,71.11764705882354
15047475.0,17,6,2718,6,2718,3009495.0,453.0,453.0,0,0,0.0,0.0,0.0
90031030.0,17,28,13364,28,13364,3334482.592592593,501.0,477.2857142857143,0,0,0.0,0.0,0.0
297975.0,6,6,412,4,272,99325.0,74.0,68.0,2,140,0.0,74.0,70.0
90052712.0,17,28,13364,28,13364,3335285.6296296297,501.0,477.2857142857143,0,0,0.0,0.0,0.0
2467043.0,6,3,1777,2,951,0.0,885.0,475.5,1,826,0.0,826.0,826.0
26657030.0,17,5,1718,4,1368,973778.6666666666,342.0,342.0,1,350,0.0,350.0,350.0
97516374.0,6,27,1954,14,1045,7484656.615384615,139.0,74.64285714285714,13,909,8108376.75,123.0,69.92307692307692
209500.0,17,2,180,1,90,0.0,90.0,90.0,1,90,0.0,90.0,90.0
198594.0,17,2,180,1,90,0.0,90.0,90.0,1,90,0.0,90.0,90.0
90348621.0,6,14,2256,7,1428,15057913.666666666,204.0,204.0,7,828,15011617.0,188.0,118.28571428571428
2800032.0,6,2,132,1,66,0.0,66.0,66.0,1,66,0.0,66.0,66.0
303123.0,6,2,132,1,66,0.0,66.0,66.0,1,66,0.0,66.0,66.0
301363.0,6,6,412,4,272,100454.33333333331,74.0,68.0,2,140,0.0,74.0,70.0
320215.0,6,6,412,4,272,106738.33333333331,74.0,68.0,2,140,0.0,74.0,70.0
23815.0,6,14,4740,7,653,3391.1666666666665,249.0,93.28571428571428,7,4087,3616.5,1514.0,583.8571428571429
30654.0,6,10,2032,5,524,7165.5,252.0,104.8,5,1508,7404.25,1236.0,301.6
196841.0,17,2,180,1,90,0.0,90.0,90.0,1,90,0.0,90.0,90.0
50612.0,6,14,4740,7,653,8282.0,249.0,93.28571428571428,7,4087,7036.5,1514.0,583.8571428571429
119959127.0,6,12,1832,4,816,30030494.33333333,204.0,204.0,8,1016,17136857.14285714,188.0,127.0
135091215.0,17,6,1146,6,1146,27018243.0,191.0,191.0,0,0,0.0,0.0,0.0
119852138.0,6,15,2318,6,1224,23969924.0,204.0,204.0,9,1094,14965787.375,188.0,121.55555555555556
228290.0,17,2,180,1,90,0.0,90.0,90.0,1,90,0.0,90.0,90.0
505804.00000000006,6,4,270,2,134,0.0,68.0,67.0,2,136,0.0,70.0,68.0
115146800.0,6,44,3799,19,1716,6397019.222222222,123.0,90.3157894736842,25,2083,4797766.0,139.0,83.32
47608944.0,6,8,1940,3,887,22583605.0,753.0,295.6666666666667,5,1053,11257856.0,785.0,210.6
82.0,17,2,700,2,700,0.0,350.0,350.0,0,0,0.0,0.0,0.0
107832489.0,6,28,1860,14,966,8294806.846153846,123.0,69.0,14,894,8278154.538461538,123.0,63.85714285714285
0.0,17,1,55,1,55,0.0,55.0,55.0,0,0,0.0,0.0,0.0
5628050.0,6,5,336,2,134,0.0,68.0,67.0,3,202,1425250.5,70.0,67.33333333333333
53600.0,6,10,2032,5,524,13029.5,252.0,104.8,5,1508,12297.75,1236.0,301.6
308308.0,6,6,412,4,272,102769.33333333331,74.0,68.0,2,140,0.0,74.0,70.0
90027509.0,17,28,13364,28,13364,3334352.185185185,501.0,477.2857142857143,0,0,0.0,0.0,0.0
81730.0,6,14,4740,7,653,12255.166666666666,249.0,93.28571428571428,7,4087,13360.833333333334,1514.0,583.8571428571429
177348.0,17,2,180,1,90,0.0,90.0,90.0,1,90,0.0,90.0,90.0
101642788.0,17,14,864,7,432,16835155.833333332,174.0,61.71428571428572,7,432,16833502.166666668,174.0,61.71428571428572
25494.0,6,14,4740,7,653,4074.8333333333335,249.0,93.28571428571428,7,4087,4115.333333333333,1514.0,583.8571428571429
311102.0,17,4,622,4,622,103700.66666666669,163.0,155.5,0,0,0.0,0.0,0.0
101292.0,17,2,762,2,762,0.0,381.0,381.0,0,0,0.0,0.0,0.0
285183.0,17,2,180,1,90,0.0,90.0,90.0,1,90,0.0,90.0,90.0
158022.0,6,4,391,2,214,0.0,160.0,107.0,2,177,0.0,123.0,88.5
4302.0,17,2,598,1,72,0.0,72.0,72.0,1,526,0.0,526.0,526.0
90257571.0,6,12,1832,8,1016,12893938.714285716,188.0,127.0,4,816,30031674.0,204.0,204.0
9845.0,17,2,571,1,86,0.0,86.0,86.0,1,485,0.0,485.0,485.0
26384881.0,17,5,1718,4,1368,826639.6666666666,342.0,342.0,1,350,0.0,350.0,350.0
2522.0,17,4,344,2,150,0.0,75.0,75.0,2,194,0.0,103.0,97.0
282333.0,17,2,180,1,90,0.0,90.0,90.0,1,90,0.0,90.0,90.0
59331.0,6,14,4740,7,653,9691.5,249.0,93.28571428571428,7,4087,9710.333333333334,1514.0,583.8571428571429
1314496.0,17,7,490,7,490,219082.66666666663,70.0,70.0,0,0,0.0,0.0,0.0
153420.0,17,2,180,1,90,0.0,90.0,90.0,1,90,0.0,90.0,90.0
20287.0,17,2,582,1,83,0.0,83.0,83.0,1,499,0.0,499.0,499.0
1307017.0,6,4,264,2,132,0.0,66.0,66.0,2,132,0.0,66.0,66.0
1817941.0,6,23,6508,12,1529,165267.36363636365,357.0,127.41666666666669,11,4979,149315.0,1510.0,452.6363636363636
146085.0,6,3,337,2,214,0.0,160.0,107.0,1,123,0.0,123.0,123.0
108109860.0,17,5,955,5,955,27027465.0,191.0,191.0,0,0,0.0,0.0,0.0
135135321.0,17,6,1206,6,1206,27027064.2,201.0,201.0,0,0,0.0,0.0,0.0
206831.0,6,3,426,2,280,0.0,214.0,140.0,1,146,0.0,146.0,146.0
2070.0,17,4,344,2,150,0.0,75.0,75.0,2,194,0.0,103.0,97.0
43137.0,6,14,4740,7,653,7068.833333333333,249.0,93.28571428571428,7,4087,6928.333333333333,1514.0,583.8571428571429
120123738.0,6,14,2240,6,1224,24024747.6,204.0,204.0,8,1016,17137370.285714287,188.0,127.0
92183436.0,6,186,21084,93,14712,999759.1195652174,284.0,158.19354838709677,93,6372,999710.4130434784,140.0,68.51612903225806
137577.0,6,2,132,1,66,0.0,66.0,66.0,1,66,0.0,66.0,66.0
130344.0,6,3,337,2,214,0.0,160.0,107.0,1,123,0.0,123.0,123.0
104296934.0,17,15,5130,15,5130,7449781.0,342.0,342.0,0,0,0.0,0.0,0.0
1055966.0,6,2,132,1,66,0.0,66.0,66.0,1,66,0.0,66.0,66.0
120244867.0,6,21,1585,10,786,13332867.111111112,95.0,78.6,11,799,11998999.1,95.0,72.63636363636364
1304906.0,6,4,264,2,132,0.0,66.0,66.0,2,132,0.0,66.0,66.0
3344.0,17,4,571,2,148,0.0,74.0,74.0,2,423,0.0,280.0,211.5
144004.0,17,2,180,1,90,0.0,90.0,90.0,1,90,0.0,90.0,90.0
109433.0,6,13,1394,7,797,18238.83333333333,253.0,113.85714285714286,6,597,19100.0,259.0,99.5
1187650.0,6,13,3010,8,2382,169664.2857142857,1514.0,297.75,5,628,228104.0,331.0,125.6
56416.0,6,14,4740,7,653,9170.333333333334,249.0,93.28571428571428,7,4087,8797.166666666666,1514.0,583.8571428571429
234196.0,6,3,337,2,214,0.0,160.0,107.0,1,123,0.0,123.0,123.0
1300728.0,6,4,264,2,132,0.0,66.0,66.0,2,132,0.0,66.0,66.0
1157688.0,6,13,3010,8,2382,165384.0,1514.0,297.75,5,628,221112.0,331.0,125.6
2409.0,17,4,344,2,150,0.0,75.0,75.0,2,194,0.0,103.0,97.0
242360.0,6,2,132,1,66,0.0,66.0,66.0,1,66,0.0,66.0,66.0
88621457.0,17,14,4788,14,4788,6817035.153846154,342.0,342.0,0,0,0.0,0.0,0.0
2589821.0,6,2,132,1,66,0.0,66.0,66.0,1,66,0.0,66.0,66.0
129007209.0,17,17,1255,9,649,16125901.125,174.0,72.11111111111111,8,606,15522074.285714284,174.0,75.75
120052737.0,17,28,13364,28,13364,4446397.666666667,501.0,477.2857142857143,0,0,0.0,0.0,0.0
226744.0,6,10,1221,6,636,45348.8,298.0,106.0,4,585,74640.66666666667,379.0,146.25
103538.0,17,2,286,2,286,0.0,143.0,143.0,0,0,0.0,0.0,0.0
28370.0,6,14,4740,7,653,4078.5,249.0,93.28571428571428,7,4087,4556.666666666667,1514.0,583.8571428571429
23801.0,6,14,4740,7,653,3642.6666666666665,249.0,93.28571428571428,7,4087,3370.1666666666665,1514.0,583.8571428571429
222474.0,6,3,426,2,280,0.0,214.0,140.0,1,146,0.0,146.0,146.0
20256.0,17,2,582,1,83,0.0,83.0,83.0,1,499,0.0,499.0,499.0
12201.0,6,11,2098,6,590,2199.8,252.0,98.33333333333331,5,1508,2614.5,1236.0,301.6
287.0,17,2,164,1,82,0.0,82.0,82.0,1,82,0.0,82.0,82.0
125919124.0,6,35,2457,18,1332,7407007.294117647,123.0,74.0,17,1125,7478356.8125,123.0,66.17647058823529
41157.0,6,14,4740,7,653,6318.0,249.0,93.28571428571428,7,4087,6691.833333333333,1514.0,583.8571428571429
308396.0,6,6,412,4,272,102798.66666666669,74.0,68.0,2,140,0.0,74.0,70.0
2663509.0,6,25,7573,14,3735,204885.3076923077,1514.0,266.7857142857143,11,3838,241068.1,1514.0,348.90909090909093
61131921.0,6,6,674,4,428,20377307.0,160.0,107.0,2,246,0.0,123.0,123.0
14638960.0,6,21,1661,10,975,1592974.5555555555,315.0,97.5,11,686,1433654.3,78.0,62.36363636363637
104016174.0,6,44,2904,22,1452,4953151.142857143,66.0,66.0,22,1452,4940027.523809524,66.0,66.0
12271.0,6,10,2032,5,524,2711.25,252.0,104.8,5,1508,2883.5,1236.0,301.6
280559.0,17,2,363,1,79,0.0,79.0,79.0,1,284,0.0,284.0,284.0
46891.0,6,14,4740,7,653,7254.833333333333,249.0,93.28571428571428,7,4087,7128.333333333333,1514.0,583.8571428571429
108108737.0,17,5,955,5,955,27027184.25,191.0,191.0,0,0,0.0,0.0,0.0
90021750.0,17,28,13364,28,13364,3334138.888888889,501.0,477.2857142857143,0,0,0.0,0.0,0.0
120124907.0,6,15,2428,9,1204,15015613.375,188.0,133.77777777777777,6,1224,18018840.6,204.0,204.0
90015322.0,17,28,13364,28,13364,3333900.814814815,501.0,477.2857142857143,0,0,0.0,0.0,0.0
457225.0,6,3,1604,2,851,0.0,785.0,425.5,1,753,0.0,753.0,753.0
314931.0,17,4,1400,4,1400,104977.0,350.0,350.0,0,0,0.0,0.0,0.0
59404.0,6,14,4740,7,653,9419.5,249.0,93.28571428571428,7,4087,7870.166666666667,1514.0,583.8571428571429
23298.0,6,14,4740,7,653,3004.5,249.0,93.28571428571428,7,4087,3662.6666666666665,1514.0,583.8571428571429
197088.0,17,2,180,1,90,0.0,90.0,90.0,1,90,0.0,90.0,90.0
309.0,17,2,164,1,82,0.0,82.0,82.0,1,82,0.0,82.0,82.0
93063758.0,6,182,20628,91,14400,1031770.2777777778,284.0,158.24175824175825,91,6228,1031764.6888888888,140.0,68.43956043956044
217806.0,6,3,426,2,280,0.0,214.0,140.0,1,146,0.0,146.0,146.0
436629.0,6,11,1021,6,444,58511.2,162.0,74.0,5,577,73064.75,349.0,115.4
2864798.0,6,3,1604,2,851,0.0,785.0,425.5,1,753,0.0,753.0,753.0
1484169.0,17,16,1120,16,1120,98944.6,70.0,70.0,0,0,0.0,0.0,0.0
864652.0,6,10,1334,6,797,172930.4,459.0,132.83333333333334,4,537,197372.66666666663,331.0,134.25
153559.0,17,2,180,1,90,0.0,90.0,90.0,1,90,0.0,90.0,90.0
5621360.0,6,109,105428,34,2409,170344.24242424243,211.0,70.8529411764706,75,103019,75796.12162162163,1514.0,1373.5866666666666
220493.0,6,3,426,2,280,0.0,214.0,140.0,1,146,0.0,146.0,146.0
120224746.0,6,234,26454,117,7944,1029287.3534482758,140.0,67.8974358974359,117,18510,1030475.9568965518,284.0,158.2051282051282
0.0,17,1,55,1,55,0.0,55.0,55.0,0,0,0.0,0.0,0.0
217997.0,6,3,426,2,280,0.0,214.0,140.0,1,146,0.0,146.0,146.0
49850.0,6,14,4740,7,653,8054.0,249.0,93.28571428571428,7,4087,6789.0,1514.0,583.8571428571429
357.0,17,2,166,1,75,0.0,75.0,75.0,1,91,0.0,91.0,91.0
309050.0,6,6,412,4,272,103016.66666666669,74.0,68.0,2,140,0.0,74.0,70.0
52861.0,6,14,4740,7,653,7767.166666666667,249.0,93.28571428571428,7,4087,7811.166666666667,1514.0,583.8571428571429
301661.0,6,6,412,4,272,100553.66666666669,74.0,68.0,2,140,0.0,74.0,70.0
10553173.0,6,5,1736,2,819,0.0,753.0,409.5,3,917,5209357.0,785.0,305.6666666666667
467.0,17,2,762,2,762,0.0,381.0,381.0,0,0,0.0,0.0,0.0
45261.0,6,14,4740,7,653,7377.666666666667,249.0,93.28571428571428,7,4087,5803.666666666667,1514.0,583.8571428571429
47295.0,6,10,2032,5,524,10281.75,252.0,104.8,5,1508,11152.25,1236.0,301.6
207221.0,6,3,426,2,280,0.0,214.0,140.0,1,146,0.0,146.0,146.0
106203.0,17,2,286,2,286,0.0,143.0,143.0,0,0,0.0,0.0,0.0
302.0,17,2,174,1,79,0.0,79.0,79.0,1,95,0.0,95.0,95.0
216557.0,17,2,180,1,90,0.0,90.0,90.0,1,90,0.0,90.0,90.0
113168369.0,6,46,3036,23,1518,5144005.318181818,66.0,66.0,23,1518,5144006.0,66.0,66.0
433.0,17,2,166,1,75,0.0,75.0,75.0,1,91,0.0,91.0,91.0
0.0,17,1,136,1,136,0.0,136.0,136.0,0,0,0.0,0.0,0.0
313785.0,17,4,1400,4,1400,104595.0,350.0,350.0,0,0,0.0,0.0,0.0
2596529.0,6,2,132,1,66,0.0,66.0,66.0,1,66,0.0,66.0,66.0
197076.0,17,2,180,1,90,0.0,90.0,90.0,1,90,0.0,90.0,90.0
313768.0,17,4,1400,4,1400,104589.33333333331,350.0,350.0,0,0,0.0,0.0,0.0
234252.0,6,3,426,2,280,0.0,214.0,140.0,1,146,0.0,146.0,146.0
2780007.0,6,2,132,1,66,0.0,66.0,66.0,1,66,0.0,66.0,66.0
90743560.0,6,17,1287,9,691,11336144.25,95.0,76.77777777777777,8,596,12960905.0,95.0,74.5
2346.0,17,4,344,2,150,0.0,75.0,75.0,2,194,0.0,103.0,97.0
90098949.0,6,11,1644,4,816,30032198.666666668,204.0,204.0,7,828,15016072.666666666,188.0,118.28571428571428
196851.0,17,2,180,1,90,0.0,90.0,90.0,1,90,0.0,90.0,90.0
41960.0,6,10,2032,5,524,9665.75,252.0,104.8,5,1508,10132.5,1236.0,301.6
90033187.0,17,28,13364,28,13364,3334562.4814814813,501.0,477.2857142857143,0,0,0.0,0.0,0.0
1467964.0,17,16,1120,16,1120,97864.26666666666,70.0,70.0,0,0,0.0,0.0,0.0
108349812.0,17,14,864,7,432,18000774.833333332,174.0,61.71428571428572,7,432,18000157.666666668,174.0,61.71428571428572
79711.0,6,10,2032,5,524,15554.75,252.0,104.8,5,1508,19061.5,1236.0,301.6
822.0,17,4,438,2,148,0.0,74.0,74.0,2,290,0.0,147.0,145.0
35634.0,6,10,2032,5,524,8581.25,252.0,104.8,5,1508,8498.25,1236.0,301.6
15799.0,6,11,1132,6,556,2571.8,218.0,92.66666666666669,5,576,3141.75,304.0,115.2
298951.0,6,6,412,4,272,99650.33333333331,74.0,68.0,2,140,0.0,74.0,70.0
112464335.0,6,46,3036,23,1518,5112001.0,66.0,66.0,23,1518,5112003.545454546,66.0,66.0
120127323.0,6,15,2444,7,1428,20021220.5,204.0,204.0,8,1016,17137502.0,188.0,127.0
50530.0,6,14,4740,7,653,8302.666666666666,249.0,93.28571428571428,7,4087,7778.166666666667,1514.0,583.8571428571429
0.0,17,1,381,1,381,0.0,381.0,381.0,0,0,0.0,0.0,0.0
20884.0,6,10,2032,5,524,4523.75,252.0,104.8,5,1508,4791.75,1236.0,301.6
308567.0,6,6,412,4,272,102855.66666666669,74.0,68.0,2,140,0.0,74.0,70.0
116906763.0,6,48,3168,24,1584,5082902.739130435,66.0,66.0,24,1584,5069224.347826087,66.0,66.0
13390.0,6,11,2098,6,590,1891.0,252.0,98.33333333333331,5,1508,2962.25,1236.0,301.6
118525800.0,6,215,24296,108,7436,1107717.7570093458,140.0,68.85185185185185,107,16860,1108502.2358490566,284.0,157.57009345794393
297749.0,6,6,412,4,272,99249.66666666669,74.0,68.0,2,140,0.0,74.0,70.0
10856849.0,6,8,544,4,272,3573277.333333333,74.0,68.0,4,272,3573217.0,74.0,68.0
326.0,17,2,174,1,79,0.0,79.0,79.0,1,95,0.0,95.0,95.0
205995.0,6,3,426,2,280,0.0,214.0,140.0,1,146,0.0,146.0,146.0
6097642.0,17,6,2100,6,2100,1219528.4,350.0,350.0,0,0,0.0,0.0,0.0
319130.0,6,6,412,4,272,106376.66666666669,74.0,68.0,2,140,0.0,74.0,70.0
9630.0,17,2,582,1,83,0.0,83.0,83.0,1,499,0.0,499.0,499.0
106056317.0,6,28,1876,14,982,8141563.076923077,139.0,70.14285714285714,14,894,8141561.692307692,123.0,63.85714285714285
53811.0,6,14,4740,7,653,8841.166666666666,249.0,93.28571428571428,7,4087,8146.833333333333,1514.0,583.8571428571429
52085.0,6,10,2032,5,524,12482.75,252.0,104.8,5,1508,10275.5,1236.0,301.6
249474.0,6,3,337,2,214,0.0,160.0,107.0,1,123,0.0,123.0,123.0
3397720.0,6,172,141213,98,132028,35028.0412371134,1510.0,1347.2244897959183,74,9185,42305.09589041096,1510.0,124.12162162162164
105427642.0,6,44,2904,22,1452,5020363.904761905,66.0,66.0,22,1452,5007358.714285715,66.0,66.0
29295.0,6,10,2032,5,524,6625.0,252.0,104.8,5,1508,6716.0,1236.0,301.6
1023874.0,6,11,1134,6,558,204774.8,220.0,93.0,5,576,255216.0,304.0,115.2
83727202.0,17,14,4796,13,4446,6229367.833333333,342.0,342.0,1,350,0.0,350.0,350.0
109230293.0,6,231,26202,116,7878,949828.6347826088,140.0,67.91379310344827,115,18324,948979.3684210526,284.0,159.33913043478262
2849505.0,6,5,336,3,202,1424752.5,70.0,67.33333333333333,2,134,0.0,68.0,67.0
26287.0,6,14,4740,7,653,4221.0,249.0,93.28571428571428,7,4087,4008.1666666666665,1514.0,583.8571428571429
90060422.0,17,28,13364,28,13364,3335571.185185185,501.0,477.2857142857143,0,0,0.0,0.0,0.0
93226.0,6,14,4740,7,653,14604.0,249.0,93.28571428571428,7,4087,15288.333333333334,1514.0,583.8571428571429
108107082.0,17,5,955,5,955,27026770.5,191.0,191.0,0,0,0.0,0.0,0.0
122975590.0,6,48,3168,24,1584,5032124.217391305,66.0,66.0,24,1584,5234954.130434782,66.0,66.0
27702370.0,17,5,1710,5,1710,6925592.5,342.0,342.0,0,0,0.0,0.0,0.0
21509.0,6,14,4740,7,653,3366.5,249.0,93.28571428571428,7,4087,3422.1666666666665,1514.0,583.8571428571429
90256994.0,6,14,2102,8,1016,12893856.285714284,188.0,127.0,6,1086,18019151.0,204.0,181.0
80745.0,6,15,4806,8,719,11438.285714285714,249.0,89.875,7,4087,13143.5,1514.0,583.8571428571429
539732.0,17,6,2100,6,2100,107946.4,350.0,350.0,0,0,0.0,0.0,0.0
135133202.0,17,6,1206,6,1206,27026640.4,201.0,201.0,0,0,0.0,0.0,0.0
110102.0,17,2,286,2,286,0.0,143.0,143.0,0,0,0.0,0.0,0.0
254604.0,6,3,337,2,214,0.0,160.0,107.0,1,123,0.0,123.0,123.0
298951.0,6,6,412,4,272,99650.33333333331,74.0,68.0,2,140,0.0,74.0,70.0
232128.0,17,2,180,1,90,0.0,90.0,90.0,1,90,0.0,90.0,90.0
80.0,17,2,762,2,762,0.0,381.0,381.0,0,0,0.0,0.0,0.0
108097619.0,17,5,1005,5,1005,27024404.75,201.0,201.0,0,0,0.0,0.0,0.0
29685.0,6,14,4740,7,653,4401.333333333333,249.0,93.28571428571428,7,4087,4741.833333333333,1514.0,583.8571428571429
135131120.0,17,6,1206,6,1206,27026224.0,201.0,201.0,0,0,0.0,0.0,0.0
209909.0,17,2,180,1,90,0.0,90.0,90.0,1,90,0.0,90.0,90.0
2158.0,17,2,664,1,322,0.0,322.0,322.0,1,342,0.0,342.0,342.0
308163.0,6,6,412,4,272,102721.0,74.0,68.0,2,140,0.0,74.0,70.0
37369.0,6,14,4740,7,653,6065.0,249.0,93.28571428571428,7,4087,6037.833333333333,1514.0,583.8571428571429
153499.0,17,2,180,1,90,0.0,90.0,90.0,1,90,0.0,90.0,90.0
11486.0,17,2,507,1,86,0.0,86.0,86.0,1,421,0.0,421.0,421.0
5622967.0,6,5,336,2,134,0.0,68.0,67.0,3,202,1524727.0,70.0,67.33333333333333
1093953.0,6,13,1386,7,789,182325.5,253.0,112.71428571428572,6,597,217715.6,259.0,99.5
147871.0,17,2,180,1,90,0.0,90.0,90.0,1,90,0.0,90.0,90.0
4297.0,17,2,614,1,72,0.0,72.0,72.0,1,542,0.0,542.0,542.0
117123.0,6,15,4806,8,719,16629.571428571428,249.0,89.875,7,4087,19071.5,1514.0,583.8571428571429
362978.0,6,11,1021,6,444,48779.6,162.0,74.0,5,577,60852.0,349.0,115.4
135117708.0,17,6,1146,6,1146,27023541.6,191.0,191.0,0,0,0.0,0.0,0.0
308070.0,6,6,412,4,272,102690.0,74.0,68.0,2,140,0.0,74.0,70.0
44236.0,6,14,4740,7,653,7193.166666666667,249.0,93.28571428571428,7,4087,6042.166666666667,1514.0,583.8571428571429
408.0,17,2,410,1,78,0.0,78.0,78.0,1,332,0.0,332.0,332.0
262326.0,6,12,1373,7,714,43721.0,298.0,102.0,5,659,61435.5,379.0,131.8
24134.0,6,14,4740,7,653,3889.3333333333335,249.0,93.28571428571428,7,4087,3878.6666666666665,1514.0,583.8571428571429
233423.0,6,3,337,2,214,0.0,160.0,107.0,1,123,0.0,123.0,123.0
90054025.0,17,28,13364,28,13364,3335334.25925926,501.0,477.2857142857143,0,0,0.0,0.0,0.0
108107026.0,17,5,955,5,955,27026756.5,191.0,191.0,0,0,0.0,0.0,0.0
120247247.0,6,224,25312,112,7688,1066311.9279279278,140.0,68.64285714285714,112,17624,1076029.2432432433,284.0,157.35714285714286
120177028.0,6,218,24662,109,7416,1105271.8796296297,140.0,68.03669724770643,109,17246,1104694.0925925926,284.0,158.22018348623854
12195.0,6,13,1459,7,862,1751.5,271.0,123.14285714285714,6,597,2234.8,259.0,99.5
65922.0,6,14,4740,7,653,10814.333333333334,249.0,93.28571428571428,7,4087,9905.666666666666,1514.0,583.8571428571429
80.0,17,2,762,2,762,0.0,381.0,381.0,0,0,0.0,0.0,0.0
44931.0,6,10,2032,5,524,10565.0,252.0,104.8,5,1508,7419.5,1236.0,301.6
229824.0,6,10,1221,6,636,45964.8,298.0,106.0,4,585,75326.33333333333,379.0,146.25
297.0,17,2,164,1,82,0.0,82.0,82.0,1,82,0.0,82.0,82.0
2274863.0,6,25,7611,13,2516,189571.91666666663,1034.0,193.53846153846155,12,5095,178914.63636363635,1510.0,424.5833333333333
25157872.0,17,3,1034,2,684,0.0,342.0,342.0,1,350,0.0,350.0,350.0
3000017.0,6,171,127190,90,117542,33564.3595505618,1510.0,1306.022222222222,81,9648,33691.0625,1510.0,119.11111111111111
10523411.0,6,7,478,4,272,3462007.6666666665,74.0,68.0,3,206,5192918.5,74.0,68.66666666666667
90287535.0,6,21,1585,11,840,9023976.2,95.0,76.36363636363636,10,745,10000632.666666666,95.0,74.5
135136841.0,17,6,1146,6,1146,27027368.2,191.0,191.0,0,0,0.0,0.0,0.0
30632.0,6,10,2032,5,524,5677.0,252.0,104.8,5,1508,7409.25,1236.0,301.6
242370.0,6,3,337,2,214,0.0,160.0,107.0,1,123,0.0,123.0,123.0
1834.0,17,2,176,1,80,0.0,80.0,80.0,1,96,0.0,96.0,96.0
108107260.0,17,5,1005,5,1005,27026815.0,201.0,201.0,0,0,0.0,0.0,0.0
18054.0,6,14,4740,7,653,2736.0,249.0,93.28571428571428,7,4087,2869.333333333333,1514.0,583.8571428571429
120593730.0,6,215,24386,108,17016,1127044.2056074766,284.0,157.55555555555554,107,7370,1127576.2452830188,140.0,68.8785046728972
362.0,17,2,174,1,79,0.0,79.0,79.0,1,95,0.0,95.0,95.0
1530304.0,6,19,7533,10,1403,170033.77777777778,583.0,140.3,9,6130,158347.0,1484.0,681.1111111111111
120135472.0,6,13,2020,9,1204,15016934.0,188.0,133.77777777777777,4,816,30029316.33333333,204.0,204.0
4599.0,17,4,344,2,150,0.0,75.0,75.0,2,194,0.0,103.0,97.0
605406.0,6,4,508,2,238,0.0,172.0,119.0,2,270,0.0,135.0,135.0
107612.0,17,2,286,2,286,0.0,143.0,143.0,0,0,0.0,0.0,0.0
36348.0,6,14,4740,7,653,5824.5,249.0,93.28571428571428,7,4087,5666.666666666667,1514.0,583.8571428571429
90260422.0,6,14,2240,8,1016,12894346.0,188.0,127.0,6,1224,18017742.2,204.0,204.0
319459.0,17,4,1400,4,1400,106486.33333333331,350.0,350.0,0,0,0.0,0.0,0.0
90954770.0,6,21,1585,11,840,9093979.9,95.0,76.36363636363636,10,745,10105328.444444444,95.0,74.5
45377.0,6,10,2032,5,524,11121.5,252.0,104.8,5,1508,10711.75,1236.0,301.6
90051007.0,17,27,12943,27,12943,3463500.269230769,501.0,479.3703703703704,0,0,0.0,0.0,0.0
92400256.0,17,16,5472,16,5472,6160017.066666666,342.0,342.0,0,0,0.0,0.0,0.0
136611.0,6,2,132,1,66,0.0,66.0,66.0,1,66,0.0,66.0,66.0
30374.0,6,14,4740,7,653,4806.5,249.0,93.28571428571428,7,4087,4898.166666666667,1514.0,583.8571428571429
108104358.0,17,5,955,5,955,27026089.5,191.0,191.0,0,0,0.0,0.0,0.0
2478.0,17,4,344,2,150,0.0,75.0,75.0,2,194,0.0,103.0,97.0
120038064.0,17,28,13364,28,13364,4445854.222222222,501.0,477.2857142857143,0,0,0.0,0.0,0.0
212721.0,6,10,1221,6,636,42544.2,298.0,106.0,4,585,70029.66666666667,379.0,146.25
144588.0,6,2,132,1,66,0.0,66.0,66.0,1,66,0.0,66.0,66.0
18051.0,6,10,2032,5,524,4236.25,252.0,104.8,5,1508,4257.25,1236.0,301.6
90773780.0,6,19,1436,10,745,10080265.666666666,95.0,74.5,9,691,11346071.375,95.0,76.77777777777777
53884.0,6,14,4740,7,653,8866.166666666666,249.0,93.28571428571428,7,4087,6818.166666666667,1514.0,583.8571428571429
252687.0,6,3,337,2,214,0.0,160.0,107.0,1,123,0.0,123.0,123.0
100855817.0,6,28,1860,14,966,7741495.461538462,123.0,69.0,14,894,7741496.692307692,123.0,63.85714285714285
119500033.0,6,221,24806,111,7622,1086363.9363636365,140.0,68.66666666666667,110,17184,1086207.6605504588,284.0,156.21818181818182
213639.0,17,2,180,1,90,0.0,90.0,90.0,1,90,0.0,90.0,90.0
282425.0,6,10,1221,6,636,56485.0,298.0,106.0,4,585,87895.0,379.0,146.25
177941.0,6,10,1066,5,490,40524.5,218.0,98.0,5,576,44286.75,304.0,115.2
28106.0,6,14,4740,7,653,4551.0,249.0,93.28571428571428,7,4087,4543.833333333333,1514.0,583.8571428571429
335.0,17,2,166,1,75,0.0,75.0,75.0,1,91,0.0,91.0,91.0
9440.0,17,2,539,1,86,0.0,86.0,86.0,1,453,0.0,453.0,453.0
24762.0,6,10,2032,5,524,5869.25,252.0,104.8,5,1508,5922.75,1236.0,301.6
105504950.0,6,32,2236,16,1165,7018573.866666666,139.0,72.8125,16,1071,7018574.6,123.0,66.9375
20263.0,6,11,1133,6,602,4052.6,264.0,100.33333333333331,5,531,2754.25,259.0,106.2
13883.0,6,10,1065,5,534,3001.75,262.0,106.8,5,531,3255.0,259.0,106.2
5623173.0,6,5,336,2,134,0.0,68.0,67.0,3,202,1425288.0,70.0,67.33333333333333
49120.0,6,14,4740,7,653,7376.0,249.0,93.28571428571428,7,4087,8033.166666666667,1514.0,583.8571428571429
204551.0,17,2,762,2,762,0.0,381.0,381.0,0,0,0.0,0.0,0.0
107551.0,17,2,286,2,286,0.0,143.0,143.0,0,0,0.0,0.0,0.0
94991.0,6,10,2032,5,524,23479.25,252.0,104.8,5,1508,22103.25,1236.0,301.6
2796633.0,6,2,132,1,66,0.0,66.0,66.0,1,66,0.0,66.0,66.0
114688612.0,6,48,3168,24,1584,4986461.391304348,66.0,66.0,24,1584,4977066.0,66.0,66.0
3436078.0,6,7,923,4,753,1076528.6666666667,571.0,188.25,3,170,1615378.5,62.0,56.66666666666666
120003681.0,6,16,1192,8,596,17143383.0,95.0,74.5,8,596,17107490.85714286,95.0,74.5
90060626.0,17,28,13364,28,13364,3335578.7407407407,501.0,477.2857142857143,0,0,0.0,0.0,0.0
2130421.0,6,2,132,1,66,0.0,66.0,66.0,1,66,0.0,66.0,66.0
404744.0,6,4,508,2,238,0.0,172.0,119.0,2,270,0.0,135.0,135.0
310605.0,6,6,412,4,272,103535.0,74.0,68.0,2,140,0.0,74.0,70.0
39006.0,6,14,4740,7,653,5380.333333333333,249.0,93.28571428571428,7,4087,6174.666666666667,1514.0,583.8571428571429
39035.0,6,14,4740,7,653,4562.666666666667,249.0,93.28571428571428,7,4087,6288.333333333333,1514.0,583.8571428571429
107461.0,17,2,286,2,286,0.0,143.0,143.0,0,0,0.0,0.0,0.0
58905710.0,17,9,3086,8,2736,5109053.0,342.0,342.0,1,350,0.0,350.0,350.0
774.0,17,4,438,2,148,0.0,74.0,74.0,2,290,0.0,147.0,145.0
12816.0,6,10,2032,5,524,2066.0,252.0,104.8,5,1508,2601.25,1236.0,301.6
5619955.0,6,5,336,2,134,0.0,68.0,67.0,3,202,1523760.0,70.0,67.33333333333333
258857.0,6,3,337,2,214,0.0,160.0,107.0,1,123,0.0,123.0,123.0
209622.0,17,2,180,1,90,0.0,90.0,90.0,1,90,0.0,90.0,90.0
206972.0,6,3,426,2,280,0.0,214.0,140.0,1,146,0.0,146.0,146.0
124001137.0,17,15,907,8,475,17714448.14285714,174.0,59.375,7,432,17334790.0,174.0,61.71428571428572
18208.0,6,10,2032,5,524,4299.5,252.0,104.8,5,1508,3967.0,1236.0,301.6
32302697.000000004,6,7,1874,3,887,16081312.5,753.0,295.6666666666667,4,987,10723840.0,785.0,246.75
228267.0,17,2,180,1,90,0.0,90.0,90.0,1,90,0.0,90.0,90.0
34905.0,6,14,4740,7,653,4871.166666666667,249.0,93.28571428571428,7,4087,5248.0,1514.0,583.8571428571429
206280.0,6,3,426,2,280,0.0,214.0,140.0,1,146,0.0,146.0,146.0
121435.0,6,3,337,2,214,0.0,160.0,107.0,1,123,0.0,123.0,123.0
5628488.0,6,5,336,2,134,0.0,68.0,67.0,3,202,1524865.0,70.0,67.33333333333333
216455.0,17,2,180,1,90,0.0,90.0,90.0,1,90,0.0,90.0,90.0
141.0,17,3,1050,3,1050,70.5,350.0,350.0,0,0,0.0,0.0,0.0
10486820.0,6,6,412,3,206,5172840.5,74.0,68.66666666666667,3,206,5172720.0,74.0,68.66666666666667
216507.0,17,2,180,1,90,0.0,90.0,90.0,1,90,0.0,90.0,90.0
297401.0,6,6,412,4,272,99133.66666666669,74.0,68.0,2,140,0.0,74.0,70.0
38424.0,6,10,2032,5,524,9250.5,252.0,104.8,5,1508,5394.5,1236.0,301.6
27975.0,6,14,4740,7,653,4199.333333333333,249.0,93.28571428571428,7,4087,4483.333333333333,1514.0,583.8571428571429
228192.0,17,2,180,1,90,0.0,90.0,90.0,1,90,0.0,90.0,90.0
90028732.0,17,28,13364,28,13364,3334397.4814814813,501.0,477.2857142857143,0,0,0.0,0.0,0.0
7069.0,17,2,566,1,83,0.0,83.0,83.0,1,483,0.0,483.0,483.0
19510.0,6,11,2098,6,590,3484.8,252.0,98.33333333333331,5,1508,4581.25,1236.0,301.6
209577.0,17,2,180,1,90,0.0,90.0,90.0,1,90,0.0,90.0,90.0
90043897.0,17,28,13364,28,13364,3334959.1481481483,501.0,477.2857142857143,0,0,0.0,0.0,0.0
301955.0,6,6,412,4,272,100651.66666666669,74.0,68.0,2,140,0.0,74.0,70.0
28528.0,6,14,4740,7,653,3901.6666666666665,249.0,93.28571428571428,7,4087,4491.5,1514.0,583.8571428571429
40284.0,6,14,4740,7,653,6533.833333333333,249.0,93.28571428571428,7,4087,6312.0,1514.0,583.8571428571429
12033259.0,17,5,2265,5,2265,3008314.75,453.0,453.0,0,0,0.0,0.0,0.0
251473.0,6,10,1221,6,636,50294.6,298.0,106.0,4,585,78058.0,379.0,146.25
196909.0,17,2,180,1,90,0.0,90.0,90.0,1,90,0.0,90.0,90.0
359.0,17,2,267,1,83,0.0,83.0,83.0,1,184,0.0,184.0,184.0
120019225.0,17,28,13364,28,13364,4445156.481481481,501.0,477.2857142857143,0,0,0.0,0.0,0.0
90255608.0,6,14,2240,8,1016,12893658.285714284,188.0,127.0,6,1224,18018069.2,204.0,204.0
38097.0,6,14,4740,7,653,5432.0,249.0,93.28571428571428,7,4087,5990.333333333333,1514.0,583.8571428571429
2396.0,17,4,344,2,150,0.0,75.0,75.0,2,194,0.0,103.0,97.0
99090.0,17,2,762,2,762,0.0,381.0,381.0,0,0,0.0,0.0,0.0
10931663.0,6,8,544,4,272,3598546.333333333,74.0,68.0,4,272,3598481.0,74.0,68.0
250500.0,17,4,6056,4,6056,83500.0,1514.0,1514.0,0,0,0.0,0.0,0.0
90214853.0,6,21,1585,10,745,9997481.333333334,95.0,74.5,11,840,9000944.9,95.0,76.36363636363636
135674.0,6,2,132,1,66,0.0,66.0,66.0,1,66,0.0,66.0,66.0
333.0,17,2,166,1,75,0.0,75.0,75.0,1,91,0.0,91.0,91.0
321410.0,17,4,1400,4,1400,107136.66666666669,350.0,350.0,0,0,0.0,0.0,0.0
438514.0,6,11,1021,6,444,58912.0,162.0,74.0,5,577,73450.75,349.0,115.4
297596.0,6,6,412,4,272,99198.66666666669,74.0,68.0,2,140,0.0,74.0,70.0
97885998.0,6,65,12881,32,6749,3157612.8387096776,1514.0,210.90625,33,6132,3050446.71875,1514.0,185.8181818181818
2374.0,17,4,344,2,150,0.0,75.0,75.0,2,194,0.0,103.0,97.0
242702.0,6,3,337,2,214,0.0,160.0,107.0,1,123,0.0,123.0,123.0
320403.0,17,4,571,2,148,0.0,74.0,74.0,2,423,0.0,280.0,211.5
110459.0,17,2,286,2,286,0.0,143.0,143.0,0,0,0.0,0.0,0.0
90362020.0,6,13,2052,6,1224,18072168.8,204.0,204.0,7,828,15014637.833333334,188.0,118.28571428571428
135137807.0,17,6,1146,6,1146,27027561.4,191.0,191.0,0,0,0.0,0.0,0.0
1516.0,17,5,550,5,550,379.0,110.0,110.0,0,0,0.0,0.0,0.0
233967.0,6,3,337,2,214,0.0,160.0,107.0,1,123,0.0,123.0,123.0
129809.0,6,14,4740,7,653,18795.166666666668,249.0,93.28571428571428,7,4087,21113.33333333333,1514.0,583.8571428571429
144033.0,17,2,180,1,90,0.0,90.0,90.0,1,90,0.0,90.0,90.0
2133.0,17,4,344,2,150,0.0,75.0,75.0,2,194,0.0,103.0,97.0
119005903.0,6,35,2542,18,1348,7000347.235294118,139.0,74.88888888888889,17,1194,7424352.0,123.0,70.23529411764706
26192.0,6,11,1133,6,602,5238.4,264.0,100.33333333333331,5,531,5348.25,259.0,106.2
123456287.0,6,49,3234,25,1650,5144011.958333333,66.0,66.0,24,1584,5004360.608695652,66.0,66.0
46184.0,6,14,4740,7,653,6867.666666666667,249.0,93.28571428571428,7,4087,7559.833333333333,1514.0,583.8571428571429
228208.0,17,2,180,1,90,0.0,90.0,90.0,1,90,0.0,90.0,90.0
146061.0,6,3,337,2,214,0.0,160.0,107.0,1,123,0.0,123.0,123.0
90305711.0,6,16,1192,8,596,12893589.857142856,95.0,74.5,8,596,12899848.0,95.0,74.5
3330.0,17,4,344,2,150,0.0,75.0,75.0,2,194,0.0,103.0,97.0
105949.0,17,2,700,2,700,0.0,350.0,350.0,0,0,0.0,0.0,0.0
316618.0,17,4,1400,4,1400,105539.33333333331,350.0,350.0,0,0,0.0,0.0,0.0
2800115.0,6,2,132,1,66,0.0,66.0,66.0,1,66,0.0,66.0,66.0
4383.0,17,4,344,2,150,0.0,75.0,75.0,2,194,0.0,103.0,97.0
35726.0,6,10,2032,5,524,8679.25,252.0,104.8,5,1508,8406.5,1236.0,301.6
125534037.0,17,14,864,7,432,17666834.666666668,174.0,61.71428571428572,7,432,17668175.833333332,174.0,61.71428571428572
120163432.0,6,220,24884,110,7556,1094968.5504587155,140.0,68.69090909090909,110,17328,1095264.724770642,284.0,157.52727272727273
0.0,17,1,90,1,90,0.0,90.0,90.0,0,0,0.0,0.0,0.0
39028.0,6,10,2032,5,524,9252.5,252.0,104.8,5,1508,9342.75,1236.0,301.6
16731.0,6,14,4740,7,653,2502.333333333333,249.0,93.28571428571428,7,4087,2652.6666666666665,1514.0,583.8571428571429
18923.0,6,20,7606,11,978,1892.3,310.0,88.9090909090909,9,6628,1785.5,1514.0,736.4444444444445
2110.0,17,2,932,1,590,0.0,590.0,590.0,1,342,0.0,342.0,342.0
204461.0,17,2,762,2,762,0.0,381.0,381.0,0,0,0.0,0.0,0.0
196939.0,17,2,180,1,90,0.0,90.0,90.0,1,90,0.0,90.0,90.0
42576.0,6,14,4740,7,653,6972.0,249.0,93.28571428571428,7,4087,6559.5,1514.0,583.8571428571429
4368.0,17,2,618,1,72,0.0,72.0,72.0,1,546,0.0,546.0,546.0
927910.0,6,13,1420,7,789,153636.16666666666,253.0,112.71428571428572,6,631,185176.8,293.0,105.16666666666669
108108462.0,17,5,1005,5,1005,27027115.5,201.0,201.0,0,0,0.0,0.0,0.0
38189.0,6,10,2032,5,524,8715.5,252.0,104.8,5,1508,8967.25,1236.0,301.6
1190851.0,17,6,1230,3,234,595195.0,78.0,78.0,3,996,595222.0,332.0,332.0
307579.0,6,6,412,4,272,102526.33333333331,74.0,68.0,2,140,0.0,74.0,70.0
108105215.0,17,5,955,5,955,27026303.75,191.0,191.0,0,0,0.0,0.0,0.0
34522.0,6,10,1065,5,534,8377.75,262.0,106.8,5,531,8082.0,259.0,106.2
135142426.0,17,6,1206,6,1206,27028485.2,201.0,201.0,0,0,0.0,0.0,0.0
1297433.0,6,4,264,2,132,0.0,66.0,66.0,2,132,0.0,66.0,66.0
103396.0,17,2,286,2,286,0.0,143.0,143.0,0,0,0.0,0.0,0.0
232965.0,6,3,337,2,214,0.0,160.0,107.0,1,123,0.0,123.0,123.0
720621.0,6,10,1065,5,534,179731.75,262.0,106.8,5,531,179780.5,259.0,106.2
2899991.0,6,2,132,1,66,0.0,66.0,66.0,1,66,0.0,66.0,66.0
302462.0,6,2,132,1,66,0.0,66.0,66.0,1,66,0.0,66.0,66.0
319.0,17,2,174,1,79,0.0,79.0,79.0,1,95,0.0,95.0,95.0
90257131.0,6,12,1832,8,1016,12893875.857142856,188.0,127.0,4,816,30031200.0,204.0,204.0
228309.0,17,2,180,1,90,0.0,90.0,90.0,1,90,0.0,90.0,90.0
306766.0,6,6,412,4,272,102255.33333333331,74.0,68.0,2,140,0.0,74.0,70.0
90296805.0,6,16,1192,8,596,12893090.57142857,95.0,74.5,8,596,12898066.857142856,95.0,74.5
90057792.0,17,28,13364,28,13364,3335473.777777778,501.0,477.2857142857143,0,0,0.0,0.0,0.0
217901.0,6,3,426,2,280,0.0,214.0,140.0,1,146,0.0,146.0,146.0
331.0,17,2,174,1,79,0.0,79.0,79.0,1,95,0.0,95.0,95.0
108106701.0,17,5,1005,5,1005,27026675.25,201.0,201.0,0,0,0.0,0.0,0.0
109625.0,17,2,762,2,762,0.0,381.0,381.0,0,0,0.0,0.0,0.0
209509.0,17,2,180,1,90,0.0,90.0,90.0,1,90,0.0,90.0,90.0
298928.0,6,6,412,4,272,99642.66666666669,74.0,68.0,2,140,0.0,74.0,70.0
9585.0,6,11,2098,6,590,1676.8,252.0,98.33333333333331,5,1508,2146.5,1236.0,301.6
218902.0,17,2,180,1,90,0.0,90.0,90.0,1,90,0.0,90.0,90.0
311603.0,17,4,1400,4,1400,103867.66666666669,350.0,350.0,0,0,0.0,0.0,0.0
10477072.0,6,7,478,4,272,3446896.6666666665,74.0,68.0,3,206,5170195.0,74.0,68.66666666666667
90020160.0,17,27,12943,27,12943,3462313.846153846,501.0,479.3703703703704,0,0,0.0,0.0,0.0
90256914.0,6,13,1898,8,1016,12893844.857142856,188.0,127.0,5,882,22523971.75,204.0,176.4
153835.0,6,10,1066,5,490,37998.0,218.0,98.0,5,576,38115.5,304.0,115.2
2081.0,17,4,344,2,150,0.0,75.0,75.0,2,194,0.0,103.0,97.0
232789.0,6,3,337,2,214,0.0,160.0,107.0,1,123,0.0,123.0,123.0
204206.0,17,4,6056,4,6056,68068.66666666667,1514.0,1514.0,0,0,0.0,0.0,0.0
2147.0,17,2,176,1,80,0.0,80.0,80.0,1,96,0.0,96.0,96.0
514960.0,6,5,336,2,134,0.0,68.0,67.0,3,202,192349.5,70.0,67.33333333333333
216535.0,17,2,180,1,90,0.0,90.0,90.0,1,90,0.0,90.0,90.0
90098703.0,6,12,1848,5,1020,22524091.5,204.0,204.0,7,828,15015971.5,188.0,118.28571428571428
161090.0,17,2,180,1,90,0.0,90.0,90.0,1,90,0.0,90.0,90.0
311823.0,17,4,1400,4,1400,103941.0,350.0,350.0,0,0,0.0,0.0,0.0
2379.0,17,4,344,2,150,0.0,75.0,75.0,2,194,0.0,103.0,97.0
300045.0,6,6,412,4,272,100015.0,74.0,68.0,2,140,0.0,74.0,70.0
49323.0,6,10,2032,5,524,11316.75,252.0,104.8,5,1508,10362.75,1236.0,301.6
37856.0,6,10,2032,5,524,9226.0,252.0,104.8,5,1508,7655.25,1236.0,301.6
202879.0,17,4,6056,4,6056,67626.33333333333,1514.0,1514.0,0,0,0.0,0.0,0.0
1055163.0,6,4,270,2,134,0.0,68.0,67.0,2,136,0.0,70.0,68.0
1025988.0,6,11,1134,6,558,205197.6,220.0,93.0,5,576,255278.25,304.0,115.2
41307.0,6,14,4740,7,653,6756.5,249.0,93.28571428571428,7,4087,6747.666666666667,1514.0,583.8571428571429
90250720.0,6,13,2036,8,1016,12892960.0,188.0,127.0,5,1020,22522137.0,204.0,204.0
38169.0,6,10,2032,5,524,9223.25,252.0,104.8,5,1508,9001.5,1236.0,301.6
43466.0,6,10,2032,5,524,10417.0,252.0,104.8,5,1508,8874.0,1236.0,301.6
4254.0,17,2,602,1,72,0.0,72.0,72.0,1,530,0.0,530.0,530.0
41576917.0,6,26,7627,14,3735,202146.0769230769,1514.0,266.7857142857143,12,3892,3761081.090909091,1514.0,324.3333333333333
20172.0,6,2,145,2,145,0.0,91.0,72.5,0,0,0.0,0.0,0.0
326.0,17,2,174,1,79,0.0,79.0,79.0,1,95,0.0,95.0,95.0
2458.0,17,4,344,2,150,0.0,75.0,75.0,2,194,0.0,103.0,97.0
2793.0,17,4,344,2,150,0.0,75.0,75.0,2,194,0.0,103.0,97.0
108117115.0,17,5,1005,5,1005,27029278.75,201.0,201.0,0,0,0.0,0.0,0.0
304431.0,6,6,412,4,272,101477.0,74.0,68.0,2,140,0.0,74.0,70.0
90295504.0,6,16,1192,8,596,12893292.285714284,95.0,74.5,8,596,12898959.0,95.0,74.5
120113725.0,6,244,27548,122,8348,985802.3388429752,140.0,68.42622950819673,122,19200,985851.1239669422,284.0,157.37704918032787
2059.0,17,4,344,2,150,0.0,75.0,75.0,2,194,0.0,103.0,97.0
118697784.0,6,34,2488,18,1348,6982222.588235294,139.0,74.88888888888889,16,1140,7233115.6,123.0,71.25
108101200.0,17,5,955,5,955,27025300.0,191.0,191.0,0,0,0.0,0.0,0.0
286991.0,6,4,492,2,280,0.0,214.0,140.0,2,212,0.0,146.0,106.0
121261.0,6,3,337,2,214,0.0,160.0,107.0,1,123,0.0,123.0,123.0
271162.0,6,10,1221,6,636,54232.4,298.0,106.0,4,585,84654.33333333333,379.0,146.25
317963.0,17,4,1400,4,1400,105987.66666666669,350.0,350.0,0,0,0.0,0.0,0.0
52228.0,6,10,2032,5,524,12531.0,252.0,104.8,5,1508,10371.25,1236.0,301.6
119835611.0,17,34,16284,34,16284,3631382.151515152,501.0,478.9411764705882,0,0,0.0,0.0,0.0
42386.0,6,14,4740,7,653,5500.166666666667,249.0,93.28571428571428,7,4087,6927.666666666667,1514.0,583.8571428571429
26263.0,6,12,1320,6,723,4848.4,253.0,120.5,6,597,3630.0,259.0,99.5
2580596.0,6,2,132,1,66,0.0,66.0,66.0,1,66,0.0,66.0,66.0
76418.0,6,13,4515,6,512,14907.0,230.0,85.33333333333333,7,4003,12503.0,1514.0,571.8571428571429
253182.00000000003,6,3,337,2,214,0.0,160.0,107.0,1,123,0.0,123.0,123.0
17191.0,17,2,447,1,84,0.0,84.0,84.0,1,363,0.0,363.0,363.0
147747.0,6,3,337,2,214,0.0,160.0,107.0,1,123,0.0,123.0,123.0
108115774.0,17,5,1005,5,1005,27028943.5,201.0,201.0,0,0,0.0,0.0,0.0
90255459.0,6,16,2368,9,1204,11281932.375,188.0,133.77777777777777,7,1164,15015313.5,204.0,166.28571428571428
2748168.0,17,2,876,2,876,0.0,438.0,438.0,0,0,0.0,0.0,0.0
2430.0,17,4,344,2,150,0.0,75.0,75.0,2,194,0.0,103.0,97.0
169632.0,17,3,1143,3,1143,84816.0,381.0,381.0,0,0,0.0,0.0,0.0
217952.0,6,3,426,2,280,0.0,214.0,140.0,1,146,0.0,146.0,146.0
2585.0,17,2,166,1,75,0.0,75.0,75.0,1,91,0.0,91.0,91.0
201129.0,17,2,180,1,90,0.0,90.0,90.0,1,90,0.0,90.0,90.0
232864.0,6,3,337,2,214,0.0,160.0,107.0,1,123,0.0,123.0,123.0
2794553.0,6,2,132,1,66,0.0,66.0,66.0,1,66,0.0,66.0,66.0
48311.0,6,14,4740,7,653,7934.166666666667,249.0,93.28571428571428,7,4087,7888.5,1514.0,583.8571428571429
301869.0,17,2,180,1,90,0.0,90.0,90.0,1,90,0.0,90.0,90.0
209467.0,17,2,180,1,90,0.0,90.0,90.0,1,90,0.0,90.0,90.0
97940579.0,6,28,1992,14,1029,7518164.769230769,123.0,73.5,14,963,7518156.769230769,123.0,68.78571428571429
38349.0,6,14,4740,7,653,6266.333333333333,249.0,93.28571428571428,7,4087,5643.0,1514.0,583.8571428571429
317301.0,17,4,1400,4,1400,105767.0,350.0,350.0,0,0,0.0,0.0,0.0
230647.0,6,3,426,2,280,0.0,214.0,140.0,1,146,0.0,146.0,146.0
32603.0,6,10,2032,5,524,7905.75,252.0,104.8,5,1508,6144.75,1236.0,301.6
10471236.0,6,7,478,4,272,3445191.0,74.0,68.0,3,206,5167662.5,74.0,68.66666666666667
2794487.0,6,2,132,1,66,0.0,66.0,66.0,1,66,0.0,66.0,66.0
52402.0,6,10,2032,5,524,12792.25,252.0,104.8,5,1508,12231.0,1236.0,301.6
46728.0,6,10,2032,5,524,11453.0,252.0,104.8,5,1508,9170.75,1236.0,301.6
38227.0,6,14,4740,7,653,5971.666666666667,249.0,93.28571428571428,7,4087,4687.0,1514.0,583.8571428571429
31734.0,6,14,4740,7,653,4985.0,249.0,93.28571428571428,7,4087,4380.0,1514.0,583.8571428571429
105068876.0,17,14,1126,7,563,17501687.333333332,174.0,80.42857142857143,7,563,17500161.5,174.0,80.42857142857143
105151710.0,6,44,2904,22,1452,5007224.285714285,66.0,66.0,22,1452,4992365.904761905,66.0,66.0
258076.00000000003,6,3,337,2,214,0.0,160.0,107.0,1,123,0.0,123.0,123.0
120021812.0,6,225,25266,113,7680,1071623.3214285714,140.0,67.96460176991151,112,17586,1071726.3153153153,284.0,157.01785714285714
15321143.0,17,6,2052,6,2052,3064228.6,342.0,342.0,0,0,0.0,0.0,0.0
135140263.0,17,6,1146,6,1146,27028052.6,191.0,191.0,0,0,0.0,0.0,0.0
41121.0,6,14,4740,7,653,5272.333333333333,249.0,93.28571428571428,7,4087,6716.0,1514.0,583.8571428571429
204366.0,17,2,762,2,762,0.0,381.0,381.0,0,0,0.0,0.0,0.0
24241.0,6,10,2032,5,524,5715.0,252.0,104.8,5,1508,5588.0,1236.0,301.6
438992.0,6,11,1021,6,444,59081.8,162.0,74.0,5,577,73653.75,349.0,115.4
143956.0,17,2,180,1,90,0.0,90.0,90.0,1,90,0.0,90.0,90.0
52423.0,6,2,132,1,66,0.0,66.0,66.0,1,66,0.0,66.0,66.0
121406.0,6,3,337,2,214,0.0,160.0,107.0,1,123,0.0,123.0,123.0
5615933.0,6,5,336,2,134,0.0,68.0,67.0,3,202,1523592.5,70.0,67.33333333333333
104927.0,17,2,286,2,286,0.0,143.0,143.0,0,0,0.0,0.0,0.0
304954.0,17,2,180,1,90,0.0,90.0,90.0,1,90,0.0,90.0,90.0
0.0,6,1,172,1,172,0.0,172.0,172.0,0,0,0.0,0.0,0.0
9127.0,17,2,539,1,86,0.0,86.0,86.0,1,453,0.0,453.0,453.0
46124.0,6,14,4740,7,653,7524.0,249.0,93.28571428571428,7,4087,6855.666666666667,1514.0,583.8571428571429
112978785.0,6,45,2970,23,1518,5135399.318181818,66.0,66.0,22,1452,5264818.952380952,66.0,66.0
93111932.0,6,38,2508,19,1254,5155437.555555556,66.0,66.0,19,1254,5155427.555555556,66.0,66.0
298531.0,6,6,412,4,272,99510.33333333331,74.0,68.0,2,140,0.0,74.0,70.0
120154391.0,6,230,25994,115,7812,1046909.5701754388,140.0,67.9304347826087,115,18182,1037822.596491228,284.0,158.10434782608695
108099420.0,17,5,955,5,955,27024855.0,191.0,191.0,0,0,0.0,0.0,0.0
16031.0,6,14,4740,7,653,2445.5,249.0,93.28571428571428,7,4087,2536.1666666666665,1514.0,583.8571428571429
135138497.0,17,6,1206,6,1206,27027699.4,201.0,201.0,0,0,0.0,0.0,0.0
115001299.0,6,784,201052,379,26050,304236.2407407408,214.0,68.7335092348285,405,175002,284040.35148514854,1514.0,432.1037037037037
70174.0,6,14,4740,7,653,11520.5,249.0,93.28571428571428,7,4087,10826.666666666666,1514.0,583.8571428571429
251899.0,6,10,1221,6,636,50379.8,298.0,106.0,4,585,76716.33333333333,379.0,146.25
1304653.0,6,4,264,2,132,0.0,66.0,66.0,2,132,0.0,66.0,66.0
103213.0,17,2,286,2,286,0.0,143.0,143.0,0,0,0.0,0.0,0.0
1424855.0,6,8,602,3,198,204897.5,66.0,66.0,5,404,331426.25,103.0,80.8
96890.0,6,14,4740,7,653,15865.333333333334,249.0,93.28571428571428,7,4087,15536.5,1514.0,583.8571428571429
90022709.0,17,28,13364,28,13364,3334174.407407407,501.0,477.2857142857143,0,0,0.0,0.0,0.0
228175.0,17,2,180,1,90,0.0,90.0,90.0,1,90,0.0,90.0,90.0
1283128.0,17,7,490,7,490,213854.66666666663,70.0,70.0,0,0,0.0,0.0,0.0
2341.0,17,4,344,2,150,0.0,75.0,75.0,2,194,0.0,103.0,97.0
310593.0,17,4,1400,4,1400,103531.0,350.0,350.0,0,0,0.0,0.0,0.0
47516.0,6,10,2032,5,524,11662.75,252.0,104.8,5,1508,10571.75,1236.0,301.6
3168285.0,6,18,1495,9,921,358123.75,315.0,102.33333333333331,9,574,358096.25,78.0,63.77777777777778
46701.0,6,10,2032,5,524,10124.0,252.0,104.8,5,1508,10829.75,1236.0,301.6
52418.0,6,14,4740,7,653,8298.333333333334,249.0,93.28571428571428,7,4087,7376.666666666667,1514.0,583.8571428571429
308559.0,17,4,1400,4,1400,102853.0,350.0,350.0,0,0,0.0,0.0,0.0
209517.0,17,2,180,1,90,0.0,90.0,90.0,1,90,0.0,90.0,90.0
322112.0,17,4,1400,4,1400,107370.66666666669,350.0,350.0,0,0,0.0,0.0,0.0
242772.0,6,3,337,2,214,0.0,160.0,107.0,1,123,0.0,123.0,123.0
307847.0,6,6,412,4,272,102615.66666666669,74.0,68.0,2,140,0.0,74.0,70.0
90523525.0,6,13,2036,8,1016,12931932.142857144,188.0,127.0,5,1020,22590281.75,204.0,204.0
1497909.0,6,4,276,2,128,0.0,74.0,64.0,2,148,0.0,74.0,74.0
112789522.0,6,31,2182,16,1165,7504916.066666666,139.0,72.8125,15,1017,8040980.785714285,123.0,67.8
37197.0,6,10,2032,5,524,8360.0,252.0,104.8,5,1508,8740.75,1236.0,301.6
90300427.0,6,16,1192,8,596,12892916.42857143,95.0,74.5,8,596,12899477.0,95.0,74.5
3344.0,17,2,363,1,79,0.0,79.0,79.0,1,284,0.0,284.0,284.0
517555.0,17,2,363,1,79,0.0,79.0,79.0,1,284,0.0,284.0,284.0
90049214.0,17,28,13364,28,13364,3335156.074074074,501.0,477.2857142857143,0,0,0.0,0.0,0.0
52861.0,6,14,4740,7,653,8341.166666666666,249.0,93.28571428571428,7,4087,8549.0,1514.0,583.8571428571429
12465.0,6,11,1133,6,602,2276.4,264.0,100.33333333333331,5,531,2526.75,259.0,106.2
131922.0,6,3,337,2,214,0.0,160.0,107.0,1,123,0.0,123.0,123.0
312137.0,17,4,1400,4,1400,104045.66666666669,350.0,350.0,0,0,0.0,0.0,0.0
23260.0,6,10,2032,5,524,4371.25,252.0,104.8,5,1508,5371.25,1236.0,301.6
153387.0,17,2,180,1,90,0.0,90.0,90.0,1,90,0.0,90.0,90.0
142125.0,6,2,132,1,66,0.0,66.0,66.0,1,66,0.0,66.0,66.0
39505.0,6,10,2032,5,524,9536.75,252.0,104.8,5,1508,9339.5,1236.0,301.6
90253097.0,6,13,2036,8,1016,12893299.57142857,188.0,127.0,5,1020,22522786.25,204.0,204.0
105141.0,17,2,286,2,286,0.0,143.0,143.0,0,0,0.0,0.0,0.0
90043322.0,17,28,13364,28,13364,3334937.851851852,501.0,477.2857142857143,0,0,0.0,0.0,0.0
207981.0,6,3,426,2,280,0.0,214.0,140.0,1,146,0.0,146.0,146.0
135131899.0,17,6,1146,6,1146,27026379.8,191.0,191.0,0,0,0.0,0.0,0.0
108105085.0,17,5,1005,5,1005,27026271.25,201.0,201.0,0,0,0.0,0.0,0.0
95634.0,6,14,4740,7,653,15488.166666666666,249.0,93.28571428571428,7,4087,14611.0,1514.0,583.8571428571429
315.0,17,2,174,1,79,0.0,79.0,79.0,1,95,0.0,95.0,95.0
4459.0,17,2,610,1,72,0.0,72.0,72.0,1,538,0.0,538.0,538.0
306681.0,6,6,412,4,272,102227.0,74.0,68.0,2,140,0.0,74.0,70.0
132719.0,6,2,132,1,66,0.0,66.0,66.0,1,66,0.0,66.0,66.0
212191.0,17,2,180,1,90,0.0,90.0,90.0,1,90,0.0,90.0,90.0
90253963.0,6,13,2036,8,1016,12893423.285714284,188.0,127.0,5,1020,22523016.0,204.0,204.0
27124438.0,17,5,1710,5,1710,6781109.5,342.0,342.0,0,0,0.0,0.0,0.0
115201662.0,17,14,1126,7,563,19173788.666666668,174.0,80.42857142857143,7,563,19173786.5,174.0,80.42857142857143
120469467.0,6,229,25960,115,18214,1056749.7105263155,284.0,158.38260869565218,114,7746,1056890.6725663715,140.0,67.94736842105263
862475.0,6,9,1269,6,798,172495.0,460.0,133.0,3,471,294921.5,331.0,157.0
10436508.0,6,7,478,4,272,3433529.0,74.0,68.0,3,206,5150164.0,74.0,68.66666666666667
90018949.0,17,28,13364,28,13364,3334035.1481481483,501.0,477.2857142857143,0,0,0.0,0.0,0.0
284438.0,17,2,363,1,79,0.0,79.0,79.0,1,284,0.0,284.0,284.0
222082.0,6,10,1221,6,636,44416.4,298.0,106.0,4,585,72753.66666666667,379.0,146.25
120118644.0,6,13,2020,9,1204,15014830.5,188.0,133.77777777777777,4,816,30029764.666666668,204.0,204.0
120124362.0,6,13,2020,9,1204,15015545.25,188.0,133.77777777777777,4,816,30031257.666666668,204.0,204.0
346.0,17,2,156,1,78,0.0,78.0,78.0,1,78,0.0,78.0,78.0
13299.0,6,14,4740,7,653,2060.6666666666665,249.0,93.28571428571428,7,4087,2079.333333333333,1514.0,583.8571428571429
0.0,17,1,381,1,381,0.0,381.0,381.0,0,0,0.0,0.0,0.0
881007.0,6,12,2715,7,743,146834.5,339.0,106.14285714285714,5,1972,151353.5,1514.0,394.4
306480.0,6,6,412,4,272,102160.0,74.0,68.0,2,140,0.0,74.0,70.0
1678983.0,6,23,6509,12,1529,152634.81818181818,357.0,127.41666666666669,11,4980,137819.1,1510.0,452.7272727272728
211905.0,6,3,426,2,280,0.0,214.0,140.0,1,146,0.0,146.0,146.0
108106710.0,17,5,1005,5,1005,27026677.5,201.0,201.0,0,0,0.0,0.0,0.0
32229.0,6,14,4740,7,653,4621.333333333333,249.0,93.28571428571428,7,4087,5235.166666666667,1514.0,583.8571428571429
1757974.0,6,2,132,1,66,0.0,66.0,66.0,1,66,0.0,66.0,66.0
1301224.0,6,4,264,2,132,0.0,66.0,66.0,2,132,0.0,66.0,66.0
31179.0,6,14,4740,7,653,4494.333333333333,249.0,93.28571428571428,7,4087,4978.166666666667,1514.0,583.8571428571429
311723.0,17,4,1400,4,1400,103907.66666666669,350.0,350.0,0,0,0.0,0.0,0.0
293.0,17,2,156,1,78,0.0,78.0,78.0,1,78,0.0,78.0,78.0
111483208.0,17,14,864,7,432,18580534.666666668,174.0,61.71428571428572,7,432,18413636.166666668,174.0,61.71428571428572
113613261.0,6,46,3036,23,1518,5150436.454545454,66.0,66.0,23,1518,5150436.090909091,66.0,66.0
2800453.0,6,2,132,1,66,0.0,66.0,66.0,1,66,0.0,66.0,66.0
15588.0,6,2,177,1,123,0.0,123.0,123.0,1,54,0.0,54.0,54.0
1306965.0,6,4,264,2,132,0.0,66.0,66.0,2,132,0.0,66.0,66.0
101054353.0,6,29,2052,15,1089,7202752.642857143,123.0,72.6,14,963,7756807.0,123.0,68.78571428571429
120078270.0,17,28,13364,28,13364,4447343.333333333,501.0,477.2857142857143,0,0,0.0,0.0,0.0
99285833.0,6,190,21426,95,14934,1053939.4680851065,284.0,157.2,95,6492,1053939.6914893617,140.0,68.33684210526316
9326.0,17,2,582,1,83,0.0,83.0,83.0,1,499,0.0,499.0,499.0
247283.0,17,2,180,1,90,0.0,90.0,90.0,1,90,0.0,90.0,90.0
107844.0,17,2,286,2,286,0.0,143.0,143.0,0,0,0.0,0.0,0.0
2407374.0,6,3,1604,2,851,0.0,785.0,425.5,1,753,0.0,753.0,753.0
118063861.0,6,30,1974,15,1026,8417712.857142856,123.0,68.4,15,948,8417715.714285715,123.0,63.2
91719.0,6,11,1132,6,556,18343.8,218.0,92.66666666666669,5,576,22327.5,304.0,115.2
207190.0,6,3,426,2,280,0.0,214.0,140.0,1,146,0.0,146.0,146.0
32717.000000000004,6,10,2032,5,524,7628.25,252.0,104.8,5,1508,7533.75,1236.0,301.6
861658.0,6,9,1267,6,796,172331.6,458.0,132.66666666666666,3,471,293158.5,331.0,157.0
103612357.0,17,14,864,7,432,17167676.5,174.0,61.71428571428572,7,432,17166827.833333332,174.0,61.71428571428572
303359.0,6,6,412,4,272,101119.66666666669,74.0,68.0,2,140,0.0,74.0,70.0
104780.0,17,2,286,2,286,0.0,143.0,143.0,0,0,0.0,0.0,0.0
248088.0,17,4,6056,4,6056,82696.0,1514.0,1514.0,0,0,0.0,0.0,0.0
37466.0,6,14,4740,7,653,6127.5,249.0,93.28571428571428,7,4087,5956.833333333333,1514.0,583.8571428571429
47295.0,6,14,4740,7,653,7027.833333333333,249.0,93.28571428571428,7,4087,6797.166666666667,1514.0,583.8571428571429
301098.0,6,6,412,4,272,100366.0,74.0,68.0,2,140,0.0,74.0,70.0
92074445.0,6,487,62500,244,46240,378907.1810699589,336.0,189.50819672131144,243,16260,379496.9214876033,140.0,66.91358024691358
90897924.0,6,19,1436,9,691,11362240.5,95.0,76.77777777777777,10,745,10071661.0,95.0,74.5
212863.0,6,3,426,2,280,0.0,214.0,140.0,1,146,0.0,146.0,146.0
120125056.0,6,14,2240,6,1224,24025011.2,204.0,204.0,8,1016,17137468.0,188.0,127.0
13985.0,6,14,4740,7,653,2178.333333333333,249.0,93.28571428571428,7,4087,2095.333333333333,1514.0,583.8571428571429
41056.0,6,14,4740,7,653,6649.333333333333,249.0,93.28571428571428,7,4087,6018.333333333333,1514.0,583.8571428571429
44472.0,6,14,4740,7,653,7253.666666666667,249.0,93.28571428571428,7,4087,6849.833333333333,1514.0,583.8571428571429
130525.0,6,3,337,2,214,0.0,160.0,107.0,1,123,0.0,123.0,123.0
213794.0,17,2,180,1,90,0.0,90.0,90.0,1,90,0.0,90.0,90.0
101920.0,17,2,762,2,762,0.0,381.0,381.0,0,0,0.0,0.0,0.0
105105095.0,17,15,5130,15,5130,7507506.785714285,342.0,342.0,0,0,0.0,0.0,0.0
48902.0,6,14,4740,7,653,7421.166666666667,249.0,93.28571428571428,7,4087,7777.5,1514.0,583.8571428571429
90256443.0,6,12,1832,8,1016,12893777.57142857,188.0,127.0,4,816,30025367.666666668,204.0,204.0
90254146.0,6,13,2036,8,1016,12893449.42857143,188.0,127.0,5,1020,22522317.25,204.0,204.0
205827.0,17,2,180,1,90,0.0,90.0,90.0,1,90,0.0,90.0,90.0
40554.0,6,14,4740,7,653,6634.5,249.0,93.28571428571428,7,4087,6271.0,1514.0,583.8571428571429
162224.0,17,2,180,1,90,0.0,90.0,90.0,1,90,0.0,90.0,90.0
2804316.0,6,2,132,1,66,0.0,66.0,66.0,1,66,0.0,66.0,66.0
90040998.0,17,27,12943,27,12943,3463115.3076923075,501.0,479.3703703703704,0,0,0.0,0.0,0.0
250985.0,6,3,337,2,214,0.0,160.0,107.0,1,123,0.0,123.0,123.0
36811.0,6,14,4740,7,653,5307.5,249.0,93.28571428571428,7,4087,5364.0,1514.0,583.8571428571429
29637.0,6,14,4740,7,653,4770.333333333333,249.0,93.28571428571428,7,4087,4798.0,1514.0,583.8571428571429
153403.0,17,2,180,1,90,0.0,90.0,90.0,1,90,0.0,90.0,90.0
42796.0,6,14,4740,7,653,6135.333333333333,249.0,93.28571428571428,7,4087,6902.5,1514.0,583.8571428571429
151453.0,17,2,180,1,70,0.0,70.0,70.0,1,110,0.0,110.0,110.0
219581.0,6,3,426,2,280,0.0,214.0,140.0,1,146,0.0,146.0,146.0
364.0,17,2,166,1,75,0.0,75.0,75.0,1,91,0.0,91.0,91.0
231490.0,6,3,426,2,280,0.0,214.0,140.0,1,146,0.0,146.0,146.0
39414.0,6,13,1386,7,789,6189.0,253.0,112.71428571428572,6,597,5813.2,259.0,99.5
32648.000000000004,6,14,4740,7,653,4833.333333333333,249.0,93.28571428571428,7,4087,4960.333333333333,1514.0,583.8571428571429
61670.0,6,12,1320,6,723,10721.4,253.0,120.5,6,597,11664.0,259.0,99.5
321.0,17,2,174,1,79,0.0,79.0,79.0,1,95,0.0,95.0,95.0
112957.0,17,2,286,2,286,0.0,143.0,143.0,0,0,0.0,0.0,0.0
59255309.0,17,9,3086,8,2736,5177311.0,342.0,342.0,1,350,0.0,350.0,350.0
8895.0,17,2,180,1,90,0.0,90.0,90.0,1,90,0.0,90.0,90.0
205772.0,17,3,1143,3,1143,102886.0,381.0,381.0,0,0,0.0,0.0,0.0
118680887.0,6,35,2520,18,1248,6981228.647058823,123.0,69.33333333333333,17,1272,6923604.6875,123.0,74.82352941176471
32791.0,6,10,2032,5,524,7955.5,252.0,104.8,5,1508,7896.5,1236.0,301.6
312503.0,17,4,622,4,622,104167.66666666669,163.0,155.5,0,0,0.0,0.0,0.0
316633.0,6,6,412,4,272,105544.33333333331,74.0,68.0,2,140,0.0,74.0,70.0
4446.0,17,2,626,1,72,0.0,72.0,72.0,1,554,0.0,554.0,554.0
209695.0,17,2,180,1,90,0.0,90.0,90.0,1,90,0.0,90.0,90.0
304697.0,6,6,412,4,272,101565.66666666669,74.0,68.0,2,140,0.0,74.0,70.0
1309061.0,6,4,264,2,132,0.0,66.0,66.0,2,132,0.0,66.0,66.0
700.0,17,4,438,2,148,0.0,74.0,74.0,2,290,0.0,147.0,145.0
25973.0,6,10,2032,5,524,6095.25,252.0,104.8,5,1508,5960.5,1236.0,301.6
38220.0,6,14,4740,7,653,6263.166666666667,249.0,93.28571428571428,7,4087,5751.666666666667,1514.0,583.8571428571429
205994.0,6,3,426,2,280,0.0,214.0,140.0,1,146,0.0,146.0,146.0
153421.0,17,2,180,1,90,0.0,90.0,90.0,1,90,0.0,90.0,90.0
108099144.0,17,5,1005,5,1005,27024786.0,201.0,201.0,0,0,0.0,0.0,0.0
204400.0,17,2,762,2,762,0.0,381.0,381.0,0,0,0.0,0.0,0.0
90534234.0,6,15,2444,8,1016,12933462.0,188.0,127.0,7,1428,15061061.166666666,204.0,204.0
305533.0,17,4,704,2,148,0.0,74.0,74.0,2,556,0.0,280.0,278.0
199121.0,17,2,180,1,90,0.0,90.0,90.0,1,90,0.0,90.0,90.0
32999.0,6,14,4740,7,653,5317.666666666667,249.0,93.28571428571428,7,4087,5241.333333333333,1514.0,583.8571428571429
46261.0,6,11,2098,6,590,8784.6,252.0,98.33333333333331,5,1508,11002.25,1236.0,301.6
1050544.0,6,11,1134,6,558,210108.8,220.0,93.0,5,576,260990.5,304.0,115.2
1002529.0,6,13,1428,7,797,166777.33333333334,253.0,113.85714285714286,6,631,199337.6,293.0,105.16666666666669
107221.0,17,2,286,2,286,0.0,143.0,143.0,0,0,0.0,0.0,0.0
439365.0,6,10,967,5,390,73802.25,162.0,78.0,5,577,73724.75,349.0,115.4
153472.0,17,2,180,1,90,0.0,90.0,90.0,1,90,0.0,90.0,90.0
90921745.0,6,21,1585,11,840,9090810.6,95.0,76.36363636363636,10,745,10101904.777777778,95.0,74.5
3700.0,17,4,571,2,148,0.0,74.0,74.0,2,423,0.0,280.0,211.5
103594.0,17,2,286,2,286,0.0,143.0,143.0,0,0,0.0,0.0,0.0
120124898.0,6,14,2224,9,1204,15015612.25,188.0,133.77777777777777,5,1020,22593524.5,204.0,204.0
526026.0,6,2,145,2,145,0.0,91.0,72.5,0,0,0.0,0.0,0.0
617229.0,17,2,346,1,78,0.0,78.0,78.0,1,268,0.0,268.0,268.0
178532.0,17,2,762,2,762,0.0,381.0,381.0,0,0,0.0,0.0,0.0
23121221.0,17,3,1034,2,684,0.0,342.0,342.0,1,350,0.0,350.0,350.0
512019.0,6,5,336,2,134,0.0,68.0,67.0,3,202,196287.0,70.0,67.33333333333333
2453.0,17,4,344,2,150,0.0,75.0,75.0,2,194,0.0,103.0,97.0
277398.0,6,12,1373,7,714,46233.0,298.0,102.0,5,659,63076.75,379.0,131.8
104635664.0,17,15,5130,15,5130,7473976.0,342.0,342.0,0,0,0.0,0.0,0.0
14332767.0,6,19,1551,9,919,1753484.625,315.0,102.11111111111111,10,632,1558630.5555555555,78.0,63.2
217545.0,6,3,426,2,280,0.0,214.0,140.0,1,146,0.0,146.0,146.0
108104950.0,17,5,1005,5,1005,27026237.5,201.0,201.0,0,0,0.0,0.0,0.0
90218732.0,6,16,1192,8,596,12852456.714285716,95.0,74.5,8,596,12857503.142857144,95.0,74.5
119670142.0,6,224,25482,112,17794,1076169.5675675676,390.0,158.875,112,7688,1076171.3333333333,140.0,68.64285714285714
120217354.0,6,234,26634,117,7944,1029158.0775862068,140.0,67.8974358974359,117,18690,1029132.8189655172,336.0,159.74358974358975
9006817.0,17,4,300,4,300,3002272.333333333,75.0,75.0,0,0,0.0,0.0,0.0
307798.0,6,6,412,4,272,102599.33333333331,74.0,68.0,2,140,0.0,74.0,70.0
2702891.0,6,2,132,1,66,0.0,66.0,66.0,1,66,0.0,66.0,66.0
97286625.0,17,14,1126,7,563,16167358.333333334,174.0,80.42857142857143,7,563,16166804.166666666,174.0,80.42857142857143
284409.0,17,2,363,1,79,0.0,79.0,79.0,1,284,0.0,284.0,284.0
90310546.0,6,21,1585,11,840,9026044.3,95.0,76.36363636363636,10,745,10003028.222222222,95.0,74.5
205035.0,17,2,762,2,762,0.0,381.0,381.0,0,0,0.0,0.0,0.0
113528274.0,6,48,3168,24,1584,4936011.913043479,66.0,66.0,24,1584,4926611.608695652,66.0,66.0
21844.0,6,14,4740,7,653,3531.6666666666665,249.0,93.28571428571428,7,4087,3407.333333333333,1514.0,583.8571428571429
257902.00000000003,6,10,1221,6,636,51580.4,298.0,106.0,4,585,80564.66666666667,379.0,146.25
311853.0,17,4,1400,4,1400,103951.0,350.0,350.0,0,0,0.0,0.0,0.0
288815.0,6,10,1221,6,636,57763.0,298.0,106.0,4,585,90861.33333333331,379.0,146.25
90256264.0,6,12,1832,8,1016,12893752.0,188.0,127.0,4,816,30030573.666666668,204.0,204.0
310084.0,6,3,202,2,128,0.0,74.0,64.0,1,74,0.0,74.0,74.0
14144.0,17,2,582,1,83,0.0,83.0,83.0,1,499,0.0,499.0,499.0
146104.0,6,3,337,2,214,0.0,160.0,107.0,1,123,0.0,123.0,123.0
126014772.0,17,15,907,8,475,18002110.285714287,174.0,59.375,7,432,17666838.5,174.0,61.71428571428572
2395.0,17,4,344,2,150,0.0,75.0,75.0,2,194,0.0,103.0,97.0
120382428.0,6,31,2034,16,1086,8025495.2,123.0,67.875,15,948,7869887.785714285,123.0,63.2
233489.0,6,3,337,2,214,0.0,160.0,107.0,1,123,0.0,123.0,123.0
46494.0,6,10,2032,5,524,11374.25,252.0,104.8,5,1508,10774.25,1236.0,301.6
509971.0,6,5,336,2,134,0.0,68.0,67.0,3,202,196283.0,70.0,67.33333333333333
1310112.0,6,4,264,2,132,0.0,66.0,66.0,2,132,0.0,66.0,66.0
18895.0,6,10,1067,5,536,4034.5,264.0,107.2,5,531,2462.5,259.0,106.2
108109069.0,17,5,955,5,955,27027267.25,191.0,191.0,0,0,0.0,0.0,0.0
111190939.0,17,14,864,7,432,18498101.166666668,174.0,61.71428571428572,7,432,18500167.5,174.0,61.71428571428572
1023444.0,6,20,6434,12,1921,93040.36363636365,620.0,160.08333333333334,8,4513,118140.28571428572,1514.0,564.125
833829.0,6,9,1118,6,586,166765.8,248.0,97.66666666666669,3,532,279288.0,392.0,177.33333333333334
3846497.0,6,5,336,2,134,0.0,68.0,67.0,3,202,532777.0,70.0,67.33333333333333
281018.0,17,2,363,1,79,0.0,79.0,79.0,1,284,0.0,284.0,284.0
317677.0,17,4,1400,4,1400,105892.33333333331,350.0,350.0,0,0,0.0,0.0,0.0
116766532.0,6,48,3168,24,1584,5076805.739130435,66.0,66.0,24,1584,5064829.347826087,66.0,66.0
854370.0,6,9,1096,6,625,170874.0,287.0,104.16666666666669,3,471,289354.5,331.0,157.0
148032.0,17,2,180,1,90,0.0,90.0,90.0,1,90,0.0,90.0,90.0
120058031.0,17,29,13785,29,13785,4287786.821428572,501.0,475.3448275862069,0,0,0.0,0.0,0.0
232921.0,6,3,337,2,214,0.0,160.0,107.0,1,123,0.0,123.0,123.0
94411136.0,6,40,2640,20,1320,4969007.157894737,66.0,66.0,20,1320,4954656.47368421,66.0,66.0
35745861.0,6,5,336,2,134,0.0,68.0,67.0,3,202,17808829.5,70.0,67.33333333333333
120078022.0,17,29,13785,29,13785,4288500.785714285,501.0,475.3448275862069,0,0,0.0,0.0,0.0
33719.0,6,14,4740,7,653,5188.666666666667,249.0,93.28571428571428,7,4087,5356.0,1514.0,583.8571428571429
233022.0,6,3,337,2,214,0.0,160.0,107.0,1,123,0.0,123.0,123.0
255868.0,6,3,337,2,214,0.0,160.0,107.0,1,123,0.0,123.0,123.0
31381.0,6,11,1131,6,600,5828.6,262.0,100.0,5,531,7495.75,259.0,106.2
4281.0,17,2,598,1,72,0.0,72.0,72.0,1,526,0.0,526.0,526.0
24647.0,6,10,2032,5,524,5646.75,252.0,104.8,5,1508,5563.5,1236.0,301.6
59967.0,6,14,4740,7,653,7759.833333333333,249.0,93.28571428571428,7,4087,9475.833333333334,1514.0,583.8571428571429
113616345.0,6,46,3036,23,1518,5150436.045454546,66.0,66.0,23,1518,5150517.681818182,66.0,66.0
10463523.0,6,7,478,4,272,3442553.0,74.0,68.0,3,206,5163689.5,74.0,68.66666666666667
186886.0,17,2,762,2,762,0.0,381.0,381.0,0,0,0.0,0.0,0.0
114086.0,17,4,1400,4,1400,38028.66666666666,350.0,350.0,0,0,0.0,0.0,0.0
71895.0,6,14,4740,7,653,11711.833333333334,249.0,93.28571428571428,7,4087,11757.833333333334,1514.0,583.8571428571429
90288329.0,6,16,1192,8,596,12892537.42857143,95.0,74.5,8,596,12896555.714285716,95.0,74.5
1239818.0,17,7,490,7,490,206636.3333333333,70.0,70.0,0,0,0.0,0.0,0.0
1446174.0,6,8,602,3,198,203929.0,66.0,66.0,5,404,337084.0,103.0,80.8
26741.0,6,14,4740,7,653,4342.166666666667,249.0,93.28571428571428,7,4087,3889.0,1514.0,583.8571428571429
30926.0,6,10,2032,5,524,6136.5,252.0,104.8,5,1508,7137.25,1236.0,301.6
57010.0,6,14,4740,7,653,8284.666666666666,249.0,93.28571428571428,7,4087,7130.333333333333,1514.0,583.8571428571429
114023797.0,6,48,3168,24,1584,4957556.391304348,66.0,66.0,24,1584,4948157.0,66.0,66.0
1144305.0,6,13,3001,8,2373,163472.14285714287,1514.0,296.625,5,628,217896.5,331.0,125.6
124001149.0,17,15,907,8,475,17714449.85714286,174.0,59.375,7,432,17334309.333333332,174.0,61.71428571428572
20104.0,17,2,582,1,83,0.0,83.0,83.0,1,499,0.0,499.0,499.0
2388.0,17,4,344,2,150,0.0,75.0,75.0,2,194,0.0,103.0,97.0
685356.0,6,4,497,3,374,342678.0,160.0,124.66666666666669,1,123,0.0,123.0,123.0
2027.0,17,4,344,2,150,0.0,75.0,75.0,2,194,0.0,103.0,97.0
208630.0,17,2,762,2,762,0.0,381.0,381.0,0,0,0.0,0.0,0.0
1049155.0,6,11,1134,6,558,209831.0,220.0,93.0,5,576,259601.25,304.0,115.2
90537051.0,6,14,2240,8,1016,12933864.42857143,188.0,127.0,6,1224,18073467.8,204.0,204.0
119963689.0,6,15,2444,7,1428,15060626.5,204.0,204.0,8,1016,17137323.57142857,188.0,127.0
302393.0,6,2,132,1,66,0.0,66.0,66.0,1,66,0.0,66.0,66.0
123667673.0,6,38,2848,20,1531,6508824.894736842,139.0,76.55,18,1317,6674527.647058823,123.0,73.16666666666667
44115.0,6,14,4740,7,653,6351.333333333333,249.0,93.28571428571428,7,4087,7181.666666666667,1514.0,583.8571428571429
206697.0,17,3,1143,3,1143,103348.5,381.0,381.0,0,0,0.0,0.0,0.0
62853.00000000001,6,10,2032,5,524,15422.75,252.0,104.8,5,1508,12897.75,1236.0,301.6
191369.0,17,4,344,2,150,0.0,75.0,75.0,2,194,0.0,103.0,97.0
28203170.0,6,26,7627,14,3735,207412.53846153847,1514.0,266.7857142857143,12,3892,2545320.1818181816,1514.0,324.3333333333333
307.0,17,2,174,1,79,0.0,79.0,79.0,1,95,0.0,95.0,95.0
122007525.0,17,17,1255,9,649,15250940.625,174.0,72.11111111111111,8,606,14499172.285714284,174.0,75.75
119995154.0,6,17,1246,9,650,14999394.25,95.0,72.22222222222223,8,596,12892924.42857143,95.0,74.5
1306924.0,6,4,264,2,132,0.0,66.0,66.0,2,132,0.0,66.0,66.0
20061.0,6,14,4740,7,653,3210.1666666666665,249.0,93.28571428571428,7,4087,3168.5,1514.0,583.8571428571429
7168.0,17,2,582,1,83,0.0,83.0,83.0,1,499,0.0,499.0,499.0
28727.0,6,14,4740,7,653,4668.833333333333,249.0,93.28571428571428,7,4087,4649.833333333333,1514.0,583.8571428571429
107309777.0,17,13,821,7,432,17884962.833333332,174.0,61.71428571428572,6,389,17738815.4,174.0,64.83333333333333
101920.0,17,2,700,2,700,0.0,350.0,350.0,0,0,0.0,0.0,0.0
1433.0,17,2,762,2,762,0.0,381.0,381.0,0,0,0.0,0.0,0.0
252070.00000000003,17,4,6056,4,6056,84023.33333333333,1514.0,1514.0,0,0,0.0,0.0,0.0
3393.0,17,4,407,2,144,0.0,72.0,72.0,2,263,0.0,136.0,131.5
315845.0,17,4,1400,4,1400,105281.66666666669,350.0,350.0,0,0,0.0,0.0,0.0
22339.0,6,14,4740,7,653,3454.333333333333,249.0,93.28571428571428,7,4087,3318.6666666666665,1514.0,583.8571428571429
302352.0,6,2,132,1,66,0.0,66.0,66.0,1,66,0.0,66.0,66.0
284591.0,17,2,363,1,79,0.0,79.0,79.0,1,284,0.0,284.0,284.0
120064122.0,17,28,13364,28,13364,4446819.333333333,501.0,477.2857142857143,0,0,0.0,0.0,0.0
2059.0,17,4,344,2,150,0.0,75.0,75.0,2,194,0.0,103.0,97.0
4191.0,17,2,598,1,72,0.0,72.0,72.0,1,526,0.0,526.0,526.0
851.0,17,2,762,2,762,0.0,381.0,381.0,0,0,0.0,0.0,0.0
101001195.0,17,13,821,7,432,16833532.5,174.0,61.71428571428572,6,389,16200895.2,174.0,64.83333333333333
135128263.0,17,6,1146,6,1146,27025652.6,191.0,191.0,0,0,0.0,0.0,0.0
48653.0,6,10,2032,5,524,10163.75,252.0,104.8,5,1508,11175.25,1236.0,301.6
13727.0,6,10,1065,5,534,3099.75,262.0,106.8,5,531,3050.75,259.0,106.2
97852459.0,17,12,778,6,389,19538303.8,174.0,64.83333333333333,6,389,19388408.0,174.0,64.83333333333333
0.0,17,1,179,1,179,0.0,179.0,179.0,0,0,0.0,0.0,0.0
204919.0,17,2,180,1,90,0.0,90.0,90.0,1,90,0.0,90.0,90.0
143885.0,17,2,180,1,90,0.0,90.0,90.0,1,90,0.0,90.0,90.0
118676901.0,6,33,2274,17,1125,7417306.3125,123.0,66.17647058823529,16,1149,7384874.733333333,123.0,71.8125
16187.0,6,11,2098,6,590,2358.8,252.0,98.33333333333331,5,1508,3363.0,1236.0,301.6
96446282.0,17,12,778,6,389,19200201.6,174.0,64.83333333333333,6,389,19200707.0,174.0,64.83333333333333
283726.0,17,2,180,1,90,0.0,90.0,90.0,1,90,0.0,90.0,90.0
235018.0,6,3,337,2,214,0.0,160.0,107.0,1,123,0.0,123.0,123.0
153427.0,17,2,180,1,90,0.0,90.0,90.0,1,90,0.0,90.0,90.0
0.0,6,1,66,1,66,0.0,66.0,66.0,0,0,0.0,0.0,0.0
107825.0,17,2,286,2,286,0.0,143.0,143.0,0,0,0.0,0.0,0.0
505185.0,6,5,336,2,134,0.0,68.0,67.0,3,202,194299.0,70.0,67.33333333333333
90755612.0,6,20,1531,11,840,9070956.4,95.0,76.36363636363636,9,691,11343163.875,95.0,76.77777777777777
17220.0,6,11,1133,6,602,3082.2,264.0,100.33333333333331,5,531,3272.5,259.0,106.2
15911.000000000002,6,10,2032,5,524,3741.5,252.0,104.8,5,1508,3718.0,1236.0,301.6
2508037.0,6,25,7573,14,3735,192925.92307692303,1514.0,266.7857142857143,11,3838,223556.2,1514.0,348.90909090909093
123730555.0,6,49,3234,25,1650,5155439.791666667,66.0,66.0,24,1584,5124932.0,66.0,66.0
98011581.0,6,26,1762,13,922,8149657.416666667,139.0,70.92307692307692,13,840,8149656.666666667,123.0,64.61538461538461
90213470.0,6,16,1192,8,596,12851631.714285716,95.0,74.5,8,596,12858251.0,95.0,74.5
228251.0,17,2,180,1,90,0.0,90.0,90.0,1,90,0.0,90.0,90.0
209586.0,6,3,426,2,280,0.0,214.0,140.0,1,146,0.0,146.0,146.0
16525.0,6,10,2032,5,524,3905.0,252.0,104.8,5,1508,3695.0,1236.0,301.6
33232.0,6,10,2032,5,524,5838.25,252.0,104.8,5,1508,7402.25,1236.0,301.6
135141533.0,17,6,1146,6,1146,27028306.6,191.0,191.0,0,0,0.0,0.0,0.0
14396.0,6,13,1459,7,862,2316.833333333333,271.0,123.14285714285714,6,597,2625.8,259.0,99.5
2397.0,17,4,344,2,150,0.0,75.0,75.0,2,194,0.0,103.0,97.0
0.0,6,1,172,1,172,0.0,172.0,172.0,0,0,0.0,0.0,0.0
90297369.0,6,16,1192,8,596,12892420.0,95.0,74.5,8,596,12897729.0,95.0,74.5
90259165.0,6,16,2368,9,1204,11282395.625,188.0,133.77777777777777,7,1164,15015367.833333334,204.0,166.28571428571428
91913.0,6,14,4740,7,653,12937.333333333334,249.0,93.28571428571428,7,4087,14559.333333333334,1514.0,583.8571428571429
308058.0,6,6,412,4,272,102686.0,74.0,68.0,2,140,0.0,74.0,70.0
108105635.0,17,5,955,5,955,27026408.75,191.0,191.0,0,0,0.0,0.0,0.0
2881984.0,6,11,2106,6,598,575922.4,252.0,99.66666666666669,5,1508,4942.75,1236.0,301.6
209772.0,17,2,180,1,90,0.0,90.0,90.0,1,90,0.0,90.0,90.0
90016954.0,6,164,18428,82,12868,1108661.024691358,284.0,156.9268292682927,82,5560,1108662.037037037,140.0,67.8048780487805
2039.0,17,4,344,2,150,0.0,75.0,75.0,2,194,0.0,103.0,97.0
114893103.0,6,48,3168,24,1584,4995352.304347826,66.0,66.0,24,1584,4985954.347826087,66.0,66.0
296.0,17,2,156,1,78,0.0,78.0,78.0,1,78,0.0,78.0,78.0
843343.0,6,9,1118,6,586,168668.6,248.0,97.66666666666669,3,532,283860.0,392.0,177.33333333333334
5625549.0,6,5,336,2,134,0.0,68.0,67.0,3,202,1522845.0,70.0,67.33333333333333
115545029.0,6,36,2464,18,1285,6784061.235294118,139.0,71.38888888888889,18,1179,6784050.0,123.0,65.5
147973.0,17,2,180,1,90,0.0,90.0,90.0,1,90,0.0,90.0,90.0
120032798.0,17,28,13364,28,13364,4445659.185185186,501.0,477.2857142857143,0,0,0.0,0.0,0.0
205997.0,17,2,180,1,90,0.0,90.0,90.0,1,90,0.0,90.0,90.0
153306.0,17,2,180,1,90,0.0,90.0,90.0,1,90,0.0,90.0,90.0
108112881.0,17,5,1005,5,1005,27028220.25,201.0,201.0,0,0,0.0,0.0,0.0
43594.0,6,14,4740,7,653,5956.166666666667,249.0,93.28571428571428,7,4087,5568.333333333333,1514.0,583.8571428571429
228276.0,17,2,180,1,90,0.0,90.0,90.0,1,90,0.0,90.0,90.0
27165568.0,17,5,1710,5,1710,6791392.0,342.0,342.0,0,0,0.0,0.0,0.0
205671.0,17,2,180,1,90,0.0,90.0,90.0,1,90,0.0,90.0,90.0
42827.0,6,11,1131,6,600,5997.0,262.0,100.0,5,531,10488.25,259.0,106.2
90257274.0,6,13,2036,8,1016,12893896.285714284,188.0,127.0,5,1020,22520929.5,204.0,204.0
92124513.0,6,40,2640,20,1320,4848658.578947368,66.0,66.0,20,1320,4842947.368421053,66.0,66.0
90029464.0,17,28,13364,28,13364,3334424.592592593,501.0,477.2857142857143,0,0,0.0,0.0,0.0
144996.0,17,2,180,1,70,0.0,70.0,70.0,1,110,0.0,110.0,110.0
36723.0,6,10,2032,5,524,7896.75,252.0,104.8,5,1508,7372.0,1236.0,301.6
101561983.0,17,14,1126,7,563,16665332.666666666,174.0,80.42857142857143,7,563,16666811.5,174.0,80.42857142857143
298049.0,6,6,412,4,272,99349.66666666669,74.0,68.0,2,140,0.0,74.0,70.0
209475.0,17,2,180,1,90,0.0,90.0,90.0,1,90,0.0,90.0,90.0
83893.0,6,14,4740,7,653,13078.166666666666,249.0,93.28571428571428,7,4087,13833.666666666666,1514.0,583.8571428571429
1164285.0,6,13,3010,8,2382,166326.42857142858,1514.0,297.75,5,628,222895.75,331.0,125.6
1727385.0,6,23,6509,12,1529,157035.0,357.0,127.41666666666669,11,4980,141864.2,1510.0,452.7272727272728
228279.0,17,2,180,1,90,0.0,90.0,90.0,1,90,0.0,90.0,90.0
253183.0,6,3,373,2,238,0.0,172.0,119.0,1,135,0.0,135.0,135.0
303667.0,6,2,132,1,66,0.0,66.0,66.0,1,66,0.0,66.0,66.0
135133000.0,17,6,1206,6,1206,27026600.0,201.0,201.0,0,0,0.0,0.0,0.0
2358.0,17,4,344,2,150,0.0,75.0,75.0,2,194,0.0,103.0,97.0
119003581.0,17,13,821,7,432,19833930.166666668,174.0,61.71428571428572,6,389,19800161.8,174.0,64.83333333333333
56861.0,6,14,4740,7,653,9352.666666666666,249.0,93.28571428571428,7,4087,8970.166666666666,1514.0,583.8571428571429
315965.0,17,4,1400,4,1400,105321.66666666669,350.0,350.0,0,0,0.0,0.0,0.0
1040742.0,6,11,1134,6,558,208148.4,220.0,93.0,5,576,259092.5,304.0,115.2
59338617.0,17,9,3086,8,2736,5424124.857142857,342.0,342.0,1,350,0.0,350.0,350.0
135127755.0,17,6,1206,6,1206,27025551.0,201.0,201.0,0,0,0.0,0.0,0.0
1171782.0,6,13,3011,8,2383,167397.42857142858,1514.0,297.875,5,628,224795.25,331.0,125.6
288398.0,17,2,363,1,79,0.0,79.0,79.0,1,284,0.0,284.0,284.0
1306043.0,6,4,264,2,132,0.0,66.0,66.0,2,132,0.0,66.0,66.0
31662.000000000004,6,14,4740,7,653,5109.5,249.0,93.28571428571428,7,4087,5125.166666666667,1514.0,583.8571428571429
139239.0,6,2,132,1,66,0.0,66.0,66.0,1,66,0.0,66.0,66.0
37048.0,6,10,2032,5,524,8231.5,252.0,104.8,5,1508,8544.25,1236.0,301.6
3431615.0,6,7,923,4,753,1075249.6666666667,571.0,188.25,3,170,1613137.0,62.0,56.66666666666666
124615.0,6,2,132,1,66,0.0,66.0,66.0,1,66,0.0,66.0,66.0
302562.0,6,6,412,4,272,100854.0,74.0,68.0,2,140,0.0,74.0,70.0
233004.0,6,3,337,2,214,0.0,160.0,107.0,1,123,0.0,123.0,123.0
147664.0,17,2,180,1,70,0.0,70.0,70.0,1,110,0.0,110.0,110.0
120123753.0,6,13,2020,9,1204,15015469.125,188.0,133.77777777777777,4,816,30031304.0,204.0,204.0
90254467.0,6,12,1832,8,1016,12893495.285714284,188.0,127.0,4,816,30030747.666666668,204.0,204.0
437404.0,6,11,1021,6,444,58753.8,162.0,74.0,5,577,73238.75,349.0,115.4
5622396.0,6,5,336,2,134,0.0,68.0,67.0,3,202,1472290.5,70.0,67.33333333333333
143895.0,17,2,180,1,90,0.0,90.0,90.0,1,90,0.0,90.0,90.0
108104529.0,17,5,955,5,955,27026132.25,191.0,191.0,0,0,0.0,0.0,0.0
135131800.0,17,6,1146,6,1146,27026360.0,191.0,191.0,0,0,0.0,0.0,0.0
148333.0,17,2,414,1,88,0.0,88.0,88.0,1,326,0.0,326.0,326.0
90282171.0,6,17,1287,9,691,11279760.5,95.0,76.77777777777777,8,596,12896092.0,95.0,74.5
101022316.0,17,14,1126,7,563,16837052.666666668,174.0,80.42857142857143,7,563,16789874.666666668,174.0,80.42857142857143
135132695.0,17,6,1146,6,1146,27026539.0,191.0,191.0,0,0,0.0,0.0,0.0
329812.0,6,6,412,4,272,109937.33333333331,74.0,68.0,2,140,0.0,74.0,70.0
103004.0,17,2,286,2,286,0.0,143.0,143.0,0,0,0.0,0.0,0.0
298.0,17,2,164,1,82,0.0,82.0,82.0,1,82,0.0,82.0,82.0
23013764.0,17,3,1034,2,684,0.0,342.0,342.0,1,350,0.0,350.0,350.0
19270.0,6,10,2032,5,524,3959.5,252.0,104.8,5,1508,4466.75,1236.0,301.6
228188.0,17,2,180,1,90,0.0,90.0,90.0,1,90,0.0,90.0,90.0
207341.0,6,3,426,2,280,0.0,214.0,140.0,1,146,0.0,146.0,146.0
102693432.0,6,44,2904,22,1452,4890163.428571428,66.0,66.0,22,1452,4879867.952380952,66.0,66.0
2026.0,17,4,344,2,150,0.0,75.0,75.0,2,194,0.0,103.0,97.0
154997.0,6,3,337,2,214,0.0,160.0,107.0,1,123,0.0,123.0,123.0
135129600.0,17,6,1146,6,1146,27025920.0,191.0,191.0,0,0,0.0,0.0,0.0
404538.0,6,4,508,2,238,0.0,172.0,119.0,2,270,0.0,135.0,135.0
2905409.0,6,3,1604,1,753,0.0,753.0,753.0,2,851,0.0,785.0,425.5
118602655.0,6,216,24312,108,16888,1106424.9719626168,284.0,156.37037037037038,108,7424,1106424.925233645,140.0,68.74074074074075
28325.0,6,10,2032,5,524,6767.0,252.0,104.8,5,1508,5245.5,1236.0,301.6
106063.0,17,2,286,2,286,0.0,143.0,143.0,0,0,0.0,0.0,0.0
90259683.0,6,12,1832,8,1016,12894240.42857143,188.0,127.0,4,816,30030702.33333333,204.0,204.0
34993.0,6,14,4740,7,653,5670.5,249.0,93.28571428571428,7,4087,5576.333333333333,1514.0,583.8571428571429
35385.0,6,14,4740,7,653,5774.0,249.0,93.28571428571428,7,4087,5361.166666666667,1514.0,583.8571428571429
193059.0,17,2,180,1,90,0.0,90.0,90.0,1,90,0.0,90.0,90.0
118346465.0,6,48,3168,24,1584,5145498.478260869,66.0,66.0,24,1584,5133660.652173913,66.0,66.0
216348.0,17,2,180,1,90,0.0,90.0,90.0,1,90,0.0,90.0,90.0
883.0,17,4,438,2,148,0.0,74.0,74.0,2,290,0.0,147.0,145.0
20787885.0,6,22,1719,11,1029,2048207.2,315.0,93.54545454545456,11,690,2048185.2,78.0,62.72727272727273
130862.0,6,2,132,1,66,0.0,66.0,66.0,1,66,0.0,66.0,66.0
21685.0,6,14,4740,7,653,3504.1666666666665,249.0,93.28571428571428,7,4087,3434.333333333333,1514.0,583.8571428571429
110977672.0,6,33,2296,17,1225,6922623.5625,139.0,72.05882352941177,16,1071,7384130.4,123.0,66.9375
135135444.0,17,6,1146,6,1146,27027088.8,191.0,191.0,0,0,0.0,0.0,0.0
100050.0,17,2,762,2,762,0.0,381.0,381.0,0,0,0.0,0.0,0.0
27379.0,6,10,2032,5,524,6153.25,252.0,104.8,5,1508,6601.5,1236.0,301.6
205011.0,17,2,762,2,762,0.0,381.0,381.0,0,0,0.0,0.0,0.0
90596561.0,6,36,2988,20,1641,4756881.578947368,123.0,82.05,16,1347,6025386.0,123.0,84.1875
864442.0,6,11,2644,7,743,144073.66666666666,339.0,106.14285714285714,4,1901,197265.66666666663,1514.0,475.25
196924.0,17,2,180,1,90,0.0,90.0,90.0,1,90,0.0,90.0,90.0
90063438.0,17,28,13364,28,13364,3335682.888888889,501.0,477.2857142857143,0,0,0.0,0.0,0.0
218260.0,17,2,180,1,90,0.0,90.0,90.0,1,90,0.0,90.0,90.0
24926.0,6,10,2032,5,524,5358.75,252.0,104.8,5,1508,5331.5,1236.0,301.6
99440446.0,17,17,5822,16,5472,5318453.6,342.0,342.0,1,350,0.0,350.0,350.0
143877.0,17,2,180,1,90,0.0,90.0,90.0,1,90,0.0,90.0,90.0
4366.0,17,2,614,1,72,0.0,72.0,72.0,1,542,0.0,542.0,542.0
119095927.0,6,240,27104,120,8216,994036.0084033612,140.0,68.46666666666667,120,18888,993730.6722689077,284.0,157.4
0.0,6,1,66,1,66,0.0,66.0,66.0,0,0,0.0,0.0,0.0
344.0,17,2,174,1,79,0.0,79.0,79.0,1,95,0.0,95.0,95.0
3346184.0,6,3,1602,1,752,0.0,752.0,752.0,2,850,0.0,784.0,425.0
33398.0,6,14,4740,7,653,5457.666666666667,249.0,93.28571428571428,7,4087,5429.833333333333,1514.0,583.8571428571429
219070.0,6,3,426,2,280,0.0,214.0,140.0,1,146,0.0,146.0,146.0
2795602.0,6,2,132,1,66,0.0,66.0,66.0,1,66,0.0,66.0,66.0
5628288.0,6,5,336,2,134,0.0,68.0,67.0,3,202,1423262.0,70.0,67.33333333333333
301797.0,6,6,412,4,272,100599.0,74.0,68.0,2,140,0.0,74.0,70.0
277517.0,6,12,1373,7,714,46252.833333333336,298.0,102.0,5,659,65063.5,379.0,131.8
819.0,17,4,438,2,148,0.0,74.0,74.0,2,290,0.0,147.0,145.0
138809.0,6,2,132,1,66,0.0,66.0,66.0,1,66,0.0,66.0,66.0
56343.0,6,14,4740,7,653,9271.333333333334,249.0,93.28571428571428,7,4087,8397.333333333334,1514.0,583.8571428571429
27418942.0,17,5,1710,5,1710,6854735.5,342.0,342.0,0,0,0.0,0.0,0.0
216518.0,17,2,180,1,90,0.0,90.0,90.0,1,90,0.0,90.0,90.0
5989.0,17,2,447,1,84,0.0,84.0,84.0,1,363,0.0,363.0,363.0
103443.0,17,2,286,2,286,0.0,143.0,143.0,0,0,0.0,0.0,0.0
302329.0,6,6,412,4,272,100776.33333333331,74.0,68.0,2,140,0.0,74.0,70.0
42684.0,6,14,4740,7,653,6937.833333333333,249.0,93.28571428571428,7,4087,6719.0,1514.0,583.8571428571429
322558.0,17,4,1400,4,1400,107519.33333333331,350.0,350.0,0,0,0.0,0.0,0.0
135133910.0,17,6,1146,6,1146,27026782.0,191.0,191.0,0,0,0.0,0.0,0.0
322060.0,17,4,1400,4,1400,107353.33333333331,350.0,350.0,0,0,0.0,0.0,0.0
90527632.0,6,14,2240,8,1016,12932518.857142856,188.0,127.0,6,1224,18073120.6,204.0,204.0
111201658.0,6,35,2542,18,1348,6528580.94117647,139.0,74.88888888888889,17,1194,6936617.3125,123.0,70.23529411764706
101900.0,17,4,1400,4,1400,33966.666666666664,350.0,350.0,0,0,0.0,0.0,0.0
108136953.0,6,27,1800,14,894,8318227.153846154,123.0,63.85714285714285,13,906,8161335.25,123.0,69.6923076923077
116123563.0,6,46,3844,26,2143,4636767.6,139.0,82.42307692307692,20,1701,6101010.421052632,123.0,85.05
7138.0,17,2,582,1,83,0.0,83.0,83.0,1,499,0.0,499.0,499.0
146099.0,6,3,337,2,214,0.0,160.0,107.0,1,123,0.0,123.0,123.0
0.0,17,1,44,1,44,0.0,44.0,44.0,0,0,0.0,0.0,0.0
315003.0,17,4,1400,4,1400,105001.0,350.0,350.0,0,0,0.0,0.0,0.0
298824.0,6,6,412,4,272,99608.0,74.0,68.0,2,140,0.0,74.0,70.0
9865.0,17,2,582,1,83,0.0,83.0,83.0,1,499,0.0,499.0,499.0
205951.0,6,3,426,2,280,0.0,214.0,140.0,1,146,0.0,146.0,146.0
355462.0,17,2,608,1,75,0.0,75.0,75.0,1,533,0.0,533.0,533.0
16880.0,17,2,180,1,90,0.0,90.0,90.0,1,90,0.0,90.0,90.0
119036308.0,6,48,3168,24,1584,5175491.652173913,66.0,66.0,24,1584,5166093.478260869,66.0,66.0
297185.0,6,6,412,4,272,99061.66666666669,74.0,68.0,2,140,0.0,74.0,70.0
108174704.0,17,14,864,7,432,18000455.833333332,174.0,61.71428571428572,7,432,18000201.333333332,174.0,61.71428571428572
106142316.0,6,213,23934,107,7284,1001342.6037735848,140.0,68.07476635514018,106,16650,1001003.8857142857,284.0,157.0754716981132
34610.0,6,14,4740,7,653,5029.833333333333,249.0,93.28571428571428,7,4087,5608.666666666667,1514.0,583.8571428571429
2059.0,17,4,344,2,150,0.0,75.0,75.0,2,194,0.0,103.0,97.0
249969.0,6,3,337,2,214,0.0,160.0,107.0,1,123,0.0,123.0,123.0
139976.0,6,2,132,1,66,0.0,66.0,66.0,1,66,0.0,66.0,66.0
9456.0,17,2,539,1,86,0.0,86.0,86.0,1,453,0.0,453.0,453.0
90303565.0,6,16,1192,8,596,12893754.142857144,95.0,74.5,8,596,12898974.42857143,95.0,74.5
20474.0,6,11,2098,6,590,2985.2,252.0,98.33333333333331,5,1508,4362.5,1236.0,301.6
228320.0,17,2,180,1,90,0.0,90.0,90.0,1,90,0.0,90.0,90.0
135135253.0,17,6,1146,6,1146,27027050.6,191.0,191.0,0,0,0.0,0.0,0.0
114307.0,17,4,1400,4,1400,38102.333333333336,350.0,350.0,0,0,0.0,0.0,0.0
63567.0,6,14,4740,7,653,9473.166666666666,249.0,93.28571428571428,7,4087,9945.166666666666,1514.0,583.8571428571429
1510.0,17,2,762,2,762,0.0,381.0,381.0,0,0,0.0,0.0,0.0
46588.0,6,14,4740,7,653,6718.333333333333,249.0,93.28571428571428,7,4087,6767.0,1514.0,583.8571428571429
5831242.0,6,5,336,2,134,0.0,68.0,67.0,3,202,1519121.5,70.0,67.33333333333333
102892.0,17,2,286,2,286,0.0,143.0,143.0,0,0,0.0,0.0,0.0
90526602.0,6,14,2240,8,1016,12932371.714285716,188.0,127.0,6,1224,18072628.6,204.0,204.0
214766.0,6,4,492,2,280,0.0,214.0,140.0,2,212,0.0,146.0,106.0
120563.0,6,3,337,2,214,0.0,160.0,107.0,1,123,0.0,123.0,123.0
1022015.0,6,11,1134,6,558,204403.0,220.0,93.0,5,576,254914.0,304.0,115.2
204252.0,17,4,6056,4,6056,68084.0,1514.0,1514.0,0,0,0.0,0.0,0.0
211398.0,6,10,1221,6,636,42279.6,298.0,106.0,4,585,69342.33333333333,379.0,146.25
108096653.0,17,5,955,5,955,27024163.25,191.0,191.0,0,0,0.0,0.0,0.0
90870933.0,6,22,1680,12,935,8256504.181818182,95.0,77.91666666666667,10,745,10064619.777777778,95.0,74.5
48776.0,6,14,4740,7,653,7944.0,249.0,93.28571428571428,7,4087,7732.333333333333,1514.0,583.8571428571429
108109766.0,17,5,955,5,955,27027441.5,191.0,191.0,0,0,0.0,0.0,0.0
117758736.0,6,711,127606,353,23816,334537.4346590909,214.0,67.46742209631728,358,103790,329801.7899159664,1514.0,289.91620111731845
2802684.0,6,2,132,1,66,0.0,66.0,66.0,1,66,0.0,66.0,66.0
65387.0,6,10,2032,5,524,15940.25,252.0,104.8,5,1508,12784.0,1236.0,301.6
20427.0,6,10,2032,5,524,4632.0,252.0,104.8,5,1508,4082.25,1236.0,301.6
38631.0,6,14,4740,7,653,6260.666666666667,249.0,93.28571428571428,7,4087,6283.5,1514.0,583.8571428571429
232917.0,6,3,373,2,238,0.0,172.0,119.0,1,135,0.0,135.0,135.0
298894.0,6,6,412,4,272,99631.33333333331,74.0,68.0,2,140,0.0,74.0,70.0
285215.0,17,2,876,2,876,0.0,438.0,438.0,0,0,0.0,0.0,0.0
232362.0,6,3,337,2,214,0.0,160.0,107.0,1,123,0.0,123.0,123.0
319427.0,17,4,1400,4,1400,106475.66666666669,350.0,350.0,0,0,0.0,0.0,0.0
120227451.0,6,27,2032,13,989,9999382.583333334,95.0,76.07692307692308,14,1043,9229995.23076923,95.0,74.5
313772.0,6,6,412,4,272,104590.66666666669,74.0,68.0,2,140,0.0,74.0,70.0
243739.0,6,3,373,2,238,0.0,172.0,119.0,1,135,0.0,135.0,135.0
5020637.0,17,4,414,2,152,0.0,76.0,76.0,2,262,0.0,170.0,131.0
300057.0,6,6,412,4,272,100019.0,74.0,68.0,2,140,0.0,74.0,70.0
362749.0,6,11,1021,6,444,48798.0,162.0,74.0,5,577,60769.5,349.0,115.4
301855.0,6,6,412,4,272,100618.33333333331,74.0,68.0,2,140,0.0,74.0,70.0
2586814.0,6,2,132,1,66,0.0,66.0,66.0,1,66,0.0,66.0,66.0
153454.0,17,2,180,1,90,0.0,90.0,90.0,1,90,0.0,90.0,90.0
44037.0,6,14,4740,7,653,6685.166666666667,249.0,93.28571428571428,7,4087,6790.5,1514.0,583.8571428571429
2782640.0,6,2,132,1,66,0.0,66.0,66.0,1,66,0.0,66.0,66.0
19635.0,6,10,2032,5,524,4692.75,252.0,104.8,5,1508,4579.25,1236.0,301.6
505632.0,6,5,336,2,134,0.0,68.0,67.0,3,202,195408.0,70.0,67.33333333333333
12635.0,6,10,1065,5,534,2659.0,262.0,106.8,5,531,2885.0,259.0,106.2
209291.0,17,2,762,2,762,0.0,381.0,381.0,0,0,0.0,0.0,0.0
90282922.0,6,16,1192,8,596,12891475.857142856,95.0,74.5,8,596,12896766.714285716,95.0,74.5
197147.0,17,2,180,1,90,0.0,90.0,90.0,1,90,0.0,90.0,90.0
107581.0,17,2,286,2,286,0.0,143.0,143.0,0,0,0.0,0.0,0.0
1039178.0,6,11,1134,6,558,207835.6,220.0,93.0,5,576,258109.0,304.0,115.2
143923.0,17,2,180,1,90,0.0,90.0,90.0,1,90,0.0,90.0,90.0
118699878.0,6,38,2842,19,1371,6594437.666666667,123.0,72.15789473684211,19,1471,6155403.666666667,139.0,77.42105263157895
119996774.0,6,17,1287,9,691,14999596.75,95.0,76.77777777777777,8,596,17105355.285714287,95.0,74.5
313523.0,17,4,1400,4,1400,104507.66666666669,350.0,350.0,0,0,0.0,0.0,0.0
247360.0,17,4,6056,4,6056,82453.33333333333,1514.0,1514.0,0,0,0.0,0.0,0.0
105547167.0,6,44,2904,22,1452,5026055.571428572,66.0,66.0,22,1452,5012931.904761905,66.0,66.0
95805479.0,17,14,4796,13,4446,6229147.0,342.0,342.0,1,350,0.0,350.0,350.0
35188.0,6,14,4740,7,653,5127.0,249.0,93.28571428571428,7,4087,5087.5,1514.0,583.8571428571429
252550.0,17,4,6056,4,6056,84183.33333333333,1514.0,1514.0,0,0,0.0,0.0,0.0
281647.0,17,2,363,1,79,0.0,79.0,79.0,1,284,0.0,284.0,284.0
395196.0,6,10,1102,5,570,98461.25,298.0,114.0,5,532,81421.25,260.0,106.4
1214284.0,6,13,3000,8,2372,173469.14285714287,1514.0,296.5,5,628,235400.25,331.0,125.6
1307784.0,6,4,264,2,132,0.0,66.0,66.0,2,132,0.0,66.0,66.0
2451.0,17,4,344,2,150,0.0,75.0,75.0,2,194,0.0,103.0,97.0
14650788.0,6,20,1648,10,1016,1593382.6666666667,315.0,101.6,10,632,1593358.888888889,78.0,63.2
1062.0,17,2,762,2,762,0.0,381.0,381.0,0,0,0.0,0.0,0.0
47712000.0,6,8,1940,3,887,22602027.5,753.0,295.6666666666667,5,1053,11256315.0,785.0,210.6
31875.0,6,14,4740,7,653,4579.166666666667,249.0,93.28571428571428,7,4087,5174.5,1514.0,583.8571428571429
15333.0,6,14,4740,7,653,2437.5,249.0,93.28571428571428,7,4087,2425.1666666666665,1514.0,583.8571428571429
297889.0,6,6,412,4,272,99296.33333333331,74.0,68.0,2,140,0.0,74.0,70.0
228278.0,17,2,180,1,90,0.0,90.0,90.0,1,90,0.0,90.0,90.0
91184363.0,6,21,1626,11,881,9111254.8,95.0,80.0909090909091,10,745,10100034.444444444,95.0,74.5
104560.0,17,2,286,2,286,0.0,143.0,143.0,0,0,0.0,0.0,0.0
196855.0,17,2,180,1,90,0.0,90.0,90.0,1,90,0.0,90.0,90.0
119864114.0,6,14,2102,5,1020,29964478.5,204.0,204.0,9,1082,14982867.875,188.0,120.22222222222224
16475.0,6,11,1133,6,602,2719.8,264.0,100.33333333333331,5,531,3747.0,259.0,106.2
109248237.0,17,15,1169,8,606,15606891.0,174.0,75.75,7,563,17326007.833333332,174.0,80.42857142857143
102215224.0,6,176,19872,88,13842,1172413.1724137932,284.0,157.29545454545453,88,6030,1172412.5057471264,140.0,68.52272727272727
284805.0,17,2,363,1,79,0.0,79.0,79.0,1,284,0.0,284.0,284.0
103390.0,17,2,286,2,286,0.0,143.0,143.0,0,0,0.0,0.0,0.0
297878.0,6,6,412,4,272,99292.66666666669,74.0,68.0,2,140,0.0,74.0,70.0
77281.0,6,14,4740,7,653,11782.0,249.0,93.28571428571428,7,4087,12178.833333333334,1514.0,583.8571428571429
92847211.0,6,40,2640,20,1320,4886695.315789473,66.0,66.0,20,1320,4873255.263157895,66.0,66.0
27715.0,6,14,4740,7,653,4140.166666666667,249.0,93.28571428571428,7,4087,4292.333333333333,1514.0,583.8571428571429
155379.0,6,3,337,2,214,0.0,160.0,107.0,1,123,0.0,123.0,123.0
2794173.0,6,2,132,1,66,0.0,66.0,66.0,1,66,0.0,66.0,66.0
240350.0,17,2,180,1,90,0.0,90.0,90.0,1,90,0.0,90.0,90.0
111396054.0,6,31,2182,16,1165,7412008.733333333,139.0,72.8125,15,1017,7941443.857142857,123.0,67.8
207562.0,6,3,426,2,280,0.0,214.0,140.0,1,146,0.0,146.0,146.0
320897.0,17,4,1400,4,1400,106965.66666666669,350.0,350.0,0,0,0.0,0.0,0.0
50747.0,6,14,4740,7,653,8309.333333333334,249.0,93.28571428571428,7,4087,7187.0,1514.0,583.8571428571429
15919.0,6,14,4740,7,653,2495.6666666666665,249.0,93.28571428571428,7,4087,2436.833333333333,1514.0,583.8571428571429
205815.0,17,2,180,1,90,0.0,90.0,90.0,1,90,0.0,90.0,90.0
90015541.0,17,28,13364,28,13364,3333908.925925926,501.0,477.2857142857143,0,0,0.0,0.0,0.0
313273.0,17,4,1400,4,1400,104424.33333333331,350.0,350.0,0,0,0.0,0.0,0.0
90261113.0,6,12,1832,8,1016,12894444.714285716,188.0,127.0,4,816,30031262.33333333,204.0,204.0
2287.0,17,4,344,2,150,0.0,75.0,75.0,2,194,0.0,103.0,97.0
110577321.0,17,14,864,7,432,18334538.166666668,174.0,61.71428571428572,7,432,18333547.0,174.0,61.71428571428572
107234.0,17,2,286,2,286,0.0,143.0,143.0,0,0,0.0,0.0,0.0
386771.0,6,3,202,2,128,0.0,74.0,64.0,1,74,0.0,74.0,74.0
31592.000000000004,6,10,2032,5,524,7677.75,252.0,104.8,5,1508,6459.0,1236.0,301.6
144898.0,17,2,180,1,70,0.0,70.0,70.0,1,110,0.0,110.0,110.0
104336096.0,6,28,1860,14,966,8009250.538461538,123.0,69.0,14,894,8009251.0,123.0,63.85714285714285
40410.0,6,14,4740,7,653,6579.166666666667,249.0,93.28571428571428,7,4087,6521.166666666667,1514.0,583.8571428571429
121394942.0,6,35,2473,18,1348,7140878.94117647,139.0,74.88888888888889,17,1125,7417922.875,123.0,66.17647058823529
108098334.0,17,5,1005,5,1005,27024583.5,201.0,201.0,0,0,0.0,0.0,0.0
114200215.0,6,48,3168,24,1584,4965226.739130435,66.0,66.0,24,1584,4953377.043478261,66.0,66.0
23181.0,17,2,582,1,83,0.0,83.0,83.0,1,499,0.0,499.0,499.0
16164.000000000002,6,10,2032,5,524,3823.75,252.0,104.8,5,1508,3692.25,1236.0,301.6
21556.0,6,10,2032,5,524,5166.75,252.0,104.8,5,1508,4533.0,1236.0,301.6
117744151.0,6,216,24504,108,17080,1098389.2056074766,300.0,158.14814814814815,108,7424,1098389.3457943923,140.0,68.74074074074075
106637.0,17,2,286,2,286,0.0,143.0,143.0,0,0,0.0,0.0,0.0
82210.0,6,10,2032,5,524,20310.75,252.0,104.8,5,1508,19461.0,1236.0,301.6
1753.0,17,2,664,1,322,0.0,322.0,322.0,1,342,0.0,342.0,342.0
321809.0,17,4,1400,4,1400,107269.66666666669,350.0,350.0,0,0,0.0,0.0,0.0
58482.0,6,14,4740,7,653,9615.666666666666,249.0,93.28571428571428,7,4087,6832.166666666667,1514.0,583.8571428571429
105585751.0,6,44,2904,22,1452,5027892.904761905,66.0,66.0,22,1452,5013550.761904762,66.0,66.0
239787.0,6,3,337,2,214,0.0,160.0,107.0,1,123,0.0,123.0,123.0
1809.0,17,2,176,1,80,0.0,80.0,80.0,1,96,0.0,96.0,96.0
213501.0,6,10,1221,6,636,42700.2,298.0,106.0,4,585,69987.66666666667,379.0,146.25
205873.0,17,2,762,2,762,0.0,381.0,381.0,0,0,0.0,0.0,0.0
103430.0,17,2,286,2,286,0.0,143.0,143.0,0,0,0.0,0.0,0.0
3012311.0,6,12,2172,7,664,501941.1666666667,252.0,94.85714285714286,5,1508,2929.0,1236.0,301.6
200197.0,17,4,6056,4,6056,66732.33333333333,1514.0,1514.0,0,0,0.0,0.0,0.0
580.0,17,2,508,2,508,0.0,257.0,254.0,0,0,0.0,0.0,0.0
307175.0,6,6,412,4,272,102391.66666666669,74.0,68.0,2,140,0.0,74.0,70.0
103567.0,6,2,132,1,66,0.0,66.0,66.0,1,66,0.0,66.0,66.0
196922.0,17,2,180,1,90,0.0,90.0,90.0,1,90,0.0,90.0,90.0
103601.0,17,2,286,2,286,0.0,143.0,143.0,0,0,0.0,0.0,0.0
310006.0,17,4,1400,4,1400,103335.33333333331,350.0,350.0,0,0,0.0,0.0,0.0
2300.0,17,4,344,2,150,0.0,75.0,75.0,2,194,0.0,103.0,97.0
120111250.0,6,14,2240,8,1016,17135752.14285714,188.0,127.0,6,1224,18011697.2,204.0,204.0
126564251.0,17,14,864,7,432,17833495.666666668,174.0,61.71428571428572,7,432,17834457.333333332,174.0,61.71428571428572
162338.0,17,2,180,1,90,0.0,90.0,90.0,1,90,0.0,90.0,90.0
90044376.0,17,28,13364,28,13364,3334976.888888889,501.0,477.2857142857143,0,0,0.0,0.0,0.0
108107360.0,17,5,955,5,955,27026840.0,191.0,191.0,0,0,0.0,0.0,0.0
437870.0,6,11,1021,6,444,58761.6,162.0,74.0,5,577,73373.25,349.0,115.4
9290581.0,17,4,1376,3,1026,938407.0,342.0,342.0,1,350,0.0,350.0,350.0
2850814.0,6,3,204,1,68,0.0,68.0,68.0,2,136,0.0,70.0,68.0
146374.0,6,3,337,2,214,0.0,160.0,107.0,1,123,0.0,123.0,123.0
10476689.0,6,7,478,4,272,3445129.0,74.0,68.0,3,206,5167614.5,74.0,68.66666666666667
2856.0,17,4,438,2,148,0.0,74.0,74.0,2,290,0.0,147.0,145.0
24070789.0,17,3,1034,2,684,0.0,342.0,342.0,1,350,0.0,350.0,350.0
6090.0,17,4,344,2,150,0.0,75.0,75.0,2,194,0.0,103.0,97.0
126027138.0,6,33,2359,16,1071,7884965.2,123.0,66.9375,17,1288,7252672.0,139.0,75.76470588235294
228265.0,17,2,180,1,90,0.0,90.0,90.0,1,90,0.0,90.0,90.0
30519.0,6,10,2032,5,524,7414.0,252.0,104.8,5,1508,7128.0,1236.0,301.6
111854150.0,6,30,1974,15,1026,7974151.071428572,123.0,68.4,15,948,7974165.357142857,123.0,63.2
13852.0,6,11,1132,6,556,2407.4,218.0,92.66666666666669,5,576,2937.0,304.0,115.2
197348.0,17,2,180,1,90,0.0,90.0,90.0,1,90,0.0,90.0,90.0
503.0,17,2,508,2,508,0.0,257.0,254.0,0,0,0.0,0.0,0.0
3109650.0,6,2,132,1,66,0.0,66.0,66.0,1,66,0.0,66.0,66.0
120047079.0,17,28,13364,28,13364,4446188.111111111,501.0,477.2857142857143,0,0,0.0,0.0,0.0
17225.0,6,11,1132,6,556,3445.0,218.0,92.66666666666669,5,576,3479.0,304.0,115.2
115510444.0,6,30,1990,15,1042,8236142.428571428,139.0,69.46666666666667,15,948,8236136.285714285,123.0,63.2
122009872.0,17,14,1126,8,606,17429981.714285713,174.0,75.75,6,520,16600166.0,174.0,86.66666666666667
38721.0,6,14,4740,7,653,6300.833333333333,249.0,93.28571428571428,7,4087,5845.5,1514.0,583.8571428571429
120038402.0,17,28,13364,28,13364,4445866.740740741,501.0,477.2857142857143,0,0,0.0,0.0,0.0
1312239.0,6,4,264,2,132,0.0,66.0,66.0,2,132,0.0,66.0,66.0
303915.0,6,6,412,4,272,101305.0,74.0,68.0,2,140,0.0,74.0,70.0
10347.0,6,11,1133,6,602,1763.6,264.0,100.33333333333331,5,531,2396.25,259.0,106.2
503801.00000000006,6,5,336,2,134,0.0,68.0,67.0,3,202,194965.0,70.0,67.33333333333333
240083.0,6,3,337,2,214,0.0,160.0,107.0,1,123,0.0,123.0,123.0
91201621.0,6,297,34698,149,24708,616227.1689189189,284.0,165.8255033557047,148,9990,613322.619047619,140.0,67.5
311804.0,6,3,202,2,128,0.0,74.0,64.0,1,74,0.0,74.0,74.0
149014010.0,6,21,1585,10,745,13256078.111111112,95.0,74.5,11,840,14879789.2,95.0,76.36363636363636
90256859.0,6,12,1832,8,1016,12893837.0,188.0,127.0,4,816,30030811.33333333,204.0,204.0
209441.0,17,2,180,1,90,0.0,90.0,90.0,1,90,0.0,90.0,90.0
528386.0,17,6,2100,6,2100,105677.2,350.0,350.0,0,0,0.0,0.0,0.0
29007.0,6,14,4740,7,653,4637.666666666667,249.0,93.28571428571428,7,4087,4696.333333333333,1514.0,583.8571428571429
705.0,17,4,438,2,148,0.0,74.0,74.0,2,290,0.0,147.0,145.0
308.0,17,2,174,1,79,0.0,79.0,79.0,1,95,0.0,95.0,95.0
137831647.0,17,15,907,7,432,19666906.5,174.0,61.71428571428572,8,475,19572760.71428572,174.0,59.375
153363.0,17,2,180,1,90,0.0,90.0,90.0,1,90,0.0,90.0,90.0
2085405.0,6,25,7611,13,2516,173783.75,1034.0,193.53846153846155,12,5095,161702.36363636365,1510.0,424.5833333333333
14638599.0,6,20,1607,10,975,1592938.0,315.0,97.5,10,632,1592934.7777777778,78.0,63.2
90558994.0,17,12,778,6,389,18001065.8,174.0,64.83333333333333,6,389,17800162.0,174.0,64.83333333333333
90787207.0,6,22,1680,12,894,8248792.181818182,95.0,74.5,10,786,10084599.222222222,95.0,78.6
108106689.0,17,5,955,5,955,27026672.25,191.0,191.0,0,0,0.0,0.0,0.0
1321518.0,6,4,264,2,132,0.0,66.0,66.0,2,132,0.0,66.0,66.0
94056730.0,6,214,24646,107,17362,885297.8962264151,464.0,162.26168224299064,107,7284,885296.962264151,140.0,68.07476635514018
256977.0,6,3,337,2,214,0.0,160.0,107.0,1,123,0.0,123.0,123.0
307796.0,6,6,412,4,272,102598.66666666669,74.0,68.0,2,140,0.0,74.0,70.0
115057454.0,6,48,3168,24,1584,5002498.0,66.0,66.0,24,1584,4989074.0,66.0,66.0
304479.0,6,6,412,4,272,101493.0,74.0,68.0,2,140,0.0,74.0,70.0
298.0,17,2,164,1,82,0.0,82.0,82.0,1,82,0.0,82.0,82.0
26944798.0,17,5,1710,5,1710,6736199.5,342.0,342.0,0,0,0.0,0.0,0.0
139010.0,6,2,132,1,66,0.0,66.0,66.0,1,66,0.0,66.0,66.0
4371.0,17,2,180,1,90,0.0,90.0,90.0,1,90,0.0,90.0,90.0
61184.0,6,14,4740,7,653,9962.833333333334,249.0,93.28571428571428,7,4087,8909.5,1514.0,583.8571428571429
145388.0,17,2,180,1,70,0.0,70.0,70.0,1,110,0.0,110.0,110.0
295199.0,17,2,246,1,76,0.0,76.0,76.0,1,170,0.0,170.0,170.0
14540104.0,6,20,1648,10,1016,1581590.0,315.0,101.6,10,632,1581623.6666666667,78.0,63.2
59633.0,6,14,4740,7,653,9552.666666666666,249.0,93.28571428571428,7,4087,9349.5,1514.0,583.8571428571429
2276906.0,6,49,23728,25,19797,94871.08333333331,1514.0,791.88,24,3931,89705.78260869565,1514.0,163.79166666666666
60174.0,6,10,2032,5,524,14783.0,252.0,104.8,5,1508,13444.5,1236.0,301.6
231960.0,6,10,1221,6,636,46392.0,298.0,106.0,4,585,75705.66666666667,379.0,146.25
143424.0,6,2,132,1,66,0.0,66.0,66.0,1,66,0.0,66.0,66.0
299219.0,6,6,412,4,272,99739.66666666669,74.0,68.0,2,140,0.0,74.0,70.0
11149.0,6,10,1067,5,536,2564.0,264.0,107.2,5,531,2341.5,259.0,106.2
120227251.0,6,380,44534,190,12762,631825.5608465609,140.0,67.16842105263157,190,31772,626333.6613756614,284.0,167.22105263157894
1814.0,17,2,508,2,508,0.0,257.0,254.0,0,0,0.0,0.0,0.0
135135241.0,17,6,1206,6,1206,27027048.2,201.0,201.0,0,0,0.0,0.0,0.0
405240.0,6,3,1604,2,851,0.0,785.0,425.5,1,753,0.0,753.0,753.0
10463469.0,6,7,478,4,272,3440985.6666666665,74.0,68.0,3,206,5161384.0,74.0,68.66666666666667
52962.0,6,14,4740,7,653,8392.666666666666,249.0,93.28571428571428,7,4087,7535.0,1514.0,583.8571428571429
313748.0,17,4,622,4,622,104582.66666666669,163.0,155.5,0,0,0.0,0.0,0.0
104876132.0,17,13,1083,7,563,17334752.0,174.0,80.42857142857143,6,520,17000164.2,174.0,86.66666666666667
120121359.0,6,15,2444,7,1428,20020226.5,204.0,204.0,8,1016,17137042.0,188.0,127.0
108105198.0,17,5,955,5,955,27026299.5,191.0,191.0,0,0,0.0,0.0,0.0
120123266.0,6,17,2344,9,1284,15015408.25,204.0,142.66666666666666,8,1060,12964043.142857144,199.0,132.5
122975329.0,6,48,3168,24,1584,5132954.217391305,66.0,66.0,24,1584,5134135.304347826,66.0,66.0
135137299.0,17,6,1206,6,1206,27027459.8,201.0,201.0,0,0,0.0,0.0,0.0
119946783.0,6,36,2580,18,1248,7055665.352941177,123.0,69.33333333333333,18,1332,6990468.764705882,123.0,74.0
231525.0,6,3,426,2,280,0.0,214.0,140.0,1,146,0.0,146.0,146.0
12080.0,6,11,1131,6,600,2185.2,262.0,100.0,5,531,2675.5,259.0,106.2
5003099.0,17,4,849,2,166,0.0,83.0,83.0,2,683,0.0,499.0,341.5
307792.0,6,6,412,4,272,102597.33333333331,74.0,68.0,2,140,0.0,74.0,70.0
39920.0,6,10,2032,5,524,9755.25,252.0,104.8,5,1508,8259.25,1236.0,301.6
10475947.0,6,7,478,4,272,3446218.333333333,74.0,68.0,3,206,5169223.5,74.0,68.66666666666667
123647754.0,6,48,3168,24,1584,5113909.739130435,66.0,66.0,24,1584,5175500.608695652,66.0,66.0
111119036.0,6,32,2220,16,1071,7407935.733333333,123.0,66.9375,16,1149,6727859.133333334,123.0,71.8125
143928.0,17,2,180,1,90,0.0,90.0,90.0,1,90,0.0,90.0,90.0
298928.0,6,6,412,4,272,99642.66666666669,74.0,68.0,2,140,0.0,74.0,70.0
146121.0,6,3,337,2,214,0.0,160.0,107.0,1,123,0.0,123.0,123.0
90186100.0,6,204,22958,102,16004,890801.3564356435,374.0,156.90196078431373,102,6954,890801.1089108911,140.0,68.17647058823529
219689.0,17,2,180,1,90,0.0,90.0,90.0,1,90,0.0,90.0,90.0
44672.0,6,14,4740,7,653,7265.333333333333,249.0,93.28571428571428,7,4087,6319.833333333333,1514.0,583.8571428571429
108713.0,17,2,286,2,286,0.0,143.0,143.0,0,0,0.0,0.0,0.0
90096368.0,6,10,1440,7,828,15016061.333333334,188.0,118.28571428571428,3,612,30029324.0,204.0,204.0
101183341.0,17,14,864,7,432,16833490.666666668,174.0,61.71428571428572,7,432,16834532.0,174.0,61.71428571428572
135133066.0,17,6,1206,6,1206,27026613.2,201.0,201.0,0,0,0.0,0.0,0.0
205879.0,6,3,426,2,280,0.0,214.0,140.0,1,146,0.0,146.0,146.0
111096.0,17,2,286,2,286,0.0,143.0,143.0,0,0,0.0,0.0,0.0
90021406.0,17,28,13364,28,13364,3334126.1481481483,501.0,477.2857142857143,0,0,0.0,0.0,0.0
1243402.0,6,7,499,4,301,403479.3333333333,103.0,75.25,3,198,613451.0,66.0,66.0
90256556.0,6,12,1832,8,1016,12893793.714285716,188.0,127.0,4,816,30030614.666666668,204.0,204.0
32680357.0,6,5,336,2,134,0.0,68.0,67.0,3,202,14939130.0,70.0,67.33333333333333
395727.0,6,10,1221,6,636,79145.4,298.0,106.0,4,585,130525.0,379.0,146.25
302442.0,6,2,132,1,66,0.0,66.0,66.0,1,66,0.0,66.0,66.0
3023347.0,6,12,2172,7,664,502181.8333333333,252.0,94.85714285714286,5,1508,5526.25,1236.0,301.6
57652.0,6,10,1066,5,490,11688.5,218.0,98.0,5,576,14018.25,304.0,115.2
90032242.0,17,27,12943,27,12943,3462778.5384615385,501.0,479.3703703703704,0,0,0.0,0.0,0.0
14642706.0,6,20,1607,10,975,1592836.3333333333,315.0,97.5,10,632,1592811.0,78.0,63.2
2794874.0,6,2,132,1,66,0.0,66.0,66.0,1,66,0.0,66.0,66.0
97539.0,17,2,762,2,762,0.0,381.0,381.0,0,0,0.0,0.0,0.0
112960.0,6,15,4806,8,719,15763.57142857143,249.0,89.875,7,4087,18269.666666666668,1514.0,583.8571428571429
218095.0,6,3,426,2,280,0.0,214.0,140.0,1,146,0.0,146.0,146.0
1308215.0,6,4,264,2,132,0.0,66.0,66.0,2,132,0.0,66.0,66.0
3004906.0,6,12,2172,7,664,500726.3333333333,252.0,94.85714285714286,5,1508,1946.5,1236.0,301.6
29702.0,6,10,1066,5,490,4540.5,218.0,98.0,5,576,7116.75,304.0,115.2
204748.0,17,2,762,2,762,0.0,381.0,381.0,0,0,0.0,0.0,0.0
10437928.0,6,7,499,4,301,3402247.333333333,103.0,75.25,3,198,4098604.000000001,66.0,66.0
1427831.0,17,16,1120,16,1120,95188.73333333334,70.0,70.0,0,0,0.0,0.0,0.0
153311.0,17,2,180,1,90,0.0,90.0,90.0,1,90,0.0,90.0,90.0
205705.0,6,3,426,2,280,0.0,214.0,140.0,1,146,0.0,146.0,146.0
93069228.0,6,25,1702,13,840,7755769.0,123.0,64.61538461538461,12,862,8138262.636363637,139.0,71.83333333333333
10463522.0,6,7,478,4,272,3442478.0,74.0,68.0,3,206,5163582.0,74.0,68.66666666666667
241928.0,6,3,337,2,214,0.0,160.0,107.0,1,123,0.0,123.0,123.0
32447.0,6,14,4740,7,653,5287.166666666667,249.0,93.28571428571428,7,4087,5215.666666666667,1514.0,583.8571428571429
97294.0,6,14,4740,7,653,15244.0,249.0,93.28571428571428,7,4087,15854.5,1514.0,583.8571428571429
6862.0,17,2,582,1,83,0.0,83.0,83.0,1,499,0.0,499.0,499.0
0.0,17,1,453,1,453,0.0,453.0,453.0,0,0,0.0,0.0,0.0
108105154.0,17,5,1005,5,1005,27026288.5,201.0,201.0,0,0,0.0,0.0,0.0
12676.0,6,11,2098,6,590,2400.6,252.0,98.33333333333331,5,1508,2560.0,1236.0,301.6
100586402.0,17,12,778,6,389,20001313.8,174.0,64.83333333333333,6,389,20000144.8,174.0,64.83333333333333
40109.0,6,14,4740,7,653,6287.166666666667,249.0,93.28571428571428,7,4087,6411.833333333333,1514.0,583.8571428571429
108132546.0,17,5,955,5,955,27033136.5,191.0,191.0,0,0,0.0,0.0,0.0
59399.0,6,14,4740,7,653,9777.0,249.0,93.28571428571428,7,4087,8610.166666666666,1514.0,583.8571428571429
8946312.0,6,31,10017,16,2754,579984.3333333334,408.0,172.125,15,7263,617264.5714285715,1514.0,484.2
10489434.0,6,6,412,3,206,5174516.5,74.0,68.66666666666667,3,206,5174403.0,74.0,68.66666666666667
838416.0,6,9,1118,6,586,167683.2,248.0,97.66666666666669,3,532,281269.0,392.0,177.33333333333334
44951223.0,6,8,1940,3,887,22459655.5,753.0,295.6666666666667,5,1053,10536563.0,785.0,210.6
43805.0,6,14,4740,7,653,7167.5,249.0,93.28571428571428,7,4087,6875.0,1514.0,583.8571428571429
80.0,17,2,762,2,762,0.0,381.0,381.0,0,0,0.0,0.0,0.0
90039830.0,17,27,12943,27,12943,3463070.3846153845,501.0,479.3703703703704,0,0,0.0,0.0,0.0
122314538.0,6,48,3168,24,1584,5185258.565217392,66.0,66.0,24,1584,5022492.347826087,66.0,66.0
93112220.0,6,38,2508,19,1254,5155445.5,66.0,66.0,19,1254,5155445.888888889,66.0,66.0
88091.0,6,14,4740,7,653,12891.0,249.0,93.28571428571428,7,4087,14385.166666666666,1514.0,583.8571428571429
103407.0,17,2,286,2,286,0.0,143.0,143.0,0,0,0.0,0.0,0.0
2434.0,17,4,344,2,150,0.0,75.0,75.0,2,194,0.0,103.0,97.0
56417.0,6,14,4740,7,653,7670.166666666667,249.0,93.28571428571428,7,4087,8410.5,1514.0,583.8571428571429
43595.0,6,14,4740,7,653,6340.166666666667,249.0,93.28571428571428,7,4087,7124.666666666667,1514.0,583.8571428571429
319188.0,6,3,202,2,128,0.0,74.0,64.0,1,74,0.0,74.0,74.0
135128527.0,17,6,1146,6,1146,27025705.4,191.0,191.0,0,0,0.0,0.0,0.0
120334730.0,6,229,26070,115,18250,1055567.8070175438,336.0,158.69565217391303,114,7820,1056905.2654867256,140.0,68.59649122807018
47538.0,6,14,4740,7,653,7424.333333333333,249.0,93.28571428571428,7,4087,7221.333333333333,1514.0,583.8571428571429
303767.0,6,6,412,4,272,101255.66666666669,74.0,68.0,2,140,0.0,74.0,70.0
103190937.0,6,41,3286,22,1777,4913854.142857143,139.0,80.77272727272727,19,1509,5720815.0,123.0,79.42105263157895
301.0,17,2,174,1,79,0.0,79.0,79.0,1,95,0.0,95.0,95.0
39903.0,6,14,4740,7,653,6521.5,249.0,93.28571428571428,7,4087,6186.166666666667,1514.0,583.8571428571429
206157.0,6,3,426,2,280,0.0,214.0,140.0,1,146,0.0,146.0,146.0
23357.0,6,14,4740,7,653,3490.333333333333,249.0,93.28571428571428,7,4087,3608.3333333333335,1514.0,583.8571428571429
316.0,17,2,174,1,79,0.0,79.0,79.0,1,95,0.0,95.0,95.0
32288.0,6,14,4740,7,653,5194.0,249.0,93.28571428571428,7,4087,4524.0,1514.0,583.8571428571429
5812529.0,6,4,270,2,134,0.0,68.0,67.0,2,136,0.0,70.0,68.0
2415.0,17,4,344,2,150,0.0,75.0,75.0,2,194,0.0,103.0,97.0
108094350.0,17,5,955,5,955,27023587.5,191.0,191.0,0,0,0.0,0.0,0.0
108101043.0,17,5,1005,5,1005,27025260.75,201.0,201.0,0,0,0.0,0.0,0.0
310231.0,17,4,1400,4,1400,103410.33333333331,350.0,350.0,0,0,0.0,0.0,0.0
91252061.0,6,27,1885,14,963,7019389.307692308,123.0,68.78571428571429,13,922,7586209.166666667,139.0,70.92307692307692
40863.0,6,14,4740,7,653,6690.0,249.0,93.28571428571428,7,4087,6320.833333333333,1514.0,583.8571428571429
90050019.0,17,28,13364,28,13364,3335185.888888889,501.0,477.2857142857143,0,0,0.0,0.0,0.0
149716971.0,6,15,2290,5,1020,29963779.25,204.0,204.0,10,1270,16635078.222222222,188.0,127.0
214845.0,17,2,180,1,90,0.0,90.0,90.0,1,90,0.0,90.0,90.0
90529188.0,6,13,2036,8,1016,12932741.142857144,188.0,127.0,5,1020,22590693.75,204.0,204.0
128899289.0,6,36,2602,19,1408,7161071.611111111,139.0,74.10526315789474,17,1194,7418568.5625,123.0,70.23529411764706
104642396.0,17,14,864,7,432,17168300.5,174.0,61.71428571428572,7,432,17166849.5,174.0,61.71428571428572
2397.0,17,4,344,2,150,0.0,75.0,75.0,2,194,0.0,103.0,97.0
1169241.0,6,13,3010,8,2382,167034.42857142858,1514.0,297.75,5,628,223299.25,331.0,125.6
120033044.0,17,28,13364,28,13364,4445668.296296297,501.0,477.2857142857143,0,0,0.0,0.0,0.0
36241.0,6,12,1413,7,882,6040.166666666667,291.0,126.0,5,531,5925.75,259.0,106.2
297399.0,6,6,412,4,272,99133.0,74.0,68.0,2,140,0.0,74.0,70.0
347.0,17,2,160,1,80,0.0,80.0,80.0,1,80,0.0,80.0,80.0
860596.0,6,9,1268,6,797,172119.2,459.0,132.83333333333334,3,471,294013.5,331.0,157.0
108497307.0,6,33,2406,17,1194,6781054.5,123.0,70.23529411764706,16,1212,6567349.133333334,123.0,75.75
83.0,17,2,762,2,762,0.0,381.0,381.0,0,0,0.0,0.0,0.0
20335.0,17,2,180,1,90,0.0,90.0,90.0,1,90,0.0,90.0,90.0
4298.0,17,2,614,1,72,0.0,72.0,72.0,1,542,0.0,542.0,542.0
47605733.0,6,8,2113,3,960,22377197.5,826.0,320.0,5,1153,11257756.5,885.0,230.6
2022500.0,17,4,525,2,150,0.0,75.0,75.0,2,375,0.0,284.0,187.5
308035.0,6,6,412,4,272,102678.33333333331,74.0,68.0,2,140,0.0,74.0,70.0
101955256.0,6,185,20932,93,14638,1108209.3043478262,284.0,157.3978494623656,92,6294,1108792.3186813188,140.0,68.41304347826087
103174997.0,6,231,26112,116,7878,897173.8869565218,140.0,67.91379310344827,115,18234,896085.2631578947,284.0,158.55652173913043
7288.0,17,2,180,1,90,0.0,90.0,90.0,1,90,0.0,90.0,90.0
313690.0,6,3,202,2,128,0.0,74.0,64.0,1,74,0.0,74.0,74.0
144886.0,17,2,180,1,70,0.0,70.0,70.0,1,110,0.0,110.0,110.0
2322213.0,6,25,7573,14,3735,178631.76923076922,1514.0,266.7857142857143,11,3838,206835.2,1514.0,348.90909090909093
10465324.0,6,7,478,4,272,3442941.6666666665,74.0,68.0,3,206,5164329.0,74.0,68.66666666666667
103000940.0,17,13,821,7,432,17166823.333333332,174.0,61.71428571428572,6,389,16607529.8,174.0,64.83333333333333
112437698.0,6,32,2220,16,1149,7481466.466666667,123.0,71.8125,16,1071,7481467.666666667,123.0,66.9375
1166732.0,6,13,3010,8,2382,166676.0,1514.0,297.75,5,628,222792.25,331.0,125.6
29666.0,6,14,4740,7,653,4144.166666666667,249.0,93.28571428571428,7,4087,4758.666666666667,1514.0,583.8571428571429
6573.0,17,4,823,2,163,0.0,89.0,81.5,2,660,0.0,443.0,330.0
27727.0,17,2,180,1,90,0.0,90.0,90.0,1,90,0.0,90.0,90.0
63654.0,6,12,1328,7,797,10609.0,253.0,113.85714285714286,5,531,13373.0,259.0,106.2
120000050.0,6,17,1287,9,691,15000006.25,95.0,76.77777777777777,8,596,12898836.142857144,95.0,74.5
3099708.0,6,5,336,2,134,0.0,68.0,67.0,3,202,1526266.0,70.0,67.33333333333333
105135733.0,17,15,5130,15,5130,7509695.214285715,342.0,342.0,0,0,0.0,0.0,0.0
2022577.0,17,4,525,2,150,0.0,75.0,75.0,2,375,0.0,284.0,187.5
10460645.0,6,7,478,4,272,3441360.6666666665,74.0,68.0,3,206,5161921.0,74.0,68.66666666666667
90255586.0,6,14,1964,8,1016,12893655.142857144,188.0,127.0,6,948,18018420.4,204.0,158.0
202102.0,17,4,1524,4,1524,67367.33333333333,381.0,381.0,0,0,0.0,0.0,0.0
59880.0,6,10,2032,5,524,14743.0,252.0,104.8,5,1508,9335.5,1236.0,301.6
327014.0,6,6,412,4,272,109004.66666666669,74.0,68.0,2,140,0.0,74.0,70.0
314091.0,6,3,1604,1,753,0.0,753.0,753.0,2,851,0.0,785.0,425.5
1041928.0,6,11,1134,6,558,208385.6,220.0,93.0,5,576,259215.25,304.0,115.2
308274.0,6,6,412,4,272,102758.0,74.0,68.0,2,140,0.0,74.0,70.0
303981.0,6,6,412,4,272,101327.0,74.0,68.0,2,140,0.0,74.0,70.0
118778024.0,6,49,3234,25,1650,4949084.333333333,66.0,66.0,24,1584,5150592.869565218,66.0,66.0
3017963.0,6,11,2106,6,598,603187.6,252.0,99.66666666666669,5,1508,4871.75,1236.0,301.6
438.0,17,2,410,1,78,0.0,78.0,78.0,1,332,0.0,332.0,332.0
436391.0,6,10,967,5,390,73089.25,162.0,78.0,5,577,73034.75,349.0,115.4
205822.0,17,2,180,1,90,0.0,90.0,90.0,1,90,0.0,90.0,90.0
90259580.0,6,13,2036,8,1016,12894225.714285716,188.0,127.0,5,1020,22520785.0,204.0,204.0
102915.0,17,2,286,2,286,0.0,143.0,143.0,0,0,0.0,0.0,0.0
300959.0,6,6,412,4,272,100319.66666666669,74.0,68.0,2,140,0.0,74.0,70.0
21079202.0,17,3,1034,2,684,0.0,342.0,342.0,1,350,0.0,350.0,350.0
0.0,6,1,54,0,0,0.0,0.0,0.0,1,54,0.0,54.0,54.0
153436.0,17,2,180,1,90,0.0,90.0,90.0,1,90,0.0,90.0,90.0
299856.0,6,6,412,4,272,99952.0,74.0,68.0,2,140,0.0,74.0,70.0
95000822.0,17,11,735,6,389,19000164.4,174.0,64.83333333333333,5,346,19925730.0,174.0,69.2
96332556.0,6,180,20422,90,6162,1082388.269662921,140.0,68.46666666666667,90,14260,1079871.2921348314,284.0,158.44444444444446
213554.0,17,2,180,1,90,0.0,90.0,90.0,1,90,0.0,90.0,90.0
120056065.0,17,29,13785,29,13785,4287716.607142857,501.0,475.3448275862069,0,0,0.0,0.0,0.0
217285.0,17,2,180,1,90,0.0,90.0,90.0,1,90,0.0,90.0,90.0
45040.0,6,14,4740,7,653,7289.0,249.0,93.28571428571428,7,4087,7370.5,1514.0,583.8571428571429
15678.999999999998,6,10,2032,5,524,3701.5,252.0,104.8,5,1508,3466.0,1236.0,301.6
79124.0,6,12,1320,7,789,13187.333333333334,253.0,112.71428571428572,5,531,16191.75,259.0,106.2
105075334.0,17,14,4788,14,4788,8082718.0,342.0,342.0,0,0,0.0,0.0,0.0
3870921.0,17,2,876,2,876,0.0,438.0,438.0,0,0,0.0,0.0,0.0
42656.0,6,10,2032,5,524,9727.5,252.0,104.8,5,1508,10095.25,1236.0,301.6
328278.0,6,3,204,1,68,0.0,68.0,68.0,2,136,0.0,70.0,68.0
226048.0,17,2,180,1,90,0.0,90.0,90.0,1,90,0.0,90.0,90.0
212168.0,17,2,414,1,88,0.0,88.0,88.0,1,326,0.0,326.0,326.0
16473.0,6,14,4740,7,653,2288.333333333333,249.0,93.28571428571428,7,4087,2610.0,1514.0,583.8571428571429
303112.0,6,6,412,4,272,101037.33333333331,74.0,68.0,2,140,0.0,74.0,70.0
57377.0,6,10,2032,5,524,14044.0,252.0,104.8,5,1508,10231.0,1236.0,301.6
120072852.0,6,234,26528,117,8018,1028163.5,140.0,68.52991452991454,117,18510,1028125.9827586206,374.0,158.2051282051282
12611.0,6,14,4740,7,653,1932.6666666666667,249.0,93.28571428571428,7,4087,1967.6666666666667,1514.0,583.8571428571429
162266.0,17,2,180,1,90,0.0,90.0,90.0,1,90,0.0,90.0,90.0
151278.0,6,3,337,2,214,0.0,160.0,107.0,1,123,0.0,123.0,123.0
108100430.0,17,5,955,5,955,27025107.5,191.0,191.0,0,0,0.0,0.0,0.0
90257470.0,6,12,1832,8,1016,12893924.285714284,188.0,127.0,4,816,30028311.33333333,204.0,204.0
228124.0,17,2,180,1,90,0.0,90.0,90.0,1,90,0.0,90.0,90.0
10464988.0,6,7,478,4,272,3442741.333333333,74.0,68.0,3,206,5164018.0,74.0,68.66666666666667
326352.0,17,4,1400,4,1400,108784.0,350.0,350.0,0,0,0.0,0.0,0.0
2805033.0,6,2,132,1,66,0.0,66.0,66.0,1,66,0.0,66.0,66.0
6819.0,17,2,582,1,83,0.0,83.0,83.0,1,499,0.0,499.0,499.0
942.0,17,4,438,2,148,0.0,74.0,74.0,2,290,0.0,147.0,145.0
27935.0,6,13,1386,7,789,4202.833333333333,253.0,112.71428571428572,6,597,5355.4,259.0,99.5
40522.0,6,10,2032,5,524,7963.0,252.0,104.8,5,1508,9560.75,1236.0,301.6
114519870.0,6,48,3168,24,1584,4979124.782608695,66.0,66.0,24,1584,4965526.695652174,66.0,66.0
106373232.0,17,14,864,7,432,17666633.666666668,174.0,61.71428571428572,7,432,17666834.666666668,174.0,61.71428571428572
153456.0,17,2,180,1,90,0.0,90.0,90.0,1,90,0.0,90.0,90.0
3112242.0,6,3,204,2,136,0.0,70.0,68.0,1,68,0.0,68.0,68.0
249156.0,17,4,6056,4,6056,83052.0,1514.0,1514.0,0,0,0.0,0.0,0.0
206931.0,17,4,6056,4,6056,68977.0,1514.0,1514.0,0,0,0.0,0.0,0.0
1764756.0,6,4,276,2,128,0.0,74.0,64.0,2,148,0.0,74.0,74.0
307476.0,6,6,412,4,272,102492.0,74.0,68.0,2,140,0.0,74.0,70.0
120123473.0,6,13,2020,9,1204,15015434.125,188.0,133.77777777777777,4,816,30027938.0,204.0,204.0
21152.0,6,14,4740,7,653,3229.333333333333,249.0,93.28571428571428,7,4087,3286.0,1514.0,583.8571428571429
82663.0,6,14,4740,7,653,13027.0,249.0,93.28571428571428,7,4087,13581.833333333334,1514.0,583.8571428571429
328.0,17,2,166,1,75,0.0,75.0,75.0,1,91,0.0,91.0,91.0
1320966.0,6,4,264,2,132,0.0,66.0,66.0,2,132,0.0,66.0,66.0
120926829.0,6,34,2413,17,1125,7052492.75,123.0,66.17647058823529,17,1288,6933757.3125,139.0,75.76470588235294
217810.0,6,3,426,2,280,0.0,214.0,140.0,1,146,0.0,146.0,146.0
48944008.0,6,7,2047,5,1153,12236002.0,885.0,230.6,2,894,0.0,826.0,447.0
1678639.0,17,18,1260,18,1260,98743.4705882353,70.0,70.0,0,0,0.0,0.0,0.0
102684.0,17,2,286,2,286,0.0,143.0,143.0,0,0,0.0,0.0,0.0
1314826.0,6,4,264,2,132,0.0,66.0,66.0,2,132,0.0,66.0,66.0
90045048.0,17,27,12943,27,12943,3463271.076923077,501.0,479.3703703703704,0,0,0.0,0.0,0.0
2598588.0,6,2,132,1,66,0.0,66.0,66.0,1,66,0.0,66.0,66.0
123839892.0,6,49,3234,25,1650,5159995.5,66.0,66.0,24,1584,5016275.826086956,66.0,66.0
47111.0,6,10,2032,5,524,11564.25,252.0,104.8,5,1508,10003.75,1236.0,301.6
30670.0,6,11,2098,6,590,5065.4,252.0,98.33333333333331,5,1508,7269.25,1236.0,301.6
215703.0,17,2,180,1,90,0.0,90.0,90.0,1,90,0.0,90.0,90.0
27613.0,6,14,4740,7,653,4259.833333333333,249.0,93.28571428571428,7,4087,4467.666666666667,1514.0,583.8571428571429
178163.0,17,2,180,1,90,0.0,90.0,90.0,1,90,0.0,90.0,90.0
118890586.0,6,35,2526,18,1332,6980844.235294118,123.0,74.0,17,1194,7417132.8125,123.0,70.23529411764706
116344657.0,6,32,2220,16,1149,7756310.466666667,123.0,71.8125,16,1071,7741884.0,123.0,66.9375
153531.0,17,2,180,1,90,0.0,90.0,90.0,1,90,0.0,90.0,90.0
300331.0,6,6,412,4,272,100110.33333333331,74.0,68.0,2,140,0.0,74.0,70.0
228218.0,17,2,180,1,90,0.0,90.0,90.0,1,90,0.0,90.0,90.0
23097.0,6,11,1131,6,600,4476.2,262.0,100.0,5,531,5439.0,259.0,106.2
108100853.0,17,5,955,5,955,27025213.25,191.0,191.0,0,0,0.0,0.0,0.0
120471577.0,6,225,25468,113,17780,1075639.080357143,284.0,157.34513274336285,112,7688,1075909.018018018,140.0,68.64285714285714
10457829.0,6,7,478,4,272,3440663.0,74.0,68.0,3,206,5160882.5,74.0,68.66666666666667
90047686.0,17,28,13364,28,13364,3335099.4814814813,501.0,477.2857142857143,0,0,0.0,0.0,0.0
56493.0,6,12,1320,7,789,9415.5,253.0,112.71428571428572,5,531,11638.75,259.0,106.2
20053217.0,17,3,1034,2,684,0.0,342.0,342.0,1,350,0.0,350.0,350.0
245546.0,6,3,337,2,214,0.0,160.0,107.0,1,123,0.0,123.0,123.0
103458776.0,17,14,864,7,432,17168693.333333332,174.0,61.71428571428572,7,432,17166837.333333332,174.0,61.71428571428572
37735.0,6,10,2032,5,524,9214.75,252.0,104.8,5,1508,7386.25,1236.0,301.6
108104281.0,17,5,1005,5,1005,27026070.25,201.0,201.0,0,0,0.0,0.0,0.0
208673.0,6,3,426,2,280,0.0,214.0,140.0,1,146,0.0,146.0,146.0
94121159.0,6,166,18794,83,13168,1145194.024390244,284.0,158.65060240963857,83,5626,1145194.1097560977,140.0,67.78313253012048
30924.0,6,10,2032,5,524,6583.75,252.0,104.8,5,1508,7489.25,1236.0,301.6
138917.0,17,2,176,1,80,0.0,80.0,80.0,1,96,0.0,96.0,96.0
50293.0,6,14,4740,7,653,7878.333333333333,249.0,93.28571428571428,7,4087,7215.166666666667,1514.0,583.8571428571429
204568.0,17,2,762,2,762,0.0,381.0,381.0,0,0,0.0,0.0,0.0
2592821.0,6,2,132,1,66,0.0,66.0,66.0,1,66,0.0,66.0,66.0
135186161.0,17,6,1146,6,1146,27037232.2,191.0,191.0,0,0,0.0,0.0,0.0
7065.0,17,2,582,1,83,0.0,83.0,83.0,1,499,0.0,499.0,499.0
306599.0,6,6,412,4,272,102199.66666666669,74.0,68.0,2,140,0.0,74.0,70.0
34432.0,6,14,4740,7,653,5084.166666666667,249.0,93.28571428571428,7,4087,5334.0,1514.0,583.8571428571429
49680625.0,6,8,2113,3,960,23519376.0,826.0,320.0,5,1153,11724927.5,885.0,230.6
0.0,6,1,66,1,66,0.0,66.0,66.0,0,0,0.0,0.0,0.0
52665.0,6,14,4740,7,653,8655.833333333334,249.0,93.28571428571428,7,4087,7678.0,1514.0,583.8571428571429
2294.0,17,4,344,2,150,0.0,75.0,75.0,2,194,0.0,103.0,97.0
108108173.0,17,5,955,5,955,27027043.25,191.0,191.0,0,0,0.0,0.0,0.0
13774.0,6,14,4740,7,653,2107.1666666666665,249.0,93.28571428571428,7,4087,2122.5,1514.0,583.8571428571429
996627.0,6,12,1447,6,816,197037.6,291.0,136.0,6,631,198665.8,293.0,105.16666666666669
314.0,17,2,174,1,79,0.0,79.0,79.0,1,95,0.0,95.0,95.0
90258914.0,6,12,1832,8,1016,12894130.57142857,188.0,127.0,4,816,30031423.666666668,204.0,204.0
135124141.0,17,6,1206,6,1206,27024828.2,201.0,201.0,0,0,0.0,0.0,0.0
120397927.0,6,211,23908,106,16756,1146646.9238095237,390.0,158.0754716981132,105,7152,1147827.5288461538,140.0,68.11428571428571
2897.0,17,2,762,2,762,0.0,381.0,381.0,0,0,0.0,0.0,0.0
46785170.0,6,8,2113,3,960,21954138.5,826.0,320.0,5,1153,11001945.0,885.0,230.6
2713115.0,6,25,7573,14,3735,208701.15384615384,1514.0,266.7857142857143,11,3838,244717.9,1514.0,348.90909090909093
41090.0,6,14,4740,7,653,6510.333333333333,249.0,93.28571428571428,7,4087,6639.333333333333,1514.0,583.8571428571429
153479.0,17,2,180,1,90,0.0,90.0,90.0,1,90,0.0,90.0,90.0
50492.0,6,10,2032,5,524,12245.75,252.0,104.8,5,1508,12254.0,1236.0,301.6
52312.0,6,14,4740,7,653,8559.0,249.0,93.28571428571428,7,4087,8529.833333333334,1514.0,583.8571428571429
90046972.0,17,27,12943,27,12943,3463345.076923077,501.0,479.3703703703704,0,0,0.0,0.0,0.0
115487944.0,6,33,2280,17,1209,7204495.25,123.0,71.11764705882354,16,1071,7684786.666666667,123.0,66.9375
298772.0,6,6,412,4,272,99590.66666666669,74.0,68.0,2,140,0.0,74.0,70.0
132151.0,6,13,1386,7,789,22025.166666666668,253.0,112.71428571428572,6,597,25359.8,259.0,99.5
197003.0,17,2,180,1,90,0.0,90.0,90.0,1,90,0.0,90.0,90.0
103268.0,17,2,286,2,286,0.0,143.0,143.0,0,0,0.0,0.0,0.0
106195.0,17,4,1400,4,1400,35398.333333333336,350.0,350.0,0,0,0.0,0.0,0.0
41689.0,6,12,1320,6,723,7152.6,253.0,120.5,6,597,7440.2,259.0,99.5
108113071.0,17,5,955,5,955,27028267.75,191.0,191.0,0,0,0.0,0.0,0.0
197675.0,17,2,180,1,90,0.0,90.0,90.0,1,90,0.0,90.0,90.0
1314530.0,6,4,264,2,132,0.0,66.0,66.0,2,132,0.0,66.0,66.0
2315.0,17,4,344,2,150,0.0,75.0,75.0,2,194,0.0,103.0,97.0
106370804.0,17,14,864,7,432,17666879.5,174.0,61.71428571428572,7,432,17667863.166666668,174.0,61.71428571428572
102138.0,17,2,286,2,286,0.0,143.0,143.0,0,0,0.0,0.0,0.0
90062441.0,6,13,1776,6,948,18011995.8,204.0,158.0,7,828,15009329.5,188.0,118.28571428571428
253908.00000000003,6,3,337,2,214,0.0,160.0,107.0,1,123,0.0,123.0,123.0
108105093.0,17,5,1005,5,1005,27026273.25,201.0,201.0,0,0,0.0,0.0,0.0
143937.0,17,2,180,1,90,0.0,90.0,90.0,1,90,0.0,90.0,90.0
113254884.0,6,46,3036,23,1518,5135438.863636363,66.0,66.0,23,1518,5135445.545454546,66.0,66.0
45885.0,6,14,4740,7,653,7443.5,249.0,93.28571428571428,7,4087,6069.166666666667,1514.0,583.8571428571429
217884.0,6,3,426,2,280,0.0,214.0,140.0,1,146,0.0,146.0,146.0
15126.0,17,4,438,2,148,0.0,74.0,74.0,2,290,0.0,147.0,145.0
90295547.0,6,16,1192,8,596,12893368.714285716,95.0,74.5,8,596,12897988.285714284,95.0,74.5
0.0,17,1,55,1,55,0.0,55.0,55.0,0,0,0.0,0.0,0.0
305020.0,6,6,412,4,272,101673.33333333331,74.0,68.0,2,140,0.0,74.0,70.0
328605.0,6,6,412,4,272,109535.0,74.0,68.0,2,140,0.0,74.0,70.0
121376.0,6,3,337,2,214,0.0,160.0,107.0,1,123,0.0,123.0,123.0
2405.0,17,4,344,2,150,0.0,75.0,75.0,2,194,0.0,103.0,97.0
145629.0,17,2,180,1,70,0.0,70.0,70.0,1,110,0.0,110.0,110.0
120232822.0,6,18,1341,9,691,14997870.375,95.0,76.77777777777777,9,650,14997497.625,95.0,72.22222222222223
44096.0,6,10,2032,5,524,10760.5,252.0,104.8,5,1508,9936.0,1236.0,301.6
259699.0,6,10,1221,6,636,51939.8,298.0,106.0,4,585,80372.66666666667,379.0,146.25
221800.0,6,10,1221,6,636,44360.0,298.0,106.0,4,585,73078.33333333333,379.0,146.25
115668874.0,6,47,3102,24,1584,5015669.521739131,66.0,66.0,23,1518,5150435.181818182,66.0,66.0
201162.0,17,4,6056,4,6056,67054.0,1514.0,1514.0,0,0,0.0,0.0,0.0
120164675.0,6,220,24868,110,7556,1094969.605504587,140.0,68.69090909090909,110,17312,1094900.2935779816,284.0,157.38181818181818
219696.0,6,3,426,2,280,0.0,214.0,140.0,1,146,0.0,146.0,146.0
353.0,17,2,166,1,75,0.0,75.0,75.0,1,91,0.0,91.0,91.0
119919887.0,17,35,16705,35,16705,3527055.5,501.0,477.2857142857143,0,0,0.0,0.0,0.0
90257854.0,6,14,1964,8,1016,12893979.142857144,188.0,127.0,6,948,18011405.2,204.0,158.0
82953.0,6,14,4740,7,653,13620.5,249.0,93.28571428571428,7,4087,13121.166666666666,1514.0,583.8571428571429
10457206.0,6,7,478,4,272,3440412.6666666665,74.0,68.0,3,206,5160490.0,74.0,68.66666666666667
239129.0,17,2,180,1,90,0.0,90.0,90.0,1,90,0.0,90.0,90.0
156994.0,6,3,337,2,214,0.0,160.0,107.0,1,123,0.0,123.0,123.0
18041.0,6,20,7606,11,978,1804.1,310.0,88.9090909090909,9,6628,1989.0,1514.0,736.4444444444445
4259.0,17,2,614,1,72,0.0,72.0,72.0,1,542,0.0,542.0,542.0
90029502.0,17,28,13364,28,13364,3334426.0,501.0,477.2857142857143,0,0,0.0,0.0,0.0
120259486.0,6,224,25184,112,7688,1075977.1531531531,140.0,68.64285714285714,112,17496,1079932.1351351351,284.0,156.21428571428572
90313817.0,6,16,1192,8,596,12894690.142857144,95.0,74.5,8,596,12901659.285714284,95.0,74.5
90064083.0,17,28,13364,28,13364,3335706.777777778,501.0,477.2857142857143,0,0,0.0,0.0,0.0
10463465.0,6,7,478,4,272,3442457.0,74.0,68.0,3,206,5163592.0,74.0,68.66666666666667
217394.0,6,3,426,2,280,0.0,214.0,140.0,1,146,0.0,146.0,146.0
30710.0,6,14,4740,7,653,4129.5,249.0,93.28571428571428,7,4087,4817.666666666667,1514.0,583.8571428571429
90290465.0,6,16,1192,8,596,12892631.57142857,95.0,74.5,8,596,12897959.0,95.0,74.5
90043387.0,17,28,13364,28,13364,3334940.25925926,501.0,477.2857142857143,0,0,0.0,0.0,0.0
108110022.0,17,5,1005,5,1005,27027505.5,201.0,201.0,0,0,0.0,0.0,0.0
26802.0,6,10,2032,5,524,5856.5,252.0,104.8,5,1508,6458.5,1236.0,301.6
26854.0,6,10,2032,5,524,6497.0,252.0,104.8,5,1508,5757.25,1236.0,301.6
2155.0,17,4,344,2,150,0.0,75.0,75.0,2,194,0.0,103.0,97.0
112915583.0,6,336,41244,168,29860,674912.5209580838,390.0,177.73809523809524,168,11384,674912.6467065868,140.0,67.76190476190476
205846.0,17,2,180,1,90,0.0,90.0,90.0,1,90,0.0,90.0,90.0
90019826.0,17,28,13364,28,13364,3334067.6296296297,501.0,477.2857142857143,0,0,0.0,0.0,0.0
2393.0,17,4,344,2,150,0.0,75.0,75.0,2,194,0.0,103.0,97.0
108114676.0,17,5,1005,5,1005,27028669.0,201.0,201.0,0,0,0.0,0.0,0.0
123839635.0,6,48,3168,24,1584,5025709.652173913,66.0,66.0,24,1584,5271721.695652174,66.0,66.0
353.0,17,2,267,1,83,0.0,83.0,83.0,1,184,0.0,184.0,184.0
232770.0,6,3,337,2,214,0.0,160.0,107.0,1,123,0.0,123.0,123.0
51218.0,17,2,180,1,90,0.0,90.0,90.0,1,90,0.0,90.0,90.0
0.0,6,1,172,1,172,0.0,172.0,172.0,0,0,0.0,0.0,0.0
25650.0,6,10,2032,5,524,6162.25,252.0,104.8,5,1508,6027.25,1236.0,301.6
284469.0,6,10,1221,6,636,56893.8,298.0,106.0,4,585,87287.66666666667,379.0,146.25
120104819.0,6,16,2632,9,1204,15013102.375,188.0,133.77777777777777,7,1428,15057268.833333334,204.0,204.0
90022585.0,17,28,13364,28,13364,3334169.814814815,501.0,477.2857142857143,0,0,0.0,0.0,0.0
1057131.0,6,3,1604,2,851,0.0,785.0,425.5,1,753,0.0,753.0,753.0
95353042.0,6,26,1815,13,909,7946086.833333333,123.0,69.92307692307692,13,906,7928025.916666667,123.0,69.6923076923077
21597.0,6,10,1067,5,536,4770.5,264.0,107.2,5,531,4243.0,259.0,106.2
90256746.0,6,13,2036,8,1016,12893820.857142856,188.0,127.0,5,1020,22523046.5,204.0,204.0
121204.0,6,3,337,2,214,0.0,160.0,107.0,1,123,0.0,123.0,123.0
1306601.0,6,4,264,2,132,0.0,66.0,66.0,2,132,0.0,66.0,66.0
205777.0,6,3,426,2,280,0.0,214.0,140.0,1,146,0.0,146.0,146.0
122975257.0,6,48,3168,24,1584,5168223.217391305,66.0,66.0,24,1584,5098844.304347826,66.0,66.0
33713468.0,6,4,264,2,132,0.0,66.0,66.0,2,132,0.0,66.0,66.0
229981.0,17,2,180,1,90,0.0,90.0,90.0,1,90,0.0,90.0,90.0
104514650.0,17,15,5130,15,5130,7465332.142857143,342.0,342.0,0,0,0.0,0.0,0.0
132969.0,6,3,337,2,214,0.0,160.0,107.0,1,123,0.0,123.0,123.0
737.0,17,2,684,2,684,0.0,342.0,342.0,0,0,0.0,0.0,0.0
109698.0,17,4,1400,4,1400,36566.0,350.0,350.0,0,0,0.0,0.0,0.0
17501.0,6,14,4740,7,653,2304.1666666666665,249.0,93.28571428571428,7,4087,2361.833333333333,1514.0,583.8571428571429
96149896.0,6,176,19962,88,13932,1102696.1264367816,284.0,158.3181818181818,88,6030,1102697.7586206896,140.0,68.52272727272727
302685.0,6,6,412,4,272,100895.0,74.0,68.0,2,140,0.0,74.0,70.0
218294.0,6,3,426,2,280,0.0,214.0,140.0,1,146,0.0,146.0,146.0
842.0,17,4,438,2,148,0.0,74.0,74.0,2,290,0.0,147.0,145.0
120072892.0,17,28,13364,28,13364,4447144.148148148,501.0,477.2857142857143,0,0,0.0,0.0,0.0
34111.0,6,10,2032,5,524,8221.25,252.0,104.8,5,1508,6711.5,1236.0,301.6
324.0,17,2,174,1,79,0.0,79.0,79.0,1,95,0.0,95.0,95.0
109162796.0,6,215,24284,108,7350,1020213.046728972,140.0,68.05555555555556,107,16934,1020043.6698113208,284.0,158.26168224299064
19066.0,6,11,1131,6,600,3564.2,262.0,100.0,5,531,4424.75,259.0,106.2
191634.0,17,2,180,1,90,0.0,90.0,90.0,1,90,0.0,90.0,90.0
1561601.0,6,20,7599,11,1469,156160.1,583.0,133.54545454545453,9,6130,162531.75,1484.0,681.1111111111111
383.0,17,2,164,1,82,0.0,82.0,82.0,1,82,0.0,82.0,82.0
65014.0,6,14,4740,7,653,10716.666666666666,249.0,93.28571428571428,7,4087,9190.666666666666,1514.0,583.8571428571429
108109204.0,17,5,1005,5,1005,27027301.0,201.0,201.0,0,0,0.0,0.0,0.0
99713.0,17,2,762,2,762,0.0,381.0,381.0,0,0,0.0,0.0,0.0
103485.0,17,2,286,2,286,0.0,143.0,143.0,0,0,0.0,0.0,0.0
105651.0,17,2,286,2,286,0.0,143.0,143.0,0,0,0.0,0.0,0.0
74127523.0,6,9,842,9,842,9265940.375,97.0,93.55555555555556,0,0,0.0,0.0,0.0
318220.0,17,4,1400,4,1400,106073.33333333331,350.0,350.0,0,0,0.0,0.0,0.0
72143.0,6,14,4740,7,653,11904.0,249.0,93.28571428571428,7,4087,11328.666666666666,1514.0,583.8571428571429
114050133.0,6,48,3168,24,1584,4958701.434782608,66.0,66.0,24,1584,4945275.826086956,66.0,66.0
91915176.0,6,24,1829,13,989,7658522.5,95.0,76.07692307692308,11,840,9190307.9,95.0,76.36363636363636
49461.0,6,14,4740,7,653,7546.666666666667,249.0,93.28571428571428,7,4087,6191.333333333333,1514.0,583.8571428571429
135145243.0,17,6,1146,6,1146,27029048.6,191.0,191.0,0,0,0.0,0.0,0.0
2979008.0,6,26,7147,13,2055,248250.66666666663,575.0,158.07692307692307,13,5092,222687.66666666663,1510.0,391.6923076923077
90256313.0,6,13,2036,8,1016,12893759.0,188.0,127.0,5,1020,22522735.0,204.0,204.0
120005678.0,17,13,821,7,432,20000946.33333333,174.0,61.71428571428572,6,389,20014316.8,174.0,64.83333333333333
114628793.0,6,48,3168,24,1584,4983860.565217392,66.0,66.0,24,1584,4971863.347826087,66.0,66.0
242784.0,6,3,337,2,214,0.0,160.0,107.0,1,123,0.0,123.0,123.0
17208.0,6,14,4740,7,653,2648.5,249.0,93.28571428571428,7,4087,2727.6666666666665,1514.0,583.8571428571429
44250.0,6,14,4740,7,653,5928.333333333333,249.0,93.28571428571428,7,4087,7236.833333333333,1514.0,583.8571428571429
0.0,17,1,44,1,44,0.0,44.0,44.0,0,0,0.0,0.0,0.0
368.0,17,2,202,1,87,0.0,87.0,87.0,1,115,0.0,115.0,115.0
62408.0,6,14,4740,7,653,10285.833333333334,249.0,93.28571428571428,7,4087,9786.5,1514.0,583.8571428571429
2800140.0,6,2,132,1,66,0.0,66.0,66.0,1,66,0.0,66.0,66.0
102860.0,17,2,286,2,286,0.0,143.0,143.0,0,0,0.0,0.0,0.0
92285782.0,6,26,1762,13,922,7672462.5,139.0,70.92307692307692,13,840,7672479.5,123.0,64.61538461538461
49786.0,6,14,4740,7,653,8137.166666666667,249.0,93.28571428571428,7,4087,7949.0,1514.0,583.8571428571429
82956258.0,17,14,4796,13,4446,6228595.333333333,342.0,342.0,1,350,0.0,350.0,350.0
410266.0,6,3,204,2,136,0.0,70.0,68.0,1,68,0.0,68.0,68.0
135160068.0,17,6,1206,6,1206,27032013.6,201.0,201.0,0,0,0.0,0.0,0.0
155101.0,6,3,337,2,214,0.0,160.0,107.0,1,123,0.0,123.0,123.0
107568.0,17,2,286,2,286,0.0,143.0,143.0,0,0,0.0,0.0,0.0
131842.0,6,3,337,2,214,0.0,160.0,107.0,1,123,0.0,123.0,123.0
245465.0,6,3,337,2,214,0.0,160.0,107.0,1,123,0.0,123.0,123.0
90294568.0,6,16,1192,8,596,12892616.57142857,95.0,74.5,8,596,12894833.0,95.0,74.5
102980.0,17,2,286,2,286,0.0,143.0,143.0,0,0,0.0,0.0,0.0
135136097.0,17,6,1146,6,1146,27027219.4,191.0,191.0,0,0,0.0,0.0,0.0
45011105.0,17,9,3086,8,2736,5133908.571428572,342.0,342.0,1,350,0.0,350.0,350.0
0.0,6,1,54,0,0,0.0,0.0,0.0,1,54,0.0,54.0,54.0
135130670.0,17,6,1146,6,1146,27026134.0,191.0,191.0,0,0,0.0,0.0,0.0
16000.0,6,14,4740,7,653,2229.0,249.0,93.28571428571428,7,4087,2530.833333333333,1514.0,583.8571428571429
202899.0,17,4,6056,4,6056,67633.0,1514.0,1514.0,0,0,0.0,0.0,0.0
123455512.0,6,48,3168,24,1584,5039206.739130435,66.0,66.0,24,1584,5228750.043478261,66.0,66.0
120006357.0,17,29,13785,29,13785,4285941.321428572,501.0,475.3448275862069,0,0,0.0,0.0,0.0
146115.0,6,3,337,2,214,0.0,160.0,107.0,1,123,0.0,123.0,123.0
868998.0,6,9,1268,6,797,173799.6,459.0,132.83333333333334,3,471,296786.0,331.0,157.0
4381.0,17,2,610,1,72,0.0,72.0,72.0,1,538,0.0,538.0,538.0
27568715.0,17,5,1710,5,1710,6892178.75,342.0,342.0,0,0,0.0,0.0,0.0
0.0,17,1,350,1,350,0.0,350.0,350.0,0,0,0.0,0.0,0.0
135143155.0,17,6,1146,6,1146,27028631.0,191.0,191.0,0,0,0.0,0.0,0.0
228109.0,17,2,180,1,90,0.0,90.0,90.0,1,90,0.0,90.0,90.0
119545969.0,6,226,25550,113,17870,1065441.6339285714,284.0,158.141592920354,113,7680,1065441.1517857143,140.0,67.96460176991151
30051.0,6,10,2032,5,524,7286.0,252.0,104.8,5,1508,6892.75,1236.0,301.6
125817277.0,6,59,12327,29,6438,3438095.8571428573,1514.0,222.0,30,5889,4331101.620689655,1514.0,196.3
218579.0,6,3,426,2,280,0.0,214.0,140.0,1,146,0.0,146.0,146.0
135143386.0,17,6,1146,6,1146,27028677.2,191.0,191.0,0,0,0.0,0.0,0.0
218162.0,6,3,426,2,280,0.0,214.0,140.0,1,146,0.0,146.0,146.0
23038.0,6,14,4740,7,653,3263.1666666666665,249.0,93.28571428571428,7,4087,3700.3333333333335,1514.0,583.8571428571429
10458312.0,6,7,478,4,272,3440354.0,74.0,68.0,3,206,5160414.0,74.0,68.66666666666667
48132.0,6,13,1479,7,882,8022.0,291.0,126.0,6,597,8172.2,259.0,99.5
31503.000000000004,6,14,4740,7,653,4238.166666666667,249.0,93.28571428571428,7,4087,5110.833333333333,1514.0,583.8571428571429
57557.0,6,14,4740,7,653,9286.333333333334,249.0,93.28571428571428,7,4087,8656.833333333334,1514.0,583.8571428571429
108111125.0,17,5,955,5,955,27027781.25,191.0,191.0,0,0,0.0,0.0,0.0
108027.0,17,2,286,2,286,0.0,143.0,143.0,0,0,0.0,0.0,0.0
314330.0,6,6,412,4,272,104776.66666666669,74.0,68.0,2,140,0.0,74.0,70.0
360230.0,6,4,508,2,238,0.0,172.0,119.0,2,270,0.0,135.0,135.0
47830944.0,6,8,1940,3,887,22622038.0,753.0,295.6666666666667,5,1053,11264028.0,785.0,210.6
223625.0,6,3,426,2,280,0.0,214.0,140.0,1,146,0.0,146.0,146.0
40778.0,6,14,4740,7,653,6493.666666666667,249.0,93.28571428571428,7,4087,4247.666666666667,1514.0,583.8571428571429
40311.0,6,10,2032,5,524,9868.25,252.0,104.8,5,1508,9830.0,1236.0,301.6
49920.0,6,14,4740,7,653,8198.166666666666,249.0,93.28571428571428,7,4087,6696.5,1514.0,583.8571428571429
3782.0,17,4,571,2,148,0.0,74.0,74.0,2,423,0.0,280.0,211.5
138790.0,17,2,176,1,80,0.0,80.0,80.0,1,96,0.0,96.0,96.0
8721265.0,6,5,1736,2,819,0.0,753.0,409.5,3,917,4291007.5,785.0,305.6666666666667
5636863.0,6,4,270,2,134,0.0,68.0,67.0,2,136,0.0,70.0,68.0
21477.0,6,14,4740,7,653,3465.0,249.0,93.28571428571428,7,4087,3440.333333333333,1514.0,583.8571428571429
113733777.0,6,48,3168,24,1584,4936032.304347826,66.0,66.0,24,1584,4944577.260869565,66.0,66.0
843306.0,6,9,1118,6,586,168661.2,248.0,97.66666666666669,3,532,281020.5,392.0,177.33333333333334
311260.0,6,6,412,4,272,103753.33333333331,74.0,68.0,2,140,0.0,74.0,70.0
217991.0,6,3,426,2,280,0.0,214.0,140.0,1,146,0.0,146.0,146.0
120013434.0,6,24,1829,13,989,9999968.75,95.0,76.07692307692308,11,840,12000115.7,95.0,76.36363636363636
144954.0,17,2,180,1,70,0.0,70.0,70.0,1,110,0.0,110.0,110.0
303914.0,6,6,412,4,272,101304.66666666669,74.0,68.0,2,140,0.0,74.0,70.0
8372161.999999999,17,3,1034,2,684,0.0,342.0,342.0,1,350,0.0,350.0,350.0
37366.0,6,14,4740,7,653,6113.166666666667,249.0,93.28571428571428,7,4087,5656.5,1514.0,583.8571428571429
777.0,17,4,438,2,148,0.0,74.0,74.0,2,290,0.0,147.0,145.0
108094452.0,17,5,1005,5,1005,27023613.0,201.0,201.0,0,0,0.0,0.0,0.0
78111288.0,17,30,10500,30,10500,2693492.6896551726,350.0,350.0,0,0,0.0,0.0,0.0
324.0,17,2,174,1,79,0.0,79.0,79.0,1,95,0.0,95.0,95.0
125006591.0,17,15,907,8,475,17858084.42857143,174.0,59.375,7,432,17333523.666666668,174.0,61.71428571428572
10537179.0,6,7,478,4,272,3465665.333333333,74.0,68.0,3,206,5198356.0,74.0,68.66666666666667
135135254.0,17,6,1206,6,1206,27027050.8,201.0,201.0,0,0,0.0,0.0,0.0
115631034.0,6,48,3168,24,1584,5027436.260869565,66.0,66.0,24,1584,5014016.521739131,66.0,66.0
887.0,17,4,438,2,148,0.0,74.0,74.0,2,290,0.0,147.0,145.0
33021.0,6,10,2032,5,524,7470.25,252.0,104.8,5,1508,7492.5,1236.0,301.6
0.0,17,1,55,1,55,0.0,55.0,55.0,0,0,0.0,0.0,0.0
9312.0,17,2,582,1,83,0.0,83.0,83.0,1,499,0.0,499.0,499.0
2693369.0,6,3,1604,2,851,0.0,785.0,425.5,1,753,0.0,753.0,753.0
107858.0,17,2,286,2,286,0.0,143.0,143.0,0,0,0.0,0.0,0.0
23796.0,6,14,4740,7,653,3598.5,249.0,93.28571428571428,7,4087,3194.833333333333,1514.0,583.8571428571429
11322.0,6,10,2032,5,524,2594.5,252.0,104.8,5,1508,2570.75,1236.0,301.6
110982245.0,6,32,2220,16,1149,7398816.333333333,123.0,71.8125,16,1071,7384388.266666667,123.0,66.9375
298362.0,6,6,412,4,272,99454.0,74.0,68.0,2,140,0.0,74.0,70.0
2059.0,17,4,344,2,150,0.0,75.0,75.0,2,194,0.0,103.0,97.0
205360.0,17,2,762,2,762,0.0,381.0,381.0,0,0,0.0,0.0,0.0
5630419.0,6,5,336,2,134,0.0,68.0,67.0,3,202,1474781.5,70.0,67.33333333333333
892240.0,17,2,246,1,76,0.0,76.0,76.0,1,170,0.0,170.0,170.0
299719.0,6,6,412,4,272,99906.33333333331,74.0,68.0,2,140,0.0,74.0,70.0
236597.0,6,3,337,2,214,0.0,160.0,107.0,1,123,0.0,123.0,123.0
2049.0,17,4,344,2,150,0.0,75.0,75.0,2,194,0.0,103.0,97.0
108906241.0,6,38,2842,19,1471,6038346.333333333,139.0,77.42105263157895,19,1371,6038346.666666667,123.0,72.15789473684211
234535.0,6,3,337,2,214,0.0,160.0,107.0,1,123,0.0,123.0,123.0
0.0,6,1,54,1,54,0.0,54.0,54.0,0,0,0.0,0.0,0.0
120331644.0,6,206,23358,103,7032,1171733.9117647058,140.0,68.27184466019418,103,16326,1171588.9215686277,284.0,158.50485436893203
204538.0,17,2,762,2,762,0.0,381.0,381.0,0,0,0.0,0.0,0.0
876243.0,6,10,1335,6,798,175248.6,460.0,133.0,4,537,200200.0,331.0,134.25
42058.0,6,14,4740,7,653,6768.5,249.0,93.28571428571428,7,4087,6827.333333333333,1514.0,583.8571428571429
148099.0,17,2,180,1,90,0.0,90.0,90.0,1,90,0.0,90.0,90.0
1011293.0,6,4,492,2,280,0.0,214.0,140.0,2,212,0.0,146.0,106.0
7504.0,17,2,498,1,80,0.0,80.0,80.0,1,418,0.0,418.0,418.0
280348.0,17,2,363,1,79,0.0,79.0,79.0,1,284,0.0,284.0,284.0
219071.0,6,3,426,2,280,0.0,214.0,140.0,1,146,0.0,146.0,146.0
35239.0,6,14,4740,7,653,5728.333333333333,249.0,93.28571428571428,7,4087,5128.0,1514.0,583.8571428571429
19689.0,6,14,4740,7,653,2926.6666666666665,249.0,93.28571428571428,7,4087,3142.1666666666665,1514.0,583.8571428571429
147838.0,6,3,373,2,238,0.0,172.0,119.0,1,135,0.0,135.0,135.0
132059.0,6,3,337,2,214,0.0,160.0,107.0,1,123,0.0,123.0,123.0
30409.0,6,10,2032,5,524,5993.0,252.0,104.8,5,1508,6808.0,1236.0,301.6
32609.0,6,10,2032,5,524,7903.5,252.0,104.8,5,1508,7828.75,1236.0,301.6
463.0,17,2,508,2,508,0.0,257.0,254.0,0,0,0.0,0.0,0.0
14485.0,17,2,618,1,72,0.0,72.0,72.0,1,546,0.0,546.0,546.0
90030748.0,17,28,13364,28,13364,3334472.1481481483,501.0,477.2857142857143,0,0,0.0,0.0,0.0
156635.0,6,3,337,2,214,0.0,160.0,107.0,1,123,0.0,123.0,123.0
0.0,17,1,342,1,342,0.0,342.0,342.0,0,0,0.0,0.0,0.0
2020870.0,17,4,525,2,150,0.0,75.0,75.0,2,375,0.0,284.0,187.5
113703660.0,6,30,1974,15,1026,8106257.857142857,123.0,68.4,15,948,8106258.357142857,123.0,63.2
135126953.0,17,6,1206,6,1206,27025390.6,201.0,201.0,0,0,0.0,0.0,0.0
322060.0,6,6,412,4,272,107353.33333333331,74.0,68.0,2,140,0.0,74.0,70.0
135136084.0,17,6,1146,6,1146,27027216.8,191.0,191.0,0,0,0.0,0.0,0.0
284508.0,17,2,363,1,79,0.0,79.0,79.0,1,284,0.0,284.0,284.0
197087.0,17,2,180,1,90,0.0,90.0,90.0,1,90,0.0,90.0,90.0
107103059.0,17,14,864,7,432,17834616.166666668,174.0,61.71428571428572,7,432,17833544.666666668,174.0,61.71428571428572
117757575.0,6,215,24438,108,17154,1100538.0841121494,300.0,158.83333333333334,107,7284,1106859.3962264152,140.0,68.07476635514018
207034.0,6,3,426,2,280,0.0,214.0,140.0,1,146,0.0,146.0,146.0
149741.0,17,4,1400,4,1400,49913.66666666666,350.0,350.0,0,0,0.0,0.0,0.0
107048573.0,17,14,864,7,432,17834946.5,174.0,61.71428571428572,7,432,17833502.0,174.0,61.71428571428572
44109.0,6,14,4740,7,653,6267.833333333333,249.0,93.28571428571428,7,4087,7141.833333333333,1514.0,583.8571428571429
114241642.0,6,48,3168,24,1584,4967027.913043479,66.0,66.0,24,1584,4953595.739130435,66.0,66.0
503744.0,6,5,336,2,134,0.0,68.0,67.0,3,202,193064.0,70.0,67.33333333333333
90025256.0,17,28,13364,28,13364,3334268.7407407407,501.0,477.2857142857143,0,0,0.0,0.0,0.0
14659.0,6,10,1066,5,490,2810.5,218.0,98.0,5,576,3325.25,304.0,115.2
10763589.0,6,5,1736,2,819,0.0,753.0,409.5,3,917,3976107.5,785.0,305.6666666666667
4136.0,17,2,598,1,72,0.0,72.0,72.0,1,526,0.0,526.0,526.0
58318.0,6,12,1413,6,816,10724.4,291.0,136.0,6,597,10266.6,259.0,99.5
106778.0,17,2,286,2,286,0.0,143.0,143.0,0,0,0.0,0.0,0.0
90054399.0,17,28,13364,28,13364,3335348.111111111,501.0,477.2857142857143,0,0,0.0,0.0,0.0
113168437.0,6,46,3036,23,1518,5144008.681818182,66.0,66.0,23,1518,5144008.7727272725,66.0,66.0
10476859.0,6,7,478,4,272,3445127.6666666665,74.0,68.0,3,206,5167588.0,74.0,68.66666666666667
79.0,17,2,906,2,906,0.0,453.0,453.0,0,0,0.0,0.0,0.0
90021892.0,17,28,13364,28,13364,3334144.1481481483,501.0,477.2857142857143,0,0,0.0,0.0,0.0
41997.0,6,14,4740,7,653,6878.833333333333,249.0,93.28571428571428,7,4087,5875.666666666667,1514.0,583.8571428571429
177874.0,17,2,180,1,90,0.0,90.0,90.0,1,90,0.0,90.0,90.0
146372.0,6,3,337,2,214,0.0,160.0,107.0,1,123,0.0,123.0,123.0
2869257.0,17,3,1026,3,1026,1434628.5,342.0,342.0,0,0,0.0,0.0,0.0
1774100.0,6,2,132,1,66,0.0,66.0,66.0,1,66,0.0,66.0,66.0
217616.0,6,3,426,2,280,0.0,214.0,140.0,1,146,0.0,146.0,146.0
120000079.0,6,25,2244,14,1445,9230775.307692308,255.0,103.21428571428572,11,799,10304742.6,95.0,72.63636363636364
46838.0,6,14,4740,7,653,7573.166666666667,249.0,93.28571428571428,7,4087,7129.5,1514.0,583.8571428571429
206116.0,6,3,426,2,280,0.0,214.0,140.0,1,146,0.0,146.0,146.0
52592.0,6,10,2032,5,524,12032.5,252.0,104.8,5,1508,12816.75,1236.0,301.6
103992.0,17,2,700,2,700,0.0,350.0,350.0,0,0,0.0,0.0,0.0
159712.0,6,3,337,2,214,0.0,160.0,107.0,1,123,0.0,123.0,123.0
143948.0,17,2,180,1,90,0.0,90.0,90.0,1,90,0.0,90.0,90.0
46445.0,6,10,2032,5,524,11349.75,252.0,104.8,5,1508,11126.75,1236.0,301.6
709.0,17,4,438,2,148,0.0,74.0,74.0,2,290,0.0,147.0,145.0
27028165.0,17,2,382,2,382,0.0,191.0,191.0,0,0,0.0,0.0,0.0
23882.0,6,20,7606,11,978,2349.6,310.0,88.9090909090909,9,6628,2875.875,1514.0,736.4444444444445
120126708.0,6,13,2036,5,1020,30031677.0,204.0,204.0,8,1016,17137508.714285713,188.0,127.0
322658.0,17,4,1400,4,1400,107552.66666666669,350.0,350.0,0,0,0.0,0.0,0.0
146116.0,6,3,337,2,214,0.0,160.0,107.0,1,123,0.0,123.0,123.0
252233.0,6,3,337,2,214,0.0,160.0,107.0,1,123,0.0,123.0,123.0
108688345.0,6,32,2236,16,1165,7245889.666666667,139.0,72.8125,16,1071,7231481.133333334,123.0,66.9375
90092228.0,6,14,1976,8,1016,12870318.285714284,188.0,127.0,6,960,12012858.6,204.0,160.0
298015.0,6,6,412,4,272,99338.33333333331,74.0,68.0,2,140,0.0,74.0,70.0
120228716.0,6,21,1585,10,786,13331931.777777778,95.0,78.6,11,799,11999003.9,95.0,72.63636363636364
228276.0,17,2,180,1,90,0.0,90.0,90.0,1,90,0.0,90.0,90.0
1164048.0,6,13,3010,8,2382,166292.57142857142,1514.0,297.75,5,628,222199.0,331.0,125.6
209050.0,6,3,426,2,280,0.0,214.0,140.0,1,146,0.0,146.0,146.0
16663.0,6,14,4740,7,653,2626.1666666666665,249.0,93.28571428571428,7,4087,2640.5,1514.0,583.8571428571429
332.0,17,2,166,1,75,0.0,75.0,75.0,1,91,0.0,91.0,91.0
298301.0,6,6,412,4,272,99433.66666666669,74.0,68.0,2,140,0.0,74.0,70.0
90300766.0,6,16,1192,8,596,12892847.57142857,95.0,74.5,8,596,12898704.42857143,95.0,74.5
305694.0,6,6,412,4,272,101898.0,74.0,68.0,2,140,0.0,74.0,70.0
140969.0,6,2,132,1,66,0.0,66.0,66.0,1,66,0.0,66.0,66.0
90267937.0,6,13,2036,8,1016,12895419.57142857,188.0,127.0,5,1020,22525794.75,204.0,204.0
3175357.0,6,17,1523,8,949,409396.1428571429,315.0,118.625,9,574,358196.875,78.0,63.77777777777778
8698.0,17,2,498,1,80,0.0,80.0,80.0,1,418,0.0,418.0,418.0
104022.0,17,2,286,2,286,0.0,143.0,143.0,0,0,0.0,0.0,0.0
113206481.0,6,32,2236,16,1165,7532697.6,139.0,72.8125,16,1071,7532698.8,123.0,66.9375
33749.0,6,10,2032,5,524,8222.5,252.0,104.8,5,1508,8086.5,1236.0,301.6
2329.0,17,4,344,2,150,0.0,75.0,75.0,2,194,0.0,103.0,97.0
899620.0,6,5,1742,3,921,449810.0,785.0,307.0,2,821,0.0,753.0,410.5
30527.0,6,14,4740,7,653,3823.1666666666665,249.0,93.28571428571428,7,4087,4202.833333333333,1514.0,583.8571428571429
3688.0,17,4,344,2,150,0.0,75.0,75.0,2,194,0.0,103.0,97.0
109373683.0,17,14,864,7,432,18167741.5,174.0,61.71428571428572,7,432,18166877.0,174.0,61.71428571428572
120054173.0,17,28,13364,28,13364,4446450.851851852,501.0,477.2857142857143,0,0,0.0,0.0,0.0
68.0,6,2,169,0,0,0.0,0.0,0.0,2,169,0.0,103.0,84.5
206345.0,6,3,426,2,280,0.0,214.0,140.0,1,146,0.0,146.0,146.0
90204583.0,6,21,1585,10,745,9996574.888888888,95.0,74.5,11,840,8999996.5,95.0,76.36363636363636
135132557.0,17,6,1206,6,1206,27026511.4,201.0,201.0,0,0,0.0,0.0,0.0
228291.0,17,2,180,1,90,0.0,90.0,90.0,1,90,0.0,90.0,90.0
144710.0,17,2,180,1,70,0.0,70.0,70.0,1,110,0.0,110.0,110.0
281237.0,17,2,363,1,79,0.0,79.0,79.0,1,284,0.0,284.0,284.0
394156.0,6,3,1604,1,753,0.0,753.0,753.0,2,851,0.0,785.0,425.5
135129938.0,17,6,1206,6,1206,27025987.6,201.0,201.0,0,0,0.0,0.0,0.0
209519.0,17,2,180,1,90,0.0,90.0,90.0,1,90,0.0,90.0,90.0
118271348.0,6,417,53970,209,14090,568612.25,140.0,67.41626794258373,208,39880,566389.695652174,336.0,191.73076923076923
210539.0,6,10,1221,6,636,42107.8,298.0,106.0,4,585,68678.66666666667,379.0,146.25
108109169.0,17,5,1005,5,1005,27027292.25,201.0,201.0,0,0,0.0,0.0,0.0
10479202.0,6,7,478,4,272,3447245.0,74.0,68.0,3,206,5170748.0,74.0,68.66666666666667
14639668.0,6,20,1607,10,975,1592224.4444444445,315.0,97.5,10,632,1592209.3333333333,78.0,63.2
186492.0,17,2,180,1,90,0.0,90.0,90.0,1,90,0.0,90.0,90.0
48863.0,6,10,1065,5,534,10832.75,262.0,106.8,5,531,9604.5,259.0,106.2
2061.0,17,4,344,2,150,0.0,75.0,75.0,2,194,0.0,103.0,97.0
227697.0,6,6,386,4,247,75899.0,85.0,61.75,2,139,0.0,85.0,69.5
308684.0,6,3,202,2,128,0.0,74.0,64.0,1,74,0.0,74.0,74.0
2799680.0,6,2,132,1,66,0.0,66.0,66.0,1,66,0.0,66.0,66.0
147906.0,17,2,180,1,90,0.0,90.0,90.0,1,90,0.0,90.0,90.0
20039713.0,6,377,353284,105,7102,192689.54807692303,206.0,67.63809523809523,272,346182,73922.89298892989,1514.0,1272.7279411764705
121382852.0,6,298,36794,149,10142,807507.7297297297,140.0,68.06711409395973,149,26652,814631.2837837838,284.0,178.8724832214765
175662.0,17,2,876,2,876,0.0,438.0,438.0,0,0,0.0,0.0,0.0
336.0,17,2,267,1,83,0.0,83.0,83.0,1,184,0.0,184.0,184.0
13252.0,6,14,4740,7,653,2082.0,249.0,93.28571428571428,7,4087,2075.833333333333,1514.0,583.8571428571429
1508005.0,6,19,7533,10,1403,167556.11111111112,583.0,140.3,9,6130,157099.625,1484.0,681.1111111111111
153436.0,17,2,180,1,90,0.0,90.0,90.0,1,90,0.0,90.0,90.0
106150.0,17,2,286,2,286,0.0,143.0,143.0,0,0,0.0,0.0,0.0
16707.0,6,2,145,2,145,0.0,91.0,72.5,0,0,0.0,0.0,0.0
31955.0,6,14,4740,7,653,4530.333333333333,249.0,93.28571428571428,7,4087,5144.0,1514.0,583.8571428571429
316764.0,6,6,412,4,272,105588.0,74.0,68.0,2,140,0.0,74.0,70.0
90257143.0,6,12,1832,8,1016,12893877.57142857,188.0,127.0,4,816,30026646.0,204.0,204.0
483.0,17,2,508,2,508,0.0,257.0,254.0,0,0,0.0,0.0,0.0
82750.0,6,2,134,1,68,0.0,68.0,68.0,1,66,0.0,66.0,66.0
90254318.0,6,14,2240,8,1016,12893474.0,188.0,127.0,6,1224,18016094.8,204.0,204.0
2593657.0,6,2,132,1,66,0.0,66.0,66.0,1,66,0.0,66.0,66.0
120238333.0,6,258,29260,129,8736,932922.7421875,140.0,67.72093023255815,129,20524,932927.40625,374.0,159.10077519379846
24687.0,6,14,4740,7,653,3989.8333333333335,249.0,93.28571428571428,7,4087,3925.1666666666665,1514.0,583.8571428571429
228545.0,17,2,180,1,90,0.0,90.0,90.0,1,90,0.0,90.0,90.0
299047.0,6,6,412,4,272,99682.33333333331,74.0,68.0,2,140,0.0,74.0,70.0
99421.0,17,2,762,2,762,0.0,381.0,381.0,0,0,0.0,0.0,0.0
238413.0,6,3,337,2,214,0.0,160.0,107.0,1,123,0.0,123.0,123.0
39267.0,6,14,4740,7,653,6167.5,249.0,93.28571428571428,7,4087,5745.0,1514.0,583.8571428571429
146156.0,6,3,337,2,214,0.0,160.0,107.0,1,123,0.0,123.0,123.0
108868.0,17,2,286,2,286,0.0,143.0,143.0,0,0,0.0,0.0,0.0
10888468.0,6,7,478,3,206,5375811.5,74.0,68.66666666666667,4,272,3583790.333333333,74.0,68.0
260828.0,6,10,1221,6,636,52165.6,298.0,106.0,4,585,80676.33333333333,379.0,146.25
351867.0,6,4,508,2,238,0.0,172.0,119.0,2,270,0.0,135.0,135.0
120135353.0,6,13,2020,9,1204,15016919.125,188.0,133.77777777777777,4,816,30030535.666666668,204.0,204.0
38343.0,6,14,4740,7,653,6234.333333333333,249.0,93.28571428571428,7,4087,5179.0,1514.0,583.8571428571429
135130781.0,17,6,1146,6,1146,27026156.2,191.0,191.0,0,0,0.0,0.0,0.0
234923.0,17,2,414,1,88,0.0,88.0,88.0,1,326,0.0,326.0,326.0
108104129.0,17,5,1005,5,1005,27026032.25,201.0,201.0,0,0,0.0,0.0,0.0
14645076.0,6,20,1607,10,975,1592932.3333333333,315.0,97.5,10,632,1592900.5555555555,78.0,63.2
228530.0,17,2,180,1,90,0.0,90.0,90.0,1,90,0.0,90.0,90.0
90530941.0,6,14,2240,8,1016,12932991.57142857,188.0,127.0,6,1224,18069946.0,204.0,204.0
106251404.0,6,27,1800,14,894,8173184.923076923,123.0,63.85714285714285,13,906,8195466.333333333,123.0,69.6923076923077
147994.0,17,2,180,1,90,0.0,90.0,90.0,1,90,0.0,90.0,90.0
90012324.0,17,28,13364,28,13364,3333789.777777778,501.0,477.2857142857143,0,0,0.0,0.0,0.0
108321840.0,17,7,1512,6,1206,21664368.0,201.0,201.0,1,306,0.0,306.0,306.0
312250.0,17,2,180,1,90,0.0,90.0,90.0,1,90,0.0,90.0,90.0
264594.0,6,3,337,2,214,0.0,160.0,107.0,1,123,0.0,123.0,123.0
5628458.0,6,5,336,2,134,0.0,68.0,67.0,3,202,1527699.0,70.0,67.33333333333333
14621.0,6,11,1132,6,556,2924.2,218.0,92.66666666666669,5,576,2668.0,304.0,115.2
5628129.0,6,4,270,2,134,0.0,68.0,67.0,2,136,0.0,70.0,68.0
166090.0,17,2,414,1,88,0.0,88.0,88.0,1,326,0.0,326.0,326.0
325.0,17,2,208,1,72,0.0,72.0,72.0,1,136,0.0,136.0,136.0
100871683.0,6,30,2122,15,1105,7205120.214285715,139.0,73.66666666666667,15,1017,7189671.0,123.0,67.8
1151417.0,6,11,1134,6,558,230283.4,220.0,93.0,5,576,286310.75,304.0,115.2
119648310.0,6,214,24218,107,16934,1126727.783018868,284.0,158.26168224299064,107,7284,1126728.1132075472,140.0,68.07476635514018
153464.0,17,2,180,1,90,0.0,90.0,90.0,1,90,0.0,90.0,90.0
6702.0,17,2,582,1,83,0.0,83.0,83.0,1,499,0.0,499.0,499.0
123550585.0,6,36,2602,19,1408,6863921.388888889,139.0,74.10526315789474,17,1194,7084344.5625,123.0,70.23529411764706
316.0,17,2,174,1,79,0.0,79.0,79.0,1,95,0.0,95.0,95.0
54815.0,6,10,2032,5,524,6724.75,252.0,104.8,5,1508,13352.25,1236.0,301.6
11274986.0,17,4,1368,4,1368,3758328.6666666665,342.0,342.0,0,0,0.0,0.0,0.0
149235120.0,6,22,1680,10,745,13279668.0,95.0,74.5,12,935,13547048.0,95.0,77.91666666666667
3009616.0,6,11,2106,6,598,601683.4,252.0,99.66666666666669,5,1508,1822.0,1236.0,301.6
90299938.0,6,16,1192,8,596,12893029.285714284,95.0,74.5,8,596,12898274.0,95.0,74.5
2108.0,17,4,344,2,150,0.0,75.0,75.0,2,194,0.0,103.0,97.0
247357.0,6,3,337,2,214,0.0,160.0,107.0,1,123,0.0,123.0,123.0
120125080.0,6,14,2224,9,1204,15015635.0,188.0,133.77777777777777,5,1020,22590797.25,204.0,204.0
102432.0,17,2,700,2,700,0.0,350.0,350.0,0,0,0.0,0.0,0.0
255019.0,6,3,337,2,214,0.0,160.0,107.0,1,123,0.0,123.0,123.0
90010824.0,17,28,13364,28,13364,3333734.222222222,501.0,477.2857142857143,0,0,0.0,0.0,0.0
5856319.0,6,5,336,2,134,0.0,68.0,67.0,3,202,1535491.5,70.0,67.33333333333333
3177798.0,6,18,1536,9,962,358298.125,315.0,106.88888888888889,9,574,358264.5,78.0,63.77777777777778
6945.0,17,2,582,1,83,0.0,83.0,83.0,1,499,0.0,499.0,499.0
7357.0,17,2,582,1,83,0.0,83.0,83.0,1,499,0.0,499.0,499.0
204479.0,17,2,180,1,90,0.0,90.0,90.0,1,90,0.0,90.0,90.0
98296374.0,6,160,18096,80,12594,1241533.7088607594,284.0,157.425,80,5502,1241534.405063291,140.0,68.775
20871.0,6,10,2032,5,524,4973.5,252.0,104.8,5,1508,4778.0,1236.0,301.6
197571.0,17,2,180,1,90,0.0,90.0,90.0,1,90,0.0,90.0,90.0
33045.0,6,14,4740,7,653,3842.3333333333335,249.0,93.28571428571428,7,4087,5333.5,1514.0,583.8571428571429
3013.0,17,2,762,2,762,0.0,381.0,381.0,0,0,0.0,0.0,0.0
317652.0,17,4,1400,4,1400,105884.0,350.0,350.0,0,0,0.0,0.0,0.0
20068.0,6,10,2032,5,524,4508.0,252.0,104.8,5,1508,3697.5,1236.0,301.6
30868.0,6,10,2032,5,524,7468.75,252.0,104.8,5,1508,7191.5,1236.0,301.6
83497.0,6,14,4740,7,653,13667.5,249.0,93.28571428571428,7,4087,13162.5,1514.0,583.8571428571429
206237.0,6,3,426,2,280,0.0,214.0,140.0,1,146,0.0,146.0,146.0
3051797.0,6,3,204,2,136,0.0,70.0,68.0,1,68,0.0,68.0,68.0
34816.0,6,14,4740,7,653,5478.5,249.0,93.28571428571428,7,4087,5664.333333333333,1514.0,583.8571428571429
112324162.0,17,16,1212,8,606,16000762.857142856,174.0,75.75,8,606,16000137.285714284,174.0,75.75
321620.0,17,4,1400,4,1400,107206.66666666669,350.0,350.0,0,0,0.0,0.0,0.0
216359.0,17,2,180,1,90,0.0,90.0,90.0,1,90,0.0,90.0,90.0
209487.0,17,2,180,1,90,0.0,90.0,90.0,1,90,0.0,90.0,90.0
135136821.0,17,6,1146,6,1146,27027364.2,191.0,191.0,0,0,0.0,0.0,0.0
143902.0,17,2,180,1,90,0.0,90.0,90.0,1,90,0.0,90.0,90.0
10559206.0,6,7,478,4,272,3472697.333333333,74.0,68.0,3,206,5208962.0,74.0,68.66666666666667
16270.0,6,10,2032,5,524,3508.75,252.0,104.8,5,1508,3344.0,1236.0,301.6
146817.0,6,3,337,2,214,0.0,160.0,107.0,1,123,0.0,123.0,123.0
103545.0,17,2,286,2,286,0.0,143.0,143.0,0,0,0.0,0.0,0.0
302966.0,6,6,412,4,272,100988.66666666669,74.0,68.0,2,140,0.0,74.0,70.0
213625.0,17,2,180,1,90,0.0,90.0,90.0,1,90,0.0,90.0,90.0
310647.0,17,4,1400,4,1400,103549.0,350.0,350.0,0,0,0.0,0.0,0.0
146446.0,6,3,337,2,214,0.0,160.0,107.0,1,123,0.0,123.0,123.0
146270.0,6,3,337,2,214,0.0,160.0,107.0,1,123,0.0,123.0,123.0
206996.0,6,3,426,2,280,0.0,214.0,140.0,1,146,0.0,146.0,146.0
90049027.0,17,28,13364,28,13364,3335149.1481481483,501.0,477.2857142857143,0,0,0.0,0.0,0.0
11503.0,6,11,2098,6,590,2069.4,252.0,98.33333333333331,5,1508,2153.5,1236.0,301.6
202070.0,6,12,1373,7,714,33678.333333333336,298.0,102.0,5,659,49576.25,379.0,131.8
2035.0,17,4,344,2,150,0.0,75.0,75.0,2,194,0.0,103.0,97.0
143976.0,17,2,180,1,90,0.0,90.0,90.0,1,90,0.0,90.0,90.0
149719270.0,6,15,2290,5,1020,29962905.75,204.0,204.0,10,1270,16635276.333333334,188.0,127.0
97915628.0,6,167,18828,84,5766,1179706.3614457832,140.0,68.64285714285714,83,13062,1181549.536585366,284.0,157.3734939759036
135129338.0,17,6,1206,6,1206,27025867.6,201.0,201.0,0,0,0.0,0.0,0.0
10462610.0,6,7,478,4,272,3441996.6666666665,74.0,68.0,3,206,5162868.0,74.0,68.66666666666667
32048.0,6,10,2032,5,524,7252.75,252.0,104.8,5,1508,7637.0,1236.0,301.6
90198342.0,6,13,2036,8,1016,12885477.42857143,188.0,127.0,5,1020,22508402.5,204.0,204.0
18030.0,6,14,4740,7,653,2808.333333333333,249.0,93.28571428571428,7,4087,2866.1666666666665,1514.0,583.8571428571429
2444.0,17,4,344,2,150,0.0,75.0,75.0,2,194,0.0,103.0,97.0
71008.0,6,14,4740,7,653,11232.5,249.0,93.28571428571428,7,4087,11696.166666666666,1514.0,583.8571428571429
120125082.0,6,14,2224,9,1204,15015635.25,188.0,133.77777777777777,5,1020,22523288.75,204.0,204.0
236060.0,6,3,337,2,214,0.0,160.0,107.0,1,123,0.0,123.0,123.0
119475635.0,6,260,30288,130,21412,924488.2945736434,300.0,164.7076923076923,130,8876,924498.7054263566,140.0,68.27692307692308
13667.0,6,11,1132,6,556,2590.8,218.0,92.66666666666669,5,576,2872.5,304.0,115.2
298990.0,6,6,412,4,272,99663.33333333331,74.0,68.0,2,140,0.0,74.0,70.0
318498.0,17,2,620,1,75,0.0,75.0,75.0,1,545,0.0,545.0,545.0
2463.0,17,4,344,2,150,0.0,75.0,75.0,2,194,0.0,103.0,97.0
104331.0,17,2,700,2,700,0.0,350.0,350.0,0,0,0.0,0.0,0.0
120077445.0,17,29,13785,29,13785,4288480.178571428,501.0,475.3448275862069,0,0,0.0,0.0,0.0
381.0,17,2,267,1,83,0.0,83.0,83.0,1,184,0.0,184.0,184.0
257120.00000000003,17,2,180,1,70,0.0,70.0,70.0,1,110,0.0,110.0,110.0
90072106.0,17,28,13364,28,13364,3336003.925925926,501.0,477.2857142857143,0,0,0.0,0.0,0.0
135137577.0,17,6,1146,6,1146,27027515.4,191.0,191.0,0,0,0.0,0.0,0.0
331.0,17,2,166,1,75,0.0,75.0,75.0,1,91,0.0,91.0,91.0
153492.0,17,2,180,1,90,0.0,90.0,90.0,1,90,0.0,90.0,90.0
311058.0,17,4,622,4,622,103686.0,163.0,155.5,0,0,0.0,0.0,0.0
9899.0,6,10,1975,5,467,2250.25,195.0,93.4,5,1508,2027.5,1236.0,301.6
495738.0,6,4,270,2,134,0.0,68.0,67.0,2,136,0.0,70.0,68.0
2197.0,17,4,344,2,150,0.0,75.0,75.0,2,194,0.0,103.0,97.0
107759.0,17,2,286,2,286,0.0,143.0,143.0,0,0,0.0,0.0,0.0
34580.0,6,14,4740,7,653,5613.833333333333,249.0,93.28571428571428,7,4087,5480.333333333333,1514.0,583.8571428571429
113950979.0,6,48,3168,24,1584,4954390.391304348,66.0,66.0,24,1584,4942544.826086956,66.0,66.0
1489.0,17,5,550,5,550,372.25,110.0,110.0,0,0,0.0,0.0,0.0
153830.0,17,2,180,1,90,0.0,90.0,90.0,1,90,0.0,90.0,90.0
109388589.0,6,30,2122,15,1105,7798062.928571428,139.0,73.66666666666667,15,1017,7798064.5,123.0,67.8
212486.0,6,3,426,2,280,0.0,214.0,140.0,1,146,0.0,146.0,146.0
405334.0,6,4,508,2,238,0.0,172.0,119.0,2,270,0.0,135.0,135.0
205577.0,17,2,180,1,90,0.0,90.0,90.0,1,90,0.0,90.0,90.0
300.0,17,2,164,1,82,0.0,82.0,82.0,1,82,0.0,82.0,82.0
90229911.0,6,17,1287,8,596,12853821.142857144,95.0,74.5,9,691,11251788.25,95.0,76.77777777777777
197164.0,17,2,180,1,90,0.0,90.0,90.0,1,90,0.0,90.0,90.0
13710.0,6,11,1131,6,600,2340.6,262.0,100.0,5,531,2712.25,259.0,106.2
52239.0,6,14,4740,7,653,8581.166666666666,249.0,93.28571428571428,7,4087,7342.333333333333,1514.0,583.8571428571429
130012.0,6,2,132,1,66,0.0,66.0,66.0,1,66,0.0,66.0,66.0
16047123.0,17,10,1746,5,380,4011701.75,89.0,76.0,5,1366,3973660.25,443.0,273.2
2396059.0,6,3,1604,1,753,0.0,753.0,753.0,2,851,0.0,785.0,425.5
347.0,17,2,160,1,80,0.0,80.0,80.0,1,80,0.0,80.0,80.0
2591895.0,6,2,132,1,66,0.0,66.0,66.0,1,66,0.0,66.0,66.0
142796.0,6,2,132,1,66,0.0,66.0,66.0,1,66,0.0,66.0,66.0
15093.0,17,2,180,1,90,0.0,90.0,90.0,1,90,0.0,90.0,90.0
262143.00000000003,6,3,337,2,214,0.0,160.0,107.0,1,123,0.0,123.0,123.0
90525335.0,6,14,2240,8,1016,12932190.714285716,188.0,127.0,6,1224,18071759.0,204.0,204.0
21380.0,6,14,4740,7,653,3291.6666666666665,249.0,93.28571428571428,7,4087,3393.1666666666665,1514.0,583.8571428571429
228301.0,17,2,180,1,90,0.0,90.0,90.0,1,90,0.0,90.0,90.0
120094197.0,6,586,88934,293,19782,408891.9280821918,214.0,67.51535836177474,293,69152,408540.0273972603,1514.0,236.0136518771331
0.0,17,1,381,1,381,0.0,381.0,381.0,0,0,0.0,0.0,0.0
140112.0,6,2,132,1,66,0.0,66.0,66.0,1,66,0.0,66.0,66.0
8901.0,17,4,823,2,163,0.0,89.0,81.5,2,660,0.0,443.0,330.0
120000008.0,6,16,1192,8,596,17142858.285714287,95.0,74.5,8,596,17106627.714285713,95.0,74.5
2135.0,17,4,344,2,150,0.0,75.0,75.0,2,194,0.0,103.0,97.0
108111887.0,17,5,955,5,955,27027971.75,191.0,191.0,0,0,0.0,0.0,0.0
105306.0,17,2,286,2,286,0.0,143.0,143.0,0,0,0.0,0.0,0.0
446749.0,6,10,1221,6,636,89349.8,298.0,106.0,4,585,143393.0,379.0,146.25
32681539.0,6,5,336,2,134,0.0,68.0,67.0,3,202,15051469.5,70.0,67.33333333333333
20856.0,6,11,1133,6,602,3208.4,264.0,100.33333333333331,5,531,4938.5,259.0,106.2
120122795.0,6,14,2224,9,1204,15015349.375,188.0,133.77777777777777,5,1020,22524335.25,204.0,204.0
5640361.0,6,5,336,2,134,0.0,68.0,67.0,3,202,1531188.5,70.0,67.33333333333333
35684.0,6,14,2899,8,685,5097.714285714285,215.0,85.625,6,2214,6578.6,1514.0,369.0
2353.0,17,2,664,1,322,0.0,322.0,322.0,1,342,0.0,342.0,342.0
108108310.0,17,5,1005,5,1005,27027077.5,201.0,201.0,0,0,0.0,0.0,0.0
135126724.0,17,6,1206,6,1206,27025344.8,201.0,201.0,0,0,0.0,0.0,0.0
106529246.0,6,29,2068,15,1105,7593799.428571428,139.0,73.66666666666667,14,963,8177938.923076923,123.0,68.78571428571429
155213.0,6,3,337,2,214,0.0,160.0,107.0,1,123,0.0,123.0,123.0
100294.0,17,2,762,2,762,0.0,381.0,381.0,0,0,0.0,0.0,0.0
3379050.0,6,180,143921,101,134065,33790.5,1510.0,1327.3762376237623,79,9856,39191.94871794872,1510.0,124.75949367088609
6734.0,17,2,582,1,83,0.0,83.0,83.0,1,499,0.0,499.0,499.0
23742.0,17,2,180,1,90,0.0,90.0,90.0,1,90,0.0,90.0,90.0
553881.0,17,4,629,3,234,1059.5,78.0,78.0,1,395,0.0,395.0,395.0
34424.0,6,14,4740,7,653,5612.333333333333,249.0,93.28571428571428,7,4087,4792.833333333333,1514.0,583.8571428571429
205067.0,17,2,762,2,762,0.0,381.0,381.0,0,0,0.0,0.0,0.0
2598679.0,6,2,132,1,66,0.0,66.0,66.0,1,66,0.0,66.0,66.0
3094.0,17,2,224,1,76,0.0,76.0,76.0,1,148,0.0,148.0,148.0
3011894.0,6,11,2106,6,598,601955.0,252.0,99.66666666666669,5,1508,3181.5,1236.0,301.6
107615955.0,6,32,2374,17,1288,6713208.9375,139.0,75.76470588235294,15,1086,7672251.285714285,123.0,72.4
120009654.0,6,21,1585,11,840,11999996.9,95.0,76.36363636363636,10,745,13333169.111111112,95.0,74.5
321911.0,17,4,1400,4,1400,107303.66666666669,350.0,350.0,0,0,0.0,0.0,0.0
299726.0,6,6,412,4,272,99908.66666666669,74.0,68.0,2,140,0.0,74.0,70.0
10840306.0,6,8,544,4,272,3567674.333333333,74.0,68.0,4,272,3567627.6666666665,74.0,68.0
3007362.0,6,11,2106,6,598,601226.6,252.0,99.66666666666669,5,1508,1700.25,1236.0,301.6
33682.0,6,14,4740,7,653,5491.5,249.0,93.28571428571428,7,4087,4034.5,1514.0,583.8571428571429
326.0,17,2,174,1,79,0.0,79.0,79.0,1,95,0.0,95.0,95.0
90258622.0,6,12,1832,8,1016,12894088.857142856,188.0,127.0,4,816,30031898.33333333,204.0,204.0
122002024.0,17,15,907,8,475,17428860.57142857,174.0,59.375,7,432,17000168.333333332,174.0,61.71428571428572
17455.0,6,10,1066,5,490,3875.25,218.0,98.0,5,576,4082.25,304.0,115.2
103225.0,17,2,286,2,286,0.0,143.0,143.0,0,0,0.0,0.0,0.0
315713.0,6,6,412,4,272,105237.66666666669,74.0,68.0,2,140,0.0,74.0,70.0
0.0,17,1,55,1,55,0.0,55.0,55.0,0,0,0.0,0.0,0.0
681320.0,6,4,497,3,374,340660.0,160.0,124.66666666666669,1,123,0.0,123.0,123.0
94978227.0,6,40,2640,20,1320,4998854.052631579,66.0,66.0,20,1320,4982861.210526316,66.0,66.0
2344.0,17,4,344,2,150,0.0,75.0,75.0,2,194,0.0,103.0,97.0
502361.0,6,3,1604,2,851,0.0,785.0,425.5,1,753,0.0,753.0,753.0
311556.0,6,3,202,2,128,0.0,74.0,64.0,1,74,0.0,74.0,74.0
148014.0,17,2,180,1,90,0.0,90.0,90.0,1,90,0.0,90.0,90.0
5009247.0,17,4,376,2,152,0.0,76.0,76.0,2,224,0.0,148.0,112.0
302850.0,6,6,412,4,272,100950.0,74.0,68.0,2,140,0.0,74.0,70.0
144783.0,17,2,180,1,70,0.0,70.0,70.0,1,110,0.0,110.0,110.0
250662.0,17,4,6056,4,6056,83554.0,1514.0,1514.0,0,0,0.0,0.0,0.0
9106.0,17,2,539,1,86,0.0,86.0,86.0,1,453,0.0,453.0,453.0
213631.0,6,10,1221,6,636,42726.2,298.0,106.0,4,585,70041.0,379.0,146.25
33507.0,6,14,4740,7,653,4763.5,249.0,93.28571428571428,7,4087,5454.333333333333,1514.0,583.8571428571429
3012115.0,6,11,2106,6,598,602250.4,252.0,99.66666666666669,5,1508,3065.0,1236.0,301.6
1937.0,17,4,344,2,150,0.0,75.0,75.0,2,194,0.0,103.0,97.0
196871.0,17,2,180,1,90,0.0,90.0,90.0,1,90,0.0,90.0,90.0
64751.0,6,14,4740,7,653,10273.666666666666,249.0,93.28571428571428,7,4087,10654.833333333334,1514.0,583.8571428571429
1303155.0,6,4,264,2,132,0.0,66.0,66.0,2,132,0.0,66.0,66.0
55074.0,6,14,4740,7,653,8871.166666666666,249.0,93.28571428571428,7,4087,5954.166666666667,1514.0,583.8571428571429
2795216.0,6,2,132,1,66,0.0,66.0,66.0,1,66,0.0,66.0,66.0
55252.0,6,14,4740,7,653,8468.833333333334,249.0,93.28571428571428,7,4087,8619.166666666666,1514.0,583.8571428571429
90372491.0,6,12,1848,5,1020,22592809.75,204.0,204.0,7,828,15061827.0,188.0,118.28571428571428
42938.0,6,14,4740,7,653,6802.5,249.0,93.28571428571428,7,4087,6716.0,1514.0,583.8571428571429
281387.0,17,2,363,1,79,0.0,79.0,79.0,1,284,0.0,284.0,284.0
90256630.0,6,12,1832,8,1016,12893804.285714284,188.0,127.0,4,816,30030931.0,204.0,204.0
108099513.0,17,5,1005,5,1005,27024878.25,201.0,201.0,0,0,0.0,0.0,0.0
103893032.0,6,44,2904,22,1452,4947287.238095238,66.0,66.0,22,1452,4932408.0,66.0,66.0
135148211.0,17,6,1206,6,1206,27029642.2,201.0,201.0,0,0,0.0,0.0,0.0
108076275.0,17,5,955,5,955,27019068.75,191.0,191.0,0,0,0.0,0.0,0.0
10935845.0,6,8,544,4,272,3599796.0,74.0,68.0,4,272,3599718.6666666665,74.0,68.0
120000122.0,6,22,1680,12,935,10909102.0,95.0,77.91666666666667,10,745,10104118.111111112,95.0,74.5
103503601.0,6,44,2904,22,1452,4928742.904761905,66.0,66.0,22,1452,4914285.571428572,66.0,66.0
1727631.0,6,23,6509,12,1529,157057.36363636365,357.0,127.41666666666669,11,4980,141346.4,1510.0,452.7272727272728
25256.0,6,10,2032,5,524,4841.25,252.0,104.8,5,1508,5573.75,1236.0,301.6
1368663.0,17,6,1230,3,234,684143.0,78.0,78.0,3,996,684130.5,332.0,332.0
59025.0,6,14,4740,7,653,9309.166666666666,249.0,93.28571428571428,7,4087,9277.833333333334,1514.0,583.8571428571429
108337566.0,6,210,23646,105,16494,1039638.5384615384,284.0,157.0857142857143,105,7152,1039638.3076923076,140.0,68.11428571428571
1449604.0,6,8,602,5,404,337629.5,103.0,80.8,3,198,204962.0,66.0,66.0
12168.0,6,13,1459,7,862,2028.0,271.0,123.14285714285714,6,597,2208.8,259.0,99.5
0.0,6,1,66,1,66,0.0,66.0,66.0,0,0,0.0,0.0,0.0
10421121.0,6,7,478,4,272,3428335.6666666665,74.0,68.0,3,206,5142389.5,74.0,68.66666666666667
90260721.0,6,13,1898,8,1016,12894388.714285716,188.0,127.0,5,882,22524196.5,204.0,176.4
120687785.0,6,22,1680,11,840,12068778.5,95.0,76.36363636363636,11,840,9044108.9,95.0,76.36363636363636
7290.0,17,4,823,2,163,0.0,89.0,81.5,2,660,0.0,443.0,330.0
52776.0,6,10,1065,5,534,12949.75,262.0,106.8,5,531,4077.5,259.0,106.2
217625.0,6,3,426,2,280,0.0,214.0,140.0,1,146,0.0,146.0,146.0
13656.0,6,10,1067,5,536,2732.75,264.0,107.2,5,531,2996.25,259.0,106.2
306013.0,6,6,412,4,272,102004.33333333331,74.0,68.0,2,140,0.0,74.0,70.0
135137518.0,17,6,1146,6,1146,27027503.6,191.0,191.0,0,0,0.0,0.0,0.0
108108865.0,17,5,955,5,955,27027216.25,191.0,191.0,0,0,0.0,0.0,0.0
9152.0,17,2,498,1,80,0.0,80.0,80.0,1,418,0.0,418.0,418.0
19615.0,6,2,145,2,145,0.0,91.0,72.5,0,0,0.0,0.0,0.0
130363.0,6,3,337,2,214,0.0,160.0,107.0,1,123,0.0,123.0,123.0
335.0,17,2,166,1,75,0.0,75.0,75.0,1,91,0.0,91.0,91.0
90045162.0,17,28,13364,28,13364,3335006.0,501.0,477.2857142857143,0,0,0.0,0.0,0.0
196856.0,17,2,180,1,90,0.0,90.0,90.0,1,90,0.0,90.0,90.0
302.0,17,2,168,1,76,0.0,76.0,76.0,1,92,0.0,92.0,92.0
329.0,17,2,174,1,79,0.0,79.0,79.0,1,95,0.0,95.0,95.0
117559941.0,6,224,25418,112,17730,1057158.6396396395,374.0,158.30357142857142,112,7688,1057158.6576576575,140.0,68.64285714285714
25292.0,17,4,344,2,150,0.0,75.0,75.0,2,194,0.0,103.0,97.0
0.0,17,1,179,1,179,0.0,179.0,179.0,0,0,0.0,0.0,0.0
104841917.0,6,32,2236,16,1165,6989461.133333334,139.0,72.8125,16,1071,6975049.933333334,123.0,66.9375
341.0,17,2,250,1,93,0.0,93.0,93.0,1,157,0.0,157.0,157.0
96005873.0,17,11,735,6,389,19201174.6,174.0,64.83333333333333,5,346,19961399.25,174.0,69.2
38583.0,6,14,4740,7,653,5151.5,249.0,93.28571428571428,7,4087,6259.5,1514.0,583.8571428571429
90293976.0,6,17,1287,9,691,11280456.625,95.0,76.77777777777777,8,596,12831950.57142857,95.0,74.5
122601742.0,6,252,28436,126,8538,952046.88,140.0,67.76190476190476,126,19898,974246.552,284.0,157.9206349206349
145085.0,17,2,180,1,70,0.0,70.0,70.0,1,110,0.0,110.0,110.0
108031687.0,6,219,24918,110,7482,991116.3944954128,140.0,68.01818181818182,109,17436,991634.6574074074,300.0,159.96330275229357
12289.0,17,4,823,2,163,0.0,89.0,81.5,2,660,0.0,443.0,330.0
4320.0,17,4,813,2,144,0.0,72.0,72.0,2,669,0.0,542.0,334.5
251145.0,6,3,373,2,238,0.0,172.0,119.0,1,135,0.0,135.0,135.0
152231.0,17,2,414,1,88,0.0,88.0,88.0,1,326,0.0,326.0,326.0
120482001.0,6,21,1585,11,840,9044205.2,95.0,76.36363636363636,10,745,13381643.111111112,95.0,74.5
90053345.0,17,27,12943,27,12943,3463590.1923076925,501.0,479.3703703703704,0,0,0.0,0.0,0.0
108104870.0,17,5,955,5,955,27026217.5,191.0,191.0,0,0,0.0,0.0,0.0
42589.0,6,10,2032,5,524,9787.5,252.0,104.8,5,1508,6317.5,1236.0,301.6
283750.0,17,2,414,1,88,0.0,88.0,88.0,1,326,0.0,326.0,326.0
176691.0,6,12,1354,6,723,33368.8,253.0,120.5,6,631,34298.0,293.0,105.16666666666669
145459.0,6,3,337,2,214,0.0,160.0,107.0,1,123,0.0,123.0,123.0
303579.0,6,6,412,4,272,101193.0,74.0,68.0,2,140,0.0,74.0,70.0
90717907.0,6,157,17734,79,5362,1163050.0897435895,140.0,67.87341772151899,78,12372,1164854.6493506494,284.0,158.6153846153846
120121590.0,6,13,2036,5,1020,30030397.5,204.0,204.0,8,1016,17136662.85714286,188.0,127.0
122687959.0,6,49,3234,25,1650,5111998.291666667,66.0,66.0,24,1584,4943821.652173913,66.0,66.0
3042.0,17,2,174,1,79,0.0,79.0,79.0,1,95,0.0,95.0,95.0
108113707.0,17,5,1005,5,1005,27028426.75,201.0,201.0,0,0,0.0,0.0,0.0
153429.0,17,2,180,1,90,0.0,90.0,90.0,1,90,0.0,90.0,90.0
108455.0,17,2,286,2,286,0.0,143.0,143.0,0,0,0.0,0.0,0.0
101199015.0,6,204,23134,102,16180,999818.5643564356,300.0,158.62745098039215,102,6954,999831.9009900992,140.0,68.17647058823529
141435.0,6,11,1132,6,556,27690.2,218.0,92.66666666666669,5,576,34962.5,304.0,115.2
0.0,17,1,55,1,55,0.0,55.0,55.0,0,0,0.0,0.0,0.0
119239675.0,17,35,16705,35,16705,3507049.2647058824,501.0,477.2857142857143,0,0,0.0,0.0,0.0
329552.0,6,10,1221,6,636,65910.4,298.0,106.0,4,585,108990.0,379.0,146.25
95573030.0,6,349,41730,175,30024,549270.2873563218,284.0,171.56571428571428,174,11706,546209.8554913295,140.0,67.27586206896552
16017382.000000002,17,2,684,2,684,0.0,342.0,342.0,0,0,0.0,0.0,0.0
228297.0,17,2,180,1,90,0.0,90.0,90.0,1,90,0.0,90.0,90.0
121516084.0,6,225,25468,113,17780,1084965.0357142857,284.0,157.34513274336285,112,7688,1076285.7027027027,140.0,68.64285714285714
20472.0,6,14,4740,7,653,3264.6666666666665,249.0,93.28571428571428,7,4087,3193.0,1514.0,583.8571428571429
311695.0,17,4,1400,4,1400,103898.33333333331,350.0,350.0,0,0,0.0,0.0,0.0
33120293.0,6,7,1874,3,887,16491144.5,753.0,295.6666666666667,4,987,10996501.0,785.0,246.75
58617085.0,17,9,3086,8,2736,5108258.571428572,342.0,342.0,1,350,0.0,350.0,350.0
143968.0,17,2,180,1,90,0.0,90.0,90.0,1,90,0.0,90.0,90.0
38356.0,6,14,4740,7,653,5926.833333333333,249.0,93.28571428571428,7,4087,6031.833333333333,1514.0,583.8571428571429
306667.0,6,6,412,4,272,102222.33333333331,74.0,68.0,2,140,0.0,74.0,70.0
246268.0,6,3,337,2,214,0.0,160.0,107.0,1,123,0.0,123.0,123.0
0.0,17,1,350,1,350,0.0,350.0,350.0,0,0,0.0,0.0,0.0
21146.0,6,11,2098,6,590,3043.4,252.0,98.33333333333331,5,1508,4805.5,1236.0,301.6
305.0,17,2,168,1,76,0.0,76.0,76.0,1,92,0.0,92.0,92.0
236596.0,6,3,337,2,214,0.0,160.0,107.0,1,123,0.0,123.0,123.0
146149.0,6,3,337,2,214,0.0,160.0,107.0,1,123,0.0,123.0,123.0
44300.0,6,14,4740,7,653,7266.666666666667,249.0,93.28571428571428,7,4087,6213.333333333333,1514.0,583.8571428571429
8691983.0,17,4,1376,3,1026,948150.0,342.0,342.0,1,350,0.0,350.0,350.0
322174.0,17,4,704,2,148,0.0,74.0,74.0,2,556,0.0,280.0,278.0
106415.0,6,14,4740,7,653,17052.833333333332,249.0,93.28571428571428,7,4087,16836.0,1514.0,583.8571428571429
108109113.0,17,5,1005,5,1005,27027278.25,201.0,201.0,0,0,0.0,0.0,0.0
4519.0,17,2,180,1,90,0.0,90.0,90.0,1,90,0.0,90.0,90.0
149998101.0,17,36,17126,36,17126,4285660.028571429,501.0,475.72222222222223,0,0,0.0,0.0,0.0
99219857.0,6,256,29278,128,8682,781212.3858267716,140.0,67.828125,128,20596,766590.7007874015,390.0,160.90625
100158791.0,6,30,2106,15,1089,7154199.357142857,123.0,72.6,15,1017,7138743.571428572,123.0,67.8
108101572.0,17,5,955,5,955,27025393.0,191.0,191.0,0,0,0.0,0.0,0.0
228120.0,17,2,180,1,90,0.0,90.0,90.0,1,90,0.0,90.0,90.0
90032246.0,17,28,13364,28,13364,3334527.6296296297,501.0,477.2857142857143,0,0,0.0,0.0,0.0
3121637.0,6,5,336,2,134,0.0,68.0,67.0,3,202,1423886.0,70.0,67.33333333333333
100823803.0,17,12,778,6,389,19835471.8,174.0,64.83333333333333,6,389,20132982.6,174.0,64.83333333333333
103589617.0,6,43,2838,22,1452,4932823.238095238,66.0,66.0,21,1386,5160003.7,66.0,66.0
27012.0,6,11,2098,6,590,5250.2,252.0,98.33333333333331,5,1508,4812.5,1236.0,301.6
113733805.0,6,46,3036,23,1518,5155437.409090909,66.0,66.0,23,1518,5155437.2727272725,66.0,66.0
143814.0,17,2,180,1,90,0.0,90.0,90.0,1,90,0.0,90.0,90.0
17240392.0,6,18,1442,9,843,2154770.25,257.0,93.66666666666669,9,599,2120612.25,95.0,66.55555555555556
4327.0,17,4,344,2,150,0.0,75.0,75.0,2,194,0.0,103.0,97.0
303566.0,6,6,412,4,272,101188.66666666669,74.0,68.0,2,140,0.0,74.0,70.0
108113804.0,17,5,1005,5,1005,27028451.0,201.0,201.0,0,0,0.0,0.0,0.0
10460350.0,6,7,478,4,272,3441290.0,74.0,68.0,3,206,5161842.0,74.0,68.66666666666667
9605.0,6,10,1065,5,534,2185.5,262.0,106.8,5,531,2088.25,259.0,106.2
2044.0,17,4,344,2,150,0.0,75.0,75.0,2,194,0.0,103.0,97.0
232426.0,6,3,337,2,214,0.0,160.0,107.0,1,123,0.0,123.0,123.0
143904.0,17,2,180,1,90,0.0,90.0,90.0,1,90,0.0,90.0,90.0
90053262.0,17,28,13364,28,13364,3335306.0,501.0,477.2857142857143,0,0,0.0,0.0,0.0
9753.0,17,2,582,1,83,0.0,83.0,83.0,1,499,0.0,499.0,499.0
308.0,17,2,174,1,79,0.0,79.0,79.0,1,95,0.0,95.0,95.0
216569.0,17,2,180,1,90,0.0,90.0,90.0,1,90,0.0,90.0,90.0
98243.0,17,2,762,2,762,0.0,381.0,381.0,0,0,0.0,0.0,0.0
122004425.0,17,15,1169,8,606,17429203.57142857,174.0,75.75,7,563,17000235.5,174.0,80.42857142857143
2016.0,17,4,344,2,150,0.0,75.0,75.0,2,194,0.0,103.0,97.0
1906.0,17,4,344,2,150,0.0,75.0,75.0,2,194,0.0,103.0,97.0
26831470.0,17,5,1710,5,1710,6707867.5,342.0,342.0,0,0,0.0,0.0,0.0
108107073.0,17,5,955,5,955,27026768.25,191.0,191.0,0,0,0.0,0.0,0.0
745902.0,6,2,132,1,66,0.0,66.0,66.0,1,66,0.0,66.0,66.0
2798860.0,6,2,132,1,66,0.0,66.0,66.0,1,66,0.0,66.0,66.0
141162.0,17,4,704,2,148,0.0,74.0,74.0,2,556,0.0,280.0,278.0
103346031.0,17,24,6409,11,1483,10334603.1,522.0,134.8181818181818,13,4926,7487504.666666667,1214.0,378.9230769230769
19890.0,17,2,582,1,83,0.0,83.0,83.0,1,499,0.0,499.0,499.0
246037.0,6,3,337,2,214,0.0,160.0,107.0,1,123,0.0,123.0,123.0
108339576.0,17,7,1452,6,1146,21667915.2,191.0,191.0,1,306,0.0,306.0,306.0
115117425.0,6,564,75420,282,56586,408897.98932384345,300.0,200.6595744680851,282,18834,408880.1921708185,140.0,66.7872340425532
90215386.0,6,16,1192,8,596,12852797.285714284,95.0,74.5,8,596,12857154.0,95.0,74.5
2093.0,17,4,344,2,150,0.0,75.0,75.0,2,194,0.0,103.0,97.0
265518.0,6,10,1221,6,636,53103.6,298.0,106.0,4,585,81133.66666666667,379.0,146.25
233680.0,6,3,337,2,214,0.0,160.0,107.0,1,123,0.0,123.0,123.0
209020.0,6,3,426,2,280,0.0,214.0,140.0,1,146,0.0,146.0,146.0
1467899.0,17,16,1120,16,1120,97859.93333333332,70.0,70.0,0,0,0.0,0.0,0.0
298018.0,6,6,412,4,272,99339.33333333331,74.0,68.0,2,140,0.0,74.0,70.0
90257732.0,6,14,2240,8,1016,12893961.714285716,188.0,127.0,6,1224,18019173.0,204.0,204.0
123455792.0,6,49,3234,25,1650,5143991.333333333,66.0,66.0,24,1584,5203917.391304348,66.0,66.0
4208.0,17,2,610,1,72,0.0,72.0,72.0,1,538,0.0,538.0,538.0
2318.0,17,4,344,2,150,0.0,75.0,75.0,2,194,0.0,103.0,97.0
12600.0,6,10,1975,5,467,2819.5,195.0,93.4,5,1508,2641.5,1236.0,301.6
2444893.0,6,3,1602,2,850,0.0,784.0,425.0,1,752,0.0,752.0,752.0
135133365.0,17,6,1206,6,1206,27026673.0,201.0,201.0,0,0,0.0,0.0,0.0
147312.0,6,4,439,2,238,0.0,172.0,119.0,2,201,0.0,135.0,100.5
153522.0,17,2,180,1,90,0.0,90.0,90.0,1,90,0.0,90.0,90.0
317195.0,6,3,202,2,128,0.0,74.0,64.0,1,74,0.0,74.0,74.0
120318462.0,6,226,25672,113,7680,1057905.232142857,140.0,67.96460176991151,113,17992,1057816.5357142857,300.0,159.2212389380531
90285573.0,6,16,1192,8,596,12892197.57142857,95.0,74.5,8,596,12896759.142857144,95.0,74.5
9844.0,17,4,823,2,163,0.0,89.0,81.5,2,660,0.0,443.0,330.0
122005388.0,17,15,1169,8,606,17429341.14285714,174.0,75.75,7,563,17000159.5,174.0,80.42857142857143
9500.0,17,2,507,1,86,0.0,86.0,86.0,1,421,0.0,421.0,421.0
90945568.0,6,21,1585,11,840,9094315.7,95.0,76.36363636363636,10,745,10103731.111111112,95.0,74.5
33690.0,6,14,4740,7,653,5372.333333333333,249.0,93.28571428571428,7,4087,4935.166666666667,1514.0,583.8571428571429
1479.0,17,5,550,5,550,369.75,110.0,110.0,0,0,0.0,0.0,0.0
34790.0,6,10,2032,5,524,8465.25,252.0,104.8,5,1508,8415.75,1236.0,301.6
296379.0,6,6,412,4,272,98793.0,74.0,68.0,2,140,0.0,74.0,70.0
108109359.0,17,5,1005,5,1005,27027339.75,201.0,201.0,0,0,0.0,0.0,0.0
3210336.0,17,3,1026,3,1026,1605168.0,342.0,342.0,0,0,0.0,0.0,0.0
40630.0,6,11,2098,6,590,7593.0,252.0,98.33333333333331,5,1508,6858.0,1236.0,301.6
35260.0,6,14,4740,7,653,5754.5,249.0,93.28571428571428,7,4087,5735.166666666667,1514.0,583.8571428571429
149761132.0,6,19,2759,11,1554,14976113.2,204.0,141.27272727272728,8,1205,17106033.42857143,199.0,150.625
135137222.0,17,6,1206,6,1206,27027444.4,201.0,201.0,0,0,0.0,0.0,0.0
100635316.0,17,12,516,6,258,20000144.4,43.0,43.0,6,258,20000755.2,43.0,43.0
207371.0,6,3,426,2,280,0.0,214.0,140.0,1,146,0.0,146.0,146.0
207303.0,6,3,426,2,280,0.0,214.0,140.0,1,146,0.0,146.0,146.0
207141.0,6,3,426,2,280,0.0,214.0,140.0,1,146,0.0,146.0,146.0
0.0,17,1,90,1,90,0.0,90.0,90.0,0,0,0.0,0.0,0.0
52896.0,6,14,4740,7,653,7898.0,249.0,93.28571428571428,7,4087,8505.166666666666,1514.0,583.8571428571429
2989577.0,6,3,1604,2,851,0.0,785.0,425.5,1,753,0.0,753.0,753.0
1312082.0,17,7,490,7,490,218680.3333333333,70.0,70.0,0,0,0.0,0.0,0.0
66587.0,6,14,4740,7,653,10947.166666666666,249.0,93.28571428571428,7,4087,10958.5,1514.0,583.8571428571429
81597.0,6,14,4740,7,653,11812.0,249.0,93.28571428571428,7,4087,11503.166666666666,1514.0,583.8571428571429
143927.0,17,2,180,1,90,0.0,90.0,90.0,1,90,0.0,90.0,90.0
29647.0,6,14,4740,7,653,4706.0,249.0,93.28571428571428,7,4087,4773.666666666667,1514.0,583.8571428571429
196951.0,17,2,180,1,90,0.0,90.0,90.0,1,90,0.0,90.0,90.0
13227.0,6,10,2032,5,524,2789.75,252.0,104.8,5,1508,3072.0,1236.0,301.6
99053523.0,17,12,778,6,389,19800944.8,174.0,64.83333333333333,6,389,19800164.0,174.0,64.83333333333333
120118618.0,6,13,2036,8,1016,17136967.14285714,188.0,127.0,5,1020,22522571.75,204.0,204.0
357267.0,17,4,704,2,148,0.0,74.0,74.0,2,556,0.0,280.0,278.0
328169.0,6,6,412,4,272,109389.66666666669,74.0,68.0,2,140,0.0,74.0,70.0
90766017.0,6,24,1829,13,989,7559866.916666667,95.0,76.07692307692308,11,840,8906039.6,95.0,76.36363636363636
90301981.0,6,16,1192,8,596,12893072.57142857,95.0,74.5,8,596,12898853.42857143,95.0,74.5
101538.0,17,2,762,2,762,0.0,381.0,381.0,0,0,0.0,0.0,0.0
264437.0,6,12,1373,7,714,44072.833333333336,298.0,102.0,5,659,62004.0,379.0,131.8
330332.0,6,6,412,4,272,110110.66666666669,74.0,68.0,2,140,0.0,74.0,70.0
103916.0,17,2,286,2,286,0.0,143.0,143.0,0,0,0.0,0.0,0.0
91268.0,6,10,2032,5,524,15713.5,252.0,104.8,5,1508,21187.25,1236.0,301.6
104160422.0,6,44,2904,22,1452,4960020.095238095,66.0,66.0,22,1452,4945308.333333333,66.0,66.0
90276201.0,6,13,2036,8,1016,12896600.142857144,188.0,127.0,5,1020,22528773.5,204.0,204.0
490507.0,6,4,270,2,134,0.0,68.0,67.0,2,136,0.0,70.0,68.0
4700.0,17,2,582,1,83,0.0,83.0,83.0,1,499,0.0,499.0,499.0
42581.0,6,13,1386,7,789,6220.166666666667,253.0,112.71428571428572,6,597,8111.8,259.0,99.5
840834.0,6,9,1118,6,586,168166.8,248.0,97.66666666666669,3,532,284152.0,392.0,177.33333333333334
309689.0,6,6,412,4,272,103229.66666666669,74.0,68.0,2,140,0.0,74.0,70.0
2333.0,17,4,344,2,150,0.0,75.0,75.0,2,194,0.0,103.0,97.0
120068462.0,17,28,13364,28,13364,4446980.074074074,501.0,477.2857142857143,0,0,0.0,0.0,0.0
121255.0,6,3,337,2,214,0.0,160.0,107.0,1,123,0.0,123.0,123.0
216731.0,17,2,180,1,90,0.0,90.0,90.0,1,90,0.0,90.0,90.0
935324.0,6,12,1427,6,796,185440.8,271.0,132.66666666666666,6,631,186290.0,293.0,105.16666666666669
120184464.0,6,246,27950,123,8414,978413.1803278688,140.0,68.40650406504065,123,19536,978507.81147541,374.0,158.82926829268294
219371.0,6,10,1221,6,636,43874.2,298.0,106.0,4,585,71381.66666666667,379.0,146.25
1302940.0,6,4,264,2,132,0.0,66.0,66.0,2,132,0.0,66.0,66.0
108103558.0,17,5,1005,5,1005,27025889.5,201.0,201.0,0,0,0.0,0.0,0.0
58421.0,6,11,2098,6,590,10850.0,252.0,98.33333333333331,5,1508,14128.0,1236.0,301.6
1049.0,17,5,550,5,550,262.25,110.0,110.0,0,0,0.0,0.0,0.0
317.0,17,2,174,1,79,0.0,79.0,79.0,1,95,0.0,95.0,95.0
43787.0,6,14,4740,7,653,6654.0,249.0,93.28571428571428,7,4087,7144.0,1514.0,583.8571428571429
112856828.0,6,48,3168,24,1584,4906818.608695652,66.0,66.0,24,1584,4897421.652173913,66.0,66.0
120122581.0,6,14,2240,6,1224,24024516.2,204.0,204.0,8,1016,17098335.285714287,188.0,127.0
64711.00000000001,6,14,4740,7,653,10661.666666666666,249.0,93.28571428571428,7,4087,10360.666666666666,1514.0,583.8571428571429
95506075.0,17,12,778,6,389,19000955.6,174.0,64.83333333333333,6,389,19000167.6,174.0,64.83333333333333
41210.0,6,14,4740,7,653,6489.833333333333,249.0,93.28571428571428,7,4087,6051.666666666667,1514.0,583.8571428571429
95234803.0,6,40,2640,20,1320,5012358.052631579,66.0,66.0,20,1320,5000973.157894737,66.0,66.0
2796400.0,6,2,132,1,66,0.0,66.0,66.0,1,66,0.0,66.0,66.0
22230124.0,17,5,1718,4,1368,857620.6666666666,342.0,342.0,1,350,0.0,350.0,350.0
108107534.0,17,5,1005,5,1005,27026883.5,201.0,201.0,0,0,0.0,0.0,0.0
878400.0,6,10,1333,6,796,175680.0,458.0,132.66666666666666,4,537,200905.3333333333,331.0,134.25
153408.0,17,2,180,1,90,0.0,90.0,90.0,1,90,0.0,90.0,90.0
153399.0,17,2,180,1,90,0.0,90.0,90.0,1,90,0.0,90.0,90.0
37168.0,6,14,4740,7,653,5555.5,249.0,93.28571428571428,7,4087,6057.5,1514.0,583.8571428571429
101030547.0,17,12,516,6,258,20000999.6,43.0,43.0,6,258,20000208.2,43.0,43.0
27022.0,6,14,4740,7,653,4396.5,249.0,93.28571428571428,7,4087,3804.8333333333335,1514.0,583.8571428571429
118930893.0,6,34,2350,17,1225,7419682.125,139.0,72.05882352941177,17,1125,7419689.875,123.0,66.17647058823529
107843753.0,6,28,1860,14,966,8279081.692307692,123.0,69.0,14,894,8279069.076923077,123.0,63.85714285714285
130467.0,6,3,337,2,214,0.0,160.0,107.0,1,123,0.0,123.0,123.0
2511262.0,6,3,204,2,136,0.0,70.0,68.0,1,68,0.0,68.0,68.0
344202.0,6,3,204,2,136,0.0,70.0,68.0,1,68,0.0,68.0,68.0
5629956.0,6,5,336,2,134,0.0,68.0,67.0,3,202,1528543.0,70.0,67.33333333333333
354867.0,6,10,1221,6,636,70973.4,298.0,106.0,4,585,112930.66666666669,379.0,146.25
37262.0,6,14,4740,7,653,5863.166666666667,249.0,93.28571428571428,7,4087,5803.5,1514.0,583.8571428571429
135146660.0,17,6,1206,6,1206,27029332.0,201.0,201.0,0,0,0.0,0.0,0.0
135131816.0,17,6,1206,6,1206,27026363.2,201.0,201.0,0,0,0.0,0.0,0.0
284696.0,17,2,363,1,79,0.0,79.0,79.0,1,284,0.0,284.0,284.0
51181.0,17,2,180,1,90,0.0,90.0,90.0,1,90,0.0,90.0,90.0
1870.0,17,2,192,1,88,0.0,88.0,88.0,1,104,0.0,104.0,104.0
92377320.0,17,15,5130,15,5130,6598380.0,342.0,342.0,0,0,0.0,0.0,0.0
135132185.0,17,6,1146,6,1146,27026437.0,191.0,191.0,0,0,0.0,0.0,0.0
112075.0,17,2,286,2,286,0.0,143.0,143.0,0,0,0.0,0.0,0.0
153594.0,17,2,180,1,90,0.0,90.0,90.0,1,90,0.0,90.0,90.0
108101442.0,17,5,955,5,955,27025360.5,191.0,191.0,0,0,0.0,0.0,0.0
324.0,17,2,174,1,79,0.0,79.0,79.0,1,95,0.0,95.0,95.0
135142992.0,17,6,1146,6,1146,27028598.4,191.0,191.0,0,0,0.0,0.0,0.0
100169873.0,17,12,516,6,258,20001375.8,43.0,43.0,6,258,20000171.8,43.0,43.0
35749.0,6,14,4740,7,653,5475.5,249.0,93.28571428571428,7,4087,5583.333333333333,1514.0,583.8571428571429
826.0,17,5,550,5,550,206.5,110.0,110.0,0,0,0.0,0.0,0.0
365.0,17,2,166,1,75,0.0,75.0,75.0,1,91,0.0,91.0,91.0
232841.0,6,3,337,2,214,0.0,160.0,107.0,1,123,0.0,123.0,123.0
16237.999999999998,6,10,2032,5,524,3833.5,252.0,104.8,5,1508,3688.0,1236.0,301.6
108100805.0,17,5,955,5,955,27025201.25,191.0,191.0,0,0,0.0,0.0,0.0
120158067.0,6,463,62184,232,15534,520164.7922077922,140.0,66.95689655172414,231,46650,521460.7,480.0,201.94805194805195
135128578.0,17,6,1146,6,1146,27025715.6,191.0,191.0,0,0,0.0,0.0,0.0
241719.0,6,3,337,2,214,0.0,160.0,107.0,1,123,0.0,123.0,123.0
237428.0,17,2,180,1,90,0.0,90.0,90.0,1,90,0.0,90.0,90.0
300.0,17,2,156,1,78,0.0,78.0,78.0,1,78,0.0,78.0,78.0
209609.0,17,2,180,1,90,0.0,90.0,90.0,1,90,0.0,90.0,90.0
114283342.0,6,48,3168,24,1584,4968840.956521739,66.0,66.0,24,1584,4955175.347826087,66.0,66.0
120234369.0,6,18,1341,9,691,14999489.25,95.0,76.77777777777777,9,650,14998703.25,95.0,72.22222222222223
3228.0,17,4,344,2,150,0.0,75.0,75.0,2,194,0.0,103.0,97.0
255493.00000000003,6,3,337,2,214,0.0,160.0,107.0,1,123,0.0,123.0,123.0
5096.0,17,4,344,2,150,0.0,75.0,75.0,2,194,0.0,103.0,97.0
2817.0,17,4,438,2,148,0.0,74.0,74.0,2,290,0.0,147.0,145.0
58606.0,6,14,4740,7,653,9075.166666666666,249.0,93.28571428571428,7,4087,7633.333333333333,1514.0,583.8571428571429
153356.0,17,2,180,1,90,0.0,90.0,90.0,1,90,0.0,90.0,90.0
136995.0,6,2,132,1,66,0.0,66.0,66.0,1,66,0.0,66.0,66.0
107781492.0,6,28,1860,14,966,8275158.923076923,123.0,69.0,14,894,8275158.461538462,123.0,63.85714285714285
146344.0,6,3,337,2,214,0.0,160.0,107.0,1,123,0.0,123.0,123.0
10914707.0,6,8,544,4,272,3592730.6666666665,74.0,68.0,4,272,3592659.0,74.0,68.0
132911.0,6,3,337,2,214,0.0,160.0,107.0,1,123,0.0,123.0,123.0
111720738.0,6,33,2296,17,1225,6969044.25,139.0,72.05882352941177,16,1071,7433648.533333333,123.0,66.9375
103159.0,17,2,286,2,286,0.0,143.0,143.0,0,0,0.0,0.0,0.0
120125096.0,6,13,2036,5,1020,30031274.0,204.0,204.0,8,1016,17136938.85714286,188.0,127.0
99003671.0,17,13,1083,7,563,16500611.833333334,174.0,80.42857142857143,6,520,16996929.8,174.0,86.66666666666667
308061.0,6,6,412,4,272,102687.0,74.0,68.0,2,140,0.0,74.0,70.0
90257470.0,6,12,1832,8,1016,12893924.285714284,188.0,127.0,4,816,30030572.33333333,204.0,204.0
1044771.0,6,11,1134,6,558,208954.2,220.0,93.0,5,576,258977.25,304.0,115.2
19485.0,6,14,4740,7,653,3099.1666666666665,249.0,93.28571428571428,7,4087,2722.0,1514.0,583.8571428571429
2324.0,17,4,344,2,150,0.0,75.0,75.0,2,194,0.0,103.0,97.0
43367.0,6,14,4740,7,653,7101.0,249.0,93.28571428571428,7,4087,5992.833333333333,1514.0,583.8571428571429
3691803.0,6,193,173067,120,163947,31023.55462184874,1510.0,1366.225,73,9120,46867.77777777778,1510.0,124.93150684931508
840865.0,6,9,1118,6,586,168173.0,248.0,97.66666666666669,3,532,282621.0,392.0,177.33333333333334
104123.0,17,2,286,2,286,0.0,143.0,143.0,0,0,0.0,0.0,0.0
319309.0,17,4,1400,4,1400,106436.33333333331,350.0,350.0,0,0,0.0,0.0,0.0
102732085.0,6,28,1860,14,966,7885858.076923077,123.0,69.0,14,894,7885863.615384615,123.0,63.85714285714285
362620.0,6,11,1021,6,444,48766.2,162.0,74.0,5,577,60777.5,349.0,115.4
204326.0,17,2,762,2,762,0.0,381.0,381.0,0,0,0.0,0.0,0.0
4444.0,17,2,626,1,72,0.0,72.0,72.0,1,554,0.0,554.0,554.0
2598114.0,6,2,132,1,66,0.0,66.0,66.0,1,66,0.0,66.0,66.0
326623.0,6,6,412,4,272,108874.33333333331,74.0,68.0,2,140,0.0,74.0,70.0
207113.0,6,3,426,2,280,0.0,214.0,140.0,1,146,0.0,146.0,146.0
10870306.0,6,8,544,4,272,3577842.0,74.0,68.0,4,272,3577777.333333333,74.0,68.0
106480469.0,6,28,1876,14,982,8174212.307692308,139.0,70.14285714285714,14,894,8174210.846153846,123.0,63.85714285714285
182030.0,17,4,1400,4,1400,60676.66666666666,350.0,350.0,0,0,0.0,0.0,0.0
232836.0,6,3,337,2,214,0.0,160.0,107.0,1,123,0.0,123.0,123.0
90290921.0,6,16,1192,8,596,12892861.285714284,95.0,74.5,8,596,12896983.42857143,95.0,74.5
120229607.0,6,220,24868,110,7556,1095555.6972477064,140.0,68.69090909090909,110,17312,1101360.128440367,284.0,157.38181818181818
122498120.0,17,26,6511,15,5012,8749865.714285715,1214.0,334.1333333333333,11,1499,10361100.4,538.0,136.27272727272728
83051.0,6,14,4740,7,653,13710.5,249.0,93.28571428571428,7,4087,11380.333333333334,1514.0,583.8571428571429
120122882.0,6,15,2428,9,1204,15015360.25,188.0,133.77777777777777,6,1224,18018598.2,204.0,204.0
2338.0,17,4,344,2,150,0.0,75.0,75.0,2,194,0.0,103.0,97.0
98697.0,17,2,762,2,762,0.0,381.0,381.0,0,0,0.0,0.0,0.0
2796062.0,6,2,132,1,66,0.0,66.0,66.0,1,66,0.0,66.0,66.0
510304.0,6,5,336,2,134,0.0,68.0,67.0,3,202,195233.0,70.0,67.33333333333333
107117.0,17,4,1400,4,1400,35705.666666666664,350.0,350.0,0,0,0.0,0.0,0.0
90096184.0,6,12,1848,5,1020,22523460.25,204.0,204.0,7,828,15015641.666666666,188.0,118.28571428571428
90300014.0,6,16,1192,8,596,12894132.714285716,95.0,74.5,8,596,12899558.285714284,95.0,74.5
281.0,17,2,164,1,82,0.0,82.0,82.0,1,82,0.0,82.0,82.0
24023.0,6,10,2032,5,524,4943.5,252.0,104.8,5,1508,4197.5,1236.0,301.6
320699.0,17,4,1400,4,1400,106899.66666666669,350.0,350.0,0,0,0.0,0.0,0.0
90013763.0,17,28,13364,28,13364,3333843.074074074,501.0,477.2857142857143,0,0,0.0,0.0,0.0
103768.0,17,2,286,2,286,0.0,143.0,143.0,0,0,0.0,0.0,0.0
322.0,17,2,174,1,79,0.0,79.0,79.0,1,95,0.0,95.0,95.0
103356645.0,6,31,2298,16,1212,6890443.0,123.0,75.75,15,1086,7367179.928571428,123.0,72.4
197031.0,17,2,180,1,90,0.0,90.0,90.0,1,90,0.0,90.0,90.0
307388.0,6,6,412,4,272,102462.66666666669,74.0,68.0,2,140,0.0,74.0,70.0
1042065.0,6,11,1134,6,558,208413.00000000003,220.0,93.0,5,576,256667.75,304.0,115.2
118000986.0,17,13,821,7,432,19666831.0,174.0,61.71428571428572,6,389,19979514.0,174.0,64.83333333333333
108144474.0,17,5,1005,5,1005,27036118.5,201.0,201.0,0,0,0.0,0.0,0.0
135134245.0,17,6,1206,6,1206,27026849.0,201.0,201.0,0,0,0.0,0.0,0.0
205730.0,17,2,180,1,90,0.0,90.0,90.0,1,90,0.0,90.0,90.0
228190.0,17,2,180,1,90,0.0,90.0,90.0,1,90,0.0,90.0,90.0
312276.0,17,4,1400,4,1400,104092.0,350.0,350.0,0,0,0.0,0.0,0.0
97390383.0,17,13,1869,13,1869,8115865.25,174.0,143.76923076923077,0,0,0.0,0.0,0.0
1302115.0,6,4,264,2,132,0.0,66.0,66.0,2,132,0.0,66.0,66.0
119858657.0,6,15,2306,6,1224,23971284.6,204.0,204.0,9,1082,14982176.75,188.0,120.22222222222224
205925.0,17,2,180,1,90,0.0,90.0,90.0,1,90,0.0,90.0,90.0
27654.0,6,13,1479,7,882,4609.0,291.0,126.0,6,597,4246.4,259.0,99.5
219681.0,17,2,180,1,90,0.0,90.0,90.0,1,90,0.0,90.0,90.0
501695.0,6,5,336,2,134,0.0,68.0,67.0,3,202,194674.5,70.0,67.33333333333333
121471.0,17,4,1524,4,1524,40490.333333333336,381.0,381.0,0,0,0.0,0.0,0.0
299980.0,6,6,412,4,272,99993.33333333331,74.0,68.0,2,140,0.0,74.0,70.0
135133540.0,17,6,1206,6,1206,27026708.0,201.0,201.0,0,0,0.0,0.0,0.0
39795.0,6,14,4740,7,653,6229.5,249.0,93.28571428571428,7,4087,4668.166666666667,1514.0,583.8571428571429
32173.0,6,2,145,2,145,0.0,91.0,72.5,0,0,0.0,0.0,0.0
33886.0,6,14,4740,7,653,4993.5,249.0,93.28571428571428,7,4087,4130.0,1514.0,583.8571428571429
90017978.0,17,28,13364,28,13364,3333999.185185185,501.0,477.2857142857143,0,0,0.0,0.0,0.0
219031.0,6,3,426,2,280,0.0,214.0,140.0,1,146,0.0,146.0,146.0
95015666.0,6,152,17568,76,12330,1264005.2933333332,284.0,162.23684210526315,76,5238,1264004.6933333334,140.0,68.92105263157895
102153955.0,6,28,1992,14,963,7857996.538461538,123.0,68.78571428571429,14,1029,7074199.846153846,123.0,73.5
120122306.0,6,13,2020,9,1204,15015288.25,188.0,133.77777777777777,4,816,30030239.666666668,204.0,204.0
98496340.0,6,30,2106,15,1089,7035452.857142857,123.0,72.6,15,1017,7020016.214285715,123.0,67.8
153478.0,17,2,180,1,90,0.0,90.0,90.0,1,90,0.0,90.0,90.0
0.0,17,1,55,1,55,0.0,55.0,55.0,0,0,0.0,0.0,0.0
318257.0,17,4,1524,4,1524,106085.66666666669,381.0,381.0,0,0,0.0,0.0,0.0
41869.0,6,14,4740,7,653,6816.5,249.0,93.28571428571428,7,4087,6835.166666666667,1514.0,583.8571428571429
143805.0,17,2,180,1,90,0.0,90.0,90.0,1,90,0.0,90.0,90.0
131001273.0,17,15,907,8,475,18714467.57142857,174.0,59.375,7,432,18500760.33333333,174.0,61.71428571428572
113734620.0,6,46,3036,23,1518,5155444.409090909,66.0,66.0,23,1518,5155438.818181818,66.0,66.0
104960084.0,17,15,5130,15,5130,7497148.857142857,342.0,342.0,0,0,0.0,0.0,0.0
32716.000000000004,6,14,4740,7,653,5276.666666666667,249.0,93.28571428571428,7,4087,5314.666666666667,1514.0,583.8571428571429
4487.0,17,2,598,1,72,0.0,72.0,72.0,1,526,0.0,526.0,526.0
206516.0,17,2,180,1,90,0.0,90.0,90.0,1,90,0.0,90.0,90.0
205368.0,17,2,762,2,762,0.0,381.0,381.0,0,0,0.0,0.0,0.0
15137.0,17,2,180,1,90,0.0,90.0,90.0,1,90,0.0,90.0,90.0
304395.0,6,6,412,4,272,101465.0,74.0,68.0,2,140,0.0,74.0,70.0
122992145.0,17,15,907,8,475,17570306.42857143,174.0,59.375,7,432,17081832.166666668,174.0,61.71428571428572
329.0,17,2,267,1,83,0.0,83.0,83.0,1,184,0.0,184.0,184.0
284701.0,17,2,363,1,79,0.0,79.0,79.0,1,284,0.0,284.0,284.0
54573.0,6,14,4740,7,653,8961.333333333334,249.0,93.28571428571428,7,4087,8745.0,1514.0,583.8571428571429
314.0,17,2,164,1,82,0.0,82.0,82.0,1,82,0.0,82.0,82.0
253476.0,6,10,1221,6,636,50695.2,298.0,106.0,4,585,79123.66666666667,379.0,146.25
223830.0,6,10,1221,6,636,44766.0,298.0,106.0,4,585,73280.33333333333,379.0,146.25
40823121.0,6,8,1307,8,1307,5831874.428571428,172.0,163.375,0,0,0.0,0.0,0.0
94870455.0,6,263,29934,132,8934,724201.9465648854,140.0,67.68181818181819,131,21000,721867.9538461538,284.0,160.3053435114504
153453.0,17,2,180,1,90,0.0,90.0,90.0,1,90,0.0,90.0,90.0
607854.0,17,4,883,2,156,0.0,78.0,78.0,2,727,0.0,395.0,363.5
147908.0,17,2,180,1,90,0.0,90.0,90.0,1,90,0.0,90.0,90.0
119569898.0,6,238,26754,119,18604,1011479.3983050848,284.0,156.3361344537815,119,8150,1011479.5169491526,140.0,68.4873949579832
196863.0,17,2,180,1,90,0.0,90.0,90.0,1,90,0.0,90.0,90.0
4538.0,17,2,626,1,72,0.0,72.0,72.0,1,554,0.0,554.0,554.0
32340.0,6,11,2098,6,590,5998.6,252.0,98.33333333333331,5,1508,7770.0,1236.0,301.6
307995.0,6,6,412,4,272,102665.0,74.0,68.0,2,140,0.0,74.0,70.0
346.0,17,2,160,1,80,0.0,80.0,80.0,1,80,0.0,80.0,80.0
144063.0,17,2,180,1,90,0.0,90.0,90.0,1,90,0.0,90.0,90.0
42401.0,6,14,4740,7,653,5801.333333333333,249.0,93.28571428571428,7,4087,6843.833333333333,1514.0,583.8571428571429
47178.0,6,10,2032,5,524,10899.75,252.0,104.8,5,1508,9889.5,1236.0,301.6
5451.0,17,2,180,1,90,0.0,90.0,90.0,1,90,0.0,90.0,90.0
1302015.0,6,4,264,2,132,0.0,66.0,66.0,2,132,0.0,66.0,66.0
126585353.0,6,37,2656,19,1408,7032519.611111111,139.0,74.10526315789474,18,1248,6846141.647058823,123.0,69.33333333333333
39901.0,6,14,4740,7,653,5659.666666666667,249.0,93.28571428571428,7,4087,6279.0,1514.0,583.8571428571429
300.0,17,2,164,1,82,0.0,82.0,82.0,1,82,0.0,82.0,82.0
146306.0,6,3,337,2,214,0.0,160.0,107.0,1,123,0.0,123.0,123.0
865055.0,6,9,1196,6,725,173011.0,387.0,120.83333333333331,3,471,294693.5,331.0,157.0
16337.999999999998,6,13,1459,7,862,2723.0,271.0,123.14285714285714,6,597,2721.8,259.0,99.5
211561.0,17,2,180,1,90,0.0,90.0,90.0,1,90,0.0,90.0,90.0
16324.000000000002,17,2,614,1,72,0.0,72.0,72.0,1,542,0.0,542.0,542.0
5005276.0,17,2,168,2,168,0.0,84.0,84.0,0,0,0.0,0.0,0.0
481427.0,6,3,204,2,136,0.0,70.0,68.0,1,68,0.0,68.0,68.0
128021484.0,6,31,2034,16,1086,8534765.6,123.0,67.875,15,948,8415603.57142857,123.0,63.2
37500.0,6,14,4740,7,653,6127.0,249.0,93.28571428571428,7,4087,6113.333333333333,1514.0,583.8571428571429
370.0,17,2,166,1,75,0.0,75.0,75.0,1,91,0.0,91.0,91.0
100237886.0,17,13,821,7,432,16666842.5,174.0,61.71428571428572,6,389,20001066.2,174.0,64.83333333333333
90527436.0,6,14,2240,8,1016,12932490.857142856,188.0,127.0,6,1224,18072738.4,204.0,204.0
90752493.0,6,15,1138,7,542,15125415.5,95.0,77.42857142857143,8,596,12924334.142857144,95.0,74.5
248171.0,6,3,337,2,214,0.0,160.0,107.0,1,123,0.0,123.0,123.0
83402710.0,17,14,4796,13,4446,6243833.166666667,342.0,342.0,1,350,0.0,350.0,350.0
48852.0,6,14,4740,7,653,7773.0,249.0,93.28571428571428,7,4087,7491.166666666667,1514.0,583.8571428571429
577617.0,6,4,508,2,238,0.0,172.0,119.0,2,270,0.0,135.0,135.0
120008770.0,6,17,1246,9,650,15001096.25,95.0,72.22222222222223,8,596,17108402.285714287,95.0,74.5
114387067.0,6,48,3168,24,1584,4973350.739130435,66.0,66.0,24,1584,4961370.0,66.0,66.0
153421.0,17,2,180,1,90,0.0,90.0,90.0,1,90,0.0,90.0,90.0
118498927.0,6,309,50812,155,10674,769473.5519480519,214.0,68.86451612903225,154,40138,773086.725490196,1514.0,260.6363636363636
87776.0,6,10,1065,5,534,21778.75,262.0,106.8,5,531,21152.5,259.0,106.2
90305591.0,6,16,1192,8,596,12893557.285714284,95.0,74.5,8,596,12899562.714285716,95.0,74.5
103315006.0,6,44,2904,22,1452,4919762.19047619,66.0,66.0,22,1452,4906649.19047619,66.0,66.0
90031962.0,17,28,13364,28,13364,3334517.111111111,501.0,477.2857142857143,0,0,0.0,0.0,0.0
301995.0,6,6,412,4,272,100665.0,74.0,68.0,2,140,0.0,74.0,70.0
102122.0,17,2,762,2,762,0.0,381.0,381.0,0,0,0.0,0.0,0.0
2640691.0,6,3,1604,1,753,0.0,753.0,753.0,2,851,0.0,785.0,425.5
153044.0,6,4,439,2,238,0.0,172.0,119.0,2,201,0.0,135.0,100.5
538194.0,17,6,2100,6,2100,107638.8,350.0,350.0,0,0,0.0,0.0,0.0
345.0,17,2,267,1,83,0.0,83.0,83.0,1,184,0.0,184.0,184.0
0.0,6,1,54,1,54,0.0,54.0,54.0,0,0,0.0,0.0,0.0
301.0,17,2,168,1,76,0.0,76.0,76.0,1,92,0.0,92.0,92.0
320901.0,17,4,1400,4,1400,106967.0,350.0,350.0,0,0,0.0,0.0,0.0
207310.0,6,3,426,2,280,0.0,214.0,140.0,1,146,0.0,146.0,146.0
153364.0,17,2,180,1,90,0.0,90.0,90.0,1,90,0.0,90.0,90.0
112873482.0,6,32,2220,16,1149,7511263.2,123.0,71.8125,16,1071,7511263.733333333,123.0,66.9375
95217746.0,17,14,1126,7,563,15833471.333333334,174.0,80.42857142857143,7,563,15834525.666666666,174.0,80.42857142857143
17076553.0,6,22,7083,13,1707,1423046.0833333333,408.0,131.30769230769232,9,5376,1617398.875,1514.0,597.3333333333334
3165735.0,6,18,1577,9,1003,358364.0,315.0,111.44444444444444,9,574,358328.625,78.0,63.77777777777778
90283664.0,6,14,1043,7,542,15047277.333333334,95.0,77.42857142857143,7,501,14998783.833333334,95.0,71.57142857142857
98011415.0,17,12,778,6,389,19600216.0,174.0,64.83333333333333,6,389,19600927.6,174.0,64.83333333333333
219514.0,6,10,1221,6,636,43902.8,298.0,106.0,4,585,72294.0,379.0,146.25
42543.0,6,14,4740,7,653,6215.5,249.0,93.28571428571428,7,4087,6422.166666666667,1514.0,583.8571428571429
135140250.0,17,6,1146,6,1146,27028050.0,191.0,191.0,0,0,0.0,0.0,0.0
1043669.0,6,3,1604,1,753,0.0,753.0,753.0,2,851,0.0,785.0,425.5
1157846.0,6,13,3000,8,2372,165406.57142857142,1514.0,296.5,5,628,221310.75,331.0,125.6
255130.00000000003,6,3,337,2,214,0.0,160.0,107.0,1,123,0.0,123.0,123.0
318856.0,17,4,1400,4,1400,106285.33333333331,350.0,350.0,0,0,0.0,0.0,0.0
19122.0,6,2,145,2,145,0.0,91.0,72.5,0,0,0.0,0.0,0.0
831.0,17,4,438,2,148,0.0,74.0,74.0,2,290,0.0,147.0,145.0
302487.0,6,2,132,1,66,0.0,66.0,66.0,1,66,0.0,66.0,66.0
320088.0,17,4,1400,4,1400,106696.0,350.0,350.0,0,0,0.0,0.0,0.0
1775656.0,6,2,132,1,66,0.0,66.0,66.0,1,66,0.0,66.0,66.0
119975.0,17,2,180,1,70,0.0,70.0,70.0,1,110,0.0,110.0,110.0
93000869.0,17,11,735,6,389,18600173.8,174.0,64.83333333333333,5,346,18252058.25,174.0,69.2
113520362.0,6,46,3036,23,1518,5160003.863636363,66.0,66.0,23,1518,5160005.045454546,66.0,66.0
197004.0,17,2,180,1,90,0.0,90.0,90.0,1,90,0.0,90.0,90.0
273705.0,6,10,1221,6,636,54741.0,298.0,106.0,4,585,85405.33333333333,379.0,146.25
1975.0,17,4,344,2,150,0.0,75.0,75.0,2,194,0.0,103.0,97.0
508651.0,17,2,346,1,78,0.0,78.0,78.0,1,268,0.0,268.0,268.0
107296.0,17,2,286,2,286,0.0,143.0,143.0,0,0,0.0,0.0,0.0
108105491.0,17,5,1005,5,1005,27026372.75,201.0,201.0,0,0,0.0,0.0,0.0
144094.0,17,2,180,1,90,0.0,90.0,90.0,1,90,0.0,90.0,90.0
18106.0,6,20,7606,11,978,1810.6,310.0,88.9090909090909,9,6628,1833.5,1514.0,736.4444444444445
5000144.0,17,4,304,2,152,0.0,76.0,76.0,2,152,0.0,76.0,76.0
38382.0,6,10,2032,5,524,9360.75,252.0,104.8,5,1508,7610.5,1236.0,301.6
218638.0,6,3,426,2,280,0.0,214.0,140.0,1,146,0.0,146.0,146.0
304.0,17,2,174,1,79,0.0,79.0,79.0,1,95,0.0,95.0,95.0
1303116.0,6,4,264,2,132,0.0,66.0,66.0,2,132,0.0,66.0,66.0
254845.0,6,3,337,2,214,0.0,160.0,107.0,1,123,0.0,123.0,123.0
45856185.0,6,7,1874,5,1053,11464046.25,785.0,210.6,2,821,0.0,753.0,410.5
135132066.0,17,6,1146,6,1146,27026413.2,191.0,191.0,0,0,0.0,0.0,0.0
108109881.0,17,5,955,5,955,27027470.25,191.0,191.0,0,0,0.0,0.0,0.0
71285.0,6,13,1394,7,797,11804.166666666666,253.0,113.85714285714286,6,597,11512.4,259.0,99.5
227291.0,17,2,180,1,90,0.0,90.0,90.0,1,90,0.0,90.0,90.0
147064.0,6,3,373,2,238,0.0,172.0,119.0,1,135,0.0,135.0,135.0
162375.0,17,2,180,1,90,0.0,90.0,90.0,1,90,0.0,90.0,90.0
102494.0,17,2,286,2,286,0.0,143.0,143.0,0,0,0.0,0.0,0.0
5823017.0,6,4,270,2,134,0.0,68.0,67.0,2,136,0.0,70.0,68.0
953915.0,6,12,1354,6,723,189556.6,253.0,120.5,6,631,189796.4,293.0,105.16666666666669
228311.0,17,2,180,1,90,0.0,90.0,90.0,1,90,0.0,90.0,90.0
284780.0,17,2,363,1,79,0.0,79.0,79.0,1,284,0.0,284.0,284.0
10964.0,17,4,438,2,148,0.0,74.0,74.0,2,290,0.0,147.0,145.0
323937.0,17,4,1400,4,1400,107979.0,350.0,350.0,0,0,0.0,0.0,0.0
107021.0,17,2,286,2,286,0.0,143.0,143.0,0,0,0.0,0.0,0.0
102622.0,17,2,286,2,286,0.0,143.0,143.0,0,0,0.0,0.0,0.0
106161.0,17,2,700,2,700,0.0,350.0,350.0,0,0,0.0,0.0,0.0
2930551.0,6,115,95438,69,88100,43096.33823529412,1510.0,1276.8115942028985,46,7338,58398.84444444445,1510.0,159.52173913043478
10187.0,6,10,2032,5,524,2337.5,252.0,104.8,5,1508,2283.0,1236.0,301.6
311020.0,17,4,1400,4,1400,103673.33333333331,350.0,350.0,0,0,0.0,0.0,0.0
59087.0,6,14,4740,7,653,8190.5,249.0,93.28571428571428,7,4087,8634.833333333334,1514.0,583.8571428571429
165464.0,6,3,337,2,214,0.0,160.0,107.0,1,123,0.0,123.0,123.0
95603395.0,6,30,2106,15,1089,6813397.214285715,123.0,72.6,15,1017,6813411.428571428,123.0,67.8
19513.0,6,14,4740,7,653,3132.5,249.0,93.28571428571428,7,4087,2783.333333333333,1514.0,583.8571428571429
105434852.0,6,28,1860,14,966,8093756.692307692,123.0,69.0,14,894,8093758.923076923,123.0,63.85714285714285
90074140.0,17,27,12943,27,12943,3464390.0,501.0,479.3703703703704,0,0,0.0,0.0,0.0
100414625.0,6,576,74882,288,55652,349163.78397212544,390.0,193.23611111111111,288,19230,349163.9756097561,140.0,66.77083333333333
105269.0,17,2,700,2,700,0.0,350.0,350.0,0,0,0.0,0.0,0.0
24235.0,6,14,4740,7,653,3864.3333333333335,249.0,93.28571428571428,7,4087,3898.1666666666665,1514.0,583.8571428571429
45067.0,6,14,4740,7,653,7387.0,249.0,93.28571428571428,7,4087,7200.5,1514.0,583.8571428571429
198185.0,17,2,180,1,90,0.0,90.0,90.0,1,90,0.0,90.0,90.0
302020.0,6,6,412,4,272,100673.33333333331,74.0,68.0,2,140,0.0,74.0,70.0
135132504.0,17,6,1206,6,1206,27026500.8,201.0,201.0,0,0,0.0,0.0,0.0
213556.0,17,2,359,1,75,0.0,75.0,75.0,1,284,0.0,284.0,284.0
135135223.0,17,6,1146,6,1146,27027044.6,191.0,191.0,0,0,0.0,0.0,0.0
321.0,17,2,174,1,79,0.0,79.0,79.0,1,95,0.0,95.0,95.0
98836.0,6,14,4740,7,653,16350.333333333334,249.0,93.28571428571428,7,4087,15228.166666666666,1514.0,583.8571428571429
5624173.0,6,5,336,2,134,0.0,68.0,67.0,3,202,1421854.5,70.0,67.33333333333333
317.0,17,2,174,1,79,0.0,79.0,79.0,1,95,0.0,95.0,95.0
861095.0,6,9,1266,6,795,172219.0,457.0,132.5,3,471,292702.5,331.0,157.0
2638290.0,6,3,1604,1,753,0.0,753.0,753.0,2,851,0.0,785.0,425.5
50983.0,6,14,4740,7,653,8266.0,249.0,93.28571428571428,7,4087,8269.5,1514.0,583.8571428571429
2064.0,17,4,344,2,150,0.0,75.0,75.0,2,194,0.0,103.0,97.0
90317883.0,6,24,1829,13,989,7521671.25,95.0,76.07692307692308,11,840,8954363.2,95.0,76.36363636363636
207128.0,6,3,426,2,280,0.0,214.0,140.0,1,146,0.0,146.0,146.0
0.0,17,1,179,1,179,0.0,179.0,179.0,0,0,0.0,0.0,0.0
82666.0,6,13,1386,7,789,13777.666666666666,253.0,112.71428571428572,6,597,15539.4,259.0,99.5
61771.0,6,11,2098,6,590,12156.0,252.0,98.33333333333331,5,1508,14717.0,1236.0,301.6
31927.0,6,11,1133,6,602,5721.2,264.0,100.33333333333331,5,531,4100.75,259.0,106.2
44977993.0,6,18,1280,9,640,5622249.125,95.0,71.11111111111111,9,640,5594111.5,95.0,71.11111111111111
25797.0,6,14,4740,7,653,3754.0,249.0,93.28571428571428,7,4087,3624.5,1514.0,583.8571428571429
90266079.0,6,15,2444,8,1016,12895154.142857144,188.0,127.0,7,1428,15016076.833333334,204.0,204.0
93774747.0,6,40,2640,20,1320,4935513.0,66.0,66.0,20,1320,4919476.842105263,66.0,66.0
145128.0,17,2,180,1,70,0.0,70.0,70.0,1,110,0.0,110.0,110.0
856900.0,6,9,1096,6,625,171380.0,287.0,104.16666666666669,3,471,292202.5,331.0,157.0
120005043.0,6,16,1192,8,596,17143577.57142857,95.0,74.5,8,596,17105480.14285714,95.0,74.5
206124.0,17,2,762,2,762,0.0,381.0,381.0,0,0,0.0,0.0,0.0
148030.0,17,2,180,1,90,0.0,90.0,90.0,1,90,0.0,90.0,90.0
157465.0,6,3,337,2,214,0.0,160.0,107.0,1,123,0.0,123.0,123.0
68521926.0,6,7,468,3,200,32966213.5,68.0,66.66666666666667,4,268,21984962.33333333,70.0,67.0
3175780.0,6,3,204,1,68,0.0,68.0,68.0,2,136,0.0,70.0,68.0
18038.0,6,10,2032,5,524,4017.75,252.0,104.8,5,1508,3676.25,1236.0,301.6
25390.0,6,14,4740,7,653,4120.333333333333,249.0,93.28571428571428,7,4087,3697.1666666666665,1514.0,583.8571428571429
539874.0,6,3,1604,2,851,0.0,785.0,425.5,1,753,0.0,753.0,753.0
330280.0,6,6,412,4,272,110093.33333333331,74.0,68.0,2,140,0.0,74.0,70.0
192677.0,17,2,180,1,90,0.0,90.0,90.0,1,90,0.0,90.0,90.0
70409.0,6,10,2032,5,524,16796.5,252.0,104.8,5,1508,8422.0,1236.0,301.6
314392.0,17,2,333,1,87,0.0,87.0,87.0,1,246,0.0,246.0,246.0
245312.0,6,3,337,2,214,0.0,160.0,107.0,1,123,0.0,123.0,123.0
392110.0,6,10,1221,6,636,78422.0,298.0,106.0,4,585,127427.33333333331,379.0,146.25
302404.0,6,2,132,1,66,0.0,66.0,66.0,1,66,0.0,66.0,66.0
298183.0,6,6,412,4,272,99394.33333333331,74.0,68.0,2,140,0.0,74.0,70.0
135133345.0,17,6,1206,6,1206,27026669.0,201.0,201.0,0,0,0.0,0.0,0.0
207952.0,6,3,426,2,280,0.0,214.0,140.0,1,146,0.0,146.0,146.0
4121.0,17,2,762,2,762,0.0,381.0,381.0,0,0,0.0,0.0,0.0
108155035.0,17,5,1005,5,1005,27038758.75,201.0,201.0,0,0,0.0,0.0,0.0
135135843.0,17,6,1146,6,1146,27027168.6,191.0,191.0,0,0,0.0,0.0,0.0
101258569.0,17,14,1126,7,563,16834747.0,174.0,80.42857142857143,7,563,16833490.0,174.0,80.42857142857143
15072.0,17,2,180,1,90,0.0,90.0,90.0,1,90,0.0,90.0,90.0
33438.0,6,10,2032,5,524,7725.0,252.0,104.8,5,1508,5563.0,1236.0,301.6
92172.0,17,2,762,2,762,0.0,381.0,381.0,0,0,0.0,0.0,0.0
243303.0,6,3,337,2,214,0.0,160.0,107.0,1,123,0.0,123.0,123.0
42132.0,6,14,4740,7,653,6785.666666666667,249.0,93.28571428571428,7,4087,6229.166666666667,1514.0,583.8571428571429
3166085.0,6,18,1495,9,921,358237.0,315.0,102.33333333333331,9,574,358212.125,78.0,63.77777777777778
34160.0,6,14,4740,7,653,5347.833333333333,249.0,93.28571428571428,7,4087,4892.0,1514.0,583.8571428571429
78913403.0,6,19,3005,9,1832,9841297.0,432.0,203.5555555555556,10,1173,8752212.888888888,219.0,117.3
43255.0,6,10,2032,5,524,10470.5,252.0,104.8,5,1508,9547.0,1236.0,301.6
205845.0,17,2,180,1,90,0.0,90.0,90.0,1,90,0.0,90.0,90.0
832.0,17,4,438,2,148,0.0,74.0,74.0,2,290,0.0,147.0,145.0
441160.0,6,7,745,4,456,147053.33333333334,250.0,114.0,3,289,208352.0,149.0,96.33333333333331
2980.0,17,2,224,1,76,0.0,76.0,76.0,1,148,0.0,148.0,148.0
16943.0,6,11,1133,6,602,3133.0,264.0,100.33333333333331,5,531,3984.5,259.0,106.2
232590.0,6,3,337,2,214,0.0,160.0,107.0,1,123,0.0,123.0,123.0
3048528.0,6,4,270,3,202,1524264.0,70.0,67.33333333333333,1,68,0.0,68.0,68.0
303778.0,6,6,412,4,272,101259.33333333331,74.0,68.0,2,140,0.0,74.0,70.0
507979.0,6,5,336,2,134,0.0,68.0,67.0,3,202,194986.0,70.0,67.33333333333333
90290659.0,6,16,1192,8,596,12891699.42857143,95.0,74.5,8,596,12898304.714285716,95.0,74.5
96295.0,17,2,762,2,762,0.0,381.0,381.0,0,0,0.0,0.0,0.0
2263.0,17,2,3028,2,3028,0.0,1514.0,1514.0,0,0,0.0,0.0,0.0
46031.0,6,14,4740,7,653,7050.166666666667,249.0,93.28571428571428,7,4087,6255.833333333333,1514.0,583.8571428571429
216677.0,17,2,180,1,90,0.0,90.0,90.0,1,90,0.0,90.0,90.0
307127.0,6,6,412,4,272,102375.66666666669,74.0,68.0,2,140,0.0,74.0,70.0
0.0,17,1,44,1,44,0.0,44.0,44.0,0,0,0.0,0.0,0.0
100936.0,17,2,762,2,762,0.0,381.0,381.0,0,0,0.0,0.0,0.0
956119.0,6,12,1447,6,816,190423.4,291.0,136.0,6,631,190418.0,293.0,105.16666666666669
9026318.0,17,4,300,4,300,3008772.6666666665,75.0,75.0,0,0,0.0,0.0,0.0
157709.0,17,2,180,1,90,0.0,90.0,90.0,1,90,0.0,90.0,90.0
101343974.0,17,14,864,7,432,16835029.0,174.0,61.71428571428572,7,432,16833495.0,174.0,61.71428571428572
1933270.0,17,4,820,2,156,0.0,78.0,78.0,2,664,0.0,332.0,332.0
350.0,17,2,156,1,78,0.0,78.0,78.0,1,78,0.0,78.0,78.0
153481.0,17,2,180,1,90,0.0,90.0,90.0,1,90,0.0,90.0,90.0
96305466.0,6,29,1999,15,1017,6878961.857142857,123.0,67.8,14,982,7391358.692307692,139.0,70.14285714285714
33267.0,6,14,4740,7,653,5168.333333333333,249.0,93.28571428571428,7,4087,4803.333333333333,1514.0,583.8571428571429
90054777.0,17,28,13364,28,13364,3335362.111111111,501.0,477.2857142857143,0,0,0.0,0.0,0.0
303463.0,6,6,412,4,272,101154.33333333331,74.0,68.0,2,140,0.0,74.0,70.0
108108647.0,17,5,1005,5,1005,27027161.75,201.0,201.0,0,0,0.0,0.0,0.0
310458.0,6,6,412,4,272,103486.0,74.0,68.0,2,140,0.0,74.0,70.0
115384.0,17,2,286,2,286,0.0,143.0,143.0,0,0,0.0,0.0,0.0
281677.0,17,2,363,1,79,0.0,79.0,79.0,1,284,0.0,284.0,284.0
121365.0,6,3,337,2,214,0.0,160.0,107.0,1,123,0.0,123.0,123.0
196877.0,17,2,180,1,90,0.0,90.0,90.0,1,90,0.0,90.0,90.0
118134265.0,6,47,3102,24,1584,5136261.217391305,66.0,66.0,23,1518,5159999.954545454,66.0,66.0
108098164.0,17,5,1005,5,1005,27024541.0,201.0,201.0,0,0,0.0,0.0,0.0
90093996.0,6,10,1440,7,828,15015666.0,188.0,118.28571428571428,3,612,30031075.0,204.0,204.0
309934.0,6,6,412,4,272,103311.33333333331,74.0,68.0,2,140,0.0,74.0,70.0
147933.0,17,2,180,1,90,0.0,90.0,90.0,1,90,0.0,90.0,90.0
217002.0,6,10,1221,6,636,43400.4,298.0,106.0,4,585,70650.33333333333,379.0,146.25
672591.0,6,2,132,1,66,0.0,66.0,66.0,1,66,0.0,66.0,66.0
16208495.0,17,6,2052,6,2052,3241699.0,342.0,342.0,0,0,0.0,0.0,0.0
90300049.0,6,16,1192,8,596,12892806.57142857,95.0,74.5,8,596,12898838.714285716,95.0,74.5
108097533.0,17,5,955,5,955,27024383.25,191.0,191.0,0,0,0.0,0.0,0.0
1027483.0,6,20,6434,12,1921,93407.54545454546,620.0,160.08333333333334,8,4513,118484.28571428572,1514.0,564.125
322295.0,17,4,1400,4,1400,107431.66666666669,350.0,350.0,0,0,0.0,0.0,0.0
0.0,6,1,172,1,172,0.0,172.0,172.0,0,0,0.0,0.0,0.0
2305.0,17,4,344,2,150,0.0,75.0,75.0,2,194,0.0,103.0,97.0
206943.0,6,3,426,2,280,0.0,214.0,140.0,1,146,0.0,146.0,146.0
102697.0,17,2,700,2,700,0.0,350.0,350.0,0,0,0.0,0.0,0.0
145872.0,17,2,180,1,90,0.0,90.0,90.0,1,90,0.0,90.0,90.0
656.0,17,2,762,2,762,0.0,381.0,381.0,0,0,0.0,0.0,0.0
93023895.0,6,39,2574,19,1254,5167979.388888889,66.0,66.0,20,1320,4895981.157894737,66.0,66.0
314644.0,17,4,1400,4,1400,104881.33333333331,350.0,350.0,0,0,0.0,0.0,0.0
16909.0,6,14,4740,7,653,2697.5,249.0,93.28571428571428,7,4087,2333.0,1514.0,583.8571428571429
186242.0,17,2,180,1,90,0.0,90.0,90.0,1,90,0.0,90.0,90.0
42883.0,6,14,4740,7,653,7027.0,249.0,93.28571428571428,7,4087,6775.0,1514.0,583.8571428571429
8167.000000000001,17,4,344,2,150,0.0,75.0,75.0,2,194,0.0,103.0,97.0
143941.0,17,2,180,1,90,0.0,90.0,90.0,1,90,0.0,90.0,90.0
291356.0,17,4,1400,4,1400,97118.66666666669,350.0,350.0,0,0,0.0,0.0,0.0
124756795.0,17,14,864,7,432,17562431.833333332,174.0,61.71428571428572,7,432,17500181.5,174.0,61.71428571428572
105313271.0,17,13,821,7,432,17552211.833333332,174.0,61.71428571428572,6,389,17053302.0,174.0,64.83333333333333
5768.0,17,2,237,1,81,0.0,81.0,81.0,1,156,0.0,156.0,156.0
146173.0,6,3,337,2,214,0.0,160.0,107.0,1,123,0.0,123.0,123.0
2273.0,17,4,344,2,150,0.0,75.0,75.0,2,194,0.0,103.0,97.0
38622621.0,6,5,336,2,134,0.0,68.0,67.0,3,202,19239847.5,70.0,67.33333333333333
216628.0,6,3,426,2,280,0.0,214.0,140.0,1,146,0.0,146.0,146.0
135130571.0,17,6,1146,6,1146,27026114.2,191.0,191.0,0,0,0.0,0.0,0.0
48012.0,6,14,4740,7,653,7876.166666666667,249.0,93.28571428571428,7,4087,7307.333333333333,1514.0,583.8571428571429
90025512.0,17,28,13364,28,13364,3334278.222222222,501.0,477.2857142857143,0,0,0.0,0.0,0.0
2567574.0,6,2,132,1,66,0.0,66.0,66.0,1,66,0.0,66.0,66.0
15208.0,6,14,4740,7,653,1997.3333333333333,249.0,93.28571428571428,7,4087,2396.6666666666665,1514.0,583.8571428571429
108578.0,17,2,286,2,286,0.0,143.0,143.0,0,0,0.0,0.0,0.0
245504.0,6,3,337,2,214,0.0,160.0,107.0,1,123,0.0,123.0,123.0
135137295.0,17,6,1206,6,1206,27027459.0,201.0,201.0,0,0,0.0,0.0,0.0
90096681.0,6,11,1644,4,816,30031437.0,204.0,204.0,7,828,15015719.166666666,188.0,118.28571428571428
38244.0,6,10,2032,5,524,8679.0,252.0,104.8,5,1508,8244.5,1236.0,301.6
32771.0,6,14,4740,7,653,5286.833333333333,249.0,93.28571428571428,7,4087,5296.333333333333,1514.0,583.8571428571429
205776.0,17,2,180,1,90,0.0,90.0,90.0,1,90,0.0,90.0,90.0
120397877.0,6,215,24374,108,17016,1125213.8037383177,284.0,157.55555555555554,107,7358,1128716.433962264,140.0,68.76635514018692
123301217.0,6,48,3168,24,1584,5045811.130434782,66.0,66.0,24,1584,5250751.739130435,66.0,66.0
1991296.0,17,4,525,2,150,0.0,75.0,75.0,2,375,0.0,284.0,187.5
39045.0,6,14,4740,7,653,6336.5,249.0,93.28571428571428,7,4087,6331.333333333333,1514.0,583.8571428571429
863973.0,6,9,1096,6,625,172794.6,287.0,104.16666666666669,3,471,294144.5,331.0,157.0
302400.0,6,6,412,4,272,100800.0,74.0,68.0,2,140,0.0,74.0,70.0
55733.0,6,14,4740,7,653,9055.333333333334,249.0,93.28571428571428,7,4087,8880.833333333334,1514.0,583.8571428571429
10439935.0,6,6,412,3,206,5151783.5,74.0,68.66666666666667,3,206,5151677.0,74.0,68.66666666666667
122688002.0,6,49,3234,25,1650,5112000.083333333,66.0,66.0,24,1584,5056492.913043479,66.0,66.0
1771059.0,6,2,132,1,66,0.0,66.0,66.0,1,66,0.0,66.0,66.0
90530071.0,6,14,2240,8,1016,12932867.285714284,188.0,127.0,6,1224,18073390.4,204.0,204.0
69125.0,6,14,4740,7,653,11395.0,249.0,93.28571428571428,7,4087,10745.666666666666,1514.0,583.8571428571429
28280.0,6,14,4740,7,653,4589.166666666667,249.0,93.28571428571428,7,4087,4570.0,1514.0,583.8571428571429
204276.0,6,10,1221,6,636,40855.2,298.0,106.0,4,585,67157.33333333333,379.0,146.25
10948.0,6,10,1067,5,536,2447.25,264.0,107.2,5,531,2235.25,259.0,106.2
211869.0,6,10,1221,6,636,42373.8,298.0,106.0,4,585,69782.33333333333,379.0,146.25
2903494.0,6,12,2172,7,664,483900.5,252.0,94.85714285714286,5,1508,1746.25,1236.0,301.6
2522643.0,6,23,7202,13,3681,210220.25,1514.0,283.15384615384613,10,3521,250800.7777777777,1514.0,352.1
9563.0,17,2,571,1,86,0.0,86.0,86.0,1,485,0.0,485.0,485.0
60679574.0,17,9,3086,8,2736,5103716.428571428,342.0,342.0,1,350,0.0,350.0,350.0
17257.0,6,11,2098,6,590,3261.4,252.0,98.33333333333331,5,1508,3669.5,1236.0,301.6
31996.0,6,10,2032,5,524,7773.75,252.0,104.8,5,1508,7483.0,1236.0,301.6
146028.0,6,3,337,2,214,0.0,160.0,107.0,1,123,0.0,123.0,123.0
2059318.0,6,19,6869,10,1501,228813.11111111112,408.0,150.1,9,5368,208857.625,1514.0,596.4444444444445
313758.0,17,4,1400,4,1400,104586.0,350.0,350.0,0,0,0.0,0.0,0.0
55967.0,6,10,2032,5,524,13176.5,252.0,104.8,5,1508,13245.0,1236.0,301.6
51732143.0,6,8,2113,3,960,24535568.5,826.0,320.0,5,1153,12237359.25,885.0,230.6
336.0,17,2,166,1,75,0.0,75.0,75.0,1,91,0.0,91.0,91.0
2014.0,17,4,344,2,150,0.0,75.0,75.0,2,194,0.0,103.0,97.0
58079.0,6,10,2032,5,524,14217.25,252.0,104.8,5,1508,14169.75,1236.0,301.6
0.0,6,1,54,0,0,0.0,0.0,0.0,1,54,0.0,54.0,54.0
1467545.0,6,7,499,4,301,486587.6666666667,103.0,75.25,3,198,642773.0,66.0,66.0
302619.0,6,6,412,4,272,100873.0,74.0,68.0,2,140,0.0,74.0,70.0
183426.0,17,4,704,2,148,0.0,74.0,74.0,2,556,0.0,280.0,278.0
129005886.0,17,15,907,8,475,18429412.285714287,174.0,59.375,7,432,18166825.166666668,174.0,61.71428571428572
41994.0,6,12,1413,7,882,6999.0,291.0,126.0,5,531,8767.75,259.0,106.2
113333467.0,6,31,2176,16,1071,7555564.466666667,123.0,66.9375,15,1105,7530587.571428572,139.0,73.66666666666667
5630870.0,6,4,270,2,134,0.0,68.0,67.0,2,136,0.0,70.0,68.0
209150.0,17,2,180,1,90,0.0,90.0,90.0,1,90,0.0,90.0,90.0
103065326.0,17,14,864,7,432,17167088.166666668,174.0,61.71428571428572,7,432,17166823.166666668,174.0,61.71428571428572
237513.0,6,3,373,2,238,0.0,172.0,119.0,1,135,0.0,135.0,135.0
228671.0,17,2,180,1,90,0.0,90.0,90.0,1,90,0.0,90.0,90.0
1734375.0,6,20,7599,11,1469,173437.5,583.0,133.54545454545453,9,6130,185218.75,1484.0,681.1111111111111
146312.0,6,3,337,2,214,0.0,160.0,107.0,1,123,0.0,123.0,123.0
58300.0,6,14,4740,7,653,9088.166666666666,249.0,93.28571428571428,7,4087,9086.166666666666,1514.0,583.8571428571429
317.0,17,2,174,1,79,0.0,79.0,79.0,1,95,0.0,95.0,95.0
308345.0,6,6,412,4,272,102781.66666666669,74.0,68.0,2,140,0.0,74.0,70.0
302437.0,6,2,132,1,66,0.0,66.0,66.0,1,66,0.0,66.0,66.0
41891.0,6,14,4740,7,653,6333.666666666667,249.0,93.28571428571428,7,4087,6839.666666666667,1514.0,583.8571428571429
90013518.0,17,28,13364,28,13364,3333834.0,501.0,477.2857142857143,0,0,0.0,0.0,0.0
12320.0,17,2,582,1,83,0.0,83.0,83.0,1,499,0.0,499.0,499.0
207552.0,6,3,426,2,280,0.0,214.0,140.0,1,146,0.0,146.0,146.0
2793304.0,6,2,132,1,66,0.0,66.0,66.0,1,66,0.0,66.0,66.0
321.0,17,2,174,1,79,0.0,79.0,79.0,1,95,0.0,95.0,95.0
391.0,17,2,208,1,72,0.0,72.0,72.0,1,136,0.0,136.0,136.0
24807.0,6,10,2032,5,524,5855.0,252.0,104.8,5,1508,5859.5,1236.0,301.6
204942.0,17,2,762,2,762,0.0,381.0,381.0,0,0,0.0,0.0,0.0
90973333.0,6,21,1585,11,840,9096121.6,95.0,76.36363636363636,10,745,10105924.111111112,95.0,74.5
39301.0,6,14,4740,7,653,5810.666666666667,249.0,93.28571428571428,7,4087,4707.166666666667,1514.0,583.8571428571429
233012.0,6,3,373,2,238,0.0,172.0,119.0,1,135,0.0,135.0,135.0
0.0,17,1,55,1,55,0.0,55.0,55.0,0,0,0.0,0.0,0.0
217895.0,17,2,180,1,90,0.0,90.0,90.0,1,90,0.0,90.0,90.0
120003921.0,6,24,1829,13,1030,9999989.5,95.0,79.23076923076923,11,799,11971914.6,95.0,72.63636363636364
206122.0,6,3,426,2,280,0.0,214.0,140.0,1,146,0.0,146.0,146.0
289039.0,17,4,704,2,148,0.0,74.0,74.0,2,556,0.0,280.0,278.0
2369.0,17,4,344,2,150,0.0,75.0,75.0,2,194,0.0,103.0,97.0
108106236.0,17,5,1005,5,1005,27026559.0,201.0,201.0,0,0,0.0,0.0,0.0
228364.0,17,2,180,1,90,0.0,90.0,90.0,1,90,0.0,90.0,90.0
314456.0,17,4,1400,4,1400,104818.66666666669,350.0,350.0,0,0,0.0,0.0,0.0
213663.0,17,2,180,1,90,0.0,90.0,90.0,1,90,0.0,90.0,90.0
17014.0,6,14,4740,7,653,2540.1666666666665,249.0,93.28571428571428,7,4087,2698.6666666666665,1514.0,583.8571428571429
799.0,17,4,438,2,148,0.0,74.0,74.0,2,290,0.0,147.0,145.0
56564.0,6,14,4740,7,653,9267.166666666666,249.0,93.28571428571428,7,4087,9161.333333333334,1514.0,583.8571428571429
180562.0,6,10,1066,5,490,43554.0,218.0,98.0,5,576,43586.5,304.0,115.2
153489.0,17,2,180,1,90,0.0,90.0,90.0,1,90,0.0,90.0,90.0
86777.0,6,13,1386,7,789,14462.833333333334,253.0,112.71428571428572,6,597,15749.8,259.0,99.5
120000231.0,6,27,2949,14,1504,9230787.0,425.0,107.42857142857144,13,1445,8885059.416666666,331.0,111.15384615384616
209502.0,17,2,180,1,90,0.0,90.0,90.0,1,90,0.0,90.0,90.0
507342.0,6,5,336,2,134,0.0,68.0,67.0,3,202,194527.5,70.0,67.33333333333333
213648.0,17,2,180,1,90,0.0,90.0,90.0,1,90,0.0,90.0,90.0
758748.0,6,6,758,3,410,364073.0,172.0,136.66666666666666,3,348,264134.5,135.0,116.0
10857823.0,6,8,544,4,272,3574111.6666666665,74.0,68.0,4,272,3574041.333333333,74.0,68.0
0.0,6,1,66,1,66,0.0,66.0,66.0,0,0,0.0,0.0,0.0
349.0,17,2,267,1,83,0.0,83.0,83.0,1,184,0.0,184.0,184.0
91880476.0,17,16,5472,16,5472,6125365.066666666,342.0,342.0,0,0,0.0,0.0,0.0
90258163.0,6,12,1832,8,1016,12894023.285714284,188.0,127.0,4,816,30031432.0,204.0,204.0
10479622.0,6,7,478,4,272,3446308.0,74.0,68.0,3,206,5169345.0,74.0,68.66666666666667
236693.0,6,3,337,2,214,0.0,160.0,107.0,1,123,0.0,123.0,123.0
5832612.0,6,5,336,2,134,0.0,68.0,67.0,3,202,1525794.0,70.0,67.33333333333333
143825.0,17,2,180,1,90,0.0,90.0,90.0,1,90,0.0,90.0,90.0
1306984.0,6,4,264,2,132,0.0,66.0,66.0,2,132,0.0,66.0,66.0
95085.0,6,11,2098,6,590,18746.8,252.0,98.33333333333331,5,1508,23344.5,1236.0,301.6
203070.0,17,4,6056,4,6056,67690.0,1514.0,1514.0,0,0,0.0,0.0,0.0
54882.0,6,14,4740,7,653,8521.166666666666,249.0,93.28571428571428,7,4087,8991.833333333334,1514.0,583.8571428571429
1033017.0,6,4,270,2,134,0.0,68.0,67.0,2,136,0.0,70.0,68.0
108116073.0,17,5,1005,5,1005,27029018.25,201.0,201.0,0,0,0.0,0.0,0.0
2608080.0,6,2,132,1,66,0.0,66.0,66.0,1,66,0.0,66.0,66.0
90014594.0,17,28,13364,28,13364,3333873.851851852,501.0,477.2857142857143,0,0,0.0,0.0,0.0
324.0,17,2,174,1,79,0.0,79.0,79.0,1,95,0.0,95.0,95.0
85406.0,6,10,2032,5,524,20847.75,252.0,104.8,5,1508,20746.5,1236.0,301.6
118573244.0,6,218,24662,109,17246,1095908.5462962964,284.0,158.22018348623854,109,7416,1095908.509259259,140.0,68.03669724770643
102962.0,17,2,286,2,286,0.0,143.0,143.0,0,0,0.0,0.0,0.0
2015.0,17,4,344,2,150,0.0,75.0,75.0,2,194,0.0,103.0,97.0
58939.0,6,10,2032,5,524,12334.75,252.0,104.8,5,1508,14295.25,1236.0,301.6
44633.0,6,14,4740,7,653,6394.0,249.0,93.28571428571428,7,4087,7115.0,1514.0,583.8571428571429
59767621.0,17,9,3086,8,2736,5363241.285714285,342.0,342.0,1,350,0.0,350.0,350.0
99592.0,17,2,762,2,762,0.0,381.0,381.0,0,0,0.0,0.0,0.0
320.0,17,2,174,1,79,0.0,79.0,79.0,1,95,0.0,95.0,95.0
406129.0,6,10,1221,6,636,81225.8,298.0,106.0,4,585,132672.33333333334,379.0,146.25
41118.0,6,14,4740,7,653,6648.0,249.0,93.28571428571428,7,4087,6713.166666666667,1514.0,583.8571428571429
19444.0,6,14,4740,7,653,3069.1666666666665,249.0,93.28571428571428,7,4087,3074.333333333333,1514.0,583.8571428571429
90017369.0,17,28,13364,28,13364,3333976.6296296297,501.0,477.2857142857143,0,0,0.0,0.0,0.0
135132113.0,17,6,1206,6,1206,27026422.6,201.0,201.0,0,0,0.0,0.0,0.0
87033.0,17,2,762,2,762,0.0,381.0,381.0,0,0,0.0,0.0,0.0
0.0,6,1,66,1,66,0.0,66.0,66.0,0,0,0.0,0.0,0.0
99171.0,17,2,762,2,762,0.0,381.0,381.0,0,0,0.0,0.0,0.0
143438.0,6,2,132,1,66,0.0,66.0,66.0,1,66,0.0,66.0,66.0
314643.0,17,4,622,4,622,104881.0,163.0,155.5,0,0,0.0,0.0,0.0
159704.0,17,4,6056,4,6056,53234.66666666666,1514.0,1514.0,0,0,0.0,0.0,0.0
317593.0,17,4,1400,4,1400,105864.33333333331,350.0,350.0,0,0,0.0,0.0,0.0
108112566.0,17,5,1005,5,1005,27028141.5,201.0,201.0,0,0,0.0,0.0,0.0
13450.0,6,11,1132,6,556,2561.6,218.0,92.66666666666669,5,576,3126.75,304.0,115.2
337.0,17,2,166,1,75,0.0,75.0,75.0,1,91,0.0,91.0,91.0
121250283.0,6,228,25756,114,7820,1056504.8672566372,140.0,68.59649122807018,114,17936,1065745.017699115,284.0,157.33333333333334
123001166.0,17,15,907,8,475,17571595.14285714,174.0,59.375,7,432,17167523.5,174.0,61.71428571428572
205869.0,6,3,426,2,280,0.0,214.0,140.0,1,146,0.0,146.0,146.0
100795539.0,17,12,778,6,389,20159107.8,174.0,64.83333333333333,6,389,20001096.2,174.0,64.83333333333333
11703.0,17,4,823,2,163,0.0,89.0,81.5,2,660,0.0,443.0,330.0
35014.0,6,10,2032,5,524,8271.5,252.0,104.8,5,1508,8298.0,1236.0,301.6
303417.0,6,6,412,4,272,101139.0,74.0,68.0,2,140,0.0,74.0,70.0
29982.0,6,11,2098,6,590,4453.4,252.0,98.33333333333331,5,1508,6431.0,1236.0,301.6
146070.0,6,3,337,2,214,0.0,160.0,107.0,1,123,0.0,123.0,123.0
108099285.0,17,5,955,5,955,27024821.25,191.0,191.0,0,0,0.0,0.0,0.0
146660.0,6,3,337,2,214,0.0,160.0,107.0,1,123,0.0,123.0,123.0
41879.0,6,10,2032,5,524,9094.75,252.0,104.8,5,1508,9428.0,1236.0,301.6
14391.0,6,13,1459,7,862,2398.5,271.0,123.14285714285714,6,597,2524.6,259.0,99.5
95243.0,6,12,1328,7,797,15873.833333333334,253.0,113.85714285714286,5,531,11214.75,259.0,106.2
253352.00000000003,6,3,337,2,214,0.0,160.0,107.0,1,123,0.0,123.0,123.0
106898.0,17,2,700,2,700,0.0,350.0,350.0,0,0,0.0,0.0,0.0
23098.0,6,10,2032,5,524,5550.25,252.0,104.8,5,1508,5509.5,1236.0,301.6
14044757.0,17,6,2052,6,2052,2808951.4,342.0,342.0,0,0,0.0,0.0,0.0
41486.0,6,14,4740,7,653,6681.5,249.0,93.28571428571428,7,4087,6268.333333333333,1514.0,583.8571428571429
240735.0,6,3,373,2,238,0.0,172.0,119.0,1,135,0.0,135.0,135.0
245447.0,6,3,337,2,214,0.0,160.0,107.0,1,123,0.0,123.0,123.0
198645.0,17,2,180,1,90,0.0,90.0,90.0,1,90,0.0,90.0,90.0
5618067.0,6,5,336,2,134,0.0,68.0,67.0,3,202,1419716.0,70.0,67.33333333333333
26044.0,6,12,1413,7,882,4340.666666666667,291.0,126.0,5,531,5765.0,259.0,106.2
277861.0,17,2,363,1,79,0.0,79.0,79.0,1,284,0.0,284.0,284.0
20153.0,6,2,145,2,145,0.0,91.0,72.5,0,0,0.0,0.0,0.0
97000757.0,17,11,735,6,389,19400151.4,174.0,64.83333333333333,5,346,19251351.75,174.0,69.2
205680.0,17,2,180,1,90,0.0,90.0,90.0,1,90,0.0,90.0,90.0
143900.0,17,2,180,1,90,0.0,90.0,90.0,1,90,0.0,90.0,90.0
124249566.0,6,36,2602,19,1408,6902753.666666667,139.0,74.10526315789474,17,1194,7127929.875,123.0,70.23529411764706
873136.0,6,10,1334,6,797,174627.2,459.0,132.83333333333334,4,537,200171.3333333333,331.0,134.25
58843472.0,17,8,2744,7,2394,5958992.5,342.0,342.0,1,350,0.0,350.0,350.0
283903.0,17,2,414,1,88,0.0,88.0,88.0,1,326,0.0,326.0,326.0
135135422.0,17,6,1146,6,1146,27027084.4,191.0,191.0,0,0,0.0,0.0,0.0
146142.0,6,3,337,2,214,0.0,160.0,107.0,1,123,0.0,123.0,123.0
65804.0,17,2,180,1,90,0.0,90.0,90.0,1,90,0.0,90.0,90.0
90035973.0,17,28,13364,28,13364,3334665.6666666665,501.0,477.2857142857143,0,0,0.0,0.0,0.0
90255769.0,6,13,2036,8,1016,12893681.285714284,188.0,127.0,5,1020,22522654.5,204.0,204.0
217775.0,6,3,426,2,280,0.0,214.0,140.0,1,146,0.0,146.0,146.0
121967.0,6,3,373,2,238,0.0,172.0,119.0,1,135,0.0,135.0,135.0
2335.0,17,4,344,2,150,0.0,75.0,75.0,2,194,0.0,103.0,97.0
119333452.0,6,401,47704,201,13562,596667.26,140.0,67.4726368159204,200,34142,594420.4924623115,464.0,170.71
296.0,17,2,164,1,82,0.0,82.0,82.0,1,82,0.0,82.0,82.0
780.0,17,4,438,2,148,0.0,74.0,74.0,2,290,0.0,147.0,145.0
121342.0,6,3,337,2,214,0.0,160.0,107.0,1,123,0.0,123.0,123.0
1941.0,17,4,344,2,150,0.0,75.0,75.0,2,194,0.0,103.0,97.0
0.0,17,1,55,1,55,0.0,55.0,55.0,0,0,0.0,0.0,0.0
153484.0,17,2,180,1,90,0.0,90.0,90.0,1,90,0.0,90.0,90.0
232887.0,6,3,337,2,214,0.0,160.0,107.0,1,123,0.0,123.0,123.0
840689.0,6,9,1096,6,625,168137.8,287.0,104.16666666666669,3,471,284082.5,331.0,157.0
206074.0,6,3,426,2,280,0.0,214.0,140.0,1,146,0.0,146.0,146.0
755960.0,6,2,132,1,66,0.0,66.0,66.0,1,66,0.0,66.0,66.0
159135.0,6,2,128,1,74,0.0,74.0,74.0,1,54,0.0,54.0,54.0
120284892.0,6,19,1477,10,786,13332590.0,95.0,78.6,9,691,15034736.5,95.0,76.77777777777777
103427.0,17,2,286,2,286,0.0,143.0,143.0,0,0,0.0,0.0,0.0
120464067.0,6,217,24792,109,17368,1115408.0277777778,374.0,159.3394495412844,108,7424,1115476.38317757,140.0,68.74074074074075
304418.0,17,2,238,1,74,0.0,74.0,74.0,1,164,0.0,164.0,164.0
14940.0,17,2,180,1,90,0.0,90.0,90.0,1,90,0.0,90.0,90.0
135134031.0,17,6,1206,6,1206,27026806.2,201.0,201.0,0,0,0.0,0.0,0.0
833823.0,6,9,1118,6,586,166764.6,248.0,97.66666666666669,3,532,280627.0,392.0,177.33333333333334
27880.0,6,14,4740,7,653,4435.5,249.0,93.28571428571428,7,4087,4148.833333333333,1514.0,583.8571428571429
143906.0,17,2,180,1,90,0.0,90.0,90.0,1,90,0.0,90.0,90.0
146398.0,6,3,337,2,214,0.0,160.0,107.0,1,123,0.0,123.0,123.0
1001987.0,6,12,1447,6,816,199123.0,291.0,136.0,6,631,199248.4,293.0,105.16666666666669
90261481.0,6,13,2036,8,1016,12894497.285714284,188.0,127.0,5,1020,22524505.75,204.0,204.0
3427.0,17,4,571,2,148,0.0,74.0,74.0,2,423,0.0,280.0,211.5
298745.0,6,6,412,4,272,99581.66666666669,74.0,68.0,2,140,0.0,74.0,70.0
108102194.0,17,5,1005,5,1005,27025548.5,201.0,201.0,0,0,0.0,0.0,0.0
119803400.0,17,35,16705,35,16705,3523629.411764706,501.0,477.2857142857143,0,0,0.0,0.0,0.0
27455.0,6,14,4740,7,653,4466.833333333333,249.0,93.28571428571428,7,4087,4433.166666666667,1514.0,583.8571428571429
327.0,17,2,208,1,72,0.0,72.0,72.0,1,136,0.0,136.0,136.0
31626.0,6,14,4740,7,653,5108.0,249.0,93.28571428571428,7,4087,4753.0,1514.0,583.8571428571429
331749.0,6,6,412,4,272,110583.0,74.0,68.0,2,140,0.0,74.0,70.0
314260.0,17,2,180,1,90,0.0,90.0,90.0,1,90,0.0,90.0,90.0
582.0,17,2,762,2,762,0.0,381.0,381.0,0,0,0.0,0.0,0.0
47633.0,6,14,4740,7,653,7821.833333333333,249.0,93.28571428571428,7,4087,6605.333333333333,1514.0,583.8571428571429
12903.0,6,10,1067,5,536,3053.25,264.0,107.2,5,531,2342.5,259.0,106.2
302019.0,6,6,412,4,272,100673.0,74.0,68.0,2,140,0.0,74.0,70.0
242376.0,6,3,373,2,238,0.0,172.0,119.0,1,135,0.0,135.0,135.0
121484.0,6,3,337,2,214,0.0,160.0,107.0,1,123,0.0,123.0,123.0
146254.0,6,3,337,2,214,0.0,160.0,107.0,1,123,0.0,123.0,123.0
299430.0,6,7,478,4,272,99810.0,74.0,68.0,3,206,73659.0,74.0,68.66666666666667
190817.0,17,2,180,1,90,0.0,90.0,90.0,1,90,0.0,90.0,90.0
3777158.0,6,5,336,2,134,0.0,68.0,67.0,3,202,1526067.5,70.0,67.33333333333333
307148.0,6,6,412,4,272,102382.66666666669,74.0,68.0,2,140,0.0,74.0,70.0
33138.0,6,14,4740,7,653,5402.333333333333,249.0,93.28571428571428,7,4087,5003.0,1514.0,583.8571428571429
120176097.0,17,13,690,7,432,19968012.83333333,174.0,61.71428571428572,6,258,20000910.4,43.0,43.0
103079.0,17,2,286,2,286,0.0,143.0,143.0,0,0,0.0,0.0,0.0
120000367.0,6,17,1287,9,691,15000045.875,95.0,76.77777777777777,8,596,12897867.714285716,95.0,74.5
309896.0,6,6,412,4,272,103298.66666666669,74.0,68.0,2,140,0.0,74.0,70.0
425408.0,6,4,508,2,238,0.0,172.0,119.0,2,270,0.0,135.0,135.0
204582.0,17,8,12112,8,12112,29226.0,1514.0,1514.0,0,0,0.0,0.0,0.0
2968.0,17,2,762,2,762,0.0,381.0,381.0,0,0,0.0,0.0,0.0
10513081.0,6,7,478,4,272,3458616.0,74.0,68.0,3,206,5187791.0,74.0,68.66666666666667
90548850.0,6,14,2240,8,1016,12935550.0,188.0,127.0,6,1224,18076961.4,204.0,204.0
310145.0,6,6,412,4,272,103381.66666666669,74.0,68.0,2,140,0.0,74.0,70.0
2356.0,17,4,344,2,150,0.0,75.0,75.0,2,194,0.0,103.0,97.0
2014.0,17,4,344,2,150,0.0,75.0,75.0,2,194,0.0,103.0,97.0
1585104.0,6,38,23903,20,1484,83426.52631578948,210.0,74.2,18,22419,92499.35294117648,1514.0,1245.5
15040392.0,6,5,370,5,370,3760098.0,74.0,74.0,0,0,0.0,0.0,0.0
97168341.0,6,51,4518,30,2556,3343190.172413793,123.0,85.2,21,1962,4847627.3,123.0,93.42857142857144
298102.0,6,6,412,4,272,99367.33333333331,74.0,68.0,2,140,0.0,74.0,70.0
146098.0,6,3,337,2,214,0.0,160.0,107.0,1,123,0.0,123.0,123.0
3743.0,17,4,344,2,150,0.0,75.0,75.0,2,194,0.0,103.0,97.0
24049.0,6,11,1131,6,600,4289.8,262.0,100.0,5,531,4734.25,259.0,106.2
31156.0,6,10,2032,5,524,7489.25,252.0,104.8,5,1508,6368.75,1236.0,301.6
65705.0,6,13,1386,7,789,10950.833333333334,253.0,112.71428571428572,6,597,9689.6,259.0,99.5
90257858.0,6,13,2036,8,1016,12893979.714285716,188.0,127.0,5,1020,22522492.75,204.0,204.0
246170.0,6,3,337,2,214,0.0,160.0,107.0,1,123,0.0,123.0,123.0
319149.0,17,4,1400,4,1400,106383.0,350.0,350.0,0,0,0.0,0.0,0.0
14635476.0,6,20,1605,10,973,1592678.4444444445,315.0,97.3,10,632,1592650.3333333333,78.0,63.2
303417.0,6,6,412,4,272,101139.0,74.0,68.0,2,140,0.0,74.0,70.0
1204571.0,17,7,490,7,490,200761.8333333333,70.0,70.0,0,0,0.0,0.0,0.0
3387634.0,6,3,1604,1,753,0.0,753.0,753.0,2,851,0.0,785.0,425.5
47707.0,6,10,2032,5,524,11691.25,252.0,104.8,5,1508,10160.5,1236.0,301.6
322973.0,17,4,1400,4,1400,107657.66666666669,350.0,350.0,0,0,0.0,0.0,0.0
302229.0,6,6,412,4,272,100743.0,74.0,68.0,2,140,0.0,74.0,70.0
53244.0,6,10,2032,5,524,8121.0,252.0,104.8,5,1508,10772.25,1236.0,301.6
10484310.0,6,6,412,3,206,5174065.0,74.0,68.66666666666667,3,206,5173946.5,74.0,68.66666666666667
102994.0,17,2,286,2,286,0.0,143.0,143.0,0,0,0.0,0.0,0.0
339110.0,6,3,202,2,128,0.0,74.0,64.0,1,74,0.0,74.0,74.0
135134846.0,17,6,1206,6,1206,27026969.2,201.0,201.0,0,0,0.0,0.0,0.0
1581158.0,6,20,7599,11,1469,158115.8,583.0,133.54545454545453,9,6130,163670.375,1484.0,681.1111111111111
16388.0,6,20,7606,11,978,1638.8,310.0,88.9090909090909,9,6628,1783.75,1514.0,736.4444444444445
2514.0,17,4,344,2,150,0.0,75.0,75.0,2,194,0.0,103.0,97.0
21731.0,17,2,582,1,83,0.0,83.0,83.0,1,499,0.0,499.0,499.0
112535426.0,6,46,3036,23,1518,5105433.5,66.0,66.0,23,1518,5105433.2727272725,66.0,66.0
90294009.0,6,16,1192,8,596,12892792.57142857,95.0,74.5,8,596,12898921.142857144,95.0,74.5
303122.0,6,2,132,1,66,0.0,66.0,66.0,1,66,0.0,66.0,66.0
411.0,17,2,267,1,83,0.0,83.0,83.0,1,184,0.0,184.0,184.0
49498.0,6,2,132,1,66,0.0,66.0,66.0,1,66,0.0,66.0,66.0
90257890.0,6,13,2036,8,1016,12893984.285714284,188.0,127.0,5,1020,22522836.25,204.0,204.0
107738.0,17,2,286,2,286,0.0,143.0,143.0,0,0,0.0,0.0,0.0
106448704.0,6,29,2068,15,1105,7588051.142857143,139.0,73.66666666666667,14,963,8171741.384615385,123.0,68.78571428571429
153577.0,17,2,180,1,90,0.0,90.0,90.0,1,90,0.0,90.0,90.0
90290569.0,6,16,1192,8,596,12892763.714285716,95.0,74.5,8,596,12896479.714285716,95.0,74.5
120010041.0,17,13,821,7,432,20001673.5,174.0,61.71428571428572,6,389,20030996.0,174.0,64.83333333333333
41957.0,6,14,4740,7,653,6811.166666666667,249.0,93.28571428571428,7,4087,5590.0,1514.0,583.8571428571429
135139481.0,17,6,1146,6,1146,27027896.2,191.0,191.0,0,0,0.0,0.0,0.0
131932.0,6,2,132,1,66,0.0,66.0,66.0,1,66,0.0,66.0,66.0
39864.0,6,13,1386,7,789,6377.5,253.0,112.71428571428572,6,597,6934.6,259.0,99.5
90257404.0,6,14,2240,8,1016,12893914.857142856,188.0,127.0,6,1224,18017014.2,204.0,204.0
14271521.0,17,6,2052,6,2052,2854304.2,342.0,342.0,0,0,0.0,0.0,0.0
153478.0,17,2,180,1,90,0.0,90.0,90.0,1,90,0.0,90.0,90.0
90018640.0,17,28,13364,28,13364,3334023.703703704,501.0,477.2857142857143,0,0,0.0,0.0,0.0
63493924.0,6,9,1479,9,1479,7936740.5,172.0,164.33333333333334,0,0,0.0,0.0,0.0
278678.0,17,2,582,1,83,0.0,83.0,83.0,1,499,0.0,499.0,499.0
90026462.0,17,27,12943,27,12943,3462556.230769231,501.0,479.3703703703704,0,0,0.0,0.0,0.0
37067.0,6,14,4740,7,653,5200.5,249.0,93.28571428571428,7,4087,5917.5,1514.0,583.8571428571429
94941842.0,17,13,1214,7,694,15823640.333333334,174.0,99.14285714285714,6,520,17983006.2,174.0,86.66666666666667
11930.0,6,10,1065,5,534,2761.0,262.0,106.8,5,531,2268.0,259.0,106.2
7103.0,17,2,414,1,88,0.0,88.0,88.0,1,326,0.0,326.0,326.0
87.0,17,2,762,2,762,0.0,381.0,381.0,0,0,0.0,0.0,0.0
233178.0,6,3,337,2,214,0.0,160.0,107.0,1,123,0.0,123.0,123.0
106849.0,17,2,286,2,286,0.0,143.0,143.0,0,0,0.0,0.0,0.0
2983452.0,6,165,126991,89,117673,33902.86363636364,1510.0,1322.1685393258426,76,9318,35709.53333333333,1510.0,122.60526315789474
99703.0,17,2,762,2,762,0.0,381.0,381.0,0,0,0.0,0.0,0.0
209844.0,6,3,426,2,280,0.0,214.0,140.0,1,146,0.0,146.0,146.0
123418268.0,6,48,3168,24,1584,4947745.652173913,66.0,66.0,24,1584,5353914.913043479,66.0,66.0
86266.0,6,2,136,1,66,0.0,66.0,66.0,1,70,0.0,70.0,70.0
5620782.0,6,5,336,2,134,0.0,68.0,67.0,3,202,1524846.0,70.0,67.33333333333333
10848934.0,6,8,544,4,272,3570598.6666666665,74.0,68.0,4,272,3570531.0,74.0,68.0
78504054.0,6,80,10080,80,10080,993722.2025316457,126.0,126.0,0,0,0.0,0.0,0.0
90979310.0,6,21,1585,11,840,9096804.4,95.0,76.36363636363636,10,745,10108428.222222222,95.0,74.5
5039.0,17,2,180,1,90,0.0,90.0,90.0,1,90,0.0,90.0,90.0
90017705.0,17,28,13364,28,13364,3333989.074074074,501.0,477.2857142857143,0,0,0.0,0.0,0.0
1707491.0,6,4,276,2,128,0.0,74.0,64.0,2,148,0.0,74.0,74.0
90523287.0,6,14,2240,8,1016,12931898.142857144,188.0,127.0,6,1224,18072342.8,204.0,204.0
1182658.0,6,13,3000,8,2372,168951.14285714287,1514.0,296.5,5,628,227565.0,331.0,125.6
37457.0,6,10,2032,5,524,8654.75,252.0,104.8,5,1508,8701.0,1236.0,301.6
121031370.0,6,33,2280,17,1209,7564460.625,123.0,71.11764705882354,16,1071,7388626.866666666,123.0,66.9375
5818347.0,6,4,270,2,136,0.0,70.0,68.0,2,134,0.0,68.0,67.0
97073327.0,6,178,20110,89,14014,1100648.6136363635,284.0,157.46067415730337,89,6096,1100660.3409090908,140.0,68.49438202247191
102437471.0,17,13,1083,7,563,17046424.0,174.0,80.42857142857143,6,520,16548962.8,174.0,86.66666666666667
120141818.0,6,244,27532,122,8348,986014.7603305784,140.0,68.42622950819673,122,19184,986142.5041322312,284.0,157.24590163934425
2345.0,17,4,344,2,150,0.0,75.0,75.0,2,194,0.0,103.0,97.0
15065.0,17,2,180,1,90,0.0,90.0,90.0,1,90,0.0,90.0,90.0
2370145.0,6,25,7573,14,3735,182318.84615384616,1514.0,266.7857142857143,11,3838,211998.1,1514.0,348.90909090909093
1036868.0,6,11,1134,6,558,207373.6,220.0,93.0,5,576,255906.0,304.0,115.2
120043529.0,17,28,13364,28,13364,4446056.62962963,501.0,477.2857142857143,0,0,0.0,0.0,0.0
16312.0,6,10,2032,5,524,3849.25,252.0,104.8,5,1508,3766.25,1236.0,301.6
90719056.0,6,21,1585,10,745,10079895.111111112,95.0,74.5,11,840,9045041.3,95.0,76.36363636363636
242380.0,6,3,337,2,214,0.0,160.0,107.0,1,123,0.0,123.0,123.0
148013.0,17,2,180,1,90,0.0,90.0,90.0,1,90,0.0,90.0,90.0
2077.0,17,4,344,2,150,0.0,75.0,75.0,2,194,0.0,103.0,97.0
99035233.0,17,14,1126,7,563,16500134.0,174.0,80.42857142857143,7,563,16500624.166666666,174.0,80.42857142857143
1092645.0,6,13,1394,7,797,182107.5,253.0,113.85714285714286,6,597,216624.6,259.0,99.5
48974.0,6,12,1447,6,816,9247.8,291.0,136.0,6,631,8971.0,293.0,105.16666666666669
148583184.0,6,23,1734,13,989,12381932.0,95.0,76.07692307692308,10,745,13209041.222222222,95.0,74.5
179182.0,17,4,1400,4,1400,59727.333333333336,350.0,350.0,0,0,0.0,0.0,0.0
10506362.0,6,7,478,4,272,3456631.333333333,74.0,68.0,3,206,5184848.5,74.0,68.66666666666667
223510.0,6,12,1373,7,714,37251.66666666666,298.0,102.0,5,659,54877.5,379.0,131.8
29404.0,6,10,2032,5,524,5352.5,252.0,104.8,5,1508,7032.25,1236.0,301.6
28307.0,6,11,2098,6,590,4663.0,252.0,98.33333333333331,5,1508,6424.0,1236.0,301.6
92829850.0,6,365,45862,183,12300,510054.1208791209,140.0,67.21311475409836,182,33562,511472.0773480663,464.0,184.4065934065934
120118011.0,6,47,3102,23,1518,5160000.363636363,66.0,66.0,24,1584,5222508.391304348,66.0,66.0
90255359.0,6,12,1832,8,1016,12893622.714285716,188.0,127.0,4,816,30029168.0,204.0,204.0
113449045.0,6,658,82824,329,60888,345257.60670731706,374.0,185.06990881458967,329,21936,345257.6768292683,140.0,66.67477203647417
197284.0,17,2,180,1,90,0.0,90.0,90.0,1,90,0.0,90.0,90.0
135147371.0,17,6,1146,6,1146,27029474.2,191.0,191.0,0,0,0.0,0.0,0.0
281831.0,17,2,493,1,88,0.0,88.0,88.0,1,405,0.0,405.0,405.0
90018845.0,17,27,12943,27,12943,3462263.269230769,501.0,479.3703703703704,0,0,0.0,0.0,0.0
104607.0,17,2,286,2,286,0.0,143.0,143.0,0,0,0.0,0.0,0.0
135132191.0,17,6,1206,6,1206,27026438.2,201.0,201.0,0,0,0.0,0.0,0.0
119441274.0,6,227,25886,114,18206,1057002.424778761,336.0,159.7017543859649,113,7680,1057157.7767857143,140.0,67.96460176991151
2005.0,17,4,344,2,150,0.0,75.0,75.0,2,194,0.0,103.0,97.0
135122395.0,17,6,1206,6,1206,27024479.0,201.0,201.0,0,0,0.0,0.0,0.0
56512.0,6,14,4740,7,653,9288.166666666666,249.0,93.28571428571428,7,4087,8827.166666666666,1514.0,583.8571428571429
135126808.0,17,6,1206,6,1206,27025361.6,201.0,201.0,0,0,0.0,0.0,0.0
38696.0,6,14,4740,7,653,5987.833333333333,249.0,93.28571428571428,7,4087,6059.5,1514.0,583.8571428571429
114329446.0,6,48,3168,24,1584,4970845.478260869,66.0,66.0,24,1584,4957255.043478261,66.0,66.0
512662.0,6,5,336,2,134,0.0,68.0,67.0,3,202,195631.0,70.0,67.33333333333333
143890.0,17,2,180,1,90,0.0,90.0,90.0,1,90,0.0,90.0,90.0
94920730.0,6,177,19938,89,6096,1078644.6590909092,140.0,68.49438202247191,88,13842,1079150.7816091955,284.0,157.29545454545453
118043543.0,6,30,1974,15,1026,8416270.5,123.0,68.4,15,948,8416270.214285715,123.0,63.2
39820.0,6,14,4740,7,653,6024.0,249.0,93.28571428571428,7,4087,4954.166666666667,1514.0,583.8571428571429
279312.0,17,4,1400,4,1400,93104.0,350.0,350.0,0,0,0.0,0.0,0.0
108025.0,17,2,286,2,286,0.0,143.0,143.0,0,0,0.0,0.0,0.0
23639.0,6,14,4740,7,653,3812.5,249.0,93.28571428571428,7,4087,3236.1666666666665,1514.0,583.8571428571429
135137952.0,17,6,1146,6,1146,27027590.4,191.0,191.0,0,0,0.0,0.0,0.0
9466.0,17,2,582,1,83,0.0,83.0,83.0,1,499,0.0,499.0,499.0
145968.0,6,3,337,2,214,0.0,160.0,107.0,1,123,0.0,123.0,123.0
29947.0,6,10,2032,5,524,6932.0,252.0,104.8,5,1508,6932.25,1236.0,301.6
241242.0,17,4,1524,4,1524,80414.0,381.0,381.0,0,0,0.0,0.0,0.0
873446.0,6,12,2709,7,743,145574.33333333334,339.0,106.14285714285714,5,1966,149459.75,1514.0,393.2
122124096.0,17,14,864,7,432,17166832.5,174.0,61.71428571428572,7,432,17168389.0,174.0,61.71428571428572
1176809.0,6,11,1134,6,558,235361.8,220.0,93.0,5,576,292693.0,304.0,115.2
10478176.0,6,7,478,4,272,3445977.6666666665,74.0,68.0,3,206,5168851.5,74.0,68.66666666666667
135103034.0,17,6,1206,6,1206,27020606.8,201.0,201.0,0,0,0.0,0.0,0.0
100587610.0,6,31,2314,15,1086,7184829.285714285,123.0,72.4,16,1228,6025746.733333333,139.0,76.75
14365971.0,17,6,2052,6,2052,2873194.2,342.0,342.0,0,0,0.0,0.0,0.0
207804.0,6,4,492,2,280,0.0,214.0,140.0,2,212,0.0,146.0,106.0
849648.0,6,9,1096,6,625,169929.6,287.0,104.16666666666669,3,471,288634.5,331.0,157.0
2450.0,17,4,344,2,150,0.0,75.0,75.0,2,194,0.0,103.0,97.0
107068.0,17,2,286,2,286,0.0,143.0,143.0,0,0,0.0,0.0,0.0
203995.0,17,2,762,2,762,0.0,381.0,381.0,0,0,0.0,0.0,0.0
1299230.0,6,4,264,2,132,0.0,66.0,66.0,2,132,0.0,66.0,66.0
108110872.0,17,5,955,5,955,27027718.0,191.0,191.0,0,0,0.0,0.0,0.0
101218781.0,17,14,1126,7,563,16834381.0,174.0,80.42857142857143,7,563,16666802.666666666,174.0,80.42857142857143
28978.0,6,14,4740,7,653,4687.666666666667,249.0,93.28571428571428,7,4087,4365.666666666667,1514.0,583.8571428571429
108115068.0,17,5,955,5,955,27028767.0,191.0,191.0,0,0,0.0,0.0,0.0
36218.0,6,14,4740,7,653,4349.833333333333,249.0,93.28571428571428,7,4087,5730.333333333333,1514.0,583.8571428571429
135151692.0,17,6,1146,6,1146,27030338.4,191.0,191.0,0,0,0.0,0.0,0.0
5621635.0,6,5,336,2,134,0.0,68.0,67.0,3,202,1403203.5,70.0,67.33333333333333
205913.0,17,2,180,1,90,0.0,90.0,90.0,1,90,0.0,90.0,90.0
327.0,17,2,174,1,79,0.0,79.0,79.0,1,95,0.0,95.0,95.0
107130.0,17,2,700,2,700,0.0,350.0,350.0,0,0,0.0,0.0,0.0
113865969.0,6,216,24312,108,16888,1064167.9345794392,284.0,156.37037037037038,108,7424,1062063.23364486,140.0,68.74074074074075
135134945.0,17,6,1206,6,1206,27026989.0,201.0,201.0,0,0,0.0,0.0,0.0
302048.0,6,6,412,4,272,100682.66666666669,74.0,68.0,2,140,0.0,74.0,70.0
108086723.0,17,5,1005,5,1005,27021680.75,201.0,201.0,0,0,0.0,0.0,0.0
108106821.0,17,5,955,5,955,27026705.25,191.0,191.0,0,0,0.0,0.0,0.0
100047309.0,17,14,864,7,432,16667473.0,174.0,61.71428571428572,7,432,16666804.666666666,174.0,61.71428571428572
115299678.0,6,219,24744,110,7556,1057795.2110091744,140.0,68.69090909090909,109,17188,1057978.7777777778,284.0,157.6880733944954
90296682.0,6,13,1898,8,1016,12899526.0,188.0,127.0,5,882,22532667.25,204.0,176.4
135131644.0,17,6,1206,6,1206,27026328.8,201.0,201.0,0,0,0.0,0.0,0.0
10943.0,17,4,438,2,148,0.0,74.0,74.0,2,290,0.0,147.0,145.0
60146.0,6,10,2032,5,524,14794.5,252.0,104.8,5,1508,14379.25,1236.0,301.6
43872.0,6,2,132,1,66,0.0,66.0,66.0,1,66,0.0,66.0,66.0
2795462.0,6,2,132,1,66,0.0,66.0,66.0,1,66,0.0,66.0,66.0
153436.0,17,2,180,1,90,0.0,90.0,90.0,1,90,0.0,90.0,90.0
103722.0,17,2,762,2,762,0.0,381.0,381.0,0,0,0.0,0.0,0.0
153132.0,6,3,337,2,214,0.0,160.0,107.0,1,123,0.0,123.0,123.0
127367864.0,6,32,2236,16,1071,7825543.266666667,123.0,66.9375,16,1165,7825559.6,139.0,72.8125
166753.0,17,2,180,1,90,0.0,90.0,90.0,1,90,0.0,90.0,90.0
162392.0,17,2,180,1,90,0.0,90.0,90.0,1,90,0.0,90.0,90.0
1302525.0,6,4,264,2,132,0.0,66.0,66.0,2,132,0.0,66.0,66.0
216859.0,6,3,426,2,280,0.0,214.0,140.0,1,146,0.0,146.0,146.0
23090.0,6,10,2032,5,524,5555.25,252.0,104.8,5,1508,5424.5,1236.0,301.6
228295.0,17,2,180,1,90,0.0,90.0,90.0,1,90,0.0,90.0,90.0
837.0,17,4,438,2,148,0.0,74.0,74.0,2,290,0.0,147.0,145.0
0.0,17,1,55,1,55,0.0,55.0,55.0,0,0,0.0,0.0,0.0
5829362.0,6,5,336,2,134,0.0,68.0,67.0,3,202,1526067.5,70.0,67.33333333333333
49288.0,6,10,2032,5,524,11663.25,252.0,104.8,5,1508,11669.5,1236.0,301.6
5010340.0,17,4,304,2,152,0.0,76.0,76.0,2,152,0.0,76.0,76.0
302393.0,6,2,132,1,66,0.0,66.0,66.0,1,66,0.0,66.0,66.0
5458.0,17,2,245,1,85,0.0,85.0,85.0,1,160,0.0,160.0,160.0
33342.0,6,14,4740,7,653,5431.833333333333,249.0,93.28571428571428,7,4087,5225.666666666667,1514.0,583.8571428571429
1307021.0,6,4,264,2,132,0.0,66.0,66.0,2,132,0.0,66.0,66.0
143922.0,17,2,180,1,90,0.0,90.0,90.0,1,90,0.0,90.0,90.0
313006.0,6,6,412,4,272,104335.33333333331,74.0,68.0,2,140,0.0,74.0,70.0
283123.0,6,10,1221,6,636,56624.6,298.0,106.0,4,585,88379.66666666667,379.0,146.25
23004.0,6,14,4740,7,653,3330.333333333333,249.0,93.28571428571428,7,4087,3674.5,1514.0,583.8571428571429
298667.0,6,6,412,4,272,99555.66666666669,74.0,68.0,2,140,0.0,74.0,70.0
898.0,17,2,267,1,83,0.0,83.0,83.0,1,184,0.0,184.0,184.0
57734.0,17,2,762,2,762,0.0,381.0,381.0,0,0,0.0,0.0,0.0
19424.0,6,14,4740,7,653,2842.0,249.0,93.28571428571428,7,4087,3099.833333333333,1514.0,583.8571428571429
26018.0,6,14,4740,7,653,3798.3333333333335,249.0,93.28571428571428,7,4087,4131.5,1514.0,583.8571428571429
108142552.0,17,5,1005,5,1005,27035638.0,201.0,201.0,0,0,0.0,0.0,0.0
37135.0,6,10,2032,5,524,8964.5,252.0,104.8,5,1508,8157.0,1236.0,301.6
915733.0,6,5,1915,3,1021,457866.5,885.0,340.3333333333333,2,894,0.0,826.0,447.0
66497.0,6,12,1328,7,797,11082.833333333334,253.0,113.85714285714286,5,531,14844.0,259.0,106.2
119942.0,17,2,180,1,70,0.0,70.0,70.0,1,110,0.0,110.0,110.0
110400089.0,6,40,3078,21,1638,5520004.45,123.0,78.0,19,1440,6120977.833333333,123.0,75.78947368421052
304106.0,6,6,412,4,272,101368.66666666669,74.0,68.0,2,140,0.0,74.0,70.0
100836.0,17,4,6056,4,6056,33612.0,1514.0,1514.0,0,0,0.0,0.0,0.0
90533759.0,6,13,2036,8,1016,12933394.142857144,188.0,127.0,5,1020,22592550.5,204.0,204.0
213602.0,17,2,180,1,90,0.0,90.0,90.0,1,90,0.0,90.0,90.0
15579.0,6,10,2032,5,524,3612.75,252.0,104.8,5,1508,3203.5,1236.0,301.6
90032472.0,17,27,12943,27,12943,3462787.3846153845,501.0,479.3703703703704,0,0,0.0,0.0,0.0
144756.0,17,2,180,1,70,0.0,70.0,70.0,1,110,0.0,110.0,110.0
283.0,17,2,164,1,82,0.0,82.0,82.0,1,82,0.0,82.0,82.0
113771795.0,6,349,40560,175,28854,653860.8908045978,284.0,164.88,174,11706,656338.8670520231,140.0,67.27586206896552
43269.0,6,14,4740,7,653,7086.666666666667,249.0,93.28571428571428,7,4087,7017.5,1514.0,583.8571428571429
26163.0,6,14,4740,7,653,3877.5,249.0,93.28571428571428,7,4087,4223.166666666667,1514.0,583.8571428571429
2794824.0,6,2,132,1,66,0.0,66.0,66.0,1,66,0.0,66.0,66.0
119931.0,17,2,180,1,70,0.0,70.0,70.0,1,110,0.0,110.0,110.0
2328.0,17,4,344,2,150,0.0,75.0,75.0,2,194,0.0,103.0,97.0
23776.0,6,14,4740,7,653,3720.0,249.0,93.28571428571428,7,4087,3383.6666666666665,1514.0,583.8571428571429
75624417.0,6,9,842,9,842,9453052.125,97.0,93.55555555555556,0,0,0.0,0.0,0.0
252588.0,6,3,337,2,214,0.0,160.0,107.0,1,123,0.0,123.0,123.0
10871176.0,6,8,544,4,272,3578476.333333333,74.0,68.0,4,272,3578402.0,74.0,68.0
235162.0,6,3,373,2,238,0.0,172.0,119.0,1,135,0.0,135.0,135.0
178243.0,17,2,180,1,90,0.0,90.0,90.0,1,90,0.0,90.0,90.0
179952.0,17,2,180,1,90,0.0,90.0,90.0,1,90,0.0,90.0,90.0
120208847.0,6,23,1988,11,1135,11999328.4,222.0,103.1818181818182,12,853,10908459.727272728,95.0,71.08333333333333
143842.0,17,2,180,1,90,0.0,90.0,90.0,1,90,0.0,90.0,90.0
108107642.0,17,5,955,5,955,27026910.5,191.0,191.0,0,0,0.0,0.0,0.0
3021492.0,6,138,114844,83,106912,36847.46341463415,1510.0,1288.0963855421687,55,7932,50215.98148148148,1510.0,144.21818181818182
52722.0,6,14,4740,7,653,7724.833333333333,249.0,93.28571428571428,7,4087,8066.333333333333,1514.0,583.8571428571429
233269.0,6,3,373,2,238,0.0,172.0,119.0,1,135,0.0,135.0,135.0
204663.0,17,2,762,2,762,0.0,381.0,381.0,0,0,0.0,0.0,0.0
90255863.0,6,13,2036,8,1016,12893694.714285716,188.0,127.0,5,1020,22522829.5,204.0,204.0
27046714.0,17,5,1710,5,1710,6761678.5,342.0,342.0,0,0,0.0,0.0,0.0
61046.0,6,14,4740,7,653,9732.5,249.0,93.28571428571428,7,4087,9816.0,1514.0,583.8571428571429
217804.0,6,3,426,2,280,0.0,214.0,140.0,1,146,0.0,146.0,146.0
2008.0,17,4,344,2,150,0.0,75.0,75.0,2,194,0.0,103.0,97.0
135137550.0,17,6,1146,6,1146,27027510.0,191.0,191.0,0,0,0.0,0.0,0.0
204842.0,17,2,762,2,762,0.0,381.0,381.0,0,0,0.0,0.0,0.0
114104224.0,6,48,3168,24,1584,4961053.217391305,66.0,66.0,24,1584,4947635.0869565215,66.0,66.0
124032094.0,6,32,2236,16,1071,7603130.266666667,123.0,66.9375,16,1165,7603150.8,139.0,72.8125
2409.0,17,4,344,2,150,0.0,75.0,75.0,2,194,0.0,103.0,97.0
305909.0,6,2,132,1,66,0.0,66.0,66.0,1,66,0.0,66.0,66.0
115737960.0,6,30,1974,15,1026,8251564.857142857,123.0,68.4,15,948,8251566.285714285,123.0,63.2
1314208.0,6,4,264,2,132,0.0,66.0,66.0,2,132,0.0,66.0,66.0
6839.0,17,2,582,1,83,0.0,83.0,83.0,1,499,0.0,499.0,499.0
13541.0,6,10,1065,5,534,2880.25,262.0,106.8,5,531,3066.0,259.0,106.2
725.0,17,2,762,2,762,0.0,381.0,381.0,0,0,0.0,0.0,0.0
90047894.0,17,28,13364,28,13364,3335107.185185185,501.0,477.2857142857143,0,0,0.0,0.0,0.0
3328.0,17,2,333,1,87,0.0,87.0,87.0,1,246,0.0,246.0,246.0
215468.0,17,2,180,1,90,0.0,90.0,90.0,1,90,0.0,90.0,90.0
1316057.0,17,7,490,7,490,219342.8333333333,70.0,70.0,0,0,0.0,0.0,0.0
120089758.0,6,192,21738,96,6632,1255538.494736842,140.0,69.08333333333333,96,15106,1255494.347368421,284.0,157.35416666666666
90945822.0,6,21,1585,11,840,9094068.3,95.0,76.36363636363636,10,745,10103740.666666666,95.0,74.5
105521984.0,17,14,864,7,432,17500166.833333332,174.0,61.71428571428572,7,432,17502385.166666668,174.0,61.71428571428572
312645.0,6,3,1777,2,951,0.0,885.0,475.5,1,826,0.0,826.0,826.0
93524043.0,6,28,2008,14,1045,7194157.153846154,139.0,74.64285714285714,14,963,7177533.307692308,123.0,68.78571428571429
116286919.0,17,14,864,7,432,19333503.166666668,174.0,61.71428571428572,7,432,19333895.83333333,174.0,61.71428571428572
47867.0,6,10,2032,5,524,10685.0,252.0,104.8,5,1508,10792.25,1236.0,301.6
111534.0,17,2,286,2,286,0.0,143.0,143.0,0,0,0.0,0.0,0.0
26804.0,6,10,2032,5,524,6468.25,252.0,104.8,5,1508,6369.5,1236.0,301.6
298334.0,6,6,412,4,272,99444.66666666669,74.0,68.0,2,140,0.0,74.0,70.0
902040.0,6,12,2710,7,742,150340.0,338.0,106.0,5,1968,157374.25,1514.0,393.6
2361.0,17,4,344,2,150,0.0,75.0,75.0,2,194,0.0,103.0,97.0
109244759.0,6,44,2904,22,1452,5202131.380952381,66.0,66.0,22,1452,5191841.285714285,66.0,66.0
36919.0,6,14,4740,7,653,5737.666666666667,249.0,93.28571428571428,7,4087,5906.333333333333,1514.0,583.8571428571429
104324.0,17,2,286,2,286,0.0,143.0,143.0,0,0,0.0,0.0,0.0
931287.0,6,12,1354,6,723,184791.8,253.0,120.5,6,631,185819.8,293.0,105.16666666666669
160804.0,17,2,180,1,90,0.0,90.0,90.0,1,90,0.0,90.0,90.0
90009920.0,17,28,13364,28,13364,3333700.7407407407,501.0,477.2857142857143,0,0,0.0,0.0,0.0
155420.0,6,3,337,2,214,0.0,160.0,107.0,1,123,0.0,123.0,123.0
5042.0,17,4,344,2,150,0.0,75.0,75.0,2,194,0.0,103.0,97.0
692.0,17,2,508,2,508,0.0,257.0,254.0,0,0,0.0,0.0,0.0
2596831.0,6,2,132,1,66,0.0,66.0,66.0,1,66,0.0,66.0,66.0
90742421.0,6,23,1775,13,1030,7557918.416666667,95.0,79.23076923076923,10,745,9897121.333333334,95.0,74.5
22101748.0,17,3,1034,2,684,0.0,342.0,342.0,1,350,0.0,350.0,350.0
461677.0,6,6,758,3,410,209424.5,172.0,136.66666666666666,3,348,171085.0,135.0,116.0
135137464.0,17,6,1206,6,1206,27027492.8,201.0,201.0,0,0,0.0,0.0,0.0
91749613.0,6,25,2811,13,1454,7627751.333333333,360.0,111.84615384615384,12,1357,8321287.090909091,426.0,113.08333333333331
146370.0,6,3,337,2,214,0.0,160.0,107.0,1,123,0.0,123.0,123.0
213474.0,17,2,180,1,90,0.0,90.0,90.0,1,90,0.0,90.0,90.0
207939.0,6,3,426,2,280,0.0,214.0,140.0,1,146,0.0,146.0,146.0
11497245.0,17,4,1368,4,1368,3832415.0,342.0,342.0,0,0,0.0,0.0,0.0
234872.0,6,3,373,2,238,0.0,172.0,119.0,1,135,0.0,135.0,135.0
2049082.0,17,8,1640,4,312,682901.3333333334,78.0,78.0,4,1328,682862.6666666666,332.0,332.0
230337.0,6,3,426,2,280,0.0,214.0,140.0,1,146,0.0,146.0,146.0
237718.0,17,2,432,1,86,0.0,86.0,86.0,1,346,0.0,346.0,346.0
231435.0,6,12,1373,7,714,38572.5,298.0,102.0,5,659,57001.0,379.0,131.8
4262.0,17,2,618,1,72,0.0,72.0,72.0,1,546,0.0,546.0,546.0
120037447.0,17,29,13785,29,13785,4287051.678571428,501.0,475.3448275862069,0,0,0.0,0.0,0.0
14832.0,6,11,1132,6,556,2626.8,218.0,92.66666666666669,5,576,3239.25,304.0,115.2
106980.0,17,2,286,2,286,0.0,143.0,143.0,0,0,0.0,0.0,0.0
2654920.0,6,3,1777,2,951,0.0,885.0,475.5,1,826,0.0,826.0,826.0
90262316.0,6,12,1832,8,1016,12894616.57142857,188.0,127.0,4,816,30032534.666666668,204.0,204.0
209562.0,17,2,180,1,90,0.0,90.0,90.0,1,90,0.0,90.0,90.0
800.0,17,4,438,2,148,0.0,74.0,74.0,2,290,0.0,147.0,145.0
305639.0,6,6,412,4,272,101879.66666666669,74.0,68.0,2,140,0.0,74.0,70.0
119789833.0,6,26,1937,14,1043,9214602.538461538,95.0,74.5,12,894,10865033.363636363,95.0,74.5
41676.0,6,14,4740,7,653,5977.0,249.0,93.28571428571428,7,4087,5560.5,1514.0,583.8571428571429
18179.0,6,20,7606,11,978,1817.9,310.0,88.9090909090909,9,6628,1587.75,1514.0,736.4444444444445
1953.0,17,4,344,2,150,0.0,75.0,75.0,2,194,0.0,103.0,97.0
108107147.0,17,5,1005,5,1005,27026786.75,201.0,201.0,0,0,0.0,0.0,0.0
149366.0,6,3,373,2,238,0.0,172.0,119.0,1,135,0.0,135.0,135.0
206321.0,6,3,426,2,280,0.0,214.0,140.0,1,146,0.0,146.0,146.0
45967.0,6,12,1328,7,797,7661.166666666667,253.0,113.85714285714286,5,531,9091.0,259.0,106.2
93294535.0,6,25,1702,13,840,7774544.583333333,123.0,64.61538461538461,12,862,8137827.545454546,139.0,71.83333333333333
232174.0,6,3,337,2,214,0.0,160.0,107.0,1,123,0.0,123.0,123.0
10017.0,17,4,823,2,163,0.0,89.0,81.5,2,660,0.0,443.0,330.0
12989.0,17,2,180,1,90,0.0,90.0,90.0,1,90,0.0,90.0,90.0
90218321.0,6,16,1192,8,596,12853626.57142857,95.0,74.5,8,596,12858999.42857143,95.0,74.5
56113.0,6,10,2032,5,524,13553.25,252.0,104.8,5,1508,12301.5,1236.0,301.6
111105225.0,6,30,1990,15,1042,7920682.857142857,139.0,69.46666666666667,15,948,7920681.428571428,123.0,63.2
25478.0,6,14,4740,7,653,3865.3333333333335,249.0,93.28571428571428,7,4087,3457.333333333333,1514.0,583.8571428571429
315351.0,6,3,202,2,128,0.0,74.0,64.0,1,74,0.0,74.0,74.0
90041597.0,17,28,13364,28,13364,3334873.962962963,501.0,477.2857142857143,0,0,0.0,0.0,0.0
33713761.0,6,5,336,2,134,0.0,68.0,67.0,3,202,15569240.5,70.0,67.33333333333333
120112410.0,6,15,2164,9,1204,14994180.25,188.0,133.77777777777777,6,960,18018399.4,204.0,160.0
1547.0,17,2,180,1,90,0.0,90.0,90.0,1,90,0.0,90.0,90.0
39113.0,6,14,4740,7,653,4952.5,249.0,93.28571428571428,7,4087,6222.333333333333,1514.0,583.8571428571429
110115071.0,17,16,1212,8,606,15714445.42857143,174.0,75.75,8,606,15715075.57142857,174.0,75.75
2906264.0,6,222,173713,120,162679,24422.386554621848,1510.0,1355.6583333333333,102,11034,25826.06930693069,1510.0,108.17647058823528
2295.0,17,4,344,2,150,0.0,75.0,75.0,2,194,0.0,103.0,97.0
100876.0,17,2,762,2,762,0.0,381.0,381.0,0,0,0.0,0.0,0.0
47587.0,6,14,4740,7,653,7506.333333333333,249.0,93.28571428571428,7,4087,7628.833333333333,1514.0,583.8571428571429
216474.0,6,3,426,2,280,0.0,214.0,140.0,1,146,0.0,146.0,146.0
58688.0,6,14,4740,7,653,9036.333333333334,249.0,93.28571428571428,7,4087,9553.166666666666,1514.0,583.8571428571429
32832.0,6,14,4740,7,653,4108.0,249.0,93.28571428571428,7,4087,5293.5,1514.0,583.8571428571429
331120.0,6,6,412,4,272,110373.33333333331,74.0,68.0,2,140,0.0,74.0,70.0
868913.0,6,9,1196,6,725,173782.6,387.0,120.83333333333331,3,471,298243.0,331.0,157.0
111007.0,17,2,286,2,286,0.0,143.0,143.0,0,0,0.0,0.0,0.0
9124.0,17,2,539,1,86,0.0,86.0,86.0,1,453,0.0,453.0,453.0
120233466.0,6,21,1585,10,786,13331845.0,95.0,78.6,11,799,11997999.6,95.0,72.63636363636364
153496.0,17,2,180,1,90,0.0,90.0,90.0,1,90,0.0,90.0,90.0
219500.0,6,4,492,2,280,0.0,214.0,140.0,2,212,0.0,146.0,106.0
0.0,6,1,60,1,60,0.0,60.0,60.0,0,0,0.0,0.0,0.0
146090.0,6,3,337,2,214,0.0,160.0,107.0,1,123,0.0,123.0,123.0
111451181.0,17,14,864,7,432,18548707.0,174.0,61.71428571428572,7,432,18545059.33333333,174.0,61.71428571428572
20695.0,6,14,4740,7,653,2904.1666666666665,249.0,93.28571428571428,7,4087,3303.333333333333,1514.0,583.8571428571429
120196736.0,6,264,31154,132,9008,914763.3282442748,140.0,68.24242424242425,132,22146,911395.8778625954,284.0,167.77272727272728
205807.0,17,2,180,1,90,0.0,90.0,90.0,1,90,0.0,90.0,90.0
115264102.0,6,48,3168,24,1584,5011482.695652174,66.0,66.0,24,1584,4998066.260869565,66.0,66.0
148393.0,6,10,1066,5,490,34719.5,218.0,98.0,5,576,32945.5,304.0,115.2
3079203.0,6,4,270,2,134,0.0,68.0,67.0,2,136,0.0,70.0,68.0
108109047.0,17,5,955,5,955,27027261.75,191.0,191.0,0,0,0.0,0.0,0.0
44577.0,6,10,2032,5,524,10920.75,252.0,104.8,5,1508,10708.0,1236.0,301.6
34145.0,6,14,4740,7,653,5406.166666666667,249.0,93.28571428571428,7,4087,5416.333333333333,1514.0,583.8571428571429
46315.0,6,2,132,1,66,0.0,66.0,66.0,1,66,0.0,66.0,66.0
108114593.0,17,5,1005,5,1005,27028648.25,201.0,201.0,0,0,0.0,0.0,0.0
106809.0,17,2,286,2,286,0.0,143.0,143.0,0,0,0.0,0.0,0.0
212522.0,6,10,1221,6,636,42504.4,298.0,106.0,4,585,70025.66666666667,379.0,146.25
103954.0,17,2,286,2,286,0.0,143.0,143.0,0,0,0.0,0.0,0.0
120226441.0,6,230,25978,115,7886,1047386.4385964912,140.0,68.57391304347826,115,18092,1047499.1140350878,284.0,157.3217391304348
2806299.0,6,2,132,1,66,0.0,66.0,66.0,1,66,0.0,66.0,66.0
205838.0,17,3,1143,3,1143,102919.0,381.0,381.0,0,0,0.0,0.0,0.0
41966.0,6,14,4740,7,653,6818.833333333333,249.0,93.28571428571428,7,4087,6044.0,1514.0,583.8571428571429
257064.00000000003,6,10,1949,5,441,63972.0,169.0,88.2,5,1508,61919.0,1236.0,301.6
358307.0,6,4,508,2,238,0.0,172.0,119.0,2,270,0.0,135.0,135.0
20895.0,6,11,1133,6,602,4072.4,264.0,100.33333333333331,5,531,3555.25,259.0,106.2
54476.0,6,14,4740,7,653,8926.833333333334,249.0,93.28571428571428,7,4087,5964.333333333333,1514.0,583.8571428571429
207876.0,6,10,1221,6,636,41575.2,298.0,106.0,4,585,67912.66666666667,379.0,146.25
59513.0,6,12,1320,6,723,10549.2,253.0,120.5,6,597,11017.6,259.0,99.5
90010677.0,17,27,12943,27,12943,3461949.1153846155,501.0,479.3703703703704,0,0,0.0,0.0,0.0
2401.0,17,4,344,2,150,0.0,75.0,75.0,2,194,0.0,103.0,97.0
107557.0,17,2,286,2,286,0.0,143.0,143.0,0,0,0.0,0.0,0.0
90262142.0,6,13,2036,8,1016,12894591.714285716,188.0,127.0,5,1020,22523787.5,204.0,204.0
70039.0,17,2,620,1,75,0.0,75.0,75.0,1,545,0.0,545.0,545.0
366.0,17,2,267,1,83,0.0,83.0,83.0,1,184,0.0,184.0,184.0
111956627.0,6,34,2350,17,1225,6984509.75,139.0,72.05882352941177,17,1125,6984481.75,123.0,66.17647058823529
90021591.0,17,28,13364,28,13364,3334133.0,501.0,477.2857142857143,0,0,0.0,0.0,0.0
32369.000000000004,6,10,1065,5,534,6567.75,262.0,106.8,5,531,5820.5,259.0,106.2
4324.0,17,2,626,1,72,0.0,72.0,72.0,1,554,0.0,554.0,554.0
0.0,17,1,55,1,55,0.0,55.0,55.0,0,0,0.0,0.0,0.0
242747.0,6,3,337,2,214,0.0,160.0,107.0,1,123,0.0,123.0,123.0
5830199.0,6,5,336,2,134,0.0,68.0,67.0,3,202,1525604.5,70.0,67.33333333333333
55221.0,6,14,4740,7,653,9085.833333333334,249.0,93.28571428571428,7,4087,8811.0,1514.0,583.8571428571429
122530684.0,6,49,3234,25,1650,5105445.166666667,66.0,66.0,24,1584,5085886.782608695,66.0,66.0
322471.0,17,4,1400,4,1400,107490.33333333331,350.0,350.0,0,0,0.0,0.0,0.0
222191.0,17,2,414,1,88,0.0,88.0,88.0,1,326,0.0,326.0,326.0
90259141.0,6,12,1832,8,1016,12894163.0,188.0,127.0,4,816,30030989.0,204.0,204.0
26274654.0,17,3,1034,2,684,0.0,342.0,342.0,1,350,0.0,350.0,350.0
2829902.0,6,12,2172,7,664,471533.1666666667,252.0,94.85714285714286,5,1508,5581.0,1236.0,301.6
0.0,17,1,179,1,179,0.0,179.0,179.0,0,0,0.0,0.0,0.0
0.0,17,1,55,1,55,0.0,55.0,55.0,0,0,0.0,0.0,0.0
121392.0,6,3,337,2,214,0.0,160.0,107.0,1,123,0.0,123.0,123.0
198304.0,17,2,762,2,762,0.0,381.0,381.0,0,0,0.0,0.0,0.0
298.0,17,2,174,1,79,0.0,79.0,79.0,1,95,0.0,95.0,95.0
148022.0,17,2,180,1,90,0.0,90.0,90.0,1,90,0.0,90.0,90.0
915904.0,6,12,2710,7,743,152650.66666666666,339.0,106.14285714285714,5,1967,160056.75,1514.0,393.4
2799816.0,6,2,132,1,66,0.0,66.0,66.0,1,66,0.0,66.0,66.0
120129046.0,6,16,2490,10,1392,13347671.777777778,188.0,139.2,6,1098,18096773.0,204.0,183.0
33082.0,6,10,2032,5,524,7049.5,252.0,104.8,5,1508,7047.25,1236.0,301.6
235112.0,6,3,337,2,214,0.0,160.0,107.0,1,123,0.0,123.0,123.0
108107408.0,17,5,1005,5,1005,27026852.0,201.0,201.0,0,0,0.0,0.0,0.0
302781.0,6,6,412,4,272,100927.0,74.0,68.0,2,140,0.0,74.0,70.0
10528133.0,6,7,478,4,272,3462064.0,74.0,68.0,3,206,5193022.0,74.0,68.66666666666667
205807.0,17,2,180,1,90,0.0,90.0,90.0,1,90,0.0,90.0,90.0
2805128.0,6,2,132,1,66,0.0,66.0,66.0,1,66,0.0,66.0,66.0
355.0,17,2,248,1,84,0.0,84.0,84.0,1,164,0.0,164.0,164.0
209682.0,17,2,180,1,90,0.0,90.0,90.0,1,90,0.0,90.0,90.0
2022150.0,17,4,525,2,150,0.0,75.0,75.0,2,375,0.0,284.0,187.5
35952.0,6,14,4740,7,653,5865.166666666667,249.0,93.28571428571428,7,4087,5599.5,1514.0,583.8571428571429
153401.0,17,2,180,1,90,0.0,90.0,90.0,1,90,0.0,90.0,90.0
0.0,17,1,55,1,55,0.0,55.0,55.0,0,0,0.0,0.0,0.0
160231.0,17,2,180,1,90,0.0,90.0,90.0,1,90,0.0,90.0,90.0
9667.0,17,2,582,1,83,0.0,83.0,83.0,1,499,0.0,499.0,499.0
298604.0,6,6,412,4,272,99534.66666666669,74.0,68.0,2,140,0.0,74.0,70.0
188846.0,17,2,180,1,90,0.0,90.0,90.0,1,90,0.0,90.0,90.0
107000961.0,17,13,821,7,432,17833493.5,174.0,61.71428571428572,6,389,17200756.6,174.0,64.83333333333333
316.0,17,2,174,1,79,0.0,79.0,79.0,1,95,0.0,95.0,95.0
325.0,17,2,208,1,72,0.0,72.0,72.0,1,136,0.0,136.0,136.0
90030743.0,17,28,13364,28,13364,3334471.962962963,501.0,477.2857142857143,0,0,0.0,0.0,0.0
109686.0,17,2,286,2,286,0.0,143.0,143.0,0,0,0.0,0.0,0.0
108106867.0,17,5,1005,5,1005,27026716.75,201.0,201.0,0,0,0.0,0.0,0.0
135127412.0,17,6,1206,6,1206,27025482.4,201.0,201.0,0,0,0.0,0.0,0.0
33790.0,6,14,4740,7,653,5478.166666666667,249.0,93.28571428571428,7,4087,5483.833333333333,1514.0,583.8571428571429
297.0,17,2,156,1,78,0.0,78.0,78.0,1,78,0.0,78.0,78.0
18525.0,6,14,4740,7,653,2929.6666666666665,249.0,93.28571428571428,7,4087,2955.5,1514.0,583.8571428571429
95866542.0,17,14,1126,7,563,15833461.666666666,174.0,80.42857142857143,7,563,15834345.333333334,174.0,80.42857142857143
120010585.0,6,26,1978,14,1084,9230766.76923077,95.0,77.42857142857143,12,894,10882455.363636363,95.0,74.5
303441.0,6,6,412,4,272,101147.0,74.0,68.0,2,140,0.0,74.0,70.0
108108272.0,17,5,955,5,955,27027068.0,191.0,191.0,0,0,0.0,0.0,0.0
2122668.0,6,25,7610,13,2516,176889.0,1034.0,193.53846153846155,12,5094,165025.9090909091,1510.0,424.5
2792526.0,6,2,132,1,66,0.0,66.0,66.0,1,66,0.0,66.0,66.0
110979601.0,6,34,2482,17,1288,6922731.875,139.0,75.76470588235294,17,1194,6922727.1875,123.0,70.23529411764706
22964.0,6,14,4740,7,653,3716.8333333333335,249.0,93.28571428571428,7,4087,3686.8333333333335,1514.0,583.8571428571429
28896.0,6,10,2032,5,524,6889.25,252.0,104.8,5,1508,6875.5,1236.0,301.6
2252.0,17,4,344,2,150,0.0,75.0,75.0,2,194,0.0,103.0,97.0
5618309.0,6,4,270,2,134,0.0,68.0,67.0,2,136,0.0,70.0,68.0
0.0,6,1,66,1,66,0.0,66.0,66.0,0,0,0.0,0.0,0.0
120383173.0,6,231,26022,116,18210,1046810.2,284.0,156.98275862068965,115,7812,1037905.1315789474,140.0,67.9304347826087
205325.0,17,2,762,2,762,0.0,381.0,381.0,0,0,0.0,0.0,0.0
228141.0,17,2,180,1,90,0.0,90.0,90.0,1,90,0.0,90.0,90.0
43954.0,6,14,4740,7,653,7205.166666666667,249.0,93.28571428571428,7,4087,6740.5,1514.0,583.8571428571429
2143426.0,6,18,6803,10,1501,238158.44444444444,408.0,150.1,8,5302,244164.8571428572,1514.0,662.75
152.0,17,3,1143,3,1143,76.0,381.0,381.0,0,0,0.0,0.0,0.0
118683540.0,6,32,2220,16,1149,7897847.866666666,123.0,71.8125,16,1071,7897848.333333333,123.0,66.9375
121389.0,6,3,337,2,214,0.0,160.0,107.0,1,123,0.0,123.0,123.0
39386.0,6,10,2032,5,524,8231.5,252.0,104.8,5,1508,9222.0,1236.0,301.6
47866.0,6,14,4740,7,653,7066.833333333333,249.0,93.28571428571428,7,4087,7824.0,1514.0,583.8571428571429
98476999.0,6,31,2298,16,1212,6565133.266666667,123.0,75.75,15,1086,7018624.428571428,123.0,72.4
313726.0,6,3,202,2,128,0.0,74.0,64.0,1,74,0.0,74.0,74.0
108099235.0,17,5,1005,5,1005,27024808.75,201.0,201.0,0,0,0.0,0.0,0.0
2327.0,17,4,344,2,150,0.0,75.0,75.0,2,194,0.0,103.0,97.0
90023187.0,17,28,13364,28,13364,3334192.111111111,501.0,477.2857142857143,0,0,0.0,0.0,0.0
96879286.0,6,187,21048,94,6426,1041712.752688172,140.0,68.36170212765957,93,14622,1041857.6630434784,284.0,157.2258064516129
85761.0,6,11,2098,6,590,16968.0,252.0,98.33333333333331,5,1508,21098.75,1236.0,301.6
109177.0,6,2,132,1,66,0.0,66.0,66.0,1,66,0.0,66.0,66.0
103951.0,17,2,286,2,286,0.0,143.0,143.0,0,0,0.0,0.0,0.0
115702389.0,6,48,3168,24,1584,5030538.652173913,66.0,66.0,24,1584,5018557.173913044,66.0,66.0
228276.0,17,2,180,1,90,0.0,90.0,90.0,1,90,0.0,90.0,90.0
111506427.0,6,32,2236,16,1165,7419380.8,139.0,72.8125,16,1071,7419380.466666667,123.0,66.9375
38753.0,6,11,1133,6,602,7488.8,264.0,100.33333333333331,5,531,8000.0,259.0,106.2
2312.0,17,4,344,2,150,0.0,75.0,75.0,2,194,0.0,103.0,97.0
315908.0,17,4,1400,4,1400,105302.66666666669,350.0,350.0,0,0,0.0,0.0,0.0
90239185.0,6,19,1436,9,691,11248960.375,95.0,76.77777777777777,10,745,10002638.555555556,95.0,74.5
50493.0,6,14,4740,7,653,7358.666666666667,249.0,93.28571428571428,7,4087,7855.666666666667,1514.0,583.8571428571429
140745.0,6,2,132,1,66,0.0,66.0,66.0,1,66,0.0,66.0,66.0
104360.0,17,2,700,2,700,0.0,350.0,350.0,0,0,0.0,0.0,0.0
204853.0,17,4,6056,4,6056,68284.33333333333,1514.0,1514.0,0,0,0.0,0.0,0.0
120114228.0,6,15,2164,9,1204,14994304.125,188.0,133.77777777777777,6,960,18017852.4,204.0,160.0
460000.0,6,10,1221,6,636,92000.0,298.0,106.0,4,585,147606.33333333334,379.0,146.25
123303019.0,6,48,3168,24,1584,5154564.956521739,66.0,66.0,24,1584,5142077.565217392,66.0,66.0
305340.0,6,6,412,4,272,101780.0,74.0,68.0,2,140,0.0,74.0,70.0
90093615.0,6,11,1644,4,816,30030417.33333333,204.0,204.0,7,828,15015327.0,188.0,118.28571428571428
2316.0,17,4,344,2,150,0.0,75.0,75.0,2,194,0.0,103.0,97.0
15361.0,6,12,1393,6,796,2934.4,271.0,132.66666666666666,6,597,2827.2,259.0,99.5
93351888.0,17,14,1126,7,563,15501375.833333334,174.0,80.42857142857143,7,563,15500140.5,174.0,80.42857142857143
26445.0,6,10,2032,5,524,5833.0,252.0,104.8,5,1508,6029.0,1236.0,301.6
2186620.0,6,19,6869,11,1567,218662.0,408.0,142.45454545454547,8,5302,251681.0,1514.0,662.75
2448.0,17,4,344,2,150,0.0,75.0,75.0,2,194,0.0,103.0,97.0
121328922.0,6,220,24772,110,7482,1096074.6330275228,140.0,68.01818181818182,110,17290,1096049.9724770642,284.0,157.1818181818182
2302.0,17,4,344,2,150,0.0,75.0,75.0,2,194,0.0,103.0,97.0
113251982.0,6,48,3168,24,1584,4920888.304347826,66.0,66.0,24,1584,4923461.130434782,66.0,66.0
113678.0,17,4,1400,4,1400,37892.66666666666,350.0,350.0,0,0,0.0,0.0,0.0
101092.0,17,2,762,2,762,0.0,381.0,381.0,0,0,0.0,0.0,0.0
209521.0,6,3,426,2,280,0.0,214.0,140.0,1,146,0.0,146.0,146.0
216318.0,17,2,180,1,90,0.0,90.0,90.0,1,90,0.0,90.0,90.0
90514103.0,6,15,2444,8,1016,12930586.142857144,188.0,127.0,7,1428,15058752.166666666,204.0,204.0
228342.0,17,2,180,1,90,0.0,90.0,90.0,1,90,0.0,90.0,90.0
1976990.0,6,23,6509,12,1529,179726.36363636365,357.0,127.41666666666669,11,4980,166961.0,1510.0,452.7272727272728
61918.0,6,11,2098,6,590,12172.4,252.0,98.33333333333331,5,1508,14905.5,1236.0,301.6
315.0,17,2,174,1,79,0.0,79.0,79.0,1,95,0.0,95.0,95.0
90299655.0,6,16,1192,8,596,12893610.285714284,95.0,74.5,8,596,12898418.142857144,95.0,74.5
15803.999999999998,6,14,4740,7,653,2393.0,249.0,93.28571428571428,7,4087,2333.6666666666665,1514.0,583.8571428571429
120037290.0,17,29,13785,29,13785,4287046.071428572,501.0,475.3448275862069,0,0,0.0,0.0,0.0
316978.0,17,4,1400,4,1400,105659.33333333331,350.0,350.0,0,0,0.0,0.0,0.0
124647474.0,17,16,1343,9,780,15580934.25,174.0,86.66666666666667,7,563,19663499.166666668,174.0,80.42857142857143
16070.999999999998,6,14,4740,7,653,2570.333333333333,249.0,93.28571428571428,7,4087,2464.0,1514.0,583.8571428571429
38987.0,6,10,2032,5,524,9407.75,252.0,104.8,5,1508,8564.75,1236.0,301.6
96353.0,17,2,762,2,762,0.0,381.0,381.0,0,0,0.0,0.0,0.0
105596.0,17,2,286,2,286,0.0,143.0,143.0,0,0,0.0,0.0,0.0
386635.0,6,3,204,1,68,0.0,68.0,68.0,2,136,0.0,70.0,68.0
0.0,17,1,44,1,44,0.0,44.0,44.0,0,0,0.0,0.0,0.0
42837.0,6,14,4740,7,653,7008.833333333333,249.0,93.28571428571428,7,4087,6191.0,1514.0,583.8571428571429
148387.0,17,2,414,1,88,0.0,88.0,88.0,1,326,0.0,326.0,326.0
135134709.0,17,6,1206,6,1206,27026941.8,201.0,201.0,0,0,0.0,0.0,0.0
298059.0,6,6,412,4,272,99353.0,74.0,68.0,2,140,0.0,74.0,70.0
209804.0,17,2,180,1,90,0.0,90.0,90.0,1,90,0.0,90.0,90.0
97809.0,6,14,4740,7,653,15221.166666666666,249.0,93.28571428571428,7,4087,12469.166666666666,1514.0,583.8571428571429
340.0,17,2,156,1,78,0.0,78.0,78.0,1,78,0.0,78.0,78.0
154679.0,6,10,1066,5,490,38187.5,218.0,98.0,5,576,38471.5,304.0,115.2
1330.0,17,6,1230,3,234,281.5,78.0,78.0,3,996,349.5,332.0,332.0
252391.0,6,3,337,2,214,0.0,160.0,107.0,1,123,0.0,123.0,123.0
855503.0,6,5,1742,3,921,427751.5,785.0,307.0,2,821,0.0,753.0,410.5
120000062.0,6,21,1626,12,935,10909096.545454543,95.0,77.91666666666667,9,691,11342624.25,95.0,76.77777777777777
1986.0,17,4,344,2,150,0.0,75.0,75.0,2,194,0.0,103.0,97.0
14913.0,17,2,180,1,90,0.0,90.0,90.0,1,90,0.0,90.0,90.0
311723.0,17,4,1400,4,1400,103907.66666666669,350.0,350.0,0,0,0.0,0.0,0.0
120151309.0,6,340,39194,170,27752,709704.1952662722,464.0,163.2470588235294,170,11442,709704.1715976332,140.0,67.30588235294118
1439780.0,17,5,961,3,234,719706.5,78.0,78.0,2,727,0.0,395.0,363.5
2428.0,17,2,762,2,762,0.0,381.0,381.0,0,0,0.0,0.0,0.0
114439604.0,6,48,3168,24,1584,4975634.956521739,66.0,66.0,24,1584,4963652.260869565,66.0,66.0
48947121.0,6,7,2047,5,1153,12236780.25,885.0,230.6,2,894,0.0,826.0,447.0
103036.0,17,2,286,2,286,0.0,143.0,143.0,0,0,0.0,0.0,0.0
309321.0,6,3,202,2,128,0.0,74.0,64.0,1,74,0.0,74.0,74.0
130916277.0,17,14,864,7,432,18500168.5,174.0,61.71428571428572,7,432,18500818.166666668,174.0,61.71428571428572
160032.0,17,2,180,1,90,0.0,90.0,90.0,1,90,0.0,90.0,90.0
90047025.0,17,28,13364,28,13364,3335075.0,501.0,477.2857142857143,0,0,0.0,0.0,0.0
104204.0,17,2,700,2,700,0.0,350.0,350.0,0,0,0.0,0.0,0.0
121812.0,6,3,373,2,238,0.0,172.0,119.0,1,135,0.0,135.0,135.0
242904.0,6,3,337,2,214,0.0,160.0,107.0,1,123,0.0,123.0,123.0
3176881.0,6,18,1495,9,921,358372.0,315.0,102.33333333333331,9,574,358342.25,78.0,63.77777777777778
10685025.0,6,6,412,3,206,5274130.0,74.0,68.66666666666667,3,206,5274024.5,74.0,68.66666666666667
40608.0,6,14,4740,7,653,6474.0,249.0,93.28571428571428,7,4087,6298.833333333333,1514.0,583.8571428571429
233195.0,6,3,337,2,214,0.0,160.0,107.0,1,123,0.0,123.0,123.0
114820450.0,6,47,3102,24,1584,4992182.434782608,66.0,66.0,23,1518,5160002.909090909,66.0,66.0
232205.0,6,3,426,2,280,0.0,214.0,140.0,1,146,0.0,146.0,146.0
313587.0,6,6,412,4,272,104529.0,74.0,68.0,2,140,0.0,74.0,70.0
44855.0,6,10,2032,5,524,10192.25,252.0,104.8,5,1508,10738.75,1236.0,301.6
13934.0,17,4,344,2,150,0.0,75.0,75.0,2,194,0.0,103.0,97.0
108104147.0,17,5,955,5,955,27026036.75,191.0,191.0,0,0,0.0,0.0,0.0
296113.0,17,2,363,1,79,0.0,79.0,79.0,1,284,0.0,284.0,284.0
127001114.0,17,15,907,8,475,18143016.285714287,174.0,59.375,7,432,17834892.833333332,174.0,61.71428571428572
121423.0,6,3,337,2,214,0.0,160.0,107.0,1,123,0.0,123.0,123.0
2274.0,17,4,344,2,150,0.0,75.0,75.0,2,194,0.0,103.0,97.0
322.0,17,2,208,1,72,0.0,72.0,72.0,1,136,0.0,136.0,136.0
94981701.0,6,217,24828,109,7416,879460.1944444445,140.0,68.03669724770643,108,17412,878105.7102803738,284.0,161.22222222222223
103600.0,17,2,286,2,286,0.0,143.0,143.0,0,0,0.0,0.0,0.0
4479.0,17,2,618,1,72,0.0,72.0,72.0,1,546,0.0,546.0,546.0
337.0,17,2,208,1,72,0.0,72.0,72.0,1,136,0.0,136.0,136.0
115739347.0,6,38,2848,20,1531,6080173.315789473,139.0,76.55,18,1317,6795499.764705882,123.0,73.16666666666667
119604039.0,6,382,47058,191,34156,628414.947368421,336.0,178.82722513089004,191,12902,628415.1842105263,140.0,67.54973821989529
39649.0,6,10,2032,5,524,9509.25,252.0,104.8,5,1508,8143.75,1236.0,301.6
34150.0,6,10,2032,5,524,7766.5,252.0,104.8,5,1508,7409.25,1236.0,301.6
108109095.0,17,5,955,5,955,27027273.75,191.0,191.0,0,0,0.0,0.0,0.0
10432063.0,6,6,412,3,206,5147802.5,74.0,68.66666666666667,3,206,5147700.5,74.0,68.66666666666667
259268.0,6,3,337,2,214,0.0,160.0,107.0,1,123,0.0,123.0,123.0
292552.0,17,4,704,2,148,0.0,74.0,74.0,2,556,0.0,280.0,278.0
90269026.0,6,13,2036,8,1016,12895575.142857144,188.0,127.0,5,1020,22526165.0,204.0,204.0
216630.0,17,2,180,1,90,0.0,90.0,90.0,1,90,0.0,90.0,90.0
520.0,17,2,508,2,508,0.0,257.0,254.0,0,0,0.0,0.0,0.0
23052.0,6,14,4740,7,653,3429.0,249.0,93.28571428571428,7,4087,3236.1666666666665,1514.0,583.8571428571429
102446033.0,17,14,864,7,432,17001103.166666668,174.0,61.71428571428572,7,432,17000191.0,174.0,61.71428571428572
2596036.0,6,2,132,1,66,0.0,66.0,66.0,1,66,0.0,66.0,66.0
10509914.0,6,7,478,4,272,3457888.0,74.0,68.0,3,206,5186740.5,74.0,68.66666666666667
2286980.0,6,49,23728,25,19797,95290.83333333331,1514.0,791.88,24,3931,90130.21739130437,1514.0,163.79166666666666
312266.0,6,3,202,2,128,0.0,74.0,64.0,1,74,0.0,74.0,74.0
314738.0,17,4,1400,4,1400,104912.66666666669,350.0,350.0,0,0,0.0,0.0,0.0
197568.0,17,2,180,1,90,0.0,90.0,90.0,1,90,0.0,90.0,90.0
10479989.0,6,7,478,4,272,3448086.333333333,74.0,68.0,3,206,5171967.5,74.0,68.66666666666667
206338.0,6,3,426,2,280,0.0,214.0,140.0,1,146,0.0,146.0,146.0
153637.0,17,2,180,1,90,0.0,90.0,90.0,1,90,0.0,90.0,90.0
90013484.0,17,28,13364,28,13364,3333832.7407407407,501.0,477.2857142857143,0,0,0.0,0.0,0.0
102990.0,17,2,286,2,286,0.0,143.0,143.0,0,0,0.0,0.0,0.0
135128278.0,17,6,1146,6,1146,27025655.6,191.0,191.0,0,0,0.0,0.0,0.0
2779123.0,6,2,132,1,66,0.0,66.0,66.0,1,66,0.0,66.0,66.0
462351.0,17,2,363,1,79,0.0,79.0,79.0,1,284,0.0,284.0,284.0
205835.0,17,2,180,1,90,0.0,90.0,90.0,1,90,0.0,90.0,90.0
118000972.0,17,15,1169,8,606,16857281.714285713,174.0,75.75,7,563,16334069.5,174.0,80.42857142857143
90257716.0,6,12,1832,8,1016,12893959.42857143,188.0,127.0,4,816,30031010.666666668,204.0,204.0
205242.0,17,2,762,2,762,0.0,381.0,381.0,0,0,0.0,0.0,0.0
2066.0,17,4,344,2,150,0.0,75.0,75.0,2,194,0.0,103.0,97.0
108106647.0,17,5,1005,5,1005,27026661.75,201.0,201.0,0,0,0.0,0.0,0.0
38309.0,6,10,2032,5,524,8467.5,252.0,104.8,5,1508,8752.5,1236.0,301.6
40869.0,6,14,4740,7,653,6032.333333333333,249.0,93.28571428571428,7,4087,6613.833333333333,1514.0,583.8571428571429
1313689.0,6,4,264,2,132,0.0,66.0,66.0,2,132,0.0,66.0,66.0
197205.0,17,2,180,1,90,0.0,90.0,90.0,1,90,0.0,90.0,90.0
90522328.0,6,14,2240,8,1016,12931761.142857144,188.0,127.0,6,1224,18071733.0,204.0,204.0
339.0,17,2,166,1,75,0.0,75.0,75.0,1,91,0.0,91.0,91.0
217783.0,6,3,426,2,280,0.0,214.0,140.0,1,146,0.0,146.0,146.0
122975550.0,6,48,3168,24,1584,5192646.347826087,66.0,66.0,24,1584,5074454.304347826,66.0,66.0
248126.0,6,3,337,2,214,0.0,160.0,107.0,1,123,0.0,123.0,123.0
495.0,17,2,508,2,508,0.0,257.0,254.0,0,0,0.0,0.0,0.0
3872050.0,6,5,336,2,134,0.0,68.0,67.0,3,202,1526055.0,70.0,67.33333333333333
107639.0,17,2,286,2,286,0.0,143.0,143.0,0,0,0.0,0.0,0.0
2125434.0,6,25,7610,13,2516,177119.5,1034.0,193.53846153846155,12,5094,165077.36363636365,1510.0,424.5
5721500.0,6,5,336,3,202,1473483.0,70.0,67.33333333333333,2,134,0.0,68.0,67.0
94986137.0,6,163,18490,82,5634,1172668.3580246917,140.0,68.70731707317073,81,12856,1174612.6625,374.0,158.71604938271605
92437743.0,6,37,2442,19,1254,5135430.166666667,66.0,66.0,18,1188,5287168.05882353,66.0,66.0
49471.0,6,10,2032,5,524,11094.25,252.0,104.8,5,1508,12084.5,1236.0,301.6
90045774.0,17,28,13364,28,13364,3335028.6666666665,501.0,477.2857142857143,0,0,0.0,0.0,0.0
318.0,17,2,174,1,79,0.0,79.0,79.0,1,95,0.0,95.0,95.0
108109943.0,17,5,955,5,955,27027485.75,191.0,191.0,0,0,0.0,0.0,0.0
100243659.0,17,12,778,6,389,20002560.0,174.0,64.83333333333333,6,389,20016536.2,174.0,64.83333333333333
3348428.0,6,154,124904,89,116313,38050.31818181818,1510.0,1306.887640449438,65,8591,47379.234375,1510.0,132.16923076923078
90212099.0,6,19,1436,9,691,11246357.375,95.0,76.77777777777777,10,745,10000790.555555556,95.0,74.5
220049.0,17,2,180,1,90,0.0,90.0,90.0,1,90,0.0,90.0,90.0
3006318.0,6,12,2172,7,664,501053.0,252.0,94.85714285714286,5,1508,2134.0,1236.0,301.6
143904.0,17,2,180,1,90,0.0,90.0,90.0,1,90,0.0,90.0,90.0
122432103.0,6,47,3102,23,1518,5135439.5,66.0,66.0,24,1584,5311297.217391305,66.0,66.0
372743.0,6,12,1373,7,714,62123.833333333336,298.0,102.0,5,659,92177.75,379.0,131.8
38365.0,6,10,2032,5,524,8100.5,252.0,104.8,5,1508,8747.75,1236.0,301.6
117966218.0,6,29,1914,15,948,8426158.42857143,123.0,63.2,14,966,8290450.230769231,123.0,69.0
70881.0,6,13,1479,7,882,11642.666666666666,291.0,126.0,6,597,13635.4,259.0,99.5
2312806.0,6,25,7573,14,3735,177908.15384615384,1514.0,266.7857142857143,11,3838,205202.9,1514.0,348.90909090909093
756.0,17,4,438,2,148,0.0,74.0,74.0,2,290,0.0,147.0,145.0
233175.0,6,10,1221,6,636,46635.0,298.0,106.0,4,585,76438.66666666667,379.0,146.25
120101442.0,6,222,24962,111,7622,1084460.709090909,140.0,68.66666666666667,111,17340,1084439.5727272728,284.0,156.21621621621622
38566.0,6,10,2032,5,524,8832.0,252.0,104.8,5,1508,8861.0,1236.0,301.6
1839.0,17,2,932,1,590,0.0,590.0,590.0,1,342,0.0,342.0,342.0
13113.0,6,10,2032,5,524,3040.5,252.0,104.8,5,1508,2025.5,1236.0,301.6
239326.0,17,2,180,1,90,0.0,90.0,90.0,1,90,0.0,90.0,90.0
38384.0,6,14,4740,7,653,5108.833333333333,249.0,93.28571428571428,7,4087,6222.166666666667,1514.0,583.8571428571429
1050584.0,6,11,1134,6,558,210116.8,220.0,93.0,5,576,260097.25,304.0,115.2
14630689.0,6,20,1646,10,1014,1592734.3333333333,315.0,101.4,10,632,1592704.4444444445,78.0,63.2
859.0,17,4,820,2,156,0.0,78.0,78.0,2,664,0.0,332.0,332.0
2023957.0,17,4,525,2,150,0.0,75.0,75.0,2,375,0.0,284.0,187.5
120007787.0,6,16,1192,8,596,17143969.57142857,95.0,74.5,8,596,17108042.14285714,95.0,74.5
0.0,17,1,381,1,381,0.0,381.0,381.0,0,0,0.0,0.0,0.0
233341.0,6,3,373,2,238,0.0,172.0,119.0,1,135,0.0,135.0,135.0
107374.0,17,2,700,2,700,0.0,350.0,350.0,0,0,0.0,0.0,0.0
2321.0,17,4,344,2,150,0.0,75.0,75.0,2,194,0.0,103.0,97.0
52524.0,6,14,4740,7,653,8569.166666666666,249.0,93.28571428571428,7,4087,8589.0,1514.0,583.8571428571429
203576.0,17,2,180,1,90,0.0,90.0,90.0,1,90,0.0,90.0,90.0
153493.0,17,2,180,1,90,0.0,90.0,90.0,1,90,0.0,90.0,90.0
11938.0,6,10,2032,5,524,2754.75,252.0,104.8,5,1508,1784.75,1236.0,301.6
3170743.0,6,18,1495,9,921,358117.5,315.0,102.33333333333331,9,574,358084.0,78.0,63.77777777777778
216613.0,6,3,426,2,280,0.0,214.0,140.0,1,146,0.0,146.0,146.0
91608085.0,17,15,5130,15,5130,6543434.642857143,342.0,342.0,0,0,0.0,0.0,0.0
225553.0,17,2,180,1,90,0.0,90.0,90.0,1,90,0.0,90.0,90.0
205828.0,17,2,180,1,90,0.0,90.0,90.0,1,90,0.0,90.0,90.0
94956871.0,6,40,2640,20,1320,4997730.052631579,66.0,66.0,20,1320,4986352.47368421,66.0,66.0
45634.0,6,12,1447,6,816,8830.8,291.0,136.0,6,631,8048.8,293.0,105.16666666666669
120063730.0,6,32,2226,17,1209,7503983.125,123.0,71.11764705882354,15,1017,7848201.642857143,123.0,67.8
7442.0,17,2,582,1,83,0.0,83.0,83.0,1,499,0.0,499.0,499.0
407.0,17,2,208,1,72,0.0,72.0,72.0,1,136,0.0,136.0,136.0
171588.0,17,2,180,1,90,0.0,90.0,90.0,1,90,0.0,90.0,90.0
318135.0,17,4,1400,4,1400,106045.0,350.0,350.0,0,0,0.0,0.0,0.0
9454.0,17,2,498,1,80,0.0,80.0,80.0,1,418,0.0,418.0,418.0
56304.0,6,10,2032,5,524,13559.5,252.0,104.8,5,1508,11957.0,1236.0,301.6
206578.0,17,2,180,1,90,0.0,90.0,90.0,1,90,0.0,90.0,90.0
97780183.0,6,178,20094,89,6096,1101806.75,140.0,68.49438202247191,89,13998,1102154.0340909092,284.0,157.2808988764045
42884.0,6,10,2032,5,524,10351.75,252.0,104.8,5,1508,10028.75,1236.0,301.6
16268.000000000002,6,14,4740,7,653,2591.6666666666665,249.0,93.28571428571428,7,4087,2578.0,1514.0,583.8571428571429
10470589.0,6,7,478,4,272,3444572.6666666665,74.0,68.0,3,206,5166795.5,74.0,68.66666666666667
120378456.0,6,225,25484,113,17870,1074807.642857143,284.0,158.141592920354,112,7614,1076272.4234234234,140.0,67.98214285714286
253466.00000000003,17,4,6056,4,6056,84488.66666666666,1514.0,1514.0,0,0,0.0,0.0,0.0
0.0,6,1,172,1,172,0.0,172.0,172.0,0,0,0.0,0.0,0.0
119610931.0,6,214,24074,107,16716,1126375.141509434,284.0,156.22429906542055,107,7358,1126366.7264150945,140.0,68.76635514018692
865714.0,6,9,1270,6,799,173142.8,461.0,133.16666666666666,3,471,294984.0,331.0,157.0
90038919.0,17,27,12943,27,12943,3463035.346153846,501.0,479.3703703703704,0,0,0.0,0.0,0.0
1302546.0,6,4,264,2,132,0.0,66.0,66.0,2,132,0.0,66.0,66.0
24643.0,6,10,2032,5,524,5939.25,252.0,104.8,5,1508,5877.75,1236.0,301.6
14504.0,6,14,4740,7,653,2246.1666666666665,249.0,93.28571428571428,7,4087,2276.5,1514.0,583.8571428571429
193135.0,17,2,180,1,90,0.0,90.0,90.0,1,90,0.0,90.0,90.0
34173.0,6,14,4740,7,653,5241.0,249.0,93.28571428571428,7,4087,5472.833333333333,1514.0,583.8571428571429
49238.0,6,14,4740,7,653,8090.833333333333,249.0,93.28571428571428,7,4087,7529.5,1514.0,583.8571428571429
153471.0,17,2,180,1,90,0.0,90.0,90.0,1,90,0.0,90.0,90.0
105016358.0,17,15,5130,15,5130,7501168.428571428,342.0,342.0,0,0,0.0,0.0,0.0
162208.0,17,2,180,1,90,0.0,90.0,90.0,1,90,0.0,90.0,90.0
92770.0,6,14,4740,7,653,15334.833333333334,249.0,93.28571428571428,7,4087,15143.833333333334,1514.0,583.8571428571429
103396.0,17,2,286,2,286,0.0,143.0,143.0,0,0,0.0,0.0,0.0
323197.0,17,4,1400,4,1400,107732.33333333331,350.0,350.0,0,0,0.0,0.0,0.0
7000.0,17,2,582,1,83,0.0,83.0,83.0,1,499,0.0,499.0,499.0
90283160.0,6,16,1192,8,596,12891299.285714284,95.0,74.5,8,596,12896481.714285716,95.0,74.5
9006706.0,17,4,300,4,300,3002235.333333333,75.0,75.0,0,0,0.0,0.0,0.0
207253.0,6,3,426,2,280,0.0,214.0,140.0,1,146,0.0,146.0,146.0
120972.0,6,12,1447,6,816,23479.4,291.0,136.0,6,631,23056.4,293.0,105.16666666666669
99284.0,17,2,762,2,762,0.0,381.0,381.0,0,0,0.0,0.0,0.0
108101601.0,17,5,1005,5,1005,27025400.25,201.0,201.0,0,0,0.0,0.0,0.0
202992.0,17,4,1524,4,1524,67664.0,381.0,381.0,0,0,0.0,0.0,0.0
1997215.0,6,18,6803,10,1501,221912.7777777777,408.0,150.1,8,5302,223543.8571428572,1514.0,662.75
2593977.0,6,2,132,1,66,0.0,66.0,66.0,1,66,0.0,66.0,66.0
46587422.0,6,8,2113,3,960,21943712.5,826.0,320.0,5,1153,10950646.25,885.0,230.6
302348.0,6,6,412,4,272,100782.66666666669,74.0,68.0,2,140,0.0,74.0,70.0
105654773.0,6,32,2220,16,1149,7043651.533333333,123.0,71.8125,16,1071,7029232.466666667,123.0,66.9375
103053.0,17,2,286,2,286,0.0,143.0,143.0,0,0,0.0,0.0,0.0
93165008.0,17,14,1388,7,694,15500878.666666666,174.0,99.14285714285714,7,694,15500871.333333334,174.0,99.14285714285714
37904.0,6,14,4740,7,653,6192.666666666667,249.0,93.28571428571428,7,4087,6118.166666666667,1514.0,583.8571428571429
323723.0,17,4,1400,4,1400,107907.66666666669,350.0,350.0,0,0,0.0,0.0,0.0
120174162.0,6,240,27734,120,8142,1003038.0672268908,140.0,67.85,120,19592,1003379.3025210084,284.0,163.26666666666668
1321457.0,6,4,264,2,132,0.0,66.0,66.0,2,132,0.0,66.0,66.0
14457.0,6,14,4740,7,653,2299.1666666666665,249.0,93.28571428571428,7,4087,2117.333333333333,1514.0,583.8571428571429
119542861.0,17,35,16705,35,16705,3515966.5,501.0,477.2857142857143,0,0,0.0,0.0,0.0
35009.0,6,13,1386,7,789,5730.166666666667,253.0,112.71428571428572,6,597,6559.2,259.0,99.5
2641132.0,6,32,10926,18,3951,155360.70588235295,1514.0,219.5,14,6975,183925.7692307692,1514.0,498.2142857142857
146124.0,6,3,337,2,214,0.0,160.0,107.0,1,123,0.0,123.0,123.0
372.0,17,2,267,1,83,0.0,83.0,83.0,1,184,0.0,184.0,184.0
135124731.0,17,6,1206,6,1206,27024946.2,201.0,201.0,0,0,0.0,0.0,0.0
135122401.0,17,6,1146,6,1146,27024480.2,191.0,191.0,0,0,0.0,0.0,0.0
90228249.0,6,19,1436,9,691,11247226.625,95.0,76.77777777777777,10,745,10001425.888888888,95.0,74.5
233743.0,6,3,337,2,214,0.0,160.0,107.0,1,123,0.0,123.0,123.0
108104586.0,17,5,955,5,955,27026146.5,191.0,191.0,0,0,0.0,0.0,0.0
307067.0,6,6,412,4,272,102355.66666666669,74.0,68.0,2,140,0.0,74.0,70.0
162375.0,17,2,180,1,90,0.0,90.0,90.0,1,90,0.0,90.0,90.0
322572.0,17,4,1400,4,1400,107524.0,350.0,350.0,0,0,0.0,0.0,0.0
207162.0,6,3,426,2,280,0.0,214.0,140.0,1,146,0.0,146.0,146.0
108137.0,17,4,1400,4,1400,36045.66666666666,350.0,350.0,0,0,0.0,0.0,0.0
2801617.0,6,2,132,1,66,0.0,66.0,66.0,1,66,0.0,66.0,66.0
1093771.0,6,13,1394,7,797,182295.16666666663,253.0,113.85714285714286,6,597,217710.0,259.0,99.5
123001134.0,17,15,907,8,475,17571590.57142857,174.0,59.375,7,432,17167789.833333332,174.0,61.71428571428572
38722719.0,6,12,816,6,423,7701386.8,123.0,70.5,6,393,7701387.4,123.0,65.5
761.0,17,2,684,2,684,0.0,342.0,342.0,0,0,0.0,0.0,0.0
90066405.0,17,28,13364,28,13364,3335792.777777778,501.0,477.2857142857143,0,0,0.0,0.0,0.0
135123756.0,17,6,1206,6,1206,27024751.2,201.0,201.0,0,0,0.0,0.0,0.0
16825.0,17,2,180,1,90,0.0,90.0,90.0,1,90,0.0,90.0,90.0
1869.0,17,4,344,2,150,0.0,75.0,75.0,2,194,0.0,103.0,97.0
2797766.0,6,2,132,1,66,0.0,66.0,66.0,1,66,0.0,66.0,66.0
360039.0,6,6,412,4,272,120013.0,74.0,68.0,2,140,0.0,74.0,70.0
2348.0,17,4,344,2,150,0.0,75.0,75.0,2,194,0.0,103.0,97.0
2323563.0,17,2,876,2,876,0.0,438.0,438.0,0,0,0.0,0.0,0.0
90203145.0,6,17,1287,8,596,12852477.57142857,95.0,74.5,9,691,11249816.125,95.0,76.77777777777777
108095876.0,17,5,1005,5,1005,27023969.0,201.0,201.0,0,0,0.0,0.0,0.0
13674453.0,6,18,1493,9,919,1671586.375,315.0,102.11111111111111,9,574,1671550.625,78.0,63.77777777777778
2803484.0,6,2,132,1,66,0.0,66.0,66.0,1,66,0.0,66.0,66.0
232314.0,6,3,337,2,214,0.0,160.0,107.0,1,123,0.0,123.0,123.0
232865.0,6,3,337,2,214,0.0,160.0,107.0,1,123,0.0,123.0,123.0
347.0,17,2,214,1,75,0.0,75.0,75.0,1,139,0.0,139.0,139.0
317017.0,6,5,367,3,235,158508.5,103.0,78.33333333333333,2,132,0.0,66.0,66.0
111350738.0,6,37,2926,20,1594,5849808.894736842,139.0,79.7,17,1332,6945375.9375,123.0,78.3529411764706
5679.0,17,4,823,2,163,0.0,89.0,81.5,2,660,0.0,443.0,330.0
246292.0,6,3,373,2,238,0.0,172.0,119.0,1,135,0.0,135.0,135.0
1683907.0,17,18,1260,18,1260,99053.35294117648,70.0,70.0,0,0,0.0,0.0,0.0
120257482.0,6,237,26816,119,18806,1019131.2033898304,284.0,158.03361344537817,118,8010,1019951.4102564104,140.0,67.88135593220339
110502730.0,17,16,1212,8,606,15714433.0,174.0,75.75,8,606,15715115.857142856,174.0,75.75
120060913.0,17,29,13785,29,13785,4287889.75,501.0,475.3448275862069,0,0,0.0,0.0,0.0
216502.0,17,2,180,1,90,0.0,90.0,90.0,1,90,0.0,90.0,90.0
121443041.0,6,36,2665,19,1471,6746835.611111111,139.0,77.42105263157895,17,1194,7096084.375,123.0,70.23529411764706
120003564.0,6,23,2057,11,1245,12000356.4,229.0,113.1818181818182,12,812,10886515.363636363,95.0,67.66666666666667
90256486.0,6,12,1832,8,1016,12893783.714285716,188.0,127.0,4,816,30031468.0,204.0,204.0
22197.0,6,14,4740,7,653,3230.333333333333,249.0,93.28571428571428,7,4087,3523.333333333333,1514.0,583.8571428571429
108960.0,17,2,286,2,286,0.0,143.0,143.0,0,0,0.0,0.0,0.0
20117.0,6,14,4740,7,653,3086.0,249.0,93.28571428571428,7,4087,3179.1666666666665,1514.0,583.8571428571429
251389.0,6,3,337,2,214,0.0,160.0,107.0,1,123,0.0,123.0,123.0
160367.0,6,2,128,1,74,0.0,74.0,74.0,1,54,0.0,54.0,54.0
108106654.0,17,5,1005,5,1005,27026663.5,201.0,201.0,0,0,0.0,0.0,0.0
117809592.0,6,48,3168,24,1584,5122156.173913044,66.0,66.0,24,1584,5110180.826086956,66.0,66.0
217356.0,6,10,1221,6,636,43471.2,298.0,106.0,4,585,70468.0,379.0,146.25
21728.0,17,2,582,1,83,0.0,83.0,83.0,1,499,0.0,499.0,499.0
54633.0,6,10,2032,5,524,12793.75,252.0,104.8,5,1508,11163.0,1236.0,301.6
2947615.0,6,3,1604,2,851,0.0,785.0,425.5,1,753,0.0,753.0,753.0
39995.0,6,14,4740,7,653,6540.666666666667,249.0,93.28571428571428,7,4087,5483.0,1514.0,583.8571428571429
238507.0,6,3,337,2,214,0.0,160.0,107.0,1,123,0.0,123.0,123.0
51697085.0,17,4643,1993801,2876,1854737,17980.54504347826,1434.0,644.9015994436718,1767,139064,29271.12514156285,351.0,78.70062252405206
108107457.0,17,5,1005,5,1005,27026864.25,201.0,201.0,0,0,0.0,0.0,0.0
146315.0,6,3,337,2,214,0.0,160.0,107.0,1,123,0.0,123.0,123.0
3755.0,17,4,344,2,150,0.0,75.0,75.0,2,194,0.0,103.0,97.0
90306523.0,6,17,1287,9,691,11280118.25,95.0,76.77777777777777,8,596,12898279.857142856,95.0,74.5
108105773.0,17,5,1005,5,1005,27026443.25,201.0,201.0,0,0,0.0,0.0,0.0
23755.0,6,14,4740,7,653,3584.1666666666665,249.0,93.28571428571428,7,4087,3819.3333333333335,1514.0,583.8571428571429
10463045.0,6,7,478,4,272,3442289.6666666665,74.0,68.0,3,206,5163275.5,74.0,68.66666666666667
90303301.0,6,21,2106,10,704,10028661.888888888,95.0,70.4,11,1402,9029561.9,376.0,127.45454545454544
2869948.0,6,4,270,2,134,0.0,68.0,67.0,2,136,0.0,70.0,68.0
5830485.0,6,4,270,2,134,0.0,68.0,67.0,2,136,0.0,70.0,68.0
258792.00000000003,6,12,1373,7,714,43132.0,298.0,102.0,5,659,60481.0,379.0,131.8
306720.0,6,6,412,4,272,102240.0,74.0,68.0,2,140,0.0,74.0,70.0
347.0,17,2,267,1,83,0.0,83.0,83.0,1,184,0.0,184.0,184.0
129001441.0,17,15,907,8,475,18428777.285714287,174.0,59.375,7,432,18168095.166666668,174.0,61.71428571428572
3077297.0,17,3,1026,3,1026,1538648.5,342.0,342.0,0,0,0.0,0.0,0.0
800.0,17,4,438,2,148,0.0,74.0,74.0,2,290,0.0,147.0,145.0
504473.0,6,6,758,3,410,205152.0,172.0,136.66666666666666,3,348,180070.0,135.0,116.0
107201979.0,6,215,24246,108,7424,1001887.6542056076,140.0,68.74074074074075,107,16822,1001545.0094339624,284.0,157.21495327102804
302464.0,6,6,412,4,272,100821.33333333331,74.0,68.0,2,140,0.0,74.0,70.0
0.0,6,1,66,1,66,0.0,66.0,66.0,0,0,0.0,0.0,0.0
146139.0,6,3,337,2,214,0.0,160.0,107.0,1,123,0.0,123.0,123.0
153455.0,17,2,180,1,90,0.0,90.0,90.0,1,90,0.0,90.0,90.0
1692.0,17,2,762,2,762,0.0,381.0,381.0,0,0,0.0,0.0,0.0
153477.0,17,2,180,1,90,0.0,90.0,90.0,1,90,0.0,90.0,90.0
108104746.0,17,5,1005,5,1005,27026186.5,201.0,201.0,0,0,0.0,0.0,0.0
108102106.0,17,5,955,5,955,27025526.5,191.0,191.0,0,0,0.0,0.0,0.0
22939.0,6,14,4740,7,653,3617.5,249.0,93.28571428571428,7,4087,3551.333333333333,1514.0,583.8571428571429
40111.0,6,10,2032,5,524,9600.0,252.0,104.8,5,1508,9373.5,1236.0,301.6
4451.0,17,2,602,1,72,0.0,72.0,72.0,1,530,0.0,530.0,530.0
212842.0,17,2,180,1,90,0.0,90.0,90.0,1,90,0.0,90.0,90.0
452.0,17,2,166,1,75,0.0,75.0,75.0,1,91,0.0,91.0,91.0
108115952.0,17,5,1005,5,1005,27028988.0,201.0,201.0,0,0,0.0,0.0,0.0
487.0,17,2,508,2,508,0.0,257.0,254.0,0,0,0.0,0.0,0.0
20086.0,17,2,582,1,83,0.0,83.0,83.0,1,499,0.0,499.0,499.0
250080.00000000003,6,3,373,2,238,0.0,172.0,119.0,1,135,0.0,135.0,135.0
375.0,17,2,174,1,79,0.0,79.0,79.0,1,95,0.0,95.0,95.0
2385.0,17,4,344,2,150,0.0,75.0,75.0,2,194,0.0,103.0,97.0
228726.0,17,2,180,1,90,0.0,90.0,90.0,1,90,0.0,90.0,90.0
135134712.0,17,6,1206,6,1206,27026942.4,201.0,201.0,0,0,0.0,0.0,0.0
90025801.0,17,28,13364,28,13364,3334288.925925926,501.0,477.2857142857143,0,0,0.0,0.0,0.0
51807.0,6,12,1320,6,723,10158.6,253.0,120.5,6,597,9843.0,259.0,99.5
118033866.0,6,30,1974,15,1026,8415567.42857143,123.0,68.4,15,948,8415572.42857143,123.0,63.2
19362.0,6,10,1067,5,536,3428.25,264.0,107.2,5,531,4196.5,259.0,106.2
309981.0,17,4,1400,4,1400,103327.0,350.0,350.0,0,0,0.0,0.0,0.0
31072.0,6,14,4740,7,653,4878.5,249.0,93.28571428571428,7,4087,4896.166666666667,1514.0,583.8571428571429
14979.0,17,2,180,1,90,0.0,90.0,90.0,1,90,0.0,90.0,90.0
41759.0,6,10,1067,5,536,9273.0,264.0,107.2,5,531,10237.5,259.0,106.2
113520237.0,6,46,3036,23,1518,5159999.2727272725,66.0,66.0,23,1518,5159998.590909091,66.0,66.0
90302098.0,6,17,1287,9,691,11281843.875,95.0,76.77777777777777,8,596,12898841.714285716,95.0,74.5
111504.0,17,2,286,2,286,0.0,143.0,143.0,0,0,0.0,0.0,0.0
19395.0,6,14,4740,7,653,2742.1666666666665,249.0,93.28571428571428,7,4087,3093.833333333333,1514.0,583.8571428571429
196944.0,17,2,180,1,90,0.0,90.0,90.0,1,90,0.0,90.0,90.0
120005328.0,17,28,13364,28,13364,4444641.777777778,501.0,477.2857142857143,0,0,0.0,0.0,0.0
1315116.0,6,4,264,2,132,0.0,66.0,66.0,2,132,0.0,66.0,66.0
107578.0,17,2,286,2,286,0.0,143.0,143.0,0,0,0.0,0.0,0.0
9354.0,17,4,823,2,163,0.0,89.0,81.5,2,660,0.0,443.0,330.0
2328.0,17,4,344,2,150,0.0,75.0,75.0,2,194,0.0,103.0,97.0
51320386.0,6,15,1077,7,532,8553239.166666666,95.0,76.0,8,545,7330372.428571428,95.0,68.125
37524.0,6,10,2032,5,524,9087.75,252.0,104.8,5,1508,7136.0,1236.0,301.6
39635.0,6,14,4740,7,653,6449.0,249.0,93.28571428571428,7,4087,5618.5,1514.0,583.8571428571429
316655.0,17,4,1400,4,1400,105551.66666666669,350.0,350.0,0,0,0.0,0.0,0.0
108129036.0,17,5,1005,5,1005,27032259.0,201.0,201.0,0,0,0.0,0.0,0.0
101095830.0,6,213,24114,107,7284,953734.2452830188,140.0,68.07476635514018,106,16830,952926.4095238096,284.0,158.7735849056604
2403.0,17,4,344,2,150,0.0,75.0,75.0,2,194,0.0,103.0,97.0
37383.0,6,14,4740,7,653,5349.5,249.0,93.28571428571428,7,4087,5174.666666666667,1514.0,583.8571428571429
303695.0,6,2,132,1,66,0.0,66.0,66.0,1,66,0.0,66.0,66.0
90260463.0,6,14,2240,8,1016,12894351.857142856,188.0,127.0,6,1224,18019578.8,204.0,204.0
103487.0,17,2,762,2,762,0.0,381.0,381.0,0,0,0.0,0.0,0.0
153437.0,17,2,180,1,90,0.0,90.0,90.0,1,90,0.0,90.0,90.0
108109411.0,17,5,1005,5,1005,27027352.75,201.0,201.0,0,0,0.0,0.0,0.0
238306.0,6,3,337,2,214,0.0,160.0,107.0,1,123,0.0,123.0,123.0
133009789.0,17,15,907,8,475,19001398.42857143,174.0,59.375,7,432,18833551.33333333,174.0,61.71428571428572
14695.0,6,10,2032,5,524,3306.0,252.0,104.8,5,1508,3109.25,1236.0,301.6
120246163.0,6,218,24646,109,7490,1105896.7685185184,140.0,68.71559633027523,109,17156,1096259.0833333333,284.0,157.39449541284404
1827057.0,6,31,15806,17,14418,114191.0625,1514.0,848.1176470588235,14,1388,123620.6153846154,271.0,99.14285714285714
207486.0,6,3,426,2,280,0.0,214.0,140.0,1,146,0.0,146.0,146.0
153732.0,17,2,180,1,90,0.0,90.0,90.0,1,90,0.0,90.0,90.0
1470171.0,6,8,602,5,404,342041.25,103.0,80.8,3,198,203818.0,66.0,66.0
90259047.0,6,12,1832,8,1016,12894149.57142857,188.0,127.0,4,816,30032308.666666668,204.0,204.0
246649.0,6,3,337,2,214,0.0,160.0,107.0,1,123,0.0,123.0,123.0
102506.0,17,2,286,2,286,0.0,143.0,143.0,0,0,0.0,0.0,0.0
103294.0,17,2,286,2,286,0.0,143.0,143.0,0,0,0.0,0.0,0.0
204583.0,17,2,762,2,762,0.0,381.0,381.0,0,0,0.0,0.0,0.0
2736256.0,6,3,1777,2,951,0.0,885.0,475.5,1,826,0.0,826.0,826.0
412.0,17,2,410,1,78,0.0,78.0,78.0,1,332,0.0,332.0,332.0
840217.0,6,9,1118,6,586,168043.4,248.0,97.66666666666669,3,532,282208.5,392.0,177.33333333333334
106871754.0,17,14,864,7,432,17666834.0,174.0,61.71428571428572,7,432,17667832.0,174.0,61.71428571428572
108110101.0,17,5,955,5,955,27027525.25,191.0,191.0,0,0,0.0,0.0,0.0
10484655.0,6,7,478,4,272,3449402.0,74.0,68.0,3,206,5173965.0,74.0,68.66666666666667
108110040.0,17,5,955,5,955,27027510.0,191.0,191.0,0,0,0.0,0.0,0.0
335.0,17,2,166,1,75,0.0,75.0,75.0,1,91,0.0,91.0,91.0
2470.0,17,4,344,2,150,0.0,75.0,75.0,2,194,0.0,103.0,97.0
5005621.0,17,4,849,2,166,0.0,83.0,83.0,2,683,0.0,499.0,341.5
3573383.0,6,5,336,2,134,0.0,68.0,67.0,3,202,1423649.0,70.0,67.33333333333333
5624748.0,6,5,336,2,134,0.0,68.0,67.0,3,202,1421736.0,70.0,67.33333333333333
223956.0,17,2,414,1,88,0.0,88.0,88.0,1,326,0.0,326.0,326.0
17904.0,6,10,2032,5,524,3233.25,252.0,104.8,5,1508,4205.25,1236.0,301.6
190448.0,17,2,180,1,90,0.0,90.0,90.0,1,90,0.0,90.0,90.0
90685781.0,6,17,2434,9,1204,11316104.875,188.0,133.77777777777777,8,1230,12926695.57142857,204.0,153.75
205393.0,17,2,762,2,762,0.0,381.0,381.0,0,0,0.0,0.0,0.0
108109507.0,17,5,955,5,955,27027376.75,191.0,191.0,0,0,0.0,0.0,0.0
311394.0,17,4,1400,4,1400,103798.0,350.0,350.0,0,0,0.0,0.0,0.0
299393.0,17,2,346,1,78,0.0,78.0,78.0,1,268,0.0,268.0,268.0
78499.0,6,14,4740,7,653,11538.833333333334,249.0,93.28571428571428,7,4087,12598.333333333334,1514.0,583.8571428571429
135136507.0,17,6,1206,6,1206,27027301.4,201.0,201.0,0,0,0.0,0.0,0.0
196983.0,17,2,180,1,90,0.0,90.0,90.0,1,90,0.0,90.0,90.0
204678.0,17,2,762,2,762,0.0,381.0,381.0,0,0,0.0,0.0,0.0
30041.0,6,14,4740,7,653,4888.0,249.0,93.28571428571428,7,4087,4830.666666666667,1514.0,583.8571428571429
103745.0,17,2,286,2,286,0.0,143.0,143.0,0,0,0.0,0.0,0.0
742835.0,6,10,1065,5,534,185062.75,262.0,106.8,5,531,185319.75,259.0,106.2
181224.0,17,2,180,1,90,0.0,90.0,90.0,1,90,0.0,90.0,90.0
33558.0,6,14,4740,7,653,4198.666666666667,249.0,93.28571428571428,7,4087,5454.166666666667,1514.0,583.8571428571429
4150.0,17,4,344,2,150,0.0,75.0,75.0,2,194,0.0,103.0,97.0
24533.0,6,14,4740,7,653,3498.1666666666665,249.0,93.28571428571428,7,4087,3951.6666666666665,1514.0,583.8571428571429
71169908.0,6,9,842,9,842,8896238.5,97.0,93.55555555555556,0,0,0.0,0.0,0.0
146191.0,6,3,337,2,214,0.0,160.0,107.0,1,123,0.0,123.0,123.0
307146.0,6,6,412,4,272,102382.0,74.0,68.0,2,140,0.0,74.0,70.0
108345.0,17,2,286,2,286,0.0,143.0,143.0,0,0,0.0,0.0,0.0
168194.0,17,2,239,1,82,0.0,82.0,82.0,1,157,0.0,157.0,157.0
2062.0,17,4,344,2,150,0.0,75.0,75.0,2,194,0.0,103.0,97.0
114332324.0,6,31,2166,16,1149,7607755.733333333,123.0,71.8125,15,1017,8151165.214285715,123.0,67.8
109268353.0,6,215,24284,108,7424,1021152.9345794392,140.0,68.74074074074075,107,16860,1026379.641509434,284.0,157.57009345794393
1308299.0,17,7,490,7,490,218049.8333333333,70.0,70.0,0,0,0.0,0.0,0.0
119673782.0,17,34,16284,34,16284,3626478.242424242,501.0,478.9411764705882,0,0,0.0,0.0,0.0
90021521.0,17,28,13364,28,13364,3334130.407407407,501.0,477.2857142857143,0,0,0.0,0.0,0.0
120045986.0,17,29,13785,29,13785,4287356.642857143,501.0,475.3448275862069,0,0,0.0,0.0,0.0
56315.0,6,10,2032,5,524,13810.75,252.0,104.8,5,1508,12742.5,1236.0,301.6
302864.0,6,6,412,4,272,100954.66666666669,74.0,68.0,2,140,0.0,74.0,70.0
2807615.0,6,2,132,1,66,0.0,66.0,66.0,1,66,0.0,66.0,66.0
34099.0,6,14,4740,7,653,4916.833333333333,249.0,93.28571428571428,7,4087,5309.5,1514.0,583.8571428571429
9186.0,17,2,582,1,83,0.0,83.0,83.0,1,499,0.0,499.0,499.0
313219.0,6,6,412,4,272,104406.33333333331,74.0,68.0,2,140,0.0,74.0,70.0
66756.0,6,14,4740,7,653,11002.666666666666,249.0,93.28571428571428,7,4087,10691.5,1514.0,583.8571428571429
0.0,6,1,54,0,0,0.0,0.0,0.0,1,54,0.0,54.0,54.0
92253704.0,6,28,2168,16,1274,6149783.266666667,95.0,79.625,12,894,8361641.090909091,95.0,74.5
128001736.0,17,15,907,8,475,18285962.285714287,174.0,59.375,7,432,18001378.666666668,174.0,61.71428571428572
1392127.0,17,16,1120,16,1120,92808.46666666666,70.0,70.0,0,0,0.0,0.0,0.0
209615.0,17,2,180,1,90,0.0,90.0,90.0,1,90,0.0,90.0,90.0
63208.0,6,10,2032,5,524,15581.75,252.0,104.8,5,1508,15006.0,1236.0,301.6
10440450.0,6,7,478,4,272,3433152.0,74.0,68.0,3,206,5149618.0,74.0,68.66666666666667
100302851.0,17,14,1126,7,563,16668254.333333334,174.0,80.42857142857143,7,563,16666811.166666666,174.0,80.42857142857143
1570113.0,6,2,132,1,66,0.0,66.0,66.0,1,66,0.0,66.0,66.0
1588500.0,17,6,1230,3,234,794064.5,78.0,78.0,3,996,794030.5,332.0,332.0
90300156.0,6,16,1192,8,596,12892849.142857144,95.0,74.5,8,596,12896340.142857144,95.0,74.5
307212.0,6,6,412,4,272,102404.0,74.0,68.0,2,140,0.0,74.0,70.0
120030995.0,17,29,13785,29,13785,4286821.25,501.0,475.3448275862069,0,0,0.0,0.0,0.0
123683652.0,6,48,3168,24,1584,5025905.130434782,66.0,66.0,24,1584,5265066.521739131,66.0,66.0
342017.0,6,10,2032,5,524,12873.0,252.0,104.8,5,1508,84227.0,1236.0,301.6
345.0,17,2,250,1,93,0.0,93.0,93.0,1,157,0.0,157.0,157.0
40873.0,6,10,2032,5,524,10002.0,252.0,104.8,5,1508,7251.0,1236.0,301.6
307230.0,6,6,412,4,272,102410.0,74.0,68.0,2,140,0.0,74.0,70.0
119372760.0,6,237,26726,119,8076,1011633.559322034,140.0,67.8655462184874,118,18650,1018017.341880342,284.0,158.05084745762713
44664.0,6,10,2032,5,524,10901.25,252.0,104.8,5,1508,10910.5,1236.0,301.6
10415517.0,6,6,412,3,206,5140006.5,74.0,68.66666666666667,3,206,5139888.5,74.0,68.66666666666667
315212.0,17,4,1400,4,1400,105070.66666666669,350.0,350.0,0,0,0.0,0.0,0.0
857.0,17,5,550,5,550,214.25,110.0,110.0,0,0,0.0,0.0,0.0
28208.0,17,4,823,2,163,0.0,89.0,81.5,2,660,0.0,443.0,330.0
90056023.0,17,28,13364,28,13364,3335408.25925926,501.0,477.2857142857143,0,0,0.0,0.0,0.0
297617.0,6,6,412,4,272,99205.66666666669,74.0,68.0,2,140,0.0,74.0,70.0
122304.0,6,3,373,2,238,0.0,172.0,119.0,1,135,0.0,135.0,135.0
234832.0,6,3,373,2,238,0.0,172.0,119.0,1,135,0.0,135.0,135.0
33259.0,6,14,4740,7,653,5436.166666666667,249.0,93.28571428571428,7,4087,5165.333333333333,1514.0,583.8571428571429
108109993.0,17,5,955,5,955,27027498.25,191.0,191.0,0,0,0.0,0.0,0.0
106815.0,17,2,286,2,286,0.0,143.0,143.0,0,0,0.0,0.0,0.0
1431858.0,17,16,1120,16,1120,95457.2,70.0,70.0,0,0,0.0,0.0,0.0
90462501.0,6,21,1626,11,881,9041946.8,95.0,80.0909090909091,10,745,9958057.333333334,95.0,74.5
5630645.0,6,5,336,2,134,0.0,68.0,67.0,3,202,1422209.5,70.0,67.33333333333333
321855.0,6,6,412,4,272,107285.0,74.0,68.0,2,140,0.0,74.0,70.0
2994.0,17,2,224,1,76,0.0,76.0,76.0,1,148,0.0,148.0,148.0
3173.0,17,2,180,1,90,0.0,90.0,90.0,1,90,0.0,90.0,90.0
108107498.0,17,5,1005,5,1005,27026874.5,201.0,201.0,0,0,0.0,0.0,0.0
108633511.0,6,32,2220,16,1149,7227853.333333333,123.0,71.8125,16,1071,7227852.266666667,123.0,66.9375
146221.0,6,3,337,2,214,0.0,160.0,107.0,1,123,0.0,123.0,123.0
1452.0,17,2,762,2,762,0.0,381.0,381.0,0,0,0.0,0.0,0.0
3006158.0,6,12,2172,7,664,501026.3333333333,252.0,94.85714285714286,5,1508,1977.75,1236.0,301.6
849066.0,6,9,1196,6,725,169813.2,387.0,120.83333333333331,3,471,286682.0,331.0,157.0
46249.0,6,10,2032,5,524,11232.0,252.0,104.8,5,1508,11049.5,1236.0,301.6
289.0,17,2,168,1,76,0.0,76.0,76.0,1,92,0.0,92.0,92.0
120361746.0,6,219,24818,110,17402,1104236.2018348624,284.0,158.2,109,7416,1104932.5833333333,140.0,68.03669724770643
119957107.0,6,14,2240,6,1224,18071763.2,204.0,204.0,8,1016,17136404.285714287,188.0,127.0
322013.0,17,4,1400,4,1400,107337.66666666669,350.0,350.0,0,0,0.0,0.0,0.0
120089284.0,17,29,13785,29,13785,4288903.0,501.0,475.3448275862069,0,0,0.0,0.0,0.0
303367.0,6,6,412,4,272,101122.33333333331,74.0,68.0,2,140,0.0,74.0,70.0
167440.0,6,10,1102,5,570,41524.25,298.0,114.0,5,532,41510.5,260.0,106.4
362.0,17,2,166,1,75,0.0,75.0,75.0,1,91,0.0,91.0,91.0
96251194.0,6,56,12206,27,6414,3701969.0,1514.0,237.5555555555556,29,5792,3428340.75,1514.0,199.72413793103448
43705.0,6,10,2032,5,524,10004.0,252.0,104.8,5,1508,9063.0,1236.0,301.6
106349.0,17,4,1400,4,1400,35449.666666666664,350.0,350.0,0,0,0.0,0.0,0.0
153481.0,17,2,180,1,90,0.0,90.0,90.0,1,90,0.0,90.0,90.0
27811.0,6,14,4740,7,653,4485.166666666667,249.0,93.28571428571428,7,4087,3291.0,1514.0,583.8571428571429
146368.0,6,3,337,2,214,0.0,160.0,107.0,1,123,0.0,123.0,123.0
90044939.0,17,27,12943,27,12943,3463266.8846153845,501.0,479.3703703703704,0,0,0.0,0.0,0.0
110798269.0,6,30,1974,15,1026,7898731.857142857,123.0,68.4,15,948,7898728.214285715,123.0,63.2
90024241.0,17,28,13364,28,13364,3334231.1481481483,501.0,477.2857142857143,0,0,0.0,0.0,0.0
108097571.0,17,5,955,5,955,27024392.75,191.0,191.0,0,0,0.0,0.0,0.0
42332.0,6,10,2032,5,524,10330.0,252.0,104.8,5,1508,9936.0,1236.0,301.6
333.0,17,2,174,1,79,0.0,79.0,79.0,1,95,0.0,95.0,95.0
131367.0,6,2,132,1,66,0.0,66.0,66.0,1,66,0.0,66.0,66.0
3027.0,17,2,224,1,76,0.0,76.0,76.0,1,148,0.0,148.0,148.0
103812.0,17,2,286,2,286,0.0,143.0,143.0,0,0,0.0,0.0,0.0
90683210.0,6,21,1585,10,745,10075912.222222222,95.0,74.5,11,840,9043507.9,95.0,76.36363636363636
187331.0,6,12,1427,6,796,37112.6,271.0,132.66666666666666,6,631,36987.8,293.0,105.16666666666669
224322.0,17,2,180,1,90,0.0,90.0,90.0,1,90,0.0,90.0,90.0
120571727.0,6,231,26162,116,18264,1048449.8,284.0,157.44827586206895,115,7898,1048663.2368421052,140.0,68.67826086956522
0.0,17,1,44,1,44,0.0,44.0,44.0,0,0,0.0,0.0,0.0
96950.0,6,2,132,1,66,0.0,66.0,66.0,1,66,0.0,66.0,66.0
1544.0,17,2,176,1,80,0.0,80.0,80.0,1,96,0.0,96.0,96.0
2319819.0,6,3,1604,2,851,0.0,785.0,425.5,1,753,0.0,753.0,753.0
44362.0,6,14,4740,7,653,6876.5,249.0,93.28571428571428,7,4087,7259.666666666667,1514.0,583.8571428571429
276577.0,6,3,337,2,214,0.0,160.0,107.0,1,123,0.0,123.0,123.0
45058.0,6,14,4740,7,653,7274.333333333333,249.0,93.28571428571428,7,4087,7051.833333333333,1514.0,583.8571428571429
207997.0,17,4,1524,4,1524,69332.33333333333,381.0,381.0,0,0,0.0,0.0,0.0
102004387.0,17,14,864,7,432,17000731.166666668,174.0,61.71428571428572,7,432,16833523.333333332,174.0,61.71428571428572
135138197.0,17,6,1206,6,1206,27027639.4,201.0,201.0,0,0,0.0,0.0,0.0
126009165.0,17,15,907,8,475,18001309.285714287,174.0,59.375,7,432,17666837.333333332,174.0,61.71428571428572
96502325.0,17,12,778,6,389,19200171.6,174.0,64.83333333333333,6,389,19200201.8,174.0,64.83333333333333
311367.0,17,4,1400,4,1400,103789.0,350.0,350.0,0,0,0.0,0.0,0.0
10877398.0,6,8,544,4,272,3580558.0,74.0,68.0,4,272,3580476.0,74.0,68.0
2501.0,17,2,762,2,762,0.0,381.0,381.0,0,0,0.0,0.0,0.0
121437.0,6,3,337,2,214,0.0,160.0,107.0,1,123,0.0,123.0,123.0
102990.0,17,2,286,2,286,0.0,143.0,143.0,0,0,0.0,0.0,0.0
1547436.0,17,8,1640,4,312,511737.3333333333,78.0,78.0,4,1328,515676.3333333333,332.0,332.0
207261.0,6,3,426,2,280,0.0,214.0,140.0,1,146,0.0,146.0,146.0
1167128.0,6,13,3010,8,2382,166732.57142857142,1514.0,297.75,5,628,223648.5,331.0,125.6
310466.0,17,4,1400,4,1400,103488.66666666669,350.0,350.0,0,0,0.0,0.0,0.0
241301.0,6,13,1386,7,789,40216.833333333336,253.0,112.71428571428572,6,597,46037.8,259.0,99.5
103156.0,17,2,700,2,700,0.0,350.0,350.0,0,0,0.0,0.0,0.0
1161124.0,6,13,3010,8,2382,165874.85714285713,1514.0,297.75,5,628,222150.25,331.0,125.6
48403.0,6,14,4740,7,653,7945.166666666667,249.0,93.28571428571428,7,4087,7665.666666666667,1514.0,583.8571428571429
90052609.0,17,28,13364,28,13364,3335281.814814815,501.0,477.2857142857143,0,0,0.0,0.0,0.0
146358.0,6,3,337,2,214,0.0,160.0,107.0,1,123,0.0,123.0,123.0
113518897.0,6,45,2970,23,1518,5159949.863636363,66.0,66.0,22,1452,5220630.857142857,66.0,66.0
55351.0,6,14,4740,7,653,9047.5,249.0,93.28571428571428,7,4087,8300.666666666666,1514.0,583.8571428571429
123730584.0,6,49,3234,25,1650,5155441.0,66.0,66.0,24,1584,4976763.217391305,66.0,66.0
22805.0,6,10,2032,5,524,5010.75,252.0,104.8,5,1508,5431.25,1236.0,301.6
90972168.0,6,228,26724,114,18978,803160.0796460178,284.0,166.47368421052633,114,7746,803160.1150442478,140.0,67.94736842105263
27035320.0,17,5,1710,5,1710,6758830.0,342.0,342.0,0,0,0.0,0.0,0.0
201684.0,6,14,4740,7,653,23990.83333333333,249.0,93.28571428571428,7,4087,33387.333333333336,1514.0,583.8571428571429
90259474.0,6,14,1964,8,1016,12894210.57142857,188.0,127.0,6,948,18019431.4,204.0,158.0
2321.0,17,4,344,2,150,0.0,75.0,75.0,2,194,0.0,103.0,97.0
3004149.0,6,12,2172,7,664,500541.3333333333,252.0,94.85714285714286,5,1508,1965.0,1236.0,301.6
130922374.0,17,14,864,7,432,18579683.83333333,174.0,61.71428571428572,7,432,18667680.33333333,174.0,61.71428571428572
24263.0,6,10,2032,5,524,5858.25,252.0,104.8,5,1508,5789.0,1236.0,301.6
42165.0,6,14,4740,7,653,5899.166666666667,249.0,93.28571428571428,7,4087,6655.166666666667,1514.0,583.8571428571429
36670.0,6,14,4740,7,653,5991.5,249.0,93.28571428571428,7,4087,5972.5,1514.0,583.8571428571429
90737276.0,6,18,1341,9,691,11342159.5,95.0,76.77777777777777,9,650,11306251.375,95.0,72.22222222222223
521340.0,17,4,601,2,146,0.0,73.0,73.0,2,455,0.0,301.0,227.5
10475407.0,6,7,478,4,272,3446373.333333333,74.0,68.0,3,206,5169390.5,74.0,68.66666666666667
102074153.0,6,215,24548,108,7424,953964.046728972,140.0,68.74074074074075,107,17124,943334.9811320754,300.0,160.0373831775701
10479360.0,6,7,478,4,272,3445868.6666666665,74.0,68.0,3,206,5168727.0,74.0,68.66666666666667
4812.0,17,2,180,1,90,0.0,90.0,90.0,1,90,0.0,90.0,90.0
9625.0,17,2,539,1,86,0.0,86.0,86.0,1,453,0.0,453.0,453.0
10506723.0,6,7,478,4,272,3456698.0,74.0,68.0,3,206,5184923.5,74.0,68.66666666666667
90013324.0,17,28,13364,28,13364,3333826.814814815,501.0,477.2857142857143,0,0,0.0,0.0,0.0
228456.0,17,2,180,1,90,0.0,90.0,90.0,1,90,0.0,90.0,90.0
10284.0,6,11,2098,6,590,1913.2,252.0,98.33333333333331,5,1508,2290.75,1236.0,301.6
153479.0,17,2,180,1,90,0.0,90.0,90.0,1,90,0.0,90.0,90.0
90928170.0,6,21,1585,11,840,9091660.4,95.0,76.36363636363636,10,745,10102398.222222222,95.0,74.5
19755.0,6,10,2032,5,524,4416.0,252.0,104.8,5,1508,3917.75,1236.0,301.6
108101703.0,17,5,955,5,955,27025425.75,191.0,191.0,0,0,0.0,0.0,0.0
16857.0,6,14,4740,7,653,2604.1666666666665,249.0,93.28571428571428,7,4087,2665.6666666666665,1514.0,583.8571428571429
53354.0,6,13,1386,7,789,8697.666666666666,253.0,112.71428571428572,6,597,9979.2,259.0,99.5
272110.0,17,2,180,1,90,0.0,90.0,90.0,1,90,0.0,90.0,90.0
90291256.0,6,16,1192,8,596,12891406.285714284,95.0,74.5,8,596,12897203.285714284,95.0,74.5
120000036.0,6,23,1936,13,1191,10000003.0,256.0,91.6153846153846,10,745,10227943.555555556,95.0,74.5
198744.0,17,2,180,1,90,0.0,90.0,90.0,1,90,0.0,90.0,90.0
752437.0,6,10,1065,5,534,187928.5,262.0,106.8,5,531,187840.5,259.0,106.2
43649.0,6,14,4740,7,653,7102.666666666667,249.0,93.28571428571428,7,4087,7128.0,1514.0,583.8571428571429
33775.0,6,11,2098,6,590,6305.6,252.0,98.33333333333331,5,1508,7757.25,1236.0,301.6
206416.0,6,3,426,2,280,0.0,214.0,140.0,1,146,0.0,146.0,146.0
2800931.0,6,2,132,1,66,0.0,66.0,66.0,1,66,0.0,66.0,66.0
35358.0,6,13,4416,6,409,6801.0,127.0,68.16666666666667,7,4007,5737.333333333333,1514.0,572.4285714285714
19340.0,6,14,4740,7,653,3029.5,249.0,93.28571428571428,7,4087,3029.1666666666665,1514.0,583.8571428571429
90283903.0,6,16,1192,8,596,12891354.714285716,95.0,74.5,8,596,12896168.714285716,95.0,74.5
223260.0,6,10,1221,6,636,44652.0,298.0,106.0,4,585,73329.66666666667,379.0,146.25
103787.0,17,2,286,2,286,0.0,143.0,143.0,0,0,0.0,0.0,0.0
266478.0,17,4,6056,4,6056,88826.0,1514.0,1514.0,0,0,0.0,0.0,0.0
232115.0,6,3,337,2,214,0.0,160.0,107.0,1,123,0.0,123.0,123.0
280.0,17,2,762,2,762,0.0,381.0,381.0,0,0,0.0,0.0,0.0
109838842.0,6,49,4404,29,2496,3922815.785714286,123.0,86.06896551724138,20,1908,5769607.315789473,123.0,95.4
37498.0,6,14,4740,7,653,5904.333333333333,249.0,93.28571428571428,7,4087,5537.333333333333,1514.0,583.8571428571429
300264.0,6,6,412,4,272,100088.0,74.0,68.0,2,140,0.0,74.0,70.0
108271478.0,17,14,864,7,432,18018757.0,174.0,61.71428571428572,7,432,18007822.0,174.0,61.71428571428572
155770.0,6,3,337,2,214,0.0,160.0,107.0,1,123,0.0,123.0,123.0
17715.0,6,10,2032,5,524,3716.75,252.0,104.8,5,1508,4113.0,1236.0,301.6
315406.0,17,4,1400,4,1400,105135.33333333331,350.0,350.0,0,0,0.0,0.0,0.0
17416.0,17,2,582,1,83,0.0,83.0,83.0,1,499,0.0,499.0,499.0
120069507.0,6,216,24312,108,7350,1114548.1495327102,140.0,68.05555555555556,108,16962,1114497.9439252336,284.0,157.05555555555554
206342.0,6,3,426,2,280,0.0,214.0,140.0,1,146,0.0,146.0,146.0
135132782.0,17,6,1146,6,1146,27026556.4,191.0,191.0,0,0,0.0,0.0,0.0
1256087.0,17,7,490,7,490,209347.8333333333,70.0,70.0,0,0,0.0,0.0,0.0
103000894.0,6,221,25130,111,7622,936371.7636363636,140.0,68.66666666666667,110,17508,936511.495412844,284.0,159.16363636363636
2404.0,17,4,344,2,150,0.0,75.0,75.0,2,194,0.0,103.0,97.0
120021907.0,6,23,1860,12,894,10909088.545454543,95.0,74.5,11,966,12001239.7,221.0,87.81818181818181
162287.0,17,2,180,1,90,0.0,90.0,90.0,1,90,0.0,90.0,90.0
90033279.0,17,28,13364,28,13364,3334565.888888889,501.0,477.2857142857143,0,0,0.0,0.0,0.0
135129753.0,17,6,1146,6,1146,27025950.6,191.0,191.0,0,0,0.0,0.0,0.0
102502833.0,17,14,864,7,432,17000819.5,174.0,61.71428571428572,7,432,17000187.333333332,174.0,61.71428571428572
1725550.0,6,19,7533,10,1403,191727.7777777777,583.0,140.3,9,6130,182857.375,1484.0,681.1111111111111
90772384.0,6,17,1287,9,691,11340557.125,95.0,76.77777777777777,8,596,12964224.285714284,95.0,74.5
537247.0,17,6,2100,6,2100,107449.4,350.0,350.0,0,0,0.0,0.0,0.0
1058699.0,6,11,1134,6,558,211739.8,220.0,93.0,5,576,261027.25,304.0,115.2
206192.0,6,3,426,2,280,0.0,214.0,140.0,1,146,0.0,146.0,146.0
1190750.0,6,13,3014,8,2386,170107.14285714287,1514.0,298.25,5,628,228785.0,331.0,125.6
395952.0,6,3,202,2,128,0.0,74.0,64.0,1,74,0.0,74.0,74.0
13947.0,6,10,2032,5,524,3263.75,252.0,104.8,5,1508,2483.75,1236.0,301.6
264173.0,6,3,337,2,214,0.0,160.0,107.0,1,123,0.0,123.0,123.0
28921.0,6,14,4740,7,653,4650.0,249.0,93.28571428571428,7,4087,4562.833333333333,1514.0,583.8571428571429
108110976.0,17,5,1005,5,1005,27027744.0,201.0,201.0,0,0,0.0,0.0,0.0
205712.0,17,2,180,1,90,0.0,90.0,90.0,1,90,0.0,90.0,90.0
272496.0,6,10,1221,6,636,54499.2,298.0,106.0,4,585,83877.0,379.0,146.25
71.0,17,2,700,2,700,0.0,350.0,350.0,0,0,0.0,0.0,0.0
120297651.0,6,231,26134,116,18248,1046066.5304347826,284.0,157.31034482758622,115,7886,1046215.3070175438,140.0,68.57391304347826
319711.0,17,4,1400,4,1400,106570.33333333331,350.0,350.0,0,0,0.0,0.0,0.0
316564.0,17,4,704,2,148,0.0,74.0,74.0,2,556,0.0,280.0,278.0
73542.0,6,14,4740,7,653,11711.666666666666,249.0,93.28571428571428,7,4087,12043.666666666666,1514.0,583.8571428571429
25683.0,6,14,4740,7,653,3737.0,249.0,93.28571428571428,7,4087,4068.1666666666665,1514.0,583.8571428571429
90258014.0,6,13,2036,8,1016,12894002.0,188.0,127.0,5,1020,22523128.0,204.0,204.0
250849.0,6,3,337,2,214,0.0,160.0,107.0,1,123,0.0,123.0,123.0
155127.0,6,3,337,2,214,0.0,160.0,107.0,1,123,0.0,123.0,123.0
39044.0,6,10,2032,5,524,8960.25,252.0,104.8,5,1508,9135.75,1236.0,301.6
486.0,17,2,508,2,508,0.0,257.0,254.0,0,0,0.0,0.0,0.0
2351.0,17,4,344,2,150,0.0,75.0,75.0,2,194,0.0,103.0,97.0
508783.0,6,5,336,2,134,0.0,68.0,67.0,3,202,195432.0,70.0,67.33333333333333
146141.0,6,3,337,2,214,0.0,160.0,107.0,1,123,0.0,123.0,123.0
120429880.0,6,407,51160,204,37466,593250.6403940887,464.0,183.65686274509804,203,13694,591624.896039604,140.0,67.45812807881774
2134173.0,6,25,7610,13,2516,177847.75,1034.0,193.53846153846155,12,5094,166258.54545454544,1510.0,424.5
149725109.0,6,18,2622,11,1458,14972510.9,188.0,132.54545454545453,7,1164,19975302.666666668,204.0,166.28571428571428
209609.0,17,2,180,1,90,0.0,90.0,90.0,1,90,0.0,90.0,90.0
50937.0,17,2,180,1,90,0.0,90.0,90.0,1,90,0.0,90.0,90.0
25595.0,6,14,4740,7,653,4101.833333333333,249.0,93.28571428571428,7,4087,3941.3333333333335,1514.0,583.8571428571429
120226767.0,6,18,1341,9,691,14998983.5,95.0,76.77777777777777,9,650,14998744.75,95.0,72.22222222222223
143978.0,17,2,180,1,90,0.0,90.0,90.0,1,90,0.0,90.0,90.0
22227.0,6,10,2032,5,524,4862.5,252.0,104.8,5,1508,4985.5,1236.0,301.6
10487452.0,6,7,478,4,272,3450122.6666666665,74.0,68.0,3,206,5175083.0,74.0,68.66666666666667
30708.0,6,14,4740,7,653,4861.0,249.0,93.28571428571428,7,4087,4014.3333333333335,1514.0,583.8571428571429
3035.0,17,2,224,1,76,0.0,76.0,76.0,1,148,0.0,148.0,148.0
54715.0,6,14,4740,7,653,8604.166666666666,249.0,93.28571428571428,7,4087,8228.0,1514.0,583.8571428571429
109612.0,6,14,4740,7,653,17802.333333333332,249.0,93.28571428571428,7,4087,17743.666666666668,1514.0,583.8571428571429
14559.0,6,10,1949,5,441,3405.75,169.0,88.2,5,1508,3365.5,1236.0,301.6
45470.0,6,14,4740,7,653,7457.666666666667,249.0,93.28571428571428,7,4087,7260.666666666667,1514.0,583.8571428571429
314.0,17,2,174,1,79,0.0,79.0,79.0,1,95,0.0,95.0,95.0
2797602.0,6,2,132,1,66,0.0,66.0,66.0,1,66,0.0,66.0,66.0
120178631.0,6,220,24868,110,7556,1094988.0,140.0,68.69090909090909,110,17312,1098869.4678899082,284.0,157.38181818181818
108086073.0,17,5,955,5,955,27021518.25,191.0,191.0,0,0,0.0,0.0,0.0
97093463.0,17,12,778,6,389,19400161.8,174.0,64.83333333333333,6,389,19401236.6,174.0,64.83333333333333
135129869.0,17,6,1206,6,1206,27025973.8,201.0,201.0,0,0,0.0,0.0,0.0
232079.0,6,3,337,2,214,0.0,160.0,107.0,1,123,0.0,123.0,123.0
17005.0,17,2,180,1,90,0.0,90.0,90.0,1,90,0.0,90.0,90.0
910252.0,6,12,2710,7,743,151708.66666666666,339.0,106.14285714285714,5,1967,158579.75,1514.0,393.4
339.0,17,2,174,1,79,0.0,79.0,79.0,1,95,0.0,95.0,95.0
351.0,17,2,267,1,83,0.0,83.0,83.0,1,184,0.0,184.0,184.0
1167406.0,6,13,3004,8,2376,166772.2857142857,1514.0,297.0,5,628,222875.75,331.0,125.6
107362.0,17,2,286,2,286,0.0,143.0,143.0,0,0,0.0,0.0,0.0
301480.0,6,6,412,4,272,100493.33333333331,74.0,68.0,2,140,0.0,74.0,70.0
68630.0,6,12,1362,6,731,12790.8,253.0,121.83333333333331,6,631,12486.4,293.0,105.16666666666669
29815244.0,6,5,1736,2,819,0.0,753.0,409.5,3,917,14839406.5,785.0,305.6666666666667
112150.0,6,14,4740,7,653,18395.5,249.0,93.28571428571428,7,4087,17683.333333333332,1514.0,583.8571428571429
153445.0,17,2,180,1,90,0.0,90.0,90.0,1,90,0.0,90.0,90.0
2098.0,17,4,344,2,150,0.0,75.0,75.0,2,194,0.0,103.0,97.0
79929.0,6,14,4740,7,653,13156.166666666666,249.0,93.28571428571428,7,4087,12950.166666666666,1514.0,583.8571428571429
90289509.0,6,16,1192,8,596,12891421.42857143,95.0,74.5,8,596,12897665.285714284,95.0,74.5
108106765.0,17,5,955,5,955,27026691.25,191.0,191.0,0,0,0.0,0.0,0.0
49263.0,6,14,4740,7,653,8076.333333333333,249.0,93.28571428571428,7,4087,8022.0,1514.0,583.8571428571429
135131983.0,17,6,1206,6,1206,27026396.6,201.0,201.0,0,0,0.0,0.0,0.0
333.0,17,2,166,1,75,0.0,75.0,75.0,1,91,0.0,91.0,91.0
109183350.0,6,44,2904,22,1452,5199207.142857143,66.0,66.0,22,1452,5184512.571428572,66.0,66.0
56809.0,6,14,4740,7,653,9340.5,249.0,93.28571428571428,7,4087,9002.833333333334,1514.0,583.8571428571429
24362.0,6,14,4740,7,653,3833.1666666666665,249.0,93.28571428571428,7,4087,3902.6666666666665,1514.0,583.8571428571429
44536.0,6,10,2032,5,524,10857.75,252.0,104.8,5,1508,10360.0,1236.0,301.6
1326550.0,6,4,264,2,132,0.0,66.0,66.0,2,132,0.0,66.0,66.0
90983090.0,6,26,1746,13,906,7564842.25,123.0,69.6923076923077,13,840,7564842.0,123.0,64.61538461538461
87522.0,17,2,762,2,762,0.0,381.0,381.0,0,0,0.0,0.0,0.0
2096.0,17,4,344,2,150,0.0,75.0,75.0,2,194,0.0,103.0,97.0
41092.0,6,14,4740,7,653,6001.0,249.0,93.28571428571428,7,4087,6593.333333333333,1514.0,583.8571428571429
16056.999999999998,6,10,2032,5,524,3780.5,252.0,104.8,5,1508,3615.25,1236.0,301.6
309854.0,6,10,1221,6,636,61970.8,298.0,106.0,4,585,96805.66666666669,379.0,146.25
108696770.0,6,33,2412,17,1272,6780047.8125,123.0,74.82352941176471,16,1140,7232044.6,123.0,71.25
143949.0,17,2,180,1,90,0.0,90.0,90.0,1,90,0.0,90.0,90.0
3110097.0,6,159,125688,90,116832,34944.910112359554,1510.0,1298.1333333333334,69,8856,41061.720588235294,1510.0,128.34782608695653
135155197.0,17,6,1146,6,1146,27031039.4,191.0,191.0,0,0,0.0,0.0,0.0
222895.0,6,13,1386,7,789,37149.16666666666,253.0,112.71428571428572,6,597,43735.4,259.0,99.5
23508.0,6,14,4740,7,653,3809.5,249.0,93.28571428571428,7,4087,3677.5,1514.0,583.8571428571429
135126494.0,17,6,1146,6,1146,27025298.8,191.0,191.0,0,0,0.0,0.0,0.0
108102111.0,17,5,1005,5,1005,27025527.75,201.0,201.0,0,0,0.0,0.0,0.0
4548.0,17,2,626,1,72,0.0,72.0,72.0,1,554,0.0,554.0,554.0
231448.0,17,2,180,1,90,0.0,90.0,90.0,1,90,0.0,90.0,90.0
405.0,17,2,410,1,78,0.0,78.0,78.0,1,332,0.0,332.0,332.0
312975.0,17,4,1400,4,1400,104325.0,350.0,350.0,0,0,0.0,0.0,0.0
308927.0,6,3,202,2,128,0.0,74.0,64.0,1,74,0.0,74.0,74.0
329.0,17,2,208,1,72,0.0,72.0,72.0,1,136,0.0,136.0,136.0
34051.0,6,14,4740,7,653,5364.0,249.0,93.28571428571428,7,4087,5277.833333333333,1514.0,583.8571428571429
303619.0,6,2,132,1,66,0.0,66.0,66.0,1,66,0.0,66.0,66.0
114561599.0,6,31,2229,16,1212,7637439.933333334,123.0,75.75,15,1017,7605675.357142857,123.0,67.8
20111.0,6,10,2032,5,524,4774.25,252.0,104.8,5,1508,4702.25,1236.0,301.6
246116.0,6,3,337,2,214,0.0,160.0,107.0,1,123,0.0,123.0,123.0
267394.0,17,2,180,1,90,0.0,90.0,90.0,1,90,0.0,90.0,90.0
303540.0,6,6,412,4,272,101180.0,74.0,68.0,2,140,0.0,74.0,70.0
216864.0,6,3,426,2,280,0.0,214.0,140.0,1,146,0.0,146.0,146.0
25508.0,6,14,4740,7,653,4071.0,249.0,93.28571428571428,7,4087,3657.6666666666665,1514.0,583.8571428571429
115572944.0,6,240,27606,120,19390,969392.319327731,284.0,161.58333333333334,120,8216,969392.7226890756,140.0,68.46666666666667
309957.0,6,6,412,4,272,103319.0,74.0,68.0,2,140,0.0,74.0,70.0
205916.0,6,3,426,2,280,0.0,214.0,140.0,1,146,0.0,146.0,146.0
32811.0,6,14,4740,7,653,5078.666666666667,249.0,93.28571428571428,7,4087,5028.333333333333,1514.0,583.8571428571429
217982.0,6,3,426,2,280,0.0,214.0,140.0,1,146,0.0,146.0,146.0
409.0,17,2,410,1,78,0.0,78.0,78.0,1,332,0.0,332.0,332.0
207084.0,6,3,426,2,280,0.0,214.0,140.0,1,146,0.0,146.0,146.0
2413.0,17,4,344,2,150,0.0,75.0,75.0,2,194,0.0,103.0,97.0
298181.0,6,6,412,4,272,99393.66666666669,74.0,68.0,2,140,0.0,74.0,70.0
284270.0,6,10,1221,6,636,56854.0,298.0,106.0,4,585,88991.0,379.0,146.25
109153160.0,17,14,864,7,432,18166834.0,174.0,61.71428571428572,7,432,18167448.33333333,174.0,61.71428571428572
3190.0,17,2,224,1,76,0.0,76.0,76.0,1,148,0.0,148.0,148.0
95440172.0,6,29,2068,15,1105,6802548.714285715,139.0,73.66666666666667,14,963,7325819.307692308,123.0,68.78571428571429
283443.0,17,4,1524,4,1524,94481.0,381.0,381.0,0,0,0.0,0.0,0.0
101349527.0,17,14,864,7,432,16834327.333333332,174.0,61.71428571428572,7,432,16833489.833333332,174.0,61.71428571428572
620416.0,6,4,508,2,238,0.0,172.0,119.0,2,270,0.0,135.0,135.0
108097226.0,17,5,955,5,955,27024306.5,191.0,191.0,0,0,0.0,0.0,0.0
367.0,17,2,267,1,83,0.0,83.0,83.0,1,184,0.0,184.0,184.0
120157238.0,6,14,2102,6,1086,24031447.6,204.0,181.0,8,1016,17136735.0,188.0,127.0
80781.0,6,12,1413,7,882,13463.5,291.0,126.0,5,531,17438.25,259.0,106.2
34986.0,6,10,2032,5,524,8492.0,252.0,104.8,5,1508,8462.25,1236.0,301.6
112414844.0,6,31,2182,16,1165,7479909.466666667,139.0,72.8125,15,1017,8014047.357142857,123.0,67.8
209537.0,17,2,180,1,90,0.0,90.0,90.0,1,90,0.0,90.0,90.0
29545.0,6,10,2032,5,524,7167.75,252.0,104.8,5,1508,7146.75,1236.0,301.6
514262.0,6,3,1777,2,951,0.0,885.0,475.5,1,826,0.0,826.0,826.0
2359.0,17,4,344,2,150,0.0,75.0,75.0,2,194,0.0,103.0,97.0
841400.0,6,9,1118,6,586,168280.0,248.0,97.66666666666669,3,532,284416.5,392.0,177.33333333333334
217921.0,6,3,426,2,280,0.0,214.0,140.0,1,146,0.0,146.0,146.0
2798862.0,6,2,132,1,66,0.0,66.0,66.0,1,66,0.0,66.0,66.0
10862547.0,6,7,478,3,206,5363263.5,74.0,68.66666666666667,4,272,3575437.0,74.0,68.0
0.0,6,1,66,1,66,0.0,66.0,66.0,0,0,0.0,0.0,0.0
104869613.0,17,15,5130,15,5130,7490686.642857143,342.0,342.0,0,0,0.0,0.0,0.0
1313605.0,6,4,264,2,132,0.0,66.0,66.0,2,132,0.0,66.0,66.0
32736.0,6,13,1394,7,797,5456.0,253.0,113.85714285714286,6,597,5555.6,259.0,99.5
108103369.0,17,5,1005,5,1005,27025842.25,201.0,201.0,0,0,0.0,0.0,0.0
16324.000000000002,6,12,1393,6,796,2853.8,271.0,132.66666666666666,6,597,2992.0,259.0,99.5
27509.0,6,10,2032,5,524,6086.75,252.0,104.8,5,1508,6111.25,1236.0,301.6
90313459.0,6,16,1192,8,596,12894052.42857143,95.0,74.5,8,596,12901242.857142856,95.0,74.5
128027721.0,6,31,2034,16,1086,8535181.4,123.0,67.875,15,948,8416119.357142856,123.0,63.2
245956.0,6,10,1221,6,636,49191.2,298.0,106.0,4,585,80393.66666666667,379.0,146.25
300.0,17,2,174,1,79,0.0,79.0,79.0,1,95,0.0,95.0,95.0
5627625.0,6,5,336,2,134,0.0,68.0,67.0,3,202,1420346.5,70.0,67.33333333333333
219298.0,6,3,426,2,280,0.0,214.0,140.0,1,146,0.0,146.0,146.0
110624553.0,6,30,1990,15,1042,7886344.357142857,139.0,69.46666666666667,15,948,7886343.142857143,123.0,63.2
108110195.0,17,5,955,5,955,27027548.75,191.0,191.0,0,0,0.0,0.0,0.0
102947.0,17,2,762,2,762,0.0,381.0,381.0,0,0,0.0,0.0,0.0
5829859.0,6,5,336,2,134,0.0,68.0,67.0,3,202,1519996.0,70.0,67.33333333333333
197370.0,17,2,180,1,90,0.0,90.0,90.0,1,90,0.0,90.0,90.0
380049.0,6,3,204,2,136,0.0,70.0,68.0,1,68,0.0,68.0,68.0
246875.0,6,3,337,2,214,0.0,160.0,107.0,1,123,0.0,123.0,123.0
143932.0,17,2,180,1,90,0.0,90.0,90.0,1,90,0.0,90.0,90.0
120050177.0,17,29,13785,29,13785,4287506.321428572,501.0,475.3448275862069,0,0,0.0,0.0,0.0
53058.0,6,13,1479,7,882,8843.0,291.0,126.0,6,597,6229.4,259.0,99.5
228479.0,17,2,180,1,90,0.0,90.0,90.0,1,90,0.0,90.0,90.0
34841.0,6,14,4740,7,653,4607.166666666667,249.0,93.28571428571428,7,4087,5591.0,1514.0,583.8571428571429
28922.0,6,10,2032,5,524,6863.75,252.0,104.8,5,1508,6837.75,1236.0,301.6
239601.0,17,4,1400,4,1400,79867.0,350.0,350.0,0,0,0.0,0.0,0.0
352.0,17,2,267,1,83,0.0,83.0,83.0,1,184,0.0,184.0,184.0
9725.0,17,4,823,2,163,0.0,89.0,81.5,2,660,0.0,443.0,330.0
90034276.0,17,27,12943,27,12943,3462856.769230769,501.0,479.3703703703704,0,0,0.0,0.0,0.0
675.0,17,4,438,2,148,0.0,74.0,74.0,2,290,0.0,147.0,145.0
90094306.0,6,10,1440,7,828,15015717.666666666,188.0,118.28571428571428,3,612,30029099.5,204.0,204.0
10473061.0,6,7,478,4,272,3444065.0,74.0,68.0,3,206,5165981.0,74.0,68.66666666666667
90288063.0,6,19,1436,10,745,10026594.888888888,95.0,74.5,9,691,11285456.375,95.0,76.77777777777777
2815755.0,6,3,1604,1,753,0.0,753.0,753.0,2,851,0.0,785.0,425.5
3237159.0,6,7,923,4,753,1010652.0,571.0,188.25,3,170,1515812.5,62.0,56.66666666666666
429.0,17,2,267,1,83,0.0,83.0,83.0,1,184,0.0,184.0,184.0
57306.0,6,14,4740,7,653,8957.833333333334,249.0,93.28571428571428,7,4087,9407.833333333334,1514.0,583.8571428571429
304421.0,17,2,363,1,79,0.0,79.0,79.0,1,284,0.0,284.0,284.0
847997.0,6,9,1118,6,586,169599.4,248.0,97.66666666666669,3,532,286150.0,392.0,177.33333333333334
104015580.0,17,14,864,7,432,17335632.0,174.0,61.71428571428572,7,432,17333490.333333332,174.0,61.71428571428572
36737.0,6,14,4740,7,653,4945.333333333333,249.0,93.28571428571428,7,4087,5564.0,1514.0,583.8571428571429
18014.0,17,4,344,2,150,0.0,75.0,75.0,2,194,0.0,103.0,97.0
29415.0,6,12,1320,6,723,5735.2,253.0,120.5,6,597,5552.6,259.0,99.5
303654.0,6,3,202,2,128,0.0,74.0,64.0,1,74,0.0,74.0,74.0
3621.0,17,4,407,2,144,0.0,72.0,72.0,2,263,0.0,136.0,131.5
50486.0,6,14,4740,7,653,7457.166666666667,249.0,93.28571428571428,7,4087,7786.5,1514.0,583.8571428571429
118319987.0,6,229,25838,115,7886,1037894.6228070176,140.0,68.57391304347826,114,17952,1037803.7168141592,284.0,157.47368421052633
100257183.0,17,13,821,7,432,16666806.666666666,174.0,61.71428571428572,6,389,20001372.4,174.0,64.83333333333333
27548.0,6,10,2032,5,524,5973.75,252.0,104.8,5,1508,6601.5,1236.0,301.6
39684.0,6,10,2032,5,524,8955.25,252.0,104.8,5,1508,9013.5,1236.0,301.6
113198211.0,17,12,778,6,389,18802925.0,174.0,64.83333333333333,6,389,18800831.8,174.0,64.83333333333333
147423.0,6,3,337,2,214,0.0,160.0,107.0,1,123,0.0,123.0,123.0
196924.0,17,2,180,1,90,0.0,90.0,90.0,1,90,0.0,90.0,90.0
216862.0,6,3,426,2,280,0.0,214.0,140.0,1,146,0.0,146.0,146.0
509699.0,6,10,1221,6,636,101939.8,298.0,106.0,4,585,164371.0,379.0,146.25
123448.0,6,14,4740,7,653,20446.0,249.0,93.28571428571428,7,4087,20175.5,1514.0,583.8571428571429
103001475.0,17,13,821,7,432,17166912.5,174.0,61.71428571428572,6,389,20029488.4,174.0,64.83333333333333
411145.0,6,4,508,2,238,0.0,172.0,119.0,2,270,0.0,135.0,135.0
2410.0,17,4,344,2,150,0.0,75.0,75.0,2,194,0.0,103.0,97.0
28606.0,6,13,1459,7,862,3844.8333333333335,271.0,123.14285714285714,6,597,4522.6,259.0,99.5
358.0,17,2,166,1,75,0.0,75.0,75.0,1,91,0.0,91.0,91.0
135129980.0,17,6,1146,6,1146,27025996.0,191.0,191.0,0,0,0.0,0.0,0.0
56856.0,6,10,2032,5,524,13705.25,252.0,104.8,5,1508,12987.75,1236.0,301.6
45940.0,6,10,2032,5,524,10364.0,252.0,104.8,5,1508,11152.75,1236.0,301.6
308610.0,6,6,412,4,272,102870.0,74.0,68.0,2,140,0.0,74.0,70.0
108100152.0,17,5,1005,5,1005,27025038.0,201.0,201.0,0,0,0.0,0.0,0.0
529.0,17,2,508,2,508,0.0,257.0,254.0,0,0,0.0,0.0,0.0
143785.0,6,12,1354,6,723,26974.0,253.0,120.5,6,631,28437.8,293.0,105.16666666666669
327545.0,17,4,1400,4,1400,109181.66666666669,350.0,350.0,0,0,0.0,0.0,0.0
135125682.0,17,6,1146,6,1146,27025136.4,191.0,191.0,0,0,0.0,0.0,0.0
5624662.0,6,5,336,2,134,0.0,68.0,67.0,3,202,1526965.5,70.0,67.33333333333333
146186.0,6,3,337,2,214,0.0,160.0,107.0,1,123,0.0,123.0,123.0
1386.0,17,5,550,5,550,346.5,110.0,110.0,0,0,0.0,0.0,0.0
1312564.0,6,4,264,2,132,0.0,66.0,66.0,2,132,0.0,66.0,66.0
50136.0,6,10,2032,5,524,9055.5,252.0,104.8,5,1508,9893.5,1236.0,301.6
91745687.0,6,26,1746,13,906,7627447.083333333,123.0,69.6923076923077,13,840,7627293.0,123.0,64.61538461538461
2288.0,17,4,344,2,150,0.0,75.0,75.0,2,194,0.0,103.0,97.0
210828.0,17,2,180,1,90,0.0,90.0,90.0,1,90,0.0,90.0,90.0
859416.0,6,9,1270,6,799,171883.2,461.0,133.16666666666666,3,471,291906.5,331.0,157.0
308486.0,6,6,412,4,272,102828.66666666669,74.0,68.0,2,140,0.0,74.0,70.0
4528.0,17,2,617,1,78,0.0,78.0,78.0,1,539,0.0,539.0,539.0
1444.0,17,2,762,2,762,0.0,381.0,381.0,0,0,0.0,0.0,0.0
233021.0,6,3,337,2,214,0.0,160.0,107.0,1,123,0.0,123.0,123.0
4316.0,17,2,602,1,72,0.0,72.0,72.0,1,530,0.0,530.0,530.0
43746.0,6,14,4740,7,653,6354.833333333333,249.0,93.28571428571428,7,4087,7154.833333333333,1514.0,583.8571428571429
70973.0,6,11,2098,6,590,14015.4,252.0,98.33333333333331,5,1508,17470.75,1236.0,301.6
153426.0,17,2,180,1,90,0.0,90.0,90.0,1,90,0.0,90.0,90.0
90014807.0,17,28,13364,28,13364,3333881.7407407407,501.0,477.2857142857143,0,0,0.0,0.0,0.0
21871.0,6,11,2098,6,590,4136.0,252.0,98.33333333333331,5,1508,5229.0,1236.0,301.6
120022002.0,17,28,13364,28,13364,4445259.333333333,501.0,477.2857142857143,0,0,0.0,0.0,0.0
135135643.0,17,6,1146,6,1146,27027128.6,191.0,191.0,0,0,0.0,0.0,0.0
143965.0,17,2,180,1,90,0.0,90.0,90.0,1,90,0.0,90.0,90.0
208653.0,17,2,762,2,762,0.0,381.0,381.0,0,0,0.0,0.0,0.0
52670.0,6,14,4740,7,653,8616.5,249.0,93.28571428571428,7,4087,8267.166666666666,1514.0,583.8571428571429
51326.0,6,14,4740,7,653,7468.666666666667,249.0,93.28571428571428,7,4087,8215.166666666666,1514.0,583.8571428571429
238430.0,6,4,439,2,238,0.0,172.0,119.0,2,201,0.0,135.0,100.5
105564.0,6,11,2098,6,590,20848.0,252.0,98.33333333333331,5,1508,25981.75,1236.0,301.6
38897.0,6,10,2032,5,524,9278.75,252.0,104.8,5,1508,9446.0,1236.0,301.6
34161.0,6,14,4740,7,653,4817.833333333333,249.0,93.28571428571428,7,4087,5376.333333333333,1514.0,583.8571428571429
243993.0,6,3,337,2,214,0.0,160.0,107.0,1,123,0.0,123.0,123.0
120240771.0,6,19,1395,10,745,13333036.0,95.0,74.5,9,650,14999996.75,95.0,72.22222222222223
46134.0,6,10,2032,5,524,10872.0,252.0,104.8,5,1508,9927.25,1236.0,301.6
48436.0,6,10,2032,5,524,11878.25,252.0,104.8,5,1508,11375.0,1236.0,301.6
90051683.0,17,28,13364,28,13364,3335247.5185185187,501.0,477.2857142857143,0,0,0.0,0.0,0.0
2061276.0,6,25,7610,13,2516,171773.0,1034.0,193.53846153846155,12,5094,159647.36363636365,1510.0,424.5
19587.0,6,2,145,2,145,0.0,91.0,72.5,0,0,0.0,0.0,0.0
55930.0,6,10,1066,5,490,10543.75,218.0,98.0,5,576,12450.25,304.0,115.2
119685096.0,6,2434,2125580,757,49962,158313.61904761905,66.0,66.0,1677,2075618,71387.68377088306,1514.0,1237.6970781156829
2021.0,17,4,344,2,150,0.0,75.0,75.0,2,194,0.0,103.0,97.0
26293.0,6,14,4740,7,653,3687.0,249.0,93.28571428571428,7,4087,4243.833333333333,1514.0,583.8571428571429
90098423.0,6,12,1848,5,1020,22524248.0,204.0,204.0,7,828,14970079.833333334,188.0,118.28571428571428
108110718.0,17,5,1005,5,1005,27027679.5,201.0,201.0,0,0,0.0,0.0,0.0
301181.0,17,2,180,1,90,0.0,90.0,90.0,1,90,0.0,90.0,90.0
10435645.0,6,6,412,3,206,5150157.0,74.0,68.66666666666667,3,206,5150071.5,74.0,68.66666666666667
108102697.0,17,5,955,5,955,27025674.25,191.0,191.0,0,0,0.0,0.0,0.0
216821.0,6,3,426,2,280,0.0,214.0,140.0,1,146,0.0,146.0,146.0
99000790.0,17,13,1083,7,563,16500131.666666666,174.0,80.42857142857143,6,520,15802802.0,174.0,86.66666666666667
120140392.0,6,262,30260,131,8868,892061.4,140.0,67.69465648854961,131,21392,917894.6692307692,300.0,163.29770992366412
782.0,17,4,438,2,148,0.0,74.0,74.0,2,290,0.0,147.0,145.0
120004006.0,6,22,1680,11,840,12000400.6,95.0,76.36363636363636,11,840,9001180.0,95.0,76.36363636363636
98446674.0,6,40,2640,20,1320,5181403.894736842,66.0,66.0,20,1320,5165113.368421053,66.0,66.0
120123215.0,6,13,2020,9,1204,15015401.875,188.0,133.77777777777777,4,816,30031116.666666668,204.0,204.0
135137056.0,17,6,1146,6,1146,27027411.2,191.0,191.0,0,0,0.0,0.0,0.0
217073.0,6,10,1221,6,636,43414.6,298.0,106.0,4,585,71338.0,379.0,146.25
1017201.0,6,11,1134,6,558,203440.2,220.0,93.0,5,576,253759.25,304.0,115.2
296503.0,17,2,180,1,90,0.0,90.0,90.0,1,90,0.0,90.0,90.0
55242.0,6,11,2098,6,590,10532.6,252.0,98.33333333333331,5,1508,12257.5,1236.0,301.6
16899.0,6,14,4740,7,653,2650.1666666666665,249.0,93.28571428571428,7,4087,2631.333333333333,1514.0,583.8571428571429
1890.0,17,2,176,1,80,0.0,80.0,80.0,1,96,0.0,96.0,96.0
15664.0,6,11,1132,6,556,2921.4,218.0,92.66666666666669,5,576,3066.0,304.0,115.2
95.0,17,2,762,2,762,0.0,381.0,381.0,0,0,0.0,0.0,0.0
2000982.0,6,19,6869,10,1501,222331.3333333333,408.0,150.1,9,5368,202940.75,1514.0,596.4444444444445
302062.0,6,6,412,4,272,100687.33333333331,74.0,68.0,2,140,0.0,74.0,70.0
99009083.0,17,14,1126,7,563,16501513.833333334,174.0,80.42857142857143,7,563,16333499.166666666,174.0,80.42857142857143
2591799.0,6,2,132,1,66,0.0,66.0,66.0,1,66,0.0,66.0,66.0
511597.0,6,5,336,2,134,0.0,68.0,67.0,3,202,196019.0,70.0,67.33333333333333
845486.0,6,9,1096,6,625,169097.2,287.0,104.16666666666669,3,471,284879.5,331.0,157.0
116632770.0,6,47,3102,24,1584,5057328.434782608,66.0,66.0,23,1518,5155444.7727272725,66.0,66.0
146380.0,6,3,337,2,214,0.0,160.0,107.0,1,123,0.0,123.0,123.0
1299714.0,6,4,264,2,132,0.0,66.0,66.0,2,132,0.0,66.0,66.0
46134.0,6,12,1320,6,723,8594.0,253.0,120.5,6,597,4948.2,259.0,99.5
3643.0,17,4,571,2,148,0.0,74.0,74.0,2,423,0.0,280.0,211.5
116940198.0,6,48,3168,24,1584,5084356.434782608,66.0,66.0,24,1584,5071090.782608695,66.0,66.0
106241606.0,6,29,2068,15,1105,7573266.428571428,139.0,73.66666666666667,14,963,8155818.0,123.0,68.78571428571429
29878.0,6,14,4740,7,653,4207.666666666667,249.0,93.28571428571428,7,4087,4814.0,1514.0,583.8571428571429
228900.0,17,4,1524,4,1524,76300.0,381.0,381.0,0,0,0.0,0.0,0.0
153359.0,17,2,180,1,90,0.0,90.0,90.0,1,90,0.0,90.0,90.0
146271.0,6,3,337,2,214,0.0,160.0,107.0,1,123,0.0,123.0,123.0
298150.0,6,6,412,4,272,99383.33333333331,74.0,68.0,2,140,0.0,74.0,70.0
90533507.0,6,15,2444,8,1016,12933358.142857144,188.0,127.0,7,1428,15061635.333333334,204.0,204.0
33021.0,6,14,4740,7,653,5346.166666666667,249.0,93.28571428571428,7,4087,5212.666666666667,1514.0,583.8571428571429
2729237.0,6,3,1604,1,753,0.0,753.0,753.0,2,851,0.0,785.0,425.5
501161.0,6,2,145,2,145,0.0,91.0,72.5,0,0,0.0,0.0,0.0
2416.0,17,4,344,2,150,0.0,75.0,75.0,2,194,0.0,103.0,97.0
125834085.0,6,59,12315,29,6427,3433321.285714286,1514.0,221.6206896551724,30,5888,4331650.344827586,1514.0,196.26666666666668
4376.0,17,2,602,1,72,0.0,72.0,72.0,1,530,0.0,530.0,530.0
12059.0,17,4,823,2,163,0.0,89.0,81.5,2,660,0.0,443.0,330.0
479215.0,6,5,336,2,134,0.0,68.0,67.0,3,202,193034.0,70.0,67.33333333333333
91386110.0,6,22,1680,12,935,8306744.727272727,95.0,77.91666666666667,10,745,10152561.666666666,95.0,74.5
263558.0,6,3,337,2,214,0.0,160.0,107.0,1,123,0.0,123.0,123.0
100142066.0,17,14,864,7,432,16668069.0,174.0,61.71428571428572,7,432,16666807.5,174.0,61.71428571428572
303686.0,6,6,412,4,272,101228.66666666669,74.0,68.0,2,140,0.0,74.0,70.0
124441365.0,17,15,1038,8,606,17777337.85714286,174.0,75.75,7,432,17500170.833333332,174.0,61.71428571428572
135129771.0,17,6,1146,6,1146,27025954.2,191.0,191.0,0,0,0.0,0.0,0.0
120473.0,6,12,1447,6,816,22749.2,291.0,136.0,6,631,22675.4,293.0,105.16666666666669
217793.0,6,3,426,2,280,0.0,214.0,140.0,1,146,0.0,146.0,146.0
67231564.0,6,19,1334,9,640,8402722.875,95.0,71.11111111111111,10,694,7468665.333333333,95.0,69.4
108107653.0,17,5,1005,5,1005,27026913.25,201.0,201.0,0,0,0.0,0.0,0.0
19750.0,6,14,4740,7,653,3138.5,249.0,93.28571428571428,7,4087,2874.0,1514.0,583.8571428571429
41230.0,6,13,1386,7,789,6622.166666666667,253.0,112.71428571428572,6,597,7353.8,259.0,99.5
28678.0,6,14,4740,7,653,4656.166666666667,249.0,93.28571428571428,7,4087,4638.833333333333,1514.0,583.8571428571429
310706.0,6,6,412,4,272,103568.66666666669,74.0,68.0,2,140,0.0,74.0,70.0
143901.0,17,2,180,1,90,0.0,90.0,90.0,1,90,0.0,90.0,90.0
90529461.0,6,14,2240,8,1016,12932780.142857144,188.0,127.0,6,1224,18072665.6,204.0,204.0
120159680.0,6,242,27480,121,8282,994477.4,140.0,68.44628099173553,121,19198,994477.3916666668,390.0,158.6611570247934
506368.00000000006,6,5,336,2,134,0.0,68.0,67.0,3,202,194536.5,70.0,67.33333333333333
90306075.0,6,16,1192,8,596,12894464.857142856,95.0,74.5,8,596,12898800.857142856,95.0,74.5
34435.0,6,14,4740,7,653,5512.5,249.0,93.28571428571428,7,4087,5482.5,1514.0,583.8571428571429
108105479.0,17,5,955,5,955,27026369.75,191.0,191.0,0,0,0.0,0.0,0.0
2867118.0,6,3,1602,2,850,0.0,784.0,425.0,1,752,0.0,752.0,752.0
97609908.0,6,26,1746,13,906,8116181.416666667,123.0,69.6923076923077,13,840,8116186.166666667,123.0,64.61538461538461
223426.0,6,3,426,2,280,0.0,214.0,140.0,1,146,0.0,146.0,146.0
324222.0,17,2,176,1,80,0.0,80.0,80.0,1,96,0.0,96.0,96.0
132001112.0,17,16,1212,9,649,16500139.0,174.0,72.11111111111111,7,563,15470843.0,174.0,80.42857142857143
149721.0,17,2,180,1,90,0.0,90.0,90.0,1,90,0.0,90.0,90.0
48762.0,6,14,4740,7,653,7960.5,249.0,93.28571428571428,7,4087,7201.333333333333,1514.0,583.8571428571429
97630816.0,6,26,1746,13,906,8117914.25,123.0,69.6923076923077,13,840,8117919.083333333,123.0,64.61538461538461
32952.0,6,14,4740,7,653,5347.666666666667,249.0,93.28571428571428,7,4087,5286.333333333333,1514.0,583.8571428571429
31347.0,6,10,2032,5,524,5434.25,252.0,104.8,5,1508,7497.5,1236.0,301.6
5453.0,17,4,344,2,150,0.0,75.0,75.0,2,194,0.0,103.0,97.0
49256.0,6,10,2032,5,524,12072.25,252.0,104.8,5,1508,11694.25,1236.0,301.6
98308.0,17,2,762,2,762,0.0,381.0,381.0,0,0,0.0,0.0,0.0
35904.0,6,14,4740,7,653,5843.833333333333,249.0,93.28571428571428,7,4087,5327.166666666667,1514.0,583.8571428571429
42673.0,6,14,4740,7,653,6927.5,249.0,93.28571428571428,7,4087,5473.666666666667,1514.0,583.8571428571429
1098697.0,6,13,1386,7,789,183116.16666666663,253.0,112.71428571428572,6,597,218851.6,259.0,99.5
135134207.0,17,6,1206,6,1206,27026841.4,201.0,201.0,0,0,0.0,0.0,0.0
246297.0,6,3,337,2,214,0.0,160.0,107.0,1,123,0.0,123.0,123.0
153452.0,17,2,180,1,90,0.0,90.0,90.0,1,90,0.0,90.0,90.0
136247.0,6,11,2098,6,590,27040.4,252.0,98.33333333333331,5,1508,33569.5,1236.0,301.6
36006176.0,6,14,982,6,437,7194831.6,95.0,72.83333333333333,8,545,5143172.428571428,95.0,68.125
97990380.0,17,11,735,6,389,19598076.0,174.0,64.83333333333333,5,346,19500158.75,174.0,69.2
100073407.0,17,13,1083,7,563,16652220.333333334,174.0,80.42857142857143,6,520,19982662.2,174.0,86.66666666666667
55148.0,6,14,4740,7,653,6807.666666666667,249.0,93.28571428571428,7,4087,8714.5,1514.0,583.8571428571429
90045262.0,17,28,13364,28,13364,3335009.703703704,501.0,477.2857142857143,0,0,0.0,0.0,0.0
108113519.0,17,5,1005,5,1005,27028379.75,201.0,201.0,0,0,0.0,0.0,0.0
320.0,17,2,160,1,80,0.0,80.0,80.0,1,80,0.0,80.0,80.0
10510203.0,6,7,478,4,272,3457910.6666666665,74.0,68.0,3,206,5186784.0,74.0,68.66666666666667
108107767.0,17,5,1005,5,1005,27026941.75,201.0,201.0,0,0,0.0,0.0,0.0
111022256.0,6,30,1974,15,1026,7914728.571428572,123.0,68.4,15,948,7914728.714285715,123.0,63.2
27404917.0,17,5,1710,5,1710,6851229.25,342.0,342.0,0,0,0.0,0.0,0.0
40001.0,6,14,4740,7,653,6483.333333333333,249.0,93.28571428571428,7,4087,6252.333333333333,1514.0,583.8571428571429
136747.0,17,2,176,1,80,0.0,80.0,80.0,1,96,0.0,96.0,96.0
108103148.0,17,5,1005,5,1005,27025787.0,201.0,201.0,0,0,0.0,0.0,0.0
218009.0,6,3,426,2,280,0.0,214.0,140.0,1,146,0.0,146.0,146.0
308019.0,6,6,412,4,272,102673.0,74.0,68.0,2,140,0.0,74.0,70.0
233870.0,6,3,373,2,238,0.0,172.0,119.0,1,135,0.0,135.0,135.0
100260327.0,17,12,778,6,389,20052065.4,174.0,64.83333333333333,6,389,19953229.0,174.0,64.83333333333333
2119.0,17,4,344,2,150,0.0,75.0,75.0,2,194,0.0,103.0,97.0
120039132.0,17,28,13364,28,13364,4445893.777777778,501.0,477.2857142857143,0,0,0.0,0.0,0.0
113561593.0,6,30,1974,15,1026,8096110.285714285,123.0,68.4,15,948,8096124.714285715,123.0,63.2
146178.0,6,2,132,1,66,0.0,66.0,66.0,1,66,0.0,66.0,66.0
302278.0,6,6,412,4,272,100759.33333333331,74.0,68.0,2,140,0.0,74.0,70.0
30701.0,6,10,2032,5,524,7365.25,252.0,104.8,5,1508,6682.0,1236.0,301.6
388028.0,6,6,412,4,272,129342.66666666669,74.0,68.0,2,140,0.0,74.0,70.0
246959.0,17,2,180,1,90,0.0,90.0,90.0,1,90,0.0,90.0,90.0
108108079.0,17,5,955,5,955,27027019.75,191.0,191.0,0,0,0.0,0.0,0.0
90053146.0,17,28,13364,28,13364,3335301.703703704,501.0,477.2857142857143,0,0,0.0,0.0,0.0
99040987.0,6,28,2008,14,963,7618537.461538462,123.0,68.78571428571429,14,1045,7192049.846153846,139.0,74.64285714285714
2160.0,17,2,691,1,349,0.0,349.0,349.0,1,342,0.0,342.0,342.0
90078228.0,17,28,13364,28,13364,3336230.6666666665,501.0,477.2857142857143,0,0,0.0,0.0,0.0
73596.0,6,14,4740,7,653,12117.666666666666,249.0,93.28571428571428,7,4087,12092.0,1514.0,583.8571428571429
319627.0,6,6,412,4,272,106542.33333333331,74.0,68.0,2,140,0.0,74.0,70.0
48262.0,6,14,4740,7,653,7512.5,249.0,93.28571428571428,7,4087,7825.5,1514.0,583.8571428571429
51524298.0,6,8,2113,3,960,24539363.0,826.0,320.0,5,1153,12237019.75,885.0,230.6
108107163.0,17,5,955,5,955,27026790.75,191.0,191.0,0,0,0.0,0.0,0.0
787105.0,6,6,758,3,410,368028.5,172.0,136.66666666666666,3,348,268744.0,135.0,116.0
2155966.0,6,37,15535,19,10912,119775.88888888888,1514.0,574.3157894736842,18,4623,113561.88235294116,1514.0,256.8333333333333
120846.0,6,3,373,2,238,0.0,172.0,119.0,1,135,0.0,135.0,135.0
1043994.0,6,11,1134,6,558,208798.8,220.0,93.0,5,576,260402.25,304.0,115.2
333.0,17,2,166,1,75,0.0,75.0,75.0,1,91,0.0,91.0,91.0
312.0,17,2,168,1,76,0.0,76.0,76.0,1,92,0.0,92.0,92.0
360.0,17,2,267,1,83,0.0,83.0,83.0,1,184,0.0,184.0,184.0
2463705.0,6,2,132,1,66,0.0,66.0,66.0,1,66,0.0,66.0,66.0
90526740.0,6,14,2240,8,1016,12932391.42857143,188.0,127.0,6,1224,18072874.8,204.0,204.0
90097605.0,6,13,2052,6,1224,18018994.8,204.0,204.0,7,828,14970102.333333334,188.0,118.28571428571428
1046485.0,6,11,1134,6,558,209297.0,220.0,93.0,5,576,259308.25,304.0,115.2
0.0,6,1,66,0,0,0.0,0.0,0.0,1,66,0.0,66.0,66.0
29613.0,6,14,4740,7,653,4805.333333333333,249.0,93.28571428571428,7,4087,4744.0,1514.0,583.8571428571429
135141339.0,17,6,1206,6,1206,27028267.8,201.0,201.0,0,0,0.0,0.0,0.0
92708051.0,6,37,2442,19,1254,5150447.277777778,66.0,66.0,18,1188,5080742.352941177,66.0,66.0
0.0,17,1,72,1,72,0.0,72.0,72.0,0,0,0.0,0.0,0.0
90005205.0,6,20,1490,10,745,10000578.333333334,95.0,74.5,10,745,9976244.555555556,95.0,74.5
90903429.0,6,21,1585,11,840,9089866.2,95.0,76.36363636363636,10,745,10099174.0,95.0,74.5
2299.0,17,4,344,2,150,0.0,75.0,75.0,2,194,0.0,103.0,97.0
42649.0,6,12,1320,6,723,7560.8,253.0,120.5,6,597,7419.8,259.0,99.5
1168851.0,6,13,3010,8,2382,166978.7142857143,1514.0,297.75,5,628,223326.25,331.0,125.6
2009.0,17,4,344,2,150,0.0,75.0,75.0,2,194,0.0,103.0,97.0
1450.0,17,2,762,2,762,0.0,381.0,381.0,0,0,0.0,0.0,0.0
91142095.0,6,26,1746,13,906,7577170.0,123.0,69.6923076923077,13,840,7577167.833333333,123.0,64.61538461538461
27341961.0,17,5,1710,5,1710,6835490.25,342.0,342.0,0,0,0.0,0.0,0.0
330.0,17,2,166,1,75,0.0,75.0,75.0,1,91,0.0,91.0,91.0
206491.0,17,2,180,1,90,0.0,90.0,90.0,1,90,0.0,90.0,90.0
317235.0,17,4,1400,4,1400,105745.0,350.0,350.0,0,0,0.0,0.0,0.0
108109389.0,17,5,955,5,955,27027347.25,191.0,191.0,0,0,0.0,0.0,0.0
27215.0,6,10,2032,5,524,6183.25,252.0,104.8,5,1508,5788.75,1236.0,301.6
307102.0,6,6,412,4,272,102367.33333333331,74.0,68.0,2,140,0.0,74.0,70.0
142743.0,6,2,132,1,66,0.0,66.0,66.0,1,66,0.0,66.0,66.0
218917.0,6,3,426,2,280,0.0,214.0,140.0,1,146,0.0,146.0,146.0
30260.0,6,10,2032,5,524,7342.25,252.0,104.8,5,1508,7032.0,1236.0,301.6
118272407.0,6,48,3168,24,1584,5142278.565217392,66.0,66.0,24,1584,5129028.173913044,66.0,66.0
143907.0,17,2,180,1,90,0.0,90.0,90.0,1,90,0.0,90.0,90.0
1415749.0,17,16,1120,16,1120,94383.26666666666,70.0,70.0,0,0,0.0,0.0,0.0
90256882.0,6,12,1832,8,1016,12893840.285714284,188.0,127.0,4,816,30031021.33333333,204.0,204.0
28436.0,6,14,4740,7,653,4543.833333333333,249.0,93.28571428571428,7,4087,4595.5,1514.0,583.8571428571429
90256064.0,6,12,1832,8,1016,12893723.42857143,188.0,127.0,4,816,30030676.33333333,204.0,204.0
24505.0,6,10,2032,5,524,5338.5,252.0,104.8,5,1508,5311.0,1236.0,301.6
18955.0,6,14,4740,7,653,2879.1666666666665,249.0,93.28571428571428,7,4087,3021.5,1514.0,583.8571428571429
92517579.0,6,25,1692,13,906,7691812.75,123.0,69.6923076923077,12,786,8391070.272727273,123.0,65.5
105137899.0,17,14,1126,7,563,17473730.5,174.0,80.42857142857143,7,563,17496300.5,174.0,80.42857142857143
2379.0,17,4,344,2,150,0.0,75.0,75.0,2,194,0.0,103.0,97.0
248367.0,6,3,337,2,214,0.0,160.0,107.0,1,123,0.0,123.0,123.0
15141.0,6,13,1459,7,862,2330.333333333333,271.0,123.14285714285714,6,597,2789.4,259.0,99.5
120463519.0,6,21,1585,11,840,9043022.9,95.0,76.36363636363636,10,745,13379354.222222222,95.0,74.5
120178911.0,6,228,25984,114,7746,1056173.07079646,140.0,67.94736842105263,114,18238,1056239.628318584,336.0,159.98245614035088
22799.0,6,11,1133,6,602,4298.4,264.0,100.33333333333331,5,531,5094.0,259.0,106.2
146156.0,6,3,337,2,214,0.0,160.0,107.0,1,123,0.0,123.0,123.0
116590186.0,6,204,23124,102,16170,1152228.108910891,284.0,158.52941176470588,102,6954,1152228.01980198,140.0,68.17647058823529
153387.0,17,2,180,1,90,0.0,90.0,90.0,1,90,0.0,90.0,90.0
128459864.0,17,15,907,7,432,18166827.0,174.0,61.71428571428572,8,475,18292337.57142857,174.0,59.375
242950.0,6,3,337,2,214,0.0,160.0,107.0,1,123,0.0,123.0,123.0
19567.0,6,10,2032,5,524,4632.25,252.0,104.8,5,1508,4617.0,1236.0,301.6
302372.0,6,2,132,1,66,0.0,66.0,66.0,1,66,0.0,66.0,66.0
54493.0,6,14,4740,7,653,8957.5,249.0,93.28571428571428,7,4087,8688.833333333334,1514.0,583.8571428571429
1147784.0,6,13,3008,8,2380,163969.14285714287,1514.0,297.5,5,628,218798.0,331.0,125.6
103200191.0,6,43,2838,22,1452,4914283.047619048,66.0,66.0,21,1386,5159996.15,66.0,66.0
107236.0,17,2,286,2,286,0.0,143.0,143.0,0,0,0.0,0.0,0.0
28373.0,6,13,1479,7,882,4664.666666666667,291.0,126.0,6,597,4199.4,259.0,99.5
120120645.0,6,14,2224,9,1204,15015080.625,188.0,133.77777777777777,5,1020,22522597.75,204.0,204.0
144939.0,17,2,180,1,70,0.0,70.0,70.0,1,110,0.0,110.0,110.0
108103371.0,17,5,1005,5,1005,27025842.75,201.0,201.0,0,0,0.0,0.0,0.0
120034.0,17,2,180,1,70,0.0,70.0,70.0,1,110,0.0,110.0,110.0
1063929.0,6,13,1386,7,789,177321.5,253.0,112.71428571428572,6,597,210811.0,259.0,99.5
406.0,17,2,410,1,78,0.0,78.0,78.0,1,332,0.0,332.0,332.0
9429.0,17,4,823,2,163,0.0,89.0,81.5,2,660,0.0,443.0,330.0
215616.0,6,10,1221,6,636,43123.2,298.0,106.0,4,585,71058.66666666667,379.0,146.25
233105.0,17,2,608,1,75,0.0,75.0,75.0,1,533,0.0,533.0,533.0
90774705.0,6,22,1680,12,894,8247481.727272727,95.0,74.5,10,786,10085165.888888888,95.0,78.6
10869250.0,6,8,544,4,272,3577883.0,74.0,68.0,4,272,3577812.0,74.0,68.0
5913.0,17,2,335,1,88,0.0,88.0,88.0,1,247,0.0,247.0,247.0
127885539.0,17,14,864,7,432,18000160.0,174.0,61.71428571428572,7,432,18001073.333333332,174.0,61.71428571428572
119900876.0,6,465,56872,233,41338,516814.1206896552,374.0,177.41630901287553,232,15534,518025.3896103896,140.0,66.95689655172414
106288.0,17,2,700,2,700,0.0,350.0,350.0,0,0,0.0,0.0,0.0
319327.0,6,6,412,4,272,106442.33333333331,74.0,68.0,2,140,0.0,74.0,70.0
101692710.0,17,14,1126,7,563,16834100.5,174.0,80.42857142857143,7,563,16833498.5,174.0,80.42857142857143
100389979.0,17,14,864,7,432,16731663.166666666,174.0,61.71428571428572,7,432,16695374.666666666,174.0,61.71428571428572
102001056.0,17,13,821,7,432,17000176.0,174.0,61.71428571428572,6,389,16400441.8,174.0,64.83333333333333
303566.0,6,10,1221,6,636,60713.2,298.0,106.0,4,585,95821.33333333331,379.0,146.25
300812.0,6,6,412,4,272,100270.66666666669,74.0,68.0,2,140,0.0,74.0,70.0
9258.0,17,2,582,1,83,0.0,83.0,83.0,1,499,0.0,499.0,499.0
1022095.0,6,11,1134,6,558,204419.0,220.0,93.0,5,576,254940.0,304.0,115.2
311517.0,6,7,478,4,272,103839.0,74.0,68.0,3,206,78396.0,74.0,68.66666666666667
47812576.0,6,8,1940,3,887,22596241.0,753.0,295.6666666666667,5,1053,11257512.25,785.0,210.6
147975.0,17,2,180,1,90,0.0,90.0,90.0,1,90,0.0,90.0,90.0
108109759.0,17,5,1005,5,1005,27027439.75,201.0,201.0,0,0,0.0,0.0,0.0
135135817.0,17,6,1146,6,1146,27027163.4,191.0,191.0,0,0,0.0,0.0,0.0
2803492.0,6,2,132,1,66,0.0,66.0,66.0,1,66,0.0,66.0,66.0
219195.0,17,2,180,1,90,0.0,90.0,90.0,1,90,0.0,90.0,90.0
119910253.0,6,30,1974,15,1026,8549588.07142857,123.0,68.4,15,948,8549582.857142856,123.0,63.2
216447.0,17,2,180,1,90,0.0,90.0,90.0,1,90,0.0,90.0,90.0
34033.0,6,14,4740,7,653,4045.6666666666665,249.0,93.28571428571428,7,4087,5529.5,1514.0,583.8571428571429
19618.0,6,20,7606,11,978,1961.8,310.0,88.9090909090909,9,6628,2201.5,1514.0,736.4444444444445
148451.0,17,2,414,1,88,0.0,88.0,88.0,1,326,0.0,326.0,326.0
111467956.0,17,14,864,7,432,18501604.5,174.0,61.71428571428572,7,432,18500161.5,174.0,61.71428571428572
327.0,17,2,166,1,75,0.0,75.0,75.0,1,91,0.0,91.0,91.0
1766713.0,6,2,132,1,66,0.0,66.0,66.0,1,66,0.0,66.0,66.0
3868.0,17,4,344,2,150,0.0,75.0,75.0,2,194,0.0,103.0,97.0
1917.0,17,2,176,1,80,0.0,80.0,80.0,1,96,0.0,96.0,96.0
241877.0,6,3,337,2,214,0.0,160.0,107.0,1,123,0.0,123.0,123.0
122844044.0,6,47,3102,23,1518,5150445.909090909,66.0,66.0,24,1584,5327639.565217392,66.0,66.0
2319285.0,6,23,4355,12,1447,210844.0909090909,311.0,120.58333333333331,11,2908,211247.7,1514.0,264.3636363636364
123250533.0,6,49,3234,25,1650,5135438.875,66.0,66.0,24,1584,4930434.347826087,66.0,66.0
230256.0,17,2,180,1,90,0.0,90.0,90.0,1,90,0.0,90.0,90.0
201923.0,17,4,6056,4,6056,67307.66666666667,1514.0,1514.0,0,0,0.0,0.0,0.0
3578446.0,6,5,336,2,134,0.0,68.0,67.0,3,202,1422623.5,70.0,67.33333333333333
148049.0,17,2,180,1,90,0.0,90.0,90.0,1,90,0.0,90.0,90.0
108105540.0,17,5,955,5,955,27026385.0,191.0,191.0,0,0,0.0,0.0,0.0
117406205.0,6,48,3168,24,1584,5104617.608695652,66.0,66.0,24,1584,5092777.782608695,66.0,66.0
102685253.0,6,602,113854,295,19914,347617.9727891156,214.0,67.50508474576272,307,93940,330277.2320261438,1514.0,305.99348534201954
102906.0,17,2,286,2,286,0.0,143.0,143.0,0,0,0.0,0.0,0.0
301517.0,6,3,202,2,128,0.0,74.0,64.0,1,74,0.0,74.0,74.0
35957.0,6,14,4740,7,653,5536.333333333333,249.0,93.28571428571428,7,4087,5495.666666666667,1514.0,583.8571428571429
121302363.0,6,30,2037,15,948,8115182.0,123.0,63.2,15,1089,7951140.642857143,123.0,72.6
3093267.0,17,4,933,2,181,0.0,103.0,90.5,2,752,0.0,449.0,376.0
32966.0,6,14,4740,7,653,5371.666666666667,249.0,93.28571428571428,7,4087,5359.166666666667,1514.0,583.8571428571429
2789609.0,6,2,132,1,66,0.0,66.0,66.0,1,66,0.0,66.0,66.0
58068.0,6,12,1447,6,816,9959.4,291.0,136.0,6,631,9859.4,293.0,105.16666666666669
146221.0,6,3,337,2,214,0.0,160.0,107.0,1,123,0.0,123.0,123.0
2356.0,17,4,344,2,150,0.0,75.0,75.0,2,194,0.0,103.0,97.0
2265.0,17,4,344,2,150,0.0,75.0,75.0,2,194,0.0,103.0,97.0
6374.0,17,2,174,1,79,0.0,79.0,79.0,1,95,0.0,95.0,95.0
309668.0,6,6,412,4,272,103222.66666666669,74.0,68.0,2,140,0.0,74.0,70.0
153459.0,17,2,180,1,90,0.0,90.0,90.0,1,90,0.0,90.0,90.0
52352.0,6,14,4740,7,653,7862.166666666667,249.0,93.28571428571428,7,4087,8007.666666666667,1514.0,583.8571428571429
330743.0,6,6,412,4,272,110247.66666666669,74.0,68.0,2,140,0.0,74.0,70.0
39944.0,6,14,4740,7,653,6193.0,249.0,93.28571428571428,7,4087,6519.833333333333,1514.0,583.8571428571429
119864667.0,17,34,16284,34,16284,3632262.636363636,501.0,478.9411764705882,0,0,0.0,0.0,0.0
54176.0,6,14,4740,7,653,8302.333333333334,249.0,93.28571428571428,7,4087,8212.5,1514.0,583.8571428571429
441326.0,6,3,1604,2,851,0.0,785.0,425.5,1,753,0.0,753.0,753.0
108354704.0,6,32,2220,16,1149,7223646.933333334,123.0,71.8125,16,1071,7209240.333333333,123.0,66.9375
0.0,17,1,55,1,55,0.0,55.0,55.0,0,0,0.0,0.0,0.0
22968.0,17,4,823,2,163,0.0,89.0,81.5,2,660,0.0,443.0,330.0
111008555.0,17,13,821,7,432,18501425.83333333,174.0,61.71428571428572,6,389,18200158.2,174.0,64.83333333333333
35632.0,6,14,4740,7,653,5031.666666666667,249.0,93.28571428571428,7,4087,5805.166666666667,1514.0,583.8571428571429
284571.0,6,10,1221,6,636,56914.2,298.0,106.0,4,585,89305.0,379.0,146.25
392.0,17,2,508,2,508,0.0,257.0,254.0,0,0,0.0,0.0,0.0
120017411.0,17,28,13364,28,13364,4445089.296296297,501.0,477.2857142857143,0,0,0.0,0.0,0.0
13443.0,6,10,2032,5,524,3109.0,252.0,104.8,5,1508,2785.5,1236.0,301.6
270640.0,17,2,180,1,90,0.0,90.0,90.0,1,90,0.0,90.0,90.0
26088837.0,17,5,1718,4,1368,653690.0,342.0,342.0,1,350,0.0,350.0,350.0
112429336.0,6,210,23780,105,16616,1078981.8173076925,374.0,158.24761904761905,105,7164,1078982.125,140.0,68.22857142857143
1243157.0,6,7,499,4,301,409871.6666666667,103.0,75.25,3,198,612927.0,66.0,66.0
86539.0,6,14,4740,7,653,14314.333333333334,249.0,93.28571428571428,7,4087,13294.5,1514.0,583.8571428571429
38591.0,6,11,2098,6,590,7718.2,252.0,98.33333333333331,5,1508,8642.5,1236.0,301.6
53160.0,6,14,4740,7,653,8665.0,249.0,93.28571428571428,7,4087,8724.0,1514.0,583.8571428571429
1100.0,17,2,3028,2,3028,0.0,1514.0,1514.0,0,0,0.0,0.0,0.0
206470.0,6,3,426,2,280,0.0,214.0,140.0,1,146,0.0,146.0,146.0
135698.0,6,2,132,1,66,0.0,66.0,66.0,1,66,0.0,66.0,66.0
317941.0,17,4,1400,4,1400,105980.33333333331,350.0,350.0,0,0,0.0,0.0,0.0
310.0,17,2,168,1,76,0.0,76.0,76.0,1,92,0.0,92.0,92.0
151431.0,17,2,414,1,88,0.0,88.0,88.0,1,326,0.0,326.0,326.0
109153005.0,6,195,21920,98,6764,1125288.7113402062,140.0,69.0204081632653,97,15156,1127291.28125,284.0,156.24742268041237
1471958.0,17,16,1120,16,1120,98130.53333333334,70.0,70.0,0,0,0.0,0.0,0.0
242551.0,6,3,337,2,214,0.0,160.0,107.0,1,123,0.0,123.0,123.0
114967338.0,6,48,3168,24,1584,4998579.913043479,66.0,66.0,24,1584,4985188.913043479,66.0,66.0
303699.0,6,2,132,1,66,0.0,66.0,66.0,1,66,0.0,66.0,66.0
382.0,17,2,166,1,75,0.0,75.0,75.0,1,91,0.0,91.0,91.0
78535.0,6,14,4740,7,653,12722.166666666666,249.0,93.28571428571428,7,4087,12059.333333333334,1514.0,583.8571428571429
1222.0,17,5,550,5,550,305.5,110.0,110.0,0,0,0.0,0.0,0.0
304131.0,17,4,704,2,148,0.0,74.0,74.0,2,556,0.0,280.0,278.0
127006072.0,17,15,907,8,475,18143724.57142857,174.0,59.375,7,432,17833519.166666668,174.0,61.71428571428572
299559.0,17,2,246,1,76,0.0,76.0,76.0,1,170,0.0,170.0,170.0
120035365.0,17,28,13364,28,13364,4445754.259259259,501.0,477.2857142857143,0,0,0.0,0.0,0.0
301183.0,6,6,412,4,272,100394.33333333331,74.0,68.0,2,140,0.0,74.0,70.0
90069113.0,17,28,13364,28,13364,3335893.074074074,501.0,477.2857142857143,0,0,0.0,0.0,0.0
228269.0,17,2,180,1,90,0.0,90.0,90.0,1,90,0.0,90.0,90.0
207869.0,6,3,426,2,280,0.0,214.0,140.0,1,146,0.0,146.0,146.0
228260.0,17,2,180,1,90,0.0,90.0,90.0,1,90,0.0,90.0,90.0
10476895.0,6,7,478,4,272,3446649.6666666665,74.0,68.0,3,206,5169847.5,74.0,68.66666666666667
2400.0,17,4,344,2,150,0.0,75.0,75.0,2,194,0.0,103.0,97.0
302028.0,6,6,412,4,272,100676.0,74.0,68.0,2,140,0.0,74.0,70.0
103604.0,17,2,286,2,286,0.0,143.0,143.0,0,0,0.0,0.0,0.0
247118.0,6,3,373,2,238,0.0,172.0,119.0,1,135,0.0,135.0,135.0
68669.0,6,14,4740,7,653,9270.833333333334,249.0,93.28571428571428,7,4087,6555.333333333333,1514.0,583.8571428571429
1049708.0,6,3,1604,2,851,0.0,785.0,425.5,1,753,0.0,753.0,753.0
135129667.0,17,6,1146,6,1146,27025933.4,191.0,191.0,0,0,0.0,0.0,0.0
381.0,17,2,152,1,76,0.0,76.0,76.0,1,76,0.0,76.0,76.0
107929.0,17,2,286,2,286,0.0,143.0,143.0,0,0,0.0,0.0,0.0
228199.0,17,2,180,1,90,0.0,90.0,90.0,1,90,0.0,90.0,90.0
131485.0,6,3,337,2,214,0.0,160.0,107.0,1,123,0.0,123.0,123.0
106910.0,17,2,700,2,700,0.0,350.0,350.0,0,0,0.0,0.0,0.0
145230.0,6,2,132,1,66,0.0,66.0,66.0,1,66,0.0,66.0,66.0
50342.0,6,14,4740,7,653,8219.333333333334,249.0,93.28571428571428,7,4087,8207.5,1514.0,583.8571428571429
4028.000000000001,17,4,344,2,150,0.0,75.0,75.0,2,194,0.0,103.0,97.0
107247229.0,17,14,1126,7,563,17847714.0,174.0,80.42857142857143,7,563,17847708.0,174.0,80.42857142857143
107809.0,17,2,286,2,286,0.0,143.0,143.0,0,0,0.0,0.0,0.0
2915.0,17,2,762,2,762,0.0,381.0,381.0,0,0,0.0,0.0,0.0
107837859.0,6,28,1860,14,966,8278612.846153846,123.0,69.0,14,894,8278617.846153846,123.0,63.85714285714285
321840.0,17,4,1400,4,1400,107280.0,350.0,350.0,0,0,0.0,0.0,0.0
54464.0,6,14,4740,7,653,8245.166666666666,249.0,93.28571428571428,7,4087,8803.0,1514.0,583.8571428571429
232370.0,6,3,337,2,214,0.0,160.0,107.0,1,123,0.0,123.0,123.0
111176245.0,6,213,24204,107,7358,1048832.5,140.0,68.76635514018692,106,16846,1039265.9619047618,374.0,158.9245283018868
221447.0,6,3,426,2,280,0.0,214.0,140.0,1,146,0.0,146.0,146.0
309.0,17,2,174,1,79,0.0,79.0,79.0,1,95,0.0,95.0,95.0
144942.0,17,2,180,1,70,0.0,70.0,70.0,1,110,0.0,110.0,110.0
43176.0,6,14,4740,7,653,7068.166666666667,249.0,93.28571428571428,7,4087,6159.0,1514.0,583.8571428571429
301472.0,6,6,412,4,272,100490.66666666669,74.0,68.0,2,140,0.0,74.0,70.0
314139.0,6,3,202,2,128,0.0,74.0,64.0,1,74,0.0,74.0,74.0
217978.0,6,3,426,2,280,0.0,214.0,140.0,1,146,0.0,146.0,146.0
2402.0,17,4,344,2,150,0.0,75.0,75.0,2,194,0.0,103.0,97.0
228471.0,17,2,180,1,90,0.0,90.0,90.0,1,90,0.0,90.0,90.0
103315.0,17,2,762,2,762,0.0,381.0,381.0,0,0,0.0,0.0,0.0
90006138.0,17,27,12943,27,12943,3461774.5384615385,501.0,479.3703703703704,0,0,0.0,0.0,0.0
217883.0,6,3,426,2,280,0.0,214.0,140.0,1,146,0.0,146.0,146.0
219080.0,6,3,426,2,280,0.0,214.0,140.0,1,146,0.0,146.0,146.0
252819.00000000003,17,2,180,1,90,0.0,90.0,90.0,1,90,0.0,90.0,90.0
90064599.0,17,28,13364,28,13364,3335725.888888889,501.0,477.2857142857143,0,0,0.0,0.0,0.0
120478723.0,6,20,1531,10,786,10049494.222222222,95.0,78.6,10,745,13380685.777777778,95.0,74.5
120313.0,17,4,1400,4,1400,40104.333333333336,350.0,350.0,0,0,0.0,0.0,0.0
308884.0,6,6,412,4,272,102961.33333333331,74.0,68.0,2,140,0.0,74.0,70.0
228281.0,17,2,180,1,90,0.0,90.0,90.0,1,90,0.0,90.0,90.0
108107623.0,17,5,955,5,955,27026905.75,191.0,191.0,0,0,0.0,0.0,0.0
120441746.0,6,231,26134,116,18248,1047319.5304347826,284.0,157.31034482758622,115,7886,1047529.0350877192,140.0,68.57391304347826
300776.0,6,6,412,4,272,100258.66666666669,74.0,68.0,2,140,0.0,74.0,70.0
204247.0,17,2,762,2,762,0.0,381.0,381.0,0,0,0.0,0.0,0.0
2421.0,17,4,344,2,150,0.0,75.0,75.0,2,194,0.0,103.0,97.0
4452.0,17,2,180,1,90,0.0,90.0,90.0,1,90,0.0,90.0,90.0
545.0,17,2,508,2,508,0.0,257.0,254.0,0,0,0.0,0.0,0.0
858.0,17,5,550,5,550,214.5,110.0,110.0,0,0,0.0,0.0,0.0
81.0,17,2,762,2,762,0.0,381.0,381.0,0,0,0.0,0.0,0.0
20773.0,6,14,4740,7,653,2757.1666666666665,249.0,93.28571428571428,7,4087,3300.5,1514.0,583.8571428571429
33679.0,6,14,4740,7,653,5420.0,249.0,93.28571428571428,7,4087,4032.0,1514.0,583.8571428571429
23943.0,6,10,2032,5,524,5469.75,252.0,104.8,5,1508,5424.5,1236.0,301.6
135130990.0,17,6,1146,6,1146,27026198.0,191.0,191.0,0,0,0.0,0.0,0.0
107330321.0,17,14,864,7,432,17834334.5,174.0,61.71428571428572,7,432,17833509.166666668,174.0,61.71428571428572
90058110.0,17,28,13364,28,13364,3335485.5555555555,501.0,477.2857142857143,0,0,0.0,0.0,0.0
185984.0,17,2,180,1,90,0.0,90.0,90.0,1,90,0.0,90.0,90.0
23192.0,6,14,4740,7,653,3163.333333333333,249.0,93.28571428571428,7,4087,3171.833333333333,1514.0,583.8571428571429
153482.0,17,2,180,1,90,0.0,90.0,90.0,1,90,0.0,90.0,90.0
18941.0,6,2,145,2,145,0.0,91.0,72.5,0,0,0.0,0.0,0.0
97986880.0,6,65,12804,32,6674,3160867.096774193,1514.0,208.5625,33,6130,3053874.625,1514.0,185.7575757575757
90523322.0,6,16,2648,8,1016,12931903.142857144,188.0,127.0,8,1632,12907753.285714284,204.0,204.0
300467.0,6,6,412,4,272,100155.66666666669,74.0,68.0,2,140,0.0,74.0,70.0
10461605.0,6,7,478,4,272,3441468.6666666665,74.0,68.0,3,206,5162075.5,74.0,68.66666666666667
120123488.0,6,587,79314,294,19626,409977.7747440273,140.0,66.75510204081633,293,59688,407831.8116438356,480.0,203.7133105802048
6256.0,17,4,344,2,150,0.0,75.0,75.0,2,194,0.0,103.0,97.0
1836.0,17,2,192,1,88,0.0,88.0,88.0,1,104,0.0,104.0,104.0
119973686.0,6,283,31958,142,9668,850877.2056737589,140.0,68.08450704225352,141,22290,849650.1071428572,284.0,158.08510638297872
6374.0,17,4,823,2,163,0.0,89.0,81.5,2,660,0.0,443.0,330.0
10287.0,6,10,2032,5,524,1911.5,252.0,104.8,5,1508,2203.25,1236.0,301.6
1581.0,17,2,762,2,762,0.0,381.0,381.0,0,0,0.0,0.0,0.0
90259999.0,6,13,2036,8,1016,12894285.57142857,188.0,127.0,5,1020,22524342.0,204.0,204.0
0.0,17,1,55,1,55,0.0,55.0,55.0,0,0,0.0,0.0,0.0
326.0,17,2,208,1,72,0.0,72.0,72.0,1,136,0.0,136.0,136.0
92236970.0,6,171,19272,86,5898,1085140.8235294118,140.0,68.5813953488372,85,13374,1085798.1547619049,284.0,157.34117647058824
3011329.0,6,168,131410,92,122092,33091.52747252747,1510.0,1327.0869565217392,76,9318,35993.53333333333,1510.0,122.60526315789474
40334.0,6,14,4740,7,653,6543.0,249.0,93.28571428571428,7,4087,5954.5,1514.0,583.8571428571429
38466.0,6,14,4740,7,653,5983.333333333333,249.0,93.28571428571428,7,4087,5808.833333333333,1514.0,583.8571428571429
103804.0,17,2,286,2,286,0.0,143.0,143.0,0,0,0.0,0.0,0.0
214336.0,6,10,1221,6,636,42867.2,298.0,106.0,4,585,70070.33333333333,379.0,146.25
311699.0,17,4,1400,4,1400,103899.66666666669,350.0,350.0,0,0,0.0,0.0,0.0
303210.0,6,2,132,1,66,0.0,66.0,66.0,1,66,0.0,66.0,66.0
85777.0,6,14,4740,7,653,13923.833333333334,249.0,93.28571428571428,7,4087,13673.0,1514.0,583.8571428571429
19980.0,17,2,582,1,83,0.0,83.0,83.0,1,499,0.0,499.0,499.0
208804.0,6,3,426,2,280,0.0,214.0,140.0,1,146,0.0,146.0,146.0
87273.0,6,11,2098,6,590,16720.6,252.0,98.33333333333331,5,1508,21519.25,1236.0,301.6
2540.0,17,2,762,2,762,0.0,381.0,381.0,0,0,0.0,0.0,0.0
3573980.0,6,5,336,2,134,0.0,68.0,67.0,3,202,1408985.5,70.0,67.33333333333333
120008850.0,6,21,1585,10,745,13334316.666666666,95.0,74.5,11,840,11974520.1,95.0,76.36363636363636
346.0,17,2,267,1,83,0.0,83.0,83.0,1,184,0.0,184.0,184.0
32018.0,6,10,2032,5,524,5088.0,252.0,104.8,5,1508,7712.0,1236.0,301.6
30710.0,6,10,2032,5,524,6415.5,252.0,104.8,5,1508,7410.75,1236.0,301.6
41722.0,6,10,2032,5,524,9927.25,252.0,104.8,5,1508,9867.75,1236.0,301.6
580254.0,17,2,335,1,88,0.0,88.0,88.0,1,247,0.0,247.0,247.0
43018591.0,6,6,1808,4,987,14339530.333333334,785.0,246.75,2,821,0.0,753.0,410.5
92858154.0,6,40,2640,20,1320,4887271.263157895,66.0,66.0,20,1320,4875894.684210527,66.0,66.0
95079339.0,17,14,1126,7,563,15833466.0,174.0,80.42857142857143,7,563,15836066.333333334,174.0,80.42857142857143
1531189.0,6,18,6507,10,1598,170132.11111111112,505.0,159.8,8,4909,174040.2857142857,1510.0,613.625
16190.0,6,11,2098,6,590,2800.6,252.0,98.33333333333331,5,1508,3699.0,1236.0,301.6
228427.0,17,2,180,1,90,0.0,90.0,90.0,1,90,0.0,90.0,90.0
90259792.0,6,12,1832,8,1016,12894256.0,188.0,127.0,4,816,30031981.666666668,204.0,204.0
384.0,17,2,508,2,508,0.0,257.0,254.0,0,0,0.0,0.0,0.0
16759.0,6,14,4740,7,653,2542.6666666666665,249.0,93.28571428571428,7,4087,2661.1666666666665,1514.0,583.8571428571429
3352866.0,6,37,19834,20,1898,176466.63157894736,369.0,94.9,17,17936,190398.0625,1514.0,1055.0588235294117
206964.0,6,3,426,2,280,0.0,214.0,140.0,1,146,0.0,146.0,146.0
103354.0,17,2,286,2,286,0.0,143.0,143.0,0,0,0.0,0.0,0.0
2986230.0,17,3,1026,3,1026,1493115.0,342.0,342.0,0,0,0.0,0.0,0.0
290.0,17,2,174,1,79,0.0,79.0,79.0,1,95,0.0,95.0,95.0
63638.0,6,10,2032,5,524,15729.0,252.0,104.8,5,1508,14848.75,1236.0,301.6
9014791.0,17,2,160,2,160,0.0,80.0,80.0,0,0,0.0,0.0,0.0
75590.0,6,15,4806,8,719,10650.714285714286,249.0,89.875,7,4087,12465.333333333334,1514.0,583.8571428571429
90289106.0,6,19,1436,10,745,10026663.888888888,95.0,74.5,9,691,11284141.5,95.0,76.77777777777777
31032.0,6,10,2032,5,524,6953.75,252.0,104.8,5,1508,7201.5,1236.0,301.6
300302.0,6,3,202,2,128,0.0,74.0,64.0,1,74,0.0,74.0,74.0
92113563.0,6,38,2508,19,1254,5105437.055555556,66.0,66.0,19,1254,5105425.666666667,66.0,66.0
123839774.0,6,48,3168,24,1584,5051971.217391305,66.0,66.0,24,1584,5245425.0,66.0,66.0
1029658.0,6,11,1134,6,558,205931.6,220.0,93.0,5,576,256039.5,304.0,115.2
208045.0,6,3,426,2,280,0.0,214.0,140.0,1,146,0.0,146.0,146.0
74620.0,6,14,4740,7,653,11978.0,249.0,93.28571428571428,7,4087,11671.333333333334,1514.0,583.8571428571429
306929.0,6,6,412,4,272,102309.66666666669,74.0,68.0,2,140,0.0,74.0,70.0
305205.0,6,6,412,4,272,101735.0,74.0,68.0,2,140,0.0,74.0,70.0
98328.0,17,2,762,2,762,0.0,381.0,381.0,0,0,0.0,0.0,0.0
120000014.0,6,17,1287,9,691,15000001.75,95.0,76.77777777777777,8,596,12896121.142857144,95.0,74.5
32746.0,6,14,4740,7,653,4412.166666666667,249.0,93.28571428571428,7,4087,4705.166666666667,1514.0,583.8571428571429
35855.0,6,13,1479,7,882,5914.833333333333,291.0,126.0,6,597,5581.8,259.0,99.5
90532074.0,6,14,2240,8,1016,12933153.42857143,188.0,127.0,6,1224,18073407.2,204.0,204.0
94773920.0,17,14,1126,7,563,15667441.5,174.0,80.42857142857143,7,563,15666805.666666666,174.0,80.42857142857143
9210.0,17,2,582,1,83,0.0,83.0,83.0,1,499,0.0,499.0,499.0
120916452.0,6,33,2296,17,1225,7557278.25,139.0,72.05882352941177,16,1071,7380951.2,123.0,66.9375
2804695.0,6,2,132,1,66,0.0,66.0,66.0,1,66,0.0,66.0,66.0
1855.0,17,2,664,1,322,0.0,322.0,322.0,1,342,0.0,342.0,342.0
36733.0,6,10,2032,5,524,6731.75,252.0,104.8,5,1508,8426.75,1236.0,301.6
108108084.0,17,5,1005,5,1005,27027021.0,201.0,201.0,0,0,0.0,0.0,0.0
320195.0,17,4,1400,4,1400,106731.66666666669,350.0,350.0,0,0,0.0,0.0,0.0
35893.0,6,14,4740,7,653,5854.5,249.0,93.28571428571428,7,4087,5701.166666666667,1514.0,583.8571428571429
90950351.0,6,21,1585,11,840,9094048.4,95.0,76.36363636363636,10,745,10103935.222222222,95.0,74.5
290070.0,17,2,238,1,74,0.0,74.0,74.0,1,164,0.0,164.0,164.0
45001.0,6,14,4740,7,653,6090.666666666667,249.0,93.28571428571428,7,4087,5976.333333333333,1514.0,583.8571428571429
123301191.0,6,48,3168,24,1584,5057044.565217392,66.0,66.0,24,1584,5239514.913043479,66.0,66.0
318.0,17,2,168,1,76,0.0,76.0,76.0,1,92,0.0,92.0,92.0
16167.999999999998,6,10,2032,5,524,3756.0,252.0,104.8,5,1508,3785.5,1236.0,301.6
90261620.0,6,14,1964,8,1016,12894517.142857144,188.0,127.0,6,948,18018879.2,204.0,158.0
12207.0,6,13,1459,7,862,2034.5,271.0,123.14285714285714,6,597,2211.2,259.0,99.5
10522866.0,6,7,478,4,272,3460369.333333333,74.0,68.0,3,206,5190421.0,74.0,68.66666666666667
757.0,17,4,438,2,148,0.0,74.0,74.0,2,290,0.0,147.0,145.0
117597309.0,6,218,24674,109,17246,1086869.8796296297,284.0,158.22018348623854,109,7428,1086855.5648148148,140.0,68.14678899082568
128610.0,6,13,1513,7,882,20752.0,291.0,126.0,6,631,23826.0,293.0,105.16666666666669
5101251.0,6,5,336,2,134,0.0,68.0,67.0,3,202,1526039.5,70.0,67.33333333333333
207441.0,6,3,426,2,280,0.0,214.0,140.0,1,146,0.0,146.0,146.0
135133415.0,17,6,1206,6,1206,27026683.0,201.0,201.0,0,0,0.0,0.0,0.0
319.0,17,2,174,1,79,0.0,79.0,79.0,1,95,0.0,95.0,95.0
120110886.0,6,226,25496,113,7754,1065117.4732142857,140.0,68.61946902654867,113,17742,1066112.9285714286,284.0,157.00884955752213
52933.0,6,10,2032,5,524,12975.25,252.0,104.8,5,1508,12482.0,1236.0,301.6
103077.0,17,2,286,2,286,0.0,143.0,143.0,0,0,0.0,0.0,0.0
0.0,6,1,66,1,66,0.0,66.0,66.0,0,0,0.0,0.0,0.0
120125310.0,6,354,41378,177,11978,681121.9261363636,140.0,67.67231638418079,177,29400,672036.4772727273,284.0,166.10169491525423
108109193.0,17,5,955,5,955,27027298.25,191.0,191.0,0,0,0.0,0.0,0.0
41014.0,6,14,4740,7,653,6513.5,249.0,93.28571428571428,7,4087,6635.333333333333,1514.0,583.8571428571429
99874.0,17,2,286,2,286,0.0,143.0,143.0,0,0,0.0,0.0,0.0
228209.0,17,2,180,1,90,0.0,90.0,90.0,1,90,0.0,90.0,90.0
136214.0,17,4,1400,4,1400,45404.66666666666,350.0,350.0,0,0,0.0,0.0,0.0
145142.0,17,2,180,1,70,0.0,70.0,70.0,1,110,0.0,110.0,110.0
498791.0,6,5,336,2,134,0.0,68.0,67.0,3,202,193305.0,70.0,67.33333333333333
120340451.0,6,227,25870,114,18116,1064959.743362832,336.0,158.91228070175438,113,7754,1056695.9285714286,140.0,68.61946902654867
135146892.0,17,6,1206,6,1206,27029378.4,201.0,201.0,0,0,0.0,0.0,0.0
215369.0,17,2,180,1,90,0.0,90.0,90.0,1,90,0.0,90.0,90.0
3392.0,17,4,344,2,150,0.0,75.0,75.0,2,194,0.0,103.0,97.0
10285.0,17,2,598,1,72,0.0,72.0,72.0,1,526,0.0,526.0,526.0
100980439.0,6,28,1860,14,966,7751135.615384615,123.0,69.0,14,894,7751138.461538462,123.0,63.85714285714285
143878.0,17,2,180,1,90,0.0,90.0,90.0,1,90,0.0,90.0,90.0
29258.0,6,14,4740,7,653,4704.166666666667,249.0,93.28571428571428,7,4087,4355.166666666667,1514.0,583.8571428571429
254281.0,6,3,373,2,238,0.0,172.0,119.0,1,135,0.0,135.0,135.0
232021.0,6,3,426,2,280,0.0,214.0,140.0,1,146,0.0,146.0,146.0
90032503.0,17,28,13364,28,13364,3334537.1481481483,501.0,477.2857142857143,0,0,0.0,0.0,0.0
31021.0,6,14,4740,7,653,4304.333333333333,249.0,93.28571428571428,7,4087,4917.5,1514.0,583.8571428571429
47081.0,6,14,4740,7,653,7670.666666666667,249.0,93.28571428571428,7,4087,6996.0,1514.0,583.8571428571429
201731.0,17,4,6056,4,6056,67243.66666666667,1514.0,1514.0,0,0,0.0,0.0,0.0
111056576.0,6,30,1974,15,1026,7917164.571428572,123.0,68.4,15,948,7917166.571428572,123.0,63.2
59889.0,6,10,2032,5,524,14737.25,252.0,104.8,5,1508,13699.0,1236.0,301.6
108108327.0,17,5,955,5,955,27027081.75,191.0,191.0,0,0,0.0,0.0,0.0
2978.0,17,2,224,1,76,0.0,76.0,76.0,1,148,0.0,148.0,148.0
90054771.0,17,28,13364,28,13364,3335361.888888889,501.0,477.2857142857143,0,0,0.0,0.0,0.0
38127.0,6,10,2032,5,524,8893.75,252.0,104.8,5,1508,9098.25,1236.0,301.6
41673.0,6,10,2032,5,524,10196.25,252.0,104.8,5,1508,8106.5,1236.0,301.6
305866.0,6,6,412,4,272,101955.33333333331,74.0,68.0,2,140,0.0,74.0,70.0
117317540.0,17,14,864,7,432,19500184.33333333,174.0,61.71428571428572,7,432,19501514.83333333,174.0,61.71428571428572
2209.0,17,2,664,1,322,0.0,322.0,322.0,1,342,0.0,342.0,342.0
20657.0,6,14,4740,7,653,3328.1666666666665,249.0,93.28571428571428,7,4087,3309.6666666666665,1514.0,583.8571428571429
141783.0,17,4,704,2,148,0.0,74.0,74.0,2,556,0.0,280.0,278.0
5621095.0,6,5,336,2,134,0.0,68.0,67.0,3,202,1424599.5,70.0,67.33333333333333
207113.0,6,3,426,2,280,0.0,214.0,140.0,1,146,0.0,146.0,146.0
310645.0,17,4,622,4,622,103548.33333333331,163.0,155.5,0,0,0.0,0.0,0.0
10465517.0,6,7,478,4,272,3442748.6666666665,74.0,68.0,3,206,5164022.5,74.0,68.66666666666667
213403.0,17,2,414,1,88,0.0,88.0,88.0,1,326,0.0,326.0,326.0
211579.0,6,10,1221,6,636,42315.8,298.0,106.0,4,585,69112.66666666667,379.0,146.25
41118.0,6,14,4740,7,653,6437.166666666667,249.0,93.28571428571428,7,4087,6512.5,1514.0,583.8571428571429
102922.0,6,10,1065,5,534,25333.5,262.0,106.8,5,531,2585.0,259.0,106.2
95461743.0,6,40,2640,20,1320,5024302.263157895,66.0,66.0,20,1320,5008021.368421053,66.0,66.0
90296907.0,6,19,1436,10,745,10027994.333333334,95.0,74.5,9,691,11286431.0,95.0,76.77777777777777
108105850.0,17,5,1005,5,1005,27026462.5,201.0,201.0,0,0,0.0,0.0,0.0
221052.0,17,2,414,1,88,0.0,88.0,88.0,1,326,0.0,326.0,326.0
32245.000000000004,6,12,1413,7,882,5374.166666666667,291.0,126.0,5,531,7157.75,259.0,106.2
209735.0,6,3,426,2,280,0.0,214.0,140.0,1,146,0.0,146.0,146.0
50761.0,17,2,180,1,90,0.0,90.0,90.0,1,90,0.0,90.0,90.0
45915.0,6,14,4740,7,653,7446.0,249.0,93.28571428571428,7,4087,7414.5,1514.0,583.8571428571429
90838486.0,6,849,199552,430,171306,211744.72261072265,1514.0,398.3860465116279,419,28246,217121.9330143541,214.0,67.4128878281623
277173.0,17,2,363,1,79,0.0,79.0,79.0,1,284,0.0,284.0,284.0
5625517.0,6,5,336,2,134,0.0,68.0,67.0,3,202,1421306.0,70.0,67.33333333333333
18120.0,6,14,4740,7,653,2905.333333333333,249.0,93.28571428571428,7,4087,2883.6666666666665,1514.0,583.8571428571429
1363435.0,17,6,1230,3,234,681525.0,78.0,78.0,3,996,681500.5,332.0,332.0
110180132.0,6,27,1822,14,982,8458791.538461538,139.0,70.14285714285714,13,840,9163579.166666666,123.0,64.61538461538461
206456.0,17,2,180,1,90,0.0,90.0,90.0,1,90,0.0,90.0,90.0
135132032.0,17,6,1146,6,1146,27026406.4,191.0,191.0,0,0,0.0,0.0,0.0
218679.0,6,3,426,2,280,0.0,214.0,140.0,1,146,0.0,146.0,146.0
118004534.0,17,13,821,7,432,19667422.33333333,174.0,61.71428571428572,6,389,19600167.2,174.0,64.83333333333333
104225444.0,6,32,2374,17,1288,6500600.875,139.0,75.76470588235294,15,1086,7429258.571428572,123.0,72.4
90257759.0,6,13,2036,8,1016,12893965.57142857,188.0,127.0,5,1020,22523282.5,204.0,204.0
135136248.0,17,6,1206,6,1206,27027249.6,201.0,201.0,0,0,0.0,0.0,0.0
108092937.0,17,5,1005,5,1005,27023234.25,201.0,201.0,0,0,0.0,0.0,0.0
302414.0,6,6,412,4,272,100804.66666666669,74.0,68.0,2,140,0.0,74.0,70.0
228231.0,17,2,180,1,90,0.0,90.0,90.0,1,90,0.0,90.0,90.0
1105647.0,6,20,6434,12,1921,100513.36363636365,620.0,160.08333333333334,8,4513,131000.0,1514.0,564.125
97005023.0,17,15,1623,8,761,13857860.42857143,250.0,95.125,7,862,13949429.5,394.0,123.14285714285714
108104215.0,17,5,1005,5,1005,27026053.75,201.0,201.0,0,0,0.0,0.0,0.0
137815.0,17,2,176,1,80,0.0,80.0,80.0,1,96,0.0,96.0,96.0
100524.0,17,2,762,2,762,0.0,381.0,381.0,0,0,0.0,0.0,0.0
432406.0,17,4,360,2,140,0.0,70.0,70.0,2,220,0.0,110.0,110.0
90022019.0,17,28,13364,28,13364,3334148.851851852,501.0,477.2857142857143,0,0,0.0,0.0,0.0
105621410.0,17,14,864,7,432,17500880.0,174.0,61.71428571428572,7,432,17500152.833333332,174.0,61.71428571428572
2263786.0,6,25,7609,13,2516,188070.0,1034.0,193.53846153846155,12,5093,177703.0909090909,1510.0,424.4166666666667
2047.0,17,4,344,2,150,0.0,75.0,75.0,2,194,0.0,103.0,97.0
209459.0,17,2,180,1,90,0.0,90.0,90.0,1,90,0.0,90.0,90.0
116456135.0,6,222,25106,111,17558,1056736.4272727272,284.0,158.18018018018017,111,7548,1056736.1272727272,140.0,68.0
1098759.0,6,13,1394,7,797,183126.5,253.0,113.85714285714286,6,597,217694.4,259.0,99.5
307927.0,6,6,412,4,272,102642.33333333331,74.0,68.0,2,140,0.0,74.0,70.0
115226698.0,6,33,2428,17,1288,7188885.75,139.0,75.76470588235294,16,1140,7668141.2,123.0,71.25
254070.00000000003,6,3,337,2,214,0.0,160.0,107.0,1,123,0.0,123.0,123.0
2598562.0,6,2,132,1,66,0.0,66.0,66.0,1,66,0.0,66.0,66.0
26841.0,6,10,2032,5,524,5951.25,252.0,104.8,5,1508,5984.75,1236.0,301.6
107921.0,17,2,286,2,286,0.0,143.0,143.0,0,0,0.0,0.0,0.0
280667.0,17,3,1143,3,1143,140333.5,381.0,381.0,0,0,0.0,0.0,0.0
10461955.0,6,6,412,3,206,5163130.0,74.0,68.66666666666667,3,206,5163018.0,74.0,68.66666666666667
93444085.0,6,40,2640,20,1320,4918109.736842105,66.0,66.0,20,1320,4901238.47368421,66.0,66.0
90288732.0,6,24,1829,13,989,7519983.0,95.0,76.07692307692308,11,840,8956550.6,95.0,76.36363636363636
323383.0,6,6,412,4,272,107794.33333333331,74.0,68.0,2,140,0.0,74.0,70.0
10516359.0,6,7,478,4,272,3460252.0,74.0,68.0,3,206,5190323.5,74.0,68.66666666666667
146983.0,6,3,373,2,238,0.0,172.0,119.0,1,135,0.0,135.0,135.0
1191985.0,6,13,3003,8,2375,170283.57142857142,1514.0,296.875,5,628,229069.25,331.0,125.6
238962.0,17,2,180,1,90,0.0,90.0,90.0,1,90,0.0,90.0,90.0
123455887.0,6,49,3234,25,1650,5143995.291666667,66.0,66.0,24,1584,4962128.434782608,66.0,66.0
135129913.0,17,6,1206,6,1206,27025982.6,201.0,201.0,0,0,0.0,0.0,0.0
284764.0,17,2,363,1,79,0.0,79.0,79.0,1,284,0.0,284.0,284.0
0.0,6,1,172,1,172,0.0,172.0,172.0,0,0,0.0,0.0,0.0
2023.0,17,4,344,2,150,0.0,75.0,75.0,2,194,0.0,103.0,97.0
135125059.0,17,6,1206,6,1206,27025011.8,201.0,201.0,0,0,0.0,0.0,0.0
108106445.0,17,5,1005,5,1005,27026611.25,201.0,201.0,0,0,0.0,0.0,0.0
10517927.0,6,7,478,4,272,3460447.6666666665,74.0,68.0,3,206,5190590.5,74.0,68.66666666666667
223069.0,17,2,414,1,88,0.0,88.0,88.0,1,326,0.0,326.0,326.0
2356.0,17,4,344,2,150,0.0,75.0,75.0,2,194,0.0,103.0,97.0
121401.0,6,3,337,2,214,0.0,160.0,107.0,1,123,0.0,123.0,123.0
2596118.0,6,2,132,1,66,0.0,66.0,66.0,1,66,0.0,66.0,66.0
27467285.0,17,5,1710,5,1710,6866821.25,342.0,342.0,0,0,0.0,0.0,0.0
13705.0,6,10,1065,5,534,2921.0,262.0,106.8,5,531,2363.0,259.0,106.2
6413.0,17,2,684,2,684,0.0,342.0,342.0,0,0,0.0,0.0,0.0
298359.0,6,6,412,4,272,99453.0,74.0,68.0,2,140,0.0,74.0,70.0
206024.0,6,3,426,2,280,0.0,214.0,140.0,1,146,0.0,146.0,146.0
153498.0,17,2,180,1,90,0.0,90.0,90.0,1,90,0.0,90.0,90.0
100001044.0,17,6,258,6,258,20000208.8,43.0,43.0,0,0,0.0,0.0,0.0
90026486.0,17,27,12943,27,12943,3462557.153846154,501.0,479.3703703703704,0,0,0.0,0.0,0.0
299.0,17,2,156,1,78,0.0,78.0,78.0,1,78,0.0,78.0,78.0
105716.0,17,2,762,2,762,0.0,381.0,381.0,0,0,0.0,0.0,0.0
22117.0,6,10,1067,5,536,4868.25,264.0,107.2,5,531,3872.25,259.0,106.2
90052509.0,17,27,12943,27,12943,3463558.0384615385,501.0,479.3703703703704,0,0,0.0,0.0,0.0
33993.0,6,14,4740,7,653,4898.5,249.0,93.28571428571428,7,4087,5509.833333333333,1514.0,583.8571428571429
143958.0,17,2,180,1,90,0.0,90.0,90.0,1,90,0.0,90.0,90.0
56063.0,6,14,4740,7,653,9217.5,249.0,93.28571428571428,7,4087,7776.666666666667,1514.0,583.8571428571429
50403.0,6,14,4740,7,653,4617.5,249.0,93.28571428571428,7,4087,7949.666666666667,1514.0,583.8571428571429
113618784.0,6,46,3036,23,1518,5150437.5,66.0,66.0,23,1518,5150433.818181818,66.0,66.0
11422.0,17,4,344,2,150,0.0,75.0,75.0,2,194,0.0,103.0,97.0
16115.0,6,11,2098,6,590,2928.0,252.0,98.33333333333331,5,1508,2515.25,1236.0,301.6
233476.0,6,3,337,2,214,0.0,160.0,107.0,1,123,0.0,123.0,123.0
328479.0,6,10,1221,6,636,65695.8,298.0,106.0,4,585,103696.0,379.0,146.25
38849.0,6,10,2032,5,524,9495.75,252.0,104.8,5,1508,9113.25,1236.0,301.6
153396.0,17,2,180,1,90,0.0,90.0,90.0,1,90,0.0,90.0,90.0
450.0,17,2,166,1,75,0.0,75.0,75.0,1,91,0.0,91.0,91.0
2374.0,17,4,344,2,150,0.0,75.0,75.0,2,194,0.0,103.0,97.0
132545163.0,17,14,864,7,432,18834603.166666668,174.0,61.71428571428572,7,432,19907606.666666668,174.0,61.71428571428572
40625.0,6,14,4740,7,653,5170.5,249.0,93.28571428571428,7,4087,5997.833333333333,1514.0,583.8571428571429
228444.0,17,2,180,1,90,0.0,90.0,90.0,1,90,0.0,90.0,90.0
15592.0,6,10,1065,5,534,3483.5,262.0,106.8,5,531,3532.5,259.0,106.2
95011365.0,6,195,22132,98,6690,979498.6082474228,140.0,68.26530612244898,97,15442,978853.3645833334,284.0,159.1958762886598
0.0,6,1,66,1,66,0.0,66.0,66.0,0,0,0.0,0.0,0.0
10488734.0,6,7,478,4,272,3449114.6666666665,74.0,68.0,3,206,5173526.5,74.0,68.66666666666667
15975.0,6,13,1459,7,862,2527.833333333333,271.0,123.14285714285714,6,597,2977.2,259.0,99.5
51991.0,6,14,4740,7,653,8442.833333333334,249.0,93.28571428571428,7,4087,8507.0,1514.0,583.8571428571429
328.0,17,2,267,1,83,0.0,83.0,83.0,1,184,0.0,184.0,184.0
102420043.0,6,44,2904,22,1452,4877144.904761905,66.0,66.0,22,1452,4868568.523809524,66.0,66.0
318541.0,17,4,1400,4,1400,106180.33333333331,350.0,350.0,0,0,0.0,0.0,0.0
1166318.0,6,13,3000,8,2372,166616.85714285713,1514.0,296.5,5,628,222666.0,331.0,125.6
101000945.0,17,13,821,7,432,16833490.833333332,174.0,61.71428571428572,6,389,16201958.4,174.0,64.83333333333333
245087.0,6,3,337,2,214,0.0,160.0,107.0,1,123,0.0,123.0,123.0
108115898.0,17,5,955,5,955,27028974.5,191.0,191.0,0,0,0.0,0.0,0.0
120120110.0,6,14,2240,6,1224,24024022.0,204.0,204.0,8,1016,17136521.0,188.0,127.0
1114300.0,6,20,6434,12,1921,101300.0,620.0,160.08333333333334,8,4513,130428.14285714286,1514.0,564.125
292490.0,6,10,1221,6,636,58498.0,298.0,106.0,4,585,91737.33333333331,379.0,146.25
1243189.0,6,13,3000,8,2372,177598.42857142858,1514.0,296.5,5,628,242438.5,331.0,125.6
101442957.0,6,28,1860,14,966,7786709.923076923,123.0,69.0,14,894,7786710.076923077,123.0,63.85714285714285
108106903.0,17,5,1005,5,1005,27026725.75,201.0,201.0,0,0,0.0,0.0,0.0
70420.0,6,14,4740,7,653,10283.0,249.0,93.28571428571428,7,4087,11473.0,1514.0,583.8571428571429
43176.0,6,14,4740,7,653,7018.833333333333,249.0,93.28571428571428,7,4087,5867.166666666667,1514.0,583.8571428571429
118034317.0,6,38,2848,20,1531,6200980.263157895,139.0,76.55,18,1317,6930506.0,123.0,73.16666666666667
208082.0,6,3,426,2,280,0.0,214.0,140.0,1,146,0.0,146.0,146.0
90775152.0,6,17,1287,9,691,11340355.5,95.0,76.77777777777777,8,596,12966647.142857144,95.0,74.5
139780.0,6,2,132,1,66,0.0,66.0,66.0,1,66,0.0,66.0,66.0
234770.0,6,13,1394,7,797,39128.333333333336,253.0,113.85714285714286,6,597,46279.8,259.0,99.5
211926.0,17,2,762,2,762,0.0,381.0,381.0,0,0,0.0,0.0,0.0
2373.0,17,4,344,2,150,0.0,75.0,75.0,2,194,0.0,103.0,97.0
14220.0,6,14,4740,7,653,2200.0,249.0,93.28571428571428,7,4087,2232.0,1514.0,583.8571428571429
107842313.0,6,28,1860,14,966,8278951.692307692,123.0,69.0,14,894,8278960.0,123.0,63.85714285714285
21360.0,6,14,4740,7,653,3333.333333333333,249.0,93.28571428571428,7,4087,3420.0,1514.0,583.8571428571429
108096096.0,17,5,1005,5,1005,27024024.0,201.0,201.0,0,0,0.0,0.0,0.0
6601.0,17,4,823,2,163,0.0,89.0,81.5,2,660,0.0,443.0,330.0
213077.0,6,3,426,2,280,0.0,214.0,140.0,1,146,0.0,146.0,146.0
1566684.0,6,2,132,1,66,0.0,66.0,66.0,1,66,0.0,66.0,66.0
272725.0,6,10,1221,6,636,54545.0,298.0,106.0,4,585,85350.0,379.0,146.25
22636.0,6,14,4740,7,653,3296.5,249.0,93.28571428571428,7,4087,3639.6666666666665,1514.0,583.8571428571429
33444.0,6,10,2032,5,524,8123.25,252.0,104.8,5,1508,8107.0,1236.0,301.6
1313771.0,17,7,490,7,490,218961.8333333333,70.0,70.0,0,0,0.0,0.0,0.0
246995.0,6,3,373,2,238,0.0,172.0,119.0,1,135,0.0,135.0,135.0
5004508.0,17,4,629,2,156,0.0,78.0,78.0,2,473,0.0,268.0,236.5
302409.0,17,2,180,1,90,0.0,90.0,90.0,1,90,0.0,90.0,90.0
303433.0,6,6,412,4,272,101144.33333333331,74.0,68.0,2,140,0.0,74.0,70.0
90259748.0,6,12,1832,8,1016,12894249.714285716,188.0,127.0,4,816,30031405.666666668,204.0,204.0
116877174.0,6,236,26656,118,18560,997110.4273504274,284.0,157.28813559322035,118,8096,997110.4017094016,140.0,68.61016949152543
303134.0,6,2,132,1,66,0.0,66.0,66.0,1,66,0.0,66.0,66.0
134010685.0,17,15,907,8,475,19144383.57142857,174.0,59.375,7,432,19000217.33333333,174.0,61.71428571428572
704.0,17,2,267,1,83,0.0,83.0,83.0,1,184,0.0,184.0,184.0
153457.0,17,2,180,1,90,0.0,90.0,90.0,1,90,0.0,90.0,90.0
232123.0,6,3,373,2,238,0.0,172.0,119.0,1,135,0.0,135.0,135.0
35697.0,6,14,4740,7,653,5663.833333333333,249.0,93.28571428571428,7,4087,5640.666666666667,1514.0,583.8571428571429
140687.0,6,2,132,1,66,0.0,66.0,66.0,1,66,0.0,66.0,66.0
1307689.0,6,4,264,2,132,0.0,66.0,66.0,2,132,0.0,66.0,66.0
35243.0,6,14,4740,7,653,5119.333333333333,249.0,93.28571428571428,7,4087,5665.166666666667,1514.0,583.8571428571429
91575120.0,6,23,1775,12,935,8320352.909090909,95.0,77.91666666666667,11,840,9157016.9,95.0,76.36363636363636
327.0,17,2,174,1,79,0.0,79.0,79.0,1,95,0.0,95.0,95.0
144788.0,17,2,180,1,70,0.0,70.0,70.0,1,110,0.0,110.0,110.0
10006.0,17,2,539,1,86,0.0,86.0,86.0,1,453,0.0,453.0,453.0
7803652.0,17,5,1710,5,1710,1950913.0,342.0,342.0,0,0,0.0,0.0,0.0
2553739.0,6,25,7573,14,3735,196441.4615384616,1514.0,266.7857142857143,11,3838,229195.8,1514.0,348.90909090909093
108109556.0,17,5,955,5,955,27027389.0,191.0,191.0,0,0,0.0,0.0,0.0
120189917.0,6,212,24070,106,7292,1136868.4666666666,140.0,68.79245283018868,106,16778,1136957.6095238095,284.0,158.28301886792454
29830.0,6,14,4740,7,653,4524.5,249.0,93.28571428571428,7,4087,4695.666666666667,1514.0,583.8571428571429
108107753.0,17,5,1005,5,1005,27026938.25,201.0,201.0,0,0,0.0,0.0,0.0
34658.0,6,14,4740,7,653,5656.166666666667,249.0,93.28571428571428,7,4087,5082.666666666667,1514.0,583.8571428571429
148531.0,6,3,373,2,238,0.0,172.0,119.0,1,135,0.0,135.0,135.0
113251830.0,6,46,3036,23,1518,5135441.636363637,66.0,66.0,23,1518,5135441.2727272725,66.0,66.0
206352.0,6,3,426,2,280,0.0,214.0,140.0,1,146,0.0,146.0,146.0
310608.0,17,4,622,4,622,103536.0,163.0,155.5,0,0,0.0,0.0,0.0
107246.0,17,2,286,2,286,0.0,143.0,143.0,0,0,0.0,0.0,0.0
34409.0,6,14,4740,7,653,5568.666666666667,249.0,93.28571428571428,7,4087,5026.5,1514.0,583.8571428571429
120335786.0,6,610,96000,302,20302,397018.950166113,214.0,67.2251655629139,308,75698,391861.3843648208,1514.0,245.77272727272728
120000878.0,6,19,1436,9,691,15000109.75,95.0,76.77777777777777,10,745,13305380.333333334,95.0,74.5
447089.0,6,3,1604,2,851,0.0,785.0,425.5,1,753,0.0,753.0,753.0
307995.0,6,6,412,4,272,102665.0,74.0,68.0,2,140,0.0,74.0,70.0
23414.0,6,14,4740,7,653,3502.333333333333,249.0,93.28571428571428,7,4087,3201.5,1514.0,583.8571428571429
90026482.0,17,28,13364,28,13364,3334314.1481481483,501.0,477.2857142857143,0,0,0.0,0.0,0.0
117326419.0,6,34,2334,17,1209,7319401.6875,123.0,71.11764705882354,17,1125,7319401.1875,123.0,66.17647058823529
171878.0,17,4,1524,4,1524,57292.66666666666,381.0,381.0,0,0,0.0,0.0,0.0
260272.0,6,10,1221,6,636,52054.4,298.0,106.0,4,585,80886.0,379.0,146.25
171633.0,17,2,180,1,90,0.0,90.0,90.0,1,90,0.0,90.0,90.0
120068524.0,17,29,13785,29,13785,4288161.571428572,501.0,475.3448275862069,0,0,0.0,0.0,0.0
1306947.0,6,4,264,2,132,0.0,66.0,66.0,2,132,0.0,66.0,66.0
113254780.0,6,46,3036,23,1518,5135435.2727272725,66.0,66.0,23,1518,5135433.454545454,66.0,66.0
228476.0,17,2,180,1,90,0.0,90.0,90.0,1,90,0.0,90.0,90.0
37772.0,6,14,4740,7,653,5871.666666666667,249.0,93.28571428571428,7,4087,6016.333333333333,1514.0,583.8571428571429
5004239.0,17,4,849,2,166,0.0,83.0,83.0,2,683,0.0,499.0,341.5
4385.0,17,2,614,1,72,0.0,72.0,72.0,1,542,0.0,542.0,542.0
768.0,17,4,438,2,148,0.0,74.0,74.0,2,290,0.0,147.0,145.0
39903.0,6,14,4740,7,653,6410.666666666667,249.0,93.28571428571428,7,4087,6456.833333333333,1514.0,583.8571428571429
108414.0,17,2,286,2,286,0.0,143.0,143.0,0,0,0.0,0.0,0.0
27529878.0,6,27,7681,14,3735,198553.2307692308,1514.0,266.7857142857143,13,3946,2277060.583333333,1514.0,303.53846153846155
24033.0,17,2,582,1,83,0.0,83.0,83.0,1,499,0.0,499.0,499.0
247120.0,17,2,180,1,90,0.0,90.0,90.0,1,90,0.0,90.0,90.0
2370331.0,6,25,7573,14,3735,182333.15384615384,1514.0,266.7857142857143,11,3838,212094.3,1514.0,348.90909090909093
81596.0,6,10,2032,5,524,19211.25,252.0,104.8,5,1508,19711.5,1236.0,301.6
107832.0,6,13,1479,7,882,11055.166666666666,291.0,126.0,6,597,20676.4,259.0,99.5
39182.0,6,14,4740,7,653,5864.0,249.0,93.28571428571428,7,4087,5585.166666666667,1514.0,583.8571428571429
120296134.0,6,239,27128,120,18978,1010891.8823529412,374.0,158.15,119,8150,1010662.220338983,140.0,68.4873949579832
234089.0,6,3,337,2,214,0.0,160.0,107.0,1,123,0.0,123.0,123.0
108103741.0,17,5,955,5,955,27025935.25,191.0,191.0,0,0,0.0,0.0,0.0
306627.0,6,6,412,4,272,102209.0,74.0,68.0,2,140,0.0,74.0,70.0
90289747.0,6,16,1192,8,596,12892290.285714284,95.0,74.5,8,596,12897206.42857143,95.0,74.5
94423392.0,6,30,2244,16,1212,6294892.8,123.0,75.75,14,1032,7246706.076923077,123.0,73.71428571428571
703.0,17,4,438,2,148,0.0,74.0,74.0,2,290,0.0,147.0,145.0
232108.0,6,3,337,2,214,0.0,160.0,107.0,1,123,0.0,123.0,123.0
41843.0,6,14,4740,7,653,6851.0,249.0,93.28571428571428,7,4087,6125.0,1514.0,583.8571428571429
821654.0,17,2,582,1,83,0.0,83.0,83.0,1,499,0.0,499.0,499.0
253766.0,17,2,180,1,90,0.0,90.0,90.0,1,90,0.0,90.0,90.0
302.0,17,2,164,1,82,0.0,82.0,82.0,1,82,0.0,82.0,82.0
31764.0,6,10,2032,5,524,7722.25,252.0,104.8,5,1508,7102.25,1236.0,301.6
296733.0,17,2,246,1,76,0.0,76.0,76.0,1,170,0.0,170.0,170.0
334.0,17,2,168,1,76,0.0,76.0,76.0,1,92,0.0,92.0,92.0
203748.0,17,2,359,1,75,0.0,75.0,75.0,1,284,0.0,284.0,284.0
108100396.0,17,5,955,5,955,27025099.0,191.0,191.0,0,0,0.0,0.0,0.0
314338.0,17,4,1400,4,1400,104779.33333333331,350.0,350.0,0,0,0.0,0.0,0.0
0.0,6,1,66,1,66,0.0,66.0,66.0,0,0,0.0,0.0,0.0
10119.0,6,10,1067,5,536,2348.75,264.0,107.2,5,531,2265.25,259.0,106.2
27646474.0,17,5,1710,5,1710,6911618.5,342.0,342.0,0,0,0.0,0.0,0.0
253108.0,6,4,492,2,280,0.0,214.0,140.0,2,212,0.0,146.0,106.0
40928.0,6,14,4740,7,653,6534.5,249.0,93.28571428571428,7,4087,6154.166666666667,1514.0,583.8571428571429
205749.0,17,2,180,1,90,0.0,90.0,90.0,1,90,0.0,90.0,90.0
53510.0,6,14,4740,7,653,8786.333333333334,249.0,93.28571428571428,7,4087,8343.5,1514.0,583.8571428571429
94957421.0,17,12,778,6,389,18803731.0,174.0,64.83333333333333,6,389,18800163.2,174.0,64.83333333333333
40039.0,6,14,4740,7,653,6212.666666666667,249.0,93.28571428571428,7,4087,6290.833333333333,1514.0,583.8571428571429
319702.0,17,4,1400,4,1400,106567.33333333331,350.0,350.0,0,0,0.0,0.0,0.0
333.0,17,2,208,1,72,0.0,72.0,72.0,1,136,0.0,136.0,136.0
294.0,17,2,156,1,78,0.0,78.0,78.0,1,78,0.0,78.0,78.0
116343844.0,6,31,2166,16,1149,7741852.466666667,123.0,71.8125,15,1017,8294786.928571428,123.0,67.8
90052775.0,17,28,13364,28,13364,3335287.962962963,501.0,477.2857142857143,0,0,0.0,0.0,0.0
103304.0,17,2,286,2,286,0.0,143.0,143.0,0,0,0.0,0.0,0.0
218146.0,6,3,426,2,280,0.0,214.0,140.0,1,146,0.0,146.0,146.0
291208.0,17,4,1400,4,1400,97069.33333333331,350.0,350.0,0,0,0.0,0.0,0.0
95829937.0,17,13,4454,12,4104,6793868.0,342.0,342.0,1,350,0.0,350.0,350.0
107975.0,17,2,286,2,286,0.0,143.0,143.0,0,0,0.0,0.0,0.0
140969.0,6,2,132,1,66,0.0,66.0,66.0,1,66,0.0,66.0,66.0
14639842.0,6,19,1553,9,921,1791842.0,315.0,102.33333333333331,10,632,1592718.7777777778,78.0,63.2
200245.0,17,4,6056,4,6056,66748.33333333333,1514.0,1514.0,0,0,0.0,0.0,0.0
103861997.0,6,31,2314,16,1228,6924133.133333334,139.0,76.75,15,1086,7403262.428571428,123.0,72.4
106346.0,17,2,286,2,286,0.0,143.0,143.0,0,0,0.0,0.0,0.0
23653.0,6,12,1320,6,723,4129.4,253.0,120.5,6,597,4001.4,259.0,99.5
8870.0,17,2,498,1,80,0.0,80.0,80.0,1,418,0.0,418.0,418.0
141080.0,6,2,132,1,66,0.0,66.0,66.0,1,66,0.0,66.0,66.0
108106576.0,17,5,955,5,955,27026644.0,191.0,191.0,0,0,0.0,0.0,0.0
90043502.0,17,28,13364,28,13364,3334944.5185185187,501.0,477.2857142857143,0,0,0.0,0.0,0.0
319174.0,17,4,1400,4,1400,106391.33333333331,350.0,350.0,0,0,0.0,0.0,0.0
299439.0,6,6,412,4,272,99813.0,74.0,68.0,2,140,0.0,74.0,70.0
16325.0,6,14,4740,7,653,2529.6666666666665,249.0,93.28571428571428,7,4087,2584.1666666666665,1514.0,583.8571428571429
2439.0,17,4,344,2,150,0.0,75.0,75.0,2,194,0.0,103.0,97.0
2983724.0,6,3,1604,1,753,0.0,753.0,753.0,2,851,0.0,785.0,425.5
167600.0,17,2,180,1,90,0.0,90.0,90.0,1,90,0.0,90.0,90.0
205987.0,17,2,180,1,90,0.0,90.0,90.0,1,90,0.0,90.0,90.0
25409.0,6,14,4740,7,653,3932.1666666666665,249.0,93.28571428571428,7,4087,3530.6666666666665,1514.0,583.8571428571429
112139167.0,6,225,25266,113,7754,1001242.5625,140.0,68.61946902654867,112,17512,1000885.7657657658,284.0,156.35714285714286
108104811.0,17,5,1005,5,1005,27026202.75,201.0,201.0,0,0,0.0,0.0,0.0
42288.0,6,14,4740,7,653,6914.0,249.0,93.28571428571428,7,4087,6069.333333333333,1514.0,583.8571428571429
0.0,6,1,66,1,66,0.0,66.0,66.0,0,0,0.0,0.0,0.0
850992.0,6,9,1371,6,795,170198.4,457.0,132.5,3,576,289262.0,436.0,192.0
120056693.0,17,29,13785,29,13785,4287739.035714285,501.0,475.3448275862069,0,0,0.0,0.0,0.0
24535.0,6,14,4740,7,653,3959.3333333333335,249.0,93.28571428571428,7,4087,3809.6666666666665,1514.0,583.8571428571429
5015499.0,17,4,849,2,166,0.0,83.0,83.0,2,683,0.0,499.0,341.5
323123.0,17,4,1400,4,1400,107707.66666666669,350.0,350.0,0,0,0.0,0.0,0.0
119297016.0,6,20,1490,10,745,13255224.0,95.0,74.5,10,745,13226183.666666666,95.0,74.5
135136609.0,17,6,1206,6,1206,27027321.8,201.0,201.0,0,0,0.0,0.0,0.0
284830.0,17,4,704,2,148,0.0,74.0,74.0,2,556,0.0,280.0,278.0
228312.0,17,2,180,1,90,0.0,90.0,90.0,1,90,0.0,90.0,90.0
190910.0,17,2,180,1,90,0.0,90.0,90.0,1,90,0.0,90.0,90.0
113841.0,17,2,286,2,286,0.0,143.0,143.0,0,0,0.0,0.0,0.0
90258115.0,6,13,2036,8,1016,12894016.42857143,188.0,127.0,5,1020,22523174.5,204.0,204.0
320904.0,6,6,412,4,272,106968.0,74.0,68.0,2,140,0.0,74.0,70.0
172100.0,17,2,180,1,90,0.0,90.0,90.0,1,90,0.0,90.0,90.0
135139136.0,17,6,1146,6,1146,27027827.2,191.0,191.0,0,0,0.0,0.0,0.0
197028.0,17,2,180,1,90,0.0,90.0,90.0,1,90,0.0,90.0,90.0
0.0,17,1,161,1,161,0.0,161.0,161.0,0,0,0.0,0.0,0.0
153436.0,17,2,180,1,90,0.0,90.0,90.0,1,90,0.0,90.0,90.0
3013102.0,6,11,2106,6,598,601743.8,252.0,99.66666666666669,5,1508,3656.25,1236.0,301.6
120344416.0,6,351,40550,176,28704,687682.3771428572,374.0,163.0909090909091,175,11846,686401.4022988506,140.0,67.69142857142857
100875.0,17,2,286,2,286,0.0,143.0,143.0,0,0,0.0,0.0,0.0
317025.0,17,4,571,2,148,0.0,74.0,74.0,2,423,0.0,276.0,211.5
135134094.0,17,6,1206,6,1206,27026818.8,201.0,201.0,0,0,0.0,0.0,0.0
122114.0,6,3,373,2,238,0.0,172.0,119.0,1,135,0.0,135.0,135.0
235662.0,6,3,337,2,214,0.0,160.0,107.0,1,123,0.0,123.0,123.0
2386.0,17,4,344,2,150,0.0,75.0,75.0,2,194,0.0,103.0,97.0
111588373.0,6,32,2236,16,1165,7439224.866666666,139.0,72.8125,16,1071,7424794.4,123.0,66.9375
111176540.0,17,16,1474,8,737,15859666.857142856,174.0,92.125,8,737,15874087.142857144,174.0,92.125
49848.0,6,14,4740,7,653,8135.166666666667,249.0,93.28571428571428,7,4087,7999.833333333333,1514.0,583.8571428571429
3407.0,17,4,571,2,148,0.0,74.0,74.0,2,423,0.0,280.0,211.5
113365773.0,6,228,25756,114,17936,1001332.3451327434,284.0,157.33333333333334,114,7820,1001332.8849557522,140.0,68.59649122807018
324.0,17,2,208,1,72,0.0,72.0,72.0,1,136,0.0,136.0,136.0
120043585.0,17,29,13785,29,13785,4287270.892857143,501.0,475.3448275862069,0,0,0.0,0.0,0.0
146254.0,6,3,337,2,214,0.0,160.0,107.0,1,123,0.0,123.0,123.0
2374.0,17,4,344,2,150,0.0,75.0,75.0,2,194,0.0,103.0,97.0
102433526.0,6,40,2640,20,1320,4950011.421052632,66.0,66.0,20,1320,5314476.368421053,66.0,66.0
10452416.0,6,7,478,4,272,3438535.6666666665,74.0,68.0,3,206,5157661.0,74.0,68.66666666666667
9199.0,17,4,823,2,163,0.0,89.0,81.5,2,660,0.0,443.0,330.0
146113.0,6,3,337,2,214,0.0,160.0,107.0,1,123,0.0,123.0,123.0
125586644.0,6,34,2356,18,1285,7387449.647058823,139.0,71.38888888888889,16,1071,7692358.466666667,123.0,66.9375
0.0,17,1,178,1,178,0.0,178.0,178.0,0,0,0.0,0.0,0.0
12403.0,6,11,1131,6,600,2262.8,262.0,100.0,5,531,2877.75,259.0,106.2
131183.0,6,2,132,1,66,0.0,66.0,66.0,1,66,0.0,66.0,66.0
1711918.0,6,22,6443,11,1463,171191.8,357.0,133.0,11,4980,140545.5,1510.0,452.7272727272728
36684.0,6,10,1065,5,534,8221.75,262.0,106.8,5,531,8925.0,259.0,106.2
120125635.0,6,13,2036,5,1020,30031408.75,204.0,204.0,8,1016,17137793.14285714,188.0,127.0
233061.0,6,3,337,2,214,0.0,160.0,107.0,1,123,0.0,123.0,123.0
102095.0,17,2,762,2,762,0.0,381.0,381.0,0,0,0.0,0.0,0.0
148573.0,17,2,414,1,88,0.0,88.0,88.0,1,326,0.0,326.0,326.0
282780.0,17,2,363,1,79,0.0,79.0,79.0,1,284,0.0,284.0,284.0
90019272.0,17,28,13364,28,13364,3334047.111111111,501.0,477.2857142857143,0,0,0.0,0.0,0.0
51742.0,6,10,2032,5,524,12596.5,252.0,104.8,5,1508,12442.0,1236.0,301.6
101717824.0,17,14,864,7,432,16834222.666666668,174.0,61.71428571428572,7,432,16833489.833333332,174.0,61.71428571428572
16592925.999999998,6,20,1652,9,962,2035258.75,315.0,106.88888888888889,11,690,1628183.3,78.0,62.72727272727273
115562666.0,6,47,3102,24,1584,5024452.826086956,66.0,66.0,23,1518,5159994.136363637,66.0,66.0
4033.0,17,2,508,2,508,0.0,257.0,254.0,0,0,0.0,0.0,0.0
228267.0,17,2,180,1,90,0.0,90.0,90.0,1,90,0.0,90.0,90.0
158992.0,6,3,337,2,214,0.0,160.0,107.0,1,123,0.0,123.0,123.0
0.0,17,1,72,1,72,0.0,72.0,72.0,0,0,0.0,0.0,0.0
0.0,17,1,381,1,381,0.0,381.0,381.0,0,0,0.0,0.0,0.0
117456955.0,6,691,95412,346,72346,340454.94202898553,480.0,209.09248554913296,345,23066,340787.8401162791,140.0,66.85797101449275
14552173.0,17,6,2052,6,2052,2910434.6,342.0,342.0,0,0,0.0,0.0,0.0
103065.0,17,2,286,2,286,0.0,143.0,143.0,0,0,0.0,0.0,0.0
208266.0,6,3,426,2,280,0.0,214.0,140.0,1,146,0.0,146.0,146.0
96319762.0,6,40,2640,20,1320,5069461.157894737,66.0,66.0,20,1320,5053210.947368421,66.0,66.0
105614.0,17,4,1400,4,1400,35204.666666666664,350.0,350.0,0,0,0.0,0.0,0.0
1046058.0,6,11,1134,6,558,209211.6,220.0,93.0,5,576,260405.5,304.0,115.2
232275.0,6,3,337,2,214,0.0,160.0,107.0,1,123,0.0,123.0,123.0
2593112.0,6,2,132,1,66,0.0,66.0,66.0,1,66,0.0,66.0,66.0
90045354.0,17,28,13364,28,13364,3335013.111111111,501.0,477.2857142857143,0,0,0.0,0.0,0.0
2598152.0,6,2,132,1,66,0.0,66.0,66.0,1,66,0.0,66.0,66.0
1178894.0,6,13,3010,8,2382,168413.42857142858,1514.0,297.75,5,628,226609.25,331.0,125.6
121885989.0,6,26,2019,14,1084,7065523.0,95.0,77.42857142857143,12,935,11076124.272727272,95.0,77.91666666666667
113852.0,6,14,4740,7,653,18719.33333333333,249.0,93.28571428571428,7,4087,18746.33333333333,1514.0,583.8571428571429
1101997.0,6,13,1386,7,789,183666.16666666663,253.0,112.71428571428572,6,597,218841.4,259.0,99.5
2017819.0,17,4,525,2,150,0.0,75.0,75.0,2,375,0.0,284.0,187.5
100195167.0,17,13,821,7,432,16666847.333333334,174.0,61.71428571428572,6,389,20001012.2,174.0,64.83333333333333
25853.0,6,14,4740,7,653,3565.833333333333,249.0,93.28571428571428,7,4087,4151.833333333333,1514.0,583.8571428571429
270163.0,6,3,337,2,214,0.0,160.0,107.0,1,123,0.0,123.0,123.0
10537703.0,6,7,478,4,272,3465800.333333333,74.0,68.0,3,206,5198607.5,74.0,68.66666666666667
15522.0,6,14,4740,7,653,2430.1666666666665,249.0,93.28571428571428,7,4087,2448.6666666666665,1514.0,583.8571428571429
34105.0,6,14,4740,7,653,5216.166666666667,249.0,93.28571428571428,7,4087,5327.5,1514.0,583.8571428571429
166607.0,17,2,231,1,78,0.0,78.0,78.0,1,153,0.0,153.0,153.0
268906.0,6,10,1221,6,636,53781.2,298.0,106.0,4,585,84056.66666666667,379.0,146.25
531.0,17,2,508,2,508,0.0,257.0,254.0,0,0,0.0,0.0,0.0
10362.0,17,4,823,2,163,0.0,89.0,81.5,2,660,0.0,443.0,330.0
114959723.0,6,263,29882,132,9008,877555.1374045801,140.0,68.24242424242425,131,20874,863758.0615384616,284.0,159.34351145038167
108109297.0,17,5,1005,5,1005,27027324.25,201.0,201.0,0,0,0.0,0.0,0.0
94381172.0,6,40,2640,20,1320,4967430.105263158,66.0,66.0,20,1320,4950990.315789473,66.0,66.0
108104736.0,17,5,1005,5,1005,27026184.0,201.0,201.0,0,0,0.0,0.0,0.0
330935.0,6,6,412,4,272,110311.66666666669,74.0,68.0,2,140,0.0,74.0,70.0
144.0,17,2,700,2,700,0.0,350.0,350.0,0,0,0.0,0.0,0.0
12698.0,6,11,2098,6,590,2354.0,252.0,98.33333333333331,5,1508,2434.0,1236.0,301.6
53950.0,6,14,4740,7,653,8866.0,249.0,93.28571428571428,7,4087,7769.666666666667,1514.0,583.8571428571429
34720475.0,6,5,336,2,134,0.0,68.0,67.0,3,202,16065086.5,70.0,67.33333333333333
316232.0,17,4,1400,4,1400,105410.66666666669,350.0,350.0,0,0,0.0,0.0,0.0
108934.0,17,2,286,2,286,0.0,143.0,143.0,0,0,0.0,0.0,0.0
757.0,17,4,438,2,148,0.0,74.0,74.0,2,290,0.0,147.0,145.0
0.0,17,1,342,1,342,0.0,342.0,342.0,0,0,0.0,0.0,0.0
1314769.0,6,4,264,2,132,0.0,66.0,66.0,2,132,0.0,66.0,66.0
103140.0,17,2,286,2,286,0.0,143.0,143.0,0,0,0.0,0.0,0.0
1315583.0,6,4,264,2,132,0.0,66.0,66.0,2,132,0.0,66.0,66.0
117848870.0,6,29,1914,15,948,8417776.42857143,123.0,63.2,14,966,8280466.538461538,123.0,69.0
2317116.0,6,25,7573,14,3735,178239.6923076923,1514.0,266.7857142857143,11,3838,206171.9,1514.0,348.90909090909093
118034574.0,17,14,864,7,432,19666815.166666668,174.0,61.71428571428572,7,432,19668161.166666668,174.0,61.71428571428572
113520299.0,6,46,3036,23,1518,5159998.727272728,66.0,66.0,23,1518,5160000.454545454,66.0,66.0
56241.0,6,11,1131,6,600,10950.4,262.0,100.0,5,531,3073.75,259.0,106.2
62827.99999999999,6,14,4740,7,653,8701.666666666666,249.0,93.28571428571428,7,4087,9445.833333333334,1514.0,583.8571428571429
310112.0,6,6,412,4,272,103370.66666666669,74.0,68.0,2,140,0.0,74.0,70.0
3009404.0,6,11,2106,6,598,601604.2,252.0,99.66666666666669,5,1508,2626.75,1236.0,301.6
120142560.0,6,274,31814,137,9338,877392.5367647059,140.0,68.16058394160584,137,22476,877412.1691176471,284.0,164.05839416058393
234237.0,6,3,337,2,214,0.0,160.0,107.0,1,123,0.0,123.0,123.0
328.0,17,2,166,1,75,0.0,75.0,75.0,1,91,0.0,91.0,91.0
47415.0,6,14,4740,7,653,7784.333333333333,249.0,93.28571428571428,7,4087,7728.0,1514.0,583.8571428571429
41076.0,6,14,4740,7,653,6627.5,249.0,93.28571428571428,7,4087,6499.333333333333,1514.0,583.8571428571429
1534456.0,6,18,6507,10,1598,170495.11111111112,505.0,159.8,8,4909,174163.57142857142,1510.0,613.625
225614.0,17,4,1400,4,1400,75204.66666666667,350.0,350.0,0,0,0.0,0.0,0.0
395.0,17,2,410,1,78,0.0,78.0,78.0,1,332,0.0,332.0,332.0
121911.0,6,3,373,2,238,0.0,172.0,119.0,1,135,0.0,135.0,135.0
213597.0,17,2,180,1,90,0.0,90.0,90.0,1,90,0.0,90.0,90.0
307998.0,6,6,412,4,272,102666.0,74.0,68.0,2,140,0.0,74.0,70.0
120012165.0,6,24,1829,13,989,10001013.75,95.0,76.07692307692308,11,840,11975311.9,95.0,76.36363636363636
37009.0,6,14,4740,7,653,5977.166666666667,249.0,93.28571428571428,7,4087,4712.166666666667,1514.0,583.8571428571429
28188.0,6,10,2032,5,524,6517.25,252.0,104.8,5,1508,6805.25,1236.0,301.6
128005658.0,17,15,907,8,475,18286522.57142857,174.0,59.375,7,432,18000158.666666668,174.0,61.71428571428572
16426.0,17,4,344,2,150,0.0,75.0,75.0,2,194,0.0,103.0,97.0
121899.0,6,3,373,2,238,0.0,172.0,119.0,1,135,0.0,135.0,135.0
245331.0,6,3,337,2,214,0.0,160.0,107.0,1,123,0.0,123.0,123.0
92546.0,6,12,1328,7,797,15424.333333333334,253.0,113.85714285714286,5,531,20914.75,259.0,106.2
291778.0,17,2,224,1,76,0.0,76.0,76.0,1,148,0.0,148.0,148.0
352991.0,6,6,412,4,272,117663.66666666669,74.0,68.0,2,140,0.0,74.0,70.0
90068991.0,17,28,13364,28,13364,3335888.5555555555,501.0,477.2857142857143,0,0,0.0,0.0,0.0
90013268.0,17,27,12943,27,12943,3462048.769230769,501.0,479.3703703703704,0,0,0.0,0.0,0.0
101173.0,17,2,762,2,762,0.0,381.0,381.0,0,0,0.0,0.0,0.0
378.0,17,2,267,1,83,0.0,83.0,83.0,1,184,0.0,184.0,184.0
10485418.0,6,7,478,4,272,3449745.6666666665,74.0,68.0,3,206,5174523.0,74.0,68.66666666666667
119560074.0,6,212,23996,106,16778,1136618.1523809524,284.0,158.28301886792454,106,7218,1136617.7904761904,140.0,68.09433962264151
260303.0,17,4,1524,4,1524,86767.66666666667,381.0,381.0,0,0,0.0,0.0,0.0
123301372.0,6,48,3168,24,1584,4997594.739130435,66.0,66.0,24,1584,5298975.521739131,66.0,66.0
314077.0,17,4,1400,4,1400,104692.33333333331,350.0,350.0,0,0,0.0,0.0,0.0
34924.0,6,14,4740,7,653,5271.0,249.0,93.28571428571428,7,4087,5260.166666666667,1514.0,583.8571428571429
108688188.0,6,37,2788,19,1471,6026230.055555556,139.0,77.42105263157895,18,1317,6380678.176470588,123.0,73.16666666666667
120000122.0,6,20,1531,11,840,12000012.2,95.0,76.36363636363636,9,691,11285517.0,95.0,76.77777777777777
242020.0,6,3,337,2,214,0.0,160.0,107.0,1,123,0.0,123.0,123.0
348.0,17,2,267,1,83,0.0,83.0,83.0,1,184,0.0,184.0,184.0
227006.0,6,10,1221,6,636,45401.2,298.0,106.0,4,585,74475.66666666667,379.0,146.25
205817.0,17,2,180,1,90,0.0,90.0,90.0,1,90,0.0,90.0,90.0
120119431.0,6,13,2036,5,1020,30029857.75,204.0,204.0,8,1016,17136431.0,188.0,127.0
100790566.0,6,28,1876,14,982,7736521.846153846,139.0,70.14285714285714,14,894,7736528.923076923,123.0,63.85714285714285
209542.0,17,2,180,1,90,0.0,90.0,90.0,1,90,0.0,90.0,90.0
114298729.0,6,48,3168,24,1584,4969509.956521739,66.0,66.0,24,1584,4957661.695652174,66.0,66.0
164783.0,17,2,414,1,88,0.0,88.0,88.0,1,326,0.0,326.0,326.0
205866.0,17,2,180,1,90,0.0,90.0,90.0,1,90,0.0,90.0,90.0
39380.0,6,14,4740,7,653,6392.333333333333,249.0,93.28571428571428,7,4087,6340.333333333333,1514.0,583.8571428571429
19585.0,6,10,2032,5,524,4349.5,252.0,104.8,5,1508,4388.0,1236.0,301.6
146099.0,6,3,337,2,214,0.0,160.0,107.0,1,123,0.0,123.0,123.0
81.0,17,2,762,2,762,0.0,381.0,381.0,0,0,0.0,0.0,0.0
33451.0,6,14,4740,7,653,5271.5,249.0,93.28571428571428,7,4087,5209.0,1514.0,583.8571428571429
76284.0,6,12,1328,6,731,13634.6,253.0,121.83333333333331,6,597,13819.0,259.0,99.5
135126407.0,17,6,1206,6,1206,27025281.4,201.0,201.0,0,0,0.0,0.0,0.0
1313787.0,6,4,264,2,132,0.0,66.0,66.0,2,132,0.0,66.0,66.0
246528.0,6,3,337,2,214,0.0,160.0,107.0,1,123,0.0,123.0,123.0
2439.0,17,4,344,2,150,0.0,75.0,75.0,2,194,0.0,103.0,97.0
833.0,17,4,438,2,148,0.0,74.0,74.0,2,290,0.0,147.0,145.0
30200.0,6,14,4740,7,653,4911.666666666667,249.0,93.28571428571428,7,4087,4847.833333333333,1514.0,583.8571428571429
5796.0,17,4,344,2,150,0.0,75.0,75.0,2,194,0.0,103.0,97.0
111070.0,17,2,286,2,286,0.0,143.0,143.0,0,0,0.0,0.0,0.0
221298.0,6,10,1221,6,636,44259.6,298.0,106.0,4,585,72616.66666666667,379.0,146.25
38493.0,6,14,4740,7,653,6293.666666666667,249.0,93.28571428571428,7,4087,6245.833333333333,1514.0,583.8571428571429
325.0,17,2,208,1,72,0.0,72.0,72.0,1,136,0.0,136.0,136.0
108122691.0,17,5,955,5,955,27030672.75,191.0,191.0,0,0,0.0,0.0,0.0
216322.0,17,2,180,1,90,0.0,90.0,90.0,1,90,0.0,90.0,90.0
39869.0,6,10,2032,5,524,9689.0,252.0,104.8,5,1508,8463.5,1236.0,301.6
233947.0,6,3,373,2,238,0.0,172.0,119.0,1,135,0.0,135.0,135.0
882818.0,6,9,1270,6,799,176563.6,461.0,133.16666666666666,3,471,303605.5,331.0,157.0
98310039.0,17,14,1126,7,563,16334226.5,174.0,80.42857142857143,7,563,16333469.5,174.0,80.42857142857143
206509.0,17,2,180,1,90,0.0,90.0,90.0,1,90,0.0,90.0,90.0
141772.0,17,4,704,2,148,0.0,74.0,74.0,2,556,0.0,280.0,278.0
2851352.0,6,12,2172,7,664,475062.6666666667,252.0,94.85714285714286,5,1508,3809.25,1236.0,301.6
13221.0,6,12,1393,6,796,2509.6,271.0,132.66666666666666,6,597,2342.8,259.0,99.5
209598.0,17,2,180,1,90,0.0,90.0,90.0,1,90,0.0,90.0,90.0
31609.0,6,14,4740,7,653,5087.5,249.0,93.28571428571428,7,4087,4862.0,1514.0,583.8571428571429
8639314.0,17,3,1034,2,684,0.0,342.0,342.0,1,350,0.0,350.0,350.0
128001155.0,17,15,907,8,475,18285879.285714287,174.0,59.375,7,432,18001452.833333332,174.0,61.71428571428572
2327.0,17,4,344,2,150,0.0,75.0,75.0,2,194,0.0,103.0,97.0
5621891.0,6,5,336,2,134,0.0,68.0,67.0,3,202,1424748.5,70.0,67.33333333333333
120251729.0,6,222,25090,111,7622,1076466.809090909,140.0,68.66666666666667,111,17468,1090562.2363636363,284.0,157.36936936936937
212884.0,6,10,1221,6,636,42576.8,298.0,106.0,4,585,69952.66666666667,379.0,146.25
120082245.0,6,240,27104,120,8216,1002176.7983193278,140.0,68.46666666666667,120,18888,994507.4453781513,284.0,157.4
2945368.0,6,11,2106,6,598,588877.8,252.0,99.66666666666669,5,1508,3136.5,1236.0,301.6
302348.0,6,3,202,2,128,0.0,74.0,64.0,1,74,0.0,74.0,74.0
440.0,17,2,267,1,83,0.0,83.0,83.0,1,184,0.0,184.0,184.0
119832192.0,6,218,24764,109,17336,1107563.9351851852,284.0,159.045871559633,109,7428,1107564.6759259258,140.0,68.14678899082568
0.0,17,1,179,1,179,0.0,179.0,179.0,0,0,0.0,0.0,0.0
426324.0,6,3,1604,2,851,0.0,785.0,425.5,1,753,0.0,753.0,753.0
120068172.0,17,29,13785,29,13785,4288149.0,501.0,475.3448275862069,0,0,0.0,0.0,0.0
90057574.0,6,13,1914,6,1086,18011057.6,204.0,181.0,7,828,15008722.166666666,188.0,118.28571428571428
143963.0,17,2,180,1,90,0.0,90.0,90.0,1,90,0.0,90.0,90.0
129008749.0,17,17,1779,8,868,15567989.42857143,174.0,108.5,9,911,16106228.875,174.0,101.22222222222224
121430269.0,6,231,26690,116,18878,1055915.3826086957,284.0,162.74137931034485,115,7812,1038878.5614035088,140.0,67.9304347826087
119840404.0,6,280,31814,140,22278,860611.3597122302,284.0,159.12857142857143,140,9536,860612.7913669065,140.0,68.11428571428571
39231.0,6,14,4740,7,653,6389.666666666667,249.0,93.28571428571428,7,4087,5937.0,1514.0,583.8571428571429
1309948.0,6,4,264,2,132,0.0,66.0,66.0,2,132,0.0,66.0,66.0
1306988.0,6,4,264,2,132,0.0,66.0,66.0,2,132,0.0,66.0,66.0
255167.0,6,3,337,2,214,0.0,160.0,107.0,1,123,0.0,123.0,123.0
32970.0,6,10,2032,5,524,6662.0,252.0,104.8,5,1508,7916.25,1236.0,301.6
135138587.0,17,6,1206,6,1206,27027717.4,201.0,201.0,0,0,0.0,0.0,0.0
30407.0,6,14,4740,7,653,4888.666666666667,249.0,93.28571428571428,7,4087,4637.5,1514.0,583.8571428571429
144033.0,17,2,180,1,90,0.0,90.0,90.0,1,90,0.0,90.0,90.0
504202.00000000006,6,5,336,2,134,0.0,68.0,67.0,3,202,185522.0,70.0,67.33333333333333
10936604.0,6,8,544,4,272,3598773.6666666665,74.0,68.0,4,272,3598682.0,74.0,68.0
90215208.0,6,22,1680,10,786,9995844.777777778,95.0,78.6,12,894,8181812.181818182,95.0,74.5
279795.0,17,2,180,1,90,0.0,90.0,90.0,1,90,0.0,90.0,90.0
209368.0,17,2,180,1,90,0.0,90.0,90.0,1,90,0.0,90.0,90.0
143880.0,17,2,180,1,90,0.0,90.0,90.0,1,90,0.0,90.0,90.0
106921.0,17,2,286,2,286,0.0,143.0,143.0,0,0,0.0,0.0,0.0
2121423.0,6,19,6869,11,1567,212142.3,408.0,142.45454545454547,8,5302,240604.7142857143,1514.0,662.75
32848.0,6,14,4740,7,653,5184.333333333333,249.0,93.28571428571428,7,4087,5338.0,1514.0,583.8571428571429
90119068.0,6,12,1572,7,828,15019844.666666666,188.0,118.28571428571428,5,744,15012579.75,204.0,148.8
17043.0,6,14,4740,7,653,2688.333333333333,249.0,93.28571428571428,7,4087,2542.833333333333,1514.0,583.8571428571429
4345.0,17,2,614,1,72,0.0,72.0,72.0,1,542,0.0,542.0,542.0
2510.0,17,4,344,2,150,0.0,75.0,75.0,2,194,0.0,103.0,97.0
1363205.0,6,4,276,2,128,0.0,74.0,64.0,2,148,0.0,74.0,74.0
146126.0,6,3,337,2,214,0.0,160.0,107.0,1,123,0.0,123.0,123.0
232426.0,6,3,337,2,214,0.0,160.0,107.0,1,123,0.0,123.0,123.0
90304153.0,6,16,1192,8,596,12893230.42857143,95.0,74.5,8,596,12898824.857142856,95.0,74.5
14948.0,6,10,1067,5,536,3366.75,264.0,107.2,5,531,3013.5,259.0,106.2
3835634.0,6,5,336,2,134,0.0,68.0,67.0,3,202,527630.5,70.0,67.33333333333333
855812.0,6,5,1742,3,921,427906.0,785.0,307.0,2,821,0.0,753.0,410.5
118025.0,6,13,1386,7,789,19670.83333333333,253.0,112.71428571428572,6,597,21793.8,259.0,99.5
53113.0,6,14,4740,7,653,8511.666666666666,249.0,93.28571428571428,7,4087,8602.0,1514.0,583.8571428571429
205757.0,17,2,762,2,762,0.0,381.0,381.0,0,0,0.0,0.0,0.0
40386.0,6,14,4740,7,653,6563.666666666667,249.0,93.28571428571428,7,4087,6467.166666666667,1514.0,583.8571428571429
1437.0,17,2,762,2,762,0.0,381.0,381.0,0,0,0.0,0.0,0.0
1072553.0,17,6,1230,3,234,536085.0,78.0,78.0,3,996,536073.5,332.0,332.0
218912.0,6,3,426,2,280,0.0,214.0,140.0,1,146,0.0,146.0,146.0
50769.0,17,2,180,1,90,0.0,90.0,90.0,1,90,0.0,90.0,90.0
1920.0,17,2,762,2,762,0.0,381.0,381.0,0,0,0.0,0.0,0.0
474.0,17,2,508,2,508,0.0,257.0,254.0,0,0,0.0,0.0,0.0
114458450.0,6,32,2236,16,1165,7616938.333333333,139.0,72.8125,16,1071,7616928.066666666,123.0,66.9375
37127.0,6,10,2032,5,524,8832.0,252.0,104.8,5,1508,8724.25,1236.0,301.6
146214.0,6,3,337,2,214,0.0,160.0,107.0,1,123,0.0,123.0,123.0
18058.0,6,13,1459,7,862,2963.6666666666665,271.0,123.14285714285714,6,597,2378.4,259.0,99.5
196832.0,17,2,180,1,90,0.0,90.0,90.0,1,90,0.0,90.0,90.0
50276.0,6,14,4740,7,653,8205.0,249.0,93.28571428571428,7,4087,7831.0,1514.0,583.8571428571429
320529.0,17,4,1400,4,1400,106843.0,350.0,350.0,0,0,0.0,0.0,0.0
5101.0,17,4,625,2,163,0.0,89.0,81.5,2,462,0.0,245.0,231.0
90015537.0,17,28,13364,28,13364,3333908.777777778,501.0,477.2857142857143,0,0,0.0,0.0,0.0
247017.0,17,2,180,1,90,0.0,90.0,90.0,1,90,0.0,90.0,90.0
135129738.0,17,6,1146,6,1146,27025947.6,191.0,191.0,0,0,0.0,0.0,0.0
2392.0,17,4,344,2,150,0.0,75.0,75.0,2,194,0.0,103.0,97.0
108105933.0,17,5,1005,5,1005,27026483.25,201.0,201.0,0,0,0.0,0.0,0.0
120069351.0,17,28,13364,28,13364,4447013.0,501.0,477.2857142857143,0,0,0.0,0.0,0.0
55524.0,6,10,2032,5,524,13662.75,252.0,104.8,5,1508,12297.75,1236.0,301.6
120060018.0,17,29,13785,29,13785,4287857.785714285,501.0,475.3448275862069,0,0,0.0,0.0,0.0
19645.0,6,2,145,2,145,0.0,91.0,72.5,0,0,0.0,0.0,0.0
0.0,17,1,55,1,55,0.0,55.0,55.0,0,0,0.0,0.0,0.0
1773.0,17,2,664,1,322,0.0,322.0,322.0,1,342,0.0,342.0,342.0
228534.0,17,2,180,1,90,0.0,90.0,90.0,1,90,0.0,90.0,90.0
8989697.0,17,3,1034,2,684,0.0,342.0,342.0,1,350,0.0,350.0,350.0
120128873.0,6,14,2224,9,1204,15016109.125,188.0,133.77777777777777,5,1020,22523359.75,204.0,204.0
0.0,6,1,66,0,0,0.0,0.0,0.0,1,66,0.0,66.0,66.0
319229.0,17,4,1400,4,1400,106409.66666666669,350.0,350.0,0,0,0.0,0.0,0.0
111869347.0,6,32,2220,16,1149,7443564.333333333,123.0,71.8125,16,1071,7443567.0,123.0,66.9375
317298.0,6,3,202,2,128,0.0,74.0,64.0,1,74,0.0,74.0,74.0
120105025.0,6,13,2036,5,1020,30026256.25,204.0,204.0,8,1016,17134572.57142857,188.0,127.0
110194139.0,6,44,2904,22,1452,5247339.952380952,66.0,66.0,22,1452,5232812.428571428,66.0,66.0
141328.0,6,2,132,1,66,0.0,66.0,66.0,1,66,0.0,66.0,66.0
0.0,17,1,381,1,381,0.0,381.0,381.0,0,0,0.0,0.0,0.0
2314755.0,6,30,9358,17,3897,144672.1875,1514.0,229.23529411764707,13,5461,170451.58333333334,1514.0,420.0769230769231
17194.0,6,11,2098,6,590,3037.0,252.0,98.33333333333331,5,1508,3784.0,1236.0,301.6
205900.0,6,3,426,2,280,0.0,214.0,140.0,1,146,0.0,146.0,146.0
90048269.0,17,28,13364,28,13364,3335121.074074074,501.0,477.2857142857143,0,0,0.0,0.0,0.0
298499.0,6,6,412,4,272,99499.66666666669,74.0,68.0,2,140,0.0,74.0,70.0
356.0,17,2,166,1,75,0.0,75.0,75.0,1,91,0.0,91.0,91.0
39361.0,6,14,4740,7,653,5760.5,249.0,93.28571428571428,7,4087,6421.5,1514.0,583.8571428571429
139715.0,6,2,132,1,66,0.0,66.0,66.0,1,66,0.0,66.0,66.0
17259.0,17,2,180,1,90,0.0,90.0,90.0,1,90,0.0,90.0,90.0
568789.0,17,2,876,2,876,0.0,438.0,438.0,0,0,0.0,0.0,0.0
35511.0,6,14,4740,7,653,5793.333333333333,249.0,93.28571428571428,7,4087,5422.166666666667,1514.0,583.8571428571429
27338.0,6,10,2032,5,524,6599.0,252.0,104.8,5,1508,6598.5,1236.0,301.6
39078.0,6,14,4740,7,653,5693.833333333333,249.0,93.28571428571428,7,4087,6235.5,1514.0,583.8571428571429
160068.0,6,3,337,2,214,0.0,160.0,107.0,1,123,0.0,123.0,123.0
3478213.0,6,198,163235,112,153257,31020.85585585585,1510.0,1368.366071428571,86,9978,37398.91764705882,1510.0,116.02325581395348
90259715.0,6,13,2036,8,1016,12894245.0,188.0,127.0,5,1020,22523167.5,204.0,204.0
10424076.0,6,6,412,3,206,5143987.5,74.0,68.66666666666667,3,206,5143852.0,74.0,68.66666666666667
232501.0,6,3,337,2,214,0.0,160.0,107.0,1,123,0.0,123.0,123.0
116723402.0,6,47,3102,24,1584,5063096.043478261,66.0,66.0,23,1518,5135443.2727272725,66.0,66.0
303656.0,6,6,412,4,272,101218.66666666669,74.0,68.0,2,140,0.0,74.0,70.0
90283104.0,6,17,1287,8,637,12897586.285714284,95.0,79.625,9,650,11248764.75,95.0,72.22222222222223
2318.0,17,4,344,2,150,0.0,75.0,75.0,2,194,0.0,103.0,97.0
2420.0,17,4,344,2,150,0.0,75.0,75.0,2,194,0.0,103.0,97.0
112464301.0,6,46,3036,23,1518,5111999.090909091,66.0,66.0,23,1518,5112001.909090909,66.0,66.0
146279.0,6,3,337,2,214,0.0,160.0,107.0,1,123,0.0,123.0,123.0
90524653.0,6,15,2444,8,1016,12932093.285714284,188.0,127.0,7,1428,15057902.333333334,204.0,204.0
510001.00000000006,6,5,336,2,134,0.0,68.0,67.0,3,202,195608.5,70.0,67.33333333333333
171646.0,17,2,180,1,90,0.0,90.0,90.0,1,90,0.0,90.0,90.0
120088006.0,17,28,13364,28,13364,4447703.925925926,501.0,477.2857142857143,0,0,0.0,0.0,0.0
302411.0,6,2,132,1,66,0.0,66.0,66.0,1,66,0.0,66.0,66.0
313979.0,17,4,1400,4,1400,104659.66666666669,350.0,350.0,0,0,0.0,0.0,0.0
208227.0,6,11,1132,6,556,41453.2,218.0,92.66666666666669,5,576,49529.0,304.0,115.2
1306850.0,6,4,264,2,132,0.0,66.0,66.0,2,132,0.0,66.0,66.0
298.0,17,2,156,1,78,0.0,78.0,78.0,1,78,0.0,78.0,78.0
51044.0,6,10,2032,5,524,12405.75,252.0,104.8,5,1508,10041.25,1236.0,301.6
42579001.0,6,8,1307,8,1307,6082714.428571428,172.0,163.375,0,0,0.0,0.0,0.0
38866.0,6,10,2032,5,524,8585.25,252.0,104.8,5,1508,9319.75,1236.0,301.6
144949.0,17,2,180,1,70,0.0,70.0,70.0,1,110,0.0,110.0,110.0
96914949.0,6,177,19954,89,6022,1101306.2386363635,140.0,67.66292134831461,88,13932,1102240.8505747127,284.0,158.3181818181818
10049.0,17,2,582,1,83,0.0,83.0,83.0,1,499,0.0,499.0,499.0
59995.0,6,11,2098,6,590,10750.0,252.0,98.33333333333331,5,1508,13586.5,1236.0,301.6
104426.0,17,2,286,2,286,0.0,143.0,143.0,0,0,0.0,0.0,0.0
521.0,17,2,508,2,508,0.0,257.0,254.0,0,0,0.0,0.0,0.0
120042116.0,6,19,1395,10,745,13332428.555555556,95.0,74.5,9,650,14999039.0,95.0,72.22222222222223
114118214.0,6,36,2580,18,1332,6712836.117647059,123.0,74.0,18,1248,6700738.352941177,123.0,69.33333333333333
502.0,17,2,508,2,508,0.0,257.0,254.0,0,0,0.0,0.0,0.0
108102667.0,17,5,955,5,955,27025666.75,191.0,191.0,0,0,0.0,0.0,0.0
36444.0,6,10,2032,5,524,8518.0,252.0,104.8,5,1508,8887.5,1236.0,301.6
740614.0,6,2,132,1,66,0.0,66.0,66.0,1,66,0.0,66.0,66.0
161067.0,17,2,180,1,90,0.0,90.0,90.0,1,90,0.0,90.0,90.0
2603657.0,6,2,132,1,66,0.0,66.0,66.0,1,66,0.0,66.0,66.0
381898.0,6,10,1221,6,636,76379.6,298.0,106.0,4,585,125376.33333333331,379.0,146.25
90058753.0,17,28,13364,28,13364,3335509.3703703703,501.0,477.2857142857143,0,0,0.0,0.0,0.0
144325.0,17,2,180,1,70,0.0,70.0,70.0,1,110,0.0,110.0,110.0
190870.0,17,2,180,1,90,0.0,90.0,90.0,1,90,0.0,90.0,90.0
5013672.0,6,11,1139,6,608,1001958.6,262.0,101.33333333333331,5,531,3236.0,259.0,106.2
120123859.0,6,12,1832,8,1016,17137404.285714287,188.0,127.0,4,816,30031368.33333333,204.0,204.0
345929.0,6,3,204,2,136,0.0,70.0,68.0,1,68,0.0,68.0,68.0
248660.0,17,2,180,1,90,0.0,90.0,90.0,1,90,0.0,90.0,90.0
35000.0,6,14,4740,7,653,5441.0,249.0,93.28571428571428,7,4087,5660.166666666667,1514.0,583.8571428571429
319046.0,6,6,412,4,272,106348.66666666669,74.0,68.0,2,140,0.0,74.0,70.0
12679.0,6,11,1132,6,556,2357.6,218.0,92.66666666666669,5,576,2972.5,304.0,115.2
6817.0,17,2,582,1,83,0.0,83.0,83.0,1,499,0.0,499.0,499.0
156271.0,17,4,571,2,148,0.0,74.0,74.0,2,423,0.0,276.0,211.5
50823.0,17,2,180,1,90,0.0,90.0,90.0,1,90,0.0,90.0,90.0
2048.0,17,4,344,2,150,0.0,75.0,75.0,2,194,0.0,103.0,97.0
234825.0,6,3,337,2,214,0.0,160.0,107.0,1,123,0.0,123.0,123.0
39563.0,6,14,4740,7,653,6475.833333333333,249.0,93.28571428571428,7,4087,6239.833333333333,1514.0,583.8571428571429
297919.0,6,6,412,4,272,99306.33333333331,74.0,68.0,2,140,0.0,74.0,70.0
509516.0,6,4,270,2,134,0.0,68.0,67.0,2,136,0.0,70.0,68.0
90059238.0,17,27,12943,27,12943,3463816.846153846,501.0,479.3703703703704,0,0,0.0,0.0,0.0
5622839.0,6,5,336,2,134,0.0,68.0,67.0,3,202,1526016.0,70.0,67.33333333333333
298940.0,6,6,412,4,272,99646.66666666669,74.0,68.0,2,140,0.0,74.0,70.0
206217.0,6,3,426,2,280,0.0,214.0,140.0,1,146,0.0,146.0,146.0
120279967.0,6,220,25202,110,7556,1097050.2018348624,140.0,68.69090909090909,110,17646,1095989.6788990826,300.0,160.4181818181818
693088.0,6,4,497,3,374,346544.0,160.0,124.66666666666669,1,123,0.0,123.0,123.0
2805811.0,6,2,132,1,66,0.0,66.0,66.0,1,66,0.0,66.0,66.0
205896.0,6,3,426,2,280,0.0,214.0,140.0,1,146,0.0,146.0,146.0
117407071.0,6,269,30564,135,9132,876172.171641791,140.0,67.64444444444445,134,21432,874953.3759398496,284.0,159.9402985074627
2323.0,17,4,344,2,150,0.0,75.0,75.0,2,194,0.0,103.0,97.0
103855.0,17,2,286,2,286,0.0,143.0,143.0,0,0,0.0,0.0,0.0
144157.0,17,2,180,1,90,0.0,90.0,90.0,1,90,0.0,90.0,90.0
115431430.0,6,36,2596,18,1348,6777392.352941177,139.0,74.88888888888889,18,1248,6777387.529411765,123.0,69.33333333333333
2694791.0,6,2,132,1,66,0.0,66.0,66.0,1,66,0.0,66.0,66.0
24692522.0,17,5,1718,4,1368,999610.6666666666,342.0,342.0,1,350,0.0,350.0,350.0
408.0,17,2,410,1,78,0.0,78.0,78.0,1,332,0.0,332.0,332.0
233875.0,6,3,337,2,214,0.0,160.0,107.0,1,123,0.0,123.0,123.0
255468.0,6,3,337,2,214,0.0,160.0,107.0,1,123,0.0,123.0,123.0
70386.0,17,2,610,1,72,0.0,72.0,72.0,1,538,0.0,538.0,538.0
876279.0,6,10,1334,6,797,175255.8,459.0,132.83333333333334,4,537,199854.3333333333,331.0,134.25
216843.0,6,3,426,2,280,0.0,214.0,140.0,1,146,0.0,146.0,146.0
243578.0,6,3,337,2,214,0.0,160.0,107.0,1,123,0.0,123.0,123.0
1004368.0,6,13,1428,7,797,166919.5,253.0,113.85714285714286,6,631,200280.0,293.0,105.16666666666669
205264.0,17,2,762,2,762,0.0,381.0,381.0,0,0,0.0,0.0,0.0
254625.0,6,10,1221,6,636,50925.0,298.0,106.0,4,585,79474.66666666667,379.0,146.25
38187.0,6,14,4740,7,653,5820.666666666667,249.0,93.28571428571428,7,4087,6216.0,1514.0,583.8571428571429
90046722.0,17,28,13364,28,13364,3335063.777777778,501.0,477.2857142857143,0,0,0.0,0.0,0.0
0.0,6,1,60,1,60,0.0,60.0,60.0,0,0,0.0,0.0,0.0
3560610.0,6,187,140547,98,130371,36707.31958762887,1510.0,1330.3163265306123,89,10176,36941.61363636364,1510.0,114.3370786516854
135133161.0,17,6,1146,6,1146,27026632.2,191.0,191.0,0,0,0.0,0.0,0.0
1764929.0,6,2,132,1,66,0.0,66.0,66.0,1,66,0.0,66.0,66.0
100766.0,17,2,762,2,762,0.0,381.0,381.0,0,0,0.0,0.0,0.0
120010178.0,6,22,1680,11,840,12001017.8,95.0,76.36363636363636,11,840,9001298.0,95.0,76.36363636363636
120005038.0,17,29,13785,29,13785,4285894.214285715,501.0,475.3448275862069,0,0,0.0,0.0,0.0
405.0,17,2,762,2,762,0.0,381.0,381.0,0,0,0.0,0.0,0.0
100419933.0,17,12,516,6,258,20000912.0,43.0,43.0,6,258,20000149.6,43.0,43.0
59160.0,6,20,7606,11,978,5916.0,310.0,88.9090909090909,9,6628,7207.875,1514.0,736.4444444444445
308287.0,6,10,1221,6,636,61657.4,298.0,106.0,4,585,96053.33333333331,379.0,146.25
159603.0,6,3,373,2,238,0.0,172.0,119.0,1,135,0.0,135.0,135.0
153296.0,17,2,414,1,88,0.0,88.0,88.0,1,326,0.0,326.0,326.0
3046264.0,6,149,121760,87,113366,35421.67441860465,1510.0,1303.057471264368,62,8394,44897.45901639344,1510.0,135.38709677419354
276017.0,6,10,1221,6,636,55203.4,298.0,106.0,4,585,83756.33333333333,379.0,146.25
90551648.0,6,13,2036,8,1016,12935949.714285716,188.0,127.0,5,1020,22594482.75,204.0,204.0
90068433.0,17,27,12943,27,12943,3464170.5,501.0,479.3703703703704,0,0,0.0,0.0,0.0
108106793.0,17,5,955,5,955,27026698.25,191.0,191.0,0,0,0.0,0.0,0.0
860574.0,6,9,1196,6,725,172114.8,387.0,120.83333333333331,3,471,292486.0,331.0,157.0
25747.0,6,11,2098,6,590,4331.8,252.0,98.33333333333331,5,1508,6212.25,1236.0,301.6
31840.0,6,11,2098,6,590,6368.0,252.0,98.33333333333331,5,1508,6260.25,1236.0,301.6
114381719.0,6,47,3760,25,2020,4765904.958333333,139.0,80.8,22,1740,5436452.904761905,123.0,79.0909090909091
320.0,17,2,174,1,79,0.0,79.0,79.0,1,95,0.0,95.0,95.0
877698.0,6,10,1335,6,798,175539.6,460.0,133.0,4,537,200637.0,331.0,134.25
2163449.0,6,26,7677,14,2582,166419.15384615384,1034.0,184.42857142857144,12,5095,168498.18181818182,1510.0,424.5833333333333
146811.0,6,3,373,2,238,0.0,172.0,119.0,1,135,0.0,135.0,135.0
29881.0,6,14,4740,7,653,4810.666666666667,249.0,93.28571428571428,7,4087,4845.333333333333,1514.0,583.8571428571429
304721.0,6,6,412,4,272,101573.66666666669,74.0,68.0,2,140,0.0,74.0,70.0
2034.0,17,4,344,2,150,0.0,75.0,75.0,2,194,0.0,103.0,97.0
377.0,17,2,508,2,508,0.0,257.0,254.0,0,0,0.0,0.0,0.0
311.0,17,2,164,1,82,0.0,82.0,82.0,1,82,0.0,82.0,82.0
209533.0,6,10,1221,6,636,41906.6,298.0,106.0,4,585,68604.66666666667,379.0,146.25
96005429.0,17,13,1083,7,563,16000904.833333334,174.0,80.42857142857143,6,520,15200125.6,174.0,86.66666666666667
203886.0,17,2,762,2,762,0.0,381.0,381.0,0,0,0.0,0.0,0.0
2669461.0,6,3,1604,1,753,0.0,753.0,753.0,2,851,0.0,785.0,425.5
199862.0,17,4,6056,4,6056,66620.66666666667,1514.0,1514.0,0,0,0.0,0.0,0.0
527032.0,6,12,2212,6,694,105183.8,233.0,115.66666666666669,6,1518,104988.0,1224.0,253.0
34819.0,6,10,2032,5,524,7412.0,252.0,104.8,5,1508,8437.0,1236.0,301.6
107073628.0,6,213,23918,107,7358,1010128.566037736,140.0,68.76635514018692,106,16560,1009890.4857142858,284.0,156.2264150943396
309942.0,17,4,1400,4,1400,103314.0,350.0,350.0,0,0,0.0,0.0,0.0
164690.0,17,2,414,1,88,0.0,88.0,88.0,1,326,0.0,326.0,326.0
502522.0,6,5,336,2,134,0.0,68.0,67.0,3,202,191915.5,70.0,67.33333333333333
148018.0,17,2,180,1,90,0.0,90.0,90.0,1,90,0.0,90.0,90.0
35933.0,6,14,4740,7,653,5652.0,249.0,93.28571428571428,7,4087,5775.166666666667,1514.0,583.8571428571429
90285045.0,6,17,1287,9,691,11279575.25,95.0,76.77777777777777,8,596,12896114.0,95.0,74.5
120057010.0,17,29,13785,29,13785,4287750.357142857,501.0,475.3448275862069,0,0,0.0,0.0,0.0
110134563.0,6,28,1860,14,966,8455298.0,123.0,69.0,14,894,8455296.0,123.0,63.85714285714285
10520998.0,6,7,478,4,272,3461444.333333333,74.0,68.0,3,206,5192046.0,74.0,68.66666666666667
316225.0,6,10,1102,5,570,78748.0,298.0,114.0,5,532,78702.25,260.0,106.4
108110289.0,17,5,1005,5,1005,27027572.25,201.0,201.0,0,0,0.0,0.0,0.0
151559.0,6,3,373,2,238,0.0,172.0,119.0,1,135,0.0,135.0,135.0
234168.0,6,3,337,2,214,0.0,160.0,107.0,1,123,0.0,123.0,123.0
195672.0,6,14,4740,7,653,28616.666666666668,249.0,93.28571428571428,7,4087,28425.33333333333,1514.0,583.8571428571429
108912.0,17,2,286,2,286,0.0,143.0,143.0,0,0,0.0,0.0,0.0
123001126.0,17,15,907,8,475,17571589.42857143,174.0,59.375,7,432,17166328.333333332,174.0,61.71428571428572
120005615.0,6,22,1900,11,900,12000561.5,155.0,81.81818181818181,11,1000,8997816.2,255.0,90.9090909090909
191152.0,17,2,180,1,90,0.0,90.0,90.0,1,90,0.0,90.0,90.0
2422.0,17,4,344,2,150,0.0,75.0,75.0,2,194,0.0,103.0,97.0
2094.0,17,4,344,2,150,0.0,75.0,75.0,2,194,0.0,103.0,97.0
249458.0,6,3,337,2,214,0.0,160.0,107.0,1,123,0.0,123.0,123.0
108001160.0,17,13,821,7,432,18000193.333333332,174.0,61.71428571428572,6,389,17600986.2,174.0,64.83333333333333
2827742.0,6,11,2106,6,598,565372.4,252.0,99.66666666666669,5,1508,3866.75,1236.0,301.6
10766482.0,6,5,1909,2,892,0.0,826.0,446.0,3,1017,3978507.5,885.0,339.0
100020373.0,17,12,516,6,258,20000163.8,43.0,43.0,6,258,20000834.4,43.0,43.0
103311.0,17,2,286,2,286,0.0,143.0,143.0,0,0,0.0,0.0,0.0
103519.0,17,2,286,2,286,0.0,143.0,143.0,0,0,0.0,0.0,0.0
5621753.0,6,5,336,2,134,0.0,68.0,67.0,3,202,1427395.5,70.0,67.33333333333333
22702.0,6,14,4740,7,653,3674.8333333333335,249.0,93.28571428571428,7,4087,3581.333333333333,1514.0,583.8571428571429
2435.0,17,2,180,1,90,0.0,90.0,90.0,1,90,0.0,90.0,90.0
314496.0,17,4,1400,4,1400,104832.0,350.0,350.0,0,0,0.0,0.0,0.0
104455683.0,6,204,23094,102,16116,1032083.6732673268,284.0,158.0,102,6978,1032083.5742574256,140.0,68.41176470588235
132838.0,6,3,337,2,214,0.0,160.0,107.0,1,123,0.0,123.0,123.0
118056.0,6,14,4740,7,653,19518.666666666668,249.0,93.28571428571428,7,4087,19416.666666666668,1514.0,583.8571428571429
232306.0,6,3,337,2,214,0.0,160.0,107.0,1,123,0.0,123.0,123.0
91766525.0,6,29,2200,15,1168,6539334.785714285,139.0,77.86666666666666,14,1032,7042357.923076923,123.0,73.71428571428571
4508.0,17,2,598,1,72,0.0,72.0,72.0,1,526,0.0,526.0,526.0
108714483.0,6,28,1860,14,966,8346041.153846154,123.0,69.0,14,894,8346022.307692308,123.0,63.85714285714285
209594.0,17,2,180,1,90,0.0,90.0,90.0,1,90,0.0,90.0,90.0
25513.0,6,10,2032,5,524,5050.5,252.0,104.8,5,1508,6144.5,1236.0,301.6
27031.0,6,10,2032,5,524,5515.0,252.0,104.8,5,1508,6465.5,1236.0,301.6
90255464.0,6,13,2036,8,1016,12893637.714285716,188.0,127.0,5,1020,22519629.5,204.0,204.0
90252111.0,6,12,1832,8,1016,12893158.714285716,188.0,127.0,4,816,30029158.0,204.0,204.0
239995.0,6,3,373,2,238,0.0,172.0,119.0,1,135,0.0,135.0,135.0
1185804.0,6,13,3011,8,2383,169400.57142857142,1514.0,297.875,5,628,227535.25,331.0,125.6
143903.0,17,2,180,1,90,0.0,90.0,90.0,1,90,0.0,90.0,90.0
96848.0,17,2,762,2,762,0.0,381.0,381.0,0,0,0.0,0.0,0.0
217778.0,6,3,426,2,280,0.0,214.0,140.0,1,146,0.0,146.0,146.0
166536.0,17,2,180,1,90,0.0,90.0,90.0,1,90,0.0,90.0,90.0
42323.0,6,14,4740,7,653,5934.333333333333,249.0,93.28571428571428,7,4087,6359.0,1514.0,583.8571428571429
121243.0,6,3,337,2,214,0.0,160.0,107.0,1,123,0.0,123.0,123.0
147149.0,6,3,373,2,238,0.0,172.0,119.0,1,135,0.0,135.0,135.0
35600.0,6,14,4740,7,653,5810.0,249.0,93.28571428571428,7,4087,5788.166666666667,1514.0,583.8571428571429
120561642.0,6,47,3102,23,1518,5150437.045454546,66.0,66.0,24,1584,5228558.043478261,66.0,66.0
2300.0,17,4,344,2,150,0.0,75.0,75.0,2,194,0.0,103.0,97.0
96215058.0,17,12,778,6,389,19211218.6,174.0,64.83333333333333,6,389,19038422.4,174.0,64.83333333333333
30196.0,17,2,762,2,762,0.0,381.0,381.0,0,0,0.0,0.0,0.0
0.0,6,1,66,1,66,0.0,66.0,66.0,0,0,0.0,0.0,0.0
46488897.0,6,891,834211,243,16209,192102.88016528924,205.0,66.70370370370371,648,818002,71835.942812983,1514.0,1262.3487654320988
180490.0,6,10,1065,5,534,44368.5,262.0,106.8,5,531,2861.0,259.0,106.2
342.0,17,2,164,1,82,0.0,82.0,82.0,1,82,0.0,82.0,82.0
108101965.0,17,5,1005,5,1005,27025491.25,201.0,201.0,0,0,0.0,0.0,0.0
10540036.0,6,7,478,4,272,3467833.6666666665,74.0,68.0,3,206,5201625.5,74.0,68.66666666666667
90073193.0,17,28,13364,28,13364,3336044.185185185,501.0,477.2857142857143,0,0,0.0,0.0,0.0
41955.0,6,14,4740,7,653,6861.333333333333,249.0,93.28571428571428,7,4087,6509.333333333333,1514.0,583.8571428571429
2802117.0,6,2,132,1,66,0.0,66.0,66.0,1,66,0.0,66.0,66.0
266963.0,6,12,1373,7,714,44493.833333333336,298.0,102.0,5,659,62425.75,379.0,131.8
108714.0,17,2,286,2,286,0.0,143.0,143.0,0,0,0.0,0.0,0.0
318.0,17,2,168,1,76,0.0,76.0,76.0,1,92,0.0,92.0,92.0
39644.0,6,10,2032,5,524,9288.75,252.0,104.8,5,1508,9420.25,1236.0,301.6
53135.0,6,14,4740,7,653,7378.0,249.0,93.28571428571428,7,4087,7991.5,1514.0,583.8571428571429
90223914.0,6,17,1287,8,596,12852669.857142856,95.0,74.5,9,691,11251057.25,95.0,76.77777777777777
149259083.0,6,22,1680,10,745,13284503.111111112,95.0,74.5,12,935,13549373.272727272,95.0,77.91666666666667
107547455.0,17,14,864,7,432,17667299.666666668,174.0,61.71428571428572,7,432,17666867.333333332,174.0,61.71428571428572
114420332.0,6,211,23712,106,7292,1089717.4476190477,140.0,68.79245283018868,105,16420,1090289.826923077,284.0,156.38095238095238
365051.0,6,11,1021,6,444,49276.6,162.0,74.0,5,577,61050.5,349.0,115.4
46349.0,6,14,4740,7,653,5978.833333333333,249.0,93.28571428571428,7,4087,6735.166666666667,1514.0,583.8571428571429
120183272.0,6,234,26540,117,7956,1029008.5862068966,140.0,68.0,117,18584,1028998.3189655172,284.0,158.83760683760684
206129.0,6,3,426,2,280,0.0,214.0,140.0,1,146,0.0,146.0,146.0
217573.0,6,3,426,2,280,0.0,214.0,140.0,1,146,0.0,146.0,146.0
105589.0,17,2,762,2,762,0.0,381.0,381.0,0,0,0.0,0.0,0.0
3145671.0,17,2,876,2,876,0.0,438.0,438.0,0,0,0.0,0.0,0.0
436.0,17,2,508,2,508,0.0,257.0,254.0,0,0,0.0,0.0,0.0
835490.0,6,9,1118,6,586,167098.0,248.0,97.66666666666669,3,532,281453.0,392.0,177.33333333333334
50057.0,6,14,4740,7,653,8185.166666666667,249.0,93.28571428571428,7,4087,7148.666666666667,1514.0,583.8571428571429
62925.99999999999,6,10,1065,5,534,15128.25,262.0,106.8,5,531,14055.25,259.0,106.2
42457.0,6,10,2032,5,524,10407.25,252.0,104.8,5,1508,10151.5,1236.0,301.6
41548.0,6,14,4740,7,653,6731.666666666667,249.0,93.28571428571428,7,4087,6515.0,1514.0,583.8571428571429
10351.0,6,10,1975,5,467,2359.5,195.0,93.4,5,1508,1802.75,1236.0,301.6
107717500.0,17,14,864,7,432,17834993.166666668,174.0,61.71428571428572,7,432,17833535.333333332,174.0,61.71428571428572
135142492.0,17,6,1146,6,1146,27028498.4,191.0,191.0,0,0,0.0,0.0,0.0
308455.0,6,6,412,4,272,102818.33333333331,74.0,68.0,2,140,0.0,74.0,70.0
2448.0,17,4,344,2,150,0.0,75.0,75.0,2,194,0.0,103.0,97.0
2931943.0,6,11,2106,6,598,585362.2,252.0,99.66666666666669,5,1508,7633.75,1236.0,301.6
79113.0,6,11,2098,6,590,15596.2,252.0,98.33333333333331,5,1508,18681.5,1236.0,301.6
39841.0,6,14,4740,7,653,6517.0,249.0,93.28571428571428,7,4087,6356.333333333333,1514.0,583.8571428571429
117834132.0,6,29,1914,15,948,8416723.714285715,123.0,63.2,14,966,8278577.769230769,123.0,69.0
53751.0,6,14,4740,7,653,8849.833333333334,249.0,93.28571428571428,7,4087,7802.833333333333,1514.0,583.8571428571429
94130364.0,17,12,778,6,389,18802170.4,174.0,64.83333333333333,6,389,18800169.6,174.0,64.83333333333333
90367795.0,6,13,2052,6,1224,18073353.0,204.0,204.0,7,828,15060904.333333334,188.0,118.28571428571428
23201.0,6,10,2032,5,524,5443.75,252.0,104.8,5,1508,5015.5,1236.0,301.6
2592795.0,6,2,132,1,66,0.0,66.0,66.0,1,66,0.0,66.0,66.0
50370.0,6,14,4740,7,653,8192.833333333334,249.0,93.28571428571428,7,4087,7251.666666666667,1514.0,583.8571428571429
34189.0,6,14,4740,7,653,5328.166666666667,249.0,93.28571428571428,7,4087,4745.166666666667,1514.0,583.8571428571429
105403536.0,6,28,1876,14,982,8091344.307692308,139.0,70.14285714285714,14,894,8091369.923076923,123.0,63.85714285714285
94152390.0,17,12,778,6,389,18800226.0,174.0,64.83333333333333,6,389,18801134.0,174.0,64.83333333333333
217100.0,6,3,426,2,280,0.0,214.0,140.0,1,146,0.0,146.0,146.0
103549.0,17,2,286,2,286,0.0,143.0,143.0,0,0,0.0,0.0,0.0
317080.0,17,4,1400,4,1400,105693.33333333331,350.0,350.0,0,0,0.0,0.0,0.0
16282.000000000002,6,10,2032,5,524,3852.5,252.0,104.8,5,1508,3824.25,1236.0,301.6
2031.0,17,4,344,2,150,0.0,75.0,75.0,2,194,0.0,103.0,97.0
3689.0,17,4,344,2,150,0.0,75.0,75.0,2,194,0.0,103.0,97.0
2291892.0,6,49,23728,25,19797,95495.5,1514.0,791.88,24,3931,90356.82608695651,1514.0,163.79166666666666
5051386.0,6,4,270,2,134,0.0,68.0,67.0,2,136,0.0,70.0,68.0
50904.0,17,2,180,1,90,0.0,90.0,90.0,1,90,0.0,90.0,90.0
159003.0,6,3,337,2,214,0.0,160.0,107.0,1,123,0.0,123.0,123.0
146056.0,6,3,337,2,214,0.0,160.0,107.0,1,123,0.0,123.0,123.0
164733.0,17,2,414,1,88,0.0,88.0,88.0,1,326,0.0,326.0,326.0
2020841.0,17,4,525,2,150,0.0,75.0,75.0,2,375,0.0,284.0,187.5
14434.0,6,11,2098,6,590,2886.8,252.0,98.33333333333331,5,1508,3211.25,1236.0,301.6
33476.0,6,14,4740,7,653,5299.0,249.0,93.28571428571428,7,4087,5398.666666666667,1514.0,583.8571428571429
309541.0,17,4,1400,4,1400,103180.33333333331,350.0,350.0,0,0,0.0,0.0,0.0
108115728.0,17,5,955,5,955,27028932.0,191.0,191.0,0,0,0.0,0.0,0.0
166573.0,17,2,180,1,90,0.0,90.0,90.0,1,90,0.0,90.0,90.0
135137609.0,17,6,1206,6,1206,27027521.8,201.0,201.0,0,0,0.0,0.0,0.0
217973.0,6,3,426,2,280,0.0,214.0,140.0,1,146,0.0,146.0,146.0
45303.0,6,10,2032,5,524,10166.75,252.0,104.8,5,1508,10346.0,1236.0,301.6
4039671.000000001,6,6,876,2,292,0.0,214.0,146.0,4,584,954098.3333333334,146.0,146.0
2377.0,17,4,344,2,150,0.0,75.0,75.0,2,194,0.0,103.0,97.0
1089438.0,6,11,1134,6,558,217887.6,220.0,93.0,5,576,269876.75,304.0,115.2
39501.0,6,14,4740,7,653,6431.0,249.0,93.28571428571428,7,4087,5651.0,1514.0,583.8571428571429
93370190.0,17,12,778,6,389,18600158.6,174.0,64.83333333333333,6,389,18601221.4,174.0,64.83333333333333
90194120.0,6,16,1192,8,596,12850701.285714284,95.0,74.5,8,596,12855521.42857143,95.0,74.5
116668733.0,6,31,2182,16,1165,7763330.4,139.0,72.8125,15,1017,8318046.071428572,123.0,67.8
90019749.0,17,28,13364,28,13364,3334064.777777778,501.0,477.2857142857143,0,0,0.0,0.0,0.0
36434.0,6,10,2032,5,524,8578.75,252.0,104.8,5,1508,8817.75,1236.0,301.6
128085437.0,17,15,907,8,475,18297919.57142857,174.0,59.375,7,432,17833508.666666668,174.0,61.71428571428572
108105938.0,17,5,1005,5,1005,27026484.5,201.0,201.0,0,0,0.0,0.0,0.0
146277.0,6,3,337,2,214,0.0,160.0,107.0,1,123,0.0,123.0,123.0
123911170.0,6,34,2413,17,1125,7392615.6875,123.0,66.17647058823529,17,1288,7120369.125,139.0,75.76470588235294
49299.0,6,10,2032,5,524,12013.0,252.0,104.8,5,1508,11093.0,1236.0,301.6
90292019.0,6,21,1585,11,840,9024111.8,95.0,76.36363636363636,10,745,10000863.555555556,95.0,74.5
49308.0,6,11,1132,6,556,9571.4,218.0,92.66666666666669,5,576,12118.0,304.0,115.2
90256136.0,6,13,2036,8,1016,12893733.714285716,188.0,127.0,5,1020,22523102.25,204.0,204.0
320.0,17,2,174,1,79,0.0,79.0,79.0,1,95,0.0,95.0,95.0
46605.0,6,14,4740,7,653,7639.666666666667,249.0,93.28571428571428,7,4087,7139.833333333333,1514.0,583.8571428571429
244585.0,6,3,426,2,280,0.0,214.0,140.0,1,146,0.0,146.0,146.0
1666392.0,6,19,7533,10,1403,185154.66666666663,583.0,140.3,9,6130,176047.75,1484.0,681.1111111111111
6656.0,17,2,582,1,83,0.0,83.0,83.0,1,499,0.0,499.0,499.0
102762.0,17,2,286,2,286,0.0,143.0,143.0,0,0,0.0,0.0,0.0
217600.0,6,3,426,2,280,0.0,214.0,140.0,1,146,0.0,146.0,146.0
2302.0,17,4,344,2,150,0.0,75.0,75.0,2,194,0.0,103.0,97.0
295.0,17,2,156,1,78,0.0,78.0,78.0,1,78,0.0,78.0,78.0
5221.0,17,2,180,1,90,0.0,90.0,90.0,1,90,0.0,90.0,90.0
298942.0,6,6,412,4,272,99647.33333333331,74.0,68.0,2,140,0.0,74.0,70.0
82621.0,6,14,4740,7,653,13618.333333333334,249.0,93.28571428571428,7,4087,12881.833333333334,1514.0,583.8571428571429
12480.0,6,10,2032,5,524,2872.25,252.0,104.8,5,1508,2771.75,1236.0,301.6
1299477.0,6,4,264,2,132,0.0,66.0,66.0,2,132,0.0,66.0,66.0
120000038.0,6,27,2195,15,1138,8571431.285714285,95.0,75.86666666666666,12,1057,10628101.727272728,217.0,88.08333333333333
35575.0,6,11,2098,6,590,6670.8,252.0,98.33333333333331,5,1508,8629.5,1236.0,301.6
302415.0,6,2,132,1,66,0.0,66.0,66.0,1,66,0.0,66.0,66.0
181222.0,17,4,1524,4,1524,60407.333333333336,381.0,381.0,0,0,0.0,0.0,0.0
190973.0,17,2,762,2,762,0.0,381.0,381.0,0,0,0.0,0.0,0.0
284319.0,17,2,363,1,79,0.0,79.0,79.0,1,284,0.0,284.0,284.0
300344.0,6,6,412,4,272,100114.66666666669,74.0,68.0,2,140,0.0,74.0,70.0
117791134.0,6,33,2290,17,1125,7361945.875,123.0,66.17647058823529,16,1165,7172715.533333333,139.0,72.8125
745.0,17,2,762,2,762,0.0,381.0,381.0,0,0,0.0,0.0,0.0
90053098.0,17,28,13364,28,13364,3335299.925925926,501.0,477.2857142857143,0,0,0.0,0.0,0.0
311158.0,17,4,1400,4,1400,103719.33333333331,350.0,350.0,0,0,0.0,0.0,0.0
2385.0,17,4,344,2,150,0.0,75.0,75.0,2,194,0.0,103.0,97.0
43834.0,6,14,4740,7,653,6866.833333333333,249.0,93.28571428571428,7,4087,6692.5,1514.0,583.8571428571429
0.0,17,1,90,1,90,0.0,90.0,90.0,0,0,0.0,0.0,0.0
116067785.0,6,31,2166,16,1149,7737852.333333333,123.0,71.8125,15,1017,8275115.285714285,123.0,67.8
232946.0,6,3,337,2,214,0.0,160.0,107.0,1,123,0.0,123.0,123.0
90925990.0,6,21,1585,11,840,9090875.1,95.0,76.36363636363636,10,745,10099856.333333334,95.0,74.5
108282.0,17,2,286,2,286,0.0,143.0,143.0,0,0,0.0,0.0,0.0
108339778.0,17,14,864,7,432,18000164.0,174.0,61.71428571428572,7,432,18000948.5,174.0,61.71428571428572
206046.0,6,3,426,2,280,0.0,214.0,140.0,1,146,0.0,146.0,146.0
3544.0,17,2,359,1,75,0.0,75.0,75.0,1,284,0.0,284.0,284.0
216706.0,17,2,180,1,90,0.0,90.0,90.0,1,90,0.0,90.0,90.0
232624.0,6,3,337,2,214,0.0,160.0,107.0,1,123,0.0,123.0,123.0
98917144.0,6,193,21714,97,6624,1030386.9166666666,140.0,68.28865979381443,96,15090,1031344.5789473684,284.0,157.1875
3179841.0,6,18,1495,9,921,358369.25,315.0,102.33333333333331,9,574,358338.875,78.0,63.77777777777778
120258394.0,6,23,1775,11,881,12025839.4,95.0,80.0909090909091,12,894,10886251.909090908,95.0,74.5
120004482.0,6,16,1192,8,596,17143497.42857143,95.0,74.5,8,596,17105696.14285714,95.0,74.5
259452.00000000003,6,10,1221,6,636,51890.4,298.0,106.0,4,585,80430.66666666667,379.0,146.25
17670.0,17,2,180,1,90,0.0,90.0,90.0,1,90,0.0,90.0,90.0
216353.0,17,2,180,1,90,0.0,90.0,90.0,1,90,0.0,90.0,90.0
27051.0,6,10,2032,5,524,6553.25,252.0,104.8,5,1508,6117.5,1236.0,301.6
108105589.0,17,5,1005,5,1005,27026397.25,201.0,201.0,0,0,0.0,0.0,0.0
4802480.0,6,5,336,2,134,0.0,68.0,67.0,3,202,1628354.5,70.0,67.33333333333333
99308472.0,17,14,1126,7,563,16501319.166666666,174.0,80.42857142857143,7,563,16500130.333333334,174.0,80.42857142857143
99931.0,17,2,286,2,286,0.0,143.0,143.0,0,0,0.0,0.0,0.0
2893877.0,6,3,204,2,136,0.0,70.0,68.0,1,68,0.0,68.0,68.0
90259530.0,6,14,1964,8,1016,12894218.57142857,188.0,127.0,6,948,18019273.4,204.0,158.0
228365.0,17,2,180,1,90,0.0,90.0,90.0,1,90,0.0,90.0,90.0
90030943.0,17,28,13364,28,13364,3334479.3703703703,501.0,477.2857142857143,0,0,0.0,0.0,0.0
226911.0,17,2,180,1,90,0.0,90.0,90.0,1,90,0.0,90.0,90.0
241593.0,6,3,337,2,214,0.0,160.0,107.0,1,123,0.0,123.0,123.0
1046939.0,6,11,1134,6,558,209387.8,220.0,93.0,5,576,258455.75,304.0,115.2
206128.0,6,3,426,2,280,0.0,214.0,140.0,1,146,0.0,146.0,146.0
34400.0,6,10,2032,5,524,8364.25,252.0,104.8,5,1508,7375.0,1236.0,301.6
120125624.0,6,18,2760,10,1392,13347291.555555556,188.0,139.2,8,1368,12909035.142857144,204.0,171.0
118061659.0,6,366,60672,183,12448,644876.598901099,214.0,68.02185792349727,183,48224,648568.8296703297,1514.0,263.5191256830601
243953.0,6,3,373,2,238,0.0,172.0,119.0,1,135,0.0,135.0,135.0
120701919.0,6,253,28750,127,20212,957951.738095238,284.0,159.1496062992126,126,8538,957389.024,140.0,67.76190476190476
90296345.0,6,17,1287,9,691,11281078.0,95.0,76.77777777777777,8,596,12897789.57142857,95.0,74.5
60382.0,6,14,4740,7,653,9942.333333333334,249.0,93.28571428571428,7,4087,9498.166666666666,1514.0,583.8571428571429
125001162.0,17,15,907,8,475,17857308.85714286,174.0,59.375,7,432,17500851.5,174.0,61.71428571428572
289793.0,17,2,180,1,90,0.0,90.0,90.0,1,90,0.0,90.0,90.0
160345.0,6,2,128,1,74,0.0,74.0,74.0,1,54,0.0,54.0,54.0
1173340.0,6,13,3015,8,2387,167620.0,1514.0,298.375,5,628,224416.0,331.0,125.6
126944843.0,6,36,2740,20,1531,6681307.52631579,139.0,76.55,16,1209,7782829.933333334,123.0,75.5625
148493.0,17,2,414,1,88,0.0,88.0,88.0,1,326,0.0,326.0,326.0
312660.0,6,3,202,2,128,0.0,74.0,64.0,1,74,0.0,74.0,74.0
111766105.0,6,30,1974,15,1026,7967871.928571428,123.0,68.4,15,948,7967812.357142857,123.0,63.2
107193500.0,6,195,22042,98,6690,1105087.6288659794,140.0,68.26530612244898,97,15352,1106191.125,284.0,158.2680412371134
108102339.0,17,5,1005,5,1005,27025584.75,201.0,201.0,0,0,0.0,0.0,0.0
146364.0,6,3,337,2,214,0.0,160.0,107.0,1,123,0.0,123.0,123.0
299254.0,6,6,412,4,272,99751.33333333331,74.0,68.0,2,140,0.0,74.0,70.0
28084.0,6,14,4740,7,653,4502.666666666667,249.0,93.28571428571428,7,4087,4413.166666666667,1514.0,583.8571428571429
109132.0,6,14,4740,7,653,18006.0,249.0,93.28571428571428,7,4087,16929.0,1514.0,583.8571428571429
2316.0,17,4,344,2,150,0.0,75.0,75.0,2,194,0.0,103.0,97.0
1848227.0,6,4,276,2,128,0.0,74.0,64.0,2,148,0.0,74.0,74.0
113254983.0,6,46,3036,23,1518,5135436.5,66.0,66.0,23,1518,5135440.545454546,66.0,66.0
121763785.0,6,34,2413,17,1125,7422677.3125,123.0,66.17647058823529,17,1288,7125423.875,139.0,75.76470588235294
216986.0,6,3,426,2,280,0.0,214.0,140.0,1,146,0.0,146.0,146.0
391966.0,6,3,204,1,68,0.0,68.0,68.0,2,136,0.0,70.0,68.0
2296.0,17,4,344,2,150,0.0,75.0,75.0,2,194,0.0,103.0,97.0
510186.0,6,5,336,2,134,0.0,68.0,67.0,3,202,196023.0,70.0,67.33333333333333
135148494.0,17,6,1146,6,1146,27029698.8,191.0,191.0,0,0,0.0,0.0,0.0
247502.0,6,10,1221,6,636,49500.4,298.0,106.0,4,585,77824.33333333333,379.0,146.25
324.0,17,2,208,1,72,0.0,72.0,72.0,1,136,0.0,136.0,136.0
100000792.0,17,11,473,6,258,20000158.4,43.0,43.0,5,215,20000896.75,43.0,43.0
21467.0,6,10,2032,5,524,5122.25,252.0,104.8,5,1508,4343.25,1236.0,301.6
303309.0,6,6,412,4,272,101103.0,74.0,68.0,2,140,0.0,74.0,70.0
228228.0,17,2,180,1,90,0.0,90.0,90.0,1,90,0.0,90.0,90.0
2295.0,17,4,344,2,150,0.0,75.0,75.0,2,194,0.0,103.0,97.0
120166871.0,6,276,31418,138,9404,872856.4744525547,140.0,68.14492753623189,138,22014,871108.4379562044,300.0,159.52173913043478
44138.0,6,13,1386,7,789,7276.0,253.0,112.71428571428572,6,597,5936.8,259.0,99.5
196914.0,17,2,180,1,90,0.0,90.0,90.0,1,90,0.0,90.0,90.0
196916.0,17,2,180,1,90,0.0,90.0,90.0,1,90,0.0,90.0,90.0
135113138.0,17,6,1206,6,1206,27022627.6,201.0,201.0,0,0,0.0,0.0,0.0
321530.0,6,3,202,2,128,0.0,74.0,64.0,1,74,0.0,74.0,74.0
1124606.0,6,13,1386,7,789,187434.3333333333,253.0,112.71428571428572,6,597,221827.6,259.0,99.5
91103418.0,6,24,1829,11,840,9110341.8,95.0,76.36363636363636,13,989,7571247.166666667,95.0,76.07692307692308
100066050.0,6,181,20398,91,6228,1111845.0,140.0,68.43956043956044,90,14170,1112561.9101123596,284.0,157.44444444444446
104406107.0,6,44,2904,22,1452,4971719.380952381,66.0,66.0,22,1452,4957419.666666667,66.0,66.0
105309481.0,17,14,1126,7,563,17501999.0,174.0,80.42857142857143,7,563,17500222.166666668,174.0,80.42857142857143
108102760.0,17,5,955,5,955,27025690.0,191.0,191.0,0,0,0.0,0.0,0.0
135141369.0,17,6,1146,6,1146,27028273.8,191.0,191.0,0,0,0.0,0.0,0.0
82822.0,17,4,1400,4,1400,27607.33333333333,350.0,350.0,0,0,0.0,0.0,0.0
121391.0,6,3,337,2,214,0.0,160.0,107.0,1,123,0.0,123.0,123.0
321032.0,17,4,1400,4,1400,107010.66666666669,350.0,350.0,0,0,0.0,0.0,0.0
0.0,17,1,44,1,44,0.0,44.0,44.0,0,0,0.0,0.0,0.0
0.0,17,1,179,1,179,0.0,179.0,179.0,0,0,0.0,0.0,0.0
1555700.0,6,2,132,1,66,0.0,66.0,66.0,1,66,0.0,66.0,66.0
1282297.0,6,4,264,2,132,0.0,66.0,66.0,2,132,0.0,66.0,66.0
90055495.0,17,28,13364,28,13364,3335388.703703704,501.0,477.2857142857143,0,0,0.0,0.0,0.0
90406283.0,6,26,1746,13,906,7514987.083333333,123.0,69.6923076923077,13,840,7514985.583333333,123.0,64.61538461538461
108085236.0,17,5,955,5,955,27021309.0,191.0,191.0,0,0,0.0,0.0,0.0
7504.0,17,3,1026,3,1026,3752.0,342.0,342.0,0,0,0.0,0.0,0.0
938326.0,17,10,3776,10,3776,104258.44444444444,394.0,377.6,0,0,0.0,0.0,0.0
11387.0,6,10,2032,5,524,2339.25,252.0,104.8,5,1508,2178.0,1236.0,301.6
209580.0,17,2,180,1,90,0.0,90.0,90.0,1,90,0.0,90.0,90.0
1741330.0,6,2,132,1,66,0.0,66.0,66.0,1,66,0.0,66.0,66.0
5620737.0,6,5,336,2,134,0.0,68.0,67.0,3,202,1526988.5,70.0,67.33333333333333
2475.0,17,4,344,2,150,0.0,75.0,75.0,2,194,0.0,103.0,97.0
2739.0,17,2,180,1,90,0.0,90.0,90.0,1,90,0.0,90.0,90.0
439885.0,6,11,1021,6,444,59233.4,162.0,74.0,5,577,73860.75,349.0,115.4
0.0,17,1,350,1,350,0.0,350.0,350.0,0,0,0.0,0.0,0.0
135131236.0,17,6,1146,6,1146,27026247.2,191.0,191.0,0,0,0.0,0.0,0.0
20284.0,6,10,2032,5,524,4860.25,252.0,104.8,5,1508,4634.0,1236.0,301.6
594.0,17,2,508,2,508,0.0,257.0,254.0,0,0,0.0,0.0,0.0
220658.0,6,3,426,2,280,0.0,214.0,140.0,1,146,0.0,146.0,146.0
205420.0,17,2,180,1,90,0.0,90.0,90.0,1,90,0.0,90.0,90.0
120300152.0,6,213,24136,107,16844,1134907.0943396229,284.0,157.42056074766356,106,7292,1136995.2666666666,140.0,68.79245283018868
32222.0,6,14,4740,7,653,4982.166666666667,249.0,93.28571428571428,7,4087,5232.166666666667,1514.0,583.8571428571429
53217.0,6,14,4740,7,653,8746.166666666666,249.0,93.28571428571428,7,4087,6750.333333333333,1514.0,583.8571428571429
242312.0,6,3,373,2,238,0.0,172.0,119.0,1,135,0.0,135.0,135.0
120288912.0,6,16,1233,8,637,17184130.285714287,95.0,79.625,8,596,17106202.14285714,95.0,74.5
21948.0,17,2,180,1,90,0.0,90.0,90.0,1,90,0.0,90.0,90.0
2792524.0,6,2,132,1,66,0.0,66.0,66.0,1,66,0.0,66.0,66.0
1079290.0,6,4,492,2,280,0.0,214.0,140.0,2,212,0.0,146.0,106.0
30650.0,6,14,4740,7,653,4857.0,249.0,93.28571428571428,7,4087,4046.8333333333335,1514.0,583.8571428571429
108246.0,17,2,286,2,286,0.0,143.0,143.0,0,0,0.0,0.0,0.0
2406.0,17,4,344,2,150,0.0,75.0,75.0,2,194,0.0,103.0,97.0
114410571.0,6,48,3168,24,1584,4974372.652173913,66.0,66.0,24,1584,4962528.565217392,66.0,66.0
108115065.0,17,5,955,5,955,27028766.25,191.0,191.0,0,0,0.0,0.0,0.0
362649.0,6,11,1021,6,444,48671.4,162.0,74.0,5,577,60751.0,349.0,115.4
143888.0,17,2,180,1,90,0.0,90.0,90.0,1,90,0.0,90.0,90.0
34691.0,6,14,4740,7,653,5482.5,249.0,93.28571428571428,7,4087,5548.5,1514.0,583.8571428571429
106970.0,17,2,286,2,286,0.0,143.0,143.0,0,0,0.0,0.0,0.0
865616.0,6,9,1270,6,799,173123.2,461.0,133.16666666666666,3,471,296476.0,331.0,157.0
0.0,17,1,55,1,55,0.0,55.0,55.0,0,0,0.0,0.0,0.0
123455925.0,6,49,3234,25,1650,5143996.875,66.0,66.0,24,1584,5152820.173913044,66.0,66.0
139779.0,6,14,4740,7,653,22098.0,249.0,93.28571428571428,7,4087,21770.666666666668,1514.0,583.8571428571429
6635.0,17,4,823,2,163,0.0,89.0,81.5,2,660,0.0,443.0,330.0
143850.0,17,2,180,1,90,0.0,90.0,90.0,1,90,0.0,90.0,90.0
120340948.0,6,216,24456,108,7350,1107247.4859813084,140.0,68.05555555555556,108,17106,1117182.0,284.0,158.38888888888889
120000104.0,6,17,1287,9,691,15000013.0,95.0,76.77777777777777,8,596,12895541.285714284,95.0,74.5
37068.0,6,14,4740,7,653,6071.333333333333,249.0,93.28571428571428,7,4087,6044.0,1514.0,583.8571428571429
48946.0,6,10,1065,5,534,10815.0,262.0,106.8,5,531,11410.0,259.0,106.2
2608153.0,6,3,1604,2,851,0.0,785.0,425.5,1,753,0.0,753.0,753.0
1966.0,17,2,176,1,80,0.0,80.0,80.0,1,96,0.0,96.0,96.0
284384.0,17,4,1400,4,1400,94794.66666666669,350.0,350.0,0,0,0.0,0.0,0.0
205979.0,6,3,426,2,280,0.0,214.0,140.0,1,146,0.0,146.0,146.0
105206665.0,17,15,5130,15,5130,7514761.785714285,342.0,342.0,0,0,0.0,0.0,0.0
112624.0,6,11,1131,6,600,22358.2,262.0,100.0,5,531,2581.5,259.0,106.2
108089230.0,17,5,955,5,955,27022307.5,191.0,191.0,0,0,0.0,0.0,0.0
90746415.0,6,19,1436,10,745,10078140.777777778,95.0,74.5,9,691,11341729.125,95.0,76.77777777777777
178884.0,17,4,1400,4,1400,59628.0,350.0,350.0,0,0,0.0,0.0,0.0
1527493.0,6,11,2023,6,515,305302.2,169.0,85.83333333333333,5,1508,4211.5,1236.0,301.6
20714.0,6,10,1066,5,490,3046.75,218.0,98.0,5,576,4970.5,304.0,115.2
143872.0,17,2,180,1,90,0.0,90.0,90.0,1,90,0.0,90.0,90.0
865536.0,6,9,1268,6,797,173107.2,459.0,132.83333333333334,3,471,295171.5,331.0,157.0
103426839.0,6,203,23042,102,16154,1024028.1089108912,284.0,158.37254901960785,101,6888,1023977.36,140.0,68.1980198019802
103075.0,17,2,286,2,286,0.0,143.0,143.0,0,0,0.0,0.0,0.0
3173455.0,6,10,1221,6,636,634691.0,298.0,106.0,4,585,1052421.3333333333,379.0,146.25
90296060.0,6,16,1192,8,596,12892938.285714284,95.0,74.5,8,596,12897873.0,95.0,74.5
100101872.0,6,167,18918,84,5840,1206046.6506024096,140.0,69.52380952380952,83,13078,1211746.987804878,374.0,157.56626506024097
90259344.0,6,12,1832,8,1016,12894192.0,188.0,127.0,4,816,30031714.33333333,204.0,204.0
9091.0,17,2,582,1,83,0.0,83.0,83.0,1,499,0.0,499.0,499.0
322.0,17,2,208,1,72,0.0,72.0,72.0,1,136,0.0,136.0,136.0
221021.0,6,13,1386,7,789,36836.833333333336,253.0,112.71428571428572,6,597,42060.4,259.0,99.5
160145.0,17,2,180,1,90,0.0,90.0,90.0,1,90,0.0,90.0,90.0
291449.0,17,4,1524,4,1524,97149.66666666669,381.0,381.0,0,0,0.0,0.0,0.0
310282.0,17,4,1400,4,1400,103427.33333333331,350.0,350.0,0,0,0.0,0.0,0.0
2943288.0,6,3,1777,2,951,0.0,885.0,475.5,1,826,0.0,826.0,826.0
90904849.0,6,167,18828,84,5766,1095239.1445783132,140.0,68.64285714285714,83,13062,1096145.475609756,284.0,157.3734939759036
228259.0,17,2,180,1,90,0.0,90.0,90.0,1,90,0.0,90.0,90.0
90060178.0,6,11,1644,7,828,15010029.666666666,188.0,118.28571428571428,4,816,20020458.0,204.0,204.0
252838.0,6,10,1221,6,636,50567.6,298.0,106.0,4,585,78894.33333333333,379.0,146.25
65067.0,6,14,4740,7,653,10713.166666666666,249.0,93.28571428571428,7,4087,10179.5,1514.0,583.8571428571429
232294.0,6,3,337,2,214,0.0,160.0,107.0,1,123,0.0,123.0,123.0
121761.0,6,3,337,2,214,0.0,160.0,107.0,1,123,0.0,123.0,123.0
197498.0,17,2,180,1,90,0.0,90.0,90.0,1,90,0.0,90.0,90.0
308197.0,6,6,412,4,272,102732.33333333331,74.0,68.0,2,140,0.0,74.0,70.0
63875.0,6,10,2032,5,524,15653.25,252.0,104.8,5,1508,13874.0,1236.0,301.6
90052337.0,17,28,13364,28,13364,3335271.7407407407,501.0,477.2857142857143,0,0,0.0,0.0,0.0
120124432.0,6,14,2224,9,1204,15015554.0,188.0,133.77777777777777,5,1020,22526361.25,204.0,204.0
18470.0,6,20,7606,11,978,1847.0,310.0,88.9090909090909,9,6628,1999.625,1514.0,736.4444444444445
480793.0,6,3,204,2,136,0.0,70.0,68.0,1,68,0.0,68.0,68.0
90692558.0,6,15,2302,9,1204,11316614.75,188.0,133.77777777777777,6,1098,18105997.2,204.0,183.0
37998.0,6,10,2032,5,524,9256.75,252.0,104.8,5,1508,7072.5,1236.0,301.6
327940.0,6,6,412,4,272,109313.33333333331,74.0,68.0,2,140,0.0,74.0,70.0
5829656.0,6,5,336,2,134,0.0,68.0,67.0,3,202,1526473.0,70.0,67.33333333333333
1168716.0,6,11,1134,6,558,233743.2,220.0,93.0,5,576,290785.5,304.0,115.2
6502.0,17,4,823,2,163,0.0,89.0,81.5,2,660,0.0,443.0,330.0
31076.0,6,14,4740,7,653,4873.166666666667,249.0,93.28571428571428,7,4087,4672.0,1514.0,583.8571428571429
206382.0,6,3,426,2,280,0.0,214.0,140.0,1,146,0.0,146.0,146.0
108840642.0,6,33,2428,17,1288,6789727.125,139.0,75.76470588235294,16,1140,7242377.733333333,123.0,71.25
9549.0,6,10,1975,5,467,2108.25,195.0,93.4,5,1508,2087.75,1236.0,301.6
120856.0,6,3,373,2,238,0.0,172.0,119.0,1,135,0.0,135.0,135.0
112187729.0,17,14,1126,7,563,18671320.83333333,174.0,80.42857142857143,7,563,18671321.666666668,174.0,80.42857142857143
14377433.0,17,6,2052,6,2052,2875486.6,342.0,342.0,0,0,0.0,0.0,0.0
90256778.0,6,14,1964,8,1016,12893825.42857143,188.0,127.0,6,948,18018633.0,204.0,158.0
107323.0,17,2,762,2,762,0.0,381.0,381.0,0,0,0.0,0.0,0.0
90050536.0,17,28,13364,28,13364,3335205.037037037,501.0,477.2857142857143,0,0,0.0,0.0,0.0
5472.0,17,2,180,1,90,0.0,90.0,90.0,1,90,0.0,90.0,90.0
232178.0,6,3,337,2,214,0.0,160.0,107.0,1,123,0.0,123.0,123.0
33122734.0,6,7,1874,3,887,16490731.0,753.0,295.6666666666667,4,987,10995526.333333334,785.0,246.75
108928.0,17,2,286,2,286,0.0,143.0,143.0,0,0,0.0,0.0,0.0
146732.0,6,3,337,2,214,0.0,160.0,107.0,1,123,0.0,123.0,123.0
354.0,17,2,156,1,78,0.0,78.0,78.0,1,78,0.0,78.0,78.0
12835.0,6,13,1459,7,862,1976.1666666666667,271.0,123.14285714285714,6,597,2382.4,259.0,99.5
237539.0,17,2,180,1,90,0.0,90.0,90.0,1,90,0.0,90.0,90.0
108105211.0,17,5,955,5,955,27026302.75,191.0,191.0,0,0,0.0,0.0,0.0
3241.0,17,2,224,1,76,0.0,76.0,76.0,1,148,0.0,148.0,148.0
2406.0,17,4,344,2,150,0.0,75.0,75.0,2,194,0.0,103.0,97.0
1813914.0,6,19,7533,10,1403,201546.0,583.0,140.3,9,6130,195167.75,1484.0,681.1111111111111
38647.0,17,2,180,1,90,0.0,90.0,90.0,1,90,0.0,90.0,90.0
2875764.0,6,4,270,2,134,0.0,68.0,67.0,2,136,0.0,70.0,68.0
2575133.0,6,2,132,1,66,0.0,66.0,66.0,1,66,0.0,66.0,66.0
212480.0,17,4,1524,4,1524,70826.66666666667,381.0,381.0,0,0,0.0,0.0,0.0
107562.0,17,2,286,2,286,0.0,143.0,143.0,0,0,0.0,0.0,0.0
91727772.0,6,23,1775,13,1030,7640161.833333333,95.0,79.23076923076923,10,745,10159837.555555556,95.0,74.5
143943.0,17,2,180,1,90,0.0,90.0,90.0,1,90,0.0,90.0,90.0
37541.0,6,10,2032,5,524,9052.5,252.0,104.8,5,1508,7922.5,1236.0,301.6
110751775.0,6,30,1974,15,1026,7895423.0,123.0,68.4,15,948,7895392.428571428,123.0,63.2
1534230.0,6,4,276,2,128,0.0,74.0,64.0,2,148,0.0,74.0,74.0
2804326.0,6,2,132,1,66,0.0,66.0,66.0,1,66,0.0,66.0,66.0
120045508.0,17,29,13785,29,13785,4287339.571428572,501.0,475.3448275862069,0,0,0.0,0.0,0.0
9369.0,17,2,539,1,86,0.0,86.0,86.0,1,453,0.0,453.0,453.0
108113690.0,17,5,955,5,955,27028422.5,191.0,191.0,0,0,0.0,0.0,0.0
314866.0,6,6,412,4,272,104955.33333333331,74.0,68.0,2,140,0.0,74.0,70.0
228301.0,17,2,180,1,90,0.0,90.0,90.0,1,90,0.0,90.0,90.0
1157546.0,6,13,3012,8,2384,165363.7142857143,1514.0,298.0,5,628,221260.5,331.0,125.6
121849.0,6,3,373,2,238,0.0,172.0,119.0,1,135,0.0,135.0,135.0
11877546.0,6,33,8878,17,4676,742346.625,1514.0,275.05882352941177,16,4202,585987.4,1514.0,262.625
9062.0,17,2,180,1,90,0.0,90.0,90.0,1,90,0.0,90.0,90.0
153442.0,17,2,180,1,90,0.0,90.0,90.0,1,90,0.0,90.0,90.0
207421.0,6,3,426,2,280,0.0,214.0,140.0,1,146,0.0,146.0,146.0
36852.0,6,10,2032,5,524,8691.75,252.0,104.8,5,1508,8647.75,1236.0,301.6
122433670.0,6,32,2242,17,1225,7652104.375,139.0,72.05882352941177,15,1017,8016600.714285715,123.0,67.8
1308509.0,6,4,264,2,132,0.0,66.0,66.0,2,132,0.0,66.0,66.0
313.0,17,2,174,1,79,0.0,79.0,79.0,1,95,0.0,95.0,95.0
284739.0,17,2,363,1,79,0.0,79.0,79.0,1,284,0.0,284.0,284.0
136360.0,6,2,132,1,66,0.0,66.0,66.0,1,66,0.0,66.0,66.0
44665.0,6,10,2032,5,524,10597.25,252.0,104.8,5,1508,10270.75,1236.0,301.6
94038.0,6,2,132,1,66,0.0,66.0,66.0,1,66,0.0,66.0,66.0
852.0,17,4,438,2,148,0.0,74.0,74.0,2,290,0.0,147.0,145.0
100477.0,17,2,762,2,762,0.0,381.0,381.0,0,0,0.0,0.0,0.0
135127805.0,17,6,1206,6,1206,27025561.0,201.0,201.0,0,0,0.0,0.0,0.0
216600.0,17,2,180,1,90,0.0,90.0,90.0,1,90,0.0,90.0,90.0
0.0,17,1,90,1,90,0.0,90.0,90.0,0,0,0.0,0.0,0.0
90012312.0,17,28,13364,28,13364,3333789.333333333,501.0,477.2857142857143,0,0,0.0,0.0,0.0
1311036.0,17,7,490,7,490,218506.0,70.0,70.0,0,0,0.0,0.0,0.0
27052.0,6,14,4740,7,653,3957.3333333333335,249.0,93.28571428571428,7,4087,4113.166666666667,1514.0,583.8571428571429
108141.0,17,4,1400,4,1400,36047.0,350.0,350.0,0,0,0.0,0.0,0.0
120237884.0,6,19,1395,10,745,13333287.444444444,95.0,74.5,9,650,14999993.625,95.0,72.22222222222223
2022823.0,17,4,525,2,150,0.0,75.0,75.0,2,375,0.0,284.0,187.5
309.0,17,2,164,1,82,0.0,82.0,82.0,1,82,0.0,82.0,82.0
155296.0,17,4,6056,4,6056,51765.333333333336,1514.0,1514.0,0,0,0.0,0.0,0.0
232933.0,6,3,373,2,238,0.0,172.0,119.0,1,135,0.0,135.0,135.0
1920.0,17,2,176,1,80,0.0,80.0,80.0,1,96,0.0,96.0,96.0
51142.0,6,13,4416,6,409,10038.0,127.0,68.16666666666667,7,4007,8179.666666666667,1514.0,572.4285714285714
460147.0,6,3,1604,2,851,0.0,785.0,425.5,1,753,0.0,753.0,753.0
755856.0,6,2,132,1,66,0.0,66.0,66.0,1,66,0.0,66.0,66.0
27464016.0,17,5,1710,5,1710,6866004.0,342.0,342.0,0,0,0.0,0.0,0.0
46790.0,6,14,4740,7,653,7009.333333333333,249.0,93.28571428571428,7,4087,7577.333333333333,1514.0,583.8571428571429
3006325.0,6,11,2106,6,598,601091.6,252.0,99.66666666666669,5,1508,1923.75,1236.0,301.6
38046.0,6,10,2032,5,524,8224.75,252.0,104.8,5,1508,8997.25,1236.0,301.6
17758.0,6,14,4740,7,653,2731.5,249.0,93.28571428571428,7,4087,2821.833333333333,1514.0,583.8571428571429
2562179.0,6,2,132,1,66,0.0,66.0,66.0,1,66,0.0,66.0,66.0
50096.0,6,10,2032,5,524,11161.25,252.0,104.8,5,1508,10519.75,1236.0,301.6
122000.0,6,3,373,2,238,0.0,172.0,119.0,1,135,0.0,135.0,135.0
27419.0,6,10,2032,5,524,6617.75,252.0,104.8,5,1508,6607.75,1236.0,301.6
96345.0,17,2,762,2,762,0.0,381.0,381.0,0,0,0.0,0.0,0.0
102780.0,17,2,286,2,286,0.0,143.0,143.0,0,0,0.0,0.0,0.0
106001027.0,17,13,821,7,432,17666837.833333332,174.0,61.71428571428572,6,389,17201649.2,174.0,64.83333333333333
153422.0,17,2,180,1,90,0.0,90.0,90.0,1,90,0.0,90.0,90.0
302076.0,6,3,202,2,128,0.0,74.0,64.0,1,74,0.0,74.0,74.0
414.0,17,2,410,1,78,0.0,78.0,78.0,1,332,0.0,332.0,332.0
218093.0,6,3,426,2,280,0.0,214.0,140.0,1,146,0.0,146.0,146.0
215997.0,6,10,1221,6,636,43199.4,298.0,106.0,4,585,69514.0,379.0,146.25
353753.0,17,2,180,1,90,0.0,90.0,90.0,1,90,0.0,90.0,90.0
3248.0,17,4,344,2,150,0.0,75.0,75.0,2,194,0.0,103.0,97.0
140713.0,6,2,132,1,66,0.0,66.0,66.0,1,66,0.0,66.0,66.0
113000852.0,17,13,821,7,432,18833475.33333333,174.0,61.71428571428572,6,389,18600842.4,174.0,64.83333333333333
10493517.0,6,7,478,4,272,3450598.0,74.0,68.0,3,206,5175781.0,74.0,68.66666666666667
10464239.0,6,7,478,4,272,3442660.6666666665,74.0,68.0,3,206,5163908.5,74.0,68.66666666666667
116519566.0,6,31,2160,16,1071,7767971.066666666,123.0,66.9375,15,1089,7594153.714285715,123.0,72.6
118473777.0,6,45,3646,24,1960,5151033.782608695,139.0,81.66666666666667,21,1686,5912879.85,123.0,80.28571428571429
90094620.0,6,12,1848,5,1020,22523058.0,204.0,204.0,7,828,15015382.833333334,188.0,118.28571428571428
58782.0,6,14,4740,7,653,9665.833333333334,249.0,93.28571428571428,7,4087,8429.333333333334,1514.0,583.8571428571429
153519.0,17,2,180,1,90,0.0,90.0,90.0,1,90,0.0,90.0,90.0
9243.0,17,2,539,1,86,0.0,86.0,86.0,1,453,0.0,453.0,453.0
135143289.0,17,6,1206,6,1206,27028657.8,201.0,201.0,0,0,0.0,0.0,0.0
99386.0,17,2,762,2,762,0.0,381.0,381.0,0,0,0.0,0.0,0.0
143.0,17,3,1143,3,1143,71.5,381.0,381.0,0,0,0.0,0.0,0.0
90085454.0,6,10,1440,7,828,15014242.333333334,188.0,118.28571428571428,3,612,30030992.0,204.0,204.0
90032968.0,17,27,12943,27,12943,3462806.461538461,501.0,479.3703703703704,0,0,0.0,0.0,0.0
2796084.0,6,2,132,1,66,0.0,66.0,66.0,1,66,0.0,66.0,66.0
0.0,17,1,90,1,90,0.0,90.0,90.0,0,0,0.0,0.0,0.0
50810.0,17,2,180,1,90,0.0,90.0,90.0,1,90,0.0,90.0,90.0
135889.0,6,2,132,1,66,0.0,66.0,66.0,1,66,0.0,66.0,66.0
207532.0,6,3,426,2,280,0.0,214.0,140.0,1,146,0.0,146.0,146.0
320.0,17,2,174,1,79,0.0,79.0,79.0,1,95,0.0,95.0,95.0
1306930.0,6,4,264,2,132,0.0,66.0,66.0,2,132,0.0,66.0,66.0
206138.0,6,3,426,2,280,0.0,214.0,140.0,1,146,0.0,146.0,146.0
207741.0,6,3,426,2,280,0.0,214.0,140.0,1,146,0.0,146.0,146.0
104971321.0,17,15,5130,15,5130,7497951.5,342.0,342.0,0,0,0.0,0.0,0.0
85924.0,6,14,4740,7,653,14195.833333333334,249.0,93.28571428571428,7,4087,12837.833333333334,1514.0,583.8571428571429
148013.0,17,2,180,1,90,0.0,90.0,90.0,1,90,0.0,90.0,90.0
90037539.0,17,28,13364,28,13364,3334723.6666666665,501.0,477.2857142857143,0,0,0.0,0.0,0.0
96388840.0,6,270,32588,135,23456,717787.2985074627,300.0,173.74814814814815,135,9132,717787.171641791,140.0,67.64444444444445
108100008.0,17,5,1005,5,1005,27025002.0,201.0,201.0,0,0,0.0,0.0,0.0
1004216.0,6,13,1428,7,797,166753.5,253.0,113.85714285714286,6,631,200039.6,293.0,105.16666666666669
43259.0,6,2,132,1,66,0.0,66.0,66.0,1,66,0.0,66.0,66.0
737034.0,6,14,4740,7,653,122567.33333333331,249.0,93.28571428571428,7,4087,122333.66666666669,1514.0,583.8571428571429
216879.0,6,3,426,2,280,0.0,214.0,140.0,1,146,0.0,146.0,146.0
538212.0,17,6,2100,6,2100,107642.4,350.0,350.0,0,0,0.0,0.0,0.0
162317.0,17,2,180,1,90,0.0,90.0,90.0,1,90,0.0,90.0,90.0
45666219.0,6,8,2113,3,960,21769492.0,826.0,320.0,5,1153,10747533.25,885.0,230.6
108121530.0,17,5,955,5,955,27030382.5,191.0,191.0,0,0,0.0,0.0,0.0
135143022.0,17,6,1146,6,1146,27028604.4,191.0,191.0,0,0,0.0,0.0,0.0
90297488.0,6,19,1760,10,1110,10027421.555555556,257.0,111.0,9,650,11286483.75,95.0,72.22222222222223
114001128.0,17,16,1172,8,554,16285875.42857143,174.0,69.25,8,618,16144018.142857144,186.0,77.25
54072.0,6,14,4740,7,653,8792.833333333334,249.0,93.28571428571428,7,4087,8839.833333333334,1514.0,583.8571428571429
2182911.0,6,28,8010,15,4022,155922.2142857143,1514.0,268.1333333333333,13,3988,132372.66666666666,1514.0,306.7692307692308
68453.0,6,14,4740,7,653,11279.666666666666,249.0,93.28571428571428,7,4087,11018.833333333334,1514.0,583.8571428571429
90050786.0,17,22,10444,22,10444,4288132.666666667,501.0,474.7272727272728,0,0,0.0,0.0,0.0
216499.0,17,2,180,1,90,0.0,90.0,90.0,1,90,0.0,90.0,90.0
47418.0,6,14,4740,7,653,7691.0,249.0,93.28571428571428,7,4087,7515.0,1514.0,583.8571428571429
120774010.0,6,224,25318,113,17758,1078339.375,284.0,157.1504424778761,111,7560,1084608.9,140.0,68.10810810810811
120241.0,17,4,1400,4,1400,40080.333333333336,350.0,350.0,0,0,0.0,0.0,0.0
138972.0,6,2,132,1,66,0.0,66.0,66.0,1,66,0.0,66.0,66.0
110344841.0,6,210,23864,105,16712,1058938.9134615385,284.0,159.16190476190476,105,7152,1058938.9711538462,140.0,68.11428571428571
15258.0,17,2,582,1,83,0.0,83.0,83.0,1,499,0.0,499.0,499.0
90261679.0,6,13,2036,8,1016,12894525.57142857,188.0,127.0,5,1020,22523003.0,204.0,204.0
120017149.0,6,1036,218120,509,34358,234667.44094488188,214.0,67.50098231827111,527,183762,228118.32319391635,1514.0,348.6944971537002
21518.0,17,2,582,1,83,0.0,83.0,83.0,1,499,0.0,499.0,499.0
1302513.0,6,4,264,2,132,0.0,66.0,66.0,2,132,0.0,66.0,66.0
248284.0,6,2,132,1,66,0.0,66.0,66.0,1,66,0.0,66.0,66.0
240200.0,6,3,337,2,214,0.0,160.0,107.0,1,123,0.0,123.0,123.0
207397.0,6,3,426,2,280,0.0,214.0,140.0,1,146,0.0,146.0,146.0
232984.0,6,3,337,2,214,0.0,160.0,107.0,1,123,0.0,123.0,123.0
20632.0,6,10,2032,5,524,4327.75,252.0,104.8,5,1508,4344.5,1236.0,301.6
9541.0,17,2,571,1,86,0.0,86.0,86.0,1,485,0.0,485.0,485.0
113255447.0,6,46,3036,23,1518,5135443.7727272725,66.0,66.0,23,1518,5135459.136363637,66.0,66.0
2120.0,17,4,344,2,150,0.0,75.0,75.0,2,194,0.0,103.0,97.0
135170861.0,17,6,1206,6,1206,27034172.2,201.0,201.0,0,0,0.0,0.0,0.0
117769405.0,6,216,24424,108,17000,1100648.6448598132,284.0,157.40740740740742,108,7424,1098531.289719626,140.0,68.74074074074075
173038.0,6,3,337,2,214,0.0,160.0,107.0,1,123,0.0,123.0,123.0
384.0,17,2,208,1,72,0.0,72.0,72.0,1,136,0.0,136.0,136.0
0.0,17,1,55,1,55,0.0,55.0,55.0,0,0,0.0,0.0,0.0
1041179.0,6,13,1386,7,789,173529.83333333334,253.0,112.71428571428572,6,597,207120.0,259.0,99.5
53873.0,6,14,4740,7,653,5916.833333333333,249.0,93.28571428571428,7,4087,8835.0,1514.0,583.8571428571429
2353.0,17,4,344,2,150,0.0,75.0,75.0,2,194,0.0,103.0,97.0
1316876.0,6,4,264,2,132,0.0,66.0,66.0,2,132,0.0,66.0,66.0
1305960.0,6,4,264,2,132,0.0,66.0,66.0,2,132,0.0,66.0,66.0
10567478.0,6,7,478,4,272,3477105.6666666665,74.0,68.0,3,206,5185874.0,74.0,68.66666666666667
93432964.0,6,25,1924,14,1084,7186092.307692308,95.0,77.42857142857143,11,840,9342952.5,95.0,76.36363636363636
1033505.0,6,11,1134,6,558,206701.0,220.0,93.0,5,576,255952.5,304.0,115.2
131001200.0,17,17,1255,9,649,16375150.0,174.0,72.11111111111111,8,606,15857833.0,174.0,75.75
1674597.0,17,18,1260,18,1260,98505.70588235294,70.0,70.0,0,0,0.0,0.0,0.0
34286.0,6,11,1131,6,600,6183.6,262.0,100.0,5,531,6864.25,259.0,106.2
100892.0,6,11,2098,6,590,19644.2,252.0,98.33333333333331,5,1508,24989.75,1236.0,301.6
90533701.0,6,14,2240,8,1016,12933385.857142856,188.0,127.0,6,1224,18073608.0,204.0,204.0
21496.0,17,2,582,1,83,0.0,83.0,83.0,1,499,0.0,499.0,499.0
343.0,17,2,250,1,93,0.0,93.0,93.0,1,157,0.0,157.0,157.0
5622335.0,6,4,270,2,134,0.0,68.0,67.0,2,136,0.0,70.0,68.0
232462.0,6,3,337,2,214,0.0,160.0,107.0,1,123,0.0,123.0,123.0
232159.0,6,3,337,2,214,0.0,160.0,107.0,1,123,0.0,123.0,123.0
2251715.0,6,28,7808,14,2582,173208.84615384616,1034.0,184.42857142857144,14,5226,149126.07692307694,1510.0,373.2857142857143
119556172.0,6,636,99314,321,78154,372939.971875,1514.0,243.47040498442368,315,21160,380066.3025477707,214.0,67.17460317460318
216374.0,17,2,180,1,90,0.0,90.0,90.0,1,90,0.0,90.0,90.0
1198964.0,6,13,3020,8,2392,171280.57142857142,1514.0,299.0,5,628,230747.75,331.0,125.6
209581.0,17,2,180,1,90,0.0,90.0,90.0,1,90,0.0,90.0,90.0
90121254.0,6,12,1848,5,1020,22529740.25,204.0,204.0,7,828,14974729.666666666,188.0,118.28571428571428
90118485.0,6,11,1644,4,816,30038687.33333333,204.0,204.0,7,828,15019361.666666666,188.0,118.28571428571428
90045428.0,17,28,13364,28,13364,3335015.851851852,501.0,477.2857142857143,0,0,0.0,0.0,0.0
2773596.0,6,11,2106,6,598,554553.6,252.0,99.66666666666669,5,1508,4400.0,1236.0,301.6
14565.0,6,10,2032,5,524,3400.5,252.0,104.8,5,1508,3374.25,1236.0,301.6
301923.0,6,6,412,4,272,100641.0,74.0,68.0,2,140,0.0,74.0,70.0
90260750.0,6,12,1832,8,1016,12894392.857142856,188.0,127.0,4,816,30031178.0,204.0,204.0
14963.0,17,2,180,1,90,0.0,90.0,90.0,1,90,0.0,90.0,90.0
1038504.0,6,11,1134,6,558,207700.8,220.0,93.0,5,576,257094.5,304.0,115.2
2331.0,17,4,344,2,150,0.0,75.0,75.0,2,194,0.0,103.0,97.0
199626.0,17,4,6056,4,6056,66542.0,1514.0,1514.0,0,0,0.0,0.0,0.0
24745.0,6,10,1913,5,461,5748.25,233.0,92.2,5,1452,4583.0,1224.0,290.4
90257346.0,6,12,1832,8,1016,12893906.57142857,188.0,127.0,4,816,30030837.33333333,204.0,204.0
15479.0,6,14,4740,7,653,2386.833333333333,249.0,93.28571428571428,7,4087,2286.0,1514.0,583.8571428571429
1020434.0,6,11,1134,6,558,204086.8,220.0,93.0,5,576,254619.75,304.0,115.2
120346094.0,6,239,27128,120,18978,1011311.7142857144,390.0,158.15,119,8150,1014341.1355932204,140.0,68.4873949579832
135138928.0,17,6,1146,6,1146,27027785.6,191.0,191.0,0,0,0.0,0.0,0.0
67840.0,6,14,4740,7,653,11122.166666666666,249.0,93.28571428571428,7,4087,9972.666666666666,1514.0,583.8571428571429
30017.0,6,14,4740,7,653,4166.5,249.0,93.28571428571428,7,4087,4848.833333333333,1514.0,583.8571428571429
46588273.0,6,8,2113,3,960,22193020.5,826.0,320.0,5,1153,11002875.25,885.0,230.6
1416042.0,17,16,1120,16,1120,94402.8,70.0,70.0,0,0,0.0,0.0,0.0
153581.0,17,2,180,1,90,0.0,90.0,90.0,1,90,0.0,90.0,90.0
66158.0,6,10,2032,5,524,16323.75,252.0,104.8,5,1508,15219.5,1236.0,301.6
411.0,17,2,410,1,78,0.0,78.0,78.0,1,332,0.0,332.0,332.0
41992.0,6,14,4740,7,653,6822.333333333333,249.0,93.28571428571428,7,4087,6415.0,1514.0,583.8571428571429
209618.0,17,2,180,1,90,0.0,90.0,90.0,1,90,0.0,90.0,90.0
99527.0,17,4,1400,4,1400,33175.666666666664,350.0,350.0,0,0,0.0,0.0,0.0
313622.0,6,6,412,4,272,104540.66666666669,74.0,68.0,2,140,0.0,74.0,70.0
33918.0,6,14,4740,7,653,5134.5,249.0,93.28571428571428,7,4087,5406.833333333333,1514.0,583.8571428571429
829976.0,6,9,1118,6,586,165995.2,248.0,97.66666666666669,3,532,278602.5,392.0,177.33333333333334
76424.0,6,14,4740,7,653,12074.666666666666,249.0,93.28571428571428,7,4087,10263.5,1514.0,583.8571428571429
1681209.0,6,8,602,3,198,204430.0,66.0,66.0,5,404,395635.5,103.0,80.8
142367.0,17,4,344,2,150,0.0,75.0,75.0,2,194,0.0,103.0,97.0
106949.0,17,2,286,2,286,0.0,143.0,143.0,0,0,0.0,0.0,0.0
146376.0,6,3,337,2,214,0.0,160.0,107.0,1,123,0.0,123.0,123.0
102456873.0,6,29,2052,15,1089,7302932.285714285,123.0,72.6,14,963,7864692.230769231,123.0,68.78571428571429
802.0,17,4,438,2,148,0.0,74.0,74.0,2,290,0.0,147.0,145.0
38590325.0,6,26,7627,14,3735,188876.3076923077,1514.0,266.7857142857143,12,3892,3489600.727272727,1514.0,324.3333333333333
1163291.0,6,13,3000,8,2372,166184.42857142858,1514.0,296.5,5,628,221922.25,331.0,125.6
120120334.0,6,13,2020,9,1204,15015041.75,188.0,133.77777777777777,4,816,30030258.33333333,204.0,204.0
319.0,17,2,174,1,79,0.0,79.0,79.0,1,95,0.0,95.0,95.0
6957.0,17,2,582,1,83,0.0,83.0,83.0,1,499,0.0,499.0,499.0
187956.0,6,2,132,1,66,0.0,66.0,66.0,1,66,0.0,66.0,66.0
90048432.0,17,28,13364,28,13364,3335127.111111111,501.0,477.2857142857143,0,0,0.0,0.0,0.0
104192.0,17,2,700,2,700,0.0,350.0,350.0,0,0,0.0,0.0,0.0
100436121.0,17,13,821,7,432,16666807.833333334,174.0,61.71428571428572,6,389,20000860.0,174.0,64.83333333333333
49549.0,6,10,2032,5,524,11823.75,252.0,104.8,5,1508,9554.75,1236.0,301.6
2027.0,17,4,344,2,150,0.0,75.0,75.0,2,194,0.0,103.0,97.0
306759.0,6,6,412,4,272,102253.0,74.0,68.0,2,140,0.0,74.0,70.0
209485.0,17,2,180,1,90,0.0,90.0,90.0,1,90,0.0,90.0,90.0
217886.0,6,3,426,2,280,0.0,214.0,140.0,1,146,0.0,146.0,146.0
309745.0,6,6,412,4,272,103248.33333333331,74.0,68.0,2,140,0.0,74.0,70.0
146027.0,6,3,337,2,214,0.0,160.0,107.0,1,123,0.0,123.0,123.0
117269119.0,17,14,864,7,432,19501744.5,174.0,61.71428571428572,7,432,19500149.33333333,174.0,61.71428571428572
116483390.0,6,48,3168,24,1584,5064495.217391305,66.0,66.0,24,1584,5051228.173913044,66.0,66.0
146131.0,6,3,337,2,214,0.0,160.0,107.0,1,123,0.0,123.0,123.0
90032880.0,17,28,13364,28,13364,3334551.111111111,501.0,477.2857142857143,0,0,0.0,0.0,0.0
131065.0,6,3,337,2,214,0.0,160.0,107.0,1,123,0.0,123.0,123.0
107341.0,17,2,286,2,286,0.0,143.0,143.0,0,0,0.0,0.0,0.0
3169491.0,6,18,1536,9,962,358369.625,315.0,106.88888888888889,9,574,358339.75,78.0,63.77777777777778
196936.0,17,2,180,1,90,0.0,90.0,90.0,1,90,0.0,90.0,90.0
221174.0,6,10,1221,6,636,44234.8,298.0,106.0,4,585,72423.66666666667,379.0,146.25
2382.0,17,4,344,2,150,0.0,75.0,75.0,2,194,0.0,103.0,97.0
40910.0,6,14,4740,7,653,6692.333333333333,249.0,93.28571428571428,7,4087,6641.5,1514.0,583.8571428571429
96911508.0,6,32,2368,16,1228,6460767.2,139.0,76.75,16,1140,6446351.6,123.0,71.25
128656478.0,6,35,2542,17,1194,7416862.5,123.0,70.23529411764706,18,1348,7115985.882352941,139.0,74.88888888888889
120364926.0,6,223,25118,112,17496,1084368.7027027027,284.0,156.21428571428572,111,7622,1084781.4454545456,140.0,68.66666666666667
120622322.0,6,33,2365,16,1140,7375871.2,123.0,71.25,17,1225,7538816.875,139.0,72.05882352941177
108105081.0,17,5,1005,5,1005,27026270.25,201.0,201.0,0,0,0.0,0.0,0.0
321116.0,17,4,1400,4,1400,107038.66666666669,350.0,350.0,0,0,0.0,0.0,0.0
292.0,17,2,174,1,79,0.0,79.0,79.0,1,95,0.0,95.0,95.0
52519.0,6,14,4740,7,653,8627.666666666666,249.0,93.28571428571428,7,4087,7825.833333333333,1514.0,583.8571428571429
90030990.0,17,28,13364,28,13364,3334481.111111111,501.0,477.2857142857143,0,0,0.0,0.0,0.0
1948.0,17,2,192,1,88,0.0,88.0,88.0,1,104,0.0,104.0,104.0
217343.0,6,3,426,2,280,0.0,214.0,140.0,1,146,0.0,146.0,146.0
123843906.0,6,49,3234,25,1650,5160162.75,66.0,66.0,24,1584,5055316.608695652,66.0,66.0
135984.0,6,2,132,1,66,0.0,66.0,66.0,1,66,0.0,66.0,66.0
123855939.0,6,49,3234,25,1650,5160664.125,66.0,66.0,24,1584,5181588.434782608,66.0,66.0
1302143.0,6,4,264,2,132,0.0,66.0,66.0,2,132,0.0,66.0,66.0
10465183.0,6,7,478,4,272,3442994.333333333,74.0,68.0,3,206,5164382.5,74.0,68.66666666666667
27594.0,6,10,2032,5,524,6693.5,252.0,104.8,5,1508,5545.25,1236.0,301.6
60090.0,6,14,4740,7,653,9540.333333333334,249.0,93.28571428571428,7,4087,9367.666666666666,1514.0,583.8571428571429
108100930.0,17,5,1005,5,1005,27025232.5,201.0,201.0,0,0,0.0,0.0,0.0
39690.0,6,14,4740,7,653,6432.333333333333,249.0,93.28571428571428,7,4087,6254.666666666667,1514.0,583.8571428571429
28322.0,6,10,1065,5,534,6218.5,262.0,106.8,5,531,6171.25,259.0,106.2
266466.0,17,4,1524,4,1524,88822.0,381.0,381.0,0,0,0.0,0.0,0.0
323.0,17,2,164,1,82,0.0,82.0,82.0,1,82,0.0,82.0,82.0
0.0,6,1,172,1,172,0.0,172.0,172.0,0,0,0.0,0.0,0.0
500696.00000000006,6,5,336,2,134,0.0,68.0,67.0,3,202,194413.5,70.0,67.33333333333333
0.0,6,1,66,1,66,0.0,66.0,66.0,0,0,0.0,0.0,0.0
108089888.0,17,5,955,5,955,27022472.0,191.0,191.0,0,0,0.0,0.0,0.0
90038212.0,17,28,13364,28,13364,3334748.592592593,501.0,477.2857142857143,0,0,0.0,0.0,0.0
204220.0,17,2,762,2,762,0.0,381.0,381.0,0,0,0.0,0.0,0.0
5010812.0,17,4,376,2,152,0.0,76.0,76.0,2,224,0.0,148.0,112.0
799.0,17,4,438,2,148,0.0,74.0,74.0,2,290,0.0,147.0,145.0
246471.0,6,10,1221,6,636,49294.2,298.0,106.0,4,585,80838.33333333333,379.0,146.25
306849.0,6,6,412,4,272,102283.0,74.0,68.0,2,140,0.0,74.0,70.0
44528.0,6,14,4740,7,653,7249.666666666667,249.0,93.28571428571428,7,4087,7245.166666666667,1514.0,583.8571428571429
108108149.0,17,5,1005,5,1005,27027037.25,201.0,201.0,0,0,0.0,0.0,0.0
136306.0,6,2,132,1,66,0.0,66.0,66.0,1,66,0.0,66.0,66.0
205924.0,17,2,180,1,90,0.0,90.0,90.0,1,90,0.0,90.0,90.0
1992.0,17,4,344,2,150,0.0,75.0,75.0,2,194,0.0,103.0,97.0
198009.0,17,2,180,1,90,0.0,90.0,90.0,1,90,0.0,90.0,90.0
139219.0,6,2,132,1,66,0.0,66.0,66.0,1,66,0.0,66.0,66.0
67088.0,6,14,4740,7,653,10843.833333333334,249.0,93.28571428571428,7,4087,10986.166666666666,1514.0,583.8571428571429
1149530.0,6,13,3004,8,2376,164218.57142857142,1514.0,297.0,5,628,219239.5,331.0,125.6
120573569.0,17,14,864,7,432,16833489.333333332,174.0,61.71428571428572,7,432,16832212.833333332,174.0,61.71428571428572
90543977.0,6,14,2240,8,1016,12934853.857142856,188.0,127.0,6,1224,18076600.0,204.0,204.0
199156.0,17,2,180,1,90,0.0,90.0,90.0,1,90,0.0,90.0,90.0
123730635.0,6,49,3234,25,1650,5155443.125,66.0,66.0,24,1584,4943004.478260869,66.0,66.0
119993745.0,17,34,16284,34,16284,3636174.090909091,501.0,478.9411764705882,0,0,0.0,0.0,0.0
90049696.0,17,27,12943,27,12943,3463449.846153846,501.0,479.3703703703704,0,0,0.0,0.0,0.0
90093472.0,6,10,1440,7,828,15015578.666666666,188.0,118.28571428571428,3,612,30027695.5,204.0,204.0
2364.0,17,4,344,2,150,0.0,75.0,75.0,2,194,0.0,103.0,97.0
31851.0,6,10,2032,5,524,7703.75,252.0,104.8,5,1508,7535.25,1236.0,301.6
309953.0,6,6,412,4,272,103317.66666666669,74.0,68.0,2,140,0.0,74.0,70.0
1179597.0,6,13,3010,8,2382,168513.85714285713,1514.0,297.75,5,628,225997.5,331.0,125.6
298240.0,6,6,412,4,272,99413.33333333331,74.0,68.0,2,140,0.0,74.0,70.0
10871987.0,6,8,544,4,272,3578275.0,74.0,68.0,4,272,3578209.6666666665,74.0,68.0
2350.0,17,4,344,2,150,0.0,75.0,75.0,2,194,0.0,103.0,97.0
268123.0,6,10,1221,6,636,53624.6,298.0,106.0,4,585,83356.0,379.0,146.25
12289005.0,6,28,9293,15,2193,877786.0714285715,408.0,146.2,13,7100,727201.3333333334,1514.0,546.1538461538462
108105303.0,17,5,955,5,955,27026325.75,191.0,191.0,0,0,0.0,0.0,0.0
246468.0,6,3,337,2,214,0.0,160.0,107.0,1,123,0.0,123.0,123.0
119574801.0,6,380,45068,190,32232,631582.0,336.0,169.6421052631579,190,12836,631582.4708994708,140.0,67.5578947368421
90034635.0,17,28,13364,28,13364,3334616.111111111,501.0,477.2857142857143,0,0,0.0,0.0,0.0
120755024.0,6,34,2419,18,1348,7103236.705882353,139.0,74.88888888888889,16,1071,7523288.666666667,123.0,66.9375
10530230.0,6,7,478,4,272,3463815.0,74.0,68.0,3,206,5195598.0,74.0,68.66666666666667
1501419.0,6,18,6507,10,1598,166824.33333333334,505.0,159.8,8,4909,170156.57142857142,1510.0,613.625
323439.0,17,4,1400,4,1400,107813.0,350.0,350.0,0,0,0.0,0.0,0.0
104837165.0,6,39,3156,21,1701,5241858.25,123.0,81.0,18,1455,6154167.529411765,123.0,80.83333333333333
113765685.0,6,48,3168,24,1584,4946334.130434782,66.0,66.0,24,1584,4934486.391304348,66.0,66.0
32971.0,6,14,4740,7,653,5056.166666666667,249.0,93.28571428571428,7,4087,4585.0,1514.0,583.8571428571429
35573.0,6,10,2032,5,524,8084.0,252.0,104.8,5,1508,8549.0,1236.0,301.6
21366.0,6,10,1067,5,536,4665.5,264.0,107.2,5,531,4041.5,259.0,106.2
99783842.0,6,320,37926,160,27144,626210.2578616352,336.0,169.65,160,10782,626216.6729559748,140.0,67.3875
246234.0,6,3,337,2,214,0.0,160.0,107.0,1,123,0.0,123.0,123.0
16597.0,6,2,145,2,145,0.0,91.0,72.5,0,0,0.0,0.0,0.0
1161475.0,6,13,3010,8,2382,165925.0,1514.0,297.75,5,628,221392.75,331.0,125.6
90038748.0,17,28,13364,28,13364,3334768.4444444445,501.0,477.2857142857143,0,0,0.0,0.0,0.0
301398.0,6,6,412,4,272,100466.0,74.0,68.0,2,140,0.0,74.0,70.0
218624.0,6,3,426,2,280,0.0,214.0,140.0,1,146,0.0,146.0,146.0
3167543.0,6,152,119697,84,110907,38163.1686746988,1510.0,1320.321428571429,68,8790,42581.19402985075,1510.0,129.26470588235293
90050232.0,17,27,12943,27,12943,3463470.461538461,501.0,479.3703703703704,0,0,0.0,0.0,0.0
153488.0,17,2,180,1,90,0.0,90.0,90.0,1,90,0.0,90.0,90.0
135122403.0,17,6,1146,6,1146,27024480.6,191.0,191.0,0,0,0.0,0.0,0.0
353.0,17,2,267,1,83,0.0,83.0,83.0,1,184,0.0,184.0,184.0
135128691.0,17,6,1146,6,1146,27025738.2,191.0,191.0,0,0,0.0,0.0,0.0
120008652.0,17,28,13364,28,13364,4444764.888888889,501.0,477.2857142857143,0,0,0.0,0.0,0.0
51108.0,6,14,4740,7,653,8333.833333333334,249.0,93.28571428571428,7,4087,7586.833333333333,1514.0,583.8571428571429
152277.0,6,10,1066,5,490,37268.75,218.0,98.0,5,576,37799.25,304.0,115.2
153463.0,17,2,180,1,90,0.0,90.0,90.0,1,90,0.0,90.0,90.0
94157501.0,6,40,2640,20,1320,4955657.947368421,66.0,66.0,20,1320,4939117.368421053,66.0,66.0
245475.0,6,3,337,2,214,0.0,160.0,107.0,1,123,0.0,123.0,123.0
1352507.0,6,4,276,2,128,0.0,74.0,64.0,2,148,0.0,74.0,74.0
219816.0,6,3,426,2,280,0.0,214.0,140.0,1,146,0.0,146.0,146.0
208412.0,6,3,426,2,280,0.0,214.0,140.0,1,146,0.0,146.0,146.0
211388.0,17,2,180,1,90,0.0,90.0,90.0,1,90,0.0,90.0,90.0
9322.0,17,2,507,1,86,0.0,86.0,86.0,1,421,0.0,421.0,421.0
206246.0,6,3,426,2,280,0.0,214.0,140.0,1,146,0.0,146.0,146.0
10520463.0,6,7,478,4,272,3461376.6666666665,74.0,68.0,3,206,5191935.0,74.0,68.66666666666667
9089994.0,6,12,2172,7,664,1508775.0,252.0,94.85714285714286,5,1508,25005.25,1236.0,301.6
147898.0,17,2,180,1,90,0.0,90.0,90.0,1,90,0.0,90.0,90.0
354.0,17,2,267,1,83,0.0,83.0,83.0,1,184,0.0,184.0,184.0
24522035.0,17,5,1718,4,1368,910278.6666666666,342.0,342.0,1,350,0.0,350.0,350.0
209531.0,17,2,180,1,90,0.0,90.0,90.0,1,90,0.0,90.0,90.0
335.0,17,2,267,1,83,0.0,83.0,83.0,1,184,0.0,184.0,184.0
1302450.0,6,4,264,2,132,0.0,66.0,66.0,2,132,0.0,66.0,66.0
218284.0,6,3,426,2,280,0.0,214.0,140.0,1,146,0.0,146.0,146.0
2923.0,17,2,224,1,76,0.0,76.0,76.0,1,148,0.0,148.0,148.0
9250.0,17,2,582,1,83,0.0,83.0,83.0,1,499,0.0,499.0,499.0
196839.0,17,2,180,1,90,0.0,90.0,90.0,1,90,0.0,90.0,90.0
117936179.0,6,47,3102,24,1584,5127649.0869565215,66.0,66.0,23,1518,5159999.727272728,66.0,66.0
1189808.0,6,13,3010,8,2382,169972.57142857142,1514.0,297.75,5,628,228539.75,331.0,125.6
90046368.0,17,27,12943,27,12943,3463321.846153846,501.0,479.3703703703704,0,0,0.0,0.0,0.0
191147.0,17,2,180,1,90,0.0,90.0,90.0,1,90,0.0,90.0,90.0
301906.0,6,3,202,2,128,0.0,74.0,64.0,1,74,0.0,74.0,74.0
105896074.0,6,32,2236,16,1165,7045337.333333333,139.0,72.8125,16,1071,7045338.0,123.0,66.9375
280710.0,17,2,180,1,90,0.0,90.0,90.0,1,90,0.0,90.0,90.0
33581.0,6,14,4740,7,653,4111.166666666667,249.0,93.28571428571428,7,4087,5446.0,1514.0,583.8571428571429
257997.0,6,12,1373,7,714,42999.5,298.0,102.0,5,659,63831.0,379.0,131.8
90046809.0,17,28,13364,28,13364,3335067.0,501.0,477.2857142857143,0,0,0.0,0.0,0.0
91458307.0,6,24,1829,13,989,7621235.833333333,95.0,76.07692307692308,11,840,9143308.4,95.0,76.36363636363636
6864.0,17,2,239,1,82,0.0,82.0,82.0,1,157,0.0,157.0,157.0
130553.0,6,2,132,1,66,0.0,66.0,66.0,1,66,0.0,66.0,66.0
210676.0,6,10,1221,6,636,42135.2,298.0,106.0,4,585,68129.33333333333,379.0,146.25
813116.0,6,5,1742,3,921,406558.0,785.0,307.0,2,821,0.0,753.0,410.5
302427.0,6,2,132,1,66,0.0,66.0,66.0,1,66,0.0,66.0,66.0
2570333.0,6,52,23902,27,19905,98858.96153846152,1514.0,737.2222222222222,25,3997,98492.66666666669,1514.0,159.88
146213.0,6,3,337,2,214,0.0,160.0,107.0,1,123,0.0,123.0,123.0
104608.0,17,2,700,2,700,0.0,350.0,350.0,0,0,0.0,0.0,0.0
83.0,17,2,762,2,762,0.0,381.0,381.0,0,0,0.0,0.0,0.0
90253227.0,6,13,2036,8,1016,12893318.142857144,188.0,127.0,5,1020,22522156.0,204.0,204.0
119828008.0,6,21,1585,11,840,11978256.2,95.0,76.36363636363636,10,745,13313322.111111112,95.0,74.5
112640916.0,6,34,2350,17,1225,7040057.25,139.0,72.05882352941177,17,1125,7026527.375,123.0,66.17647058823529
120000131.0,6,18,1382,10,786,13333347.888888888,95.0,78.6,8,596,12898160.0,95.0,74.5
103609920.0,17,14,864,7,432,17166834.166666668,174.0,61.71428571428572,7,432,17167324.333333332,174.0,61.71428571428572
90103124.0,6,23,1775,10,745,10011458.222222222,95.0,74.5,13,1030,7485898.25,95.0,79.23076923076923
2597272.0,6,2,132,1,66,0.0,66.0,66.0,1,66,0.0,66.0,66.0
10525147.0,6,7,478,4,272,3461230.333333333,74.0,68.0,3,206,5191690.0,74.0,68.66666666666667
108283090.0,6,31,2182,16,1165,7204494.466666667,139.0,72.8125,15,1017,7719098.571428572,123.0,67.8
26777.0,6,10,1066,5,490,5888.75,218.0,98.0,5,576,6015.5,304.0,115.2
100834125.0,17,13,821,7,432,16666818.333333334,174.0,61.71428571428572,6,389,20000956.8,174.0,64.83333333333333
147963.0,17,2,180,1,90,0.0,90.0,90.0,1,90,0.0,90.0,90.0
102728.0,17,2,286,2,286,0.0,143.0,143.0,0,0,0.0,0.0,0.0
29122.0,6,14,4740,7,653,4681.166666666667,249.0,93.28571428571428,7,4087,4650.666666666667,1514.0,583.8571428571429
302396.0,6,2,132,1,66,0.0,66.0,66.0,1,66,0.0,66.0,66.0
18043.0,6,10,2032,5,524,4252.0,252.0,104.8,5,1508,4152.25,1236.0,301.6
114283238.0,6,48,3168,24,1584,4968836.434782608,66.0,66.0,24,1584,4954783.434782608,66.0,66.0
47422.0,6,14,4740,7,653,7793.5,249.0,93.28571428571428,7,4087,6964.666666666667,1514.0,583.8571428571429
107075499.0,6,28,1860,14,966,8219985.076923077,123.0,69.0,14,894,8219985.307692308,123.0,63.85714285714285
6875.0,17,2,582,1,83,0.0,83.0,83.0,1,499,0.0,499.0,499.0
2485.0,17,4,344,2,150,0.0,75.0,75.0,2,194,0.0,103.0,97.0
112045243.0,6,212,24086,106,7218,1059215.0761904763,140.0,68.09433962264151,106,16868,1059297.6666666667,284.0,159.1320754716981
108299563.0,6,32,2220,16,1149,7219970.866666666,123.0,71.8125,16,1071,7205526.933333334,123.0,66.9375
50108.0,6,14,4740,7,653,7375.333333333333,249.0,93.28571428571428,7,4087,8213.166666666666,1514.0,583.8571428571429
0.0,6,1,66,1,66,0.0,66.0,66.0,0,0,0.0,0.0,0.0
54760.0,6,14,4740,7,653,8961.333333333334,249.0,93.28571428571428,7,4087,8444.666666666666,1514.0,583.8571428571429
816.0,17,4,438,2,148,0.0,74.0,74.0,2,290,0.0,147.0,145.0
29927.0,6,14,4740,7,653,3975.5,249.0,93.28571428571428,7,4087,4848.166666666667,1514.0,583.8571428571429
0.0,17,1,179,1,179,0.0,179.0,179.0,0,0,0.0,0.0,0.0
248386.0,17,4,6056,4,6056,82795.33333333333,1514.0,1514.0,0,0,0.0,0.0,0.0
213723.0,17,2,180,1,90,0.0,90.0,90.0,1,90,0.0,90.0,90.0
27557.0,6,14,4740,7,653,4477.833333333333,249.0,93.28571428571428,7,4087,4397.0,1514.0,583.8571428571429
305263.0,6,6,412,4,272,101754.33333333331,74.0,68.0,2,140,0.0,74.0,70.0
232275.0,6,3,337,2,214,0.0,160.0,107.0,1,123,0.0,123.0,123.0
103309876.0,6,44,2904,22,1452,4911209.761904762,66.0,66.0,22,1452,4916309.80952381,66.0,66.0
9887.0,17,2,582,1,83,0.0,83.0,83.0,1,499,0.0,499.0,499.0
52468.0,6,14,4740,7,653,8624.0,249.0,93.28571428571428,7,4087,8576.5,1514.0,583.8571428571429
11517.0,6,11,2098,6,590,2303.4,252.0,98.33333333333331,5,1508,2362.75,1236.0,301.6
36066.0,6,10,2032,5,524,7965.75,252.0,104.8,5,1508,8660.75,1236.0,301.6
103662.0,17,2,286,2,286,0.0,143.0,143.0,0,0,0.0,0.0,0.0
102946.0,17,2,700,2,700,0.0,350.0,350.0,0,0,0.0,0.0,0.0
232943.0,6,3,337,2,214,0.0,160.0,107.0,1,123,0.0,123.0,123.0
101112801.0,17,12,778,6,389,19883421.4,174.0,64.83333333333333,6,389,20190363.4,174.0,64.83333333333333
108101875.0,17,5,1005,5,1005,27025468.75,201.0,201.0,0,0,0.0,0.0,0.0
90292729.0,6,16,1192,8,596,12891432.714285716,95.0,74.5,8,596,12898180.714285716,95.0,74.5
148110.0,17,2,180,1,90,0.0,90.0,90.0,1,90,0.0,90.0,90.0
153494.0,17,2,180,1,90,0.0,90.0,90.0,1,90,0.0,90.0,90.0
299979.0,6,6,412,4,272,99993.0,74.0,68.0,2,140,0.0,74.0,70.0
689715.0,6,4,497,3,374,344857.5,160.0,124.66666666666669,1,123,0.0,123.0,123.0
144857.0,17,2,180,1,70,0.0,70.0,70.0,1,110,0.0,110.0,110.0
116172903.0,6,30,1990,15,1042,8282649.428571428,139.0,69.46666666666667,15,948,8282647.214285715,123.0,63.2
841827.0,6,9,1118,6,586,168365.4,248.0,97.66666666666669,3,532,283143.5,392.0,177.33333333333334
117553249.0,6,248,28066,124,8480,955717.4715447156,140.0,68.38709677419355,124,19586,953911.8699186991,284.0,157.9516129032258
3408.0,17,2,359,1,75,0.0,75.0,75.0,1,284,0.0,284.0,284.0
3169770.0,6,18,1577,9,1003,358315.875,315.0,111.44444444444444,9,574,358291.75,78.0,63.77777777777778
118944568.0,6,34,2334,17,1209,7434035.5,123.0,71.11764705882354,17,1125,7421233.0625,123.0,66.17647058823529
3007302.0,6,12,2172,7,664,501141.8333333333,252.0,94.85714285714286,5,1508,1978.75,1236.0,301.6
20044.0,17,2,582,1,83,0.0,83.0,83.0,1,499,0.0,499.0,499.0
49765.0,6,14,4740,7,653,7843.5,249.0,93.28571428571428,7,4087,7963.5,1514.0,583.8571428571429
116604065.0,6,210,23822,105,16596,1119121.951923077,300.0,158.05714285714285,105,7226,1119123.2692307692,140.0,68.81904761904762
120242319.0,6,228,25768,114,7832,1033418.5663716814,140.0,68.70175438596492,114,17936,1056674.442477876,284.0,157.33333333333334
217891.0,6,3,426,2,280,0.0,214.0,140.0,1,146,0.0,146.0,146.0
145930.0,6,3,337,2,214,0.0,160.0,107.0,1,123,0.0,123.0,123.0
118888021.0,6,34,2334,17,1209,7430501.3125,123.0,71.11764705882354,17,1125,7416981.4375,123.0,66.17647058823529
232245.0,6,3,373,2,238,0.0,172.0,119.0,1,135,0.0,135.0,135.0
25472.0,6,14,4740,7,653,4061.1666666666665,249.0,93.28571428571428,7,4087,3865.3333333333335,1514.0,583.8571428571429
13998.0,6,12,1393,6,796,2635.4,271.0,132.66666666666666,6,597,2446.0,259.0,99.5
106926.0,17,2,286,2,286,0.0,143.0,143.0,0,0,0.0,0.0,0.0
90034610.0,17,28,13364,28,13364,3334615.185185185,501.0,477.2857142857143,0,0,0.0,0.0,0.0
2530788.0,6,3,1777,2,951,0.0,885.0,475.5,1,826,0.0,826.0,826.0
938.0,17,4,438,2,148,0.0,74.0,74.0,2,290,0.0,147.0,145.0
220640.0,6,3,426,2,280,0.0,214.0,140.0,1,146,0.0,146.0,146.0
90016394.0,17,28,13364,28,13364,3333940.5185185187,501.0,477.2857142857143,0,0,0.0,0.0,0.0
120041095.0,17,28,13364,28,13364,4445966.481481481,501.0,477.2857142857143,0,0,0.0,0.0,0.0
120785474.0,6,335,41220,168,29902,723266.3113772455,480.0,177.98809523809524,167,11318,711053.6927710844,140.0,67.77245508982035
103567.0,17,2,286,2,286,0.0,143.0,143.0,0,0,0.0,0.0,0.0
123108052.0,6,41,3408,18,1524,6654271.94117647,123.0,84.66666666666667,23,1884,5141941.090909091,123.0,81.91304347826087
50354.0,6,14,4740,7,653,8266.833333333334,249.0,93.28571428571428,7,4087,7990.666666666667,1514.0,583.8571428571429
107896.0,17,2,286,2,286,0.0,143.0,143.0,0,0,0.0,0.0,0.0
100886196.0,17,12,516,6,258,20003144.8,43.0,43.0,6,258,20000166.4,43.0,43.0
2030.0,17,4,344,2,150,0.0,75.0,75.0,2,194,0.0,103.0,97.0
1046862.0,6,13,1394,7,797,174477.0,253.0,113.85714285714286,6,597,207104.8,259.0,99.5
30870.0,6,14,4740,7,653,4611.333333333333,249.0,93.28571428571428,7,4087,4972.333333333333,1514.0,583.8571428571429
300974.0,6,6,412,4,272,100324.66666666669,74.0,68.0,2,140,0.0,74.0,70.0
98520070.0,6,29,2046,14,1029,7561802.307692308,123.0,73.5,15,1017,7021732.142857143,123.0,67.8
407.0,17,2,208,1,72,0.0,72.0,72.0,1,136,0.0,136.0,136.0
4353633.0,6,14,2478,8,958,621920.4285714285,267.0,119.75,6,1520,810492.6,614.0,253.3333333333333
90059914.0,17,28,13364,28,13364,3335552.3703703703,501.0,477.2857142857143,0,0,0.0,0.0,0.0
2587692.0,6,157,125902,87,117437,26596.02325581396,1510.0,1349.8505747126435,70,8465,33147.07246376811,1510.0,120.92857142857144
110001607.0,17,13,821,7,432,18333601.166666668,174.0,61.71428571428572,6,389,18000153.6,174.0,64.83333333333333
232081.0,6,3,373,2,238,0.0,172.0,119.0,1,135,0.0,135.0,135.0
3205930.0,6,3,1602,2,850,0.0,784.0,425.0,1,752,0.0,752.0,752.0
61894.0,6,14,4740,7,653,10194.0,249.0,93.28571428571428,7,4087,9911.5,1514.0,583.8571428571429
113254655.0,6,46,3036,23,1518,5135430.409090909,66.0,66.0,23,1518,5135426.0,66.0,66.0
106983.0,17,2,286,2,286,0.0,143.0,143.0,0,0,0.0,0.0,0.0
39277.0,6,10,2032,5,524,9593.5,252.0,104.8,5,1508,7192.0,1236.0,301.6
108000861.0,6,27,1800,14,894,8307758.538461538,123.0,63.85714285714285,13,906,8150060.583333333,123.0,69.6923076923077
166363.0,17,2,402,1,82,0.0,82.0,82.0,1,320,0.0,320.0,320.0
135156952.0,17,6,1146,6,1146,27031390.4,191.0,191.0,0,0,0.0,0.0,0.0
146572.0,6,3,337,2,214,0.0,160.0,107.0,1,123,0.0,123.0,123.0
25011.0,6,10,2032,5,524,5256.0,252.0,104.8,5,1508,6007.0,1236.0,301.6
135136550.0,17,6,1206,6,1206,27027310.0,201.0,201.0,0,0,0.0,0.0,0.0
90288306.0,6,14,1043,7,542,15048051.0,95.0,77.42857142857143,7,501,14996333.5,95.0,71.57142857142857
21123.0,6,10,2032,5,524,4864.25,252.0,104.8,5,1508,4714.25,1236.0,301.6
39896.0,6,14,4740,7,653,5136.833333333333,249.0,93.28571428571428,7,4087,6416.833333333333,1514.0,583.8571428571429
90030239.0,17,28,13364,28,13364,3334453.296296296,501.0,477.2857142857143,0,0,0.0,0.0,0.0
149577204.0,6,27,2032,14,1043,9214623.538461538,95.0,74.5,13,989,12462813.0,95.0,76.07692307692308
145385.0,6,3,337,2,214,0.0,160.0,107.0,1,123,0.0,123.0,123.0
452.0,17,2,410,1,78,0.0,78.0,78.0,1,332,0.0,332.0,332.0
47075.0,6,14,4740,7,653,7714.833333333333,249.0,93.28571428571428,7,4087,2982.0,1514.0,583.8571428571429
316629.0,17,4,704,2,148,0.0,74.0,74.0,2,556,0.0,280.0,278.0
146238.0,6,3,337,2,214,0.0,160.0,107.0,1,123,0.0,123.0,123.0
114514077.0,6,36,2580,18,1332,6723418.352941177,123.0,74.0,18,1248,6723414.0,123.0,69.33333333333333
108108884.0,17,5,1005,5,1005,27027221.0,201.0,201.0,0,0,0.0,0.0,0.0
92318037.0,6,27,1938,14,1029,7101387.461538462,123.0,73.5,13,909,7675153.583333333,123.0,69.92307692307692
108104851.0,17,5,1005,5,1005,27026212.75,201.0,201.0,0,0,0.0,0.0,0.0
166550.0,17,2,180,1,90,0.0,90.0,90.0,1,90,0.0,90.0,90.0
29472.0,6,14,4740,7,653,4803.0,249.0,93.28571428571428,7,4087,4704.0,1514.0,583.8571428571429
114282273.0,6,48,3168,24,1584,4968794.478260869,66.0,66.0,24,1584,4955527.739130435,66.0,66.0
135131011.0,17,6,1146,6,1146,27026202.2,191.0,191.0,0,0,0.0,0.0,0.0
90061439.0,17,27,12943,27,12943,3463901.5,501.0,479.3703703703704,0,0,0.0,0.0,0.0
10002.0,17,2,571,1,86,0.0,86.0,86.0,1,485,0.0,485.0,485.0
1986.0,17,4,344,2,150,0.0,75.0,75.0,2,194,0.0,103.0,97.0
40251.0,6,10,2032,5,524,9818.25,252.0,104.8,5,1508,9620.5,1236.0,301.6
216966.0,6,3,426,2,280,0.0,214.0,140.0,1,146,0.0,146.0,146.0
49290.0,6,14,4740,7,653,7991.833333333333,249.0,93.28571428571428,7,4087,8035.333333333333,1514.0,583.8571428571429
10872121.0,6,8,544,4,272,3578738.6666666665,74.0,68.0,4,272,3578661.333333333,74.0,68.0
90525646.0,6,13,2036,8,1016,12932235.142857144,188.0,127.0,5,1020,22590322.0,204.0,204.0
14636340.0,6,20,1648,10,1016,1592550.0,315.0,101.6,10,632,1592527.2222222222,78.0,63.2
19984.0,6,2,145,2,145,0.0,91.0,72.5,0,0,0.0,0.0,0.0
5419.0,17,2,359,1,75,0.0,75.0,75.0,1,284,0.0,284.0,284.0
156893.0,6,3,337,2,214,0.0,160.0,107.0,1,123,0.0,123.0,123.0
7060.0,17,2,582,1,83,0.0,83.0,83.0,1,499,0.0,499.0,499.0
645387.0,6,2,132,1,66,0.0,66.0,66.0,1,66,0.0,66.0,66.0
135128982.0,17,6,1206,6,1206,27025796.4,201.0,201.0,0,0,0.0,0.0,0.0
6757.0,17,2,582,1,83,0.0,83.0,83.0,1,499,0.0,499.0,499.0
197002.0,17,2,180,1,90,0.0,90.0,90.0,1,90,0.0,90.0,90.0
46204.0,6,14,4740,7,653,7579.5,249.0,93.28571428571428,7,4087,7441.5,1514.0,583.8571428571429
90020695.0,17,28,13364,28,13364,3334099.814814815,501.0,477.2857142857143,0,0,0.0,0.0,0.0
153430.0,17,2,180,1,90,0.0,90.0,90.0,1,90,0.0,90.0,90.0
3035.0,17,2,224,1,76,0.0,76.0,76.0,1,148,0.0,148.0,148.0
54343.0,6,12,1328,6,731,9123.2,253.0,121.83333333333331,6,597,10262.4,259.0,99.5
10461785.0,6,7,478,4,272,3441573.0,74.0,68.0,3,206,5162265.0,74.0,68.66666666666667
108104771.0,17,5,955,5,955,27026192.75,191.0,191.0,0,0,0.0,0.0,0.0
3505874.0,6,5,336,2,134,0.0,68.0,67.0,3,202,1424237.5,70.0,67.33333333333333
100669.0,17,2,762,2,762,0.0,381.0,381.0,0,0,0.0,0.0,0.0
209455.0,17,2,180,1,90,0.0,90.0,90.0,1,90,0.0,90.0,90.0
5822763.0,6,5,336,2,134,0.0,68.0,67.0,3,202,1524054.5,70.0,67.33333333333333
90257121.0,6,13,2036,8,1016,12893874.42857143,188.0,127.0,5,1020,22523742.75,204.0,204.0
90041362.0,17,28,13364,28,13364,3334865.25925926,501.0,477.2857142857143,0,0,0.0,0.0,0.0
135157043.0,17,6,1146,6,1146,27031408.6,191.0,191.0,0,0,0.0,0.0,0.0
90911937.0,6,26,1762,13,922,7557990.75,139.0,70.92307692307692,13,840,7557996.416666667,123.0,64.61538461538461
308355.0,6,6,412,4,272,102785.0,74.0,68.0,2,140,0.0,74.0,70.0
2474.0,17,4,344,2,150,0.0,75.0,75.0,2,194,0.0,103.0,97.0
100833909.0,17,14,1126,7,563,16666831.333333334,174.0,80.42857142857143,7,563,16667405.666666666,174.0,80.42857142857143
17681.0,6,14,4740,7,653,2623.833333333333,249.0,93.28571428571428,7,4087,2435.333333333333,1514.0,583.8571428571429
1714226.0,6,19,7533,10,1403,190469.5555555556,583.0,140.3,9,6130,182945.5,1484.0,681.1111111111111
49051.0,6,14,4740,7,653,7985.166666666667,249.0,93.28571428571428,7,4087,7061.833333333333,1514.0,583.8571428571429
880461.0,6,10,1335,6,798,176092.2,460.0,133.0,4,537,201646.0,331.0,134.25
216430.0,17,2,180,1,90,0.0,90.0,90.0,1,90,0.0,90.0,90.0
121193733.0,6,47,3102,23,1518,5160000.227272728,66.0,66.0,24,1584,5269281.956521739,66.0,66.0
0.0,6,1,66,1,66,0.0,66.0,66.0,0,0,0.0,0.0,0.0
204676.0,17,2,762,2,762,0.0,381.0,381.0,0,0,0.0,0.0,0.0
94861033.0,17,14,1126,7,563,15667444.0,174.0,80.42857142857143,7,563,15666808.666666666,174.0,80.42857142857143
307721.0,6,6,412,4,272,102573.66666666669,74.0,68.0,2,140,0.0,74.0,70.0
51840.0,6,14,4740,7,653,7890.333333333333,249.0,93.28571428571428,7,4087,8310.0,1514.0,583.8571428571429
90046972.0,17,28,13364,28,13364,3335073.037037037,501.0,477.2857142857143,0,0,0.0,0.0,0.0
2899616.0,6,11,2106,6,598,579743.6,252.0,99.66666666666669,5,1508,1573.25,1236.0,301.6
297631.0,6,6,412,4,272,99210.33333333331,74.0,68.0,2,140,0.0,74.0,70.0
108476745.0,6,32,2368,16,1140,7231754.933333334,123.0,71.25,16,1228,6566149.8,139.0,76.75
1310219.0,6,4,264,2,132,0.0,66.0,66.0,2,132,0.0,66.0,66.0
2889.0,17,2,224,1,76,0.0,76.0,76.0,1,148,0.0,148.0,148.0
2443.0,17,4,344,2,150,0.0,75.0,75.0,2,194,0.0,103.0,97.0
869296.0,6,11,2644,7,743,144882.66666666666,339.0,106.14285714285714,4,1901,198923.3333333333,1514.0,475.25
209500.0,17,2,180,1,90,0.0,90.0,90.0,1,90,0.0,90.0,90.0
2797812.0,6,2,132,1,66,0.0,66.0,66.0,1,66,0.0,66.0,66.0
12534.0,6,10,1066,5,490,2961.75,218.0,98.0,5,576,2548.75,304.0,115.2
91777577.0,6,167,18828,84,5766,1105753.939759036,140.0,68.64285714285714,83,13062,1106802.3414634147,284.0,157.3734939759036
116456561.0,6,36,2596,18,1248,6850385.94117647,123.0,69.33333333333333,18,1348,6250230.529411765,139.0,74.88888888888889
108108595.0,17,5,955,5,955,27027148.75,191.0,191.0,0,0,0.0,0.0,0.0
106731513.0,6,28,1860,14,966,8193434.923076923,123.0,69.0,14,894,8193515.0,123.0,63.85714285714285
207210.0,6,3,426,2,280,0.0,214.0,140.0,1,146,0.0,146.0,146.0
299115.0,6,6,412,4,272,99705.0,74.0,68.0,2,140,0.0,74.0,70.0
3168761.0,6,18,1618,9,1044,358320.25,315.0,116.0,9,574,358288.25,78.0,63.77777777777778
2596092.0,6,2,132,1,66,0.0,66.0,66.0,1,66,0.0,66.0,66.0
1737175.0,6,20,7599,11,1469,173717.5,583.0,133.54545454545453,9,6130,185359.125,1484.0,681.1111111111111
105139125.0,17,14,864,7,432,17501322.0,174.0,61.71428571428572,7,432,17500199.333333332,174.0,61.71428571428572
366736.0,6,10,1221,6,636,73347.2,298.0,106.0,4,585,121308.66666666669,379.0,146.25
10495199.0,6,7,478,4,272,3451733.333333333,74.0,68.0,3,206,5177479.0,74.0,68.66666666666667
98977230.0,6,29,2052,15,1089,7053941.214285715,123.0,72.6,14,963,7596558.307692308,123.0,68.78571428571429
120123390.0,6,13,2020,9,1204,15015423.75,188.0,133.77777777777777,4,816,30030307.666666668,204.0,204.0
209468.0,17,2,180,1,90,0.0,90.0,90.0,1,90,0.0,90.0,90.0
2589016.0,6,25,7573,14,3735,199155.0769230769,1514.0,266.7857142857143,11,3838,232681.5,1514.0,348.90909090909093
59449.0,6,10,2032,5,524,14638.75,252.0,104.8,5,1508,14325.25,1236.0,301.6
13938817.0,17,6,2052,6,2052,2787763.4,342.0,342.0,0,0,0.0,0.0,0.0
120053986.0,17,28,13364,28,13364,4446443.925925926,501.0,477.2857142857143,0,0,0.0,0.0,0.0
120009917.0,17,15,1169,8,606,17144273.85714286,174.0,75.75,7,563,17388793.666666668,174.0,80.42857142857143
318244.0,17,4,1400,4,1400,106081.33333333331,350.0,350.0,0,0,0.0,0.0,0.0
155460.0,6,3,337,2,214,0.0,160.0,107.0,1,123,0.0,123.0,123.0
420.0,17,2,164,1,82,0.0,82.0,82.0,1,82,0.0,82.0,82.0
2271.0,17,4,344,2,150,0.0,75.0,75.0,2,194,0.0,103.0,97.0
301030.0,6,10,1221,6,636,60206.0,298.0,106.0,4,585,94965.33333333331,379.0,146.25
119557899.0,6,232,26216,116,18264,1037762.591304348,284.0,157.44827586206895,116,7952,1037762.2434782608,140.0,68.55172413793103
108107570.0,17,5,955,5,955,27026892.5,191.0,191.0,0,0,0.0,0.0,0.0
153384.0,17,2,180,1,90,0.0,90.0,90.0,1,90,0.0,90.0,90.0
23625.0,6,14,4740,7,653,3573.6666666666665,249.0,93.28571428571428,7,4087,3536.1666666666665,1514.0,583.8571428571429
300209.0,6,6,412,4,272,100069.66666666669,74.0,68.0,2,140,0.0,74.0,70.0
155406.0,6,3,337,2,214,0.0,160.0,107.0,1,123,0.0,123.0,123.0
144760.0,17,2,180,1,70,0.0,70.0,70.0,1,110,0.0,110.0,110.0
100091774.0,17,14,864,7,432,16671444.5,174.0,61.71428571428572,7,432,16666802.0,174.0,61.71428571428572
303631.0,6,2,132,1,66,0.0,66.0,66.0,1,66,0.0,66.0,66.0
2793344.0,6,2,132,1,66,0.0,66.0,66.0,1,66,0.0,66.0,66.0
11314354.0,17,8,1371,4,306,3720542.3333333335,89.0,76.5,4,1065,3720558.6666666665,443.0,266.25
1581342.0,6,20,7599,11,1469,158134.2,583.0,133.54545454545453,9,6130,166039.0,1484.0,681.1111111111111
207988.0,6,3,426,2,280,0.0,214.0,140.0,1,146,0.0,146.0,146.0
293.0,17,2,168,1,76,0.0,76.0,76.0,1,92,0.0,92.0,92.0
18911.0,17,2,582,1,83,0.0,83.0,83.0,1,499,0.0,499.0,499.0
29986.0,6,12,1393,6,796,5826.2,271.0,132.66666666666666,6,597,4782.4,259.0,99.5
47417.0,6,14,4740,7,653,6512.666666666667,249.0,93.28571428571428,7,4087,7670.833333333333,1514.0,583.8571428571429
330.0,17,2,166,1,75,0.0,75.0,75.0,1,91,0.0,91.0,91.0
137787.0,17,2,192,1,88,0.0,88.0,88.0,1,104,0.0,104.0,104.0
29597.0,6,14,4740,7,653,3680.8333333333335,249.0,93.28571428571428,7,4087,4678.333333333333,1514.0,583.8571428571429
934821.0,6,12,1373,7,714,155803.5,298.0,102.0,5,659,229396.25,379.0,131.8
233866.0,6,3,337,2,214,0.0,160.0,107.0,1,123,0.0,123.0,123.0
2060307.0,6,19,6869,10,1501,228923.0,408.0,150.1,9,5368,209276.25,1514.0,596.4444444444445
28386.0,6,14,4740,7,653,4453.5,249.0,93.28571428571428,7,4087,4587.0,1514.0,583.8571428571429
52282.0,6,12,1320,7,789,8713.666666666666,253.0,112.71428571428572,5,531,11948.0,259.0,106.2
1307797.0,6,3,198,2,132,0.0,66.0,66.0,1,66,0.0,66.0,66.0
318926.0,17,4,571,2,148,0.0,74.0,74.0,2,423,0.0,276.0,211.5
20867.0,6,20,7606,11,978,2086.7,310.0,88.9090909090909,9,6628,2361.25,1514.0,736.4444444444445
2846470.0,6,3,204,2,136,0.0,70.0,68.0,1,68,0.0,68.0,68.0
2346.0,17,4,344,2,150,0.0,75.0,75.0,2,194,0.0,103.0,97.0
120000556.0,6,291,47360,145,9940,829808.0694444445,214.0,68.55172413793103,146,37420,823548.6965517241,1514.0,256.3013698630137
107448654.0,6,182,20534,91,14220,1191481.7777777778,284.0,156.26373626373626,91,6314,1191481.2,140.0,69.38461538461539
108100252.0,17,5,955,5,955,27025063.0,191.0,191.0,0,0,0.0,0.0,0.0
323515.0,17,4,1400,4,1400,107838.33333333331,350.0,350.0,0,0,0.0,0.0,0.0
1089743.0,6,13,1386,7,789,181623.8333333333,253.0,112.71428571428572,6,597,217122.0,259.0,99.5
273693.0,6,12,1373,7,714,45615.5,298.0,102.0,5,659,64152.75,379.0,131.8
40608.0,6,10,2032,5,524,9470.5,252.0,104.8,5,1508,9809.0,1236.0,301.6
4598.0,17,2,602,1,72,0.0,72.0,72.0,1,530,0.0,530.0,530.0
198202.0,17,2,180,1,90,0.0,90.0,90.0,1,90,0.0,90.0,90.0
236190.0,17,2,180,1,90,0.0,90.0,90.0,1,90,0.0,90.0,90.0
143865.0,17,2,180,1,90,0.0,90.0,90.0,1,90,0.0,90.0,90.0
316355.0,17,4,1400,4,1400,105451.66666666669,350.0,350.0,0,0,0.0,0.0,0.0
14710.0,17,2,180,1,90,0.0,90.0,90.0,1,90,0.0,90.0,90.0
25895.0,6,14,4740,7,653,4191.5,249.0,93.28571428571428,7,4087,3818.8333333333335,1514.0,583.8571428571429
90047101.0,17,28,13364,28,13364,3335077.814814815,501.0,477.2857142857143,0,0,0.0,0.0,0.0
297297.0,6,6,412,4,272,99099.0,74.0,68.0,2,140,0.0,74.0,70.0
14521.0,6,10,1067,5,536,3397.0,264.0,107.2,5,531,3205.5,259.0,106.2
10482792.0,6,7,478,4,272,3448937.6666666665,74.0,68.0,3,206,5173277.5,74.0,68.66666666666667
14942.0,17,2,180,1,90,0.0,90.0,90.0,1,90,0.0,90.0,90.0
2085.0,17,4,344,2,150,0.0,75.0,75.0,2,194,0.0,103.0,97.0
0.0,17,1,381,1,381,0.0,381.0,381.0,0,0,0.0,0.0,0.0
110305564.0,6,32,2220,16,1149,7339321.866666666,123.0,71.8125,16,1071,7339306.0,123.0,66.9375
245199.0,6,3,426,2,280,0.0,214.0,140.0,1,146,0.0,146.0,146.0
368858.0,6,6,412,4,272,122952.66666666669,74.0,68.0,2,140,0.0,74.0,70.0
121263.0,6,3,337,2,214,0.0,160.0,107.0,1,123,0.0,123.0,123.0
4179.0,17,2,602,1,72,0.0,72.0,72.0,1,530,0.0,530.0,530.0
27669.0,6,10,2032,5,524,6693.0,252.0,104.8,5,1508,6421.0,1236.0,301.6
40517.0,6,14,4740,7,653,6012.5,249.0,93.28571428571428,7,4087,5535.333333333333,1514.0,583.8571428571429
1478.0,17,2,176,1,80,0.0,80.0,80.0,1,96,0.0,96.0,96.0
497055.0,6,5,336,2,134,0.0,68.0,67.0,3,202,192882.5,70.0,67.33333333333333
306970.0,6,6,412,4,272,102323.33333333331,74.0,68.0,2,140,0.0,74.0,70.0
205623.0,17,2,180,1,90,0.0,90.0,90.0,1,90,0.0,90.0,90.0
847.0,17,5,550,5,550,211.75,110.0,110.0,0,0,0.0,0.0,0.0
234368.0,6,3,373,2,238,0.0,172.0,119.0,1,135,0.0,135.0,135.0
114353536.0,6,30,2106,15,1017,8168079.0,123.0,67.8,15,1089,7454938.857142857,123.0,72.6
250997.00000000003,17,4,6056,4,6056,83665.66666666667,1514.0,1514.0,0,0,0.0,0.0,0.0
120026901.0,17,28,13364,28,13364,4445440.777777778,501.0,477.2857142857143,0,0,0.0,0.0,0.0
107618526.0,6,43,2838,22,1452,5110001.857142857,66.0,66.0,21,1386,5150445.15,66.0,66.0
284858.0,17,2,363,1,79,0.0,79.0,79.0,1,284,0.0,284.0,284.0
110267773.0,6,30,1974,15,1026,7860859.928571428,123.0,68.4,15,948,7860860.214285715,123.0,63.2
120136398.0,6,228,25628,114,7820,1055913.4955752213,140.0,68.59649122807018,114,17808,1046769.9115044248,284.0,156.21052631578948
120040950.0,17,29,13785,29,13785,4287176.785714285,501.0,475.3448275862069,0,0,0.0,0.0,0.0
90281671.0,6,12,1832,8,1016,12897381.57142857,188.0,127.0,4,816,30039045.666666668,204.0,204.0
37798.0,6,10,2032,5,524,9224.25,252.0,104.8,5,1508,8841.5,1236.0,301.6
85455.0,6,14,4740,7,653,11511.333333333334,249.0,93.28571428571428,7,4087,11903.166666666666,1514.0,583.8571428571429
2799478.0,6,2,132,1,66,0.0,66.0,66.0,1,66,0.0,66.0,66.0
82.0,17,2,762,2,762,0.0,381.0,381.0,0,0,0.0,0.0,0.0
9061.0,17,2,762,2,762,0.0,381.0,381.0,0,0,0.0,0.0,0.0
339.0,17,2,267,1,83,0.0,83.0,83.0,1,184,0.0,184.0,184.0
359.0,17,2,166,1,75,0.0,75.0,75.0,1,91,0.0,91.0,91.0
90055438.0,17,28,13364,28,13364,3335386.592592593,501.0,477.2857142857143,0,0,0.0,0.0,0.0
90041907.0,17,28,13364,28,13364,3334885.4444444445,501.0,477.2857142857143,0,0,0.0,0.0,0.0
228238.0,17,2,180,1,90,0.0,90.0,90.0,1,90,0.0,90.0,90.0
266977.0,6,10,1221,6,636,53395.4,298.0,106.0,4,585,83480.33333333333,379.0,146.25
144962.0,17,2,180,1,70,0.0,70.0,70.0,1,110,0.0,110.0,110.0
11571.0,6,11,1133,6,602,2064.0,264.0,100.33333333333331,5,531,2221.75,259.0,106.2
284358.0,17,2,363,1,79,0.0,79.0,79.0,1,284,0.0,284.0,284.0
121186.0,6,3,337,2,214,0.0,160.0,107.0,1,123,0.0,123.0,123.0
1655958.0,6,4,276,2,128,0.0,74.0,64.0,2,148,0.0,74.0,74.0
364.0,17,2,166,1,75,0.0,75.0,75.0,1,91,0.0,91.0,91.0
114456551.0,6,39,2902,20,1531,6024029.0,139.0,76.55,19,1371,6346670.5,123.0,72.15789473684211
45112.0,6,14,4740,7,653,7020.666666666667,249.0,93.28571428571428,7,4087,7228.833333333333,1514.0,583.8571428571429
106979.0,17,2,700,2,700,0.0,350.0,350.0,0,0,0.0,0.0,0.0
10915465.0,6,7,478,3,206,5389926.0,74.0,68.66666666666667,4,272,3593218.6666666665,74.0,68.0
7660.0,17,2,582,1,83,0.0,83.0,83.0,1,499,0.0,499.0,499.0
326.0,17,2,208,1,72,0.0,72.0,72.0,1,136,0.0,136.0,136.0
232910.0,6,3,373,2,238,0.0,172.0,119.0,1,135,0.0,135.0,135.0
33516.0,6,10,2032,5,524,7089.75,252.0,104.8,5,1508,7581.75,1236.0,301.6
144917.0,17,2,180,1,70,0.0,70.0,70.0,1,110,0.0,110.0,110.0
2311.0,17,4,344,2,150,0.0,75.0,75.0,2,194,0.0,103.0,97.0
90018218.0,17,28,13364,28,13364,3334008.074074074,501.0,477.2857142857143,0,0,0.0,0.0,0.0
62745.99999999999,6,14,4740,7,653,9566.666666666666,249.0,93.28571428571428,7,4087,10095.166666666666,1514.0,583.8571428571429
623123.0,17,4,629,3,234,74057.5,78.0,78.0,1,395,0.0,395.0,395.0
26857.0,6,14,4740,7,653,4352.0,249.0,93.28571428571428,7,4087,3514.5,1514.0,583.8571428571429
35020.0,6,14,4740,7,653,5713.0,249.0,93.28571428571428,7,4087,5664.0,1514.0,583.8571428571429
1822056.0,6,2,132,1,66,0.0,66.0,66.0,1,66,0.0,66.0,66.0
1984.0,17,4,344,2,150,0.0,75.0,75.0,2,194,0.0,103.0,97.0
2311.0,17,4,344,2,150,0.0,75.0,75.0,2,194,0.0,103.0,97.0
95222.0,6,14,4740,7,653,15746.833333333334,249.0,93.28571428571428,7,4087,14058.166666666666,1514.0,583.8571428571429
108108769.0,17,5,1005,5,1005,27027192.25,201.0,201.0,0,0,0.0,0.0,0.0
2071.0,17,4,344,2,150,0.0,75.0,75.0,2,194,0.0,103.0,97.0
124011202.0,17,15,907,8,475,17715886.0,174.0,59.375,7,432,17299314.5,174.0,61.71428571428572
119490185.0,6,311,37026,156,10592,770826.6451612903,140.0,67.8974358974359,155,26434,770626.987012987,390.0,170.54193548387096
146814.0,6,3,337,2,214,0.0,160.0,107.0,1,123,0.0,123.0,123.0
204513.0,17,2,180,1,90,0.0,90.0,90.0,1,90,0.0,90.0,90.0
21442.0,6,14,4740,7,653,3302.333333333333,249.0,93.28571428571428,7,4087,3438.333333333333,1514.0,583.8571428571429
90333430.0,6,18,1502,9,852,11281775.125,256.0,94.66666666666669,9,650,11290149.125,95.0,72.22222222222223
314.0,17,2,164,1,82,0.0,82.0,82.0,1,82,0.0,82.0,82.0
120011149.0,6,34,2413,17,1288,7487196.6875,139.0,75.76470588235294,17,1125,7487199.0,123.0,66.17647058823529
1711490.0,6,55,40791,25,1812,71312.08333333333,208.0,72.48,30,38979,58728.41379310345,1514.0,1299.3
103266200.0,6,190,21532,95,15040,1096286.170212766,374.0,158.31578947368422,95,6492,1096286.9468085107,140.0,68.33684210526316
205660.0,17,2,180,1,90,0.0,90.0,90.0,1,90,0.0,90.0,90.0
228333.0,17,2,180,1,90,0.0,90.0,90.0,1,90,0.0,90.0,90.0
90528907.0,6,15,2444,8,1016,12932701.0,188.0,127.0,7,1428,15059388.166666666,204.0,204.0
1703421.0,6,22,6443,11,1463,170342.1,357.0,133.0,11,4980,139621.5,1510.0,452.7272727272728
0.0,6,1,54,1,54,0.0,54.0,54.0,0,0,0.0,0.0,0.0
106680.0,17,4,1400,4,1400,35560.0,350.0,350.0,0,0,0.0,0.0,0.0
108104842.0,17,5,955,5,955,27026210.5,191.0,191.0,0,0,0.0,0.0,0.0
98000881.0,17,13,1083,7,563,16333480.166666666,174.0,80.42857142857143,6,520,15600819.2,174.0,86.66666666666667
29368.0,6,11,2098,6,590,5659.2,252.0,98.33333333333331,5,1508,5515.5,1236.0,301.6
158850.0,6,3,337,2,214,0.0,160.0,107.0,1,123,0.0,123.0,123.0
105802.0,17,2,700,2,700,0.0,350.0,350.0,0,0,0.0,0.0,0.0
91429772.0,6,22,1680,12,935,8309953.454545454,95.0,77.91666666666667,10,745,10158351.0,95.0,74.5
103090111.0,6,30,2106,15,1089,7348165.357142857,123.0,72.6,15,1017,7348166.642857143,123.0,67.8
90013485.0,17,27,12943,27,12943,3462057.1153846155,501.0,479.3703703703704,0,0,0.0,0.0,0.0
34540.0,6,14,4740,7,653,5439.5,249.0,93.28571428571428,7,4087,5539.666666666667,1514.0,583.8571428571429
108110769.0,17,5,955,5,955,27027692.25,191.0,191.0,0,0,0.0,0.0,0.0
53987.0,6,14,4740,7,653,8876.333333333334,249.0,93.28571428571428,7,4087,8526.666666666666,1514.0,583.8571428571429
312454.0,6,6,412,4,272,104151.33333333331,74.0,68.0,2,140,0.0,74.0,70.0
1755274.0,6,23,6508,12,1529,159570.36363636365,357.0,127.41666666666669,11,4979,144385.2,1510.0,452.6363636363636
120140307.0,6,269,30442,135,9206,896569.4552238806,140.0,68.19259259259259,134,21236,895990.8270676691,284.0,158.47761194029852
70747.0,17,2,608,1,75,0.0,75.0,75.0,1,533,0.0,533.0,533.0
90041601.0,17,28,13364,28,13364,3334874.111111111,501.0,477.2857142857143,0,0,0.0,0.0,0.0
99330433.0,17,12,778,6,389,19800162.4,174.0,64.83333333333333,6,389,19800680.8,174.0,64.83333333333333
90052909.0,17,27,12943,27,12943,3463573.423076923,501.0,479.3703703703704,0,0,0.0,0.0,0.0
1226970.0,6,4,492,2,280,0.0,214.0,140.0,2,212,0.0,146.0,106.0
108106280.0,17,5,955,5,955,27026570.0,191.0,191.0,0,0,0.0,0.0,0.0
2596751.0,6,2,132,1,66,0.0,66.0,66.0,1,66,0.0,66.0,66.0
232340.0,6,3,337,2,214,0.0,160.0,107.0,1,123,0.0,123.0,123.0
135133535.0,17,6,1146,6,1146,27026707.0,191.0,191.0,0,0,0.0,0.0,0.0
112731077.0,6,47,3102,24,1584,4901338.608695652,66.0,66.0,23,1518,5111999.954545454,66.0,66.0
121000927.0,17,14,864,7,432,19891524.666666668,174.0,61.71428571428572,7,432,20140182.0,174.0,61.71428571428572
5624701.0,6,4,270,2,134,0.0,68.0,67.0,2,136,0.0,70.0,68.0
1308478.0,6,4,264,2,132,0.0,66.0,66.0,2,132,0.0,66.0,66.0
1019666.0,6,11,1134,6,558,203933.2,220.0,93.0,5,576,254468.25,304.0,115.2
74925.0,6,14,4740,7,653,12113.5,249.0,93.28571428571428,7,4087,12258.5,1514.0,583.8571428571429
108105124.0,17,5,955,5,955,27026281.0,191.0,191.0,0,0,0.0,0.0,0.0
334.0,17,2,166,1,75,0.0,75.0,75.0,1,91,0.0,91.0,91.0
108097960.0,17,5,955,5,955,27024490.0,191.0,191.0,0,0,0.0,0.0,0.0
39243.0,6,10,1065,5,534,9113.25,262.0,106.8,5,531,9234.0,259.0,106.2
1310584.0,6,4,264,2,132,0.0,66.0,66.0,2,132,0.0,66.0,66.0
2215858.0,6,25,7610,13,2516,184493.0,1034.0,193.53846153846155,12,5094,173653.36363636365,1510.0,424.5
459834.0,17,2,363,1,75,0.0,75.0,75.0,1,288,0.0,288.0,288.0
10904407.0,6,7,478,3,206,5379943.5,74.0,68.66666666666667,4,272,3586549.6666666665,74.0,68.0
100794755.0,17,13,821,7,432,16666803.333333334,174.0,61.71428571428572,6,389,20004276.0,174.0,64.83333333333333
153345.0,17,2,180,1,90,0.0,90.0,90.0,1,90,0.0,90.0,90.0
113401024.0,6,48,3168,24,1584,4930479.304347826,66.0,66.0,24,1584,4920338.304347826,66.0,66.0
111321124.0,17,14,864,7,432,18553520.666666668,174.0,61.71428571428572,7,432,18458164.33333333,174.0,61.71428571428572
379011.0,6,3,204,1,68,0.0,68.0,68.0,2,136,0.0,70.0,68.0
442.0,17,2,166,1,75,0.0,75.0,75.0,1,91,0.0,91.0,91.0
117113670.0,6,48,3168,24,1584,5091898.695652174,66.0,66.0,24,1584,5078415.304347826,66.0,66.0
79455.0,6,14,4740,7,653,13085.0,249.0,93.28571428571428,7,4087,12502.833333333334,1514.0,583.8571428571429
0.0,17,1,44,1,44,0.0,44.0,44.0,0,0,0.0,0.0,0.0
154389.0,17,2,180,1,90,0.0,90.0,90.0,1,90,0.0,90.0,90.0
317.0,17,2,174,1,79,0.0,79.0,79.0,1,95,0.0,95.0,95.0
398876.0,6,3,1604,2,851,0.0,785.0,425.5,1,753,0.0,753.0,753.0
204441.0,17,2,762,2,762,0.0,381.0,381.0,0,0,0.0,0.0,0.0
0.0,17,1,90,1,90,0.0,90.0,90.0,0,0,0.0,0.0,0.0
113254953.0,6,46,3036,23,1518,5135437.636363637,66.0,66.0,23,1518,5135443.318181818,66.0,66.0
307161.0,6,6,412,4,272,102387.0,74.0,68.0,2,140,0.0,74.0,70.0
2042.0,17,4,344,2,150,0.0,75.0,75.0,2,194,0.0,103.0,97.0
21982.0,6,10,2032,5,524,5211.5,252.0,104.8,5,1508,5216.75,1236.0,301.6
323.0,17,2,174,1,79,0.0,79.0,79.0,1,95,0.0,95.0,95.0
105007418.0,17,15,5130,15,5130,7500529.857142857,342.0,342.0,0,0,0.0,0.0,0.0
90774497.0,6,19,1436,10,745,10080219.333333334,95.0,74.5,9,691,11345588.375,95.0,76.77777777777777
10455382.0,6,7,478,4,272,3439557.6666666665,74.0,68.0,3,206,5159228.5,74.0,68.66666666666667
90217951.0,6,16,1192,8,596,12853524.285714284,95.0,74.5,8,596,12859049.0,95.0,74.5
58209.0,6,14,4740,7,653,8764.333333333334,249.0,93.28571428571428,7,4087,9567.833333333334,1514.0,583.8571428571429
51734.0,17,2,180,1,90,0.0,90.0,90.0,1,90,0.0,90.0,90.0
118787748.0,6,36,2602,19,1408,6587314.277777778,139.0,74.10526315789474,17,1194,7410743.25,123.0,70.23529411764706
200.0,17,2,762,2,762,0.0,381.0,381.0,0,0,0.0,0.0,0.0
29549.0,6,10,2032,5,524,7017.25,252.0,104.8,5,1508,6992.75,1236.0,301.6
103101.0,17,2,286,2,286,0.0,143.0,143.0,0,0,0.0,0.0,0.0
99447.0,17,2,762,2,762,0.0,381.0,381.0,0,0,0.0,0.0,0.0
46099.0,6,11,2098,6,590,8934.2,252.0,98.33333333333331,5,1508,11236.5,1236.0,301.6
450053.0,6,10,1221,6,636,90010.6,298.0,106.0,4,585,144583.33333333334,379.0,146.25
90021680.0,17,28,13364,28,13364,3334136.296296296,501.0,477.2857142857143,0,0,0.0,0.0,0.0
15689786.0,17,12,5004,12,5004,1426344.181818182,453.0,417.0,0,0,0.0,0.0,0.0
218335.0,6,3,426,2,280,0.0,214.0,140.0,1,146,0.0,146.0,146.0
120238998.0,6,292,33412,146,9944,823489.3586206896,140.0,68.10958904109589,146,23468,829126.124137931,374.0,160.73972602739727
34183.0,6,11,2098,6,590,6397.8,252.0,98.33333333333331,5,1508,8265.25,1236.0,301.6
28208.0,6,14,4740,7,653,3835.6666666666665,249.0,93.28571428571428,7,4087,4569.166666666667,1514.0,583.8571428571429
11371.0,17,2,582,1,83,0.0,83.0,83.0,1,499,0.0,499.0,499.0
5623699.0,6,5,336,2,134,0.0,68.0,67.0,3,202,1526666.0,70.0,67.33333333333333
13532.0,6,14,4740,7,653,2077.833333333333,249.0,93.28571428571428,7,4087,2119.0,1514.0,583.8571428571429
109121536.0,17,14,864,7,432,18167698.83333333,174.0,61.71428571428572,7,432,18166825.666666668,174.0,61.71428571428572
86058.0,6,14,4740,7,653,13712.0,249.0,93.28571428571428,7,4087,14205.166666666666,1514.0,583.8571428571429
331.0,17,2,208,1,72,0.0,72.0,72.0,1,136,0.0,136.0,136.0
92857553.0,6,40,2640,20,1320,4887239.631578947,66.0,66.0,20,1320,4875850.368421053,66.0,66.0
415.0,17,2,410,1,78,0.0,78.0,78.0,1,332,0.0,332.0,332.0
1811.0,17,4,344,2,150,0.0,75.0,75.0,2,194,0.0,103.0,97.0
100010272.0,17,11,604,6,389,19988785.4,174.0,64.83333333333333,5,215,20000977.0,43.0,43.0
103013.0,17,2,286,2,286,0.0,143.0,143.0,0,0,0.0,0.0,0.0
103108851.0,6,41,2706,21,1386,5155442.55,66.0,66.0,20,1320,5358414.47368421,66.0,66.0
333167.0,6,3,1604,2,851,0.0,785.0,425.5,1,753,0.0,753.0,753.0
242531.0,6,3,426,2,280,0.0,214.0,140.0,1,146,0.0,146.0,146.0
29985.0,6,10,1066,5,490,5441.5,218.0,98.0,5,576,7294.5,304.0,115.2
108090944.0,17,5,1005,5,1005,27022736.0,201.0,201.0,0,0,0.0,0.0,0.0
18758.0,6,11,2098,6,590,3208.0,252.0,98.33333333333331,5,1508,3994.75,1236.0,301.6
1570855.0,6,4,276,2,128,0.0,74.0,64.0,2,148,0.0,74.0,74.0
275470.0,17,2,238,1,74,0.0,74.0,74.0,1,164,0.0,164.0,164.0
90210485.0,6,19,1436,9,691,11244618.25,95.0,76.77777777777777,10,745,9999367.222222222,95.0,74.5
309772.0,17,4,1400,4,1400,103257.33333333331,350.0,350.0,0,0,0.0,0.0,0.0
2069.0,17,4,344,2,150,0.0,75.0,75.0,2,194,0.0,103.0,97.0
90049501.0,17,28,13364,28,13364,3335166.703703704,501.0,477.2857142857143,0,0,0.0,0.0,0.0
2433.0,17,4,344,2,150,0.0,75.0,75.0,2,194,0.0,103.0,97.0
46882.0,6,10,2032,5,524,11492.25,252.0,104.8,5,1508,8780.75,1236.0,301.6
842.0,17,5,550,5,550,210.5,110.0,110.0,0,0,0.0,0.0,0.0
130394.0,6,13,1394,7,797,21732.33333333333,253.0,113.85714285714286,6,597,23646.0,259.0,99.5
0.0,6,1,66,1,66,0.0,66.0,66.0,0,0,0.0,0.0,0.0
108483829.0,6,32,2236,16,1165,7232255.266666667,139.0,72.8125,16,1071,7217836.6,123.0,66.9375
108114448.0,17,5,955,5,955,27028612.0,191.0,191.0,0,0,0.0,0.0,0.0
34433.0,6,14,4740,7,653,5448.5,249.0,93.28571428571428,7,4087,5600.5,1514.0,583.8571428571429
90301924.0,6,16,1192,8,596,12893142.714285716,95.0,74.5,8,596,12899415.142857144,95.0,74.5
15034621.0,17,6,2718,6,2718,3006924.2,453.0,453.0,0,0,0.0,0.0,0.0
110133988.0,6,28,1860,14,966,8455232.307692308,123.0,69.0,14,894,8455240.153846154,123.0,63.85714285714285
2925572.0,6,3,1604,1,753,0.0,753.0,753.0,2,851,0.0,785.0,425.5
103108.0,17,2,286,2,286,0.0,143.0,143.0,0,0,0.0,0.0,0.0
92735789.0,6,173,19690,87,13792,1078323.1279069767,374.0,158.5287356321839,86,5898,1078791.623529412,140.0,68.5813953488372
22052.0,6,14,4740,7,653,2708.0,249.0,93.28571428571428,7,4087,3537.5,1514.0,583.8571428571429
90016675.0,17,28,13364,28,13364,3333950.925925926,501.0,477.2857142857143,0,0,0.0,0.0,0.0
41524.0,6,14,4740,7,653,6805.333333333333,249.0,93.28571428571428,7,4087,5448.166666666667,1514.0,583.8571428571429
9033.0,17,2,582,1,83,0.0,83.0,83.0,1,499,0.0,499.0,499.0
104967.0,17,2,286,2,286,0.0,143.0,143.0,0,0,0.0,0.0,0.0
3006927.0,6,11,2106,6,598,601210.6,252.0,99.66666666666669,5,1508,2919.5,1236.0,301.6
234253.0,6,3,337,2,214,0.0,160.0,107.0,1,123,0.0,123.0,123.0
114025595.0,6,48,3168,24,1584,4957634.565217392,66.0,66.0,24,1584,4945660.521739131,66.0,66.0
205794.0,17,2,762,2,762,0.0,381.0,381.0,0,0,0.0,0.0,0.0
23371.0,6,10,2032,5,524,5361.0,252.0,104.8,5,1508,5492.75,1236.0,301.6
28240.0,6,14,4740,7,653,4533.166666666667,249.0,93.28571428571428,7,4087,4161.666666666667,1514.0,583.8571428571429
442556.0,6,11,1021,6,444,59763.8,162.0,74.0,5,577,74483.5,349.0,115.4
121005325.0,17,15,907,8,475,17286475.0,174.0,59.375,7,432,16833497.0,174.0,61.71428571428572
205834.0,6,3,426,2,280,0.0,214.0,140.0,1,146,0.0,146.0,146.0
105260599.0,6,28,1876,14,982,8080364.615384615,139.0,70.14285714285714,14,894,8080364.538461538,123.0,63.85714285714285
13975937.0,17,6,2052,6,2052,2795187.4,342.0,342.0,0,0,0.0,0.0,0.0
23624.0,6,10,2032,5,524,5675.0,252.0,104.8,5,1508,5618.75,1236.0,301.6
6251.0,17,4,823,2,163,0.0,89.0,81.5,2,660,0.0,443.0,330.0
306829.0,6,6,412,4,272,102276.33333333331,74.0,68.0,2,140,0.0,74.0,70.0
93328.0,17,2,762,2,762,0.0,381.0,381.0,0,0,0.0,0.0,0.0
106233.0,17,2,700,2,700,0.0,350.0,350.0,0,0,0.0,0.0,0.0
922586.0,6,13,1420,7,789,152924.33333333334,253.0,112.71428571428572,6,631,183634.0,293.0,105.16666666666669
216763.0,17,2,180,1,90,0.0,90.0,90.0,1,90,0.0,90.0,90.0
261511.0,6,10,1221,6,636,52302.2,298.0,106.0,4,585,86321.0,379.0,146.25
301172.0,6,6,412,4,272,100390.66666666669,74.0,68.0,2,140,0.0,74.0,70.0
96851.0,17,2,762,2,762,0.0,381.0,381.0,0,0,0.0,0.0,0.0
196879.0,17,2,180,1,90,0.0,90.0,90.0,1,90,0.0,90.0,90.0
57255.0,6,11,2098,6,590,11254.4,252.0,98.33333333333331,5,1508,13994.0,1236.0,301.6
314613.0,6,3,202,2,128,0.0,74.0,64.0,1,74,0.0,74.0,74.0
15070466.0,17,6,2718,6,2718,3014093.2,453.0,453.0,0,0,0.0,0.0,0.0
318838.0,6,6,412,4,272,106279.33333333331,74.0,68.0,2,140,0.0,74.0,70.0
27784.0,6,14,4740,7,653,4308.666666666667,249.0,93.28571428571428,7,4087,4492.333333333333,1514.0,583.8571428571429
339754.0,6,3,1604,1,753,0.0,753.0,753.0,2,851,0.0,785.0,425.5
94007495.0,6,40,2640,20,1320,4947762.894736842,66.0,66.0,20,1320,4931521.421052632,66.0,66.0
96454.0,17,2,286,2,286,0.0,143.0,143.0,0,0,0.0,0.0,0.0
2450.0,17,4,344,2,150,0.0,75.0,75.0,2,194,0.0,103.0,97.0
115562866.0,6,30,1974,15,1026,8239842.5,123.0,68.4,15,948,8239883.071428572,123.0,63.2
107493488.0,17,14,864,7,432,17833536.0,174.0,61.71428571428572,7,432,17834945.0,174.0,61.71428571428572
135131184.0,17,6,1206,6,1206,27026236.8,201.0,201.0,0,0,0.0,0.0,0.0
24267579.0,17,3,1034,2,684,0.0,342.0,342.0,1,350,0.0,350.0,350.0
29558.0,6,11,2098,6,590,4765.6,252.0,98.33333333333331,5,1508,6888.5,1236.0,301.6
42878.0,6,14,4740,7,653,5792.5,249.0,93.28571428571428,7,4087,7000.833333333333,1514.0,583.8571428571429
26733.0,6,10,2032,5,524,6035.25,252.0,104.8,5,1508,6401.5,1236.0,301.6
224973.0,17,2,414,1,88,0.0,88.0,88.0,1,326,0.0,326.0,326.0
121232.0,6,3,337,2,214,0.0,160.0,107.0,1,123,0.0,123.0,123.0
9502.0,17,2,498,1,80,0.0,80.0,80.0,1,418,0.0,418.0,418.0
90258443.0,6,13,2036,8,1016,12894063.285714284,188.0,127.0,5,1020,22523606.0,204.0,204.0
209685.0,6,3,426,2,280,0.0,214.0,140.0,1,146,0.0,146.0,146.0
0.0,17,1,55,1,55,0.0,55.0,55.0,0,0,0.0,0.0,0.0
0.0,6,1,97,1,97,0.0,97.0,97.0,0,0,0.0,0.0,0.0
482.0,17,2,508,2,508,0.0,257.0,254.0,0,0,0.0,0.0,0.0
5627087.0,6,5,336,2,134,0.0,68.0,67.0,3,202,1527988.0,70.0,67.33333333333333
2090.0,17,4,344,2,150,0.0,75.0,75.0,2,194,0.0,103.0,97.0
31607.000000000004,6,14,4740,7,653,5147.166666666667,249.0,93.28571428571428,7,4087,4926.5,1514.0,583.8571428571429
24561.0,6,14,4740,7,653,3788.1666666666665,249.0,93.28571428571428,7,4087,3408.833333333333,1514.0,583.8571428571429
108107532.0,17,5,1005,5,1005,27026883.0,201.0,201.0,0,0,0.0,0.0,0.0
81430.0,6,14,4740,7,653,12278.833333333334,249.0,93.28571428571428,7,4087,13428.333333333334,1514.0,583.8571428571429
103130.0,17,2,286,2,286,0.0,143.0,143.0,0,0,0.0,0.0,0.0
148040.0,17,2,180,1,90,0.0,90.0,90.0,1,90,0.0,90.0,90.0
304410.0,6,6,412,4,272,101470.0,74.0,68.0,2,140,0.0,74.0,70.0
193074.0,17,2,180,1,90,0.0,90.0,90.0,1,90,0.0,90.0,90.0
37122.0,6,14,4740,7,653,4035.6666666666665,249.0,93.28571428571428,7,4087,5887.666666666667,1514.0,583.8571428571429
129247.0,6,2,132,1,66,0.0,66.0,66.0,1,66,0.0,66.0,66.0
142491.0,17,4,704,2,148,0.0,74.0,74.0,2,556,0.0,280.0,278.0
19333.0,6,10,2032,5,524,4597.25,252.0,104.8,5,1508,4593.0,1236.0,301.6
135133071.0,17,6,1206,6,1206,27026614.2,201.0,201.0,0,0,0.0,0.0,0.0
302.0,17,2,164,1,82,0.0,82.0,82.0,1,82,0.0,82.0,82.0
238076.0,6,3,337,2,214,0.0,160.0,107.0,1,123,0.0,123.0,123.0
316.0,17,2,174,1,79,0.0,79.0,79.0,1,95,0.0,95.0,95.0
14635103.0,6,20,1648,10,1016,1592627.2222222222,315.0,101.6,10,632,1592595.0,78.0,63.2
108103630.0,17,5,1005,5,1005,27025907.5,201.0,201.0,0,0,0.0,0.0,0.0
181303.0,17,2,180,1,90,0.0,90.0,90.0,1,90,0.0,90.0,90.0
311757.0,17,4,1400,4,1400,103919.0,350.0,350.0,0,0,0.0,0.0,0.0
0.0,17,1,453,1,453,0.0,453.0,453.0,0,0,0.0,0.0,0.0
153467.0,17,2,180,1,90,0.0,90.0,90.0,1,90,0.0,90.0,90.0
119583855.0,6,20,1490,10,745,13287095.0,95.0,74.5,10,745,13257373.111111112,95.0,74.5
120057818.0,17,28,13364,28,13364,4446585.851851852,501.0,477.2857142857143,0,0,0.0,0.0,0.0
90031261.0,17,27,12943,27,12943,3462740.8076923075,501.0,479.3703703703704,0,0,0.0,0.0,0.0
2288.0,17,4,344,2,150,0.0,75.0,75.0,2,194,0.0,103.0,97.0
33962.0,6,14,4740,7,653,5475.833333333333,249.0,93.28571428571428,7,4087,4908.0,1514.0,583.8571428571429
90641086.0,6,29,2200,15,1168,6474363.285714285,139.0,77.86666666666666,14,1032,6956626.615384615,123.0,73.71428571428571
2327.0,17,4,344,2,150,0.0,75.0,75.0,2,194,0.0,103.0,97.0
0.0,17,1,55,1,55,0.0,55.0,55.0,0,0,0.0,0.0,0.0
114513658.0,6,220,24884,110,17328,1048608.5596330275,284.0,157.52727272727273,110,7556,1048609.4770642202,140.0,68.69090909090909
143908.0,17,2,180,1,90,0.0,90.0,90.0,1,90,0.0,90.0,90.0
111486.0,17,2,286,2,286,0.0,143.0,143.0,0,0,0.0,0.0,0.0
44017.0,6,10,2032,5,524,10580.75,252.0,104.8,5,1508,10723.5,1236.0,301.6
0.0,6,1,66,1,66,0.0,66.0,66.0,0,0,0.0,0.0,0.0
192940.0,17,2,180,1,90,0.0,90.0,90.0,1,90,0.0,90.0,90.0
33499.0,6,14,4740,7,653,5458.833333333333,249.0,93.28571428571428,7,4087,4842.166666666667,1514.0,583.8571428571429
120051698.0,17,28,13364,28,13364,4446359.185185186,501.0,477.2857142857143,0,0,0.0,0.0,0.0
108100652.0,17,5,955,5,955,27025163.0,191.0,191.0,0,0,0.0,0.0,0.0
20457.0,6,14,4740,7,653,2911.333333333333,249.0,93.28571428571428,7,4087,3261.6666666666665,1514.0,583.8571428571429
146286.0,6,3,337,2,214,0.0,160.0,107.0,1,123,0.0,123.0,123.0
252373.0,17,4,6056,4,6056,84124.33333333333,1514.0,1514.0,0,0,0.0,0.0,0.0
2452.0,17,6,1230,3,234,1058.5,78.0,78.0,3,996,1016.5,332.0,332.0
35991.0,6,14,4740,7,653,5874.5,249.0,93.28571428571428,7,4087,5865.666666666667,1514.0,583.8571428571429
107880.0,17,2,286,2,286,0.0,143.0,143.0,0,0,0.0,0.0,0.0
317.0,17,2,166,1,75,0.0,75.0,75.0,1,91,0.0,91.0,91.0
52312.0,6,14,4740,7,653,8282.166666666666,249.0,93.28571428571428,7,4087,6425.5,1514.0,583.8571428571429
90056345.0,17,28,13364,28,13364,3335420.185185185,501.0,477.2857142857143,0,0,0.0,0.0,0.0
2249787.0,6,3,1777,2,951,0.0,885.0,475.5,1,826,0.0,826.0,826.0
47488.0,6,14,4740,7,653,7418.666666666667,249.0,93.28571428571428,7,4087,7285.333333333333,1514.0,583.8571428571429
16605.0,6,13,1459,7,862,2584.1666666666665,271.0,123.14285714285714,6,597,2682.0,259.0,99.5
97378925.0,6,28,1992,14,1029,7474089.0,123.0,73.5,14,963,7474092.692307692,123.0,68.78571428571429
747665.0,6,10,1065,5,534,186562.75,262.0,106.8,5,531,186357.75,259.0,106.2
101179.0,17,2,762,2,762,0.0,381.0,381.0,0,0,0.0,0.0,0.0
315142.0,6,3,202,2,128,0.0,74.0,64.0,1,74,0.0,74.0,74.0
44502.0,6,10,2032,5,524,10898.0,252.0,104.8,5,1508,10423.75,1236.0,301.6
10929630.0,6,8,544,4,272,3597807.6666666665,74.0,68.0,4,272,3597730.333333333,74.0,68.0
17727.0,6,11,1132,6,556,3545.4,218.0,92.66666666666669,5,576,3384.5,304.0,115.2
206012.0,17,2,180,1,90,0.0,90.0,90.0,1,90,0.0,90.0,90.0
108099451.0,17,5,1005,5,1005,27024862.75,201.0,201.0,0,0,0.0,0.0,0.0
32375.0,6,14,4740,7,653,4840.0,249.0,93.28571428571428,7,4087,5056.0,1514.0,583.8571428571429
246262.0,6,3,337,2,214,0.0,160.0,107.0,1,123,0.0,123.0,123.0
250132.00000000003,6,3,337,2,214,0.0,160.0,107.0,1,123,0.0,123.0,123.0
50262.0,6,14,4740,7,653,7378.0,249.0,93.28571428571428,7,4087,8029.833333333333,1514.0,583.8571428571429
113251976.0,6,46,3036,23,1518,5135442.5,66.0,66.0,23,1518,5135438.818181818,66.0,66.0
330.0,17,2,160,1,80,0.0,80.0,80.0,1,80,0.0,80.0,80.0
90255824.0,6,13,2036,8,1016,12893689.142857144,188.0,127.0,5,1020,22522223.75,204.0,204.0
28024.0,6,14,4740,7,653,4562.166666666667,249.0,93.28571428571428,7,4087,4236.166666666667,1514.0,583.8571428571429
90230049.0,6,45,3784,25,2083,3759585.375,139.0,83.32,20,1701,4737565.0,123.0,85.05
4528.0,17,2,180,1,90,0.0,90.0,90.0,1,90,0.0,90.0,90.0
135129022.0,17,6,1146,6,1146,27025804.4,191.0,191.0,0,0,0.0,0.0,0.0
119195896.0,6,30,1974,15,1026,8498569.5,123.0,68.4,15,948,8498563.57142857,123.0,63.2
313341.0,6,6,412,4,272,104447.0,74.0,68.0,2,140,0.0,74.0,70.0
4494.0,17,4,344,2,150,0.0,75.0,75.0,2,194,0.0,103.0,97.0
149935975.0,17,36,17126,36,17126,4283885.0,501.0,475.72222222222223,0,0,0.0,0.0,0.0
219782.0,17,2,180,1,90,0.0,90.0,90.0,1,90,0.0,90.0,90.0
3177208.0,6,18,1495,9,921,358378.5,315.0,102.33333333333331,9,574,358284.5,78.0,63.77777777777778
38909.0,6,10,2032,5,524,8857.0,252.0,104.8,5,1508,9439.75,1236.0,301.6
38215.0,6,14,4740,7,653,6128.0,249.0,93.28571428571428,7,4087,4923.166666666667,1514.0,583.8571428571429
295476.0,6,10,1221,6,636,59095.2,298.0,106.0,4,585,97074.66666666669,379.0,146.25
189207.0,17,2,180,1,90,0.0,90.0,90.0,1,90,0.0,90.0,90.0
140062.0,6,2,132,1,66,0.0,66.0,66.0,1,66,0.0,66.0,66.0
207119.0,6,3,426,2,280,0.0,214.0,140.0,1,146,0.0,146.0,146.0
5620064.0,6,5,336,2,134,0.0,68.0,67.0,3,202,1526359.0,70.0,67.33333333333333
90047416.0,17,28,13364,28,13364,3335089.4814814813,501.0,477.2857142857143,0,0,0.0,0.0,0.0
196932.0,17,2,180,1,90,0.0,90.0,90.0,1,90,0.0,90.0,90.0
90293155.0,6,16,1192,8,596,12892766.714285716,95.0,74.5,8,596,12897264.42857143,95.0,74.5
32316.0,6,14,4740,7,653,5075.166666666667,249.0,93.28571428571428,7,4087,5218.0,1514.0,583.8571428571429
701039.0,17,4,820,2,156,0.0,78.0,78.0,2,664,0.0,332.0,332.0
295403.0,17,2,180,1,90,0.0,90.0,90.0,1,90,0.0,90.0,90.0
83.0,17,2,762,2,762,0.0,381.0,381.0,0,0,0.0,0.0,0.0
2119.0,17,4,344,2,150,0.0,75.0,75.0,2,194,0.0,103.0,97.0
749025.0,6,2,132,1,66,0.0,66.0,66.0,1,66,0.0,66.0,66.0
551336.0,6,2,132,1,66,0.0,66.0,66.0,1,66,0.0,66.0,66.0
43416.0,6,14,4740,7,653,6948.833333333333,249.0,93.28571428571428,7,4087,6860.166666666667,1514.0,583.8571428571429
108108441.0,17,5,955,5,955,27027110.25,191.0,191.0,0,0,0.0,0.0,0.0
109076003.0,6,218,24550,109,17134,1007970.2222222222,284.0,157.19266055045873,109,7416,1007971.1296296295,140.0,68.03669724770643
108860391.0,6,192,21812,96,6632,1126388.5684210523,140.0,69.08333333333333,96,15180,1137395.9157894736,284.0,158.125
53889.0,6,12,1320,6,723,9385.0,253.0,120.5,6,597,9771.6,259.0,99.5
315072.0,17,4,1400,4,1400,105024.0,350.0,350.0,0,0,0.0,0.0,0.0
108103938.0,17,5,955,5,955,27025984.5,191.0,191.0,0,0,0.0,0.0,0.0
0.0,17,1,381,1,381,0.0,381.0,381.0,0,0,0.0,0.0,0.0
196897.0,17,2,180,1,90,0.0,90.0,90.0,1,90,0.0,90.0,90.0
297041.0,6,6,412,4,272,99013.66666666669,74.0,68.0,2,140,0.0,74.0,70.0
166279.0,17,2,414,1,88,0.0,88.0,88.0,1,326,0.0,326.0,326.0
390.0,17,2,174,1,79,0.0,79.0,79.0,1,95,0.0,95.0,95.0
135141278.0,17,6,1146,6,1146,27028255.6,191.0,191.0,0,0,0.0,0.0,0.0
146545.0,6,3,337,2,214,0.0,160.0,107.0,1,123,0.0,123.0,123.0
334.0,17,2,166,1,75,0.0,75.0,75.0,1,91,0.0,91.0,91.0
316072.0,17,4,1400,4,1400,105357.33333333331,350.0,350.0,0,0,0.0,0.0,0.0
140119.0,6,2,132,1,66,0.0,66.0,66.0,1,66,0.0,66.0,66.0
2800716.0,6,2,132,1,66,0.0,66.0,66.0,1,66,0.0,66.0,66.0
300973.0,6,6,412,4,272,100324.33333333331,74.0,68.0,2,140,0.0,74.0,70.0
6101003.0,17,6,2100,6,2100,1220200.6,350.0,350.0,0,0,0.0,0.0,0.0
109696869.0,6,33,2412,17,1272,6842551.0625,123.0,74.82352941176471,16,1140,7298721.133333334,123.0,71.25
118336456.0,6,207,23380,104,7160,1148897.6310679612,140.0,68.84615384615384,103,16220,1150039.5588235294,284.0,157.4757281553398
108591909.0,17,14,864,7,432,18000138.833333332,174.0,61.71428571428572,7,432,18001046.333333332,174.0,61.71428571428572
142276.0,17,4,1524,4,1524,47425.333333333336,381.0,381.0,0,0,0.0,0.0,0.0
251508.0,17,4,1524,4,1524,83836.0,381.0,381.0,0,0,0.0,0.0,0.0
120124498.0,6,16,2356,9,1204,15015562.25,188.0,133.77777777777777,7,1152,15055333.333333334,204.0,164.57142857142858
120357659.0,6,439,54802,220,40052,549578.3515981735,336.0,182.05454545454543,219,14750,547300.9220183486,140.0,67.35159817351598
119900799.0,17,34,16284,34,16284,3633357.5454545454,501.0,478.9411764705882,0,0,0.0,0.0,0.0
95665730.0,6,162,18318,81,5568,1174217.95,140.0,68.74074074074075,81,12750,1185676.175,284.0,157.40740740740742
112076.0,17,4,1400,4,1400,37358.66666666666,350.0,350.0,0,0,0.0,0.0,0.0
250114.0,6,3,373,2,238,0.0,172.0,119.0,1,135,0.0,135.0,135.0
120038948.0,17,28,13364,28,13364,4445886.962962963,501.0,477.2857142857143,0,0,0.0,0.0,0.0
65061.99999999999,6,14,4740,7,653,9726.5,249.0,93.28571428571428,7,4087,8919.666666666666,1514.0,583.8571428571429
115279512.0,6,219,24728,110,7556,1057610.2018348624,140.0,68.69090909090909,109,17172,1063745.6666666667,284.0,157.54128440366972
44722.0,6,14,4740,7,653,7257.166666666667,249.0,93.28571428571428,7,4087,6653.666666666667,1514.0,583.8571428571429
113419790.0,6,45,2970,23,1518,5155445.0,66.0,66.0,22,1452,5230550.714285715,66.0,66.0
95629.0,6,10,2032,5,524,23255.25,252.0,104.8,5,1508,21086.5,1236.0,301.6
321.0,17,2,174,1,79,0.0,79.0,79.0,1,95,0.0,95.0,95.0
1454104.0,6,8,602,5,404,337337.25,103.0,80.8,3,198,204728.5,66.0,66.0
446972.0,6,4,508,2,238,0.0,172.0,119.0,2,270,0.0,135.0,135.0
116471047.0,6,34,2334,17,1209,7279440.4375,123.0,71.11764705882354,17,1125,7265928.8125,123.0,66.17647058823529
128107993.0,6,37,2640,19,1392,7117110.722222222,123.0,73.26315789473684,18,1248,6935761.411764706,123.0,69.33333333333333
135133834.0,17,6,1146,6,1146,27026766.8,191.0,191.0,0,0,0.0,0.0,0.0
167979.0,6,11,1132,6,556,33541.2,218.0,92.66666666666669,5,576,39450.25,304.0,115.2
16684173.999999998,6,20,1652,9,962,2047327.5,315.0,106.88888888888889,11,690,1637843.2,78.0,62.72727272727273
131423649.0,17,17,1517,8,737,16003602.714285716,174.0,92.125,9,780,16407940.75,174.0,86.66666666666667
2341.0,17,4,344,2,150,0.0,75.0,75.0,2,194,0.0,103.0,97.0
72426.0,6,12,1413,7,882,12071.0,291.0,126.0,5,531,14223.5,259.0,106.2
120102981.0,6,212,24022,106,7218,1136017.857142857,140.0,68.09433962264151,106,16804,1135999.7904761904,390.0,158.52830188679246
2339.0,17,4,344,2,150,0.0,75.0,75.0,2,194,0.0,103.0,97.0
35221.0,6,14,4740,7,653,5204.5,249.0,93.28571428571428,7,4087,5724.833333333333,1514.0,583.8571428571429
713.0,17,2,762,2,762,0.0,381.0,381.0,0,0,0.0,0.0,0.0
206491.0,6,3,426,2,280,0.0,214.0,140.0,1,146,0.0,146.0,146.0
2487484.0,6,2,132,1,66,0.0,66.0,66.0,1,66,0.0,66.0,66.0
2372.0,17,4,344,2,150,0.0,75.0,75.0,2,194,0.0,103.0,97.0
217598.0,6,3,426,2,280,0.0,214.0,140.0,1,146,0.0,146.0,146.0
1780884.0,17,6,1230,3,234,890264.0,78.0,78.0,3,996,890224.5,332.0,332.0
92207.0,6,14,4740,7,653,15080.333333333334,249.0,93.28571428571428,7,4087,14215.166666666666,1514.0,583.8571428571429
103561084.0,17,14,864,7,432,17166820.333333332,174.0,61.71428571428572,7,432,17167649.666666668,174.0,61.71428571428572
129828.0,6,12,1447,6,816,25069.8,291.0,136.0,6,631,25119.0,293.0,105.16666666666669
14923.0,17,2,180,1,90,0.0,90.0,90.0,1,90,0.0,90.0,90.0
2798878.0,6,2,132,1,66,0.0,66.0,66.0,1,66,0.0,66.0,66.0
114473533.0,6,38,2996,20,1610,6024922.7894736845,139.0,80.5,18,1386,6721013.117647059,123.0,77.0
298817.0,6,6,412,4,272,99605.66666666669,74.0,68.0,2,140,0.0,74.0,70.0
108103140.0,17,5,955,5,955,27025785.0,191.0,191.0,0,0,0.0,0.0,0.0
99054070.0,17,14,1126,7,563,16500177.333333334,174.0,80.42857142857143,7,563,16501053.666666666,174.0,80.42857142857143
1314451.0,6,4,264,2,132,0.0,66.0,66.0,2,132,0.0,66.0,66.0
207188.0,6,3,426,2,280,0.0,214.0,140.0,1,146,0.0,146.0,146.0
20735.0,6,14,4740,7,653,3341.333333333333,249.0,93.28571428571428,7,4087,3321.333333333333,1514.0,583.8571428571429
94243494.0,6,184,20776,92,14482,1033264.098901099,284.0,157.41304347826087,92,6294,1033277.3956043957,140.0,68.41304347826087
232168.0,6,3,373,2,238,0.0,172.0,119.0,1,135,0.0,135.0,135.0
217579.0,6,3,426,2,280,0.0,214.0,140.0,1,146,0.0,146.0,146.0
10468222.0,6,7,478,4,272,3443781.6666666665,74.0,68.0,3,206,5165529.5,74.0,68.66666666666667
523.0,17,2,508,2,508,0.0,257.0,254.0,0,0,0.0,0.0,0.0
19852.0,6,10,2032,5,524,4750.75,252.0,104.8,5,1508,4381.0,1236.0,301.6
1452290.0,6,8,602,5,404,337401.5,103.0,80.8,3,198,204741.5,66.0,66.0
11506803.0,17,4,1368,4,1368,3835601.0,342.0,342.0,0,0,0.0,0.0,0.0
42661.0,6,14,4740,7,653,6739.833333333333,249.0,93.28571428571428,7,4087,6978.5,1514.0,583.8571428571429
27977.0,6,12,1320,6,723,5054.0,253.0,120.5,6,597,4688.2,259.0,99.5
308711.0,6,4,492,2,280,0.0,214.0,140.0,2,212,0.0,146.0,106.0
209543.0,17,2,180,1,90,0.0,90.0,90.0,1,90,0.0,90.0,90.0
1819934.0,6,49,32405,25,1814,75830.58333333333,210.0,72.56,24,30591,78870.08695652174,1514.0,1274.625
90258723.0,6,13,2036,8,1016,12894103.285714284,188.0,127.0,5,1020,22523437.5,204.0,204.0
15795.0,17,2,180,1,90,0.0,90.0,90.0,1,90,0.0,90.0,90.0
93604466.0,6,43,3654,24,2007,4069759.391304348,123.0,83.625,19,1647,5188234.333333333,123.0,86.6842105263158
42991.0,6,14,4740,7,653,5979.0,249.0,93.28571428571428,7,4087,7029.666666666667,1514.0,583.8571428571429
246667.0,6,3,337,2,214,0.0,160.0,107.0,1,123,0.0,123.0,123.0
90774179.0,6,22,1680,12,894,8247517.363636363,95.0,74.5,10,786,10085745.222222222,95.0,78.6
14015.0,6,14,4740,7,653,2037.3333333333333,249.0,93.28571428571428,7,4087,2200.5,1514.0,583.8571428571429
146830.0,6,3,337,2,214,0.0,160.0,107.0,1,123,0.0,123.0,123.0
108106543.0,17,5,955,5,955,27026635.75,191.0,191.0,0,0,0.0,0.0,0.0
141309.0,6,2,132,1,66,0.0,66.0,66.0,1,66,0.0,66.0,66.0
48362.0,6,14,4740,7,653,7891.833333333333,249.0,93.28571428571428,7,4087,7285.166666666667,1514.0,583.8571428571429
90034186.0,17,28,13364,28,13364,3334599.4814814813,501.0,477.2857142857143,0,0,0.0,0.0,0.0
120010623.0,17,15,1169,8,606,17144374.714285713,174.0,75.75,7,563,16666780.833333334,174.0,80.42857142857143
153662.0,17,2,180,1,90,0.0,90.0,90.0,1,90,0.0,90.0,90.0
90503559.0,6,19,1634,10,1025,10055951.0,338.0,102.5,9,609,11276451.25,95.0,67.66666666666667
748145.0,6,2,132,1,66,0.0,66.0,66.0,1,66,0.0,66.0,66.0
92295599.0,17,15,5130,15,5130,6592542.785714285,342.0,342.0,0,0,0.0,0.0,0.0
284268.0,17,4,704,2,148,0.0,74.0,74.0,2,556,0.0,280.0,278.0
495109.0,6,5,336,2,134,0.0,68.0,67.0,3,202,192811.0,70.0,67.33333333333333
206289.0,6,3,426,2,280,0.0,214.0,140.0,1,146,0.0,146.0,146.0
2588609.0,6,2,132,1,66,0.0,66.0,66.0,1,66,0.0,66.0,66.0
42769.0,6,10,2032,5,524,10174.25,252.0,104.8,5,1508,8045.5,1236.0,301.6
114266792.0,6,231,26134,116,7952,993624.2782608696,140.0,68.55172413793103,115,18182,993117.8859649122,284.0,158.10434782608695
356.0,17,2,267,1,83,0.0,83.0,83.0,1,184,0.0,184.0,184.0
135118464.0,17,6,1206,6,1206,27023692.8,201.0,201.0,0,0,0.0,0.0,0.0
41891.0,6,10,2032,5,524,9830.5,252.0,104.8,5,1508,8613.25,1236.0,301.6
38617.0,6,14,4740,7,653,6061.0,249.0,93.28571428571428,7,4087,6012.333333333333,1514.0,583.8571428571429
90391503.0,6,14,2256,7,1428,15065071.333333334,204.0,204.0,7,828,15019324.5,188.0,118.28571428571428
4798747.0,6,5,336,2,134,0.0,68.0,67.0,3,202,1527843.5,70.0,67.33333333333333
117242022.0,6,233,26282,117,8018,1010707.0862068966,140.0,68.52991452991454,116,18264,1010577.3652173912,284.0,157.44827586206895
37713.0,6,14,4740,7,653,6028.666666666667,249.0,93.28571428571428,7,4087,5642.166666666667,1514.0,583.8571428571429
14654785.0,6,5,1736,3,917,6031672.0,785.0,305.6666666666667,2,819,0.0,753.0,409.5
119532253.0,6,238,26988,119,18912,1011160.745762712,300.0,158.92436974789916,119,8076,1011161.0254237287,140.0,67.8655462184874
10580637.0,6,7,478,4,272,3466452.0,74.0,68.0,3,206,5199586.0,74.0,68.66666666666667
120110595.0,6,208,23536,105,7226,1154909.5673076925,140.0,68.81904761904762,103,16310,1161248.9117647058,284.0,158.3495145631068
57010.0,6,14,4740,7,653,7537.833333333333,249.0,93.28571428571428,7,4087,8499.0,1514.0,583.8571428571429
108098019.0,17,5,1005,5,1005,27024504.75,201.0,201.0,0,0,0.0,0.0,0.0
212700.0,17,2,180,1,90,0.0,90.0,90.0,1,90,0.0,90.0,90.0
2794755.0,6,2,132,1,66,0.0,66.0,66.0,1,66,0.0,66.0,66.0
246169.0,6,3,337,2,214,0.0,160.0,107.0,1,123,0.0,123.0,123.0
205853.0,17,2,180,1,90,0.0,90.0,90.0,1,90,0.0,90.0,90.0
58572407.0,6,17,1226,8,586,8367013.857142857,95.0,73.25,9,640,7320795.625,95.0,71.11111111111111
217373.0,6,3,426,2,280,0.0,214.0,140.0,1,146,0.0,146.0,146.0
2795643.0,6,2,132,1,66,0.0,66.0,66.0,1,66,0.0,66.0,66.0
2344.0,17,4,344,2,150,0.0,75.0,75.0,2,194,0.0,103.0,97.0
312506.0,17,4,1400,4,1400,104168.66666666669,350.0,350.0,0,0,0.0,0.0,0.0
816.0,17,4,438,2,148,0.0,74.0,74.0,2,290,0.0,147.0,145.0
302396.0,6,2,132,1,66,0.0,66.0,66.0,1,66,0.0,66.0,66.0
36326.0,6,14,4740,7,653,5584.333333333333,249.0,93.28571428571428,7,4087,5622.666666666667,1514.0,583.8571428571429
232064.0,6,3,337,2,214,0.0,160.0,107.0,1,123,0.0,123.0,123.0
114255526.0,6,48,3168,24,1584,4967631.565217392,66.0,66.0,24,1584,4954173.347826087,66.0,66.0
795.0,17,4,438,2,148,0.0,74.0,74.0,2,290,0.0,147.0,145.0
318883.0,17,4,1400,4,1400,106294.33333333331,350.0,350.0,0,0,0.0,0.0,0.0
200525.0,17,2,762,2,762,0.0,381.0,381.0,0,0,0.0,0.0,0.0
314870.0,6,3,202,2,128,0.0,74.0,64.0,1,74,0.0,74.0,74.0
120046381.0,17,29,13785,29,13785,4287370.75,501.0,475.3448275862069,0,0,0.0,0.0,0.0
197323.0,17,2,180,1,90,0.0,90.0,90.0,1,90,0.0,90.0,90.0
15280.0,6,14,4740,7,653,2335.1666666666665,249.0,93.28571428571428,7,4087,2407.833333333333,1514.0,583.8571428571429
3613.0,17,4,344,2,150,0.0,75.0,75.0,2,194,0.0,103.0,97.0
2386.0,17,4,344,2,150,0.0,75.0,75.0,2,194,0.0,103.0,97.0
2347.0,17,4,344,2,150,0.0,75.0,75.0,2,194,0.0,103.0,97.0
321.0,17,2,168,1,76,0.0,76.0,76.0,1,92,0.0,92.0,92.0
206046.0,17,2,180,1,90,0.0,90.0,90.0,1,90,0.0,90.0,90.0
13472.0,6,13,1459,7,862,2009.8333333333333,271.0,123.14285714285714,6,597,2459.0,259.0,99.5
103535.0,17,2,286,2,286,0.0,143.0,143.0,0,0,0.0,0.0,0.0
1213.0,17,2,762,2,762,0.0,381.0,381.0,0,0,0.0,0.0,0.0
33159.0,6,14,4740,7,653,5418.0,249.0,93.28571428571428,7,4087,5186.5,1514.0,583.8571428571429
41888.0,6,10,2032,5,524,9438.0,252.0,104.8,5,1508,9084.0,1236.0,301.6
319132.0,6,6,412,4,272,106377.33333333331,74.0,68.0,2,140,0.0,74.0,70.0
2354.0,17,4,344,2,150,0.0,75.0,75.0,2,194,0.0,103.0,97.0
10880378.0,6,8,544,4,272,3581445.6666666665,74.0,68.0,4,272,3581386.6666666665,74.0,68.0
15046159.0,17,6,2718,6,2718,3009231.8,453.0,453.0,0,0,0.0,0.0,0.0
90024181.0,17,28,13364,28,13364,3334228.925925926,501.0,477.2857142857143,0,0,0.0,0.0,0.0
108101376.0,17,5,1005,5,1005,27025344.0,201.0,201.0,0,0,0.0,0.0,0.0
281145.0,17,2,363,1,79,0.0,79.0,79.0,1,284,0.0,284.0,284.0
5625290.0,6,4,270,2,134,0.0,68.0,67.0,2,136,0.0,70.0,68.0
53846.0,6,14,4740,7,653,8434.5,249.0,93.28571428571428,7,4087,6607.833333333333,1514.0,583.8571428571429
309837.0,6,6,412,4,272,103279.0,74.0,68.0,2,140,0.0,74.0,70.0
120943030.0,6,35,2542,18,1348,7114295.882352941,139.0,74.88888888888889,17,1194,6921393.25,123.0,70.23529411764706
38754.0,6,14,4740,7,653,6329.166666666667,249.0,93.28571428571428,7,4087,5848.833333333333,1514.0,583.8571428571429
11257.0,6,13,1459,7,862,1876.1666666666667,271.0,123.14285714285714,6,597,1946.8,259.0,99.5
205453.0,17,2,180,1,90,0.0,90.0,90.0,1,90,0.0,90.0,90.0
2018.0,17,4,344,2,150,0.0,75.0,75.0,2,194,0.0,103.0,97.0
90257777.0,6,14,2240,8,1016,12893968.142857144,188.0,127.0,6,1224,18018803.6,204.0,204.0
212894.0,17,2,762,2,762,0.0,381.0,381.0,0,0,0.0,0.0,0.0
39892.0,6,14,4740,7,653,5723.0,249.0,93.28571428571428,7,4087,6513.5,1514.0,583.8571428571429
205865.0,17,2,180,1,90,0.0,90.0,90.0,1,90,0.0,90.0,90.0
373189.0,17,4,1400,4,1400,124396.33333333331,350.0,350.0,0,0,0.0,0.0,0.0
0.0,6,1,66,1,66,0.0,66.0,66.0,0,0,0.0,0.0,0.0
348397.0,6,6,412,4,272,116132.33333333331,74.0,68.0,2,140,0.0,74.0,70.0
108107033.0,17,5,955,5,955,27026758.25,191.0,191.0,0,0,0.0,0.0,0.0
50705728.0,6,8,2113,3,960,24026575.0,826.0,320.0,5,1153,12032435.5,885.0,230.6
314.0,17,2,164,1,82,0.0,82.0,82.0,1,82,0.0,82.0,82.0
147220.0,17,4,704,2,148,0.0,74.0,74.0,2,556,0.0,280.0,278.0
207829.0,6,3,426,2,280,0.0,214.0,140.0,1,146,0.0,146.0,146.0
212888.0,6,10,1221,6,636,42577.6,298.0,106.0,4,585,70103.33333333333,379.0,146.25
107891.0,6,12,1354,6,723,20236.4,253.0,120.5,6,631,21213.0,293.0,105.16666666666669
81.0,17,2,700,2,700,0.0,350.0,350.0,0,0,0.0,0.0,0.0
41657.0,6,10,2032,5,524,9608.25,252.0,104.8,5,1508,9852.5,1236.0,301.6
155073.0,6,3,337,2,214,0.0,160.0,107.0,1,123,0.0,123.0,123.0
216475.0,6,12,1373,7,714,36079.16666666666,298.0,102.0,5,659,53210.25,379.0,131.8
80727.0,6,14,4740,7,653,12507.5,249.0,93.28571428571428,7,4087,13142.5,1514.0,583.8571428571429
102238.0,17,2,700,2,700,0.0,350.0,350.0,0,0,0.0,0.0,0.0
113754700.0,6,47,3102,24,1584,4932649.652173913,66.0,66.0,23,1518,5150449.136363637,66.0,66.0
103000955.0,17,13,821,7,432,17166825.833333332,174.0,61.71428571428572,6,389,16598508.2,174.0,64.83333333333333
123416337.0,6,48,3168,24,1584,5121824.521739131,66.0,66.0,24,1584,5179913.782608695,66.0,66.0
12432.0,6,12,1393,6,796,2230.8,271.0,132.66666666666666,6,597,2248.2,259.0,99.5
90057274.0,17,27,12943,27,12943,3463741.3076923075,501.0,479.3703703703704,0,0,0.0,0.0,0.0
111780685.0,6,31,2166,16,1149,7452045.666666667,123.0,71.8125,15,1017,7255700.928571428,123.0,67.8
99836911.0,6,66,12958,32,6733,3220545.516129032,1514.0,210.40625,34,6225,3017010.636363636,1514.0,183.08823529411765
120202133.0,6,18,1341,9,691,14998262.125,95.0,76.77777777777777,9,650,14998334.0,95.0,72.22222222222223
247549.0,17,4,6056,4,6056,82516.33333333333,1514.0,1514.0,0,0,0.0,0.0,0.0
90288840.0,6,16,1192,8,596,12892732.0,95.0,74.5,8,596,12897148.0,95.0,74.5
327960.0,17,4,1400,4,1400,109320.0,350.0,350.0,0,0,0.0,0.0,0.0
10460412.0,6,7,478,4,272,3441247.0,74.0,68.0,3,206,5161766.5,74.0,68.66666666666667
31546.0,6,14,4740,7,653,5149.333333333333,249.0,93.28571428571428,7,4087,5076.5,1514.0,583.8571428571429
312713.0,17,4,1400,4,1400,104237.66666666669,350.0,350.0,0,0,0.0,0.0,0.0
351.0,17,2,267,1,83,0.0,83.0,83.0,1,184,0.0,184.0,184.0
356.0,17,2,267,1,83,0.0,83.0,83.0,1,184,0.0,184.0,184.0
90258152.0,6,13,2036,8,1016,12894021.714285716,188.0,127.0,5,1020,22523694.25,204.0,204.0
90008294.0,17,28,13364,28,13364,3333640.5185185187,501.0,477.2857142857143,0,0,0.0,0.0,0.0
5364.0,17,4,344,2,150,0.0,75.0,75.0,2,194,0.0,103.0,97.0
42882.0,6,14,4740,7,653,7019.666666666667,249.0,93.28571428571428,7,4087,6531.333333333333,1514.0,583.8571428571429
10518003.0,6,7,478,4,272,3460542.0,74.0,68.0,3,206,5190653.0,74.0,68.66666666666667
335.0,17,2,160,1,80,0.0,80.0,80.0,1,80,0.0,80.0,80.0
5048.0,17,4,344,2,150,0.0,75.0,75.0,2,194,0.0,103.0,97.0
113619228.0,6,46,3036,23,1518,5150452.045454546,66.0,66.0,23,1518,5150452.136363637,66.0,66.0
0.0,17,1,55,1,55,0.0,55.0,55.0,0,0,0.0,0.0,0.0
104128536.0,17,15,5130,15,5130,7437752.571428572,342.0,342.0,0,0,0.0,0.0,0.0
117863804.0,6,487,63328,244,16400,485036.2304526749,140.0,67.21311475409836,243,46928,486140.5247933885,480.0,193.119341563786
216378.0,17,2,180,1,90,0.0,90.0,90.0,1,90,0.0,90.0,90.0
48744.0,6,10,2032,5,524,11773.25,252.0,104.8,5,1508,11940.25,1236.0,301.6
249002.0,6,3,426,2,280,0.0,214.0,140.0,1,146,0.0,146.0,146.0
144023.0,17,2,180,1,90,0.0,90.0,90.0,1,90,0.0,90.0,90.0
15487.0,17,4,823,2,163,0.0,89.0,81.5,2,660,0.0,443.0,330.0
120122210.0,6,13,2020,9,1204,15015276.25,188.0,133.77777777777777,4,816,30030317.0,204.0,204.0
123001151.0,17,15,907,8,475,17571593.0,174.0,59.375,7,432,17171302.666666668,174.0,61.71428571428572
298210.0,6,6,412,4,272,99403.33333333331,74.0,68.0,2,140,0.0,74.0,70.0
10464622.0,6,7,478,4,272,3442784.0,74.0,68.0,3,206,5164365.5,74.0,68.66666666666667
3774587.0,6,5,336,2,134,0.0,68.0,67.0,3,202,1525769.0,70.0,67.33333333333333
49978.0,6,10,2032,5,524,11879.0,252.0,104.8,5,1508,11777.5,1236.0,301.6
40705.0,6,14,4740,7,653,6655.833333333333,249.0,93.28571428571428,7,4087,5696.166666666667,1514.0,583.8571428571429
298879.0,6,6,412,4,272,99626.33333333331,74.0,68.0,2,140,0.0,74.0,70.0
391.0,17,2,168,1,76,0.0,76.0,76.0,1,92,0.0,92.0,92.0
99907.0,17,2,762,2,762,0.0,381.0,381.0,0,0,0.0,0.0,0.0
324.0,17,2,174,1,79,0.0,79.0,79.0,1,95,0.0,95.0,95.0
14150396.0,17,6,2052,6,2052,2830079.2,342.0,342.0,0,0,0.0,0.0,0.0
102244487.0,17,14,864,7,432,17001463.666666668,174.0,61.71428571428572,7,432,17000198.666666668,174.0,61.71428571428572
108103086.0,17,5,1005,5,1005,27025771.5,201.0,201.0,0,0,0.0,0.0,0.0
106736.0,17,2,286,2,286,0.0,143.0,143.0,0,0,0.0,0.0,0.0
186074.0,17,2,180,1,90,0.0,90.0,90.0,1,90,0.0,90.0,90.0
283288.0,17,2,180,1,90,0.0,90.0,90.0,1,90,0.0,90.0,90.0
52738.0,6,13,1394,7,797,8789.666666666666,253.0,113.85714285714286,6,597,8623.6,259.0,99.5
56478.0,6,14,4740,7,653,8451.5,249.0,93.28571428571428,7,4087,8979.0,1514.0,583.8571428571429
306691.0,6,6,412,4,272,102230.33333333331,74.0,68.0,2,140,0.0,74.0,70.0
205356.0,17,2,762,2,762,0.0,381.0,381.0,0,0,0.0,0.0,0.0
503283.00000000006,6,5,336,2,134,0.0,68.0,67.0,3,202,193220.0,70.0,67.33333333333333
16917.0,6,10,1949,5,441,4024.0,169.0,88.2,5,1508,3482.25,1236.0,301.6
222164.0,6,3,426,2,280,0.0,214.0,140.0,1,146,0.0,146.0,146.0
135115577.0,17,6,1206,6,1206,27023115.4,201.0,201.0,0,0,0.0,0.0,0.0
204013.0,6,10,1221,6,636,40802.6,298.0,106.0,4,585,66574.0,379.0,146.25
108112683.0,17,5,1005,5,1005,27028170.75,201.0,201.0,0,0,0.0,0.0,0.0
143894.0,17,2,180,1,90,0.0,90.0,90.0,1,90,0.0,90.0,90.0
501468.0,6,5,336,2,134,0.0,68.0,67.0,3,202,191563.0,70.0,67.33333333333333
48285.0,6,14,4740,7,653,7921.166666666667,249.0,93.28571428571428,7,4087,7633.5,1514.0,583.8571428571429
17390.0,6,14,4740,7,653,2617.0,249.0,93.28571428571428,7,4087,2760.6666666666665,1514.0,583.8571428571429
28656.0,6,14,4740,7,653,4235.0,249.0,93.28571428571428,7,4087,4636.0,1514.0,583.8571428571429
36638.0,6,10,2032,5,524,8604.5,252.0,104.8,5,1508,8406.0,1236.0,301.6
0.0,6,1,66,1,66,0.0,66.0,66.0,0,0,0.0,0.0,0.0
12076.0,6,10,1065,5,534,2747.75,262.0,106.8,5,531,2809.0,259.0,106.2
135141076.0,17,6,1146,6,1146,27028215.2,191.0,191.0,0,0,0.0,0.0,0.0
4382.0,17,2,614,1,72,0.0,72.0,72.0,1,542,0.0,542.0,542.0
507239.0,6,3,1604,1,753,0.0,753.0,753.0,2,851,0.0,785.0,425.5
135127741.0,17,6,1146,6,1146,27025548.2,191.0,191.0,0,0,0.0,0.0,0.0
300792.0,6,6,412,4,272,100264.0,74.0,68.0,2,140,0.0,74.0,70.0
90254036.0,6,12,1832,8,1016,12893433.714285716,188.0,127.0,4,816,30028199.33333333,204.0,204.0
135129679.0,17,6,1146,6,1146,27025935.8,191.0,191.0,0,0,0.0,0.0,0.0
2071.0,17,4,344,2,150,0.0,75.0,75.0,2,194,0.0,103.0,97.0
44101.0,6,10,2032,5,524,10499.0,252.0,104.8,5,1508,5320.75,1236.0,301.6
205908.0,17,2,180,1,90,0.0,90.0,90.0,1,90,0.0,90.0,90.0
247036.0,6,3,337,2,214,0.0,160.0,107.0,1,123,0.0,123.0,123.0
112448689.0,6,320,38144,160,27288,705870.2012578617,374.0,170.55,160,10856,705869.1509433963,140.0,67.85
307518.0,17,4,1400,4,1400,102506.0,350.0,350.0,0,0,0.0,0.0,0.0
241866.0,6,3,337,2,214,0.0,160.0,107.0,1,123,0.0,123.0,123.0
37564.0,6,14,4740,7,653,5810.333333333333,249.0,93.28571428571428,7,4087,6123.166666666667,1514.0,583.8571428571429
381918.0,6,3,204,2,136,0.0,70.0,68.0,1,68,0.0,68.0,68.0
120117449.0,6,14,2240,8,1016,17136612.57142857,188.0,127.0,6,1224,18017120.4,204.0,204.0
45050726.0,17,8,2744,7,2394,5958424.666666667,342.0,342.0,1,350,0.0,350.0,350.0
211172.0,6,10,1221,6,636,42234.4,298.0,106.0,4,585,69303.66666666667,379.0,146.25
507114.0,6,5,336,2,134,0.0,68.0,67.0,3,202,191995.5,70.0,67.33333333333333
1302520.0,6,4,264,2,132,0.0,66.0,66.0,2,132,0.0,66.0,66.0
90015514.0,17,28,13364,28,13364,3333907.925925926,501.0,477.2857142857143,0,0,0.0,0.0,0.0
12974.0,6,10,1065,5,534,2860.25,262.0,106.8,5,531,2901.25,259.0,106.2
627.0,17,2,762,2,762,0.0,381.0,381.0,0,0,0.0,0.0,0.0
1447710.0,6,7,499,4,301,467153.0,103.0,75.25,3,198,716433.0,66.0,66.0
1073.0,17,4,316,2,158,0.0,79.0,79.0,2,158,0.0,79.0,79.0
103214.0,17,2,286,2,286,0.0,143.0,143.0,0,0,0.0,0.0,0.0
105000960.0,17,13,821,7,432,17500160.0,174.0,61.71428571428572,6,389,19886948.4,174.0,64.83333333333333
110277211.0,17,14,864,7,432,18333566.666666668,174.0,61.71428571428572,7,432,18334301.666666668,174.0,61.71428571428572
22650.0,6,14,4740,7,653,3593.5,249.0,93.28571428571428,7,4087,3283.0,1514.0,583.8571428571429
191158.0,17,2,180,1,90,0.0,90.0,90.0,1,90,0.0,90.0,90.0
57330.0,6,14,4740,7,653,9259.166666666666,249.0,93.28571428571428,7,4087,7710.0,1514.0,583.8571428571429
137228.0,17,4,344,2,150,0.0,75.0,75.0,2,194,0.0,103.0,97.0
90043885.0,17,28,13364,28,13364,3334958.703703704,501.0,477.2857142857143,0,0,0.0,0.0,0.0
122237.0,6,3,373,2,238,0.0,172.0,119.0,1,135,0.0,135.0,135.0
362.0,17,2,267,1,83,0.0,83.0,83.0,1,184,0.0,184.0,184.0
40436.0,6,14,4740,7,653,6567.833333333333,249.0,93.28571428571428,7,4087,6481.833333333333,1514.0,583.8571428571429
233169.0,6,3,337,2,214,0.0,160.0,107.0,1,123,0.0,123.0,123.0
49761.0,6,14,4740,7,653,6770.166666666667,249.0,93.28571428571428,7,4087,7944.166666666667,1514.0,583.8571428571429
90040862.0,17,28,13364,28,13364,3334846.7407407407,501.0,477.2857142857143,0,0,0.0,0.0,0.0
1046668.0,6,13,1386,7,789,174444.66666666666,253.0,112.71428571428572,6,597,207712.6,259.0,99.5
2152.0,17,2,664,1,322,0.0,322.0,322.0,1,342,0.0,342.0,342.0
1315518.0,6,4,264,2,132,0.0,66.0,66.0,2,132,0.0,66.0,66.0
245918.0,6,3,337,2,214,0.0,160.0,107.0,1,123,0.0,123.0,123.0
52188.0,6,10,2032,5,524,12791.25,252.0,104.8,5,1508,12635.75,1236.0,301.6
102409172.0,6,31,2176,16,1071,6827249.8,123.0,66.9375,15,1105,6601577.357142857,139.0,73.66666666666667
299459.0,6,6,412,4,272,99819.66666666669,74.0,68.0,2,140,0.0,74.0,70.0
108141341.0,6,203,22840,102,6954,1070706.3465346536,140.0,68.17647058823529,101,15886,1071034.12,284.0,157.2871287128713
32112.0,6,14,4740,7,653,5222.5,249.0,93.28571428571428,7,4087,5211.0,1514.0,583.8571428571429
9039.0,6,10,2032,5,524,2015.5,252.0,104.8,5,1508,2014.75,1236.0,301.6
144001.0,17,2,180,1,90,0.0,90.0,90.0,1,90,0.0,90.0,90.0
104395.0,17,2,286,2,286,0.0,143.0,143.0,0,0,0.0,0.0,0.0
45046.0,6,14,4740,7,653,7326.833333333333,249.0,93.28571428571428,7,4087,6097.666666666667,1514.0,583.8571428571429
90033587.0,17,28,13364,28,13364,3334577.296296296,501.0,477.2857142857143,0,0,0.0,0.0,0.0
35047.0,6,14,4740,7,653,4854.333333333333,249.0,93.28571428571428,7,4087,5635.166666666667,1514.0,583.8571428571429
120124769.0,6,15,2152,9,1204,15015596.125,188.0,133.77777777777777,6,948,18020037.6,204.0,158.0
108101199.0,17,5,1005,5,1005,27025299.75,201.0,201.0,0,0,0.0,0.0,0.0
1306924.0,6,4,264,2,132,0.0,66.0,66.0,2,132,0.0,66.0,66.0
10452153.0,6,7,478,4,272,3438433.0,74.0,68.0,3,206,5157553.0,74.0,68.66666666666667
27246.0,6,14,4740,7,653,3704.6666666666665,249.0,93.28571428571428,7,4087,4326.833333333333,1514.0,583.8571428571429
8481.0,6,11,2098,6,590,1616.4,252.0,98.33333333333331,5,1508,1877.75,1236.0,301.6
196960.0,17,2,180,1,90,0.0,90.0,90.0,1,90,0.0,90.0,90.0
25801.0,6,14,4740,7,653,3846.1666666666665,249.0,93.28571428571428,7,4087,4002.5,1514.0,583.8571428571429
297943.0,6,6,412,4,272,99314.33333333331,74.0,68.0,2,140,0.0,74.0,70.0
309921.0,6,6,412,4,272,103307.0,74.0,68.0,2,140,0.0,74.0,70.0
90016709.0,17,27,12943,27,12943,3462181.1153846155,501.0,479.3703703703704,0,0,0.0,0.0,0.0
10502077.0,6,7,478,4,272,3455161.0,74.0,68.0,3,206,5182634.0,74.0,68.66666666666667
90296566.0,6,26,2865,13,1410,7521276.916666667,426.0,108.46153846153848,13,1455,7523735.416666667,360.0,111.92307692307692
153430.0,17,2,180,1,90,0.0,90.0,90.0,1,90,0.0,90.0,90.0
135133323.0,17,6,1206,6,1206,27026664.6,201.0,201.0,0,0,0.0,0.0,0.0
16784.0,17,2,180,1,90,0.0,90.0,90.0,1,90,0.0,90.0,90.0
311632.0,17,4,1400,4,1400,103877.33333333331,350.0,350.0,0,0,0.0,0.0,0.0
110955243.0,6,32,2220,16,1149,7382625.666666667,123.0,71.8125,16,1071,7382618.0,123.0,66.9375
10476367.0,6,7,478,4,272,3444902.333333333,74.0,68.0,3,206,5167224.5,74.0,68.66666666666667
234573.0,6,3,337,2,214,0.0,160.0,107.0,1,123,0.0,123.0,123.0
90528162.0,6,13,2036,8,1016,12932594.57142857,188.0,127.0,5,1020,22589958.75,204.0,204.0
104766768.0,17,15,5130,15,5130,7483340.571428572,342.0,342.0,0,0,0.0,0.0,0.0
10482935.0,6,7,478,4,272,3447173.0,74.0,68.0,3,206,5170640.5,74.0,68.66666666666667
228316.0,6,12,1373,7,714,38052.66666666666,298.0,102.0,5,659,56042.25,379.0,131.8
12115.0,6,11,2098,6,590,2276.0,252.0,98.33333333333331,5,1508,2805.25,1236.0,301.6
254505.0,17,4,1524,4,1524,84835.0,381.0,381.0,0,0,0.0,0.0,0.0
13826.0,6,11,1133,6,602,2529.6,264.0,100.33333333333331,5,531,3045.0,259.0,106.2
859668.0,6,10,1336,6,799,171933.6,461.0,133.16666666666666,4,537,195525.0,331.0,134.25
248510.0,17,2,180,1,90,0.0,90.0,90.0,1,90,0.0,90.0,90.0
108104331.0,17,5,955,5,955,27026082.75,191.0,191.0,0,0,0.0,0.0,0.0
120361067.0,6,47,3102,23,1518,5105439.318181818,66.0,66.0,24,1584,5223705.956521739,66.0,66.0
33144.0,6,10,2032,5,524,6939.5,252.0,104.8,5,1508,7853.0,1236.0,301.6
1022802.0,6,11,1134,6,558,204560.4,220.0,93.0,5,576,254906.0,304.0,115.2
200507.0,17,4,6056,4,6056,66835.66666666667,1514.0,1514.0,0,0,0.0,0.0,0.0
508692.00000000006,6,5,336,2,134,0.0,68.0,67.0,3,202,192818.0,70.0,67.33333333333333
2921.0,17,4,344,2,150,0.0,75.0,75.0,2,194,0.0,103.0,97.0
120435457.0,6,219,24802,110,17312,1104912.4495412845,284.0,157.38181818181818,109,7490,1105571.6296296297,140.0,68.71559633027523
120123467.0,6,14,2240,6,1224,24024693.4,204.0,204.0,8,1016,17098106.14285714,188.0,127.0
104082.0,17,2,286,2,286,0.0,143.0,143.0,0,0,0.0,0.0,0.0
108242.0,17,2,286,2,286,0.0,143.0,143.0,0,0,0.0,0.0,0.0
3181324.0,6,18,1495,9,921,358408.125,315.0,102.33333333333331,9,574,358377.25,78.0,63.77777777777778
221555.0,6,13,1394,7,797,36925.833333333336,253.0,113.85714285714286,6,597,42061.4,259.0,99.5
3009332.0,6,3,222,3,222,1504666.0,74.0,74.0,0,0,0.0,0.0,0.0
322.0,17,2,174,1,79,0.0,79.0,79.0,1,95,0.0,95.0,95.0
311.0,17,2,168,1,76,0.0,76.0,76.0,1,92,0.0,92.0,92.0
2408.0,17,4,344,2,150,0.0,75.0,75.0,2,194,0.0,103.0,97.0
310079.0,6,6,412,4,272,103359.66666666669,74.0,68.0,2,140,0.0,74.0,70.0
294724.0,6,12,1373,7,714,49120.66666666666,298.0,102.0,5,659,69330.0,379.0,131.8
96145865.0,17,14,1126,7,563,16000127.333333334,174.0,80.42857142857143,7,563,16000749.5,174.0,80.42857142857143
91434802.0,6,24,1829,13,989,7618620.583333333,95.0,76.07692307692308,11,840,9141792.1,95.0,76.36363636363636
5621785.0,6,5,336,2,134,0.0,68.0,67.0,3,202,1471822.0,70.0,67.33333333333333
405876.0,6,3,1604,2,851,0.0,785.0,425.5,1,753,0.0,753.0,753.0
90214874.0,6,16,1192,8,596,12852742.42857143,95.0,74.5,8,596,12857092.714285716,95.0,74.5
131331558.0,17,14,864,7,432,18667545.0,174.0,61.71428571428572,7,432,18666825.33333333,174.0,61.71428571428572
4602578.0,6,5,336,2,134,0.0,68.0,67.0,3,202,1526078.5,70.0,67.33333333333333
2366.0,17,4,344,2,150,0.0,75.0,75.0,2,194,0.0,103.0,97.0
27181935.0,17,5,1718,4,1368,743326.6666666666,342.0,342.0,1,350,0.0,350.0,350.0
153387.0,17,2,180,1,90,0.0,90.0,90.0,1,90,0.0,90.0,90.0
113376317.0,6,205,23144,103,7118,1111532.5196078431,140.0,69.10679611650485,102,16026,1071285.108910891,284.0,157.11764705882354
205660.0,17,2,180,1,90,0.0,90.0,90.0,1,90,0.0,90.0,90.0
695.0,17,4,438,2,148,0.0,74.0,74.0,2,290,0.0,147.0,145.0
36635.0,6,10,2032,5,524,8390.75,252.0,104.8,5,1508,8494.75,1236.0,301.6
135151323.0,17,6,1146,6,1146,27030264.6,191.0,191.0,0,0,0.0,0.0,0.0
99006.0,17,2,286,2,286,0.0,143.0,143.0,0,0,0.0,0.0,0.0
129005865.0,17,15,907,8,475,18429409.285714287,174.0,59.375,7,432,18166897.5,174.0,61.71428571428572
123839966.0,6,49,3234,25,1650,5159998.583333333,66.0,66.0,24,1584,5016072.043478261,66.0,66.0
206040.0,6,3,426,2,280,0.0,214.0,140.0,1,146,0.0,146.0,146.0
3129.0,17,2,359,1,75,0.0,75.0,75.0,1,284,0.0,284.0,284.0
91374015.0,6,24,1829,13,989,7614086.416666667,95.0,76.07692307692308,11,840,9136526.8,95.0,76.36363636363636
326135.0,17,4,1400,4,1400,108711.66666666669,350.0,350.0,0,0,0.0,0.0,0.0
239120.0,17,2,180,1,90,0.0,90.0,90.0,1,90,0.0,90.0,90.0
207121.0,6,3,426,2,280,0.0,214.0,140.0,1,146,0.0,146.0,146.0
120021878.0,17,28,13364,28,13364,4445254.740740741,501.0,477.2857142857143,0,0,0.0,0.0,0.0
5617957.0,6,5,336,2,134,0.0,68.0,67.0,3,202,1410164.5,70.0,67.33333333333333
105173910.0,17,14,1126,7,563,17502495.5,174.0,80.42857142857143,7,563,17502498.833333332,174.0,80.42857142857143
2794045.0,6,2,132,1,66,0.0,66.0,66.0,1,66,0.0,66.0,66.0
336.0,17,2,160,1,80,0.0,80.0,80.0,1,80,0.0,80.0,80.0
5731.0,17,4,438,2,148,0.0,74.0,74.0,2,290,0.0,147.0,145.0
60793.0,6,12,1320,6,723,10350.6,253.0,120.5,6,597,11406.4,259.0,99.5
73150166.0,6,9,842,9,842,9143770.75,97.0,93.55555555555556,0,0,0.0,0.0,0.0
8822.0,17,2,224,1,76,0.0,76.0,76.0,1,148,0.0,148.0,148.0
108114191.0,17,5,1005,5,1005,27028547.75,201.0,201.0,0,0,0.0,0.0,0.0
95024604.0,17,21,9513,21,9513,4751230.2,453.0,453.0,0,0,0.0,0.0,0.0
44684.0,6,12,1320,6,723,8453.8,253.0,120.5,6,597,8310.0,259.0,99.5
1459.0,17,2,180,1,90,0.0,90.0,90.0,1,90,0.0,90.0,90.0
11162.0,17,2,627,1,79,0.0,79.0,79.0,1,548,0.0,548.0,548.0
332.0,17,2,248,1,84,0.0,84.0,84.0,1,164,0.0,164.0,164.0
90260739.0,6,13,2036,8,1016,12894391.285714284,188.0,127.0,5,1020,22523596.25,204.0,204.0
265489.0,6,10,1221,6,636,53097.8,298.0,106.0,4,585,82285.0,379.0,146.25
205260.0,17,2,762,2,762,0.0,381.0,381.0,0,0,0.0,0.0,0.0
120237083.0,6,226,25614,113,7680,1066237.3035714286,140.0,67.96460176991151,113,17934,1066231.125,300.0,158.7079646017699
322.0,17,2,174,1,79,0.0,79.0,79.0,1,95,0.0,95.0,95.0
181256.0,17,2,180,1,90,0.0,90.0,90.0,1,90,0.0,90.0,90.0
111127123.0,6,32,2236,16,1165,7394074.466666667,139.0,72.8125,16,1071,7394074.733333333,123.0,66.9375
95092093.0,6,30,2122,15,1105,6776876.428571428,139.0,73.66666666666667,15,1017,6776878.071428572,123.0,67.8
29440.0,6,11,2098,6,590,5712.8,252.0,98.33333333333331,5,1508,7056.0,1236.0,301.6
143860.0,17,2,180,1,90,0.0,90.0,90.0,1,90,0.0,90.0,90.0
306028.0,6,6,412,4,272,102009.33333333331,74.0,68.0,2,140,0.0,74.0,70.0
6745.0,17,2,582,1,83,0.0,83.0,83.0,1,499,0.0,499.0,499.0
216899.0,6,3,426,2,280,0.0,214.0,140.0,1,146,0.0,146.0,146.0
45334.0,6,14,4740,7,653,7414.666666666667,249.0,93.28571428571428,7,4087,6166.833333333333,1514.0,583.8571428571429
13637.0,6,11,1132,6,556,2452.8,218.0,92.66666666666669,5,576,2728.25,304.0,115.2
90367590.0,6,12,1848,5,1020,22591593.0,204.0,204.0,7,828,15060879.666666666,188.0,118.28571428571428
306961.0,6,6,412,4,272,102320.33333333331,74.0,68.0,2,140,0.0,74.0,70.0
74114974.0,6,9,842,9,842,9264371.75,97.0,93.55555555555556,0,0,0.0,0.0,0.0
90759480.0,6,19,1436,10,745,10079492.777777778,95.0,74.5,9,691,11344352.125,95.0,76.77777777777777
45216.0,6,14,4740,7,653,7415.166666666667,249.0,93.28571428571428,7,4087,6906.5,1514.0,583.8571428571429
19947.0,17,2,582,1,83,0.0,83.0,83.0,1,499,0.0,499.0,499.0
111049705.0,6,32,2236,16,1165,7388889.933333334,139.0,72.8125,16,1071,7388874.733333333,123.0,66.9375
310.0,17,2,174,1,79,0.0,79.0,79.0,1,95,0.0,95.0,95.0
100539.0,17,2,762,2,762,0.0,381.0,381.0,0,0,0.0,0.0,0.0
228397.0,17,2,180,1,90,0.0,90.0,90.0,1,90,0.0,90.0,90.0
437688.0,6,10,967,5,390,73304.25,162.0,78.0,5,577,73241.75,349.0,115.4
44557.0,6,14,4740,7,653,7246.333333333333,249.0,93.28571428571428,7,4087,5076.666666666667,1514.0,583.8571428571429
36712.0,6,14,4740,7,653,5533.833333333333,249.0,93.28571428571428,7,4087,5956.833333333333,1514.0,583.8571428571429
135128124.0,17,6,1146,6,1146,27025624.8,191.0,191.0,0,0,0.0,0.0,0.0
118041201.0,6,32,2220,16,1149,7869413.4,123.0,71.8125,16,1071,7854997.866666666,123.0,66.9375
1303713.0,6,4,264,2,132,0.0,66.0,66.0,2,132,0.0,66.0,66.0
27667.0,6,14,4740,7,653,4451.666666666667,249.0,93.28571428571428,7,4087,4458.5,1514.0,583.8571428571429
16415336.0,6,27,9227,15,2193,1172524.0,408.0,146.2,12,7034,1118311.5454545454,1514.0,586.1666666666666
114710768.0,6,48,3168,24,1584,4987424.695652174,66.0,66.0,24,1584,4973756.347826087,66.0,66.0
90037400.0,17,27,12943,27,12943,3462976.923076923,501.0,479.3703703703704,0,0,0.0,0.0,0.0
305987.0,6,6,412,4,272,101995.66666666669,74.0,68.0,2,140,0.0,74.0,70.0
90257979.0,6,13,2036,8,1016,12893997.0,188.0,127.0,5,1020,22523011.75,204.0,204.0
90306194.0,6,16,1192,8,596,12894016.285714284,95.0,74.5,8,596,12900532.57142857,95.0,74.5
127611.0,6,2,132,1,66,0.0,66.0,66.0,1,66,0.0,66.0,66.0
120122771.0,6,13,2036,8,1016,17137049.714285713,188.0,127.0,5,1020,22522369.75,204.0,204.0
41348.0,6,14,4740,7,653,6730.333333333333,249.0,93.28571428571428,7,4087,6705.666666666667,1514.0,583.8571428571429
1651529.0,6,20,6434,12,1921,150139.0,620.0,160.08333333333334,8,4513,192531.7142857143,1514.0,564.125
302173.0,6,6,412,4,272,100724.33333333331,74.0,68.0,2,140,0.0,74.0,70.0
302384.0,6,2,132,1,66,0.0,66.0,66.0,1,66,0.0,66.0,66.0
228186.0,17,2,180,1,90,0.0,90.0,90.0,1,90,0.0,90.0,90.0
346.0,17,2,160,1,80,0.0,80.0,80.0,1,80,0.0,80.0,80.0
106354685.0,6,44,2904,22,1452,5064508.80952381,66.0,66.0,22,1452,5054199.0,66.0,66.0
90301417.0,6,19,1436,10,745,10027965.666666666,95.0,74.5,9,691,11286775.125,95.0,76.77777777777777
317025.0,17,4,1400,4,1400,105675.0,350.0,350.0,0,0,0.0,0.0,0.0
120306322.0,6,218,24662,109,7416,1106125.4074074074,140.0,68.03669724770643,109,17246,1106328.5277777778,284.0,158.22018348623854
121459.0,6,3,337,2,214,0.0,160.0,107.0,1,123,0.0,123.0,123.0
120125197.0,6,13,2036,5,1020,30031299.25,204.0,204.0,8,1016,17137477.14285714,188.0,127.0
2301.0,17,4,344,2,150,0.0,75.0,75.0,2,194,0.0,103.0,97.0
30801016.0,17,4,360,2,140,0.0,70.0,70.0,2,220,0.0,110.0,110.0
108116764.0,17,5,1005,5,1005,27029191.0,201.0,201.0,0,0,0.0,0.0,0.0
14632348.0,6,20,1607,10,975,1592537.0,315.0,97.5,10,632,1592535.7777777778,78.0,63.2
22162.0,6,10,2032,5,524,5333.25,252.0,104.8,5,1508,3139.25,1236.0,301.6
1301611.0,6,4,264,2,132,0.0,66.0,66.0,2,132,0.0,66.0,66.0
94784186.0,17,12,778,6,389,18800205.8,174.0,64.83333333333333,6,389,18801332.4,174.0,64.83333333333333
121243245.0,17,14,864,7,432,17000137.833333332,174.0,61.71428571428572,7,432,17001353.0,174.0,61.71428571428572
143920.0,17,2,180,1,90,0.0,90.0,90.0,1,90,0.0,90.0,90.0
790.0,17,4,438,2,148,0.0,74.0,74.0,2,290,0.0,147.0,145.0
206913.0,6,3,426,2,280,0.0,214.0,140.0,1,146,0.0,146.0,146.0
60212227.0,17,8,344,4,172,20001345.0,43.0,43.0,4,172,20000205.33333333,43.0,43.0
120003067.0,6,24,1829,13,989,9999994.333333334,95.0,76.07692307692308,11,840,12000035.8,95.0,76.36363636363636
108102350.0,17,5,955,5,955,27025587.5,191.0,191.0,0,0,0.0,0.0,0.0
102985885.0,17,13,952,7,563,17164314.166666668,174.0,80.42857142857143,6,389,16706073.0,174.0,64.83333333333333
118037392.0,6,30,1974,15,1026,8415867.142857144,123.0,68.4,15,948,8415867.857142856,123.0,63.2
4162.0,17,2,614,1,72,0.0,72.0,72.0,1,542,0.0,542.0,542.0
0.0,6,1,54,0,0,0.0,0.0,0.0,1,54,0.0,54.0,54.0
31835.000000000004,6,10,2032,5,524,7736.5,252.0,104.8,5,1508,7204.5,1236.0,301.6
2693978.0,6,2,132,1,66,0.0,66.0,66.0,1,66,0.0,66.0,66.0
90065063.0,17,28,13364,28,13364,3335743.074074074,501.0,477.2857142857143,0,0,0.0,0.0,0.0
314.0,17,2,174,1,79,0.0,79.0,79.0,1,95,0.0,95.0,95.0
1536497.0,6,3,198,2,132,0.0,66.0,66.0,1,66,0.0,66.0,66.0
514248.00000000006,6,3,204,1,68,0.0,68.0,68.0,2,136,0.0,70.0,68.0
307430.0,17,4,1400,4,1400,102476.66666666669,350.0,350.0,0,0,0.0,0.0,0.0
47011.0,6,14,4740,7,653,7369.5,249.0,93.28571428571428,7,4087,7668.0,1514.0,583.8571428571429
156372.0,17,2,180,1,90,0.0,90.0,90.0,1,90,0.0,90.0,90.0
9333.0,6,10,1067,5,536,2170.25,264.0,107.2,5,531,2132.5,259.0,106.2
42133.0,6,14,4740,7,653,6865.0,249.0,93.28571428571428,7,4087,6729.833333333333,1514.0,583.8571428571429
103021.0,17,2,286,2,286,0.0,143.0,143.0,0,0,0.0,0.0,0.0
32285.0,17,4,823,2,163,0.0,89.0,81.5,2,660,0.0,443.0,330.0
120401490.0,6,223,25262,112,17640,1084698.1081081082,284.0,157.5,111,7622,1085144.5818181818,140.0,68.66666666666667
3491.0,17,4,438,2,148,0.0,74.0,74.0,2,290,0.0,147.0,145.0
120080390.0,17,28,13364,28,13364,4447421.851851852,501.0,477.2857142857143,0,0,0.0,0.0,0.0
90257616.0,6,12,1832,8,1016,12893945.142857144,188.0,127.0,4,816,30031488.666666668,204.0,204.0
189377.0,17,2,180,1,90,0.0,90.0,90.0,1,90,0.0,90.0,90.0
108940410.0,6,28,1860,14,966,8363425.0,123.0,69.0,14,894,8363429.0,123.0,63.85714285714285
316130.0,17,4,1400,4,1400,105376.66666666669,350.0,350.0,0,0,0.0,0.0,0.0
17197.0,6,20,7606,11,978,1719.7,310.0,88.9090909090909,9,6628,1898.625,1514.0,736.4444444444445
99802158.0,6,40,2640,20,1320,5252745.157894737,66.0,66.0,20,1320,5238405.315789473,66.0,66.0
105541.0,17,2,762,2,762,0.0,381.0,381.0,0,0,0.0,0.0,0.0
328878.0,17,4,1400,4,1400,109626.0,350.0,350.0,0,0,0.0,0.0,0.0
237022.0,6,3,373,2,238,0.0,172.0,119.0,1,135,0.0,135.0,135.0
103402.0,17,2,286,2,286,0.0,143.0,143.0,0,0,0.0,0.0,0.0
232918.0,6,3,337,2,214,0.0,160.0,107.0,1,123,0.0,123.0,123.0
120071144.0,6,236,26644,118,8084,1010477.2735042736,140.0,68.50847457627118,118,18560,1018797.3162393162,284.0,157.28813559322035
35217.0,6,14,4740,7,653,5743.166666666667,249.0,93.28571428571428,7,4087,4901.0,1514.0,583.8571428571429
10519654.0,6,7,478,4,272,3461162.6666666665,74.0,68.0,3,206,5191611.5,74.0,68.66666666666667
304179.0,6,6,412,4,272,101393.0,74.0,68.0,2,140,0.0,74.0,70.0
143934.0,17,2,180,1,90,0.0,90.0,90.0,1,90,0.0,90.0,90.0
3044240.0,6,4,270,3,202,1522120.0,70.0,67.33333333333333,1,68,0.0,68.0,68.0
3199.0,17,2,246,1,76,0.0,76.0,76.0,1,170,0.0,170.0,170.0
93541441.0,6,40,2640,20,1320,4923233.736842105,66.0,66.0,20,1320,4908895.631578947,66.0,66.0
311564.0,17,4,1400,4,1400,103854.66666666669,350.0,350.0,0,0,0.0,0.0,0.0
401.0,17,2,410,1,78,0.0,78.0,78.0,1,332,0.0,332.0,332.0
25794.0,6,10,2032,5,524,5690.5,252.0,104.8,5,1508,5842.0,1236.0,301.6
205702.0,17,2,180,1,90,0.0,90.0,90.0,1,90,0.0,90.0,90.0
12128.0,6,10,1065,5,534,2742.75,262.0,106.8,5,531,2719.75,259.0,106.2
10460356.0,6,7,478,4,272,3441139.6666666665,74.0,68.0,3,206,5161596.0,74.0,68.66666666666667
99892886.0,6,245,28206,123,8340,818794.1475409836,140.0,67.8048780487805,122,19866,817931.5454545454,284.0,162.8360655737705
110773006.0,6,32,2289,16,1140,7384867.066666666,123.0,71.25,16,1149,7370389.2,123.0,71.8125
144927.0,6,2,132,1,66,0.0,66.0,66.0,1,66,0.0,66.0,66.0
56196.0,6,14,4740,7,653,9051.833333333334,249.0,93.28571428571428,7,4087,9227.833333333334,1514.0,583.8571428571429
153533.0,17,2,180,1,90,0.0,90.0,90.0,1,90,0.0,90.0,90.0
10598.0,6,10,2032,5,524,2426.25,252.0,104.8,5,1508,2413.5,1236.0,301.6
90570843.0,6,26,1746,13,906,7529590.0,123.0,69.6923076923077,13,840,7529588.083333333,123.0,64.61538461538461
146091.0,6,3,337,2,214,0.0,160.0,107.0,1,123,0.0,123.0,123.0
14633861.0,6,20,1607,10,975,1592718.111111111,315.0,97.5,10,632,1592689.4444444445,78.0,63.2
90531683.0,6,13,2036,8,1016,12933097.57142857,188.0,127.0,5,1020,22591554.0,204.0,204.0
1035911.0,6,11,1134,6,558,207182.2,220.0,93.0,5,576,255385.75,304.0,115.2
236919.0,6,3,337,2,214,0.0,160.0,107.0,1,123,0.0,123.0,123.0
23069.0,6,10,2032,5,524,5549.5,252.0,104.8,5,1508,5488.75,1236.0,301.6
1024157.0,6,11,1134,6,558,204831.4,220.0,93.0,5,576,255180.75,304.0,115.2
366.0,17,2,267,1,83,0.0,83.0,83.0,1,184,0.0,184.0,184.0
873613.0,6,10,1336,6,799,174722.6,461.0,133.16666666666666,4,537,199274.0,331.0,134.25
277220.0,17,2,363,1,79,0.0,79.0,79.0,1,284,0.0,284.0,284.0
128813358.0,17,14,864,7,432,18166829.166666668,174.0,61.71428571428572,7,432,18167473.33333333,174.0,61.71428571428572
90298656.0,6,16,1192,8,596,12893902.0,95.0,74.5,8,596,12899384.857142856,95.0,74.5
74612758.0,6,9,842,9,842,9326594.75,97.0,93.55555555555556,0,0,0.0,0.0,0.0
14816.0,6,11,2098,6,590,2835.8,252.0,98.33333333333331,5,1508,3344.5,1236.0,301.6
198222.0,17,4,6056,4,6056,66074.0,1514.0,1514.0,0,0,0.0,0.0,0.0
1202369.0,6,13,3014,8,2386,171767.0,1514.0,298.25,5,628,231661.0,331.0,125.6
120233753.0,6,18,1382,9,691,14999826.5,95.0,76.77777777777777,9,691,15023420.375,95.0,76.77777777777777
701.0,17,4,438,2,148,0.0,74.0,74.0,2,290,0.0,147.0,145.0
103424.0,17,2,286,2,286,0.0,143.0,143.0,0,0,0.0,0.0,0.0
328388.0,17,4,1400,4,1400,109462.66666666669,350.0,350.0,0,0,0.0,0.0,0.0
217913.0,6,3,426,2,280,0.0,214.0,140.0,1,146,0.0,146.0,146.0
300.0,17,2,156,1,78,0.0,78.0,78.0,1,78,0.0,78.0,78.0
90052730.0,17,28,13364,28,13364,3335286.296296296,501.0,477.2857142857143,0,0,0.0,0.0,0.0
113540399.0,6,48,3168,24,1584,4936539.0869565215,66.0,66.0,24,1584,4924702.739130435,66.0,66.0
67709.0,6,14,4740,7,653,10911.333333333334,249.0,93.28571428571428,7,4087,9812.666666666666,1514.0,583.8571428571429
40887.0,6,14,4740,7,653,6635.0,249.0,93.28571428571428,7,4087,6575.833333333333,1514.0,583.8571428571429
233024.0,6,3,337,2,214,0.0,160.0,107.0,1,123,0.0,123.0,123.0
21894.0,17,2,582,1,83,0.0,83.0,83.0,1,499,0.0,499.0,499.0
2458.0,17,4,344,2,150,0.0,75.0,75.0,2,194,0.0,103.0,97.0
20941.0,6,14,4740,7,653,3017.0,249.0,93.28571428571428,7,4087,3344.5,1514.0,583.8571428571429
99517.0,17,2,762,2,762,0.0,381.0,381.0,0,0,0.0,0.0,0.0
2334.0,17,4,344,2,150,0.0,75.0,75.0,2,194,0.0,103.0,97.0
216924.0,6,3,426,2,280,0.0,214.0,140.0,1,146,0.0,146.0,146.0
99927674.0,6,24,1500,12,783,9064765.090909092,123.0,65.25,12,717,9064768.181818182,123.0,59.75
1732.0,17,6,1230,3,234,566.0,78.0,78.0,3,996,656.0,332.0,332.0
136845.0,6,2,132,1,66,0.0,66.0,66.0,1,66,0.0,66.0,66.0
296263.0,6,6,412,4,272,98754.33333333331,74.0,68.0,2,140,0.0,74.0,70.0
146784.0,6,3,337,2,214,0.0,160.0,107.0,1,123,0.0,123.0,123.0
307280.0,6,6,412,4,272,102426.66666666669,74.0,68.0,2,140,0.0,74.0,70.0
14952.0,17,2,180,1,90,0.0,90.0,90.0,1,90,0.0,90.0,90.0
107385.0,17,2,286,2,286,0.0,143.0,143.0,0,0,0.0,0.0,0.0
204417.0,17,2,762,2,762,0.0,381.0,381.0,0,0,0.0,0.0,0.0
43939.0,6,14,4740,7,653,6896.833333333333,249.0,93.28571428571428,7,4087,7110.166666666667,1514.0,583.8571428571429
20317.0,17,2,582,1,83,0.0,83.0,83.0,1,499,0.0,499.0,499.0
2290.0,17,4,344,2,150,0.0,75.0,75.0,2,194,0.0,103.0,97.0
308683.0,6,6,412,4,272,102894.33333333331,74.0,68.0,2,140,0.0,74.0,70.0
251166.0,6,3,373,2,238,0.0,172.0,119.0,1,135,0.0,135.0,135.0
1106694.0,6,13,1386,7,789,184449.0,253.0,112.71428571428572,6,597,218750.0,259.0,99.5
102151.0,17,2,762,2,762,0.0,381.0,381.0,0,0,0.0,0.0,0.0
90256212.0,6,12,1832,8,1016,12893744.57142857,188.0,127.0,4,816,30026609.0,204.0,204.0
58921417.0,17,9,3086,8,2736,5108002.428571428,342.0,342.0,1,350,0.0,350.0,350.0
90202124.0,6,16,1192,8,596,12851659.285714284,95.0,74.5,8,596,12856705.857142856,95.0,74.5
2262.0,17,4,344,2,150,0.0,75.0,75.0,2,194,0.0,103.0,97.0
3002618.0,6,3,1604,2,851,0.0,785.0,425.5,1,753,0.0,753.0,753.0
206696.0,17,2,180,1,90,0.0,90.0,90.0,1,90,0.0,90.0,90.0
298651.0,6,6,412,4,272,99550.33333333331,74.0,68.0,2,140,0.0,74.0,70.0
162627.0,6,3,337,2,214,0.0,160.0,107.0,1,123,0.0,123.0,123.0
1542753.0,6,4,276,2,128,0.0,74.0,64.0,2,148,0.0,74.0,74.0
92443254.0,6,28,2008,14,1045,7094428.307692308,139.0,74.64285714285714,14,963,7094426.230769231,123.0,68.78571428571429
108111210.0,17,5,1005,5,1005,27027802.5,201.0,201.0,0,0,0.0,0.0,0.0
120118174.0,6,15,2444,7,1428,20019695.666666668,204.0,204.0,8,1016,17097001.0,188.0,127.0
2329.0,17,4,344,2,150,0.0,75.0,75.0,2,194,0.0,103.0,97.0
15008.0,17,2,180,1,90,0.0,90.0,90.0,1,90,0.0,90.0,90.0
269653.0,6,10,1221,6,636,53930.6,298.0,106.0,4,585,84092.33333333333,379.0,146.25
124148.0,17,4,1400,4,1400,41382.66666666666,350.0,350.0,0,0,0.0,0.0,0.0
348091.0,6,3,1604,2,851,0.0,785.0,425.5,1,753,0.0,753.0,753.0
10867383.0,6,8,544,4,272,3576858.6666666665,74.0,68.0,4,272,3576801.333333333,74.0,68.0
126643984.0,17,15,1169,7,563,17822538.333333332,174.0,80.42857142857143,8,606,18069130.0,174.0,75.75
56638.0,6,14,4740,7,653,9237.0,249.0,93.28571428571428,7,4087,6844.666666666667,1514.0,583.8571428571429
232452.0,6,3,337,2,214,0.0,160.0,107.0,1,123,0.0,123.0,123.0
260391.0,6,3,337,2,214,0.0,160.0,107.0,1,123,0.0,123.0,123.0
206088.0,6,3,426,2,280,0.0,214.0,140.0,1,146,0.0,146.0,146.0
108100750.0,17,5,1005,5,1005,27025187.5,201.0,201.0,0,0,0.0,0.0,0.0
338807.0,6,3,1604,1,753,0.0,753.0,753.0,2,851,0.0,785.0,425.5
160957.0,17,2,762,2,762,0.0,381.0,381.0,0,0,0.0,0.0,0.0
40157.0,6,14,4740,7,653,6566.5,249.0,93.28571428571428,7,4087,6559.5,1514.0,583.8571428571429
58705715.0,17,9,3086,8,2736,5105831.714285715,342.0,342.0,1,350,0.0,350.0,350.0
2460755.0,6,32,10926,18,3951,144750.29411764705,1514.0,219.5,14,6975,170189.46153846153,1514.0,498.2142857142857
108109971.0,17,5,1005,5,1005,27027492.75,201.0,201.0,0,0,0.0,0.0,0.0
95950440.0,6,175,19716,88,6030,1102878.6206896552,140.0,68.52272727272727,87,13686,1103660.1860465116,284.0,157.31034482758622
205038.0,17,2,762,2,762,0.0,381.0,381.0,0,0,0.0,0.0,0.0
305829.0,17,2,238,1,74,0.0,74.0,74.0,1,164,0.0,164.0,164.0
40702.0,6,14,4740,7,653,6485.5,249.0,93.28571428571428,7,4087,6528.833333333333,1514.0,583.8571428571429
310265.0,17,4,1400,4,1400,103421.66666666669,350.0,350.0,0,0,0.0,0.0,0.0
114377371.0,6,34,2350,17,1225,7135084.25,139.0,72.05882352941177,17,1125,7135086.25,123.0,66.17647058823529
47584.0,6,14,4740,7,653,7767.166666666667,249.0,93.28571428571428,7,4087,5950.5,1514.0,583.8571428571429
25963.0,6,14,4740,7,653,3656.3333333333335,249.0,93.28571428571428,7,4087,4191.0,1514.0,583.8571428571429
38034.0,6,14,4740,7,653,5889.666666666667,249.0,93.28571428571428,7,4087,5634.666666666667,1514.0,583.8571428571429
146182.0,6,3,337,2,214,0.0,160.0,107.0,1,123,0.0,123.0,123.0
90094114.0,6,13,1776,6,948,18018625.2,204.0,158.0,7,828,15015290.333333334,188.0,118.28571428571428
2479.0,17,4,344,2,150,0.0,75.0,75.0,2,194,0.0,103.0,97.0
98000761.0,17,11,735,6,389,19600152.2,174.0,64.83333333333333,5,346,20062042.75,174.0,69.2
101000995.0,17,14,864,7,432,16833499.166666668,174.0,61.71428571428572,7,432,16667349.666666666,174.0,61.71428571428572
270749.0,17,2,180,1,90,0.0,90.0,90.0,1,90,0.0,90.0,90.0
90260081.0,6,12,1832,8,1016,12894297.285714284,188.0,127.0,4,816,30032674.0,204.0,204.0
359.0,17,2,166,1,75,0.0,75.0,75.0,1,91,0.0,91.0,91.0
308801.0,6,6,412,4,272,102933.66666666669,74.0,68.0,2,140,0.0,74.0,70.0
54591.0,6,14,4740,7,653,8968.833333333334,249.0,93.28571428571428,7,4087,7564.166666666667,1514.0,583.8571428571429
108471.0,17,2,286,2,286,0.0,143.0,143.0,0,0,0.0,0.0,0.0
68640.0,6,14,4740,7,653,10838.166666666666,249.0,93.28571428571428,7,4087,9804.0,1514.0,583.8571428571429
57692.0,6,10,2032,5,524,12466.5,252.0,104.8,5,1508,13562.75,1236.0,301.6
7534.0,17,2,582,1,83,0.0,83.0,83.0,1,499,0.0,499.0,499.0
108757.0,17,2,286,2,286,0.0,143.0,143.0,0,0,0.0,0.0,0.0
90269179.0,6,13,2036,8,1016,12895597.0,188.0,127.0,5,1020,22526827.0,204.0,204.0
10537649.0,6,7,478,4,272,3466753.333333333,74.0,68.0,3,206,5200007.0,74.0,68.66666666666667
1189121.0,6,13,3000,8,2372,169874.42857142858,1514.0,296.5,5,628,228374.5,331.0,125.6
119352455.0,17,34,16284,34,16284,3616741.060606061,501.0,478.9411764705882,0,0,0.0,0.0,0.0
147084.0,6,3,373,2,238,0.0,172.0,119.0,1,135,0.0,135.0,135.0
107832897.0,6,28,1860,14,966,8278222.307692308,123.0,69.0,14,894,8278220.923076923,123.0,63.85714285714285
4321880.0,6,188,153027,106,143313,41160.76190476191,1510.0,1352.0094339622642,82,9714,49465.92592592593,1510.0,118.46341463414636
120117639.0,6,13,2036,5,1020,30029409.75,204.0,204.0,8,1016,17136420.57142857,188.0,127.0
120045576.0,17,28,13364,28,13364,4446132.444444444,501.0,477.2857142857143,0,0,0.0,0.0,0.0
33919.0,6,10,2032,5,524,8098.75,252.0,104.8,5,1508,8213.0,1236.0,301.6
135129878.0,17,6,1146,6,1146,27025975.6,191.0,191.0,0,0,0.0,0.0,0.0
5638637.0,6,5,336,2,134,0.0,68.0,67.0,3,202,1530346.5,70.0,67.33333333333333
100010063.0,17,12,516,6,258,20000179.4,43.0,43.0,6,258,20001014.2,43.0,43.0
298561.0,6,6,412,4,272,99520.33333333331,74.0,68.0,2,140,0.0,74.0,70.0
108106198.0,17,5,955,5,955,27026549.5,191.0,191.0,0,0,0.0,0.0,0.0
90027496.0,17,27,12943,27,12943,3462596.0,501.0,479.3703703703704,0,0,0.0,0.0,0.0
233002.0,6,3,337,2,214,0.0,160.0,107.0,1,123,0.0,123.0,123.0
311362.0,17,4,1400,4,1400,103787.33333333331,350.0,350.0,0,0,0.0,0.0,0.0
277380.0,17,2,363,1,79,0.0,79.0,79.0,1,284,0.0,284.0,284.0
1315880.0,6,4,264,2,132,0.0,66.0,66.0,2,132,0.0,66.0,66.0
319.0,17,2,174,1,79,0.0,79.0,79.0,1,95,0.0,95.0,95.0
90016346.0,17,27,12943,27,12943,3462167.153846154,501.0,479.3703703703704,0,0,0.0,0.0,0.0
572.0,17,2,508,2,508,0.0,257.0,254.0,0,0,0.0,0.0,0.0
209473.0,17,2,180,1,90,0.0,90.0,90.0,1,90,0.0,90.0,90.0
502205.0,6,4,270,2,134,0.0,68.0,67.0,2,136,0.0,70.0,68.0
90061999.0,17,28,13364,28,13364,3335629.592592593,501.0,477.2857142857143,0,0,0.0,0.0,0.0
3078009.0,6,4,270,2,134,0.0,68.0,67.0,2,136,0.0,70.0,68.0
26134.0,6,10,2032,5,524,6288.25,252.0,104.8,5,1508,5798.5,1236.0,301.6
63408.00000000001,6,14,4740,7,653,10329.166666666666,249.0,93.28571428571428,7,4087,9708.666666666666,1514.0,583.8571428571429
299468.0,6,6,412,4,272,99822.66666666669,74.0,68.0,2,140,0.0,74.0,70.0
2276296.0,6,49,23728,25,19797,94845.66666666669,1514.0,791.88,24,3931,89703.0,1514.0,163.79166666666666
90527788.0,6,13,2036,8,1016,12932541.142857144,188.0,127.0,5,1020,22589884.75,204.0,204.0
2242.0,17,2,664,1,322,0.0,322.0,322.0,1,342,0.0,342.0,342.0
90023226.0,17,28,13364,28,13364,3334193.5555555555,501.0,477.2857142857143,0,0,0.0,0.0,0.0
110962.0,17,2,762,2,762,0.0,381.0,381.0,0,0,0.0,0.0,0.0
90281172.0,6,16,1192,8,596,12891046.57142857,95.0,74.5,8,596,12896167.285714284,95.0,74.5
70547.0,6,10,2032,5,524,16978.5,252.0,104.8,5,1508,17349.75,1236.0,301.6
64402.0,6,14,4740,7,653,9485.166666666666,249.0,93.28571428571428,7,4087,7582.166666666667,1514.0,583.8571428571429
146950.0,6,3,337,2,214,0.0,160.0,107.0,1,123,0.0,123.0,123.0
91468227.0,6,26,1762,13,922,7604377.083333333,139.0,70.92307692307692,13,840,7604377.0,123.0,64.61538461538461
96079434.0,17,12,1040,6,520,19184105.6,174.0,86.66666666666667,6,520,19184107.6,174.0,86.66666666666667
104000963.0,17,14,1126,7,563,17333493.833333332,174.0,80.42857142857143,7,563,17171925.166666668,174.0,80.42857142857143
120669760.0,6,22,1680,11,840,12066976.0,95.0,76.36363636363636,11,840,9043137.2,95.0,76.36363636363636
2356.0,17,4,344,2,150,0.0,75.0,75.0,2,194,0.0,103.0,97.0
324740.0,17,2,180,1,90,0.0,90.0,90.0,1,90,0.0,90.0,90.0
51082.0,17,2,180,1,90,0.0,90.0,90.0,1,90,0.0,90.0,90.0
115321132.0,6,211,23856,106,7218,1098296.4952380953,140.0,68.09433962264151,105,16638,1099012.0192307692,284.0,158.45714285714286
90258942.0,6,15,2168,8,1016,12894134.57142857,188.0,127.0,7,1152,15016051.666666666,204.0,164.57142857142858
46673.0,6,14,4740,7,653,6318.666666666667,249.0,93.28571428571428,7,4087,7268.166666666667,1514.0,583.8571428571429
207514.0,6,3,426,2,280,0.0,214.0,140.0,1,146,0.0,146.0,146.0
896006.0,6,12,2709,7,742,149334.33333333334,338.0,106.0,5,1967,155853.25,1514.0,393.4
3227569.0,6,147,124420,88,116224,37098.49425287356,1510.0,1320.7272727272727,59,8196,50399.93103448276,1510.0,138.91525423728814
103069.0,17,2,286,2,286,0.0,143.0,143.0,0,0,0.0,0.0,0.0
219114.0,6,3,426,2,280,0.0,214.0,140.0,1,146,0.0,146.0,146.0
153452.0,17,2,180,1,90,0.0,90.0,90.0,1,90,0.0,90.0,90.0
803.0,17,4,438,2,148,0.0,74.0,74.0,2,290,0.0,147.0,145.0
218892.0,6,3,426,2,280,0.0,214.0,140.0,1,146,0.0,146.0,146.0
45752.0,6,10,2032,5,524,11228.5,252.0,104.8,5,1508,8568.75,1236.0,301.6
2317.0,17,4,344,2,150,0.0,75.0,75.0,2,194,0.0,103.0,97.0
297495.0,6,6,412,4,272,99165.0,74.0,68.0,2,140,0.0,74.0,70.0
237351.0,17,2,180,1,90,0.0,90.0,90.0,1,90,0.0,90.0,90.0
184713.0,17,2,180,1,90,0.0,90.0,90.0,1,90,0.0,90.0,90.0
5827948.0,6,4,270,2,134,0.0,68.0,67.0,2,136,0.0,70.0,68.0
2651544.0,6,25,7573,14,3735,203964.92307692303,1514.0,266.7857142857143,11,3838,239221.0,1514.0,348.90909090909093
143875.0,17,2,180,1,90,0.0,90.0,90.0,1,90,0.0,90.0,90.0
29774.0,6,10,2032,5,524,6384.25,252.0,104.8,5,1508,5878.0,1236.0,301.6
232936.0,6,3,337,2,214,0.0,160.0,107.0,1,123,0.0,123.0,123.0
196975.0,17,2,180,1,90,0.0,90.0,90.0,1,90,0.0,90.0,90.0
6356.0,17,4,344,2,150,0.0,75.0,75.0,2,194,0.0,103.0,97.0
2369.0,17,4,344,2,150,0.0,75.0,75.0,2,194,0.0,103.0,97.0
113254694.0,6,46,3036,23,1518,5135434.7727272725,66.0,66.0,23,1518,5135420.954545454,66.0,66.0
148056.0,17,2,180,1,90,0.0,90.0,90.0,1,90,0.0,90.0,90.0
37379.0,6,20,7606,11,978,3737.9,310.0,88.9090909090909,9,6628,4420.875,1514.0,736.4444444444445
62623.0,6,14,4740,7,653,9695.333333333334,249.0,93.28571428571428,7,4087,9527.666666666666,1514.0,583.8571428571429
2188.0,17,4,344,2,150,0.0,75.0,75.0,2,194,0.0,103.0,97.0
251261.0,6,10,1221,6,636,50252.2,298.0,106.0,4,585,78308.33333333333,379.0,146.25
120000059.0,6,26,2906,13,1451,10000004.916666666,427.0,111.6153846153846,13,1455,7523775.0,360.0,111.92307692307692
108135591.0,17,5,1005,5,1005,27033897.75,201.0,201.0,0,0,0.0,0.0,0.0
4234.0,17,2,614,1,72,0.0,72.0,72.0,1,542,0.0,542.0,542.0
24042.0,6,14,4740,7,653,3171.6666666666665,249.0,93.28571428571428,7,4087,3861.1666666666665,1514.0,583.8571428571429
233869.0,6,3,337,2,214,0.0,160.0,107.0,1,123,0.0,123.0,123.0
300284.0,6,6,412,4,272,100094.66666666669,74.0,68.0,2,140,0.0,74.0,70.0
2629016.0,6,25,7573,14,3735,202232.0,1514.0,266.7857142857143,11,3838,236392.7,1514.0,348.90909090909093
90007572.0,17,28,13364,28,13364,3333613.777777778,501.0,477.2857142857143,0,0,0.0,0.0,0.0
135135041.0,17,6,1146,6,1146,27027008.2,191.0,191.0,0,0,0.0,0.0,0.0
0.0,6,1,66,1,66,0.0,66.0,66.0,0,0,0.0,0.0,0.0
197160.0,17,2,180,1,90,0.0,90.0,90.0,1,90,0.0,90.0,90.0
28314.0,6,13,1386,7,789,4539.5,253.0,112.71428571428572,6,597,4500.8,259.0,99.5
103922.0,17,2,286,2,286,0.0,143.0,143.0,0,0,0.0,0.0,0.0
90292279.0,6,16,1192,8,596,12892438.285714284,95.0,74.5,8,596,12898377.142857144,95.0,74.5
179847.0,17,2,180,1,90,0.0,90.0,90.0,1,90,0.0,90.0,90.0
42553.0,6,14,4740,7,653,6251.333333333333,249.0,93.28571428571428,7,4087,6895.166666666667,1514.0,583.8571428571429
1514322.0,6,4,492,2,280,0.0,214.0,140.0,2,212,0.0,146.0,106.0
93729723.0,6,186,21030,93,6360,1010036.8804347826,140.0,68.38709677419355,93,14670,1009848.0326086956,300.0,157.74193548387098
29669.0,6,14,4740,7,653,4357.333333333333,249.0,93.28571428571428,7,4087,4758.5,1514.0,583.8571428571429
103134587.0,6,32,2220,16,1149,6861239.066666666,123.0,71.8125,16,1071,6861240.0,123.0,66.9375
162326.0,17,2,180,1,90,0.0,90.0,90.0,1,90,0.0,90.0,90.0
3168429.0,6,18,1495,9,921,358366.875,315.0,102.33333333333331,9,574,358205.625,78.0,63.77777777777778
120121500.0,6,13,2036,5,1020,30030375.0,204.0,204.0,8,1016,17136997.0,188.0,127.0
90036708.0,17,28,13364,28,13364,3334692.888888889,501.0,477.2857142857143,0,0,0.0,0.0,0.0
90295605.0,6,17,1287,9,691,11281691.875,95.0,76.77777777777777,8,596,12897412.42857143,95.0,74.5
514816.00000000006,6,5,367,2,132,0.0,66.0,66.0,3,235,257408.00000000003,103.0,78.33333333333333
27910.0,6,14,4740,7,653,4424.5,249.0,93.28571428571428,7,4087,4245.833333333333,1514.0,583.8571428571429
32680863.000000004,6,5,336,2,134,0.0,68.0,67.0,3,202,14949817.0,70.0,67.33333333333333
90274891.0,6,13,2036,8,1016,12896413.0,188.0,127.0,5,1020,22524368.75,204.0,204.0
317210.0,6,6,412,4,272,105736.66666666669,74.0,68.0,2,140,0.0,74.0,70.0
307276.0,6,6,412,4,272,102425.33333333331,74.0,68.0,2,140,0.0,74.0,70.0
38897004.0,6,4,270,3,202,19448502.0,70.0,67.33333333333333,1,68,0.0,68.0,68.0
322664.0,17,4,1400,4,1400,107554.66666666669,350.0,350.0,0,0,0.0,0.0,0.0
196834.0,17,2,180,1,90,0.0,90.0,90.0,1,90,0.0,90.0,90.0
2353.0,17,4,344,2,150,0.0,75.0,75.0,2,194,0.0,103.0,97.0
120137730.0,6,228,25644,114,7820,1055911.203539823,140.0,68.59649122807018,114,17824,1055830.2300884956,284.0,156.35087719298247
108359.0,17,2,286,2,286,0.0,143.0,143.0,0,0,0.0,0.0,0.0
31613.000000000004,6,14,4740,7,653,5059.666666666667,249.0,93.28571428571428,7,4087,5084.833333333333,1514.0,583.8571428571429
9987.0,17,2,582,1,83,0.0,83.0,83.0,1,499,0.0,499.0,499.0
69634.0,6,14,4740,7,653,11024.0,249.0,93.28571428571428,7,4087,11466.166666666666,1514.0,583.8571428571429
22290.0,6,20,7606,11,978,2229.0,310.0,88.9090909090909,9,6628,1962.25,1514.0,736.4444444444445
69434.0,17,2,626,1,72,0.0,72.0,72.0,1,554,0.0,554.0,554.0
108112237.0,17,5,1005,5,1005,27028059.25,201.0,201.0,0,0,0.0,0.0,0.0
2795772.0,6,2,132,1,66,0.0,66.0,66.0,1,66,0.0,66.0,66.0
150011318.0,17,36,17126,36,17126,4286037.657142857,501.0,475.72222222222223,0,0,0.0,0.0,0.0
120299521.0,6,233,26334,117,18456,1037064.8362068966,284.0,157.74358974358975,116,7878,1038070.8608695652,140.0,67.91379310344827
47611031.0,6,8,1940,3,887,22539072.5,753.0,295.6666666666667,5,1053,11207761.25,785.0,210.6
44743.0,6,10,2032,5,524,10947.5,252.0,104.8,5,1508,10294.75,1236.0,301.6
101114108.0,6,220,24884,110,17402,925666.4403669724,284.0,158.2,110,7482,925666.018348624,140.0,68.01818181818182
317276.0,17,4,1400,4,1400,105758.66666666669,350.0,350.0,0,0,0.0,0.0,0.0
54736.0,6,10,2032,5,524,13079.75,252.0,104.8,5,1508,11566.25,1236.0,301.6
120000030.0,6,17,1287,9,691,15000003.75,95.0,76.77777777777777,8,596,12897396.42857143,95.0,74.5
216991.0,17,2,180,1,90,0.0,90.0,90.0,1,90,0.0,90.0,90.0
5005397.0,17,4,849,2,166,0.0,83.0,83.0,2,683,0.0,499.0,341.5
306002.0,6,6,412,4,272,102000.66666666669,74.0,68.0,2,140,0.0,74.0,70.0
1565013.0,6,2,132,1,66,0.0,66.0,66.0,1,66,0.0,66.0,66.0
822.0,17,4,438,2,148,0.0,74.0,74.0,2,290,0.0,147.0,145.0
360.0,17,2,267,1,83,0.0,83.0,83.0,1,184,0.0,184.0,184.0
319853.0,17,4,1400,4,1400,106617.66666666669,350.0,350.0,0,0,0.0,0.0,0.0
43515.0,6,14,4740,7,653,5805.333333333333,249.0,93.28571428571428,7,4087,7097.833333333333,1514.0,583.8571428571429
45266.0,6,10,2032,5,524,11099.75,252.0,104.8,5,1508,10751.0,1236.0,301.6
328.0,17,2,164,1,82,0.0,82.0,82.0,1,82,0.0,82.0,82.0
38365.0,6,10,2032,5,524,8753.0,252.0,104.8,5,1508,8312.0,1236.0,301.6
144007.0,17,2,180,1,90,0.0,90.0,90.0,1,90,0.0,90.0,90.0
155729.0,6,3,337,2,214,0.0,160.0,107.0,1,123,0.0,123.0,123.0
0.0,6,1,66,1,66,0.0,66.0,66.0,0,0,0.0,0.0,0.0
1044054.0,6,11,1134,6,558,208810.8,220.0,93.0,5,576,258376.0,304.0,115.2
293.0,17,2,156,1,78,0.0,78.0,78.0,1,78,0.0,78.0,78.0
120120849.0,6,18,2760,10,1392,13346761.0,188.0,139.2,8,1368,12908707.285714284,204.0,171.0
29694.0,6,14,4740,7,653,4230.0,249.0,93.28571428571428,7,4087,4777.0,1514.0,583.8571428571429
7246.0,17,2,582,1,83,0.0,83.0,83.0,1,499,0.0,499.0,499.0
196938.0,17,2,180,1,90,0.0,90.0,90.0,1,90,0.0,90.0,90.0
120036118.0,17,28,13364,28,13364,4445782.148148148,501.0,477.2857142857143,0,0,0.0,0.0,0.0
52710.0,6,12,1413,6,816,10129.0,291.0,136.0,6,597,8789.2,259.0,99.5
78006.0,6,14,4740,7,653,12787.833333333334,249.0,93.28571428571428,7,4087,12104.333333333334,1514.0,583.8571428571429
37662.0,6,14,4740,7,653,6044.5,249.0,93.28571428571428,7,4087,5755.166666666667,1514.0,583.8571428571429
280601.0,17,2,180,1,90,0.0,90.0,90.0,1,90,0.0,90.0,90.0
32717.000000000004,6,10,2032,5,524,6372.25,252.0,104.8,5,1508,7817.25,1236.0,301.6
507816.00000000006,6,4,270,2,134,0.0,68.0,67.0,2,136,0.0,70.0,68.0
98125.0,17,2,762,2,762,0.0,381.0,381.0,0,0,0.0,0.0,0.0
228191.0,17,2,180,1,90,0.0,90.0,90.0,1,90,0.0,90.0,90.0
302439.0,6,2,132,1,66,0.0,66.0,66.0,1,66,0.0,66.0,66.0
32006.0,6,10,2032,5,524,7589.5,252.0,104.8,5,1508,7207.75,1236.0,301.6
115006685.0,17,14,864,7,432,19167780.83333333,174.0,61.71428571428572,7,432,19166860.166666668,174.0,61.71428571428572
29982.0,6,10,2032,5,524,7250.0,252.0,104.8,5,1508,7148.5,1236.0,301.6
233072.0,6,3,373,2,238,0.0,172.0,119.0,1,135,0.0,135.0,135.0
108108218.0,17,5,955,5,955,27027054.5,191.0,191.0,0,0,0.0,0.0,0.0
2615152.0,6,25,7573,14,3735,201165.53846153847,1514.0,266.7857142857143,11,3838,235390.1,1514.0,348.90909090909093
2020.0,17,4,344,2,150,0.0,75.0,75.0,2,194,0.0,103.0,97.0
50818.0,6,10,1065,5,534,12440.25,262.0,106.8,5,531,11686.75,259.0,106.2
65866.0,6,14,4740,7,653,10859.333333333334,249.0,93.28571428571428,7,4087,10683.333333333334,1514.0,583.8571428571429
216831.0,6,3,426,2,280,0.0,214.0,140.0,1,146,0.0,146.0,146.0
324.0,17,2,166,1,75,0.0,75.0,75.0,1,91,0.0,91.0,91.0
120222753.0,6,24,1788,12,894,10905872.909090908,95.0,74.5,12,894,10904550.636363637,95.0,74.5
21308.0,6,14,4740,7,653,3338.5,249.0,93.28571428571428,7,4087,3374.0,1514.0,583.8571428571429
0.0,17,1,90,1,90,0.0,90.0,90.0,0,0,0.0,0.0,0.0
308464.0,6,6,412,4,272,102821.33333333331,74.0,68.0,2,140,0.0,74.0,70.0
207948.0,6,3,426,2,280,0.0,214.0,140.0,1,146,0.0,146.0,146.0
50835.0,6,10,2032,5,524,11949.75,252.0,104.8,5,1508,11018.0,1236.0,301.6
2312.0,17,4,344,2,150,0.0,75.0,75.0,2,194,0.0,103.0,97.0
4173.0,17,2,598,1,72,0.0,72.0,72.0,1,526,0.0,526.0,526.0
312186.0,17,4,1400,4,1400,104062.0,350.0,350.0,0,0,0.0,0.0,0.0
41180.0,6,14,4740,7,653,5586.166666666667,249.0,93.28571428571428,7,4087,6726.833333333333,1514.0,583.8571428571429
284438.0,17,2,363,1,79,0.0,79.0,79.0,1,284,0.0,284.0,284.0
298097.0,6,6,412,4,272,99365.66666666669,74.0,68.0,2,140,0.0,74.0,70.0
137835.0,6,2,132,1,66,0.0,66.0,66.0,1,66,0.0,66.0,66.0
4338.0,17,2,614,1,72,0.0,72.0,72.0,1,542,0.0,542.0,542.0
3821.0,17,4,344,2,150,0.0,75.0,75.0,2,194,0.0,103.0,97.0
63349346.0,17,11,3770,10,3420,4635359.888888889,342.0,342.0,1,350,0.0,350.0,350.0
90037851.0,17,28,13364,28,13364,3334735.222222222,501.0,477.2857142857143,0,0,0.0,0.0,0.0
90742777.0,6,17,1287,9,691,11337522.5,95.0,76.77777777777777,8,596,12962550.42857143,95.0,74.5
107836223.0,6,28,1860,14,966,8277685.538461538,123.0,69.0,14,894,8277685.230769231,123.0,63.85714285714285
130350.0,6,3,337,2,214,0.0,160.0,107.0,1,123,0.0,123.0,123.0
111633700.0,6,34,2466,17,1272,6963617.125,123.0,74.82352941176471,17,1194,6963621.4375,123.0,70.23529411764706
0.0,17,1,99,1,99,0.0,99.0,99.0,0,0,0.0,0.0,0.0
115865570.0,6,48,3168,24,1584,5037633.478260869,66.0,66.0,24,1584,5028237.739130435,66.0,66.0
100591868.0,6,28,1992,14,963,7737836.0,123.0,68.78571428571429,14,1029,7609585.615384615,123.0,73.5
5608150.0,6,5,336,2,134,0.0,68.0,67.0,3,202,1421980.5,70.0,67.33333333333333
90226053.0,6,16,1192,8,596,12853214.714285716,95.0,74.5,8,596,12858653.714285716,95.0,74.5
251351.0,6,3,337,2,214,0.0,160.0,107.0,1,123,0.0,123.0,123.0
90029574.0,17,28,13364,28,13364,3334428.6666666665,501.0,477.2857142857143,0,0,0.0,0.0,0.0
4815.0,17,2,626,1,72,0.0,72.0,72.0,1,554,0.0,554.0,554.0
209585.0,6,3,426,2,280,0.0,214.0,140.0,1,146,0.0,146.0,146.0
55495.0,6,10,2032,5,524,13545.75,252.0,104.8,5,1508,12940.5,1236.0,301.6
60774.0,6,10,2032,5,524,14980.75,252.0,104.8,5,1508,14934.25,1236.0,301.6
234720.0,6,3,373,2,238,0.0,172.0,119.0,1,135,0.0,135.0,135.0
15128.0,6,11,2098,6,590,2619.0,252.0,98.33333333333331,5,1508,3275.5,1236.0,301.6
232400.0,6,3,337,2,214,0.0,160.0,107.0,1,123,0.0,123.0,123.0
108102910.0,17,5,955,5,955,27025727.5,191.0,191.0,0,0,0.0,0.0,0.0
1300499.0,6,4,264,2,132,0.0,66.0,66.0,2,132,0.0,66.0,66.0
36524.0,6,14,4740,7,653,5895.0,249.0,93.28571428571428,7,4087,5848.5,1514.0,583.8571428571429
92880256.0,6,38,2508,19,1254,5160000.944444444,66.0,66.0,19,1254,5159994.666666667,66.0,66.0
58852.0,6,10,2032,5,524,14496.25,252.0,104.8,5,1508,13026.0,1236.0,301.6
90304050.0,6,16,1192,8,596,12893978.285714284,95.0,74.5,8,596,12899464.57142857,95.0,74.5
304290.0,6,6,412,4,272,101430.0,74.0,68.0,2,140,0.0,74.0,70.0
350.0,17,2,267,1,83,0.0,83.0,83.0,1,184,0.0,184.0,184.0
153473.0,17,2,180,1,90,0.0,90.0,90.0,1,90,0.0,90.0,90.0
53853.0,6,13,1394,7,797,8903.166666666666,253.0,113.85714285714286,6,597,9006.8,259.0,99.5
120116632.0,6,16,2356,9,1204,15014579.0,188.0,133.77777777777777,7,1152,15014164.5,204.0,164.57142857142858
143922.0,17,2,180,1,90,0.0,90.0,90.0,1,90,0.0,90.0,90.0
504347.0,6,5,336,2,134,0.0,68.0,67.0,3,202,193865.0,70.0,67.33333333333333
109114204.0,6,223,25044,112,7688,983010.8468468467,140.0,68.64285714285714,111,17356,983609.9,284.0,156.36036036036035
15993.0,6,14,4740,7,653,2475.5,249.0,93.28571428571428,7,4087,2525.1666666666665,1514.0,583.8571428571429
1307099.0,6,4,264,2,132,0.0,66.0,66.0,2,132,0.0,66.0,66.0
9848.0,17,2,571,1,86,0.0,86.0,86.0,1,485,0.0,485.0,485.0
9184.0,17,4,344,2,150,0.0,75.0,75.0,2,194,0.0,103.0,97.0
144887.0,6,2,132,1,66,0.0,66.0,66.0,1,66,0.0,66.0,66.0
302135.0,6,6,412,4,272,100711.66666666669,74.0,68.0,2,140,0.0,74.0,70.0
108109476.0,17,5,1005,5,1005,27027369.0,201.0,201.0,0,0,0.0,0.0,0.0
135140064.0,17,6,1206,6,1206,27028012.8,201.0,201.0,0,0,0.0,0.0,0.0
112077351.0,17,15,1169,8,606,16011050.142857144,174.0,75.75,7,563,17000105.166666668,174.0,80.42857142857143
196932.0,17,2,180,1,90,0.0,90.0,90.0,1,90,0.0,90.0,90.0
26127024.0,17,5,1718,4,1368,703720.0,342.0,342.0,1,350,0.0,350.0,350.0
117482210.0,6,443,57322,222,42514,531593.7104072399,352.0,191.5045045045045,221,14808,532931.4318181818,140.0,67.00452488687783
120224971.0,6,35,2542,18,1348,7072057.117647059,139.0,74.88888888888889,17,1194,6876584.25,123.0,70.23529411764706
254783.0,6,10,1221,6,636,50956.6,298.0,106.0,4,585,79558.0,379.0,146.25
53376.0,6,11,2098,6,590,9239.2,252.0,98.33333333333331,5,1508,11348.25,1236.0,301.6
205599.0,17,4,6056,4,6056,68533.0,1514.0,1514.0,0,0,0.0,0.0,0.0
41882.0,6,14,4740,7,653,6799.666666666667,249.0,93.28571428571428,7,4087,6340.333333333333,1514.0,583.8571428571429
106145.0,17,2,700,2,700,0.0,350.0,350.0,0,0,0.0,0.0,0.0
113376963.0,6,46,3036,23,1518,5140441.181818182,66.0,66.0,23,1518,5140455.045454546,66.0,66.0
1287853.0,17,7,490,7,490,214642.16666666663,70.0,70.0,0,0,0.0,0.0,0.0
1067756.0,6,11,1134,6,558,213551.2,220.0,93.0,5,576,261442.0,304.0,115.2
1174593.0,6,13,3010,8,2382,167799.0,1514.0,297.75,5,628,224778.0,331.0,125.6
301486.0,6,6,412,4,272,100495.33333333331,74.0,68.0,2,140,0.0,74.0,70.0
90257512.0,6,12,1832,8,1016,12893930.285714284,188.0,127.0,4,816,30031149.33333333,204.0,204.0
135133998.0,17,6,1146,6,1146,27026799.6,191.0,191.0,0,0,0.0,0.0,0.0
92183780.0,6,160,18096,80,12594,1164276.759493671,284.0,157.425,80,5502,1164284.9367088608,140.0,68.775
36189.0,6,14,4740,7,653,4298.166666666667,249.0,93.28571428571428,7,4087,5843.833333333333,1514.0,583.8571428571429
207344.0,6,3,426,2,280,0.0,214.0,140.0,1,146,0.0,146.0,146.0
2023.0,17,4,344,2,150,0.0,75.0,75.0,2,194,0.0,103.0,97.0
10627.0,17,4,823,2,163,0.0,89.0,81.5,2,660,0.0,443.0,330.0
90059643.0,17,28,13364,28,13364,3335542.333333333,501.0,477.2857142857143,0,0,0.0,0.0,0.0
2217.0,17,4,344,2,150,0.0,75.0,75.0,2,194,0.0,103.0,97.0
143965.0,17,2,180,1,90,0.0,90.0,90.0,1,90,0.0,90.0,90.0
41670.0,6,14,4740,7,653,6817.0,249.0,93.28571428571428,7,4087,6024.166666666667,1514.0,583.8571428571429
29416.0,6,14,4740,7,653,4440.0,249.0,93.28571428571428,7,4087,4172.166666666667,1514.0,583.8571428571429
2272.0,17,4,344,2,150,0.0,75.0,75.0,2,194,0.0,103.0,97.0
113254954.0,6,46,3036,23,1518,5135439.727272728,66.0,66.0,23,1518,5135442.545454546,66.0,66.0
437954.0,6,11,1021,6,444,58936.2,162.0,74.0,5,577,73348.5,349.0,115.4
56710390.0,17,9,3086,8,2736,5107873.571428572,342.0,342.0,1,350,0.0,350.0,350.0
15484.0,6,14,4740,7,653,2319.1666666666665,249.0,93.28571428571428,7,4087,2443.0,1514.0,583.8571428571429
6862.0,17,2,582,1,83,0.0,83.0,83.0,1,499,0.0,499.0,499.0
244655.0,6,3,337,2,214,0.0,160.0,107.0,1,123,0.0,123.0,123.0
69841.0,6,14,4740,7,653,11519.666666666666,249.0,93.28571428571428,7,4087,11501.0,1514.0,583.8571428571429
216396.0,17,2,180,1,90,0.0,90.0,90.0,1,90,0.0,90.0,90.0
14638300.0,6,20,1607,10,975,1592789.3333333333,315.0,97.5,10,632,1592772.0,78.0,63.2
103515.0,17,2,286,2,286,0.0,143.0,143.0,0,0,0.0,0.0,0.0
135131570.0,17,6,1146,6,1146,27026314.0,191.0,191.0,0,0,0.0,0.0,0.0
110790000.0,6,31,2176,16,1071,7386000.0,123.0,66.9375,15,1105,7184951.5,139.0,73.66666666666667
103535.0,17,2,700,2,700,0.0,350.0,350.0,0,0,0.0,0.0,0.0
6617.0,17,2,582,1,83,0.0,83.0,83.0,1,499,0.0,499.0,499.0
25561.0,6,10,2032,5,524,6156.0,252.0,104.8,5,1508,5868.0,1236.0,301.6
1307996.0,17,7,490,7,490,217999.3333333333,70.0,70.0,0,0,0.0,0.0,0.0
26650.0,6,14,4740,7,653,4188.666666666667,249.0,93.28571428571428,7,4087,4318.166666666667,1514.0,583.8571428571429
27341749.0,17,5,1710,5,1710,6835437.25,342.0,342.0,0,0,0.0,0.0,0.0
3658359.0,6,5,336,2,134,0.0,68.0,67.0,3,202,1423658.5,70.0,67.33333333333333
209455.0,17,2,180,1,90,0.0,90.0,90.0,1,90,0.0,90.0,90.0
7082.0,17,4,823,2,163,0.0,89.0,81.5,2,660,0.0,443.0,330.0
16347.0,6,14,4740,7,653,2221.0,249.0,93.28571428571428,7,4087,2584.1666666666665,1514.0,583.8571428571429
120048416.0,6,232,26200,116,7952,1037685.3130434784,140.0,68.55172413793103,116,18248,1036722.0695652174,284.0,157.31034482758622
2539718.0,6,3,204,2,136,0.0,70.0,68.0,1,68,0.0,68.0,68.0
109042983.0,6,211,23908,106,16756,1038504.6,284.0,158.0754716981132,105,7152,1039663.4326923076,140.0,68.11428571428571
284893.0,17,2,363,1,79,0.0,79.0,79.0,1,284,0.0,284.0,284.0
160294.0,6,2,128,1,74,0.0,74.0,74.0,1,54,0.0,54.0,54.0
13043.0,6,10,2032,5,524,2819.5,252.0,104.8,5,1508,2871.5,1236.0,301.6
27245.0,6,14,4740,7,653,3618.1666666666665,249.0,93.28571428571428,7,4087,4000.5,1514.0,583.8571428571429
41648.0,6,10,2032,5,524,9682.25,252.0,104.8,5,1508,9927.25,1236.0,301.6
299239.0,6,6,412,4,272,99746.33333333331,74.0,68.0,2,140,0.0,74.0,70.0
2588.0,17,4,344,2,150,0.0,75.0,75.0,2,194,0.0,103.0,97.0
215376.0,6,10,1221,6,636,43075.2,298.0,106.0,4,585,70525.66666666667,379.0,146.25
105597057.0,6,44,2904,22,1452,5028431.285714285,66.0,66.0,22,1452,5015314.80952381,66.0,66.0
105062.0,6,16,5440,9,742,13132.75,206.0,82.44444444444444,7,4698,16065.5,1514.0,671.1428571428571
417.0,17,2,410,1,78,0.0,78.0,78.0,1,332,0.0,332.0,332.0
246557.0,6,3,337,2,214,0.0,160.0,107.0,1,123,0.0,123.0,123.0
51011.0,17,2,180,1,90,0.0,90.0,90.0,1,90,0.0,90.0,90.0
143922.0,17,2,180,1,90,0.0,90.0,90.0,1,90,0.0,90.0,90.0
51347.0,6,14,4740,7,653,7903.5,249.0,93.28571428571428,7,4087,7887.166666666667,1514.0,583.8571428571429
90033724.0,17,28,13364,28,13364,3334582.3703703703,501.0,477.2857142857143,0,0,0.0,0.0,0.0
526984.0,6,5,336,2,134,0.0,68.0,67.0,3,202,207274.5,70.0,67.33333333333333
317521.0,17,4,1400,4,1400,105840.33333333331,350.0,350.0,0,0,0.0,0.0,0.0
38344.0,6,14,4740,7,653,5731.0,249.0,93.28571428571428,7,4087,6052.0,1514.0,583.8571428571429
2057.0,17,4,344,2,150,0.0,75.0,75.0,2,194,0.0,103.0,97.0
13205.0,17,2,180,1,90,0.0,90.0,90.0,1,90,0.0,90.0,90.0
108108322.0,17,5,1005,5,1005,27027080.5,201.0,201.0,0,0,0.0,0.0,0.0
120140259.0,6,222,25180,111,7622,1085653.3545454545,140.0,68.66666666666667,111,17558,1084522.3363636364,284.0,158.18018018018017
48427.0,6,14,4740,7,653,7277.666666666667,249.0,93.28571428571428,7,4087,7808.0,1514.0,583.8571428571429
96003930.0,6,29,2068,15,1105,6842007.357142857,139.0,73.66666666666667,14,963,7368314.307692308,123.0,68.78571428571429
14639671.0,6,19,1553,9,921,1791949.125,315.0,102.33333333333331,10,632,1592794.111111111,78.0,63.2
2464860.0,6,3,1777,1,826,0.0,826.0,826.0,2,951,0.0,885.0,475.5
2588337.0,6,2,132,1,66,0.0,66.0,66.0,1,66,0.0,66.0,66.0
51512.0,6,10,2032,5,524,12630.0,252.0,104.8,5,1508,12118.5,1236.0,301.6
30422.0,6,10,2032,5,524,7352.5,252.0,104.8,5,1508,6456.0,1236.0,301.6
709.0,17,4,438,2,148,0.0,74.0,74.0,2,290,0.0,147.0,145.0
41295.0,6,10,2032,5,524,9928.25,252.0,104.8,5,1508,8397.25,1236.0,301.6
156290.0,6,3,337,2,214,0.0,160.0,107.0,1,123,0.0,123.0,123.0
3051117.0,6,4,270,3,202,1525558.5,70.0,67.33333333333333,1,68,0.0,68.0,68.0
369771.0,17,2,363,1,75,0.0,75.0,75.0,1,288,0.0,288.0,288.0
117297641.0,6,211,23930,106,16704,1117120.3904761905,284.0,157.58490566037736,105,7226,1121535.5096153845,140.0,68.81904761904762
106899.0,17,2,286,2,286,0.0,143.0,143.0,0,0,0.0,0.0,0.0
153464.0,17,2,180,1,90,0.0,90.0,90.0,1,90,0.0,90.0,90.0
49805.0,6,10,2032,5,524,11746.25,252.0,104.8,5,1508,11409.75,1236.0,301.6
2799786.0,6,2,132,1,66,0.0,66.0,66.0,1,66,0.0,66.0,66.0
298762.0,6,6,412,4,272,99587.33333333331,74.0,68.0,2,140,0.0,74.0,70.0
370398.0,6,11,1021,6,444,50794.4,162.0,74.0,5,577,62613.5,349.0,115.4
8195.0,17,2,582,1,83,0.0,83.0,83.0,1,499,0.0,499.0,499.0
5625927.0,6,5,336,2,134,0.0,68.0,67.0,3,202,1513036.0,70.0,67.33333333333333
213548.0,17,2,414,1,88,0.0,88.0,88.0,1,326,0.0,326.0,326.0
13408.0,6,11,2098,6,590,2152.8,252.0,98.33333333333331,5,1508,3010.25,1236.0,301.6
90051275.0,17,28,13364,28,13364,3335232.407407407,501.0,477.2857142857143,0,0,0.0,0.0,0.0
1316018.0,6,4,264,2,132,0.0,66.0,66.0,2,132,0.0,66.0,66.0
45511.0,6,14,4740,7,653,7438.166666666667,249.0,93.28571428571428,7,4087,6856.833333333333,1514.0,583.8571428571429
301384.0,6,6,412,4,272,100461.33333333331,74.0,68.0,2,140,0.0,74.0,70.0
47889.0,6,14,4740,7,653,7791.666666666667,249.0,93.28571428571428,7,4087,4681.0,1514.0,583.8571428571429
2465910.0,6,3,1604,2,851,0.0,785.0,425.5,1,753,0.0,753.0,753.0
2401.0,17,4,344,2,150,0.0,75.0,75.0,2,194,0.0,103.0,97.0
1990.0,17,4,344,2,150,0.0,75.0,75.0,2,194,0.0,103.0,97.0
232870.0,6,3,337,2,214,0.0,160.0,107.0,1,123,0.0,123.0,123.0
617199.0,17,2,346,1,78,0.0,78.0,78.0,1,268,0.0,268.0,268.0
319122.0,17,4,1400,4,1400,106374.0,350.0,350.0,0,0,0.0,0.0,0.0
321213.0,17,4,1400,4,1400,107071.0,350.0,350.0,0,0,0.0,0.0,0.0
108116444.0,17,5,955,5,955,27029111.0,191.0,191.0,0,0,0.0,0.0,0.0
90034009.0,17,28,13364,28,13364,3334592.925925926,501.0,477.2857142857143,0,0,0.0,0.0,0.0
2274462.0,6,3,1604,1,753,0.0,753.0,753.0,2,851,0.0,785.0,425.5
320033.0,6,6,544,3,350,80455.5,210.0,116.66666666666669,3,194,80457.5,74.0,64.66666666666667
120090975.0,6,1096,253116,538,36396,223633.1005586592,214.0,67.65055762081785,558,216720,215190.02154398564,1514.0,388.3870967741936
107288.0,17,2,286,2,286,0.0,143.0,143.0,0,0,0.0,0.0,0.0
312996.0,6,6,412,4,272,104332.0,74.0,68.0,2,140,0.0,74.0,70.0
120031163.0,17,28,13364,28,13364,4445598.62962963,501.0,477.2857142857143,0,0,0.0,0.0,0.0
877315.0,6,12,1362,6,731,173776.0,253.0,121.83333333333331,6,631,175060.2,293.0,105.16666666666669
306655.0,6,6,412,4,272,102218.33333333331,74.0,68.0,2,140,0.0,74.0,70.0
3168774.0,6,18,1493,9,919,358281.625,315.0,102.11111111111111,9,574,358236.125,78.0,63.77777777777778
205783.0,17,2,180,1,90,0.0,90.0,90.0,1,90,0.0,90.0,90.0
90290287.0,6,14,2102,8,1016,12898612.42857143,188.0,127.0,6,1086,18025169.6,204.0,181.0
90699205.0,6,24,1829,11,840,9069920.5,95.0,76.36363636363636,13,989,7536588.083333333,95.0,76.07692307692308
146151.0,6,3,373,2,238,0.0,172.0,119.0,1,135,0.0,135.0,135.0
308984.0,6,6,412,4,272,102994.66666666669,74.0,68.0,2,140,0.0,74.0,70.0
241208.0,6,3,337,2,214,0.0,160.0,107.0,1,123,0.0,123.0,123.0
231948.0,6,3,337,2,214,0.0,160.0,107.0,1,123,0.0,123.0,123.0
4374.0,17,2,614,1,72,0.0,72.0,72.0,1,542,0.0,542.0,542.0
197133.0,17,2,180,1,90,0.0,90.0,90.0,1,90,0.0,90.0,90.0
243604.0,6,3,337,2,214,0.0,160.0,107.0,1,123,0.0,123.0,123.0
1024410.0,6,12,1362,6,731,203392.8,253.0,121.83333333333331,6,631,203807.2,293.0,105.16666666666669
2072.0,17,4,438,2,148,0.0,74.0,74.0,2,290,0.0,147.0,145.0
153358.0,17,2,180,1,90,0.0,90.0,90.0,1,90,0.0,90.0,90.0
204776.0,17,2,762,2,762,0.0,381.0,381.0,0,0,0.0,0.0,0.0
48638172.0,6,8,2113,3,960,22921066.5,826.0,320.0,5,1153,11515992.25,885.0,230.6
316165.0,17,4,1400,4,1400,105388.33333333331,350.0,350.0,0,0,0.0,0.0,0.0
212273.0,17,2,180,1,90,0.0,90.0,90.0,1,90,0.0,90.0,90.0
2999762.0,17,2,906,2,906,0.0,453.0,453.0,0,0,0.0,0.0,0.0
105623971.0,6,43,2838,22,1452,5019433.238095238,66.0,66.0,21,1386,5105434.8,66.0,66.0
205997.0,6,3,426,2,280,0.0,214.0,140.0,1,146,0.0,146.0,146.0
160161.0,17,2,180,1,90,0.0,90.0,90.0,1,90,0.0,90.0,90.0
205784.0,17,2,180,1,90,0.0,90.0,90.0,1,90,0.0,90.0,90.0
298571.0,6,6,412,4,272,99523.66666666669,74.0,68.0,2,140,0.0,74.0,70.0
115000992.0,17,13,821,7,432,19166832.0,174.0,61.71428571428572,6,389,19001265.6,174.0,64.83333333333333
92713.0,17,2,286,2,286,0.0,143.0,143.0,0,0,0.0,0.0,0.0
308058.0,6,6,412,4,272,102686.0,74.0,68.0,2,140,0.0,74.0,70.0
115158177.0,6,234,26756,117,8018,985822.448275862,140.0,68.52991452991454,117,18738,989175.948275862,300.0,160.15384615384616
2978419.0,6,11,2106,6,598,595375.2,252.0,99.66666666666669,5,1508,2122.25,1236.0,301.6
24831.0,6,10,2032,5,524,5971.5,252.0,104.8,5,1508,3402.5,1236.0,301.6
307957.0,6,2,132,1,66,0.0,66.0,66.0,1,66,0.0,66.0,66.0
2780592.0,6,2,132,1,66,0.0,66.0,66.0,1,66,0.0,66.0,66.0
0.0,6,1,66,0,0,0.0,0.0,0.0,1,66,0.0,66.0,66.0
214510.0,17,2,604,1,75,0.0,75.0,75.0,1,529,0.0,529.0,529.0
14828.0,6,10,1065,5,534,3114.25,262.0,106.8,5,531,3220.5,259.0,106.2
311690.0,17,4,1400,4,1400,103896.66666666669,350.0,350.0,0,0,0.0,0.0,0.0
228090.0,17,2,180,1,90,0.0,90.0,90.0,1,90,0.0,90.0,90.0
217512.0,6,3,426,2,280,0.0,214.0,140.0,1,146,0.0,146.0,146.0
120231190.0,6,230,25956,115,7886,1047538.350877193,140.0,68.57391304347826,115,18070,1047476.6578947369,374.0,157.1304347826087
39645228.0,6,5,336,2,134,0.0,68.0,67.0,3,202,19752114.5,70.0,67.33333333333333
6679.0,17,2,582,1,83,0.0,83.0,83.0,1,499,0.0,499.0,499.0
51435.0,6,14,4740,7,653,7763.666666666667,249.0,93.28571428571428,7,4087,6931.5,1514.0,583.8571428571429
42415.0,6,14,4740,7,653,5948.666666666667,249.0,93.28571428571428,7,4087,5095.0,1514.0,583.8571428571429
22887.0,6,12,1320,6,723,3523.2,253.0,120.5,6,597,4244.4,259.0,99.5
2689471.0,6,3,1777,1,826,0.0,826.0,826.0,2,951,0.0,885.0,475.5
106985.0,17,2,286,2,286,0.0,143.0,143.0,0,0,0.0,0.0,0.0
45842.0,6,14,4740,7,653,7508.833333333333,249.0,93.28571428571428,7,4087,7328.166666666667,1514.0,583.8571428571429
30301.0,6,14,4740,7,653,4420.5,249.0,93.28571428571428,7,4087,4749.166666666667,1514.0,583.8571428571429
108797.0,17,2,286,2,286,0.0,143.0,143.0,0,0,0.0,0.0,0.0
23726.0,6,14,4740,7,653,3797.3333333333335,249.0,93.28571428571428,7,4087,2866.833333333333,1514.0,583.8571428571429
236632.0,6,3,373,2,238,0.0,172.0,119.0,1,135,0.0,135.0,135.0
2365.0,17,4,344,2,150,0.0,75.0,75.0,2,194,0.0,103.0,97.0
22680.0,6,14,4740,7,653,3671.3333333333335,249.0,93.28571428571428,7,4087,3438.5,1514.0,583.8571428571429
205794.0,17,2,180,1,90,0.0,90.0,90.0,1,90,0.0,90.0,90.0
10869506.0,6,8,544,4,272,3577617.0,74.0,68.0,4,272,3577530.6666666665,74.0,68.0
207792.0,17,2,762,2,762,0.0,381.0,381.0,0,0,0.0,0.0,0.0
95007784.0,17,13,1083,7,563,15834630.666666666,174.0,80.42857142857143,6,520,15000112.8,174.0,86.66666666666667
3492.0,17,2,359,1,75,0.0,75.0,75.0,1,284,0.0,284.0,284.0
314342.0,6,6,412,4,272,104780.66666666669,74.0,68.0,2,140,0.0,74.0,70.0
111246171.0,6,32,2236,16,1165,7402011.466666667,139.0,72.8125,16,1071,7402023.133333334,123.0,66.9375
11499336.0,17,4,1368,4,1368,3833112.0,342.0,342.0,0,0,0.0,0.0,0.0
90067499.0,17,28,13364,28,13364,3335833.296296296,501.0,477.2857142857143,0,0,0.0,0.0,0.0
108105271.0,17,5,1005,5,1005,27026317.75,201.0,201.0,0,0,0.0,0.0,0.0
317967.0,17,4,1400,4,1400,105989.0,350.0,350.0,0,0,0.0,0.0,0.0
91128606.0,6,176,20132,88,14176,1044980.0229885058,300.0,161.0909090909091,88,5956,1044980.7011494252,140.0,67.68181818181819
304037.0,6,6,412,4,272,101345.66666666669,74.0,68.0,2,140,0.0,74.0,70.0
119433921.0,6,261,29908,131,21106,918722.4692307692,284.0,161.1145038167939,130,8802,924024.7906976744,140.0,67.70769230769231
31756.0,6,14,4740,7,653,4909.166666666667,249.0,93.28571428571428,7,4087,4476.5,1514.0,583.8571428571429
101874092.0,17,8,720,4,360,33908714.666666664,90.0,90.0,4,360,33908726.333333336,90.0,90.0
322925.0,17,4,1400,4,1400,107641.66666666669,350.0,350.0,0,0,0.0,0.0,0.0
111001244.0,17,13,821,7,432,18500207.33333333,174.0,61.71428571428572,6,389,18199424.0,174.0,64.83333333333333
105184077.0,17,15,5130,15,5130,7513148.357142857,342.0,342.0,0,0,0.0,0.0,0.0
4170522.0,6,19,1594,9,962,482542.125,315.0,106.88888888888889,10,632,428901.8888888889,78.0,63.2
25234.0,17,2,582,1,83,0.0,83.0,83.0,1,499,0.0,499.0,499.0
109174586.0,17,14,1126,7,563,18169084.83333333,174.0,80.42857142857143,7,563,18169087.0,174.0,80.42857142857143
33001.0,6,14,4740,7,653,5107.833333333333,249.0,93.28571428571428,7,4087,4228.5,1514.0,583.8571428571429
300414.0,17,2,180,1,90,0.0,90.0,90.0,1,90,0.0,90.0,90.0
90209471.0,6,22,1680,10,745,9995752.444444444,95.0,74.5,12,935,8181277.909090909,95.0,77.91666666666667
111155413.0,17,14,864,7,432,18499212.5,174.0,61.71428571428572,7,432,18507660.5,174.0,61.71428571428572
147165.0,6,3,373,2,238,0.0,172.0,119.0,1,135,0.0,135.0,135.0
109355699.0,6,222,25106,111,17558,992184.9727272728,284.0,158.18018018018017,111,7548,992186.1818181818,140.0,68.0
119546889.0,6,20,1490,10,745,13282987.666666666,95.0,74.5,10,745,13253587.777777778,95.0,74.5
2578128.0,6,2,132,1,66,0.0,66.0,66.0,1,66,0.0,66.0,66.0
24667.0,6,14,4740,7,653,3737.8333333333335,249.0,93.28571428571428,7,4087,3973.6666666666665,1514.0,583.8571428571429
120311042.0,6,271,31076,136,21870,891192.9037037037,284.0,160.80882352941177,135,9206,883148.7835820896,140.0,68.19259259259259
116764701.0,6,48,3168,24,1584,5076726.130434782,66.0,66.0,24,1584,5063456.043478261,66.0,66.0
811.0,17,4,438,2,148,0.0,74.0,74.0,2,290,0.0,147.0,145.0
870320.0,6,9,1269,6,798,174064.0,460.0,133.0,3,471,297320.5,331.0,157.0
108112112.0,17,5,1005,5,1005,27028028.0,201.0,201.0,0,0,0.0,0.0,0.0
752881.0,6,10,1065,5,534,187902.0,262.0,106.8,5,531,187540.0,259.0,106.2
100273541.0,6,28,1860,14,966,7697625.384615385,123.0,69.0,14,894,7697624.230769231,123.0,63.85714285714285
92949168.0,17,11,866,6,520,18589833.6,174.0,86.66666666666667,5,346,18218886.0,174.0,69.2
1581162.0,6,8,602,3,198,203805.5,66.0,66.0,5,404,369762.0,103.0,80.8
10486928.0,6,7,478,4,272,3450022.6666666665,74.0,68.0,3,206,5174949.0,74.0,68.66666666666667
90094263.0,6,13,1776,6,948,18018559.0,204.0,158.0,7,828,15015310.333333334,188.0,118.28571428571428
108105969.0,17,5,955,5,955,27026492.25,191.0,191.0,0,0,0.0,0.0,0.0
137784.0,6,2,132,1,66,0.0,66.0,66.0,1,66,0.0,66.0,66.0
321.0,17,2,174,1,79,0.0,79.0,79.0,1,95,0.0,95.0,95.0
5623271.0,6,5,336,2,134,0.0,68.0,67.0,3,202,1523400.5,70.0,67.33333333333333
153.0,17,2,700,2,700,0.0,350.0,350.0,0,0,0.0,0.0,0.0
341.0,17,2,250,1,93,0.0,93.0,93.0,1,157,0.0,157.0,157.0
34574.0,6,2,145,2,145,0.0,91.0,72.5,0,0,0.0,0.0,0.0
90258001.0,6,13,2036,8,1016,12894000.142857144,188.0,127.0,5,1020,22523119.75,204.0,204.0
4746.0,17,2,614,1,72,0.0,72.0,72.0,1,542,0.0,542.0,542.0
200249.0,17,2,180,1,90,0.0,90.0,90.0,1,90,0.0,90.0,90.0
47896.0,6,10,1065,5,534,8385.75,262.0,106.8,5,531,10141.5,259.0,106.2
13349.0,17,4,823,2,163,0.0,89.0,81.5,2,660,0.0,443.0,330.0
119681447.0,6,220,25002,110,17508,1096021.3302752294,374.0,159.16363636363636,110,7494,1096021.3577981652,140.0,68.12727272727273
120476447.0,6,215,24374,108,17016,1125948.1028037383,284.0,157.55555555555554,107,7358,1125016.4433962265,140.0,68.76635514018692
111249861.0,17,14,864,7,432,18500872.166666668,174.0,61.71428571428572,7,432,18500157.83333333,174.0,61.71428571428572
110682732.0,17,14,864,7,432,18333512.166666668,174.0,61.71428571428572,7,432,18334377.33333333,174.0,61.71428571428572
102984209.0,6,42,2772,21,1386,5135439.15,66.0,66.0,21,1386,5135433.65,66.0,66.0
747436.0,6,2,132,1,66,0.0,66.0,66.0,1,66,0.0,66.0,66.0
2820828.0,6,12,2172,7,664,469979.3333333333,252.0,94.85714285714286,5,1508,2583.25,1236.0,301.6
295309.0,6,6,412,4,272,98436.33333333331,74.0,68.0,2,140,0.0,74.0,70.0
5003375.0,17,4,849,2,166,0.0,83.0,83.0,2,683,0.0,499.0,341.5
90252429.0,6,15,2444,8,1016,12893204.142857144,188.0,127.0,7,1428,15015205.166666666,204.0,204.0
120122585.0,6,13,2020,9,1204,15015323.125,188.0,133.77777777777777,4,816,30032246.0,204.0,204.0
297846.0,6,6,412,4,272,99282.0,74.0,68.0,2,140,0.0,74.0,70.0
103080.0,17,2,286,2,286,0.0,143.0,143.0,0,0,0.0,0.0,0.0
1669.0,17,2,762,2,762,0.0,381.0,381.0,0,0,0.0,0.0,0.0
120271149.0,6,18,1382,9,691,14999977.625,95.0,76.77777777777777,9,691,15033104.0,95.0,76.77777777777777
35224.0,6,10,2032,5,524,7697.0,252.0,104.8,5,1508,8541.75,1236.0,301.6
433098.0,6,3,1604,1,753,0.0,753.0,753.0,2,851,0.0,785.0,425.5
94507263.0,17,12,778,6,389,18800146.6,174.0,64.83333333333333,6,389,18800721.4,174.0,64.83333333333333
302415.0,6,6,412,4,272,100805.0,74.0,68.0,2,140,0.0,74.0,70.0
43476.0,6,20,7606,11,978,4347.6,310.0,88.9090909090909,9,6628,5075.25,1514.0,736.4444444444445
360937.0,17,2,180,1,90,0.0,90.0,90.0,1,90,0.0,90.0,90.0
120123061.0,6,13,2036,5,1020,30030765.25,204.0,204.0,8,1016,17136467.42857143,188.0,127.0
120028281.0,17,28,13364,28,13364,4445491.888888889,501.0,477.2857142857143,0,0,0.0,0.0,0.0
90290563.0,6,14,1043,7,542,15048427.166666666,95.0,77.42857142857143,7,501,14998359.333333334,95.0,71.57142857142857
106158.0,17,2,286,2,286,0.0,143.0,143.0,0,0,0.0,0.0,0.0
233733.0,6,3,373,2,238,0.0,172.0,119.0,1,135,0.0,135.0,135.0
2016.0,17,4,344,2,150,0.0,75.0,75.0,2,194,0.0,103.0,97.0
197004.0,17,2,180,1,90,0.0,90.0,90.0,1,90,0.0,90.0,90.0
205215.0,17,2,180,1,90,0.0,90.0,90.0,1,90,0.0,90.0,90.0
71484.0,6,14,4740,7,653,11655.0,249.0,93.28571428571428,7,4087,10826.666666666666,1514.0,583.8571428571429
35299.0,6,14,4740,7,653,5614.166666666667,249.0,93.28571428571428,7,4087,3795.1666666666665,1514.0,583.8571428571429
90077693.0,6,10,1440,7,828,15012948.833333334,188.0,118.28571428571428,3,612,30030249.5,204.0,204.0
300639.0,6,6,412,4,272,100213.0,74.0,68.0,2,140,0.0,74.0,70.0
41768.0,6,10,2032,5,524,9975.75,252.0,104.8,5,1508,8612.5,1236.0,301.6
301412.0,6,6,412,4,272,100470.66666666669,74.0,68.0,2,140,0.0,74.0,70.0
17499.0,6,14,4740,7,653,2599.333333333333,249.0,93.28571428571428,7,4087,2406.1666666666665,1514.0,583.8571428571429
211374.0,6,12,1373,7,714,35229.0,298.0,102.0,5,659,52044.5,379.0,131.8
5622098.0,6,5,336,2,134,0.0,68.0,67.0,3,202,1419470.0,70.0,67.33333333333333
27291.0,6,14,4740,7,653,4390.666666666667,249.0,93.28571428571428,7,4087,3940.5,1514.0,583.8571428571429
90046162.0,17,28,13364,28,13364,3335043.037037037,501.0,477.2857142857143,0,0,0.0,0.0,0.0
10926170.0,6,7,478,3,206,5394668.5,74.0,68.66666666666667,4,272,3596384.6666666665,74.0,68.0
2074.0,17,4,344,2,150,0.0,75.0,75.0,2,194,0.0,103.0,97.0
4499.0,17,2,180,1,90,0.0,90.0,90.0,1,90,0.0,90.0,90.0
60380.0,6,14,4740,7,653,9332.666666666666,249.0,93.28571428571428,7,4087,9229.666666666666,1514.0,583.8571428571429
147952.0,17,2,180,1,90,0.0,90.0,90.0,1,90,0.0,90.0,90.0
6194.0,17,2,565,1,93,0.0,93.0,93.0,1,472,0.0,472.0,472.0
0.0,6,1,66,1,66,0.0,66.0,66.0,0,0,0.0,0.0,0.0
23131863.0,17,3,1034,2,684,0.0,342.0,342.0,1,350,0.0,350.0,350.0
24135.0,6,11,2098,6,590,4429.6,252.0,98.33333333333331,5,1508,5056.25,1236.0,301.6
196860.0,17,2,180,1,90,0.0,90.0,90.0,1,90,0.0,90.0,90.0
2596046.0,6,2,132,1,66,0.0,66.0,66.0,1,66,0.0,66.0,66.0
310857.0,6,6,412,4,272,103619.0,74.0,68.0,2,140,0.0,74.0,70.0
97006.0,6,14,4740,7,653,16033.333333333334,249.0,93.28571428571428,7,4087,10332.833333333334,1514.0,583.8571428571429
5004999.0,17,4,849,2,166,0.0,83.0,83.0,2,683,0.0,499.0,341.5
70714.0,6,10,2032,5,524,16024.25,252.0,104.8,5,1508,16835.25,1236.0,301.6
265035.0,6,10,1221,6,636,53007.0,298.0,106.0,4,585,82595.0,379.0,146.25
2010114.0,17,4,525,2,150,0.0,75.0,75.0,2,375,0.0,284.0,187.5
36376.0,6,14,4740,7,653,3566.0,249.0,93.28571428571428,7,4087,5772.666666666667,1514.0,583.8571428571429
2426935.0,6,25,7589,14,3751,186687.3076923077,1514.0,267.92857142857144,11,3838,217582.2,1514.0,348.90909090909093
119608414.0,6,26,1978,12,935,10873492.181818182,95.0,77.91666666666667,14,1043,9181052.846153846,95.0,74.5
377673.0,6,11,1021,6,444,51925.2,162.0,74.0,5,577,64533.0,349.0,115.4
1487435.0,17,16,1120,16,1120,99162.33333333331,70.0,70.0,0,0,0.0,0.0,0.0
60990073.0,17,9,3086,8,2736,5111909.142857143,342.0,342.0,1,350,0.0,350.0,350.0
228506.0,17,2,180,1,90,0.0,90.0,90.0,1,90,0.0,90.0,90.0
206859.0,6,3,426,2,280,0.0,214.0,140.0,1,146,0.0,146.0,146.0
146165.0,6,3,337,2,214,0.0,160.0,107.0,1,123,0.0,123.0,123.0
120013482.0,6,583,70928,292,19568,412417.4639175258,140.0,67.01369863013699,291,51360,410261.16896551725,374.0,176.49484536082474
10539989.0,6,7,478,4,272,3468045.333333333,74.0,68.0,3,206,5201967.5,74.0,68.66666666666667
99565.0,17,2,286,2,286,0.0,143.0,143.0,0,0,0.0,0.0,0.0
40625.0,6,14,4740,7,653,6583.666666666667,249.0,93.28571428571428,7,4087,6551.333333333333,1514.0,583.8571428571429
108113671.0,17,5,1005,5,1005,27028417.75,201.0,201.0,0,0,0.0,0.0,0.0
123850059.0,6,49,3234,25,1650,5160419.125,66.0,66.0,24,1584,4989247.956521739,66.0,66.0
107571795.0,6,211,24158,106,7292,1024493.2857142856,140.0,68.79245283018868,105,16866,1024444.4230769232,300.0,160.62857142857143
135134173.0,17,6,1206,6,1206,27026834.6,201.0,201.0,0,0,0.0,0.0,0.0
1313580.0,6,4,264,2,132,0.0,66.0,66.0,2,132,0.0,66.0,66.0
51110.0,6,14,4740,7,653,7872.5,249.0,93.28571428571428,7,4087,8268.833333333334,1514.0,583.8571428571429
117025319.0,6,47,3102,24,1584,5088046.260869565,66.0,66.0,23,1518,5143931.045454546,66.0,66.0
90027863.0,17,28,13364,28,13364,3334365.296296296,501.0,477.2857142857143,0,0,0.0,0.0,0.0
130299.0,6,3,337,2,214,0.0,160.0,107.0,1,123,0.0,123.0,123.0
90988441.0,6,513,85292,257,68002,355423.59765625,1514.0,264.59922178988325,256,17290,355910.4274509804,214.0,67.5390625
90068854.0,17,27,12943,27,12943,3464186.6923076925,501.0,479.3703703703704,0,0,0.0,0.0,0.0
93657669.0,6,40,2640,20,1320,4929351.0,66.0,66.0,20,1320,4913048.52631579,66.0,66.0
147220.0,6,3,373,2,238,0.0,172.0,119.0,1,135,0.0,135.0,135.0
90259236.0,6,12,1832,8,1016,12894176.57142857,188.0,127.0,4,816,30031747.666666668,204.0,204.0
312076.0,17,4,1400,4,1400,104025.33333333331,350.0,350.0,0,0,0.0,0.0,0.0
120283497.0,17,13,690,7,432,20047249.5,174.0,61.71428571428572,6,258,20000585.0,43.0,43.0
1034132.0,6,11,1134,6,558,206826.4,220.0,93.0,5,576,256428.5,304.0,115.2
122181.0,6,3,373,2,238,0.0,172.0,119.0,1,135,0.0,135.0,135.0
108105133.0,17,5,955,5,955,27026283.25,191.0,191.0,0,0,0.0,0.0,0.0
298585.0,6,6,412,4,272,99528.33333333331,74.0,68.0,2,140,0.0,74.0,70.0
48647.0,6,10,2032,5,524,11838.25,252.0,104.8,5,1508,10247.5,1236.0,301.6
36293.0,6,14,4740,7,653,5932.5,249.0,93.28571428571428,7,4087,5455.833333333333,1514.0,583.8571428571429
218931.0,6,3,426,2,280,0.0,214.0,140.0,1,146,0.0,146.0,146.0
135131944.0,17,6,1206,6,1206,27026388.8,201.0,201.0,0,0,0.0,0.0,0.0
47493559.0,6,8,1940,3,887,22380730.0,753.0,295.6666666666667,5,1053,11257699.75,785.0,210.6
141142.0,6,2,132,1,66,0.0,66.0,66.0,1,66,0.0,66.0,66.0
334.0,17,2,160,1,80,0.0,80.0,80.0,1,80,0.0,80.0,80.0
5623501.0,6,5,336,2,134,0.0,68.0,67.0,3,202,1420599.5,70.0,67.33333333333333
847016.0,6,9,1268,6,797,169403.2,459.0,132.83333333333334,3,471,287255.5,331.0,157.0
162186.0,17,2,180,1,90,0.0,90.0,90.0,1,90,0.0,90.0,90.0
244966.0,6,3,337,2,214,0.0,160.0,107.0,1,123,0.0,123.0,123.0
120118983.0,6,280,32624,140,9536,850752.3165467626,140.0,68.11428571428571,140,23088,858206.381294964,464.0,164.9142857142857
41089.0,6,10,2032,5,524,10048.0,252.0,104.8,5,1508,10002.5,1236.0,301.6
97799.0,17,2,762,2,762,0.0,381.0,381.0,0,0,0.0,0.0,0.0
90267192.0,6,14,2240,8,1016,12895313.142857144,188.0,127.0,6,1224,18020761.0,204.0,204.0
307734.0,6,6,412,4,272,102578.0,74.0,68.0,2,140,0.0,74.0,70.0
417781.0,6,10,1221,6,636,83556.2,298.0,106.0,4,585,138037.0,379.0,146.25
92775.0,6,2,132,1,66,0.0,66.0,66.0,1,66,0.0,66.0,66.0
90287592.0,6,16,1192,8,596,12891727.142857144,95.0,74.5,8,596,12897237.142857144,95.0,74.5
394.0,17,2,373,1,86,0.0,86.0,86.0,1,287,0.0,287.0,287.0
18941.0,6,10,2032,5,524,4056.25,252.0,104.8,5,1508,4263.0,1236.0,301.6
99716405.0,17,11,604,6,389,19943281.0,174.0,64.83333333333333,5,215,20001254.0,43.0,43.0
102894.0,17,2,286,2,286,0.0,143.0,143.0,0,0,0.0,0.0,0.0
69611.0,6,12,1447,6,816,13082.8,291.0,136.0,6,631,10450.8,293.0,105.16666666666669
99225.0,17,2,762,2,762,0.0,381.0,381.0,0,0,0.0,0.0,0.0
123839997.0,6,49,3234,25,1650,5159999.875,66.0,66.0,24,1584,5162425.913043479,66.0,66.0
760.0,17,5,550,5,550,190.0,110.0,110.0,0,0,0.0,0.0,0.0
1299176.0,6,4,264,2,132,0.0,66.0,66.0,2,132,0.0,66.0,66.0
600044.0,17,2,346,1,78,0.0,78.0,78.0,1,268,0.0,268.0,268.0
146782.0,6,3,373,2,238,0.0,172.0,119.0,1,135,0.0,135.0,135.0
21662977.0,6,6,1981,4,1087,7220992.333333333,885.0,271.75,2,894,0.0,826.0,447.0
502065.0,6,5,336,2,134,0.0,68.0,67.0,3,202,193264.5,70.0,67.33333333333333
73614.0,6,10,2032,5,524,18162.25,252.0,104.8,5,1508,16945.75,1236.0,301.6
1314751.0,6,4,264,2,132,0.0,66.0,66.0,2,132,0.0,66.0,66.0
120157591.0,6,202,22886,101,6888,1193420.56,140.0,68.1980198019802,101,15998,1153174.35,284.0,158.3960396039604
119569333.0,6,453,54534,227,15204,529067.8451327434,140.0,66.97797356828194,226,39330,530352.5377777778,374.0,174.02654867256638
288648.0,6,10,1221,6,636,57729.6,298.0,106.0,4,585,90787.33333333331,379.0,146.25
58594.0,6,10,1066,5,490,9972.5,218.0,98.0,5,576,13966.75,304.0,115.2
153518.0,6,3,337,2,214,0.0,160.0,107.0,1,123,0.0,123.0,123.0
120244252.0,6,218,24646,109,7490,1107558.5462962964,140.0,68.71559633027523,109,17156,1105680.8240740742,284.0,157.39449541284404
148097.0,17,2,180,1,90,0.0,90.0,90.0,1,90,0.0,90.0,90.0
90299924.0,6,16,1192,8,596,12892718.714285716,95.0,74.5,8,596,12897463.857142856,95.0,74.5
4261.0,17,2,602,1,72,0.0,72.0,72.0,1,530,0.0,530.0,530.0
135135017.0,17,6,1206,6,1206,27027003.4,201.0,201.0,0,0,0.0,0.0,0.0
67666.0,6,10,2032,5,524,16220.75,252.0,104.8,5,1508,15773.5,1236.0,301.6
108109602.0,17,5,955,5,955,27027400.5,191.0,191.0,0,0,0.0,0.0,0.0
1826.0,17,2,192,1,88,0.0,88.0,88.0,1,104,0.0,104.0,104.0
206308.0,17,2,180,1,90,0.0,90.0,90.0,1,90,0.0,90.0,90.0
90050404.0,17,28,13364,28,13364,3335200.1481481483,501.0,477.2857142857143,0,0,0.0,0.0,0.0
2104664.0,6,18,6803,10,1501,233851.5555555556,408.0,150.1,8,5302,237638.7142857143,1514.0,662.75
1166519.0,6,13,3001,8,2373,166645.57142857142,1514.0,296.625,5,628,223425.25,331.0,125.6
90059148.0,17,28,13364,28,13364,3335524.0,501.0,477.2857142857143,0,0,0.0,0.0,0.0
496.0,17,2,508,2,508,0.0,257.0,254.0,0,0,0.0,0.0,0.0
113254874.0,6,46,3036,23,1518,5135437.818181818,66.0,66.0,23,1518,5135437.090909091,66.0,66.0
30698.0,6,14,4740,7,653,4868.5,249.0,93.28571428571428,7,4087,4597.5,1514.0,583.8571428571429
234242.0,6,3,337,2,214,0.0,160.0,107.0,1,123,0.0,123.0,123.0
148010.0,17,2,180,1,90,0.0,90.0,90.0,1,90,0.0,90.0,90.0
4492.0,17,2,614,1,72,0.0,72.0,72.0,1,542,0.0,542.0,542.0
222129.0,6,3,426,2,280,0.0,214.0,140.0,1,146,0.0,146.0,146.0
2798783.0,6,2,132,1,66,0.0,66.0,66.0,1,66,0.0,66.0,66.0
45795.0,6,14,4740,7,653,7506.833333333333,249.0,93.28571428571428,7,4087,6570.666666666667,1514.0,583.8571428571429
139177.0,6,2,132,1,66,0.0,66.0,66.0,1,66,0.0,66.0,66.0
108111594.0,17,5,1005,5,1005,27027898.5,201.0,201.0,0,0,0.0,0.0,0.0
297082.0,6,6,412,4,272,99027.33333333331,74.0,68.0,2,140,0.0,74.0,70.0
123455980.0,6,49,3234,25,1650,5143999.166666667,66.0,66.0,24,1584,5153370.260869565,66.0,66.0
3315987.0,6,177,144648,101,135330,33135.69,1510.0,1339.90099009901,76,9318,40150.746666666666,1510.0,122.60526315789474
50058.0,6,10,1066,5,490,10618.25,218.0,98.0,5,576,11296.25,304.0,115.2
127813.0,6,14,4740,7,653,21041.0,249.0,93.28571428571428,7,4087,20432.33333333333,1514.0,583.8571428571429
2086832.0,6,19,6869,11,1567,208683.2,408.0,142.45454545454547,8,5302,235138.0,1514.0,662.75
204906.0,17,2,762,2,762,0.0,381.0,381.0,0,0,0.0,0.0,0.0
2011.0,17,4,344,2,150,0.0,75.0,75.0,2,194,0.0,103.0,97.0
314.0,17,2,174,1,79,0.0,79.0,79.0,1,95,0.0,95.0,95.0
90096198.0,6,11,1644,4,816,30031304.666666668,204.0,204.0,7,828,15015654.666666666,188.0,118.28571428571428
298095.0,6,6,412,4,272,99365.0,74.0,68.0,2,140,0.0,74.0,70.0
256108.0,6,10,1221,6,636,51221.6,298.0,106.0,4,585,79591.0,379.0,146.25
484.0,17,2,508,2,508,0.0,257.0,254.0,0,0,0.0,0.0,0.0
1300185.0,6,4,264,2,132,0.0,66.0,66.0,2,132,0.0,66.0,66.0
7056284.0,6,6,1802,3,885,3445830.0,753.0,295.0,3,917,3468867.0,785.0,305.6666666666667
90280638.0,6,13,2036,8,1016,12897234.0,188.0,127.0,5,1020,22523664.75,204.0,204.0
210921.0,6,10,1221,6,636,42184.2,298.0,106.0,4,585,68823.66666666667,379.0,146.25
121339.0,6,3,337,2,214,0.0,160.0,107.0,1,123,0.0,123.0,123.0
108096042.0,17,5,1005,5,1005,27024010.5,201.0,201.0,0,0,0.0,0.0,0.0
132636.0,6,2,132,1,66,0.0,66.0,66.0,1,66,0.0,66.0,66.0
13802.0,6,13,1459,7,862,1991.3333333333333,271.0,123.14285714285714,6,597,2570.2,259.0,99.5
217852.0,6,3,426,2,280,0.0,214.0,140.0,1,146,0.0,146.0,146.0
533573.0,6,2,132,1,66,0.0,66.0,66.0,1,66,0.0,66.0,66.0
146153.0,6,3,337,2,214,0.0,160.0,107.0,1,123,0.0,123.0,123.0
310.0,17,2,208,1,72,0.0,72.0,72.0,1,136,0.0,136.0,136.0
118540107.0,6,226,25534,113,17780,1056472.330357143,284.0,157.34513274336285,113,7754,1056471.017857143,140.0,68.61946902654867
232333.0,6,3,337,2,214,0.0,160.0,107.0,1,123,0.0,123.0,123.0
108105638.0,17,5,955,5,955,27026409.5,191.0,191.0,0,0,0.0,0.0,0.0
120002693.0,6,16,1192,8,596,17143241.85714286,95.0,74.5,8,596,17107401.0,95.0,74.5
31998.0,6,14,4740,7,653,5130.833333333333,249.0,93.28571428571428,7,4087,4621.333333333333,1514.0,583.8571428571429
5007530.0,17,4,534,2,166,0.0,83.0,83.0,2,368,0.0,184.0,184.0
14955.0,6,14,4740,7,653,2196.6666666666665,249.0,93.28571428571428,7,4087,2354.1666666666665,1514.0,583.8571428571429
2081.0,17,4,344,2,150,0.0,75.0,75.0,2,194,0.0,103.0,97.0
3574892.0,6,5,336,2,134,0.0,68.0,67.0,3,202,1423646.0,70.0,67.33333333333333
15685.000000000002,6,14,4740,7,653,2304.1666666666665,249.0,93.28571428571428,7,4087,2480.833333333333,1514.0,583.8571428571429
30158.0,6,14,4740,7,653,4903.0,249.0,93.28571428571428,7,4087,4491.666666666667,1514.0,583.8571428571429
2051071.0,6,24,6999,13,2047,170922.58333333334,575.0,157.46153846153845,11,4952,174447.5,1510.0,450.1818181818182
3071.0,17,2,359,1,75,0.0,75.0,75.0,1,284,0.0,284.0,284.0
216837.0,6,10,1221,6,636,43367.4,298.0,106.0,4,585,70745.33333333333,379.0,146.25
216609.0,17,2,180,1,90,0.0,90.0,90.0,1,90,0.0,90.0,90.0
90271935.0,6,12,1832,8,1016,12895990.714285716,188.0,127.0,4,816,30035330.0,204.0,204.0
92999889.0,17,11,735,6,389,18599977.8,174.0,64.83333333333333,5,346,19980997.75,174.0,69.2
4602926.0,6,5,336,2,134,0.0,68.0,67.0,3,202,1528395.5,70.0,67.33333333333333
51492.0,6,10,2032,5,524,12618.0,252.0,104.8,5,1508,12376.0,1236.0,301.6
18866.0,6,14,4740,7,653,2953.6666666666665,249.0,93.28571428571428,7,4087,3007.5,1514.0,583.8571428571429
233803.0,6,3,337,2,214,0.0,160.0,107.0,1,123,0.0,123.0,123.0
197705.0,17,4,6056,4,6056,65901.66666666667,1514.0,1514.0,0,0,0.0,0.0,0.0
1984.0,17,4,344,2,150,0.0,75.0,75.0,2,194,0.0,103.0,97.0
7990522.0,17,8,1427,4,306,2663394.6666666665,89.0,76.5,4,1121,2611742.0,443.0,280.25
265171.0,6,10,1221,6,636,53034.2,298.0,106.0,4,585,82950.0,379.0,146.25
91720094.0,6,21,1626,12,935,8332663.818181818,95.0,77.91666666666667,9,691,11404879.0,95.0,76.77777777777777
103195.0,17,2,286,2,286,0.0,143.0,143.0,0,0,0.0,0.0,0.0
334.0,17,2,166,1,75,0.0,75.0,75.0,1,91,0.0,91.0,91.0
90037364.0,17,28,13364,28,13364,3334717.185185185,501.0,477.2857142857143,0,0,0.0,0.0,0.0
120003.0,17,2,180,1,70,0.0,70.0,70.0,1,110,0.0,110.0,110.0
307383.0,17,2,246,1,76,0.0,76.0,76.0,1,170,0.0,170.0,170.0
1058640.0,17,2,876,2,876,0.0,438.0,438.0,0,0,0.0,0.0,0.0
121361.0,6,3,337,2,214,0.0,160.0,107.0,1,123,0.0,123.0,123.0
1339162.0,17,16,1120,16,1120,89277.46666666666,70.0,70.0,0,0,0.0,0.0,0.0
1907264.0,6,4,492,2,280,0.0,214.0,140.0,2,212,0.0,146.0,106.0
2529.0,17,2,180,1,90,0.0,90.0,90.0,1,90,0.0,90.0,90.0
10479570.0,6,6,412,3,206,5171571.5,74.0,68.66666666666667,3,206,5171476.5,74.0,68.66666666666667
103318.0,17,2,286,2,286,0.0,143.0,143.0,0,0,0.0,0.0,0.0
102794711.0,6,40,2640,20,1320,5032310.263157895,66.0,66.0,20,1320,5266341.0,66.0,66.0
9905.0,17,4,823,2,163,0.0,89.0,81.5,2,660,0.0,443.0,330.0
59813.0,6,10,2032,5,524,14638.5,252.0,104.8,5,1508,14355.75,1236.0,301.6
91251694.0,6,25,1924,14,1084,7016129.153846154,95.0,77.42857142857143,11,840,9095868.0,95.0,76.36363636363636
67753.0,6,14,4740,7,653,10666.333333333334,249.0,93.28571428571428,7,4087,10936.166666666666,1514.0,583.8571428571429
148420.0,17,4,6056,4,6056,49473.333333333336,1514.0,1514.0,0,0,0.0,0.0,0.0
90024690.0,17,27,12943,27,12943,3462488.076923077,501.0,479.3703703703704,0,0,0.0,0.0,0.0
90252658.0,6,13,2036,8,1016,12893236.857142856,188.0,127.0,5,1020,22522640.5,204.0,204.0
2984399.0,6,20,6935,11,1567,298439.9,408.0,142.45454545454547,9,5368,319997.75,1514.0,596.4444444444445
90764097.0,6,19,1436,10,745,10079419.888888888,95.0,74.5,9,691,11343999.375,95.0,76.77777777777777
9872.0,17,2,582,1,83,0.0,83.0,83.0,1,499,0.0,499.0,499.0
16141.0,6,13,1459,7,862,2252.0,271.0,123.14285714285714,6,597,2770.6,259.0,99.5
207198.0,6,3,426,2,280,0.0,214.0,140.0,1,146,0.0,146.0,146.0
303082.0,6,2,132,1,66,0.0,66.0,66.0,1,66,0.0,66.0,66.0
94189310.0,17,12,778,6,389,18800151.8,174.0,64.83333333333333,6,389,18801284.0,174.0,64.83333333333333
25325.0,6,14,4740,7,653,3711.5,249.0,93.28571428571428,7,4087,4081.8333333333335,1514.0,583.8571428571429
1311808.0,17,7,490,7,490,218634.66666666663,70.0,70.0,0,0,0.0,0.0,0.0
130968.0,6,3,337,2,214,0.0,160.0,107.0,1,123,0.0,123.0,123.0
299015.0,6,6,412,4,272,99671.66666666669,74.0,68.0,2,140,0.0,74.0,70.0
320.0,17,2,174,1,79,0.0,79.0,79.0,1,95,0.0,95.0,95.0
1988.0,17,4,344,2,150,0.0,75.0,75.0,2,194,0.0,103.0,97.0
2088.0,17,4,344,2,150,0.0,75.0,75.0,2,194,0.0,103.0,97.0
299422.0,6,6,412,4,272,99807.33333333331,74.0,68.0,2,140,0.0,74.0,70.0
390812.0,6,3,204,2,136,0.0,70.0,68.0,1,68,0.0,68.0,68.0
105942.0,17,2,286,2,286,0.0,143.0,143.0,0,0,0.0,0.0,0.0
119376058.0,6,20,1490,11,840,11933076.2,95.0,76.36363636363636,9,650,14920959.0,95.0,72.22222222222223
58640.0,6,14,4740,7,653,9560.833333333334,249.0,93.28571428571428,7,4087,9203.833333333334,1514.0,583.8571428571429
38555.0,6,14,4740,7,653,6206.5,249.0,93.28571428571428,7,4087,6284.166666666667,1514.0,583.8571428571429
90254983.0,6,12,1832,8,1016,12893569.0,188.0,127.0,4,816,30030394.33333333,204.0,204.0
9746016.0,6,5,1909,3,1017,4799743.5,885.0,339.0,2,892,0.0,826.0,446.0
5623762.0,6,5,336,2,134,0.0,68.0,67.0,3,202,1518901.5,70.0,67.33333333333333
48835554.0,6,8,1940,3,887,23015320.0,753.0,295.6666666666667,5,1053,11514007.5,785.0,210.6
52062.0,6,14,4740,7,653,8144.0,249.0,93.28571428571428,7,4087,7720.166666666667,1514.0,583.8571428571429
0.0,17,1,44,1,44,0.0,44.0,44.0,0,0,0.0,0.0,0.0
28080.0,6,14,4740,7,653,3955.0,249.0,93.28571428571428,7,4087,4243.666666666667,1514.0,583.8571428571429
105748158.0,6,244,27780,122,19506,872173.4462809918,284.0,159.88524590163934,122,8274,872171.0661157025,140.0,67.81967213114754
135148902.0,17,6,1206,6,1206,27029780.4,201.0,201.0,0,0,0.0,0.0,0.0
114370495.0,6,30,1974,15,1026,8153914.142857143,123.0,68.4,15,948,8153915.071428572,123.0,63.2
17750.0,6,11,2098,6,590,3464.4,252.0,98.33333333333331,5,1508,4170.75,1236.0,301.6
334.0,17,2,166,1,75,0.0,75.0,75.0,1,91,0.0,91.0,91.0
228531.0,17,2,180,1,90,0.0,90.0,90.0,1,90,0.0,90.0,90.0
26102.0,6,11,2098,6,590,4078.6,252.0,98.33333333333331,5,1508,6238.0,1236.0,301.6
30346.0,6,14,4740,7,653,4947.166666666667,249.0,93.28571428571428,7,4087,4366.166666666667,1514.0,583.8571428571429
10486516.0,6,7,478,4,272,3449864.6666666665,74.0,68.0,3,206,5174653.0,74.0,68.66666666666667
56827.0,6,14,4740,7,653,9333.833333333334,249.0,93.28571428571428,7,4087,9336.166666666666,1514.0,583.8571428571429
116574721.0,6,48,3168,24,1584,5068466.130434782,66.0,66.0,24,1584,5054874.304347826,66.0,66.0
35448.0,6,14,4740,7,653,5094.0,249.0,93.28571428571428,7,4087,5773.333333333333,1514.0,583.8571428571429
1303281.0,6,4,264,2,132,0.0,66.0,66.0,2,132,0.0,66.0,66.0
232665.0,6,3,337,2,214,0.0,160.0,107.0,1,123,0.0,123.0,123.0
234612.0,6,3,426,2,280,0.0,214.0,140.0,1,146,0.0,146.0,146.0
2846871.0,6,5,336,3,202,1423435.5,70.0,67.33333333333333,2,134,0.0,68.0,67.0
108415.0,17,2,700,2,700,0.0,350.0,350.0,0,0,0.0,0.0,0.0
96264869.0,17,13,1083,7,563,16044144.833333334,174.0,80.42857142857143,6,520,15299565.4,174.0,86.66666666666667
93016205.0,6,38,2508,19,1254,5150440.111111111,66.0,66.0,19,1254,5150431.833333333,66.0,66.0
5625571.0,6,5,336,2,134,0.0,68.0,67.0,3,202,1525229.5,70.0,67.33333333333333
100012574.0,6,28,1876,14,982,7677502.615384615,139.0,70.14285714285714,14,894,7677502.076923077,123.0,63.85714285714285
228356.0,17,2,180,1,90,0.0,90.0,90.0,1,90,0.0,90.0,90.0
5626025.0,6,4,270,2,134,0.0,68.0,67.0,2,136,0.0,70.0,68.0
17002.0,6,14,4740,7,653,2452.6666666666665,249.0,93.28571428571428,7,4087,2673.5,1514.0,583.8571428571429
90258814.0,6,12,1832,8,1016,12894116.285714284,188.0,127.0,4,816,30031318.0,204.0,204.0
321922.0,17,4,1400,4,1400,107307.33333333331,350.0,350.0,0,0,0.0,0.0,0.0
235543.0,6,3,337,2,214,0.0,160.0,107.0,1,123,0.0,123.0,123.0
10420568.0,6,6,412,3,206,5142053.5,74.0,68.66666666666667,3,206,5141959.5,74.0,68.66666666666667
2097.0,17,4,344,2,150,0.0,75.0,75.0,2,194,0.0,103.0,97.0
305.0,17,2,164,1,82,0.0,82.0,82.0,1,82,0.0,82.0,82.0
316474.0,17,4,1400,4,1400,105491.33333333331,350.0,350.0,0,0,0.0,0.0,0.0
147996.0,17,2,180,1,90,0.0,90.0,90.0,1,90,0.0,90.0,90.0
355.0,17,2,762,2,762,0.0,381.0,381.0,0,0,0.0,0.0,0.0
44277.0,6,14,4740,7,653,5234.333333333333,249.0,93.28571428571428,7,4087,6825.5,1514.0,583.8571428571429
227214.0,6,10,1221,6,636,45442.8,298.0,106.0,4,585,74805.0,379.0,146.25
105387793.0,6,43,2838,22,1452,5018454.428571428,66.0,66.0,21,1386,5111999.45,66.0,66.0
305178.0,6,6,412,4,272,101726.0,74.0,68.0,2,140,0.0,74.0,70.0
159961.0,6,2,128,1,74,0.0,74.0,74.0,1,54,0.0,54.0,54.0
987673.0,17,4,820,2,156,0.0,78.0,78.0,2,664,0.0,332.0,332.0
317210.0,17,4,1400,4,1400,105736.66666666669,350.0,350.0,0,0,0.0,0.0,0.0
108113544.0,17,5,1005,5,1005,27028386.0,201.0,201.0,0,0,0.0,0.0,0.0
324.0,17,2,174,1,79,0.0,79.0,79.0,1,95,0.0,95.0,95.0
1298377.0,6,4,264,2,132,0.0,66.0,66.0,2,132,0.0,66.0,66.0
108109814.0,17,5,955,5,955,27027453.5,191.0,191.0,0,0,0.0,0.0,0.0
90258846.0,6,12,1832,8,1016,12894120.857142856,188.0,127.0,4,816,30030458.666666668,204.0,204.0
143940.0,6,2,132,1,66,0.0,66.0,66.0,1,66,0.0,66.0,66.0
103048754.0,6,183,20694,91,6228,1144986.1555555556,140.0,68.43956043956044,92,14466,1098470.5934065934,284.0,157.2391304347826
117152073.0,6,268,30714,134,9140,874605.07518797,140.0,68.2089552238806,134,21574,880683.4135338346,284.0,161.0
135142316.0,17,6,1206,6,1206,27028463.2,201.0,201.0,0,0,0.0,0.0,0.0
309186.0,6,6,412,4,272,103062.0,74.0,68.0,2,140,0.0,74.0,70.0
2155417.0,6,19,6869,11,1567,215541.7,408.0,142.45454545454547,8,5302,246776.8571428572,1514.0,662.75
116169634.0,17,14,864,7,432,19333496.5,174.0,61.71428571428572,7,432,19334486.666666668,174.0,61.71428571428572
53822.0,6,12,1328,6,731,9137.2,253.0,121.83333333333331,6,597,10138.4,259.0,99.5
3008316.0,6,12,2172,7,664,501069.1666666667,252.0,94.85714285714286,5,1508,2753.0,1236.0,301.6
2463.0,17,4,344,2,150,0.0,75.0,75.0,2,194,0.0,103.0,97.0
120958036.0,17,14,864,7,432,16834985.333333332,174.0,61.71428571428572,7,432,16833503.833333332,174.0,61.71428571428572
146937.0,6,3,337,2,214,0.0,160.0,107.0,1,123,0.0,123.0,123.0
245206.0,6,3,337,2,214,0.0,160.0,107.0,1,123,0.0,123.0,123.0
127429464.0,6,36,2596,18,1248,6908398.588235294,123.0,69.33333333333333,18,1348,6908398.411764706,139.0,74.88888888888889
10464946.0,6,7,478,4,272,3442890.6666666665,74.0,68.0,3,206,5164226.5,74.0,68.66666666666667
33308.0,6,14,4740,7,653,3996.6666666666665,249.0,93.28571428571428,7,4087,5416.166666666667,1514.0,583.8571428571429
208996.0,17,2,762,2,762,0.0,381.0,381.0,0,0,0.0,0.0,0.0
37762.0,6,14,4740,7,653,6078.666666666667,249.0,93.28571428571428,7,4087,5568.5,1514.0,583.8571428571429
103050.0,17,2,286,2,286,0.0,143.0,143.0,0,0,0.0,0.0,0.0
153405.0,17,2,180,1,90,0.0,90.0,90.0,1,90,0.0,90.0,90.0
60809.0,6,10,2032,5,524,14991.25,252.0,104.8,5,1508,14926.0,1236.0,301.6
2406.0,17,4,344,2,150,0.0,75.0,75.0,2,194,0.0,103.0,97.0
101038475.0,6,30,2122,15,1105,7201621.0,139.0,73.66666666666667,15,1017,7201614.785714285,123.0,67.8
124001123.0,17,15,907,8,475,17714446.14285714,174.0,59.375,7,432,17334026.666666668,174.0,61.71428571428572
118036627.0,6,30,1974,15,1026,8415780.714285715,123.0,68.4,15,948,8415780.142857144,123.0,63.2
90096590.0,6,11,1644,4,816,30030804.666666668,204.0,204.0,7,828,15015711.166666666,188.0,118.28571428571428
309108.0,6,6,412,4,272,103036.0,74.0,68.0,2,140,0.0,74.0,70.0
106848.0,17,2,700,2,700,0.0,350.0,350.0,0,0,0.0,0.0,0.0
98191942.0,6,181,20500,91,14326,1091021.5777777778,284.0,157.42857142857142,90,6174,1100406.8539325842,140.0,68.6
90043415.0,17,28,13364,28,13364,3334941.296296296,501.0,477.2857142857143,0,0,0.0,0.0,0.0
131201.0,6,3,337,2,214,0.0,160.0,107.0,1,123,0.0,123.0,123.0
120013459.0,6,46,3036,24,1584,5217976.478260869,66.0,66.0,22,1452,5076850.904761905,66.0,66.0
24225.0,6,14,4740,7,653,3781.5,249.0,93.28571428571428,7,4087,3899.0,1514.0,583.8571428571429
0.0,17,1,381,1,381,0.0,381.0,381.0,0,0,0.0,0.0,0.0
318159.0,17,4,1400,4,1400,106053.0,350.0,350.0,0,0,0.0,0.0,0.0
104168778.0,6,44,2904,22,1452,4960418.0,66.0,66.0,22,1452,4945680.666666667,66.0,66.0
62780.0,6,13,1394,7,797,10463.333333333334,253.0,113.85714285714286,6,597,11236.8,259.0,99.5
120000686.0,6,19,1436,10,745,13333409.555555556,95.0,74.5,9,691,14967339.0,95.0,76.77777777777777
31018.0,6,10,2032,5,524,6156.25,252.0,104.8,5,1508,7166.0,1236.0,301.6
218070.0,6,3,426,2,280,0.0,214.0,140.0,1,146,0.0,146.0,146.0
730.0,17,4,438,2,148,0.0,74.0,74.0,2,290,0.0,147.0,145.0
120087989.0,6,230,25994,115,7886,1046169.052631579,140.0,68.57391304347826,115,18108,1047235.5087719298,284.0,157.4608695652174
488.0,17,2,508,2,508,0.0,257.0,254.0,0,0,0.0,0.0,0.0
41025.0,6,10,2032,5,524,9598.75,252.0,104.8,5,1508,9098.75,1236.0,301.6
90061906.0,17,28,13364,28,13364,3335626.1481481483,501.0,477.2857142857143,0,0,0.0,0.0,0.0
100124271.0,17,12,516,6,258,20000168.8,43.0,43.0,6,258,20001438.8,43.0,43.0
90538276.0,6,16,2246,9,1094,11317284.5,188.0,121.55555555555556,7,1152,15060759.333333334,204.0,164.57142857142858
23556.0,6,10,2032,5,524,5497.5,252.0,104.8,5,1508,5421.75,1236.0,301.6
109741.0,17,2,286,2,286,0.0,143.0,143.0,0,0,0.0,0.0,0.0
336.0,17,2,160,1,80,0.0,80.0,80.0,1,80,0.0,80.0,80.0
46461.0,6,14,4740,7,653,7190.833333333333,249.0,93.28571428571428,7,4087,7607.166666666667,1514.0,583.8571428571429
126355011.0,6,33,2296,17,1225,7897188.1875,139.0,72.05882352941177,16,1071,7743449.466666667,123.0,66.9375
390.0,17,2,341,1,86,0.0,86.0,86.0,1,255,0.0,255.0,255.0
350.0,17,2,267,1,83,0.0,83.0,83.0,1,184,0.0,184.0,184.0
2837.0,17,2,224,1,76,0.0,76.0,76.0,1,148,0.0,148.0,148.0
53148.0,6,11,2098,6,590,9689.4,252.0,98.33333333333331,5,1508,13016.0,1236.0,301.6
30221.0,6,14,4740,7,653,4620.5,249.0,93.28571428571428,7,4087,4100.166666666667,1514.0,583.8571428571429
95841835.0,6,177,19938,89,6096,1089111.7613636365,140.0,68.49438202247191,88,13842,1089674.3908045976,284.0,157.29545454545453
40071.0,6,14,4740,7,653,6557.166666666667,249.0,93.28571428571428,7,4087,6039.666666666667,1514.0,583.8571428571429
301046.0,6,6,412,4,272,100348.66666666669,74.0,68.0,2,140,0.0,74.0,70.0
120120554.0,6,13,2036,8,1016,17136575.0,188.0,127.0,5,1020,22523839.5,204.0,204.0
106452.0,17,2,762,2,762,0.0,381.0,381.0,0,0,0.0,0.0,0.0
8924.0,17,2,498,1,80,0.0,80.0,80.0,1,418,0.0,418.0,418.0
241181.0,17,4,1524,4,1524,80393.66666666667,381.0,381.0,0,0,0.0,0.0,0.0
147091.0,6,3,373,2,238,0.0,172.0,119.0,1,135,0.0,135.0,135.0
873717.0,6,10,1162,6,625,174743.4,287.0,104.16666666666669,4,537,199378.0,331.0,134.25
100747.0,6,14,4740,7,653,16672.333333333332,249.0,93.28571428571428,7,4087,15521.0,1514.0,583.8571428571429
228277.0,17,2,180,1,90,0.0,90.0,90.0,1,90,0.0,90.0,90.0
120125516.0,6,15,2428,9,1204,15015689.5,188.0,133.77777777777777,6,1224,18073997.4,204.0,204.0
31823.0,6,14,4740,7,653,4709.333333333333,249.0,93.28571428571428,7,4087,5123.833333333333,1514.0,583.8571428571429
20437.0,17,2,571,1,86,0.0,86.0,86.0,1,485,0.0,485.0,485.0
120200435.0,6,21,1585,10,786,13332876.444444444,95.0,78.6,11,799,11999583.7,95.0,72.63636363636364
10474528.0,6,7,478,4,272,3446011.333333333,74.0,68.0,3,206,5168914.0,74.0,68.66666666666667
52931.0,6,10,1913,5,461,12580.0,233.0,92.2,5,1452,12319.25,1224.0,290.4
247092.0,6,3,337,2,214,0.0,160.0,107.0,1,123,0.0,123.0,123.0
55615.0,6,14,4740,7,653,9105.833333333334,249.0,93.28571428571428,7,4087,7293.166666666667,1514.0,583.8571428571429
2233017.0,6,23,7478,12,2450,203001.54545454544,1034.0,204.16666666666663,11,5028,192052.2,1510.0,457.09090909090907
46962.0,6,14,4740,7,653,7696.333333333333,249.0,93.28571428571428,7,4087,6858.333333333333,1514.0,583.8571428571429
108451400.0,6,44,2904,22,1452,5164352.380952381,66.0,66.0,22,1452,5149479.047619048,66.0,66.0
135138902.0,17,6,1146,6,1146,27027780.4,191.0,191.0,0,0,0.0,0.0,0.0
2366.0,17,4,344,2,150,0.0,75.0,75.0,2,194,0.0,103.0,97.0
157240.0,6,3,337,2,214,0.0,160.0,107.0,1,123,0.0,123.0,123.0
5007088.0,17,4,849,2,166,0.0,83.0,83.0,2,683,0.0,499.0,341.5
109464887.0,6,196,22092,98,15402,1126272.6804123712,284.0,157.16326530612244,98,6690,1126272.7525773195,140.0,68.26530612244898
100901038.0,6,182,20628,91,6228,1111997.7777777778,140.0,68.43956043956044,91,14400,1111317.7333333334,284.0,158.24175824175825
2242.0,17,4,344,2,150,0.0,75.0,75.0,2,194,0.0,103.0,97.0
5627126.0,6,4,270,2,134,0.0,68.0,67.0,2,136,0.0,70.0,68.0
2321.0,17,4,344,2,150,0.0,75.0,75.0,2,194,0.0,103.0,97.0
90256970.0,6,13,2036,8,1016,12893852.857142856,188.0,127.0,5,1020,22522974.75,204.0,204.0
13328.0,17,2,208,1,72,0.0,72.0,72.0,1,136,0.0,136.0,136.0
2560.0,17,2,762,2,762,0.0,381.0,381.0,0,0,0.0,0.0,0.0
22745.0,6,11,1133,6,602,2907.8,264.0,100.33333333333331,5,531,4947.0,259.0,106.2
120001718.0,6,22,1879,11,799,11999888.9,95.0,72.63636363636364,11,1080,11999445.5,215.0,98.1818181818182
833660.0,6,9,1118,6,586,166732.0,248.0,97.66666666666669,3,532,280546.0,392.0,177.33333333333334
108103445.0,17,5,1005,5,1005,27025861.25,201.0,201.0,0,0,0.0,0.0,0.0
323308.0,17,4,704,2,148,0.0,74.0,74.0,2,556,0.0,280.0,278.0
196902.0,17,2,180,1,90,0.0,90.0,90.0,1,90,0.0,90.0,90.0
300891.0,6,6,412,4,272,100297.0,74.0,68.0,2,140,0.0,74.0,70.0
103506186.0,17,14,864,7,432,17168540.333333332,174.0,61.71428571428572,7,432,17166828.333333332,174.0,61.71428571428572
2439.0,17,4,344,2,150,0.0,75.0,75.0,2,194,0.0,103.0,97.0
0.0,6,1,66,1,66,0.0,66.0,66.0,0,0,0.0,0.0,0.0
46263.0,6,14,4740,7,653,7499.166666666667,249.0,93.28571428571428,7,4087,6974.0,1514.0,583.8571428571429
308151.0,6,6,412,4,272,102717.0,74.0,68.0,2,140,0.0,74.0,70.0
321.0,17,2,174,1,79,0.0,79.0,79.0,1,95,0.0,95.0,95.0
2368.0,17,4,344,2,150,0.0,75.0,75.0,2,194,0.0,103.0,97.0
3174047.0,6,18,1536,9,962,358387.875,315.0,106.88888888888889,9,574,358358.375,78.0,63.77777777777778
218978.0,6,3,426,2,280,0.0,214.0,140.0,1,146,0.0,146.0,146.0
208765.0,6,3,426,2,280,0.0,214.0,140.0,1,146,0.0,146.0,146.0
149785386.0,17,36,17126,36,17126,4279582.457142857,501.0,475.72222222222223,0,0,0.0,0.0,0.0
42138.0,6,10,2032,5,524,10015.75,252.0,104.8,5,1508,9699.25,1236.0,301.6
120055173.0,17,29,13785,29,13785,4287684.75,501.0,475.3448275862069,0,0,0.0,0.0,0.0
120086534.0,6,38,2710,19,1408,6659463.444444444,139.0,74.10526315789474,19,1302,6659467.166666667,123.0,68.52631578947368
90052973.0,17,28,13364,28,13364,3335295.296296296,501.0,477.2857142857143,0,0,0.0,0.0,0.0
107005906.0,17,13,821,7,432,17834317.666666668,174.0,61.71428571428572,6,389,17400208.4,174.0,64.83333333333333
332.0,17,2,208,1,72,0.0,72.0,72.0,1,136,0.0,136.0,136.0
330041.0,6,6,412,4,272,110013.66666666669,74.0,68.0,2,140,0.0,74.0,70.0
939307.0,6,2,132,1,66,0.0,66.0,66.0,1,66,0.0,66.0,66.0
149783679.0,17,36,17126,36,17126,4279533.685714286,501.0,475.72222222222223,0,0,0.0,0.0,0.0
105357498.0,6,44,2904,22,1452,5017023.714285715,66.0,66.0,22,1452,5002677.19047619,66.0,66.0
108108895.0,17,5,955,5,955,27027223.75,191.0,191.0,0,0,0.0,0.0,0.0
101696072.0,17,14,1126,7,563,16667812.0,174.0,80.42857142857143,7,563,16833485.0,174.0,80.42857142857143
135139644.0,17,6,1206,6,1206,27027928.8,201.0,201.0,0,0,0.0,0.0,0.0
5005250.0,17,4,849,2,166,0.0,83.0,83.0,2,683,0.0,499.0,341.5
884809.0,6,10,1262,6,725,176961.8,387.0,120.83333333333331,4,537,203026.3333333333,331.0,134.25
882665.0,6,12,2718,7,743,147110.83333333334,339.0,106.14285714285714,5,1975,152551.0,1514.0,395.0
120262583.0,6,228,25772,114,7820,1056883.4867256638,140.0,68.59649122807018,114,17952,1056938.4336283186,284.0,157.47368421052633
121488.0,6,3,337,2,214,0.0,160.0,107.0,1,123,0.0,123.0,123.0
1044265.0,17,2,246,1,76,0.0,76.0,76.0,1,170,0.0,170.0,170.0
206378.0,6,3,426,2,280,0.0,214.0,140.0,1,146,0.0,146.0,146.0
241327.0,6,3,337,2,214,0.0,160.0,107.0,1,123,0.0,123.0,123.0
142334.0,17,2,176,1,80,0.0,80.0,80.0,1,96,0.0,96.0,96.0
46977.0,6,14,4740,7,653,7550.0,249.0,93.28571428571428,7,4087,7605.833333333333,1514.0,583.8571428571429
3693.0,17,4,344,2,150,0.0,75.0,75.0,2,194,0.0,103.0,97.0
2002.0,17,4,344,2,150,0.0,75.0,75.0,2,194,0.0,103.0,97.0
228309.0,17,2,180,1,90,0.0,90.0,90.0,1,90,0.0,90.0,90.0
232574.0,17,2,180,1,90,0.0,90.0,90.0,1,90,0.0,90.0,90.0
126001342.0,17,15,907,8,475,18000191.714285713,174.0,59.375,7,432,17667572.166666668,174.0,61.71428571428572
104033.0,17,2,700,2,700,0.0,350.0,350.0,0,0,0.0,0.0,0.0
1771836.0,6,2,132,1,66,0.0,66.0,66.0,1,66,0.0,66.0,66.0
213435.0,17,2,180,1,90,0.0,90.0,90.0,1,90,0.0,90.0,90.0
120251519.0,6,224,25312,112,7688,1075876.5945945946,140.0,68.64285714285714,112,17624,1079380.7477477477,284.0,157.35714285714286
90255308.0,6,12,1832,8,1016,12893615.42857143,188.0,127.0,4,816,30030746.0,204.0,204.0
834255.0,6,9,1118,6,586,166851.0,248.0,97.66666666666669,3,532,280534.0,392.0,177.33333333333334
228445.0,17,2,180,1,90,0.0,90.0,90.0,1,90,0.0,90.0,90.0
2589703.0,6,2,132,1,66,0.0,66.0,66.0,1,66,0.0,66.0,66.0
21990308.0,17,3,1034,2,684,0.0,342.0,342.0,1,350,0.0,350.0,350.0
114243.0,17,4,1400,4,1400,38081.0,350.0,350.0,0,0,0.0,0.0,0.0
108100715.0,17,5,1005,5,1005,27025178.75,201.0,201.0,0,0,0.0,0.0,0.0
39304.0,6,14,4740,7,653,6429.666666666667,249.0,93.28571428571428,7,4087,5253.833333333333,1514.0,583.8571428571429
120163378.0,6,14,2224,9,1204,15020422.25,188.0,133.77777777777777,5,1020,22591821.25,204.0,204.0
340.0,17,2,267,1,83,0.0,83.0,83.0,1,184,0.0,184.0,184.0
1158907.0,6,13,3011,8,2383,165558.14285714287,1514.0,297.875,5,628,220959.75,331.0,125.6
120012693.0,6,21,1585,11,840,11999997.1,95.0,76.36363636363636,10,745,13334117.333333334,95.0,74.5
278924.0,6,10,1221,6,636,55784.8,298.0,106.0,4,585,87538.0,379.0,146.25
108097979.0,17,5,1005,5,1005,27024494.75,201.0,201.0,0,0,0.0,0.0,0.0
20402.0,6,10,2032,5,524,4874.75,252.0,104.8,5,1508,4347.75,1236.0,301.6
246809.0,6,3,373,2,238,0.0,172.0,119.0,1,135,0.0,135.0,135.0
207360.0,6,3,426,2,280,0.0,214.0,140.0,1,146,0.0,146.0,146.0
153410.0,17,2,180,1,90,0.0,90.0,90.0,1,90,0.0,90.0,90.0
48356.0,6,10,2032,5,524,10738.5,252.0,104.8,5,1508,9909.25,1236.0,301.6
303099.0,6,2,132,1,66,0.0,66.0,66.0,1,66,0.0,66.0,66.0
895752.0,6,10,1334,6,797,179150.4,459.0,132.83333333333334,4,537,206675.0,331.0,134.25
5612946.0,6,5,336,2,134,0.0,68.0,67.0,3,202,1423418.0,70.0,67.33333333333333
100895692.0,17,12,778,6,389,20076106.6,174.0,64.83333333333333,6,389,20147187.4,174.0,64.83333333333333
120052381.0,17,29,13785,29,13785,4287585.035714285,501.0,475.3448275862069,0,0,0.0,0.0,0.0
228101.0,17,2,180,1,90,0.0,90.0,90.0,1,90,0.0,90.0,90.0
120186909.0,6,209,23692,105,16532,1155643.3557692308,284.0,157.44761904761904,104,7160,1159277.1941747572,140.0,68.84615384615384
14519.0,6,10,1067,5,536,3392.0,264.0,107.2,5,531,3194.0,259.0,106.2
52406.0,6,14,4740,7,653,8380.5,249.0,93.28571428571428,7,4087,7602.0,1514.0,583.8571428571429
126890.0,6,2,132,1,66,0.0,66.0,66.0,1,66,0.0,66.0,66.0
108113359.0,17,5,955,5,955,27028339.75,191.0,191.0,0,0,0.0,0.0,0.0
146236.0,6,3,337,2,214,0.0,160.0,107.0,1,123,0.0,123.0,123.0
140478.0,6,12,1447,6,816,26571.6,291.0,136.0,6,631,27369.6,293.0,105.16666666666669
147366.0,6,3,373,2,238,0.0,172.0,119.0,1,135,0.0,135.0,135.0
308128.0,6,6,412,4,272,102709.33333333331,74.0,68.0,2,140,0.0,74.0,70.0
10483881.0,6,7,478,4,272,3447593.6666666665,74.0,68.0,3,206,5171200.0,74.0,68.66666666666667
207979.0,6,3,426,2,280,0.0,214.0,140.0,1,146,0.0,146.0,146.0
316522.0,17,4,1400,4,1400,105507.33333333331,350.0,350.0,0,0,0.0,0.0,0.0
90532953.0,6,14,2240,8,1016,12933279.0,188.0,127.0,6,1224,18073827.8,204.0,204.0
154980.0,6,3,337,2,214,0.0,160.0,107.0,1,123,0.0,123.0,123.0
0.0,6,1,66,1,66,0.0,66.0,66.0,0,0,0.0,0.0,0.0
146377.0,6,3,337,2,214,0.0,160.0,107.0,1,123,0.0,123.0,123.0
323.0,17,2,166,1,75,0.0,75.0,75.0,1,91,0.0,91.0,91.0
305191.0,6,6,412,4,272,101730.33333333331,74.0,68.0,2,140,0.0,74.0,70.0
32659.0,6,14,4740,7,653,5278.166666666667,249.0,93.28571428571428,7,4087,5224.166666666667,1514.0,583.8571428571429
314626.0,17,4,1400,4,1400,104875.33333333331,350.0,350.0,0,0,0.0,0.0,0.0
108101345.0,17,5,1005,5,1005,27025336.25,201.0,201.0,0,0,0.0,0.0,0.0
249117.0,6,3,337,2,214,0.0,160.0,107.0,1,123,0.0,123.0,123.0
10511331.0,6,7,478,4,272,3458542.6666666665,74.0,68.0,3,206,5187731.5,74.0,68.66666666666667
122896.0,6,13,1394,7,797,20482.666666666668,253.0,113.85714285714286,6,597,22900.6,259.0,99.5
26297.0,6,14,4740,7,653,4018.1666666666665,249.0,93.28571428571428,7,4087,4115.0,1514.0,583.8571428571429
5623331.0,6,4,270,2,134,0.0,68.0,67.0,2,136,0.0,70.0,68.0
108104220.0,17,5,955,5,955,27026055.0,191.0,191.0,0,0,0.0,0.0,0.0
243499.0,6,3,337,2,214,0.0,160.0,107.0,1,123,0.0,123.0,123.0
744.0,17,4,438,2,148,0.0,74.0,74.0,2,290,0.0,147.0,145.0
50961.0,17,2,180,1,90,0.0,90.0,90.0,1,90,0.0,90.0,90.0
143235.0,6,2,132,1,66,0.0,66.0,66.0,1,66,0.0,66.0,66.0
6025710.0,17,3,1143,3,1143,3012855.0,381.0,381.0,0,0,0.0,0.0,0.0
5288.0,17,2,180,1,90,0.0,90.0,90.0,1,90,0.0,90.0,90.0
387.0,17,2,174,1,79,0.0,79.0,79.0,1,95,0.0,95.0,95.0
149466.0,17,4,6056,4,6056,49822.0,1514.0,1514.0,0,0,0.0,0.0,0.0
90296802.0,6,16,1192,8,596,12892651.857142856,95.0,74.5,8,596,12897322.857142856,95.0,74.5
0.0,17,1,55,1,55,0.0,55.0,55.0,0,0,0.0,0.0,0.0
108109604.0,17,5,1005,5,1005,27027401.0,201.0,201.0,0,0,0.0,0.0,0.0
215291.0,6,12,1373,7,714,35881.833333333336,298.0,102.0,5,659,52784.25,379.0,131.8
250906.00000000003,17,4,6056,4,6056,83635.33333333333,1514.0,1514.0,0,0,0.0,0.0,0.0
90053047.0,17,28,13364,28,13364,3335298.037037037,501.0,477.2857142857143,0,0,0.0,0.0,0.0
135118939.0,17,6,1206,6,1206,27023787.8,201.0,201.0,0,0,0.0,0.0,0.0
121365.0,6,3,337,2,214,0.0,160.0,107.0,1,123,0.0,123.0,123.0
123306995.0,6,48,3168,24,1584,5133554.304347826,66.0,66.0,24,1584,5156999.826086956,66.0,66.0
26614.0,6,11,1133,6,602,4972.2,264.0,100.33333333333331,5,531,4680.0,259.0,106.2
28205.0,6,14,4740,7,653,4352.166666666667,249.0,93.28571428571428,7,4087,4559.333333333333,1514.0,583.8571428571429
100663824.0,6,29,2062,15,1017,7190273.142857143,123.0,67.8,14,1045,7556247.846153846,139.0,74.64285714285714
144166.0,17,2,180,1,90,0.0,90.0,90.0,1,90,0.0,90.0,90.0
205591.0,6,3,426,2,280,0.0,214.0,140.0,1,146,0.0,146.0,146.0
146408.0,6,2,132,1,66,0.0,66.0,66.0,1,66,0.0,66.0,66.0
90764498.0,6,21,1585,10,786,10084944.222222222,95.0,78.6,11,799,9046995.2,95.0,72.63636363636364
874080.0,6,5,1742,3,921,437040.0,785.0,307.0,2,821,0.0,753.0,410.5
128090529.0,6,21,1713,11,968,12809052.9,223.0,88.0,10,745,13257123.0,95.0,74.5
108110385.0,17,5,955,5,955,27027596.25,191.0,191.0,0,0,0.0,0.0,0.0
90254833.0,6,12,1832,8,1016,12893547.57142857,188.0,127.0,4,816,30030469.666666668,204.0,204.0
120223696.0,6,218,24662,109,7416,1107587.8055555555,140.0,68.03669724770643,109,17246,1106498.8240740742,284.0,158.22018348623854
1302527.0,6,4,264,2,132,0.0,66.0,66.0,2,132,0.0,66.0,66.0
36529.0,6,14,4740,7,653,4531.333333333333,249.0,93.28571428571428,7,4087,5035.666666666667,1514.0,583.8571428571429
108104923.0,17,5,955,5,955,27026230.75,191.0,191.0,0,0,0.0,0.0,0.0
100320760.0,6,28,1945,14,963,7716981.538461538,123.0,68.78571428571429,14,982,7700204.615384615,139.0,70.14285714285714
171795.0,6,2,132,1,66,0.0,66.0,66.0,1,66,0.0,66.0,66.0
204362.0,17,2,762,2,762,0.0,381.0,381.0,0,0,0.0,0.0,0.0
147090.0,6,3,373,2,238,0.0,172.0,119.0,1,135,0.0,135.0,135.0
2456.0,17,4,344,2,150,0.0,75.0,75.0,2,194,0.0,103.0,97.0
47606139.0,6,7,1874,3,887,22468873.5,753.0,295.6666666666667,4,987,15012873.0,785.0,246.75
208292.0,6,3,426,2,280,0.0,214.0,140.0,1,146,0.0,146.0,146.0
154910.0,17,4,1400,4,1400,51636.66666666666,350.0,350.0,0,0,0.0,0.0,0.0
2106857.0,6,23,7479,12,2450,191532.45454545456,1034.0,204.16666666666663,11,5029,179412.2,1510.0,457.1818181818182
247117.0,17,2,180,1,90,0.0,90.0,90.0,1,90,0.0,90.0,90.0
205969.0,6,3,426,2,280,0.0,214.0,140.0,1,146,0.0,146.0,146.0
31927.0,6,10,2032,5,524,7495.5,252.0,104.8,5,1508,7447.0,1236.0,301.6
277849.0,17,2,363,1,79,0.0,79.0,79.0,1,284,0.0,284.0,284.0
183344.0,17,4,1524,4,1524,61114.66666666666,381.0,381.0,0,0,0.0,0.0,0.0
44479.0,6,14,4740,7,653,6565.333333333333,249.0,93.28571428571428,7,4087,7202.333333333333,1514.0,583.8571428571429
129864165.0,6,34,2340,18,1269,7639068.529411765,123.0,70.5,16,1071,7978328.4,123.0,66.9375
100121682.0,17,14,1126,7,563,16666796.0,174.0,80.42857142857143,7,563,16666839.666666666,174.0,80.42857142857143
97269578.0,17,12,778,6,389,19401100.0,174.0,64.83333333333333,6,389,19400163.0,174.0,64.83333333333333
308494.0,6,6,412,4,272,102831.33333333331,74.0,68.0,2,140,0.0,74.0,70.0
122001899.0,6,232,26306,116,7952,1025876.9217391304,140.0,68.55172413793103,116,18354,1053804.947826087,374.0,158.22413793103448
4366.0,17,2,614,1,72,0.0,72.0,72.0,1,542,0.0,542.0,542.0
2589.0,17,4,344,2,150,0.0,75.0,75.0,2,194,0.0,103.0,97.0
27484.0,6,10,2032,5,524,6547.0,252.0,104.8,5,1508,6570.0,1236.0,301.6
27072357.0,17,5,1718,4,1368,1747151.3333333333,342.0,342.0,1,350,0.0,350.0,350.0
18306.0,6,14,4740,7,653,2935.333333333333,249.0,93.28571428571428,7,4087,2857.833333333333,1514.0,583.8571428571429
51753155.0,17,561,239134,364,223060,142563.45454545456,1316.0,612.8021978021978,197,16074,264028.5918367347,309.0,81.59390862944163
20290.0,17,2,582,1,83,0.0,83.0,83.0,1,499,0.0,499.0,499.0
1993.0,17,4,344,2,150,0.0,75.0,75.0,2,194,0.0,103.0,97.0
9371.0,17,2,582,1,83,0.0,83.0,83.0,1,499,0.0,499.0,499.0
0.0,17,1,381,1,381,0.0,381.0,381.0,0,0,0.0,0.0,0.0
101665227.0,17,14,864,7,432,16834183.833333332,174.0,61.71428571428572,7,432,16833500.833333332,174.0,61.71428571428572
120122191.0,6,13,2020,9,1204,15015273.875,188.0,133.77777777777777,4,816,30031216.0,204.0,204.0
509342.0,6,5,336,2,134,0.0,68.0,67.0,3,202,192712.5,70.0,67.33333333333333
44216.0,6,14,4740,7,653,6848.833333333333,249.0,93.28571428571428,7,4087,6575.5,1514.0,583.8571428571429
2348.0,17,4,344,2,150,0.0,75.0,75.0,2,194,0.0,103.0,97.0
56353.0,6,14,4740,7,653,7523.166666666667,249.0,93.28571428571428,7,4087,8822.666666666666,1514.0,583.8571428571429
109435121.0,6,31,2166,16,1149,7295674.733333333,123.0,71.8125,15,1017,7801342.071428572,123.0,67.8
95454730.0,6,30,2238,15,1086,6818163.928571428,123.0,72.4,15,1152,6104992.285714285,123.0,76.8
302.0,17,2,168,1,76,0.0,76.0,76.0,1,92,0.0,92.0,92.0
449829.0,6,11,1021,6,444,61090.6,162.0,74.0,5,577,76280.75,349.0,115.4
197626.0,17,2,180,1,90,0.0,90.0,90.0,1,90,0.0,90.0,90.0
119637543.0,6,326,37602,163,26622,737109.0185185185,284.0,163.32515337423314,163,10980,737108.7160493827,140.0,67.36196319018404
204866.0,17,2,762,2,762,0.0,381.0,381.0,0,0,0.0,0.0,0.0
5615408.0,6,5,336,2,134,0.0,68.0,67.0,3,202,1524689.5,70.0,67.33333333333333
122010727.0,17,15,907,8,475,17430103.85714286,174.0,59.375,7,432,17000184.5,174.0,61.71428571428572
285.0,17,2,168,1,76,0.0,76.0,76.0,1,92,0.0,92.0,92.0
197359.0,17,2,180,1,90,0.0,90.0,90.0,1,90,0.0,90.0,90.0
120065708.0,17,28,13364,28,13364,4446878.074074074,501.0,477.2857142857143,0,0,0.0,0.0,0.0
113328262.0,6,223,25220,112,7688,1020975.3333333334,140.0,68.64285714285714,111,17532,1020900.9181818182,300.0,157.94594594594594
1023544.0,6,11,1134,6,558,204708.8,220.0,93.0,5,576,255158.25,304.0,115.2
135131947.0,17,6,1146,6,1146,27026389.4,191.0,191.0,0,0,0.0,0.0,0.0
90954842.0,6,21,1585,11,840,9094162.0,95.0,76.36363636363636,10,745,10105070.111111112,95.0,74.5
90276780.0,6,17,1374,9,819,11284597.5,223.0,91.0,8,555,12855569.57142857,95.0,69.375
0.0,17,1,55,1,55,0.0,55.0,55.0,0,0,0.0,0.0,0.0
2352.0,17,4,344,2,150,0.0,75.0,75.0,2,194,0.0,103.0,97.0
108672.0,17,2,286,2,286,0.0,143.0,143.0,0,0,0.0,0.0,0.0
4449.0,17,2,626,1,72,0.0,72.0,72.0,1,554,0.0,554.0,554.0
206964.0,6,10,1221,6,636,41392.8,298.0,106.0,4,585,67836.33333333333,379.0,146.25
740480.0,6,11,1131,6,600,147778.0,262.0,100.0,5,531,184902.5,259.0,106.2
18545274.0,6,5,1736,2,819,0.0,753.0,409.5,3,917,9208281.5,785.0,305.6666666666667
128851145.0,6,35,2394,18,1269,7579479.117647059,123.0,70.5,17,1125,7415654.625,123.0,66.17647058823529
108127449.0,17,5,1005,5,1005,27031862.25,201.0,201.0,0,0,0.0,0.0,0.0
302406.0,6,2,132,1,66,0.0,66.0,66.0,1,66,0.0,66.0,66.0
35869.0,6,14,4740,7,653,5830.666666666667,249.0,93.28571428571428,7,4087,5628.833333333333,1514.0,583.8571428571429
9864.0,17,2,582,1,83,0.0,83.0,83.0,1,499,0.0,499.0,499.0
147563.0,6,3,373,2,238,0.0,172.0,119.0,1,135,0.0,135.0,135.0
204322.0,6,10,1221,6,636,40864.4,298.0,106.0,4,585,67002.33333333333,379.0,146.25
120123136.0,6,15,2152,9,1204,15015392.0,188.0,133.77777777777777,6,948,18015226.8,204.0,158.0
246959.0,17,2,180,1,90,0.0,90.0,90.0,1,90,0.0,90.0,90.0
105235.0,17,2,700,2,700,0.0,350.0,350.0,0,0,0.0,0.0,0.0
2431.0,17,4,344,2,150,0.0,75.0,75.0,2,194,0.0,103.0,97.0
59278099.0,17,9,3086,8,2736,5177531.571428572,342.0,342.0,1,350,0.0,350.0,350.0
44470.0,6,10,2032,5,524,10869.0,252.0,104.8,5,1508,10721.75,1236.0,301.6
248331.0,6,3,337,2,214,0.0,160.0,107.0,1,123,0.0,123.0,123.0
332.0,17,2,166,1,75,0.0,75.0,75.0,1,91,0.0,91.0,91.0
40548.0,6,14,4740,7,653,6324.166666666667,249.0,93.28571428571428,7,4087,5604.0,1514.0,583.8571428571429
5825248.0,6,5,336,2,134,0.0,68.0,67.0,3,202,1526999.5,70.0,67.33333333333333
120046205.0,6,18,1341,9,691,14999712.875,95.0,76.77777777777777,9,650,15000019.25,95.0,72.22222222222223
5833262.0,6,5,336,2,134,0.0,68.0,67.0,3,202,1525789.0,70.0,67.33333333333333
2794794.0,6,2,132,1,66,0.0,66.0,66.0,1,66,0.0,66.0,66.0
213653.0,17,2,876,2,876,0.0,438.0,438.0,0,0,0.0,0.0,0.0
1938071.0,6,4,492,2,280,0.0,214.0,140.0,2,212,0.0,146.0,106.0
5004108.0,17,4,849,2,166,0.0,83.0,83.0,2,683,0.0,499.0,341.5
1343474.0,17,5,961,3,234,671529.5,78.0,78.0,2,727,0.0,395.0,363.5
120305834.0,6,224,25484,112,7626,1076389.2882882883,140.0,68.08928571428571,112,17858,1076527.3873873877,284.0,159.44642857142858
109020601.0,17,14,1126,7,563,18143474.5,174.0,80.42857142857143,7,563,18143468.83333333,174.0,80.42857142857143
27906.0,6,14,4740,7,653,4529.0,249.0,93.28571428571428,7,4087,4431.166666666667,1514.0,583.8571428571429
153527.0,17,2,180,1,90,0.0,90.0,90.0,1,90,0.0,90.0,90.0
50350.0,6,14,4740,7,653,8070.5,249.0,93.28571428571428,7,4087,7865.666666666667,1514.0,583.8571428571429
228499.0,17,2,180,1,90,0.0,90.0,90.0,1,90,0.0,90.0,90.0
9486.0,17,2,582,1,83,0.0,83.0,83.0,1,499,0.0,499.0,499.0
10884308.0,6,8,544,4,272,3582738.0,74.0,68.0,4,272,3582680.0,74.0,68.0
107545.0,17,2,286,2,286,0.0,143.0,143.0,0,0,0.0,0.0,0.0
122145468.0,6,34,2466,17,1194,7010068.6875,123.0,70.23529411764706,17,1272,7149716.3125,123.0,74.82352941176471
108109026.0,17,5,1005,5,1005,27027256.5,201.0,201.0,0,0,0.0,0.0,0.0
16754.0,17,2,180,1,90,0.0,90.0,90.0,1,90,0.0,90.0,90.0
116848678.0,6,34,2334,17,1209,7289488.3125,123.0,71.11764705882354,17,1125,7289556.0625,123.0,66.17647058823529
60522.0,6,12,1320,7,789,10087.0,253.0,112.71428571428572,5,531,12420.75,259.0,106.2
96930760.0,17,14,4796,13,4446,6236325.0,342.0,342.0,1,350,0.0,350.0,350.0
120025198.0,17,28,13364,28,13364,4445377.703703703,501.0,477.2857142857143,0,0,0.0,0.0,0.0
153420.0,17,2,180,1,90,0.0,90.0,90.0,1,90,0.0,90.0,90.0
135132435.0,17,6,1146,6,1146,27026487.0,191.0,191.0,0,0,0.0,0.0,0.0
879819.0,6,9,1268,6,797,175963.8,459.0,132.83333333333334,3,471,302316.0,331.0,157.0
52317.0,6,14,4740,7,653,8574.166666666666,249.0,93.28571428571428,7,4087,8133.666666666667,1514.0,583.8571428571429
50231.0,6,2,132,1,66,0.0,66.0,66.0,1,66,0.0,66.0,66.0
135130945.0,17,6,1206,6,1206,27026189.0,201.0,201.0,0,0,0.0,0.0,0.0
41348.0,6,14,4740,7,653,6291.333333333333,249.0,93.28571428571428,7,4087,2906.0,1514.0,583.8571428571429
120262550.0,6,214,24202,107,7358,1123488.4716981133,140.0,68.76635514018692,107,16844,1126776.575471698,284.0,157.42056074766356
119878854.0,6,14,2102,5,1020,29968826.25,204.0,204.0,9,1082,14984466.375,188.0,120.22222222222224
120122434.0,6,14,2240,8,1016,17137085.14285714,188.0,127.0,6,1224,18018591.2,204.0,204.0
30245.0,6,10,2032,5,524,7241.0,252.0,104.8,5,1508,6158.25,1236.0,301.6
315505.0,17,4,1400,4,1400,105168.33333333331,350.0,350.0,0,0,0.0,0.0,0.0
307052.0,6,6,412,4,272,102350.66666666669,74.0,68.0,2,140,0.0,74.0,70.0
95478.0,6,2,132,1,66,0.0,66.0,66.0,1,66,0.0,66.0,66.0
0.0,6,1,66,1,66,0.0,66.0,66.0,0,0,0.0,0.0,0.0
108274821.0,6,215,24262,108,16978,1011914.214953271,284.0,157.2037037037037,107,7284,1019414.1320754716,140.0,68.07476635514018
63553.0,6,14,4740,7,653,8703.5,249.0,93.28571428571428,7,4087,9162.5,1514.0,583.8571428571429
15269.0,6,10,2032,5,524,3575.5,252.0,104.8,5,1508,3416.0,1236.0,301.6
106285.0,17,2,286,2,286,0.0,143.0,143.0,0,0,0.0,0.0,0.0
2028.0,17,4,344,2,150,0.0,75.0,75.0,2,194,0.0,103.0,97.0
123647631.0,6,48,3168,24,1584,5074396.782608695,66.0,66.0,24,1584,5215005.434782608,66.0,66.0
601423.0,6,4,508,2,238,0.0,172.0,119.0,2,270,0.0,135.0,135.0
217786.0,6,10,1221,6,636,43557.2,298.0,106.0,4,585,71396.66666666667,379.0,146.25
401.0,17,2,267,1,83,0.0,83.0,83.0,1,184,0.0,184.0,184.0
145135.0,17,2,180,1,70,0.0,70.0,70.0,1,110,0.0,110.0,110.0
221123.0,17,2,414,1,88,0.0,88.0,88.0,1,326,0.0,326.0,326.0
90056582.0,17,27,12943,27,12943,3463714.6923076925,501.0,479.3703703703704,0,0,0.0,0.0,0.0
995192.0,6,12,1362,6,731,198671.6,253.0,121.83333333333331,6,631,198112.4,293.0,105.16666666666669
206637.0,17,2,180,1,90,0.0,90.0,90.0,1,90,0.0,90.0,90.0
307351.0,6,6,412,4,272,102450.33333333331,74.0,68.0,2,140,0.0,74.0,70.0
108108158.0,17,5,1005,5,1005,27027039.5,201.0,201.0,0,0,0.0,0.0,0.0
26028.0,6,14,4740,7,653,4190.5,249.0,93.28571428571428,7,4087,3824.5,1514.0,583.8571428571429
90095250.0,6,12,1848,5,1020,22523244.75,204.0,204.0,7,828,14970222.166666666,188.0,118.28571428571428
68073.0,6,14,4740,7,653,10989.166666666666,249.0,93.28571428571428,7,4087,10123.333333333334,1514.0,583.8571428571429
1168843.0,6,13,3010,8,2382,166977.57142857142,1514.0,297.75,5,628,223417.75,331.0,125.6
253595.00000000003,6,3,337,2,214,0.0,160.0,107.0,1,123,0.0,123.0,123.0
12271.0,6,10,2032,5,524,2712.0,252.0,104.8,5,1508,2780.25,1236.0,301.6
316273.0,17,4,1400,4,1400,105424.33333333331,350.0,350.0,0,0,0.0,0.0,0.0
301318.0,6,6,412,4,272,100439.33333333331,74.0,68.0,2,140,0.0,74.0,70.0
0.0,17,1,381,1,381,0.0,381.0,381.0,0,0,0.0,0.0,0.0
1314627.0,6,4,264,2,132,0.0,66.0,66.0,2,132,0.0,66.0,66.0
146069.0,6,3,337,2,214,0.0,160.0,107.0,1,123,0.0,123.0,123.0
304323.0,6,6,412,4,272,101441.0,74.0,68.0,2,140,0.0,74.0,70.0
135135436.0,17,6,1206,6,1206,27027087.2,201.0,201.0,0,0,0.0,0.0,0.0
120253324.0,6,25,2848,12,1395,8221652.818181818,424.0,116.25,13,1453,10016988.583333334,334.0,111.76923076923076
121272.0,6,3,337,2,214,0.0,160.0,107.0,1,123,0.0,123.0,123.0
40434.0,6,14,4740,7,653,6549.833333333333,249.0,93.28571428571428,7,4087,6200.0,1514.0,583.8571428571429
3032.0,17,2,224,1,76,0.0,76.0,76.0,1,148,0.0,148.0,148.0
108107907.0,17,5,955,5,955,27026976.75,191.0,191.0,0,0,0.0,0.0,0.0
0.0,17,1,381,1,381,0.0,381.0,381.0,0,0,0.0,0.0,0.0
102901.0,17,2,286,2,286,0.0,143.0,143.0,0,0,0.0,0.0,0.0
323.0,17,2,174,1,79,0.0,79.0,79.0,1,95,0.0,95.0,95.0
100206068.0,17,12,778,6,389,19980227.8,174.0,64.83333333333333,6,389,20009032.6,174.0,64.83333333333333
323.0,17,2,174,1,79,0.0,79.0,79.0,1,95,0.0,95.0,95.0
123839735.0,6,48,3168,24,1584,5042124.173913044,66.0,66.0,24,1584,5255309.478260869,66.0,66.0
99687.0,17,2,762,2,762,0.0,381.0,381.0,0,0,0.0,0.0,0.0
162314.0,17,2,180,1,90,0.0,90.0,90.0,1,90,0.0,90.0,90.0
217768.0,6,3,426,2,280,0.0,214.0,140.0,1,146,0.0,146.0,146.0
107417.0,17,2,286,2,286,0.0,143.0,143.0,0,0,0.0,0.0,0.0
90306595.0,6,16,1192,8,596,12893712.0,95.0,74.5,8,596,12899004.857142856,95.0,74.5
892.0,17,4,316,2,158,0.0,79.0,79.0,2,158,0.0,79.0,79.0
108112897.0,17,5,1005,5,1005,27028224.25,201.0,201.0,0,0,0.0,0.0,0.0
830734.0,6,9,1118,6,586,166146.8,248.0,97.66666666666669,3,532,279146.5,392.0,177.33333333333334
206432.0,17,2,180,1,90,0.0,90.0,90.0,1,90,0.0,90.0,90.0
233436.0,6,3,337,2,214,0.0,160.0,107.0,1,123,0.0,123.0,123.0
284281.0,17,2,363,1,79,0.0,79.0,79.0,1,284,0.0,284.0,284.0
157906.0,17,2,180,1,90,0.0,90.0,90.0,1,90,0.0,90.0,90.0
2929.0,17,4,344,2,150,0.0,75.0,75.0,2,194,0.0,103.0,97.0
10483366.0,6,7,478,4,272,3449028.0,74.0,68.0,3,206,5173447.5,74.0,68.66666666666667
162526.0,6,3,337,2,214,0.0,160.0,107.0,1,123,0.0,123.0,123.0
42772.0,6,14,4740,7,653,6978.5,249.0,93.28571428571428,7,4087,6933.833333333333,1514.0,583.8571428571429
310939.0,6,6,412,4,272,103646.33333333331,74.0,68.0,2,140,0.0,74.0,70.0
2392.0,17,4,344,2,150,0.0,75.0,75.0,2,194,0.0,103.0,97.0
2364.0,17,4,344,2,150,0.0,75.0,75.0,2,194,0.0,103.0,97.0
306956.0,6,6,412,4,272,102318.66666666669,74.0,68.0,2,140,0.0,74.0,70.0
15066.0,17,2,180,1,90,0.0,90.0,90.0,1,90,0.0,90.0,90.0
10427407.0,6,6,412,3,206,5145219.5,74.0,68.66666666666667,3,206,5145113.0,74.0,68.66666666666667
119328080.0,6,223,25150,112,7614,1075027.7477477477,140.0,67.98214285714286,111,17536,1075370.9545454546,390.0,157.981981981982
233811.0,6,3,373,2,238,0.0,172.0,119.0,1,135,0.0,135.0,135.0
111598672.0,6,32,2220,16,1149,7425522.6,123.0,71.8125,16,1071,7425522.0,123.0,66.9375
90073620.0,17,28,13364,28,13364,3336060.0,501.0,477.2857142857143,0,0,0.0,0.0,0.0
23752.0,6,14,4740,7,653,3851.0,249.0,93.28571428571428,7,4087,3612.8333333333335,1514.0,583.8571428571429
313242.0,6,3,202,2,128,0.0,74.0,64.0,1,74,0.0,74.0,74.0
2779523.0,6,2,132,1,66,0.0,66.0,66.0,1,66,0.0,66.0,66.0
120095.0,17,2,762,2,762,0.0,381.0,381.0,0,0,0.0,0.0,0.0
210289.0,6,10,1221,6,636,42057.8,298.0,106.0,4,585,68822.66666666667,379.0,146.25
294.0,17,2,174,1,79,0.0,79.0,79.0,1,95,0.0,95.0,95.0
314553.0,17,4,1400,4,1400,104851.0,350.0,350.0,0,0,0.0,0.0,0.0
128005706.0,17,15,907,8,475,18286529.42857143,174.0,59.375,7,432,18000194.333333332,174.0,61.71428571428572
116463726.0,6,32,2220,16,1149,7764248.4,123.0,71.8125,16,1071,7749832.733333333,123.0,66.9375
120109517.0,6,14,2240,6,1224,24021903.4,204.0,204.0,8,1016,17135232.85714286,188.0,127.0
0.0,17,1,55,1,55,0.0,55.0,55.0,0,0,0.0,0.0,0.0
120244784.0,6,24,1788,12,894,10909088.636363637,95.0,74.5,12,894,10909052.636363637,95.0,74.5
114215477.0,6,30,1990,15,1042,8142831.142857143,139.0,69.46666666666667,15,948,8142830.214285715,123.0,63.2
170482.0,17,4,1400,4,1400,56827.333333333336,350.0,350.0,0,0,0.0,0.0,0.0
43044.0,6,14,4740,7,653,6768.166666666667,249.0,93.28571428571428,7,4087,6806.166666666667,1514.0,583.8571428571429
301929.0,6,6,412,4,272,100643.0,74.0,68.0,2,140,0.0,74.0,70.0
94239649.0,6,40,2640,20,1320,4959981.52631579,66.0,66.0,20,1320,4943693.052631579,66.0,66.0
18312.0,6,14,4740,7,653,2594.0,249.0,93.28571428571428,7,4087,2835.333333333333,1514.0,583.8571428571429
214789.0,6,3,426,2,280,0.0,214.0,140.0,1,146,0.0,146.0,146.0
15393.0,6,10,2032,5,524,3558.75,252.0,104.8,5,1508,3485.5,1236.0,301.6
57778.0,6,10,2032,5,524,13031.75,252.0,104.8,5,1508,13408.5,1236.0,301.6
1413589.0,17,2,346,1,78,0.0,78.0,78.0,1,268,0.0,268.0,268.0
1183922.0,6,13,3010,8,2382,169131.7142857143,1514.0,297.75,5,628,227122.25,331.0,125.6
31635.000000000004,6,14,4740,7,653,5147.833333333333,249.0,93.28571428571428,7,4087,5008.5,1514.0,583.8571428571429
2500.0,17,4,344,2,150,0.0,75.0,75.0,2,194,0.0,103.0,97.0
2479145.0,6,3,1604,1,753,0.0,753.0,753.0,2,851,0.0,785.0,425.5
390102.0,6,4,270,2,136,0.0,70.0,68.0,2,134,0.0,68.0,67.0
39655.0,6,14,4740,7,653,6488.666666666667,249.0,93.28571428571428,7,4087,6112.0,1514.0,583.8571428571429
90005485.0,6,17,1287,9,691,11250685.625,95.0,76.77777777777777,8,596,12817088.857142856,95.0,74.5
108100260.0,17,5,1005,5,1005,27025065.0,201.0,201.0,0,0,0.0,0.0,0.0
135128790.0,17,6,1146,6,1146,27025758.0,191.0,191.0,0,0,0.0,0.0,0.0
143889.0,17,2,180,1,90,0.0,90.0,90.0,1,90,0.0,90.0,90.0
76236.0,6,14,4740,7,653,12494.333333333334,249.0,93.28571428571428,7,4087,11507.0,1514.0,583.8571428571429
111189528.0,6,32,2236,16,1165,7398254.2,139.0,72.8125,16,1071,7398255.266666667,123.0,66.9375
305454.0,6,6,412,4,272,101818.0,74.0,68.0,2,140,0.0,74.0,70.0
3558035.0,6,179,145423,102,136042,35228.069306930694,1510.0,1333.7450980392157,77,9381,42729.82894736842,1510.0,121.83116883116882
2794070.0,6,2,132,1,66,0.0,66.0,66.0,1,66,0.0,66.0,66.0
102935.0,17,2,286,2,286,0.0,143.0,143.0,0,0,0.0,0.0,0.0
90299160.0,6,16,1192,8,596,12892526.285714284,95.0,74.5,8,596,12898910.285714284,95.0,74.5
2605980.0,6,3,1777,2,951,0.0,885.0,475.5,1,826,0.0,826.0,826.0
118805707.0,6,48,3168,24,1584,5165465.521739131,66.0,66.0,24,1584,5152360.260869565,66.0,66.0
135128099.0,17,6,1206,6,1206,27025619.8,201.0,201.0,0,0,0.0,0.0,0.0
105451.0,17,2,286,2,286,0.0,143.0,143.0,0,0,0.0,0.0,0.0
27244.0,6,14,4740,7,653,4415.166666666667,249.0,93.28571428571428,7,4087,3844.0,1514.0,583.8571428571429
90259639.0,6,12,1832,8,1016,12894234.142857144,188.0,127.0,4,816,30031540.666666668,204.0,204.0
129007384.0,17,14,864,8,475,18429626.285714287,174.0,59.375,6,389,18000202.4,174.0,64.83333333333333
3892.0,17,2,762,2,762,0.0,381.0,381.0,0,0,0.0,0.0,0.0
116061592.0,6,48,3168,24,1584,5046156.173913044,66.0,66.0,24,1584,5031881.043478261,66.0,66.0
135135781.0,17,6,1206,6,1206,27027156.2,201.0,201.0,0,0,0.0,0.0,0.0
132875.0,6,3,337,2,214,0.0,160.0,107.0,1,123,0.0,123.0,123.0
2522.0,17,4,344,2,150,0.0,75.0,75.0,2,194,0.0,103.0,97.0
105417845.0,17,14,864,7,432,17500156.833333332,174.0,61.71428571428572,7,432,17500789.5,174.0,61.71428571428572
90215004.0,6,19,1436,9,691,11247448.75,95.0,76.77777777777777,10,745,10001165.222222222,95.0,74.5
10480187.0,6,6,412,3,206,5171872.5,74.0,68.66666666666667,3,206,5170231.5,74.0,68.66666666666667
18551325.0,6,5,1909,2,892,0.0,826.0,446.0,3,1017,7978985.0,885.0,339.0
4873.0,17,2,180,1,90,0.0,90.0,90.0,1,90,0.0,90.0,90.0
45011.0,6,12,1413,6,816,8834.6,291.0,136.0,6,597,7732.8,259.0,99.5
3822.0,17,2,762,2,762,0.0,381.0,381.0,0,0,0.0,0.0,0.0
42153.0,6,14,4740,7,653,6903.333333333333,249.0,93.28571428571428,7,4087,6484.333333333333,1514.0,583.8571428571429
221366.0,6,10,1221,6,636,44273.2,298.0,106.0,4,585,71995.66666666667,379.0,146.25
106144.0,17,2,286,2,286,0.0,143.0,143.0,0,0,0.0,0.0,0.0
10280.0,17,4,823,2,163,0.0,89.0,81.5,2,660,0.0,443.0,330.0
472.0,17,2,508,2,508,0.0,257.0,254.0,0,0,0.0,0.0,0.0
36332.0,6,10,2032,5,524,7406.5,252.0,104.8,5,1508,7690.5,1236.0,301.6
233085.0,6,3,373,2,238,0.0,172.0,119.0,1,135,0.0,135.0,135.0
0.0,17,1,381,1,381,0.0,381.0,381.0,0,0,0.0,0.0,0.0
5619561.0,6,5,336,2,134,0.0,68.0,67.0,3,202,1525751.0,70.0,67.33333333333333
304.0,17,2,174,1,79,0.0,79.0,79.0,1,95,0.0,95.0,95.0
10454947.0,6,6,412,3,206,5159046.5,74.0,68.66666666666667,3,206,5158918.5,74.0,68.66666666666667
120121069.0,6,14,2240,8,1016,17136738.57142857,188.0,127.0,6,1224,18018509.4,204.0,204.0
147447.0,6,3,337,2,214,0.0,160.0,107.0,1,123,0.0,123.0,123.0
35501.0,6,14,4740,7,653,5089.333333333333,249.0,93.28571428571428,7,4087,5786.333333333333,1514.0,583.8571428571429
2413.0,17,4,344,2,150,0.0,75.0,75.0,2,194,0.0,103.0,97.0
0.0,17,1,84,1,84,0.0,84.0,84.0,0,0,0.0,0.0,0.0
145158.0,17,2,180,1,90,0.0,90.0,90.0,1,90,0.0,90.0,90.0
211556.0,6,10,1221,6,636,42311.2,298.0,106.0,4,585,69259.0,379.0,146.25
108109400.0,17,5,1005,5,1005,27027350.0,201.0,201.0,0,0,0.0,0.0,0.0
207999.0,6,3,426,2,280,0.0,214.0,140.0,1,146,0.0,146.0,146.0
6068062.0,6,24,7542,12,2450,551642.0,1034.0,204.16666666666663,12,5092,524269.0,1510.0,424.3333333333333
206182.0,17,2,762,2,762,0.0,381.0,381.0,0,0,0.0,0.0,0.0
108103243.0,17,5,955,5,955,27025810.75,191.0,191.0,0,0,0.0,0.0,0.0
90010171.0,17,28,13364,28,13364,3333710.037037037,501.0,477.2857142857143,0,0,0.0,0.0,0.0
2802653.0,6,2,132,1,66,0.0,66.0,66.0,1,66,0.0,66.0,66.0
3798766.0,17,9,3022,9,3022,474845.75,382.0,335.77777777777777,0,0,0.0,0.0,0.0
135128318.0,17,6,1146,6,1146,27025663.6,191.0,191.0,0,0,0.0,0.0,0.0
212236.0,6,10,1221,6,636,42447.2,298.0,106.0,4,585,69060.33333333333,379.0,146.25
318.0,17,2,174,1,79,0.0,79.0,79.0,1,95,0.0,95.0,95.0
90056155.0,17,27,12943,27,12943,3463698.269230769,501.0,479.3703703703704,0,0,0.0,0.0,0.0
2045.0,17,4,344,2,150,0.0,75.0,75.0,2,194,0.0,103.0,97.0
213631.0,17,2,180,1,90,0.0,90.0,90.0,1,90,0.0,90.0,90.0
2608767.0,6,34,11034,18,3951,153456.88235294115,1514.0,219.5,16,7083,156743.66666666666,1514.0,442.6875
108108684.0,17,5,1005,5,1005,27027171.0,201.0,201.0,0,0,0.0,0.0,0.0
0.0,17,1,90,1,90,0.0,90.0,90.0,0,0,0.0,0.0,0.0
239621.0,6,3,337,2,214,0.0,160.0,107.0,1,123,0.0,123.0,123.0
110712.0,6,14,4740,7,653,18330.166666666668,249.0,93.28571428571428,7,4087,17359.166666666668,1514.0,583.8571428571429
120055771.0,17,28,13364,28,13364,4446510.037037037,501.0,477.2857142857143,0,0,0.0,0.0,0.0
52283.0,6,14,4740,7,653,8513.666666666666,249.0,93.28571428571428,7,4087,8033.833333333333,1514.0,583.8571428571429
154155.0,6,2,132,1,66,0.0,66.0,66.0,1,66,0.0,66.0,66.0
153393.0,17,2,180,1,90,0.0,90.0,90.0,1,90,0.0,90.0,90.0
90097352.0,6,15,2180,7,1164,15015813.666666666,204.0,166.28571428571428,8,1016,12838326.42857143,188.0,127.0
90258767.0,6,12,1832,8,1016,12894109.57142857,188.0,127.0,4,816,30031389.666666668,204.0,204.0
6627.0,17,2,508,2,508,0.0,257.0,254.0,0,0,0.0,0.0,0.0
2785916.0,6,3,1604,1,753,0.0,753.0,753.0,2,851,0.0,785.0,425.5
4434.0,17,4,813,2,144,0.0,72.0,72.0,2,669,0.0,542.0,334.5
37058.0,6,14,4740,7,653,6056.0,249.0,93.28571428571428,7,4087,6037.333333333333,1514.0,583.8571428571429
141438.0,17,4,704,2,148,0.0,74.0,74.0,2,556,0.0,280.0,278.0
45240.0,6,14,4740,7,653,5748.5,249.0,93.28571428571428,7,4087,7343.666666666667,1514.0,583.8571428571429
118891455.0,6,48,3168,24,1584,5169193.695652174,66.0,66.0,24,1584,5155775.782608695,66.0,66.0
236215.0,6,3,337,2,214,0.0,160.0,107.0,1,123,0.0,123.0,123.0
109009546.0,6,734,131580,372,107244,293826.2695417789,1514.0,288.2903225806452,362,24336,301020.5373961219,214.0,67.22651933701657
590964.0,6,4,508,2,238,0.0,172.0,119.0,2,270,0.0,135.0,135.0
1305877.0,6,4,264,2,132,0.0,66.0,66.0,2,132,0.0,66.0,66.0
39806.0,6,14,4740,7,653,6458.833333333333,249.0,93.28571428571428,7,4087,6256.0,1514.0,583.8571428571429
0.0,17,1,80,1,80,0.0,80.0,80.0,0,0,0.0,0.0,0.0
333.0,17,2,166,1,75,0.0,75.0,75.0,1,91,0.0,91.0,91.0
113520335.0,6,46,3036,23,1518,5160003.0,66.0,66.0,23,1518,5160003.0,66.0,66.0
105694.0,17,2,286,2,286,0.0,143.0,143.0,0,0,0.0,0.0,0.0
215121.0,6,10,1221,6,636,43024.2,298.0,106.0,4,585,68913.33333333333,379.0,146.25
2802764.0,6,2,132,1,66,0.0,66.0,66.0,1,66,0.0,66.0,66.0
147648.0,17,4,704,2,148,0.0,74.0,74.0,2,556,0.0,280.0,278.0
135158173.0,17,6,1146,6,1146,27031634.6,191.0,191.0,0,0,0.0,0.0,0.0
1477.0,17,2,762,2,762,0.0,381.0,381.0,0,0,0.0,0.0,0.0
132002.0,17,4,1400,4,1400,44000.66666666666,350.0,350.0,0,0,0.0,0.0,0.0
67608.0,6,14,4740,7,653,11140.666666666666,249.0,93.28571428571428,7,4087,11135.5,1514.0,583.8571428571429
15682005.0,6,5,1736,3,917,6545224.0,785.0,305.6666666666667,2,819,0.0,753.0,409.5
52040.0,6,14,4740,7,653,8497.5,249.0,93.28571428571428,7,4087,7132.833333333333,1514.0,583.8571428571429
90294173.0,6,16,1192,8,596,12892630.0,95.0,74.5,8,596,12897678.57142857,95.0,74.5
90040096.0,17,28,13364,28,13364,3334818.3703703703,501.0,477.2857142857143,0,0,0.0,0.0,0.0
349.0,17,2,250,1,93,0.0,93.0,93.0,1,157,0.0,157.0,157.0
14930.0,17,2,180,1,90,0.0,90.0,90.0,1,90,0.0,90.0,90.0
167011.0,6,11,1132,6,556,32945.4,218.0,92.66666666666669,5,576,40443.0,304.0,115.2
96018042.0,6,29,2046,15,1017,6858431.571428572,123.0,67.8,14,1029,7366369.0,123.0,73.5
135140967.0,17,6,1206,6,1206,27028193.4,201.0,201.0,0,0,0.0,0.0,0.0
64599.00000000001,6,14,4740,7,653,9859.833333333334,249.0,93.28571428571428,7,4087,10121.333333333334,1514.0,583.8571428571429
146791.0,6,3,337,2,214,0.0,160.0,107.0,1,123,0.0,123.0,123.0
196953.0,17,2,180,1,90,0.0,90.0,90.0,1,90,0.0,90.0,90.0
2372.0,17,4,344,2,150,0.0,75.0,75.0,2,194,0.0,103.0,97.0
47260.0,6,14,4740,7,653,7571.5,249.0,93.28571428571428,7,4087,7719.5,1514.0,583.8571428571429
107344621.0,6,29,2068,15,1105,7652871.571428572,139.0,73.66666666666667,14,963,8241548.692307692,123.0,68.78571428571429
130982.0,6,2,132,1,66,0.0,66.0,66.0,1,66,0.0,66.0,66.0
154011.0,17,2,180,1,90,0.0,90.0,90.0,1,90,0.0,90.0,90.0
103109.0,17,2,286,2,286,0.0,143.0,143.0,0,0,0.0,0.0,0.0
120443802.0,6,231,26256,116,18444,1047337.408695652,374.0,159.0,115,7812,1047490.1666666666,140.0,67.9304347826087
322811.0,17,4,1400,4,1400,107603.66666666669,350.0,350.0,0,0,0.0,0.0,0.0
896.0,17,4,438,2,148,0.0,74.0,74.0,2,290,0.0,147.0,145.0
108031349.0,6,44,2904,22,1452,5144349.952380952,66.0,66.0,22,1452,5129643.0,66.0,66.0
90092123.0,6,13,2052,6,1224,18018137.6,204.0,204.0,7,828,14969132.666666666,188.0,118.28571428571428
258453.0,6,3,337,2,214,0.0,160.0,107.0,1,123,0.0,123.0,123.0
529343.0,6,5,336,2,134,0.0,68.0,67.0,3,202,208493.5,70.0,67.33333333333333
311870.0,17,4,622,4,622,103956.66666666669,163.0,155.5,0,0,0.0,0.0,0.0
202273.0,17,2,762,2,762,0.0,381.0,381.0,0,0,0.0,0.0,0.0
2312.0,17,4,344,2,150,0.0,75.0,75.0,2,194,0.0,103.0,97.0
15883.000000000002,6,11,1133,6,602,2990.0,264.0,100.33333333333331,5,531,3671.5,259.0,106.2
118704110.0,6,33,2296,17,1225,7419006.875,139.0,72.05882352941177,16,1071,7233517.866666666,123.0,66.9375
15439.0,6,10,2032,5,524,3009.75,252.0,104.8,5,1508,3610.75,1236.0,301.6
0.0,6,1,54,0,0,0.0,0.0,0.0,1,54,0.0,54.0,54.0
102001000.0,17,13,821,7,432,17000166.666666668,174.0,61.71428571428572,6,389,16401094.8,174.0,64.83333333333333
123018.0,6,3,373,2,238,0.0,172.0,119.0,1,135,0.0,135.0,135.0
91935544.0,6,27,2073,15,1138,6566654.428571428,95.0,75.86666666666666,12,935,8356985.636363637,95.0,77.91666666666667
90300133.0,6,21,1585,11,840,9025613.7,95.0,76.36363636363636,10,745,10000077.222222222,95.0,74.5
135126842.0,17,6,1206,6,1206,27025368.4,201.0,201.0,0,0,0.0,0.0,0.0
85568.0,6,20,10003,11,889,8556.8,221.0,80.81818181818181,9,9114,10366.0,1514.0,1012.6666666666666
150195.0,6,3,337,2,214,0.0,160.0,107.0,1,123,0.0,123.0,123.0
95087361.0,17,12,778,6,389,19000160.6,174.0,64.83333333333333,6,389,19001164.8,174.0,64.83333333333333
2175120.0,6,3,1604,2,851,0.0,785.0,425.5,1,753,0.0,753.0,753.0
3215.0,17,4,344,2,150,0.0,75.0,75.0,2,194,0.0,103.0,97.0
706.0,17,4,438,2,148,0.0,74.0,74.0,2,290,0.0,147.0,145.0
106801.0,17,2,286,2,286,0.0,143.0,143.0,0,0,0.0,0.0,0.0
311524.0,17,4,1400,4,1400,103841.33333333331,350.0,350.0,0,0,0.0,0.0,0.0
91428382.0,6,22,1680,12,935,8311161.090909091,95.0,77.91666666666667,10,745,10157480.111111112,95.0,74.5
14649618.0,6,20,1730,10,1098,1592857.2222222222,315.0,109.8,10,632,1592833.5555555555,78.0,63.2
25239.0,6,10,2032,5,524,5513.75,252.0,104.8,5,1508,5720.75,1236.0,301.6
250331.00000000003,6,3,337,2,214,0.0,160.0,107.0,1,123,0.0,123.0,123.0
39233.0,6,14,4740,7,653,6370.333333333333,249.0,93.28571428571428,7,4087,6239.833333333333,1514.0,583.8571428571429
104414.0,17,2,700,2,700,0.0,350.0,350.0,0,0,0.0,0.0,0.0
34207.0,6,14,4740,7,653,5417.166666666667,249.0,93.28571428571428,7,4087,5562.0,1514.0,583.8571428571429
33681.0,6,14,4740,7,653,5439.0,249.0,93.28571428571428,7,4087,5389.333333333333,1514.0,583.8571428571429
90286226.0,6,18,1465,9,650,11280713.0,95.0,72.22222222222223,9,815,11283228.0,219.0,90.55555555555556
90289664.0,6,16,1192,8,596,12891399.57142857,95.0,74.5,8,596,12897672.142857144,95.0,74.5
233248.0,6,3,337,2,214,0.0,160.0,107.0,1,123,0.0,123.0,123.0
4780.0,17,2,762,2,762,0.0,381.0,381.0,0,0,0.0,0.0,0.0
108108514.0,17,5,955,5,955,27027128.5,191.0,191.0,0,0,0.0,0.0,0.0
315.0,17,2,174,1,79,0.0,79.0,79.0,1,95,0.0,95.0,95.0
108116339.0,17,5,1005,5,1005,27029084.75,201.0,201.0,0,0,0.0,0.0,0.0
233437.0,17,4,6056,4,6056,77812.33333333333,1514.0,1514.0,0,0,0.0,0.0,0.0
47604848.0,6,7,1872,3,886,22376751.0,752.0,295.3333333333333,4,986,15010680.666666666,784.0,246.5
310454.0,17,4,1400,4,1400,103484.66666666669,350.0,350.0,0,0,0.0,0.0,0.0
103131.0,17,2,286,2,286,0.0,143.0,143.0,0,0,0.0,0.0,0.0
305815.0,17,4,1400,4,1400,101938.33333333331,350.0,350.0,0,0,0.0,0.0,0.0
319.0,17,2,156,1,78,0.0,78.0,78.0,1,78,0.0,78.0,78.0
40592.0,6,14,4740,7,653,6142.5,249.0,93.28571428571428,7,4087,6467.833333333333,1514.0,583.8571428571429
186063.0,17,2,180,1,90,0.0,90.0,90.0,1,90,0.0,90.0,90.0
113264900.0,6,46,3036,23,1518,5135893.409090909,66.0,66.0,23,1518,5135902.454545454,66.0,66.0
155037.0,6,3,337,2,214,0.0,160.0,107.0,1,123,0.0,123.0,123.0
120110711.0,6,13,2036,8,1016,17135635.0,188.0,127.0,5,1020,22523667.75,204.0,204.0
66537.0,6,12,1320,7,789,11089.5,253.0,112.71428571428572,5,531,11645.5,259.0,106.2
10486934.0,6,7,478,4,272,3450081.6666666665,74.0,68.0,3,206,5175014.5,74.0,68.66666666666667
15397.0,6,13,1386,7,789,2294.1666666666665,253.0,112.71428571428572,6,597,2806.8,259.0,99.5
2019939.0,17,4,525,2,150,0.0,75.0,75.0,2,375,0.0,284.0,187.5
53686.0,6,14,4740,7,653,8349.5,249.0,93.28571428571428,7,4087,8647.833333333334,1514.0,583.8571428571429
49128.0,6,10,2032,5,524,12060.25,252.0,104.8,5,1508,12067.75,1236.0,301.6
4335.0,17,2,614,1,72,0.0,72.0,72.0,1,542,0.0,542.0,542.0
19751.0,6,10,2032,5,524,4708.5,252.0,104.8,5,1508,4586.75,1236.0,301.6
14378328.0,17,6,2052,6,2052,2875665.6,342.0,342.0,0,0,0.0,0.0,0.0
318.0,17,2,174,1,79,0.0,79.0,79.0,1,95,0.0,95.0,95.0
21118.0,6,14,4740,7,653,3181.6666666666665,249.0,93.28571428571428,7,4087,3362.833333333333,1514.0,583.8571428571429
171692.0,17,2,180,1,90,0.0,90.0,90.0,1,90,0.0,90.0,90.0
106035395.0,6,440,60162,220,45420,483197.3287671233,570.0,206.45454545454547,220,14742,483197.4931506849,140.0,67.00909090909092
37535.0,6,14,4740,7,653,6009.166666666667,249.0,93.28571428571428,7,4087,5672.5,1514.0,583.8571428571429
761.0,17,4,438,2,148,0.0,74.0,74.0,2,290,0.0,147.0,145.0
25480.0,6,11,2098,6,590,3933.2,252.0,98.33333333333331,5,1508,5676.25,1236.0,301.6
298.0,17,2,164,1,82,0.0,82.0,82.0,1,82,0.0,82.0,82.0
2463.0,17,4,344,2,150,0.0,75.0,75.0,2,194,0.0,103.0,97.0
126001181.0,17,15,907,8,475,18000168.714285713,174.0,59.375,7,432,17667782.666666668,174.0,61.71428571428572
18686.0,6,13,1459,7,862,2931.833333333333,271.0,123.14285714285714,6,597,3520.2,259.0,99.5
1041626.0,6,13,1394,7,797,173604.33333333334,253.0,113.85714285714286,6,597,207182.0,259.0,99.5
302485.0,6,2,132,1,66,0.0,66.0,66.0,1,66,0.0,66.0,66.0
90255347.0,6,13,2036,8,1016,12893621.0,188.0,127.0,5,1020,22523385.5,204.0,204.0
94302928.0,6,162,18318,81,12750,1175818.0,284.0,157.40740740740742,81,5568,1176094.35,140.0,68.74074074074075
223504.0,6,4,492,2,280,0.0,214.0,140.0,2,212,0.0,146.0,106.0
92592141.0,6,38,2508,19,1254,5143993.833333333,66.0,66.0,19,1254,5143993.222222222,66.0,66.0
1307967.0,6,4,264,2,132,0.0,66.0,66.0,2,132,0.0,66.0,66.0
21727.0,6,14,4740,7,653,3502.0,249.0,93.28571428571428,7,4087,3300.5,1514.0,583.8571428571429
153433.0,17,2,180,1,90,0.0,90.0,90.0,1,90,0.0,90.0,90.0
192959.0,17,2,180,1,90,0.0,90.0,90.0,1,90,0.0,90.0,90.0
90257406.0,6,13,2036,8,1016,12893915.142857144,188.0,127.0,5,1020,22523045.25,204.0,204.0
2368.0,17,4,344,2,150,0.0,75.0,75.0,2,194,0.0,103.0,97.0
503698.0,6,4,270,2,134,0.0,68.0,67.0,2,136,0.0,70.0,68.0
351.0,17,2,214,1,75,0.0,75.0,75.0,1,139,0.0,139.0,139.0
1321258.0,6,4,276,2,128,0.0,74.0,64.0,2,148,0.0,74.0,74.0
301791.0,6,6,412,4,272,100597.0,74.0,68.0,2,140,0.0,74.0,70.0
36611.0,6,14,4740,7,653,5689.666666666667,249.0,93.28571428571428,7,4087,5149.0,1514.0,583.8571428571429
120248050.0,6,220,25064,110,7556,1086129.0825688073,140.0,68.69090909090909,110,17508,1095728.23853211,374.0,159.16363636363636
120043494.0,17,29,13785,29,13785,4287267.642857143,501.0,475.3448275862069,0,0,0.0,0.0,0.0
839.0,17,4,438,2,148,0.0,74.0,74.0,2,290,0.0,147.0,145.0
4219.0,17,2,598,1,72,0.0,72.0,72.0,1,526,0.0,526.0,526.0
200443.0,17,4,6056,4,6056,66814.33333333333,1514.0,1514.0,0,0,0.0,0.0,0.0
2033.0,17,4,344,2,150,0.0,75.0,75.0,2,194,0.0,103.0,97.0
119283024.0,6,35,2542,18,1348,7004393.588235294,139.0,74.88888888888889,17,1194,7442379.6875,123.0,70.23529411764706
102639501.0,6,35,2796,19,1518,5702194.5,123.0,79.89473684210526,16,1278,6827513.333333333,123.0,79.875
340823.0,6,6,412,4,272,113607.66666666669,74.0,68.0,2,140,0.0,74.0,70.0
114010335.0,17,13,821,7,432,19001722.5,174.0,61.71428571428572,6,389,18800150.4,174.0,64.83333333333333
3170451.0,6,18,1495,9,921,358383.25,315.0,102.33333333333331,9,574,358349.75,78.0,63.77777777777778
17715.0,6,14,4740,7,653,2707.833333333333,249.0,93.28571428571428,7,4087,2686.6666666666665,1514.0,583.8571428571429
129794330.0,6,35,2394,18,1269,7634960.588235294,123.0,70.5,17,1125,7475097.25,123.0,66.17647058823529
1450518.0,6,7,499,4,301,416226.3333333333,103.0,75.25,3,198,715588.0,66.0,66.0
108430403.0,6,44,2904,22,1452,5163352.523809524,66.0,66.0,22,1452,5150375.285714285,66.0,66.0
108105701.0,17,5,955,5,955,27026425.25,191.0,191.0,0,0,0.0,0.0,0.0
156051.0,17,2,180,1,90,0.0,90.0,90.0,1,90,0.0,90.0,90.0
905421.0,6,12,1447,6,816,180122.0,291.0,136.0,6,631,180465.8,293.0,105.16666666666669
304340.0,17,4,1400,4,1400,101446.66666666669,350.0,350.0,0,0,0.0,0.0,0.0
298211.0,6,6,412,4,272,99403.66666666669,74.0,68.0,2,140,0.0,74.0,70.0
3005900.0,6,11,2106,6,598,601007.6,252.0,99.66666666666669,5,1508,1907.0,1236.0,301.6
108105804.0,17,5,955,5,955,27026451.0,191.0,191.0,0,0,0.0,0.0,0.0
308.0,17,2,164,1,82,0.0,82.0,82.0,1,82,0.0,82.0,82.0
239970.0,6,13,1394,7,797,39995.0,253.0,113.85714285714286,6,597,44512.0,259.0,99.5
102953711.0,6,243,28164,122,8274,850857.1157024794,140.0,67.81967213114754,121,19890,850234.925,284.0,164.3801652892562
196806.0,17,2,180,1,90,0.0,90.0,90.0,1,90,0.0,90.0,90.0
3327649.0,6,3,1604,2,851,0.0,785.0,425.5,1,753,0.0,753.0,753.0
2842682.0,6,11,2106,6,598,568369.2,252.0,99.66666666666669,5,1508,3000.0,1236.0,301.6
1636847.0,17,6,1230,3,234,818234.5,78.0,78.0,3,996,818202.0,332.0,332.0
2804308.0,6,2,132,1,66,0.0,66.0,66.0,1,66,0.0,66.0,66.0
613992.0,17,4,629,3,234,151237.0,78.0,78.0,1,395,0.0,395.0,395.0
628.0,17,2,762,2,762,0.0,381.0,381.0,0,0,0.0,0.0,0.0
108457708.0,6,32,2368,16,1140,7230486.8,123.0,71.25,16,1228,6564755.133333334,139.0,76.75
319.0,17,2,166,1,75,0.0,75.0,75.0,1,91,0.0,91.0,91.0
445.0,17,2,166,1,75,0.0,75.0,75.0,1,91,0.0,91.0,91.0
319757.0,17,4,704,2,148,0.0,74.0,74.0,2,556,0.0,280.0,278.0
321833.0,17,4,1400,4,1400,107277.66666666669,350.0,350.0,0,0,0.0,0.0,0.0
90257647.0,6,13,2036,8,1016,12893949.57142857,188.0,127.0,5,1020,22523158.75,204.0,204.0
51217.0,6,10,2032,5,524,12273.25,252.0,104.8,5,1508,12032.5,1236.0,301.6
65490.00000000001,6,10,2032,5,524,15823.75,252.0,104.8,5,1508,15309.25,1236.0,301.6
102572281.0,17,12,647,6,258,20000169.6,43.0,43.0,6,389,16568154.4,174.0,64.83333333333333
142751.0,17,4,704,2,148,0.0,74.0,74.0,2,556,0.0,280.0,278.0
115913028.0,6,34,2403,17,1194,7244564.25,123.0,70.23529411764706,17,1209,7230935.625,123.0,71.11764705882354
120244553.0,6,19,1436,9,691,14999721.875,95.0,76.77777777777777,10,745,13332223.666666666,95.0,74.5
14426.0,6,13,1459,7,862,2232.833333333333,271.0,123.14285714285714,6,597,2718.0,259.0,99.5
816.0,17,4,438,2,148,0.0,74.0,74.0,2,290,0.0,147.0,145.0
29741.0,6,14,4740,7,653,4397.833333333333,249.0,93.28571428571428,7,4087,4534.166666666667,1514.0,583.8571428571429
106182.0,17,2,286,2,286,0.0,143.0,143.0,0,0,0.0,0.0,0.0
107542909.0,17,14,864,7,432,17830969.0,174.0,61.71428571428572,7,432,17833481.833333332,174.0,61.71428571428572
446725.0,6,10,1221,6,636,89345.0,298.0,106.0,4,585,141176.33333333334,379.0,146.25
90955735.0,6,16,2522,9,1572,11369466.875,204.0,174.66666666666666,7,950,15054084.833333334,188.0,135.71428571428572
26790.0,6,14,4740,7,653,4336.833333333333,249.0,93.28571428571428,7,4087,3776.5,1514.0,583.8571428571429
27074915.0,17,5,1710,5,1710,6768728.75,342.0,342.0,0,0,0.0,0.0,0.0
215060.0,6,10,1221,6,636,43012.0,298.0,106.0,4,585,70583.66666666667,379.0,146.25
105748.0,17,2,286,2,286,0.0,143.0,143.0,0,0,0.0,0.0,0.0
502519.00000000006,6,5,336,2,134,0.0,68.0,67.0,3,202,195476.0,70.0,67.33333333333333
9863.0,17,2,571,1,86,0.0,86.0,86.0,1,485,0.0,485.0,485.0
310087.0,17,4,1400,4,1400,103362.33333333331,350.0,350.0,0,0,0.0,0.0,0.0
310536.0,17,2,180,1,90,0.0,90.0,90.0,1,90,0.0,90.0,90.0
2438968.0,6,2,132,1,66,0.0,66.0,66.0,1,66,0.0,66.0,66.0
171468.0,6,3,337,2,214,0.0,160.0,107.0,1,123,0.0,123.0,123.0
310734.0,17,4,571,2,148,0.0,74.0,74.0,2,423,0.0,276.0,211.5
51675.0,6,14,4740,7,653,8029.5,249.0,93.28571428571428,7,4087,8438.666666666666,1514.0,583.8571428571429
614677.0,6,12,1373,7,714,102446.16666666669,298.0,102.0,5,659,153038.75,379.0,131.8
1698002.0,6,2,132,1,66,0.0,66.0,66.0,1,66,0.0,66.0,66.0
41348.0,6,14,4740,7,653,6630.166666666667,249.0,93.28571428571428,7,4087,6565.833333333333,1514.0,583.8571428571429
120231878.0,6,25,1924,11,840,11953671.7,95.0,76.36363636363636,14,1084,9231950.923076924,95.0,77.42857142857143
149924.0,6,3,337,2,214,0.0,160.0,107.0,1,123,0.0,123.0,123.0
314447.0,6,6,412,4,272,104815.66666666669,74.0,68.0,2,140,0.0,74.0,70.0
18320.0,17,4,823,2,163,0.0,89.0,81.5,2,660,0.0,443.0,330.0
2351.0,17,4,344,2,150,0.0,75.0,75.0,2,194,0.0,103.0,97.0
4124.0,17,2,582,1,83,0.0,83.0,83.0,1,499,0.0,499.0,499.0
105465.0,17,2,762,2,762,0.0,381.0,381.0,0,0,0.0,0.0,0.0
35260.0,6,14,4740,7,653,5690.0,249.0,93.28571428571428,7,4087,5631.0,1514.0,583.8571428571429
228368.0,17,2,180,1,90,0.0,90.0,90.0,1,90,0.0,90.0,90.0
10532069.0,6,7,478,4,272,3463947.333333333,74.0,68.0,3,206,5195801.5,74.0,68.66666666666667
0.0,17,1,381,1,381,0.0,381.0,381.0,0,0,0.0,0.0,0.0
228375.0,17,2,180,1,90,0.0,90.0,90.0,1,90,0.0,90.0,90.0
107458.0,17,2,762,2,762,0.0,381.0,381.0,0,0,0.0,0.0,0.0
108108697.0,17,5,1005,5,1005,27027174.25,201.0,201.0,0,0,0.0,0.0,0.0
113629032.0,6,46,3036,23,1518,5150893.090909091,66.0,66.0,23,1518,5150896.5,66.0,66.0
23402.0,6,14,4740,7,653,3559.5,249.0,93.28571428571428,7,4087,3757.1666666666665,1514.0,583.8571428571429
160904.0,17,2,180,1,90,0.0,90.0,90.0,1,90,0.0,90.0,90.0
108109057.0,17,5,955,5,955,27027264.25,191.0,191.0,0,0,0.0,0.0,0.0
191316.0,17,2,180,1,90,0.0,90.0,90.0,1,90,0.0,90.0,90.0
217057.0,6,3,426,2,280,0.0,214.0,140.0,1,146,0.0,146.0,146.0
58556.0,6,10,2032,5,524,14412.0,252.0,104.8,5,1508,13733.75,1236.0,301.6
135133646.0,17,6,1146,6,1146,27026729.2,191.0,191.0,0,0,0.0,0.0,0.0
105851332.0,6,32,2220,16,1149,7042378.466666667,123.0,71.8125,16,1071,7042377.4,123.0,66.9375
40879.0,6,14,4740,7,653,6694.166666666667,249.0,93.28571428571428,7,4087,6097.0,1514.0,583.8571428571429
123844036.0,6,49,3234,25,1650,5160168.166666667,66.0,66.0,24,1584,5146461.826086956,66.0,66.0
2029.0,17,4,344,2,150,0.0,75.0,75.0,2,194,0.0,103.0,97.0
80744651.0,6,32,2112,16,1056,5382976.733333333,66.0,66.0,16,1056,5368568.733333333,66.0,66.0
334.0,17,2,166,1,75,0.0,75.0,75.0,1,91,0.0,91.0,91.0
5622229.0,6,5,336,2,134,0.0,68.0,67.0,3,202,1522995.5,70.0,67.33333333333333
114178904.0,17,16,1474,8,737,16288399.285714284,174.0,92.125,8,737,16288400.714285716,174.0,92.125
54963.0,6,10,2032,5,524,13462.25,252.0,104.8,5,1508,12540.0,1236.0,301.6
90530021.0,6,14,2240,8,1016,12932860.142857144,188.0,127.0,6,1224,18073276.6,204.0,204.0
103617541.0,6,34,2636,18,1427,6082444.588235294,139.0,79.27777777777777,16,1209,6893434.666666667,123.0,75.5625
90217380.0,6,16,1192,8,596,12853525.714285716,95.0,74.5,8,596,12858894.714285716,95.0,74.5
13907769.0,17,6,2052,6,2052,2781553.8,342.0,342.0,0,0,0.0,0.0,0.0
504271.0,6,5,336,2,134,0.0,68.0,67.0,3,202,192011.5,70.0,67.33333333333333
48103.0,6,10,2032,5,524,11773.0,252.0,104.8,5,1508,10781.75,1236.0,301.6
111276820.0,6,201,22602,101,6888,1112768.2,140.0,68.1980198019802,100,15714,1114810.1616161617,284.0,157.14
3011807.0,6,156,124108,87,115252,34502.75581395349,1510.0,1324.735632183908,69,8856,39848.91176470588,1510.0,128.34782608695653
213563.0,6,3,426,2,280,0.0,214.0,140.0,1,146,0.0,146.0,146.0
69453.0,6,14,4740,7,653,11413.5,249.0,93.28571428571428,7,4087,11426.0,1514.0,583.8571428571429
153504.0,17,2,180,1,90,0.0,90.0,90.0,1,90,0.0,90.0,90.0
228156.0,17,2,180,1,90,0.0,90.0,90.0,1,90,0.0,90.0,90.0
119846290.0,17,35,16705,35,16705,3524890.882352941,501.0,477.2857142857143,0,0,0.0,0.0,0.0
35853.0,6,11,2098,6,590,6860.4,252.0,98.33333333333331,5,1508,8396.25,1236.0,301.6
406.0,17,2,762,2,762,0.0,381.0,381.0,0,0,0.0,0.0,0.0
205572.0,17,2,180,1,90,0.0,90.0,90.0,1,90,0.0,90.0,90.0
110164641.0,17,14,1126,7,563,18334146.666666668,174.0,80.42857142857143,7,563,18334142.166666668,174.0,80.42857142857143
298295.0,6,6,412,4,272,99431.66666666669,74.0,68.0,2,140,0.0,74.0,70.0
90257071.0,6,12,1832,8,1016,12893867.285714284,188.0,127.0,4,816,30031418.33333333,204.0,204.0
96.0,17,2,762,2,762,0.0,381.0,381.0,0,0,0.0,0.0,0.0
0.0,17,1,44,1,44,0.0,44.0,44.0,0,0,0.0,0.0,0.0
106923.0,17,2,700,2,700,0.0,350.0,350.0,0,0,0.0,0.0,0.0
147937.0,17,2,180,1,90,0.0,90.0,90.0,1,90,0.0,90.0,90.0
105613751.0,6,43,2838,22,1452,5018949.142857143,66.0,66.0,21,1386,5105432.9,66.0,66.0
48883.0,6,12,1413,6,816,9170.2,291.0,136.0,6,597,9256.0,259.0,99.5
5827842.0,6,5,336,2,134,0.0,68.0,67.0,3,202,1523130.0,70.0,67.33333333333333
403.0,17,2,410,1,78,0.0,78.0,78.0,1,332,0.0,332.0,332.0
2589986.0,6,2,132,1,66,0.0,66.0,66.0,1,66,0.0,66.0,66.0
300386.0,6,6,412,4,272,100128.66666666669,74.0,68.0,2,140,0.0,74.0,70.0
10873752.0,6,8,544,4,272,3577891.333333333,74.0,68.0,4,272,3577822.333333333,74.0,68.0
15141.0,17,4,823,2,163,0.0,89.0,81.5,2,660,0.0,443.0,330.0
124444729.0,6,31,2034,16,1086,8296315.266666667,123.0,67.875,15,948,8160239.142857143,123.0,63.2
2132124.0,6,39,15667,20,10978,112217.05263157896,1514.0,548.9,19,4689,105954.33333333331,1514.0,246.7894736842105
597014.0,17,3,551,2,156,0.0,78.0,78.0,1,395,0.0,395.0,395.0
100089097.0,17,12,778,6,389,20017819.4,174.0,64.83333333333333,6,389,19951488.6,174.0,64.83333333333333
205883.0,6,3,426,2,280,0.0,214.0,140.0,1,146,0.0,146.0,146.0
2288.0,17,4,344,2,150,0.0,75.0,75.0,2,194,0.0,103.0,97.0
105610.0,17,2,700,2,700,0.0,350.0,350.0,0,0,0.0,0.0,0.0
298458.0,6,6,412,4,272,99486.0,74.0,68.0,2,140,0.0,74.0,70.0
349696.0,6,10,1221,6,636,69939.2,298.0,106.0,4,585,110722.33333333331,379.0,146.25
236739.0,6,3,373,2,238,0.0,172.0,119.0,1,135,0.0,135.0,135.0
40311.0,6,14,4740,7,653,6310.5,249.0,93.28571428571428,7,4087,6506.833333333333,1514.0,583.8571428571429
502071.00000000006,6,5,336,2,134,0.0,68.0,67.0,3,202,192427.0,70.0,67.33333333333333
126007438.0,17,15,907,8,475,18001062.57142857,174.0,59.375,7,432,17666874.333333332,174.0,61.71428571428572
102695.0,6,10,2032,5,524,24483.75,252.0,104.8,5,1508,14499.75,1236.0,301.6
184007.0,17,2,180,1,90,0.0,90.0,90.0,1,90,0.0,90.0,90.0
31022.0,6,14,4740,7,653,4579.666666666667,249.0,93.28571428571428,7,4087,4842.0,1514.0,583.8571428571429
100833203.0,17,12,516,6,258,20000170.6,43.0,43.0,6,258,20001009.0,43.0,43.0
90259233.0,6,13,2036,8,1016,12894176.142857144,188.0,127.0,5,1020,22523470.25,204.0,204.0
98020.0,6,2,132,1,66,0.0,66.0,66.0,1,66,0.0,66.0,66.0
301540.0,6,6,412,4,272,100513.33333333331,74.0,68.0,2,140,0.0,74.0,70.0
296.0,17,2,156,1,78,0.0,78.0,78.0,1,78,0.0,78.0,78.0
105150127.0,17,15,5130,15,5130,7510723.357142857,342.0,342.0,0,0,0.0,0.0,0.0
2343.0,17,4,344,2,150,0.0,75.0,75.0,2,194,0.0,103.0,97.0
1985.0,17,4,344,2,150,0.0,75.0,75.0,2,194,0.0,103.0,97.0
120116219.0,6,13,2036,5,1020,30029054.75,204.0,204.0,8,1016,17136109.14285714,188.0,127.0
232512.0,6,3,337,2,214,0.0,160.0,107.0,1,123,0.0,123.0,123.0
59140.0,6,14,4740,7,653,7603.666666666667,249.0,93.28571428571428,7,4087,9718.833333333334,1514.0,583.8571428571429
143151.0,6,2,132,1,66,0.0,66.0,66.0,1,66,0.0,66.0,66.0
2392.0,17,4,344,2,150,0.0,75.0,75.0,2,194,0.0,103.0,97.0
90251630.0,6,14,2240,8,1016,12893090.0,188.0,127.0,6,1224,18017713.4,204.0,204.0
2207.0,17,4,344,2,150,0.0,75.0,75.0,2,194,0.0,103.0,97.0
108699847.0,6,34,2482,17,1288,6780259.6875,139.0,75.76470588235294,17,1194,6780258.3125,123.0,70.23529411764706
123588237.0,6,38,2848,20,1531,6504644.052631579,139.0,76.55,18,1317,6669753.529411765,123.0,73.16666666666667
100772849.0,6,28,1860,14,966,7736034.0,123.0,69.0,14,894,7736011.461538462,123.0,63.85714285714285
65358.0,6,10,2032,5,524,14813.5,252.0,104.8,5,1508,14052.5,1236.0,301.6
4421.0,17,2,626,1,72,0.0,72.0,72.0,1,554,0.0,554.0,554.0
1998.0,17,4,344,2,150,0.0,75.0,75.0,2,194,0.0,103.0,97.0
303696.0,6,2,132,1,66,0.0,66.0,66.0,1,66,0.0,66.0,66.0
410373.0,17,2,363,1,75,0.0,75.0,75.0,1,288,0.0,288.0,288.0
92437922.0,6,37,2442,19,1254,5135440.111111111,66.0,66.0,18,1188,5180043.705882353,66.0,66.0
4999100.0,17,4,376,2,152,0.0,76.0,76.0,2,224,0.0,148.0,112.0
216821.0,6,3,426,2,280,0.0,214.0,140.0,1,146,0.0,146.0,146.0
841868.0,6,9,1196,6,725,168373.6,387.0,120.83333333333331,3,471,284713.5,331.0,157.0
110264706.0,17,14,864,7,432,18334444.0,174.0,61.71428571428572,7,432,18333493.33333333,174.0,61.71428571428572
299462.0,6,6,412,4,272,99820.66666666669,74.0,68.0,2,140,0.0,74.0,70.0
153540.0,17,2,180,1,90,0.0,90.0,90.0,1,90,0.0,90.0,90.0
45235.0,6,14,4740,7,653,6428.833333333333,249.0,93.28571428571428,7,4087,6957.166666666667,1514.0,583.8571428571429
120006015.0,6,13,1898,8,1016,17143716.42857143,188.0,127.0,5,882,15024767.0,204.0,176.4
146896.0,6,3,337,2,214,0.0,160.0,107.0,1,123,0.0,123.0,123.0
100054622.0,17,12,778,6,389,19966841.6,174.0,64.83333333333333,6,389,19979143.6,174.0,64.83333333333333
2031.0,17,4,344,2,150,0.0,75.0,75.0,2,194,0.0,103.0,97.0
153469.0,17,2,180,1,90,0.0,90.0,90.0,1,90,0.0,90.0,90.0
0.0,17,1,381,1,381,0.0,381.0,381.0,0,0,0.0,0.0,0.0
19901969.0,17,3,1034,2,684,0.0,342.0,342.0,1,350,0.0,350.0,350.0
40989.0,6,14,4740,7,653,6712.166666666667,249.0,93.28571428571428,7,4087,6066.333333333333,1514.0,583.8571428571429
31275.0,6,10,2032,5,524,7590.5,252.0,104.8,5,1508,7421.75,1236.0,301.6
18707.0,6,10,2032,5,524,4439.0,252.0,104.8,5,1508,4068.0,1236.0,301.6
2108.0,17,4,344,2,150,0.0,75.0,75.0,2,194,0.0,103.0,97.0
58773.0,6,10,2032,5,524,12114.0,252.0,104.8,5,1508,14334.0,1236.0,301.6
312297.0,17,4,1400,4,1400,104099.0,350.0,350.0,0,0,0.0,0.0,0.0
153384.0,17,2,180,1,90,0.0,90.0,90.0,1,90,0.0,90.0,90.0
51450.0,6,14,4740,7,653,8254.666666666666,249.0,93.28571428571428,7,4087,6728.0,1514.0,583.8571428571429
90025700.0,17,28,13364,28,13364,3334285.185185185,501.0,477.2857142857143,0,0,0.0,0.0,0.0
302018.0,17,2,246,1,76,0.0,76.0,76.0,1,170,0.0,170.0,170.0
2852940.0,6,11,2106,6,598,570335.6,252.0,99.66666666666669,5,1508,3245.75,1236.0,301.6
4421.0,17,4,344,2,150,0.0,75.0,75.0,2,194,0.0,103.0,97.0
73753.0,6,14,4740,7,653,12165.166666666666,249.0,93.28571428571428,7,4087,10497.666666666666,1514.0,583.8571428571429
233350.0,6,4,439,2,238,0.0,172.0,119.0,2,201,0.0,135.0,100.5
298290.0,6,6,412,4,272,99430.0,74.0,68.0,2,140,0.0,74.0,70.0
135133148.0,17,6,1206,6,1206,27026629.6,201.0,201.0,0,0,0.0,0.0,0.0
122099.0,6,3,337,2,214,0.0,160.0,107.0,1,123,0.0,123.0,123.0
120112180.0,6,274,31094,137,9338,877151.4117647059,140.0,68.16058394160584,137,21756,883028.6176470588,284.0,158.8029197080292
2590042.0,6,2,132,1,66,0.0,66.0,66.0,1,66,0.0,66.0,66.0
25043.0,6,10,2032,5,524,6016.5,252.0,104.8,5,1508,5986.5,1236.0,301.6
90073529.0,17,28,13364,28,13364,3336056.6296296297,501.0,477.2857142857143,0,0,0.0,0.0,0.0
103518.0,17,2,286,2,286,0.0,143.0,143.0,0,0,0.0,0.0,0.0
1033755.0,6,11,1134,6,558,206751.0,220.0,93.0,5,576,255111.25,304.0,115.2
82737.0,6,14,4740,7,653,13620.166666666666,249.0,93.28571428571428,7,4087,13592.166666666666,1514.0,583.8571428571429
90362922.0,6,15,2460,8,1632,12908828.42857143,204.0,204.0,7,828,15014664.5,188.0,118.28571428571428
120282121.0,6,233,26228,117,18276,1036914.8362068966,284.0,156.2051282051282,116,7952,1037958.5739130436,140.0,68.55172413793103
90045981.0,17,28,13364,28,13364,3335036.333333333,501.0,477.2857142857143,0,0,0.0,0.0,0.0
184848.0,17,2,180,1,90,0.0,90.0,90.0,1,90,0.0,90.0,90.0
5011761.0,17,4,1164,2,166,0.0,83.0,83.0,2,998,0.0,499.0,499.0
108108904.0,17,5,955,5,955,27027226.0,191.0,191.0,0,0,0.0,0.0,0.0
118330033.0,6,205,23174,103,7020,1160098.362745098,140.0,68.15533980582525,102,16154,1161257.504950495,284.0,158.37254901960785
33941.0,6,14,4740,7,653,4981.166666666667,249.0,93.28571428571428,7,4087,5171.666666666667,1514.0,583.8571428571429
32680921.0,6,5,336,2,134,0.0,68.0,67.0,3,202,14942401.5,70.0,67.33333333333333
831835.0,6,9,1118,6,586,166367.0,248.0,97.66666666666669,3,532,279551.0,392.0,177.33333333333334
2388.0,17,4,344,2,150,0.0,75.0,75.0,2,194,0.0,103.0,97.0
520283.00000000006,6,3,198,2,132,0.0,66.0,66.0,1,66,0.0,66.0,66.0
83820.0,6,11,2098,6,590,16520.0,252.0,98.33333333333331,5,1508,20593.75,1236.0,301.6
122240405.0,17,15,1431,7,694,16998026.666666668,174.0,99.14285714285714,8,737,17440204.714285713,174.0,92.125
362326.0,6,11,1021,6,444,48745.8,162.0,74.0,5,577,60714.25,349.0,115.4
111045.0,17,2,286,2,286,0.0,143.0,143.0,0,0,0.0,0.0,0.0
317880.0,6,6,412,4,272,105960.0,74.0,68.0,2,140,0.0,74.0,70.0
145954.0,6,3,373,2,238,0.0,172.0,119.0,1,135,0.0,135.0,135.0
519094.00000000006,6,5,336,2,134,0.0,68.0,67.0,3,202,200368.5,70.0,67.33333333333333
1300902.0,6,4,264,2,132,0.0,66.0,66.0,2,132,0.0,66.0,66.0
244124.0,17,2,180,1,70,0.0,70.0,70.0,1,110,0.0,110.0,110.0
145243.0,17,2,180,1,70,0.0,70.0,70.0,1,110,0.0,110.0,110.0
146156.0,6,3,337,2,214,0.0,160.0,107.0,1,123,0.0,123.0,123.0
204540.0,17,2,180,1,90,0.0,90.0,90.0,1,90,0.0,90.0,90.0
232997.0,6,3,337,2,214,0.0,160.0,107.0,1,123,0.0,123.0,123.0
147534.0,6,3,337,2,214,0.0,160.0,107.0,1,123,0.0,123.0,123.0
120252356.0,6,34,2403,18,1332,7073668.0,123.0,74.0,16,1071,7490155.266666667,123.0,66.9375
2430.0,17,4,344,2,150,0.0,75.0,75.0,2,194,0.0,103.0,97.0
139091.0,6,2,132,1,66,0.0,66.0,66.0,1,66,0.0,66.0,66.0
506224.0,6,5,336,2,134,0.0,68.0,67.0,3,202,194497.0,70.0,67.33333333333333
623951.0,17,2,762,2,762,0.0,381.0,381.0,0,0,0.0,0.0,0.0
99003680.0,17,13,1083,7,563,16500613.333333334,174.0,80.42857142857143,6,520,15800190.8,174.0,86.66666666666667
209967.0,6,3,426,2,280,0.0,214.0,140.0,1,146,0.0,146.0,146.0
46335.0,6,2,132,1,66,0.0,66.0,66.0,1,66,0.0,66.0,66.0
760.0,17,4,438,2,148,0.0,74.0,74.0,2,290,0.0,147.0,145.0
120259869.0,6,220,24884,110,7482,1095635.4220183487,140.0,68.01818181818182,110,17402,1095791.486238532,284.0,158.2
120061564.0,6,234,26438,117,8018,1029005.7672413794,140.0,68.52991452991454,117,18420,1027887.5948275862,284.0,157.43589743589743
91236585.0,6,23,1775,13,1030,7598500.333333333,95.0,79.23076923076923,10,745,10052318.222222222,95.0,74.5
116787.0,6,15,4806,8,719,16354.42857142857,249.0,89.875,7,4087,19247.5,1514.0,583.8571428571429
1304893.0,6,4,264,2,132,0.0,66.0,66.0,2,132,0.0,66.0,66.0
216948.0,6,3,426,2,280,0.0,214.0,140.0,1,146,0.0,146.0,146.0
90294866.0,6,17,1287,8,637,12899266.57142857,95.0,79.625,9,650,11249418.125,95.0,72.22222222222223
510254.0,6,5,336,2,134,0.0,68.0,67.0,3,202,195420.5,70.0,67.33333333333333
513.0,17,2,508,2,508,0.0,257.0,254.0,0,0,0.0,0.0,0.0
90528424.0,6,14,2240,8,1016,12932632.0,188.0,127.0,6,1224,18072706.4,204.0,204.0
241993.0,6,3,373,2,238,0.0,172.0,119.0,1,135,0.0,135.0,135.0
108110692.0,17,5,1005,5,1005,27027673.0,201.0,201.0,0,0,0.0,0.0,0.0
703178.0,6,11,1131,6,600,140635.6,262.0,100.0,5,531,174129.0,259.0,106.2
119955041.0,6,28,2127,13,989,9975693.5,95.0,76.07692307692308,15,1138,8556428.142857144,95.0,75.86666666666666
108092848.0,17,5,1005,5,1005,27023212.0,201.0,201.0,0,0,0.0,0.0,0.0
155499.0,6,3,337,2,214,0.0,160.0,107.0,1,123,0.0,123.0,123.0
120316790.0,6,21,1626,11,840,11999999.3,95.0,76.36363636363636,10,786,13367765.888888888,95.0,78.6
18459.0,6,10,1067,5,536,4452.0,264.0,107.2,5,531,2110.25,259.0,106.2
2422.0,17,4,344,2,150,0.0,75.0,75.0,2,194,0.0,103.0,97.0
120124396.0,6,13,2020,9,1204,15015549.5,188.0,133.77777777777777,4,816,30032051.33333333,204.0,204.0
3201434.0,6,4,492,2,280,0.0,214.0,140.0,2,212,0.0,146.0,106.0
38085.0,6,14,4740,7,653,6222.166666666667,249.0,93.28571428571428,7,4087,6208.166666666667,1514.0,583.8571428571429
120121051.0,6,14,2240,6,1224,24024210.2,204.0,204.0,8,1016,17136543.57142857,188.0,127.0
342546.0,6,6,412,4,272,114182.0,74.0,68.0,2,140,0.0,74.0,70.0
90257531.0,6,12,1832,8,1016,12893933.0,188.0,127.0,4,816,30030988.33333333,204.0,204.0
38112.0,6,14,4740,7,653,6185.5,249.0,93.28571428571428,7,4087,5220.166666666667,1514.0,583.8571428571429
120000073.0,6,17,1287,9,691,15000009.125,95.0,76.77777777777777,8,596,12898393.0,95.0,74.5
1316069.0,17,7,490,7,490,219344.8333333333,70.0,70.0,0,0,0.0,0.0,0.0
216589.0,17,2,180,1,90,0.0,90.0,90.0,1,90,0.0,90.0,90.0
120123913.0,6,14,2240,6,1224,24024782.6,204.0,204.0,8,1016,17136962.42857143,188.0,127.0
320936.0,17,4,1400,4,1400,106978.66666666669,350.0,350.0,0,0,0.0,0.0,0.0
5007316.0,17,4,849,2,166,0.0,83.0,83.0,2,683,0.0,499.0,341.5
93316196.0,17,12,778,6,389,18631454.4,174.0,64.83333333333333,6,389,18519402.4,174.0,64.83333333333333
108117242.0,17,5,1005,5,1005,27029310.5,201.0,201.0,0,0,0.0,0.0,0.0
3004.0,17,2,224,1,76,0.0,76.0,76.0,1,148,0.0,148.0,148.0
2876144.0,6,4,270,2,134,0.0,68.0,67.0,2,136,0.0,70.0,68.0
104790648.0,17,15,5130,15,5130,7485046.285714285,342.0,342.0,0,0,0.0,0.0,0.0
1280115.0,17,7,490,7,490,213352.5,70.0,70.0,0,0,0.0,0.0,0.0
108103242.0,17,5,955,5,955,27025810.5,191.0,191.0,0,0,0.0,0.0,0.0
283655.0,17,4,704,2,148,0.0,74.0,74.0,2,556,0.0,280.0,278.0
90203850.0,6,22,1680,10,786,9996567.0,95.0,78.6,12,894,8181729.545454546,95.0,74.5
101960.0,17,2,286,2,286,0.0,143.0,143.0,0,0,0.0,0.0,0.0
875288.0,6,12,2718,7,743,145881.33333333334,339.0,106.14285714285714,5,1975,150703.25,1514.0,395.0
206824.0,17,2,180,1,90,0.0,90.0,90.0,1,90,0.0,90.0,90.0
3053534.0,6,3,204,2,136,0.0,70.0,68.0,1,68,0.0,68.0,68.0
217778.0,6,3,426,2,280,0.0,214.0,140.0,1,146,0.0,146.0,146.0
12663.0,6,11,2098,6,590,2141.6,252.0,98.33333333333331,5,1508,2606.75,1236.0,301.6
107532.0,17,2,286,2,286,0.0,143.0,143.0,0,0,0.0,0.0,0.0
140507.0,6,2,132,1,66,0.0,66.0,66.0,1,66,0.0,66.0,66.0
302098.0,6,6,412,4,272,100699.33333333331,74.0,68.0,2,140,0.0,74.0,70.0
2244.0,17,4,344,2,150,0.0,75.0,75.0,2,194,0.0,103.0,97.0
43441.0,6,14,4740,7,653,6676.333333333333,249.0,93.28571428571428,7,4087,6709.166666666667,1514.0,583.8571428571429
0.0,6,1,66,1,66,0.0,66.0,66.0,0,0,0.0,0.0,0.0
6869.0,17,2,582,1,83,0.0,83.0,83.0,1,499,0.0,499.0,499.0
209532.0,17,2,180,1,90,0.0,90.0,90.0,1,90,0.0,90.0,90.0
445.0,17,2,166,1,75,0.0,75.0,75.0,1,91,0.0,91.0,91.0
135132477.0,17,6,1146,6,1146,27026495.4,191.0,191.0,0,0,0.0,0.0,0.0
108102796.0,17,5,1005,5,1005,27025699.0,201.0,201.0,0,0,0.0,0.0,0.0
47795303.0,6,7,1874,3,887,22598100.5,753.0,295.6666666666667,4,987,15011234.666666666,785.0,246.75
113520322.0,6,46,3036,23,1518,5160003.409090909,66.0,66.0,23,1518,5160003.454545454,66.0,66.0
108110.0,17,2,286,2,286,0.0,143.0,143.0,0,0,0.0,0.0,0.0
128655987.0,6,34,2334,17,1125,7416934.3125,123.0,66.17647058823529,17,1209,7416920.125,123.0,71.11764705882354
90280754.0,6,14,1043,7,542,15046792.333333334,95.0,77.42857142857143,7,501,14999363.5,95.0,71.57142857142857
104345.0,17,2,286,2,286,0.0,143.0,143.0,0,0,0.0,0.0,0.0
2181998.0,6,18,6803,10,1501,242444.22222222225,408.0,150.1,8,5302,249242.4285714285,1514.0,662.75
216228.0,17,2,180,1,90,0.0,90.0,90.0,1,90,0.0,90.0,90.0
25054380.0,17,5,1718,4,1368,1055257.6666666667,342.0,342.0,1,350,0.0,350.0,350.0
60463.0,6,14,4740,7,653,9482.333333333334,249.0,93.28571428571428,7,4087,9452.0,1514.0,583.8571428571429
36115.0,6,14,4740,7,653,5894.5,249.0,93.28571428571428,7,4087,5724.166666666667,1514.0,583.8571428571429
1839.0,17,2,176,1,80,0.0,80.0,80.0,1,96,0.0,96.0,96.0
146756.0,6,3,373,2,238,0.0,172.0,119.0,1,135,0.0,135.0,135.0
153484.0,17,2,180,1,90,0.0,90.0,90.0,1,90,0.0,90.0,90.0
3166461.0,6,18,1536,9,962,358148.75,315.0,106.88888888888889,9,574,358117.875,78.0,63.77777777777778
9008294.0,6,12,2172,7,664,1501273.0,252.0,94.85714285714286,5,1508,1911.25,1236.0,301.6
531777.0,17,6,2100,6,2100,106355.4,350.0,350.0,0,0,0.0,0.0,0.0
108001007.0,17,14,864,7,432,18000167.833333332,174.0,61.71428571428572,7,432,17832157.833333332,174.0,61.71428571428572
173457.0,17,4,704,2,148,0.0,74.0,74.0,2,556,0.0,280.0,278.0
90287241.0,6,19,1436,10,745,10027356.222222222,95.0,74.5,9,691,11285246.625,95.0,76.77777777777777
15110.0,6,10,1067,5,536,3491.25,264.0,107.2,5,531,3172.25,259.0,106.2
511076.0,6,5,336,2,134,0.0,68.0,67.0,3,202,193709.0,70.0,67.33333333333333
206854.0,6,3,426,2,280,0.0,214.0,140.0,1,146,0.0,146.0,146.0
232792.0,6,3,337,2,214,0.0,160.0,107.0,1,123,0.0,123.0,123.0
232497.0,6,3,337,2,214,0.0,160.0,107.0,1,123,0.0,123.0,123.0
108100524.0,17,5,955,5,955,27025131.0,191.0,191.0,0,0,0.0,0.0,0.0
140306.0,6,2,132,1,66,0.0,66.0,66.0,1,66,0.0,66.0,66.0
218852.0,6,3,426,2,280,0.0,214.0,140.0,1,146,0.0,146.0,146.0
1955.0,17,2,180,1,90,0.0,90.0,90.0,1,90,0.0,90.0,90.0
33702123.0,6,5,336,2,134,0.0,68.0,67.0,3,202,15462518.0,70.0,67.33333333333333
106776.0,17,2,286,2,286,0.0,143.0,143.0,0,0,0.0,0.0,0.0
13910.0,6,11,1133,6,602,2320.4,264.0,100.33333333333331,5,531,2528.5,259.0,106.2
0.0,17,1,381,1,381,0.0,381.0,381.0,0,0,0.0,0.0,0.0
6490.0,17,4,823,2,163,0.0,89.0,81.5,2,660,0.0,443.0,330.0
22418.0,6,10,2032,5,524,5355.5,252.0,104.8,5,1508,5256.75,1236.0,301.6
145431.0,6,3,337,2,214,0.0,160.0,107.0,1,123,0.0,123.0,123.0
119734807.0,6,240,27258,120,19042,1004366.9663865546,300.0,158.68333333333334,120,8216,1004367.0588235294,140.0,68.46666666666667
143992.0,17,2,180,1,90,0.0,90.0,90.0,1,90,0.0,90.0,90.0
84.0,17,2,762,2,762,0.0,381.0,381.0,0,0,0.0,0.0,0.0
50537.0,6,14,4740,7,653,8215.166666666666,249.0,93.28571428571428,7,4087,7840.833333333333,1514.0,583.8571428571429
205916.0,17,2,180,1,90,0.0,90.0,90.0,1,90,0.0,90.0,90.0
166081.0,6,3,337,2,214,0.0,160.0,107.0,1,123,0.0,123.0,123.0
121949.0,6,3,337,2,214,0.0,160.0,107.0,1,123,0.0,123.0,123.0
206204.0,6,3,426,2,280,0.0,214.0,140.0,1,146,0.0,146.0,146.0
110942504.0,6,34,2620,18,1411,6513339.647058823,139.0,78.38888888888889,16,1209,7381787.533333333,123.0,75.5625
42631.0,6,12,1320,6,723,7912.6,253.0,120.5,6,597,7225.0,259.0,99.5
119851271.0,6,16,2510,7,1428,19974812.83333333,204.0,204.0,9,1082,14981225.0,188.0,120.22222222222224
108113375.0,17,5,955,5,955,27028343.75,191.0,191.0,0,0,0.0,0.0,0.0
2951222.0,6,3,1604,1,753,0.0,753.0,753.0,2,851,0.0,785.0,425.5
515863.0,6,3,204,2,136,0.0,70.0,68.0,1,68,0.0,68.0,68.0
182092.0,17,6,1230,3,234,90854.5,78.0,78.0,3,996,90840.0,332.0,332.0
6752.0,17,2,582,1,83,0.0,83.0,83.0,1,499,0.0,499.0,499.0
148011.0,17,2,180,1,90,0.0,90.0,90.0,1,90,0.0,90.0,90.0
299028.0,6,6,412,4,272,99676.0,74.0,68.0,2,140,0.0,74.0,70.0
270566.0,6,10,1221,6,636,54113.2,298.0,106.0,4,585,80903.66666666667,379.0,146.25
19694.0,6,14,4740,7,653,3050.5,249.0,93.28571428571428,7,4087,3138.1666666666665,1514.0,583.8571428571429
13053.0,6,11,2098,6,590,2468.0,252.0,98.33333333333331,5,1508,3016.5,1236.0,301.6
2351.0,17,4,344,2,150,0.0,75.0,75.0,2,194,0.0,103.0,97.0
106879609.0,6,30,2106,15,1089,7618840.5,123.0,72.6,15,1017,7618821.642857143,123.0,67.8
90400647.0,6,31,2436,17,1335,5636166.5625,123.0,78.52941176470588,14,1101,6936821.153846154,123.0,78.64285714285714
39111.0,6,10,2032,5,524,8375.75,252.0,104.8,5,1508,9441.0,1236.0,301.6
43163.0,6,14,4740,7,653,6065.166666666667,249.0,93.28571428571428,7,4087,6302.333333333333,1514.0,583.8571428571429
120114822.0,6,13,2036,8,1016,17136323.85714286,188.0,127.0,5,1020,22523288.75,204.0,204.0
207823.0,6,10,1221,6,636,41564.6,298.0,106.0,4,585,68148.33333333333,379.0,146.25
209508.0,17,2,180,1,90,0.0,90.0,90.0,1,90,0.0,90.0,90.0
36559.0,6,14,4740,7,653,5517.666666666667,249.0,93.28571428571428,7,4087,5442.166666666667,1514.0,583.8571428571429
0.0,17,1,90,1,90,0.0,90.0,90.0,0,0,0.0,0.0,0.0
46786560.0,6,8,1940,3,887,22323899.5,753.0,295.6666666666667,5,1053,11002427.0,785.0,210.6
147167.0,6,3,373,2,238,0.0,172.0,119.0,1,135,0.0,135.0,135.0
98228228.0,17,12,778,6,389,19601325.8,174.0,64.83333333333333,6,389,19600161.8,174.0,64.83333333333333
337894.0,6,6,412,4,272,112631.33333333331,74.0,68.0,2,140,0.0,74.0,70.0
103342.0,17,2,286,2,286,0.0,143.0,143.0,0,0,0.0,0.0,0.0
65286.0,6,14,4740,7,653,10716.166666666666,249.0,93.28571428571428,7,4087,9507.333333333334,1514.0,583.8571428571429
101781.0,17,2,762,2,762,0.0,381.0,381.0,0,0,0.0,0.0,0.0
120129175.0,6,252,29066,127,8678,953406.1507936508,140.0,68.33070866141732,125,20388,954337.0967741936,284.0,163.104
241664.0,6,3,337,2,214,0.0,160.0,107.0,1,123,0.0,123.0,123.0
6592.0,17,4,823,2,163,0.0,89.0,81.5,2,660,0.0,443.0,330.0
381812.0,6,4,508,2,238,0.0,172.0,119.0,2,270,0.0,135.0,135.0
3134491.0,6,18,1495,9,921,352957.0,315.0,102.33333333333331,9,574,352926.875,78.0,63.77777777777778
106288946.0,6,43,2838,22,1452,5061365.761904762,66.0,66.0,21,1386,5111998.05,66.0,66.0
19926.0,17,2,582,1,83,0.0,83.0,83.0,1,499,0.0,499.0,499.0
120142597.0,6,222,24962,111,7622,1084739.472727273,140.0,68.66666666666667,111,17340,1084672.4636363636,284.0,156.21621621621622
135127339.0,17,6,1146,6,1146,27025467.8,191.0,191.0,0,0,0.0,0.0,0.0
307103.0,6,6,412,4,272,102367.66666666669,74.0,68.0,2,140,0.0,74.0,70.0
2095.0,17,4,344,2,150,0.0,75.0,75.0,2,194,0.0,103.0,97.0
13717.0,6,10,2032,5,524,3190.25,252.0,104.8,5,1508,3187.75,1236.0,301.6
209706.0,6,3,426,2,280,0.0,214.0,140.0,1,146,0.0,146.0,146.0
9363.0,17,2,582,1,83,0.0,83.0,83.0,1,499,0.0,499.0,499.0
108105681.0,17,5,955,5,955,27026420.25,191.0,191.0,0,0,0.0,0.0,0.0
57573.0,6,14,4740,7,653,9353.166666666666,249.0,93.28571428571428,7,4087,9127.333333333334,1514.0,583.8571428571429
147198.0,6,3,373,2,238,0.0,172.0,119.0,1,135,0.0,135.0,135.0
307.0,17,2,174,1,79,0.0,79.0,79.0,1,95,0.0,95.0,95.0
303827.0,6,6,412,4,272,101275.66666666669,74.0,68.0,2,140,0.0,74.0,70.0
7206.0,17,2,582,1,83,0.0,83.0,83.0,1,499,0.0,499.0,499.0
120010680.0,6,23,1734,12,935,10909074.090909092,95.0,77.91666666666667,11,799,12000069.1,95.0,72.63636363636364
0.0,6,1,66,0,0,0.0,0.0,0.0,1,66,0.0,66.0,66.0
39378.0,6,14,4740,7,653,6436.0,249.0,93.28571428571428,7,4087,5885.833333333333,1514.0,583.8571428571429
17104.0,6,19,7540,11,978,1710.4,310.0,88.9090909090909,8,6562,2108.5714285714284,1514.0,820.25
148087.0,17,2,180,1,90,0.0,90.0,90.0,1,90,0.0,90.0,90.0
1169984.0,6,13,3002,8,2374,167140.57142857142,1514.0,296.75,5,628,224370.5,331.0,125.6
4320877.0,6,163,129763,91,120711,48009.74444444444,1510.0,1326.4945054945056,72,9052,56559.47887323944,1510.0,125.72222222222224
108693.0,17,2,286,2,286,0.0,143.0,143.0,0,0,0.0,0.0,0.0
108445388.0,6,32,2352,16,1140,7229692.533333333,123.0,71.25,16,1212,6702927.666666667,123.0,75.75
216666.0,6,3,426,2,280,0.0,214.0,140.0,1,146,0.0,146.0,146.0
2089.0,17,4,344,2,150,0.0,75.0,75.0,2,194,0.0,103.0,97.0
107167.0,17,2,286,2,286,0.0,143.0,143.0,0,0,0.0,0.0,0.0
298399.0,6,6,412,4,272,99466.33333333331,74.0,68.0,2,140,0.0,74.0,70.0
749424.0,6,2,132,1,66,0.0,66.0,66.0,1,66,0.0,66.0,66.0
38875.0,6,10,2032,5,524,9416.25,252.0,104.8,5,1508,8639.25,1236.0,301.6
144936.0,17,2,180,1,70,0.0,70.0,70.0,1,110,0.0,110.0,110.0
52964.0,6,14,4740,7,653,8662.166666666666,249.0,93.28571428571428,7,4087,7954.833333333333,1514.0,583.8571428571429
86081.0,6,14,4740,7,653,13282.833333333334,249.0,93.28571428571428,7,4087,14187.0,1514.0,583.8571428571429
108109241.0,17,5,1005,5,1005,27027310.25,201.0,201.0,0,0,0.0,0.0,0.0
119036194.0,6,47,3102,24,1584,5175471.869565218,66.0,66.0,23,1518,5144003.181818182,66.0,66.0
257506.0,6,3,337,2,214,0.0,160.0,107.0,1,123,0.0,123.0,123.0
8232.0,17,4,823,2,163,0.0,89.0,81.5,2,660,0.0,443.0,330.0
25559.0,6,14,4740,7,653,3703.6666666666665,249.0,93.28571428571428,7,4087,4034.0,1514.0,583.8571428571429
119978.0,17,2,180,1,70,0.0,70.0,70.0,1,110,0.0,110.0,110.0
112760209.0,17,14,864,7,432,18667746.166666668,174.0,61.71428571428572,7,432,18666884.5,174.0,61.71428571428572
113117186.0,6,207,23486,103,7020,1100962.31372549,140.0,68.15533980582525,104,16466,1090229.6990291262,284.0,158.32692307692307
2321.0,17,4,344,2,150,0.0,75.0,75.0,2,194,0.0,103.0,97.0
121334.0,6,3,337,2,214,0.0,160.0,107.0,1,123,0.0,123.0,123.0
239512.0,6,3,337,2,214,0.0,160.0,107.0,1,123,0.0,123.0,123.0
228242.0,17,2,180,1,90,0.0,90.0,90.0,1,90,0.0,90.0,90.0
196967.0,17,2,180,1,90,0.0,90.0,90.0,1,90,0.0,90.0,90.0
196230.0,6,11,1132,6,556,38465.4,218.0,92.66666666666669,5,576,48770.25,304.0,115.2
32495.000000000004,6,11,2098,6,590,6426.0,252.0,98.33333333333331,5,1508,7019.0,1236.0,301.6
3003040.0,6,12,2172,7,664,500442.3333333333,252.0,94.85714285714286,5,1508,1737.25,1236.0,301.6
153424.0,17,2,180,1,90,0.0,90.0,90.0,1,90,0.0,90.0,90.0
2408.0,17,4,344,2,150,0.0,75.0,75.0,2,194,0.0,103.0,97.0
242429.0,6,3,337,2,214,0.0,160.0,107.0,1,123,0.0,123.0,123.0
90757730.0,6,19,1436,10,745,10079496.777777778,95.0,74.5,9,691,11343100.25,95.0,76.77777777777777
317761.0,6,6,412,4,272,105920.33333333331,74.0,68.0,2,140,0.0,74.0,70.0
32166.0,6,10,1065,5,534,7122.75,262.0,106.8,5,531,5809.25,259.0,106.2
111386788.0,6,204,22980,102,16026,1100707.524752475,284.0,157.11764705882354,102,6954,1100707.8514851483,140.0,68.17647058823529
282677.0,17,2,180,1,90,0.0,90.0,90.0,1,90,0.0,90.0,90.0
146048.0,6,3,337,2,214,0.0,160.0,107.0,1,123,0.0,123.0,123.0
13323.0,6,10,1067,5,536,3137.25,264.0,107.2,5,531,2493.5,259.0,106.2
280761.0,6,10,1221,6,636,56152.2,298.0,106.0,4,585,88169.66666666667,379.0,146.25
140055.0,6,11,1132,6,556,27052.8,218.0,92.66666666666669,5,576,34804.25,304.0,115.2
211965.0,6,10,1221,6,636,42393.0,298.0,106.0,4,585,69764.66666666667,379.0,146.25
90653584.0,6,33,2560,17,1351,5665849.0,139.0,79.47058823529412,16,1209,6029867.266666667,123.0,75.5625
108105543.0,17,5,955,5,955,27026385.75,191.0,191.0,0,0,0.0,0.0,0.0
2300.0,17,4,344,2,150,0.0,75.0,75.0,2,194,0.0,103.0,97.0
508728.0,6,5,336,2,134,0.0,68.0,67.0,3,202,190876.0,70.0,67.33333333333333
108104666.0,17,5,955,5,955,27026166.5,191.0,191.0,0,0,0.0,0.0,0.0
14684.0,6,14,4740,7,653,2305.333333333333,249.0,93.28571428571428,7,4087,2211.333333333333,1514.0,583.8571428571429
88226.0,6,13,1386,7,789,14704.333333333334,253.0,112.71428571428572,6,597,14454.4,259.0,99.5
108994.0,17,2,286,2,286,0.0,143.0,143.0,0,0,0.0,0.0,0.0
94424969.0,6,40,2640,20,1320,4969735.210526316,66.0,66.0,20,1320,4958358.736842105,66.0,66.0
13737459.0,17,6,2052,6,2052,2747491.8,342.0,342.0,0,0,0.0,0.0,0.0
255232.0,6,3,337,2,214,0.0,160.0,107.0,1,123,0.0,123.0,123.0
135132879.0,17,6,1206,6,1206,27026575.8,201.0,201.0,0,0,0.0,0.0,0.0
556469.0,17,4,629,3,234,3944.0,78.0,78.0,1,395,0.0,395.0,395.0
228224.0,17,2,180,1,90,0.0,90.0,90.0,1,90,0.0,90.0,90.0
2576177.0,6,2,132,1,66,0.0,66.0,66.0,1,66,0.0,66.0,66.0
232321.0,6,3,337,2,214,0.0,160.0,107.0,1,123,0.0,123.0,123.0
29900750.0,6,4,270,3,202,14950375.0,70.0,67.33333333333333,1,68,0.0,68.0,68.0
90299281.0,6,16,1192,8,596,12892907.714285716,95.0,74.5,8,596,12899455.57142857,95.0,74.5
54762.0,6,10,2032,5,524,12961.75,252.0,104.8,5,1508,12991.75,1236.0,301.6
1092664.0,6,13,1386,7,789,182110.66666666663,253.0,112.71428571428572,6,597,217375.4,259.0,99.5
830.0,17,4,438,2,148,0.0,74.0,74.0,2,290,0.0,147.0,145.0
41802.0,6,12,1413,7,882,6967.0,291.0,126.0,5,531,9457.25,259.0,106.2
108106523.0,17,5,955,5,955,27026630.75,191.0,191.0,0,0,0.0,0.0,0.0
844927.0,6,9,1196,6,725,168985.4,387.0,120.83333333333331,3,471,286244.5,331.0,157.0
2306.0,17,4,344,2,150,0.0,75.0,75.0,2,194,0.0,103.0,97.0
196951.0,17,2,180,1,90,0.0,90.0,90.0,1,90,0.0,90.0,90.0
135137105.0,17,6,1206,6,1206,27027421.0,201.0,201.0,0,0,0.0,0.0,0.0
135131945.0,17,6,1146,6,1146,27026389.0,191.0,191.0,0,0,0.0,0.0,0.0
233079.0,6,3,337,2,214,0.0,160.0,107.0,1,123,0.0,123.0,123.0
303265.0,6,6,412,4,272,101088.33333333331,74.0,68.0,2,140,0.0,74.0,70.0
90026861.0,17,28,13364,28,13364,3334328.185185185,501.0,477.2857142857143,0,0,0.0,0.0,0.0
36057.0,6,14,4740,7,653,5830.333333333333,249.0,93.28571428571428,7,4087,5460.333333333333,1514.0,583.8571428571429
152365.0,17,4,6056,4,6056,50788.333333333336,1514.0,1514.0,0,0,0.0,0.0,0.0
126410567.0,17,19,2057,9,1079,13375106.5,394.0,119.88888888888889,10,978,14001235.111111112,250.0,97.8
61296.0,6,12,1320,7,789,10216.0,253.0,112.71428571428572,5,531,12773.5,259.0,106.2
50833.0,6,12,1320,6,723,9194.0,253.0,120.5,6,597,7985.8,259.0,99.5
2384.0,17,4,344,2,150,0.0,75.0,75.0,2,194,0.0,103.0,97.0
2375.0,17,2,762,2,762,0.0,381.0,381.0,0,0,0.0,0.0,0.0
4608.0,17,2,614,1,72,0.0,72.0,72.0,1,542,0.0,542.0,542.0
117514055.0,6,210,23646,105,16494,1127871.6634615385,284.0,157.0857142857143,105,7152,1127873.1538461538,140.0,68.11428571428571
10911479.0,6,8,544,4,272,3590630.0,74.0,68.0,4,272,3590602.6666666665,74.0,68.0
40695.0,6,10,2032,5,524,9907.0,252.0,104.8,5,1508,8163.0,1236.0,301.6
128011104.0,6,31,2034,16,1086,8534073.6,123.0,67.875,15,948,8415074.92857143,123.0,63.2
90256011.0,6,13,2036,8,1016,12893715.857142856,188.0,127.0,5,1020,22523414.5,204.0,204.0
315033.0,17,4,1400,4,1400,105011.0,350.0,350.0,0,0,0.0,0.0,0.0
319560.0,6,6,412,4,272,106520.0,74.0,68.0,2,140,0.0,74.0,70.0
208277.0,6,3,426,2,280,0.0,214.0,140.0,1,146,0.0,146.0,146.0
111174926.0,17,14,1126,7,563,18502470.5,174.0,80.42857142857143,7,563,18502465.33333333,174.0,80.42857142857143
35118.0,6,10,2032,5,524,8043.0,252.0,104.8,5,1508,7732.75,1236.0,301.6
100968.0,17,2,286,2,286,0.0,143.0,143.0,0,0,0.0,0.0,0.0
113527347.0,6,48,3168,24,1584,4935971.608695652,66.0,66.0,24,1584,4926568.478260869,66.0,66.0
27344165.0,17,5,1710,5,1710,6836041.25,342.0,342.0,0,0,0.0,0.0,0.0
442129.0,6,10,967,5,390,74477.0,162.0,78.0,5,577,74415.25,349.0,115.4
108109971.0,17,5,955,5,955,27027492.75,191.0,191.0,0,0,0.0,0.0,0.0
5834024.0,6,5,336,2,134,0.0,68.0,67.0,3,202,1522597.5,70.0,67.33333333333333
120480886.0,6,617,97522,309,76824,391171.7077922078,1514.0,248.62135922330097,308,20698,389810.3094462541,214.0,67.2012987012987
146514.0,6,10,1066,5,490,36068.75,218.0,98.0,5,576,36424.0,304.0,115.2
210385.0,17,2,414,1,88,0.0,88.0,88.0,1,326,0.0,326.0,326.0
219713.0,6,4,492,2,280,0.0,214.0,140.0,2,212,0.0,146.0,106.0
148092.0,17,2,180,1,90,0.0,90.0,90.0,1,90,0.0,90.0,90.0
126011249.0,17,15,907,8,475,18001607.0,174.0,59.375,7,432,17666831.166666668,174.0,61.71428571428572
586726.0,6,4,508,2,238,0.0,172.0,119.0,2,270,0.0,135.0,135.0
15155648.0,17,6,2718,6,2718,3031129.6,453.0,453.0,0,0,0.0,0.0,0.0
106622.0,17,2,286,2,286,0.0,143.0,143.0,0,0,0.0,0.0,0.0
142146.0,17,2,192,1,88,0.0,88.0,88.0,1,104,0.0,104.0,104.0
302439.0,6,2,132,1,66,0.0,66.0,66.0,1,66,0.0,66.0,66.0
4454.0,17,2,626,1,72,0.0,72.0,72.0,1,554,0.0,554.0,554.0
90213141.0,6,18,1382,8,596,12853346.57142857,95.0,74.5,10,786,10000952.888888888,95.0,78.6
303182.0,17,2,180,1,90,0.0,90.0,90.0,1,90,0.0,90.0,90.0
303109.0,6,2,132,1,66,0.0,66.0,66.0,1,66,0.0,66.0,66.0
302572.0,6,6,412,4,272,100857.33333333331,74.0,68.0,2,140,0.0,74.0,70.0
120149864.0,6,16,2372,8,1356,17164266.285714287,204.0,169.5,8,1016,17139529.714285713,188.0,127.0
2482.0,17,4,344,2,150,0.0,75.0,75.0,2,194,0.0,103.0,97.0
153375.0,17,2,180,1,90,0.0,90.0,90.0,1,90,0.0,90.0,90.0
99742420.0,17,12,778,6,389,19948484.0,174.0,64.83333333333333,6,389,19873915.2,174.0,64.83333333333333
1037532.0,6,11,1134,6,558,207506.4,220.0,93.0,5,576,257564.75,304.0,115.2
120152775.0,6,230,25978,115,7886,1046837.6228070176,140.0,68.57391304347826,115,18092,1037802.3333333334,284.0,157.3217391304348
57374.0,6,14,4740,7,653,8345.333333333334,249.0,93.28571428571428,7,4087,9113.166666666666,1514.0,583.8571428571429
218598.0,6,3,426,2,280,0.0,214.0,140.0,1,146,0.0,146.0,146.0
2425.0,17,4,344,2,150,0.0,75.0,75.0,2,194,0.0,103.0,97.0
93995631.0,6,172,19444,86,13546,1103297.9176470588,284.0,157.51162790697674,86,5898,1103299.1764705882,140.0,68.5813953488372
104718.0,17,2,700,2,700,0.0,350.0,350.0,0,0,0.0,0.0,0.0
717.0,17,4,438,2,148,0.0,74.0,74.0,2,290,0.0,147.0,145.0
27436.0,6,10,2032,5,524,6638.0,252.0,104.8,5,1508,5441.5,1236.0,301.6
236196.0,6,3,337,2,214,0.0,160.0,107.0,1,123,0.0,123.0,123.0
2574078.0,6,28,9195,16,3843,171605.2,1514.0,240.1875,12,5352,211304.2727272728,1514.0,446.0
71042.0,6,10,2032,5,524,17503.75,252.0,104.8,5,1508,15342.0,1236.0,301.6
108094668.0,17,5,955,5,955,27023667.0,191.0,191.0,0,0,0.0,0.0,0.0
118384198.0,6,205,23030,103,7094,1160629.392156863,140.0,68.87378640776699,102,15936,1151460.3861386138,284.0,156.23529411764707
108104082.0,17,5,1005,5,1005,27026020.5,201.0,201.0,0,0,0.0,0.0,0.0
3650976.0,6,164,125978,88,116662,41965.24137931035,1510.0,1325.7045454545455,76,9316,44622.85333333333,1510.0,122.57894736842104
2846440.0,6,3,204,2,136,0.0,70.0,68.0,1,68,0.0,68.0,68.0
228276.0,17,2,180,1,90,0.0,90.0,90.0,1,90,0.0,90.0,90.0
90303626.0,6,21,1585,11,840,9025513.2,95.0,76.36363636363636,10,745,9993377.666666666,95.0,74.5
303456.0,6,6,412,4,272,101152.0,74.0,68.0,2,140,0.0,74.0,70.0
3170954.0,6,18,1495,9,921,358352.125,315.0,102.33333333333331,9,574,358329.0,78.0,63.77777777777778
121974.0,6,3,337,2,214,0.0,160.0,107.0,1,123,0.0,123.0,123.0
291302.0,17,2,224,1,76,0.0,76.0,76.0,1,148,0.0,148.0,148.0
216627.0,6,3,426,2,280,0.0,214.0,140.0,1,146,0.0,146.0,146.0
220360.0,17,2,180,1,90,0.0,90.0,90.0,1,90,0.0,90.0,90.0
14379.0,6,12,1393,6,796,2746.2,271.0,132.66666666666666,6,597,2599.8,259.0,99.5
74654582.0,6,9,842,9,842,9331822.75,97.0,93.55555555555556,0,0,0.0,0.0,0.0
2432.0,17,4,344,2,150,0.0,75.0,75.0,2,194,0.0,103.0,97.0
509494.0,6,5,336,2,134,0.0,68.0,67.0,3,202,196397.0,70.0,67.33333333333333
320398.0,17,4,1400,4,1400,106799.33333333331,350.0,350.0,0,0,0.0,0.0,0.0
108104798.0,17,5,955,5,955,27026199.5,191.0,191.0,0,0,0.0,0.0,0.0
114005698.0,6,38,2710,19,1408,6321650.111111111,139.0,74.10526315789474,19,1302,6321649.277777778,123.0,68.52631578947368
1283803.0,17,7,490,7,490,213967.16666666663,70.0,70.0,0,0,0.0,0.0,0.0
3375581.0,6,148,116819,83,108227,41165.62195121951,1510.0,1303.9397590361446,65,8592,47938.15625,1510.0,132.1846153846154
46147.0,6,10,2032,5,524,11250.25,252.0,104.8,5,1508,10713.5,1236.0,301.6
40621.0,6,14,4740,7,653,6655.5,249.0,93.28571428571428,7,4087,6275.0,1514.0,583.8571428571429
216181.0,17,2,180,1,90,0.0,90.0,90.0,1,90,0.0,90.0,90.0
302257.0,6,6,412,4,272,100752.33333333331,74.0,68.0,2,140,0.0,74.0,70.0
121651.0,6,3,337,2,214,0.0,160.0,107.0,1,123,0.0,123.0,123.0
149451.0,6,3,337,2,214,0.0,160.0,107.0,1,123,0.0,123.0,123.0
90535278.0,6,13,2036,8,1016,12933611.142857144,188.0,127.0,5,1020,22592781.25,204.0,204.0
211258.0,17,2,180,1,90,0.0,90.0,90.0,1,90,0.0,90.0,90.0
153438.0,17,2,180,1,90,0.0,90.0,90.0,1,90,0.0,90.0,90.0
224132.0,6,3,426,2,280,0.0,214.0,140.0,1,146,0.0,146.0,146.0
205685.0,17,2,180,1,90,0.0,90.0,90.0,1,90,0.0,90.0,90.0
90095253.0,6,12,1848,5,1020,22523221.0,204.0,204.0,7,828,14970786.666666666,188.0,118.28571428571428
22992559.0,17,3,1034,2,684,0.0,342.0,342.0,1,350,0.0,350.0,350.0
119736.0,17,2,180,1,70,0.0,70.0,70.0,1,110,0.0,110.0,110.0
105212980.0,6,193,21804,97,15246,1095968.5416666667,284.0,157.17525773195877,96,6558,1096685.894736842,140.0,68.3125
375.0,17,2,267,1,83,0.0,83.0,83.0,1,184,0.0,184.0,184.0
151908.0,17,2,414,1,88,0.0,88.0,88.0,1,326,0.0,326.0,326.0
146656.0,6,3,337,2,214,0.0,160.0,107.0,1,123,0.0,123.0,123.0
114430038.0,6,220,24756,110,17274,1047840.9357798164,284.0,157.03636363636363,110,7482,1047842.4403669724,140.0,68.01818181818182
96841059.0,6,23,2653,12,1392,8784162.0,331.0,116.0,11,1261,9658625.9,425.0,114.63636363636364
90260140.0,6,13,1898,8,1016,12894305.714285716,188.0,127.0,5,882,22524532.25,204.0,176.4
4085.0,17,2,582,1,83,0.0,83.0,83.0,1,499,0.0,499.0,499.0
204742.0,17,3,1143,3,1143,102371.0,381.0,381.0,0,0,0.0,0.0,0.0
300420.0,6,6,412,4,272,100140.0,74.0,68.0,2,140,0.0,74.0,70.0
305610.0,6,6,412,4,272,101870.0,74.0,68.0,2,140,0.0,74.0,70.0
2343.0,17,4,344,2,150,0.0,75.0,75.0,2,194,0.0,103.0,97.0
8991.0,17,2,539,1,86,0.0,86.0,86.0,1,453,0.0,453.0,453.0
36564.0,6,14,4740,7,653,5973.5,249.0,93.28571428571428,7,4087,5405.666666666667,1514.0,583.8571428571429
78907.0,6,14,4740,7,653,12949.5,249.0,93.28571428571428,7,4087,12495.0,1514.0,583.8571428571429
64916.0,17,2,582,1,83,0.0,83.0,83.0,1,499,0.0,499.0,499.0
120037165.0,17,29,13785,29,13785,4287041.607142857,501.0,475.3448275862069,0,0,0.0,0.0,0.0
1302390.0,6,4,264,2,132,0.0,66.0,66.0,2,132,0.0,66.0,66.0
18054.0,17,2,582,1,83,0.0,83.0,83.0,1,499,0.0,499.0,499.0
30994.0,6,10,2032,5,524,7105.75,252.0,104.8,5,1508,7511.0,1236.0,301.6
135121034.0,17,6,1146,6,1146,27024206.8,191.0,191.0,0,0,0.0,0.0,0.0
215402.0,17,2,180,1,90,0.0,90.0,90.0,1,90,0.0,90.0,90.0
43710.0,6,13,1479,7,882,7285.0,291.0,126.0,6,597,6869.0,259.0,99.5
93029089.0,6,165,18584,83,13024,1134501.0853658535,284.0,156.9156626506024,82,5560,1134414.4197530863,140.0,67.8048780487805
13220.0,6,11,1132,6,556,2058.8,218.0,92.66666666666669,5,576,2649.25,304.0,115.2
249587.0,17,2,180,1,90,0.0,90.0,90.0,1,90,0.0,90.0,90.0
386.0,17,2,166,1,75,0.0,75.0,75.0,1,91,0.0,91.0,91.0
90046190.0,17,28,13364,28,13364,3335044.074074074,501.0,477.2857142857143,0,0,0.0,0.0,0.0
120000501.0,6,19,1436,9,691,15000062.625,95.0,76.77777777777777,10,745,13304872.222222222,95.0,74.5
113105589.0,6,84,7884,52,4569,2217756.647058824,123.0,87.86538461538461,32,3315,3641595.935483871,123.0,103.59375
2448.0,17,4,344,2,150,0.0,75.0,75.0,2,194,0.0,103.0,97.0
1492.0,17,2,762,2,762,0.0,381.0,381.0,0,0,0.0,0.0,0.0
90030743.0,17,28,13364,28,13364,3334471.962962963,501.0,477.2857142857143,0,0,0.0,0.0,0.0
339.0,17,2,166,1,75,0.0,75.0,75.0,1,91,0.0,91.0,91.0
2189.0,17,4,344,2,150,0.0,75.0,75.0,2,194,0.0,103.0,97.0
120067362.0,6,373,43584,187,12564,645523.4516129033,140.0,67.18716577540107,186,31020,647738.7243243243,284.0,166.7741935483871
196986.0,17,2,180,1,90,0.0,90.0,90.0,1,90,0.0,90.0,90.0
307979.0,6,6,412,4,272,102659.66666666669,74.0,68.0,2,140,0.0,74.0,70.0
364815.0,6,10,967,5,390,61355.5,162.0,78.0,5,577,61305.5,349.0,115.4
25180.0,6,14,4740,7,653,3261.6666666666665,249.0,93.28571428571428,7,4087,3260.0,1514.0,583.8571428571429
48623553.0,6,7,1872,3,886,23063566.5,752.0,295.3333333333333,4,986,15283795.666666666,784.0,246.5
62331.0,6,14,4740,7,653,10223.0,249.0,93.28571428571428,7,4087,10114.666666666666,1514.0,583.8571428571429
209494.0,17,2,180,1,90,0.0,90.0,90.0,1,90,0.0,90.0,90.0
96256210.0,17,12,778,6,389,19200176.2,174.0,64.83333333333333,6,389,19201124.2,174.0,64.83333333333333
22203.0,6,14,4740,7,653,3316.0,249.0,93.28571428571428,7,4087,3488.833333333333,1514.0,583.8571428571429
1838.0,17,2,939,1,590,0.0,590.0,590.0,1,349,0.0,349.0,349.0
228303.0,17,2,180,1,90,0.0,90.0,90.0,1,90,0.0,90.0,90.0
2045089.0,17,8,1640,4,312,681569.6666666667,78.0,78.0,4,1328,681561.6666666666,332.0,332.0
118532479.0,6,48,3168,24,1584,5153586.043478261,66.0,66.0,24,1584,5141617.608695652,66.0,66.0
90908176.0,6,222,25566,111,18018,824480.1818181818,300.0,162.32432432432432,111,7548,824480.1545454545,140.0,68.0
36961.0,6,10,2032,5,524,8987.0,252.0,104.8,5,1508,8985.25,1236.0,301.6
2808468.0,6,2,132,1,66,0.0,66.0,66.0,1,66,0.0,66.0,66.0
504082.00000000006,6,5,336,2,134,0.0,68.0,67.0,3,202,196399.5,70.0,67.33333333333333
65909.0,17,2,180,1,90,0.0,90.0,90.0,1,90,0.0,90.0,90.0
90304390.0,6,31,3249,16,1654,6016033.933333334,425.0,103.375,15,1595,6430160.428571428,335.0,106.33333333333331
24410.0,6,14,4740,7,653,3954.0,249.0,93.28571428571428,7,4087,3837.5,1514.0,583.8571428571429
312686.0,17,4,1400,4,1400,104228.66666666669,350.0,350.0,0,0,0.0,0.0,0.0
28114.0,6,10,2032,5,524,5650.25,252.0,104.8,5,1508,5909.5,1236.0,301.6
6647.0,17,2,180,1,90,0.0,90.0,90.0,1,90,0.0,90.0,90.0
596982.0,6,4,508,2,238,0.0,172.0,119.0,2,270,0.0,135.0,135.0
0.0,17,1,55,1,55,0.0,55.0,55.0,0,0,0.0,0.0,0.0
104285072.0,6,194,21854,97,15156,1084061.8333333333,284.0,156.24742268041237,97,6698,1084061.8854166667,140.0,69.05154639175258
103159912.0,6,43,2838,22,1452,4912363.571428572,66.0,66.0,21,1386,5143964.8,66.0,66.0
2386.0,17,4,344,2,150,0.0,75.0,75.0,2,194,0.0,103.0,97.0
1040838.0,6,11,1134,6,558,208167.6,220.0,93.0,5,576,259174.75,304.0,115.2
120428550.0,6,223,25564,112,18016,1084941.8918918918,336.0,160.85714285714286,111,7548,1085397.1636363636,140.0,68.0
207216.0,6,3,426,2,280,0.0,214.0,140.0,1,146,0.0,146.0,146.0
30078.0,6,10,2032,5,524,7281.25,252.0,104.8,5,1508,7271.75,1236.0,301.6
49010.0,6,10,1066,5,490,11312.5,218.0,98.0,5,576,11903.75,304.0,115.2
284850.0,17,2,363,1,79,0.0,79.0,79.0,1,284,0.0,284.0,284.0
39524.0,6,14,4740,7,653,6117.333333333333,249.0,93.28571428571428,7,4087,6354.166666666667,1514.0,583.8571428571429
306913.0,6,2,132,1,66,0.0,66.0,66.0,1,66,0.0,66.0,66.0
120358040.0,6,235,26450,118,18432,1028701.1965811966,284.0,156.20338983050848,117,8018,1028733.5431034482,140.0,68.52991452991454
46568.0,6,14,4740,7,653,6124.833333333333,249.0,93.28571428571428,7,4087,6468.833333333333,1514.0,583.8571428571429
1347821.0,17,16,1120,16,1120,89854.73333333334,70.0,70.0,0,0,0.0,0.0,0.0
46261.0,6,10,2032,5,524,10816.5,252.0,104.8,5,1508,10451.0,1236.0,301.6
6826.0,17,2,231,1,78,0.0,78.0,78.0,1,153,0.0,153.0,153.0
162354.0,17,2,180,1,90,0.0,90.0,90.0,1,90,0.0,90.0,90.0
135126115.0,17,6,1146,6,1146,27025223.0,191.0,191.0,0,0,0.0,0.0,0.0
579.0,17,2,762,2,762,0.0,381.0,381.0,0,0,0.0,0.0,0.0
311462.0,17,4,1400,4,1400,103820.66666666669,350.0,350.0,0,0,0.0,0.0,0.0
281257.0,17,2,363,1,79,0.0,79.0,79.0,1,284,0.0,284.0,284.0
208058.0,6,3,426,2,280,0.0,214.0,140.0,1,146,0.0,146.0,146.0
108100578.0,17,5,955,5,955,27025144.5,191.0,191.0,0,0,0.0,0.0,0.0
210382.0,6,10,1221,6,636,42076.4,298.0,106.0,4,585,68743.33333333333,379.0,146.25
120122464.0,6,14,2224,9,1204,15015308.0,188.0,133.77777777777777,5,1020,22590191.25,204.0,204.0
157107.0,6,3,337,2,214,0.0,160.0,107.0,1,123,0.0,123.0,123.0
90529967.0,6,13,2036,8,1016,12932852.42857143,188.0,127.0,5,1020,22591865.75,204.0,204.0
90026841.0,17,27,12943,27,12943,3462570.8076923075,501.0,479.3703703703704,0,0,0.0,0.0,0.0
1479907.0,17,16,1120,16,1120,98660.46666666666,70.0,70.0,0,0,0.0,0.0,0.0
113925519.0,6,30,1974,15,1026,8122124.357142857,123.0,68.4,15,948,8122119.214285715,123.0,63.2
50946.0,17,2,180,1,90,0.0,90.0,90.0,1,90,0.0,90.0,90.0
53793.0,6,14,4740,7,653,8797.833333333334,249.0,93.28571428571428,7,4087,8768.5,1514.0,583.8571428571429
117568116.0,6,48,3168,24,1584,5111657.217391305,66.0,66.0,24,1584,5097983.0869565215,66.0,66.0
3562668.0,6,5,336,2,134,0.0,68.0,67.0,3,202,1419738.5,70.0,67.33333333333333
105863027.0,6,44,2904,22,1452,5041096.523809524,66.0,66.0,22,1452,5028133.238095238,66.0,66.0
90043552.0,17,28,13364,28,13364,3334946.3703703703,501.0,477.2857142857143,0,0,0.0,0.0,0.0
243565.0,6,3,337,2,214,0.0,160.0,107.0,1,123,0.0,123.0,123.0
402980.0,6,4,508,2,238,0.0,172.0,119.0,2,270,0.0,135.0,135.0
153424.0,17,2,180,1,90,0.0,90.0,90.0,1,90,0.0,90.0,90.0
1171123.0,6,13,3010,8,2382,167303.2857142857,1514.0,297.75,5,628,223985.75,331.0,125.6
2796533.0,6,2,132,1,66,0.0,66.0,66.0,1,66,0.0,66.0,66.0
206228.0,6,3,426,2,280,0.0,214.0,140.0,1,146,0.0,146.0,146.0
122826.0,6,10,1065,5,534,30394.75,262.0,106.8,5,531,2193.5,259.0,106.2
118461833.0,6,236,26644,118,18560,1010655.9829059828,284.0,157.28813559322035,118,8084,1010656.2735042736,140.0,68.50847457627118
206260.0,6,3,426,2,280,0.0,214.0,140.0,1,146,0.0,146.0,146.0
298154.0,6,6,412,4,272,99384.66666666669,74.0,68.0,2,140,0.0,74.0,70.0
233357.0,6,3,373,2,238,0.0,172.0,119.0,1,135,0.0,135.0,135.0
141768.0,6,2,132,1,66,0.0,66.0,66.0,1,66,0.0,66.0,66.0
13619744.0,6,20,1607,10,975,1479245.2222222222,315.0,97.5,10,632,1479222.0,78.0,63.2
36843.0,6,14,4740,7,653,6016.0,249.0,93.28571428571428,7,4087,5946.5,1514.0,583.8571428571429
216594.0,6,3,426,2,280,0.0,214.0,140.0,1,146,0.0,146.0,146.0
10470414.0,6,6,412,3,206,5166874.0,74.0,68.66666666666667,3,206,5166762.0,74.0,68.66666666666667
405437.0,6,3,1604,2,851,0.0,785.0,425.5,1,753,0.0,753.0,753.0
948866.0,6,13,1394,7,797,158144.33333333334,253.0,113.85714285714286,6,597,187555.2,259.0,99.5
49322.0,6,14,4740,7,653,8022.333333333333,249.0,93.28571428571428,7,4087,7930.833333333333,1514.0,583.8571428571429
216388.0,17,2,180,1,90,0.0,90.0,90.0,1,90,0.0,90.0,90.0
8588261.0,17,3,1034,2,684,0.0,342.0,342.0,1,350,0.0,350.0,350.0
143887.0,17,2,180,1,90,0.0,90.0,90.0,1,90,0.0,90.0,90.0
546385.0,6,2,132,1,66,0.0,66.0,66.0,1,66,0.0,66.0,66.0
2066967.0,6,19,6869,11,1567,206696.7,408.0,142.45454545454547,8,5302,232852.4285714285,1514.0,662.75
65974.0,6,14,4740,7,653,10582.166666666666,249.0,93.28571428571428,7,4087,10141.833333333334,1514.0,583.8571428571429
135133862.0,17,6,1206,6,1206,27026772.4,201.0,201.0,0,0,0.0,0.0,0.0
31107.0,6,10,2032,5,524,7260.5,252.0,104.8,5,1508,7359.5,1236.0,301.6
726873.0,17,5,961,3,234,363256.0,78.0,78.0,2,727,0.0,395.0,363.5
32876460.0,6,5,336,2,134,0.0,68.0,67.0,3,202,15052710.5,70.0,67.33333333333333
309404.0,6,6,412,4,272,103134.66666666669,74.0,68.0,2,140,0.0,74.0,70.0
2400.0,17,4,344,2,150,0.0,75.0,75.0,2,194,0.0,103.0,97.0
105005224.0,6,44,2904,22,1452,5000248.761904762,66.0,66.0,22,1452,4985278.666666667,66.0,66.0
90261284.0,6,12,1832,8,1016,12894469.142857144,188.0,127.0,4,816,30031525.666666668,204.0,204.0
33435.0,6,14,4740,7,653,4656.833333333333,249.0,93.28571428571428,7,4087,5362.833333333333,1514.0,583.8571428571429
221902.0,17,4,6056,4,6056,73967.33333333333,1514.0,1514.0,0,0,0.0,0.0,0.0
146224.0,6,3,337,2,214,0.0,160.0,107.0,1,123,0.0,123.0,123.0
20576.0,6,10,2032,5,524,4913.5,252.0,104.8,5,1508,4328.25,1236.0,301.6
518610.0,6,3,1604,1,753,0.0,753.0,753.0,2,851,0.0,785.0,425.5
71027.0,6,14,4740,7,653,11705.5,249.0,93.28571428571428,7,4087,11257.333333333334,1514.0,583.8571428571429
24029.0,6,10,2032,5,524,5520.0,252.0,104.8,5,1508,5364.0,1236.0,301.6
113663431.0,6,37,2772,19,1455,6302643.5,123.0,76.57894736842105,18,1317,6673300.588235294,123.0,73.16666666666667
233767.0,6,3,373,2,238,0.0,172.0,119.0,1,135,0.0,135.0,135.0
103028.0,17,2,286,2,286,0.0,143.0,143.0,0,0,0.0,0.0,0.0
1306026.0,6,4,264,2,132,0.0,66.0,66.0,2,132,0.0,66.0,66.0
406126.0,6,3,1604,2,851,0.0,785.0,425.5,1,753,0.0,753.0,753.0
107193.0,17,2,286,2,286,0.0,143.0,143.0,0,0,0.0,0.0,0.0
2440.0,17,4,344,2,150,0.0,75.0,75.0,2,194,0.0,103.0,97.0
90493496.0,6,13,2036,8,1016,12927642.285714284,188.0,127.0,5,1020,22582359.0,204.0,204.0
14890.0,6,10,2032,5,524,3505.0,252.0,104.8,5,1508,3478.25,1236.0,301.6
29256.0,6,10,2032,5,524,6083.5,252.0,104.8,5,1508,6946.5,1236.0,301.6
90260569.0,6,12,1832,8,1016,12894367.0,188.0,127.0,4,816,30031519.33333333,204.0,204.0
73269.0,6,14,4740,7,653,9111.833333333334,249.0,93.28571428571428,7,4087,11437.333333333334,1514.0,583.8571428571429
90033824.0,17,27,12943,27,12943,3462839.3846153845,501.0,479.3703703703704,0,0,0.0,0.0,0.0
90016987.0,17,28,13364,28,13364,3333962.4814814813,501.0,477.2857142857143,0,0,0.0,0.0,0.0
108100527.0,17,5,955,5,955,27025131.75,191.0,191.0,0,0,0.0,0.0,0.0
2444.0,17,4,344,2,150,0.0,75.0,75.0,2,194,0.0,103.0,97.0
115049964.0,6,47,3102,24,1584,5002158.956521739,66.0,66.0,23,1518,5154361.727272728,66.0,66.0
90048581.0,17,28,13364,28,13364,3335132.6296296297,501.0,477.2857142857143,0,0,0.0,0.0,0.0
3157.0,17,4,344,2,150,0.0,75.0,75.0,2,194,0.0,103.0,97.0
4415.0,17,2,626,1,72,0.0,72.0,72.0,1,554,0.0,554.0,554.0
3000.0,17,2,180,1,90,0.0,90.0,90.0,1,90,0.0,90.0,90.0
121299.0,6,3,337,2,214,0.0,160.0,107.0,1,123,0.0,123.0,123.0
90260945.0,6,12,1832,8,1016,12894420.714285716,188.0,127.0,4,816,30031855.666666668,204.0,204.0
38684.0,6,10,2032,5,524,9409.25,252.0,104.8,5,1508,8425.5,1236.0,301.6
10970.0,17,4,823,2,163,0.0,89.0,81.5,2,660,0.0,443.0,330.0
58172.0,6,11,2098,6,590,10601.4,252.0,98.33333333333331,5,1508,4281.0,1236.0,301.6
444916.0,6,3,204,2,136,0.0,70.0,68.0,1,68,0.0,68.0,68.0
3658533.0,6,5,336,2,134,0.0,68.0,67.0,3,202,1423617.5,70.0,67.33333333333333
104610825.0,17,14,1126,7,563,17334188.333333332,174.0,80.42857142857143,7,563,17333485.666666668,174.0,80.42857142857143
98489373.0,6,44,3852,26,2190,3939574.92,123.0,84.23076923076923,18,1662,5781375.117647059,123.0,92.33333333333331
209517.0,17,2,180,1,90,0.0,90.0,90.0,1,90,0.0,90.0,90.0
7469016.0,6,18,1495,9,921,895734.5,315.0,102.33333333333331,9,574,834671.125,78.0,63.77777777777778
27706317.0,17,5,1710,5,1710,6926579.25,342.0,342.0,0,0,0.0,0.0,0.0
40322.0,6,14,4740,7,653,5472.166666666667,249.0,93.28571428571428,7,4087,6474.0,1514.0,583.8571428571429
43063.0,6,13,1394,7,797,7177.166666666667,253.0,113.85714285714286,6,597,7366.2,259.0,99.5
39814.0,6,10,2032,5,524,9360.5,252.0,104.8,5,1508,9635.5,1236.0,301.6
135131658.0,17,6,1206,6,1206,27026331.6,201.0,201.0,0,0,0.0,0.0,0.0
217797.0,6,3,426,2,280,0.0,214.0,140.0,1,146,0.0,146.0,146.0
49976.0,6,2,132,1,66,0.0,66.0,66.0,1,66,0.0,66.0,66.0
102173752.0,6,28,1860,14,966,7842685.769230769,123.0,69.0,14,894,7842696.076923077,123.0,63.85714285714285
2088.0,17,4,344,2,150,0.0,75.0,75.0,2,194,0.0,103.0,97.0
965.0,17,2,762,2,762,0.0,381.0,381.0,0,0,0.0,0.0,0.0
135135064.0,17,6,1146,6,1146,27027012.8,191.0,191.0,0,0,0.0,0.0,0.0
1184682.0,6,13,3010,8,2382,169240.2857142857,1514.0,297.75,5,628,227233.0,331.0,125.6
276656.0,6,12,1373,7,714,46109.333333333336,298.0,102.0,5,659,63512.25,379.0,131.8
112830762.0,6,32,2236,16,1165,7522050.8,139.0,72.8125,16,1071,7508377.0,123.0,66.9375
33890.0,6,14,4740,7,653,4371.5,249.0,93.28571428571428,7,4087,5242.666666666667,1514.0,583.8571428571429
117412656.0,6,48,3168,24,1584,5104898.0869565215,66.0,66.0,24,1584,5091441.173913044,66.0,66.0
302408.0,6,2,132,1,66,0.0,66.0,66.0,1,66,0.0,66.0,66.0
299305.0,6,6,412,4,272,99768.33333333331,74.0,68.0,2,140,0.0,74.0,70.0
284658.0,17,2,363,1,79,0.0,79.0,79.0,1,284,0.0,284.0,284.0
448.0,17,2,300,1,80,0.0,80.0,80.0,1,220,0.0,220.0,220.0
297829.0,17,2,180,1,90,0.0,90.0,90.0,1,90,0.0,90.0,90.0
125220024.0,6,32,2226,17,1209,7826251.5,123.0,71.11764705882354,15,1017,8215697.642857143,123.0,67.8
2331.0,17,4,344,2,150,0.0,75.0,75.0,2,194,0.0,103.0,97.0
135136918.0,17,6,1206,6,1206,27027383.6,201.0,201.0,0,0,0.0,0.0,0.0
3249162.0,6,193,162966,112,153318,29271.72972972973,1510.0,1368.9107142857142,81,9648,36747.025,1510.0,119.11111111111111
147014.0,6,3,373,2,238,0.0,172.0,119.0,1,135,0.0,135.0,135.0
90256549.0,6,12,1832,8,1016,12893792.714285716,188.0,127.0,4,816,30030177.33333333,204.0,204.0
120295484.0,6,19,1477,10,786,13333326.555555556,95.0,78.6,9,691,14977332.0,95.0,76.77777777777777
97918.0,17,2,286,2,286,0.0,143.0,143.0,0,0,0.0,0.0,0.0
111165834.0,6,219,24690,110,7482,1019870.0366972478,140.0,68.01818181818182,109,17208,1019667.2870370372,284.0,157.87155963302752
21636.0,6,11,2098,6,590,3970.6,252.0,98.33333333333331,5,1508,4720.5,1236.0,301.6
407.0,17,2,283,1,78,0.0,78.0,78.0,1,205,0.0,205.0,205.0
120031634.0,6,213,23934,107,7284,1132373.9056603771,140.0,68.07476635514018,106,16650,1133395.5238095238,284.0,157.0754716981132
323.0,17,2,174,1,79,0.0,79.0,79.0,1,95,0.0,95.0,95.0
359.0,17,2,160,1,80,0.0,80.0,80.0,1,80,0.0,80.0,80.0
29181.0,6,14,4740,7,653,4684.666666666667,249.0,93.28571428571428,7,4087,4731.166666666667,1514.0,583.8571428571429
60850.0,6,14,4740,7,653,10024.0,249.0,93.28571428571428,7,4087,8967.5,1514.0,583.8571428571429
147562.0,6,3,373,2,238,0.0,172.0,119.0,1,135,0.0,135.0,135.0
17404.0,6,11,2098,6,590,3267.0,252.0,98.33333333333331,5,1508,3088.25,1236.0,301.6
146196.0,6,3,337,2,214,0.0,160.0,107.0,1,123,0.0,123.0,123.0
48852.0,6,14,4740,7,653,8018.5,249.0,93.28571428571428,7,4087,7854.0,1514.0,583.8571428571429
149.0,17,2,158,2,158,0.0,79.0,79.0,0,0,0.0,0.0,0.0
10487483.0,6,7,478,4,272,3450491.333333333,74.0,68.0,3,206,5175634.5,74.0,68.66666666666667
140912.0,6,2,132,1,66,0.0,66.0,66.0,1,66,0.0,66.0,66.0
143961.0,17,2,180,1,90,0.0,90.0,90.0,1,90,0.0,90.0,90.0
27052364.0,17,5,1710,5,1710,6763091.0,342.0,342.0,0,0,0.0,0.0,0.0
33364.0,6,10,2032,5,524,7713.25,252.0,104.8,5,1508,7541.75,1236.0,301.6
91507266.0,17,12,778,6,389,18201100.0,174.0,64.83333333333333,6,389,18200200.6,174.0,64.83333333333333
135129233.0,17,6,1146,6,1146,27025846.6,191.0,191.0,0,0,0.0,0.0,0.0
95191563.0,17,12,778,6,389,19000809.6,174.0,64.83333333333333,6,389,19000184.4,174.0,64.83333333333333
108102835.0,17,5,1005,5,1005,27025708.75,201.0,201.0,0,0,0.0,0.0,0.0
39740.0,6,13,1386,7,789,6492.833333333333,253.0,112.71428571428572,6,597,7238.8,259.0,99.5
91279553.0,17,14,1126,7,563,15169453.5,174.0,80.42857142857143,7,563,15166802.166666666,174.0,80.42857142857143
217278.0,17,2,180,1,90,0.0,90.0,90.0,1,90,0.0,90.0,90.0
90292299.0,6,13,2036,8,1016,12898899.857142856,188.0,127.0,5,1020,22524375.5,204.0,204.0
862058.0,6,9,1196,6,725,172411.6,387.0,120.83333333333331,3,471,294683.5,331.0,157.0
5006702.0,17,4,629,2,156,0.0,78.0,78.0,2,473,0.0,268.0,236.5
108858.0,17,2,286,2,286,0.0,143.0,143.0,0,0,0.0,0.0,0.0
108103900.0,17,5,955,5,955,27025975.0,191.0,191.0,0,0,0.0,0.0,0.0
313922.0,6,6,412,4,272,104640.66666666669,74.0,68.0,2,140,0.0,74.0,70.0
92742803.0,6,317,39994,159,29344,586979.7658227849,464.0,184.5534591194969,158,10650,584197.4968152866,140.0,67.40506329113924
2800111.0,6,2,132,1,66,0.0,66.0,66.0,1,66,0.0,66.0,66.0
204428.0,17,2,762,2,762,0.0,381.0,381.0,0,0,0.0,0.0,0.0
9124.0,17,2,498,1,80,0.0,80.0,80.0,1,418,0.0,418.0,418.0
27378.0,6,14,4740,7,653,3922.3333333333335,249.0,93.28571428571428,7,4087,4374.333333333333,1514.0,583.8571428571429
48617.0,6,14,4740,7,653,5608.833333333333,249.0,93.28571428571428,7,4087,7915.5,1514.0,583.8571428571429
215972.0,6,10,1221,6,636,43194.4,298.0,106.0,4,585,70959.33333333333,379.0,146.25
108103043.0,17,5,1005,5,1005,27025760.75,201.0,201.0,0,0,0.0,0.0,0.0
37755.0,6,13,1479,7,882,6110.0,291.0,126.0,6,597,6575.8,259.0,99.5
57475.0,6,14,4740,7,653,9195.166666666666,249.0,93.28571428571428,7,4087,8862.5,1514.0,583.8571428571429
13189.0,6,10,1065,5,534,3078.0,262.0,106.8,5,531,2980.0,259.0,106.2
46461.0,6,14,4740,7,653,7515.0,249.0,93.28571428571428,7,4087,7604.166666666667,1514.0,583.8571428571429
307183.0,6,6,412,4,272,102394.33333333331,74.0,68.0,2,140,0.0,74.0,70.0
234156.0,6,3,337,2,214,0.0,160.0,107.0,1,123,0.0,123.0,123.0
153364.0,17,2,180,1,90,0.0,90.0,90.0,1,90,0.0,90.0,90.0
167829.0,17,4,704,2,148,0.0,74.0,74.0,2,556,0.0,280.0,278.0
146758.0,6,3,337,2,214,0.0,160.0,107.0,1,123,0.0,123.0,123.0
205927.0,17,2,180,1,90,0.0,90.0,90.0,1,90,0.0,90.0,90.0
135123819.0,17,6,1146,6,1146,27024763.8,191.0,191.0,0,0,0.0,0.0,0.0
41460.0,6,14,4740,7,653,5903.666666666667,249.0,93.28571428571428,7,4087,5775.666666666667,1514.0,583.8571428571429
90255472.0,6,14,2240,8,1016,12893638.857142856,188.0,127.0,6,1224,18017847.4,204.0,204.0
91665049.0,6,23,1775,13,1030,7634486.083333333,95.0,79.23076923076923,10,745,10151824.0,95.0,74.5
333703.0,6,6,412,4,272,111234.33333333331,74.0,68.0,2,140,0.0,74.0,70.0
212540.0,6,10,1221,6,636,42508.0,298.0,106.0,4,585,69690.0,379.0,146.25
37772.0,6,14,4740,7,653,5462.166666666667,249.0,93.28571428571428,7,4087,5936.0,1514.0,583.8571428571429
324.0,17,2,174,1,79,0.0,79.0,79.0,1,95,0.0,95.0,95.0
302.0,17,2,168,1,76,0.0,76.0,76.0,1,92,0.0,92.0,92.0
123253628.0,6,48,3168,25,1650,5135567.833333333,66.0,66.0,23,1518,5135440.863636363,66.0,66.0
90020315.0,6,21,1585,10,745,10002257.222222222,95.0,74.5,11,840,8974752.1,95.0,76.36363636363636
320.0,17,2,174,1,79,0.0,79.0,79.0,1,95,0.0,95.0,95.0
1017430.0,6,12,1362,6,731,202691.4,253.0,121.83333333333331,6,631,202278.4,293.0,105.16666666666669
2021787.0,17,4,525,2,150,0.0,75.0,75.0,2,375,0.0,284.0,187.5
34939.0,6,14,4740,7,653,5704.333333333333,249.0,93.28571428571428,7,4087,5393.0,1514.0,583.8571428571429
93508314.0,6,40,2640,20,1320,4921490.210526316,66.0,66.0,20,1320,4905204.210526316,66.0,66.0
232093.0,17,4,6056,4,6056,77364.33333333333,1514.0,1514.0,0,0,0.0,0.0,0.0
3471.0,17,4,407,2,144,0.0,72.0,72.0,2,263,0.0,136.0,131.5
2598699.0,6,2,132,1,66,0.0,66.0,66.0,1,66,0.0,66.0,66.0
502178.0,6,5,336,2,134,0.0,68.0,67.0,3,202,192069.5,70.0,67.33333333333333
233005.0,6,3,337,2,214,0.0,160.0,107.0,1,123,0.0,123.0,123.0
120065936.0,6,20,1531,11,840,12006593.6,95.0,76.36363636363636,9,691,11346501.875,95.0,76.77777777777777
2252510.0,6,20,6935,11,1567,225251.0,408.0,142.45454545454547,9,5368,238851.75,1514.0,596.4444444444445
112209230.0,6,213,23934,107,7284,1058577.641509434,140.0,68.07476635514018,106,16650,1058640.6952380952,284.0,157.0754716981132
114622842.0,6,48,3168,24,1584,4983601.826086956,66.0,66.0,24,1584,4969447.739130435,66.0,66.0
217820.0,17,2,180,1,90,0.0,90.0,90.0,1,90,0.0,90.0,90.0
112147747.0,6,31,2166,16,1149,7462130.333333333,123.0,71.8125,15,1017,7995136.0,123.0,67.8
32307.000000000004,6,14,4740,7,653,4848.166666666667,249.0,93.28571428571428,7,4087,5086.666666666667,1514.0,583.8571428571429
90253317.0,6,14,2102,8,1016,12893331.0,188.0,127.0,6,1086,18018255.4,204.0,181.0
305842.0,6,6,412,4,272,101947.33333333331,74.0,68.0,2,140,0.0,74.0,70.0
11533.0,6,11,2098,6,590,1995.8,252.0,98.33333333333331,5,1508,2013.0,1236.0,301.6
106651572.0,6,39,3294,22,1824,5078646.285714285,123.0,82.9090909090909,17,1470,6652910.375,123.0,86.47058823529412
126109.0,6,2,132,1,66,0.0,66.0,66.0,1,66,0.0,66.0,66.0
513595.0,6,10,1221,6,636,102719.0,298.0,106.0,4,585,165709.0,379.0,146.25
20438.0,6,14,4740,7,653,2711.6666666666665,249.0,93.28571428571428,7,4087,3269.6666666666665,1514.0,583.8571428571429
30324.0,6,14,4740,7,653,4124.833333333333,249.0,93.28571428571428,7,4087,4843.333333333333,1514.0,583.8571428571429
121006293.0,17,15,907,8,475,17286613.285714287,174.0,59.375,7,432,16859503.333333332,174.0,61.71428571428572
5808306.0,6,5,336,2,134,0.0,68.0,67.0,3,202,1520997.0,70.0,67.33333333333333
100603.0,17,2,762,2,762,0.0,381.0,381.0,0,0,0.0,0.0,0.0
348.0,17,2,160,1,80,0.0,80.0,80.0,1,80,0.0,80.0,80.0
103200308.0,6,42,2772,21,1386,5160002.25,66.0,66.0,21,1386,5160001.7,66.0,66.0
120000077.0,6,17,1287,9,691,15000009.625,95.0,76.77777777777777,8,596,12897295.0,95.0,74.5
143953.0,17,2,180,1,90,0.0,90.0,90.0,1,90,0.0,90.0,90.0
122402.0,6,3,373,2,238,0.0,172.0,119.0,1,135,0.0,135.0,135.0
90216612.0,6,16,1192,8,596,12852765.285714284,95.0,74.5,8,596,12857309.142857144,95.0,74.5
95101454.0,17,12,778,6,389,19000446.6,174.0,64.83333333333333,6,389,19000221.2,174.0,64.83333333333333
241706.0,6,3,373,2,238,0.0,172.0,119.0,1,135,0.0,135.0,135.0
16079146.000000002,6,26,7627,14,3735,197329.15384615384,1514.0,266.7857142857143,12,3892,1442170.0909090908,1514.0,324.3333333333333
48175.0,6,14,4740,7,653,7673.0,249.0,93.28571428571428,7,4087,7639.666666666667,1514.0,583.8571428571429
23596.0,6,14,4740,7,653,3294.6666666666665,249.0,93.28571428571428,7,4087,3760.6666666666665,1514.0,583.8571428571429
102708665.0,6,41,2706,21,1386,5135433.25,66.0,66.0,20,1320,5245112.894736842,66.0,66.0
330.0,17,2,166,1,75,0.0,75.0,75.0,1,91,0.0,91.0,91.0
324.0,17,2,174,1,79,0.0,79.0,79.0,1,95,0.0,95.0,95.0
169285.0,17,2,180,1,90,0.0,90.0,90.0,1,90,0.0,90.0,90.0
104075.0,17,2,286,2,286,0.0,143.0,143.0,0,0,0.0,0.0,0.0
120122646.0,6,17,2344,9,1284,15015330.75,204.0,142.66666666666666,8,1060,12868675.714285716,199.0,132.5
120056582.0,17,28,13364,28,13364,4446540.074074074,501.0,477.2857142857143,0,0,0.0,0.0,0.0
207885.0,6,3,426,2,280,0.0,214.0,140.0,1,146,0.0,146.0,146.0
869296.0,6,9,1096,6,625,173859.2,287.0,104.16666666666669,3,471,296904.0,331.0,157.0
204360.0,17,2,762,2,762,0.0,381.0,381.0,0,0,0.0,0.0,0.0
211447.0,6,10,1221,6,636,42289.4,298.0,106.0,4,585,69477.66666666667,379.0,146.25
862292.0,6,9,1270,6,799,172458.4,461.0,133.16666666666666,3,471,293213.5,331.0,157.0
10519211.0,6,7,478,4,272,3461097.333333333,74.0,68.0,3,206,5191531.5,74.0,68.66666666666667
119895.0,17,2,180,1,70,0.0,70.0,70.0,1,110,0.0,110.0,110.0
108090478.0,17,5,955,5,955,27022619.5,191.0,191.0,0,0,0.0,0.0,0.0
113144995.0,6,38,2710,19,1408,6273841.833333333,139.0,74.10526315789474,19,1302,6273838.277777778,123.0,68.52631578947368
47126.0,6,14,4740,7,653,7733.666666666667,249.0,93.28571428571428,7,4087,7119.833333333333,1514.0,583.8571428571429
18169.0,6,14,4740,7,653,2498.1666666666665,249.0,93.28571428571428,7,4087,2802.6666666666665,1514.0,583.8571428571429
309540.0,17,2,246,1,76,0.0,76.0,76.0,1,170,0.0,170.0,170.0
18852.0,6,10,1065,5,534,4532.25,262.0,106.8,5,531,2315.0,259.0,106.2
10455823.0,6,6,412,3,206,5159549.0,74.0,68.66666666666667,3,206,5159428.0,74.0,68.66666666666667
313548.0,17,4,1400,4,1400,104516.0,350.0,350.0,0,0,0.0,0.0,0.0
101231938.0,6,170,19206,85,13374,1202580.5357142857,284.0,157.34117647058824,85,5832,1202580.6904761903,140.0,68.61176470588235
103448527.0,6,41,3424,23,1900,4692392.363636363,139.0,82.6086956521739,18,1524,6072507.176470588,123.0,84.66666666666667
306506.0,6,6,412,4,272,102168.66666666669,74.0,68.0,2,140,0.0,74.0,70.0
101526005.0,17,14,1126,7,563,16921000.833333332,174.0,80.42857142857143,7,563,16837818.666666668,174.0,80.42857142857143
32680.0,6,10,2032,5,524,7835.75,252.0,104.8,5,1508,7480.25,1236.0,301.6
305.0,17,2,156,1,78,0.0,78.0,78.0,1,78,0.0,78.0,78.0
148761.0,17,2,414,1,88,0.0,88.0,88.0,1,326,0.0,326.0,326.0
101625422.0,17,14,864,7,432,16835026.166666668,174.0,61.71428571428572,7,432,16833519.833333332,174.0,61.71428571428572
120120422.0,6,12,1832,8,1016,17137249.714285713,188.0,127.0,4,816,30031313.0,204.0,204.0
43475.0,6,14,4740,7,653,6157.5,249.0,93.28571428571428,7,4087,6577.666666666667,1514.0,583.8571428571429
1303126.0,6,4,264,2,132,0.0,66.0,66.0,2,132,0.0,66.0,66.0
38494.0,6,10,2032,5,524,9387.0,252.0,104.8,5,1508,8122.5,1236.0,301.6
5619839.0,6,4,270,2,134,0.0,68.0,67.0,2,136,0.0,70.0,68.0
104589.0,17,2,700,2,700,0.0,350.0,350.0,0,0,0.0,0.0,0.0
213608.0,17,2,180,1,90,0.0,90.0,90.0,1,90,0.0,90.0,90.0
1306936.0,6,4,264,2,132,0.0,66.0,66.0,2,132,0.0,66.0,66.0
120000293.0,6,16,1192,8,596,17142899.0,95.0,74.5,8,596,17105652.57142857,95.0,74.5
115616317.0,6,766,100700,383,25500,302596.4973821989,140.0,66.57963446475196,383,75200,302602.1963350785,426.0,196.34464751958225
90095007.0,6,12,1848,5,1020,22522581.0,204.0,204.0,7,828,14969908.333333334,188.0,118.28571428571428
118570198.0,6,222,25180,111,17558,1075953.5454545454,284.0,158.18018018018017,111,7622,1075953.4181818182,140.0,68.66666666666667
232125.0,6,3,337,2,214,0.0,160.0,107.0,1,123,0.0,123.0,123.0
24676.0,6,11,1133,6,602,4688.8,264.0,100.33333333333331,5,531,5121.25,259.0,106.2
208823.0,6,3,426,2,280,0.0,214.0,140.0,1,146,0.0,146.0,146.0
2262.0,17,4,344,2,150,0.0,75.0,75.0,2,194,0.0,103.0,97.0
118908424.0,6,34,2350,17,1225,7431776.5,139.0,72.05882352941177,17,1125,7418243.625,123.0,66.17647058823529
10462255.0,6,6,412,3,206,5162544.5,74.0,68.66666666666667,3,206,5162361.5,74.0,68.66666666666667
105835906.0,6,28,1860,14,966,8125423.923076923,123.0,69.0,14,894,8125484.461538462,123.0,63.85714285714285
2591991.0,6,2,132,1,66,0.0,66.0,66.0,1,66,0.0,66.0,66.0
234840.0,6,3,373,2,238,0.0,172.0,119.0,1,135,0.0,135.0,135.0
108116304.0,17,5,1005,5,1005,27029076.0,201.0,201.0,0,0,0.0,0.0,0.0
121241.0,6,3,337,2,214,0.0,160.0,107.0,1,123,0.0,123.0,123.0
241126.0,6,3,373,2,238,0.0,172.0,119.0,1,135,0.0,135.0,135.0
90022226.0,17,28,13364,28,13364,3334156.5185185187,501.0,477.2857142857143,0,0,0.0,0.0,0.0
356.0,17,2,248,1,84,0.0,84.0,84.0,1,164,0.0,164.0,164.0
2045.0,17,4,344,2,150,0.0,75.0,75.0,2,194,0.0,103.0,97.0
209490.0,17,2,180,1,90,0.0,90.0,90.0,1,90,0.0,90.0,90.0
179755.0,17,2,180,1,90,0.0,90.0,90.0,1,90,0.0,90.0,90.0
305462.0,6,6,412,4,272,101820.66666666669,74.0,68.0,2,140,0.0,74.0,70.0
315731.0,17,4,1400,4,1400,105243.66666666669,350.0,350.0,0,0,0.0,0.0,0.0
2586853.0,6,2,132,1,66,0.0,66.0,66.0,1,66,0.0,66.0,66.0
135132715.0,17,6,1146,6,1146,27026543.0,191.0,191.0,0,0,0.0,0.0,0.0
47609825.0,6,8,1938,3,886,22627247.5,752.0,295.3333333333333,5,1052,11206894.75,784.0,210.4
90021607.0,17,28,13364,28,13364,3334133.592592593,501.0,477.2857142857143,0,0,0.0,0.0,0.0
118474103.0,6,222,24978,111,17430,1075081.3454545457,284.0,157.02702702702703,111,7548,1075081.0636363635,140.0,68.0
292443.0,17,2,180,1,90,0.0,90.0,90.0,1,90,0.0,90.0,90.0
44585.0,6,10,2032,5,524,10913.5,252.0,104.8,5,1508,9718.25,1236.0,301.6
358.0,17,2,248,1,84,0.0,84.0,84.0,1,164,0.0,164.0,164.0
1733473.0,6,20,7599,11,1469,173347.3,583.0,133.54545454545453,9,6130,184096.0,1484.0,681.1111111111111
207079.0,6,3,426,2,280,0.0,214.0,140.0,1,146,0.0,146.0,146.0
10483642.0,6,6,412,3,206,5173507.5,74.0,68.66666666666667,3,206,5173393.5,74.0,68.66666666666667
43808.0,6,10,2032,5,524,10437.75,252.0,104.8,5,1508,8844.75,1236.0,301.6
228355.0,17,2,180,1,90,0.0,90.0,90.0,1,90,0.0,90.0,90.0
149.0,17,2,158,2,158,0.0,79.0,79.0,0,0,0.0,0.0,0.0
59446.0,6,14,4740,7,653,8098.0,249.0,93.28571428571428,7,4087,8873.166666666666,1514.0,583.8571428571429
205780.0,17,2,180,1,90,0.0,90.0,90.0,1,90,0.0,90.0,90.0
26551.0,6,14,4740,7,653,4260.166666666667,249.0,93.28571428571428,7,4087,4142.166666666667,1514.0,583.8571428571429
113948477.0,6,37,2788,19,1471,6318480.777777778,139.0,77.42105263157895,18,1317,6690162.647058823,123.0,73.16666666666667
147949.0,17,2,180,1,90,0.0,90.0,90.0,1,90,0.0,90.0,90.0
90109922.0,6,13,2052,6,1224,18021419.6,204.0,204.0,7,828,15017942.166666666,188.0,118.28571428571428
202435.0,17,4,6056,4,6056,67478.33333333333,1514.0,1514.0,0,0,0.0,0.0,0.0
90032185.0,17,27,12943,27,12943,3462776.346153846,501.0,479.3703703703704,0,0,0.0,0.0,0.0
193031.0,17,2,180,1,90,0.0,90.0,90.0,1,90,0.0,90.0,90.0
35848.0,6,14,4740,7,653,5849.5,249.0,93.28571428571428,7,4087,5591.5,1514.0,583.8571428571429
420.0,17,2,762,2,762,0.0,381.0,381.0,0,0,0.0,0.0,0.0
323106.0,17,4,1400,4,1400,107702.0,350.0,350.0,0,0,0.0,0.0,0.0
2416.0,17,4,344,2,150,0.0,75.0,75.0,2,194,0.0,103.0,97.0
233515.0,6,3,337,2,214,0.0,160.0,107.0,1,123,0.0,123.0,123.0
238842.0,17,2,180,1,90,0.0,90.0,90.0,1,90,0.0,90.0,90.0
103059.0,17,2,286,2,286,0.0,143.0,143.0,0,0,0.0,0.0,0.0
116272974.0,6,47,3102,24,1584,5055332.739130435,66.0,66.0,23,1518,5144004.363636363,66.0,66.0
216862.0,6,3,426,2,280,0.0,214.0,140.0,1,146,0.0,146.0,146.0
2326.0,17,4,344,2,150,0.0,75.0,75.0,2,194,0.0,103.0,97.0
26800362.0,17,5,1718,4,1368,975715.3333333334,342.0,342.0,1,350,0.0,350.0,350.0
120128264.0,6,15,2152,9,1204,15016033.0,188.0,133.77777777777777,6,948,18019082.8,204.0,158.0
112573.0,17,4,1400,4,1400,37524.333333333336,350.0,350.0,0,0,0.0,0.0,0.0
4432.0,17,2,614,1,72,0.0,72.0,72.0,1,542,0.0,542.0,542.0
234354.0,6,3,337,2,214,0.0,160.0,107.0,1,123,0.0,123.0,123.0
120412240.0,6,219,24802,110,17312,1104699.4495412845,284.0,157.38181818181818,109,7490,1105067.638888889,140.0,68.71559633027523
153447.0,17,2,180,1,90,0.0,90.0,90.0,1,90,0.0,90.0,90.0
308962.0,6,6,412,4,272,102987.33333333331,74.0,68.0,2,140,0.0,74.0,70.0
204407.0,17,2,762,2,762,0.0,381.0,381.0,0,0,0.0,0.0,0.0
2386.0,17,4,344,2,150,0.0,75.0,75.0,2,194,0.0,103.0,97.0
1675.0,17,5,550,5,550,418.75,110.0,110.0,0,0,0.0,0.0,0.0
398.0,17,2,341,1,86,0.0,86.0,86.0,1,255,0.0,255.0,255.0
2356.0,17,4,344,2,150,0.0,75.0,75.0,2,194,0.0,103.0,97.0
123455756.0,6,48,3168,24,1584,4942745.478260869,66.0,66.0,24,1584,5325085.260869565,66.0,66.0
38478.0,6,14,4740,7,653,6028.0,249.0,93.28571428571428,7,4087,6092.166666666667,1514.0,583.8571428571429
2590205.0,6,2,132,1,66,0.0,66.0,66.0,1,66,0.0,66.0,66.0
4323.0,17,2,598,1,72,0.0,72.0,72.0,1,526,0.0,526.0,526.0
600650.0,17,3,551,2,156,0.0,78.0,78.0,1,395,0.0,395.0,395.0
204756.0,17,2,762,2,762,0.0,381.0,381.0,0,0,0.0,0.0,0.0
203285.0,6,10,1221,6,636,40657.0,298.0,106.0,4,585,66523.0,379.0,146.25
16876.0,17,2,180,1,90,0.0,90.0,90.0,1,90,0.0,90.0,90.0
110298580.0,6,727,116384,363,24266,304687.6215469613,214.0,66.84848484848484,364,92118,303488.2314049587,1514.0,253.07142857142856
59085.0,6,14,4740,7,653,9402.333333333334,249.0,93.28571428571428,7,4087,9547.166666666666,1514.0,583.8571428571429
135140398.0,17,6,1206,6,1206,27028079.6,201.0,201.0,0,0,0.0,0.0,0.0
18898.0,6,10,2032,5,524,4535.5,252.0,104.8,5,1508,3957.25,1236.0,301.6
314559.0,6,6,412,4,272,104853.0,74.0,68.0,2,140,0.0,74.0,70.0
166834.0,17,2,180,1,90,0.0,90.0,90.0,1,90,0.0,90.0,90.0
5006545.0,17,4,629,2,156,0.0,78.0,78.0,2,473,0.0,268.0,236.5
115617620.0,6,47,3102,24,1584,5014886.347826087,66.0,66.0,23,1518,5135444.636363637,66.0,66.0
31313.0,6,14,4740,7,653,5098.5,249.0,93.28571428571428,7,4087,4932.166666666667,1514.0,583.8571428571429
108098336.0,17,5,1005,5,1005,27024584.0,201.0,201.0,0,0,0.0,0.0,0.0
111021095.0,6,30,1990,15,1042,7914656.714285715,139.0,69.46666666666667,15,948,7914671.5,123.0,63.2
103351832.0,17,14,1126,7,563,17167511.666666668,174.0,80.42857142857143,7,563,17166828.333333332,174.0,80.42857142857143
34081.0,6,14,4740,7,653,5109.333333333333,249.0,93.28571428571428,7,4087,5198.833333333333,1514.0,583.8571428571429
519371.0,17,6,2100,6,2100,103874.2,350.0,350.0,0,0,0.0,0.0,0.0
19662.0,6,14,4740,7,653,3164.0,249.0,93.28571428571428,7,4087,3150.1666666666665,1514.0,583.8571428571429
108114476.0,17,5,1005,5,1005,27028619.0,201.0,201.0,0,0,0.0,0.0,0.0
38531.0,6,10,2032,5,524,9412.0,252.0,104.8,5,1508,8347.5,1236.0,301.6
204989.0,17,3,1143,3,1143,102494.5,381.0,381.0,0,0,0.0,0.0,0.0
115845261.0,6,48,3168,24,1584,5036750.478260869,66.0,66.0,24,1584,5024767.565217392,66.0,66.0
2349.0,17,4,344,2,150,0.0,75.0,75.0,2,194,0.0,103.0,97.0
258801.0,6,10,1221,6,636,51760.2,298.0,106.0,4,585,80601.0,379.0,146.25
305.0,17,2,156,1,78,0.0,78.0,78.0,1,78,0.0,78.0,78.0
228321.0,17,2,180,1,90,0.0,90.0,90.0,1,90,0.0,90.0,90.0
42806.0,6,14,4740,7,653,6010.166666666667,249.0,93.28571428571428,7,4087,6735.666666666667,1514.0,583.8571428571429
46611.0,6,14,4740,7,653,6925.333333333333,249.0,93.28571428571428,7,4087,7621.5,1514.0,583.8571428571429
93881489.0,6,189,21270,95,6492,998739.2446808512,140.0,68.33684210526316,94,14778,998443.8279569892,284.0,157.2127659574468
429801.0,6,3,204,1,68,0.0,68.0,68.0,2,136,0.0,70.0,68.0
152150.0,17,2,414,1,88,0.0,88.0,88.0,1,326,0.0,326.0,326.0
107241.0,17,2,286,2,286,0.0,143.0,143.0,0,0,0.0,0.0,0.0
536307.0,6,5,336,2,134,0.0,68.0,67.0,3,202,214138.5,70.0,67.33333333333333
41835.0,6,14,4740,7,653,6846.333333333333,249.0,93.28571428571428,7,4087,6579.666666666667,1514.0,583.8571428571429
68106.0,6,14,4740,7,653,11150.0,249.0,93.28571428571428,7,4087,11147.833333333334,1514.0,583.8571428571429
25013.0,6,10,2032,5,524,5819.75,252.0,104.8,5,1508,5871.25,1236.0,301.6
405590.0,6,3,204,1,68,0.0,68.0,68.0,2,136,0.0,70.0,68.0
122432.0,6,3,373,2,238,0.0,172.0,119.0,1,135,0.0,135.0,135.0
9185.0,6,10,1066,5,490,2043.75,218.0,98.0,5,576,2087.0,304.0,115.2
90027378.0,17,28,13364,28,13364,3334347.333333333,501.0,477.2857142857143,0,0,0.0,0.0,0.0
0.0,6,1,66,1,66,0.0,66.0,66.0,0,0,0.0,0.0,0.0
319933.0,6,6,412,4,272,106644.33333333331,74.0,68.0,2,140,0.0,74.0,70.0
251549.00000000003,6,3,337,2,214,0.0,160.0,107.0,1,123,0.0,123.0,123.0
302871.0,6,12,1373,7,714,50478.5,298.0,102.0,5,659,69922.5,379.0,131.8
106350.0,17,2,286,2,286,0.0,143.0,143.0,0,0,0.0,0.0,0.0
31114.0,6,11,1133,6,602,5995.8,264.0,100.33333333333331,5,531,5661.5,259.0,106.2
92017074.0,6,30,2254,15,1086,6572648.142857143,123.0,72.4,15,1168,6007801.071428572,139.0,77.86666666666666
332060.0,6,3,202,2,128,0.0,74.0,64.0,1,74,0.0,74.0,74.0
206272.0,6,3,426,2,280,0.0,214.0,140.0,1,146,0.0,146.0,146.0
47771.0,6,14,4740,7,653,7800.166666666667,249.0,93.28571428571428,7,4087,6234.166666666667,1514.0,583.8571428571429
0.0,17,1,55,1,55,0.0,55.0,55.0,0,0,0.0,0.0,0.0
313414.0,17,4,1400,4,1400,104471.33333333331,350.0,350.0,0,0,0.0,0.0,0.0
10528701.0,6,7,478,4,272,3464254.333333333,74.0,68.0,3,206,5196253.0,74.0,68.66666666666667
90054655.0,17,27,12943,27,12943,3463640.576923077,501.0,479.3703703703704,0,0,0.0,0.0,0.0
3154778.0,6,5,336,2,134,0.0,68.0,67.0,3,202,1526334.0,70.0,67.33333333333333
36923.0,6,14,4740,7,653,5369.166666666667,249.0,93.28571428571428,7,4087,5979.166666666667,1514.0,583.8571428571429
103337.0,17,2,286,2,286,0.0,143.0,143.0,0,0,0.0,0.0,0.0
307844.0,6,6,412,4,272,102614.66666666669,74.0,68.0,2,140,0.0,74.0,70.0
323780.0,17,4,1400,4,1400,107926.66666666669,350.0,350.0,0,0,0.0,0.0,0.0
90011229.0,17,28,13364,28,13364,3333749.222222222,501.0,477.2857142857143,0,0,0.0,0.0,0.0
40938.0,17,2,684,2,684,0.0,342.0,342.0,0,0,0.0,0.0,0.0
7732.0,17,4,344,2,150,0.0,75.0,75.0,2,194,0.0,103.0,97.0
16336.0,6,20,7606,11,978,1633.6,310.0,88.9090909090909,9,6628,1824.625,1514.0,736.4444444444445
201738.0,17,2,180,1,90,0.0,90.0,90.0,1,90,0.0,90.0,90.0
359467.0,6,6,412,4,272,119822.33333333331,74.0,68.0,2,140,0.0,74.0,70.0
828.0,17,5,550,5,550,207.0,110.0,110.0,0,0,0.0,0.0,0.0
1622.0,17,2,192,1,88,0.0,88.0,88.0,1,104,0.0,104.0,104.0
20761.0,6,14,4740,7,653,3339.333333333333,249.0,93.28571428571428,7,4087,3113.1666666666665,1514.0,583.8571428571429
135156549.0,17,6,1146,6,1146,27031309.8,191.0,191.0,0,0,0.0,0.0,0.0
307718.0,6,6,412,4,272,102572.66666666669,74.0,68.0,2,140,0.0,74.0,70.0
217173.0,6,10,1221,6,636,43434.6,298.0,106.0,4,585,71527.66666666667,379.0,146.25
228216.0,17,2,180,1,90,0.0,90.0,90.0,1,90,0.0,90.0,90.0
108108019.0,17,5,1005,5,1005,27027004.75,201.0,201.0,0,0,0.0,0.0,0.0
35416.0,6,10,2032,5,524,7845.75,252.0,104.8,5,1508,7811.75,1236.0,301.6
5628695.0,6,5,336,3,202,1423680.5,70.0,67.33333333333333,2,134,0.0,68.0,67.0
90287869.0,6,16,1192,8,596,12891690.0,95.0,74.5,8,596,12897677.857142856,95.0,74.5
308600.0,6,6,412,4,272,102866.66666666669,74.0,68.0,2,140,0.0,74.0,70.0
302371.0,6,2,132,1,66,0.0,66.0,66.0,1,66,0.0,66.0,66.0
100549561.0,6,29,2068,15,1105,7166670.5,139.0,73.66666666666667,14,963,7717952.615384615,123.0,68.78571428571429
2040703.0,6,25,7611,13,2516,170058.58333333334,1034.0,193.53846153846155,12,5095,157807.18181818182,1510.0,424.5833333333333
10487333.0,6,6,412,3,206,5173017.0,74.0,68.66666666666667,3,206,5172910.5,74.0,68.66666666666667
8975.0,17,2,539,1,86,0.0,86.0,86.0,1,453,0.0,453.0,453.0
290232.0,17,2,224,1,76,0.0,76.0,76.0,1,148,0.0,148.0,148.0
90255798.0,6,13,2036,8,1016,12893685.42857143,188.0,127.0,5,1020,22523174.25,204.0,204.0
112464242.0,6,46,3036,23,1518,5111999.409090909,66.0,66.0,23,1518,5111998.7727272725,66.0,66.0
2801429.0,6,2,132,1,66,0.0,66.0,66.0,1,66,0.0,66.0,66.0
14109.0,17,4,629,3,234,1033.5,78.0,78.0,1,395,0.0,395.0,395.0
289.0,17,2,168,1,76,0.0,76.0,76.0,1,92,0.0,92.0,92.0
317098.0,17,4,1400,4,1400,105699.33333333331,350.0,350.0,0,0,0.0,0.0,0.0
108356012.0,6,280,32856,140,23394,777984.071942446,284.0,167.1,140,9462,777988.2517985612,140.0,67.58571428571429
205729.0,17,2,762,2,762,0.0,381.0,381.0,0,0,0.0,0.0,0.0
135137760.0,17,6,1146,6,1146,27027552.0,191.0,191.0,0,0,0.0,0.0,0.0
0.0,17,1,179,1,179,0.0,179.0,179.0,0,0,0.0,0.0,0.0
50203.0,6,10,2032,5,524,12308.5,252.0,104.8,5,1508,10307.0,1236.0,301.6
34497.0,6,14,4740,7,653,5629.333333333333,249.0,93.28571428571428,7,4087,5394.0,1514.0,583.8571428571429
135130228.0,17,6,1146,6,1146,27026045.6,191.0,191.0,0,0,0.0,0.0,0.0
1307014.0,6,4,264,2,132,0.0,66.0,66.0,2,132,0.0,66.0,66.0
43095.0,6,13,1479,7,882,7182.5,291.0,126.0,6,597,6714.4,259.0,99.5
198801.0,17,2,180,1,90,0.0,90.0,90.0,1,90,0.0,90.0,90.0
135133916.0,17,6,1206,6,1206,27026783.2,201.0,201.0,0,0,0.0,0.0,0.0
135128110.0,17,6,1206,6,1206,27025622.0,201.0,201.0,0,0,0.0,0.0,0.0
10470434.0,6,7,478,4,272,3444804.333333333,74.0,68.0,3,206,5167092.5,74.0,68.66666666666667
22017.0,6,10,2032,5,524,5273.0,252.0,104.8,5,1508,5171.0,1236.0,301.6
135130351.0,17,6,1146,6,1146,27026070.2,191.0,191.0,0,0,0.0,0.0,0.0
120123095.0,6,14,2224,9,1204,15015386.875,188.0,133.77777777777777,5,1020,22522736.25,204.0,204.0
94338.0,6,2,132,1,66,0.0,66.0,66.0,1,66,0.0,66.0,66.0
135135604.0,17,6,1146,6,1146,27027120.8,191.0,191.0,0,0,0.0,0.0,0.0
12405.0,17,4,823,2,163,0.0,89.0,81.5,2,660,0.0,443.0,330.0
59133.0,6,10,2032,5,524,10975.0,252.0,104.8,5,1508,14144.5,1236.0,301.6
106560.0,17,2,286,2,286,0.0,143.0,143.0,0,0,0.0,0.0,0.0
1057719.0,6,3,1604,2,851,0.0,785.0,425.5,1,753,0.0,753.0,753.0
113254899.0,6,46,3036,23,1518,5135439.227272728,66.0,66.0,23,1518,5135436.227272728,66.0,66.0
107626.0,17,2,286,2,286,0.0,143.0,143.0,0,0,0.0,0.0,0.0
12075.0,6,10,2032,5,524,2329.75,252.0,104.8,5,1508,2168.0,1236.0,301.6
157020.0,6,3,337,2,214,0.0,160.0,107.0,1,123,0.0,123.0,123.0
20563.0,6,10,2032,5,524,4896.0,252.0,104.8,5,1508,4873.0,1236.0,301.6
19013.0,17,2,582,1,83,0.0,83.0,83.0,1,499,0.0,499.0,499.0
47602377.0,6,7,1874,3,887,22865600.5,753.0,295.6666666666667,4,987,14943444.666666666,785.0,246.75
233767.0,6,3,337,2,214,0.0,160.0,107.0,1,123,0.0,123.0,123.0
120529388.0,6,223,25246,112,17624,1085850.3423423425,284.0,157.35714285714286,111,7622,1086219.8272727274,140.0,68.66666666666667
126533023.0,17,14,864,7,432,17833501.333333332,174.0,61.71428571428572,7,432,20031623.0,174.0,61.71428571428572
5833930.0,6,5,336,2,134,0.0,68.0,67.0,3,202,1526259.0,70.0,67.33333333333333
28210.0,6,14,4740,7,653,4036.8333333333335,249.0,93.28571428571428,7,4087,4514.833333333333,1514.0,583.8571428571429
518241.0,17,4,1400,4,1400,172747.0,350.0,350.0,0,0,0.0,0.0,0.0
103975.0,17,2,700,2,700,0.0,350.0,350.0,0,0,0.0,0.0,0.0
106990.0,17,2,286,2,286,0.0,143.0,143.0,0,0,0.0,0.0,0.0
25836.0,6,10,2032,5,524,4273.75,252.0,104.8,5,1508,5872.5,1236.0,301.6
3213875.0,6,15,2267,8,1146,459125.0,580.0,143.25,7,1121,499031.3333333333,733.0,160.14285714285714
3064.0,17,2,224,1,76,0.0,76.0,76.0,1,148,0.0,148.0,148.0
1491.0,17,2,762,2,762,0.0,381.0,381.0,0,0,0.0,0.0,0.0
171642.0,17,2,180,1,90,0.0,90.0,90.0,1,90,0.0,90.0,90.0
107547642.0,6,44,2904,22,1452,5121316.285714285,66.0,66.0,22,1452,5106432.047619048,66.0,66.0
120130946.0,6,304,36008,152,10254,790159.9139072847,140.0,67.46052631578948,152,25754,783314.3112582781,284.0,169.43421052631578
5321583.0,6,35,11060,18,7022,313034.29411764705,1514.0,390.1111111111111,17,4038,282071.6875,1514.0,237.52941176470588
298191.0,6,6,412,4,272,99397.0,74.0,68.0,2,140,0.0,74.0,70.0
124661642.0,17,14,864,7,432,17500166.666666668,174.0,61.71428571428572,7,432,17501370.166666668,174.0,61.71428571428572
221856.0,6,13,1394,7,797,36976.0,253.0,113.85714285714286,6,597,42462.6,259.0,99.5
2497.0,17,4,344,2,150,0.0,75.0,75.0,2,194,0.0,103.0,97.0
32953.0,6,10,2032,5,524,7525.0,252.0,104.8,5,1508,6530.5,1236.0,301.6
307270.0,6,6,412,4,272,102423.33333333331,74.0,68.0,2,140,0.0,74.0,70.0
1295716.0,6,4,264,2,132,0.0,66.0,66.0,2,132,0.0,66.0,66.0
889954.0,17,2,246,1,76,0.0,76.0,76.0,1,170,0.0,170.0,170.0
51630.0,6,14,4740,7,653,8482.166666666666,249.0,93.28571428571428,7,4087,8107.0,1514.0,583.8571428571429
3245316.0,6,3,1604,2,851,0.0,785.0,425.5,1,753,0.0,753.0,753.0
148034.0,17,2,180,1,90,0.0,90.0,90.0,1,90,0.0,90.0,90.0
108108658.0,17,5,955,5,955,27027164.5,191.0,191.0,0,0,0.0,0.0,0.0
46282.0,6,13,1479,7,882,7394.166666666667,291.0,126.0,6,597,7527.6,259.0,99.5
14973.0,17,2,180,1,90,0.0,90.0,90.0,1,90,0.0,90.0,90.0
3010518.0,6,11,2106,6,598,601935.0,252.0,99.66666666666669,5,1508,1890.5,1236.0,301.6
49382.0,6,14,4740,7,653,7544.5,249.0,93.28571428571428,7,4087,8098.0,1514.0,583.8571428571429
90255200.0,6,14,2240,8,1016,12893600.0,188.0,127.0,6,1224,18018012.2,204.0,204.0
66362.0,6,14,4740,7,653,10910.333333333334,249.0,93.28571428571428,7,4087,10798.666666666666,1514.0,583.8571428571429
120125399.0,6,14,2224,9,1204,15015674.875,188.0,133.77777777777777,5,1020,22523502.75,204.0,204.0
247125.0,17,2,180,1,90,0.0,90.0,90.0,1,90,0.0,90.0,90.0
210466.0,17,2,762,2,762,0.0,381.0,381.0,0,0,0.0,0.0,0.0
2379.0,17,4,344,2,150,0.0,75.0,75.0,2,194,0.0,103.0,97.0
390.0,17,2,166,1,75,0.0,75.0,75.0,1,91,0.0,91.0,91.0
37116.0,6,10,2032,5,524,9000.75,252.0,104.8,5,1508,8227.25,1236.0,301.6
101851.0,17,2,762,2,762,0.0,381.0,381.0,0,0,0.0,0.0,0.0
306712.0,17,2,180,1,90,0.0,90.0,90.0,1,90,0.0,90.0,90.0
48022.0,6,14,4740,7,653,7855.0,249.0,93.28571428571428,7,4087,7450.333333333333,1514.0,583.8571428571429
61636.0,6,14,4740,7,653,10146.833333333334,249.0,93.28571428571428,7,4087,9898.333333333334,1514.0,583.8571428571429
284320.0,17,2,363,1,79,0.0,79.0,79.0,1,284,0.0,284.0,284.0
304712.0,6,6,412,4,272,101570.66666666669,74.0,68.0,2,140,0.0,74.0,70.0
122314449.0,6,48,3168,24,1584,4914999.0,66.0,66.0,24,1584,5292747.478260869,66.0,66.0
117458575.0,6,230,25866,115,17980,1028439.4298245612,284.0,156.34782608695653,115,7886,1028439.0087719298,140.0,68.57391304347826
120665.0,6,3,373,2,238,0.0,172.0,119.0,1,135,0.0,135.0,135.0
8948.0,17,2,539,1,86,0.0,86.0,86.0,1,453,0.0,453.0,453.0
103628829.0,6,43,2838,22,1452,4921744.476190476,66.0,66.0,21,1386,5135442.65,66.0,66.0
4199.0,17,2,762,2,762,0.0,381.0,381.0,0,0,0.0,0.0,0.0
216861.0,6,3,426,2,280,0.0,214.0,140.0,1,146,0.0,146.0,146.0
120122341.0,6,13,2036,5,1020,30030585.25,204.0,204.0,8,1016,17136763.85714286,188.0,127.0
2028.0,17,4,344,2,150,0.0,75.0,75.0,2,194,0.0,103.0,97.0
56143.0,6,12,1320,6,723,8918.4,253.0,120.5,6,597,10293.4,259.0,99.5
1312124.0,17,7,490,7,490,218687.3333333333,70.0,70.0,0,0,0.0,0.0,0.0
233490.0,6,3,337,2,214,0.0,160.0,107.0,1,123,0.0,123.0,123.0
114794940.0,6,30,1974,15,1026,8184233.928571428,123.0,68.4,15,948,8184231.928571428,123.0,63.2
4600154.0,6,5,336,2,134,0.0,68.0,67.0,3,202,1419206.5,70.0,67.33333333333333
204251.0,17,4,6056,4,6056,68083.66666666667,1514.0,1514.0,0,0,0.0,0.0,0.0
244505.0,6,3,337,2,214,0.0,160.0,107.0,1,123,0.0,123.0,123.0
232964.0,6,3,337,2,214,0.0,160.0,107.0,1,123,0.0,123.0,123.0
0.0,6,1,66,1,66,0.0,66.0,66.0,0,0,0.0,0.0,0.0
15291.0,6,11,1132,6,556,2727.6,218.0,92.66666666666669,5,576,3424.0,304.0,115.2
108103986.0,17,5,1005,5,1005,27025996.5,201.0,201.0,0,0,0.0,0.0,0.0
2422.0,17,4,344,2,150,0.0,75.0,75.0,2,194,0.0,103.0,97.0
205984.0,17,2,180,1,90,0.0,90.0,90.0,1,90,0.0,90.0,90.0
17967.0,6,20,7606,11,978,1796.7,310.0,88.9090909090909,9,6628,1984.0,1514.0,736.4444444444445
230114.0,17,2,180,1,90,0.0,90.0,90.0,1,90,0.0,90.0,90.0
16764.0,6,14,4740,7,653,2552.333333333333,249.0,93.28571428571428,7,4087,2655.333333333333,1514.0,583.8571428571429
104869727.0,6,43,3792,25,2130,4369571.958333333,123.0,85.2,18,1662,6155983.705882353,123.0,92.33333333333331
6600.0,17,2,570,1,81,0.0,81.0,81.0,1,489,0.0,489.0,489.0
166648.0,17,2,180,1,90,0.0,90.0,90.0,1,90,0.0,90.0,90.0
1742684.0,6,22,6441,12,1529,158425.81818181818,357.0,127.41666666666669,10,4912,159321.44444444444,1510.0,491.2
1167023.0,6,13,3011,8,2383,166717.57142857142,1514.0,297.875,5,628,222956.5,331.0,125.6
2590355.0,6,2,132,1,66,0.0,66.0,66.0,1,66,0.0,66.0,66.0
284887.0,17,2,363,1,79,0.0,79.0,79.0,1,284,0.0,284.0,284.0
91648929.0,17,12,778,6,389,18200207.4,174.0,64.83333333333333,6,389,18201264.4,174.0,64.83333333333333
106925699.0,6,27,1800,14,894,8225020.153846154,123.0,63.85714285714285,13,906,8078379.333333333,123.0,69.6923076923077
1046.0,17,2,762,2,762,0.0,381.0,381.0,0,0,0.0,0.0,0.0
57363.0,6,14,4740,7,653,8708.166666666666,249.0,93.28571428571428,7,4087,8662.0,1514.0,583.8571428571429
322794.0,6,10,1221,6,636,64558.8,298.0,106.0,4,585,100876.0,379.0,146.25
113276233.0,6,225,25574,113,7754,1011394.9375,140.0,68.61946902654867,112,17820,1012249.5495495496,284.0,159.10714285714286
120325156.0,6,247,28106,124,19692,978253.300813008,300.0,158.80645161290323,123,8414,977687.3606557376,140.0,68.40650406504065
69880.0,6,10,2032,5,524,16939.25,252.0,104.8,5,1508,16699.75,1236.0,301.6
306198.0,6,6,412,4,272,102066.0,74.0,68.0,2,140,0.0,74.0,70.0
102285.0,17,2,286,2,286,0.0,143.0,143.0,0,0,0.0,0.0,0.0
90523002.0,6,15,2444,8,1016,12931857.42857143,188.0,127.0,7,1428,15060355.833333334,204.0,204.0
4413.0,17,2,626,1,72,0.0,72.0,72.0,1,554,0.0,554.0,554.0
120084770.0,6,212,23868,106,7218,1135699.6761904762,140.0,68.09433962264151,106,16650,1136838.2285714287,284.0,157.0754716981132
106206.0,17,2,286,2,286,0.0,143.0,143.0,0,0,0.0,0.0,0.0
167346.0,17,4,704,2,148,0.0,74.0,74.0,2,556,0.0,280.0,278.0
2421.0,17,4,344,2,150,0.0,75.0,75.0,2,194,0.0,103.0,97.0
127801769.0,6,32,2157,16,1071,7854471.8,123.0,66.9375,16,1086,8519934.466666667,123.0,67.875
118673916.0,6,33,2274,17,1125,7417119.75,123.0,66.17647058823529,16,1149,7231438.0,123.0,71.8125
109714203.0,6,321,37358,161,26576,685713.76875,284.0,165.06832298136646,160,10782,688582.8364779875,140.0,67.3875
90257418.0,6,12,1832,8,1016,12893916.857142856,188.0,127.0,4,816,30030225.33333333,204.0,204.0
124153.0,6,3,337,2,214,0.0,160.0,107.0,1,123,0.0,123.0,123.0
205685.0,17,2,180,1,90,0.0,90.0,90.0,1,90,0.0,90.0,90.0
144959.0,17,4,820,2,156,0.0,78.0,78.0,2,664,0.0,332.0,332.0
115930622.0,6,47,3102,24,1584,5028502.391304348,66.0,66.0,23,1518,5135434.636363637,66.0,66.0
217562.0,6,3,426,2,280,0.0,214.0,140.0,1,146,0.0,146.0,146.0
205642.0,17,3,1143,3,1143,102821.0,381.0,381.0,0,0,0.0,0.0,0.0
29463.0,6,14,4740,7,653,4643.5,249.0,93.28571428571428,7,4087,3604.0,1514.0,583.8571428571429
1314544.0,6,4,264,2,132,0.0,66.0,66.0,2,132,0.0,66.0,66.0
105008.0,17,2,286,2,286,0.0,143.0,143.0,0,0,0.0,0.0,0.0
135125392.0,17,6,1146,6,1146,27025078.4,191.0,191.0,0,0,0.0,0.0,0.0
300037.0,6,6,412,4,272,100012.33333333331,74.0,68.0,2,140,0.0,74.0,70.0
90258441.0,6,13,2036,8,1016,12894063.0,188.0,127.0,5,1020,22520745.0,204.0,204.0
2353.0,17,4,344,2,150,0.0,75.0,75.0,2,194,0.0,103.0,97.0
202826.0,17,2,762,2,762,0.0,381.0,381.0,0,0,0.0,0.0,0.0
329.0,17,2,160,1,80,0.0,80.0,80.0,1,80,0.0,80.0,80.0
612175.0,6,4,508,2,238,0.0,172.0,119.0,2,270,0.0,135.0,135.0
300026.0,17,4,6056,4,6056,100008.66666666669,1514.0,1514.0,0,0,0.0,0.0,0.0
18759.0,6,10,1065,5,534,3166.0,262.0,106.8,5,531,4352.5,259.0,106.2
412.0,17,2,410,1,78,0.0,78.0,78.0,1,332,0.0,332.0,332.0
35546.0,6,14,4740,7,653,5120.333333333333,249.0,93.28571428571428,7,4087,5683.833333333333,1514.0,583.8571428571429
114729981.0,6,30,1974,15,1026,8179569.642857143,123.0,68.4,15,948,8179542.5,123.0,63.2
0.0,6,1,66,1,66,0.0,66.0,66.0,0,0,0.0,0.0,0.0
120063225.0,17,29,13785,29,13785,4287972.321428572,501.0,475.3448275862069,0,0,0.0,0.0,0.0
135132445.0,17,6,1146,6,1146,27026489.0,191.0,191.0,0,0,0.0,0.0,0.0
90258511.0,6,16,2368,9,1204,11282313.875,188.0,133.77777777777777,7,1164,15015464.833333334,204.0,166.28571428571428
410.0,17,2,410,1,78,0.0,78.0,78.0,1,332,0.0,332.0,332.0
90278940.0,6,17,1287,9,691,11279801.875,95.0,76.77777777777777,8,596,12895545.142857144,95.0,74.5
104851545.0,6,44,2904,22,1452,4992930.714285715,66.0,66.0,22,1452,4978045.333333333,66.0,66.0
147961.0,17,2,180,1,90,0.0,90.0,90.0,1,90,0.0,90.0,90.0
246534.0,17,4,1400,4,1400,82178.0,350.0,350.0,0,0,0.0,0.0,0.0
75401.0,6,14,4740,7,653,11751.5,249.0,93.28571428571428,7,4087,12429.333333333334,1514.0,583.8571428571429
47642.0,6,14,4740,7,653,7585.166666666667,249.0,93.28571428571428,7,4087,7530.166666666667,1514.0,583.8571428571429
244290.0,17,2,180,1,90,0.0,90.0,90.0,1,90,0.0,90.0,90.0
0.0,17,1,55,1,55,0.0,55.0,55.0,0,0,0.0,0.0,0.0
119205863.0,6,31,2166,16,1149,7932646.933333334,123.0,71.8125,15,1017,8498901.92857143,123.0,67.8
90060104.0,17,28,13364,28,13364,3335559.407407407,501.0,477.2857142857143,0,0,0.0,0.0,0.0
29725.0,6,11,2098,6,590,5831.6,252.0,98.33333333333331,5,1508,6483.0,1236.0,301.6
281111.0,17,2,414,1,88,0.0,88.0,88.0,1,326,0.0,326.0,326.0
206030.0,17,2,180,1,90,0.0,90.0,90.0,1,90,0.0,90.0,90.0
350.0,17,2,267,1,83,0.0,83.0,83.0,1,184,0.0,184.0,184.0
120043812.0,17,29,13785,29,13785,4287279.0,501.0,475.3448275862069,0,0,0.0,0.0,0.0
116395.0,6,10,2032,5,524,27789.75,252.0,104.8,5,1508,28734.25,1236.0,301.6
240956.0,6,3,373,2,238,0.0,172.0,119.0,1,135,0.0,135.0,135.0
112818614.0,6,32,2236,16,1165,7521240.933333334,139.0,72.8125,16,1071,7506415.933333334,123.0,66.9375
198474.0,17,2,180,1,90,0.0,90.0,90.0,1,90,0.0,90.0,90.0
103200316.0,6,196,22236,98,15546,1061698.030927835,284.0,158.6326530612245,98,6690,1061693.030927835,140.0,68.26530612244898
119789940.0,6,24,1788,13,989,9982495.0,95.0,76.07692307692308,11,799,11952903.9,95.0,72.63636363636364
190915.0,17,2,180,1,90,0.0,90.0,90.0,1,90,0.0,90.0,90.0
16759.0,17,2,180,1,90,0.0,90.0,90.0,1,90,0.0,90.0,90.0
90301019.0,6,29,3354,14,1466,6942736.307692308,427.0,104.71428571428572,15,1888,6449381.0,361.0,125.86666666666666
108108196.0,17,5,955,5,955,27027049.0,191.0,191.0,0,0,0.0,0.0,0.0
269877.0,6,10,1221,6,636,53975.4,298.0,106.0,4,585,84579.66666666667,379.0,146.25
135135088.0,17,6,1206,6,1206,27027017.6,201.0,201.0,0,0,0.0,0.0,0.0
100641.0,17,2,286,2,286,0.0,143.0,143.0,0,0,0.0,0.0,0.0
2413.0,17,4,344,2,150,0.0,75.0,75.0,2,194,0.0,103.0,97.0
109407512.0,6,32,2236,16,1165,7279419.8,139.0,72.8125,16,1071,7279442.933333334,123.0,66.9375
228221.0,17,2,180,1,90,0.0,90.0,90.0,1,90,0.0,90.0,90.0
90220556.0,6,16,1192,8,596,12853413.714285716,95.0,74.5,8,596,12857863.142857144,95.0,74.5
108110191.0,17,5,955,5,955,27027547.75,191.0,191.0,0,0,0.0,0.0,0.0
28676.0,6,14,4740,7,653,4459.166666666667,249.0,93.28571428571428,7,4087,4646.833333333333,1514.0,583.8571428571429
114819633.0,6,215,24284,108,7350,1073080.6822429907,140.0,68.05555555555556,107,16934,1074122.6698113207,284.0,158.26168224299064
98142.0,17,2,762,2,762,0.0,381.0,381.0,0,0,0.0,0.0,0.0
146515.0,6,3,337,2,214,0.0,160.0,107.0,1,123,0.0,123.0,123.0
108103351.0,17,5,1005,5,1005,27025837.75,201.0,201.0,0,0,0.0,0.0,0.0
108322.0,17,2,286,2,286,0.0,143.0,143.0,0,0,0.0,0.0,0.0
4203.0,17,2,614,1,72,0.0,72.0,72.0,1,542,0.0,542.0,542.0
17938.0,6,11,2098,6,590,3001.4,252.0,98.33333333333331,5,1508,4175.5,1236.0,301.6
90227654.0,6,16,1192,8,596,12853784.57142857,95.0,74.5,8,596,12858734.0,95.0,74.5
120001998.0,6,20,1656,11,840,12000199.8,95.0,76.36363636363636,9,816,11284593.75,220.0,90.66666666666669
94710574.0,6,29,2062,15,1017,6765010.071428572,123.0,67.8,14,1045,6517348.461538462,139.0,74.64285714285714
2796016.0,6,2,132,1,66,0.0,66.0,66.0,1,66,0.0,66.0,66.0
118714206.0,6,206,23202,103,16108,1161755.7156862745,284.0,156.38834951456312,103,7094,1161755.549019608,140.0,68.87378640776699
856289.0,6,9,1096,6,625,171257.8,287.0,104.16666666666669,3,471,291658.0,331.0,157.0
90676770.0,6,22,1680,10,745,10075196.666666666,95.0,74.5,12,935,8220687.272727272,95.0,77.91666666666667
153502.0,17,2,180,1,90,0.0,90.0,90.0,1,90,0.0,90.0,90.0
1054535.0,6,13,1386,7,789,175755.83333333334,253.0,112.71428571428572,6,597,209433.2,259.0,99.5
96131383.0,17,12,778,6,389,19201124.4,174.0,64.83333333333333,6,389,19200188.8,174.0,64.83333333333333
10522054.0,6,7,478,4,272,3462000.333333333,74.0,68.0,3,206,5192881.0,74.0,68.66666666666667
2848062.0,6,3,204,2,136,0.0,70.0,68.0,1,68,0.0,68.0,68.0
90288361.0,6,12,1832,8,1016,12898337.285714284,188.0,127.0,4,816,30041110.666666668,204.0,204.0
58701.0,6,14,4740,7,653,9283.666666666666,249.0,93.28571428571428,7,4087,9640.666666666666,1514.0,583.8571428571429
204725.0,17,2,180,1,90,0.0,90.0,90.0,1,90,0.0,90.0,90.0
234030.0,6,3,337,2,214,0.0,160.0,107.0,1,123,0.0,123.0,123.0
2606981.0,6,2,132,1,66,0.0,66.0,66.0,1,66,0.0,66.0,66.0
2469.0,17,4,344,2,150,0.0,75.0,75.0,2,194,0.0,103.0,97.0
24326584.0,17,5,1718,4,1368,848628.6666666666,342.0,342.0,1,350,0.0,350.0,350.0
91860614.0,6,32,2368,16,1228,6124040.933333334,139.0,76.75,16,1140,6109633.2,123.0,71.25
0.0,6,1,66,1,66,0.0,66.0,66.0,0,0,0.0,0.0,0.0
108105392.0,17,5,955,5,955,27026348.0,191.0,191.0,0,0,0.0,0.0,0.0
308700.0,17,4,1400,4,1400,102900.0,350.0,350.0,0,0,0.0,0.0,0.0
62703.99999999999,6,13,1394,7,797,10450.666666666666,253.0,113.85714285714286,6,597,11481.4,259.0,99.5
90254640.0,6,13,2036,8,1016,12893520.0,188.0,127.0,5,1020,22522905.75,204.0,204.0
90523576.0,6,14,2240,8,1016,12931939.42857143,188.0,127.0,6,1224,18071644.8,204.0,204.0
2997305.0,6,2,132,1,66,0.0,66.0,66.0,1,66,0.0,66.0,66.0
208551.0,6,3,426,2,280,0.0,214.0,140.0,1,146,0.0,146.0,146.0
135127372.0,17,6,1146,6,1146,27025474.4,191.0,191.0,0,0,0.0,0.0,0.0
90294227.0,6,16,1192,8,596,12892666.857142856,95.0,74.5,8,596,12897920.857142856,95.0,74.5
132597.0,6,2,132,1,66,0.0,66.0,66.0,1,66,0.0,66.0,66.0
196967.0,17,2,180,1,90,0.0,90.0,90.0,1,90,0.0,90.0,90.0
108105556.0,17,5,955,5,955,27026389.0,191.0,191.0,0,0,0.0,0.0,0.0
2187515.0,6,2,132,1,66,0.0,66.0,66.0,1,66,0.0,66.0,66.0
98073.0,17,2,762,2,762,0.0,381.0,381.0,0,0,0.0,0.0,0.0
108103889.0,17,5,955,5,955,27025972.25,191.0,191.0,0,0,0.0,0.0,0.0
120398704.0,6,243,27482,122,19200,995030.611570248,284.0,157.37704918032787,121,8282,994856.1833333332,140.0,68.44628099173553
120248178.0,6,20,1490,10,745,13360908.666666666,95.0,74.5,10,745,13332109.555555556,95.0,74.5
113947967.0,6,48,3168,24,1584,4954259.434782608,66.0,66.0,24,1584,4940680.826086956,66.0,66.0
135137797.0,17,6,1206,6,1206,27027559.4,201.0,201.0,0,0,0.0,0.0,0.0
107296.0,17,2,286,2,286,0.0,143.0,143.0,0,0,0.0,0.0,0.0
135134808.0,17,6,1146,6,1146,27026961.6,191.0,191.0,0,0,0.0,0.0,0.0
308048.0,6,6,412,4,272,102682.66666666669,74.0,68.0,2,140,0.0,74.0,70.0
846.0,17,4,438,2,148,0.0,74.0,74.0,2,290,0.0,147.0,145.0
90029795.0,17,27,12943,27,12943,3462684.423076923,501.0,479.3703703703704,0,0,0.0,0.0,0.0
3051714.0,6,3,204,2,136,0.0,70.0,68.0,1,68,0.0,68.0,68.0
2266.0,17,4,344,2,150,0.0,75.0,75.0,2,194,0.0,103.0,97.0
102114.0,17,2,762,2,762,0.0,381.0,381.0,0,0,0.0,0.0,0.0
307851.0,6,6,412,4,272,102617.0,74.0,68.0,2,140,0.0,74.0,70.0
120418990.0,6,239,27034,120,18872,1011924.2857142856,284.0,157.26666666666668,119,8162,1011852.1694915254,140.0,68.58823529411765
228361.0,17,2,180,1,90,0.0,90.0,90.0,1,90,0.0,90.0,90.0
2074490.0,6,19,6869,11,1567,207449.0,408.0,142.45454545454547,8,5302,233783.2857142857,1514.0,662.75
232927.0,6,3,337,2,214,0.0,160.0,107.0,1,123,0.0,123.0,123.0
7220125.0,17,6,1423,3,273,3605507.0,103.0,91.0,3,1150,3605306.5,449.0,383.3333333333333
5826937.0,6,5,336,2,134,0.0,68.0,67.0,3,202,1522339.0,70.0,67.33333333333333
100456259.0,17,14,1126,7,563,16742709.833333334,174.0,80.42857142857143,7,563,16636253.0,174.0,80.42857142857143
1027652.0,6,11,1134,6,558,205530.4,220.0,93.0,5,576,255875.75,304.0,115.2
106478743.0,6,32,2220,16,1149,7084184.6,123.0,71.8125,16,1071,7084182.733333333,123.0,66.9375
108108319.0,17,5,1005,5,1005,27027079.75,201.0,201.0,0,0,0.0,0.0,0.0
88132.0,6,12,1320,7,789,14688.666666666666,253.0,112.71428571428572,5,531,16291.5,259.0,106.2
10938.0,17,2,582,1,83,0.0,83.0,83.0,1,499,0.0,499.0,499.0
53129.0,6,14,4740,7,653,8516.5,249.0,93.28571428571428,7,4087,8720.5,1514.0,583.8571428571429
120000045.0,6,27,2955,14,1502,9230772.692307692,423.0,107.28571428571428,13,1453,9950189.5,361.0,111.76923076923076
105229700.0,6,210,23774,105,16548,1009755.2884615384,284.0,157.6,105,7226,1009755.5384615384,140.0,68.81904761904762
1915.0,17,4,344,2,150,0.0,75.0,75.0,2,194,0.0,103.0,97.0
10521973.0,6,7,478,4,272,3462224.0,74.0,68.0,3,206,5193226.5,74.0,68.66666666666667
303125.0,6,2,132,1,66,0.0,66.0,66.0,1,66,0.0,66.0,66.0
10539001.0,6,7,478,4,272,3465782.0,74.0,68.0,3,206,5198572.5,74.0,68.66666666666667
60949.0,6,14,4740,7,653,10031.0,249.0,93.28571428571428,7,4087,7753.333333333333,1514.0,583.8571428571429
312.0,17,2,156,1,78,0.0,78.0,78.0,1,78,0.0,78.0,78.0
66881.0,6,14,4740,7,653,10227.5,249.0,93.28571428571428,7,4087,10799.5,1514.0,583.8571428571429
108104280.0,17,5,1005,5,1005,27026070.0,201.0,201.0,0,0,0.0,0.0,0.0
103670.0,17,2,286,2,286,0.0,143.0,143.0,0,0,0.0,0.0,0.0
2586518.0,6,2,132,1,66,0.0,66.0,66.0,1,66,0.0,66.0,66.0
402162.0,6,3,204,2,136,0.0,70.0,68.0,1,68,0.0,68.0,68.0
28803.0,6,14,4740,7,653,4681.666666666667,249.0,93.28571428571428,7,4087,4661.833333333333,1514.0,583.8571428571429
104988579.0,17,15,5130,15,5130,7499184.214285715,342.0,342.0,0,0,0.0,0.0,0.0
216755.0,17,2,180,1,90,0.0,90.0,90.0,1,90,0.0,90.0,90.0
0.0,6,1,66,1,66,0.0,66.0,66.0,0,0,0.0,0.0,0.0
859172.0,6,9,1269,6,798,171834.4,460.0,133.0,3,471,291738.5,331.0,157.0
237129.0,6,3,337,2,214,0.0,160.0,107.0,1,123,0.0,123.0,123.0
174584.0,17,4,1524,4,1524,58194.66666666666,381.0,381.0,0,0,0.0,0.0,0.0
2379.0,17,4,344,2,150,0.0,75.0,75.0,2,194,0.0,103.0,97.0
9241.0,17,2,582,1,83,0.0,83.0,83.0,1,499,0.0,499.0,499.0
90807282.0,6,19,1436,10,745,10083841.666666666,95.0,74.5,9,691,11349898.625,95.0,76.77777777777777
105228933.0,17,14,1126,7,563,17538155.5,174.0,80.42857142857143,7,563,17459580.166666668,174.0,80.42857142857143
5005075.0,17,4,849,2,166,0.0,83.0,83.0,2,683,0.0,499.0,341.5
123455410.0,6,48,3168,24,1584,4961957.260869565,66.0,66.0,24,1584,5305995.782608695,66.0,66.0
2368.0,17,4,344,2,150,0.0,75.0,75.0,2,194,0.0,103.0,97.0
121280.0,6,3,337,2,214,0.0,160.0,107.0,1,123,0.0,123.0,123.0
29510.0,6,14,4740,7,653,4754.333333333333,249.0,93.28571428571428,7,4087,4518.333333333333,1514.0,583.8571428571429
91573959.0,6,517,65344,259,17316,354937.82558139536,140.0,66.85714285714286,258,48028,355412.16342412453,570.0,186.15503875968992
205969.0,17,2,180,1,90,0.0,90.0,90.0,1,90,0.0,90.0,90.0
1796611.0,6,23,6509,12,1529,163328.27272727274,357.0,127.41666666666669,11,4980,148445.2,1510.0,452.7272727272728
104499296.0,17,14,864,7,432,17333512.166666668,174.0,61.71428571428572,7,432,17334872.666666668,174.0,61.71428571428572
46720.0,6,14,4740,7,653,7197.166666666667,249.0,93.28571428571428,7,4087,5990.5,1514.0,583.8571428571429
90047140.0,17,28,13364,28,13364,3335079.25925926,501.0,477.2857142857143,0,0,0.0,0.0,0.0
202115.0,17,4,6056,4,6056,67371.66666666667,1514.0,1514.0,0,0,0.0,0.0,0.0
512472.00000000006,6,5,336,2,134,0.0,68.0,67.0,3,202,192352.0,70.0,67.33333333333333
162340.0,17,2,180,1,90,0.0,90.0,90.0,1,90,0.0,90.0,90.0
46515.0,6,14,4740,7,653,7533.0,249.0,93.28571428571428,7,4087,6923.666666666667,1514.0,583.8571428571429
5281.0,17,4,344,2,150,0.0,75.0,75.0,2,194,0.0,103.0,97.0
23854.0,6,14,4740,7,653,3844.8333333333335,249.0,93.28571428571428,7,4087,3839.0,1514.0,583.8571428571429
143838.0,17,2,180,1,90,0.0,90.0,90.0,1,90,0.0,90.0,90.0
222639.0,6,3,426,2,280,0.0,214.0,140.0,1,146,0.0,146.0,146.0
3007143.0,6,12,2172,7,664,500832.1666666667,252.0,94.85714285714286,5,1508,2116.0,1236.0,301.6
725563.0,6,12,1373,7,714,120927.16666666669,298.0,102.0,5,659,169481.0,379.0,131.8
209718.0,6,3,426,2,280,0.0,214.0,140.0,1,146,0.0,146.0,146.0
106711.0,17,2,286,2,286,0.0,143.0,143.0,0,0,0.0,0.0,0.0
2591354.0,6,2,132,1,66,0.0,66.0,66.0,1,66,0.0,66.0,66.0
2459144.0,6,25,7573,14,3735,189164.92307692303,1514.0,266.7857142857143,11,3838,219763.6,1514.0,348.90909090909093
317441.0,17,4,1400,4,1400,105813.66666666669,350.0,350.0,0,0,0.0,0.0,0.0
29343.0,6,10,2032,5,524,5495.5,252.0,104.8,5,1508,6997.25,1236.0,301.6
90120093.0,6,12,1848,5,1020,22529669.25,204.0,204.0,7,828,15019623.0,188.0,118.28571428571428
112464305.0,6,46,3036,23,1518,5112002.5,66.0,66.0,23,1518,5112002.7727272725,66.0,66.0
110225.0,17,4,1400,4,1400,36741.66666666666,350.0,350.0,0,0,0.0,0.0,0.0
345.0,17,2,166,1,75,0.0,75.0,75.0,1,91,0.0,91.0,91.0
2089.0,17,2,180,1,90,0.0,90.0,90.0,1,90,0.0,90.0,90.0
135133825.0,17,6,1206,6,1206,27026765.0,201.0,201.0,0,0,0.0,0.0,0.0
328.0,17,2,166,1,75,0.0,75.0,75.0,1,91,0.0,91.0,91.0
216751.0,17,2,180,1,90,0.0,90.0,90.0,1,90,0.0,90.0,90.0
10020.0,17,4,823,2,163,0.0,89.0,81.5,2,660,0.0,443.0,330.0
2340.0,17,4,344,2,150,0.0,75.0,75.0,2,194,0.0,103.0,97.0
2598187.0,6,2,132,1,66,0.0,66.0,66.0,1,66,0.0,66.0,66.0
6106.0,17,4,344,2,150,0.0,75.0,75.0,2,194,0.0,103.0,97.0
1306683.0,17,7,490,7,490,217780.5,70.0,70.0,0,0,0.0,0.0,0.0
3910283.0,6,25,7608,13,2516,325856.9166666667,1034.0,193.53846153846155,12,5092,327783.54545454547,1510.0,424.3333333333333
205914.0,6,3,426,2,280,0.0,214.0,140.0,1,146,0.0,146.0,146.0
228489.0,17,2,180,1,90,0.0,90.0,90.0,1,90,0.0,90.0,90.0
290226.0,6,10,1221,6,636,58045.2,298.0,106.0,4,585,90906.33333333331,379.0,146.25
18464.0,17,4,823,2,163,0.0,89.0,81.5,2,660,0.0,443.0,330.0
401963.0,6,4,508,2,238,0.0,172.0,119.0,2,270,0.0,135.0,135.0
2592644.0,6,2,132,1,66,0.0,66.0,66.0,1,66,0.0,66.0,66.0
120004631.0,6,21,1585,11,840,11999963.9,95.0,76.36363636363636,10,745,13332843.444444444,95.0,74.5
123610599.0,6,49,3234,25,1650,5150441.625,66.0,66.0,24,1584,5185313.130434782,66.0,66.0
24929.0,6,14,4740,7,653,3940.6666666666665,249.0,93.28571428571428,7,4087,3243.1666666666665,1514.0,583.8571428571429
2597491.0,6,2,132,1,66,0.0,66.0,66.0,1,66,0.0,66.0,66.0
2397.0,17,4,344,2,150,0.0,75.0,75.0,2,194,0.0,103.0,97.0
16734.0,6,10,2032,5,524,3836.25,252.0,104.8,5,1508,3739.5,1236.0,301.6
2061.0,17,4,344,2,150,0.0,75.0,75.0,2,194,0.0,103.0,97.0
2573936.0,6,3,1777,1,826,0.0,826.0,826.0,2,951,0.0,885.0,475.5
2523.0,17,2,180,1,90,0.0,90.0,90.0,1,90,0.0,90.0,90.0
321.0,17,2,164,1,82,0.0,82.0,82.0,1,82,0.0,82.0,82.0
41778.0,6,14,4740,7,653,6809.0,249.0,93.28571428571428,7,4087,6597.166666666667,1514.0,583.8571428571429
33068.0,6,14,4740,7,653,5137.833333333333,249.0,93.28571428571428,7,4087,5310.166666666667,1514.0,583.8571428571429
303096.0,6,2,132,1,66,0.0,66.0,66.0,1,66,0.0,66.0,66.0
31727.0,6,14,4740,7,653,4979.166666666667,249.0,93.28571428571428,7,4087,4282.0,1514.0,583.8571428571429
91952.0,17,2,762,2,762,0.0,381.0,381.0,0,0,0.0,0.0,0.0
54207.0,6,14,4740,7,653,8633.333333333334,249.0,93.28571428571428,7,4087,8890.333333333334,1514.0,583.8571428571429
108106119.0,17,5,1005,5,1005,27026529.75,201.0,201.0,0,0,0.0,0.0,0.0
319404.0,17,4,622,4,622,106468.0,163.0,155.5,0,0,0.0,0.0,0.0
116143068.0,6,214,24372,107,7358,1095689.3207547169,140.0,68.76635514018692,107,17014,1093150.9056603771,390.0,159.00934579439252
302083.0,6,12,1373,7,714,50347.16666666666,298.0,102.0,5,659,71153.25,379.0,131.8
4733206.0,6,13,1396,7,765,788867.6666666666,253.0,109.28571428571428,6,631,944039.2,293.0,105.16666666666669
308315.0,6,6,412,4,272,102771.66666666669,74.0,68.0,2,140,0.0,74.0,70.0
239755.0,6,3,337,2,214,0.0,160.0,107.0,1,123,0.0,123.0,123.0
20982.0,6,10,1067,5,536,4648.5,264.0,107.2,5,531,3832.25,259.0,106.2
255261.00000000003,17,2,180,1,90,0.0,90.0,90.0,1,90,0.0,90.0,90.0
48202.0,6,14,4740,7,653,7643.333333333333,249.0,93.28571428571428,7,4087,7679.666666666667,1514.0,583.8571428571429
2597005.0,6,2,132,1,66,0.0,66.0,66.0,1,66,0.0,66.0,66.0
110061.0,17,2,286,2,286,0.0,143.0,143.0,0,0,0.0,0.0,0.0
97944359.0,6,187,21048,94,6426,1053165.1505376345,140.0,68.36170212765957,93,14622,1053342.0,284.0,157.2258064516129
120121691.0,6,14,2224,9,1204,15015211.375,188.0,133.77777777777777,5,1020,22522863.75,204.0,204.0
90102896.0,6,12,1848,5,1020,22522984.25,204.0,204.0,7,828,15016966.333333334,188.0,118.28571428571428
291.0,17,2,156,1,78,0.0,78.0,78.0,1,78,0.0,78.0,78.0
227014.0,17,2,180,1,90,0.0,90.0,90.0,1,90,0.0,90.0,90.0
2792569.0,6,2,132,1,66,0.0,66.0,66.0,1,66,0.0,66.0,66.0
50789.0,6,14,4740,7,653,6654.5,249.0,93.28571428571428,7,4087,8246.666666666666,1514.0,583.8571428571429
116550.0,17,2,286,2,286,0.0,143.0,143.0,0,0,0.0,0.0,0.0
3563732.0,6,146,113547,80,104889,45110.53164556962,1510.0,1311.1125,66,8658,49756.16923076923,1510.0,131.1818181818182
135127096.0,17,6,1206,6,1206,27025419.2,201.0,201.0,0,0,0.0,0.0,0.0
157786.0,17,2,180,1,90,0.0,90.0,90.0,1,90,0.0,90.0,90.0
978939.0,6,12,1362,6,731,193706.0,253.0,121.83333333333331,6,631,194536.4,293.0,105.16666666666669
495.0,17,2,410,1,78,0.0,78.0,78.0,1,332,0.0,332.0,332.0
123522865.0,17,15,907,7,432,17333495.333333332,174.0,61.71428571428572,8,475,17572652.714285713,174.0,59.375
19583.0,6,14,4740,7,653,3052.5,249.0,93.28571428571428,7,4087,3066.333333333333,1514.0,583.8571428571429
15041.0,17,2,180,1,90,0.0,90.0,90.0,1,90,0.0,90.0,90.0
145284.0,6,10,1066,5,490,35155.25,218.0,98.0,5,576,32508.25,304.0,115.2
120002042.0,6,17,1287,9,691,15000255.25,95.0,76.77777777777777,8,596,12898505.142857144,95.0,74.5
109973.0,17,4,1400,4,1400,36657.66666666666,350.0,350.0,0,0,0.0,0.0,0.0
7965.0,17,2,762,2,762,0.0,381.0,381.0,0,0,0.0,0.0,0.0
93652841.0,6,40,2640,20,1320,4929096.894736842,66.0,66.0,20,1320,4912543.368421053,66.0,66.0
120456067.0,6,244,27712,122,8348,991192.9421487604,140.0,68.42622950819673,122,19364,995471.6446280992,284.0,158.72131147540983
42812.0,6,14,4740,7,653,6506.333333333333,249.0,93.28571428571428,7,4087,6489.5,1514.0,583.8571428571429
41964.0,6,14,4740,7,653,6878.333333333333,249.0,93.28571428571428,7,4087,4666.333333333333,1514.0,583.8571428571429
506081.0,6,5,336,2,134,0.0,68.0,67.0,3,202,196349.5,70.0,67.33333333333333
25409.0,6,13,4416,6,409,4935.2,127.0,68.16666666666667,7,4007,4070.5,1514.0,572.4285714285714
206097.0,6,3,426,2,280,0.0,214.0,140.0,1,146,0.0,146.0,146.0
5625206.0,6,5,336,2,134,0.0,68.0,67.0,3,202,1426062.0,70.0,67.33333333333333
65978132.0,17,11,3770,10,3420,4521728.555555556,342.0,342.0,1,350,0.0,350.0,350.0
516662.0,6,3,204,2,136,0.0,70.0,68.0,1,68,0.0,68.0,68.0
3000642.0,6,11,2106,6,598,599937.2,252.0,99.66666666666669,5,1508,2570.0,1236.0,301.6
243706.0,6,3,337,2,214,0.0,160.0,107.0,1,123,0.0,123.0,123.0
86545.0,6,13,1394,7,797,12144.5,253.0,113.85714285714286,6,597,16745.2,259.0,99.5
311966.0,6,10,1221,6,636,62393.2,298.0,106.0,4,585,95308.33333333331,379.0,146.25
250484.0,17,4,6056,4,6056,83494.66666666667,1514.0,1514.0,0,0,0.0,0.0,0.0
310983.0,17,4,1400,4,1400,103661.0,350.0,350.0,0,0,0.0,0.0,0.0
219453.0,6,3,426,2,280,0.0,214.0,140.0,1,146,0.0,146.0,146.0
138425.0,6,2,132,1,66,0.0,66.0,66.0,1,66,0.0,66.0,66.0
323968.0,17,4,1400,4,1400,107989.33333333331,350.0,350.0,0,0,0.0,0.0,0.0
146085.0,6,3,337,2,214,0.0,160.0,107.0,1,123,0.0,123.0,123.0
120125904.0,6,13,2036,5,1020,30031476.0,204.0,204.0,8,1016,17137477.285714287,188.0,127.0
294680.0,17,2,180,1,90,0.0,90.0,90.0,1,90,0.0,90.0,90.0
109713258.0,6,30,2122,15,1105,7836661.285714285,139.0,73.66666666666667,15,1017,7821199.642857143,123.0,67.8
558.0,17,2,156,1,78,0.0,78.0,78.0,1,78,0.0,78.0,78.0
139332.0,6,2,132,1,66,0.0,66.0,66.0,1,66,0.0,66.0,66.0
109549567.0,6,33,2412,17,1272,6833347.3125,123.0,74.82352941176471,16,1140,7288901.933333334,123.0,71.25
74557783.0,6,9,842,9,842,9319722.875,97.0,93.55555555555556,0,0,0.0,0.0,0.0
3127.0,17,2,224,1,76,0.0,76.0,76.0,1,148,0.0,148.0,148.0
319127.0,6,6,412,4,272,106375.66666666669,74.0,68.0,2,140,0.0,74.0,70.0
93016325.0,6,38,2508,19,1254,5150440.333333333,66.0,66.0,19,1254,5150444.611111111,66.0,66.0
121432.0,6,3,337,2,214,0.0,160.0,107.0,1,123,0.0,123.0,123.0
440693.0,6,11,1021,6,444,59399.8,162.0,74.0,5,577,74068.25,349.0,115.4
120025158.0,17,28,13364,28,13364,4445376.222222222,501.0,477.2857142857143,0,0,0.0,0.0,0.0
218227.0,6,3,426,2,280,0.0,214.0,140.0,1,146,0.0,146.0,146.0
216653.0,17,2,180,1,90,0.0,90.0,90.0,1,90,0.0,90.0,90.0
99784.0,17,2,286,2,286,0.0,143.0,143.0,0,0,0.0,0.0,0.0
90046268.0,17,28,13364,28,13364,3335046.962962963,501.0,477.2857142857143,0,0,0.0,0.0,0.0
106165.0,17,4,1400,4,1400,35388.333333333336,350.0,350.0,0,0,0.0,0.0,0.0
21441.0,6,20,7606,11,978,2144.1,310.0,88.9090909090909,9,6628,1940.875,1514.0,736.4444444444445
16630132.0,6,26,7627,14,3735,191215.38461538465,1514.0,266.7857142857143,12,3892,1492255.9090909092,1514.0,324.3333333333333
14697.0,6,11,1133,6,602,2939.4,264.0,100.33333333333331,5,531,3175.25,259.0,106.2
33379.0,6,10,2032,5,524,8121.25,252.0,104.8,5,1508,7572.5,1236.0,301.6
2809804.0,6,2,132,1,66,0.0,66.0,66.0,1,66,0.0,66.0,66.0
434901.0,6,3,204,1,68,0.0,68.0,68.0,2,136,0.0,70.0,68.0
307078.0,6,6,412,4,272,102359.33333333331,74.0,68.0,2,140,0.0,74.0,70.0
146178.0,6,3,337,2,214,0.0,160.0,107.0,1,123,0.0,123.0,123.0
97330041.0,6,27,1938,14,1029,7486926.230769231,123.0,73.5,13,909,8092804.5,123.0,69.92307692307692
1386415.0,6,7,499,3,198,614835.5,66.0,66.0,4,301,448184.3333333333,103.0,75.25
49502.0,6,14,4740,7,653,8125.166666666667,249.0,93.28571428571428,7,4087,6770.333333333333,1514.0,583.8571428571429
2342.0,17,4,344,2,150,0.0,75.0,75.0,2,194,0.0,103.0,97.0
335.0,17,2,267,1,83,0.0,83.0,83.0,1,184,0.0,184.0,184.0
103000919.0,17,14,864,7,432,17166819.833333332,174.0,61.71428571428572,7,432,16984635.666666668,174.0,61.71428571428572
141419.0,6,2,132,1,66,0.0,66.0,66.0,1,66,0.0,66.0,66.0
2347.0,17,4,344,2,150,0.0,75.0,75.0,2,194,0.0,103.0,97.0
115175905.0,6,218,24646,109,7490,1063611.611111111,140.0,68.71559633027523,109,17156,1058783.4537037036,284.0,157.39449541284404
119340316.0,6,223,25368,112,17820,1075137.981981982,300.0,159.10714285714286,111,7548,1075439.4,140.0,68.0
297791.0,6,6,412,4,272,99263.66666666669,74.0,68.0,2,140,0.0,74.0,70.0
121400.0,6,3,337,2,214,0.0,160.0,107.0,1,123,0.0,123.0,123.0
43252.0,6,14,4740,7,653,6801.5,249.0,93.28571428571428,7,4087,6818.166666666667,1514.0,583.8571428571429
16001.000000000002,6,10,2032,5,524,3803.5,252.0,104.8,5,1508,3719.0,1236.0,301.6
127001167.0,17,15,907,8,475,18143023.85714286,174.0,59.375,7,432,17835834.5,174.0,61.71428571428572
0.0,17,1,381,1,381,0.0,381.0,381.0,0,0,0.0,0.0,0.0
117831358.0,6,29,1914,15,948,8416525.57142857,123.0,63.2,14,966,8279315.153846154,123.0,69.0
35480.0,6,14,4740,7,653,5750.166666666667,249.0,93.28571428571428,7,4087,5682.333333333333,1514.0,583.8571428571429
99799452.0,17,12,778,6,389,19959890.4,174.0,64.83333333333333,6,389,19907434.8,174.0,64.83333333333333
102367.0,17,2,762,2,762,0.0,381.0,381.0,0,0,0.0,0.0,0.0
102243.0,17,2,762,2,762,0.0,381.0,381.0,0,0,0.0,0.0,0.0
97434279.0,6,40,2640,20,1320,5128119.947368421,66.0,66.0,20,1320,5111870.052631579,66.0,66.0
181157.0,17,4,6056,4,6056,60385.66666666666,1514.0,1514.0,0,0,0.0,0.0,0.0
18225.0,6,2,145,2,145,0.0,91.0,72.5,0,0,0.0,0.0,0.0
20170.0,17,3,1026,3,1026,10085.0,342.0,342.0,0,0,0.0,0.0,0.0
232058.0,6,3,337,2,214,0.0,160.0,107.0,1,123,0.0,123.0,123.0
44670.0,6,14,4740,7,653,7113.0,249.0,93.28571428571428,7,4087,7310.166666666667,1514.0,583.8571428571429
2744927.0,6,2,134,1,68,0.0,68.0,68.0,1,66,0.0,66.0,66.0
2322.0,17,4,344,2,150,0.0,75.0,75.0,2,194,0.0,103.0,97.0
22732.0,6,10,2032,5,524,5380.5,252.0,104.8,5,1508,5398.0,1236.0,301.6
108096990.0,17,5,1005,5,1005,27024247.5,201.0,201.0,0,0,0.0,0.0,0.0
53665.0,6,10,2032,5,524,12737.75,252.0,104.8,5,1508,12097.0,1236.0,301.6
19953.0,17,2,582,1,83,0.0,83.0,83.0,1,499,0.0,499.0,499.0
71805.0,6,13,1394,7,797,11664.833333333334,253.0,113.85714285714286,6,597,13078.0,259.0,99.5
11961.0,6,10,1066,5,490,2826.0,218.0,98.0,5,576,2618.25,304.0,115.2
23661.0,6,14,4740,7,653,3351.333333333333,249.0,93.28571428571428,7,4087,3510.833333333333,1514.0,583.8571428571429
113279461.0,17,14,864,7,432,18822536.0,174.0,61.71428571428572,7,432,18833495.83333333,174.0,61.71428571428572
90287876.0,6,16,1192,8,596,12891271.714285716,95.0,74.5,8,596,12896366.0,95.0,74.5
2332.0,17,4,344,2,150,0.0,75.0,75.0,2,194,0.0,103.0,97.0
2052.0,17,4,344,2,150,0.0,75.0,75.0,2,194,0.0,103.0,97.0
2659.0,17,4,344,2,150,0.0,75.0,75.0,2,194,0.0,103.0,97.0
296.0,17,2,156,1,78,0.0,78.0,78.0,1,78,0.0,78.0,78.0
33294.0,6,10,2032,5,524,8095.0,252.0,104.8,5,1508,7776.0,1236.0,301.6
228253.0,17,2,180,1,90,0.0,90.0,90.0,1,90,0.0,90.0,90.0
94484143.0,6,28,2008,14,1045,7251453.538461538,139.0,74.64285714285714,14,963,7251455.384615385,123.0,68.78571428571429
225527.0,6,12,1373,7,714,37587.833333333336,298.0,102.0,5,659,55379.25,379.0,131.8
2078.0,17,4,344,2,150,0.0,75.0,75.0,2,194,0.0,103.0,97.0
326.0,17,2,174,1,79,0.0,79.0,79.0,1,95,0.0,95.0,95.0
371921.0,6,3,1604,2,851,0.0,785.0,425.5,1,753,0.0,753.0,753.0
122232.0,6,3,373,2,238,0.0,172.0,119.0,1,135,0.0,135.0,135.0
0.0,6,1,66,1,66,0.0,66.0,66.0,0,0,0.0,0.0,0.0
118453099.0,17,13,821,7,432,19666831.33333333,174.0,61.71428571428572,6,389,19801561.2,174.0,64.83333333333333
106338738.0,6,234,26898,117,18954,914856.2672413794,300.0,162.0,117,7944,914852.7931034482,140.0,67.8974358974359
602403.0,6,4,508,2,238,0.0,172.0,119.0,2,270,0.0,135.0,135.0
120126886.0,6,13,2020,9,1204,15015860.75,188.0,133.77777777777777,4,816,30042416.666666668,204.0,204.0
135892181.0,17,14,864,7,432,19334709.0,174.0,61.71428571428572,7,432,19333496.83333333,174.0,61.71428571428572
44525.0,6,14,4740,7,653,7160.833333333333,249.0,93.28571428571428,7,4087,7260.0,1514.0,583.8571428571429
19739.0,6,20,7606,11,978,1973.9,310.0,88.9090909090909,9,6628,2188.0,1514.0,736.4444444444445
3008076.0,6,11,2106,6,598,601450.0,252.0,99.66666666666669,5,1508,1848.75,1236.0,301.6
210214.0,6,10,1949,5,441,52335.25,169.0,88.2,5,1508,4156.25,1236.0,301.6
302396.0,6,6,412,4,272,100798.66666666669,74.0,68.0,2,140,0.0,74.0,70.0
228161.0,17,2,180,1,90,0.0,90.0,90.0,1,90,0.0,90.0,90.0
110503515.0,6,20,1490,10,745,12278168.333333334,95.0,74.5,10,745,12250346.666666666,95.0,74.5
45808.0,6,14,4740,7,653,7506.833333333333,249.0,93.28571428571428,7,4087,6457.5,1514.0,583.8571428571429
312480.0,6,6,412,4,272,104160.0,74.0,68.0,2,140,0.0,74.0,70.0
108116390.0,17,5,1005,5,1005,27029097.5,201.0,201.0,0,0,0.0,0.0,0.0
3263179.0,6,5,336,2,134,0.0,68.0,67.0,3,202,1526734.5,70.0,67.33333333333333
302.0,17,2,156,1,78,0.0,78.0,78.0,1,78,0.0,78.0,78.0
64669.00000000001,6,14,4740,7,653,8343.333333333334,249.0,93.28571428571428,7,4087,10563.166666666666,1514.0,583.8571428571429
241080.0,6,4,439,2,238,0.0,172.0,119.0,2,201,0.0,135.0,100.5
120223266.0,6,234,26438,117,8018,1029362.724137931,140.0,68.52991452991454,117,18420,1029127.5603448276,284.0,157.43589743589743
103361592.0,17,14,864,7,432,17166832.333333332,174.0,61.71428571428572,7,432,17167339.5,174.0,61.71428571428572
0.0,17,1,342,1,342,0.0,342.0,342.0,0,0,0.0,0.0,0.0
2020.0,17,4,344,2,150,0.0,75.0,75.0,2,194,0.0,103.0,97.0
77199.0,6,14,4740,7,653,12495.5,249.0,93.28571428571428,7,4087,9369.5,1514.0,583.8571428571429
1574.0,17,2,762,2,762,0.0,381.0,381.0,0,0,0.0,0.0,0.0
302491.0,6,6,412,4,272,100830.33333333331,74.0,68.0,2,140,0.0,74.0,70.0
2805767.0,6,2,132,1,66,0.0,66.0,66.0,1,66,0.0,66.0,66.0
116304667.0,6,221,24966,111,7548,1057315.1545454543,140.0,68.0,110,17418,1057533.7889908256,284.0,158.34545454545454
118043017.0,6,32,2220,16,1149,7869534.466666667,123.0,71.8125,16,1071,7855103.2,123.0,66.9375
3052741.0,6,3,1604,2,851,0.0,785.0,425.5,1,753,0.0,753.0,753.0
120122590.0,6,13,2020,9,1204,15015323.75,188.0,133.77777777777777,4,816,30033711.666666668,204.0,204.0
15649.0,6,12,1393,6,796,2956.4,271.0,132.66666666666666,6,597,2444.0,259.0,99.5
242178.0,6,3,337,2,214,0.0,160.0,107.0,1,123,0.0,123.0,123.0
2794345.0,6,2,132,1,66,0.0,66.0,66.0,1,66,0.0,66.0,66.0
329940.0,6,10,1221,6,636,65988.0,298.0,106.0,4,585,104234.0,379.0,146.25
13089.0,6,10,2032,5,524,3061.75,252.0,104.8,5,1508,3009.0,1236.0,301.6
103001102.0,17,13,1083,7,563,17166850.333333332,174.0,80.42857142857143,6,520,16601574.4,174.0,86.66666666666667
120007895.0,6,20,1863,11,1172,12000789.5,427.0,106.54545454545456,9,691,14944831.5,95.0,76.77777777777777
115491429.0,6,48,3168,24,1584,5021366.478260869,66.0,66.0,24,1584,5008277.652173913,66.0,66.0
48819.0,6,10,2032,5,524,11794.0,252.0,104.8,5,1508,10592.5,1236.0,301.6
47325.0,6,10,2032,5,524,11493.75,252.0,104.8,5,1508,10833.5,1236.0,301.6
323.0,17,2,160,1,80,0.0,80.0,80.0,1,80,0.0,80.0,80.0
90256704.0,6,14,2240,8,1016,12893814.857142856,188.0,127.0,6,1224,18018216.4,204.0,204.0
331.0,17,2,267,1,83,0.0,83.0,83.0,1,184,0.0,184.0,184.0
120024240.0,17,29,13785,29,13785,4286580.0,501.0,475.3448275862069,0,0,0.0,0.0,0.0
95786553.0,17,14,4796,13,4446,6226961.833333333,342.0,342.0,1,350,0.0,350.0,350.0
99081460.0,6,298,35590,149,10056,669341.4662162162,140.0,67.48993288590604,149,25534,669434.9797297297,374.0,171.36912751677852
298321.0,6,6,412,4,272,99440.33333333331,74.0,68.0,2,140,0.0,74.0,70.0
50041.0,6,11,2098,6,590,9885.8,252.0,98.33333333333331,5,1508,8782.75,1236.0,301.6
126204017.0,6,35,2410,18,1285,7423765.705882353,139.0,71.38888888888889,17,1125,7250919.375,123.0,66.17647058823529
216827.0,17,2,180,1,90,0.0,90.0,90.0,1,90,0.0,90.0,90.0
1256810.0,17,7,490,7,490,209468.3333333333,70.0,70.0,0,0,0.0,0.0,0.0
241814.0,6,3,373,2,238,0.0,172.0,119.0,1,135,0.0,135.0,135.0
493838.0,6,5,336,2,134,0.0,68.0,67.0,3,202,195954.0,70.0,67.33333333333333
90031957.0,17,28,13364,28,13364,3334516.925925926,501.0,477.2857142857143,0,0,0.0,0.0,0.0
13746.0,6,10,2032,5,524,2962.75,252.0,104.8,5,1508,2862.75,1236.0,301.6
36643.0,6,13,1479,7,882,6107.166666666667,291.0,126.0,6,597,6467.2,259.0,99.5
135135213.0,17,6,1206,6,1206,27027042.6,201.0,201.0,0,0,0.0,0.0,0.0
74536.0,6,14,4740,7,653,12061.166666666666,249.0,93.28571428571428,7,4087,11491.333333333334,1514.0,583.8571428571429
95999025.0,6,171,19272,86,5898,1129400.294117647,140.0,68.5813953488372,85,13374,1130590.6904761903,284.0,157.34117647058824
3439.0,17,2,359,1,75,0.0,75.0,75.0,1,284,0.0,284.0,284.0
14631271.0,6,20,1648,10,1016,1592333.0,315.0,101.6,10,632,1592241.4444444445,78.0,63.2
15500.0,6,11,2098,6,590,2743.8,252.0,98.33333333333331,5,1508,3567.75,1236.0,301.6
153551.0,17,2,180,1,90,0.0,90.0,90.0,1,90,0.0,90.0,90.0
113520149.0,6,46,3036,23,1518,5159994.090909091,66.0,66.0,23,1518,5159994.818181818,66.0,66.0
35180683.0,6,7,1874,3,887,17515430.0,753.0,295.6666666666667,4,987,11679044.0,785.0,246.75
23955.0,6,14,4740,7,653,3288.1666666666665,249.0,93.28571428571428,7,4087,3854.5,1514.0,583.8571428571429
117358959.0,6,229,25854,115,7812,1029464.552631579,140.0,67.9304347826087,114,18042,1029385.6106194692,284.0,158.26315789473685
0.0,17,1,72,1,72,0.0,72.0,72.0,0,0,0.0,0.0,0.0
90256878.0,6,14,2240,8,1016,12893839.714285716,188.0,127.0,6,1224,18018391.4,204.0,204.0
298908.0,6,6,412,4,272,99636.0,74.0,68.0,2,140,0.0,74.0,70.0
146826.0,6,3,337,2,214,0.0,160.0,107.0,1,123,0.0,123.0,123.0
2254954.0,6,49,23728,25,19797,93956.41666666669,1514.0,791.88,24,3931,88770.65217391304,1514.0,163.79166666666666
108098516.0,17,5,1005,5,1005,27024629.0,201.0,201.0,0,0,0.0,0.0,0.0
105411615.0,6,30,2106,15,1089,7513981.857142857,123.0,72.6,15,1017,7513979.428571428,123.0,67.8
298.0,17,2,164,1,82,0.0,82.0,82.0,1,82,0.0,82.0,82.0
113613388.0,6,46,3036,23,1518,5150445.0,66.0,66.0,23,1518,5150443.909090909,66.0,66.0
107310.0,17,2,286,2,286,0.0,143.0,143.0,0,0,0.0,0.0,0.0
494.0,17,2,166,1,83,0.0,83.0,83.0,1,83,0.0,83.0,83.0
100727.0,17,2,762,2,762,0.0,381.0,381.0,0,0,0.0,0.0,0.0
10446470.0,6,7,478,4,272,3435498.6666666665,74.0,68.0,3,206,5153158.0,74.0,68.66666666666667
4331.0,17,2,598,1,72,0.0,72.0,72.0,1,526,0.0,526.0,526.0
0.0,17,1,55,1,55,0.0,55.0,55.0,0,0,0.0,0.0,0.0
102789.0,17,2,286,2,286,0.0,143.0,143.0,0,0,0.0,0.0,0.0
114835939.0,6,48,3168,24,1584,4992866.913043479,66.0,66.0,24,1584,4983470.826086956,66.0,66.0
32527.0,6,10,2032,5,524,7895.25,252.0,104.8,5,1508,7545.0,1236.0,301.6
217861.0,6,3,426,2,280,0.0,214.0,140.0,1,146,0.0,146.0,146.0
5623877.0,6,4,270,2,134,0.0,68.0,67.0,2,136,0.0,70.0,68.0
215407.0,6,14,4740,7,653,29341.33333333333,249.0,93.28571428571428,7,4087,33863.0,1514.0,583.8571428571429
115497145.0,6,29,2058,16,1149,7683596.266666667,123.0,71.8125,13,909,7940147.5,123.0,69.92307692307692
161818.0,6,3,337,2,214,0.0,160.0,107.0,1,123,0.0,123.0,123.0
121269.0,6,3,337,2,214,0.0,160.0,107.0,1,123,0.0,123.0,123.0
108080434.0,17,5,955,5,955,27020108.5,191.0,191.0,0,0,0.0,0.0,0.0
62227.0,6,14,4740,7,653,9645.166666666666,249.0,93.28571428571428,7,4087,9157.0,1514.0,583.8571428571429
145826.0,6,10,1066,5,490,36243.75,218.0,98.0,5,576,33906.5,304.0,115.2
323660.0,17,4,1400,4,1400,107886.66666666669,350.0,350.0,0,0,0.0,0.0,0.0
108101854.0,17,5,1005,5,1005,27025463.5,201.0,201.0,0,0,0.0,0.0,0.0
41058.0,6,14,4740,7,653,6605.0,249.0,93.28571428571428,7,4087,6692.5,1514.0,583.8571428571429
1168731.0,6,13,3011,8,2383,166961.57142857142,1514.0,297.875,5,628,223223.0,331.0,125.6
90027737.0,17,27,12943,27,12943,3462605.269230769,501.0,479.3703703703704,0,0,0.0,0.0,0.0
108106734.0,17,5,955,5,955,27026683.5,191.0,191.0,0,0,0.0,0.0,0.0
115304271.0,6,47,3102,23,1518,5144008.045454546,66.0,66.0,24,1584,5013218.130434782,66.0,66.0
989.0,17,2,3028,2,3028,0.0,1514.0,1514.0,0,0,0.0,0.0,0.0
235752.0,6,3,337,2,214,0.0,160.0,107.0,1,123,0.0,123.0,123.0
23886.0,17,4,344,2,150,0.0,75.0,75.0,2,194,0.0,103.0,97.0
217688.0,6,3,426,2,280,0.0,214.0,140.0,1,146,0.0,146.0,146.0
92637034.0,17,14,1126,7,563,15439505.666666666,174.0,80.42857142857143,7,563,15352434.666666666,174.0,80.42857142857143
2807201.0,6,2,132,1,66,0.0,66.0,66.0,1,66,0.0,66.0,66.0
93805022.0,17,12,778,6,389,18728818.2,174.0,64.83333333333333,6,389,18625254.2,174.0,64.83333333333333
135530.0,6,2,132,1,66,0.0,66.0,66.0,1,66,0.0,66.0,66.0
73983.0,6,12,1328,6,731,12949.4,253.0,121.83333333333331,6,597,13473.4,259.0,99.5
207688.0,17,2,762,2,762,0.0,381.0,381.0,0,0,0.0,0.0,0.0
108864896.0,6,31,2166,16,1149,7243269.866666666,123.0,71.8125,15,1017,7760645.571428572,123.0,67.8
108104414.0,17,5,955,5,955,27026103.5,191.0,191.0,0,0,0.0,0.0,0.0
146744.0,17,4,704,2,148,0.0,74.0,74.0,2,556,0.0,280.0,278.0
97564.0,17,2,762,2,762,0.0,381.0,381.0,0,0,0.0,0.0,0.0
249943.0,17,4,6056,4,6056,83314.33333333333,1514.0,1514.0,0,0,0.0,0.0,0.0
16697.0,6,14,4740,7,653,2600.0,249.0,93.28571428571428,7,4087,2497.833333333333,1514.0,583.8571428571429
228285.0,17,2,180,1,90,0.0,90.0,90.0,1,90,0.0,90.0,90.0
93801565.0,6,164,18552,82,5646,1135090.4567901234,140.0,68.85365853658537,82,12906,1148084.8395061728,284.0,157.390243902439
0.0,17,1,44,1,44,0.0,44.0,44.0,0,0,0.0,0.0,0.0
245658.0,6,3,337,2,214,0.0,160.0,107.0,1,123,0.0,123.0,123.0
5625818.0,6,5,336,2,134,0.0,68.0,67.0,3,202,1422387.5,70.0,67.33333333333333
108123387.0,17,5,955,5,955,27030846.75,191.0,191.0,0,0,0.0,0.0,0.0
90060003.0,17,28,13364,28,13364,3335555.6666666665,501.0,477.2857142857143,0,0,0.0,0.0,0.0
164822.0,17,2,414,1,88,0.0,88.0,88.0,1,326,0.0,326.0,326.0
3109709.0,6,157,122022,87,113100,36159.40697674418,1510.0,1300.0,70,8922,40600.811594202896,1510.0,127.45714285714286
864429.0,6,9,1267,6,796,172885.8,458.0,132.66666666666666,3,471,294463.5,331.0,157.0
90038668.0,17,28,13364,28,13364,3334765.4814814813,501.0,477.2857142857143,0,0,0.0,0.0,0.0
2392471.0,6,50,23782,26,19851,95698.84,1514.0,763.5,24,3931,94168.43478260867,1514.0,163.79166666666666
215983.0,17,2,180,1,90,0.0,90.0,90.0,1,90,0.0,90.0,90.0
119829508.0,6,14,2102,5,1020,29956475.0,204.0,204.0,9,1082,14978376.875,188.0,120.22222222222224
135128108.0,17,6,1146,6,1146,27025621.6,191.0,191.0,0,0,0.0,0.0,0.0
135126031.0,17,6,1206,6,1206,27025206.2,201.0,201.0,0,0,0.0,0.0,0.0
310496.0,6,12,1373,7,714,51749.333333333336,298.0,102.0,5,659,73421.0,379.0,131.8
24018862.0,17,3,1034,2,684,0.0,342.0,342.0,1,350,0.0,350.0,350.0
0.0,17,1,342,1,342,0.0,342.0,342.0,0,0,0.0,0.0,0.0
309.0,17,2,174,1,79,0.0,79.0,79.0,1,95,0.0,95.0,95.0
5726317.0,6,5,336,2,134,0.0,68.0,67.0,3,202,1523476.5,70.0,67.33333333333333
432812.0,6,12,1373,7,714,72135.33333333333,298.0,102.0,5,659,107121.5,379.0,131.8
309014.0,6,6,412,4,272,103004.66666666669,74.0,68.0,2,140,0.0,74.0,70.0
90054058.0,17,28,13364,28,13364,3335335.4814814813,501.0,477.2857142857143,0,0,0.0,0.0,0.0
503326.00000000006,6,5,336,2,134,0.0,68.0,67.0,3,202,198334.5,70.0,67.33333333333333
306804.0,6,6,412,4,272,102268.0,74.0,68.0,2,140,0.0,74.0,70.0
106317.0,17,2,700,2,700,0.0,350.0,350.0,0,0,0.0,0.0,0.0
33439.0,6,14,4740,7,653,5054.166666666667,249.0,93.28571428571428,7,4087,5436.666666666667,1514.0,583.8571428571429
51399.0,6,11,2098,6,590,10016.4,252.0,98.33333333333331,5,1508,12195.5,1236.0,301.6
415794.0,6,2,132,1,66,0.0,66.0,66.0,1,66,0.0,66.0,66.0
217515.0,6,10,1221,6,636,43503.0,298.0,106.0,4,585,71641.33333333333,379.0,146.25
120043146.0,17,29,13785,29,13785,4287255.214285715,501.0,475.3448275862069,0,0,0.0,0.0,0.0
419479.0,17,2,762,2,762,0.0,381.0,381.0,0,0,0.0,0.0,0.0
103664768.0,6,43,2838,22,1452,4926136.571428572,66.0,66.0,21,1386,5105435.7,66.0,66.0
188880.0,6,14,4740,7,653,30182.666666666668,249.0,93.28571428571428,7,4087,29820.5,1514.0,583.8571428571429
83547208.0,17,14,4796,13,4446,6378853.166666667,342.0,342.0,1,350,0.0,350.0,350.0
120010695.0,6,18,1341,9,691,14999979.75,95.0,76.77777777777777,9,650,15000894.25,95.0,72.22222222222223
38387.0,6,14,4740,7,653,5943.333333333333,249.0,93.28571428571428,7,4087,6181.166666666667,1514.0,583.8571428571429
45105.0,6,14,4740,7,653,7349.666666666667,249.0,93.28571428571428,7,4087,7123.833333333333,1514.0,583.8571428571429
4389.0,17,2,598,1,72,0.0,72.0,72.0,1,526,0.0,526.0,526.0
219624.0,6,4,504,3,358,109812.0,214.0,119.33333333333331,1,146,0.0,146.0,146.0
108122750.0,17,5,955,5,955,27030687.5,191.0,191.0,0,0,0.0,0.0,0.0
359.0,17,2,267,1,83,0.0,83.0,83.0,1,184,0.0,184.0,184.0
4422.0,17,2,614,1,72,0.0,72.0,72.0,1,542,0.0,542.0,542.0
41640.0,6,14,4740,7,653,6515.833333333333,249.0,93.28571428571428,7,4087,6483.333333333333,1514.0,583.8571428571429
0.0,17,1,453,1,453,0.0,453.0,453.0,0,0,0.0,0.0,0.0
120191619.0,6,220,24756,110,7482,1095059.1376146788,140.0,68.01818181818182,110,17274,1095046.1376146788,284.0,157.03636363636363
29209.0,6,14,4740,7,653,3578.833333333333,249.0,93.28571428571428,7,4087,4678.166666666667,1514.0,583.8571428571429
120042077.0,17,29,13785,29,13785,4287217.035714285,501.0,475.3448275862069,0,0,0.0,0.0,0.0
90255053.0,6,12,1832,8,1016,12893579.0,188.0,127.0,4,816,30028726.33333333,204.0,204.0
119407153.0,6,47,3102,24,1584,5191603.869565218,66.0,66.0,23,1518,5160000.454545454,66.0,66.0
39471.0,6,14,4740,7,653,6375.0,249.0,93.28571428571428,7,4087,6339.166666666667,1514.0,583.8571428571429
6522.0,17,4,344,2,150,0.0,75.0,75.0,2,194,0.0,103.0,97.0
24026513.0,17,3,1026,3,1026,12013256.5,342.0,342.0,0,0,0.0,0.0,0.0
298499.0,6,6,412,4,272,99499.66666666669,74.0,68.0,2,140,0.0,74.0,70.0
120284714.0,6,206,23346,103,7020,1171096.9215686277,140.0,68.15533980582525,103,16326,1171096.2549019607,284.0,158.50485436893203
120001423.0,6,19,1436,9,691,15000177.875,95.0,76.77777777777777,10,745,13304430.444444444,95.0,74.5
90280847.0,6,16,1192,8,596,12891310.714285716,95.0,74.5,8,596,12896781.857142856,95.0,74.5
120066291.0,17,29,13785,29,13785,4288081.821428572,501.0,475.3448275862069,0,0,0.0,0.0,0.0
48843881.0,6,6,1806,2,819,0.0,753.0,409.5,4,987,15285242.333333334,785.0,246.75
345.0,17,2,250,1,93,0.0,93.0,93.0,1,157,0.0,157.0,157.0
353651.0,6,6,412,4,272,117883.66666666669,74.0,68.0,2,140,0.0,74.0,70.0
99661550.0,6,29,2046,15,1017,7118682.142857143,123.0,67.8,14,1029,6881602.692307692,123.0,73.5
310094.0,17,4,704,2,148,0.0,74.0,74.0,2,556,0.0,280.0,278.0
120256953.0,6,287,33160,144,23426,840957.7132867132,284.0,162.68055555555554,143,9734,832826.485915493,140.0,68.06993006993007
122011101.0,17,15,907,8,475,17430157.285714287,174.0,59.375,7,432,17000179.5,174.0,61.71428571428572
125602259.0,6,32,2157,16,1071,7707813.6,123.0,66.9375,16,1086,8373353.2,123.0,67.875
137850.0,17,4,344,2,150,0.0,75.0,75.0,2,194,0.0,103.0,97.0
135127683.0,17,6,1206,6,1206,27025536.6,201.0,201.0,0,0,0.0,0.0,0.0
217342.0,17,2,180,1,90,0.0,90.0,90.0,1,90,0.0,90.0,90.0
239804.0,6,3,337,2,214,0.0,160.0,107.0,1,123,0.0,123.0,123.0
97412218.0,6,26,1762,13,922,8099680.583333333,139.0,70.92307692307692,13,840,8099688.5,123.0,64.61538461538461
91703223.0,17,16,5472,16,5472,6113548.2,342.0,342.0,0,0,0.0,0.0,0.0
30055.0,6,10,2032,5,524,7044.0,252.0,104.8,5,1508,6504.25,1236.0,301.6
1302377.0,6,4,264,2,132,0.0,66.0,66.0,2,132,0.0,66.0,66.0
54596.0,6,10,2032,5,524,12822.0,252.0,104.8,5,1508,13288.75,1236.0,301.6
244009.0,6,3,337,2,214,0.0,160.0,107.0,1,123,0.0,123.0,123.0
56705.0,6,14,4740,7,653,7686.166666666667,249.0,93.28571428571428,7,4087,8083.666666666667,1514.0,583.8571428571429
299664.0,6,6,412,4,272,99888.0,74.0,68.0,2,140,0.0,74.0,70.0
133012028.0,17,17,1255,9,649,16626503.5,174.0,72.11111111111111,8,606,16130927.0,174.0,75.75
297383.0,6,6,412,4,272,99127.66666666669,74.0,68.0,2,140,0.0,74.0,70.0
67323.0,6,11,2098,6,590,12330.8,252.0,98.33333333333331,5,1508,16146.75,1236.0,301.6
2265.0,17,2,508,2,508,0.0,257.0,254.0,0,0,0.0,0.0,0.0
108106532.0,17,5,1005,5,1005,27026633.0,201.0,201.0,0,0,0.0,0.0,0.0
165735.0,6,13,1394,7,797,27622.5,253.0,113.85714285714286,6,597,32148.6,259.0,99.5
208635.0,17,2,762,2,762,0.0,381.0,381.0,0,0,0.0,0.0,0.0
90746799.0,6,17,1287,9,691,11337407.0,95.0,76.77777777777777,8,596,12962982.714285716,95.0,74.5
58318.0,6,14,4740,7,653,7544.166666666667,249.0,93.28571428571428,7,4087,7789.5,1514.0,583.8571428571429
39708.0,6,14,4740,7,653,5481.5,249.0,93.28571428571428,7,4087,6249.333333333333,1514.0,583.8571428571429
10260.0,6,10,1067,5,536,2098.5,264.0,107.2,5,531,2317.0,259.0,106.2
108104404.0,17,5,955,5,955,27026101.0,191.0,191.0,0,0,0.0,0.0,0.0
310059.0,6,6,412,4,272,103353.0,74.0,68.0,2,140,0.0,74.0,70.0
120016658.0,17,28,13364,28,13364,4445061.407407408,501.0,477.2857142857143,0,0,0.0,0.0,0.0
108104814.0,17,5,955,5,955,27026203.5,191.0,191.0,0,0,0.0,0.0,0.0
90947367.0,6,19,1436,9,691,11368420.875,95.0,76.77777777777777,10,745,10076448.333333334,95.0,74.5
79363.0,6,10,2032,5,524,18961.5,252.0,104.8,5,1508,9217.25,1236.0,301.6
119979545.0,6,30,2276,17,1287,7497975.75,95.0,75.70588235294117,13,989,9978440.416666666,95.0,76.07692307692308
211370.0,6,4,492,2,280,0.0,214.0,140.0,2,212,0.0,146.0,106.0
316866.0,17,4,1400,4,1400,105622.0,350.0,350.0,0,0,0.0,0.0,0.0
2618519.0,6,2,132,1,66,0.0,66.0,66.0,1,66,0.0,66.0,66.0
5624181.0,6,4,270,2,134,0.0,68.0,67.0,2,136,0.0,70.0,68.0
1153830.0,6,13,3010,8,2382,164832.85714285713,1514.0,297.75,5,628,220221.5,331.0,125.6
120160389.0,6,263,30062,132,21194,917254.8778625954,284.0,160.56060606060606,131,8868,918158.676923077,140.0,67.69465648854961
65664.0,6,14,4740,7,653,10526.0,249.0,93.28571428571428,7,4087,10398.333333333334,1514.0,583.8571428571429
197145.0,17,2,180,1,90,0.0,90.0,90.0,1,90,0.0,90.0,90.0
216874.0,17,2,180,1,90,0.0,90.0,90.0,1,90,0.0,90.0,90.0
233917.0,6,3,337,2,214,0.0,160.0,107.0,1,123,0.0,123.0,123.0
2590975.0,6,2,132,1,66,0.0,66.0,66.0,1,66,0.0,66.0,66.0
403141.0,6,4,508,2,238,0.0,172.0,119.0,2,270,0.0,135.0,135.0
113496489.0,6,47,3102,24,1584,4922795.260869565,66.0,66.0,23,1518,5135443.5,66.0,66.0
21704.0,6,14,4740,7,653,3306.6666666666665,249.0,93.28571428571428,7,4087,2887.1666666666665,1514.0,583.8571428571429
101940625.0,6,197,22142,99,6830,1040210.4591836736,140.0,68.98989898989899,98,15312,1041448.2474226804,284.0,156.24489795918367
121400.0,6,3,337,2,214,0.0,160.0,107.0,1,123,0.0,123.0,123.0
37750249.0,17,9,3078,9,3078,4718781.125,342.0,342.0,0,0,0.0,0.0,0.0
102026572.0,6,197,22338,99,15648,1041087.4693877551,284.0,158.06060606060606,98,6690,1041146.8762886598,140.0,68.26530612244898
115174791.0,6,48,3168,24,1584,5007599.608695652,66.0,66.0,24,1584,4994017.652173913,66.0,66.0
260039.00000000003,6,10,1221,6,636,52007.8,298.0,106.0,4,585,80832.0,379.0,146.25
29744.0,6,14,4740,7,653,4465.333333333333,249.0,93.28571428571428,7,4087,4707.666666666667,1514.0,583.8571428571429
108108538.0,17,5,1005,5,1005,27027134.5,201.0,201.0,0,0,0.0,0.0,0.0
108098935.0,17,5,1005,5,1005,27024733.75,201.0,201.0,0,0,0.0,0.0,0.0
90228934.0,6,16,1192,8,596,12855900.142857144,95.0,74.5,8,596,12860584.0,95.0,74.5
3777824.0,6,5,336,2,134,0.0,68.0,67.0,3,202,1525949.0,70.0,67.33333333333333
2057762.0,6,2,132,1,66,0.0,66.0,66.0,1,66,0.0,66.0,66.0
0.0,6,1,66,1,66,0.0,66.0,66.0,0,0,0.0,0.0,0.0
101797.0,17,2,762,2,762,0.0,381.0,381.0,0,0,0.0,0.0,0.0
19575.0,6,14,4740,7,653,3130.6666666666665,249.0,93.28571428571428,7,4087,3040.1666666666665,1514.0,583.8571428571429
1878.0,17,2,192,1,88,0.0,88.0,88.0,1,104,0.0,104.0,104.0
3112104.0,6,3,1777,1,826,0.0,826.0,826.0,2,951,0.0,885.0,475.5
120129617.0,6,14,2102,6,1086,24025923.4,204.0,181.0,8,1016,17137798.42857143,188.0,127.0
90089739.0,6,10,1440,7,828,15014956.5,188.0,118.28571428571428,3,612,30029002.0,204.0,204.0
90261304.0,6,12,1832,8,1016,12894472.0,188.0,127.0,4,816,30031981.33333333,204.0,204.0
249441.0,17,2,180,1,90,0.0,90.0,90.0,1,90,0.0,90.0,90.0
313701.0,17,4,1400,4,1400,104567.0,350.0,350.0,0,0,0.0,0.0,0.0
106103249.0,6,239,27234,120,8142,891623.9411764706,140.0,67.85,119,19092,891204.6610169491,284.0,160.43697478991598
307872.0,6,6,412,4,272,102624.0,74.0,68.0,2,140,0.0,74.0,70.0
13618190.0,6,20,1648,10,1016,1479105.888888889,315.0,101.6,10,632,1479076.888888889,78.0,63.2
143889.0,17,2,180,1,90,0.0,90.0,90.0,1,90,0.0,90.0,90.0
209345.0,17,2,180,1,90,0.0,90.0,90.0,1,90,0.0,90.0,90.0
120569.0,6,3,337,2,214,0.0,160.0,107.0,1,123,0.0,123.0,123.0
276088.0,17,4,823,2,163,0.0,89.0,81.5,2,660,0.0,443.0,330.0
196772.0,17,2,180,1,90,0.0,90.0,90.0,1,90,0.0,90.0,90.0
153344.0,17,2,180,1,90,0.0,90.0,90.0,1,90,0.0,90.0,90.0
108105280.0,17,5,955,5,955,27026320.0,191.0,191.0,0,0,0.0,0.0,0.0
35507.0,6,2,145,2,145,0.0,91.0,72.5,0,0,0.0,0.0,0.0
2322.0,17,4,344,2,150,0.0,75.0,75.0,2,194,0.0,103.0,97.0
171779.0,17,2,180,1,90,0.0,90.0,90.0,1,90,0.0,90.0,90.0
90214474.0,6,16,1192,8,596,12851739.285714284,95.0,74.5,8,596,12856475.285714284,95.0,74.5
871679.0,6,10,1262,6,725,174335.8,387.0,120.83333333333331,4,537,198480.3333333333,331.0,134.25
24630.0,6,14,4740,7,653,3678.6666666666665,249.0,93.28571428571428,7,4087,3924.1666666666665,1514.0,583.8571428571429
93206609.0,6,40,2640,20,1320,4905611.0,66.0,66.0,20,1320,4894236.684210527,66.0,66.0
14126568.0,6,20,1607,10,975,1535561.5555555555,315.0,97.5,10,632,1535536.888888889,78.0,63.2
5824951.0,6,5,336,2,134,0.0,68.0,67.0,3,202,1523179.5,70.0,67.33333333333333
1840240.0,6,20,7599,11,1469,184024.0,583.0,133.54545454545453,9,6130,198443.625,1484.0,681.1111111111111
113520374.0,6,46,3036,23,1518,5160005.909090909,66.0,66.0,23,1518,5160005.363636363,66.0,66.0
120179189.0,6,224,25200,112,7688,1076158.5495495496,140.0,68.64285714285714,112,17512,1076401.1351351351,284.0,156.35714285714286
34955.0,6,10,2032,5,524,8433.5,252.0,104.8,5,1508,8049.0,1236.0,301.6
310501.0,6,6,412,4,272,103500.33333333331,74.0,68.0,2,140,0.0,74.0,70.0
309098.0,6,6,412,4,272,103032.66666666669,74.0,68.0,2,140,0.0,74.0,70.0
20099.0,6,14,4740,7,653,3074.333333333333,249.0,93.28571428571428,7,4087,3218.833333333333,1514.0,583.8571428571429
90032034.0,17,28,13364,28,13364,3334519.777777778,501.0,477.2857142857143,0,0,0.0,0.0,0.0
113812807.0,17,14,864,7,432,18836667.5,174.0,61.71428571428572,7,432,18833496.166666668,174.0,61.71428571428572
1388260.0,17,16,1120,16,1120,92550.66666666669,70.0,70.0,0,0,0.0,0.0,0.0
265190.0,6,3,337,2,214,0.0,160.0,107.0,1,123,0.0,123.0,123.0
54043.0,6,14,4740,7,653,8548.333333333334,249.0,93.28571428571428,7,4087,7215.333333333333,1514.0,583.8571428571429
120697.0,17,4,1400,4,1400,40232.333333333336,350.0,350.0,0,0,0.0,0.0,0.0
32885589.000000004,6,5,336,2,134,0.0,68.0,67.0,3,202,15050118.0,70.0,67.33333333333333
105224.0,17,2,286,2,286,0.0,143.0,143.0,0,0,0.0,0.0,0.0
255215.00000000003,6,3,337,2,214,0.0,160.0,107.0,1,123,0.0,123.0,123.0
26586.0,6,14,4740,7,653,4131.333333333333,249.0,93.28571428571428,7,4087,3792.6666666666665,1514.0,583.8571428571429
103155.0,17,2,286,2,286,0.0,143.0,143.0,0,0,0.0,0.0,0.0
127281828.0,17,14,864,7,432,18000392.0,174.0,61.71428571428572,7,432,18000224.833333332,174.0,61.71428571428572
32305.0,6,10,1065,5,534,7887.75,262.0,106.8,5,531,7616.25,259.0,106.2
1176967.0,6,13,3011,8,2383,168138.14285714287,1514.0,297.875,5,628,226098.0,331.0,125.6
108102731.0,17,5,955,5,955,27025682.75,191.0,191.0,0,0,0.0,0.0,0.0
135134234.0,17,6,1206,6,1206,27026846.8,201.0,201.0,0,0,0.0,0.0,0.0
122984743.0,6,48,3168,24,1584,5000284.913043479,66.0,66.0,24,1584,5267212.391304348,66.0,66.0
317.0,17,2,174,1,79,0.0,79.0,79.0,1,95,0.0,95.0,95.0
53539.0,6,10,2032,5,524,12176.0,252.0,104.8,5,1508,12418.5,1236.0,301.6
1177174.0,6,13,3010,8,2382,168167.7142857143,1514.0,297.75,5,628,226115.0,331.0,125.6
120000121.0,6,20,1853,11,1203,12000012.1,256.0,109.36363636363636,9,650,12992591.5,95.0,72.22222222222223
319147.0,17,4,1400,4,1400,106382.33333333331,350.0,350.0,0,0,0.0,0.0,0.0
4335.0,17,2,598,1,72,0.0,72.0,72.0,1,526,0.0,526.0,526.0
44124.0,6,10,2032,5,524,10794.25,252.0,104.8,5,1508,10874.0,1236.0,301.6
222718.0,17,2,231,1,78,0.0,78.0,78.0,1,153,0.0,153.0,153.0
150.0,17,2,700,2,700,0.0,350.0,350.0,0,0,0.0,0.0,0.0
120117920.0,6,15,2444,7,1428,20019653.33333333,204.0,204.0,8,1016,17097837.85714286,188.0,127.0
96138595.0,6,196,22452,98,15762,988901.824742268,284.0,160.83673469387756,98,6690,988896.8041237112,140.0,68.26530612244898
114459422.0,6,29,1914,15,948,8175673.0,123.0,63.2,14,966,8019730.230769231,123.0,69.0
4959.0,17,4,344,2,150,0.0,75.0,75.0,2,194,0.0,103.0,97.0
33721561.0,6,5,336,2,134,0.0,68.0,67.0,3,202,15470481.0,70.0,67.33333333333333
105464012.0,6,224,25396,112,17782,948188.2612612612,284.0,158.76785714285714,112,7614,948188.2342342342,140.0,67.98214285714286
205060.0,17,2,180,1,90,0.0,90.0,90.0,1,90,0.0,90.0,90.0
218715.0,17,2,180,1,90,0.0,90.0,90.0,1,90,0.0,90.0,90.0
2524015.0,6,25,7573,14,3735,194155.0,1514.0,266.7857142857143,11,3838,225644.6,1514.0,348.90909090909093
873379.0,6,12,2709,7,742,145563.16666666666,338.0,106.0,5,1967,149437.25,1514.0,393.4
12024.0,17,2,571,1,86,0.0,86.0,86.0,1,485,0.0,485.0,485.0
125221.0,17,2,876,2,876,0.0,438.0,438.0,0,0,0.0,0.0,0.0
116714.0,17,4,1400,4,1400,38904.66666666666,350.0,350.0,0,0,0.0,0.0,0.0
311527.0,17,4,1400,4,1400,103842.33333333331,350.0,350.0,0,0,0.0,0.0,0.0
90253917.0,6,15,2444,8,1016,12893416.714285716,188.0,127.0,7,1428,15014771.5,204.0,204.0
33569.0,6,10,2032,5,524,8162.75,252.0,104.8,5,1508,8099.25,1236.0,301.6
128276.0,17,4,1524,4,1524,42758.66666666666,381.0,381.0,0,0,0.0,0.0,0.0
108105736.0,17,5,955,5,955,27026434.0,191.0,191.0,0,0,0.0,0.0,0.0
90757509.0,6,19,1436,9,691,11344688.625,95.0,76.77777777777777,10,745,10051108.333333334,95.0,74.5
345.0,17,2,250,1,93,0.0,93.0,93.0,1,157,0.0,157.0,157.0
4255.0,17,2,602,1,72,0.0,72.0,72.0,1,530,0.0,530.0,530.0
14469.0,6,10,2032,5,524,3397.0,252.0,104.8,5,1508,3372.5,1236.0,301.6
29069.0,6,14,4740,7,653,3385.333333333333,249.0,93.28571428571428,7,4087,4701.5,1514.0,583.8571428571429
299191.0,6,6,412,4,272,99730.33333333331,74.0,68.0,2,140,0.0,74.0,70.0
302091.0,6,6,412,4,272,100697.0,74.0,68.0,2,140,0.0,74.0,70.0
26380.0,6,14,4740,7,653,3716.3333333333335,249.0,93.28571428571428,7,4087,4237.833333333333,1514.0,583.8571428571429
318036.0,17,4,1400,4,1400,106012.0,350.0,350.0,0,0,0.0,0.0,0.0
123840018.0,6,49,3234,25,1650,5160000.75,66.0,66.0,24,1584,4998379.304347826,66.0,66.0
126066164.0,6,31,2034,16,1086,8404410.933333334,123.0,67.875,15,948,8275989.5,123.0,63.2
7514.0,17,2,582,1,83,0.0,83.0,83.0,1,499,0.0,499.0,499.0
26985.0,6,10,2032,5,524,5942.5,252.0,104.8,5,1508,6167.25,1236.0,301.6
10477544.0,6,6,412,3,206,5170315.5,74.0,68.66666666666667,3,206,5170209.0,74.0,68.66666666666667
108112746.0,17,5,955,5,955,27028186.5,191.0,191.0,0,0,0.0,0.0,0.0
12140.0,6,10,1067,5,536,2850.0,264.0,107.2,5,531,2101.0,259.0,106.2
210813.0,17,2,414,1,88,0.0,88.0,88.0,1,326,0.0,326.0,326.0
1174432.0,6,13,3010,8,2382,167776.0,1514.0,297.75,5,628,224664.25,331.0,125.6
305331.0,6,6,412,4,272,101777.0,74.0,68.0,2,140,0.0,74.0,70.0
2085801.0,6,4,492,2,280,0.0,214.0,140.0,2,212,0.0,146.0,106.0
90301829.0,6,16,1192,8,596,12893875.57142857,95.0,74.5,8,596,12898906.0,95.0,74.5
106125046.0,6,322,39048,161,10848,658116.925,140.0,67.37888198757764,161,28200,663155.23125,284.0,175.1552795031056
352480.0,6,6,412,4,272,117493.33333333331,74.0,68.0,2,140,0.0,74.0,70.0
15025149.0,17,6,2052,6,2052,3005029.8,342.0,342.0,0,0,0.0,0.0,0.0
20419.0,6,10,2032,5,524,4894.0,252.0,104.8,5,1508,4774.0,1236.0,301.6
162285.0,17,2,180,1,90,0.0,90.0,90.0,1,90,0.0,90.0,90.0
370.0,17,2,204,1,88,0.0,88.0,88.0,1,116,0.0,116.0,116.0
155053.0,6,3,337,2,214,0.0,160.0,107.0,1,123,0.0,123.0,123.0
317.0,17,2,174,1,79,0.0,79.0,79.0,1,95,0.0,95.0,95.0
43857.0,6,14,4740,7,653,7018.833333333333,249.0,93.28571428571428,7,4087,6914.166666666667,1514.0,583.8571428571429
9047.0,17,2,539,1,86,0.0,86.0,86.0,1,453,0.0,453.0,453.0
115617634.0,6,48,3168,24,1584,5026853.652173913,66.0,66.0,24,1584,5013430.782608695,66.0,66.0
9282.0,17,2,414,1,88,0.0,88.0,88.0,1,326,0.0,326.0,326.0
123730715.0,6,49,3234,25,1650,5155446.458333333,66.0,66.0,24,1584,5124693.913043479,66.0,66.0
16011.999999999998,6,14,4740,7,653,2559.0,249.0,93.28571428571428,7,4087,2528.833333333333,1514.0,583.8571428571429
249488.0,6,3,337,2,214,0.0,160.0,107.0,1,123,0.0,123.0,123.0
1183911.0,6,11,1134,6,558,236782.2,220.0,93.0,5,576,294675.75,304.0,115.2
74675197.0,6,9,1479,9,1479,9334399.625,172.0,164.33333333333334,0,0,0.0,0.0,0.0
2054.0,17,4,344,2,150,0.0,75.0,75.0,2,194,0.0,103.0,97.0
148029.0,17,2,180,1,90,0.0,90.0,90.0,1,90,0.0,90.0,90.0
22096.0,6,10,2032,5,524,4780.0,252.0,104.8,5,1508,5187.0,1236.0,301.6
111358272.0,6,226,25550,113,17796,992348.7678571428,284.0,157.4867256637168,113,7754,992348.7857142856,140.0,68.61946902654867
228370.0,17,2,180,1,90,0.0,90.0,90.0,1,90,0.0,90.0,90.0
672281.0,6,10,1065,5,534,167841.25,262.0,106.8,5,531,167715.0,259.0,106.2
310492.0,17,4,1400,4,1400,103497.33333333331,350.0,350.0,0,0,0.0,0.0,0.0
35301.0,6,14,4740,7,653,4660.333333333333,249.0,93.28571428571428,7,4087,5691.333333333333,1514.0,583.8571428571429
249493.0,6,3,337,2,214,0.0,160.0,107.0,1,123,0.0,123.0,123.0
31291.0,6,10,2032,5,524,6862.25,252.0,104.8,5,1508,7322.25,1236.0,301.6
120354680.0,6,38,2779,20,1531,6334456.842105263,139.0,76.55,18,1248,6986758.94117647,123.0,69.33333333333333
90302711.0,6,16,1192,8,596,12893703.42857143,95.0,74.5,8,596,12899811.714285716,95.0,74.5
205996.0,17,2,180,1,90,0.0,90.0,90.0,1,90,0.0,90.0,90.0
216413.0,17,2,180,1,90,0.0,90.0,90.0,1,90,0.0,90.0,90.0
13610484.0,6,20,1605,10,973,1478693.888888889,315.0,97.3,10,632,1478666.3333333333,78.0,63.2
204046.0,6,10,1221,6,636,40809.2,298.0,106.0,4,585,65503.333333333336,379.0,146.25
18586.0,6,14,4740,7,653,2485.5,249.0,93.28571428571428,7,4087,2958.0,1514.0,583.8571428571429
197064.0,17,2,180,1,90,0.0,90.0,90.0,1,90,0.0,90.0,90.0
17171.0,17,2,180,1,90,0.0,90.0,90.0,1,90,0.0,90.0,90.0
111106062.0,17,14,864,7,432,18501019.83333333,174.0,61.71428571428572,7,432,18500166.666666668,174.0,61.71428571428572
40339.0,6,10,2032,5,524,8360.75,252.0,104.8,5,1508,9658.75,1236.0,301.6
1031394.0,6,11,1134,6,558,206278.8,220.0,93.0,5,576,255016.0,304.0,115.2
120244482.0,6,204,22980,102,7028,1172127.6336633663,140.0,68.90196078431373,102,15952,1183576.9108910891,284.0,156.3921568627451
113168289.0,6,46,3036,23,1518,5144001.5,66.0,66.0,23,1518,5144001.545454546,66.0,66.0
21647.0,17,2,582,1,83,0.0,83.0,83.0,1,499,0.0,499.0,499.0
31986.0,6,14,4740,7,653,5164.0,249.0,93.28571428571428,7,4087,4562.0,1514.0,583.8571428571429
45230.0,6,14,4740,7,653,7377.833333333333,249.0,93.28571428571428,7,4087,6169.0,1514.0,583.8571428571429
16493.0,6,14,4740,7,653,2628.333333333333,249.0,93.28571428571428,7,4087,2604.1666666666665,1514.0,583.8571428571429
2923.0,17,2,224,1,76,0.0,76.0,76.0,1,148,0.0,148.0,148.0
234004.0,6,3,373,2,238,0.0,172.0,119.0,1,135,0.0,135.0,135.0
500140.0,6,4,270,2,134,0.0,68.0,67.0,2,136,0.0,70.0,68.0
0.0,17,1,381,1,381,0.0,381.0,381.0,0,0,0.0,0.0,0.0
303347.0,6,6,412,4,272,101115.66666666669,74.0,68.0,2,140,0.0,74.0,70.0
108108914.0,17,5,955,5,955,27027228.5,191.0,191.0,0,0,0.0,0.0,0.0
27898.0,6,14,4740,7,653,4223.0,249.0,93.28571428571428,7,4087,4126.666666666667,1514.0,583.8571428571429
206031.0,6,3,426,2,280,0.0,214.0,140.0,1,146,0.0,146.0,146.0
217044.0,6,3,426,2,280,0.0,214.0,140.0,1,146,0.0,146.0,146.0
143881.0,17,2,180,1,90,0.0,90.0,90.0,1,90,0.0,90.0,90.0
336.0,17,2,166,1,75,0.0,75.0,75.0,1,91,0.0,91.0,91.0
2428.0,17,4,344,2,150,0.0,75.0,75.0,2,194,0.0,103.0,97.0
474107.0,6,3,1604,2,851,0.0,785.0,425.5,1,753,0.0,753.0,753.0
219558.0,6,3,426,2,280,0.0,214.0,140.0,1,146,0.0,146.0,146.0
103004622.0,17,13,821,7,432,17167437.0,174.0,61.71428571428572,6,389,16600161.8,174.0,64.83333333333333
10527206.0,6,7,478,4,272,3463235.0,74.0,68.0,3,206,5194719.0,74.0,68.66666666666667
123610506.0,6,49,3234,25,1650,5150437.75,66.0,66.0,24,1584,5110741.782608695,66.0,66.0
96604221.0,6,40,2640,20,1320,5084432.684210527,66.0,66.0,20,1320,5068137.894736842,66.0,66.0
196996.0,17,2,180,1,90,0.0,90.0,90.0,1,90,0.0,90.0,90.0
90294637.0,6,22,1921,11,799,9025136.2,95.0,72.63636363636364,11,1122,9028425.9,340.0,102.0
187632.0,17,2,180,1,90,0.0,90.0,90.0,1,90,0.0,90.0,90.0
2426.0,17,4,344,2,150,0.0,75.0,75.0,2,194,0.0,103.0,97.0
14968.0,17,2,180,1,90,0.0,90.0,90.0,1,90,0.0,90.0,90.0
90308232.0,6,16,1192,8,596,12894743.285714284,95.0,74.5,8,596,12900610.714285716,95.0,74.5
209434.0,17,2,180,1,90,0.0,90.0,90.0,1,90,0.0,90.0,90.0
105514584.0,6,34,2482,17,1288,6594661.5,139.0,75.76470588235294,17,1194,6581131.6875,123.0,70.23529411764706
135133777.0,17,6,1206,6,1206,27026755.4,201.0,201.0,0,0,0.0,0.0,0.0
153497.0,17,2,180,1,90,0.0,90.0,90.0,1,90,0.0,90.0,90.0
101180837.0,6,185,20842,93,6360,1099791.706521739,140.0,68.38709677419355,92,14482,1100614.6923076925,284.0,157.41304347826087
228454.0,17,2,180,1,90,0.0,90.0,90.0,1,90,0.0,90.0,90.0
6807.0,17,2,582,1,83,0.0,83.0,83.0,1,499,0.0,499.0,499.0
281284.0,17,2,363,1,79,0.0,79.0,79.0,1,284,0.0,284.0,284.0
165823.0,17,2,180,1,90,0.0,90.0,90.0,1,90,0.0,90.0,90.0
75125077.0,6,9,842,9,842,9390634.625,97.0,93.55555555555556,0,0,0.0,0.0,0.0
772908.0,6,2,132,1,66,0.0,66.0,66.0,1,66,0.0,66.0,66.0
2909223.0,6,2,132,1,66,0.0,66.0,66.0,1,66,0.0,66.0,66.0
2016.0,17,4,344,2,150,0.0,75.0,75.0,2,194,0.0,103.0,97.0
6142.0,6,5,578,3,438,1969.5,298.0,146.0,2,140,0.0,74.0,70.0
2274.0,17,4,344,2,150,0.0,75.0,75.0,2,194,0.0,103.0,97.0
24019906.0,17,3,1026,3,1026,12009953.0,342.0,342.0,0,0,0.0,0.0,0.0
108085306.0,17,5,1005,5,1005,27021326.5,201.0,201.0,0,0,0.0,0.0,0.0
13691.0,6,11,1133,6,602,2608.6,264.0,100.33333333333331,5,531,2523.0,259.0,106.2
135152481.0,17,6,1146,6,1146,27030496.2,191.0,191.0,0,0,0.0,0.0,0.0
103828578.0,17,14,1126,7,563,17278279.166666668,174.0,80.42857142857143,7,563,17280992.333333332,174.0,80.42857142857143
135136671.0,17,6,1206,6,1206,27027334.2,201.0,201.0,0,0,0.0,0.0,0.0
5827758.0,6,5,336,2,134,0.0,68.0,67.0,3,202,1526071.5,70.0,67.33333333333333
1810.0,17,2,176,1,80,0.0,80.0,80.0,1,96,0.0,96.0,96.0
106807.0,17,2,286,2,286,0.0,143.0,143.0,0,0,0.0,0.0,0.0
120434894.0,6,19,1477,11,881,12043489.4,95.0,80.0909090909091,8,596,17038626.14285714,95.0,74.5
103929461.0,17,14,864,7,432,17167642.333333332,174.0,61.71428571428572,7,432,17166826.666666668,174.0,61.71428571428572
216589.0,17,2,180,1,90,0.0,90.0,90.0,1,90,0.0,90.0,90.0
2051.0,17,4,344,2,150,0.0,75.0,75.0,2,194,0.0,103.0,97.0
214577.0,6,10,1221,6,636,42915.4,298.0,106.0,4,585,70128.66666666667,379.0,146.25
232516.0,6,3,337,2,214,0.0,160.0,107.0,1,123,0.0,123.0,123.0
322231.0,17,4,1400,4,1400,107410.33333333331,350.0,350.0,0,0,0.0,0.0,0.0
26535.0,6,14,4740,7,653,3719.3333333333335,249.0,93.28571428571428,7,4087,4255.0,1514.0,583.8571428571429
90249687.0,6,14,1043,7,501,15041614.5,95.0,71.57142857142857,7,542,15004080.666666666,95.0,77.42857142857143
3438.0,17,2,414,1,88,0.0,88.0,88.0,1,326,0.0,326.0,326.0
10417570.0,6,6,412,3,206,5141172.0,74.0,68.66666666666667,3,206,5140894.5,74.0,68.66666666666667
420.0,17,2,410,1,78,0.0,78.0,78.0,1,332,0.0,332.0,332.0
2341.0,17,4,344,2,150,0.0,75.0,75.0,2,194,0.0,103.0,97.0
31881.0,6,13,4519,6,512,6244.6,230.0,85.33333333333333,7,4007,4887.833333333333,1514.0,572.4285714285714
809.0,17,4,438,2,148,0.0,74.0,74.0,2,290,0.0,147.0,145.0
90045849.0,17,27,12943,27,12943,3463301.8846153845,501.0,479.3703703703704,0,0,0.0,0.0,0.0
228261.0,17,2,180,1,90,0.0,90.0,90.0,1,90,0.0,90.0,90.0
90051891.0,17,28,13364,28,13364,3335255.222222222,501.0,477.2857142857143,0,0,0.0,0.0,0.0
108800657.0,6,32,2220,16,1149,7238996.733333333,123.0,71.8125,16,1071,7238996.133333334,123.0,66.9375
30685.0,6,14,4740,7,653,4507.333333333333,249.0,93.28571428571428,7,4087,4975.666666666667,1514.0,583.8571428571429
4130.0,6,2,132,1,66,0.0,66.0,66.0,1,66,0.0,66.0,66.0
102992.0,17,2,286,2,286,0.0,143.0,143.0,0,0,0.0,0.0,0.0
120803652.0,6,34,2356,18,1285,7106097.176470588,139.0,71.38888888888889,16,1071,6707660.466666667,123.0,66.9375
213045.0,17,2,414,1,88,0.0,88.0,88.0,1,326,0.0,326.0,326.0
178334.0,17,4,1524,4,1524,59444.66666666666,381.0,381.0,0,0,0.0,0.0,0.0
120284.0,17,2,180,1,70,0.0,70.0,70.0,1,110,0.0,110.0,110.0
17054.0,6,2,145,2,145,0.0,91.0,72.5,0,0,0.0,0.0,0.0
230700.0,17,2,359,1,75,0.0,75.0,75.0,1,284,0.0,284.0,284.0
2596905.0,6,2,132,1,66,0.0,66.0,66.0,1,66,0.0,66.0,66.0
30107.0,6,14,4740,7,653,4747.333333333333,249.0,93.28571428571428,7,4087,4799.166666666667,1514.0,583.8571428571429
251103.00000000003,6,3,337,2,214,0.0,160.0,107.0,1,123,0.0,123.0,123.0
116133896.0,6,48,3168,24,1584,5049299.826086956,66.0,66.0,24,1584,5035718.347826087,66.0,66.0
120393047.0,6,2454,2126472,1693,2076234,71154.28309692671,1514.0,1226.3638511518016,761,50238,157798.53684210527,78.0,66.01576872536137
920125.0,17,6,1230,3,234,459881.0,78.0,78.0,3,996,459851.0,332.0,332.0
217983.0,6,3,426,2,280,0.0,214.0,140.0,1,146,0.0,146.0,146.0
120239088.0,6,23,1734,11,840,11999642.9,95.0,76.36363636363636,12,894,10909088.181818182,95.0,74.5
298410.0,6,6,412,4,272,99470.0,74.0,68.0,2,140,0.0,74.0,70.0
3051436.0,6,3,204,1,68,0.0,68.0,68.0,2,136,0.0,70.0,68.0
9188.0,17,2,582,1,83,0.0,83.0,83.0,1,499,0.0,499.0,499.0
117716489.0,6,47,3102,24,1584,5118096.304347826,66.0,66.0,23,1518,5111996.0,66.0,66.0
389.0,17,2,762,2,762,0.0,381.0,381.0,0,0,0.0,0.0,0.0
228461.0,17,2,180,1,90,0.0,90.0,90.0,1,90,0.0,90.0,90.0
104184551.0,6,44,2904,22,1452,4961169.095238095,66.0,66.0,22,1452,4950873.761904762,66.0,66.0
45403.0,6,14,4740,7,653,7325.833333333333,249.0,93.28571428571428,7,4087,7090.333333333333,1514.0,583.8571428571429
105762.0,17,2,286,2,286,0.0,143.0,143.0,0,0,0.0,0.0,0.0
18233.0,6,14,4740,7,653,2754.6666666666665,249.0,93.28571428571428,7,4087,2277.0,1514.0,583.8571428571429
234447.0,6,3,337,2,214,0.0,160.0,107.0,1,123,0.0,123.0,123.0
108104628.0,17,5,955,5,955,27026157.0,191.0,191.0,0,0,0.0,0.0,0.0
302449.0,6,2,132,1,66,0.0,66.0,66.0,1,66,0.0,66.0,66.0
344.0,17,2,208,1,72,0.0,72.0,72.0,1,136,0.0,136.0,136.0
90264566.0,6,13,2036,8,1016,12894938.0,188.0,127.0,5,1020,22524211.5,204.0,204.0
15108.0,6,14,4740,7,653,2382.0,249.0,93.28571428571428,7,4087,2368.5,1514.0,583.8571428571429
29989.0,6,14,4740,7,653,4870.166666666667,249.0,93.28571428571428,7,4087,4858.833333333333,1514.0,583.8571428571429
90030595.0,17,28,13364,28,13364,3334466.4814814813,501.0,477.2857142857143,0,0,0.0,0.0,0.0
128863318.0,6,35,2394,18,1269,7580195.176470588,123.0,70.5,17,1125,7416347.6875,123.0,66.17647058823529
95476397.0,17,15,5138,14,4788,5731557.384615385,342.0,342.0,1,350,0.0,350.0,350.0
10508081.0,6,7,478,4,272,3457423.6666666665,74.0,68.0,3,206,5186033.5,74.0,68.66666666666667
235413.0,6,3,337,2,214,0.0,160.0,107.0,1,123,0.0,123.0,123.0
1115296.0,6,4,264,3,198,532965.5,66.0,66.0,1,66,0.0,66.0,66.0
90302246.0,6,20,1531,10,786,10028644.777777778,95.0,78.6,10,745,10000519.111111112,95.0,74.5
18800.0,6,11,2098,6,590,3104.6,252.0,98.33333333333331,5,1508,4240.5,1236.0,301.6
38385.0,6,10,2032,5,524,8186.75,252.0,104.8,5,1508,8875.5,1236.0,301.6
363160.0,6,10,967,5,390,61051.5,162.0,78.0,5,577,60990.5,349.0,115.4
0.0,6,1,172,1,172,0.0,172.0,172.0,0,0,0.0,0.0,0.0
295.0,17,2,156,1,78,0.0,78.0,78.0,1,78,0.0,78.0,78.0
158772.0,6,3,337,2,214,0.0,160.0,107.0,1,123,0.0,123.0,123.0
398909.0,6,10,1221,6,636,79781.8,298.0,106.0,4,585,132041.33333333334,379.0,146.25
97273382.0,6,228,26470,114,18724,859015.8318584071,336.0,164.24561403508773,114,7746,859013.1681415929,140.0,67.94736842105263
10924394.0,6,8,544,4,272,3595575.0,74.0,68.0,4,272,3595508.6666666665,74.0,68.0
14647703.0,6,19,1553,9,921,1791963.875,315.0,102.33333333333331,10,632,1592840.3333333333,78.0,63.2
120168386.0,6,466,91062,233,75240,517038.974137931,1514.0,322.9184549356223,233,15822,517038.6163793103,214.0,67.90557939914163
143892.0,17,2,180,1,90,0.0,90.0,90.0,1,90,0.0,90.0,90.0
90295868.0,6,16,1192,8,596,12891843.142857144,95.0,74.5,8,596,12898770.285714284,95.0,74.5
146148.0,6,3,337,2,214,0.0,160.0,107.0,1,123,0.0,123.0,123.0
203118.0,6,10,1221,6,636,40623.6,298.0,106.0,4,585,66784.0,379.0,146.25
310951.0,17,4,704,2,148,0.0,74.0,74.0,2,556,0.0,280.0,278.0
120408026.0,6,235,26696,118,18740,1029128.4273504274,284.0,158.8135593220339,117,7956,1029940.7672413794,140.0,68.0
9682.0,17,2,582,1,83,0.0,83.0,83.0,1,499,0.0,499.0,499.0
82.0,17,2,762,2,762,0.0,381.0,381.0,0,0,0.0,0.0,0.0
152027.0,6,2,132,1,66,0.0,66.0,66.0,1,66,0.0,66.0,66.0
2386538.0,6,3,204,2,136,0.0,70.0,68.0,1,68,0.0,68.0,68.0
525.0,17,2,508,2,508,0.0,257.0,254.0,0,0,0.0,0.0,0.0
34742.0,6,12,1320,6,723,6110.4,253.0,120.5,6,597,5061.2,259.0,99.5
152.0,17,2,700,2,700,0.0,350.0,350.0,0,0,0.0,0.0,0.0
25516.0,6,14,4740,7,653,4141.333333333333,249.0,93.28571428571428,7,4087,4115.5,1514.0,583.8571428571429
315318.0,17,4,1400,4,1400,105106.0,350.0,350.0,0,0,0.0,0.0,0.0
32289.0,6,14,4740,7,653,5193.5,249.0,93.28571428571428,7,4087,4916.833333333333,1514.0,583.8571428571429
207120.0,6,3,426,2,280,0.0,214.0,140.0,1,146,0.0,146.0,146.0
90301528.0,6,16,1192,8,596,12893606.857142856,95.0,74.5,8,596,12899557.714285716,95.0,74.5
108101088.0,17,5,955,5,955,27025272.0,191.0,191.0,0,0,0.0,0.0,0.0
90076624.0,6,11,1644,4,816,30024754.0,204.0,204.0,7,828,15012362.5,188.0,118.28571428571428
209432.0,17,2,180,1,90,0.0,90.0,90.0,1,90,0.0,90.0,90.0
787.0,17,5,550,5,550,196.75,110.0,110.0,0,0,0.0,0.0,0.0
10508287.0,6,7,478,4,272,3457081.333333333,74.0,68.0,3,206,5185524.0,74.0,68.66666666666667
102495.0,17,2,286,2,286,0.0,143.0,143.0,0,0,0.0,0.0,0.0
90259099.0,6,13,1898,8,1016,12894157.0,188.0,127.0,5,882,22524475.0,204.0,176.4
90258166.0,6,13,2036,8,1016,12894023.714285716,188.0,127.0,5,1020,22523581.0,204.0,204.0
3012608.0,6,11,1139,6,608,602030.4,262.0,101.33333333333331,5,531,3236.5,259.0,106.2
866966.0,6,9,1267,6,796,173393.2,458.0,132.66666666666666,3,471,295646.5,331.0,157.0
897695.0,6,12,2708,7,742,149615.83333333334,338.0,106.0,5,1966,155540.5,1514.0,393.2
44396.0,6,2,132,1,66,0.0,66.0,66.0,1,66,0.0,66.0,66.0
30743.0,6,14,4740,7,653,4190.333333333333,249.0,93.28571428571428,7,4087,4486.333333333333,1514.0,583.8571428571429
242351.0,6,3,373,2,238,0.0,172.0,119.0,1,135,0.0,135.0,135.0
330977.0,6,6,412,4,272,110325.66666666669,74.0,68.0,2,140,0.0,74.0,70.0
74593582.0,6,9,842,9,842,9324197.75,97.0,93.55555555555556,0,0,0.0,0.0,0.0
4391.0,17,2,614,1,72,0.0,72.0,72.0,1,542,0.0,542.0,542.0
2450.0,17,4,344,2,150,0.0,75.0,75.0,2,194,0.0,103.0,97.0
90038041.0,17,28,13364,28,13364,3334742.25925926,501.0,477.2857142857143,0,0,0.0,0.0,0.0
102880.0,17,2,286,2,286,0.0,143.0,143.0,0,0,0.0,0.0,0.0
217828.0,6,3,426,2,280,0.0,214.0,140.0,1,146,0.0,146.0,146.0
107615.0,17,2,286,2,286,0.0,143.0,143.0,0,0,0.0,0.0,0.0
129317594.0,6,34,2340,18,1269,7606917.294117647,123.0,70.5,16,1071,7941179.266666667,123.0,66.9375
160124.0,17,2,180,1,90,0.0,90.0,90.0,1,90,0.0,90.0,90.0
10161.0,17,2,414,1,88,0.0,88.0,88.0,1,326,0.0,326.0,326.0
2450.0,17,4,344,2,150,0.0,75.0,75.0,2,194,0.0,103.0,97.0
305616.0,6,6,412,4,272,101872.0,74.0,68.0,2,140,0.0,74.0,70.0
115837.0,6,14,4740,7,653,14201.333333333334,249.0,93.28571428571428,7,4087,15651.166666666666,1514.0,583.8571428571429
147990.0,17,2,180,1,90,0.0,90.0,90.0,1,90,0.0,90.0,90.0
216945.0,17,2,180,1,90,0.0,90.0,90.0,1,90,0.0,90.0,90.0
831.0,17,2,508,2,508,0.0,257.0,254.0,0,0,0.0,0.0,0.0
9038.0,6,10,2032,5,524,2021.25,252.0,104.8,5,1508,1988.0,1236.0,301.6
113168315.0,6,46,3036,23,1518,5144002.545454546,66.0,66.0,23,1518,5144003.181818182,66.0,66.0
309228.0,17,4,1400,4,1400,103076.0,350.0,350.0,0,0,0.0,0.0,0.0
45323.0,6,10,2032,5,524,10570.25,252.0,104.8,5,1508,7251.5,1236.0,301.6
90055866.0,17,28,13364,28,13364,3335402.4444444445,501.0,477.2857142857143,0,0,0.0,0.0,0.0
2792840.0,6,2,132,1,66,0.0,66.0,66.0,1,66,0.0,66.0,66.0
2333.0,17,4,344,2,150,0.0,75.0,75.0,2,194,0.0,103.0,97.0
52227.0,6,10,2032,5,524,12819.5,252.0,104.8,5,1508,11114.25,1236.0,301.6
146284.0,6,3,337,2,214,0.0,160.0,107.0,1,123,0.0,123.0,123.0
24727.0,6,10,2032,5,524,5499.75,252.0,104.8,5,1508,5591.0,1236.0,301.6
119100320.0,17,13,821,6,389,19984429.4,174.0,64.83333333333333,7,432,19834269.5,174.0,61.71428571428572
59126.0,6,14,4740,7,653,9330.333333333334,249.0,93.28571428571428,7,4087,8427.833333333334,1514.0,583.8571428571429
232072.0,17,4,1524,4,1524,77357.33333333333,381.0,381.0,0,0,0.0,0.0,0.0
119803054.0,6,231,26134,116,18248,1041765.6869565216,284.0,157.31034482758622,115,7886,1042805.596491228,140.0,68.57391304347826
2312.0,17,4,344,2,150,0.0,75.0,75.0,2,194,0.0,103.0,97.0
2334.0,17,4,344,2,150,0.0,75.0,75.0,2,194,0.0,103.0,97.0
90266789.0,6,13,2036,8,1016,12895255.57142857,188.0,127.0,5,1020,22525514.5,204.0,204.0
109360082.0,6,216,24312,108,16888,1020046.4485981308,284.0,156.37037037037038,108,7424,1020045.8037383178,140.0,68.74074074074075
298.0,17,2,168,1,76,0.0,76.0,76.0,1,92,0.0,92.0,92.0
7398.0,17,4,344,2,150,0.0,75.0,75.0,2,194,0.0,103.0,97.0
153416.0,17,2,180,1,90,0.0,90.0,90.0,1,90,0.0,90.0,90.0
153520.0,17,2,180,1,90,0.0,90.0,90.0,1,90,0.0,90.0,90.0
319.0,17,2,174,1,79,0.0,79.0,79.0,1,95,0.0,95.0,95.0
228333.0,17,2,180,1,90,0.0,90.0,90.0,1,90,0.0,90.0,90.0
133471.0,6,2,132,1,66,0.0,66.0,66.0,1,66,0.0,66.0,66.0
49165.0,6,14,4740,7,653,8062.833333333333,249.0,93.28571428571428,7,4087,7736.5,1514.0,583.8571428571429
109190.0,17,2,286,2,286,0.0,143.0,143.0,0,0,0.0,0.0,0.0
120121344.0,6,228,25718,114,7820,1056288.9203539824,140.0,68.59649122807018,114,17898,1055739.9911504425,284.0,157.0
90260107.0,6,13,2036,8,1016,12894301.0,188.0,127.0,5,1020,22523421.0,204.0,204.0
103395.0,17,2,700,2,700,0.0,350.0,350.0,0,0,0.0,0.0,0.0
332.0,17,2,164,1,82,0.0,82.0,82.0,1,82,0.0,82.0,82.0
90301526.0,6,16,1192,8,596,12894069.42857143,95.0,74.5,8,596,12897152.0,95.0,74.5
298381.0,6,6,412,4,272,99460.33333333331,74.0,68.0,2,140,0.0,74.0,70.0
849891.0,6,9,1096,6,625,169978.2,287.0,104.16666666666669,3,471,288723.0,331.0,157.0
537.0,17,4,6056,4,6056,179.0,1514.0,1514.0,0,0,0.0,0.0,0.0
213733.0,17,2,180,1,90,0.0,90.0,90.0,1,90,0.0,90.0,90.0
123413876.0,6,30,1974,15,948,8102088.285714285,123.0,63.2,15,1026,8102077.214285715,123.0,68.4
311270.0,17,4,1400,4,1400,103756.66666666669,350.0,350.0,0,0,0.0,0.0,0.0
16540.0,6,14,4740,7,653,2365.6666666666665,249.0,93.28571428571428,7,4087,2525.833333333333,1514.0,583.8571428571429
839845.0,6,9,1196,6,725,167969.0,387.0,120.83333333333331,3,471,283601.0,331.0,157.0
0.0,17,1,90,1,90,0.0,90.0,90.0,0,0,0.0,0.0,0.0
153319.0,17,2,180,1,90,0.0,90.0,90.0,1,90,0.0,90.0,90.0
92710042.0,6,38,2508,19,1254,5135443.166666667,66.0,66.0,19,1254,5135437.5,66.0,66.0
146810.0,6,3,337,2,214,0.0,160.0,107.0,1,123,0.0,123.0,123.0
204244.0,17,2,762,2,762,0.0,381.0,381.0,0,0,0.0,0.0,0.0
135127850.0,17,6,1146,6,1146,27025570.0,191.0,191.0,0,0,0.0,0.0,0.0
2081267.0,6,19,6869,11,1567,208126.7,408.0,142.45454545454547,8,5302,234907.8571428572,1514.0,662.75
187084.0,17,2,180,1,90,0.0,90.0,90.0,1,90,0.0,90.0,90.0
1735205.0,6,20,7599,11,1469,173520.5,583.0,133.54545454545453,9,6130,184576.125,1484.0,681.1111111111111
196912.0,17,2,180,1,90,0.0,90.0,90.0,1,90,0.0,90.0,90.0
79670.0,6,14,4740,7,653,13124.833333333334,249.0,93.28571428571428,7,4087,12963.166666666666,1514.0,583.8571428571429
21618.0,6,20,7606,11,978,2161.8,310.0,88.9090909090909,9,6628,2414.625,1514.0,736.4444444444445
143835.0,17,2,180,1,90,0.0,90.0,90.0,1,90,0.0,90.0,90.0
146266.0,6,3,337,2,214,0.0,160.0,107.0,1,123,0.0,123.0,123.0
108104528.0,17,5,955,5,955,27026132.0,191.0,191.0,0,0,0.0,0.0,0.0
90298231.0,6,16,1192,8,596,12892343.714285716,95.0,74.5,8,596,12899129.142857144,95.0,74.5
2034010.0,6,25,7610,13,2516,169500.83333333334,1034.0,193.53846153846155,12,5094,157789.18181818182,1510.0,424.5
2148164.0,6,25,7611,13,2516,179013.66666666666,1034.0,193.53846153846155,12,5095,166779.0,1510.0,424.5833333333333
233725.0,6,3,337,2,214,0.0,160.0,107.0,1,123,0.0,123.0,123.0
52890.0,6,14,4740,7,653,8585.833333333334,249.0,93.28571428571428,7,4087,8001.833333333333,1514.0,583.8571428571429
90054312.0,17,27,12943,27,12943,3463627.3846153845,501.0,479.3703703703704,0,0,0.0,0.0,0.0
120140568.0,6,14,2240,6,1224,24028113.6,204.0,204.0,8,1016,17137205.14285714,188.0,127.0
148020.0,17,2,180,1,90,0.0,90.0,90.0,1,90,0.0,90.0,90.0
38043.0,6,14,4740,7,653,5504.166666666667,249.0,93.28571428571428,7,4087,6086.333333333333,1514.0,583.8571428571429
22969.0,6,10,2032,5,524,5082.25,252.0,104.8,5,1508,3983.25,1236.0,301.6
1313741.0,6,4,264,2,132,0.0,66.0,66.0,2,132,0.0,66.0,66.0
90020518.0,17,28,13364,28,13364,3334093.25925926,501.0,477.2857142857143,0,0,0.0,0.0,0.0
217718.0,6,3,426,2,280,0.0,214.0,140.0,1,146,0.0,146.0,146.0
103199.0,17,2,286,2,286,0.0,143.0,143.0,0,0,0.0,0.0,0.0
262.0,17,3,1050,3,1050,131.0,350.0,350.0,0,0,0.0,0.0,0.0
302352.0,6,2,132,1,66,0.0,66.0,66.0,1,66,0.0,66.0,66.0
108110932.0,17,5,955,5,955,27027733.0,191.0,191.0,0,0,0.0,0.0,0.0
119603304.0,6,32,2236,16,1165,7959162.8,139.0,72.8125,16,1071,7959161.466666667,123.0,66.9375
330159.0,6,12,1373,7,714,55026.5,298.0,102.0,5,659,77204.0,379.0,131.8
751511.0,6,2,132,1,66,0.0,66.0,66.0,1,66,0.0,66.0,66.0
55517.0,6,14,4740,7,653,9130.0,249.0,93.28571428571428,7,4087,7409.166666666667,1514.0,583.8571428571429
381131.0,17,2,346,1,78,0.0,78.0,78.0,1,268,0.0,268.0,268.0
280382.0,17,2,363,1,79,0.0,79.0,79.0,1,284,0.0,284.0,284.0
114240.0,17,4,1400,4,1400,38080.0,350.0,350.0,0,0,0.0,0.0,0.0
120051768.0,17,28,13364,28,13364,4446361.777777778,501.0,477.2857142857143,0,0,0.0,0.0,0.0
3169101.0,6,17,1441,8,867,409686.4285714286,315.0,108.375,9,574,358428.125,78.0,63.77777777777778
52484.0,6,14,4740,7,653,8615.666666666666,249.0,93.28571428571428,7,4087,8527.0,1514.0,583.8571428571429
302259.0,6,6,412,4,272,100753.0,74.0,68.0,2,140,0.0,74.0,70.0
142246.0,6,11,1132,6,556,28022.8,218.0,92.66666666666669,5,576,34750.25,304.0,115.2
103183535.0,17,14,864,7,432,17166824.333333332,174.0,61.71428571428572,7,432,17167520.666666668,174.0,61.71428571428572
310731.0,17,4,1400,4,1400,103577.0,350.0,350.0,0,0,0.0,0.0,0.0
12015.0,6,11,2041,6,533,1737.2,195.0,88.83333333333333,5,1508,2643.5,1236.0,301.6
129104481.0,6,35,2394,18,1269,7594381.235294118,123.0,70.5,17,1125,7431336.4375,123.0,66.17647058823529
37133.0,6,14,4740,7,653,5690.833333333333,249.0,93.28571428571428,7,4087,5902.833333333333,1514.0,583.8571428571429
126169.0,17,4,1524,4,1524,42056.333333333336,381.0,381.0,0,0,0.0,0.0,0.0
205589.0,17,2,180,1,90,0.0,90.0,90.0,1,90,0.0,90.0,90.0
146010.0,6,3,373,2,238,0.0,172.0,119.0,1,135,0.0,135.0,135.0
2926816.0,6,5,336,2,134,0.0,68.0,67.0,3,202,1423951.5,70.0,67.33333333333333
153170.0,17,4,6056,4,6056,51056.66666666666,1514.0,1514.0,0,0,0.0,0.0,0.0
10497749.0,6,7,478,4,272,3452108.333333333,74.0,68.0,3,206,5178073.0,74.0,68.66666666666667
10521879.0,6,7,478,4,272,3460180.0,74.0,68.0,3,206,5190146.0,74.0,68.66666666666667
24313.0,6,14,4740,7,653,3602.0,249.0,93.28571428571428,7,4087,3679.0,1514.0,583.8571428571429
295.0,17,2,156,1,78,0.0,78.0,78.0,1,78,0.0,78.0,78.0
6667.0,17,4,344,2,150,0.0,75.0,75.0,2,194,0.0,103.0,97.0
90737071.0,6,25,1771,13,985,7561422.583333333,139.0,75.76923076923077,12,786,8136813.818181818,123.0,65.5
43687507.0,6,9,1479,9,1479,5460938.375,172.0,164.33333333333334,0,0,0.0,0.0,0.0
153523.0,17,2,180,1,90,0.0,90.0,90.0,1,90,0.0,90.0,90.0
97236057.0,17,13,1083,7,563,16166860.666666666,174.0,80.42857142857143,6,520,15600704.6,174.0,86.66666666666667
92592538.0,6,38,2508,19,1254,5144015.5,66.0,66.0,19,1254,5144014.777777778,66.0,66.0
232547.0,6,3,337,2,214,0.0,160.0,107.0,1,123,0.0,123.0,123.0
371461.0,17,2,180,1,90,0.0,90.0,90.0,1,90,0.0,90.0,90.0
323603.0,17,4,1400,4,1400,107867.66666666669,350.0,350.0,0,0,0.0,0.0,0.0
102158.0,17,2,286,2,286,0.0,143.0,143.0,0,0,0.0,0.0,0.0
756.0,17,4,438,2,148,0.0,74.0,74.0,2,290,0.0,147.0,145.0
296.0,17,2,156,1,78,0.0,78.0,78.0,1,78,0.0,78.0,78.0
95793293.0,6,195,21952,98,6690,987559.7216494846,140.0,68.26530612244898,97,15262,976924.8020833334,284.0,157.340206185567
214650.0,6,3,426,2,280,0.0,214.0,140.0,1,146,0.0,146.0,146.0
159099.0,6,2,128,1,74,0.0,74.0,74.0,1,54,0.0,54.0,54.0
345035.0,6,6,412,4,272,115011.66666666669,74.0,68.0,2,140,0.0,74.0,70.0
135128270.0,17,6,1206,6,1206,27025654.0,201.0,201.0,0,0,0.0,0.0,0.0
120222326.0,6,214,24202,107,7358,1126487.1792452831,140.0,68.76635514018692,107,16844,1126396.650943396,284.0,157.42056074766356
86264.0,6,11,2098,6,590,16465.8,252.0,98.33333333333331,5,1508,20219.25,1236.0,301.6
120248423.0,6,19,1395,10,745,13332984.111111112,95.0,74.5,9,650,14999971.5,95.0,72.22222222222223
326910.0,6,6,412,4,272,108970.0,74.0,68.0,2,140,0.0,74.0,70.0
845.0,17,5,550,5,550,211.25,110.0,110.0,0,0,0.0,0.0,0.0
84246.0,6,14,4740,7,653,13748.833333333334,249.0,93.28571428571428,7,4087,13784.666666666666,1514.0,583.8571428571429
90093415.0,6,12,1848,5,1020,22522770.25,204.0,204.0,7,828,15015161.5,188.0,118.28571428571428
28522.0,6,14,4740,7,653,4639.0,249.0,93.28571428571428,7,4087,3507.6666666666665,1514.0,583.8571428571429
1315573.0,6,4,264,2,132,0.0,66.0,66.0,2,132,0.0,66.0,66.0
120117610.0,6,14,2224,9,1204,15014701.25,188.0,133.77777777777777,5,1020,22590510.5,204.0,204.0
307458.0,6,6,412,4,272,102486.0,74.0,68.0,2,140,0.0,74.0,70.0
27058.0,6,14,4740,7,653,4389.333333333333,249.0,93.28571428571428,7,4087,4378.666666666667,1514.0,583.8571428571429
32311686.0,6,7,1874,3,887,16081978.5,753.0,295.6666666666667,4,987,10711262.0,785.0,246.75
207760.0,6,3,426,2,280,0.0,214.0,140.0,1,146,0.0,146.0,146.0
110127.0,17,4,1400,4,1400,36709.0,350.0,350.0,0,0,0.0,0.0,0.0
3099262.0,6,3,1602,2,850,0.0,784.0,425.0,1,752,0.0,752.0,752.0
212291.0,17,2,180,1,90,0.0,90.0,90.0,1,90,0.0,90.0,90.0
3382.0,17,4,571,2,148,0.0,74.0,74.0,2,423,0.0,280.0,211.5
307651.0,6,6,412,4,272,102550.33333333331,74.0,68.0,2,140,0.0,74.0,70.0
120373880.0,6,221,24912,111,17356,1094308.0,284.0,156.36036036036035,110,7556,1094966.6605504588,140.0,68.69090909090909
510093.0,6,5,336,2,134,0.0,68.0,67.0,3,202,194711.0,70.0,67.33333333333333
112736321.0,6,48,3168,24,1584,4901579.173913044,66.0,66.0,24,1584,4892187.391304348,66.0,66.0
3266.0,17,4,344,2,150,0.0,75.0,75.0,2,194,0.0,103.0,97.0
146235.0,6,3,337,2,214,0.0,160.0,107.0,1,123,0.0,123.0,123.0
90016087.0,17,27,12943,27,12943,3462157.1923076925,501.0,479.3703703703704,0,0,0.0,0.0,0.0
13615082.0,6,20,1607,10,975,1478762.6666666667,315.0,97.5,10,632,1478742.5555555555,78.0,63.2
50427.0,6,10,2032,5,524,12308.0,252.0,104.8,5,1508,12334.5,1236.0,301.6
108117666.0,17,5,1005,5,1005,27029416.5,201.0,201.0,0,0,0.0,0.0,0.0
2050539.0,17,20,7568,20,7568,107923.1052631579,394.0,378.4,0,0,0.0,0.0,0.0
40224.0,6,14,4740,7,653,6578.0,249.0,93.28571428571428,7,4087,5023.333333333333,1514.0,583.8571428571429
1321506.0,6,4,264,2,132,0.0,66.0,66.0,2,132,0.0,66.0,66.0
108104687.0,17,5,1005,5,1005,27026171.75,201.0,201.0,0,0,0.0,0.0,0.0
146485.0,6,3,337,2,214,0.0,160.0,107.0,1,123,0.0,123.0,123.0
32647.000000000004,6,14,4740,7,653,3597.1666666666665,249.0,93.28571428571428,7,4087,5301.666666666667,1514.0,583.8571428571429
39298.0,6,14,4740,7,653,5845.0,249.0,93.28571428571428,7,4087,6259.666666666667,1514.0,583.8571428571429
526179.0,17,6,2100,6,2100,105235.8,350.0,350.0,0,0,0.0,0.0,0.0
16296.000000000002,6,10,2032,5,524,3642.5,252.0,104.8,5,1508,3550.0,1236.0,301.6
31216.0,6,14,4740,7,653,5002.0,249.0,93.28571428571428,7,4087,4957.333333333333,1514.0,583.8571428571429
143900.0,17,2,180,1,90,0.0,90.0,90.0,1,90,0.0,90.0,90.0
304204.0,6,6,412,4,272,101401.33333333331,74.0,68.0,2,140,0.0,74.0,70.0
306024.0,6,6,412,4,272,102008.0,74.0,68.0,2,140,0.0,74.0,70.0
107859746.0,6,28,1860,14,966,8280300.615384615,123.0,69.0,14,894,8280300.846153846,123.0,63.85714285714285
102193754.0,6,413,55272,207,41454,496086.1844660194,300.0,200.2608695652174,206,13818,497434.3804878049,140.0,67.07766990291262
47951.0,6,10,2032,5,524,11000.75,252.0,104.8,5,1508,11247.75,1236.0,301.6
100000844.0,17,11,473,6,258,20000168.8,43.0,43.0,5,215,20000932.25,43.0,43.0
96162857.0,6,58,12223,29,6429,3434387.75,1514.0,221.6896551724137,29,5794,3424914.6071428573,1514.0,199.79310344827587
124959.0,6,11,1132,6,556,24250.6,218.0,92.66666666666669,5,576,31038.25,304.0,115.2
119854714.0,6,14,2102,5,1020,29963097.25,204.0,204.0,9,1082,14981368.0,188.0,120.22222222222224
9005420.0,17,2,160,2,160,0.0,80.0,80.0,0,0,0.0,0.0,0.0
204692.0,17,2,762,2,762,0.0,381.0,381.0,0,0,0.0,0.0,0.0
27463802.0,17,5,1710,5,1710,6865950.5,342.0,342.0,0,0,0.0,0.0,0.0
306535.0,6,6,412,4,272,102178.33333333331,74.0,68.0,2,140,0.0,74.0,70.0
3099436.0,6,157,119616,84,110496,37342.60240963855,1510.0,1315.428571428571,73,9120,38707.875,1510.0,124.93150684931508
24800.0,6,10,2032,5,524,4728.25,252.0,104.8,5,1508,5356.0,1236.0,301.6
84.0,17,2,762,2,762,0.0,381.0,381.0,0,0,0.0,0.0,0.0
2802453.0,6,2,132,1,66,0.0,66.0,66.0,1,66,0.0,66.0,66.0
2325.0,17,4,344,2,150,0.0,75.0,75.0,2,194,0.0,103.0,97.0
90213896.0,6,19,1436,9,691,11246475.5,95.0,76.77777777777777,10,745,10000994.222222222,95.0,74.5
282739.0,17,2,363,1,79,0.0,79.0,79.0,1,284,0.0,284.0,284.0
90285997.0,6,16,1192,8,596,12890538.285714284,95.0,74.5,8,596,12895301.714285716,95.0,74.5
209448.0,17,2,180,1,90,0.0,90.0,90.0,1,90,0.0,90.0,90.0
385.0,17,2,166,1,75,0.0,75.0,75.0,1,91,0.0,91.0,91.0
206156.0,6,3,426,2,280,0.0,214.0,140.0,1,146,0.0,146.0,146.0
24153.0,6,10,2032,5,524,5575.5,252.0,104.8,5,1508,4070.25,1236.0,301.6
102039.0,6,14,4740,7,653,16327.833333333334,249.0,93.28571428571428,7,4087,16544.0,1514.0,583.8571428571429
90045153.0,17,28,13364,28,13364,3335005.6666666665,501.0,477.2857142857143,0,0,0.0,0.0,0.0
135141538.0,17,6,1206,6,1206,27028307.6,201.0,201.0,0,0,0.0,0.0,0.0
25344.0,6,10,2032,5,524,5997.0,252.0,104.8,5,1508,5726.0,1236.0,301.6
312542.0,6,6,412,4,272,104180.66666666669,74.0,68.0,2,140,0.0,74.0,70.0
119889295.0,17,35,16705,35,16705,3526155.7352941176,501.0,477.2857142857143,0,0,0.0,0.0,0.0
90101913.0,6,10,1440,7,828,15016985.5,188.0,118.28571428571428,3,612,30034230.5,204.0,204.0
274986.0,6,10,1221,6,636,54997.2,298.0,106.0,4,585,85099.0,379.0,146.25
27272.0,6,14,4740,7,653,4081.0,249.0,93.28571428571428,7,4087,4056.6666666666665,1514.0,583.8571428571429
20673.0,17,4,344,2,150,0.0,75.0,75.0,2,194,0.0,103.0,97.0
96220.0,6,12,1328,7,797,16036.666666666666,253.0,113.85714285714286,5,531,21298.75,259.0,106.2
5441.0,17,4,344,2,150,0.0,75.0,75.0,2,194,0.0,103.0,97.0
1285015.0,17,6,1230,3,234,642323.0,78.0,78.0,3,996,642306.5,332.0,332.0
342.0,17,2,166,1,75,0.0,75.0,75.0,1,91,0.0,91.0,91.0
59183.0,6,14,4740,7,653,9189.833333333334,249.0,93.28571428571428,7,4087,9635.5,1514.0,583.8571428571429
120108094.0,6,14,2240,6,1224,24021618.8,204.0,204.0,8,1016,17096523.57142857,188.0,127.0
90526478.0,6,14,2240,8,1016,12932354.0,188.0,127.0,6,1224,18073140.6,204.0,204.0
107477709.0,6,194,21870,97,15246,1117317.8958333333,284.0,157.17525773195877,97,6624,1117317.0625,140.0,68.28865979381443
1302564.0,6,4,264,2,132,0.0,66.0,66.0,2,132,0.0,66.0,66.0
315844.0,17,4,1400,4,1400,105281.33333333331,350.0,350.0,0,0,0.0,0.0,0.0
100971.0,17,2,286,2,286,0.0,143.0,143.0,0,0,0.0,0.0,0.0
311516.0,17,4,622,4,622,103838.66666666669,163.0,155.5,0,0,0.0,0.0,0.0
12234.0,6,12,1393,6,796,2179.0,271.0,132.66666666666666,6,597,2023.2,259.0,99.5
120060764.0,17,28,13364,28,13364,4446694.962962963,501.0,477.2857142857143,0,0,0.0,0.0,0.0
153294.0,17,2,180,1,90,0.0,90.0,90.0,1,90,0.0,90.0,90.0
2085.0,17,4,344,2,150,0.0,75.0,75.0,2,194,0.0,103.0,97.0
2542424.0,6,12,1354,6,723,507524.2,253.0,120.5,6,631,506639.6,293.0,105.16666666666669
42800.0,6,13,1386,7,789,7133.333333333333,253.0,112.71428571428572,6,597,7303.8,259.0,99.5
135122353.0,17,6,1146,6,1146,27024470.6,191.0,191.0,0,0,0.0,0.0,0.0
301011.0,6,6,412,4,272,100337.0,74.0,68.0,2,140,0.0,74.0,70.0
207132.0,6,3,426,2,280,0.0,214.0,140.0,1,146,0.0,146.0,146.0
256480.0,6,3,337,2,214,0.0,160.0,107.0,1,123,0.0,123.0,123.0
1303545.0,6,4,264,2,132,0.0,66.0,66.0,2,132,0.0,66.0,66.0
855568.0,6,9,1268,6,797,171113.6,459.0,132.83333333333334,3,471,291445.5,331.0,157.0
90044045.0,17,28,13364,28,13364,3334964.6296296297,501.0,477.2857142857143,0,0,0.0,0.0,0.0
58886.0,6,14,4740,7,653,9689.166666666666,249.0,93.28571428571428,7,4087,9134.666666666666,1514.0,583.8571428571429
4600.0,17,2,180,1,90,0.0,90.0,90.0,1,90,0.0,90.0,90.0
121182.0,6,3,337,2,214,0.0,160.0,107.0,1,123,0.0,123.0,123.0
48783.0,6,10,2032,5,524,11883.25,252.0,104.8,5,1508,11434.75,1236.0,301.6
37595.0,6,14,4740,7,653,6140.833333333333,249.0,93.28571428571428,7,4087,5685.333333333333,1514.0,583.8571428571429
96071280.0,6,30,2106,15,1089,6846817.5,123.0,72.6,15,1017,6846816.928571428,123.0,67.8
24980.0,6,11,1132,6,556,4837.6,218.0,92.66666666666669,5,576,4699.75,304.0,115.2
1246402.0,17,7,490,7,490,207733.66666666663,70.0,70.0,0,0,0.0,0.0,0.0
111802.0,17,2,286,2,286,0.0,143.0,143.0,0,0,0.0,0.0,0.0
110311310.0,6,193,21714,97,6624,1149076.1458333333,140.0,68.28865979381443,96,15090,1150280.2315789473,284.0,157.1875
179822.0,17,2,180,1,90,0.0,90.0,90.0,1,90,0.0,90.0,90.0
101249230.0,6,190,21426,95,14934,1074830.1595744682,284.0,157.2,95,6492,1074829.0212765958,140.0,68.33684210526316
90023892.0,17,28,13364,28,13364,3334218.222222222,501.0,477.2857142857143,0,0,0.0,0.0,0.0
120008567.0,6,20,1531,10,786,13334285.222222222,95.0,78.6,10,745,10001220.666666666,95.0,74.5
97993373.0,17,13,1083,7,563,16332228.833333334,174.0,80.42857142857143,6,520,15600117.2,174.0,86.66666666666667
0.0,6,1,66,1,66,0.0,66.0,66.0,0,0,0.0,0.0,0.0
34929.0,6,20,7606,11,978,3492.9,310.0,88.9090909090909,9,6628,4044.0,1514.0,736.4444444444445
234043.0,6,3,373,2,238,0.0,172.0,119.0,1,135,0.0,135.0,135.0
1423137.0,6,8,602,3,198,204532.0,66.0,66.0,5,404,331220.5,103.0,80.8
10543974.0,6,7,478,4,272,3467564.6666666665,74.0,68.0,3,206,5201264.0,74.0,68.66666666666667
10461.0,6,10,2032,5,524,2421.5,252.0,104.8,5,1508,2383.75,1236.0,301.6
115653603.0,17,14,864,7,432,19168036.83333333,174.0,61.71428571428572,7,432,19166825.83333333,174.0,61.71428571428572
120124360.0,6,14,2224,9,1204,15015545.0,188.0,133.77777777777777,5,1020,22523161.5,204.0,204.0
5365489.0,6,8,550,4,278,1788496.3333333333,78.0,69.5,4,272,762869.6666666666,70.0,68.0
21129.0,6,14,4740,7,653,3302.1666666666665,249.0,93.28571428571428,7,4087,3385.1666666666665,1514.0,583.8571428571429
90252766.0,6,12,1832,8,1016,12893252.285714284,188.0,127.0,4,816,30018171.666666668,204.0,204.0
1081953.0,6,13,1386,7,789,180325.5,253.0,112.71428571428572,6,597,215024.6,259.0,99.5
90038563.0,17,28,13364,28,13364,3334761.592592593,501.0,477.2857142857143,0,0,0.0,0.0,0.0
342566.0,6,6,412,4,272,114188.66666666669,74.0,68.0,2,140,0.0,74.0,70.0
236538.0,6,3,373,2,238,0.0,172.0,119.0,1,135,0.0,135.0,135.0
0.0,17,1,44,1,44,0.0,44.0,44.0,0,0,0.0,0.0,0.0
350.0,17,2,267,1,83,0.0,83.0,83.0,1,184,0.0,184.0,184.0
249594.0,6,3,337,2,214,0.0,160.0,107.0,1,123,0.0,123.0,123.0
90020645.0,17,28,13364,28,13364,3334097.962962963,501.0,477.2857142857143,0,0,0.0,0.0,0.0
78827.0,6,10,2032,5,524,19484.25,252.0,104.8,5,1508,19153.0,1236.0,301.6
2579247.0,6,3,1604,1,753,0.0,753.0,753.0,2,851,0.0,785.0,425.5
90912623.0,6,21,1585,11,840,9090751.6,95.0,76.36363636363636,10,745,10098874.0,95.0,74.5
28087.0,6,14,4740,7,653,4408.0,249.0,93.28571428571428,7,4087,4251.666666666667,1514.0,583.8571428571429
108115809.0,17,5,1005,5,1005,27028952.25,201.0,201.0,0,0,0.0,0.0,0.0
24024.0,6,14,4740,7,653,3795.1666666666665,249.0,93.28571428571428,7,4087,3806.0,1514.0,583.8571428571429
327.0,17,2,174,1,79,0.0,79.0,79.0,1,95,0.0,95.0,95.0
143871.0,17,2,180,1,90,0.0,90.0,90.0,1,90,0.0,90.0,90.0
317542.0,17,4,1400,4,1400,105847.33333333331,350.0,350.0,0,0,0.0,0.0,0.0
2411.0,17,4,344,2,150,0.0,75.0,75.0,2,194,0.0,103.0,97.0
6799.0,17,2,582,1,83,0.0,83.0,83.0,1,499,0.0,499.0,499.0
13951277.0,17,6,2052,6,2052,2790255.4,342.0,342.0,0,0,0.0,0.0,0.0
111247877.0,17,14,864,7,432,18501483.666666668,174.0,61.71428571428572,7,432,18500154.166666668,174.0,61.71428571428572
113791551.0,6,48,3168,24,1584,4947458.739130435,66.0,66.0,24,1584,4935649.173913044,66.0,66.0
120088680.0,6,222,25090,111,7622,1085320.7818181815,140.0,68.66666666666667,111,17468,1084170.5818181818,284.0,157.36936936936937
108124.0,17,2,700,2,700,0.0,350.0,350.0,0,0,0.0,0.0,0.0
93296495.0,6,23,1775,13,1030,7774356.25,95.0,79.23076923076923,10,745,10365317.111111112,95.0,74.5
206881.0,6,3,426,2,280,0.0,214.0,140.0,1,146,0.0,146.0,146.0
42173.0,6,14,4740,7,653,6650.166666666667,249.0,93.28571428571428,7,4087,6812.5,1514.0,583.8571428571429
205815.0,17,2,180,1,90,0.0,90.0,90.0,1,90,0.0,90.0,90.0
135136499.0,17,6,1146,6,1146,27027299.8,191.0,191.0,0,0,0.0,0.0,0.0
281354.0,6,12,1373,7,714,46892.333333333336,298.0,102.0,5,659,65923.0,379.0,131.8
120119662.0,6,15,2428,9,1204,15014957.75,188.0,133.77777777777777,6,1224,18017654.0,204.0,204.0
207287.0,6,3,426,2,280,0.0,214.0,140.0,1,146,0.0,146.0,146.0
119573336.0,17,35,16705,35,16705,3516862.823529412,501.0,477.2857142857143,0,0,0.0,0.0,0.0
202905.0,6,14,4740,7,653,14327.5,249.0,93.28571428571428,7,4087,30392.33333333333,1514.0,583.8571428571429
0.0,17,1,453,1,453,0.0,453.0,453.0,0,0,0.0,0.0,0.0
29634.0,6,10,2032,5,524,6256.0,252.0,104.8,5,1508,7140.25,1236.0,301.6
1571.0,17,5,550,5,550,392.75,110.0,110.0,0,0,0.0,0.0,0.0
108131778.0,17,5,1005,5,1005,27032944.5,201.0,201.0,0,0,0.0,0.0,0.0
90565798.0,6,30,2254,15,1168,6468985.571428572,139.0,77.86666666666666,15,1086,6453499.142857143,123.0,72.4
49740.0,6,10,2032,5,524,12156.25,252.0,104.8,5,1508,11657.25,1236.0,301.6
9390.0,17,2,582,1,83,0.0,83.0,83.0,1,499,0.0,499.0,499.0
90257913.0,6,13,2036,8,1016,12893987.57142857,188.0,127.0,5,1020,22521419.0,204.0,204.0
406.0,17,2,410,1,78,0.0,78.0,78.0,1,332,0.0,332.0,332.0
108103384.0,17,5,1005,5,1005,27025846.0,201.0,201.0,0,0,0.0,0.0,0.0
39638719.0,6,5,336,2,134,0.0,68.0,67.0,3,202,19756147.0,70.0,67.33333333333333
90257280.0,6,12,1832,8,1016,12893897.142857144,188.0,127.0,4,816,30030598.0,204.0,204.0
108105525.0,17,5,955,5,955,27026381.25,191.0,191.0,0,0,0.0,0.0,0.0
26298.0,6,14,4740,7,653,4254.0,249.0,93.28571428571428,7,4087,4104.333333333333,1514.0,583.8571428571429
22726.0,6,10,2032,5,524,5440.75,252.0,104.8,5,1508,5131.0,1236.0,301.6
308422.0,6,6,412,4,272,102807.33333333331,74.0,68.0,2,140,0.0,74.0,70.0
103202.0,17,2,762,2,762,0.0,381.0,381.0,0,0,0.0,0.0,0.0
212333.0,6,10,1221,6,636,42466.6,298.0,106.0,4,585,69929.33333333333,379.0,146.25
853371.0,6,9,1118,6,586,170674.2,248.0,97.66666666666669,3,532,288703.5,392.0,177.33333333333334
2959216.0,6,3,1604,2,851,0.0,785.0,425.5,1,753,0.0,753.0,753.0
171711.0,17,2,180,1,90,0.0,90.0,90.0,1,90,0.0,90.0,90.0
119652362.0,17,35,16705,35,16705,3519187.117647059,501.0,477.2857142857143,0,0,0.0,0.0,0.0
304.0,17,2,156,1,78,0.0,78.0,78.0,1,78,0.0,78.0,78.0
329.0,17,2,166,1,75,0.0,75.0,75.0,1,91,0.0,91.0,91.0
153503.0,17,2,180,1,90,0.0,90.0,90.0,1,90,0.0,90.0,90.0
119772429.0,6,1082,227384,532,35778,225554.9661016949,214.0,67.25187969924812,550,191606,218152.3661202186,1514.0,348.37454545454545
228238.0,17,2,180,1,90,0.0,90.0,90.0,1,90,0.0,90.0,90.0
508653.0,6,5,336,2,134,0.0,68.0,67.0,3,202,195063.5,70.0,67.33333333333333
114175598.0,6,229,25838,115,7886,1001540.3333333334,140.0,68.57391304347826,114,17952,1004274.0884955752,284.0,157.47368421052633
24301.0,6,10,2032,5,524,5633.75,252.0,104.8,5,1508,5323.5,1236.0,301.6
42777.0,6,10,2032,5,524,10465.75,252.0,104.8,5,1508,9997.5,1236.0,301.6
153363.0,17,2,180,1,90,0.0,90.0,90.0,1,90,0.0,90.0,90.0
130716.0,6,10,2032,5,524,11369.0,252.0,104.8,5,1508,32235.25,1236.0,301.6
4507.0,17,2,614,1,72,0.0,72.0,72.0,1,542,0.0,542.0,542.0
90102163.0,6,10,1440,7,828,15017027.166666666,188.0,118.28571428571428,3,612,30035755.5,204.0,204.0
108102318.0,17,5,1005,5,1005,27025579.5,201.0,201.0,0,0,0.0,0.0,0.0
94065686.0,6,26,1762,13,922,7820825.0,139.0,70.92307692307692,13,840,7820822.416666667,123.0,64.61538461538461
103798.0,17,2,762,2,762,0.0,381.0,381.0,0,0,0.0,0.0,0.0
121598.0,6,4,439,2,238,0.0,172.0,119.0,2,201,0.0,135.0,100.5
508914.0,6,5,336,2,134,0.0,68.0,67.0,3,202,194092.5,70.0,67.33333333333333
120122172.0,6,18,2760,10,1392,13346908.0,188.0,139.2,8,1368,12872030.0,204.0,171.0
205739.0,17,2,180,1,90,0.0,90.0,90.0,1,90,0.0,90.0,90.0
9249.0,17,4,344,2,150,0.0,75.0,75.0,2,194,0.0,103.0,97.0
2306.0,17,4,344,2,150,0.0,75.0,75.0,2,194,0.0,103.0,97.0
98054414.0,6,212,24228,106,7218,932511.561904762,140.0,68.09433962264151,106,17010,925968.0285714286,284.0,160.47169811320754
1306363.0,6,4,264,2,132,0.0,66.0,66.0,2,132,0.0,66.0,66.0
209450.0,17,2,180,1,90,0.0,90.0,90.0,1,90,0.0,90.0,90.0
46770.0,6,12,1320,6,723,8975.4,253.0,120.5,6,597,8330.2,259.0,99.5
105451.0,17,2,286,2,286,0.0,143.0,143.0,0,0,0.0,0.0,0.0
3348426.0,6,145,119643,86,111447,39393.24705882353,1510.0,1295.8953488372092,59,8196,52406.08620689655,1510.0,138.91525423728814
366412.0,17,2,363,1,75,0.0,75.0,75.0,1,288,0.0,288.0,288.0
121228.0,6,3,337,2,214,0.0,160.0,107.0,1,123,0.0,123.0,123.0
119821502.0,6,36,2596,18,1248,7048295.470588235,123.0,69.33333333333333,18,1348,6460939.764705882,139.0,74.88888888888889
120227612.0,6,226,25656,113,7754,1066099.3125,140.0,68.61946902654867,113,17902,1066250.8214285714,390.0,158.42477876106196
104952698.0,6,32,2236,16,1165,6982466.8,139.0,72.8125,16,1071,6982465.933333334,123.0,66.9375
249062.0,17,4,6056,4,6056,83020.66666666667,1514.0,1514.0,0,0,0.0,0.0,0.0
318251.0,17,4,528,2,176,0.0,88.0,88.0,2,352,0.0,200.0,176.0
2874345.0,6,3,204,2,134,0.0,68.0,67.0,1,70,0.0,70.0,70.0
72831.0,6,10,2032,5,524,17412.75,252.0,104.8,5,1508,17351.0,1236.0,301.6
90254992.0,6,13,2036,8,1016,12893570.285714284,188.0,127.0,5,1020,22515647.0,204.0,204.0
108108991.0,17,5,955,5,955,27027247.75,191.0,191.0,0,0,0.0,0.0,0.0
30505.0,6,14,4740,7,653,4918.833333333333,249.0,93.28571428571428,7,4087,4349.166666666667,1514.0,583.8571428571429
53000.0,6,12,1320,6,723,9499.4,253.0,120.5,6,597,9686.4,259.0,99.5
116666619.0,6,200,22676,100,15842,1176276.404040404,284.0,158.42,100,6834,1176276.8585858585,140.0,68.34
122687970.0,6,49,3234,25,1650,5111998.75,66.0,66.0,24,1584,4987839.043478261,66.0,66.0
4602444.0,6,5,336,2,134,0.0,68.0,67.0,3,202,1422190.0,70.0,67.33333333333333
119527016.0,6,20,1490,10,745,13280779.555555556,95.0,74.5,10,745,13252277.444444444,95.0,74.5
8642.0,17,4,823,2,163,0.0,89.0,81.5,2,660,0.0,443.0,330.0
90061319.0,17,27,12943,27,12943,3463896.8846153845,501.0,479.3703703703704,0,0,0.0,0.0,0.0
108106770.0,17,5,955,5,955,27026692.5,191.0,191.0,0,0,0.0,0.0,0.0
16056.0,6,14,4740,7,653,2524.0,249.0,93.28571428571428,7,4087,2538.333333333333,1514.0,583.8571428571429
98993772.0,6,25,1692,13,906,8231490.416666667,123.0,69.6923076923077,12,786,8979813.090909092,123.0,65.5
149816932.0,17,36,17126,36,17126,4280483.771428571,501.0,475.72222222222223,0,0,0.0,0.0,0.0
9690.0,6,10,2032,5,524,1747.25,252.0,104.8,5,1508,2132.0,1236.0,301.6
3004810.0,6,11,2106,6,598,600713.6,252.0,99.66666666666669,5,1508,1764.75,1236.0,301.6
135132843.0,17,6,1206,6,1206,27026568.6,201.0,201.0,0,0,0.0,0.0,0.0
22095.0,6,10,2032,5,524,4543.0,252.0,104.8,5,1508,4884.25,1236.0,301.6
210047.0,6,3,426,2,280,0.0,214.0,140.0,1,146,0.0,146.0,146.0
2440777.0,6,25,7573,14,3735,187752.0769230769,1514.0,266.7857142857143,11,3838,218034.4,1514.0,348.90909090909093
2063.0,17,4,344,2,150,0.0,75.0,75.0,2,194,0.0,103.0,97.0
104834.0,17,2,762,2,762,0.0,381.0,381.0,0,0,0.0,0.0,0.0
5948.0,17,2,180,1,90,0.0,90.0,90.0,1,90,0.0,90.0,90.0
309270.0,6,6,412,4,272,103090.0,74.0,68.0,2,140,0.0,74.0,70.0
141871.0,17,4,344,2,150,0.0,75.0,75.0,2,194,0.0,103.0,97.0
2202257.0,6,19,6869,10,1501,244695.22222222225,408.0,150.1,9,5368,232052.625,1514.0,596.4444444444445
3107790.0,6,3,1604,2,851,0.0,785.0,425.5,1,753,0.0,753.0,753.0
146197.0,6,3,337,2,214,0.0,160.0,107.0,1,123,0.0,123.0,123.0
90052520.0,17,28,13364,28,13364,3335278.5185185187,501.0,477.2857142857143,0,0,0.0,0.0,0.0
235634.0,6,3,337,2,214,0.0,160.0,107.0,1,123,0.0,123.0,123.0
126950931.0,6,31,2097,16,1149,8463395.4,123.0,71.8125,15,948,8416193.642857144,123.0,63.2
120175528.0,6,792,101622,396,75190,303723.982278481,374.0,189.87373737373736,396,26432,303724.08101265825,140.0,66.74747474747475
243139.0,6,3,337,2,214,0.0,160.0,107.0,1,123,0.0,123.0,123.0
143145.0,17,2,176,1,80,0.0,80.0,80.0,1,96,0.0,96.0,96.0
252750.0,6,3,337,2,214,0.0,160.0,107.0,1,123,0.0,123.0,123.0
311180.0,17,4,1400,4,1400,103726.66666666669,350.0,350.0,0,0,0.0,0.0,0.0
206505.0,17,2,180,1,90,0.0,90.0,90.0,1,90,0.0,90.0,90.0
0.0,17,1,381,1,381,0.0,381.0,381.0,0,0,0.0,0.0,0.0
303662.0,6,2,132,1,66,0.0,66.0,66.0,1,66,0.0,66.0,66.0
216389.0,17,2,180,1,90,0.0,90.0,90.0,1,90,0.0,90.0,90.0
108241449.0,6,29,2068,14,963,7558160.0,123.0,68.78571428571429,15,1105,7018279.357142857,139.0,73.66666666666667
2589591.0,6,2,132,1,66,0.0,66.0,66.0,1,66,0.0,66.0,66.0
90807039.0,6,19,1436,10,745,10084080.444444444,95.0,74.5,9,691,11349146.75,95.0,76.77777777777777
120009881.0,6,18,1468,9,818,15001235.125,222.0,90.88888888888889,9,650,14967753.375,95.0,72.22222222222223
27822.0,6,14,4740,7,653,4227.0,249.0,93.28571428571428,7,4087,4400.666666666667,1514.0,583.8571428571429
369332.0,6,11,1021,6,444,49970.4,162.0,74.0,5,577,62368.75,349.0,115.4
90088225.0,6,14,1976,8,1016,12869746.42857143,188.0,127.0,6,960,12012072.2,204.0,160.0
108109830.0,17,5,1005,5,1005,27027457.5,201.0,201.0,0,0,0.0,0.0,0.0
943736.0,6,13,1493,7,862,155745.83333333334,271.0,123.14285714285714,6,631,187626.8,293.0,105.16666666666669
90034117.0,17,28,13364,28,13364,3334596.925925926,501.0,477.2857142857143,0,0,0.0,0.0,0.0
282716.0,17,4,820,2,156,0.0,78.0,78.0,2,664,0.0,332.0,332.0
35679.0,6,14,4740,7,653,5502.5,249.0,93.28571428571428,7,4087,5339.333333333333,1514.0,583.8571428571429
11783212.0,6,5,1736,2,819,0.0,753.0,409.5,3,917,5826552.5,785.0,305.6666666666667
9458.0,17,2,582,1,83,0.0,83.0,83.0,1,499,0.0,499.0,499.0
464.0,17,2,508,2,508,0.0,257.0,254.0,0,0,0.0,0.0,0.0
119873110.0,6,2381,2122434,1655,2074518,72468.59008464329,1514.0,1253.4851963746223,726,47916,165339.81379310344,66.0,66.0
85396220.0,17,12,1040,6,520,16919421.2,174.0,86.66666666666667,6,520,17047220.0,174.0,86.66666666666667
135136346.0,17,6,1146,6,1146,27027269.2,191.0,191.0,0,0,0.0,0.0,0.0
1317053.0,6,4,264,2,132,0.0,66.0,66.0,2,132,0.0,66.0,66.0
2314.0,17,4,344,2,150,0.0,75.0,75.0,2,194,0.0,103.0,97.0
1110912.0,6,13,1386,7,789,185152.0,253.0,112.71428571428572,6,597,218744.8,259.0,99.5
2961156.0,6,11,2106,6,598,592057.4,252.0,99.66666666666669,5,1508,4040.0,1236.0,301.6
26838.0,6,10,2032,5,524,5014.0,252.0,104.8,5,1508,6151.75,1236.0,301.6
86764.0,6,14,4740,7,653,14339.333333333334,249.0,93.28571428571428,7,4087,13864.0,1514.0,583.8571428571429
4291.0,17,2,598,1,72,0.0,72.0,72.0,1,526,0.0,526.0,526.0
2873950.0,6,4,270,2,134,0.0,68.0,67.0,2,136,0.0,70.0,68.0
36803.0,6,10,2032,5,524,8803.75,252.0,104.8,5,1508,7838.5,1236.0,301.6
14091.0,6,14,4740,7,653,2239.333333333333,249.0,93.28571428571428,7,4087,2054.1666666666665,1514.0,583.8571428571429
136877.0,17,2,192,1,88,0.0,88.0,88.0,1,104,0.0,104.0,104.0
209606.0,17,2,180,1,90,0.0,90.0,90.0,1,90,0.0,90.0,90.0
157039.0,6,3,337,2,214,0.0,160.0,107.0,1,123,0.0,123.0,123.0
90034890.0,17,28,13364,28,13364,3334625.5555555555,501.0,477.2857142857143,0,0,0.0,0.0,0.0
36634.0,6,14,4740,7,653,5444.5,249.0,93.28571428571428,7,4087,5025.833333333333,1514.0,583.8571428571429
2300.0,17,4,344,2,150,0.0,75.0,75.0,2,194,0.0,103.0,97.0
5612429.0,6,5,336,2,134,0.0,68.0,67.0,3,202,1424885.0,70.0,67.33333333333333
1462533.0,6,4,276,2,128,0.0,74.0,64.0,2,148,0.0,74.0,74.0
94114852.0,17,12,778,6,389,18800678.2,174.0,64.83333333333333,6,389,18800179.6,174.0,64.83333333333333
104021261.0,17,14,864,7,432,17334172.666666668,174.0,61.71428571428572,7,432,17333473.333333332,174.0,61.71428571428572
2377.0,17,4,344,2,150,0.0,75.0,75.0,2,194,0.0,103.0,97.0
2549897.0,6,2,134,1,68,0.0,68.0,68.0,1,66,0.0,66.0,66.0
3171042.0,6,18,1495,9,921,358139.75,315.0,102.33333333333331,9,574,358108.5,78.0,63.77777777777778
24264.0,6,14,4740,7,653,3633.5,249.0,93.28571428571428,7,4087,3854.8333333333335,1514.0,583.8571428571429
58661.0,6,14,4740,7,653,9062.833333333334,249.0,93.28571428571428,7,4087,9353.333333333334,1514.0,583.8571428571429
92924809.0,6,179,20208,90,6162,1044098.97752809,140.0,68.46666666666667,89,14046,1044123.8181818182,300.0,157.82022471910113
867594.0,6,9,1096,6,625,173518.8,287.0,104.16666666666669,3,471,296226.5,331.0,157.0
108113213.0,17,5,955,5,955,27028303.25,191.0,191.0,0,0,0.0,0.0,0.0
2364.0,17,4,344,2,150,0.0,75.0,75.0,2,194,0.0,103.0,97.0
112374888.0,6,257,29988,129,8810,877928.8125,140.0,68.29457364341086,128,21178,876556.2755905512,374.0,165.453125
216954.0,6,3,426,2,280,0.0,214.0,140.0,1,146,0.0,146.0,146.0
19353.0,6,10,2032,5,524,4626.5,252.0,104.8,5,1508,3211.75,1236.0,301.6
102144.0,17,2,286,2,286,0.0,143.0,143.0,0,0,0.0,0.0,0.0
2058923.0,6,2,132,1,66,0.0,66.0,66.0,1,66,0.0,66.0,66.0
90097071.0,6,14,2256,7,1428,15015333.0,204.0,204.0,7,828,15015518.166666666,188.0,118.28571428571428
283758.0,17,2,363,1,79,0.0,79.0,79.0,1,284,0.0,284.0,284.0
353.0,17,2,267,1,83,0.0,83.0,83.0,1,184,0.0,184.0,184.0
108106256.0,17,5,955,5,955,27026564.0,191.0,191.0,0,0,0.0,0.0,0.0
334411.0,6,10,1221,6,636,66882.2,298.0,106.0,4,585,103345.33333333331,379.0,146.25
324148.0,6,6,412,4,272,108049.33333333331,74.0,68.0,2,140,0.0,74.0,70.0
0.0,6,1,54,0,0,0.0,0.0,0.0,1,54,0.0,54.0,54.0
228820.0,17,2,359,1,75,0.0,75.0,75.0,1,284,0.0,284.0,284.0
90255654.0,6,12,1832,8,1016,12893664.857142856,188.0,127.0,4,816,30030989.666666668,204.0,204.0
0.0,17,1,453,1,453,0.0,453.0,453.0,0,0,0.0,0.0,0.0
108101273.0,17,5,955,5,955,27025318.25,191.0,191.0,0,0,0.0,0.0,0.0
224512.0,17,2,180,1,90,0.0,90.0,90.0,1,90,0.0,90.0,90.0
1994.0,17,4,344,2,150,0.0,75.0,75.0,2,194,0.0,103.0,97.0
100093260.0,17,12,516,6,258,20000163.4,43.0,43.0,6,258,20001440.4,43.0,43.0
108032.0,17,2,700,2,700,0.0,350.0,350.0,0,0,0.0,0.0,0.0
13933835.0,6,21,1700,10,1014,1514329.2222222222,315.0,101.4,11,686,1362868.7,78.0,62.36363636363637
112341477.0,6,220,24740,110,17184,1028773.247706422,284.0,156.21818181818182,110,7556,1028773.1467889908,140.0,68.69090909090909
2594977.0,6,2,132,1,66,0.0,66.0,66.0,1,66,0.0,66.0,66.0
9815.0,17,2,582,1,83,0.0,83.0,83.0,1,499,0.0,499.0,499.0
97462964.0,6,37,3064,16,1347,6497530.933333334,123.0,84.1875,21,1717,4363104.05,139.0,81.76190476190476
99854.0,17,2,762,2,762,0.0,381.0,381.0,0,0,0.0,0.0,0.0
18246.0,6,13,1459,7,862,2823.5,271.0,123.14285714285714,6,597,3481.4,259.0,99.5
143865.0,17,2,180,1,90,0.0,90.0,90.0,1,90,0.0,90.0,90.0
14658592.0,6,20,1607,10,975,1595825.6666666667,315.0,97.5,10,632,1595785.111111111,78.0,63.2
46247.0,6,14,4740,7,653,7032.0,249.0,93.28571428571428,7,4087,7440.666666666667,1514.0,583.8571428571429
106669415.0,6,32,2220,16,1149,7096897.6,123.0,71.8125,16,1071,7096894.4,123.0,66.9375
108107040.0,17,5,1005,5,1005,27026760.0,201.0,201.0,0,0,0.0,0.0,0.0
10526504.0,6,7,478,4,272,3463400.333333333,74.0,68.0,3,206,5194996.0,74.0,68.66666666666667
49264.0,6,14,4740,7,653,8088.333333333333,249.0,93.28571428571428,7,4087,6917.333333333333,1514.0,583.8571428571429
2720169.0,6,3,1604,2,851,0.0,785.0,425.5,1,753,0.0,753.0,753.0
58350.0,6,10,2032,5,524,14156.0,252.0,104.8,5,1508,10230.25,1236.0,301.6
217755.0,6,3,426,2,280,0.0,214.0,140.0,1,146,0.0,146.0,146.0
135510.0,6,2,132,1,66,0.0,66.0,66.0,1,66,0.0,66.0,66.0
64546.00000000001,6,14,4740,7,653,10631.5,249.0,93.28571428571428,7,4087,8446.166666666666,1514.0,583.8571428571429
128364203.0,6,34,2334,17,1125,7398707.75,123.0,66.17647058823529,17,1209,7703654.25,123.0,71.11764705882354
16088.000000000002,6,20,7606,11,978,1608.8,310.0,88.9090909090909,9,6628,1823.5,1514.0,736.4444444444445
2450858.0,6,3,1777,1,826,0.0,826.0,826.0,2,951,0.0,885.0,475.5
1476522.0,17,16,1120,16,1120,98434.8,70.0,70.0,0,0,0.0,0.0,0.0
32819.0,6,14,4740,7,653,5324.833333333333,249.0,93.28571428571428,7,4087,5338.333333333333,1514.0,583.8571428571429
19022878.0,17,3,1034,2,684,0.0,342.0,342.0,1,350,0.0,350.0,350.0
130599.0,6,3,337,2,214,0.0,160.0,107.0,1,123,0.0,123.0,123.0
90044359.0,17,28,13364,28,13364,3334976.25925926,501.0,477.2857142857143,0,0,0.0,0.0,0.0
115750162.0,6,47,3102,24,1584,5032604.043478261,66.0,66.0,23,1518,5159994.909090909,66.0,66.0
318129.0,17,4,1400,4,1400,106043.0,350.0,350.0,0,0,0.0,0.0,0.0
92867347.0,6,46,3960,26,2190,3705814.68,123.0,84.23076923076923,20,1770,4876072.52631579,123.0,88.5
135121677.0,17,6,1146,6,1146,27024335.4,191.0,191.0,0,0,0.0,0.0,0.0
4362.0,17,2,614,1,72,0.0,72.0,72.0,1,542,0.0,542.0,542.0
90527761.0,6,15,2444,8,1016,12932537.285714284,188.0,127.0,7,1428,15061099.166666666,204.0,204.0
22372.0,6,12,1320,6,723,4160.6,253.0,120.5,6,597,3934.4,259.0,99.5
64211.00000000001,6,13,1386,7,789,10701.833333333334,253.0,112.71428571428572,6,597,8742.4,259.0,99.5
146199.0,6,3,337,2,214,0.0,160.0,107.0,1,123,0.0,123.0,123.0
41206.0,6,10,2032,5,524,9928.75,252.0,104.8,5,1508,8896.75,1236.0,301.6
1885.0,17,2,192,1,88,0.0,88.0,88.0,1,104,0.0,104.0,104.0
12900.0,6,10,1067,5,536,3059.0,264.0,107.2,5,531,2918.75,259.0,106.2
1905.0,17,2,664,1,322,0.0,322.0,322.0,1,342,0.0,342.0,342.0
40622.0,6,10,2032,5,524,9526.0,252.0,104.8,5,1508,9098.0,1236.0,301.6
9597.0,17,2,582,1,83,0.0,83.0,83.0,1,499,0.0,499.0,499.0
5623630.0,6,4,270,2,134,0.0,68.0,67.0,2,136,0.0,70.0,68.0
90041206.0,17,28,13364,28,13364,3334859.4814814813,501.0,477.2857142857143,0,0,0.0,0.0,0.0
102001006.0,17,13,821,7,432,17000167.666666668,174.0,61.71428571428572,6,389,19901266.4,174.0,64.83333333333333
102573.0,17,2,286,2,286,0.0,143.0,143.0,0,0,0.0,0.0,0.0
279642.0,6,10,1221,6,636,55928.4,298.0,106.0,4,585,87782.66666666667,379.0,146.25
32664.0,6,14,4740,7,653,5286.333333333333,249.0,93.28571428571428,7,4087,5073.166666666667,1514.0,583.8571428571429
108107920.0,17,5,1005,5,1005,27026980.0,201.0,201.0,0,0,0.0,0.0,0.0
118215793.0,6,31,2166,16,1149,7866651.066666666,123.0,71.8125,15,1017,8428566.785714285,123.0,67.8
120258318.0,6,244,27574,122,8274,987018.520661157,140.0,67.81967213114754,122,19300,978506.0082644628,390.0,158.1967213114754
36762.0,6,10,2032,5,524,7743.25,252.0,104.8,5,1508,7879.25,1236.0,301.6
105040.0,17,2,286,2,286,0.0,143.0,143.0,0,0,0.0,0.0,0.0
43197.0,6,14,4740,7,653,7031.166666666667,249.0,93.28571428571428,7,4087,7039.833333333333,1514.0,583.8571428571429
90293644.0,6,16,1192,8,596,12892956.714285716,95.0,74.5,8,596,12897075.0,95.0,74.5
135053.0,6,2,132,1,66,0.0,66.0,66.0,1,66,0.0,66.0,66.0
90556025.0,6,16,2648,8,1016,12936575.0,188.0,127.0,8,1632,12913309.857142856,204.0,204.0
131906.0,6,3,337,2,214,0.0,160.0,107.0,1,123,0.0,123.0,123.0
2804026.0,6,2,132,1,66,0.0,66.0,66.0,1,66,0.0,66.0,66.0
120000368.0,6,14,2240,6,1224,18072962.8,204.0,204.0,8,1016,17142585.57142857,188.0,127.0
135131928.0,17,6,1146,6,1146,27026385.6,191.0,191.0,0,0,0.0,0.0,0.0
104523.0,17,2,286,2,286,0.0,143.0,143.0,0,0,0.0,0.0,0.0
311091.0,17,4,1400,4,1400,103697.0,350.0,350.0,0,0,0.0,0.0,0.0
2324.0,17,4,344,2,150,0.0,75.0,75.0,2,194,0.0,103.0,97.0
90287656.0,6,16,1192,8,596,12891066.857142856,95.0,74.5,8,596,12896595.714285716,95.0,74.5
143938.0,17,2,180,1,90,0.0,90.0,90.0,1,90,0.0,90.0,90.0
327900.0,6,6,412,4,272,109300.0,74.0,68.0,2,140,0.0,74.0,70.0
309425.0,6,6,412,4,272,103141.66666666669,74.0,68.0,2,140,0.0,74.0,70.0
0.0,17,1,347,1,347,0.0,347.0,347.0,0,0,0.0,0.0,0.0
828239.0,6,9,1118,6,586,165647.8,248.0,97.66666666666669,3,532,277819.0,392.0,177.33333333333334
314522.0,17,4,1400,4,1400,104840.66666666669,350.0,350.0,0,0,0.0,0.0,0.0
264149.0,6,10,1221,6,636,52829.8,298.0,106.0,4,585,81944.0,379.0,146.25
37942.0,6,10,2032,5,524,8598.75,252.0,104.8,5,1508,8900.75,1236.0,301.6
119853803.0,6,16,2510,7,1428,19975243.666666668,204.0,204.0,9,1082,14981594.375,188.0,120.22222222222224
14642728.0,6,20,1607,10,975,1592302.2222222222,315.0,97.5,10,632,1592299.5555555555,78.0,63.2
400852.0,6,3,204,1,68,0.0,68.0,68.0,2,136,0.0,70.0,68.0
219615.0,6,10,1221,6,636,43923.0,298.0,106.0,4,585,71885.0,379.0,146.25
51468153.0,17,4,360,2,180,0.0,90.0,90.0,2,180,0.0,90.0,90.0
90263440.0,6,13,1898,8,1016,12894777.142857144,188.0,127.0,5,882,22524108.25,204.0,176.4
2806932.0,6,2,132,1,66,0.0,66.0,66.0,1,66,0.0,66.0,66.0
120014529.0,6,293,33662,147,23804,822017.3219178083,284.0,161.93197278911563,146,9858,826157.5310344828,140.0,67.52054794520548
143913.0,17,2,180,1,90,0.0,90.0,90.0,1,90,0.0,90.0,90.0
330.0,17,2,166,1,75,0.0,75.0,75.0,1,91,0.0,91.0,91.0
94901154.0,6,189,21392,95,6418,1009586.7446808512,140.0,67.5578947368421,94,14974,1015541.5161290322,284.0,159.29787234042553
232026.0,6,3,373,2,238,0.0,172.0,119.0,1,135,0.0,135.0,135.0
5625034.0,6,5,336,2,134,0.0,68.0,67.0,3,202,1421749.5,70.0,67.33333333333333
287914.0,6,10,1221,6,636,57582.8,298.0,106.0,4,585,90560.66666666669,379.0,146.25
27479.0,6,10,2032,5,524,6627.25,252.0,104.8,5,1508,5660.75,1236.0,301.6
268750.0,6,10,1221,6,636,53750.0,298.0,106.0,4,585,73252.33333333333,379.0,146.25
109015226.0,6,2316,2129304,1687,2087790,64659.09015421115,1514.0,1237.575577949022,629,41514,173575.38853503185,66.0,66.0
113708070.0,6,46,3036,23,1518,5154528.863636363,66.0,66.0,23,1518,5153914.045454546,66.0,66.0
90204409.0,6,24,1829,11,840,8996696.6,95.0,76.36363636363636,13,989,7499985.666666667,95.0,76.07692307692308
5348958.0,6,5,367,2,132,0.0,66.0,66.0,3,235,2674479.0,103.0,78.33333333333333
303634.0,6,2,132,1,66,0.0,66.0,66.0,1,66,0.0,66.0,66.0
313739.0,6,6,412,4,272,104579.66666666669,74.0,68.0,2,140,0.0,74.0,70.0
355898.0,6,3,1604,1,753,0.0,753.0,753.0,2,851,0.0,785.0,425.5
2366.0,17,4,344,2,150,0.0,75.0,75.0,2,194,0.0,103.0,97.0
37813.0,6,14,4740,7,653,5767.333333333333,249.0,93.28571428571428,7,4087,6108.666666666667,1514.0,583.8571428571429
120040523.0,17,28,13364,28,13364,4445945.296296297,501.0,477.2857142857143,0,0,0.0,0.0,0.0
209491.0,17,2,180,1,90,0.0,90.0,90.0,1,90,0.0,90.0,90.0
92622797.0,6,39,2574,20,1320,4874884.052631579,66.0,66.0,19,1254,5143992.222222222,66.0,66.0
119774436.0,6,19,1395,10,745,13281767.444444444,95.0,74.5,9,650,14941247.625,95.0,72.22222222222223
233212.0,6,3,373,2,238,0.0,172.0,119.0,1,135,0.0,135.0,135.0
122085865.0,6,30,2053,15,948,8171049.428571428,123.0,63.2,15,1105,8007057.357142857,139.0,73.66666666666667
216362.0,17,2,180,1,90,0.0,90.0,90.0,1,90,0.0,90.0,90.0
182582.0,17,2,176,1,80,0.0,80.0,80.0,1,96,0.0,96.0,96.0
255507.0,6,3,337,2,214,0.0,160.0,107.0,1,123,0.0,123.0,123.0
514132.00000000006,6,5,336,2,134,0.0,68.0,67.0,3,202,195611.5,70.0,67.33333333333333
108096138.0,17,5,1005,5,1005,27024034.5,201.0,201.0,0,0,0.0,0.0,0.0
101537.0,17,2,286,2,286,0.0,143.0,143.0,0,0,0.0,0.0,0.0
39254.0,6,14,4740,7,653,5753.5,249.0,93.28571428571428,7,4087,6254.333333333333,1514.0,583.8571428571429
2898261.0,6,2,132,1,66,0.0,66.0,66.0,1,66,0.0,66.0,66.0
9812.0,17,2,582,1,83,0.0,83.0,83.0,1,499,0.0,499.0,499.0
0.0,17,1,90,1,90,0.0,90.0,90.0,0,0,0.0,0.0,0.0
90476355.0,6,20,1490,11,840,9044194.6,95.0,76.36363636363636,9,650,11304150.0,95.0,72.22222222222223
108128.0,17,2,286,2,286,0.0,143.0,143.0,0,0,0.0,0.0,0.0
115546575.0,17,14,864,7,432,19166906.166666668,174.0,61.71428571428572,7,432,19167768.166666668,174.0,61.71428571428572
190631.0,17,2,180,1,90,0.0,90.0,90.0,1,90,0.0,90.0,90.0
301987.0,6,6,412,4,272,100662.33333333331,74.0,68.0,2,140,0.0,74.0,70.0
23275.0,6,14,4740,7,653,3069.5,249.0,93.28571428571428,7,4087,3513.833333333333,1514.0,583.8571428571429
17465.0,6,10,2032,5,524,3864.75,252.0,104.8,5,1508,3605.25,1236.0,301.6
90284781.0,6,16,1192,8,596,12891471.42857143,95.0,74.5,8,596,12896162.42857143,95.0,74.5
27310754.0,17,5,1710,5,1710,6827688.5,342.0,342.0,0,0,0.0,0.0,0.0
93180622.0,6,868,226016,420,28682,222383.08591885443,214.0,68.29047619047618,448,197334,208397.89932885903,1514.0,440.47767857142856
306516.0,6,6,412,4,272,102172.0,74.0,68.0,2,140,0.0,74.0,70.0
206165.0,6,3,426,2,280,0.0,214.0,140.0,1,146,0.0,146.0,146.0
216868.0,6,3,426,2,280,0.0,214.0,140.0,1,146,0.0,146.0,146.0
233293.0,6,3,337,2,214,0.0,160.0,107.0,1,123,0.0,123.0,123.0
2592793.0,6,2,132,1,66,0.0,66.0,66.0,1,66,0.0,66.0,66.0
4560.0,17,2,614,1,72,0.0,72.0,72.0,1,542,0.0,542.0,542.0
0.0,6,1,66,1,66,0.0,66.0,66.0,0,0,0.0,0.0,0.0
107704059.0,6,28,1860,14,966,8268327.769230769,123.0,69.0,14,894,8268329.230769231,123.0,63.85714285714285
301079.0,6,6,412,4,272,100359.66666666669,74.0,68.0,2,140,0.0,74.0,70.0
0.0,17,1,350,1,350,0.0,350.0,350.0,0,0,0.0,0.0,0.0
49689932.0,6,20,1309,11,770,4947403.3,123.0,70.0,9,539,6184257.25,107.0,59.888888888888886
111905.0,17,2,286,2,286,0.0,143.0,143.0,0,0,0.0,0.0,0.0
51136.0,6,12,1328,7,797,8522.666666666666,253.0,113.85714285714286,5,531,9424.25,259.0,106.2
47613466.0,6,8,1940,3,887,22590130.0,753.0,295.6666666666667,5,1053,11261501.25,785.0,210.6
208561.0,6,10,1221,6,636,41712.2,298.0,106.0,4,585,68356.33333333333,379.0,146.25
2680004.0,6,3,1604,1,753,0.0,753.0,753.0,2,851,0.0,785.0,425.5
108107840.0,17,5,1005,5,1005,27026960.0,201.0,201.0,0,0,0.0,0.0,0.0
90256076.0,6,16,2368,9,1204,11282009.5,188.0,133.77777777777777,7,1164,15015007.333333334,204.0,166.28571428571428
107941.0,17,2,700,2,700,0.0,350.0,350.0,0,0,0.0,0.0,0.0
100813195.0,17,12,778,6,389,20071788.6,174.0,64.83333333333333,6,389,20130447.8,174.0,64.83333333333333
3176084.0,6,18,1495,9,921,358040.5,315.0,102.33333333333331,9,574,358008.875,78.0,63.77777777777778
42759.0,6,10,2032,5,524,9551.75,252.0,104.8,5,1508,9978.25,1236.0,301.6
4331.0,17,4,344,2,150,0.0,75.0,75.0,2,194,0.0,103.0,97.0
72845.0,6,14,4740,7,653,8352.666666666666,249.0,93.28571428571428,7,4087,11859.666666666666,1514.0,583.8571428571429
153453.0,17,2,180,1,90,0.0,90.0,90.0,1,90,0.0,90.0,90.0
120118654.0,6,14,2224,9,1204,15014831.75,188.0,133.77777777777777,5,1020,22522763.25,204.0,204.0
103189.0,17,2,286,2,286,0.0,143.0,143.0,0,0,0.0,0.0,0.0
298.0,17,2,164,1,82,0.0,82.0,82.0,1,82,0.0,82.0,82.0
22048.0,6,14,4740,7,653,3371.6666666666665,249.0,93.28571428571428,7,4087,3443.0,1514.0,583.8571428571429
259583.0,6,12,1373,7,714,43263.833333333336,298.0,102.0,5,659,60463.75,379.0,131.8
309.0,17,2,156,1,78,0.0,78.0,78.0,1,78,0.0,78.0,78.0
1248407.0,17,7,490,7,490,208067.8333333333,70.0,70.0,0,0,0.0,0.0,0.0
46720.0,6,14,4740,7,653,7035.666666666667,249.0,93.28571428571428,7,4087,7318.666666666667,1514.0,583.8571428571429
238879.0,6,3,337,2,214,0.0,160.0,107.0,1,123,0.0,123.0,123.0
31076.0,17,2,906,2,906,0.0,453.0,453.0,0,0,0.0,0.0,0.0
241140.0,6,3,337,2,214,0.0,160.0,107.0,1,123,0.0,123.0,123.0
2348.0,17,4,344,2,150,0.0,75.0,75.0,2,194,0.0,103.0,97.0
714764.0,6,14,4740,7,653,118592.66666666669,249.0,93.28571428571428,7,4087,118474.33333333331,1514.0,583.8571428571429
1404063.0,17,7,490,7,490,234010.5,70.0,70.0,0,0,0.0,0.0,0.0
156646.0,6,3,337,2,214,0.0,160.0,107.0,1,123,0.0,123.0,123.0
301936.0,6,6,412,4,272,100645.33333333331,74.0,68.0,2,140,0.0,74.0,70.0
90303789.0,6,16,1192,8,596,12892654.285714284,95.0,74.5,8,596,12899520.142857144,95.0,74.5
90263486.0,6,13,2036,8,1016,12894783.714285716,188.0,127.0,5,1020,22524213.0,204.0,204.0
216493.0,17,2,180,1,90,0.0,90.0,90.0,1,90,0.0,90.0,90.0
135134054.0,17,6,1146,6,1146,27026810.8,191.0,191.0,0,0,0.0,0.0,0.0
108106970.0,17,5,955,5,955,27026742.5,191.0,191.0,0,0,0.0,0.0,0.0
793.0,17,4,438,2,148,0.0,74.0,74.0,2,290,0.0,147.0,145.0
960837.0,17,10,3736,10,3736,106759.66666666669,390.0,373.6,0,0,0.0,0.0,0.0
900866.0,6,12,2715,7,743,150144.33333333334,339.0,106.14285714285714,5,1972,156325.0,1514.0,394.4
1033609.0,6,11,1134,6,558,206721.8,220.0,93.0,5,576,256481.75,304.0,115.2
120090392.0,6,390,46724,195,13166,609898.5,140.0,67.51794871794871,195,33558,615347.4432989691,336.0,172.09230769230768
110971274.0,6,188,21188,94,6500,1185614.6344086025,140.0,69.14893617021276,94,14688,1184429.6989247312,284.0,156.25531914893617
113402377.0,6,34,2334,17,1209,7074867.3125,123.0,71.11764705882354,17,1125,7074866.0,123.0,66.17647058823529
93161987.0,6,40,2640,20,1320,4903262.47368421,66.0,66.0,20,1320,4889333.210526316,66.0,66.0
3913660.0,6,144,130750,92,122773,43007.25274725275,1510.0,1334.4891304347825,52,7977,70647.82352941176,1510.0,153.40384615384616
104197547.0,17,14,1126,7,563,17334641.666666668,174.0,80.42857142857143,7,563,17333519.333333332,174.0,80.42857142857143
90259125.0,6,12,1832,8,1016,12894160.714285716,188.0,127.0,4,816,30030923.0,204.0,204.0
100310312.0,17,13,821,7,432,16667304.666666666,174.0,61.71428571428572,6,389,20000158.4,174.0,64.83333333333333
105011800.0,17,14,1126,7,563,17429395.0,174.0,80.42857142857143,7,563,17475479.333333332,174.0,80.42857142857143
120000983.0,17,14,864,8,475,17142997.57142857,174.0,59.375,6,389,20001016.0,174.0,64.83333333333333
127102612.0,6,50,3300,25,1650,4942504.791666667,66.0,66.0,25,1650,5282183.083333333,66.0,66.0
72621536.0,6,9,842,9,842,9077692.0,97.0,93.55555555555556,0,0,0.0,0.0,0.0
99397224.0,17,12,778,6,389,19799985.0,174.0,64.83333333333333,6,389,19800170.8,174.0,64.83333333333333
120220.0,17,2,180,1,70,0.0,70.0,70.0,1,110,0.0,110.0,110.0
2455957.0,6,25,7573,14,3735,188919.7692307692,1514.0,266.7857142857143,11,3838,219697.9,1514.0,348.90909090909093
103200229.0,6,42,2772,21,1386,5159997.65,66.0,66.0,21,1386,5159998.45,66.0,66.0
32086.000000000004,6,10,2032,5,524,7688.75,252.0,104.8,5,1508,7587.75,1236.0,301.6
120026.0,17,2,180,1,70,0.0,70.0,70.0,1,110,0.0,110.0,110.0
146216.0,6,3,337,2,214,0.0,160.0,107.0,1,123,0.0,123.0,123.0
1691661.0,6,22,6443,12,1529,153787.36363636365,357.0,127.41666666666669,10,4914,154249.33333333334,1510.0,491.4
217752.0,6,3,426,2,280,0.0,214.0,140.0,1,146,0.0,146.0,146.0
301370.0,6,7,478,4,272,100456.66666666669,74.0,68.0,3,206,74780.0,74.0,68.66666666666667
90035979.0,17,28,13364,28,13364,3334665.888888889,501.0,477.2857142857143,0,0,0.0,0.0,0.0
50966.0,6,10,1065,5,534,12549.25,262.0,106.8,5,531,11013.0,259.0,106.2
315516.0,17,4,1400,4,1400,105172.0,350.0,350.0,0,0,0.0,0.0,0.0
135136297.0,17,6,1146,6,1146,27027259.4,191.0,191.0,0,0,0.0,0.0,0.0
177671.0,17,2,180,1,90,0.0,90.0,90.0,1,90,0.0,90.0,90.0
2314.0,17,4,344,2,150,0.0,75.0,75.0,2,194,0.0,103.0,97.0
16876.0,17,2,180,1,90,0.0,90.0,90.0,1,90,0.0,90.0,90.0
2847609.0,6,11,2106,6,598,569317.8,252.0,99.66666666666669,5,1508,1630.75,1236.0,301.6
217399.0,6,3,426,2,280,0.0,214.0,140.0,1,146,0.0,146.0,146.0
255091.0,6,3,373,2,238,0.0,172.0,119.0,1,135,0.0,135.0,135.0
3251776.0,6,3,1604,2,851,0.0,785.0,425.5,1,753,0.0,753.0,753.0
304.0,17,2,164,1,82,0.0,82.0,82.0,1,82,0.0,82.0,82.0
892785.0,6,12,2709,7,742,148797.5,338.0,106.0,5,1967,154888.25,1514.0,393.4
90061795.0,17,28,13364,28,13364,3335622.037037037,501.0,477.2857142857143,0,0,0.0,0.0,0.0
123839965.0,6,49,3234,25,1650,5159998.541666667,66.0,66.0,24,1584,5161790.043478261,66.0,66.0
233001.0,6,3,337,2,214,0.0,160.0,107.0,1,123,0.0,123.0,123.0
27296.0,6,14,4740,7,653,4425.5,249.0,93.28571428571428,7,4087,3979.3333333333335,1514.0,583.8571428571429
99204224.0,6,30,2106,15,1089,7086016.0,123.0,72.6,15,1017,7070581.071428572,123.0,67.8
120000033.0,6,17,1287,9,691,15000004.125,95.0,76.77777777777777,8,596,12898668.285714284,95.0,74.5
2343.0,17,4,344,2,150,0.0,75.0,75.0,2,194,0.0,103.0,97.0
240612.0,6,3,337,2,214,0.0,160.0,107.0,1,123,0.0,123.0,123.0
3039.0,17,2,224,1,76,0.0,76.0,76.0,1,148,0.0,148.0,148.0
33938.0,6,14,4740,7,653,5364.333333333333,249.0,93.28571428571428,7,4087,5442.5,1514.0,583.8571428571429
17878.0,6,20,7606,11,978,1787.8,310.0,88.9090909090909,9,6628,1933.375,1514.0,736.4444444444445
303668.0,6,2,132,1,66,0.0,66.0,66.0,1,66,0.0,66.0,66.0
104226.0,17,2,286,2,286,0.0,143.0,143.0,0,0,0.0,0.0,0.0
94185.0,17,2,762,2,762,0.0,381.0,381.0,0,0,0.0,0.0,0.0
4341.0,17,2,582,1,83,0.0,83.0,83.0,1,499,0.0,499.0,499.0
147112.0,6,3,373,2,238,0.0,172.0,119.0,1,135,0.0,135.0,135.0
305472.0,6,6,412,4,272,101824.0,74.0,68.0,2,140,0.0,74.0,70.0
117004.0,6,12,1320,7,789,19500.666666666668,253.0,112.71428571428572,5,531,26394.0,259.0,106.2
11870.0,6,10,1065,5,534,2725.5,262.0,106.8,5,531,2569.25,259.0,106.2
147926.0,17,2,180,1,90,0.0,90.0,90.0,1,90,0.0,90.0,90.0
3006859.0,6,11,2106,6,598,601192.4,252.0,99.66666666666669,5,1508,1794.25,1236.0,301.6
187436.0,17,4,1400,4,1400,62478.66666666666,350.0,350.0,0,0,0.0,0.0,0.0
48930.0,6,14,4740,7,653,7353.833333333333,249.0,93.28571428571428,7,4087,7705.166666666667,1514.0,583.8571428571429
489095.0,17,6,1230,3,234,244329.0,78.0,78.0,3,996,244338.5,332.0,332.0
293208.0,17,2,180,1,90,0.0,90.0,90.0,1,90,0.0,90.0,90.0
2337.0,17,4,344,2,150,0.0,75.0,75.0,2,194,0.0,103.0,97.0
4422.0,17,2,626,1,72,0.0,72.0,72.0,1,554,0.0,554.0,554.0
5622966.0,6,4,270,2,134,0.0,68.0,67.0,2,136,0.0,70.0,68.0
108365.0,17,2,700,2,700,0.0,350.0,350.0,0,0,0.0,0.0,0.0
96894442.0,6,40,2640,20,1320,5099707.47368421,66.0,66.0,20,1320,5088330.578947368,66.0,66.0
90093859.0,6,12,1848,7,828,15015643.166666666,188.0,118.28571428571428,5,1020,15015463.25,204.0,204.0
2289.0,17,4,344,2,150,0.0,75.0,75.0,2,194,0.0,103.0,97.0
3582.0,17,4,344,2,150,0.0,75.0,75.0,2,194,0.0,103.0,97.0
217908.0,6,3,426,2,280,0.0,214.0,140.0,1,146,0.0,146.0,146.0
90043999.0,17,27,12943,27,12943,3463230.730769231,501.0,479.3703703703704,0,0,0.0,0.0,0.0
2800788.0,6,2,132,1,66,0.0,66.0,66.0,1,66,0.0,66.0,66.0
213448.0,17,2,359,1,75,0.0,75.0,75.0,1,284,0.0,284.0,284.0
206373.0,6,3,426,2,280,0.0,214.0,140.0,1,146,0.0,146.0,146.0
235089.0,6,3,373,2,238,0.0,172.0,119.0,1,135,0.0,135.0,135.0
3047777.0,6,4,270,3,202,1523888.5,70.0,67.33333333333333,1,68,0.0,68.0,68.0
108095917.0,17,5,1005,5,1005,27023979.25,201.0,201.0,0,0,0.0,0.0,0.0
72164.0,6,14,4740,7,653,11730.0,249.0,93.28571428571428,7,4087,11871.5,1514.0,583.8571428571429
91178023.0,6,186,21088,93,14728,988712.8695652174,374.0,158.36559139784947,93,6360,988713.5652173914,140.0,68.38709677419355
271943.0,17,2,180,1,90,0.0,90.0,90.0,1,90,0.0,90.0,90.0
108118109.0,17,5,955,5,955,27029527.25,191.0,191.0,0,0,0.0,0.0,0.0
2270.0,17,4,344,2,150,0.0,75.0,75.0,2,194,0.0,103.0,97.0
50761.0,6,14,4740,7,653,7884.666666666667,249.0,93.28571428571428,7,4087,8319.5,1514.0,583.8571428571429
90279428.0,6,14,1043,7,542,15046571.333333334,95.0,77.42857142857143,7,501,14997799.5,95.0,71.57142857142857
135130527.0,17,6,1206,6,1206,27026105.4,201.0,201.0,0,0,0.0,0.0,0.0
101763612.0,6,32,2236,16,1165,6784240.8,139.0,72.8125,16,1071,6769812.266666667,123.0,66.9375
25994.0,6,13,1479,7,882,3712.5,291.0,126.0,6,597,4787.4,259.0,99.5
209566.0,17,2,180,1,90,0.0,90.0,90.0,1,90,0.0,90.0,90.0
233004.0,6,3,337,2,214,0.0,160.0,107.0,1,123,0.0,123.0,123.0
99260.0,17,2,762,2,762,0.0,381.0,381.0,0,0,0.0,0.0,0.0
836669.0,6,9,1118,6,586,167333.8,248.0,97.66666666666669,3,532,280498.5,392.0,177.33333333333334
1885.0,17,2,762,2,762,0.0,381.0,381.0,0,0,0.0,0.0,0.0
224033.0,6,3,426,2,280,0.0,214.0,140.0,1,146,0.0,146.0,146.0
144057.0,17,2,180,1,90,0.0,90.0,90.0,1,90,0.0,90.0,90.0
307504.0,6,10,1221,6,636,61500.8,298.0,106.0,4,585,87347.66666666667,379.0,146.25
45680.0,6,14,4740,7,653,7399.833333333333,249.0,93.28571428571428,7,4087,7129.166666666667,1514.0,583.8571428571429
209552.0,17,2,180,1,90,0.0,90.0,90.0,1,90,0.0,90.0,90.0
1479935.0,17,16,1120,16,1120,98662.33333333331,70.0,70.0,0,0,0.0,0.0,0.0
29349.0,6,10,2032,5,524,5072.5,252.0,104.8,5,1508,6829.0,1236.0,301.6
147225.0,6,2,132,1,66,0.0,66.0,66.0,1,66,0.0,66.0,66.0
64982.0,6,12,1328,7,797,10830.333333333334,253.0,113.85714285714286,5,531,13082.0,259.0,106.2
137964.0,17,4,344,2,150,0.0,75.0,75.0,2,194,0.0,103.0,97.0
6866.0,17,2,582,1,83,0.0,83.0,83.0,1,499,0.0,499.0,499.0
217970.0,6,3,426,2,280,0.0,214.0,140.0,1,146,0.0,146.0,146.0
153455.0,17,2,180,1,90,0.0,90.0,90.0,1,90,0.0,90.0,90.0
217000.0,6,3,426,2,280,0.0,214.0,140.0,1,146,0.0,146.0,146.0
90222528.0,6,16,1192,8,596,12852949.57142857,95.0,74.5,8,596,12858057.285714284,95.0,74.5
539409.0,17,6,2100,6,2100,107881.8,350.0,350.0,0,0,0.0,0.0,0.0
5627543.0,6,5,336,2,134,0.0,68.0,67.0,3,202,1424075.0,70.0,67.33333333333333
108115745.0,17,5,955,5,955,27028936.25,191.0,191.0,0,0,0.0,0.0,0.0
853.0,17,4,438,2,148,0.0,74.0,74.0,2,290,0.0,147.0,145.0
94091520.0,6,40,2640,20,1320,4952185.263157895,66.0,66.0,20,1320,4937846.47368421,66.0,66.0
2913882.0,6,11,2106,6,598,582586.8,252.0,99.66666666666669,5,1508,2725.5,1236.0,301.6
20243.0,6,10,2032,5,524,4841.5,252.0,104.8,5,1508,4436.25,1236.0,301.6
14365.0,17,2,180,1,90,0.0,90.0,90.0,1,90,0.0,90.0,90.0
58686.0,6,14,4740,7,653,9121.0,249.0,93.28571428571428,7,4087,9518.666666666666,1514.0,583.8571428571429
321670.0,17,4,1400,4,1400,107223.33333333331,350.0,350.0,0,0,0.0,0.0,0.0
108547400.0,6,32,2220,16,1149,7222108.333333333,123.0,71.8125,16,1071,7222111.733333333,123.0,66.9375
291231.0,17,2,180,1,90,0.0,90.0,90.0,1,90,0.0,90.0,90.0
37260.0,6,14,4740,7,653,6057.0,249.0,93.28571428571428,7,4087,5560.0,1514.0,583.8571428571429
90070702.0,17,27,12943,27,12943,3464257.769230769,501.0,479.3703703703704,0,0,0.0,0.0,0.0
123001360.0,17,15,907,8,475,17571622.85714286,174.0,59.375,7,432,17167613.833333332,174.0,61.71428571428572
108106253.0,17,5,955,5,955,27026563.25,191.0,191.0,0,0,0.0,0.0,0.0
91073031.0,6,156,17742,78,12372,1180107.6753246754,284.0,158.6153846153846,78,5370,1180107.1168831168,140.0,68.84615384615384
90043093.0,17,27,12943,27,12943,3463195.8846153845,501.0,479.3703703703704,0,0,0.0,0.0,0.0
90258691.0,6,12,1832,8,1016,12894098.714285716,188.0,127.0,4,816,30030432.0,204.0,204.0
3007.0,17,4,625,2,163,0.0,89.0,81.5,2,462,0.0,245.0,231.0
135121550.0,17,6,1146,6,1146,27024310.0,191.0,191.0,0,0,0.0,0.0,0.0
513332.0,17,3,1026,3,1026,256666.00000000003,342.0,342.0,0,0,0.0,0.0,0.0
1535.0,17,2,180,1,90,0.0,90.0,90.0,1,90,0.0,90.0,90.0
207148.0,6,3,426,2,280,0.0,214.0,140.0,1,146,0.0,146.0,146.0
10430636.0,6,6,412,3,206,5146736.5,74.0,68.66666666666667,3,206,5146607.0,74.0,68.66666666666667
102208973.0,17,16,1212,8,606,14578283.57142857,174.0,75.75,8,606,14552888.142857144,174.0,75.75
44711.0,6,14,4740,7,653,7029.166666666667,249.0,93.28571428571428,7,4087,7309.833333333333,1514.0,583.8571428571429
315437.0,17,4,1400,4,1400,105145.66666666669,350.0,350.0,0,0,0.0,0.0,0.0
107213.0,17,2,286,2,286,0.0,143.0,143.0,0,0,0.0,0.0,0.0
107694.0,17,2,762,2,762,0.0,381.0,381.0,0,0,0.0,0.0,0.0
96167177.0,6,188,21204,94,14778,1031741.365591398,284.0,157.2127659574468,94,6426,1031739.4731182796,140.0,68.36170212765957
32185.0,6,14,4740,7,653,5167.833333333333,249.0,93.28571428571428,7,4087,3876.8333333333335,1514.0,583.8571428571429
518374.0,17,2,176,1,80,0.0,80.0,80.0,1,96,0.0,96.0,96.0
118921532.0,6,34,2334,17,1209,7432595.75,123.0,71.11764705882354,17,1125,7419055.75,123.0,66.17647058823529
35443.0,6,14,4740,7,653,5453.833333333333,249.0,93.28571428571428,7,4087,4293.666666666667,1514.0,583.8571428571429
146272.0,6,3,337,2,214,0.0,160.0,107.0,1,123,0.0,123.0,123.0
2025.0,17,4,344,2,150,0.0,75.0,75.0,2,194,0.0,103.0,97.0
404406.0,6,4,508,2,238,0.0,172.0,119.0,2,270,0.0,135.0,135.0
142969.0,17,4,704,2,148,0.0,74.0,74.0,2,556,0.0,280.0,278.0
9567.0,17,2,571,1,86,0.0,86.0,86.0,1,485,0.0,485.0,485.0
49219.0,6,10,2032,5,524,12082.0,252.0,104.8,5,1508,12076.0,1236.0,301.6
26401.0,6,12,1320,6,723,4595.8,253.0,120.5,6,597,4529.2,259.0,99.5
301.0,17,2,164,1,82,0.0,82.0,82.0,1,82,0.0,82.0,82.0
305.0,17,2,174,1,79,0.0,79.0,79.0,1,95,0.0,95.0,95.0
108105909.0,17,5,1005,5,1005,27026477.25,201.0,201.0,0,0,0.0,0.0,0.0
1487973.0,6,4,276,2,128,0.0,74.0,64.0,2,148,0.0,74.0,74.0
113618070.0,6,46,3036,23,1518,5150437.318181818,66.0,66.0,23,1518,5150439.136363637,66.0,66.0
29661301.0,6,557,522837,152,10201,196432.4569536424,215.0,67.11184210526316,405,512636,73403.96782178218,1514.0,1265.767901234568
331.0,17,2,191,1,73,0.0,73.0,73.0,1,118,0.0,118.0,118.0
610.0,17,2,762,2,762,0.0,381.0,381.0,0,0,0.0,0.0,0.0
58740752.0,17,9,3086,8,2736,5108251.142857143,342.0,342.0,1,350,0.0,350.0,350.0
212172.0,6,3,426,2,280,0.0,214.0,140.0,1,146,0.0,146.0,146.0
305924.0,6,6,412,4,272,101974.66666666669,74.0,68.0,2,140,0.0,74.0,70.0
727670.0,6,14,4740,7,653,120305.5,249.0,93.28571428571428,7,4087,120950.66666666669,1514.0,583.8571428571429
27188.0,6,14,4740,7,653,4360.833333333333,249.0,93.28571428571428,7,4087,4311.0,1514.0,583.8571428571429
3108.0,17,2,224,1,76,0.0,76.0,76.0,1,148,0.0,148.0,148.0
42712.0,6,10,2032,5,524,10465.75,252.0,104.8,5,1508,10385.0,1236.0,301.6
197378.0,17,2,180,1,90,0.0,90.0,90.0,1,90,0.0,90.0,90.0
21861.0,17,2,582,1,83,0.0,83.0,83.0,1,499,0.0,499.0,499.0
103899.0,17,2,762,2,762,0.0,381.0,381.0,0,0,0.0,0.0,0.0
228866.0,6,10,1221,6,636,45773.2,298.0,106.0,4,585,74528.33333333333,379.0,146.25
210347.0,6,3,426,2,280,0.0,214.0,140.0,1,146,0.0,146.0,146.0
147928.0,17,2,180,1,90,0.0,90.0,90.0,1,90,0.0,90.0,90.0
41489.0,6,14,4740,7,653,6574.833333333333,249.0,93.28571428571428,7,4087,6730.166666666667,1514.0,583.8571428571429
108001299.0,17,13,821,7,432,18000216.5,174.0,61.71428571428572,6,389,17601301.6,174.0,64.83333333333333
1307458.0,6,4,264,2,132,0.0,66.0,66.0,2,132,0.0,66.0,66.0
302060.0,6,6,412,4,272,100686.66666666669,74.0,68.0,2,140,0.0,74.0,70.0
3693242.0,17,3,1026,3,1026,1846621.0,342.0,342.0,0,0,0.0,0.0,0.0
26557.0,6,11,2098,6,590,4319.0,252.0,98.33333333333331,5,1508,6052.75,1236.0,301.6
3564.0,17,2,414,1,88,0.0,88.0,88.0,1,326,0.0,326.0,326.0
1037915.0,6,11,1134,6,558,207583.0,220.0,93.0,5,576,257045.75,304.0,115.2
120022344.0,6,25,1924,14,1084,9232488.0,95.0,77.42857142857143,11,840,9047151.9,95.0,76.36363636363636
2785.0,17,2,762,2,762,0.0,381.0,381.0,0,0,0.0,0.0,0.0
0.0,17,1,350,1,350,0.0,350.0,350.0,0,0,0.0,0.0,0.0
303642.0,6,2,132,1,66,0.0,66.0,66.0,1,66,0.0,66.0,66.0
32684585.0,6,5,336,2,134,0.0,68.0,67.0,3,202,14951760.0,70.0,67.33333333333333
108346.0,17,2,286,2,286,0.0,143.0,143.0,0,0,0.0,0.0,0.0
90213257.0,6,24,1829,11,840,8997706.5,95.0,76.36363636363636,13,989,7500731.25,95.0,76.07692307692308
62859.0,6,10,2032,5,524,13604.75,252.0,104.8,5,1508,15446.25,1236.0,301.6
96525853.0,6,40,2640,20,1320,5080308.052631579,66.0,66.0,20,1320,5065960.684210527,66.0,66.0
312197.0,6,3,202,2,128,0.0,74.0,64.0,1,74,0.0,74.0,74.0
299114.0,6,6,412,4,272,99704.66666666669,74.0,68.0,2,140,0.0,74.0,70.0
228381.0,17,2,180,1,90,0.0,90.0,90.0,1,90,0.0,90.0,90.0
200972.0,17,4,6056,4,6056,66990.66666666667,1514.0,1514.0,0,0,0.0,0.0,0.0
116439721.0,6,475,76906,238,16078,491306.8396624473,214.0,67.5546218487395,237,60828,488881.6779661017,1514.0,256.65822784810126
236246.0,6,3,337,2,214,0.0,160.0,107.0,1,123,0.0,123.0,123.0
82977188.0,17,14,4796,13,4446,6230435.0,342.0,342.0,1,350,0.0,350.0,350.0
179820.0,17,2,180,1,90,0.0,90.0,90.0,1,90,0.0,90.0,90.0
21861.0,6,14,4740,7,653,3418.1666666666665,249.0,93.28571428571428,7,4087,3105.333333333333,1514.0,583.8571428571429
108107940.0,17,5,1005,5,1005,27026985.0,201.0,201.0,0,0,0.0,0.0,0.0
119956.0,17,2,180,1,70,0.0,70.0,70.0,1,110,0.0,110.0,110.0
279825.0,17,2,180,1,90,0.0,90.0,90.0,1,90,0.0,90.0,90.0
857353.0,6,9,1268,6,797,171470.6,459.0,132.83333333333334,3,471,292372.5,331.0,157.0
135130642.0,17,6,1146,6,1146,27026128.4,191.0,191.0,0,0,0.0,0.0,0.0
207316.0,6,3,426,2,280,0.0,214.0,140.0,1,146,0.0,146.0,146.0
90257230.0,6,14,2252,8,1028,12893890.0,188.0,128.5,6,1224,18018773.2,204.0,204.0
96030.0,17,2,762,2,762,0.0,381.0,381.0,0,0,0.0,0.0,0.0
52613.0,6,14,4740,7,653,7564.0,249.0,93.28571428571428,7,4087,7535.0,1514.0,583.8571428571429
146279.0,6,3,337,2,214,0.0,160.0,107.0,1,123,0.0,123.0,123.0
3005305.0,6,11,2106,6,598,600896.2,252.0,99.66666666666669,5,1508,1625.5,1236.0,301.6
205312.0,17,2,762,2,762,0.0,381.0,381.0,0,0,0.0,0.0,0.0
2055010.0,6,19,6869,11,1567,205501.0,408.0,142.45454545454547,8,5302,230503.14285714287,1514.0,662.75
5839269.0,6,5,1736,2,819,0.0,753.0,409.5,3,917,2851698.5,785.0,305.6666666666667
204871.0,17,2,762,2,762,0.0,381.0,381.0,0,0,0.0,0.0,0.0
90755067.0,6,19,1436,10,745,10079208.888888888,95.0,74.5,9,691,11342985.875,95.0,76.77777777777777
277911.0,17,2,363,1,79,0.0,79.0,79.0,1,284,0.0,284.0,284.0
237680.0,6,3,337,2,214,0.0,160.0,107.0,1,123,0.0,123.0,123.0
90292716.0,6,15,2444,8,1016,12898959.42857143,188.0,127.0,7,1428,15021139.333333334,204.0,204.0
108112048.0,17,5,955,5,955,27028012.0,191.0,191.0,0,0,0.0,0.0,0.0
248115.0,6,3,373,2,238,0.0,172.0,119.0,1,135,0.0,135.0,135.0
108011.0,17,2,286,2,286,0.0,143.0,143.0,0,0,0.0,0.0,0.0
90257183.0,6,12,1832,8,1016,12893883.285714284,188.0,127.0,4,816,30030867.0,204.0,204.0
90299941.0,6,19,1436,10,745,10027762.555555556,95.0,74.5,9,691,11287235.75,95.0,76.77777777777777
327331.0,6,6,412,4,272,109110.33333333331,74.0,68.0,2,140,0.0,74.0,70.0
9989.0,17,4,823,2,163,0.0,89.0,81.5,2,660,0.0,443.0,330.0
206811.0,6,3,426,2,280,0.0,214.0,140.0,1,146,0.0,146.0,146.0
108097765.0,17,5,955,5,955,27024441.25,191.0,191.0,0,0,0.0,0.0,0.0
20459.0,6,14,4740,7,653,2617.5,249.0,93.28571428571428,7,4087,3277.6666666666665,1514.0,583.8571428571429
148125.0,17,2,180,1,90,0.0,90.0,90.0,1,90,0.0,90.0,90.0
117247041.0,6,696,92586,348,23264,337863.50720461097,140.0,66.85057471264368,348,69322,337834.144092219,480.0,199.20114942528733
119312323.0,6,231,26330,116,7878,1037498.4608695653,140.0,67.91379310344827,115,18452,1037442.9298245612,336.0,160.45217391304348
538146.0,17,6,2100,6,2100,107629.2,350.0,350.0,0,0,0.0,0.0,0.0
203870.0,6,10,1221,6,636,40774.0,298.0,106.0,4,585,67030.66666666667,379.0,146.25
2789905.0,6,2,132,1,66,0.0,66.0,66.0,1,66,0.0,66.0,66.0
13934.0,6,11,1131,6,600,2156.6,262.0,100.0,5,531,3142.25,259.0,106.2
299125.0,6,6,412,4,272,99708.33333333331,74.0,68.0,2,140,0.0,74.0,70.0
90250016.0,6,13,2036,8,1016,12892859.42857143,188.0,127.0,5,1020,22521304.75,204.0,204.0
107342660.0,17,14,864,7,432,17834989.333333332,174.0,61.71428571428572,7,432,17833503.0,174.0,61.71428571428572
285127.0,17,4,704,2,148,0.0,74.0,74.0,2,556,0.0,280.0,278.0
108703.0,17,2,286,2,286,0.0,143.0,143.0,0,0,0.0,0.0,0.0
18799.0,17,3,1026,3,1026,9399.5,342.0,342.0,0,0,0.0,0.0,0.0
2438.0,17,4,344,2,150,0.0,75.0,75.0,2,194,0.0,103.0,97.0
235176.0,6,3,373,2,238,0.0,172.0,119.0,1,135,0.0,135.0,135.0
49083.0,6,14,4740,7,653,8002.333333333333,249.0,93.28571428571428,7,4087,7522.0,1514.0,583.8571428571429
305648.0,6,6,412,4,272,101882.66666666669,74.0,68.0,2,140,0.0,74.0,70.0
22729.0,6,14,4740,7,653,3677.6666666666665,249.0,93.28571428571428,7,4087,3617.5,1514.0,583.8571428571429
104145137.0,17,14,1388,7,694,17330701.833333332,174.0,99.14285714285714,7,694,17330691.833333332,174.0,99.14285714285714
12590.0,6,13,1459,7,862,2021.5,271.0,123.14285714285714,6,597,2187.2,259.0,99.5
2594116.0,6,2,132,1,66,0.0,66.0,66.0,1,66,0.0,66.0,66.0
2307.0,17,4,344,2,150,0.0,75.0,75.0,2,194,0.0,103.0,97.0
51696.0,6,10,2032,5,524,12704.0,252.0,104.8,5,1508,10448.25,1236.0,301.6
135139268.0,17,6,1206,6,1206,27027853.6,201.0,201.0,0,0,0.0,0.0,0.0
2672.0,17,4,344,2,150,0.0,75.0,75.0,2,194,0.0,103.0,97.0
24263.0,6,10,2032,5,524,5827.5,252.0,104.8,5,1508,5831.25,1236.0,301.6
120255206.0,6,31,2113,16,1165,8017013.733333333,139.0,72.8125,15,948,8416119.42857143,123.0,63.2
22875.0,6,11,1131,6,600,4299.0,262.0,100.0,5,531,5113.75,259.0,106.2
207679.0,17,2,762,2,762,0.0,381.0,381.0,0,0,0.0,0.0,0.0
150276.0,6,4,391,2,214,0.0,160.0,107.0,2,177,0.0,123.0,88.5
233499.0,6,3,337,2,214,0.0,160.0,107.0,1,123,0.0,123.0,123.0
218166.0,6,3,426,2,280,0.0,214.0,140.0,1,146,0.0,146.0,146.0
10181.0,6,11,2098,6,590,1914.0,252.0,98.33333333333331,5,1508,2011.5,1236.0,301.6
102545.0,17,2,286,2,286,0.0,143.0,143.0,0,0,0.0,0.0,0.0
291.0,17,2,174,1,79,0.0,79.0,79.0,1,95,0.0,95.0,95.0
506488.00000000006,6,5,336,2,134,0.0,68.0,67.0,3,202,196740.5,70.0,67.33333333333333
11725124.0,17,4,1368,4,1368,3908374.6666666665,342.0,342.0,0,0,0.0,0.0,0.0
10481341.0,6,7,478,4,272,3448448.6666666665,74.0,68.0,3,206,5172576.0,74.0,68.66666666666667
251955.0,6,3,337,2,214,0.0,160.0,107.0,1,123,0.0,123.0,123.0
120066581.0,6,230,25978,115,7886,1045959.6403508772,140.0,68.57391304347826,115,18092,1047014.1842105264,284.0,157.3217391304348
425509.0,6,13,1394,7,797,70918.16666666667,253.0,113.85714285714286,6,597,82307.4,259.0,99.5
36590.0,6,10,2032,5,524,8396.25,252.0,104.8,5,1508,8270.0,1236.0,301.6
35886.0,6,14,4740,7,653,5438.333333333333,249.0,93.28571428571428,7,4087,5702.333333333333,1514.0,583.8571428571429
103591.0,17,2,286,2,286,0.0,143.0,143.0,0,0,0.0,0.0,0.0
289459.0,17,4,1524,4,1524,96486.33333333331,381.0,381.0,0,0,0.0,0.0,0.0
1112750.0,6,13,1394,7,797,185458.3333333333,253.0,113.85714285714286,6,597,219800.8,259.0,99.5
120103062.0,6,14,2240,6,1224,24020612.4,204.0,204.0,8,1016,17095121.714285713,188.0,127.0
10922970.0,6,8,544,4,272,3595557.6666666665,74.0,68.0,4,272,3595504.6666666665,74.0,68.0
74544318.0,6,9,842,9,842,9318039.75,97.0,93.55555555555556,0,0,0.0,0.0,0.0
2074.0,17,4,344,2,150,0.0,75.0,75.0,2,194,0.0,103.0,97.0
117816193.0,6,48,3168,24,1584,5122443.173913044,66.0,66.0,24,1584,5113049.739130435,66.0,66.0
0.0,6,1,66,0,0,0.0,0.0,0.0,1,66,0.0,66.0,66.0
2651759.0,6,3,1604,1,753,0.0,753.0,753.0,2,851,0.0,785.0,425.5
232162.0,6,3,337,2,214,0.0,160.0,107.0,1,123,0.0,123.0,123.0
146040.0,6,3,337,2,214,0.0,160.0,107.0,1,123,0.0,123.0,123.0
135138645.0,17,6,1146,6,1146,27027729.0,191.0,191.0,0,0,0.0,0.0,0.0
101623.0,17,2,286,2,286,0.0,143.0,143.0,0,0,0.0,0.0,0.0
25957721.0,17,5,1718,4,1368,1079482.6666666667,342.0,342.0,1,350,0.0,350.0,350.0
135142869.0,17,6,1206,6,1206,27028573.8,201.0,201.0,0,0,0.0,0.0,0.0
122265.0,6,3,373,2,238,0.0,172.0,119.0,1,135,0.0,135.0,135.0
0.0,17,1,381,1,381,0.0,381.0,381.0,0,0,0.0,0.0,0.0
90299137.0,6,16,1192,8,596,12893228.0,95.0,74.5,8,596,12899257.714285716,95.0,74.5
205850.0,17,2,180,1,90,0.0,90.0,90.0,1,90,0.0,90.0,90.0
118434236.0,6,48,3168,24,1584,5149314.608695652,66.0,66.0,24,1584,5135647.217391305,66.0,66.0
135129171.0,17,6,1206,6,1206,27025834.2,201.0,201.0,0,0,0.0,0.0,0.0
34098.0,6,14,4740,7,653,5524.833333333333,249.0,93.28571428571428,7,4087,5541.666666666667,1514.0,583.8571428571429
120182985.0,6,240,27374,120,8216,1003142.5294117648,140.0,68.46666666666667,120,19158,1003134.1932773108,374.0,159.65
9434.0,17,2,582,1,83,0.0,83.0,83.0,1,499,0.0,499.0,499.0
232944.0,6,3,337,2,214,0.0,160.0,107.0,1,123,0.0,123.0,123.0
216682.0,6,3,426,2,280,0.0,214.0,140.0,1,146,0.0,146.0,146.0
120121072.0,6,12,1832,8,1016,17136862.57142857,188.0,127.0,4,816,30030950.0,204.0,204.0
322.0,17,2,156,1,78,0.0,78.0,78.0,1,78,0.0,78.0,78.0
92880167.0,6,38,2508,19,1254,5159994.5,66.0,66.0,19,1254,5159980.944444444,66.0,66.0
195958.0,17,4,1400,4,1400,65319.333333333336,350.0,350.0,0,0,0.0,0.0,0.0
10457081.0,6,6,412,3,206,5160108.5,74.0,68.66666666666667,3,206,5159956.0,74.0,68.66666666666667
162303.0,17,2,180,1,90,0.0,90.0,90.0,1,90,0.0,90.0,90.0
307738.0,6,6,412,4,272,102579.33333333331,74.0,68.0,2,140,0.0,74.0,70.0
2013.0,17,4,344,2,150,0.0,75.0,75.0,2,194,0.0,103.0,97.0
26856.0,6,10,2032,5,524,5953.0,252.0,104.8,5,1508,6085.0,1236.0,301.6
1023591.0,6,11,1134,6,558,204718.2,220.0,93.0,5,576,254547.0,304.0,115.2
19213261.0,6,26,7627,14,3735,209300.6923076923,1514.0,266.7857142857143,12,3892,1727017.2727272727,1514.0,324.3333333333333
146695.0,6,3,337,2,214,0.0,160.0,107.0,1,123,0.0,123.0,123.0
153446.0,17,2,180,1,90,0.0,90.0,90.0,1,90,0.0,90.0,90.0
222886.0,17,2,180,1,90,0.0,90.0,90.0,1,90,0.0,90.0,90.0
120125920.0,6,12,1832,8,1016,17136365.57142857,188.0,127.0,4,816,30034604.33333333,204.0,204.0
104246669.0,17,14,864,7,432,17334321.666666668,174.0,61.71428571428572,7,432,17333512.5,174.0,61.71428571428572
7089.0,17,2,582,1,83,0.0,83.0,83.0,1,499,0.0,499.0,499.0
322060.0,6,6,412,4,272,107353.33333333331,74.0,68.0,2,140,0.0,74.0,70.0
102859.0,17,2,286,2,286,0.0,143.0,143.0,0,0,0.0,0.0,0.0
538.0,17,2,508,2,508,0.0,257.0,254.0,0,0,0.0,0.0,0.0
235794.0,6,3,373,2,238,0.0,172.0,119.0,1,135,0.0,135.0,135.0
234015.0,6,3,373,2,238,0.0,172.0,119.0,1,135,0.0,135.0,135.0
8234.0,6,10,1975,5,467,1840.0,195.0,93.4,5,1508,1784.0,1236.0,301.6
2042785.0,17,6,1230,3,234,1021176.0,78.0,78.0,3,996,1021188.5,332.0,332.0
18896.0,6,2,145,2,145,0.0,91.0,72.5,0,0,0.0,0.0,0.0
100420338.0,17,12,778,6,389,19933821.0,174.0,64.83333333333333,6,389,20052053.2,174.0,64.83333333333333
7697.0,17,2,582,1,83,0.0,83.0,83.0,1,499,0.0,499.0,499.0
859690.0,6,9,1267,6,796,171938.0,458.0,132.66666666666666,3,471,293558.0,331.0,157.0
1593340.0,6,4,276,2,128,0.0,74.0,64.0,2,148,0.0,74.0,74.0
530350.0,6,3,204,2,136,0.0,70.0,68.0,1,68,0.0,68.0,68.0
2008.0,17,4,344,2,150,0.0,75.0,75.0,2,194,0.0,103.0,97.0
39921.0,6,14,4740,7,653,6305.5,249.0,93.28571428571428,7,4087,6020.666666666667,1514.0,583.8571428571429
9756.0,17,2,582,1,83,0.0,83.0,83.0,1,499,0.0,499.0,499.0
135129192.0,17,6,1146,6,1146,27025838.4,191.0,191.0,0,0,0.0,0.0,0.0
2406.0,17,4,344,2,150,0.0,75.0,75.0,2,194,0.0,103.0,97.0
90208802.0,6,19,1436,9,691,11245708.875,95.0,76.77777777777777,10,745,10000449.0,95.0,74.5
81439.0,6,13,1394,7,797,13573.166666666666,253.0,113.85714285714286,6,597,14807.0,259.0,99.5
92241.0,6,14,4740,7,653,14273.333333333334,249.0,93.28571428571428,7,4087,9486.0,1514.0,583.8571428571429
921.0,17,5,550,5,550,230.25,110.0,110.0,0,0,0.0,0.0,0.0
318140.0,17,4,1400,4,1400,106046.66666666669,350.0,350.0,0,0,0.0,0.0,0.0
46732.0,6,14,4740,7,653,7475.666666666667,249.0,93.28571428571428,7,4087,6024.666666666667,1514.0,583.8571428571429
116614.0,6,13,1420,7,789,18033.0,253.0,112.71428571428572,6,631,22388.0,293.0,105.16666666666669
90255369.0,6,13,2036,8,1016,12893624.142857144,188.0,127.0,5,1020,22523377.5,204.0,204.0
31535.0,6,11,2098,6,590,5294.8,252.0,98.33333333333331,5,1508,6933.75,1236.0,301.6
90259056.0,6,12,1832,8,1016,12894150.857142856,188.0,127.0,4,816,30031607.0,204.0,204.0
307641.0,6,6,412,4,272,102547.0,74.0,68.0,2,140,0.0,74.0,70.0
90013893.0,17,27,12943,27,12943,3462072.8076923075,501.0,479.3703703703704,0,0,0.0,0.0,0.0
171878.0,17,2,180,1,90,0.0,90.0,90.0,1,90,0.0,90.0,90.0
90298770.0,6,19,1436,10,745,10026922.222222222,95.0,74.5,9,691,11285042.5,95.0,76.77777777777777
342.0,17,2,166,1,75,0.0,75.0,75.0,1,91,0.0,91.0,91.0
153463.0,17,2,180,1,90,0.0,90.0,90.0,1,90,0.0,90.0,90.0
2324.0,17,4,344,2,150,0.0,75.0,75.0,2,194,0.0,103.0,97.0
82.0,17,2,762,2,762,0.0,381.0,381.0,0,0,0.0,0.0,0.0
107248.0,17,2,286,2,286,0.0,143.0,143.0,0,0,0.0,0.0,0.0
135121152.0,17,6,1206,6,1206,27024230.4,201.0,201.0,0,0,0.0,0.0,0.0
244832.0,6,3,337,2,214,0.0,160.0,107.0,1,123,0.0,123.0,123.0
10549885.0,6,7,478,4,272,3469626.333333333,74.0,68.0,3,206,5204304.5,74.0,68.66666666666667
90658039.0,6,19,1436,10,745,10067560.666666666,95.0,74.5,9,691,11331948.375,95.0,76.77777777777777
213036.0,6,10,1221,6,636,42607.2,298.0,106.0,4,585,69682.0,379.0,146.25
196987.0,17,2,180,1,90,0.0,90.0,90.0,1,90,0.0,90.0,90.0
120306624.0,6,235,26594,118,18576,1028261.7435897436,284.0,157.42372881355934,117,8018,1020147.1120689656,140.0,68.52991452991454
108113175.0,17,5,955,5,955,27028293.75,191.0,191.0,0,0,0.0,0.0,0.0
98123.0,6,13,1479,7,882,16312.666666666666,291.0,126.0,6,597,18450.2,259.0,99.5
104632042.0,17,13,952,7,563,17407434.5,174.0,80.42857142857143,6,389,19955595.2,174.0,64.83333333333333
107288.0,17,2,286,2,286,0.0,143.0,143.0,0,0,0.0,0.0,0.0
149048.0,17,2,414,1,88,0.0,88.0,88.0,1,326,0.0,326.0,326.0
10456245.0,6,7,478,4,272,3438620.0,74.0,68.0,3,206,5157840.0,74.0,68.66666666666667
0.0,17,1,72,1,72,0.0,72.0,72.0,0,0,0.0,0.0,0.0
90046820.0,17,27,12943,27,12943,3463339.230769231,501.0,479.3703703703704,0,0,0.0,0.0,0.0
123455774.0,6,49,3234,25,1650,5143990.583333333,66.0,66.0,24,1584,5021773.347826087,66.0,66.0
123839945.0,6,49,3234,25,1650,5159997.708333333,66.0,66.0,24,1584,5001873.652173913,66.0,66.0
16519708.000000002,6,27,8809,16,1869,1101313.8666666667,408.0,116.8125,11,6940,1550820.8,1514.0,630.9090909090909
107179.0,17,2,286,2,286,0.0,143.0,143.0,0,0,0.0,0.0,0.0
108104408.0,17,5,955,5,955,27026102.0,191.0,191.0,0,0,0.0,0.0,0.0
40939.0,6,10,2032,5,524,8084.0,252.0,104.8,5,1508,9676.5,1236.0,301.6
90253433.0,6,16,2368,9,1204,11281679.125,188.0,133.77777777777777,7,1164,15015349.333333334,204.0,166.28571428571428
10490208.0,6,7,478,4,272,3451259.0,74.0,68.0,3,206,5176793.5,74.0,68.66666666666667
90295698.0,6,17,1287,9,691,11281607.125,95.0,76.77777777777777,8,596,12897912.42857143,95.0,74.5
37554.0,6,11,2098,6,590,7035.0,252.0,98.33333333333331,5,1508,9089.0,1236.0,301.6
216465.0,6,3,426,2,280,0.0,214.0,140.0,1,146,0.0,146.0,146.0
159186.0,6,2,128,1,74,0.0,74.0,74.0,1,54,0.0,54.0,54.0
47633.0,6,10,2032,5,524,11633.5,252.0,104.8,5,1508,10284.5,1236.0,301.6
15406811.0,17,6,2052,6,2052,3081362.2,342.0,342.0,0,0,0.0,0.0,0.0
42077.0,6,14,4740,7,653,6739.666666666667,249.0,93.28571428571428,7,4087,6875.833333333333,1514.0,583.8571428571429
37212.0,6,10,2032,5,524,7544.75,252.0,104.8,5,1508,8371.25,1236.0,301.6
851188.0,6,9,1096,6,625,170237.6,287.0,104.16666666666669,3,471,287756.5,331.0,157.0
146222.0,6,3,337,2,214,0.0,160.0,107.0,1,123,0.0,123.0,123.0
90066041.0,17,28,13364,28,13364,3335779.296296296,501.0,477.2857142857143,0,0,0.0,0.0,0.0
5554.0,17,4,823,2,163,0.0,89.0,81.5,2,660,0.0,443.0,330.0
483235.0,17,2,363,1,79,0.0,79.0,79.0,1,284,0.0,284.0,284.0
5822110.0,6,5,336,2,134,0.0,68.0,67.0,3,202,1529396.5,70.0,67.33333333333333
108094532.0,17,5,1005,5,1005,27023633.0,201.0,201.0,0,0,0.0,0.0,0.0
4467.0,17,2,180,1,90,0.0,90.0,90.0,1,90,0.0,90.0,90.0
108896.0,17,2,286,2,286,0.0,143.0,143.0,0,0,0.0,0.0,0.0
246234.0,6,3,337,2,214,0.0,160.0,107.0,1,123,0.0,123.0,123.0
38001.0,6,14,4740,7,653,5908.0,249.0,93.28571428571428,7,4087,5456.833333333333,1514.0,583.8571428571429
90285286.0,6,16,1192,8,596,12891535.857142856,95.0,74.5,8,596,12896093.0,95.0,74.5
108104608.0,17,5,955,5,955,27026152.0,191.0,191.0,0,0,0.0,0.0,0.0
97541458.0,6,30,2106,15,1089,6951816.928571428,123.0,72.6,15,1017,6951817.5,123.0,67.8
108106427.0,17,5,955,5,955,27026606.75,191.0,191.0,0,0,0.0,0.0,0.0
5622353.0,6,5,336,2,134,0.0,68.0,67.0,3,202,1527358.5,70.0,67.33333333333333
146201.0,6,3,337,2,214,0.0,160.0,107.0,1,123,0.0,123.0,123.0
120077655.0,17,29,13785,29,13785,4288487.678571428,501.0,475.3448275862069,0,0,0.0,0.0,0.0
3325070.0,6,186,152794,107,143278,31368.584905660377,1510.0,1339.0467289719627,79,9516,38735.58974358974,1510.0,120.45569620253164
248397.0,6,3,337,2,214,0.0,160.0,107.0,1,123,0.0,123.0,123.0
18372.0,6,10,2032,5,524,4370.75,252.0,104.8,5,1508,3255.75,1236.0,301.6
118559844.0,6,228,25756,114,17936,1047285.4159292036,284.0,157.33333333333334,114,7820,1047286.4159292036,140.0,68.59649122807018
96966.0,6,12,1328,7,797,16161.0,253.0,113.85714285714286,5,531,19032.25,259.0,106.2
39656.0,6,14,4740,7,653,6490.166666666667,249.0,93.28571428571428,7,4087,6472.666666666667,1514.0,583.8571428571429
115891657.0,6,32,2236,16,1165,7712447.466666667,139.0,72.8125,16,1071,7712446.2,123.0,66.9375
226956.0,6,3,426,2,280,0.0,214.0,140.0,1,146,0.0,146.0,146.0
1307016.0,6,4,264,2,132,0.0,66.0,66.0,2,132,0.0,66.0,66.0
41601.0,6,14,4740,7,653,6809.0,249.0,93.28571428571428,7,4087,6188.5,1514.0,583.8571428571429
121430.0,6,3,337,2,214,0.0,160.0,107.0,1,123,0.0,123.0,123.0
119364699.0,6,39,3018,19,1440,6631348.0,123.0,75.78947368421052,20,1578,6039772.947368421,123.0,78.9
1105059.0,6,11,1134,6,558,221011.8,220.0,93.0,5,576,275602.0,304.0,115.2
120005111.0,6,18,1341,9,691,14999992.0,95.0,76.77777777777777,9,650,14998887.875,95.0,72.22222222222223
26681.0,6,10,2032,5,524,6441.0,252.0,104.8,5,1508,6409.75,1236.0,301.6
96004228.0,17,11,735,6,389,19200845.6,174.0,64.83333333333333,5,346,19000172.25,174.0,69.2
108108234.0,17,5,955,5,955,27027058.5,191.0,191.0,0,0,0.0,0.0,0.0
15202.0,6,10,2032,5,524,3585.25,252.0,104.8,5,1508,3438.25,1236.0,301.6
2115.0,17,4,344,2,150,0.0,75.0,75.0,2,194,0.0,103.0,97.0
102945.0,17,2,762,2,762,0.0,381.0,381.0,0,0,0.0,0.0,0.0
252159.00000000003,6,3,373,2,238,0.0,172.0,119.0,1,135,0.0,135.0,135.0
543.0,17,2,508,2,508,0.0,257.0,254.0,0,0,0.0,0.0,0.0
336.0,17,2,166,1,75,0.0,75.0,75.0,1,91,0.0,91.0,91.0
2287.0,17,4,344,2,150,0.0,75.0,75.0,2,194,0.0,103.0,97.0
47227.0,6,13,1479,7,882,7397.0,291.0,126.0,6,597,8678.8,259.0,99.5
219663.0,6,3,426,2,280,0.0,214.0,140.0,1,146,0.0,146.0,146.0
30816.0,6,14,4740,7,653,3924.5,249.0,93.28571428571428,7,4087,4998.166666666667,1514.0,583.8571428571429
42113.0,6,14,4740,7,653,6896.833333333333,249.0,93.28571428571428,7,4087,6160.166666666667,1514.0,583.8571428571429
16757.0,17,2,180,1,90,0.0,90.0,90.0,1,90,0.0,90.0,90.0
102114938.0,6,181,20382,91,6228,1134610.4222222222,140.0,68.43956043956044,90,14154,1135749.6629213484,284.0,157.26666666666668
510764.0,6,5,336,2,134,0.0,68.0,67.0,3,202,195507.5,70.0,67.33333333333333
5829353.0,6,5,336,2,134,0.0,68.0,67.0,3,202,1524594.5,70.0,67.33333333333333
228277.0,17,2,180,1,90,0.0,90.0,90.0,1,90,0.0,90.0,90.0
39617.0,6,14,4740,7,653,6366.833333333333,249.0,93.28571428571428,7,4087,6235.5,1514.0,583.8571428571429
316950.0,17,4,1400,4,1400,105650.0,350.0,350.0,0,0,0.0,0.0,0.0
114787727.0,6,48,3168,24,1584,4990770.739130435,66.0,66.0,24,1584,4977544.782608695,66.0,66.0
331.0,17,2,160,1,80,0.0,80.0,80.0,1,80,0.0,80.0,80.0
304375.0,6,6,412,4,272,101458.33333333331,74.0,68.0,2,140,0.0,74.0,70.0
149289.0,6,3,373,2,238,0.0,172.0,119.0,1,135,0.0,135.0,135.0
300641.0,6,6,412,4,272,100213.66666666669,74.0,68.0,2,140,0.0,74.0,70.0
5269.0,17,4,344,2,150,0.0,75.0,75.0,2,194,0.0,103.0,97.0
206261.0,6,3,426,2,280,0.0,214.0,140.0,1,146,0.0,146.0,146.0
143904.0,17,2,180,1,90,0.0,90.0,90.0,1,90,0.0,90.0,90.0
873.0,17,4,820,2,156,0.0,78.0,78.0,2,664,0.0,332.0,332.0
52982.0,6,10,2032,5,524,13026.5,252.0,104.8,5,1508,12816.0,1236.0,301.6
120052109.0,17,29,13785,29,13785,4287575.321428572,501.0,475.3448275862069,0,0,0.0,0.0,0.0
209799.0,6,3,426,2,280,0.0,214.0,140.0,1,146,0.0,146.0,146.0
40612.0,6,14,4740,7,653,6637.5,249.0,93.28571428571428,7,4087,6282.0,1514.0,583.8571428571429
108105810.0,17,5,955,5,955,27026452.5,191.0,191.0,0,0,0.0,0.0,0.0
153456.0,17,2,180,1,90,0.0,90.0,90.0,1,90,0.0,90.0,90.0
1304074.0,6,4,264,2,132,0.0,66.0,66.0,2,132,0.0,66.0,66.0
55876.0,6,14,4740,7,653,9190.166666666666,249.0,93.28571428571428,7,4087,8956.333333333334,1514.0,583.8571428571429
160994.0,17,2,180,1,90,0.0,90.0,90.0,1,90,0.0,90.0,90.0
2427.0,17,4,344,2,150,0.0,75.0,75.0,2,194,0.0,103.0,97.0
93966469.0,6,40,2640,20,1320,4945603.631578947,66.0,66.0,20,1320,4934228.157894737,66.0,66.0
355263.0,6,5,367,2,132,0.0,66.0,66.0,3,235,177631.5,103.0,78.33333333333333
19637.0,6,14,4740,7,653,2681.0,249.0,93.28571428571428,7,4087,3135.333333333333,1514.0,583.8571428571429
43755.0,6,14,4740,7,653,7054.0,249.0,93.28571428571428,7,4087,7000.166666666667,1514.0,583.8571428571429
119998355.0,17,34,16284,34,16284,3636313.787878788,501.0,478.9411764705882,0,0,0.0,0.0,0.0
114310515.0,6,431,56926,216,14552,531676.8139534884,140.0,67.37037037037037,215,42374,529304.0794392524,336.0,197.08837209302325
2596767.0,6,2,132,1,66,0.0,66.0,66.0,1,66,0.0,66.0,66.0
31394.0,6,14,4740,7,653,4618.0,249.0,93.28571428571428,7,4087,5049.833333333333,1514.0,583.8571428571429
125234652.0,17,14,864,7,432,17667551.5,174.0,61.71428571428572,7,432,17666847.0,174.0,61.71428571428572
28985.0,6,10,2032,5,524,5840.5,252.0,104.8,5,1508,5427.0,1236.0,301.6
46370.0,6,14,4740,7,653,7536.5,249.0,93.28571428571428,7,4087,7588.833333333333,1514.0,583.8571428571429
115006099.0,17,13,821,7,432,19167683.166666668,174.0,61.71428571428572,6,389,19000155.0,174.0,64.83333333333333
207280.0,6,3,426,2,280,0.0,214.0,140.0,1,146,0.0,146.0,146.0
9061.0,17,4,823,2,163,0.0,89.0,81.5,2,660,0.0,443.0,330.0
320108.0,17,4,1400,4,1400,106702.66666666669,350.0,350.0,0,0,0.0,0.0,0.0
2604500.0,6,25,7573,14,3735,200346.15384615384,1514.0,266.7857142857143,11,3838,235143.4,1514.0,348.90909090909093
208074.0,6,3,426,2,280,0.0,214.0,140.0,1,146,0.0,146.0,146.0
1479877.0,17,16,1120,16,1120,98658.46666666666,70.0,70.0,0,0,0.0,0.0,0.0
147050.0,6,3,337,2,214,0.0,160.0,107.0,1,123,0.0,123.0,123.0
30317.0,6,14,4740,7,653,4901.0,249.0,93.28571428571428,7,4087,4924.5,1514.0,583.8571428571429
51722.0,6,14,4740,7,653,8450.0,249.0,93.28571428571428,7,4087,8484.5,1514.0,583.8571428571429
111049.0,17,4,1400,4,1400,37016.333333333336,350.0,350.0,0,0,0.0,0.0,0.0
1161918.0,6,13,3012,8,2384,165988.2857142857,1514.0,298.0,5,628,222379.25,331.0,125.6
228270.0,17,2,180,1,90,0.0,90.0,90.0,1,90,0.0,90.0,90.0
108106620.0,17,5,955,5,955,27026655.0,191.0,191.0,0,0,0.0,0.0,0.0
90060268.0,17,28,13364,28,13364,3335565.4814814813,501.0,477.2857142857143,0,0,0.0,0.0,0.0
535843.0,17,6,2100,6,2100,107168.6,350.0,350.0,0,0,0.0,0.0,0.0
332.0,17,2,166,1,75,0.0,75.0,75.0,1,91,0.0,91.0,91.0
179273.0,17,4,1524,4,1524,59757.66666666666,381.0,381.0,0,0,0.0,0.0,0.0
39584.0,6,10,2032,5,524,6520.25,252.0,104.8,5,1508,9405.75,1236.0,301.6
1473345.0,17,16,1120,16,1120,98223.0,70.0,70.0,0,0,0.0,0.0,0.0
487404.0,6,5,336,2,134,0.0,68.0,67.0,3,202,192363.0,70.0,67.33333333333333
213873.0,6,10,1221,6,636,42774.6,298.0,106.0,4,585,69917.66666666667,379.0,146.25
299363.0,6,6,412,4,272,99787.66666666669,74.0,68.0,2,140,0.0,74.0,70.0
110632812.0,6,32,2220,16,1149,7361129.266666667,123.0,71.8125,16,1071,7361120.866666666,123.0,66.9375
120125136.0,6,13,2020,9,1204,15015642.0,188.0,133.77777777777777,4,816,30031349.33333333,204.0,204.0
135131352.0,17,6,1206,6,1206,27026270.4,201.0,201.0,0,0,0.0,0.0,0.0
17082.0,6,11,2098,6,590,2259.4,252.0,98.33333333333331,5,1508,3920.75,1236.0,301.6
123840120.0,6,49,3234,25,1650,5160005.0,66.0,66.0,24,1584,4946069.434782608,66.0,66.0
43135.0,6,10,1066,5,490,8220.5,218.0,98.0,5,576,10576.25,304.0,115.2
213607.0,17,2,180,1,90,0.0,90.0,90.0,1,90,0.0,90.0,90.0
52011.0,6,14,4740,7,653,8472.333333333334,249.0,93.28571428571428,7,4087,8530.666666666666,1514.0,583.8571428571429
51793.0,6,13,1386,7,789,8583.5,253.0,112.71428571428572,6,597,10021.6,259.0,99.5
321678.0,6,6,412,4,272,107226.0,74.0,68.0,2,140,0.0,74.0,70.0
90035559.0,17,28,13364,28,13364,3334650.333333333,501.0,477.2857142857143,0,0,0.0,0.0,0.0
237650.0,17,2,180,1,90,0.0,90.0,90.0,1,90,0.0,90.0,90.0
38203.0,6,14,4740,7,653,5875.166666666667,249.0,93.28571428571428,7,4087,6101.333333333333,1514.0,583.8571428571429
205869.0,17,2,180,1,90,0.0,90.0,90.0,1,90,0.0,90.0,90.0
279277.0,6,10,1221,6,636,55855.4,298.0,106.0,4,585,87690.66666666667,379.0,146.25
90020384.0,17,28,13364,28,13364,3334088.296296296,501.0,477.2857142857143,0,0,0.0,0.0,0.0
12602626.0,6,5,1736,3,917,6236037.5,785.0,305.6666666666667,2,819,0.0,753.0,409.5
108259162.0,6,31,2182,16,1165,7217277.466666667,139.0,72.8125,15,1017,7717360.142857143,123.0,67.8
4245.0,17,2,598,1,72,0.0,72.0,72.0,1,526,0.0,526.0,526.0
211016.0,6,3,426,2,280,0.0,214.0,140.0,1,146,0.0,146.0,146.0
115328.0,6,15,4806,8,719,14587.0,249.0,89.875,7,4087,18928.666666666668,1514.0,583.8571428571429
10518.0,6,10,1067,5,536,2398.0,264.0,107.2,5,531,1820.5,259.0,106.2
57121.0,6,14,4740,7,653,9397.166666666666,249.0,93.28571428571428,7,4087,9255.5,1514.0,583.8571428571429
3171037.0,6,18,1495,9,921,357918.5,315.0,102.33333333333331,9,574,357934.5,78.0,63.77777777777778
108741115.0,6,33,2412,17,1272,6796319.6875,123.0,74.82352941176471,16,1140,7234977.933333334,123.0,71.25
314383.0,6,6,412,4,272,104794.33333333331,74.0,68.0,2,140,0.0,74.0,70.0
51939.0,6,14,4740,7,653,8529.333333333334,249.0,93.28571428571428,7,4087,7947.666666666667,1514.0,583.8571428571429
2067.0,17,4,344,2,150,0.0,75.0,75.0,2,194,0.0,103.0,97.0
92363820.0,6,176,19872,88,13842,1059177.8735632184,284.0,157.29545454545453,88,6030,1059178.6666666667,140.0,68.52272727272727
232729.0,6,3,337,2,214,0.0,160.0,107.0,1,123,0.0,123.0,123.0
27220.0,6,14,4740,7,653,4380.833333333333,249.0,93.28571428571428,7,4087,3699.0,1514.0,583.8571428571429
96900166.0,6,191,21598,96,6558,1020001.747368421,140.0,68.3125,95,15040,1026010.7021276596,284.0,158.31578947368422
268734.0,6,10,1221,6,636,53746.8,298.0,106.0,4,585,83822.33333333333,379.0,146.25
280161.0,17,2,363,1,79,0.0,79.0,79.0,1,284,0.0,284.0,284.0
3269121.0,6,3,1604,1,753,0.0,753.0,753.0,2,851,0.0,785.0,425.5
101535039.0,17,14,864,7,432,16834479.166666668,174.0,61.71428571428572,7,432,16833492.0,174.0,61.71428571428572
26986.0,6,14,4740,7,653,3940.1666666666665,249.0,93.28571428571428,7,4087,4269.5,1514.0,583.8571428571429
51442.0,6,14,4740,7,653,7301.5,249.0,93.28571428571428,7,4087,8436.666666666666,1514.0,583.8571428571429
48810.0,6,14,4740,7,653,6353.0,249.0,93.28571428571428,7,4087,7909.333333333333,1514.0,583.8571428571429
86832.0,6,14,4740,7,653,14260.666666666666,249.0,93.28571428571428,7,4087,14283.0,1514.0,583.8571428571429
90034298.0,17,28,13364,28,13364,3334603.6296296297,501.0,477.2857142857143,0,0,0.0,0.0,0.0
155214.0,6,3,337,2,214,0.0,160.0,107.0,1,123,0.0,123.0,123.0
0.0,17,1,350,1,350,0.0,350.0,350.0,0,0,0.0,0.0,0.0
48314.0,6,10,2032,5,524,11852.75,252.0,104.8,5,1508,10614.25,1236.0,301.6
133426.0,6,12,1354,6,723,26185.4,253.0,120.5,6,631,25666.2,293.0,105.16666666666669
1299097.0,17,6,1230,3,234,649359.5,78.0,78.0,3,996,649293.5,332.0,332.0
51371.0,6,14,4740,7,653,8438.166666666666,249.0,93.28571428571428,7,4087,8162.333333333333,1514.0,583.8571428571429
305.0,17,2,174,1,79,0.0,79.0,79.0,1,95,0.0,95.0,95.0
25382.0,6,10,2032,5,524,6140.25,252.0,104.8,5,1508,6018.0,1236.0,301.6
217945.0,6,13,1386,7,789,36324.16666666666,253.0,112.71428571428572,6,597,40888.8,259.0,99.5
2336.0,17,4,344,2,150,0.0,75.0,75.0,2,194,0.0,103.0,97.0
301751.0,6,6,412,4,272,100583.66666666669,74.0,68.0,2,140,0.0,74.0,70.0
0.0,17,1,350,1,350,0.0,350.0,350.0,0,0,0.0,0.0,0.0
234586.0,6,3,373,2,238,0.0,172.0,119.0,1,135,0.0,135.0,135.0
525272.0,6,3,1604,2,851,0.0,785.0,425.5,1,753,0.0,753.0,753.0
105143651.0,17,18,2014,9,1079,13125158.0,394.0,119.88888888888889,9,935,13125730.375,250.0,103.88888888888889
222500.0,17,2,180,1,90,0.0,90.0,90.0,1,90,0.0,90.0,90.0
145016.0,6,3,337,2,214,0.0,160.0,107.0,1,123,0.0,123.0,123.0
98667.0,17,2,762,2,762,0.0,381.0,381.0,0,0,0.0,0.0,0.0
3347.0,17,2,414,1,88,0.0,88.0,88.0,1,326,0.0,326.0,326.0
208963.0,6,3,426,2,280,0.0,214.0,140.0,1,146,0.0,146.0,146.0
294229.0,17,2,246,1,76,0.0,76.0,76.0,1,170,0.0,170.0,170.0
120118831.0,6,15,2444,7,1428,20019805.166666668,204.0,204.0,8,1016,17097864.0,188.0,127.0
16741.0,6,10,2032,5,524,3351.0,252.0,104.8,5,1508,3607.25,1236.0,301.6
120037983.0,17,28,13364,28,13364,4445851.222222222,501.0,477.2857142857143,0,0,0.0,0.0,0.0
135127514.0,17,6,1146,6,1146,27025502.8,191.0,191.0,0,0,0.0,0.0,0.0
108093100.0,17,5,1005,5,1005,27023275.0,201.0,201.0,0,0,0.0,0.0,0.0
207484.0,6,3,426,2,280,0.0,214.0,140.0,1,146,0.0,146.0,146.0
204681.0,17,2,762,2,762,0.0,381.0,381.0,0,0,0.0,0.0,0.0
90764741.0,6,18,1382,10,786,10079252.555555556,95.0,78.6,8,596,12964494.285714284,95.0,74.5
69907.0,17,2,620,1,75,0.0,75.0,75.0,1,545,0.0,545.0,545.0
108105183.0,17,5,955,5,955,27026295.75,191.0,191.0,0,0,0.0,0.0,0.0
207311.0,6,3,426,2,280,0.0,214.0,140.0,1,146,0.0,146.0,146.0
2192.0,17,4,344,2,150,0.0,75.0,75.0,2,194,0.0,103.0,97.0
2314.0,17,4,344,2,150,0.0,75.0,75.0,2,194,0.0,103.0,97.0
1314135.0,6,4,264,2,132,0.0,66.0,66.0,2,132,0.0,66.0,66.0
53075.0,6,14,4740,7,653,8709.0,249.0,93.28571428571428,7,4087,8145.333333333333,1514.0,583.8571428571429
111342.0,6,10,1065,5,534,27601.0,262.0,106.8,5,531,26068.0,259.0,106.2
90095947.0,6,11,1644,4,816,30030496.666666668,204.0,204.0,7,828,15015696.5,188.0,118.28571428571428
10471641.0,6,7,478,4,272,3443286.333333333,74.0,68.0,3,206,5164818.5,74.0,68.66666666666667
260641.0,6,3,337,2,214,0.0,160.0,107.0,1,123,0.0,123.0,123.0
108109076.0,17,5,955,5,955,27027269.0,191.0,191.0,0,0,0.0,0.0,0.0
66485.0,6,14,4740,7,653,10864.166666666666,249.0,93.28571428571428,7,4087,10310.333333333334,1514.0,583.8571428571429
1978.0,17,2,180,1,90,0.0,90.0,90.0,1,90,0.0,90.0,90.0
18505.0,6,14,4740,7,653,2971.333333333333,249.0,93.28571428571428,7,4087,2713.833333333333,1514.0,583.8571428571429
316.0,17,2,174,1,79,0.0,79.0,79.0,1,95,0.0,95.0,95.0
2404.0,17,4,344,2,150,0.0,75.0,75.0,2,194,0.0,103.0,97.0
319884.0,6,6,412,4,272,106628.0,74.0,68.0,2,140,0.0,74.0,70.0
190888.0,17,2,180,1,90,0.0,90.0,90.0,1,90,0.0,90.0,90.0
30900.0,6,10,2032,5,524,7206.5,252.0,104.8,5,1508,6985.75,1236.0,301.6
32679124.0,6,5,336,2,134,0.0,68.0,67.0,3,202,14946754.5,70.0,67.33333333333333
1032260.0,6,6,482,4,338,343289.3333333333,103.0,84.5,2,144,0.0,78.0,72.0
18625.0,17,2,180,1,90,0.0,90.0,90.0,1,90,0.0,90.0,90.0
36577.0,6,14,4740,7,653,5628.0,249.0,93.28571428571428,7,4087,5934.833333333333,1514.0,583.8571428571429
26646.0,6,14,4740,7,653,4321.833333333333,249.0,93.28571428571428,7,4087,3780.6666666666665,1514.0,583.8571428571429
2602034.0,6,2,132,1,66,0.0,66.0,66.0,1,66,0.0,66.0,66.0
90712826.0,17,17,5814,17,5814,5669551.625,342.0,342.0,0,0,0.0,0.0,0.0
233552.0,6,3,337,2,214,0.0,160.0,107.0,1,123,0.0,123.0,123.0
11224.0,6,10,1949,5,441,2572.0,169.0,88.2,5,1508,2526.5,1236.0,301.6
103946247.0,6,182,20538,91,6228,1145796.0222222223,140.0,68.43956043956044,91,14310,1146891.088888889,284.0,157.25274725274724
114000939.0,17,13,821,7,432,19000156.5,174.0,61.71428571428572,6,389,19970909.2,174.0,64.83333333333333
98087436.0,17,14,1126,7,563,16333471.833333334,174.0,80.42857142857143,7,563,16334086.666666666,174.0,80.42857142857143
2332.0,17,4,344,2,150,0.0,75.0,75.0,2,194,0.0,103.0,97.0
42097.0,6,14,4740,7,653,6083.333333333333,249.0,93.28571428571428,7,4087,6874.166666666667,1514.0,583.8571428571429
2330.0,17,4,344,2,150,0.0,75.0,75.0,2,194,0.0,103.0,97.0
58757703.0,17,9,3086,8,2736,5109279.0,342.0,342.0,1,350,0.0,350.0,350.0
90290815.0,6,21,1585,11,840,9024144.6,95.0,76.36363636363636,10,745,10001776.888888888,95.0,74.5
119383855.0,17,14,864,7,432,19835220.666666668,174.0,61.71428571428572,7,432,19833492.0,174.0,61.71428571428572
144005.0,17,2,180,1,90,0.0,90.0,90.0,1,90,0.0,90.0,90.0
52996.0,6,14,4740,7,653,8716.833333333334,249.0,93.28571428571428,7,4087,7799.666666666667,1514.0,583.8571428571429
352.0,17,2,267,1,83,0.0,83.0,83.0,1,184,0.0,184.0,184.0
3369049.0,6,18,1577,9,1003,383728.75,315.0,111.44444444444444,9,574,383762.375,78.0,63.77777777777778
303198.0,6,2,132,1,66,0.0,66.0,66.0,1,66,0.0,66.0,66.0
48093.0,6,14,4740,7,653,6498.5,249.0,93.28571428571428,7,4087,7837.333333333333,1514.0,583.8571428571429
2795279.0,6,2,132,1,66,0.0,66.0,66.0,1,66,0.0,66.0,66.0
197442.0,17,2,180,1,90,0.0,90.0,90.0,1,90,0.0,90.0,90.0
101580.0,6,10,2032,5,524,25101.5,252.0,104.8,5,1508,3658.0,1236.0,301.6
2214735.0,6,24,4409,13,1501,184561.25,311.0,115.46153846153848,11,2908,197677.0,1514.0,264.3636363636364
90257569.0,6,12,1832,8,1016,12893938.42857143,188.0,127.0,4,816,30030888.666666668,204.0,204.0
103543030.0,6,44,2904,22,1452,4930620.476190476,66.0,66.0,22,1452,4915923.571428572,66.0,66.0
24023559.0,17,3,1026,3,1026,12011779.500000002,342.0,342.0,0,0,0.0,0.0,0.0
217955.0,6,3,426,2,280,0.0,214.0,140.0,1,146,0.0,146.0,146.0
92955814.0,6,39,2574,20,1320,4892397.105263158,66.0,66.0,19,1254,5159997.0,66.0,66.0
330.0,17,2,166,1,75,0.0,75.0,75.0,1,91,0.0,91.0,91.0
46073.0,6,14,4740,7,653,7359.666666666667,249.0,93.28571428571428,7,4087,6334.5,1514.0,583.8571428571429
115739681.0,6,48,3168,24,1584,5032160.043478261,66.0,66.0,24,1584,5018490.173913044,66.0,66.0
120077830.0,17,28,13364,28,13364,4447327.037037037,501.0,477.2857142857143,0,0,0.0,0.0,0.0
1347853.0,17,16,1120,16,1120,89856.86666666667,70.0,70.0,0,0,0.0,0.0,0.0
120006838.0,6,24,1829,13,1030,9999986.416666666,95.0,79.23076923076923,11,799,11999634.0,95.0,72.63636363636364
10465674.0,6,7,478,4,272,3442976.6666666665,74.0,68.0,3,206,5164318.0,74.0,68.66666666666667
27975384.0,17,5,1710,5,1710,6993846.0,342.0,342.0,0,0,0.0,0.0,0.0
45713.0,6,14,4740,7,653,7500.666666666667,249.0,93.28571428571428,7,4087,6312.333333333333,1514.0,583.8571428571429
254186.00000000003,17,4,6056,4,6056,84728.66666666667,1514.0,1514.0,0,0,0.0,0.0,0.0
135140644.0,17,6,1146,6,1146,27028128.8,191.0,191.0,0,0,0.0,0.0,0.0
217937.0,6,3,426,2,280,0.0,214.0,140.0,1,146,0.0,146.0,146.0
1585285.0,6,20,7599,11,1469,158528.5,583.0,133.54545454545453,9,6130,166366.875,1484.0,681.1111111111111
1186706.0,6,13,3010,8,2382,169529.42857142858,1514.0,297.75,5,628,227745.25,331.0,125.6
2589195.0,6,2,132,1,66,0.0,66.0,66.0,1,66,0.0,66.0,66.0
14862.0,17,4,823,2,163,0.0,89.0,81.5,2,660,0.0,443.0,330.0
118087381.0,6,48,3168,24,1584,5134233.956521739,66.0,66.0,24,1584,5120969.043478261,66.0,66.0
140328.0,6,2,132,1,66,0.0,66.0,66.0,1,66,0.0,66.0,66.0
2569.0,17,4,344,2,150,0.0,75.0,75.0,2,194,0.0,103.0,97.0
208427.0,6,4,492,2,280,0.0,214.0,140.0,2,212,0.0,146.0,106.0
105196932.0,17,14,864,7,432,17500187.0,174.0,61.71428571428572,7,432,17500934.833333332,174.0,61.71428571428572
49733.0,6,14,4740,7,653,8099.333333333333,249.0,93.28571428571428,7,4087,7985.666666666667,1514.0,583.8571428571429
113520042.0,6,46,3036,23,1518,5159990.2727272725,66.0,66.0,23,1518,5159990.636363637,66.0,66.0
120172.0,17,2,180,1,70,0.0,70.0,70.0,1,110,0.0,110.0,110.0
225460.0,6,10,1065,5,534,55593.5,262.0,106.8,5,531,2705.0,259.0,106.2
90286698.0,6,12,1832,8,1016,12898099.714285716,188.0,127.0,4,816,30039917.666666668,204.0,204.0
146232.0,6,3,337,2,214,0.0,160.0,107.0,1,123,0.0,123.0,123.0
108099925.0,17,5,955,5,955,27024981.25,191.0,191.0,0,0,0.0,0.0,0.0
120282306.0,6,18,1382,9,691,14999991.625,95.0,76.77777777777777,9,691,15033953.25,95.0,76.77777777777777
120377347.0,6,41,3424,18,1524,6789318.588235294,123.0,84.66666666666667,23,1900,5471615.5,139.0,82.6086956521739
25182.0,6,14,4740,7,653,4000.1666666666665,249.0,93.28571428571428,7,4087,3357.0,1514.0,583.8571428571429
13270.0,6,10,2032,5,524,3110.25,252.0,104.8,5,1508,3057.0,1236.0,301.6
26443.0,6,11,2098,6,590,5007.6,252.0,98.33333333333331,5,1508,6048.0,1236.0,301.6
94623321.0,6,224,26550,112,7614,845199.3243243244,140.0,67.98214285714286,112,18936,846191.8198198198,374.0,169.07142857142858
39388.0,6,14,4740,7,653,5562.5,249.0,93.28571428571428,7,4087,6362.333333333333,1514.0,583.8571428571429
165933.0,17,2,414,1,88,0.0,88.0,88.0,1,326,0.0,326.0,326.0
34443.0,6,14,4740,7,653,5618.0,249.0,93.28571428571428,7,4087,5442.166666666667,1514.0,583.8571428571429
90289710.0,6,16,1192,8,596,12892215.285714284,95.0,74.5,8,596,12897314.857142856,95.0,74.5
60312.0,6,10,2032,5,524,11763.25,252.0,104.8,5,1508,14699.25,1236.0,301.6
138405.0,6,2,132,1,66,0.0,66.0,66.0,1,66,0.0,66.0,66.0
400419.0,6,4,508,2,238,0.0,172.0,119.0,2,270,0.0,135.0,135.0
80307.0,6,14,4740,7,653,13003.5,249.0,93.28571428571428,7,4087,11742.166666666666,1514.0,583.8571428571429
314234.0,6,3,1604,2,851,0.0,785.0,425.5,1,753,0.0,753.0,753.0
2378.0,17,4,344,2,150,0.0,75.0,75.0,2,194,0.0,103.0,97.0
37403.0,6,11,2098,6,590,4863.6,252.0,98.33333333333331,5,1508,8085.25,1236.0,301.6
147896.0,17,2,180,1,90,0.0,90.0,90.0,1,90,0.0,90.0,90.0
107320.0,17,2,286,2,286,0.0,143.0,143.0,0,0,0.0,0.0,0.0
2603570.0,6,2,132,1,66,0.0,66.0,66.0,1,66,0.0,66.0,66.0
120163436.0,6,224,25328,112,7688,1075089.7477477477,140.0,68.64285714285714,112,17640,1075105.8918918918,284.0,157.5
1757466.0,6,23,6509,12,1529,159769.63636363635,357.0,127.41666666666669,11,4980,145079.2,1510.0,452.7272727272728
110839283.0,6,32,2236,16,1165,7389285.533333333,139.0,72.8125,16,1071,7374867.866666666,123.0,66.9375
135132956.0,17,6,1146,6,1146,27026591.2,191.0,191.0,0,0,0.0,0.0,0.0
2098.0,17,4,344,2,150,0.0,75.0,75.0,2,194,0.0,103.0,97.0
105434.0,17,2,700,2,700,0.0,350.0,350.0,0,0,0.0,0.0,0.0
1163426.0,6,13,3010,8,2382,166203.7142857143,1514.0,297.75,5,628,222062.5,331.0,125.6
153532.0,17,2,180,1,90,0.0,90.0,90.0,1,90,0.0,90.0,90.0
275197.0,6,10,1221,6,636,55039.4,298.0,106.0,4,585,85323.0,379.0,146.25
153418.0,17,2,180,1,90,0.0,90.0,90.0,1,90,0.0,90.0,90.0
239648.0,6,3,373,2,238,0.0,172.0,119.0,1,135,0.0,135.0,135.0
262893.0,6,3,337,2,214,0.0,160.0,107.0,1,123,0.0,123.0,123.0
124276265.0,17,15,1169,8,606,17753752.14285714,174.0,75.75,7,563,17525618.833333332,174.0,80.42857142857143
118270705.0,6,229,25838,115,7812,1037462.3245614036,140.0,67.9304347826087,114,18026,1037422.6106194692,284.0,158.12280701754386
107743.0,17,2,286,2,286,0.0,143.0,143.0,0,0,0.0,0.0,0.0
376970.0,6,6,412,4,272,125656.66666666669,74.0,68.0,2,140,0.0,74.0,70.0
1682679.0,6,23,6509,12,1529,152970.81818181818,357.0,127.41666666666669,11,4980,137864.2,1510.0,452.7272727272728
120003817.0,6,19,1436,9,691,15000477.125,95.0,76.77777777777777,10,745,13304783.111111112,95.0,74.5
273692.0,6,10,1221,6,636,54738.4,298.0,106.0,4,585,90064.66666666667,379.0,146.25
49796.0,6,12,1320,7,789,8299.333333333334,253.0,112.71428571428572,5,531,10315.75,259.0,106.2
118186707.0,6,232,26232,116,7878,1011471.1130434782,140.0,67.91379310344827,116,18354,1020459.3913043478,284.0,158.22413793103448
108103926.0,17,5,955,5,955,27025981.5,191.0,191.0,0,0,0.0,0.0,0.0
25217.0,6,14,4740,7,653,4031.1666666666665,249.0,93.28571428571428,7,4087,3619.5,1514.0,583.8571428571429
738.0,17,4,438,2,148,0.0,74.0,74.0,2,290,0.0,147.0,145.0
92028138.0,6,39,2574,20,1320,4843573.47368421,66.0,66.0,19,1254,5112660.277777778,66.0,66.0
120129446.0,6,13,2036,5,1020,30032361.5,204.0,204.0,8,1016,17138210.42857143,188.0,127.0
26981998.0,17,5,1710,5,1710,6745499.5,342.0,342.0,0,0,0.0,0.0,0.0
42301.0,6,10,2032,5,524,10362.0,252.0,104.8,5,1508,10328.5,1236.0,301.6
63171.00000000001,6,10,2032,5,524,10350.5,252.0,104.8,5,1508,15278.75,1236.0,301.6
119334367.0,6,231,26150,116,7952,1037690.147826087,140.0,68.55172413793103,115,18198,1038626.9912280702,284.0,158.24347826086955
153427.0,17,2,180,1,90,0.0,90.0,90.0,1,90,0.0,90.0,90.0
10186.0,6,11,1133,6,602,1687.0,264.0,100.33333333333331,5,531,2336.75,259.0,106.2
299626.0,6,6,412,4,272,99875.33333333331,74.0,68.0,2,140,0.0,74.0,70.0
120121212.0,6,17,2556,10,1392,13346801.333333334,188.0,139.2,7,1164,15014977.666666666,204.0,166.28571428571428
1319851.0,17,7,490,7,490,219975.16666666663,70.0,70.0,0,0,0.0,0.0,0.0
407.0,17,2,174,1,79,0.0,79.0,79.0,1,95,0.0,95.0,95.0
90749407.0,6,17,1287,9,691,11337816.25,95.0,76.77777777777777,8,596,12963095.285714284,95.0,74.5
300777.0,6,3,202,2,128,0.0,74.0,64.0,1,74,0.0,74.0,74.0
246171.0,6,3,337,2,214,0.0,160.0,107.0,1,123,0.0,123.0,123.0
119809946.0,6,23,1693,12,894,10891813.272727272,95.0,74.5,11,799,11956786.5,95.0,72.63636363636364
50411.0,6,14,4740,7,653,8111.666666666667,249.0,93.28571428571428,7,4087,8050.333333333333,1514.0,583.8571428571429
2145.0,17,2,762,2,762,0.0,381.0,381.0,0,0,0.0,0.0,0.0
90256618.0,6,14,2240,8,1016,12893802.57142857,188.0,127.0,6,1224,18018391.0,204.0,204.0
315600.0,17,4,1400,4,1400,105200.0,350.0,350.0,0,0,0.0,0.0,0.0
9006191.0,17,4,300,4,300,3002063.6666666665,75.0,75.0,0,0,0.0,0.0,0.0
90126804.0,6,12,1848,5,1020,22530648.25,204.0,204.0,7,828,15020751.833333334,188.0,118.28571428571428
34780.0,6,10,2032,5,524,8470.25,252.0,104.8,5,1508,8134.25,1236.0,301.6
115869677.0,6,47,3102,24,1584,5037797.956521739,66.0,66.0,23,1518,5144007.909090909,66.0,66.0
103105.0,17,2,286,2,286,0.0,143.0,143.0,0,0,0.0,0.0,0.0
79603.0,6,14,4740,7,653,11294.5,249.0,93.28571428571428,7,4087,12661.833333333334,1514.0,583.8571428571429
103491.0,17,2,286,2,286,0.0,143.0,143.0,0,0,0.0,0.0,0.0
190941.0,17,2,180,1,90,0.0,90.0,90.0,1,90,0.0,90.0,90.0
1315555.0,6,4,264,2,132,0.0,66.0,66.0,2,132,0.0,66.0,66.0
259968.0,6,10,1221,6,636,51993.6,298.0,106.0,4,585,80879.33333333333,379.0,146.25
106904.0,17,2,286,2,286,0.0,143.0,143.0,0,0,0.0,0.0,0.0
107731.0,17,2,286,2,286,0.0,143.0,143.0,0,0,0.0,0.0,0.0
323782.0,6,3,202,2,128,0.0,74.0,64.0,1,74,0.0,74.0,74.0
135125271.0,17,6,1206,6,1206,27025054.2,201.0,201.0,0,0,0.0,0.0,0.0
109072309.0,17,14,864,7,432,18152231.666666668,174.0,61.71428571428572,7,432,18120778.0,174.0,61.71428571428572
106993.0,17,2,700,2,700,0.0,350.0,350.0,0,0,0.0,0.0,0.0
108121286.0,17,5,955,5,955,27030321.5,191.0,191.0,0,0,0.0,0.0,0.0
108100280.0,17,5,1005,5,1005,27025070.0,201.0,201.0,0,0,0.0,0.0,0.0
153389.0,17,2,180,1,90,0.0,90.0,90.0,1,90,0.0,90.0,90.0
15202.0,6,11,2098,6,590,2783.2,252.0,98.33333333333331,5,1508,2083.5,1236.0,301.6
95898.0,17,2,762,2,762,0.0,381.0,381.0,0,0,0.0,0.0,0.0
2592740.0,6,2,132,1,66,0.0,66.0,66.0,1,66,0.0,66.0,66.0
256837.0,6,3,337,2,214,0.0,160.0,107.0,1,123,0.0,123.0,123.0
2432.0,17,4,344,2,150,0.0,75.0,75.0,2,194,0.0,103.0,97.0
102630714.0,17,14,1126,7,563,17001528.833333332,174.0,80.42857142857143,7,563,17000155.333333332,174.0,80.42857142857143
112480864.0,17,14,864,7,432,18666820.166666668,174.0,61.71428571428572,7,432,18667479.5,174.0,61.71428571428572
103705.0,17,2,286,2,286,0.0,143.0,143.0,0,0,0.0,0.0,0.0
308173.0,6,6,412,4,272,102724.33333333331,74.0,68.0,2,140,0.0,74.0,70.0
10470322.0,6,7,478,4,272,3443539.333333333,74.0,68.0,3,206,5165174.5,74.0,68.66666666666667
120338022.0,6,31,2097,16,1149,8022534.8,123.0,71.8125,15,948,8030811.428571428,123.0,63.2
128926459.0,6,38,2716,20,1468,6785603.105263158,139.0,73.4,18,1248,6984379.117647059,123.0,69.33333333333333
120183516.0,6,232,26232,116,7878,1038007.1304347826,140.0,67.91379310344827,116,18354,1042974.8608695652,284.0,158.22413793103448
373.0,17,2,160,1,80,0.0,80.0,80.0,1,80,0.0,80.0,80.0
26815.0,6,14,4740,7,653,4303.833333333333,249.0,93.28571428571428,7,4087,3740.0,1514.0,583.8571428571429
0.0,6,1,66,1,66,0.0,66.0,66.0,0,0,0.0,0.0,0.0
120072640.0,17,28,13364,28,13364,4447134.814814814,501.0,477.2857142857143,0,0,0.0,0.0,0.0
284139.0,6,13,1386,7,789,47356.5,253.0,112.71428571428572,6,597,55211.2,259.0,99.5
157496.0,6,3,337,2,214,0.0,160.0,107.0,1,123,0.0,123.0,123.0
1056325.0,6,13,1394,7,797,176054.16666666666,253.0,113.85714285714286,6,597,209654.2,259.0,99.5
4435.0,17,2,626,1,72,0.0,72.0,72.0,1,554,0.0,554.0,554.0
525.0,17,2,508,2,508,0.0,257.0,254.0,0,0,0.0,0.0,0.0
342.0,17,2,267,1,83,0.0,83.0,83.0,1,184,0.0,184.0,184.0
98335.0,17,2,762,2,762,0.0,381.0,381.0,0,0,0.0,0.0,0.0
248835.0,6,3,337,2,214,0.0,160.0,107.0,1,123,0.0,123.0,123.0
108109196.0,17,5,1005,5,1005,27027299.0,201.0,201.0,0,0,0.0,0.0,0.0
0.0,17,1,453,1,453,0.0,453.0,453.0,0,0,0.0,0.0,0.0
90280383.0,6,13,2036,8,1016,12897197.57142857,188.0,127.0,5,1020,22528669.75,204.0,204.0
209508.0,17,2,180,1,90,0.0,90.0,90.0,1,90,0.0,90.0,90.0
339.0,17,2,166,1,75,0.0,75.0,75.0,1,91,0.0,91.0,91.0
102755.0,17,2,700,2,700,0.0,350.0,350.0,0,0,0.0,0.0,0.0
26760926.0,17,5,1718,4,1368,936518.6666666666,342.0,342.0,1,350,0.0,350.0,350.0
2796334.0,6,2,132,1,66,0.0,66.0,66.0,1,66,0.0,66.0,66.0
207949.0,6,3,426,2,280,0.0,214.0,140.0,1,146,0.0,146.0,146.0
24626.0,6,10,2032,5,524,5929.0,252.0,104.8,5,1508,5805.0,1236.0,301.6
108118026.0,17,5,955,5,955,27029506.5,191.0,191.0,0,0,0.0,0.0,0.0
148690.0,6,3,373,2,238,0.0,172.0,119.0,1,135,0.0,135.0,135.0
312218.0,6,6,412,4,272,104072.66666666669,74.0,68.0,2,140,0.0,74.0,70.0
17232.0,6,10,2032,5,524,4078.5,252.0,104.8,5,1508,3324.75,1236.0,301.6
264792.0,6,10,1221,6,636,52958.4,298.0,106.0,4,585,82498.0,379.0,146.25
153855.0,17,2,180,1,90,0.0,90.0,90.0,1,90,0.0,90.0,90.0
40896.0,6,10,2032,5,524,9985.75,252.0,104.8,5,1508,9317.0,1236.0,301.6
37797.0,6,11,2098,6,590,7021.4,252.0,98.33333333333331,5,1508,7755.25,1236.0,301.6
42363.0,6,13,1394,7,797,7019.666666666667,253.0,113.85714285714286,6,597,7318.0,259.0,99.5
120268414.0,6,300,34622,150,10196,801657.6979865772,140.0,67.97333333333333,150,24426,801745.5637583892,300.0,162.84
235168.0,6,3,337,2,214,0.0,160.0,107.0,1,123,0.0,123.0,123.0
106777697.0,6,44,2904,22,1452,5084652.238095238,66.0,66.0,22,1452,5074346.619047619,66.0,66.0
120029704.0,17,28,13364,28,13364,4445544.592592592,501.0,477.2857142857143,0,0,0.0,0.0,0.0
314.0,17,2,174,1,79,0.0,79.0,79.0,1,95,0.0,95.0,95.0
92107220.0,17,15,5130,15,5130,6579087.142857143,342.0,342.0,0,0,0.0,0.0,0.0
90257585.0,6,13,2036,8,1016,12893940.714285716,188.0,127.0,5,1020,22523353.5,204.0,204.0
15379.0,17,2,180,1,90,0.0,90.0,90.0,1,90,0.0,90.0,90.0
46769.0,6,12,1320,7,789,7794.833333333333,253.0,112.71428571428572,5,531,10091.25,259.0,106.2
11550.0,6,13,1459,7,862,1732.8333333333333,271.0,123.14285714285714,6,597,2100.0,259.0,99.5
59659.0,6,10,2032,5,524,14654.75,252.0,104.8,5,1508,11100.25,1236.0,301.6
90766662.0,6,19,1436,10,745,10080394.222222222,95.0,74.5,9,691,11343575.125,95.0,76.77777777777777
2506452.0,6,25,7573,14,3735,192804.0,1514.0,266.7857142857143,11,3838,224262.9,1514.0,348.90909090909093
121006536.0,17,15,907,8,475,17286648.0,174.0,59.375,7,432,16833506.5,174.0,61.71428571428572
115781897.0,6,48,3168,24,1584,5033995.521739131,66.0,66.0,24,1584,5022159.0,66.0,66.0
2078.0,17,4,344,2,150,0.0,75.0,75.0,2,194,0.0,103.0,97.0
105193.0,17,2,286,2,286,0.0,143.0,143.0,0,0,0.0,0.0,0.0
971926.0,6,16,3808,9,986,70985.0,252.0,109.55555555555556,7,2822,160733.0,1236.0,403.1428571428572
501772.0,6,5,336,2,134,0.0,68.0,67.0,3,202,178292.5,70.0,67.33333333333333
2189669.0,6,25,7609,13,2516,182472.41666666663,1034.0,193.53846153846155,12,5093,169347.18181818182,1510.0,424.4166666666667
303649.0,6,2,132,1,66,0.0,66.0,66.0,1,66,0.0,66.0,66.0
103508.0,17,2,286,2,286,0.0,143.0,143.0,0,0,0.0,0.0,0.0
3781817.0,6,5,336,2,134,0.0,68.0,67.0,3,202,1526076.5,70.0,67.33333333333333
197053.0,17,2,180,1,90,0.0,90.0,90.0,1,90,0.0,90.0,90.0
1164917.0,6,13,3000,8,2372,166416.7142857143,1514.0,296.5,5,628,223069.5,331.0,125.6
28682.0,6,14,4740,7,653,4541.166666666667,249.0,93.28571428571428,7,4087,2706.5,1514.0,583.8571428571429
214186.0,6,10,1221,6,636,42837.2,298.0,106.0,4,585,70157.0,379.0,146.25
30651.0,6,14,4740,7,653,4845.833333333333,249.0,93.28571428571428,7,4087,4704.5,1514.0,583.8571428571429
2410.0,17,4,344,2,150,0.0,75.0,75.0,2,194,0.0,103.0,97.0
31125.0,6,10,2032,5,524,5398.0,252.0,104.8,5,1508,7439.25,1236.0,301.6
158655.0,6,3,337,2,214,0.0,160.0,107.0,1,123,0.0,123.0,123.0
108112823.0,17,5,1005,5,1005,27028205.75,201.0,201.0,0,0,0.0,0.0,0.0
2326.0,17,4,344,2,150,0.0,75.0,75.0,2,194,0.0,103.0,97.0
122913432.0,6,32,2220,16,1071,7528625.0,123.0,66.9375,16,1149,7677107.266666667,123.0,71.8125
121405.0,6,3,337,2,214,0.0,160.0,107.0,1,123,0.0,123.0,123.0
261105.0,6,10,1221,6,636,52221.0,298.0,106.0,4,585,81242.66666666667,379.0,146.25
32181424.0,6,9,754,5,482,8005115.0,210.0,96.4,4,272,10638555.666666666,74.0,68.0
2684.0,17,2,180,1,90,0.0,90.0,90.0,1,90,0.0,90.0,90.0
90060390.0,17,27,12943,27,12943,3463861.153846154,501.0,479.3703703703704,0,0,0.0,0.0,0.0
96999061.0,6,159,17956,80,5502,1227836.2151898737,140.0,68.775,79,12454,1230300.3076923075,284.0,157.64556962025316
206160.0,6,3,426,2,280,0.0,214.0,140.0,1,146,0.0,146.0,146.0
308951.0,6,6,412,4,272,102983.66666666669,74.0,68.0,2,140,0.0,74.0,70.0
1106883.0,6,13,1386,7,789,184480.5,253.0,112.71428571428572,6,597,217993.4,259.0,99.5
128415.0,6,2,132,1,66,0.0,66.0,66.0,1,66,0.0,66.0,66.0
144249.0,17,2,180,1,90,0.0,90.0,90.0,1,90,0.0,90.0,90.0
135142067.0,17,6,1206,6,1206,27028413.4,201.0,201.0,0,0,0.0,0.0,0.0
24006.0,6,20,7606,11,978,2400.6,310.0,88.9090909090909,9,6628,2726.75,1514.0,736.4444444444445
119365773.0,6,48,3168,24,1584,5189816.217391305,66.0,66.0,24,1584,5177835.913043479,66.0,66.0
816.0,17,5,550,5,550,204.0,110.0,110.0,0,0,0.0,0.0,0.0
300.0,17,2,164,1,82,0.0,82.0,82.0,1,82,0.0,82.0,82.0
16163.0,6,20,7606,11,978,1616.3,310.0,88.9090909090909,9,6628,1763.25,1514.0,736.4444444444445
38171925.0,6,5,336,2,134,0.0,68.0,67.0,3,202,19037754.5,70.0,67.33333333333333
112464220.0,6,46,3036,23,1518,5111997.090909091,66.0,66.0,23,1518,5111998.818181818,66.0,66.0
92591698.0,6,37,2442,19,1254,5143983.222222222,66.0,66.0,18,1188,5298729.529411765,66.0,66.0
303716.0,17,2,876,2,876,0.0,438.0,438.0,0,0,0.0,0.0,0.0
26979.0,6,11,2098,6,590,5162.4,252.0,98.33333333333331,5,1508,5372.75,1236.0,301.6
10503130.0,6,7,478,4,272,3455484.333333333,74.0,68.0,3,206,5183103.0,74.0,68.66666666666667
226576.0,6,10,1221,6,636,45315.2,298.0,106.0,4,585,74011.66666666667,379.0,146.25
13688.0,6,10,1067,5,536,3240.5,264.0,107.2,5,531,2593.0,259.0,106.2
90591721.0,6,16,2648,8,1016,12941674.42857143,188.0,127.0,8,1632,12912981.714285716,204.0,204.0
108106358.0,17,5,1005,5,1005,27026589.5,201.0,201.0,0,0,0.0,0.0,0.0
726.0,17,4,438,2,148,0.0,74.0,74.0,2,290,0.0,147.0,145.0
42877.0,6,14,4740,7,653,6843.333333333333,249.0,93.28571428571428,7,4087,6982.666666666667,1514.0,583.8571428571429
196905.0,17,2,180,1,90,0.0,90.0,90.0,1,90,0.0,90.0,90.0
148541.0,17,2,414,1,88,0.0,88.0,88.0,1,326,0.0,326.0,326.0
10489874.0,6,7,478,4,272,3451160.6666666665,74.0,68.0,3,206,5176635.5,74.0,68.66666666666667
200981.0,17,4,6056,4,6056,66993.66666666667,1514.0,1514.0,0,0,0.0,0.0,0.0
2158.0,17,4,344,2,150,0.0,75.0,75.0,2,194,0.0,103.0,97.0
160221.0,6,3,337,2,214,0.0,160.0,107.0,1,123,0.0,123.0,123.0
99763856.0,6,52,4588,30,2572,3440132.965517241,139.0,85.73333333333333,22,2016,4740357.857142857,123.0,91.63636363636364
148127.0,17,2,180,1,90,0.0,90.0,90.0,1,90,0.0,90.0,90.0
206321.0,17,2,180,1,90,0.0,90.0,90.0,1,90,0.0,90.0,90.0
135126906.0,17,6,1206,6,1206,27025381.2,201.0,201.0,0,0,0.0,0.0,0.0
13725.0,17,2,582,1,83,0.0,83.0,83.0,1,499,0.0,499.0,499.0
120126095.0,6,13,2020,9,1204,15015761.875,188.0,133.77777777777777,4,816,30031595.0,204.0,204.0
43432.0,6,14,4740,7,653,6807.666666666667,249.0,93.28571428571428,7,4087,6779.333333333333,1514.0,583.8571428571429
315.0,17,2,174,1,79,0.0,79.0,79.0,1,95,0.0,95.0,95.0
108111112.0,17,5,955,5,955,27027778.0,191.0,191.0,0,0,0.0,0.0,0.0
21468.0,6,14,4740,7,653,3100.6666666666665,249.0,93.28571428571428,7,4087,3421.5,1514.0,583.8571428571429
120028605.0,17,28,13364,28,13364,4445503.888888889,501.0,477.2857142857143,0,0,0.0,0.0,0.0
228253.0,17,2,180,1,90,0.0,90.0,90.0,1,90,0.0,90.0,90.0
15456.0,6,2,145,2,145,0.0,91.0,72.5,0,0,0.0,0.0,0.0
40304.0,6,10,2032,5,524,9602.0,252.0,104.8,5,1508,9752.75,1236.0,301.6
52538.0,6,14,4740,7,653,7150.833333333333,249.0,93.28571428571428,7,4087,8315.333333333334,1514.0,583.8571428571429
63978.99999999999,6,10,2032,5,524,13989.0,252.0,104.8,5,1508,15386.5,1236.0,301.6
2018.0,17,2,180,1,90,0.0,90.0,90.0,1,90,0.0,90.0,90.0
135147799.0,17,6,1146,6,1146,27029559.8,191.0,191.0,0,0,0.0,0.0,0.0
3119556.0,6,7,923,4,753,967761.3333333334,571.0,188.25,3,170,1451997.0,62.0,56.66666666666666
162418.0,17,2,180,1,90,0.0,90.0,90.0,1,90,0.0,90.0,90.0
2794095.0,6,2,132,1,66,0.0,66.0,66.0,1,66,0.0,66.0,66.0
135121989.0,17,6,1206,6,1206,27024397.8,201.0,201.0,0,0,0.0,0.0,0.0
118737399.0,6,216,24440,108,17016,1107683.214953271,284.0,157.55555555555554,108,7424,1107683.0654205608,140.0,68.74074074074075
117359232.0,6,213,24152,107,16934,1107162.566037736,284.0,158.26168224299064,106,7218,1107864.1714285717,140.0,68.09433962264151
246351.0,6,3,373,2,238,0.0,172.0,119.0,1,135,0.0,135.0,135.0
142456.0,6,2,132,1,66,0.0,66.0,66.0,1,66,0.0,66.0,66.0
90955504.0,6,21,1585,11,840,9094312.4,95.0,76.36363636363636,10,745,10104920.555555556,95.0,74.5
12793.0,6,10,1065,5,534,2719.0,262.0,106.8,5,531,2869.5,259.0,106.2
102876267.0,6,28,1876,14,982,7896844.307692308,139.0,70.14285714285714,14,894,7896921.692307692,123.0,63.85714285714285
108101812.0,17,5,955,5,955,27025453.0,191.0,191.0,0,0,0.0,0.0,0.0
234258.0,6,3,337,2,214,0.0,160.0,107.0,1,123,0.0,123.0,123.0
143917.0,17,2,180,1,90,0.0,90.0,90.0,1,90,0.0,90.0,90.0
302528.0,6,6,412,4,272,100842.66666666669,74.0,68.0,2,140,0.0,74.0,70.0
302879.0,6,6,412,4,272,100959.66666666669,74.0,68.0,2,140,0.0,74.0,70.0
10532977.0,6,7,478,4,272,3465772.333333333,74.0,68.0,3,206,5198564.0,74.0,68.66666666666667
45260.0,6,14,4740,7,653,7138.166666666667,249.0,93.28571428571428,7,4087,5912.666666666667,1514.0,583.8571428571429
108750043.0,6,31,2182,16,1165,7235284.0,139.0,72.8125,15,1017,7752431.071428572,123.0,67.8
2328697.0,6,3,1602,2,850,0.0,784.0,425.0,1,752,0.0,752.0,752.0
299856.0,17,2,246,1,76,0.0,76.0,76.0,1,170,0.0,170.0,170.0
109823.0,17,2,286,2,286,0.0,143.0,143.0,0,0,0.0,0.0,0.0
90064442.0,17,28,13364,28,13364,3335720.074074074,501.0,477.2857142857143,0,0,0.0,0.0,0.0
196863.0,17,2,180,1,90,0.0,90.0,90.0,1,90,0.0,90.0,90.0
120279702.0,6,17,1287,9,691,15034962.75,95.0,76.77777777777777,8,596,17105598.0,95.0,74.5
96802320.0,6,26,1762,13,922,8048886.416666667,139.0,70.92307692307692,13,840,8048884.166666667,123.0,64.61538461538461
149722.0,17,4,6056,4,6056,49907.333333333336,1514.0,1514.0,0,0,0.0,0.0,0.0
500831.0,6,5,336,2,134,0.0,68.0,67.0,3,202,194526.0,70.0,67.33333333333333
45250.0,6,14,4740,7,653,6824.5,249.0,93.28571428571428,7,4087,7054.0,1514.0,583.8571428571429
16924.0,17,2,180,1,90,0.0,90.0,90.0,1,90,0.0,90.0,90.0
47403.0,6,10,2032,5,524,11091.75,252.0,104.8,5,1508,11267.0,1236.0,301.6
90303454.0,6,16,1192,8,596,12893915.857142856,95.0,74.5,8,596,12898833.285714284,95.0,74.5
90769329.0,6,22,1680,12,935,8246977.181818182,95.0,77.91666666666667,10,745,10001322.111111112,95.0,74.5
108115479.0,17,5,1005,5,1005,27028869.75,201.0,201.0,0,0,0.0,0.0,0.0
9220.0,17,2,582,1,83,0.0,83.0,83.0,1,499,0.0,499.0,499.0
93012856.0,6,38,2508,19,1254,5150440.611111111,66.0,66.0,19,1254,5150455.388888889,66.0,66.0
12939359.0,17,18,6796,18,6796,761138.7647058824,394.0,377.55555555555554,0,0,0.0,0.0,0.0
5056634.0,6,34,19329,18,1471,297449.0588235294,365.0,81.72222222222223,16,17858,154152.33333333334,1514.0,1116.125
97235940.0,6,184,20776,92,14482,1066161.8131868131,284.0,157.41304347826087,92,6294,1066161.5934065934,140.0,68.41304347826087
36835.0,6,14,4740,7,653,4833.333333333333,249.0,93.28571428571428,7,4087,5984.5,1514.0,583.8571428571429
33716.0,6,14,4740,7,653,5289.166666666667,249.0,93.28571428571428,7,4087,5481.833333333333,1514.0,583.8571428571429
95367454.0,6,203,23698,102,6954,944232.2178217822,140.0,68.17647058823529,101,16744,897749.33,390.0,165.78217821782178
105819252.0,6,43,2838,22,1452,5024362.285714285,66.0,66.0,21,1386,5150437.65,66.0,66.0
27199.0,6,14,4740,7,653,4412.166666666667,249.0,93.28571428571428,7,4087,3667.5,1514.0,583.8571428571429
327.0,17,2,174,1,79,0.0,79.0,79.0,1,95,0.0,95.0,95.0
1025753.0,6,11,1134,6,558,205150.6,220.0,93.0,5,576,255775.5,304.0,115.2
38851.0,6,14,4740,7,653,6348.5,249.0,93.28571428571428,7,4087,6296.333333333333,1514.0,583.8571428571429
288832.0,17,2,180,1,90,0.0,90.0,90.0,1,90,0.0,90.0,90.0
280526.0,17,2,363,1,79,0.0,79.0,79.0,1,284,0.0,284.0,284.0
90257696.0,6,13,2036,8,1016,12893956.57142857,188.0,127.0,5,1020,22524079.25,204.0,204.0
106267435.0,6,31,2182,16,1165,7070119.666666667,139.0,72.8125,15,1017,7575123.857142857,123.0,67.8
92707749.0,6,37,2442,19,1254,5150430.5,66.0,66.0,18,1188,5232798.882352941,66.0,66.0
228227.0,17,2,180,1,90,0.0,90.0,90.0,1,90,0.0,90.0,90.0
39462.0,6,14,4740,7,653,5792.833333333333,249.0,93.28571428571428,7,4087,6453.5,1514.0,583.8571428571429
281670.0,17,2,363,1,79,0.0,79.0,79.0,1,284,0.0,284.0,284.0
5624662.0,6,5,336,2,134,0.0,68.0,67.0,3,202,1524426.5,70.0,67.33333333333333
196941.0,17,2,180,1,90,0.0,90.0,90.0,1,90,0.0,90.0,90.0
2297.0,17,4,344,2,150,0.0,75.0,75.0,2,194,0.0,103.0,97.0
2047513.0,17,8,1640,4,312,682384.0,78.0,78.0,4,1328,682365.3333333334,332.0,332.0
109106.0,6,10,2032,5,524,25871.0,252.0,104.8,5,1508,27043.5,1236.0,301.6
109216886.0,6,199,22380,100,6822,1103200.8686868686,140.0,68.22,99,15558,1103824.5204081633,284.0,157.15151515151516
103580.0,17,2,286,2,286,0.0,143.0,143.0,0,0,0.0,0.0,0.0
147989.0,17,2,180,1,90,0.0,90.0,90.0,1,90,0.0,90.0,90.0
9599.0,17,4,823,2,163,0.0,89.0,81.5,2,660,0.0,443.0,330.0
104003758.0,17,21,5844,9,1171,13000469.75,506.0,130.11111111111111,12,4673,9405814.0,1214.0,389.4166666666667
106017308.0,17,14,1126,7,563,17377437.0,174.0,80.42857142857143,7,563,17642728.0,174.0,80.42857142857143
81.0,17,2,762,2,762,0.0,381.0,381.0,0,0,0.0,0.0,0.0
437631.0,6,10,1221,6,636,87526.2,298.0,106.0,4,585,144997.0,379.0,146.25
315432.0,17,4,1400,4,1400,105144.0,350.0,350.0,0,0,0.0,0.0,0.0
29866.0,6,10,2032,5,524,7199.25,252.0,104.8,5,1508,6648.5,1236.0,301.6
0.0,17,1,453,1,453,0.0,453.0,453.0,0,0,0.0,0.0,0.0
143853.0,17,2,180,1,90,0.0,90.0,90.0,1,90,0.0,90.0,90.0
162365.0,17,2,180,1,90,0.0,90.0,90.0,1,90,0.0,90.0,90.0
113273284.0,6,36,2580,18,1332,6650442.588235294,123.0,74.0,18,1248,6650437.882352941,123.0,69.33333333333333
50778.0,6,13,1386,7,789,7671.5,253.0,112.71428571428572,6,597,9170.6,259.0,99.5
129615544.0,17,14,864,7,432,18333509.83333333,174.0,61.71428571428572,7,432,18333978.166666668,174.0,61.71428571428572
329.0,17,2,166,1,75,0.0,75.0,75.0,1,91,0.0,91.0,91.0
90265312.0,6,15,2168,8,1016,12895044.57142857,188.0,127.0,7,1152,15016937.666666666,204.0,164.57142857142858
330.0,17,2,208,1,72,0.0,72.0,72.0,1,136,0.0,136.0,136.0
108099240.0,17,5,955,5,955,27024810.0,191.0,191.0,0,0,0.0,0.0,0.0
120332804.0,6,214,24074,107,7358,1127428.1698113207,140.0,68.76635514018692,107,16716,1126028.9150943395,284.0,156.22429906542055
27623.0,6,10,2032,5,524,6690.75,252.0,104.8,5,1508,6655.0,1236.0,301.6
5625311.0,6,5,336,2,134,0.0,68.0,67.0,3,202,1522830.0,70.0,67.33333333333333
90289768.0,6,16,1192,8,596,12892599.42857143,95.0,74.5,8,596,12896668.0,95.0,74.5
2832.0,17,2,224,1,76,0.0,76.0,76.0,1,148,0.0,148.0,148.0
121339.0,6,3,337,2,214,0.0,160.0,107.0,1,123,0.0,123.0,123.0
190499.0,17,2,604,1,75,0.0,75.0,75.0,1,529,0.0,529.0,529.0
2978569.0,6,12,2172,7,664,496325.1666666667,252.0,94.85714285714286,5,1508,2009.0,1236.0,301.6
0.0,17,1,72,1,72,0.0,72.0,72.0,0,0,0.0,0.0,0.0
108102119.0,17,5,955,5,955,27025529.75,191.0,191.0,0,0,0.0,0.0,0.0
0.0,6,1,66,1,66,0.0,66.0,66.0,0,0,0.0,0.0,0.0
206269.0,6,3,426,2,280,0.0,214.0,140.0,1,146,0.0,146.0,146.0
242845.0,6,3,337,2,214,0.0,160.0,107.0,1,123,0.0,123.0,123.0
298955.0,6,6,412,4,272,99651.66666666669,74.0,68.0,2,140,0.0,74.0,70.0
108102397.0,17,5,1005,5,1005,27025599.25,201.0,201.0,0,0,0.0,0.0,0.0
90100726.0,6,15,1936,8,1060,12871396.57142857,199.0,132.5,7,876,14977262.666666666,204.0,125.14285714285714
3362.0,17,4,344,2,150,0.0,75.0,75.0,2,194,0.0,103.0,97.0
145619.0,6,3,337,2,214,0.0,160.0,107.0,1,123,0.0,123.0,123.0
108102531.0,17,5,955,5,955,27025632.75,191.0,191.0,0,0,0.0,0.0,0.0
44260.0,6,14,4740,7,653,6994.333333333333,249.0,93.28571428571428,7,4087,6780.333333333333,1514.0,583.8571428571429
2416.0,17,4,344,2,150,0.0,75.0,75.0,2,194,0.0,103.0,97.0
213615.0,6,10,1221,6,636,42723.0,298.0,106.0,4,585,70096.33333333333,379.0,146.25
1393687.0,17,16,1120,16,1120,92912.46666666666,70.0,70.0,0,0,0.0,0.0,0.0
493611.0,6,5,336,2,134,0.0,68.0,67.0,3,202,192884.5,70.0,67.33333333333333
12474.0,17,4,823,2,163,0.0,89.0,81.5,2,660,0.0,443.0,330.0
90863858.0,6,25,1692,13,906,7554952.333333333,123.0,69.6923076923077,12,786,8241766.636363637,123.0,65.5
32263.0,6,14,4740,7,653,5257.833333333333,249.0,93.28571428571428,7,4087,4934.833333333333,1514.0,583.8571428571429
197188.0,17,2,180,1,90,0.0,90.0,90.0,1,90,0.0,90.0,90.0
18146.0,6,10,2032,5,524,3459.25,252.0,104.8,5,1508,4254.25,1236.0,301.6
10465271.0,6,7,478,4,272,3443143.0,74.0,68.0,3,206,5164657.0,74.0,68.66666666666667
108104942.0,17,5,955,5,955,27026235.5,191.0,191.0,0,0,0.0,0.0,0.0
105662703.0,6,44,2904,22,1452,5031557.285714285,66.0,66.0,22,1452,5016106.666666667,66.0,66.0
90092077.0,6,11,1644,4,816,30029851.0,204.0,204.0,7,828,15014629.833333334,188.0,118.28571428571428
851604.0,6,9,1268,6,797,170320.8,459.0,132.83333333333334,3,471,289479.5,331.0,157.0
90572084.0,6,29,2200,15,1168,6469434.571428572,139.0,77.86666666666666,14,1032,6950455.461538462,123.0,73.71428571428571
303153.0,6,2,132,1,66,0.0,66.0,66.0,1,66,0.0,66.0,66.0
23635.0,6,14,4740,7,653,3659.8333333333335,249.0,93.28571428571428,7,4087,3032.833333333333,1514.0,583.8571428571429
153465.0,17,2,180,1,90,0.0,90.0,90.0,1,90,0.0,90.0,90.0
211591.0,6,3,426,2,280,0.0,214.0,140.0,1,146,0.0,146.0,146.0
119754191.0,6,26,1978,12,894,10886744.636363637,95.0,74.5,14,1084,9195840.923076924,95.0,77.42857142857143
2101.0,17,4,344,2,150,0.0,75.0,75.0,2,194,0.0,103.0,97.0
503815.0,6,5,336,2,134,0.0,68.0,67.0,3,202,195195.0,70.0,67.33333333333333
206254.0,6,3,426,2,280,0.0,214.0,140.0,1,146,0.0,146.0,146.0
106000970.0,17,13,821,7,432,17666828.333333332,174.0,61.71428571428572,6,389,19949747.2,174.0,64.83333333333333
4872997.0,17,2,152,2,152,0.0,76.0,76.0,0,0,0.0,0.0,0.0
144874.0,17,2,180,1,70,0.0,70.0,70.0,1,110,0.0,110.0,110.0
2601514.0,6,2,132,1,66,0.0,66.0,66.0,1,66,0.0,66.0,66.0
321.0,17,2,160,1,80,0.0,80.0,80.0,1,80,0.0,80.0,80.0
93765995.0,6,26,2019,15,1179,6697042.214285715,95.0,78.6,11,840,9376026.7,95.0,76.36363636363636
0.0,17,1,191,1,191,0.0,191.0,191.0,0,0,0.0,0.0,0.0
143848.0,17,2,180,1,90,0.0,90.0,90.0,1,90,0.0,90.0,90.0
33569.0,6,14,4740,7,653,5486.0,249.0,93.28571428571428,7,4087,4242.333333333333,1514.0,583.8571428571429
125856791.0,6,66,13821,33,7269,3025150.28125,1514.0,220.27272727272728,33,6552,3926277.875,1514.0,198.54545454545453
474.0,17,2,410,1,78,0.0,78.0,78.0,1,332,0.0,332.0,332.0
33032.0,6,14,4740,7,653,5050.666666666667,249.0,93.28571428571428,7,4087,5337.5,1514.0,583.8571428571429
107872153.0,6,28,1860,14,966,8281253.615384615,123.0,69.0,14,894,8281254.076923077,123.0,63.85714285714285
1027565.0,6,11,1134,6,558,205513.0,220.0,93.0,5,576,256029.0,304.0,115.2
38166.0,6,14,4740,7,653,6238.5,249.0,93.28571428571428,7,4087,6221.5,1514.0,583.8571428571429
24291.0,6,14,4740,7,653,3827.3333333333335,249.0,93.28571428571428,7,4087,3910.0,1514.0,583.8571428571429
103299.0,17,2,286,2,286,0.0,143.0,143.0,0,0,0.0,0.0,0.0
23258.0,6,14,4740,7,653,3719.8333333333335,249.0,93.28571428571428,7,4087,3744.0,1514.0,583.8571428571429
135137394.0,17,6,1146,6,1146,27027478.8,191.0,191.0,0,0,0.0,0.0,0.0
19220.0,6,14,4740,7,653,2780.0,249.0,93.28571428571428,7,4087,3064.1666666666665,1514.0,583.8571428571429
2339.0,17,4,344,2,150,0.0,75.0,75.0,2,194,0.0,103.0,97.0
28336.0,6,10,2032,5,524,6523.5,252.0,104.8,5,1508,6798.5,1236.0,301.6
120011309.0,17,29,13785,29,13785,4286118.178571428,501.0,475.3448275862069,0,0,0.0,0.0,0.0
346.0,17,2,267,1,83,0.0,83.0,83.0,1,184,0.0,184.0,184.0
120119903.0,6,15,2428,9,1204,15014987.875,188.0,133.77777777777777,6,1224,18018078.0,204.0,204.0
142823.0,6,2,132,1,66,0.0,66.0,66.0,1,66,0.0,66.0,66.0
135136243.0,17,6,1206,6,1206,27027248.6,201.0,201.0,0,0,0.0,0.0,0.0
204963.0,17,2,762,2,762,0.0,381.0,381.0,0,0,0.0,0.0,0.0
114750567.0,6,33,2428,16,1140,7650037.8,123.0,71.25,17,1288,6534216.25,139.0,75.76470588235294
128860129.0,6,35,2394,18,1269,7580007.588235294,123.0,70.5,17,1125,7416213.375,123.0,66.17647058823529
21917.0,6,10,2032,5,524,4055.0,252.0,104.8,5,1508,5200.75,1236.0,301.6
90034951.0,17,27,12943,27,12943,3462882.730769231,501.0,479.3703703703704,0,0,0.0,0.0,0.0
3353828.0,6,7,923,4,753,1049126.3333333333,571.0,188.25,3,170,1574056.5,62.0,56.66666666666666
112155.0,17,2,700,2,700,0.0,350.0,350.0,0,0,0.0,0.0,0.0
694.0,17,4,438,2,148,0.0,74.0,74.0,2,290,0.0,147.0,145.0
36367495.0,6,5,336,2,134,0.0,68.0,67.0,3,202,18101798.5,70.0,67.33333333333333
4473.0,17,2,614,1,72,0.0,72.0,72.0,1,542,0.0,542.0,542.0
299.0,17,2,168,1,76,0.0,76.0,76.0,1,92,0.0,92.0,92.0
103531.0,17,2,286,2,286,0.0,143.0,143.0,0,0,0.0,0.0,0.0
63671.00000000001,6,12,1413,6,816,11788.0,291.0,136.0,6,597,10849.0,259.0,99.5
90707689.0,6,23,1853,11,959,9070768.9,214.0,87.18181818181819,12,894,8221737.818181818,95.0,74.5
232630.0,6,12,1373,7,714,38771.66666666666,298.0,102.0,5,659,56734.5,379.0,131.8
2599653.0,6,2,132,1,66,0.0,66.0,66.0,1,66,0.0,66.0,66.0
104193.0,17,2,286,2,286,0.0,143.0,143.0,0,0,0.0,0.0,0.0
67679.0,6,14,4740,7,653,8447.5,249.0,93.28571428571428,7,4087,10380.333333333334,1514.0,583.8571428571429
197901.0,17,2,180,1,90,0.0,90.0,90.0,1,90,0.0,90.0,90.0
311807.0,17,4,1400,4,1400,103935.66666666669,350.0,350.0,0,0,0.0,0.0,0.0
1447641.0,6,7,499,4,301,469504.0,103.0,75.25,3,198,716327.0,66.0,66.0
962944.0,17,10,3736,10,3736,106993.77777777778,390.0,373.6,0,0,0.0,0.0,0.0
297634.0,6,6,412,4,272,99211.33333333331,74.0,68.0,2,140,0.0,74.0,70.0
14303646.0,17,6,2052,6,2052,2860729.2,342.0,342.0,0,0,0.0,0.0,0.0
104067697.0,17,14,1126,7,563,17334022.166666668,174.0,80.42857142857143,7,563,17333502.666666668,174.0,80.42857142857143
120345156.0,6,257,29232,129,20562,940196.53125,284.0,159.3953488372093,128,8670,939541.811023622,140.0,67.734375
733943.0,6,6,758,3,410,353310.5,172.0,136.66666666666666,3,348,248001.0,135.0,116.0
2352476.0,6,49,23728,25,19797,98019.83333333331,1514.0,791.88,24,3931,92601.34782608696,1514.0,163.79166666666666
27506078.0,17,5,1710,5,1710,6876519.5,342.0,342.0,0,0,0.0,0.0,0.0
44358.0,6,13,1394,7,797,7090.5,253.0,113.85714285714286,6,597,8447.0,259.0,99.5
369775.0,6,3,204,1,68,0.0,68.0,68.0,2,136,0.0,70.0,68.0
39657.0,6,14,4740,7,653,6463.666666666667,249.0,93.28571428571428,7,4087,5455.833333333333,1514.0,583.8571428571429
120144672.0,6,14,2224,9,1204,15018084.0,188.0,133.77777777777777,5,1020,22521725.25,204.0,204.0
149717655.0,6,21,3234,10,1776,13316334.777777778,204.0,177.6,11,1458,14971648.1,188.0,132.54545454545453
146472.0,6,13,1394,7,797,24412.0,253.0,113.85714285714286,6,597,27068.0,259.0,99.5
119110194.0,6,220,24868,110,7556,1085232.6972477064,140.0,68.69090909090909,110,17312,1092725.275229358,284.0,157.38181818181818
2879196.0,6,3,1777,1,826,0.0,826.0,826.0,2,951,0.0,885.0,475.5
302219.0,6,6,412,4,272,100739.66666666669,74.0,68.0,2,140,0.0,74.0,70.0
220735.0,17,2,180,1,90,0.0,90.0,90.0,1,90,0.0,90.0,90.0
209539.0,17,2,180,1,90,0.0,90.0,90.0,1,90,0.0,90.0,90.0
153516.0,17,2,180,1,90,0.0,90.0,90.0,1,90,0.0,90.0,90.0
90528419.0,6,14,2240,8,1016,12932631.285714284,188.0,127.0,6,1224,18072751.8,204.0,204.0
2935370.0,6,135,128313,89,121432,29904.31818181818,1510.0,1364.4044943820224,46,6881,58483.4,1510.0,149.58695652173913
57464.0,6,14,4740,7,653,9213.833333333334,249.0,93.28571428571428,7,4087,9431.5,1514.0,583.8571428571429
319419.0,17,4,1400,4,1400,106473.0,350.0,350.0,0,0,0.0,0.0,0.0
13863054.0,6,259,240933,74,5045,189904.84931506848,207.0,68.17567567567568,185,235888,75268.56521739131,1514.0,1275.0702702702702
4228.0,17,2,620,1,75,0.0,75.0,75.0,1,545,0.0,545.0,545.0
105840.0,17,4,1400,4,1400,35280.0,350.0,350.0,0,0,0.0,0.0,0.0
36347.0,6,10,2032,5,524,8127.5,252.0,104.8,5,1508,6369.0,1236.0,301.6
246290.0,6,3,337,2,214,0.0,160.0,107.0,1,123,0.0,123.0,123.0
59144.0,6,14,4740,7,653,7779.5,249.0,93.28571428571428,7,4087,9455.0,1514.0,583.8571428571429
836774.0,6,9,1118,6,586,167354.8,248.0,97.66666666666669,3,532,280650.0,392.0,177.33333333333334
16073.0,6,11,2098,6,590,3026.0,252.0,98.33333333333331,5,1508,3712.25,1236.0,301.6
69332.0,17,2,602,1,72,0.0,72.0,72.0,1,530,0.0,530.0,530.0
12657.0,6,14,4740,7,653,1983.0,249.0,93.28571428571428,7,4087,1968.3333333333333,1514.0,583.8571428571429
22450.0,6,14,4740,7,653,3509.833333333333,249.0,93.28571428571428,7,4087,2427.333333333333,1514.0,583.8571428571429
61738.0,6,13,1479,7,882,10289.666666666666,291.0,126.0,6,597,11583.8,259.0,99.5
90281289.0,6,14,1043,7,542,15046881.5,95.0,77.42857142857143,7,501,14998806.166666666,95.0,71.57142857142857
53111.0,6,14,4740,7,653,8729.5,249.0,93.28571428571428,7,4087,8171.833333333333,1514.0,583.8571428571429
119867.0,17,2,180,1,70,0.0,70.0,70.0,1,110,0.0,110.0,110.0
652579.0,6,4,508,2,238,0.0,172.0,119.0,2,270,0.0,135.0,135.0
90254253.0,6,12,1832,8,1016,12893464.714285716,188.0,127.0,4,816,30030529.33333333,204.0,204.0
108119204.0,17,5,955,5,955,27029801.0,191.0,191.0,0,0,0.0,0.0,0.0
17414.0,17,2,180,1,90,0.0,90.0,90.0,1,90,0.0,90.0,90.0
291386.0,6,10,1221,6,636,58277.2,298.0,106.0,4,585,91770.33333333331,379.0,146.25
90256443.0,6,13,2036,8,1016,12893777.57142857,188.0,127.0,5,1020,22522493.5,204.0,204.0
116936453.0,6,401,47576,201,13562,584682.265,140.0,67.4726368159204,200,34014,586498.0351758794,284.0,170.07
90486188.0,6,21,1626,11,840,9024903.7,95.0,76.36363636363636,10,786,9972550.888888888,95.0,78.6
112853.0,17,2,286,2,286,0.0,143.0,143.0,0,0,0.0,0.0,0.0
2265.0,17,4,344,2,150,0.0,75.0,75.0,2,194,0.0,103.0,97.0
2370.0,17,4,344,2,150,0.0,75.0,75.0,2,194,0.0,103.0,97.0
2463.0,17,4,344,2,150,0.0,75.0,75.0,2,194,0.0,103.0,97.0
50115.0,6,14,4740,7,653,8225.0,249.0,93.28571428571428,7,4087,7628.333333333333,1514.0,583.8571428571429
301499.0,6,6,412,4,272,100499.66666666669,74.0,68.0,2,140,0.0,74.0,70.0
133908.0,6,2,132,1,66,0.0,66.0,66.0,1,66,0.0,66.0,66.0
216410.0,6,3,426,2,280,0.0,214.0,140.0,1,146,0.0,146.0,146.0
120111739.0,6,186,21094,93,14660,1303221.5108695652,284.0,157.63440860215053,93,6434,1303222.6195652173,140.0,69.18279569892474
208940.0,6,2,132,1,66,0.0,66.0,66.0,1,66,0.0,66.0,66.0
92113756.0,6,38,2508,19,1254,5105437.0,66.0,66.0,19,1254,5105439.666666667,66.0,66.0
28540.0,6,14,4740,7,653,3983.3333333333335,249.0,93.28571428571428,7,4087,4458.0,1514.0,583.8571428571429
31221.0,6,10,1065,5,534,6776.5,262.0,106.8,5,531,7584.5,259.0,106.2
3150.0,17,4,344,2,150,0.0,75.0,75.0,2,194,0.0,103.0,97.0
146327.0,6,3,337,2,214,0.0,160.0,107.0,1,123,0.0,123.0,123.0
113522132.0,6,46,3036,23,1518,5160074.909090909,66.0,66.0,23,1518,5160085.318181818,66.0,66.0
249897.0,6,3,337,2,214,0.0,160.0,107.0,1,123,0.0,123.0,123.0
1821372.0,6,4,492,2,280,0.0,214.0,140.0,2,212,0.0,146.0,106.0
3016.0,17,4,344,2,150,0.0,75.0,75.0,2,194,0.0,103.0,97.0
1477204.0,6,20,7599,11,1469,147720.4,583.0,133.54545454545453,9,6130,151533.5,1484.0,681.1111111111111
308120.0,6,6,412,4,272,102706.66666666669,74.0,68.0,2,140,0.0,74.0,70.0
406308.0,6,3,1604,2,851,0.0,785.0,425.5,1,753,0.0,753.0,753.0
199888.0,17,4,6056,4,6056,66629.33333333333,1514.0,1514.0,0,0,0.0,0.0,0.0
90100257.0,6,12,1848,5,1020,22521999.25,204.0,204.0,7,828,15016318.333333334,188.0,118.28571428571428
135145442.0,17,6,1146,6,1146,27029088.4,191.0,191.0,0,0,0.0,0.0,0.0
2607785.0,17,6,1293,3,234,1023912.0,78.0,78.0,3,1059,1303693.5,395.0,353.0
219305.0,17,2,180,1,90,0.0,90.0,90.0,1,90,0.0,90.0,90.0
229079.0,6,10,1221,6,636,45815.8,298.0,106.0,4,585,74318.33333333333,379.0,146.25
960881.0,17,10,3736,10,3736,106764.55555555556,390.0,373.6,0,0,0.0,0.0,0.0
244768.0,6,10,1221,6,636,48953.6,298.0,106.0,4,585,80431.33333333333,379.0,146.25
128663146.0,6,34,2334,17,1125,7417373.375,123.0,66.17647058823529,17,1209,7417352.25,123.0,71.11764705882354
324.0,17,2,174,1,79,0.0,79.0,79.0,1,95,0.0,95.0,95.0
44451.0,6,14,4740,7,653,7279.333333333333,249.0,93.28571428571428,7,4087,6839.5,1514.0,583.8571428571429
303126.0,6,2,132,1,66,0.0,66.0,66.0,1,66,0.0,66.0,66.0
2354.0,17,4,344,2,150,0.0,75.0,75.0,2,194,0.0,103.0,97.0
120456499.0,6,22,1680,10,745,10105479.888888888,95.0,74.5,12,935,10928182.090909092,95.0,77.91666666666667
302383.0,6,2,132,1,66,0.0,66.0,66.0,1,66,0.0,66.0,66.0
24889195.0,17,5,1718,4,1368,1047568.3333333334,342.0,342.0,1,350,0.0,350.0,350.0
26126.0,6,14,4740,7,653,3890.6666666666665,249.0,93.28571428571428,7,4087,4217.0,1514.0,583.8571428571429
2427.0,17,4,344,2,150,0.0,75.0,75.0,2,194,0.0,103.0,97.0
1880.0,17,2,664,1,322,0.0,322.0,322.0,1,342,0.0,342.0,342.0
13896407.0,17,6,2052,6,2052,2779281.4,342.0,342.0,0,0,0.0,0.0,0.0
33630.0,6,14,4740,7,653,4395.5,249.0,93.28571428571428,7,4087,5463.666666666667,1514.0,583.8571428571429
135127513.0,17,6,1206,6,1206,27025502.6,201.0,201.0,0,0,0.0,0.0,0.0
135131059.0,17,6,1146,6,1146,27026211.8,191.0,191.0,0,0,0.0,0.0,0.0
300.0,17,2,156,1,78,0.0,78.0,78.0,1,78,0.0,78.0,78.0
189326.0,17,2,180,1,90,0.0,90.0,90.0,1,90,0.0,90.0,90.0
50986.0,6,14,4740,7,653,8337.166666666666,249.0,93.28571428571428,7,4087,8364.166666666666,1514.0,583.8571428571429
5619254.0,6,5,336,2,134,0.0,68.0,67.0,3,202,1422733.5,70.0,67.33333333333333
1737626.0,6,20,7599,11,1469,173762.6,583.0,133.54545454545453,9,6130,185106.625,1484.0,681.1111111111111
90247609.0,6,12,1832,8,1016,12892515.57142857,188.0,127.0,4,816,30028506.33333333,204.0,204.0
234074.0,6,3,337,2,214,0.0,160.0,107.0,1,123,0.0,123.0,123.0
1029382.0,6,11,1134,6,558,205876.4,220.0,93.0,5,576,256196.75,304.0,115.2
244416.0,6,3,337,2,214,0.0,160.0,107.0,1,123,0.0,123.0,123.0
93226134.0,17,14,1126,7,563,15500139.333333334,174.0,80.42857142857143,7,563,15501181.333333334,174.0,80.42857142857143
48947413.0,6,7,2047,5,1153,12236853.25,885.0,230.6,2,894,0.0,826.0,447.0
14639148.0,6,20,1607,10,975,1592910.4444444445,315.0,97.5,10,632,1592897.111111111,78.0,63.2
301492.0,6,6,412,4,272,100497.33333333331,74.0,68.0,2,140,0.0,74.0,70.0
167879.0,17,2,414,1,88,0.0,88.0,88.0,1,326,0.0,326.0,326.0
96801212.0,6,27,1954,14,1045,7429642.923076923,139.0,74.64285714285714,13,909,8048780.333333333,123.0,69.92307692307692
108108033.0,17,5,1005,5,1005,27027008.25,201.0,201.0,0,0,0.0,0.0,0.0
90107380.0,6,12,1848,7,828,15017896.666666666,188.0,118.28571428571428,5,1020,15016412.25,204.0,204.0
3492.0,17,2,359,1,75,0.0,75.0,75.0,1,284,0.0,284.0,284.0
135131234.0,17,6,1206,6,1206,27026246.8,201.0,201.0,0,0,0.0,0.0,0.0
54960.0,6,14,4740,7,653,7979.833333333333,249.0,93.28571428571428,7,4087,8169.0,1514.0,583.8571428571429
113504969.0,6,32,2236,16,1165,7552609.066666666,139.0,72.8125,16,1071,7552598.0,123.0,66.9375
35685.0,6,14,4740,7,653,5697.0,249.0,93.28571428571428,7,4087,5776.5,1514.0,583.8571428571429
11398.0,17,2,602,1,72,0.0,72.0,72.0,1,530,0.0,530.0,530.0
120124738.0,6,14,2224,9,1204,15015592.25,188.0,133.77777777777777,5,1020,22528031.25,204.0,204.0
298790.0,6,6,412,4,272,99596.66666666669,74.0,68.0,2,140,0.0,74.0,70.0
103508.0,17,2,286,2,286,0.0,143.0,143.0,0,0,0.0,0.0,0.0
33313.0,6,10,2032,5,524,8121.25,252.0,104.8,5,1508,7750.0,1236.0,301.6
217798.0,6,3,426,2,280,0.0,214.0,140.0,1,146,0.0,146.0,146.0
153445.0,17,2,180,1,90,0.0,90.0,90.0,1,90,0.0,90.0,90.0
55193.0,6,14,4740,7,653,9063.0,249.0,93.28571428571428,7,4087,7634.5,1514.0,583.8571428571429
100728264.0,17,13,821,7,432,16667522.833333334,174.0,61.71428571428572,6,389,20000159.4,174.0,64.83333333333333
141468.0,17,4,1400,4,1400,47156.0,350.0,350.0,0,0,0.0,0.0,0.0
1074278.0,6,13,1394,7,797,179046.33333333334,253.0,113.85714285714286,6,597,211387.8,259.0,99.5
97048420.0,6,181,20394,91,6240,1078315.7777777778,140.0,68.57142857142857,90,14154,1086614.5056179776,284.0,157.26666666666668
52106.0,6,14,4740,7,653,8558.0,249.0,93.28571428571428,7,4087,6380.666666666667,1514.0,583.8571428571429
208418.0,6,10,1221,6,636,41683.6,298.0,106.0,4,585,68018.33333333333,379.0,146.25
90285082.0,6,16,1192,8,596,12892151.142857144,95.0,74.5,8,596,12897159.142857144,95.0,74.5
93834722.0,6,40,2640,20,1320,4938669.578947368,66.0,66.0,20,1320,4922427.421052632,66.0,66.0
215531.0,6,10,1221,6,636,43106.2,298.0,106.0,4,585,70533.66666666667,379.0,146.25
10434163.0,6,7,478,4,272,3432774.333333333,74.0,68.0,3,206,5149051.0,74.0,68.66666666666667
32283.0,6,14,4740,7,653,5174.0,249.0,93.28571428571428,7,4087,4543.833333333333,1514.0,583.8571428571429
101244.0,17,2,762,2,762,0.0,381.0,381.0,0,0,0.0,0.0,0.0
297270.0,17,2,180,1,90,0.0,90.0,90.0,1,90,0.0,90.0,90.0
7164.0,17,2,180,1,90,0.0,90.0,90.0,1,90,0.0,90.0,90.0
120082104.0,17,28,13364,28,13364,4447485.333333333,501.0,477.2857142857143,0,0,0.0,0.0,0.0
918956.0,6,10,1333,6,796,183791.2,458.0,132.66666666666666,4,537,214447.3333333333,331.0,134.25
217901.0,6,3,426,2,280,0.0,214.0,140.0,1,146,0.0,146.0,146.0
119529015.0,17,35,16705,35,16705,3515559.2647058824,501.0,477.2857142857143,0,0,0.0,0.0,0.0
91384.0,17,2,762,2,762,0.0,381.0,381.0,0,0,0.0,0.0,0.0
1461767.0,6,4,276,2,128,0.0,74.0,64.0,2,148,0.0,74.0,74.0
90031331.0,17,28,13364,28,13364,3334493.7407407407,501.0,477.2857142857143,0,0,0.0,0.0,0.0
1010.0,17,4,438,2,148,0.0,74.0,74.0,2,290,0.0,147.0,145.0
1031470.0,6,10,1221,6,636,206294.0,298.0,106.0,4,585,338410.0,379.0,146.25
129405306.0,6,35,2410,18,1285,7612076.823529412,139.0,71.38888888888889,17,1125,7449575.9375,123.0,66.17647058823529
3046302.0,6,3,204,2,136,0.0,70.0,68.0,1,68,0.0,68.0,68.0
92177482.0,17,16,5472,16,5472,6145165.466666667,342.0,342.0,0,0,0.0,0.0,0.0
23683.0,6,14,4740,7,653,3249.5,249.0,93.28571428571428,7,4087,3577.1666666666665,1514.0,583.8571428571429
47991.0,6,10,2032,5,524,11591.25,252.0,104.8,5,1508,7942.75,1236.0,301.6
399617.0,6,10,1221,6,636,79923.4,298.0,106.0,4,585,126335.66666666669,379.0,146.25
28186.0,6,14,4740,7,653,3911.0,249.0,93.28571428571428,7,4087,4509.833333333333,1514.0,583.8571428571429
295.0,17,2,156,1,78,0.0,78.0,78.0,1,78,0.0,78.0,78.0
34386.0,6,14,4740,7,653,5608.833333333333,249.0,93.28571428571428,7,4087,5544.666666666667,1514.0,583.8571428571429
2761.0,17,2,762,2,762,0.0,381.0,381.0,0,0,0.0,0.0,0.0
1779208.0,17,6,1230,3,234,889418.0,78.0,78.0,3,996,889388.0,332.0,332.0
113520288.0,6,46,3036,23,1518,5159999.818181818,66.0,66.0,23,1518,5160001.590909091,66.0,66.0
0.0,17,1,381,1,381,0.0,381.0,381.0,0,0,0.0,0.0,0.0
216447.0,17,2,180,1,90,0.0,90.0,90.0,1,90,0.0,90.0,90.0
2479.0,17,4,344,2,150,0.0,75.0,75.0,2,194,0.0,103.0,97.0
207724.0,6,3,426,2,280,0.0,214.0,140.0,1,146,0.0,146.0,146.0
34421.0,6,14,4740,7,653,5255.833333333333,249.0,93.28571428571428,7,4087,5598.166666666667,1514.0,583.8571428571429
216706.0,6,3,426,2,280,0.0,214.0,140.0,1,146,0.0,146.0,146.0
144932.0,17,2,180,1,70,0.0,70.0,70.0,1,110,0.0,110.0,110.0
334324.0,6,6,412,4,272,111441.33333333331,74.0,68.0,2,140,0.0,74.0,70.0
44989.0,6,14,4740,7,653,7291.666666666667,249.0,93.28571428571428,7,4087,6978.333333333333,1514.0,583.8571428571429
213886.0,17,2,414,1,88,0.0,88.0,88.0,1,326,0.0,326.0,326.0
103596824.0,17,14,864,7,432,17168415.5,174.0,61.71428571428572,7,432,17166848.833333332,174.0,61.71428571428572
18525.0,6,10,1949,5,441,4401.25,169.0,88.2,5,1508,4339.75,1236.0,301.6
1667791.0,17,18,1260,18,1260,98105.35294117648,70.0,70.0,0,0,0.0,0.0,0.0
103049.0,17,2,286,2,286,0.0,143.0,143.0,0,0,0.0,0.0,0.0
162392.0,17,2,180,1,90,0.0,90.0,90.0,1,90,0.0,90.0,90.0
314.0,17,2,174,1,79,0.0,79.0,79.0,1,95,0.0,95.0,95.0
108146.0,17,2,286,2,286,0.0,143.0,143.0,0,0,0.0,0.0,0.0
147952.0,6,3,337,2,214,0.0,160.0,107.0,1,123,0.0,123.0,123.0
120000005.0,6,17,1287,9,691,15000000.625,95.0,76.77777777777777,8,596,12898380.857142856,95.0,74.5
23774.0,17,2,180,1,90,0.0,90.0,90.0,1,90,0.0,90.0,90.0
300398.0,6,6,412,4,272,100132.66666666669,74.0,68.0,2,140,0.0,74.0,70.0
90385.0,6,2,134,1,68,0.0,68.0,68.0,1,66,0.0,66.0,66.0
2021.0,17,4,344,2,150,0.0,75.0,75.0,2,194,0.0,103.0,97.0
5005651.0,17,4,849,2,166,0.0,83.0,83.0,2,683,0.0,499.0,341.5
4406.0,17,2,598,1,72,0.0,72.0,72.0,1,526,0.0,526.0,526.0
2345.0,17,4,344,2,150,0.0,75.0,75.0,2,194,0.0,103.0,97.0
0.0,17,1,55,1,55,0.0,55.0,55.0,0,0,0.0,0.0,0.0
108129558.0,17,5,955,5,955,27032389.5,191.0,191.0,0,0,0.0,0.0,0.0
90962094.0,6,21,1585,11,840,9094984.0,95.0,76.36363636363636,10,745,10105422.333333334,95.0,74.5
11872775.0,17,5,850,5,850,2968193.75,170.0,170.0,0,0,0.0,0.0,0.0
319.0,17,2,174,1,79,0.0,79.0,79.0,1,95,0.0,95.0,95.0
205823.0,17,2,180,1,90,0.0,90.0,90.0,1,90,0.0,90.0,90.0
90294691.0,6,16,1192,8,596,12892598.57142857,95.0,74.5,8,596,12898795.57142857,95.0,74.5
123858121.0,6,48,3168,24,1584,5026272.347826087,66.0,66.0,24,1584,5274380.608695652,66.0,66.0
454056.0,6,3,1604,2,851,0.0,785.0,425.5,1,753,0.0,753.0,753.0
446457.0,17,4,360,2,140,0.0,70.0,70.0,2,220,0.0,110.0,110.0
302960.0,6,6,412,4,272,100986.66666666669,74.0,68.0,2,140,0.0,74.0,70.0
120056010.0,17,29,13785,29,13785,4287714.642857143,501.0,475.3448275862069,0,0,0.0,0.0,0.0
142408.0,6,2,132,1,66,0.0,66.0,66.0,1,66,0.0,66.0,66.0
30334.0,6,14,4740,7,653,4419.0,249.0,93.28571428571428,7,4087,4877.166666666667,1514.0,583.8571428571429
2800601.0,6,2,132,1,66,0.0,66.0,66.0,1,66,0.0,66.0,66.0
498.0,17,2,508,2,508,0.0,257.0,254.0,0,0,0.0,0.0,0.0
302.0,17,2,164,1,82,0.0,82.0,82.0,1,82,0.0,82.0,82.0
242747.0,6,3,373,2,238,0.0,172.0,119.0,1,135,0.0,135.0,135.0
120132839.0,6,214,24106,107,7284,1125574.7641509434,140.0,68.07476635514018,107,16822,1125619.1132075472,284.0,157.21495327102804
287862.0,17,6,1230,3,234,143747.5,78.0,78.0,3,996,139114.5,332.0,332.0
4888785.0,6,1685,1691969,1111,1658125,4220.165765765766,1514.0,1492.4617461746177,574,33844,8174.591623036649,1514.0,58.9616724738676
90034392.0,17,28,13364,28,13364,3334607.111111111,501.0,477.2857142857143,0,0,0.0,0.0,0.0
116352456.0,6,211,23818,106,16666,1108118.6285714286,284.0,157.2264150943396,105,7152,1108899.048076923,140.0,68.11428571428571
103518.0,17,2,286,2,286,0.0,143.0,143.0,0,0,0.0,0.0,0.0
90258535.0,6,12,1832,8,1016,12894076.42857143,188.0,127.0,4,816,30031335.666666668,204.0,204.0
100712984.0,17,12,516,6,258,20001237.8,43.0,43.0,6,258,20000164.6,43.0,43.0
2597057.0,6,2,132,1,66,0.0,66.0,66.0,1,66,0.0,66.0,66.0
106956.0,17,2,286,2,286,0.0,143.0,143.0,0,0,0.0,0.0,0.0
121514.0,6,3,337,2,214,0.0,160.0,107.0,1,123,0.0,123.0,123.0
124001162.0,17,15,907,8,475,17714451.714285713,174.0,59.375,7,432,17334494.666666668,174.0,61.71428571428572
90267701.0,6,15,1097,8,596,12895385.857142856,95.0,74.5,7,501,14997365.0,95.0,71.57142857142857
108109913.0,17,5,1005,5,1005,27027478.25,201.0,201.0,0,0,0.0,0.0,0.0
357.0,17,2,166,1,75,0.0,75.0,75.0,1,91,0.0,91.0,91.0
45142.0,6,14,4740,7,653,7400.333333333333,249.0,93.28571428571428,7,4087,7333.333333333333,1514.0,583.8571428571429
872991.0,6,10,1335,6,798,174598.2,460.0,133.0,4,537,199073.3333333333,331.0,134.25
141498.0,17,4,704,2,148,0.0,74.0,74.0,2,556,0.0,280.0,278.0
25112.0,6,10,2032,5,524,6070.25,252.0,104.8,5,1508,5917.25,1236.0,301.6
3959.0,17,4,344,2,150,0.0,75.0,75.0,2,194,0.0,103.0,97.0
2334.0,17,4,344,2,150,0.0,75.0,75.0,2,194,0.0,103.0,97.0
209382.0,17,2,180,1,90,0.0,90.0,90.0,1,90,0.0,90.0,90.0
10657.0,6,10,1065,5,534,2410.25,262.0,106.8,5,531,2444.0,259.0,106.2
303773.0,6,6,412,4,272,101257.66666666669,74.0,68.0,2,140,0.0,74.0,70.0
206431.0,6,3,426,2,280,0.0,214.0,140.0,1,146,0.0,146.0,146.0
190940.0,17,2,180,1,90,0.0,90.0,90.0,1,90,0.0,90.0,90.0
319.0,17,2,174,1,79,0.0,79.0,79.0,1,95,0.0,95.0,95.0
153811.0,17,2,180,1,90,0.0,90.0,90.0,1,90,0.0,90.0,90.0
90767034.0,6,17,1287,9,691,11339884.25,95.0,76.77777777777777,8,596,12965848.0,95.0,74.5
107373.0,17,2,286,2,286,0.0,143.0,143.0,0,0,0.0,0.0,0.0
8312920.999999999,17,3,1034,2,684,0.0,342.0,342.0,1,350,0.0,350.0,350.0
223765.0,6,3,426,2,280,0.0,214.0,140.0,1,146,0.0,146.0,146.0
11782940.0,6,5,1736,2,819,0.0,753.0,409.5,3,917,5826523.5,785.0,305.6666666666667
39327.0,6,10,2032,5,524,9601.0,252.0,104.8,5,1508,9168.5,1236.0,301.6
24493.0,6,10,2032,5,524,5783.5,252.0,104.8,5,1508,5908.5,1236.0,301.6
73172.0,6,14,4740,7,653,10862.833333333334,249.0,93.28571428571428,7,4087,11892.166666666666,1514.0,583.8571428571429
9380.0,17,2,539,1,86,0.0,86.0,86.0,1,453,0.0,453.0,453.0
108105309.0,17,5,955,5,955,27026327.25,191.0,191.0,0,0,0.0,0.0,0.0
146155.0,6,3,337,2,214,0.0,160.0,107.0,1,123,0.0,123.0,123.0
327.0,17,2,208,1,72,0.0,72.0,72.0,1,136,0.0,136.0,136.0
135140792.0,17,6,1146,6,1146,27028158.4,191.0,191.0,0,0,0.0,0.0,0.0
15899.0,6,10,1975,5,467,3742.5,195.0,93.4,5,1508,1876.25,1236.0,301.6
2594578.0,6,2,132,1,66,0.0,66.0,66.0,1,66,0.0,66.0,66.0
21834.0,6,11,2098,6,590,3754.4,252.0,98.33333333333331,5,1508,4964.25,1236.0,301.6
90228171.0,6,12,1832,8,1016,12889738.714285716,188.0,127.0,4,816,30020387.666666668,204.0,204.0
225576.0,6,10,1221,6,636,45115.2,298.0,106.0,4,585,74309.66666666667,379.0,146.25
147912.0,17,2,180,1,90,0.0,90.0,90.0,1,90,0.0,90.0,90.0
32681435.0,6,5,336,2,134,0.0,68.0,67.0,3,202,14950565.5,70.0,67.33333333333333
49354.0,6,14,4740,7,653,4711.666666666667,249.0,93.28571428571428,7,4087,7282.0,1514.0,583.8571428571429
4151694.0,6,198,169521,117,159873,35790.46551724138,1510.0,1366.4358974358977,81,9648,48024.4875,1510.0,119.11111111111111
1487685.0,17,6,1230,3,234,743656.0,78.0,78.0,3,996,743636.0,332.0,332.0
101000994.0,17,13,821,7,432,16833499.0,174.0,61.71428571428572,6,389,20041187.6,174.0,64.83333333333333
66522.0,6,19,7540,11,978,6652.2,310.0,88.9090909090909,8,6562,6708.571428571428,1514.0,820.25
744147.0,6,2,132,1,66,0.0,66.0,66.0,1,66,0.0,66.0,66.0
90525642.0,6,13,2036,8,1016,12932234.57142857,188.0,127.0,5,1020,22591137.25,204.0,204.0
209627.0,17,2,180,1,90,0.0,90.0,90.0,1,90,0.0,90.0,90.0
153422.0,17,2,180,1,90,0.0,90.0,90.0,1,90,0.0,90.0,90.0
2799769.0,6,2,132,1,66,0.0,66.0,66.0,1,66,0.0,66.0,66.0
127414.0,6,2,132,1,66,0.0,66.0,66.0,1,66,0.0,66.0,66.0
0.0,17,1,381,1,381,0.0,381.0,381.0,0,0,0.0,0.0,0.0
0.0,17,1,381,1,381,0.0,381.0,381.0,0,0,0.0,0.0,0.0
196981.0,17,2,180,1,90,0.0,90.0,90.0,1,90,0.0,90.0,90.0
302.0,17,2,164,1,82,0.0,82.0,82.0,1,82,0.0,82.0,82.0
35553.0,6,13,1386,7,789,5925.5,253.0,112.71428571428572,6,597,6287.8,259.0,99.5
104047225.0,6,27,2129,14,1043,8003632.692307692,95.0,74.5,13,1086,8628200.416666666,155.0,83.53846153846153
2345335.0,6,11,1131,6,600,468746.2,262.0,100.0,5,531,3843.25,259.0,106.2
102059447.0,17,14,864,7,432,16983416.166666668,174.0,61.71428571428572,7,432,16944027.333333332,174.0,61.71428571428572
228165.0,17,2,180,1,90,0.0,90.0,90.0,1,90,0.0,90.0,90.0
36491.0,6,14,4740,7,653,5914.5,249.0,93.28571428571428,7,4087,5784.333333333333,1514.0,583.8571428571429
523806.0,6,3,1604,1,753,0.0,753.0,753.0,2,851,0.0,785.0,425.5
116627088.0,6,47,3102,24,1584,5070728.0869565215,66.0,66.0,23,1518,5160012.863636363,66.0,66.0
103414.0,17,2,286,2,286,0.0,143.0,143.0,0,0,0.0,0.0,0.0
60143.0,6,14,4740,7,653,9294.0,249.0,93.28571428571428,7,4087,7509.5,1514.0,583.8571428571429
89227.0,6,14,4740,7,653,11476.5,249.0,93.28571428571428,7,4087,14561.5,1514.0,583.8571428571429
35240.0,6,10,2032,5,524,8501.5,252.0,104.8,5,1508,6773.25,1236.0,301.6
135135447.0,17,6,1146,6,1146,27027089.4,191.0,191.0,0,0,0.0,0.0,0.0
221497.0,6,10,1221,6,636,44299.4,298.0,106.0,4,585,72624.33333333333,379.0,146.25
1167651.0,6,13,3012,8,2384,166807.2857142857,1514.0,298.0,5,628,223014.75,331.0,125.6
207175.0,6,3,426,2,280,0.0,214.0,140.0,1,146,0.0,146.0,146.0
10463581.0,6,7,478,4,272,3442380.0,74.0,68.0,3,206,5163467.5,74.0,68.66666666666667
322605.0,17,4,1400,4,1400,107535.0,350.0,350.0,0,0,0.0,0.0,0.0
55484.0,6,14,4740,7,653,9117.5,249.0,93.28571428571428,7,4087,8246.5,1514.0,583.8571428571429
93391680.0,6,26,2019,14,1084,7180628.153846154,95.0,77.42857142857143,12,935,8489658.727272727,95.0,77.91666666666667
90037830.0,17,28,13364,28,13364,3334734.4444444445,501.0,477.2857142857143,0,0,0.0,0.0,0.0
135137453.0,17,6,1146,6,1146,27027490.6,191.0,191.0,0,0,0.0,0.0,0.0
340932.0,17,2,582,1,83,0.0,83.0,83.0,1,499,0.0,499.0,499.0
11157.0,6,11,1132,6,556,1861.8,218.0,92.66666666666669,5,576,2453.75,304.0,115.2
242153.0,6,3,337,2,214,0.0,160.0,107.0,1,123,0.0,123.0,123.0
90009912.0,17,27,12943,27,12943,3461919.6923076925,501.0,479.3703703703704,0,0,0.0,0.0,0.0
116788611.0,6,48,3168,24,1584,5077765.695652174,66.0,66.0,24,1584,5068367.0869565215,66.0,66.0
2284732.0,6,49,23728,25,19797,95197.16666666669,1514.0,791.88,24,3931,89835.82608695653,1514.0,163.79166666666666
308495.0,6,6,412,4,272,102831.66666666669,74.0,68.0,2,140,0.0,74.0,70.0
14868.0,6,10,2032,5,524,3409.25,252.0,104.8,5,1508,3374.0,1236.0,301.6
8076.0,17,4,823,2,163,0.0,89.0,81.5,2,660,0.0,443.0,330.0
90039889.0,17,28,13364,28,13364,3334810.703703704,501.0,477.2857142857143,0,0,0.0,0.0,0.0
94307.0,6,14,4740,7,653,14615.166666666666,249.0,93.28571428571428,7,4087,14087.5,1514.0,583.8571428571429
33706729.0,6,5,336,2,134,0.0,68.0,67.0,3,202,16774321.500000002,70.0,67.33333333333333
205903.0,6,3,426,2,280,0.0,214.0,140.0,1,146,0.0,146.0,146.0
207058.0,6,3,426,2,280,0.0,214.0,140.0,1,146,0.0,146.0,146.0
316366.0,17,4,1400,4,1400,105455.33333333331,350.0,350.0,0,0,0.0,0.0,0.0
54919.0,6,10,2032,5,524,11206.5,252.0,104.8,5,1508,13445.0,1236.0,301.6
129001432.0,17,15,907,8,475,18428776.0,174.0,59.375,7,432,18167782.83333333,174.0,61.71428571428572
1302148.0,6,4,264,2,132,0.0,66.0,66.0,2,132,0.0,66.0,66.0
107284.0,17,2,286,2,286,0.0,143.0,143.0,0,0,0.0,0.0,0.0
2055.0,17,4,344,2,150,0.0,75.0,75.0,2,194,0.0,103.0,97.0
193245.0,17,2,180,1,90,0.0,90.0,90.0,1,90,0.0,90.0,90.0
167882.0,6,2,132,1,66,0.0,66.0,66.0,1,66,0.0,66.0,66.0
104569474.0,17,14,1126,7,563,17333491.833333332,174.0,80.42857142857143,7,563,17334137.666666668,174.0,80.42857142857143
875887.0,6,9,1268,6,797,175177.4,459.0,132.83333333333334,3,471,300125.5,331.0,157.0
120066712.0,17,28,13364,28,13364,4446915.259259259,501.0,477.2857142857143,0,0,0.0,0.0,0.0
113675734.0,6,218,24698,109,7490,1052553.0925925926,140.0,68.71559633027523,109,17208,1050509.888888889,336.0,157.87155963302752
1996.0,17,4,344,2,150,0.0,75.0,75.0,2,194,0.0,103.0,97.0
198636.0,17,4,6056,4,6056,66212.0,1514.0,1514.0,0,0,0.0,0.0,0.0
143882.0,17,2,180,1,90,0.0,90.0,90.0,1,90,0.0,90.0,90.0
509.0,17,2,508,2,508,0.0,257.0,254.0,0,0,0.0,0.0,0.0
217198.0,6,3,426,2,280,0.0,214.0,140.0,1,146,0.0,146.0,146.0
320734.0,17,4,1400,4,1400,106911.33333333331,350.0,350.0,0,0,0.0,0.0,0.0
103522.0,17,2,286,2,286,0.0,143.0,143.0,0,0,0.0,0.0,0.0
45205.0,6,10,2032,5,524,8988.25,252.0,104.8,5,1508,8966.75,1236.0,301.6
218455.0,6,3,426,2,280,0.0,214.0,140.0,1,146,0.0,146.0,146.0
49190.0,6,14,4740,7,653,8072.666666666667,249.0,93.28571428571428,7,4087,7776.333333333333,1514.0,583.8571428571429
90528974.0,6,13,2036,8,1016,12932710.57142857,188.0,127.0,5,1020,22590859.0,204.0,204.0
370.0,17,2,267,1,83,0.0,83.0,83.0,1,184,0.0,184.0,184.0
90379757.0,6,17,1408,9,650,11297469.625,95.0,72.22222222222223,8,758,12874803.285714284,257.0,94.75
1040767.0,6,11,1134,6,558,208153.4,220.0,93.0,5,576,258187.75,304.0,115.2
305626.0,6,6,412,4,272,101875.33333333331,74.0,68.0,2,140,0.0,74.0,70.0
153479.0,17,2,180,1,90,0.0,90.0,90.0,1,90,0.0,90.0,90.0
105174256.0,6,44,2904,22,1452,5008297.904761905,66.0,66.0,22,1452,4993414.571428572,66.0,66.0
216449.0,17,2,180,1,90,0.0,90.0,90.0,1,90,0.0,90.0,90.0
106347.0,17,2,286,2,286,0.0,143.0,143.0,0,0,0.0,0.0,0.0
114104808.0,6,47,3102,24,1584,4961064.217391305,66.0,66.0,23,1518,5160000.7727272725,66.0,66.0
15959.000000000002,6,20,7606,11,978,1595.9,310.0,88.9090909090909,9,6628,1723.75,1514.0,736.4444444444445
103521.0,17,2,286,2,286,0.0,143.0,143.0,0,0,0.0,0.0,0.0
300.0,17,2,166,1,75,0.0,75.0,75.0,1,91,0.0,91.0,91.0
146362.0,6,3,337,2,214,0.0,160.0,107.0,1,123,0.0,123.0,123.0
103711.0,17,2,286,2,286,0.0,143.0,143.0,0,0,0.0,0.0,0.0
5005490.0,17,4,849,2,166,0.0,83.0,83.0,2,683,0.0,499.0,341.5
2533903.0,6,27,11985,15,4361,180993.07142857145,1510.0,290.7333333333333,12,7624,194314.9090909091,1510.0,635.3333333333334
43807084.0,6,7,1874,5,1053,10951771.0,785.0,210.6,2,821,0.0,753.0,410.5
117647598.0,6,500,64684,250,47962,471611.4136546185,336.0,191.848,250,16722,471611.0522088353,140.0,66.888
90262374.0,6,13,2036,8,1016,12894624.857142856,188.0,127.0,5,1020,22524229.0,204.0,204.0
245252.0,6,3,337,2,214,0.0,160.0,107.0,1,123,0.0,123.0,123.0
250111.00000000003,17,4,1524,4,1524,83370.33333333333,381.0,381.0,0,0,0.0,0.0,0.0
148877.0,6,3,337,2,214,0.0,160.0,107.0,1,123,0.0,123.0,123.0
488766.0,6,5,336,2,134,0.0,68.0,67.0,3,202,193363.0,70.0,67.33333333333333
119477075.0,6,201,22820,101,15998,1194770.75,284.0,158.3960396039604,100,6822,1196520.4747474748,140.0,68.22
120384140.0,6,207,23432,104,16338,1168778.0582524273,284.0,157.09615384615384,103,7094,1170172.0588235294,140.0,68.87378640776699
235219.0,6,3,373,2,238,0.0,172.0,119.0,1,135,0.0,135.0,135.0
120126629.0,6,14,2224,9,1204,15015828.625,188.0,133.77777777777777,5,1020,22523727.5,204.0,204.0
343.0,17,2,166,1,83,0.0,83.0,83.0,1,83,0.0,83.0,83.0
2008613.0,17,4,525,2,150,0.0,75.0,75.0,2,375,0.0,284.0,187.5
108109675.0,17,5,955,5,955,27027418.75,191.0,191.0,0,0,0.0,0.0,0.0
405103.0,6,4,508,2,238,0.0,172.0,119.0,2,270,0.0,135.0,135.0
120414928.0,6,36,2580,18,1248,6495792.705882353,123.0,69.33333333333333,18,1332,6630884.176470588,123.0,74.0
301813.0,6,10,1221,6,636,60362.6,298.0,106.0,4,585,95205.33333333331,379.0,146.25
4854.0,17,2,762,2,762,0.0,381.0,381.0,0,0,0.0,0.0,0.0
90256993.0,6,13,2036,8,1016,12893856.142857144,188.0,127.0,5,1020,22523058.75,204.0,204.0
109041.0,17,2,700,2,700,0.0,350.0,350.0,0,0,0.0,0.0,0.0
46763.0,6,10,2032,5,524,9053.75,252.0,104.8,5,1508,11238.25,1236.0,301.6
198006.0,6,14,4740,7,653,28754.0,249.0,93.28571428571428,7,4087,32812.5,1514.0,583.8571428571429
34921.0,6,10,2032,5,524,8477.5,252.0,104.8,5,1508,8028.0,1236.0,301.6
120000019.0,6,17,1287,9,691,15000002.375,95.0,76.77777777777777,8,596,12897328.285714284,95.0,74.5
93232265.0,6,27,1954,14,1045,7171712.692307692,139.0,74.64285714285714,13,909,6919201.083333333,123.0,69.92307692307692
108986.0,17,2,286,2,286,0.0,143.0,143.0,0,0,0.0,0.0,0.0
108892510.0,6,32,2236,16,1165,7259500.666666667,139.0,72.8125,16,1071,7245844.2,123.0,66.9375
90060721.0,17,28,13364,28,13364,3335582.25925926,501.0,477.2857142857143,0,0,0.0,0.0,0.0
153395.0,17,2,180,1,90,0.0,90.0,90.0,1,90,0.0,90.0,90.0
2348.0,17,4,344,2,150,0.0,75.0,75.0,2,194,0.0,103.0,97.0
330.0,17,2,160,1,80,0.0,80.0,80.0,1,80,0.0,80.0,80.0
297737.0,6,6,412,4,272,99245.66666666669,74.0,68.0,2,140,0.0,74.0,70.0
2022672.0,17,4,525,2,150,0.0,75.0,75.0,2,375,0.0,284.0,187.5
99576617.0,17,12,778,6,389,19883300.4,174.0,64.83333333333333,6,389,19794948.6,174.0,64.83333333333333
3925087.0,17,2,876,2,876,0.0,438.0,438.0,0,0,0.0,0.0,0.0
10256.0,6,10,1066,5,490,2204.5,218.0,98.0,5,576,2340.0,304.0,115.2
48075.0,6,14,4740,7,653,7543.333333333333,249.0,93.28571428571428,7,4087,7437.666666666667,1514.0,583.8571428571429
850678.0,6,9,1118,6,586,170135.6,248.0,97.66666666666669,3,532,287478.0,392.0,177.33333333333334
59876.0,6,14,4740,7,653,9751.833333333334,249.0,93.28571428571428,7,4087,8563.5,1514.0,583.8571428571429
90918810.0,6,244,27488,122,8200,744532.652892562,140.0,67.21311475409836,122,19288,751222.6280991735,284.0,158.0983606557377
90299991.0,6,16,1192,8,596,12893872.0,95.0,74.5,8,596,12897960.57142857,95.0,74.5
687980.0,6,6,758,3,410,299188.0,172.0,136.66666666666666,3,348,224295.0,135.0,116.0
242860.0,6,3,337,2,214,0.0,160.0,107.0,1,123,0.0,123.0,123.0
2928652.0,6,12,2172,7,664,488002.0,252.0,94.85714285714286,5,1508,2502.0,1236.0,301.6
100547905.0,17,14,1126,7,563,16666834.333333334,174.0,80.42857142857143,7,563,16667609.0,174.0,80.42857142857143
309362.0,17,4,1400,4,1400,103120.66666666669,350.0,350.0,0,0,0.0,0.0,0.0
2205.0,17,2,932,1,590,0.0,590.0,590.0,1,342,0.0,342.0,342.0
43017.0,6,14,4740,7,653,6958.166666666667,249.0,93.28571428571428,7,4087,6864.0,1514.0,583.8571428571429
776.0,17,4,438,2,148,0.0,74.0,74.0,2,290,0.0,147.0,145.0
9428.0,6,10,1975,5,467,2165.75,195.0,93.4,5,1508,1729.5,1236.0,301.6
285066.0,17,2,363,1,79,0.0,79.0,79.0,1,284,0.0,284.0,284.0
218211.0,6,3,426,2,280,0.0,214.0,140.0,1,146,0.0,146.0,146.0
519336.0,6,2,145,2,145,0.0,91.0,72.5,0,0,0.0,0.0,0.0
300733.0,6,7,478,4,272,100244.33333333331,74.0,68.0,3,206,76582.5,74.0,68.66666666666667
299468.0,6,6,412,4,272,99822.66666666669,74.0,68.0,2,140,0.0,74.0,70.0
10469616.0,6,7,478,4,272,3444241.0,74.0,68.0,3,206,5166224.5,74.0,68.66666666666667
47817026.0,6,8,2113,3,960,22532967.0,826.0,320.0,5,1153,11515891.75,885.0,230.6
105595475.0,6,44,2904,22,1452,5028355.952380952,66.0,66.0,22,1452,5015242.19047619,66.0,66.0
135133102.0,17,6,1206,6,1206,27026620.4,201.0,201.0,0,0,0.0,0.0,0.0
302295.0,6,6,412,4,272,100765.0,74.0,68.0,2,140,0.0,74.0,70.0
49353.0,6,10,2032,5,524,10662.0,252.0,104.8,5,1508,10952.0,1236.0,301.6
146774.0,6,3,337,2,214,0.0,160.0,107.0,1,123,0.0,123.0,123.0
2061.0,17,4,344,2,150,0.0,75.0,75.0,2,194,0.0,103.0,97.0
2512287.0,6,12,1354,6,723,498108.8,253.0,120.5,6,631,501007.0,293.0,105.16666666666669
59581.0,6,10,2032,5,524,11655.75,252.0,104.8,5,1508,14382.0,1236.0,301.6
10499988.0,6,7,478,4,272,3452899.0,74.0,68.0,3,206,5179233.0,74.0,68.66666666666667
120085040.0,17,28,13364,28,13364,4447594.074074074,501.0,477.2857142857143,0,0,0.0,0.0,0.0
242019.0,6,3,337,2,214,0.0,160.0,107.0,1,123,0.0,123.0,123.0
41155.0,6,14,4740,7,653,6689.166666666667,249.0,93.28571428571428,7,4087,6219.166666666667,1514.0,583.8571428571429
50984.0,6,14,4740,7,653,8157.833333333333,249.0,93.28571428571428,7,4087,8319.166666666666,1514.0,583.8571428571429
108103780.0,17,5,1005,5,1005,27025945.0,201.0,201.0,0,0,0.0,0.0,0.0
120042985.0,17,29,13785,29,13785,4287249.464285715,501.0,475.3448275862069,0,0,0.0,0.0,0.0
100777788.0,6,28,1876,14,982,7735537.307692308,139.0,70.14285714285714,14,894,7735535.923076923,123.0,63.85714285714285
118685123.0,6,228,26106,114,7820,1050310.8230088495,140.0,68.59649122807018,114,18286,1048313.6548672566,300.0,160.40350877192984
146050.0,6,3,337,2,214,0.0,160.0,107.0,1,123,0.0,123.0,123.0
3225.0,17,2,224,1,76,0.0,76.0,76.0,1,148,0.0,148.0,148.0
22310.0,17,2,582,1,83,0.0,83.0,83.0,1,499,0.0,499.0,499.0
2046.0,17,4,344,2,150,0.0,75.0,75.0,2,194,0.0,103.0,97.0
56881.0,6,10,2032,5,524,11871.0,252.0,104.8,5,1508,13110.5,1236.0,301.6
877.0,17,4,360,2,172,0.0,86.0,86.0,2,188,0.0,102.0,94.0
10728.0,17,4,823,2,163,0.0,89.0,81.5,2,660,0.0,443.0,330.0
101131.0,17,2,700,2,700,0.0,350.0,350.0,0,0,0.0,0.0,0.0
145591.0,6,3,337,2,214,0.0,160.0,107.0,1,123,0.0,123.0,123.0
2149042.0,6,9,754,5,482,497516.75,210.0,96.4,4,272,663270.0,74.0,68.0
102755.0,17,2,762,2,762,0.0,381.0,381.0,0,0,0.0,0.0,0.0
236028.0,17,2,180,1,90,0.0,90.0,90.0,1,90,0.0,90.0,90.0
135130356.0,17,6,1206,6,1206,27026071.2,201.0,201.0,0,0,0.0,0.0,0.0
298462.0,6,6,412,4,272,99487.33333333331,74.0,68.0,2,140,0.0,74.0,70.0
26601.0,6,14,4740,7,653,4125.333333333333,249.0,93.28571428571428,7,4087,4258.166666666667,1514.0,583.8571428571429
119360630.0,6,19,1395,10,745,13257753.333333334,95.0,74.5,9,650,14918832.5,95.0,72.22222222222223
100586579.0,17,12,778,6,389,20090722.0,174.0,64.83333333333333,6,389,20085359.8,174.0,64.83333333333333
206631.0,6,3,426,2,280,0.0,214.0,140.0,1,146,0.0,146.0,146.0
33089.0,6,14,4740,7,653,4432.666666666667,249.0,93.28571428571428,7,4087,5281.666666666667,1514.0,583.8571428571429
95932637.0,6,40,2640,20,1320,5049086.157894737,66.0,66.0,20,1320,5032632.842105263,66.0,66.0
12822.0,6,11,1133,6,602,2093.6,264.0,100.33333333333331,5,531,2919.75,259.0,106.2
100492114.0,17,12,516,6,258,20001001.4,43.0,43.0,6,258,20000168.2,43.0,43.0
90257506.0,6,12,1832,8,1016,12893929.42857143,188.0,127.0,4,816,30030883.666666668,204.0,204.0
121991.0,6,3,337,2,214,0.0,160.0,107.0,1,123,0.0,123.0,123.0
3185925.0,6,18,1495,9,921,358363.125,315.0,102.33333333333331,9,574,358246.125,78.0,63.77777777777778
82084.0,6,12,1328,7,797,13680.666666666666,253.0,113.85714285714286,5,531,14611.75,259.0,106.2
349.0,17,2,250,1,93,0.0,93.0,93.0,1,157,0.0,157.0,157.0
1302418.0,6,4,264,2,132,0.0,66.0,66.0,2,132,0.0,66.0,66.0
36318.0,6,14,4740,7,653,5935.5,249.0,93.28571428571428,7,4087,5430.166666666667,1514.0,583.8571428571429
90068217.0,17,28,13364,28,13364,3335859.888888889,501.0,477.2857142857143,0,0,0.0,0.0,0.0
328.0,17,2,208,1,72,0.0,72.0,72.0,1,136,0.0,136.0,136.0
831366.0,6,9,1118,6,586,166273.2,248.0,97.66666666666669,3,532,279426.5,392.0,177.33333333333334
5612300.0,6,5,336,2,134,0.0,68.0,67.0,3,202,1420228.5,70.0,67.33333333333333
119384433.0,6,223,25262,112,7688,1075535.4324324324,140.0,68.64285714285714,111,17574,1075880.209090909,374.0,158.32432432432432
118293649.0,6,203,22840,102,6954,1171224.2475247525,140.0,68.17647058823529,101,15886,1172442.44,284.0,157.2871287128713
534434.0,6,15,4815,7,742,88918.0,230.0,106.0,8,4073,75295.14285714286,1514.0,509.125
235615.0,6,3,373,2,238,0.0,172.0,119.0,1,135,0.0,135.0,135.0
5631038.0,6,5,336,2,134,0.0,68.0,67.0,3,202,1424762.0,70.0,67.33333333333333
755.0,17,4,438,2,148,0.0,74.0,74.0,2,290,0.0,147.0,145.0
40297.0,6,10,2032,5,524,9820.25,252.0,104.8,5,1508,9661.5,1236.0,301.6
2283604.0,6,49,23728,25,19797,95150.16666666669,1514.0,791.88,24,3931,90052.86956521739,1514.0,163.79166666666666
90026465.0,17,28,13364,28,13364,3334313.5185185187,501.0,477.2857142857143,0,0,0.0,0.0,0.0
10577739.0,6,7,478,4,272,3465199.333333333,74.0,68.0,3,206,5197679.5,74.0,68.66666666666667
90207482.0,6,16,1192,8,596,12852603.285714284,95.0,74.5,8,596,12857524.57142857,95.0,74.5
293.0,17,2,156,1,78,0.0,78.0,78.0,1,78,0.0,78.0,78.0
9668.0,17,2,582,1,83,0.0,83.0,83.0,1,499,0.0,499.0,499.0
27171819.0,17,5,1710,5,1710,6792954.75,342.0,342.0,0,0,0.0,0.0,0.0
209733.0,17,2,180,1,90,0.0,90.0,90.0,1,90,0.0,90.0,90.0
43613.0,6,14,4740,7,653,6625.666666666667,249.0,93.28571428571428,7,4087,6902.0,1514.0,583.8571428571429
2048.0,17,4,344,2,150,0.0,75.0,75.0,2,194,0.0,103.0,97.0
246027.0,6,3,337,2,214,0.0,160.0,107.0,1,123,0.0,123.0,123.0
429859.0,6,3,1604,2,851,0.0,785.0,425.5,1,753,0.0,753.0,753.0
101001026.0,17,13,821,7,432,16833504.333333332,174.0,61.71428571428572,6,389,16201160.8,174.0,64.83333333333333
140938.0,6,12,1447,6,816,27008.8,291.0,136.0,6,631,27008.4,293.0,105.16666666666669
894796.0,6,12,2710,7,743,149132.66666666666,339.0,106.14285714285714,5,1967,154824.75,1514.0,393.4
21581.0,17,2,582,1,83,0.0,83.0,83.0,1,499,0.0,499.0,499.0
2447.0,17,4,344,2,150,0.0,75.0,75.0,2,194,0.0,103.0,97.0
103842432.0,17,14,864,7,432,17167607.166666668,174.0,61.71428571428572,7,432,17166831.833333332,174.0,61.71428571428572
119917.0,17,2,180,1,70,0.0,70.0,70.0,1,110,0.0,110.0,110.0
153416.0,17,2,180,1,90,0.0,90.0,90.0,1,90,0.0,90.0,90.0
15916.0,6,10,2032,5,524,3742.25,252.0,104.8,5,1508,3609.25,1236.0,301.6
50944.0,17,2,180,1,90,0.0,90.0,90.0,1,90,0.0,90.0,90.0
312564.0,17,4,1400,4,1400,104188.0,350.0,350.0,0,0,0.0,0.0,0.0
142563.0,17,4,344,2,150,0.0,75.0,75.0,2,194,0.0,103.0,97.0
312.0,17,2,174,1,79,0.0,79.0,79.0,1,95,0.0,95.0,95.0
120123020.0,6,13,2036,5,1020,30030755.0,204.0,204.0,8,1016,17136949.42857143,188.0,127.0
206915.0,6,3,426,2,280,0.0,214.0,140.0,1,146,0.0,146.0,146.0
90254668.0,6,13,2036,8,1016,12893524.0,188.0,127.0,5,1020,22522478.25,204.0,204.0
120009462.0,17,28,13364,28,13364,4444794.888888889,501.0,477.2857142857143,0,0,0.0,0.0,0.0
29756.0,6,10,2032,5,524,5952.0,252.0,104.8,5,1508,7101.75,1236.0,301.6
369336.0,6,11,1021,6,444,51581.4,162.0,74.0,5,577,62492.0,349.0,115.4
2318.0,17,4,344,2,150,0.0,75.0,75.0,2,194,0.0,103.0,97.0
107364.0,17,2,286,2,286,0.0,143.0,143.0,0,0,0.0,0.0,0.0
313787.0,17,4,1400,4,1400,104595.66666666669,350.0,350.0,0,0,0.0,0.0,0.0
228266.0,17,2,180,1,90,0.0,90.0,90.0,1,90,0.0,90.0,90.0
90258823.0,6,13,2036,8,1016,12894117.57142857,188.0,127.0,5,1020,22522826.0,204.0,204.0
153420.0,17,2,180,1,90,0.0,90.0,90.0,1,90,0.0,90.0,90.0
90024636.0,17,28,13364,28,13364,3334245.777777778,501.0,477.2857142857143,0,0,0.0,0.0,0.0
197293.0,17,2,180,1,90,0.0,90.0,90.0,1,90,0.0,90.0,90.0
120000272.0,6,30,3203,16,1655,8000018.133333334,427.0,103.4375,14,1548,8466372.461538462,362.0,110.57142857142856
90015611.0,17,28,13364,28,13364,3333911.5185185187,501.0,477.2857142857143,0,0,0.0,0.0,0.0
209763.0,6,3,426,2,280,0.0,214.0,140.0,1,146,0.0,146.0,146.0
3812933.0,6,5,336,2,134,0.0,68.0,67.0,3,202,1526102.0,70.0,67.33333333333333
3000.0,17,2,224,1,76,0.0,76.0,76.0,1,148,0.0,148.0,148.0
2323.0,17,4,344,2,150,0.0,75.0,75.0,2,194,0.0,103.0,97.0
28015.0,6,10,2032,5,524,6484.5,252.0,104.8,5,1508,6656.75,1236.0,301.6
50231.0,6,14,4740,7,653,8214.666666666666,249.0,93.28571428571428,7,4087,7576.166666666667,1514.0,583.8571428571429
90223439.0,6,19,1436,9,691,11247183.25,95.0,76.77777777777777,10,745,10002004.222222222,95.0,74.5
107345561.0,17,14,864,7,432,17833531.666666668,174.0,61.71428571428572,7,432,17834564.5,174.0,61.71428571428572
300301.0,6,6,412,4,272,100100.33333333331,74.0,68.0,2,140,0.0,74.0,70.0
3951.0,17,4,704,2,148,0.0,74.0,74.0,2,556,0.0,280.0,278.0
2314.0,17,4,344,2,150,0.0,75.0,75.0,2,194,0.0,103.0,97.0
15596.0,6,11,1131,6,600,2906.4,262.0,100.0,5,531,3557.75,259.0,106.2
112006307.0,17,10,900,5,450,27958656.5,90.0,90.0,5,450,27958656.5,90.0,90.0
2260.0,17,4,344,2,150,0.0,75.0,75.0,2,194,0.0,103.0,97.0
20083743.0,6,22,7083,13,1707,1673645.25,408.0,131.30769230769232,9,5376,1994517.5,1514.0,597.3333333333334
120123917.0,6,13,2036,5,1020,30030979.25,204.0,204.0,8,1016,17137030.57142857,188.0,127.0
120035957.0,17,29,13785,29,13785,4286998.464285715,501.0,475.3448275862069,0,0,0.0,0.0,0.0
228364.0,17,2,180,1,90,0.0,90.0,90.0,1,90,0.0,90.0,90.0
91415323.0,6,22,1680,12,935,8309995.636363637,95.0,77.91666666666667,10,745,10156118.222222222,95.0,74.5
10747.0,17,2,539,1,86,0.0,86.0,86.0,1,453,0.0,453.0,453.0
76049418.0,6,9,842,9,842,9506177.25,97.0,93.55555555555556,0,0,0.0,0.0,0.0
120036609.0,6,18,1341,9,691,14999548.0,95.0,76.77777777777777,9,650,14999427.375,95.0,72.22222222222223
15032.0,17,2,180,1,90,0.0,90.0,90.0,1,90,0.0,90.0,90.0
526121.0,17,6,2100,6,2100,105224.2,350.0,350.0,0,0,0.0,0.0,0.0
90007808.0,17,28,13364,28,13364,3333622.5185185187,501.0,477.2857142857143,0,0,0.0,0.0,0.0
19515.0,6,14,4740,7,653,3094.833333333333,249.0,93.28571428571428,7,4087,3114.1666666666665,1514.0,583.8571428571429
119993571.0,17,35,16705,35,16705,3529222.6764705884,501.0,477.2857142857143,0,0,0.0,0.0,0.0
108223.0,17,2,762,2,762,0.0,381.0,381.0,0,0,0.0,0.0,0.0
10866994.0,6,8,544,4,272,3576769.333333333,74.0,68.0,4,272,3576707.333333333,74.0,68.0
10501.0,17,2,582,1,83,0.0,83.0,83.0,1,499,0.0,499.0,499.0
234274.0,6,3,373,2,238,0.0,172.0,119.0,1,135,0.0,135.0,135.0
1068039.0,6,13,1394,7,797,178006.5,253.0,113.85714285714286,6,597,210992.4,259.0,99.5
149664672.0,6,24,1829,13,1030,12472056.0,95.0,79.23076923076923,11,799,11991321.6,95.0,72.63636363636364
107134595.0,6,43,2838,22,1452,5101635.095238095,66.0,66.0,21,1386,5156005.75,66.0,66.0
2699292.0,6,3,1604,2,851,0.0,785.0,425.5,1,753,0.0,753.0,753.0
3789115.0,6,5,336,2,134,0.0,68.0,67.0,3,202,1527959.0,70.0,67.33333333333333
1645875.0,17,6,1230,3,234,822743.5,78.0,78.0,3,996,822693.0,332.0,332.0
4734.0,17,4,344,2,150,0.0,75.0,75.0,2,194,0.0,103.0,97.0
46461.0,6,2,132,1,66,0.0,66.0,66.0,1,66,0.0,66.0,66.0
119285833.0,6,215,24268,108,7424,1114820.8691588785,140.0,68.74074074074075,107,16844,1115470.5566037735,284.0,157.42056074766356
66006210.99999999,17,9,3086,8,2736,5106288.428571428,342.0,342.0,1,350,0.0,350.0,350.0
49116.0,6,10,2032,5,524,9919.0,252.0,104.8,5,1508,11750.75,1236.0,301.6
338868.0,6,3,1604,2,851,0.0,785.0,425.5,1,753,0.0,753.0,753.0
17690.0,6,14,4740,7,653,2843.0,249.0,93.28571428571428,7,4087,2812.833333333333,1514.0,583.8571428571429
1985.0,17,4,344,2,150,0.0,75.0,75.0,2,194,0.0,103.0,97.0
103148.0,17,2,286,2,286,0.0,143.0,143.0,0,0,0.0,0.0,0.0
287717.0,6,10,1221,6,636,57543.4,298.0,106.0,4,585,94152.66666666669,379.0,146.25
90292228.0,6,17,1287,9,691,11281297.25,95.0,76.77777777777777,8,596,12897158.285714284,95.0,74.5
10763.0,6,11,1132,6,556,1828.2,218.0,92.66666666666669,5,576,2254.5,304.0,115.2
120121236.0,6,12,1832,8,1016,17137367.714285713,188.0,127.0,4,816,30031651.666666668,204.0,204.0
120122275.0,6,13,2036,8,1016,17136965.714285713,188.0,127.0,5,1020,22523379.25,204.0,204.0
228114.0,17,2,180,1,90,0.0,90.0,90.0,1,90,0.0,90.0,90.0
657.0,17,2,762,2,762,0.0,381.0,381.0,0,0,0.0,0.0,0.0
0.0,17,1,55,1,55,0.0,55.0,55.0,0,0,0.0,0.0,0.0
107485.0,17,2,286,2,286,0.0,143.0,143.0,0,0,0.0,0.0,0.0
135143524.0,17,6,1206,6,1206,27028704.8,201.0,201.0,0,0,0.0,0.0,0.0
2342.0,17,4,344,2,150,0.0,75.0,75.0,2,194,0.0,103.0,97.0
2297.0,17,4,344,2,150,0.0,75.0,75.0,2,194,0.0,103.0,97.0
3023.0,17,5,550,5,550,755.75,110.0,110.0,0,0,0.0,0.0,0.0
113610543.0,6,46,3036,23,1518,5150438.5,66.0,66.0,23,1518,5150432.136363637,66.0,66.0
120214923.0,6,188,21332,94,6426,1284953.7204301076,140.0,68.36170212765957,94,14906,1283545.5376344086,284.0,158.5744680851064
90092697.0,6,12,1848,5,1020,22522588.0,204.0,204.0,7,828,15014915.333333334,188.0,118.28571428571428
18483.0,6,10,2032,5,524,4383.0,252.0,104.8,5,1508,4347.75,1236.0,301.6
14328.0,6,10,2032,5,524,3261.25,252.0,104.8,5,1508,3197.5,1236.0,301.6
93752509.0,17,14,1126,7,563,15500961.0,174.0,80.42857142857143,7,563,15333459.166666666,174.0,80.42857142857143
102230.0,17,2,286,2,286,0.0,143.0,143.0,0,0,0.0,0.0,0.0
1149205.0,6,13,3010,8,2382,164172.14285714287,1514.0,297.75,5,628,219161.25,331.0,125.6
1037274.0,6,11,1134,6,558,207454.8,220.0,93.0,5,576,256739.0,304.0,115.2
27973575.0,17,5,1710,5,1710,6993393.75,342.0,342.0,0,0,0.0,0.0,0.0
2297.0,17,4,344,2,150,0.0,75.0,75.0,2,194,0.0,103.0,97.0
98192721.0,17,12,1040,6,520,19606359.2,174.0,86.66666666666667,6,520,19606348.6,174.0,86.66666666666667
90256283.0,6,12,1832,8,1016,12893754.714285716,188.0,127.0,4,816,30030900.33333333,204.0,204.0
289629.0,17,2,620,1,75,0.0,75.0,75.0,1,545,0.0,545.0,545.0
121453.0,6,3,337,2,214,0.0,160.0,107.0,1,123,0.0,123.0,123.0
2593638.0,6,2,132,1,66,0.0,66.0,66.0,1,66,0.0,66.0,66.0
120098501.0,6,817,127566,406,27240,296539.5086419753,214.0,67.0935960591133,411,100326,292048.28536585363,1514.0,244.1021897810219
90199474.0,6,16,1192,8,596,12851928.142857144,95.0,74.5,8,596,12856259.42857143,95.0,74.5
509451.0,6,5,336,2,134,0.0,68.0,67.0,3,202,196326.5,70.0,67.33333333333333
232678.0,6,3,337,2,214,0.0,160.0,107.0,1,123,0.0,123.0,123.0
50805.0,6,14,4740,7,653,8201.0,249.0,93.28571428571428,7,4087,7023.0,1514.0,583.8571428571429
45236.0,6,10,2032,5,524,8917.75,252.0,104.8,5,1508,11063.5,1236.0,301.6
135129996.0,17,6,1206,6,1206,27025999.2,201.0,201.0,0,0,0.0,0.0,0.0
108112402.0,17,5,1005,5,1005,27028100.5,201.0,201.0,0,0,0.0,0.0,0.0
121136704.0,6,294,34390,147,9998,817291.4246575342,140.0,68.01360544217687,147,24392,824099.0410958905,464.0,165.93197278911563
58425.0,6,10,2032,5,524,13246.0,252.0,104.8,5,1508,11283.5,1236.0,301.6
35713.0,6,14,4740,7,653,5590.666666666667,249.0,93.28571428571428,7,4087,5790.833333333333,1514.0,583.8571428571429
2800897.0,6,2,132,1,66,0.0,66.0,66.0,1,66,0.0,66.0,66.0
50840.0,17,2,180,1,90,0.0,90.0,90.0,1,90,0.0,90.0,90.0
216422.0,17,2,180,1,90,0.0,90.0,90.0,1,90,0.0,90.0,90.0
250352.00000000003,6,3,373,2,238,0.0,172.0,119.0,1,135,0.0,135.0,135.0
90811266.0,6,28,1992,14,1029,6969686.769230769,123.0,73.5,14,963,6969756.076923077,123.0,68.78571428571429
306985.0,6,2,132,1,66,0.0,66.0,66.0,1,66,0.0,66.0,66.0
87705.0,6,12,1320,6,723,12127.6,253.0,120.5,6,597,15146.4,259.0,99.5
125020.0,17,4,1400,4,1400,41673.333333333336,350.0,350.0,0,0,0.0,0.0,0.0
92606750.0,6,39,2574,20,1320,4874039.47368421,66.0,66.0,19,1254,5143992.333333333,66.0,66.0
10521376.0,6,7,478,4,272,3460100.333333333,74.0,68.0,3,206,5190050.0,74.0,68.66666666666667
59416.0,6,12,1413,7,882,9902.666666666666,291.0,126.0,5,531,12971.25,259.0,106.2
29799.0,6,14,4740,7,653,4348.833333333333,249.0,93.28571428571428,7,4087,4566.666666666667,1514.0,583.8571428571429
60899321.0,6,5,1736,2,819,0.0,753.0,409.5,3,917,30449660.5,785.0,305.6666666666667
401491.0,6,4,508,2,238,0.0,172.0,119.0,2,270,0.0,135.0,135.0
117763920.0,6,32,2220,16,1149,7833125.066666666,123.0,71.8125,16,1071,7831247.533333333,123.0,66.9375
128389.0,6,2,132,1,66,0.0,66.0,66.0,1,66,0.0,66.0,66.0
5626325.0,6,5,336,2,134,0.0,68.0,67.0,3,202,1421642.5,70.0,67.33333333333333
90045283.0,17,28,13364,28,13364,3335010.4814814813,501.0,477.2857142857143,0,0,0.0,0.0,0.0
833.0,17,4,438,2,148,0.0,74.0,74.0,2,290,0.0,147.0,145.0
0.0,17,1,44,1,44,0.0,44.0,44.0,0,0,0.0,0.0,0.0
135135679.0,17,6,1206,6,1206,27027135.8,201.0,201.0,0,0,0.0,0.0,0.0
119382549.0,6,22,1801,11,799,11938254.9,95.0,72.63636363636364,11,1002,11911728.7,257.0,91.0909090909091
153496.0,17,2,180,1,90,0.0,90.0,90.0,1,90,0.0,90.0,90.0
205614.0,6,3,426,2,280,0.0,214.0,140.0,1,146,0.0,146.0,146.0
121067980.0,6,210,23774,105,7226,1146290.826923077,140.0,68.81904761904762,105,16548,1157471.6826923075,284.0,157.6
216203.0,17,2,180,1,90,0.0,90.0,90.0,1,90,0.0,90.0,90.0
1114223.0,6,13,1386,7,789,185703.8333333333,253.0,112.71428571428572,6,597,221960.8,259.0,99.5
204648.0,17,2,762,2,762,0.0,381.0,381.0,0,0,0.0,0.0,0.0
36415.0,6,12,1320,6,723,7008.2,253.0,120.5,6,597,6163.6,259.0,99.5
113246804.0,6,258,29626,129,8810,884740.65625,140.0,68.29457364341086,129,20816,883031.8359375,284.0,161.36434108527132
118908173.0,6,34,2334,17,1209,7418248.8125,123.0,71.11764705882354,17,1125,7418259.3125,123.0,66.17647058823529
204640.0,17,2,762,2,762,0.0,381.0,381.0,0,0,0.0,0.0,0.0
120123644.0,6,12,1832,8,1016,17136934.14285714,188.0,127.0,4,816,30029966.33333333,204.0,204.0
34559.0,6,14,4740,7,653,5600.0,249.0,93.28571428571428,7,4087,5480.0,1514.0,583.8571428571429
254082.0,6,3,337,2,214,0.0,160.0,107.0,1,123,0.0,123.0,123.0
104716.0,17,4,1400,4,1400,34905.333333333336,350.0,350.0,0,0,0.0,0.0,0.0
35379.0,6,10,2032,5,524,8286.0,252.0,104.8,5,1508,8350.5,1236.0,301.6
113511065.0,6,200,22536,100,15714,1144403.9797979798,284.0,157.14,100,6822,1144404.3232323232,140.0,68.22
10462345.0,6,7,478,4,272,3441669.6666666665,74.0,68.0,3,206,5162398.5,74.0,68.66666666666667
309.0,17,2,168,1,76,0.0,76.0,76.0,1,92,0.0,92.0,92.0
59470998.0,6,8,1307,8,1307,8495856.857142856,172.0,163.375,0,0,0.0,0.0,0.0
331.0,17,2,208,1,72,0.0,72.0,72.0,1,136,0.0,136.0,136.0
32806.0,6,14,4740,7,653,5339.833333333333,249.0,93.28571428571428,7,4087,5326.333333333333,1514.0,583.8571428571429
301750.0,6,6,412,4,272,100583.33333333331,74.0,68.0,2,140,0.0,74.0,70.0
24347.0,6,14,4740,7,653,3885.3333333333335,249.0,93.28571428571428,7,4087,3820.8333333333335,1514.0,583.8571428571429
5634.0,17,2,231,1,78,0.0,78.0,78.0,1,153,0.0,153.0,153.0
28720.0,6,14,4740,7,653,4536.333333333333,249.0,93.28571428571428,7,4087,4569.5,1514.0,583.8571428571429
48571.0,6,14,4740,7,653,7575.5,249.0,93.28571428571428,7,4087,7525.333333333333,1514.0,583.8571428571429
317101.0,17,4,1400,4,1400,105700.33333333331,350.0,350.0,0,0,0.0,0.0,0.0
120088062.0,6,220,24884,110,7482,1094183.770642202,140.0,68.01818181818182,110,17402,1094338.5688073395,284.0,158.2
98391470.0,17,12,778,6,389,19678294.0,174.0,64.83333333333333,6,389,19601646.2,174.0,64.83333333333333
147642740.0,6,29,2222,17,1328,9227671.25,95.0,78.11764705882354,12,894,10802806.909090908,95.0,74.5
245637.0,6,3,337,2,214,0.0,160.0,107.0,1,123,0.0,123.0,123.0
19380.0,6,10,2032,5,524,4614.25,252.0,104.8,5,1508,3750.75,1236.0,301.6
837627.0,6,11,1131,6,600,167335.2,262.0,100.0,5,531,209185.25,259.0,106.2
213721.0,17,2,180,1,90,0.0,90.0,90.0,1,90,0.0,90.0,90.0
101416933.0,17,14,864,7,432,16833534.666666668,174.0,61.71428571428572,7,432,16834364.5,174.0,61.71428571428572
116726805.0,6,40,3354,23,1884,5305763.863636363,123.0,81.91304347826087,17,1470,7281818.875,123.0,86.47058823529412
416.0,17,2,267,1,83,0.0,83.0,83.0,1,184,0.0,184.0,184.0
2086324.0,6,19,6869,11,1567,208632.4,408.0,142.45454545454547,8,5302,237339.57142857145,1514.0,662.75
14974.0,6,14,4740,7,653,2258.833333333333,249.0,93.28571428571428,7,4087,2085.6666666666665,1514.0,583.8571428571429
20092409.0,6,8,644,5,376,5023102.25,160.0,75.2,3,268,9972425.5,123.0,89.33333333333333
12985.0,6,13,1459,7,862,2010.6666666666667,271.0,123.14285714285714,6,597,2363.8,259.0,99.5
135126861.0,17,6,1206,6,1206,27025372.2,201.0,201.0,0,0,0.0,0.0,0.0
186088.0,17,2,180,1,90,0.0,90.0,90.0,1,90,0.0,90.0,90.0
22999.0,6,10,2032,5,524,5445.5,252.0,104.8,5,1508,5479.0,1236.0,301.6
254735.0,6,10,1221,6,636,50947.0,298.0,106.0,4,585,78661.66666666667,379.0,146.25
142655.0,6,13,1394,7,797,23775.83333333333,253.0,113.85714285714286,6,597,26222.4,259.0,99.5
207209.0,6,3,426,2,280,0.0,214.0,140.0,1,146,0.0,146.0,146.0
313131.0,17,4,1400,4,1400,104377.0,350.0,350.0,0,0,0.0,0.0,0.0
111442743.0,6,218,24534,109,17044,1029884.1388888888,284.0,156.36697247706422,109,7490,1029884.4814814816,140.0,68.71559633027523
196958.0,17,2,180,1,90,0.0,90.0,90.0,1,90,0.0,90.0,90.0
2026350.0,17,4,525,2,150,0.0,75.0,75.0,2,375,0.0,284.0,187.5
509529.0,6,5,336,2,134,0.0,68.0,67.0,3,202,192932.5,70.0,67.33333333333333
104063.0,17,2,286,2,286,0.0,143.0,143.0,0,0,0.0,0.0,0.0
14632892.0,6,19,1553,9,921,1790390.75,315.0,102.33333333333331,10,632,1591432.111111111,78.0,63.2
121260.0,6,3,337,2,214,0.0,160.0,107.0,1,123,0.0,123.0,123.0
9247.0,6,10,2032,5,524,2011.75,252.0,104.8,5,1508,1748.75,1236.0,301.6
108107980.0,17,5,1005,5,1005,27026995.0,201.0,201.0,0,0,0.0,0.0,0.0
298094.0,6,6,412,4,272,99364.66666666669,74.0,68.0,2,140,0.0,74.0,70.0
118931810.0,6,35,2542,18,1348,6995988.823529412,139.0,74.88888888888889,17,1194,7419708.9375,123.0,70.23529411764706
108100916.0,17,5,955,5,955,27025229.0,191.0,191.0,0,0,0.0,0.0,0.0
60026.0,6,14,4740,7,653,9871.166666666666,249.0,93.28571428571428,7,4087,9593.0,1514.0,583.8571428571429
102710.0,17,2,286,2,286,0.0,143.0,143.0,0,0,0.0,0.0,0.0
284486.0,17,2,363,1,79,0.0,79.0,79.0,1,284,0.0,284.0,284.0
116001043.0,17,15,1169,8,606,16571577.57142857,174.0,75.75,7,563,16001180.666666666,174.0,80.42857142857143
27551609.0,17,5,1710,5,1710,6887902.25,342.0,342.0,0,0,0.0,0.0,0.0
27975.0,6,14,4740,7,653,3812.6666666666665,249.0,93.28571428571428,7,4087,4028.5,1514.0,583.8571428571429
43837.0,6,14,4740,7,653,6477.166666666667,249.0,93.28571428571428,7,4087,7149.5,1514.0,583.8571428571429
120032290.0,6,24,1788,13,989,9999037.166666666,95.0,76.07692307692308,11,799,11996744.9,95.0,72.63636363636364
308461.0,6,3,202,2,128,0.0,74.0,64.0,1,74,0.0,74.0,74.0
41621.0,6,10,2032,5,524,9606.5,252.0,104.8,5,1508,9133.75,1236.0,301.6
108104008.0,17,5,955,5,955,27026002.0,191.0,191.0,0,0,0.0,0.0,0.0
526047.0,6,3,1604,2,851,0.0,785.0,425.5,1,753,0.0,753.0,753.0
3358327.0,6,141,121810,87,113944,39050.31395348837,1510.0,1309.7011494252874,54,7866,57568.54716981132,1510.0,145.66666666666666
33476.0,6,10,2032,5,524,8136.25,252.0,104.8,5,1508,8113.25,1236.0,301.6
208033.0,17,2,762,2,762,0.0,381.0,381.0,0,0,0.0,0.0,0.0
15764.0,17,2,180,1,90,0.0,90.0,90.0,1,90,0.0,90.0,90.0
95161348.0,17,12,778,6,389,19001090.0,174.0,64.83333333333333,6,389,19000160.4,174.0,64.83333333333333
209454.0,17,2,180,1,90,0.0,90.0,90.0,1,90,0.0,90.0,90.0
10513259.0,6,7,478,4,272,3457184.333333333,74.0,68.0,3,206,5185665.5,74.0,68.66666666666667
412818.0,17,2,762,2,762,0.0,381.0,381.0,0,0,0.0,0.0,0.0
5803.0,17,2,180,1,90,0.0,90.0,90.0,1,90,0.0,90.0,90.0
63105.99999999999,6,10,2032,5,524,15295.0,252.0,104.8,5,1508,13494.25,1236.0,301.6
2496.0,17,4,344,2,150,0.0,75.0,75.0,2,194,0.0,103.0,97.0
42586.0,6,12,1320,7,789,7097.666666666667,253.0,112.71428571428572,5,531,9403.0,259.0,106.2
44886388.0,17,9,3086,8,2736,5108227.0,342.0,342.0,1,350,0.0,350.0,350.0
3003102.0,6,11,2106,6,598,600412.0,252.0,99.66666666666669,5,1508,1916.5,1236.0,301.6
42296.0,6,10,2032,5,524,6686.0,252.0,104.8,5,1508,9645.75,1236.0,301.6
153479.0,17,2,180,1,90,0.0,90.0,90.0,1,90,0.0,90.0,90.0
90098968.0,6,11,1644,4,816,30031670.666666668,204.0,204.0,7,828,15016124.666666666,188.0,118.28571428571428
218176.0,6,3,426,2,280,0.0,214.0,140.0,1,146,0.0,146.0,146.0
117962.0,17,2,286,2,286,0.0,143.0,143.0,0,0,0.0,0.0,0.0
135127402.0,17,6,1206,6,1206,27025480.4,201.0,201.0,0,0,0.0,0.0,0.0
28050.0,6,10,1066,5,490,5009.5,218.0,98.0,5,576,6805.5,304.0,115.2
2148375.0,6,27,4583,15,1609,153455.35714285713,311.0,107.26666666666668,12,2974,175543.9090909091,1514.0,247.8333333333333
9611.0,17,2,539,1,86,0.0,86.0,86.0,1,453,0.0,453.0,453.0
5724278.0,6,4,270,2,134,0.0,68.0,67.0,2,136,0.0,70.0,68.0
98649424.0,17,12,778,6,389,19729884.8,174.0,64.83333333333333,6,389,19644232.4,174.0,64.83333333333333
107812.0,17,2,286,2,286,0.0,143.0,143.0,0,0,0.0,0.0,0.0
102086117.0,6,24,1990,13,1191,8506138.666666666,256.0,91.6153846153846,11,799,10179458.4,95.0,72.63636363636364
55330.0,6,10,2032,5,524,12727.5,252.0,104.8,5,1508,12976.0,1236.0,301.6
40061.0,6,10,2032,5,524,8788.5,252.0,104.8,5,1508,9101.0,1236.0,301.6
247059.0,17,2,180,1,90,0.0,90.0,90.0,1,90,0.0,90.0,90.0
3084986.0,6,4,270,2,134,0.0,68.0,67.0,2,136,0.0,70.0,68.0
18776.0,6,14,4740,7,653,2864.1666666666665,249.0,93.28571428571428,7,4087,2941.6666666666665,1514.0,583.8571428571429
27064227.0,17,5,1710,5,1710,6766056.75,342.0,342.0,0,0,0.0,0.0,0.0
41400.0,6,10,2032,5,524,9967.25,252.0,104.8,5,1508,9691.0,1236.0,301.6
300149.0,6,6,412,4,272,100049.66666666669,74.0,68.0,2,140,0.0,74.0,70.0
120204257.0,6,242,27500,121,8282,994801.7833333332,140.0,68.44628099173553,121,19218,994683.7583333332,300.0,158.82644628099175
146398.0,6,3,337,2,214,0.0,160.0,107.0,1,123,0.0,123.0,123.0
316119.0,17,4,1400,4,1400,105373.0,350.0,350.0,0,0,0.0,0.0,0.0
584284.0,6,2,145,2,145,0.0,91.0,72.5,0,0,0.0,0.0,0.0
123730702.0,6,49,3234,25,1650,5155445.916666667,66.0,66.0,24,1584,5154752.652173913,66.0,66.0
24116.0,6,10,2032,5,524,5561.5,252.0,104.8,5,1508,5048.25,1236.0,301.6
3662996.0,17,10,2050,5,390,915657.25,78.0,78.0,5,1660,915647.0,332.0,332.0
120237097.0,6,224,25196,112,7700,1076871.8468468469,140.0,68.75,112,17496,1075816.801801802,284.0,156.21428571428572
33192.0,6,10,1065,5,534,7715.0,262.0,106.8,5,531,7894.5,259.0,106.2
116361515.0,6,665,153270,326,22256,358035.4307692308,214.0,68.26993865030674,339,131014,341230.8343195266,1514.0,386.4719764011799
5623000.0,6,4,270,2,136,0.0,70.0,68.0,2,134,0.0,68.0,67.0
107001040.0,17,13,821,7,432,17833506.666666668,174.0,61.71428571428572,6,389,17401249.0,174.0,64.83333333333333
107391.0,17,2,286,2,286,0.0,143.0,143.0,0,0,0.0,0.0,0.0
2332.0,17,4,344,2,150,0.0,75.0,75.0,2,194,0.0,103.0,97.0
506524.0,6,5,336,2,134,0.0,68.0,67.0,3,202,198734.5,70.0,67.33333333333333
1493461.0,6,7,499,3,198,716486.5,66.0,66.0,4,301,432446.0,103.0,75.25
5833087.0,6,5,336,2,134,0.0,68.0,67.0,3,202,1526914.5,70.0,67.33333333333333
209380.0,17,2,180,1,90,0.0,90.0,90.0,1,90,0.0,90.0,90.0
90215376.0,6,16,1192,8,596,12852353.142857144,95.0,74.5,8,596,12857152.57142857,95.0,74.5
99073.0,17,2,762,2,762,0.0,381.0,381.0,0,0,0.0,0.0,0.0
0.0,17,1,55,1,55,0.0,55.0,55.0,0,0,0.0,0.0,0.0
335.0,17,2,166,1,75,0.0,75.0,75.0,1,91,0.0,91.0,91.0
1284013.0,17,7,490,7,490,214002.16666666663,70.0,70.0,0,0,0.0,0.0,0.0
143868.0,17,2,180,1,90,0.0,90.0,90.0,1,90,0.0,90.0,90.0
98177642.0,17,14,1388,7,694,16336449.833333334,174.0,99.14285714285714,7,694,16336452.166666666,174.0,99.14285714285714
1309107.0,6,4,264,2,132,0.0,66.0,66.0,2,132,0.0,66.0,66.0
90040130.0,17,28,13364,28,13364,3334819.6296296297,501.0,477.2857142857143,0,0,0.0,0.0,0.0
90050883.0,17,27,12943,27,12943,3463495.5,501.0,479.3703703703704,0,0,0.0,0.0,0.0
144035.0,17,2,180,1,90,0.0,90.0,90.0,1,90,0.0,90.0,90.0
35702.0,6,14,4740,7,653,5830.0,249.0,93.28571428571428,7,4087,5765.166666666667,1514.0,583.8571428571429
92324042.0,17,15,5130,15,5130,6594574.428571428,342.0,342.0,0,0,0.0,0.0,0.0
1314531.0,6,4,264,2,132,0.0,66.0,66.0,2,132,0.0,66.0,66.0
305914.0,6,3,202,2,128,0.0,74.0,64.0,1,74,0.0,74.0,74.0
494037.0,6,4,270,2,134,0.0,68.0,67.0,2,136,0.0,70.0,68.0
304.0,17,2,164,1,82,0.0,82.0,82.0,1,82,0.0,82.0,82.0
111597128.0,6,44,2904,22,1452,5314148.952380952,66.0,66.0,22,1452,5298328.047619048,66.0,66.0
829128.0,6,2,132,1,66,0.0,66.0,66.0,1,66,0.0,66.0,66.0
33432.0,6,14,4740,7,653,5446.666666666667,249.0,93.28571428571428,7,4087,5212.666666666667,1514.0,583.8571428571429
69464.0,17,2,604,1,75,0.0,75.0,75.0,1,529,0.0,529.0,529.0
367161.0,17,2,363,1,75,0.0,75.0,75.0,1,288,0.0,288.0,288.0
89548.0,6,14,4740,7,653,14697.0,249.0,93.28571428571428,7,4087,14147.5,1514.0,583.8571428571429
153430.0,17,2,180,1,90,0.0,90.0,90.0,1,90,0.0,90.0,90.0
2669410.0,6,3,1604,1,753,0.0,753.0,753.0,2,851,0.0,785.0,425.5
1637096.0,17,6,1230,3,234,818364.5,78.0,78.0,3,996,818339.5,332.0,332.0
326336.0,6,5,367,3,235,163168.0,103.0,78.33333333333333,2,132,0.0,66.0,66.0
29793.0,6,14,4740,7,653,4632.166666666667,249.0,93.28571428571428,7,4087,4691.833333333333,1514.0,583.8571428571429
20368.0,6,14,4740,7,653,3132.833333333333,249.0,93.28571428571428,7,4087,3226.1666666666665,1514.0,583.8571428571429
2588073.0,6,2,132,1,66,0.0,66.0,66.0,1,66,0.0,66.0,66.0
1302481.0,6,4,264,2,132,0.0,66.0,66.0,2,132,0.0,66.0,66.0
5626359.0,6,5,336,2,134,0.0,68.0,67.0,3,202,1526749.0,70.0,67.33333333333333
121388.0,6,3,337,2,214,0.0,160.0,107.0,1,123,0.0,123.0,123.0
123250606.0,6,49,3234,25,1650,5135441.916666667,66.0,66.0,24,1584,5119451.521739131,66.0,66.0
502273.0,6,5,336,2,134,0.0,68.0,67.0,3,202,191473.0,70.0,67.33333333333333
135134404.0,17,6,1146,6,1146,27026880.8,191.0,191.0,0,0,0.0,0.0,0.0
302748.0,6,6,412,4,272,100916.0,74.0,68.0,2,140,0.0,74.0,70.0
107829954.0,6,28,1860,14,966,8278848.153846154,123.0,69.0,14,894,8278881.615384615,123.0,63.85714285714285
213265.0,17,2,414,1,88,0.0,88.0,88.0,1,326,0.0,326.0,326.0
143926.0,17,2,180,1,90,0.0,90.0,90.0,1,90,0.0,90.0,90.0
239608.0,6,3,337,2,214,0.0,160.0,107.0,1,123,0.0,123.0,123.0
90253227.0,6,13,2036,8,1016,12893318.142857144,188.0,127.0,5,1020,22523031.25,204.0,204.0
207255.0,6,3,426,2,280,0.0,214.0,140.0,1,146,0.0,146.0,146.0
363520.0,6,11,1021,6,444,48861.0,162.0,74.0,5,577,60999.25,349.0,115.4
248050.0,6,3,337,2,214,0.0,160.0,107.0,1,123,0.0,123.0,123.0
90001732.0,6,16,1192,9,691,11250216.5,95.0,76.77777777777777,7,501,14950586.833333334,95.0,71.57142857142857
14636637.0,6,20,1607,10,975,1592781.2222222222,315.0,97.5,10,632,1592698.4444444445,78.0,63.2
102855077.0,6,192,21776,96,6558,1074131.4421052632,140.0,68.3125,96,15218,1079942.452631579,284.0,158.52083333333334
90260285.0,6,12,1832,8,1016,12894326.42857143,188.0,127.0,4,816,30031427.33333333,204.0,204.0
108107505.0,17,5,1005,5,1005,27026876.25,201.0,201.0,0,0,0.0,0.0,0.0
299713.0,6,6,412,4,272,99904.33333333331,74.0,68.0,2,140,0.0,74.0,70.0
120039442.0,6,23,1862,12,894,10908692.272727272,95.0,74.5,11,968,11980564.2,223.0,88.0
26140.0,6,14,4740,7,653,4237.5,249.0,93.28571428571428,7,4087,4157.833333333333,1514.0,583.8571428571429
298745.0,17,2,238,1,74,0.0,74.0,74.0,1,164,0.0,164.0,164.0
90361594.0,6,12,1848,7,828,15060265.666666666,188.0,118.28571428571428,5,1020,15082817.25,204.0,204.0
212461.0,6,3,426,2,280,0.0,214.0,140.0,1,146,0.0,146.0,146.0
91079933.0,6,26,1746,13,906,7572006.25,123.0,69.6923076923077,13,840,7572002.75,123.0,64.61538461538461
308131.0,6,6,412,4,272,102710.33333333331,74.0,68.0,2,140,0.0,74.0,70.0
56079.0,6,14,4740,7,653,9173.0,249.0,93.28571428571428,7,4087,8861.5,1514.0,583.8571428571429
3009865.0,6,11,2106,6,598,601696.0,252.0,99.66666666666669,5,1508,1996.75,1236.0,301.6
154802.0,6,10,1066,5,490,38237.5,218.0,98.0,5,576,38452.25,304.0,115.2
90218189.0,6,16,1192,8,596,12852579.142857144,95.0,74.5,8,596,12857556.714285716,95.0,74.5
232342.0,6,3,337,2,214,0.0,160.0,107.0,1,123,0.0,123.0,123.0
10520075.0,6,7,478,4,272,3461289.6666666665,74.0,68.0,3,206,5191791.0,74.0,68.66666666666667
302379.0,6,2,132,1,66,0.0,66.0,66.0,1,66,0.0,66.0,66.0
303627.0,6,2,132,1,66,0.0,66.0,66.0,1,66,0.0,66.0,66.0
90527788.0,6,13,2036,8,1016,12932541.142857144,188.0,127.0,5,1020,22591497.25,204.0,204.0
26803382.0,17,5,1710,5,1710,6700845.5,342.0,342.0,0,0,0.0,0.0,0.0
236025.0,6,10,1221,6,636,47205.0,298.0,106.0,4,585,77784.66666666667,379.0,146.25
30797.0,6,14,4740,7,653,3990.3333333333335,249.0,93.28571428571428,7,4087,4909.5,1514.0,583.8571428571429
302495.0,6,2,132,1,66,0.0,66.0,66.0,1,66,0.0,66.0,66.0
207291.0,6,3,426,2,280,0.0,214.0,140.0,1,146,0.0,146.0,146.0
205052.0,17,2,762,2,762,0.0,381.0,381.0,0,0,0.0,0.0,0.0
62806224.0,17,11,3770,10,3420,4574296.444444444,342.0,342.0,1,350,0.0,350.0,350.0
146022.0,6,3,337,2,214,0.0,160.0,107.0,1,123,0.0,123.0,123.0
2195730.0,6,19,6869,10,1501,243970.0,408.0,150.1,9,5368,230820.0,1514.0,596.4444444444445
218018.0,6,3,426,2,280,0.0,214.0,140.0,1,146,0.0,146.0,146.0
4275.0,17,4,571,2,148,0.0,74.0,74.0,2,423,0.0,280.0,211.5
116367950.0,6,48,3168,24,1584,5059476.0869565215,66.0,66.0,24,1584,5047628.608695652,66.0,66.0
33912.0,6,14,4740,7,653,4435.0,249.0,93.28571428571428,7,4087,5429.166666666667,1514.0,583.8571428571429
298999.0,6,6,412,4,272,99666.33333333331,74.0,68.0,2,140,0.0,74.0,70.0
90525927.0,6,13,2036,8,1016,12932275.285714284,188.0,127.0,5,1020,22591298.5,204.0,204.0
36339.0,6,14,4740,7,653,4031.8333333333335,249.0,93.28571428571428,7,4087,5917.166666666667,1514.0,583.8571428571429
474181.0,6,3,1604,2,851,0.0,785.0,425.5,1,753,0.0,753.0,753.0
199255.0,17,4,6056,4,6056,66418.33333333333,1514.0,1514.0,0,0,0.0,0.0,0.0
108105493.0,17,5,1005,5,1005,27026373.25,201.0,201.0,0,0,0.0,0.0,0.0
39373.0,6,14,4740,7,653,6186.833333333333,249.0,93.28571428571428,7,4087,6039.0,1514.0,583.8571428571429
104000967.0,17,13,1083,7,563,17333494.5,174.0,80.42857142857143,6,520,16797303.8,174.0,86.66666666666667
298009.0,6,6,412,4,272,99336.33333333331,74.0,68.0,2,140,0.0,74.0,70.0
104598124.0,17,14,864,7,432,17334678.333333332,174.0,61.71428571428572,7,432,17333501.666666668,174.0,61.71428571428572
94026376.0,17,12,778,6,389,18600423.8,174.0,64.83333333333333,6,389,18600162.0,174.0,64.83333333333333
2212.0,17,4,344,2,150,0.0,75.0,75.0,2,194,0.0,103.0,97.0
21845231.0,6,6,1981,4,1087,7281743.666666667,885.0,271.75,2,894,0.0,826.0,447.0
297969.0,6,6,412,4,272,99323.0,74.0,68.0,2,140,0.0,74.0,70.0
143937.0,17,2,180,1,90,0.0,90.0,90.0,1,90,0.0,90.0,90.0
208857.0,17,2,762,2,762,0.0,381.0,381.0,0,0,0.0,0.0,0.0
0.0,6,1,66,1,66,0.0,66.0,66.0,0,0,0.0,0.0,0.0
6881.0,17,2,447,1,84,0.0,84.0,84.0,1,363,0.0,363.0,363.0
250424.0,6,10,1221,6,636,50084.8,298.0,106.0,4,585,77969.0,379.0,146.25
29735.0,6,10,2032,5,524,7234.5,252.0,104.8,5,1508,6352.0,1236.0,301.6
207393.0,6,3,426,2,280,0.0,214.0,140.0,1,146,0.0,146.0,146.0
6745.0,17,2,582,1,83,0.0,83.0,83.0,1,499,0.0,499.0,499.0
72171085.0,6,9,842,9,842,9021385.625,97.0,93.55555555555556,0,0,0.0,0.0,0.0
1321414.0,6,4,264,2,132,0.0,66.0,66.0,2,132,0.0,66.0,66.0
37865.0,6,14,4740,7,653,6152.666666666667,249.0,93.28571428571428,7,4087,6153.833333333333,1514.0,583.8571428571429
2589722.0,6,2,132,1,66,0.0,66.0,66.0,1,66,0.0,66.0,66.0
14982.0,6,11,2098,6,590,2547.6,252.0,98.33333333333331,5,1508,3475.75,1236.0,301.6
108103963.0,17,5,1005,5,1005,27025990.75,201.0,201.0,0,0,0.0,0.0,0.0
2488.0,17,4,344,2,150,0.0,75.0,75.0,2,194,0.0,103.0,97.0
108088578.0,17,5,955,5,955,27022144.5,191.0,191.0,0,0,0.0,0.0,0.0
87731.0,6,14,4740,7,653,10475.166666666666,249.0,93.28571428571428,7,4087,14117.333333333334,1514.0,583.8571428571429
2884.0,17,2,180,1,90,0.0,90.0,90.0,1,90,0.0,90.0,90.0
10090.0,17,2,498,1,80,0.0,80.0,80.0,1,418,0.0,418.0,418.0
109428.0,17,2,286,2,286,0.0,143.0,143.0,0,0,0.0,0.0,0.0
162898.0,6,2,128,1,74,0.0,74.0,74.0,1,54,0.0,54.0,54.0
91834352.0,6,27,2073,15,1179,6559133.857142857,95.0,78.6,12,894,8323497.181818182,95.0,74.5
90037349.0,17,28,13364,28,13364,3334716.6296296297,501.0,477.2857142857143,0,0,0.0,0.0,0.0
320065.0,17,4,1400,4,1400,106688.33333333331,350.0,350.0,0,0,0.0,0.0,0.0
57250.0,6,14,4740,7,653,9420.666666666666,249.0,93.28571428571428,7,4087,8246.666666666666,1514.0,583.8571428571429
104871365.0,6,20,1546,10,842,11629635.444444444,155.0,84.2,10,704,11629647.0,95.0,70.4
90309459.0,6,16,1192,8,596,12894308.142857144,95.0,74.5,8,596,12899418.714285716,95.0,74.5
40855.0,6,11,2098,6,590,7838.2,252.0,98.33333333333331,5,1508,9524.0,1236.0,301.6
135136400.0,17,6,1146,6,1146,27027280.0,191.0,191.0,0,0,0.0,0.0,0.0
2592169.0,6,2,132,1,66,0.0,66.0,66.0,1,66,0.0,66.0,66.0
90740135.0,6,21,1713,11,799,9069385.8,95.0,72.63636363636364,10,914,10080808.111111112,223.0,91.4
120001292.0,6,20,1531,11,840,12000129.2,95.0,76.36363636363636,9,691,11284527.25,95.0,76.77777777777777
715540.0,6,2,132,1,66,0.0,66.0,66.0,1,66,0.0,66.0,66.0
3014336.0,6,11,2106,6,598,602216.2,252.0,99.66666666666669,5,1508,4006.5,1236.0,301.6
272.0,17,2,700,2,700,0.0,350.0,350.0,0,0,0.0,0.0,0.0
120000125.0,6,23,1775,13,1030,10000010.416666666,95.0,79.23076923076923,10,745,9999857.0,95.0,74.5
490284.0,6,5,336,2,134,0.0,68.0,67.0,3,202,193071.0,70.0,67.33333333333333
30802.0,6,12,1393,6,796,6023.4,271.0,132.66666666666666,6,597,5957.2,259.0,99.5
177370.0,17,2,180,1,90,0.0,90.0,90.0,1,90,0.0,90.0,90.0
90254086.0,6,13,2036,8,1016,12893440.857142856,188.0,127.0,5,1020,22522992.5,204.0,204.0
119006325.0,17,15,1169,8,606,17000903.57142857,174.0,75.75,7,563,16500138.0,174.0,80.42857142857143
533.0,17,2,508,2,508,0.0,257.0,254.0,0,0,0.0,0.0,0.0
41677.0,6,14,4740,7,653,6487.0,249.0,93.28571428571428,7,4087,5066.666666666667,1514.0,583.8571428571429
119366567.0,17,35,16705,35,16705,3510781.382352941,501.0,477.2857142857143,0,0,0.0,0.0,0.0
307889.0,6,6,412,4,272,102629.66666666669,74.0,68.0,2,140,0.0,74.0,70.0
2029.0,17,4,344,2,150,0.0,75.0,75.0,2,194,0.0,103.0,97.0
232959.0,6,3,337,2,214,0.0,160.0,107.0,1,123,0.0,123.0,123.0
105247791.0,6,43,2838,22,1452,5011787.952380952,66.0,66.0,21,1386,5159999.3,66.0,66.0
20374.0,6,20,7606,11,978,2037.4,310.0,88.9090909090909,9,6628,2150.5,1514.0,736.4444444444445
27113889.0,17,5,1710,5,1710,6778472.25,342.0,342.0,0,0,0.0,0.0,0.0
153241.0,6,2,132,1,66,0.0,66.0,66.0,1,66,0.0,66.0,66.0
4646.0,17,2,582,1,83,0.0,83.0,83.0,1,499,0.0,499.0,499.0
107513.0,17,2,286,2,286,0.0,143.0,143.0,0,0,0.0,0.0,0.0
869420.0,6,9,1267,6,796,173884.0,458.0,132.66666666666666,3,471,296867.5,331.0,157.0
120101518.0,6,218,24640,109,7416,1104450.5462962964,140.0,68.03669724770643,109,17224,1105662.111111111,284.0,158.0183486238532
19349.0,6,14,4740,7,653,3069.1666666666665,249.0,93.28571428571428,7,4087,3056.0,1514.0,583.8571428571429
120116385.0,6,12,1832,8,1016,17136195.85714286,188.0,127.0,4,816,30029096.666666668,204.0,204.0
40385.0,6,13,1386,7,789,6674.666666666667,253.0,112.71428571428572,6,597,7123.8,259.0,99.5
205787.0,17,2,180,1,90,0.0,90.0,90.0,1,90,0.0,90.0,90.0
109297255.0,17,14,864,7,432,18167606.5,174.0,61.71428571428572,7,432,18166841.0,174.0,61.71428571428572
120026.0,17,4,1400,4,1400,40008.66666666666,350.0,350.0,0,0,0.0,0.0,0.0
103833.0,17,2,286,2,286,0.0,143.0,143.0,0,0,0.0,0.0,0.0
298817.0,6,6,412,4,272,99605.66666666669,74.0,68.0,2,140,0.0,74.0,70.0
106169602.0,17,14,864,7,432,17667476.333333332,174.0,61.71428571428572,7,432,17666775.166666668,174.0,61.71428571428572
1055493.0,6,3,1604,2,851,0.0,785.0,425.5,1,753,0.0,753.0,753.0
0.0,17,1,55,1,55,0.0,55.0,55.0,0,0,0.0,0.0,0.0
90623104.0,6,189,22148,95,15722,964075.5744680852,284.0,165.49473684210523,94,6426,971984.0322580644,140.0,68.36170212765957
3012924.0,6,12,2172,7,664,502154.0,252.0,94.85714285714286,5,1508,2360.0,1236.0,301.6
244451.0,6,3,337,2,214,0.0,160.0,107.0,1,123,0.0,123.0,123.0
39214.0,6,10,2032,5,524,9567.0,252.0,104.8,5,1508,9241.0,1236.0,301.6
96084992.0,6,19,1756,10,1106,10674722.777777778,255.0,110.6,9,650,12010245.0,95.0,72.22222222222223
301667.0,6,6,412,4,272,100555.66666666669,74.0,68.0,2,140,0.0,74.0,70.0
1035450.0,6,11,1134,6,558,207090.0,220.0,93.0,5,576,257573.5,304.0,115.2
239850.0,6,3,337,2,214,0.0,160.0,107.0,1,123,0.0,123.0,123.0
1995.0,17,4,344,2,150,0.0,75.0,75.0,2,194,0.0,103.0,97.0
137465896.0,17,14,864,7,432,19667518.5,174.0,61.71428571428572,7,432,19666859.83333333,174.0,61.71428571428572
107376.0,17,2,286,2,286,0.0,143.0,143.0,0,0,0.0,0.0,0.0
388.0,17,2,174,1,79,0.0,79.0,79.0,1,95,0.0,95.0,95.0
196911.0,17,2,180,1,90,0.0,90.0,90.0,1,90,0.0,90.0,90.0
46687.0,6,13,1394,7,797,7781.166666666667,253.0,113.85714285714286,6,597,8369.8,259.0,99.5
120858945.0,6,31,2182,15,1017,7919512.785714285,123.0,67.8,16,1165,7397065.533333333,139.0,72.8125
270419.0,17,2,582,1,83,0.0,83.0,83.0,1,499,0.0,499.0,499.0
1298593.0,6,4,264,2,132,0.0,66.0,66.0,2,132,0.0,66.0,66.0
6974.0,17,2,582,1,83,0.0,83.0,83.0,1,499,0.0,499.0,499.0
108096868.0,6,386,62530,193,49422,561875.2239583334,1514.0,256.07253886010363,193,13108,561877.8802083334,214.0,67.91709844559585
821.0,17,4,438,2,148,0.0,74.0,74.0,2,290,0.0,147.0,145.0
355.0,17,2,267,1,83,0.0,83.0,83.0,1,184,0.0,184.0,184.0
153470.0,17,2,180,1,90,0.0,90.0,90.0,1,90,0.0,90.0,90.0
815.0,17,5,550,5,550,203.75,110.0,110.0,0,0,0.0,0.0,0.0
135134724.0,17,6,1206,6,1206,27026944.8,201.0,201.0,0,0,0.0,0.0,0.0
113536302.0,6,47,3102,24,1584,4936346.956521739,66.0,66.0,23,1518,5160728.545454546,66.0,66.0
36391.0,6,14,4740,7,653,5647.333333333333,249.0,93.28571428571428,7,4087,5933.0,1514.0,583.8571428571429
120055609.0,17,28,13364,28,13364,4446504.037037037,501.0,477.2857142857143,0,0,0.0,0.0,0.0
33188.0,6,10,2032,5,524,6553.5,252.0,104.8,5,1508,8035.25,1236.0,301.6
108108910.0,17,5,1005,5,1005,27027227.5,201.0,201.0,0,0,0.0,0.0,0.0
622.0,17,2,508,2,508,0.0,257.0,254.0,0,0,0.0,0.0,0.0
9642.0,17,2,582,1,83,0.0,83.0,83.0,1,499,0.0,499.0,499.0
90053329.0,17,27,12943,27,12943,3463589.576923077,501.0,479.3703703703704,0,0,0.0,0.0,0.0
182389.0,6,11,1132,6,556,34017.6,218.0,92.66666666666669,5,576,44520.5,304.0,115.2
90759573.0,6,22,1680,12,935,8246762.545454546,95.0,77.91666666666667,10,745,10052078.0,95.0,74.5
69630.0,17,2,620,1,75,0.0,75.0,75.0,1,545,0.0,545.0,545.0
88895.0,6,10,2032,5,524,21232.5,252.0,104.8,5,1508,21050.25,1236.0,301.6
146095.0,6,3,337,2,214,0.0,160.0,107.0,1,123,0.0,123.0,123.0
47505584.0,6,8,2113,3,960,22363959.5,826.0,320.0,5,1153,11258174.25,885.0,230.6
90092893.0,6,11,1644,7,828,15015482.166666666,188.0,118.28571428571428,4,816,20020182.666666668,204.0,204.0
116436033.0,6,221,25068,111,7560,1058509.3909090909,140.0,68.10810810810811,110,17508,1059896.1559633028,284.0,159.16363636363636
40203.0,6,10,2032,5,524,7604.0,252.0,104.8,5,1508,8427.5,1236.0,301.6
1284338.0,17,7,490,7,490,214056.3333333333,70.0,70.0,0,0,0.0,0.0,0.0
303.0,17,2,168,1,76,0.0,76.0,76.0,1,92,0.0,92.0,92.0
113411313.0,6,32,2220,16,1149,7546364.933333334,123.0,71.8125,16,1071,7546362.0,123.0,66.9375
310394.0,6,6,412,4,272,103464.66666666669,74.0,68.0,2,140,0.0,74.0,70.0
24444.0,6,10,2032,5,524,5826.25,252.0,104.8,5,1508,4560.25,1236.0,301.6
312034.0,17,4,1400,4,1400,104011.33333333331,350.0,350.0,0,0,0.0,0.0,0.0
90036939.0,17,28,13364,28,13364,3334701.4444444445,501.0,477.2857142857143,0,0,0.0,0.0,0.0
57901.0,6,14,4740,7,653,9345.666666666666,249.0,93.28571428571428,7,4087,9128.5,1514.0,583.8571428571429
388012.0,6,3,204,1,68,0.0,68.0,68.0,2,136,0.0,70.0,68.0
28156.0,6,14,4740,7,653,4537.166666666667,249.0,93.28571428571428,7,4087,4554.5,1514.0,583.8571428571429
18295.0,6,10,2032,5,524,4345.75,252.0,104.8,5,1508,4204.25,1236.0,301.6
45053695.0,17,9,3086,8,2736,5108667.571428572,342.0,342.0,1,350,0.0,350.0,350.0
45160.0,6,14,4740,7,653,7341.333333333333,249.0,93.28571428571428,7,4087,7384.166666666667,1514.0,583.8571428571429
31062.0,6,14,4740,7,653,4842.166666666667,249.0,93.28571428571428,7,4087,2550.833333333333,1514.0,583.8571428571429
120666.0,6,3,337,2,214,0.0,160.0,107.0,1,123,0.0,123.0,123.0
90052795.0,17,28,13364,28,13364,3335288.703703704,501.0,477.2857142857143,0,0,0.0,0.0,0.0
2062.0,17,4,344,2,150,0.0,75.0,75.0,2,194,0.0,103.0,97.0
1306960.0,6,4,264,2,132,0.0,66.0,66.0,2,132,0.0,66.0,66.0
55464.0,6,14,4740,7,653,9117.166666666666,249.0,93.28571428571428,7,4087,8343.5,1514.0,583.8571428571429
120122711.0,6,13,2036,5,1020,30030677.75,204.0,204.0,8,1016,17136959.57142857,188.0,127.0
107323810.0,6,43,2838,22,1452,5110642.666666667,66.0,66.0,21,1386,5112001.1,66.0,66.0
43542.0,6,11,2098,6,590,8708.4,252.0,98.33333333333331,5,1508,8417.25,1236.0,301.6
122090258.0,17,15,1300,8,737,17441465.42857143,174.0,92.125,7,563,19513004.0,174.0,80.42857142857143
115273295.0,6,203,22898,102,15936,1141319.7524752475,284.0,156.23529411764707,101,6962,1142294.08,140.0,68.93069306930693
1163025.0,6,13,3010,8,2382,166146.42857142858,1514.0,297.75,5,628,222619.5,331.0,125.6
3268.0,17,2,359,1,75,0.0,75.0,75.0,1,284,0.0,284.0,284.0
304738.0,17,4,704,2,148,0.0,74.0,74.0,2,556,0.0,280.0,278.0
162392.0,17,2,180,1,90,0.0,90.0,90.0,1,90,0.0,90.0,90.0
282271.0,17,2,363,1,79,0.0,79.0,79.0,1,284,0.0,284.0,284.0
146195.0,6,3,337,2,214,0.0,160.0,107.0,1,123,0.0,123.0,123.0
308181.0,6,6,412,4,272,102727.0,74.0,68.0,2,140,0.0,74.0,70.0
108105251.0,17,5,1005,5,1005,27026312.75,201.0,201.0,0,0,0.0,0.0,0.0
232280.0,6,3,337,2,214,0.0,160.0,107.0,1,123,0.0,123.0,123.0
105232660.0,6,29,2052,15,1089,7501189.428571428,123.0,72.6,14,963,8078201.076923077,123.0,68.78571428571429
46880.0,6,14,4740,7,653,6502.333333333333,249.0,93.28571428571428,7,4087,7684.5,1514.0,583.8571428571429
216651.0,17,2,180,1,90,0.0,90.0,90.0,1,90,0.0,90.0,90.0
155925.0,6,3,337,2,214,0.0,160.0,107.0,1,123,0.0,123.0,123.0
118001015.0,17,13,821,7,432,19666835.83333333,174.0,61.71428571428572,6,389,19601116.2,174.0,64.83333333333333
9394.0,17,2,582,1,83,0.0,83.0,83.0,1,499,0.0,499.0,499.0
90014816.0,6,14,1043,7,542,15002469.333333334,95.0,77.42857142857143,7,501,14952979.5,95.0,71.57142857142857
47217.0,6,12,1413,7,882,7869.5,291.0,126.0,5,531,10475.25,259.0,106.2
111179.0,17,4,1400,4,1400,37059.66666666666,350.0,350.0,0,0,0.0,0.0,0.0
108111182.0,17,5,1005,5,1005,27027795.5,201.0,201.0,0,0,0.0,0.0,0.0
2379.0,17,4,344,2,150,0.0,75.0,75.0,2,194,0.0,103.0,97.0
0.0,6,1,66,1,66,0.0,66.0,66.0,0,0,0.0,0.0,0.0
36198.0,6,10,2032,5,524,8175.0,252.0,104.8,5,1508,8717.25,1236.0,301.6
20122.0,6,11,1131,6,600,3758.8,262.0,100.0,5,531,4693.25,259.0,106.2
209533.0,17,2,180,1,90,0.0,90.0,90.0,1,90,0.0,90.0,90.0
847.0,17,2,684,2,684,0.0,342.0,342.0,0,0,0.0,0.0,0.0
4542.0,17,2,626,1,72,0.0,72.0,72.0,1,554,0.0,554.0,554.0
2442296.0,6,3,1777,2,951,0.0,885.0,475.5,1,826,0.0,826.0,826.0
196166.0,6,12,1354,6,723,38832.2,253.0,120.5,6,631,38224.8,293.0,105.16666666666669
1261.0,17,2,508,2,508,0.0,257.0,254.0,0,0,0.0,0.0,0.0
103851.0,17,2,286,2,286,0.0,143.0,143.0,0,0,0.0,0.0,0.0
20911.0,6,10,1065,5,534,5045.0,262.0,106.8,5,531,4671.0,259.0,106.2
2593.0,17,2,762,2,762,0.0,381.0,381.0,0,0,0.0,0.0,0.0
90052835.0,17,28,13364,28,13364,3335290.185185185,501.0,477.2857142857143,0,0,0.0,0.0,0.0
257538.0,6,10,1221,6,636,51507.6,298.0,106.0,4,585,79945.0,379.0,146.25
324403.0,17,4,1400,4,1400,108134.33333333331,350.0,350.0,0,0,0.0,0.0,0.0
156261.0,6,3,337,2,214,0.0,160.0,107.0,1,123,0.0,123.0,123.0
90256876.0,6,12,1832,8,1016,12893839.42857143,188.0,127.0,4,816,30031194.666666668,204.0,204.0
93049306.0,6,178,20110,89,14088,1054932.7840909092,284.0,158.2921348314607,89,6022,1054932.8522727273,140.0,67.66292134831461
12560.0,6,11,1133,6,602,2057.8,264.0,100.33333333333331,5,531,2770.5,259.0,106.2
90347437.0,17,12,778,6,389,18000511.8,174.0,64.83333333333333,6,389,18000174.2,174.0,64.83333333333333
100815592.0,6,28,1860,14,966,7738436.923076923,123.0,69.0,14,894,7738413.230769231,123.0,63.85714285714285
96348717.0,17,14,1126,7,563,16002066.5,174.0,80.42857142857143,7,563,16000143.833333334,174.0,80.42857142857143
153481.0,17,2,180,1,90,0.0,90.0,90.0,1,90,0.0,90.0,90.0
0.0,6,1,66,1,66,0.0,66.0,66.0,0,0,0.0,0.0,0.0
207742.0,17,2,762,2,762,0.0,381.0,381.0,0,0,0.0,0.0,0.0
1024567.0,6,11,1134,6,558,204913.4,220.0,93.0,5,576,255412.0,304.0,115.2
121824.0,6,3,337,2,214,0.0,160.0,107.0,1,123,0.0,123.0,123.0
94800669.0,6,177,20044,89,14014,1077280.3295454546,284.0,157.46067415730337,88,6030,1077814.183908046,140.0,68.52272727272727
153456.0,17,2,180,1,90,0.0,90.0,90.0,1,90,0.0,90.0,90.0
114269158.0,6,32,2236,16,1165,7617943.866666666,139.0,72.8125,16,1071,7604284.066666666,123.0,66.9375
49889.0,6,14,4740,7,653,8181.333333333333,249.0,93.28571428571428,7,4087,6305.833333333333,1514.0,583.8571428571429
197715.0,17,2,180,1,90,0.0,90.0,90.0,1,90,0.0,90.0,90.0
120148018.0,6,246,27754,123,8414,969647.631147541,140.0,68.40650406504065,123,19340,979833.6229508196,284.0,157.2357723577236
17921.0,6,14,4740,7,653,2575.1666666666665,249.0,93.28571428571428,7,4087,2848.0,1514.0,583.8571428571429
24025818.0,17,3,1026,3,1026,12012909.0,342.0,342.0,0,0,0.0,0.0,0.0
91919083.0,6,27,2073,15,1138,6565041.714285715,95.0,75.86666666666666,12,935,8355729.636363637,95.0,77.91666666666667
22454677.0,17,4,1376,3,1026,472244.0,342.0,342.0,1,350,0.0,350.0,350.0
107800.0,17,2,286,2,286,0.0,143.0,143.0,0,0,0.0,0.0,0.0
302239.0,6,6,412,4,272,100746.33333333331,74.0,68.0,2,140,0.0,74.0,70.0
206432.0,17,2,180,1,90,0.0,90.0,90.0,1,90,0.0,90.0,90.0
350008.0,6,10,1221,6,636,70001.6,298.0,106.0,4,585,93907.33333333331,379.0,146.25
108599.0,17,2,286,2,286,0.0,143.0,143.0,0,0,0.0,0.0,0.0
122314527.0,6,48,3168,24,1584,5052066.217391305,66.0,66.0,24,1584,5155685.217391305,66.0,66.0
2332.0,17,4,344,2,150,0.0,75.0,75.0,2,194,0.0,103.0,97.0
128694403.0,6,36,2596,18,1248,6982858.588235294,123.0,69.33333333333333,18,1348,6982856.352941177,139.0,74.88888888888889
108122544.0,17,5,1005,5,1005,27030636.0,201.0,201.0,0,0,0.0,0.0,0.0
2341.0,17,4,344,2,150,0.0,75.0,75.0,2,194,0.0,103.0,97.0
210133.0,6,12,1373,7,714,35022.166666666664,298.0,102.0,5,659,51830.75,379.0,131.8
148147.0,17,2,180,1,90,0.0,90.0,90.0,1,90,0.0,90.0,90.0
2347.0,17,4,344,2,150,0.0,75.0,75.0,2,194,0.0,103.0,97.0
135118720.0,17,6,1206,6,1206,27023744.0,201.0,201.0,0,0,0.0,0.0,0.0
153483.0,17,2,180,1,90,0.0,90.0,90.0,1,90,0.0,90.0,90.0
99212890.0,6,49,4552,29,2575,3543317.5,139.0,88.79310344827586,20,1977,5210344.684210527,123.0,98.85
108905.0,17,2,286,2,286,0.0,143.0,143.0,0,0,0.0,0.0,0.0
246885.0,17,4,6056,4,6056,82295.0,1514.0,1514.0,0,0,0.0,0.0,0.0
151872.0,17,2,180,1,90,0.0,90.0,90.0,1,90,0.0,90.0,90.0
108115361.0,17,5,955,5,955,27028840.25,191.0,191.0,0,0,0.0,0.0,0.0
216637.0,6,3,426,2,280,0.0,214.0,140.0,1,146,0.0,146.0,146.0
13378060.0,6,18,1495,9,921,1634285.375,315.0,102.33333333333331,9,574,1634250.75,78.0,63.77777777777778
299861.0,6,6,412,4,272,99953.66666666669,74.0,68.0,2,140,0.0,74.0,70.0
14975.0,17,2,180,1,90,0.0,90.0,90.0,1,90,0.0,90.0,90.0
146318.0,6,3,337,2,214,0.0,160.0,107.0,1,123,0.0,123.0,123.0
123839974.0,6,49,3234,25,1650,5159998.916666667,66.0,66.0,24,1584,4995713.565217392,66.0,66.0
119436056.0,6,32,2220,16,1071,7962403.733333333,123.0,66.9375,16,1149,7282315.533333333,123.0,71.8125
90490316.0,6,19,1436,10,786,10050009.777777778,95.0,78.6,9,650,11305088.5,95.0,72.22222222222223
514734.0,6,3,204,2,136,0.0,70.0,68.0,1,68,0.0,68.0,68.0
246687.0,6,3,337,2,214,0.0,160.0,107.0,1,123,0.0,123.0,123.0
108099258.0,17,5,1005,5,1005,27024814.5,201.0,201.0,0,0,0.0,0.0,0.0
354.0,17,2,160,1,80,0.0,80.0,80.0,1,80,0.0,80.0,80.0
90247975.0,17,12,778,6,389,18000714.0,174.0,64.83333333333333,6,389,18000166.6,174.0,64.83333333333333
13205.0,6,13,1459,7,862,2053.833333333333,271.0,123.14285714285714,6,597,2384.0,259.0,99.5
35505.0,6,10,2032,5,524,8509.75,252.0,104.8,5,1508,8603.75,1236.0,301.6
241460.0,6,3,426,2,280,0.0,214.0,140.0,1,146,0.0,146.0,146.0
3953.0,17,4,438,2,148,0.0,74.0,74.0,2,290,0.0,147.0,145.0
108242.0,17,2,286,2,286,0.0,143.0,143.0,0,0,0.0,0.0,0.0
159098.0,6,3,337,2,214,0.0,160.0,107.0,1,123,0.0,123.0,123.0
110974610.0,6,32,2236,16,1165,7383925.0,139.0,72.8125,16,1071,7383928.2,123.0,66.9375
255972.0,17,4,6056,4,6056,85324.00000000001,1514.0,1514.0,0,0,0.0,0.0,0.0
210484.0,6,10,1221,6,636,42096.8,298.0,106.0,4,585,69098.66666666667,379.0,146.25
50215.0,6,10,2032,5,524,11729.75,252.0,104.8,5,1508,10518.5,1236.0,301.6
90022132.0,17,27,12943,27,12943,3462389.6923076925,501.0,479.3703703703704,0,0,0.0,0.0,0.0
29439.0,6,10,2032,5,524,7138.25,252.0,104.8,5,1508,6901.0,1236.0,301.6
90255996.0,6,13,2036,8,1016,12893713.714285716,188.0,127.0,5,1020,22523085.75,204.0,204.0
1307763.0,6,4,264,2,132,0.0,66.0,66.0,2,132,0.0,66.0,66.0
153926.0,17,2,180,1,90,0.0,90.0,90.0,1,90,0.0,90.0,90.0
13944379.0,6,20,1607,10,975,1514615.4444444445,315.0,97.5,10,632,1514640.4444444445,78.0,63.2
23581.0,6,10,2032,5,524,5125.5,252.0,104.8,5,1508,5598.75,1236.0,301.6
21539.0,6,11,1133,6,602,3832.0,264.0,100.33333333333331,5,531,4644.0,259.0,106.2
314167.0,17,4,1400,4,1400,104722.33333333331,350.0,350.0,0,0,0.0,0.0,0.0
2328.0,17,4,344,2,150,0.0,75.0,75.0,2,194,0.0,103.0,97.0
90252497.0,6,12,1832,8,1016,12893213.857142856,188.0,127.0,4,816,30030599.0,204.0,204.0
12590145.0,17,10,3500,10,3500,1398905.0,350.0,350.0,0,0,0.0,0.0,0.0
40035.0,6,14,4740,7,653,5858.833333333333,249.0,93.28571428571428,7,4087,6494.333333333333,1514.0,583.8571428571429
303648.0,6,2,132,1,66,0.0,66.0,66.0,1,66,0.0,66.0,66.0
299268.0,6,6,412,4,272,99756.0,74.0,68.0,2,140,0.0,74.0,70.0
207284.0,6,3,426,2,280,0.0,214.0,140.0,1,146,0.0,146.0,146.0
847.0,17,4,438,2,148,0.0,74.0,74.0,2,290,0.0,147.0,145.0
90271668.0,6,12,1832,8,1016,12895952.57142857,188.0,127.0,4,816,30036127.33333333,204.0,204.0
197121.0,17,2,180,1,90,0.0,90.0,90.0,1,90,0.0,90.0,90.0
41716.0,6,14,4740,7,653,6556.166666666667,249.0,93.28571428571428,7,4087,6369.333333333333,1514.0,583.8571428571429
67124.0,6,12,1413,7,882,11187.333333333334,291.0,126.0,5,531,11702.0,259.0,106.2
9934.0,17,2,539,1,86,0.0,86.0,86.0,1,453,0.0,453.0,453.0
4450.0,17,2,598,1,72,0.0,72.0,72.0,1,526,0.0,526.0,526.0
217670.0,6,3,426,2,280,0.0,214.0,140.0,1,146,0.0,146.0,146.0
42152.0,6,14,4740,7,653,6213.5,249.0,93.28571428571428,7,4087,6381.333333333333,1514.0,583.8571428571429
108103185.0,17,5,1005,5,1005,27025796.25,201.0,201.0,0,0,0.0,0.0,0.0
135126018.0,17,6,1146,6,1146,27025203.6,191.0,191.0,0,0,0.0,0.0,0.0
105678907.0,17,14,864,7,432,17500861.833333332,174.0,61.71428571428572,7,432,17500190.5,174.0,61.71428571428572
108108365.0,17,5,955,5,955,27027091.25,191.0,191.0,0,0,0.0,0.0,0.0
120107374.0,6,13,2036,8,1016,17135353.42857143,188.0,127.0,5,1020,22519533.75,204.0,204.0
6361380.0,6,9,1059,5,827,1538827.5,571.0,165.4,4,232,2052161.3333333333,62.0,58.0
90257343.0,6,13,2036,8,1016,12893906.142857144,188.0,127.0,5,1020,22517727.75,204.0,204.0
113176287.0,6,215,24156,108,7424,1057722.308411215,140.0,68.74074074074075,107,16732,1059037.1132075472,284.0,156.37383177570092
319663.0,6,6,412,4,272,106554.33333333331,74.0,68.0,2,140,0.0,74.0,70.0
498.0,17,2,508,2,508,0.0,257.0,254.0,0,0,0.0,0.0,0.0
67668.0,6,14,4740,7,653,11156.166666666666,249.0,93.28571428571428,7,4087,10894.5,1514.0,583.8571428571429
239165.0,6,3,337,2,214,0.0,160.0,107.0,1,123,0.0,123.0,123.0
196902.0,17,2,180,1,90,0.0,90.0,90.0,1,90,0.0,90.0,90.0
79421.0,6,14,4740,7,653,12869.833333333334,249.0,93.28571428571428,7,4087,13079.166666666666,1514.0,583.8571428571429
390650.0,6,3,204,2,136,0.0,70.0,68.0,1,68,0.0,68.0,68.0
214674.0,17,2,180,1,90,0.0,90.0,90.0,1,90,0.0,90.0,90.0
23604.0,6,14,4740,7,653,3806.5,249.0,93.28571428571428,7,4087,3660.1666666666665,1514.0,583.8571428571429
2019.0,17,4,344,2,150,0.0,75.0,75.0,2,194,0.0,103.0,97.0
108104194.0,17,5,1005,5,1005,27026048.5,201.0,201.0,0,0,0.0,0.0,0.0
2312347.0,6,2,132,1,66,0.0,66.0,66.0,1,66,0.0,66.0,66.0
1306776.0,6,4,264,2,132,0.0,66.0,66.0,2,132,0.0,66.0,66.0
41724.0,6,14,4740,7,653,5954.833333333333,249.0,93.28571428571428,7,4087,6320.833333333333,1514.0,583.8571428571429
2109.0,17,2,684,1,342,0.0,342.0,342.0,1,342,0.0,342.0,342.0
90258569.0,6,13,2036,8,1016,12894081.285714284,188.0,127.0,5,1020,22523550.25,204.0,204.0
236419.0,6,3,337,2,214,0.0,160.0,107.0,1,123,0.0,123.0,123.0
23125547.0,17,3,1034,2,684,0.0,342.0,342.0,1,350,0.0,350.0,350.0
1300830.0,6,4,264,2,132,0.0,66.0,66.0,2,132,0.0,66.0,66.0
311412.0,17,4,622,4,622,103804.0,163.0,155.5,0,0,0.0,0.0,0.0
284785.0,6,10,1221,6,636,56957.0,298.0,106.0,4,585,89111.0,379.0,146.25
16920.0,17,2,180,1,90,0.0,90.0,90.0,1,90,0.0,90.0,90.0
312383.0,6,3,202,2,128,0.0,74.0,64.0,1,74,0.0,74.0,74.0
135129678.0,17,6,1146,6,1146,27025935.6,191.0,191.0,0,0,0.0,0.0,0.0
37012.0,6,14,4740,7,653,5172.666666666667,249.0,93.28571428571428,7,4087,5750.333333333333,1514.0,583.8571428571429
1011.0,17,2,508,2,508,0.0,257.0,254.0,0,0,0.0,0.0,0.0
108104440.0,17,5,955,5,955,27026110.0,191.0,191.0,0,0,0.0,0.0,0.0
303070.0,6,5,337,2,163,0.0,97.0,81.5,3,174,151535.0,66.0,58.0
221847.0,6,3,426,2,280,0.0,214.0,140.0,1,146,0.0,146.0,146.0
153443.0,17,2,180,1,90,0.0,90.0,90.0,1,90,0.0,90.0,90.0
108110129.0,17,5,1005,5,1005,27027532.25,201.0,201.0,0,0,0.0,0.0,0.0
146280.0,6,3,337,2,214,0.0,160.0,107.0,1,123,0.0,123.0,123.0
24144.0,6,14,4740,7,653,3090.833333333333,249.0,93.28571428571428,7,4087,3824.3333333333335,1514.0,583.8571428571429
1157555.0,6,13,3017,8,2389,165365.0,1514.0,298.625,5,628,221191.0,331.0,125.6
119561424.0,6,242,27182,121,18900,994552.2083333334,284.0,156.19834710743802,121,8282,994552.425,140.0,68.44628099173553
33074.0,6,14,4740,7,653,5096.5,249.0,93.28571428571428,7,4087,4421.0,1514.0,583.8571428571429
228822.0,17,2,180,1,90,0.0,90.0,90.0,1,90,0.0,90.0,90.0
16950.0,17,2,180,1,90,0.0,90.0,90.0,1,90,0.0,90.0,90.0
204620.0,17,2,762,2,762,0.0,381.0,381.0,0,0,0.0,0.0,0.0
577.0,17,2,508,2,508,0.0,257.0,254.0,0,0,0.0,0.0,0.0
0.0,17,1,44,1,44,0.0,44.0,44.0,0,0,0.0,0.0,0.0
217855.0,6,3,426,2,280,0.0,214.0,140.0,1,146,0.0,146.0,146.0
228112.0,17,2,180,1,90,0.0,90.0,90.0,1,90,0.0,90.0,90.0
108082122.0,17,5,1005,5,1005,27020530.5,201.0,201.0,0,0,0.0,0.0,0.0
157939.0,6,3,337,2,214,0.0,160.0,107.0,1,123,0.0,123.0,123.0
513268.0,6,5,336,2,134,0.0,68.0,67.0,3,202,195234.0,70.0,67.33333333333333
90015130.0,17,28,13364,28,13364,3333893.703703704,501.0,477.2857142857143,0,0,0.0,0.0,0.0
3486.0,17,2,346,1,78,0.0,78.0,78.0,1,268,0.0,268.0,268.0
37192.0,6,14,4740,7,653,5769.5,249.0,93.28571428571428,7,4087,5287.333333333333,1514.0,583.8571428571429
317.0,17,2,174,1,79,0.0,79.0,79.0,1,95,0.0,95.0,95.0
24875.0,6,14,4740,7,653,3991.5,249.0,93.28571428571428,7,4087,3930.3333333333335,1514.0,583.8571428571429
196998.0,17,2,180,1,90,0.0,90.0,90.0,1,90,0.0,90.0,90.0
218260.0,6,3,426,2,280,0.0,214.0,140.0,1,146,0.0,146.0,146.0
153440.0,17,2,180,1,90,0.0,90.0,90.0,1,90,0.0,90.0,90.0
298719.0,6,6,412,4,272,99573.0,74.0,68.0,2,140,0.0,74.0,70.0
147431.0,6,3,373,2,238,0.0,172.0,119.0,1,135,0.0,135.0,135.0
68574.0,6,13,1386,7,789,11429.0,253.0,112.71428571428572,6,597,10446.0,259.0,99.5
298479.0,6,6,412,4,272,99493.0,74.0,68.0,2,140,0.0,74.0,70.0
232362.0,6,3,337,2,214,0.0,160.0,107.0,1,123,0.0,123.0,123.0
10466446.0,6,7,478,4,272,3443574.0,74.0,68.0,3,206,5165267.0,74.0,68.66666666666667
157415.0,17,4,1524,4,1524,52471.66666666666,381.0,381.0,0,0,0.0,0.0,0.0
137464.0,17,2,176,1,80,0.0,80.0,80.0,1,96,0.0,96.0,96.0
153623.0,17,2,180,1,90,0.0,90.0,90.0,1,90,0.0,90.0,90.0
301685.0,6,6,412,4,272,100561.66666666669,74.0,68.0,2,140,0.0,74.0,70.0
301838.0,6,6,412,4,272,100612.66666666669,74.0,68.0,2,140,0.0,74.0,70.0
2450.0,17,4,344,2,150,0.0,75.0,75.0,2,194,0.0,103.0,97.0
120123116.0,6,13,2020,9,1204,15015389.5,188.0,133.77777777777777,4,816,30030302.666666668,204.0,204.0
20910.0,17,2,582,1,83,0.0,83.0,83.0,1,499,0.0,499.0,499.0
96889344.0,17,14,4796,13,4446,6244211.666666667,342.0,342.0,1,350,0.0,350.0,350.0
217627.0,6,3,426,2,280,0.0,214.0,140.0,1,146,0.0,146.0,146.0
205765.0,17,2,180,1,90,0.0,90.0,90.0,1,90,0.0,90.0,90.0
205920.0,6,3,426,2,280,0.0,214.0,140.0,1,146,0.0,146.0,146.0
108109683.0,17,5,955,5,955,27027420.75,191.0,191.0,0,0,0.0,0.0,0.0
1161834.0,6,13,3004,8,2376,165976.2857142857,1514.0,297.0,5,628,221581.0,331.0,125.6
55562.0,6,14,4740,7,653,9134.666666666666,249.0,93.28571428571428,7,4087,7444.166666666667,1514.0,583.8571428571429
298190.0,6,6,412,4,272,99396.66666666669,74.0,68.0,2,140,0.0,74.0,70.0
1173425.0,6,13,3000,8,2372,167632.14285714287,1514.0,296.5,5,628,225212.25,331.0,125.6
108106080.0,17,5,1005,5,1005,27026520.0,201.0,201.0,0,0,0.0,0.0,0.0
159300.0,6,3,337,2,214,0.0,160.0,107.0,1,123,0.0,123.0,123.0
90762343.0,6,20,1531,11,840,9071814.9,95.0,76.36363636363636,9,691,11344211.25,95.0,76.77777777777777
2399794.0,6,27,8017,14,2948,184599.53846153847,1029.0,210.57142857142856,13,5069,174396.58333333334,1510.0,389.9230769230769
313228.0,17,4,1400,4,1400,104409.33333333331,350.0,350.0,0,0,0.0,0.0,0.0
153391.0,17,2,180,1,90,0.0,90.0,90.0,1,90,0.0,90.0,90.0
60138.0,6,14,4740,7,653,9231.666666666666,249.0,93.28571428571428,7,4087,9123.166666666666,1514.0,583.8571428571429
94899162.0,6,165,18606,83,5700,1157306.853658537,140.0,68.67469879518072,82,12906,1158921.061728395,284.0,157.390243902439
157908.0,17,2,180,1,90,0.0,90.0,90.0,1,90,0.0,90.0,90.0
29117.0,6,14,4740,7,653,4490.5,249.0,93.28571428571428,7,4087,4265.0,1514.0,583.8571428571429
167171.0,17,4,704,2,148,0.0,74.0,74.0,2,556,0.0,280.0,278.0
303.0,17,2,164,1,82,0.0,82.0,82.0,1,82,0.0,82.0,82.0
2446.0,17,4,344,2,150,0.0,75.0,75.0,2,194,0.0,103.0,97.0
48806.0,6,14,4740,7,653,7901.5,249.0,93.28571428571428,7,4087,7657.5,1514.0,583.8571428571429
51212.0,6,10,2032,5,524,10325.0,252.0,104.8,5,1508,10807.75,1236.0,301.6
120025439.0,17,29,13785,29,13785,4286622.821428572,501.0,475.3448275862069,0,0,0.0,0.0,0.0
96115832.0,6,65,14213,33,6757,3003619.75,1514.0,204.7575757575757,32,7456,3092297.580645161,1514.0,233.0
120128874.0,6,13,2020,9,1204,15016109.25,188.0,133.77777777777777,4,816,30030739.666666668,204.0,204.0
303542.0,6,6,412,4,272,101180.66666666669,74.0,68.0,2,140,0.0,74.0,70.0
21629.0,6,10,2032,5,524,4979.5,252.0,104.8,5,1508,4448.25,1236.0,301.6
10455912.0,6,7,478,4,272,3438655.333333333,74.0,68.0,3,206,5157858.0,74.0,68.66666666666667
99584.0,6,10,2032,5,524,17839.0,252.0,104.8,5,1508,23282.0,1236.0,301.6
2333.0,17,4,344,2,150,0.0,75.0,75.0,2,194,0.0,103.0,97.0
7997379.0,17,4,1376,3,1026,78077.5,342.0,342.0,1,350,0.0,350.0,350.0
32995.0,6,14,4740,7,653,5280.166666666667,249.0,93.28571428571428,7,4087,5333.666666666667,1514.0,583.8571428571429
1627198.0,17,2,876,2,876,0.0,438.0,438.0,0,0,0.0,0.0,0.0
90733854.0,6,18,1341,9,691,11341731.75,95.0,76.77777777777777,9,650,11306262.0,95.0,72.22222222222223
111206.0,17,2,762,2,762,0.0,381.0,381.0,0,0,0.0,0.0,0.0
2057.0,17,4,344,2,150,0.0,75.0,75.0,2,194,0.0,103.0,97.0
2290.0,17,4,344,2,150,0.0,75.0,75.0,2,194,0.0,103.0,97.0
142364.0,6,2,132,1,66,0.0,66.0,66.0,1,66,0.0,66.0,66.0
26938.0,6,11,2098,6,590,5223.0,252.0,98.33333333333331,5,1508,4888.5,1236.0,301.6
179816.0,17,2,180,1,90,0.0,90.0,90.0,1,90,0.0,90.0,90.0
103147.0,17,2,286,2,286,0.0,143.0,143.0,0,0,0.0,0.0,0.0
301.0,17,2,164,1,82,0.0,82.0,82.0,1,82,0.0,82.0,82.0
33861.0,6,14,4740,7,653,5270.166666666667,249.0,93.28571428571428,7,4087,5096.5,1514.0,583.8571428571429
49536.0,6,2,132,1,66,0.0,66.0,66.0,1,66,0.0,66.0,66.0
46405.0,6,14,4740,7,653,7576.666666666667,249.0,93.28571428571428,7,4087,5941.166666666667,1514.0,583.8571428571429
68365.0,6,14,4740,7,653,11267.833333333334,249.0,93.28571428571428,7,4087,11112.5,1514.0,583.8571428571429
36030.0,6,14,4740,7,653,5627.5,249.0,93.28571428571428,7,4087,5368.166666666667,1514.0,583.8571428571429
217863.0,6,3,426,2,280,0.0,214.0,140.0,1,146,0.0,146.0,146.0
47917.0,6,14,4740,7,653,7642.166666666667,249.0,93.28571428571428,7,4087,7809.333333333333,1514.0,583.8571428571429
115477546.0,6,48,3168,24,1584,5020762.869565218,66.0,66.0,24,1584,5008778.826086956,66.0,66.0
41984002.0,6,4,1670,3,917,20992001.0,785.0,305.6666666666667,1,753,0.0,753.0,753.0
102940.0,17,2,286,2,286,0.0,143.0,143.0,0,0,0.0,0.0,0.0
2320.0,17,4,344,2,150,0.0,75.0,75.0,2,194,0.0,103.0,97.0
20310.0,17,2,582,1,83,0.0,83.0,83.0,1,499,0.0,499.0,499.0
221673.0,17,2,180,1,90,0.0,90.0,90.0,1,90,0.0,90.0,90.0
382.0,17,2,300,1,80,0.0,80.0,80.0,1,220,0.0,220.0,220.0
198963.0,17,2,180,1,90,0.0,90.0,90.0,1,90,0.0,90.0,90.0
200142.0,17,4,6056,4,6056,66714.0,1514.0,1514.0,0,0,0.0,0.0,0.0
90298392.0,6,19,1436,10,745,10027574.444444444,95.0,74.5,9,691,11281947.375,95.0,76.77777777777777
333.0,17,2,166,1,75,0.0,75.0,75.0,1,91,0.0,91.0,91.0
108104544.0,17,5,1005,5,1005,27026136.0,201.0,201.0,0,0,0.0,0.0,0.0
204814.0,17,2,762,2,762,0.0,381.0,381.0,0,0,0.0,0.0,0.0
2046.0,17,4,344,2,150,0.0,75.0,75.0,2,194,0.0,103.0,97.0
234388.0,6,3,337,2,214,0.0,160.0,107.0,1,123,0.0,123.0,123.0
90205474.0,6,17,1287,8,596,12852410.857142856,95.0,74.5,9,691,11249988.75,95.0,76.77777777777777
4361.0,17,2,614,1,72,0.0,72.0,72.0,1,542,0.0,542.0,542.0
108573.0,17,4,1400,4,1400,36191.0,350.0,350.0,0,0,0.0,0.0,0.0
23963.0,6,10,2032,5,524,5709.75,252.0,104.8,5,1508,5471.25,1236.0,301.6
198663.0,17,2,180,1,90,0.0,90.0,90.0,1,90,0.0,90.0,90.0
1131565.0,6,5,1736,2,819,0.0,753.0,409.5,3,917,501295.0,785.0,305.6666666666667
203925.0,17,2,762,2,762,0.0,381.0,381.0,0,0,0.0,0.0,0.0
360587.0,6,4,508,2,238,0.0,172.0,119.0,2,270,0.0,135.0,135.0
97314079.0,6,66,12881,33,6750,3041064.96875,1514.0,204.54545454545453,33,6131,3032485.0625,1514.0,185.7878787878788
143918.0,17,2,180,1,90,0.0,90.0,90.0,1,90,0.0,90.0,90.0
4511.0,17,2,598,1,72,0.0,72.0,72.0,1,526,0.0,526.0,526.0
292799.0,17,2,180,1,90,0.0,90.0,90.0,1,90,0.0,90.0,90.0
166811.0,17,2,180,1,90,0.0,90.0,90.0,1,90,0.0,90.0,90.0
206118.0,17,2,180,1,90,0.0,90.0,90.0,1,90,0.0,90.0,90.0
204451.0,17,2,762,2,762,0.0,381.0,381.0,0,0,0.0,0.0,0.0
319945.0,17,4,1400,4,1400,106648.33333333331,350.0,350.0,0,0,0.0,0.0,0.0
82751.0,6,11,2098,6,590,16323.6,252.0,98.33333333333331,5,1508,20343.75,1236.0,301.6
127005140.0,17,15,907,8,475,18143591.42857143,174.0,59.375,7,432,17833513.833333332,174.0,61.71428571428572
135127633.0,17,6,1206,6,1206,27025526.6,201.0,201.0,0,0,0.0,0.0,0.0
113277733.0,6,48,3168,24,1584,4925118.826086956,66.0,66.0,24,1584,4915720.652173913,66.0,66.0
48947.0,6,14,4740,7,653,7940.833333333333,249.0,93.28571428571428,7,4087,7677.666666666667,1514.0,583.8571428571429
3053473.0,6,4,270,3,202,1526736.5,70.0,67.33333333333333,1,68,0.0,68.0,68.0
120126036.0,6,13,2020,9,1204,15015754.5,188.0,133.77777777777777,4,816,30041159.33333333,204.0,204.0
32938.0,6,10,2032,5,524,7984.75,252.0,104.8,5,1508,8007.0,1236.0,301.6
0.0,17,1,84,1,84,0.0,84.0,84.0,0,0,0.0,0.0,0.0
25136.0,6,14,4740,7,653,4032.5,249.0,93.28571428571428,7,4087,4054.6666666666665,1514.0,583.8571428571429
20107.0,6,14,4740,7,653,2909.5,249.0,93.28571428571428,7,4087,3213.333333333333,1514.0,583.8571428571429
102157.0,17,2,762,2,762,0.0,381.0,381.0,0,0,0.0,0.0,0.0
36560.0,6,10,2032,5,524,8934.25,252.0,104.8,5,1508,5288.5,1236.0,301.6
2809191.0,6,2,132,1,66,0.0,66.0,66.0,1,66,0.0,66.0,66.0
2269.0,17,4,344,2,150,0.0,75.0,75.0,2,194,0.0,103.0,97.0
236665.0,17,2,180,1,90,0.0,90.0,90.0,1,90,0.0,90.0,90.0
4975.0,17,2,180,1,90,0.0,90.0,90.0,1,90,0.0,90.0,90.0
63224.0,6,14,4740,7,653,9562.333333333334,249.0,93.28571428571428,7,4087,10401.833333333334,1514.0,583.8571428571429
6458.0,17,4,6056,4,6056,2152.6666666666665,1514.0,1514.0,0,0,0.0,0.0,0.0
213615.0,17,2,180,1,90,0.0,90.0,90.0,1,90,0.0,90.0,90.0
45175.0,6,14,4740,7,653,7061.166666666667,249.0,93.28571428571428,7,4087,6919.666666666667,1514.0,583.8571428571429
90871508.0,6,20,1531,10,786,10091897.555555556,95.0,78.6,10,745,10095792.888888888,95.0,74.5
113715050.0,6,48,3168,24,1584,4944132.608695652,66.0,66.0,24,1584,4935647.434782608,66.0,66.0
120037344.0,17,28,13364,28,13364,4445827.555555556,501.0,477.2857142857143,0,0,0.0,0.0,0.0
6778.0,17,2,582,1,83,0.0,83.0,83.0,1,499,0.0,499.0,499.0
3011101.0,6,11,2106,6,598,602043.4,252.0,99.66666666666669,5,1508,2952.5,1236.0,301.6
203481.0,17,2,762,2,762,0.0,381.0,381.0,0,0,0.0,0.0,0.0
196849.0,17,2,180,1,90,0.0,90.0,90.0,1,90,0.0,90.0,90.0
284431.0,17,2,363,1,79,0.0,79.0,79.0,1,284,0.0,284.0,284.0
318.0,17,2,174,1,79,0.0,79.0,79.0,1,95,0.0,95.0,95.0
7266.0,17,4,344,2,150,0.0,75.0,75.0,2,194,0.0,103.0,97.0
108106331.0,17,5,955,5,955,27026582.75,191.0,191.0,0,0,0.0,0.0,0.0
90059436.0,17,28,13364,28,13364,3335534.6666666665,501.0,477.2857142857143,0,0,0.0,0.0,0.0
222301.0,17,2,180,1,90,0.0,90.0,90.0,1,90,0.0,90.0,90.0
302389.0,6,2,132,1,66,0.0,66.0,66.0,1,66,0.0,66.0,66.0
2408259.0,6,2,132,1,66,0.0,66.0,66.0,1,66,0.0,66.0,66.0
324377.0,17,4,1400,4,1400,108125.66666666669,350.0,350.0,0,0,0.0,0.0,0.0
120004275.0,17,28,13364,28,13364,4444602.777777778,501.0,477.2857142857143,0,0,0.0,0.0,0.0
5624063.0,6,5,336,2,134,0.0,68.0,67.0,3,202,1523022.5,70.0,67.33333333333333
206122.0,17,2,180,1,90,0.0,90.0,90.0,1,90,0.0,90.0,90.0
26404.0,6,14,4740,7,653,2456.0,249.0,93.28571428571428,7,4087,4259.5,1514.0,583.8571428571429
120283576.0,6,16,1233,8,637,17183368.0,95.0,79.625,8,596,17108134.285714287,95.0,74.5
200842.0,17,4,6056,4,6056,66947.33333333333,1514.0,1514.0,0,0,0.0,0.0,0.0
236703.0,6,2,132,1,66,0.0,66.0,66.0,1,66,0.0,66.0,66.0
23552.0,6,14,4740,7,653,3624.5,249.0,93.28571428571428,7,4087,3734.3333333333335,1514.0,583.8571428571429
2040.0,17,4,344,2,150,0.0,75.0,75.0,2,194,0.0,103.0,97.0
108105243.0,17,5,1005,5,1005,27026310.75,201.0,201.0,0,0,0.0,0.0,0.0
2457.0,17,4,344,2,150,0.0,75.0,75.0,2,194,0.0,103.0,97.0
111297426.0,6,207,23280,104,7172,1080557.5339805826,140.0,68.96153846153847,103,16108,1080898.862745098,284.0,156.38834951456312
155866.0,6,2,132,1,66,0.0,66.0,66.0,1,66,0.0,66.0,66.0
284231.0,17,2,363,1,79,0.0,79.0,79.0,1,284,0.0,284.0,284.0
235128.0,6,3,337,2,214,0.0,160.0,107.0,1,123,0.0,123.0,123.0
2362.0,17,4,344,2,150,0.0,75.0,75.0,2,194,0.0,103.0,97.0
14641539.0,6,20,1607,10,975,1592483.111111111,315.0,97.5,10,632,1593241.0,78.0,63.2
90297253.0,6,16,1192,8,596,12893313.57142857,95.0,74.5,8,596,12898395.42857143,95.0,74.5
4289.0,17,2,614,1,72,0.0,72.0,72.0,1,542,0.0,542.0,542.0
104623.0,17,2,700,2,700,0.0,350.0,350.0,0,0,0.0,0.0,0.0
26038.0,6,14,4740,7,653,4078.3333333333335,249.0,93.28571428571428,7,4087,4198.5,1514.0,583.8571428571429
1200976.0,6,11,1134,6,558,240195.2,220.0,93.0,5,576,298196.25,304.0,115.2
108104106.0,17,5,955,5,955,27026026.5,191.0,191.0,0,0,0.0,0.0,0.0
0.0,6,1,172,1,172,0.0,172.0,172.0,0,0,0.0,0.0,0.0
1167821.0,6,13,3011,8,2383,166831.57142857142,1514.0,297.875,5,628,223041.75,331.0,125.6
300672.0,6,6,412,4,272,100224.0,74.0,68.0,2,140,0.0,74.0,70.0
216457.0,17,2,180,1,90,0.0,90.0,90.0,1,90,0.0,90.0,90.0
694.0,17,4,438,2,148,0.0,74.0,74.0,2,290,0.0,147.0,145.0
2434.0,17,4,344,2,150,0.0,75.0,75.0,2,194,0.0,103.0,97.0
19435955.0,6,11,738,5,342,4857982.25,95.0,68.4,6,396,3886321.8,95.0,66.0
4812.0,17,2,602,1,72,0.0,72.0,72.0,1,530,0.0,530.0,530.0
110131426.0,6,27,1806,14,966,8455038.384615384,123.0,69.0,13,840,9159492.666666666,123.0,64.61538461538461
27022.0,6,14,4740,7,653,4309.333333333333,249.0,93.28571428571428,7,4087,4195.166666666667,1514.0,583.8571428571429
33972.0,6,14,4740,7,653,5519.5,249.0,93.28571428571428,7,4087,5520.166666666667,1514.0,583.8571428571429
90526780.0,6,13,2036,8,1016,12932397.142857144,188.0,127.0,5,1020,22590840.0,204.0,204.0
8248.0,17,2,762,2,762,0.0,381.0,381.0,0,0,0.0,0.0,0.0
90937664.0,6,21,1585,11,840,9093106.5,95.0,76.36363636363636,10,745,10102934.222222222,95.0,74.5
87.0,17,2,762,2,762,0.0,381.0,381.0,0,0,0.0,0.0,0.0
65184.00000000001,6,10,2032,5,524,15447.5,252.0,104.8,5,1508,14404.5,1236.0,301.6
97.0,17,2,906,2,906,0.0,453.0,453.0,0,0,0.0,0.0,0.0
140018.0,6,2,132,1,66,0.0,66.0,66.0,1,66,0.0,66.0,66.0
26693.0,6,10,2032,5,524,6431.5,252.0,104.8,5,1508,6088.25,1236.0,301.6
539219.0,17,6,2100,6,2100,107843.8,350.0,350.0,0,0,0.0,0.0,0.0
102504.0,17,2,286,2,286,0.0,143.0,143.0,0,0,0.0,0.0,0.0
34735.0,6,10,2032,5,524,8422.5,252.0,104.8,5,1508,8087.0,1236.0,301.6
104786691.0,17,14,4788,14,4788,8060514.692307692,342.0,342.0,0,0,0.0,0.0,0.0
103083888.0,6,44,2904,22,1452,4908756.571428572,66.0,66.0,22,1452,4899036.523809524,66.0,66.0
120144000.0,6,228,25772,114,7746,1046760.9911504424,140.0,67.94736842105263,114,18026,1056056.0442477877,284.0,158.12280701754386
90230643.0,6,16,1192,8,596,12852898.57142857,95.0,74.5,8,596,12857677.714285716,95.0,74.5
282633.0,17,4,704,2,148,0.0,74.0,74.0,2,556,0.0,280.0,278.0
65567.0,6,14,4740,7,653,10700.166666666666,249.0,93.28571428571428,7,4087,8987.166666666666,1514.0,583.8571428571429
90285364.0,6,12,1832,8,1016,12897909.142857144,188.0,127.0,4,816,30040679.0,204.0,204.0
16744.0,6,11,1132,6,556,3202.8,218.0,92.66666666666669,5,576,2854.75,304.0,115.2
90529508.0,6,13,2036,8,1016,12932786.857142856,188.0,127.0,5,1020,22591727.25,204.0,204.0
137997.0,17,2,176,1,80,0.0,80.0,80.0,1,96,0.0,96.0,96.0
32342.000000000004,6,13,1479,7,882,5223.0,291.0,126.0,6,597,5434.6,259.0,99.5
305170.0,6,3,337,2,214,0.0,160.0,107.0,1,123,0.0,123.0,123.0
21859.0,6,10,2032,5,524,4643.75,252.0,104.8,5,1508,5178.25,1236.0,301.6
205591.0,17,2,180,1,90,0.0,90.0,90.0,1,90,0.0,90.0,90.0
215492.0,17,2,180,1,90,0.0,90.0,90.0,1,90,0.0,90.0,90.0
97938915.0,17,17,5822,16,5472,5357108.933333334,342.0,342.0,1,350,0.0,350.0,350.0
32875.0,6,14,4740,7,653,5356.833333333333,249.0,93.28571428571428,7,4087,5269.5,1514.0,583.8571428571429
108126386.0,17,5,1005,5,1005,27031596.5,201.0,201.0,0,0,0.0,0.0,0.0
10486719.0,6,7,478,4,272,3450160.0,74.0,68.0,3,206,5175124.0,74.0,68.66666666666667
102659024.0,17,14,864,7,432,17001097.166666668,174.0,61.71428571428572,7,432,17000166.833333332,174.0,61.71428571428572
797208.0,6,10,1221,6,636,159441.6,298.0,106.0,4,585,264066.6666666667,379.0,146.25
105211.0,17,2,700,2,700,0.0,350.0,350.0,0,0,0.0,0.0,0.0
2797536.0,6,2,132,1,66,0.0,66.0,66.0,1,66,0.0,66.0,66.0
2859852.0,6,4,270,3,202,1429926.0,70.0,67.33333333333333,1,68,0.0,68.0,68.0
50868.0,6,11,2098,6,590,8481.4,252.0,98.33333333333331,5,1508,11299.25,1236.0,301.6
32491.0,6,14,4740,7,653,5229.333333333333,249.0,93.28571428571428,7,4087,4839.833333333333,1514.0,583.8571428571429
196827.0,17,2,180,1,90,0.0,90.0,90.0,1,90,0.0,90.0,90.0
148957.0,17,2,414,1,88,0.0,88.0,88.0,1,326,0.0,326.0,326.0
111440487.0,17,14,864,7,432,18500163.5,174.0,61.71428571428572,7,432,18500418.83333333,174.0,61.71428571428572
3116448.0,6,130,118382,85,111110,37100.57142857143,1510.0,1307.1764705882354,45,7272,62932.84090909091,1510.0,161.6
103943.0,17,2,286,2,286,0.0,143.0,143.0,0,0,0.0,0.0,0.0
208600.0,6,12,1373,7,714,34766.666666666664,298.0,102.0,5,659,51164.75,379.0,131.8
7748991.0,17,4,1376,3,1026,55659.5,342.0,342.0,1,350,0.0,350.0,350.0
103274.0,17,2,286,2,286,0.0,143.0,143.0,0,0,0.0,0.0,0.0
1815.0,17,4,344,2,150,0.0,75.0,75.0,2,194,0.0,103.0,97.0
2284.0,17,4,344,2,150,0.0,75.0,75.0,2,194,0.0,103.0,97.0
108108758.0,17,5,1005,5,1005,27027189.5,201.0,201.0,0,0,0.0,0.0,0.0
66821.0,6,10,2032,5,524,15958.75,252.0,104.8,5,1508,12445.0,1236.0,301.6
212844.0,17,2,180,1,90,0.0,90.0,90.0,1,90,0.0,90.0,90.0
2592763.0,6,2,132,1,66,0.0,66.0,66.0,1,66,0.0,66.0,66.0
92838702.0,6,457,89792,229,74226,407187.2894736842,1514.0,324.13100436681225,228,15566,407938.5550660793,214.0,68.2719298245614
493019.0,6,4,270,2,134,0.0,68.0,67.0,2,136,0.0,70.0,68.0
1116758.0,6,13,1386,7,789,186126.3333333333,253.0,112.71428571428572,6,597,220983.4,259.0,99.5
47032.0,6,14,4740,7,653,7710.833333333333,249.0,93.28571428571428,7,4087,7089.166666666667,1514.0,583.8571428571429
209796.0,6,3,426,2,280,0.0,214.0,140.0,1,146,0.0,146.0,146.0
164572.0,17,2,414,1,88,0.0,88.0,88.0,1,326,0.0,326.0,326.0
99524925.0,6,179,20262,90,6174,1118257.5842696629,140.0,68.6,89,14088,1119179.4545454546,284.0,158.2921348314607
103367.0,17,2,286,2,286,0.0,143.0,143.0,0,0,0.0,0.0,0.0
93011553.0,6,38,2508,19,1254,5150436.833333333,66.0,66.0,19,1254,5150436.0,66.0,66.0
302195.0,6,6,412,4,272,100731.66666666669,74.0,68.0,2,140,0.0,74.0,70.0
90262737.0,6,13,2036,8,1016,12894676.714285716,188.0,127.0,5,1020,22516208.25,204.0,204.0
15713.999999999998,17,2,180,1,90,0.0,90.0,90.0,1,90,0.0,90.0,90.0
202106.0,17,2,359,1,75,0.0,75.0,75.0,1,284,0.0,284.0,284.0
18452.0,6,14,4740,7,653,2965.6666666666665,249.0,93.28571428571428,7,4087,2769.6666666666665,1514.0,583.8571428571429
0.0,6,1,66,1,66,0.0,66.0,66.0,0,0,0.0,0.0,0.0
71429.0,6,14,4740,7,653,11722.0,249.0,93.28571428571428,7,4087,10705.0,1514.0,583.8571428571429
121462.0,6,3,337,2,214,0.0,160.0,107.0,1,123,0.0,123.0,123.0
117128324.0,6,48,3168,24,1584,5092535.826086956,66.0,66.0,24,1584,5079121.391304348,66.0,66.0
210579.0,6,10,1221,6,636,42115.8,298.0,106.0,4,585,68874.33333333333,379.0,146.25
64537.0,6,14,4740,7,653,9617.333333333334,249.0,93.28571428571428,7,4087,10563.833333333334,1514.0,583.8571428571429
5622576.0,6,4,270,2,134,0.0,68.0,67.0,2,136,0.0,70.0,68.0
205747.0,17,2,180,1,90,0.0,90.0,90.0,1,90,0.0,90.0,90.0
10481043.0,6,7,478,4,272,3448357.0,74.0,68.0,3,206,5172444.0,74.0,68.66666666666667
308134.0,6,6,412,4,272,102711.33333333331,74.0,68.0,2,140,0.0,74.0,70.0
35593.0,6,14,4740,7,653,5808.166666666667,249.0,93.28571428571428,7,4087,5413.833333333333,1514.0,583.8571428571429
91801594.0,6,177,19938,89,6096,1043199.9318181818,140.0,68.49438202247191,88,13842,1043437.1264367816,284.0,157.29545454545453
162335.0,17,2,180,1,90,0.0,90.0,90.0,1,90,0.0,90.0,90.0
861.0,17,2,508,2,508,0.0,257.0,254.0,0,0,0.0,0.0,0.0
5832430.0,6,5,336,2,134,0.0,68.0,67.0,3,202,1523647.0,70.0,67.33333333333333
120336342.0,17,15,1038,8,606,17190906.0,174.0,75.75,7,432,17000154.0,174.0,61.71428571428572
2282.0,17,4,344,2,150,0.0,75.0,75.0,2,194,0.0,103.0,97.0
211412.0,17,2,180,1,90,0.0,90.0,90.0,1,90,0.0,90.0,90.0
237192.0,6,10,1221,6,636,47438.4,298.0,106.0,4,585,77961.0,379.0,146.25
39907.0,6,14,4740,7,653,6498.333333333333,249.0,93.28571428571428,7,4087,6461.5,1514.0,583.8571428571429
209510.0,17,2,180,1,90,0.0,90.0,90.0,1,90,0.0,90.0,90.0
4821.0,17,4,344,2,150,0.0,75.0,75.0,2,194,0.0,103.0,97.0
624306.0,6,4,508,2,238,0.0,172.0,119.0,2,270,0.0,135.0,135.0
831915.0,6,9,1118,6,586,166383.0,248.0,97.66666666666669,3,532,279671.0,392.0,177.33333333333334
206073.0,6,3,426,2,280,0.0,214.0,140.0,1,146,0.0,146.0,146.0
41803.0,6,2,132,1,66,0.0,66.0,66.0,1,66,0.0,66.0,66.0
92710211.0,6,38,2508,19,1254,5135439.722222222,66.0,66.0,19,1254,5135439.888888889,66.0,66.0
121395.0,6,3,337,2,214,0.0,160.0,107.0,1,123,0.0,123.0,123.0
315733.0,17,4,1400,4,1400,105244.33333333331,350.0,350.0,0,0,0.0,0.0,0.0
10450419.0,6,7,478,4,272,3438103.6666666665,74.0,68.0,3,206,5157071.0,74.0,68.66666666666667
90532476.0,6,14,2240,8,1016,12933210.857142856,188.0,127.0,6,1224,18073859.0,204.0,204.0
895490.0,6,10,1334,6,797,179098.0,459.0,132.83333333333334,4,537,207566.0,331.0,134.25
146094.0,6,3,337,2,214,0.0,160.0,107.0,1,123,0.0,123.0,123.0
103200368.0,6,42,2772,21,1386,5160000.2,66.0,66.0,21,1386,5160006.25,66.0,66.0
135128981.0,17,6,1146,6,1146,27025796.2,191.0,191.0,0,0,0.0,0.0,0.0
5822457.0,6,5,336,2,134,0.0,68.0,67.0,3,202,1525098.5,70.0,67.33333333333333
303312.0,6,6,412,4,272,101104.0,74.0,68.0,2,140,0.0,74.0,70.0
113948775.0,6,48,3168,24,1584,4954294.565217392,66.0,66.0,24,1584,4940872.608695652,66.0,66.0
321818.0,6,6,412,4,272,107272.66666666669,74.0,68.0,2,140,0.0,74.0,70.0
60908.0,6,14,4740,7,653,10020.833333333334,249.0,93.28571428571428,7,4087,9460.166666666666,1514.0,583.8571428571429
162331.0,17,2,180,1,90,0.0,90.0,90.0,1,90,0.0,90.0,90.0
298365.0,6,6,412,4,272,99455.0,74.0,68.0,2,140,0.0,74.0,70.0
153481.0,17,2,180,1,90,0.0,90.0,90.0,1,90,0.0,90.0,90.0
135136376.0,17,6,1206,6,1206,27027275.2,201.0,201.0,0,0,0.0,0.0,0.0
120123719.0,6,17,2556,10,1392,13347079.888888888,188.0,139.2,7,1164,15015414.0,204.0,166.28571428571428
210781.0,17,2,180,1,90,0.0,90.0,90.0,1,90,0.0,90.0,90.0
108104208.0,17,5,955,5,955,27026052.0,191.0,191.0,0,0,0.0,0.0,0.0
36678.0,6,14,4740,7,653,5993.333333333333,249.0,93.28571428571428,7,4087,5519.0,1514.0,583.8571428571429
136756.0,6,2,132,1,66,0.0,66.0,66.0,1,66,0.0,66.0,66.0
102005640.0,17,14,1126,7,563,17000940.0,174.0,80.42857142857143,7,563,16833486.166666668,174.0,80.42857142857143
308214.0,6,6,412,4,272,102738.0,74.0,68.0,2,140,0.0,74.0,70.0
2588092.0,6,2,132,1,66,0.0,66.0,66.0,1,66,0.0,66.0,66.0
148440.0,6,3,337,2,214,0.0,160.0,107.0,1,123,0.0,123.0,123.0
105798259.0,6,32,2220,16,1149,7038838.133333334,123.0,71.8125,16,1071,7038832.533333333,123.0,66.9375
120308859.0,6,224,25540,112,7614,1076425.9099099098,140.0,67.98214285714286,112,17926,1076478.2522522523,390.0,160.05357142857142
2320.0,17,4,344,2,150,0.0,75.0,75.0,2,194,0.0,103.0,97.0
104965726.0,17,14,1126,7,563,17453386.5,174.0,80.42857142857143,7,563,17467791.833333332,174.0,80.42857142857143
2144050.0,6,24,7544,13,2516,178670.83333333334,1034.0,193.53846153846155,11,5028,183555.6,1510.0,457.09090909090907
1580919.0,6,19,7533,10,1403,175657.66666666666,583.0,140.3,9,6130,165232.375,1484.0,681.1111111111111
12862.0,6,10,1066,5,490,2757.75,218.0,98.0,5,576,3006.25,304.0,115.2
107153.0,17,2,286,2,286,0.0,143.0,143.0,0,0,0.0,0.0,0.0
44046.0,6,10,2032,5,524,10068.25,252.0,104.8,5,1508,7040.75,1236.0,301.6
2806.0,17,2,224,1,76,0.0,76.0,76.0,1,148,0.0,148.0,148.0
44712.0,6,10,2032,5,524,7674.5,252.0,104.8,5,1508,10818.75,1236.0,301.6
3271.0,17,2,762,2,762,0.0,381.0,381.0,0,0,0.0,0.0,0.0
24960.0,6,14,4740,7,653,3869.3333333333335,249.0,93.28571428571428,7,4087,3443.333333333333,1514.0,583.8571428571429
18066.0,6,14,4740,7,653,2800.5,249.0,93.28571428571428,7,4087,2659.833333333333,1514.0,583.8571428571429
90292144.0,6,17,1287,9,691,11281276.5,95.0,76.77777777777777,8,596,12831299.857142856,95.0,74.5
115215519.0,6,48,3168,24,1584,5009370.391304348,66.0,66.0,24,1584,4997399.956521739,66.0,66.0
91886118.0,6,23,1734,11,840,9188611.8,95.0,76.36363636363636,12,894,8329632.545454546,95.0,74.5
120222595.0,6,230,25990,115,7898,1047891.754385965,140.0,68.67826086956522,115,18092,1048338.0614035088,284.0,157.3217391304348
120057156.0,17,29,13785,29,13785,4287755.571428572,501.0,475.3448275862069,0,0,0.0,0.0,0.0
2042.0,17,4,344,2,150,0.0,75.0,75.0,2,194,0.0,103.0,97.0
102024566.0,6,447,56928,224,15006,457509.264573991,140.0,66.99107142857143,223,41922,454872.26576576574,374.0,187.9910313901345
119605208.0,6,214,24090,107,16806,1126422.6792452831,284.0,157.06542056074767,107,7284,1126422.4622641508,140.0,68.07476635514018
11751.0,17,4,823,2,163,0.0,89.0,81.5,2,660,0.0,443.0,330.0
143917.0,17,2,180,1,90,0.0,90.0,90.0,1,90,0.0,90.0,90.0
109413.0,17,4,1400,4,1400,36471.0,350.0,350.0,0,0,0.0,0.0,0.0
1314507.0,6,4,264,2,132,0.0,66.0,66.0,2,132,0.0,66.0,66.0
1444.0,17,2,180,1,90,0.0,90.0,90.0,1,90,0.0,90.0,90.0
120125386.0,6,13,2036,5,1020,30031346.5,204.0,204.0,8,1016,17136781.285714287,188.0,127.0
512123.0,6,3,204,1,68,0.0,68.0,68.0,2,136,0.0,70.0,68.0
161146.0,6,2,128,1,74,0.0,74.0,74.0,1,54,0.0,54.0,54.0
2187907.0,6,24,7544,12,2450,198900.63636363635,1034.0,204.16666666666663,12,5094,170340.18181818182,1510.0,424.5
225461.0,6,4,492,2,280,0.0,214.0,140.0,2,212,0.0,146.0,106.0
112688328.0,6,48,3168,24,1584,4899492.521739131,66.0,66.0,24,1584,4890097.173913044,66.0,66.0
90255492.0,6,13,2036,8,1016,12893641.714285716,188.0,127.0,5,1020,22523024.75,204.0,204.0
5621894.0,6,5,336,2,134,0.0,68.0,67.0,3,202,1423522.5,70.0,67.33333333333333
2427.0,17,4,344,2,150,0.0,75.0,75.0,2,194,0.0,103.0,97.0
1471937.0,17,16,1120,16,1120,98129.13333333332,70.0,70.0,0,0,0.0,0.0,0.0
128967.0,6,2,132,1,66,0.0,66.0,66.0,1,66,0.0,66.0,66.0
108190484.0,6,34,3493,18,1800,6363945.882352941,424.0,100.0,16,1693,7194224.4,355.0,105.8125
108100133.0,17,5,955,5,955,27025033.25,191.0,191.0,0,0,0.0,0.0,0.0
320.0,17,2,174,1,79,0.0,79.0,79.0,1,95,0.0,95.0,95.0
414.0,17,2,410,1,78,0.0,78.0,78.0,1,332,0.0,332.0,332.0
107830823.0,6,28,1860,14,966,8278079.769230769,123.0,69.0,14,894,8278086.538461538,123.0,63.85714285714285
364385.0,6,3,1604,2,851,0.0,785.0,425.5,1,753,0.0,753.0,753.0
125476.0,6,2,132,1,66,0.0,66.0,66.0,1,66,0.0,66.0,66.0
122687794.0,6,48,3168,24,1584,5131258.478260869,66.0,66.0,24,1584,5077074.782608695,66.0,66.0
1457513.0,6,7,499,4,301,430097.0,103.0,75.25,3,198,719476.0,66.0,66.0
118720575.0,6,31,2160,16,1071,7914705.0,123.0,66.9375,15,1089,7915401.642857143,123.0,72.6
135135594.0,17,6,1146,6,1146,27027118.8,191.0,191.0,0,0,0.0,0.0,0.0
475.0,17,2,267,1,83,0.0,83.0,83.0,1,184,0.0,184.0,184.0
120277347.0,6,16,1233,8,637,17182478.14285714,95.0,79.625,8,596,17106339.42857143,95.0,74.5
221901.0,6,3,426,2,280,0.0,214.0,140.0,1,146,0.0,146.0,146.0
297669.0,6,6,412,4,272,99223.0,74.0,68.0,2,140,0.0,74.0,70.0
1420272.0,6,4,276,2,128,0.0,74.0,64.0,2,148,0.0,74.0,74.0
31607338.0,6,26,7627,14,3735,178731.53846153847,1514.0,266.7857142857143,12,3892,2854689.636363636,1514.0,324.3333333333333
205699.0,17,2,180,1,90,0.0,90.0,90.0,1,90,0.0,90.0,90.0
90530925.0,6,14,2240,8,1016,12932989.285714284,188.0,127.0,6,1224,18073300.8,204.0,204.0
90092075.0,6,10,1440,7,828,15015345.833333334,188.0,118.28571428571428,3,612,30031461.5,204.0,204.0
321250.0,17,4,1400,4,1400,107083.33333333331,350.0,350.0,0,0,0.0,0.0,0.0
297948.0,17,2,180,1,90,0.0,90.0,90.0,1,90,0.0,90.0,90.0
41214.0,6,14,4740,7,653,6640.166666666667,249.0,93.28571428571428,7,4087,6147.666666666667,1514.0,583.8571428571429
1970.0,17,6,1230,3,234,673.0,78.0,78.0,3,996,779.5,332.0,332.0
108111339.0,17,5,955,5,955,27027834.75,191.0,191.0,0,0,0.0,0.0,0.0
115781.0,6,11,1132,6,556,22553.0,218.0,92.66666666666669,5,576,28611.75,304.0,115.2
3590.0,17,2,414,1,88,0.0,88.0,88.0,1,326,0.0,326.0,326.0
326.0,17,2,160,1,80,0.0,80.0,80.0,1,80,0.0,80.0,80.0
204878.0,17,2,762,2,762,0.0,381.0,381.0,0,0,0.0,0.0,0.0
239061.0,17,2,180,1,70,0.0,70.0,70.0,1,110,0.0,110.0,110.0
220948.0,6,10,1221,6,636,44189.6,298.0,106.0,4,585,70986.33333333333,379.0,146.25
208684.0,6,3,426,2,280,0.0,214.0,140.0,1,146,0.0,146.0,146.0
24851.0,6,10,2032,5,524,5879.75,252.0,104.8,5,1508,5699.0,1236.0,301.6
396624.0,6,3,1604,2,851,0.0,785.0,425.5,1,753,0.0,753.0,753.0
206619.0,17,2,762,2,762,0.0,381.0,381.0,0,0,0.0,0.0,0.0
2396.0,17,4,344,2,150,0.0,75.0,75.0,2,194,0.0,103.0,97.0
119639337.0,6,224,25312,112,17624,1075893.5945945946,284.0,157.35714285714286,112,7688,1075893.4144144144,140.0,68.64285714285714
1507127.0,6,20,7599,11,1469,150712.7,583.0,133.54545454545453,9,6130,156507.375,1484.0,681.1111111111111
31366.0,6,10,2032,5,524,7052.0,252.0,104.8,5,1508,6090.25,1236.0,301.6
761.0,17,2,762,2,762,0.0,381.0,381.0,0,0,0.0,0.0,0.0
102898.0,17,2,286,2,286,0.0,143.0,143.0,0,0,0.0,0.0,0.0
124011058.0,17,15,1169,8,606,17715865.42857143,174.0,75.75,7,563,17333538.5,174.0,80.42857142857143
71223.0,17,2,604,1,75,0.0,75.0,75.0,1,529,0.0,529.0,529.0
38966.0,6,10,2032,5,524,9511.5,252.0,104.8,5,1508,8570.5,1236.0,301.6
120007.0,17,2,180,1,70,0.0,70.0,70.0,1,110,0.0,110.0,110.0
217991.0,6,3,426,2,280,0.0,214.0,140.0,1,146,0.0,146.0,146.0
708.0,17,2,508,2,508,0.0,257.0,254.0,0,0,0.0,0.0,0.0
2219.0,17,2,932,1,590,0.0,590.0,590.0,1,342,0.0,342.0,342.0
42945.0,6,14,4740,7,653,6703.833333333333,249.0,93.28571428571428,7,4087,6888.333333333333,1514.0,583.8571428571429
2022553.0,17,4,525,2,150,0.0,75.0,75.0,2,375,0.0,284.0,187.5
260665.0,6,10,1221,6,636,52133.0,298.0,106.0,4,585,81137.33333333333,379.0,146.25
107851398.0,6,28,1860,14,966,8279655.769230769,123.0,69.0,14,894,8279647.692307692,123.0,63.85714285714285
204979.0,17,2,180,1,90,0.0,90.0,90.0,1,90,0.0,90.0,90.0
228211.0,17,2,180,1,90,0.0,90.0,90.0,1,90,0.0,90.0,90.0
135125360.0,17,6,1206,6,1206,27025072.0,201.0,201.0,0,0,0.0,0.0,0.0
121125.0,6,3,373,2,238,0.0,172.0,119.0,1,135,0.0,135.0,135.0
103175.0,17,2,762,2,762,0.0,381.0,381.0,0,0,0.0,0.0,0.0
135131793.0,17,6,1146,6,1146,27026358.6,191.0,191.0,0,0,0.0,0.0,0.0
1236394.0,17,7,490,7,490,206065.66666666663,70.0,70.0,0,0,0.0,0.0,0.0
90029935.0,17,27,12943,27,12943,3462689.8076923075,501.0,479.3703703703704,0,0,0.0,0.0,0.0
826.0,17,4,438,2,148,0.0,74.0,74.0,2,290,0.0,147.0,145.0
36380.0,6,14,4740,7,653,5940.666666666667,249.0,93.28571428571428,7,4087,5555.0,1514.0,583.8571428571429
184427.0,17,2,180,1,90,0.0,90.0,90.0,1,90,0.0,90.0,90.0
1289359.0,17,7,490,7,490,214893.16666666663,70.0,70.0,0,0,0.0,0.0,0.0
14629013.0,6,20,1607,10,975,1592328.111111111,315.0,97.5,10,632,1592303.3333333333,78.0,63.2
42178.0,6,14,4740,7,653,6872.166666666667,249.0,93.28571428571428,7,4087,6342.166666666667,1514.0,583.8571428571429
108098906.0,17,5,955,5,955,27024726.5,191.0,191.0,0,0,0.0,0.0,0.0
61764.0,6,14,4740,7,653,7454.666666666667,249.0,93.28571428571428,7,4087,9626.666666666666,1514.0,583.8571428571429
153489.0,17,2,180,1,90,0.0,90.0,90.0,1,90,0.0,90.0,90.0
36265.0,6,10,2032,5,524,8788.5,252.0,104.8,5,1508,8547.5,1236.0,301.6
216590.0,6,3,426,2,280,0.0,214.0,140.0,1,146,0.0,146.0,146.0
34278413.0,6,26,7627,14,3735,193487.3076923077,1514.0,266.7857142857143,12,3892,3097596.5454545454,1514.0,324.3333333333333
253961.0,6,3,337,2,214,0.0,160.0,107.0,1,123,0.0,123.0,123.0
2591049.0,6,2,132,1,66,0.0,66.0,66.0,1,66,0.0,66.0,66.0
162325.0,17,2,180,1,90,0.0,90.0,90.0,1,90,0.0,90.0,90.0
732.0,17,2,762,2,762,0.0,381.0,381.0,0,0,0.0,0.0,0.0
90043233.0,6,13,989,6,447,12050981.8,95.0,74.5,7,542,15005755.0,95.0,77.42857142857143
42300.0,6,14,4740,7,653,6928.666666666667,249.0,93.28571428571428,7,4087,6914.333333333333,1514.0,583.8571428571429
119344229.0,6,235,26520,118,8010,1020036.1452991453,140.0,67.88135593220339,117,18510,1023396.198275862,284.0,158.2051282051282
108105743.0,17,5,1005,5,1005,27026435.75,201.0,201.0,0,0,0.0,0.0,0.0
5619218.0,6,4,270,2,134,0.0,68.0,67.0,2,136,0.0,70.0,68.0
247165.0,17,2,180,1,90,0.0,90.0,90.0,1,90,0.0,90.0,90.0
123973098.0,6,33,2296,17,1225,7748318.625,139.0,72.05882352941177,16,1071,7584670.933333334,123.0,66.9375
1086.0,17,4,438,2,148,0.0,74.0,74.0,2,290,0.0,147.0,145.0
543035.0,6,2,132,1,66,0.0,66.0,66.0,1,66,0.0,66.0,66.0
5620027.0,6,5,336,2,134,0.0,68.0,67.0,3,202,1421858.0,70.0,67.33333333333333
29824.0,6,14,4740,7,653,4631.0,249.0,93.28571428571428,7,4087,4568.5,1514.0,583.8571428571429
0.0,17,1,90,1,90,0.0,90.0,90.0,0,0,0.0,0.0,0.0
3721.0,17,4,344,2,150,0.0,75.0,75.0,2,194,0.0,103.0,97.0
155670.0,17,2,180,1,90,0.0,90.0,90.0,1,90,0.0,90.0,90.0
206898.0,6,4,492,2,280,0.0,214.0,140.0,2,212,0.0,146.0,106.0
307762.0,6,6,412,4,272,102587.33333333331,74.0,68.0,2,140,0.0,74.0,70.0
242050.0,6,3,337,2,214,0.0,160.0,107.0,1,123,0.0,123.0,123.0
228544.0,17,2,180,1,90,0.0,90.0,90.0,1,90,0.0,90.0,90.0
106737.0,17,2,286,2,286,0.0,143.0,143.0,0,0,0.0,0.0,0.0
122687714.0,6,48,3168,24,1584,4988187.956521739,66.0,66.0,24,1584,5220129.130434782,66.0,66.0
105891.0,17,2,286,2,286,0.0,143.0,143.0,0,0,0.0,0.0,0.0
90255894.0,6,12,1832,8,1016,12893699.142857144,188.0,127.0,4,816,30031138.33333333,204.0,204.0
4231.0,17,2,598,1,72,0.0,72.0,72.0,1,526,0.0,526.0,526.0
219601.0,6,3,426,2,280,0.0,214.0,140.0,1,146,0.0,146.0,146.0
0.0,17,1,44,1,44,0.0,44.0,44.0,0,0,0.0,0.0,0.0
92828317.0,6,38,2508,19,1254,5157108.555555556,66.0,66.0,19,1254,5157106.944444444,66.0,66.0
33777.0,6,2,145,2,145,0.0,91.0,72.5,0,0,0.0,0.0,0.0
108102797.0,17,5,1005,5,1005,27025699.25,201.0,201.0,0,0,0.0,0.0,0.0
96152538.0,6,29,2068,15,1105,6852620.642857143,139.0,73.66666666666667,14,963,7379746.307692308,123.0,68.78571428571429
9544.0,17,4,823,2,163,0.0,89.0,81.5,2,660,0.0,443.0,330.0
9280.0,6,10,1065,5,534,2084.25,262.0,106.8,5,531,2115.25,259.0,106.2
118095875.0,6,48,3168,24,1584,5134603.260869565,66.0,66.0,24,1584,5125216.478260869,66.0,66.0
106741.0,17,2,286,2,286,0.0,143.0,143.0,0,0,0.0,0.0,0.0
303693.0,6,6,412,4,272,101231.0,74.0,68.0,2,140,0.0,74.0,70.0
93162669.0,6,32,2490,17,1335,5809173.1875,123.0,78.52941176470588,15,1155,6639057.142857143,123.0,77.0
48945264.0,6,7,2047,5,1153,12236316.0,885.0,230.6,2,894,0.0,826.0,447.0
481376.0,6,3,204,1,68,0.0,68.0,68.0,2,136,0.0,70.0,68.0
125010062.0,17,15,1169,8,606,17858580.285714287,174.0,75.75,7,563,17500169.666666668,174.0,80.42857142857143
11294.0,6,13,1459,7,862,1771.1666666666667,271.0,123.14285714285714,6,597,2078.4,259.0,99.5
393282.0,17,2,363,1,75,0.0,75.0,75.0,1,288,0.0,288.0,288.0
706.0,17,4,438,2,148,0.0,74.0,74.0,2,290,0.0,147.0,145.0
108102183.0,17,5,955,5,955,27025545.75,191.0,191.0,0,0,0.0,0.0,0.0
304257.0,6,6,412,4,272,101419.0,74.0,68.0,2,140,0.0,74.0,70.0
135125485.0,17,6,1146,6,1146,27025097.0,191.0,191.0,0,0,0.0,0.0,0.0
220741.0,17,2,180,1,90,0.0,90.0,90.0,1,90,0.0,90.0,90.0
294115.0,17,2,246,1,76,0.0,76.0,76.0,1,170,0.0,170.0,170.0
56628.0,6,14,4740,7,653,9305.166666666666,249.0,93.28571428571428,7,4087,8114.5,1514.0,583.8571428571429
1302672.0,6,4,264,2,132,0.0,66.0,66.0,2,132,0.0,66.0,66.0
135120040.0,17,6,1146,6,1146,27024008.0,191.0,191.0,0,0,0.0,0.0,0.0
122687867.0,6,48,3168,24,1584,5076237.173913044,66.0,66.0,24,1584,5132099.869565218,66.0,66.0
108110840.0,17,5,1005,5,1005,27027710.0,201.0,201.0,0,0,0.0,0.0,0.0
2797058.0,6,2,132,1,66,0.0,66.0,66.0,1,66,0.0,66.0,66.0
307743.0,17,4,1400,4,1400,102581.0,350.0,350.0,0,0,0.0,0.0,0.0
98198.0,6,14,4740,7,653,16211.833333333334,249.0,93.28571428571428,7,4087,16224.5,1514.0,583.8571428571429
135131922.0,17,6,1146,6,1146,27026384.4,191.0,191.0,0,0,0.0,0.0,0.0
299413.0,6,7,478,4,272,99804.33333333331,74.0,68.0,3,206,74561.0,74.0,68.66666666666667
103695076.0,6,489,62274,245,45948,424979.8196721312,374.0,187.5428571428572,244,16326,424989.1440329218,140.0,66.90983606557377
887204.0,6,9,1268,6,797,177440.8,459.0,132.83333333333334,3,471,305910.5,331.0,157.0
90095563.0,6,12,1848,5,1020,22523296.5,204.0,204.0,7,828,15015532.333333334,188.0,118.28571428571428
108091889.0,17,5,955,5,955,27022972.25,191.0,191.0,0,0,0.0,0.0,0.0
62656.0,6,14,4740,7,653,9842.166666666666,249.0,93.28571428571428,7,4087,9450.333333333334,1514.0,583.8571428571429
108098113.0,17,5,1005,5,1005,27024528.25,201.0,201.0,0,0,0.0,0.0,0.0
103313689.0,6,42,2772,21,1386,5150442.45,66.0,66.0,21,1386,5150444.3,66.0,66.0
303908.0,6,6,412,4,272,101302.66666666669,74.0,68.0,2,140,0.0,74.0,70.0
90029082.0,17,27,12943,27,12943,3462657.0,501.0,479.3703703703704,0,0,0.0,0.0,0.0
120008030.0,17,28,13364,28,13364,4444741.851851852,501.0,477.2857142857143,0,0,0.0,0.0,0.0
2847498.0,6,4,270,3,202,1423749.0,70.0,67.33333333333333,1,68,0.0,68.0,68.0
26476.0,6,10,1066,5,490,6265.5,218.0,98.0,5,576,6089.5,304.0,115.2
2054.0,17,4,344,2,150,0.0,75.0,75.0,2,194,0.0,103.0,97.0
114227784.0,6,648,90336,324,21618,353570.8359133127,140.0,66.72222222222223,324,68718,351092.1919504644,480.0,212.09259259259247
251214.0,6,3,373,2,238,0.0,172.0,119.0,1,135,0.0,135.0,135.0
90261236.0,6,14,2240,8,1016,12894462.285714284,188.0,127.0,6,1224,18019848.0,204.0,204.0
120123412.0,6,14,2224,9,1204,15015426.5,188.0,133.77777777777777,5,1020,22523222.75,204.0,204.0
234516.0,6,3,337,2,214,0.0,160.0,107.0,1,123,0.0,123.0,123.0
14650352.0,6,20,1607,10,975,1593375.7777777778,315.0,97.5,10,632,1593295.5555555555,78.0,63.2
90165007.0,6,12,1710,5,882,22539959.25,204.0,176.4,7,828,15027261.666666666,188.0,118.28571428571428
9654.0,17,2,566,1,83,0.0,83.0,83.0,1,483,0.0,483.0,483.0
22190.0,6,14,4740,7,653,3151.6666666666665,249.0,93.28571428571428,7,4087,3556.0,1514.0,583.8571428571429
0.0,17,1,179,1,179,0.0,179.0,179.0,0,0,0.0,0.0,0.0
135133887.0,17,6,1146,6,1146,27026777.4,191.0,191.0,0,0,0.0,0.0,0.0
2374.0,17,4,344,2,150,0.0,75.0,75.0,2,194,0.0,103.0,97.0
4239.0,17,2,598,1,72,0.0,72.0,72.0,1,526,0.0,526.0,526.0
90768638.0,6,22,1680,12,935,8247715.818181818,95.0,77.91666666666667,10,745,10000185.777777778,95.0,74.5
38755.0,6,10,2032,5,524,8908.75,252.0,104.8,5,1508,9165.75,1236.0,301.6
9250.0,17,2,539,1,86,0.0,86.0,86.0,1,453,0.0,453.0,453.0
90257740.0,6,13,2036,8,1016,12893962.857142856,188.0,127.0,5,1020,22523392.0,204.0,204.0
103412.0,17,2,762,2,762,0.0,381.0,381.0,0,0,0.0,0.0,0.0
302370.0,6,2,132,1,66,0.0,66.0,66.0,1,66,0.0,66.0,66.0
147056.0,6,3,373,2,238,0.0,172.0,119.0,1,135,0.0,135.0,135.0
46087.0,6,10,2032,5,524,11045.5,252.0,104.8,5,1508,11078.0,1236.0,301.6
5013834.0,17,4,1164,2,166,0.0,83.0,83.0,2,998,0.0,499.0,499.0
242081.0,6,3,373,2,238,0.0,172.0,119.0,1,135,0.0,135.0,135.0
1037258.0,6,11,1134,6,558,207451.6,220.0,93.0,5,576,257943.0,304.0,115.2
101668144.0,6,27,1816,14,894,7820626.461538462,123.0,63.85714285714285,13,922,7622144.083333333,139.0,70.92307692307692
1417667.0,17,16,1120,16,1120,94511.13333333332,70.0,70.0,0,0,0.0,0.0,0.0
135124616.0,17,6,1206,6,1206,27024923.2,201.0,201.0,0,0,0.0,0.0,0.0
108685556.0,6,29,2052,15,1089,7747826.642857143,123.0,72.6,14,963,8343673.307692308,123.0,68.78571428571429
587142.0,6,4,508,2,238,0.0,172.0,119.0,2,270,0.0,135.0,135.0
0.0,6,1,54,1,54,0.0,54.0,54.0,0,0,0.0,0.0,0.0
10513159.0,6,7,478,4,272,3459125.333333333,74.0,68.0,3,206,5188555.5,74.0,68.66666666666667
18140.0,6,14,4740,7,653,2596.833333333333,249.0,93.28571428571428,7,4087,2813.833333333333,1514.0,583.8571428571429
22980577.0,17,3,1034,2,684,0.0,342.0,342.0,1,350,0.0,350.0,350.0
204694.0,17,2,762,2,762,0.0,381.0,381.0,0,0,0.0,0.0,0.0
1990.0,17,4,344,2,150,0.0,75.0,75.0,2,194,0.0,103.0,97.0
25579.0,6,10,2032,5,524,6176.25,252.0,104.8,5,1508,5670.5,1236.0,301.6
303984.0,6,6,412,4,272,101328.0,74.0,68.0,2,140,0.0,74.0,70.0
90025982.0,17,28,13364,28,13364,3334295.6296296297,501.0,477.2857142857143,0,0,0.0,0.0,0.0
525050.0,6,3,1604,1,753,0.0,753.0,753.0,2,851,0.0,785.0,425.5
90268406.0,6,14,2240,8,1016,12895486.57142857,188.0,127.0,6,1224,18018358.4,204.0,204.0
310663.0,17,4,1400,4,1400,103554.33333333331,350.0,350.0,0,0,0.0,0.0,0.0
204263.0,17,2,762,2,762,0.0,381.0,381.0,0,0,0.0,0.0,0.0
3007815.0,6,12,2172,7,664,501162.1666666667,252.0,94.85714285714286,5,1508,2224.5,1236.0,301.6
157832.0,17,2,180,1,90,0.0,90.0,90.0,1,90,0.0,90.0,90.0
76704.0,6,14,4740,7,653,11066.5,249.0,93.28571428571428,7,4087,11872.166666666666,1514.0,583.8571428571429
303540.0,6,6,412,4,272,101180.0,74.0,68.0,2,140,0.0,74.0,70.0
90055343.0,17,28,13364,28,13364,3335383.074074074,501.0,477.2857142857143,0,0,0.0,0.0,0.0
90326300.0,6,16,1192,8,596,12897994.285714284,95.0,74.5,8,596,12902814.142857144,95.0,74.5
108109148.0,17,5,955,5,955,27027287.0,191.0,191.0,0,0,0.0,0.0,0.0
65369.0,6,14,4740,7,653,10651.333333333334,249.0,93.28571428571428,7,4087,10539.333333333334,1514.0,583.8571428571429
2915807.0,6,3,1604,2,851,0.0,785.0,425.5,1,753,0.0,753.0,753.0
135126007.0,17,6,1206,6,1206,27025201.4,201.0,201.0,0,0,0.0,0.0,0.0
67345.0,6,10,2032,5,524,15644.0,252.0,104.8,5,1508,15045.75,1236.0,301.6
303654.0,6,2,132,1,66,0.0,66.0,66.0,1,66,0.0,66.0,66.0
135129320.0,17,6,1206,6,1206,27025864.0,201.0,201.0,0,0,0.0,0.0,0.0
0.0,6,1,66,1,66,0.0,66.0,66.0,0,0,0.0,0.0,0.0
108117.0,17,2,286,2,286,0.0,143.0,143.0,0,0,0.0,0.0,0.0
99543.0,6,14,4740,7,653,16379.0,249.0,93.28571428571428,7,4087,15917.0,1514.0,583.8571428571429
65226.99999999999,6,10,2032,5,524,15959.75,252.0,104.8,5,1508,16049.75,1236.0,301.6
135127175.0,17,6,1206,6,1206,27025435.0,201.0,201.0,0,0,0.0,0.0,0.0
311729.0,17,4,1400,4,1400,103909.66666666669,350.0,350.0,0,0,0.0,0.0,0.0
108105048.0,17,5,1005,5,1005,27026262.0,201.0,201.0,0,0,0.0,0.0,0.0
505093.0,6,5,336,2,134,0.0,68.0,67.0,3,202,193037.5,70.0,67.33333333333333
100300700.0,6,184,20760,92,14466,1099840.6703296704,284.0,157.2391304347826,92,6294,1099840.956043956,140.0,68.41304347826087
90295456.0,6,21,1585,11,840,9024445.0,95.0,76.36363636363636,10,745,10000402.333333334,95.0,74.5
2422.0,17,4,344,2,150,0.0,75.0,75.0,2,194,0.0,103.0,97.0
8991.0,17,2,539,1,86,0.0,86.0,86.0,1,453,0.0,453.0,453.0
207331.0,6,3,426,2,280,0.0,214.0,140.0,1,146,0.0,146.0,146.0
90286384.0,6,21,1585,11,840,9023991.2,95.0,76.36363636363636,10,745,10000878.777777778,95.0,74.5
153478.0,17,2,180,1,90,0.0,90.0,90.0,1,90,0.0,90.0,90.0
3039.0,17,2,224,1,76,0.0,76.0,76.0,1,148,0.0,148.0,148.0
36724.0,6,14,4740,7,653,5851.833333333333,249.0,93.28571428571428,7,4087,5874.5,1514.0,583.8571428571429
219177.0,6,3,426,2,280,0.0,214.0,140.0,1,146,0.0,146.0,146.0
120126023.0,6,14,2224,9,1204,15015752.875,188.0,133.77777777777777,5,1020,22592062.25,204.0,204.0
156641.0,6,3,337,2,214,0.0,160.0,107.0,1,123,0.0,123.0,123.0
1475875.0,17,16,1120,16,1120,98391.66666666669,70.0,70.0,0,0,0.0,0.0,0.0
97695178.0,6,165,18618,83,5712,1191404.6097560977,140.0,68.81927710843374,82,12906,1196558.4197530863,284.0,157.390243902439
42359.0,6,14,4740,7,653,6843.0,249.0,93.28571428571428,7,4087,6919.166666666667,1514.0,583.8571428571429
56056.0,6,14,4740,7,653,8374.333333333334,249.0,93.28571428571428,7,4087,8022.333333333333,1514.0,583.8571428571429
125801647.0,6,54,11620,28,5907,3558896.407407407,1514.0,210.9642857142857,26,5713,5023846.24,1514.0,219.73076923076923
5622632.0,6,5,336,2,134,0.0,68.0,67.0,3,202,1417361.0,70.0,67.33333333333333
332979.0,6,3,204,2,136,0.0,70.0,68.0,1,68,0.0,68.0,68.0
13930567.0,6,18,1495,9,921,1703940.375,315.0,102.33333333333331,9,574,1703904.75,78.0,63.77777777777778
10466836.0,6,7,478,4,272,3443444.6666666665,74.0,68.0,3,206,5165064.0,74.0,68.66666666666667
47923673.0,6,7,2047,5,1153,11980918.25,885.0,230.6,2,894,0.0,826.0,447.0
912398.0,6,10,1334,6,797,182479.6,459.0,132.83333333333334,4,537,212251.66666666663,331.0,134.25
88311.0,6,10,1065,5,534,21194.0,262.0,106.8,5,531,3210.0,259.0,106.2
209431.0,17,2,180,1,90,0.0,90.0,90.0,1,90,0.0,90.0,90.0
121114092.0,6,47,3102,23,1518,5150438.181818182,66.0,66.0,24,1584,5252742.652173913,66.0,66.0
206160.0,6,3,426,2,280,0.0,214.0,140.0,1,146,0.0,146.0,146.0
19830.0,17,2,582,1,83,0.0,83.0,83.0,1,499,0.0,499.0,499.0
314.0,17,2,174,1,79,0.0,79.0,79.0,1,95,0.0,95.0,95.0
121776848.0,6,32,2226,17,1209,7611053.0,123.0,71.11764705882354,15,1017,7969804.357142857,123.0,67.8
218007.0,6,3,426,2,280,0.0,214.0,140.0,1,146,0.0,146.0,146.0
43598.0,6,14,4740,7,653,6402.833333333333,249.0,93.28571428571428,7,4087,5695.666666666667,1514.0,583.8571428571429
135136209.0,17,6,1146,6,1146,27027241.8,191.0,191.0,0,0,0.0,0.0,0.0
120243898.0,6,21,1909,10,745,13333132.666666666,95.0,74.5,11,1164,11999999.8,257.0,105.8181818181818
106087810.0,6,44,2904,22,1452,5051800.476190476,66.0,66.0,22,1452,5041510.619047619,66.0,66.0
41008.0,6,14,4740,7,653,6711.0,249.0,93.28571428571428,7,4087,6620.0,1514.0,583.8571428571429
117332141.0,6,52,4434,29,2433,4182731.392857143,123.0,83.89655172413794,23,2001,5322588.681818182,123.0,87.0
19686.0,6,10,1067,5,536,4742.25,264.0,107.2,5,531,4196.5,259.0,106.2
147025.0,6,3,373,2,238,0.0,172.0,119.0,1,135,0.0,135.0,135.0
48746.0,6,10,2032,5,524,10611.75,252.0,104.8,5,1508,10869.75,1236.0,301.6
31092.0,6,10,2032,5,524,6818.25,252.0,104.8,5,1508,6670.5,1236.0,301.6
90310626.0,6,16,1192,8,596,12895009.857142856,95.0,74.5,8,596,12900078.0,95.0,74.5
305287.0,6,6,412,4,272,101762.33333333331,74.0,68.0,2,140,0.0,74.0,70.0
2349.0,17,4,344,2,150,0.0,75.0,75.0,2,194,0.0,103.0,97.0
226195.0,6,3,426,2,280,0.0,214.0,140.0,1,146,0.0,146.0,146.0
107561.0,17,2,286,2,286,0.0,143.0,143.0,0,0,0.0,0.0,0.0
168094.0,17,4,1400,4,1400,56031.333333333336,350.0,350.0,0,0,0.0,0.0,0.0
38723.0,6,14,4740,7,653,6233.666666666667,249.0,93.28571428571428,7,4087,5917.833333333333,1514.0,583.8571428571429
37757.0,6,10,1067,5,536,7540.75,264.0,107.2,5,531,5967.0,259.0,106.2
686.0,17,2,762,2,762,0.0,381.0,381.0,0,0,0.0,0.0,0.0
120332145.0,6,227,25690,114,17936,1064886.2389380531,284.0,157.33333333333334,113,7754,1065159.7589285714,140.0,68.61946902654867
754.0,17,4,438,2,148,0.0,74.0,74.0,2,290,0.0,147.0,145.0
146418.0,6,3,337,2,214,0.0,160.0,107.0,1,123,0.0,123.0,123.0
309370.0,6,6,412,4,272,103123.33333333331,74.0,68.0,2,140,0.0,74.0,70.0
37277.0,6,14,4740,7,653,4449.166666666667,249.0,93.28571428571428,7,4087,6035.333333333333,1514.0,583.8571428571429
40472.0,6,14,4740,7,653,6620.0,249.0,93.28571428571428,7,4087,6607.666666666667,1514.0,583.8571428571429
155057.0,6,3,337,2,214,0.0,160.0,107.0,1,123,0.0,123.0,123.0
221586.0,6,3,426,2,280,0.0,214.0,140.0,1,146,0.0,146.0,146.0
165854.0,17,2,180,1,90,0.0,90.0,90.0,1,90,0.0,90.0,90.0
120361596.0,6,208,23536,104,7160,1160527.8252427184,140.0,68.84615384615384,104,16376,1160440.417475728,284.0,157.46153846153845
107671.0,17,2,286,2,286,0.0,143.0,143.0,0,0,0.0,0.0,0.0
687988.0,6,4,508,2,238,0.0,172.0,119.0,2,270,0.0,135.0,135.0
123730644.0,6,49,3234,25,1650,5155443.5,66.0,66.0,24,1584,5094999.565217392,66.0,66.0
117672514.0,6,48,3958,27,2203,4517568.923076923,139.0,81.5925925925926,21,1755,5872840.35,123.0,83.57142857142857
643.0,17,2,508,2,508,0.0,257.0,254.0,0,0,0.0,0.0,0.0
99054.0,17,4,1400,4,1400,33018.0,350.0,350.0,0,0,0.0,0.0,0.0
2315151.0,6,19,6869,10,1501,257239.0,408.0,150.1,9,5368,246563.875,1514.0,596.4444444444445
90316560.0,6,19,1436,10,745,10029540.222222222,95.0,74.5,9,691,11288544.875,95.0,76.77777777777777
2801440.0,6,2,132,1,66,0.0,66.0,66.0,1,66,0.0,66.0,66.0
2969.0,17,2,224,1,76,0.0,76.0,76.0,1,148,0.0,148.0,148.0
143935.0,17,2,180,1,90,0.0,90.0,90.0,1,90,0.0,90.0,90.0
90737403.0,6,19,1436,10,745,10077308.222222222,95.0,74.5,9,691,11341743.375,95.0,76.77777777777777
2413.0,17,4,344,2,150,0.0,75.0,75.0,2,194,0.0,103.0,97.0
357.0,17,2,248,1,84,0.0,84.0,84.0,1,164,0.0,164.0,164.0
218201.0,6,3,426,2,280,0.0,214.0,140.0,1,146,0.0,146.0,146.0
352.0,17,2,267,1,83,0.0,83.0,83.0,1,184,0.0,184.0,184.0
90035709.0,17,28,13364,28,13364,3334655.888888889,501.0,477.2857142857143,0,0,0.0,0.0,0.0
34146.0,6,14,4740,7,653,5560.166666666667,249.0,93.28571428571428,7,4087,5554.5,1514.0,583.8571428571429
114346115.0,6,36,2596,18,1348,6713521.352941177,139.0,74.88888888888889,18,1248,6713532.470588235,123.0,69.33333333333333
297581.0,6,6,412,4,272,99193.66666666669,74.0,68.0,2,140,0.0,74.0,70.0
35072.0,6,11,2098,6,590,3848.0,252.0,98.33333333333331,5,1508,8136.5,1236.0,301.6
300871.0,6,6,412,4,272,100290.33333333331,74.0,68.0,2,140,0.0,74.0,70.0
2544867.0,6,145,112301,78,104034,29053.948051948053,1510.0,1333.7692307692307,67,8267,33964.65151515151,1510.0,123.38805970149254
303.0,17,2,164,1,82,0.0,82.0,82.0,1,82,0.0,82.0,82.0
153408.0,17,2,180,1,90,0.0,90.0,90.0,1,90,0.0,90.0,90.0
113617910.0,6,46,3036,23,1518,5150437.909090909,66.0,66.0,23,1518,5150428.409090909,66.0,66.0
40441.0,6,14,4740,7,653,6044.666666666667,249.0,93.28571428571428,7,4087,5247.5,1514.0,583.8571428571429
5625389.0,6,5,336,2,134,0.0,68.0,67.0,3,202,1527102.5,70.0,67.33333333333333
103128.0,17,2,286,2,286,0.0,143.0,143.0,0,0,0.0,0.0,0.0
2369.0,17,4,344,2,150,0.0,75.0,75.0,2,194,0.0,103.0,97.0
2802899.0,6,2,132,1,66,0.0,66.0,66.0,1,66,0.0,66.0,66.0
37508.0,6,14,4740,7,653,5141.166666666667,249.0,93.28571428571428,7,4087,6112.0,1514.0,583.8571428571429
153509.0,17,2,180,1,90,0.0,90.0,90.0,1,90,0.0,90.0,90.0
119077309.0,6,26,1978,12,935,10825209.909090908,95.0,77.91666666666667,14,1043,9139948.0,95.0,74.5
216555.0,6,3,426,2,280,0.0,214.0,140.0,1,146,0.0,146.0,146.0
196858.0,17,2,180,1,90,0.0,90.0,90.0,1,90,0.0,90.0,90.0
242179.0,6,3,337,2,214,0.0,160.0,107.0,1,123,0.0,123.0,123.0
996000.0,6,4,264,2,132,0.0,66.0,66.0,2,132,0.0,66.0,66.0
100623.0,6,2,132,1,66,0.0,66.0,66.0,1,66,0.0,66.0,66.0
2276558.0,6,25,7573,14,3735,175119.84615384616,1514.0,266.7857142857143,11,3838,202873.3,1514.0,348.90909090909093
123418509.0,6,48,3168,24,1584,4974883.304347826,66.0,66.0,24,1584,5326778.695652174,66.0,66.0
102145857.0,6,33,2428,17,1288,6370615.75,139.0,75.76470588235294,16,1140,6795321.666666667,123.0,71.25
508377.0,6,5,336,2,134,0.0,68.0,67.0,3,202,192590.0,70.0,67.33333333333333
106225735.0,6,208,23562,104,16476,1029217.1650485436,300.0,158.42307692307693,104,7086,1029216.7572815532,140.0,68.13461538461539
144013.0,17,2,180,1,90,0.0,90.0,90.0,1,90,0.0,90.0,90.0
9277.0,17,2,539,1,86,0.0,86.0,86.0,1,453,0.0,453.0,453.0
119000964.0,17,13,821,7,432,19833494.0,174.0,61.71428571428572,6,389,19801355.0,174.0,64.83333333333333
22948479.0,17,5,1718,4,1368,1073517.0,342.0,342.0,1,350,0.0,350.0,350.0
108649551.0,6,32,2236,16,1165,7229618.6,139.0,72.8125,16,1071,7229628.266666667,123.0,66.9375
322820.0,17,4,1400,4,1400,107606.66666666669,350.0,350.0,0,0,0.0,0.0,0.0
102708708.0,6,41,2706,21,1386,5135435.4,66.0,66.0,20,1320,5115331.263157895,66.0,66.0
103404.0,17,2,286,2,286,0.0,143.0,143.0,0,0,0.0,0.0,0.0
3174587.0,6,18,1495,9,921,358329.125,315.0,102.33333333333331,9,574,358305.625,78.0,63.77777777777778
2120.0,17,4,344,2,150,0.0,75.0,75.0,2,194,0.0,103.0,97.0
90055097.0,17,28,13364,28,13364,3335373.962962963,501.0,477.2857142857143,0,0,0.0,0.0,0.0
118399999.0,6,34,2350,17,1225,7386518.9375,139.0,72.05882352941177,17,1125,7386515.125,123.0,66.17647058823529
5005611.0,17,4,849,2,166,0.0,83.0,83.0,2,683,0.0,499.0,341.5
277746.0,6,10,1221,6,636,55549.2,298.0,106.0,4,585,86703.66666666667,379.0,146.25
206237.0,6,3,426,2,280,0.0,214.0,140.0,1,146,0.0,146.0,146.0
90037477.0,17,27,12943,27,12943,3462979.8846153845,501.0,479.3703703703704,0,0,0.0,0.0,0.0
20193.0,6,14,4740,7,653,2819.333333333333,249.0,93.28571428571428,7,4087,3181.333333333333,1514.0,583.8571428571429
216465.0,17,2,180,1,90,0.0,90.0,90.0,1,90,0.0,90.0,90.0
47399.0,6,14,4740,7,653,7683.166666666667,249.0,93.28571428571428,7,4087,6706.5,1514.0,583.8571428571429
10093.0,17,2,582,1,83,0.0,83.0,83.0,1,499,0.0,499.0,499.0
32314.000000000004,6,14,4740,7,653,5052.666666666667,249.0,93.28571428571428,7,4087,5161.0,1514.0,583.8571428571429
285243.0,17,2,180,1,90,0.0,90.0,90.0,1,90,0.0,90.0,90.0
12091901.0,6,33,8878,17,4676,755743.8125,1514.0,275.05882352941177,16,4202,600379.2,1514.0,262.625
217700.0,6,3,426,2,280,0.0,214.0,140.0,1,146,0.0,146.0,146.0
10863980.0,6,8,544,4,272,3576131.6666666665,74.0,68.0,4,272,3576070.0,74.0,68.0
50267.0,6,10,2032,5,524,12128.0,252.0,104.8,5,1508,11810.25,1236.0,301.6
42974.0,6,10,2032,5,524,9821.75,252.0,104.8,5,1508,10387.75,1236.0,301.6
90269433.0,6,14,2240,8,1016,12895633.285714284,188.0,127.0,6,1224,18021290.2,204.0,204.0
135136942.0,17,6,1146,6,1146,27027388.4,191.0,191.0,0,0,0.0,0.0,0.0
205687.0,6,3,426,2,280,0.0,214.0,140.0,1,146,0.0,146.0,146.0
279603.0,17,2,180,1,90,0.0,90.0,90.0,1,90,0.0,90.0,90.0
161616.0,17,2,180,1,90,0.0,90.0,90.0,1,90,0.0,90.0,90.0
254471.0,6,3,337,2,214,0.0,160.0,107.0,1,123,0.0,123.0,123.0
305265.0,6,6,412,4,272,101755.0,74.0,68.0,2,140,0.0,74.0,70.0
119605421.0,6,236,26644,118,18560,1020419.658119658,284.0,157.28813559322035,118,8084,1020419.7264957264,140.0,68.50847457627118
131029.0,6,3,337,2,214,0.0,160.0,107.0,1,123,0.0,123.0,123.0
1039.0,17,4,438,2,148,0.0,74.0,74.0,2,290,0.0,147.0,145.0
296624.0,6,10,1221,6,636,59324.8,298.0,106.0,4,585,93441.33333333331,379.0,146.25
5824945.0,6,4,270,2,134,0.0,68.0,67.0,2,136,0.0,70.0,68.0
197056.0,17,2,180,1,90,0.0,90.0,90.0,1,90,0.0,90.0,90.0
330.0,17,2,160,1,80,0.0,80.0,80.0,1,80,0.0,80.0,80.0
120337732.0,6,226,25566,113,7680,1067085.5535714286,140.0,67.96460176991151,113,17886,1067066.6339285714,284.0,158.28318584070797
143964.0,17,2,180,1,90,0.0,90.0,90.0,1,90,0.0,90.0,90.0
228436.0,17,2,180,1,90,0.0,90.0,90.0,1,90,0.0,90.0,90.0
44002.0,6,10,2032,5,524,10773.25,252.0,104.8,5,1508,8959.5,1236.0,301.6
107334.0,17,2,286,2,286,0.0,143.0,143.0,0,0,0.0,0.0,0.0
283673.0,17,2,363,1,79,0.0,79.0,79.0,1,284,0.0,284.0,284.0
90027937.0,17,28,13364,28,13364,3334368.037037037,501.0,477.2857142857143,0,0,0.0,0.0,0.0
228250.0,17,2,180,1,90,0.0,90.0,90.0,1,90,0.0,90.0,90.0
191218.0,17,2,180,1,90,0.0,90.0,90.0,1,90,0.0,90.0,90.0
103494.0,17,2,286,2,286,0.0,143.0,143.0,0,0,0.0,0.0,0.0
90011947.0,17,27,12943,27,12943,3461997.961538461,501.0,479.3703703703704,0,0,0.0,0.0,0.0
219841.0,6,10,1221,6,636,43968.2,298.0,106.0,4,585,72021.66666666667,379.0,146.25
120000036.0,6,27,2952,14,1505,9230772.0,425.0,107.5,13,1447,9170759.083333334,334.0,111.3076923076923
105044620.0,6,44,2904,22,1452,5002124.761904762,66.0,66.0,22,1452,4987388.142857143,66.0,66.0
302.0,17,2,164,1,82,0.0,82.0,82.0,1,82,0.0,82.0,82.0
308620.0,6,6,412,4,272,102873.33333333331,74.0,68.0,2,140,0.0,74.0,70.0
2139886.0,6,24,7544,12,2450,193929.0,1034.0,204.16666666666663,12,5094,167079.81818181818,1510.0,424.5
162210.0,17,2,180,1,90,0.0,90.0,90.0,1,90,0.0,90.0,90.0
202990.0,17,2,180,1,90,0.0,90.0,90.0,1,90,0.0,90.0,90.0
90298621.0,6,16,1192,8,596,12892990.142857144,95.0,74.5,8,596,12897848.285714284,95.0,74.5
18864.0,6,2,145,2,145,0.0,91.0,72.5,0,0,0.0,0.0,0.0
58285.0,6,10,2032,5,524,14351.25,252.0,104.8,5,1508,14215.0,1236.0,301.6
52725.0,6,14,4740,7,653,7233.833333333333,249.0,93.28571428571428,7,4087,7616.5,1514.0,583.8571428571429
45761.0,6,10,2032,5,524,9850.75,252.0,104.8,5,1508,10874.0,1236.0,301.6
2417.0,17,4,344,2,150,0.0,75.0,75.0,2,194,0.0,103.0,97.0
3048738.0,6,3,204,2,136,0.0,70.0,68.0,1,68,0.0,68.0,68.0
900.0,17,5,550,5,550,225.0,110.0,110.0,0,0,0.0,0.0,0.0
119606598.0,6,222,25122,111,17574,1085376.1090909091,284.0,158.32432432432432,111,7548,1085375.9272727272,140.0,68.0
99982.0,17,2,762,2,762,0.0,381.0,381.0,0,0,0.0,0.0,0.0
14931.0,17,4,823,2,163,0.0,89.0,81.5,2,660,0.0,443.0,330.0
1059.0,17,4,438,2,148,0.0,74.0,74.0,2,290,0.0,147.0,145.0
113520552.0,6,46,3036,23,1518,5160013.7727272725,66.0,66.0,23,1518,5160013.909090909,66.0,66.0
48198.0,6,14,4740,7,653,6998.0,249.0,93.28571428571428,7,4087,5945.833333333333,1514.0,583.8571428571429
100923544.0,6,28,1876,14,982,7746511.230769231,139.0,70.14285714285714,14,894,7746672.923076923,123.0,63.85714285714285
177401.0,17,2,180,1,90,0.0,90.0,90.0,1,90,0.0,90.0,90.0
233158.0,6,3,337,2,214,0.0,160.0,107.0,1,123,0.0,123.0,123.0
120119997.0,6,15,2444,7,1428,20019999.5,204.0,204.0,8,1016,17098008.57142857,188.0,127.0
2788.0,17,5,550,5,550,697.0,110.0,110.0,0,0,0.0,0.0,0.0
51426875.0,17,4,360,2,180,0.0,90.0,90.0,2,180,0.0,90.0,90.0
50256.0,6,14,4740,7,653,7931.333333333333,249.0,93.28571428571428,7,4087,6937.666666666667,1514.0,583.8571428571429
496137.0,17,2,363,1,79,0.0,79.0,79.0,1,284,0.0,284.0,284.0
90030519.0,17,28,13364,28,13364,3334463.6666666665,501.0,477.2857142857143,0,0,0.0,0.0,0.0
2080778.0,6,19,6869,11,1567,208077.8,408.0,142.45454545454547,8,5302,235320.4285714285,1514.0,662.75
96728.0,17,2,762,2,762,0.0,381.0,381.0,0,0,0.0,0.0,0.0
100342.0,17,2,762,2,762,0.0,381.0,381.0,0,0,0.0,0.0,0.0
108009168.0,17,13,821,7,432,18001528.0,174.0,61.71428571428572,6,389,17600179.0,174.0,64.83333333333333
90532834.0,6,17,2572,9,1204,11316604.25,188.0,133.77777777777777,8,1368,12910056.714285716,204.0,171.0
2426.0,17,4,344,2,150,0.0,75.0,75.0,2,194,0.0,103.0,97.0
322941.0,6,6,412,4,272,107647.0,74.0,68.0,2,140,0.0,74.0,70.0
120052898.0,17,28,13364,28,13364,4446403.62962963,501.0,477.2857142857143,0,0,0.0,0.0,0.0
72172629.0,6,9,842,9,842,9021578.625,97.0,93.55555555555556,0,0,0.0,0.0,0.0
90261999.0,6,13,2036,8,1016,12894571.285714284,188.0,127.0,5,1020,22523623.75,204.0,204.0
151386.0,17,2,414,1,88,0.0,88.0,88.0,1,326,0.0,326.0,326.0
83.0,17,2,762,2,762,0.0,381.0,381.0,0,0,0.0,0.0,0.0
121521.0,6,3,337,2,214,0.0,160.0,107.0,1,123,0.0,123.0,123.0
90064097.0,17,27,12943,27,12943,3464003.730769231,501.0,479.3703703703704,0,0,0.0,0.0,0.0
304094.0,6,6,412,4,272,101364.66666666669,74.0,68.0,2,140,0.0,74.0,70.0
14146.0,6,14,4740,7,653,2181.833333333333,249.0,93.28571428571428,7,4087,2209.6666666666665,1514.0,583.8571428571429
792.0,17,4,438,2,148,0.0,74.0,74.0,2,290,0.0,147.0,145.0
34259.0,6,10,2032,5,524,8026.0,252.0,104.8,5,1508,8064.5,1236.0,301.6
120283397.0,6,212,23868,106,7218,1137715.704761905,140.0,68.09433962264151,106,16650,1137867.0380952382,284.0,157.0754716981132
50888.0,6,14,4740,7,653,8275.0,249.0,93.28571428571428,7,4087,8342.166666666666,1514.0,583.8571428571429
359.0,17,2,267,1,83,0.0,83.0,83.0,1,184,0.0,184.0,184.0
0.0,6,1,172,1,172,0.0,172.0,172.0,0,0,0.0,0.0,0.0
321503.0,6,6,412,4,272,107167.66666666669,74.0,68.0,2,140,0.0,74.0,70.0
1016682.0,6,13,1420,7,789,167740.0,253.0,112.71428571428572,6,631,201875.0,293.0,105.16666666666669
108112941.0,17,5,1005,5,1005,27028235.25,201.0,201.0,0,0,0.0,0.0,0.0
129663684.0,17,16,1212,8,606,15649400.285714284,174.0,75.75,8,606,17998393.14285714,174.0,75.75
2350.0,17,4,344,2,150,0.0,75.0,75.0,2,194,0.0,103.0,97.0
60214.0,6,14,4740,7,653,9876.166666666666,249.0,93.28571428571428,7,4087,9339.333333333334,1514.0,583.8571428571429
113168287.0,6,46,3036,23,1518,5143999.681818182,66.0,66.0,23,1518,5144000.363636363,66.0,66.0
300992.0,6,6,412,4,272,100330.66666666669,74.0,68.0,2,140,0.0,74.0,70.0
147518.0,6,2,132,1,66,0.0,66.0,66.0,1,66,0.0,66.0,66.0
147257.0,6,10,1066,5,490,36330.5,218.0,98.0,5,576,36518.75,304.0,115.2
2282.0,17,4,344,2,150,0.0,75.0,75.0,2,194,0.0,103.0,97.0
169258.0,17,2,414,1,88,0.0,88.0,88.0,1,326,0.0,326.0,326.0
191639.0,17,2,180,1,90,0.0,90.0,90.0,1,90,0.0,90.0,90.0
2301.0,17,4,344,2,150,0.0,75.0,75.0,2,194,0.0,103.0,97.0
5626953.0,6,4,270,2,134,0.0,68.0,67.0,2,136,0.0,70.0,68.0
109305097.0,17,14,864,7,432,18169223.0,174.0,61.71428571428572,7,432,18166815.166666668,174.0,61.71428571428572
46578608.0,6,8,1940,3,887,22094344.5,753.0,295.6666666666667,5,1053,11003051.0,785.0,210.6
20493.0,6,11,2098,6,590,3576.2,252.0,98.33333333333331,5,1508,4111.0,1236.0,301.6
108103963.0,17,5,955,5,955,27025990.75,191.0,191.0,0,0,0.0,0.0,0.0
105113.0,17,2,700,2,700,0.0,350.0,350.0,0,0,0.0,0.0,0.0
228933.0,6,3,426,2,280,0.0,214.0,140.0,1,146,0.0,146.0,146.0
437672.0,6,11,1021,6,444,58812.2,162.0,74.0,5,577,73303.75,349.0,115.4
3784330.0,6,5,336,2,134,0.0,68.0,67.0,3,202,1527755.0,70.0,67.33333333333333
58073.0,6,13,1386,7,789,9517.166666666666,253.0,112.71428571428572,6,597,8989.2,259.0,99.5
95957040.0,6,39,2574,20,1320,5050356.421052632,66.0,66.0,19,1254,5167990.833333333,66.0,66.0
318118.0,6,6,412,4,272,106039.33333333331,74.0,68.0,2,140,0.0,74.0,70.0
90280743.0,6,15,1097,8,596,12897249.0,95.0,74.5,7,501,14995697.0,95.0,71.57142857142857
310360.0,17,4,1400,4,1400,103453.33333333331,350.0,350.0,0,0,0.0,0.0,0.0
122714.0,6,10,2032,5,524,27951.25,252.0,104.8,5,1508,30220.5,1236.0,301.6
108110990.0,17,5,955,5,955,27027747.5,191.0,191.0,0,0,0.0,0.0,0.0
120682939.0,6,31,2182,15,1017,7906998.142857143,123.0,67.8,16,1165,7379836.933333334,139.0,72.8125
108075460.0,17,5,955,5,955,27018865.0,191.0,191.0,0,0,0.0,0.0,0.0
5007068.0,17,4,849,2,166,0.0,83.0,83.0,2,683,0.0,499.0,341.5
48048.0,6,14,4740,7,653,7462.833333333333,249.0,93.28571428571428,7,4087,7165.0,1514.0,583.8571428571429
103318085.0,6,42,2772,21,1386,5150438.25,66.0,66.0,21,1386,5150437.3,66.0,66.0
96243621.0,6,39,2574,20,1320,5048914.631578947,66.0,66.0,19,1254,5155451.722222222,66.0,66.0
3031338.0,6,12,2172,7,664,504869.6666666667,252.0,94.85714285714286,5,1508,7861.75,1236.0,301.6
2290.0,17,4,344,2,150,0.0,75.0,75.0,2,194,0.0,103.0,97.0
30138.0,6,10,2032,5,524,7310.0,252.0,104.8,5,1508,7207.75,1236.0,301.6
53931.0,6,12,1413,6,816,10238.2,291.0,136.0,6,597,8803.4,259.0,99.5
13170.0,6,11,1133,6,602,2634.0,264.0,100.33333333333331,5,531,2668.25,259.0,106.2
98650366.0,6,26,1746,13,906,8202879.5,123.0,69.6923076923077,13,840,8202838.666666667,123.0,64.61538461538461
90252473.0,6,16,2368,9,1204,11281559.125,188.0,133.77777777777777,7,1164,15014506.0,204.0,166.28571428571428
90946782.0,6,21,1585,11,840,9094007.0,95.0,76.36363636363636,10,745,10104228.0,95.0,74.5
526.0,17,2,762,2,762,0.0,381.0,381.0,0,0,0.0,0.0,0.0
5853.0,17,2,180,1,90,0.0,90.0,90.0,1,90,0.0,90.0,90.0
135126111.0,17,6,1146,6,1146,27025222.2,191.0,191.0,0,0,0.0,0.0,0.0
13937.0,17,2,180,1,90,0.0,90.0,90.0,1,90,0.0,90.0,90.0
305201.0,6,10,1221,6,636,61040.2,298.0,106.0,4,585,96357.66666666669,379.0,146.25
103710913.0,6,28,1876,14,982,7961093.769230769,139.0,70.14285714285714,14,894,7961137.692307692,123.0,63.85714285714285
120203.0,17,2,180,1,70,0.0,70.0,70.0,1,110,0.0,110.0,110.0
206118.0,17,2,180,1,90,0.0,90.0,90.0,1,90,0.0,90.0,90.0
103397.0,17,2,286,2,286,0.0,143.0,143.0,0,0,0.0,0.0,0.0
2592536.0,6,2,132,1,66,0.0,66.0,66.0,1,66,0.0,66.0,66.0
103596.0,17,2,286,2,286,0.0,143.0,143.0,0,0,0.0,0.0,0.0
234054.0,17,2,180,1,90,0.0,90.0,90.0,1,90,0.0,90.0,90.0
310101.0,6,3,202,2,128,0.0,74.0,64.0,1,74,0.0,74.0,74.0
114616984.0,6,47,3102,24,1584,4970259.130434782,66.0,66.0,23,1518,5150430.136363637,66.0,66.0
2455.0,17,4,344,2,150,0.0,75.0,75.0,2,194,0.0,103.0,97.0
31477.0,17,4,823,2,163,0.0,89.0,81.5,2,660,0.0,443.0,330.0
120082521.0,6,15,2444,7,1428,20013753.5,204.0,204.0,8,1016,17091273.285714287,188.0,127.0
452115.0,17,4,360,2,140,0.0,70.0,70.0,2,220,0.0,110.0,110.0
216479.0,17,2,180,1,90,0.0,90.0,90.0,1,90,0.0,90.0,90.0
108108805.0,17,5,955,5,955,27027201.25,191.0,191.0,0,0,0.0,0.0,0.0
90291763.0,6,16,1192,8,596,12892817.42857143,95.0,74.5,8,596,12897674.142857144,95.0,74.5
107109.0,17,2,286,2,286,0.0,143.0,143.0,0,0,0.0,0.0,0.0
90288621.0,6,16,1192,8,596,12892092.0,95.0,74.5,8,596,12896977.0,95.0,74.5
320479.0,17,4,1400,4,1400,106826.33333333331,350.0,350.0,0,0,0.0,0.0,0.0
1447712.0,6,8,602,5,404,336717.25,103.0,80.8,3,198,205398.0,66.0,66.0
290770.0,6,10,1221,6,636,58154.0,298.0,106.0,4,585,91124.33333333331,379.0,146.25
3008006.0,6,3,1604,2,851,0.0,785.0,425.5,1,753,0.0,753.0,753.0
595806.0,17,2,346,1,78,0.0,78.0,78.0,1,268,0.0,268.0,268.0
153451.0,17,2,180,1,90,0.0,90.0,90.0,1,90,0.0,90.0,90.0
341.0,17,2,267,1,83,0.0,83.0,83.0,1,184,0.0,184.0,184.0
97096853.0,6,176,19888,88,13858,1113582.4137931035,284.0,157.47727272727272,88,6030,1113583.1264367816,140.0,68.52272727272727
135130711.0,17,6,1206,6,1206,27026142.2,201.0,201.0,0,0,0.0,0.0,0.0
197218.0,17,2,180,1,90,0.0,90.0,90.0,1,90,0.0,90.0,90.0
2558.0,17,4,344,2,150,0.0,75.0,75.0,2,194,0.0,103.0,97.0
2365.0,17,4,344,2,150,0.0,75.0,75.0,2,194,0.0,103.0,97.0
288587.0,6,12,1373,7,714,48097.833333333336,298.0,102.0,5,659,67737.0,379.0,131.8
2017624.0,17,4,525,2,150,0.0,75.0,75.0,2,375,0.0,284.0,187.5
9182.0,17,2,539,1,86,0.0,86.0,86.0,1,453,0.0,453.0,453.0
1982.0,17,4,344,2,150,0.0,75.0,75.0,2,194,0.0,103.0,97.0
111139187.0,6,424,53410,212,14362,522838.1800947868,140.0,67.74528301886792,212,39048,526634.9289099526,464.0,184.18867924528303
205785.0,17,2,762,2,762,0.0,381.0,381.0,0,0,0.0,0.0,0.0
1771388.0,6,20,7599,11,1469,177138.8,583.0,133.54545454545453,9,6130,185951.875,1484.0,681.1111111111111
307616.0,17,4,1400,4,1400,102538.66666666669,350.0,350.0,0,0,0.0,0.0,0.0
55828.0,6,14,4740,7,653,9174.5,249.0,93.28571428571428,7,4087,8397.0,1514.0,583.8571428571429
907.0,17,4,438,2,148,0.0,74.0,74.0,2,290,0.0,147.0,145.0
264829.0,17,4,1524,4,1524,88276.33333333333,381.0,381.0,0,0,0.0,0.0,0.0
113341979.0,6,35,2542,18,1348,6667175.235294118,139.0,74.88888888888889,17,1194,7071044.25,123.0,70.23529411764706
38952.0,6,13,1386,7,789,6140.5,253.0,112.71428571428572,6,597,6899.6,259.0,99.5
421.0,17,2,410,1,78,0.0,78.0,78.0,1,332,0.0,332.0,332.0
114348.0,17,2,286,2,286,0.0,143.0,143.0,0,0,0.0,0.0,0.0
108128745.0,17,5,1005,5,1005,27032186.25,201.0,201.0,0,0,0.0,0.0,0.0
90648461.0,6,15,2302,9,1204,11315945.25,188.0,133.77777777777777,6,1098,18097191.8,204.0,183.0
250736.0,17,4,6056,4,6056,83578.66666666667,1514.0,1514.0,0,0,0.0,0.0,0.0
30419.0,6,10,2032,5,524,7387.25,252.0,104.8,5,1508,6543.5,1236.0,301.6
14629677.0,6,19,1553,9,921,1791026.0,315.0,102.33333333333331,10,632,1591983.4444444445,78.0,63.2
295131.0,6,10,1221,6,636,59026.2,298.0,106.0,4,585,97471.66666666669,379.0,146.25
90017846.0,17,28,13364,28,13364,3333994.296296296,501.0,477.2857142857143,0,0,0.0,0.0,0.0
104126293.0,6,44,2904,22,1452,4958394.904761905,66.0,66.0,22,1452,4945273.761904762,66.0,66.0
90257791.0,6,13,2036,8,1016,12893970.142857144,188.0,127.0,5,1020,22523490.0,204.0,204.0
103026545.0,17,14,864,7,432,17167671.5,174.0,61.71428571428572,7,432,17166889.666666668,174.0,61.71428571428572
2587581.0,6,2,132,1,66,0.0,66.0,66.0,1,66,0.0,66.0,66.0
115856011.0,6,48,3168,24,1584,5037217.869565218,66.0,66.0,24,1584,5023794.956521739,66.0,66.0
113520173.0,6,46,3036,23,1518,5159996.2727272725,66.0,66.0,23,1518,5159996.0,66.0,66.0
146262.0,6,3,337,2,214,0.0,160.0,107.0,1,123,0.0,123.0,123.0
759.0,17,4,438,2,148,0.0,74.0,74.0,2,290,0.0,147.0,145.0
284017.0,17,2,363,1,79,0.0,79.0,79.0,1,284,0.0,284.0,284.0
218480.0,17,2,180,1,90,0.0,90.0,90.0,1,90,0.0,90.0,90.0
500427.0,6,5,336,2,134,0.0,68.0,67.0,3,202,191534.5,70.0,67.33333333333333
15183.0,6,14,4740,7,653,2342.6666666666665,249.0,93.28571428571428,7,4087,2395.5,1514.0,583.8571428571429
116498505.0,6,214,24090,107,16806,1097012.6226415094,284.0,157.06542056074767,107,7284,1097013.0566037735,140.0,68.07476635514018
146351.0,6,3,337,2,214,0.0,160.0,107.0,1,123,0.0,123.0,123.0
598294.0,17,4,629,3,234,205780.5,78.0,78.0,1,395,0.0,395.0,395.0
380146.0,6,4,508,2,238,0.0,172.0,119.0,2,270,0.0,135.0,135.0
14127493.0,6,115,31681,59,25280,243577.4655172414,580.0,428.4745762711864,56,6401,253045.41818181807,730.0,114.30357142857144
297170.0,17,2,246,1,76,0.0,76.0,76.0,1,170,0.0,170.0,170.0
21617927.0,6,5,1736,3,917,9408977.0,785.0,305.6666666666667,2,819,0.0,753.0,409.5
37847.0,6,14,4740,7,653,5893.333333333333,249.0,93.28571428571428,7,4087,6165.166666666667,1514.0,583.8571428571429
113376843.0,6,46,3036,23,1518,5140437.0,66.0,66.0,23,1518,5140438.227272728,66.0,66.0
50854.0,6,14,4740,7,653,8155.5,249.0,93.28571428571428,7,4087,7112.333333333333,1514.0,583.8571428571429
117354203.0,17,14,864,7,432,19500224.33333333,174.0,61.71428571428572,7,432,19500854.666666668,174.0,61.71428571428572
46537.0,6,14,4740,7,653,7591.0,249.0,93.28571428571428,7,4087,6474.333333333333,1514.0,583.8571428571429
252949.0,6,3,337,2,214,0.0,160.0,107.0,1,123,0.0,123.0,123.0
213780.0,17,2,180,1,90,0.0,90.0,90.0,1,90,0.0,90.0,90.0
66758.0,6,14,4740,7,653,10713.666666666666,249.0,93.28571428571428,7,4087,10533.166666666666,1514.0,583.8571428571429
2279.0,17,4,344,2,150,0.0,75.0,75.0,2,194,0.0,103.0,97.0
228318.0,17,2,180,1,90,0.0,90.0,90.0,1,90,0.0,90.0,90.0
204191.0,17,2,762,2,762,0.0,381.0,381.0,0,0,0.0,0.0,0.0
23368.0,6,10,2032,5,524,5622.5,252.0,104.8,5,1508,5373.5,1236.0,301.6
120124749.0,6,14,2224,9,1204,15015593.625,188.0,133.77777777777777,5,1020,22515009.25,204.0,204.0
44020.0,17,2,180,1,90,0.0,90.0,90.0,1,90,0.0,90.0,90.0
108111223.0,17,5,955,5,955,27027805.75,191.0,191.0,0,0,0.0,0.0,0.0
23836.0,6,11,2098,6,590,4767.2,252.0,98.33333333333331,5,1508,5374.5,1236.0,301.6
998708.0,6,10,1221,6,636,199741.6,298.0,106.0,4,585,331275.3333333333,379.0,146.25
126153.0,6,2,132,1,66,0.0,66.0,66.0,1,66,0.0,66.0,66.0
538871.0,17,6,2100,6,2100,107774.2,350.0,350.0,0,0,0.0,0.0,0.0
120058056.0,17,28,13364,28,13364,4446594.666666667,501.0,477.2857142857143,0,0,0.0,0.0,0.0
2406693.0,6,3,1777,1,826,0.0,826.0,826.0,2,951,0.0,885.0,475.5
220988.0,6,3,426,2,280,0.0,214.0,140.0,1,146,0.0,146.0,146.0
29700.0,6,10,2032,5,524,5652.25,252.0,104.8,5,1508,6903.75,1236.0,301.6
51331.0,6,10,2032,5,524,12607.25,252.0,104.8,5,1508,9385.0,1236.0,301.6
35317.0,6,14,4740,7,653,4711.333333333333,249.0,93.28571428571428,7,4087,5500.0,1514.0,583.8571428571429
306231.0,17,2,180,1,90,0.0,90.0,90.0,1,90,0.0,90.0,90.0
123440621.0,6,31,2182,15,1017,8104008.5,123.0,67.8,16,1165,7563681.8,139.0,72.8125
20491.0,6,20,7606,11,978,2049.1,310.0,88.9090909090909,9,6628,2215.75,1514.0,736.4444444444445
49304.0,6,14,4740,7,653,8097.666666666667,249.0,93.28571428571428,7,4087,7098.666666666667,1514.0,583.8571428571429
142221.0,17,4,571,2,148,0.0,74.0,74.0,2,423,0.0,276.0,211.5
307486.0,6,6,412,4,272,102495.33333333331,74.0,68.0,2,140,0.0,74.0,70.0
108101404.0,17,5,1005,5,1005,27025351.0,201.0,201.0,0,0,0.0,0.0,0.0
242524.0,6,3,337,2,214,0.0,160.0,107.0,1,123,0.0,123.0,123.0
897364.0,6,12,2709,7,742,149560.66666666666,338.0,106.0,5,1967,155412.0,1514.0,393.4
204901.0,17,2,762,2,762,0.0,381.0,381.0,0,0,0.0,0.0,0.0
99429624.0,6,785,162252,400,136250,248654.9223057644,1514.0,340.625,385,26002,258367.9140625,214.0,67.53766233766234
42955.0,6,10,2032,5,524,10498.0,252.0,104.8,5,1508,10082.5,1236.0,301.6
36254.0,6,14,4740,7,653,5076.166666666667,249.0,93.28571428571428,7,4087,5860.5,1514.0,583.8571428571429
135137108.0,17,6,1146,6,1146,27027421.6,191.0,191.0,0,0,0.0,0.0,0.0
2332.0,17,4,344,2,150,0.0,75.0,75.0,2,194,0.0,103.0,97.0
1472404.0,17,16,1120,16,1120,98160.26666666666,70.0,70.0,0,0,0.0,0.0,0.0
107311.0,17,2,286,2,286,0.0,143.0,143.0,0,0,0.0,0.0,0.0
90254526.0,6,13,2036,8,1016,12893503.714285716,188.0,127.0,5,1020,22520240.5,204.0,204.0
254876.0,6,12,1373,7,714,42479.333333333336,298.0,102.0,5,659,58918.25,379.0,131.8
30952.0,6,10,2032,5,524,7507.5,252.0,104.8,5,1508,6783.5,1236.0,301.6
301968.0,6,6,412,4,272,100656.0,74.0,68.0,2,140,0.0,74.0,70.0
90015444.0,17,28,13364,28,13364,3333905.333333333,501.0,477.2857142857143,0,0,0.0,0.0,0.0
106240650.0,6,251,28618,126,8538,849925.2,140.0,67.76190476190476,125,20080,854993.3306451613,284.0,160.64
123416456.0,6,48,3168,24,1584,5086912.521739131,66.0,66.0,24,1584,5214657.869565218,66.0,66.0
143965.0,17,2,180,1,90,0.0,90.0,90.0,1,90,0.0,90.0,90.0
121524.0,6,3,337,2,214,0.0,160.0,107.0,1,123,0.0,123.0,123.0
44111.0,6,14,4740,7,653,7243.0,249.0,93.28571428571428,7,4087,6775.0,1514.0,583.8571428571429
107296.0,17,2,286,2,286,0.0,143.0,143.0,0,0,0.0,0.0,0.0
135131131.0,17,6,1206,6,1206,27026226.2,201.0,201.0,0,0,0.0,0.0,0.0
2337.0,17,4,344,2,150,0.0,75.0,75.0,2,194,0.0,103.0,97.0
9008378.0,17,4,300,4,300,3002792.6666666665,75.0,75.0,0,0,0.0,0.0,0.0
54456.0,6,14,4740,7,653,8767.166666666666,249.0,93.28571428571428,7,4087,8039.0,1514.0,583.8571428571429
52009.0,6,14,4740,7,653,8169.833333333333,249.0,93.28571428571428,7,4087,8015.333333333333,1514.0,583.8571428571429
316.0,17,2,174,1,79,0.0,79.0,79.0,1,95,0.0,95.0,95.0
256175.0,6,3,337,2,214,0.0,160.0,107.0,1,123,0.0,123.0,123.0
350.0,17,2,160,1,80,0.0,80.0,80.0,1,80,0.0,80.0,80.0
312322.0,17,4,1400,4,1400,104107.33333333331,350.0,350.0,0,0,0.0,0.0,0.0
161140.0,6,2,128,1,74,0.0,74.0,74.0,1,54,0.0,54.0,54.0
5342754.0,6,5,336,2,134,0.0,68.0,67.0,3,202,1525999.5,70.0,67.33333333333333
207031.0,6,3,426,2,280,0.0,214.0,140.0,1,146,0.0,146.0,146.0
135125818.0,17,6,1146,6,1146,27025163.6,191.0,191.0,0,0,0.0,0.0,0.0
98230040.0,17,14,1126,7,563,16345182.833333334,174.0,80.42857142857143,7,563,16308184.0,174.0,80.42857142857143
116952654.0,6,232,26952,116,19074,1015107.052173913,284.0,164.43103448275863,116,7878,1015108.4347826086,140.0,67.91379310344827
2799872.0,6,2,132,1,66,0.0,66.0,66.0,1,66,0.0,66.0,66.0
2258513.0,6,2,132,1,66,0.0,66.0,66.0,1,66,0.0,66.0,66.0
40630.0,6,14,4740,7,653,6128.666666666667,249.0,93.28571428571428,7,4087,6486.5,1514.0,583.8571428571429
92718981.0,6,203,23364,102,6954,918009.7128712873,140.0,68.17647058823529,101,16410,907733.34,284.0,162.47524752475246
149718092.0,6,15,2290,5,1020,29962338.5,204.0,204.0,10,1270,16634798.666666666,188.0,127.0
298089.0,6,6,412,4,272,99363.0,74.0,68.0,2,140,0.0,74.0,70.0
90262742.0,6,13,2036,8,1016,12894677.42857143,188.0,127.0,5,1020,22523611.25,204.0,204.0
279638.0,6,12,1373,7,714,46606.333333333336,298.0,102.0,5,659,65865.75,379.0,131.8
699774.0,6,10,1124,6,608,139954.8,222.0,101.33333333333331,4,516,148363.33333333334,206.0,129.0
108000994.0,17,13,821,7,432,18000165.666666668,174.0,61.71428571428572,6,389,17601130.8,174.0,64.83333333333333
53978.0,6,10,2032,5,524,11131.25,252.0,104.8,5,1508,12520.75,1236.0,301.6
2075.0,17,4,344,2,150,0.0,75.0,75.0,2,194,0.0,103.0,97.0
35242.0,6,14,4740,7,653,5740.833333333333,249.0,93.28571428571428,7,4087,4685.666666666667,1514.0,583.8571428571429
100677826.0,17,17,5822,16,5472,5304547.8,342.0,342.0,1,350,0.0,350.0,350.0
37397.0,6,14,4740,7,653,6112.166666666667,249.0,93.28571428571428,7,4087,5413.5,1514.0,583.8571428571429
325442.0,17,4,1400,4,1400,108480.66666666669,350.0,350.0,0,0,0.0,0.0,0.0
110321771.0,6,199,22508,100,6896,1114361.3232323232,140.0,68.96,99,15612,1122102.6836734691,284.0,157.6969696969697
34160.0,6,14,4740,7,653,5282.5,249.0,93.28571428571428,7,4087,5403.666666666667,1514.0,583.8571428571429
14582.0,6,14,4740,7,653,2320.0,249.0,93.28571428571428,7,4087,2097.5,1514.0,583.8571428571429
351.0,17,2,152,1,76,0.0,76.0,76.0,1,76,0.0,76.0,76.0
2793516.0,6,2,132,1,66,0.0,66.0,66.0,1,66,0.0,66.0,66.0
196925.0,17,2,180,1,90,0.0,90.0,90.0,1,90,0.0,90.0,90.0
117199638.0,6,48,3168,24,1584,5095636.434782608,66.0,66.0,24,1584,5083661.0,66.0,66.0
143992.0,17,2,180,1,90,0.0,90.0,90.0,1,90,0.0,90.0,90.0
90031141.0,17,28,13364,28,13364,3334486.703703704,501.0,477.2857142857143,0,0,0.0,0.0,0.0
0.0,6,1,54,1,54,0.0,54.0,54.0,0,0,0.0,0.0,0.0
2597592.0,6,2,132,1,66,0.0,66.0,66.0,1,66,0.0,66.0,66.0
192900.0,17,2,180,1,90,0.0,90.0,90.0,1,90,0.0,90.0,90.0
103894.0,17,2,286,2,286,0.0,143.0,143.0,0,0,0.0,0.0,0.0
90256847.0,6,13,2036,8,1016,12893835.285714284,188.0,127.0,5,1020,22523162.0,204.0,204.0
120037116.0,17,28,13364,28,13364,4445819.111111111,501.0,477.2857142857143,0,0,0.0,0.0,0.0
108234.0,17,2,286,2,286,0.0,143.0,143.0,0,0,0.0,0.0,0.0
162331.0,17,2,180,1,90,0.0,90.0,90.0,1,90,0.0,90.0,90.0
90289858.0,6,16,1192,8,596,12892117.285714284,95.0,74.5,8,596,12897216.285714284,95.0,74.5
90290848.0,6,16,1192,8,596,12892267.857142856,95.0,74.5,8,596,12897306.857142856,95.0,74.5
29642.0,6,14,4740,7,653,3956.3333333333335,249.0,93.28571428571428,7,4087,4721.0,1514.0,583.8571428571429
90088041.0,6,12,1848,5,1020,22521431.5,204.0,204.0,7,828,14969162.666666666,188.0,118.28571428571428
1177747.0,6,13,3010,8,2382,168249.57142857142,1514.0,297.75,5,628,226279.5,331.0,125.6
232438.0,6,3,337,2,214,0.0,160.0,107.0,1,123,0.0,123.0,123.0
297754.0,6,11,1287,6,636,59550.8,298.0,106.0,5,651,73464.0,379.0,130.2
22630.0,6,10,2032,5,524,5425.75,252.0,104.8,5,1508,5452.5,1236.0,301.6
30845.0,6,14,4740,7,653,4999.0,249.0,93.28571428571428,7,4087,4276.666666666667,1514.0,583.8571428571429
120077361.0,17,28,13364,28,13364,4447309.666666667,501.0,477.2857142857143,0,0,0.0,0.0,0.0
5621181.0,6,4,270,2,134,0.0,68.0,67.0,2,136,0.0,70.0,68.0
108104916.0,17,5,955,5,955,27026229.0,191.0,191.0,0,0,0.0,0.0,0.0
120189005.0,6,36,2596,18,1248,7069941.470588235,123.0,69.33333333333333,18,1348,6601567.764705882,139.0,74.88888888888889
105542105.0,6,44,2904,22,1452,5025814.523809524,66.0,66.0,22,1452,5010220.714285715,66.0,66.0
205855.0,17,2,180,1,90,0.0,90.0,90.0,1,90,0.0,90.0,90.0
116131327.0,6,236,27396,118,8010,985536.8376068376,140.0,67.88135593220339,118,19386,986451.376068376,284.0,164.28813559322035
45188.0,6,10,2032,5,524,10984.0,252.0,104.8,5,1508,10334.75,1236.0,301.6
3045663.0,6,12,2172,7,664,507252.0,252.0,94.85714285714286,5,1508,4123.75,1236.0,301.6
34725.0,6,12,1393,6,796,6631.2,271.0,132.66666666666666,6,597,6051.0,259.0,99.5
2595521.0,6,2,132,1,66,0.0,66.0,66.0,1,66,0.0,66.0,66.0
323.0,17,2,174,1,79,0.0,79.0,79.0,1,95,0.0,95.0,95.0
90528902.0,6,13,2036,8,1016,12932700.285714284,188.0,127.0,5,1020,22591535.5,204.0,204.0
22304.0,6,11,1133,6,602,3955.4,264.0,100.33333333333331,5,531,5003.5,259.0,106.2
90091347.0,17,28,13364,28,13364,3336716.5555555555,501.0,477.2857142857143,0,0,0.0,0.0,0.0
19871.0,6,10,2032,5,524,4030.75,252.0,104.8,5,1508,4364.25,1236.0,301.6
107705.0,17,2,286,2,286,0.0,143.0,143.0,0,0,0.0,0.0,0.0
209536.0,17,2,180,1,90,0.0,90.0,90.0,1,90,0.0,90.0,90.0
50500279.0,6,8,2113,3,960,24030793.5,826.0,320.0,5,1153,11980928.0,885.0,230.6
309917.0,17,4,1400,4,1400,103305.66666666669,350.0,350.0,0,0,0.0,0.0,0.0
6601.0,17,2,447,1,84,0.0,84.0,84.0,1,363,0.0,363.0,363.0
42383.0,6,14,4740,7,653,6937.333333333333,249.0,93.28571428571428,7,4087,6347.166666666667,1514.0,583.8571428571429
7027.0,17,2,239,1,82,0.0,82.0,82.0,1,157,0.0,157.0,157.0
103806.0,17,2,286,2,286,0.0,143.0,143.0,0,0,0.0,0.0,0.0
153381.0,17,2,180,1,90,0.0,90.0,90.0,1,90,0.0,90.0,90.0
22073.0,17,4,823,2,163,0.0,89.0,81.5,2,660,0.0,443.0,330.0
107673624.0,6,30,2106,15,1017,7690973.142857143,123.0,67.8,15,1089,7126302.714285715,123.0,72.6
41766.0,6,14,4740,7,653,6847.833333333333,249.0,93.28571428571428,7,4087,5803.0,1514.0,583.8571428571429
251897.0,6,10,1221,6,636,50379.4,298.0,106.0,4,585,78574.33333333333,379.0,146.25
29118.0,6,14,4740,7,653,4703.166666666667,249.0,93.28571428571428,7,4087,4430.166666666667,1514.0,583.8571428571429
175854.0,17,4,1524,4,1524,58618.0,381.0,381.0,0,0,0.0,0.0,0.0
100971712.0,6,197,22386,99,15696,1030323.5918367348,300.0,158.54545454545453,98,6690,1030203.5154639176,140.0,68.26530612244898
120265890.0,6,236,26660,118,8084,1021403.0256410256,140.0,68.50847457627118,118,18576,1020890.829059829,284.0,157.42372881355934
210922.0,17,2,414,1,88,0.0,88.0,88.0,1,326,0.0,326.0,326.0
308252.0,6,6,412,4,272,102750.66666666669,74.0,68.0,2,140,0.0,74.0,70.0
2038.0,17,4,344,2,150,0.0,75.0,75.0,2,194,0.0,103.0,97.0
90048927.0,17,27,12943,27,12943,3463420.269230769,501.0,479.3703703703704,0,0,0.0,0.0,0.0
108106233.0,17,5,1005,5,1005,27026558.25,201.0,201.0,0,0,0.0,0.0,0.0
90025210.0,17,27,12943,27,12943,3462508.076923077,501.0,479.3703703703704,0,0,0.0,0.0,0.0
2415.0,17,4,344,2,150,0.0,75.0,75.0,2,194,0.0,103.0,97.0
2698344.0,6,25,7573,14,3735,207564.92307692303,1514.0,266.7857142857143,11,3838,243639.0,1514.0,348.90909090909093
5801255.0,6,5,336,2,134,0.0,68.0,67.0,3,202,1525639.0,70.0,67.33333333333333
2795373.0,6,2,132,1,66,0.0,66.0,66.0,1,66,0.0,66.0,66.0
511716.0,6,5,336,2,134,0.0,68.0,67.0,3,202,195541.5,70.0,67.33333333333333
90291567.0,6,16,1192,8,596,12892606.42857143,95.0,74.5,8,596,12896906.285714284,95.0,74.5
206851.0,6,3,426,2,280,0.0,214.0,140.0,1,146,0.0,146.0,146.0
119862891.0,6,498,115512,245,16762,487862.58196721313,214.0,68.41632653061224,253,98750,475569.0674603175,1514.0,390.3162055335968
302398.0,6,2,132,1,66,0.0,66.0,66.0,1,66,0.0,66.0,66.0
5628521.0,6,4,270,2,134,0.0,68.0,67.0,2,136,0.0,70.0,68.0
10477241.0,6,7,478,4,272,3446785.6666666665,74.0,68.0,3,206,5170110.5,74.0,68.66666666666667
756435.0,6,2,132,1,66,0.0,66.0,66.0,1,66,0.0,66.0,66.0
0.0,17,1,90,1,90,0.0,90.0,90.0,0,0,0.0,0.0,0.0
217489.0,17,2,180,1,90,0.0,90.0,90.0,1,90,0.0,90.0,90.0
18790.0,6,10,1810,5,358,4480.5,130.0,71.6,5,1452,4318.0,1224.0,290.4
314915.0,6,3,202,2,128,0.0,74.0,64.0,1,74,0.0,74.0,74.0
111908760.0,6,40,2956,20,1531,5889934.736842105,139.0,76.55,20,1425,5878543.947368421,123.0,71.25
772.0,17,5,550,5,550,193.0,110.0,110.0,0,0,0.0,0.0,0.0
206445.0,17,2,762,2,762,0.0,381.0,381.0,0,0,0.0,0.0,0.0
313248.0,17,2,180,1,90,0.0,90.0,90.0,1,90,0.0,90.0,90.0
15847.0,6,11,1143,6,612,2769.6,262.0,102.0,5,531,3583.25,259.0,106.2
113499421.0,6,48,3168,24,1584,4934757.434782608,66.0,66.0,24,1584,4922778.347826087,66.0,66.0
135125209.0,17,6,1146,6,1146,27025041.8,191.0,191.0,0,0,0.0,0.0,0.0
14666592.0,6,20,1607,10,975,1592489.111111111,315.0,97.5,10,632,1592215.111111111,78.0,63.2
1408953.0,17,2,876,2,876,0.0,438.0,438.0,0,0,0.0,0.0,0.0
761.0,17,4,438,2,148,0.0,74.0,74.0,2,290,0.0,147.0,145.0
93132555.0,6,180,20332,90,14244,1044016.4606741572,284.0,158.26666666666668,90,6088,1044013.2921348314,140.0,67.64444444444445
298000.0,6,6,412,4,272,99333.33333333331,74.0,68.0,2,140,0.0,74.0,70.0
298234.0,6,6,412,4,272,99411.33333333331,74.0,68.0,2,140,0.0,74.0,70.0
51554.0,6,14,4740,7,653,8471.833333333334,249.0,93.28571428571428,7,4087,7435.666666666667,1514.0,583.8571428571429
106436773.0,6,56,4948,32,2755,3433444.290322581,139.0,86.09375,24,2193,4618292.304347826,123.0,91.375
10534986.0,6,7,478,4,272,3463767.6666666665,74.0,68.0,3,206,5195515.0,74.0,68.66666666666667
32676762.0,6,5,336,2,134,0.0,68.0,67.0,3,202,14941937.5,70.0,67.33333333333333
5004696.0,17,4,849,2,166,0.0,83.0,83.0,2,683,0.0,499.0,341.5
90257415.0,6,15,2168,8,1016,12893916.42857143,188.0,127.0,7,1152,15015823.833333334,204.0,164.57142857142858
120001253.0,17,28,13364,28,13364,4444490.851851852,501.0,477.2857142857143,0,0,0.0,0.0,0.0
139001309.0,17,17,1255,9,649,17375163.625,174.0,72.11111111111111,8,606,16988777.57142857,174.0,75.75
48096.0,6,14,4740,7,653,7900.833333333333,249.0,93.28571428571428,7,4087,7256.333333333333,1514.0,583.8571428571429
265172.0,6,3,337,2,214,0.0,160.0,107.0,1,123,0.0,123.0,123.0
32472.0,6,14,4740,7,653,4154.833333333333,249.0,93.28571428571428,7,4087,5270.333333333333,1514.0,583.8571428571429
120381823.0,6,215,24358,108,17000,1125063.76635514,284.0,157.40740740740742,107,7358,1105122.5188679246,140.0,68.76635514018692
90281105.0,6,17,1287,9,691,11279443.25,95.0,76.77777777777777,8,596,12896700.714285716,95.0,74.5
1743.0,17,3,1315,3,1315,871.5,445.0,438.3333333333333,0,0,0.0,0.0,0.0
25708533.0,17,5,1718,4,1368,847287.6666666666,342.0,342.0,1,350,0.0,350.0,350.0
108106238.0,17,5,955,5,955,27026559.5,191.0,191.0,0,0,0.0,0.0,0.0
46737.0,6,13,1394,7,797,7714.166666666667,253.0,113.85714285714286,6,597,8719.2,259.0,99.5
117536599.0,6,218,24662,109,17172,1086309.509259259,284.0,157.54128440366972,109,7490,1086309.5555555555,140.0,68.71559633027523
2068.0,17,6,1230,3,234,718.0,78.0,78.0,3,996,818.5,332.0,332.0
130612.0,6,3,337,2,214,0.0,160.0,107.0,1,123,0.0,123.0,123.0
249268.0,6,3,373,2,238,0.0,172.0,119.0,1,135,0.0,135.0,135.0
2995167.0,17,4,1752,4,1752,998389.0,438.0,438.0,0,0,0.0,0.0,0.0
108108020.0,17,5,1005,5,1005,27027005.0,201.0,201.0,0,0,0.0,0.0,0.0
55634.0,6,10,2032,5,524,12039.25,252.0,104.8,5,1508,13665.5,1236.0,301.6
120198365.0,6,242,27342,121,8208,994825.0666666668,140.0,67.83471074380165,121,19134,994813.4083333332,284.0,158.13223140495867
5003876.0,17,4,849,2,166,0.0,83.0,83.0,2,683,0.0,499.0,341.5
146449.0,6,4,439,2,238,0.0,172.0,119.0,2,201,0.0,135.0,100.5
120123735.0,6,13,2020,9,1204,15015466.875,188.0,133.77777777777777,4,816,30031785.33333333,204.0,204.0
3044991.0,6,3,204,1,68,0.0,68.0,68.0,2,136,0.0,70.0,68.0
118342589.0,6,36,2596,18,1348,6961328.764705882,139.0,74.88888888888889,18,1248,6948584.94117647,123.0,69.33333333333333
145760.0,6,3,373,2,238,0.0,172.0,119.0,1,135,0.0,135.0,135.0
2415.0,17,4,344,2,150,0.0,75.0,75.0,2,194,0.0,103.0,97.0
1802604.0,6,23,6509,12,1529,163830.81818181818,357.0,127.41666666666669,11,4980,148861.4,1510.0,452.7272727272728
103061232.0,17,14,1126,7,563,17167690.666666668,174.0,80.42857142857143,7,563,17166801.5,174.0,80.42857142857143
135170308.0,17,6,1206,6,1206,27034061.6,201.0,201.0,0,0,0.0,0.0,0.0
1525342.0,17,6,1230,3,234,762484.0,78.0,78.0,3,996,762467.5,332.0,332.0
108105368.0,17,5,955,5,955,27026342.0,191.0,191.0,0,0,0.0,0.0,0.0
2363.0,17,4,344,2,150,0.0,75.0,75.0,2,194,0.0,103.0,97.0
2802065.0,6,2,132,1,66,0.0,66.0,66.0,1,66,0.0,66.0,66.0
319.0,17,2,174,1,79,0.0,79.0,79.0,1,95,0.0,95.0,95.0
989639.0,6,12,1362,6,731,197521.6,253.0,121.83333333333331,6,631,197514.8,293.0,105.16666666666669
322637.0,17,4,1400,4,1400,107545.66666666669,350.0,350.0,0,0,0.0,0.0,0.0
26803.0,6,14,4740,7,653,4352.833333333333,249.0,93.28571428571428,7,4087,3964.3333333333335,1514.0,583.8571428571429
14638281.0,6,20,1607,10,975,1592799.0,315.0,97.5,10,632,1592768.7777777778,78.0,63.2
232933.0,6,3,337,2,214,0.0,160.0,107.0,1,123,0.0,123.0,123.0
5823500.0,6,5,336,2,134,0.0,68.0,67.0,3,202,1522733.5,70.0,67.33333333333333
185787.0,17,2,180,1,90,0.0,90.0,90.0,1,90,0.0,90.0,90.0
217003.0,6,3,426,2,280,0.0,214.0,140.0,1,146,0.0,146.0,146.0
44852.0,6,14,4740,7,653,7142.0,249.0,93.28571428571428,7,4087,6805.166666666667,1514.0,583.8571428571429
149638.0,17,2,180,1,90,0.0,90.0,90.0,1,90,0.0,90.0,90.0
25402.0,6,14,4740,7,653,4080.6666666666665,249.0,93.28571428571428,7,4087,3900.5,1514.0,583.8571428571429
206506.0,6,3,426,2,280,0.0,214.0,140.0,1,146,0.0,146.0,146.0
217131.0,6,3,426,2,280,0.0,214.0,140.0,1,146,0.0,146.0,146.0
46692.0,6,10,2032,5,524,11409.0,252.0,104.8,5,1508,10500.0,1236.0,301.6
60804.0,6,14,4740,7,653,9977.5,249.0,93.28571428571428,7,4087,9495.833333333334,1514.0,583.8571428571429
35397.0,6,14,4740,7,653,5242.333333333333,249.0,93.28571428571428,7,4087,5174.666666666667,1514.0,583.8571428571429
11586.0,6,10,1067,5,536,2401.0,264.0,107.2,5,531,2641.0,259.0,106.2
118679215.0,17,14,864,7,432,19666909.0,174.0,61.71428571428572,7,432,19670770.0,174.0,61.71428571428572
134414.0,6,10,1065,5,534,33208.25,262.0,106.8,5,531,2781.5,259.0,106.2
207494.0,6,12,1373,7,714,34582.333333333336,298.0,102.0,5,659,50830.5,379.0,131.8
313581.0,17,4,1400,4,1400,104527.0,350.0,350.0,0,0,0.0,0.0,0.0
2592.0,17,4,344,2,150,0.0,75.0,75.0,2,194,0.0,103.0,97.0
44994.0,6,11,2098,6,590,8863.8,252.0,98.33333333333331,5,1508,10994.5,1236.0,301.6
108106504.0,17,5,955,5,955,27026626.0,191.0,191.0,0,0,0.0,0.0,0.0
3574501.0,6,5,367,2,132,0.0,66.0,66.0,3,235,1787250.5,103.0,78.33333333333333
34520.0,6,10,2032,5,524,8380.0,252.0,104.8,5,1508,8279.25,1236.0,301.6
228190.0,17,2,180,1,90,0.0,90.0,90.0,1,90,0.0,90.0,90.0
107617721.0,6,32,2236,16,1165,7174514.733333333,139.0,72.8125,16,1071,7160104.6,123.0,66.9375
213814.0,6,3,426,2,280,0.0,214.0,140.0,1,146,0.0,146.0,146.0
92485167.0,6,29,2200,15,1168,6606083.357142857,139.0,77.86666666666666,14,1032,7097587.692307692,123.0,73.71428571428571
234506.0,6,3,373,2,238,0.0,172.0,119.0,1,135,0.0,135.0,135.0
103072.0,17,2,700,2,700,0.0,350.0,350.0,0,0,0.0,0.0,0.0
108094309.0,17,5,1005,5,1005,27023577.25,201.0,201.0,0,0,0.0,0.0,0.0
104891.0,6,13,1420,7,789,17077.166666666668,253.0,112.71428571428572,6,631,20662.6,293.0,105.16666666666669
35733.0,6,14,4740,7,653,5470.833333333333,249.0,93.28571428571428,7,4087,5820.333333333333,1514.0,583.8571428571429
219307.0,6,3,426,2,280,0.0,214.0,140.0,1,146,0.0,146.0,146.0
111117276.0,6,33,2428,17,1288,6931318.8125,139.0,75.76470588235294,16,1140,7393429.666666667,123.0,71.25
122975180.0,6,48,3168,24,1584,5180165.347826087,66.0,66.0,24,1584,5086913.434782608,66.0,66.0
217621.0,6,3,426,2,280,0.0,214.0,140.0,1,146,0.0,146.0,146.0
227481.0,17,2,180,1,90,0.0,90.0,90.0,1,90,0.0,90.0,90.0
6446903.0,6,37,9783,20,5715,339310.6842105263,1514.0,285.75,17,4068,259005.3125,1514.0,239.2941176470588
120571335.0,6,213,24008,107,16716,1137465.424528302,284.0,156.22429906542055,106,7292,1138497.1619047618,140.0,68.79245283018868
310.0,17,2,174,1,79,0.0,79.0,79.0,1,95,0.0,95.0,95.0
103601.0,17,2,762,2,762,0.0,381.0,381.0,0,0,0.0,0.0,0.0
40043.0,6,14,4740,7,653,6550.0,249.0,93.28571428571428,7,4087,6237.0,1514.0,583.8571428571429
102869.0,17,2,286,2,286,0.0,143.0,143.0,0,0,0.0,0.0,0.0
2468.0,17,4,344,2,150,0.0,75.0,75.0,2,194,0.0,103.0,97.0
82.0,17,2,896,2,896,0.0,453.0,448.0,0,0,0.0,0.0,0.0
90301481.0,6,16,1192,8,596,12893875.142857144,95.0,74.5,8,596,12899693.857142856,95.0,74.5
34152877.0,6,7,1874,3,887,17003301.5,753.0,295.6666666666667,4,987,11336078.666666666,785.0,246.75
5603778.0,6,5,336,2,134,0.0,68.0,67.0,3,202,1527186.5,70.0,67.33333333333333
153524.0,17,2,180,1,90,0.0,90.0,90.0,1,90,0.0,90.0,90.0
119436918.0,17,35,16705,35,16705,3512850.529411765,501.0,477.2857142857143,0,0,0.0,0.0,0.0
116195367.0,17,16,1474,8,737,16576505.42857143,174.0,92.125,8,737,16576509.0,174.0,92.125
340.0,17,2,160,1,80,0.0,80.0,80.0,1,80,0.0,80.0,80.0
90299683.0,6,16,1192,8,596,12892761.714285716,95.0,74.5,8,596,12898912.0,95.0,74.5
300406.0,6,6,412,4,272,100135.33333333331,74.0,68.0,2,140,0.0,74.0,70.0
23973.0,6,14,4740,7,653,3579.5,249.0,93.28571428571428,7,4087,3858.5,1514.0,583.8571428571429
217509.0,6,3,426,2,280,0.0,214.0,140.0,1,146,0.0,146.0,146.0
2344503.0,6,25,7573,14,3735,180346.38461538465,1514.0,266.7857142857143,11,3838,209087.1,1514.0,348.90909090909093
90063011.0,17,28,13364,28,13364,3335667.074074074,501.0,477.2857142857143,0,0,0.0,0.0,0.0
308689.0,6,6,412,4,272,102896.33333333331,74.0,68.0,2,140,0.0,74.0,70.0
90288580.0,6,17,1287,9,691,11279882.75,95.0,76.77777777777777,8,596,12897305.714285716,95.0,74.5
155667.0,6,15,4806,8,719,20776.28571428572,249.0,89.875,7,4087,25626.5,1514.0,583.8571428571429
135130196.0,17,6,1146,6,1146,27026039.2,191.0,191.0,0,0,0.0,0.0,0.0
509668.0,6,5,336,2,134,0.0,68.0,67.0,3,202,195546.0,70.0,67.33333333333333
117747386.0,6,243,27264,122,8348,973057.6033057852,140.0,68.42622950819673,121,18916,975285.925,284.0,156.3305785123967
51197.0,6,13,1386,7,789,8148.333333333333,253.0,112.71428571428572,6,597,9160.8,259.0,99.5
209355.0,17,2,180,1,90,0.0,90.0,90.0,1,90,0.0,90.0,90.0
58444.0,6,14,4740,7,653,9436.5,249.0,93.28571428571428,7,4087,9511.166666666666,1514.0,583.8571428571429
120504040.0,17,14,864,7,432,19849125.166666668,174.0,61.71428571428572,7,432,20057320.83333333,174.0,61.71428571428572
303.0,17,2,168,1,76,0.0,76.0,76.0,1,92,0.0,92.0,92.0
4434.0,17,2,614,1,72,0.0,72.0,72.0,1,542,0.0,542.0,542.0
246483.0,6,3,337,2,214,0.0,160.0,107.0,1,123,0.0,123.0,123.0
90257493.0,6,13,2036,8,1016,12893927.57142857,188.0,127.0,5,1020,22522099.75,204.0,204.0
144715.0,17,2,180,1,70,0.0,70.0,70.0,1,110,0.0,110.0,110.0
2041.0,17,4,344,2,150,0.0,75.0,75.0,2,194,0.0,103.0,97.0
29067.0,6,13,4412,6,409,5667.2,127.0,68.16666666666667,7,4003,4598.0,1514.0,571.8571428571429
120650555.0,6,218,24662,109,7416,1095757.1851851852,140.0,68.03669724770643,109,17246,1109718.6851851852,284.0,158.22018348623854
252054.0,6,3,337,2,214,0.0,160.0,107.0,1,123,0.0,123.0,123.0
173991.0,17,4,1524,4,1524,57997.0,381.0,381.0,0,0,0.0,0.0,0.0
120339928.0,6,297,34360,149,24296,813107.6216216217,284.0,163.06040268456377,148,10064,811950.7619047619,140.0,68.0
60664.0,6,14,4740,7,653,9987.833333333334,249.0,93.28571428571428,7,4087,9208.833333333334,1514.0,583.8571428571429
5629108.0,6,4,270,2,134,0.0,68.0,67.0,2,136,0.0,70.0,68.0
147125.0,6,3,373,2,238,0.0,172.0,119.0,1,135,0.0,135.0,135.0
109122017.0,6,31,2160,16,1071,7274773.6,123.0,66.9375,15,1089,7081166.642857143,123.0,72.6
2780698.0,6,2,132,1,66,0.0,66.0,66.0,1,66,0.0,66.0,66.0
10465990.0,6,7,478,4,272,3443157.6666666665,74.0,68.0,3,206,5164752.0,74.0,68.66666666666667
0.0,6,1,66,1,66,0.0,66.0,66.0,0,0,0.0,0.0,0.0
147924.0,6,3,337,2,214,0.0,160.0,107.0,1,123,0.0,123.0,123.0
316347.0,6,6,412,4,272,105449.0,74.0,68.0,2,140,0.0,74.0,70.0
260608.0,6,10,1221,6,636,52121.6,298.0,106.0,4,585,81527.66666666667,379.0,146.25
18543.0,6,11,1131,6,600,3494.2,262.0,100.0,5,531,4298.5,259.0,106.2
14904.0,6,14,4740,7,653,2258.6666666666665,249.0,93.28571428571428,7,4087,2318.833333333333,1514.0,583.8571428571429
2587243.0,6,3,204,2,136,0.0,70.0,68.0,1,68,0.0,68.0,68.0
131307.0,6,2,132,1,66,0.0,66.0,66.0,1,66,0.0,66.0,66.0
111003299.0,6,34,2350,17,1225,6924124.75,139.0,72.05882352941177,17,1125,6924197.125,123.0,66.17647058823529
255214.0,6,3,373,2,238,0.0,172.0,119.0,1,135,0.0,135.0,135.0
108103212.0,17,5,1005,5,1005,27025803.0,201.0,201.0,0,0,0.0,0.0,0.0
16285.999999999998,6,10,1067,5,536,3884.0,264.0,107.2,5,531,3181.25,259.0,106.2
90257779.0,6,12,1832,8,1016,12893968.42857143,188.0,127.0,4,816,30031164.666666668,204.0,204.0
120534154.0,17,14,864,7,432,16834763.5,174.0,61.71428571428572,7,432,16833500.166666668,174.0,61.71428571428572
247652.0,6,3,337,2,214,0.0,160.0,107.0,1,123,0.0,123.0,123.0
207298.0,6,3,426,2,280,0.0,214.0,140.0,1,146,0.0,146.0,146.0
120156388.0,6,240,26976,120,8142,1002727.4957983192,140.0,67.85,120,18834,994032.8067226892,284.0,156.95
108108964.0,17,5,1005,5,1005,27027241.0,201.0,201.0,0,0,0.0,0.0,0.0
5627440.0,6,4,270,2,134,0.0,68.0,67.0,2,136,0.0,70.0,68.0
108105268.0,17,5,955,5,955,27026317.0,191.0,191.0,0,0,0.0,0.0,0.0
20868.0,6,10,2032,5,524,4022.5,252.0,104.8,5,1508,4978.25,1236.0,301.6
2795915.0,6,2,132,1,66,0.0,66.0,66.0,1,66,0.0,66.0,66.0
135131566.0,17,6,1206,6,1206,27026313.2,201.0,201.0,0,0,0.0,0.0,0.0
90256335.0,6,13,2036,8,1016,12893762.142857144,188.0,127.0,5,1020,22523320.5,204.0,204.0
307258.0,6,6,412,4,272,102419.33333333331,74.0,68.0,2,140,0.0,74.0,70.0
4202.0,17,2,614,1,72,0.0,72.0,72.0,1,542,0.0,542.0,542.0
49050.0,6,14,4740,7,653,7611.0,249.0,93.28571428571428,7,4087,7827.666666666667,1514.0,583.8571428571429
43993.0,6,14,4740,7,653,7040.666666666667,249.0,93.28571428571428,7,4087,6862.666666666667,1514.0,583.8571428571429
90034095.0,17,27,12943,27,12943,3462849.8076923075,501.0,479.3703703703704,0,0,0.0,0.0,0.0
42327.0,6,10,2032,5,524,8775.25,252.0,104.8,5,1508,8030.75,1236.0,301.6
21712.0,6,14,4740,7,653,3367.1666666666665,249.0,93.28571428571428,7,4087,3442.333333333333,1514.0,583.8571428571429
198898.0,17,4,6056,4,6056,66299.33333333333,1514.0,1514.0,0,0,0.0,0.0,0.0
38842.0,6,14,4740,7,653,5550.333333333333,249.0,93.28571428571428,7,4087,5693.166666666667,1514.0,583.8571428571429
208168.0,6,10,1221,6,636,41633.6,298.0,106.0,4,585,67796.66666666667,379.0,146.25
318.0,17,2,174,1,79,0.0,79.0,79.0,1,95,0.0,95.0,95.0
108102851.0,17,5,955,5,955,27025712.75,191.0,191.0,0,0,0.0,0.0,0.0
1272799.0,17,6,1230,3,234,636182.0,78.0,78.0,3,996,636183.5,332.0,332.0
108106242.0,17,5,955,5,955,27026560.5,191.0,191.0,0,0,0.0,0.0,0.0
312.0,17,2,174,1,79,0.0,79.0,79.0,1,95,0.0,95.0,95.0
302612.0,17,2,246,1,76,0.0,76.0,76.0,1,170,0.0,170.0,170.0
2370.0,17,4,344,2,150,0.0,75.0,75.0,2,194,0.0,103.0,97.0
312917.0,17,4,1400,4,1400,104305.66666666669,350.0,350.0,0,0,0.0,0.0,0.0
2051727.0,6,4,270,2,134,0.0,68.0,67.0,2,136,0.0,70.0,68.0
146075.0,6,3,337,2,214,0.0,160.0,107.0,1,123,0.0,123.0,123.0
59881.0,6,14,4740,7,653,9738.0,249.0,93.28571428571428,7,4087,8404.5,1514.0,583.8571428571429
92988873.0,6,27,1938,14,1029,7135915.923076923,123.0,73.5,13,909,7730387.666666667,123.0,69.92307692307692
245688.0,6,3,337,2,214,0.0,160.0,107.0,1,123,0.0,123.0,123.0
33848.0,6,14,4740,7,653,5270.0,249.0,93.28571428571428,7,4087,5506.666666666667,1514.0,583.8571428571429
505680.0,6,5,336,2,134,0.0,68.0,67.0,3,202,193902.5,70.0,67.33333333333333
104121.0,17,2,286,2,286,0.0,143.0,143.0,0,0,0.0,0.0,0.0
25592.0,6,14,4740,7,653,4065.5,249.0,93.28571428571428,7,4087,3879.3333333333335,1514.0,583.8571428571429
308133.0,6,6,412,4,272,102711.0,74.0,68.0,2,140,0.0,74.0,70.0
147254.0,6,3,373,2,238,0.0,172.0,119.0,1,135,0.0,135.0,135.0
120120623.0,6,17,2560,9,1204,15015077.875,188.0,133.77777777777777,8,1356,12904002.42857143,204.0,169.5
237099.0,6,3,337,2,214,0.0,160.0,107.0,1,123,0.0,123.0,123.0
12293.0,6,11,1131,6,600,2262.8,262.0,100.0,5,531,2705.75,259.0,106.2
109262905.0,17,14,864,7,432,18168114.0,174.0,61.71428571428572,7,432,18166886.0,174.0,61.71428571428572
90011175.0,6,20,1490,10,745,10001241.666666666,95.0,74.5,10,745,9975544.777777778,95.0,74.5
107254.0,17,2,286,2,286,0.0,143.0,143.0,0,0,0.0,0.0,0.0
224421.0,6,3,426,2,280,0.0,214.0,140.0,1,146,0.0,146.0,146.0
314.0,17,2,174,1,79,0.0,79.0,79.0,1,95,0.0,95.0,95.0
1307486.0,6,4,264,2,132,0.0,66.0,66.0,2,132,0.0,66.0,66.0
262525.0,6,10,1221,6,636,52505.0,298.0,106.0,4,585,82106.66666666667,379.0,146.25
135140791.0,17,6,1146,6,1146,27028158.2,191.0,191.0,0,0,0.0,0.0,0.0
256125.0,6,3,337,2,214,0.0,160.0,107.0,1,123,0.0,123.0,123.0
220858.0,17,2,180,1,90,0.0,90.0,90.0,1,90,0.0,90.0,90.0
90256228.0,6,13,1898,8,1016,12893746.857142856,188.0,127.0,5,882,22523283.5,204.0,176.4
231845.0,6,3,337,2,214,0.0,160.0,107.0,1,123,0.0,123.0,123.0
22543.0,6,10,2032,5,524,5393.5,252.0,104.8,5,1508,5329.5,1236.0,301.6
112522.0,17,4,1400,4,1400,37507.333333333336,350.0,350.0,0,0,0.0,0.0,0.0
789.0,17,4,438,2,148,0.0,74.0,74.0,2,290,0.0,147.0,145.0
10457072.0,6,7,478,4,272,3438599.6666666665,74.0,68.0,3,206,5157801.0,74.0,68.66666666666667
108102804.0,17,5,1005,5,1005,27025701.0,201.0,201.0,0,0,0.0,0.0,0.0
4241.0,17,4,344,2,150,0.0,75.0,75.0,2,194,0.0,103.0,97.0
336.0,17,2,166,1,75,0.0,75.0,75.0,1,91,0.0,91.0,91.0
0.0,17,1,381,1,381,0.0,381.0,381.0,0,0,0.0,0.0,0.0
90007221.0,17,12,778,6,389,18001444.2,174.0,64.83333333333333,6,389,17800224.2,174.0,64.83333333333333
143865.0,17,2,180,1,90,0.0,90.0,90.0,1,90,0.0,90.0,90.0
36444.0,6,14,4740,7,653,5540.166666666667,249.0,93.28571428571428,7,4087,5410.166666666667,1514.0,583.8571428571429
90258268.0,6,13,2036,8,1016,12894038.285714284,188.0,127.0,5,1020,22523378.5,204.0,204.0
305459.0,6,6,412,4,272,101819.66666666669,74.0,68.0,2,140,0.0,74.0,70.0
0.0,17,1,72,1,72,0.0,72.0,72.0,0,0,0.0,0.0,0.0
2305.0,17,4,344,2,150,0.0,75.0,75.0,2,194,0.0,103.0,97.0
10764.0,17,2,582,1,83,0.0,83.0,83.0,1,499,0.0,499.0,499.0
120127389.0,6,15,2428,9,1204,15015923.625,188.0,133.77777777777777,6,1224,18071932.4,204.0,204.0
1177902.0,6,13,3008,8,2380,168271.7142857143,1514.0,297.5,5,628,226329.75,331.0,125.6
216618.0,17,2,180,1,90,0.0,90.0,90.0,1,90,0.0,90.0,90.0
90020316.0,17,28,13364,28,13364,3334085.777777778,501.0,477.2857142857143,0,0,0.0,0.0,0.0
33462.0,6,14,4740,7,653,5411.333333333333,249.0,93.28571428571428,7,4087,5439.666666666667,1514.0,583.8571428571429
107720.0,17,2,286,2,286,0.0,143.0,143.0,0,0,0.0,0.0,0.0
218063.0,6,3,426,2,280,0.0,214.0,140.0,1,146,0.0,146.0,146.0
315.0,17,2,174,1,79,0.0,79.0,79.0,1,95,0.0,95.0,95.0
2389.0,17,4,344,2,150,0.0,75.0,75.0,2,194,0.0,103.0,97.0
147085.0,17,2,176,1,80,0.0,80.0,80.0,1,96,0.0,96.0,96.0
72056103.0,6,9,842,9,842,9007012.875,97.0,93.55555555555556,0,0,0.0,0.0,0.0
33468.0,6,10,2032,5,524,7918.0,252.0,104.8,5,1508,7674.25,1236.0,301.6
191038.0,17,2,180,1,90,0.0,90.0,90.0,1,90,0.0,90.0,90.0
108099836.0,17,5,955,5,955,27024959.0,191.0,191.0,0,0,0.0,0.0,0.0
232848.0,6,3,337,2,214,0.0,160.0,107.0,1,123,0.0,123.0,123.0
132996.0,6,3,337,2,214,0.0,160.0,107.0,1,123,0.0,123.0,123.0
211336.0,17,2,180,1,90,0.0,90.0,90.0,1,90,0.0,90.0,90.0
123010.0,6,3,337,2,214,0.0,160.0,107.0,1,123,0.0,123.0,123.0
51383.0,6,14,4740,7,653,8324.0,249.0,93.28571428571428,7,4087,6579.0,1514.0,583.8571428571429
44096.0,6,14,4740,7,653,5943.5,249.0,93.28571428571428,7,4087,7036.5,1514.0,583.8571428571429
2451550.0,6,25,7573,14,3735,188580.7692307692,1514.0,266.7857142857143,11,3838,218874.7,1514.0,348.90909090909093
100248504.0,17,12,778,6,389,20049700.8,174.0,64.83333333333333,6,389,19923818.8,174.0,64.83333333333333
34378.0,6,13,4416,6,409,6733.8,127.0,68.16666666666667,7,4007,4318.0,1514.0,572.4285714285714
135128959.0,17,6,1146,6,1146,27025791.8,191.0,191.0,0,0,0.0,0.0,0.0
135659.0,6,2,132,1,66,0.0,66.0,66.0,1,66,0.0,66.0,66.0
6806.0,17,2,582,1,83,0.0,83.0,83.0,1,499,0.0,499.0,499.0
45671.0,6,14,4740,7,653,7041.833333333333,249.0,93.28571428571428,7,4087,7425.833333333333,1514.0,583.8571428571429
90071372.0,17,28,13364,28,13364,3335976.7407407407,501.0,477.2857142857143,0,0,0.0,0.0,0.0
10457250.0,6,7,478,4,272,3440335.0,74.0,68.0,3,206,5160380.5,74.0,68.66666666666667
29261.0,6,14,4740,7,653,4570.0,249.0,93.28571428571428,7,4087,4740.0,1514.0,583.8571428571429
2316.0,17,4,344,2,150,0.0,75.0,75.0,2,194,0.0,103.0,97.0
44602.0,6,14,4740,7,653,6728.666666666667,249.0,93.28571428571428,7,4087,6477.5,1514.0,583.8571428571429
319608.0,17,4,1400,4,1400,106536.0,350.0,350.0,0,0,0.0,0.0,0.0
9818.0,6,10,1067,5,536,2291.0,264.0,107.2,5,531,2186.5,259.0,106.2
10486469.0,6,7,478,4,272,3449872.333333333,74.0,68.0,3,206,5174691.5,74.0,68.66666666666667
2593666.0,6,2,132,1,66,0.0,66.0,66.0,1,66,0.0,66.0,66.0
121268.0,6,3,337,2,214,0.0,160.0,107.0,1,123,0.0,123.0,123.0
108102189.0,17,5,955,5,955,27025547.25,191.0,191.0,0,0,0.0,0.0,0.0
106867.0,17,2,700,2,700,0.0,350.0,350.0,0,0,0.0,0.0,0.0
318053.0,17,4,1400,4,1400,106017.66666666669,350.0,350.0,0,0,0.0,0.0,0.0
236835.0,6,10,1221,6,636,47367.0,298.0,106.0,4,585,78082.66666666667,379.0,146.25
40465.0,6,14,4740,7,653,6618.833333333333,249.0,93.28571428571428,7,4087,6459.333333333333,1514.0,583.8571428571429
35604.0,6,14,4740,7,653,5805.5,249.0,93.28571428571428,7,4087,5538.0,1514.0,583.8571428571429
63224.0,6,14,4740,7,653,10326.166666666666,249.0,93.28571428571428,7,4087,10088.5,1514.0,583.8571428571429
507676.0,6,5,336,2,134,0.0,68.0,67.0,3,202,191817.0,70.0,67.33333333333333
135119321.0,17,6,1146,6,1146,27023864.2,191.0,191.0,0,0,0.0,0.0,0.0
385247.0,6,12,1373,7,714,64207.833333333336,298.0,102.0,5,659,94889.75,379.0,131.8
296535.0,17,2,180,1,90,0.0,90.0,90.0,1,90,0.0,90.0,90.0
30231443.0,6,7,982,4,508,10077147.666666666,188.0,127.0,3,474,15034942.0,204.0,158.0
202456.0,17,4,6056,4,6056,67485.33333333333,1514.0,1514.0,0,0,0.0,0.0,0.0
316743.0,17,4,1400,4,1400,105581.0,350.0,350.0,0,0,0.0,0.0,0.0
190872.0,17,2,180,1,90,0.0,90.0,90.0,1,90,0.0,90.0,90.0
207909.0,6,3,426,2,280,0.0,214.0,140.0,1,146,0.0,146.0,146.0
108103440.0,17,5,955,5,955,27025860.0,191.0,191.0,0,0,0.0,0.0,0.0
0.0,6,1,54,0,0,0.0,0.0,0.0,1,54,0.0,54.0,54.0
321515.0,6,3,1604,1,753,0.0,753.0,753.0,2,851,0.0,785.0,425.5
44706.0,6,14,4740,7,653,6681.0,249.0,93.28571428571428,7,4087,6977.0,1514.0,583.8571428571429
55899.0,6,14,4740,7,653,8913.166666666666,249.0,93.28571428571428,7,4087,9101.833333333334,1514.0,583.8571428571429
298488.0,6,6,412,4,272,99496.0,74.0,68.0,2,140,0.0,74.0,70.0
359.0,17,2,267,1,83,0.0,83.0,83.0,1,184,0.0,184.0,184.0
283936.0,17,2,363,1,79,0.0,79.0,79.0,1,284,0.0,284.0,284.0
105110.0,17,2,700,2,700,0.0,350.0,350.0,0,0,0.0,0.0,0.0
393418.0,6,3,204,2,136,0.0,70.0,68.0,1,68,0.0,68.0,68.0
299.0,17,2,168,1,76,0.0,76.0,76.0,1,92,0.0,92.0,92.0
197008.0,17,2,180,1,90,0.0,90.0,90.0,1,90,0.0,90.0,90.0
14760.0,17,2,180,1,90,0.0,90.0,90.0,1,90,0.0,90.0,90.0
362646.0,6,10,967,5,390,60766.0,162.0,78.0,5,577,60706.0,349.0,115.4
0.0,17,1,438,1,438,0.0,438.0,438.0,0,0,0.0,0.0,0.0
120225635.0,6,226,25656,113,7680,1066065.044642857,140.0,67.96460176991151,113,17976,1065857.732142857,374.0,159.0796460176991
3518.0,17,2,493,1,88,0.0,88.0,88.0,1,405,0.0,405.0,405.0
19505.0,6,10,2032,5,524,3534.0,252.0,104.8,5,1508,4589.0,1236.0,301.6
306135.0,6,6,412,4,272,102045.0,74.0,68.0,2,140,0.0,74.0,70.0
108106498.0,17,5,955,5,955,27026624.5,191.0,191.0,0,0,0.0,0.0,0.0
312402.0,6,6,412,4,272,104134.0,74.0,68.0,2,140,0.0,74.0,70.0
237967.0,6,3,426,2,280,0.0,214.0,140.0,1,146,0.0,146.0,146.0
242183.0,6,3,337,2,214,0.0,160.0,107.0,1,123,0.0,123.0,123.0
107529.0,17,2,286,2,286,0.0,143.0,143.0,0,0,0.0,0.0,0.0
120038618.0,17,28,13364,28,13364,4445874.740740741,501.0,477.2857142857143,0,0,0.0,0.0,0.0
103588.0,17,2,286,2,286,0.0,143.0,143.0,0,0,0.0,0.0,0.0
228317.0,17,2,180,1,90,0.0,90.0,90.0,1,90,0.0,90.0,90.0
34976.0,17,2,582,1,83,0.0,83.0,83.0,1,499,0.0,499.0,499.0
103530724.0,6,42,2772,21,1386,5160439.05,66.0,66.0,21,1386,5160393.15,66.0,66.0
206594.0,6,10,1221,6,636,41318.8,298.0,106.0,4,585,67800.33333333333,379.0,146.25
3821.0,17,4,344,2,150,0.0,75.0,75.0,2,194,0.0,103.0,97.0
193737.0,17,2,180,1,90,0.0,90.0,90.0,1,90,0.0,90.0,90.0
1173966.0,6,13,3010,8,2382,167709.42857142858,1514.0,297.75,5,628,224558.0,331.0,125.6
90092884.0,6,12,1848,5,1020,22522955.0,204.0,204.0,7,828,15014962.833333334,188.0,118.28571428571428
255940.0,6,3,337,2,214,0.0,160.0,107.0,1,123,0.0,123.0,123.0
284796.0,17,2,363,1,79,0.0,79.0,79.0,1,284,0.0,284.0,284.0
90251714.0,6,11,1766,7,950,15015346.166666666,188.0,135.71428571428572,4,816,30030661.0,204.0,204.0
301535.0,6,6,412,4,272,100511.66666666669,74.0,68.0,2,140,0.0,74.0,70.0
108110860.0,17,5,955,5,955,27027715.0,191.0,191.0,0,0,0.0,0.0,0.0
35142.0,6,10,2032,5,524,8545.5,252.0,104.8,5,1508,7057.25,1236.0,301.6
153481.0,17,2,180,1,90,0.0,90.0,90.0,1,90,0.0,90.0,90.0
2802216.0,6,2,132,1,66,0.0,66.0,66.0,1,66,0.0,66.0,66.0
136202.0,6,2,132,1,66,0.0,66.0,66.0,1,66,0.0,66.0,66.0
303254.0,6,6,412,4,272,101084.66666666669,74.0,68.0,2,140,0.0,74.0,70.0
205939.0,6,3,426,2,280,0.0,214.0,140.0,1,146,0.0,146.0,146.0
2100.0,17,4,820,2,156,0.0,78.0,78.0,2,664,0.0,332.0,332.0
2322.0,17,4,344,2,150,0.0,75.0,75.0,2,194,0.0,103.0,97.0
47611565.0,6,8,1940,3,887,22735395.5,753.0,295.6666666666667,5,1053,11208794.5,785.0,210.6
143870.0,17,2,180,1,90,0.0,90.0,90.0,1,90,0.0,90.0,90.0
675.0,17,4,438,2,148,0.0,74.0,74.0,2,290,0.0,147.0,145.0
195016.0,17,2,180,1,90,0.0,90.0,90.0,1,90,0.0,90.0,90.0
116663431.0,6,34,2334,17,1209,7277977.5,123.0,71.11764705882354,17,1125,7277977.1875,123.0,66.17647058823529
2088.0,17,4,344,2,150,0.0,75.0,75.0,2,194,0.0,103.0,97.0
108299541.0,6,32,2220,16,1149,7219969.4,123.0,71.8125,16,1071,7205538.666666667,123.0,66.9375
362.0,17,2,267,1,83,0.0,83.0,83.0,1,184,0.0,184.0,184.0
48834.0,6,14,4740,7,653,6455.0,249.0,93.28571428571428,7,4087,7778.0,1514.0,583.8571428571429
46029.0,6,14,4740,7,653,7043.666666666667,249.0,93.28571428571428,7,4087,7432.166666666667,1514.0,583.8571428571429
4358.0,17,2,626,1,72,0.0,72.0,72.0,1,554,0.0,554.0,554.0
102672.0,17,2,286,2,286,0.0,143.0,143.0,0,0,0.0,0.0,0.0
121008168.0,17,15,1169,8,606,17286881.14285714,174.0,75.75,7,563,16833489.666666668,174.0,80.42857142857143
312232.0,6,6,412,4,272,104077.33333333331,74.0,68.0,2,140,0.0,74.0,70.0
118497971.0,6,31,2166,15,1017,7750781.857142857,123.0,67.8,16,1149,7384833.8,123.0,71.8125
108297718.0,17,14,864,7,432,18002215.5,174.0,61.71428571428572,7,432,18000084.333333332,174.0,61.71428571428572
120110755.0,6,14,2224,9,1204,15013844.375,188.0,133.77777777777777,5,1020,22520404.5,204.0,204.0
147670.0,6,3,337,2,214,0.0,160.0,107.0,1,123,0.0,123.0,123.0
120118066.0,6,14,2240,6,1224,24023613.2,204.0,204.0,8,1016,17136208.85714286,188.0,127.0
217227.0,6,3,426,2,280,0.0,214.0,140.0,1,146,0.0,146.0,146.0
153535.0,17,2,180,1,90,0.0,90.0,90.0,1,90,0.0,90.0,90.0
51575.0,6,14,4740,7,653,7600.0,249.0,93.28571428571428,7,4087,8261.5,1514.0,583.8571428571429
93098.0,6,14,4740,7,653,14919.166666666666,249.0,93.28571428571428,7,4087,15372.0,1514.0,583.8571428571429
31951.0,6,14,4740,7,653,5162.5,249.0,93.28571428571428,7,4087,5080.166666666667,1514.0,583.8571428571429
256.0,17,3,1050,3,1050,128.0,350.0,350.0,0,0,0.0,0.0,0.0
12907.0,17,4,823,2,163,0.0,89.0,81.5,2,660,0.0,443.0,330.0
108107459.0,17,5,955,5,955,27026864.75,191.0,191.0,0,0,0.0,0.0,0.0
120012950.0,17,28,13364,28,13364,4444924.074074074,501.0,477.2857142857143,0,0,0.0,0.0,0.0
90036486.0,17,28,13364,28,13364,3334684.6666666665,501.0,477.2857142857143,0,0,0.0,0.0,0.0
90258992.0,6,14,1964,8,1016,12894141.714285716,188.0,127.0,6,948,18019019.6,204.0,158.0
512.0,17,2,267,1,83,0.0,83.0,83.0,1,184,0.0,184.0,184.0
120111711.0,6,228,25772,114,7820,1046616.8407079646,140.0,68.59649122807018,114,17952,1058144.7610619469,284.0,157.47368421052633
318.0,17,2,174,1,79,0.0,79.0,79.0,1,95,0.0,95.0,95.0
1024502.0,6,11,1134,6,558,204900.4,220.0,93.0,5,576,255402.75,304.0,115.2
90525434.0,6,15,2444,8,1016,12932204.857142856,188.0,127.0,7,1428,15060315.166666666,204.0,204.0
90295223.0,6,26,2863,13,1410,7520409.833333333,427.0,108.46153846153848,13,1453,7523358.75,337.0,111.76923076923076
107443.0,17,2,286,2,286,0.0,143.0,143.0,0,0,0.0,0.0,0.0
14710304.0,6,20,1607,10,975,1592448.6666666667,315.0,97.5,10,632,1590940.888888889,78.0,63.2
254267.00000000003,6,3,337,2,214,0.0,160.0,107.0,1,123,0.0,123.0,123.0
120029685.0,17,29,13785,29,13785,4286774.464285715,501.0,475.3448275862069,0,0,0.0,0.0,0.0
100510920.0,6,29,1983,15,1017,7179351.428571428,123.0,67.8,14,966,7714653.846153846,123.0,69.0
120242968.0,6,24,1829,11,881,11999143.4,95.0,80.0909090909091,13,948,9999174.083333334,95.0,72.92307692307692
216787.0,6,10,1221,6,636,43357.4,298.0,106.0,4,585,70447.33333333333,379.0,146.25
935429.0,17,10,3736,10,3736,103936.55555555556,390.0,373.6,0,0,0.0,0.0,0.0
120055528.0,17,28,13364,28,13364,4446501.037037037,501.0,477.2857142857143,0,0,0.0,0.0,0.0
115522774.0,6,47,3102,24,1584,5013344.782608695,66.0,66.0,23,1518,5105438.909090909,66.0,66.0
146157.0,6,3,337,2,214,0.0,160.0,107.0,1,123,0.0,123.0,123.0
380.0,17,2,508,2,508,0.0,257.0,254.0,0,0,0.0,0.0,0.0
90525131.0,6,15,2444,8,1016,12932161.57142857,188.0,127.0,7,1428,15060217.5,204.0,204.0
223805.0,6,3,426,2,280,0.0,214.0,140.0,1,146,0.0,146.0,146.0
148050.0,17,2,180,1,90,0.0,90.0,90.0,1,90,0.0,90.0,90.0
238039.0,17,2,180,1,90,0.0,90.0,90.0,1,90,0.0,90.0,90.0
214456.0,6,10,1221,6,636,42891.2,298.0,106.0,4,585,70147.33333333333,379.0,146.25
108112167.0,17,5,955,5,955,27028041.75,191.0,191.0,0,0,0.0,0.0,0.0
232791.0,6,3,337,2,214,0.0,160.0,107.0,1,123,0.0,123.0,123.0
112040528.0,6,35,2542,18,1348,6577931.647058823,139.0,74.88888888888889,17,1194,6989050.9375,123.0,70.23529411764706
247634.0,6,3,337,2,214,0.0,160.0,107.0,1,123,0.0,123.0,123.0
9384.0,17,2,539,1,86,0.0,86.0,86.0,1,453,0.0,453.0,453.0
540200.0,17,6,2100,6,2100,108040.0,350.0,350.0,0,0,0.0,0.0,0.0
36860.0,6,14,4740,7,653,5767.166666666667,249.0,93.28571428571428,7,4087,5664.833333333333,1514.0,583.8571428571429
209511.0,17,2,180,1,90,0.0,90.0,90.0,1,90,0.0,90.0,90.0
93926590.0,6,427,88594,209,14238,451570.1442307693,214.0,68.1244019138756,218,74356,431790.2534562212,1514.0,341.08256880733944
291482.0,6,10,1221,6,636,58296.4,298.0,106.0,4,585,91402.33333333331,379.0,146.25
5619235.0,6,5,336,2,134,0.0,68.0,67.0,3,202,1524080.0,70.0,67.33333333333333
37606.0,6,10,2032,5,524,9168.0,252.0,104.8,5,1508,5674.25,1236.0,301.6
44195.0,6,14,4740,7,653,7092.166666666667,249.0,93.28571428571428,7,4087,7234.666666666667,1514.0,583.8571428571429
250291.0,17,4,6056,4,6056,83430.33333333333,1514.0,1514.0,0,0,0.0,0.0,0.0
14136.0,6,14,4740,7,653,2182.1666666666665,249.0,93.28571428571428,7,4087,2222.5,1514.0,583.8571428571429
415.0,17,2,174,1,79,0.0,79.0,79.0,1,95,0.0,95.0,95.0
43341.0,6,14,4740,7,653,6449.833333333333,249.0,93.28571428571428,7,4087,6443.833333333333,1514.0,583.8571428571429
522405.0,17,6,2100,6,2100,104481.0,350.0,350.0,0,0,0.0,0.0,0.0
103548.0,17,2,286,2,286,0.0,143.0,143.0,0,0,0.0,0.0,0.0
4154.0,17,4,344,2,150,0.0,75.0,75.0,2,194,0.0,103.0,97.0
63069.0,6,10,1810,5,358,15412.25,130.0,71.6,5,1452,13733.25,1224.0,290.4
5007874.0,17,4,849,2,166,0.0,83.0,83.0,2,683,0.0,499.0,341.5
302425.0,6,2,132,1,66,0.0,66.0,66.0,1,66,0.0,66.0,66.0
228447.0,17,2,180,1,90,0.0,90.0,90.0,1,90,0.0,90.0,90.0
153477.0,17,2,180,1,90,0.0,90.0,90.0,1,90,0.0,90.0,90.0
150564.0,6,11,1132,6,556,30112.8,218.0,92.66666666666669,5,576,36927.25,304.0,115.2
43838.0,6,14,4740,7,653,6609.833333333333,249.0,93.28571428571428,7,4087,6641.833333333333,1514.0,583.8571428571429
90299831.0,6,21,1585,11,840,9025474.5,95.0,76.36363636363636,10,745,10000438.666666666,95.0,74.5
216549.0,17,2,180,1,90,0.0,90.0,90.0,1,90,0.0,90.0,90.0
121808.0,6,3,373,2,238,0.0,172.0,119.0,1,135,0.0,135.0,135.0
90108226.0,6,12,1848,5,1020,22523443.5,204.0,204.0,7,828,15017775.333333334,188.0,118.28571428571428
111164159.0,6,273,31118,137,9338,817383.5220588235,140.0,68.16058394160584,136,21780,815878.9037037037,336.0,160.14705882352942
405860.0,6,3,1604,2,851,0.0,785.0,425.5,1,753,0.0,753.0,753.0
147976.0,17,2,180,1,90,0.0,90.0,90.0,1,90,0.0,90.0,90.0
228236.0,6,3,426,2,280,0.0,214.0,140.0,1,146,0.0,146.0,146.0
119637256.0,6,248,28262,124,19782,971847.18699187,284.0,159.53225806451613,124,8480,970909.62601626,140.0,68.38709677419355
319110.0,6,6,412,4,272,106370.0,74.0,68.0,2,140,0.0,74.0,70.0
153866.0,17,2,180,1,90,0.0,90.0,90.0,1,90,0.0,90.0,90.0
108108383.0,17,5,955,5,955,27027095.75,191.0,191.0,0,0,0.0,0.0,0.0
232111.0,6,3,337,2,214,0.0,160.0,107.0,1,123,0.0,123.0,123.0
120282463.0,6,17,1287,9,691,15035307.875,95.0,76.77777777777777,8,596,17107486.714285713,95.0,74.5
5005575.0,17,4,849,2,166,0.0,83.0,83.0,2,683,0.0,499.0,341.5
32404.000000000004,6,11,2098,6,590,6480.8,252.0,98.33333333333331,5,1508,7762.75,1236.0,301.6
107348.0,17,2,286,2,286,0.0,143.0,143.0,0,0,0.0,0.0,0.0
46939.0,6,14,4740,7,653,7713.333333333333,249.0,93.28571428571428,7,4087,6732.666666666667,1514.0,583.8571428571429
108104923.0,17,5,955,5,955,27026230.75,191.0,191.0,0,0,0.0,0.0,0.0
668.0,17,2,762,2,762,0.0,381.0,381.0,0,0,0.0,0.0,0.0
238090.0,6,3,337,2,214,0.0,160.0,107.0,1,123,0.0,123.0,123.0
846.0,17,4,438,2,148,0.0,74.0,74.0,2,290,0.0,147.0,145.0
829.0,17,4,438,2,148,0.0,74.0,74.0,2,290,0.0,147.0,145.0
135132966.0,17,6,1206,6,1206,27026593.2,201.0,201.0,0,0,0.0,0.0,0.0
122009930.0,17,15,1169,8,606,17429990.0,174.0,75.75,7,563,17000158.5,174.0,80.42857142857143
233048.0,6,3,337,2,214,0.0,160.0,107.0,1,123,0.0,123.0,123.0
143825.0,17,2,180,1,90,0.0,90.0,90.0,1,90,0.0,90.0,90.0
2705286.0,6,3,1604,1,753,0.0,753.0,753.0,2,851,0.0,785.0,425.5
108090816.0,17,5,955,5,955,27022704.0,191.0,191.0,0,0,0.0,0.0,0.0
107392.0,17,2,286,2,286,0.0,143.0,143.0,0,0,0.0,0.0,0.0
37589.0,6,14,4740,7,653,5701.666666666667,249.0,93.28571428571428,7,4087,5859.833333333333,1514.0,583.8571428571429
2781472.0,6,2,132,1,66,0.0,66.0,66.0,1,66,0.0,66.0,66.0
95371155.0,17,12,778,6,389,19003045.0,174.0,64.83333333333333,6,389,19000171.4,174.0,64.83333333333333
136882908.0,17,14,864,7,432,19500173.5,174.0,61.71428571428572,7,432,19501155.666666668,174.0,61.71428571428572
205579.0,17,4,6056,4,6056,68526.33333333333,1514.0,1514.0,0,0,0.0,0.0,0.0
315527.0,17,4,1400,4,1400,105175.66666666669,350.0,350.0,0,0,0.0,0.0,0.0
54298.0,6,14,4740,7,653,8782.666666666666,249.0,93.28571428571428,7,4087,8090.833333333333,1514.0,583.8571428571429
232918.0,6,3,337,2,214,0.0,160.0,107.0,1,123,0.0,123.0,123.0
2362.0,17,4,344,2,150,0.0,75.0,75.0,2,194,0.0,103.0,97.0
37849.0,6,14,4740,7,653,5210.5,249.0,93.28571428571428,7,4087,6125.833333333333,1514.0,583.8571428571429
10522064.0,6,7,478,4,272,3461992.6666666665,74.0,68.0,3,206,5192889.5,74.0,68.66666666666667
1815.0,17,5,550,5,550,453.75,110.0,110.0,0,0,0.0,0.0,0.0
216433.0,17,2,180,1,90,0.0,90.0,90.0,1,90,0.0,90.0,90.0
90256766.0,6,13,1898,8,1016,12893823.714285716,188.0,127.0,5,882,22523733.25,204.0,176.4
39254.0,6,14,4740,7,653,5730.5,249.0,93.28571428571428,7,4087,5759.0,1514.0,583.8571428571429
228451.0,17,2,180,1,90,0.0,90.0,90.0,1,90,0.0,90.0,90.0
121492928.0,6,221,25040,111,17484,1104481.1636363636,284.0,157.51351351351352,110,7556,1095683.23853211,140.0,68.69090909090909
120059806.0,17,29,13785,29,13785,4287850.214285715,501.0,475.3448275862069,0,0,0.0,0.0,0.0
13877.0,17,2,498,1,80,0.0,80.0,80.0,1,418,0.0,418.0,418.0
20509.0,6,11,1133,6,602,3345.4,264.0,100.33333333333331,5,531,4217.0,259.0,106.2
84910.0,6,10,2032,5,524,19355.75,252.0,104.8,5,1508,18296.25,1236.0,301.6
108107300.0,17,5,1005,5,1005,27026825.0,201.0,201.0,0,0,0.0,0.0,0.0
52533.0,6,10,2032,5,524,12905.0,252.0,104.8,5,1508,12576.0,1236.0,301.6
45074115.0,17,9,3086,8,2736,5107731.714285715,342.0,342.0,1,350,0.0,350.0,350.0
104521.0,17,2,762,2,762,0.0,381.0,381.0,0,0,0.0,0.0,0.0
26380.0,6,10,2033,5,525,5826.5,253.0,105.0,5,1508,6142.75,1236.0,301.6
147919.0,17,2,180,1,90,0.0,90.0,90.0,1,90,0.0,90.0,90.0
436860.0,6,11,1021,6,444,58609.2,162.0,74.0,5,577,73161.75,349.0,115.4
2397.0,17,4,344,2,150,0.0,75.0,75.0,2,194,0.0,103.0,97.0
48130.0,6,14,4740,7,653,7564.0,249.0,93.28571428571428,7,4087,6786.166666666667,1514.0,583.8571428571429
157301.0,6,3,337,2,214,0.0,160.0,107.0,1,123,0.0,123.0,123.0
135145617.0,17,6,1146,6,1146,27029123.4,191.0,191.0,0,0,0.0,0.0,0.0
42875.0,6,14,4740,7,653,7006.333333333333,249.0,93.28571428571428,7,4087,6660.166666666667,1514.0,583.8571428571429
1086.0,17,2,508,2,508,0.0,257.0,254.0,0,0,0.0,0.0,0.0
35085.0,6,10,2032,5,524,5322.0,252.0,104.8,5,1508,8500.25,1236.0,301.6
135135967.0,17,6,1146,6,1146,27027193.4,191.0,191.0,0,0,0.0,0.0,0.0
132231.0,6,11,2098,6,590,26120.2,252.0,98.33333333333331,5,1508,32735.25,1236.0,301.6
114833368.0,6,48,3168,24,1584,4992755.130434782,66.0,66.0,24,1584,4979484.304347826,66.0,66.0
104004568.0,17,13,821,7,432,17334094.666666668,174.0,61.71428571428572,6,389,16800161.6,174.0,64.83333333333333
120078184.0,17,29,13785,29,13785,4288506.571428572,501.0,475.3448275862069,0,0,0.0,0.0,0.0
298449.0,6,6,412,4,272,99483.0,74.0,68.0,2,140,0.0,74.0,70.0
0.0,17,1,55,1,55,0.0,55.0,55.0,0,0,0.0,0.0,0.0
135125933.0,17,6,1206,6,1206,27025186.6,201.0,201.0,0,0,0.0,0.0,0.0
120000047.0,6,17,1287,9,691,15000005.875,95.0,76.77777777777777,8,596,12899382.57142857,95.0,74.5
120079274.0,6,232,26200,116,18248,1042296.1652173912,284.0,157.31034482758622,116,7952,1042296.8086956522,140.0,68.55172413793103
13163.0,17,2,571,1,86,0.0,86.0,86.0,1,485,0.0,485.0,485.0
120028578.0,17,28,13364,28,13364,4445502.888888889,501.0,477.2857142857143,0,0,0.0,0.0,0.0
2321.0,17,4,344,2,150,0.0,75.0,75.0,2,194,0.0,103.0,97.0
235141.0,6,3,337,2,214,0.0,160.0,107.0,1,123,0.0,123.0,123.0
118048193.0,6,30,1974,15,1026,8416585.5,123.0,68.4,15,948,8416584.0,123.0,63.2
2372.0,17,4,344,2,150,0.0,75.0,75.0,2,194,0.0,103.0,97.0
71359.0,6,14,4740,7,653,11723.0,249.0,93.28571428571428,7,4087,11497.333333333334,1514.0,583.8571428571429
349795.0,17,4,704,2,148,0.0,74.0,74.0,2,556,0.0,280.0,278.0
227024.0,6,3,426,2,280,0.0,214.0,140.0,1,146,0.0,146.0,146.0
123956354.0,6,35,2394,18,1269,7291550.235294118,123.0,70.5,17,1125,7109722.0625,123.0,66.17647058823529
153401.0,17,2,180,1,90,0.0,90.0,90.0,1,90,0.0,90.0,90.0
117469312.0,6,240,27178,120,18962,985327.7394957984,284.0,158.01666666666668,120,8216,985328.2941176472,140.0,68.46666666666667
765.0,17,4,438,2,148,0.0,74.0,74.0,2,290,0.0,147.0,145.0
198901.0,17,2,180,1,90,0.0,90.0,90.0,1,90,0.0,90.0,90.0
319310.0,6,6,412,4,272,106436.66666666669,74.0,68.0,2,140,0.0,74.0,70.0
51439.0,6,14,4740,7,653,8446.166666666666,249.0,93.28571428571428,7,4087,6873.166666666667,1514.0,583.8571428571429
496638.0,6,5,336,2,134,0.0,68.0,67.0,3,202,196536.5,70.0,67.33333333333333
225505.0,6,10,1221,6,636,45101.0,298.0,106.0,4,585,73817.66666666667,379.0,146.25
159340.0,6,3,337,2,214,0.0,160.0,107.0,1,123,0.0,123.0,123.0
314155.0,17,4,1400,4,1400,104718.33333333331,350.0,350.0,0,0,0.0,0.0,0.0
120441602.0,6,22,1680,10,745,10101736.222222222,95.0,74.5,12,935,10927270.181818182,95.0,77.91666666666667
251993.00000000003,6,10,1221,6,636,50398.6,298.0,106.0,4,585,82929.0,379.0,146.25
269033.0,6,12,1373,7,714,44838.833333333336,298.0,102.0,5,659,63040.25,379.0,131.8
204073.0,17,4,6056,4,6056,68024.33333333333,1514.0,1514.0,0,0,0.0,0.0,0.0
90092581.0,6,10,1440,7,828,15015430.166666666,188.0,118.28571428571428,3,612,30028195.5,204.0,204.0
97494058.0,17,14,1126,7,563,16166802.833333334,174.0,80.42857142857143,7,563,16167809.833333334,174.0,80.42857142857143
100202.0,17,2,762,2,762,0.0,381.0,381.0,0,0,0.0,0.0,0.0
90258570.0,6,14,2240,8,1016,12894081.42857143,188.0,127.0,6,1224,18019336.0,204.0,204.0
90042284.0,17,27,12943,27,12943,3463164.769230769,501.0,479.3703703703704,0,0,0.0,0.0,0.0
205895.0,17,2,180,1,90,0.0,90.0,90.0,1,90,0.0,90.0,90.0
120016256.0,17,29,13785,29,13785,4286294.857142857,501.0,475.3448275862069,0,0,0.0,0.0,0.0
90253287.0,6,16,2368,9,1204,11281660.875,188.0,133.77777777777777,7,1164,15015435.5,204.0,166.28571428571428
1816.0,17,2,664,1,322,0.0,322.0,322.0,1,342,0.0,342.0,342.0
109086089.0,6,199,22380,100,6822,1101879.686868687,140.0,68.22,99,15558,1102672.275510204,284.0,157.15151515151516
108340861.0,17,7,1452,6,1146,21668172.2,191.0,191.0,1,306,0.0,306.0,306.0
68201.0,6,10,2032,5,524,16785.0,252.0,104.8,5,1508,16005.75,1236.0,301.6
47264.0,6,14,4740,7,653,7521.5,249.0,93.28571428571428,7,4087,7169.5,1514.0,583.8571428571429
206294.0,17,2,180,1,90,0.0,90.0,90.0,1,90,0.0,90.0,90.0
120529463.0,6,221,25394,111,17838,1095722.3909090909,300.0,160.7027027027027,110,7556,1086601.0550458715,140.0,68.69090909090909
147427.0,6,2,132,1,66,0.0,66.0,66.0,1,66,0.0,66.0,66.0
1884294.0,6,23,6508,12,1529,171255.45454545456,357.0,127.41666666666669,11,4979,156237.1,1510.0,452.6363636363636
196975.0,17,2,180,1,90,0.0,90.0,90.0,1,90,0.0,90.0,90.0
54396.0,6,14,4740,7,653,8626.166666666666,249.0,93.28571428571428,7,4087,7847.166666666667,1514.0,583.8571428571429
114279795.0,6,203,22952,102,7028,1131483.1188118812,140.0,68.90196078431373,101,15924,1132822.06,284.0,157.66336633663366
1937475.0,17,2,876,2,876,0.0,438.0,438.0,0,0,0.0,0.0,0.0
347252.0,6,3,1604,2,851,0.0,785.0,425.5,1,753,0.0,753.0,753.0
121908.0,6,3,337,2,214,0.0,160.0,107.0,1,123,0.0,123.0,123.0
311779.0,6,6,412,4,272,103926.33333333331,74.0,68.0,2,140,0.0,74.0,70.0
90255917.0,6,14,2240,8,1016,12893702.42857143,188.0,127.0,6,1224,18018050.0,204.0,204.0
43576.0,6,14,4740,7,653,7150.833333333333,249.0,93.28571428571428,7,4087,7071.166666666667,1514.0,583.8571428571429
38137.0,6,2,132,1,66,0.0,66.0,66.0,1,66,0.0,66.0,66.0
238436.0,6,3,337,2,214,0.0,160.0,107.0,1,123,0.0,123.0,123.0
13493.0,17,2,539,1,86,0.0,86.0,86.0,1,453,0.0,453.0,453.0
90033427.0,17,27,12943,27,12943,3462824.1153846155,501.0,479.3703703703704,0,0,0.0,0.0,0.0
90029447.0,17,28,13364,28,13364,3334423.962962963,501.0,477.2857142857143,0,0,0.0,0.0,0.0
245618.0,6,3,337,2,214,0.0,160.0,107.0,1,123,0.0,123.0,123.0
410.0,17,2,410,1,78,0.0,78.0,78.0,1,332,0.0,332.0,332.0
171768.0,17,2,180,1,90,0.0,90.0,90.0,1,90,0.0,90.0,90.0
25324.0,6,14,4740,7,653,3915.0,249.0,93.28571428571428,7,4087,4081.8333333333335,1514.0,583.8571428571429
103357.0,17,2,286,2,286,0.0,143.0,143.0,0,0,0.0,0.0,0.0
197720.0,17,2,180,1,90,0.0,90.0,90.0,1,90,0.0,90.0,90.0
123242.0,6,15,4806,8,719,16854.714285714286,249.0,89.875,7,4087,19869.666666666668,1514.0,583.8571428571429
310330.0,17,4,1400,4,1400,103443.33333333331,350.0,350.0,0,0,0.0,0.0,0.0
2249853.0,6,4,1668,2,850,0.0,784.0,425.0,2,818,0.0,752.0,409.0
34270.0,6,14,4740,7,653,5370.666666666667,249.0,93.28571428571428,7,4087,4923.0,1514.0,583.8571428571429
238127.0,6,3,337,2,214,0.0,160.0,107.0,1,123,0.0,123.0,123.0
82985244.0,17,14,4796,13,4446,6227510.833333333,342.0,342.0,1,350,0.0,350.0,350.0
144059.0,17,2,180,1,90,0.0,90.0,90.0,1,90,0.0,90.0,90.0
1412002.0,17,16,1120,16,1120,94133.46666666666,70.0,70.0,0,0,0.0,0.0,0.0
837834.0,6,9,1118,6,586,167566.8,248.0,97.66666666666669,3,532,281117.0,392.0,177.33333333333334
90322602.0,6,21,1585,11,840,9027092.6,95.0,76.36363636363636,10,745,10002586.555555556,95.0,74.5
785.0,17,4,438,2,148,0.0,74.0,74.0,2,290,0.0,147.0,145.0
171625.0,17,2,180,1,90,0.0,90.0,90.0,1,90,0.0,90.0,90.0
108104629.0,17,5,1005,5,1005,27026157.25,201.0,201.0,0,0,0.0,0.0,0.0
47439.0,6,13,1394,7,797,7906.5,253.0,113.85714285714286,6,597,7821.8,259.0,99.5
135131225.0,17,6,1146,6,1146,27026245.0,191.0,191.0,0,0,0.0,0.0,0.0
322956.0,17,4,1400,4,1400,107652.0,350.0,350.0,0,0,0.0,0.0,0.0
246458.0,6,3,337,2,214,0.0,160.0,107.0,1,123,0.0,123.0,123.0
514864.0,6,4,270,2,134,0.0,68.0,67.0,2,136,0.0,70.0,68.0
311937.0,17,4,1400,4,1400,103979.0,350.0,350.0,0,0,0.0,0.0,0.0
336229.0,17,2,582,1,83,0.0,83.0,83.0,1,499,0.0,499.0,499.0
37795.0,6,12,1320,6,723,6589.0,253.0,120.5,6,597,7260.2,259.0,99.5
308536.0,6,6,412,4,272,102845.33333333331,74.0,68.0,2,140,0.0,74.0,70.0
120002617.0,6,20,1617,10,872,13333624.111111112,222.0,87.2,10,745,13303909.555555556,95.0,74.5
312032.0,6,3,202,2,128,0.0,74.0,64.0,1,74,0.0,74.0,74.0
120357758.0,6,249,28004,125,19524,970627.0806451612,284.0,156.192,124,8480,970101.569105691,140.0,68.38709677419355
108106088.0,17,5,1005,5,1005,27026522.0,201.0,201.0,0,0,0.0,0.0,0.0
314383.0,17,4,1400,4,1400,104794.33333333331,350.0,350.0,0,0,0.0,0.0,0.0
90260623.0,6,12,1832,8,1016,12894374.714285716,188.0,127.0,4,816,30032428.666666668,204.0,204.0
90299789.0,6,19,1436,10,745,10028882.111111112,95.0,74.5,9,691,11285996.5,95.0,76.77777777777777
1303105.0,6,4,264,2,132,0.0,66.0,66.0,2,132,0.0,66.0,66.0
108241.0,17,2,700,2,700,0.0,350.0,350.0,0,0,0.0,0.0,0.0
321.0,17,2,174,1,79,0.0,79.0,79.0,1,95,0.0,95.0,95.0
0.0,6,1,54,1,54,0.0,54.0,54.0,0,0,0.0,0.0,0.0
46375.0,6,22,9762,12,945,4215.909090909091,211.0,78.75,10,8817,4782.555555555556,1514.0,881.7
144031.0,17,2,180,1,90,0.0,90.0,90.0,1,90,0.0,90.0,90.0
311.0,17,2,174,1,79,0.0,79.0,79.0,1,95,0.0,95.0,95.0
90256365.0,6,13,2036,8,1016,12893766.42857143,188.0,127.0,5,1020,22522848.5,204.0,204.0
90054073.0,17,27,12943,27,12943,3463618.1923076925,501.0,479.3703703703704,0,0,0.0,0.0,0.0
18408.0,6,11,2098,6,590,3392.4,252.0,98.33333333333331,5,1508,4004.25,1236.0,301.6
14637833.0,6,20,1607,10,975,1592515.3333333333,315.0,97.5,10,632,1592488.5555555555,78.0,63.2
118254794.0,17,14,864,7,432,19501771.83333333,174.0,61.71428571428572,7,432,19500160.5,174.0,61.71428571428572
90057209.0,17,28,13364,28,13364,3335452.185185185,501.0,477.2857142857143,0,0,0.0,0.0,0.0
147181.0,6,3,373,2,238,0.0,172.0,119.0,1,135,0.0,135.0,135.0
49310.0,6,14,4740,7,653,6995.333333333333,249.0,93.28571428571428,7,4087,6721.333333333333,1514.0,583.8571428571429
53511.0,6,12,1413,7,882,8918.5,291.0,126.0,5,531,11810.0,259.0,106.2
302404.0,17,2,246,1,76,0.0,76.0,76.0,1,170,0.0,170.0,170.0
1310401.0,6,4,264,2,132,0.0,66.0,66.0,2,132,0.0,66.0,66.0
311251.0,6,6,412,4,272,103750.33333333331,74.0,68.0,2,140,0.0,74.0,70.0
34771.0,17,2,180,1,90,0.0,90.0,90.0,1,90,0.0,90.0,90.0
90052422.0,17,28,13364,28,13364,3335274.888888889,501.0,477.2857142857143,0,0,0.0,0.0,0.0
111643360.0,6,31,2182,16,1165,7428511.6,139.0,72.8125,15,1017,7959119.714285715,123.0,67.8
108104825.0,17,5,955,5,955,27026206.25,191.0,191.0,0,0,0.0,0.0,0.0
103533250.0,6,44,2904,22,1452,4930154.761904762,66.0,66.0,22,1452,4917188.095238095,66.0,66.0
208045.0,17,2,180,1,90,0.0,90.0,90.0,1,90,0.0,90.0,90.0
1694906.0,6,38,22321,20,1472,89205.57894736843,210.0,73.6,18,20849,99552.5294117647,1514.0,1158.2777777777778
101839.0,17,2,286,2,286,0.0,143.0,143.0,0,0,0.0,0.0,0.0
143855.0,17,2,180,1,90,0.0,90.0,90.0,1,90,0.0,90.0,90.0
216614.0,17,2,180,1,90,0.0,90.0,90.0,1,90,0.0,90.0,90.0
90016923.0,17,28,13364,28,13364,3333960.111111111,501.0,477.2857142857143,0,0,0.0,0.0,0.0
111178986.0,6,217,24702,109,7490,1029435.0555555556,140.0,68.71559633027523,108,17212,1019810.7757009346,336.0,159.37037037037038
94795316.0,6,21,2041,11,1160,9479531.6,255.0,105.45454545454544,10,881,10505539.666666666,231.0,88.1
1385412.0,6,4,276,2,128,0.0,74.0,64.0,2,148,0.0,74.0,74.0
121466.0,6,3,337,2,214,0.0,160.0,107.0,1,123,0.0,123.0,123.0
120056199.0,17,29,13785,29,13785,4287721.392857143,501.0,475.3448275862069,0,0,0.0,0.0,0.0
23627.0,6,14,4740,7,653,3623.6666666666665,249.0,93.28571428571428,7,4087,3662.5,1514.0,583.8571428571429
10494085.0,6,7,478,4,272,3452577.333333333,74.0,68.0,3,206,5178738.0,74.0,68.66666666666667
143922.0,17,2,180,1,90,0.0,90.0,90.0,1,90,0.0,90.0,90.0
90024505.0,17,28,13364,28,13364,3334240.925925926,501.0,477.2857142857143,0,0,0.0,0.0,0.0
90297419.0,6,16,1192,8,596,12892953.142857144,95.0,74.5,8,596,12897790.285714284,95.0,74.5
35241.0,6,10,2032,5,524,7511.0,252.0,104.8,5,1508,7908.0,1236.0,301.6
31510.000000000004,6,10,2032,5,524,6784.75,252.0,104.8,5,1508,7152.750000000001,1236.0,301.6
268878.0,6,10,1221,6,636,53775.6,298.0,106.0,4,585,84232.0,379.0,146.25
1766812.0,6,2,132,1,66,0.0,66.0,66.0,1,66,0.0,66.0,66.0
46647.0,6,14,4740,7,653,6467.666666666667,249.0,93.28571428571428,7,4087,7341.666666666667,1514.0,583.8571428571429
146113.0,6,3,337,2,214,0.0,160.0,107.0,1,123,0.0,123.0,123.0
43502.0,6,10,2032,5,524,10645.5,252.0,104.8,5,1508,10136.75,1236.0,301.6
148026.0,17,2,180,1,90,0.0,90.0,90.0,1,90,0.0,90.0,90.0
241689.0,6,3,337,2,214,0.0,160.0,107.0,1,123,0.0,123.0,123.0
124588503.0,6,35,2410,18,1285,7328735.470588235,139.0,71.38888888888889,17,1125,7148871.0625,123.0,66.17647058823529
10284.0,6,11,2098,6,590,1951.0,252.0,98.33333333333331,5,1508,2322.25,1236.0,301.6
232731.0,6,3,337,2,214,0.0,160.0,107.0,1,123,0.0,123.0,123.0
113728785.0,17,14,864,7,432,18834168.666666668,174.0,61.71428571428572,7,432,18833519.5,174.0,61.71428571428572
793.0,17,4,438,2,148,0.0,74.0,74.0,2,290,0.0,147.0,145.0
479119.0,6,3,1604,2,851,0.0,785.0,425.5,1,753,0.0,753.0,753.0
744652.0,6,2,132,1,66,0.0,66.0,66.0,1,66,0.0,66.0,66.0
1946117.0,17,3,1026,3,1026,973058.5,342.0,342.0,0,0,0.0,0.0,0.0
2085253.0,6,25,7610,13,2516,173771.08333333334,1034.0,193.53846153846155,12,5094,161053.9090909091,1510.0,424.5
95038149.0,17,12,778,6,389,19001383.4,174.0,64.83333333333333,6,389,19000158.0,174.0,64.83333333333333
34883.0,6,10,2032,5,524,7135.25,252.0,104.8,5,1508,8134.75,1236.0,301.6
0.0,6,1,66,1,66,0.0,66.0,66.0,0,0,0.0,0.0,0.0
252996.0,6,3,337,2,214,0.0,160.0,107.0,1,123,0.0,123.0,123.0
2030.0,17,4,344,2,150,0.0,75.0,75.0,2,194,0.0,103.0,97.0
110000893.0,17,13,821,7,432,18333482.166666668,174.0,61.71428571428572,6,389,17971870.4,174.0,64.83333333333333
1099527.0,6,13,1386,7,789,183254.5,253.0,112.71428571428572,6,597,219153.4,259.0,99.5
135132320.0,17,6,1146,6,1146,27026464.0,191.0,191.0,0,0,0.0,0.0,0.0
217156.0,6,3,426,2,280,0.0,214.0,140.0,1,146,0.0,146.0,146.0
119920324.0,6,13,1898,5,882,22514601.0,204.0,176.4,8,1016,17124941.0,188.0,127.0
20142.0,6,10,2032,5,524,4206.0,252.0,104.8,5,1508,4746.25,1236.0,301.6
52077.0,6,10,2032,5,524,9330.75,252.0,104.8,5,1508,12802.75,1236.0,301.6
143909.0,17,2,180,1,90,0.0,90.0,90.0,1,90,0.0,90.0,90.0
120255991.0,6,222,25106,111,7548,1085589.4454545456,140.0,68.0,111,17558,1087112.972727273,284.0,158.18018018018017
25422.0,6,14,4740,7,653,4120.666666666667,249.0,93.28571428571428,7,4087,4097.666666666667,1514.0,583.8571428571429
85.0,17,2,762,2,762,0.0,381.0,381.0,0,0,0.0,0.0,0.0
83444.0,6,12,1320,6,723,14754.6,253.0,120.5,6,597,13671.4,259.0,99.5
90093444.0,6,10,1440,7,828,15015574.0,188.0,118.28571428571428,3,612,30031358.0,204.0,204.0
245500.0,6,3,337,2,214,0.0,160.0,107.0,1,123,0.0,123.0,123.0
12677657.0,6,18,1495,9,921,1545388.625,315.0,102.33333333333331,9,574,1545358.75,78.0,63.77777777777778
14624.0,17,2,180,1,90,0.0,90.0,90.0,1,90,0.0,90.0,90.0
307721.0,6,6,412,4,272,102573.66666666669,74.0,68.0,2,140,0.0,74.0,70.0
135131955.0,17,6,1146,6,1146,27026391.0,191.0,191.0,0,0,0.0,0.0,0.0
33846.0,6,14,4740,7,653,5521.0,249.0,93.28571428571428,7,4087,5446.666666666667,1514.0,583.8571428571429
32701.0,6,14,4740,7,653,5332.5,249.0,93.28571428571428,7,4087,3858.8333333333335,1514.0,583.8571428571429
153843.0,6,3,373,2,238,0.0,172.0,119.0,1,135,0.0,135.0,135.0
232570.0,6,3,337,2,214,0.0,160.0,107.0,1,123,0.0,123.0,123.0
2077.0,17,4,344,2,150,0.0,75.0,75.0,2,194,0.0,103.0,97.0
842150.0,6,9,1118,6,586,168430.0,248.0,97.66666666666669,3,532,283046.0,392.0,177.33333333333334
31499.0,6,14,4740,7,653,5124.166666666667,249.0,93.28571428571428,7,4087,5061.166666666667,1514.0,583.8571428571429
135135193.0,17,6,1146,6,1146,27027038.6,191.0,191.0,0,0,0.0,0.0,0.0
2585130.0,6,2,132,1,66,0.0,66.0,66.0,1,66,0.0,66.0,66.0
2397.0,17,4,344,2,150,0.0,75.0,75.0,2,194,0.0,103.0,97.0
108947.0,17,2,286,2,286,0.0,143.0,143.0,0,0,0.0,0.0,0.0
2468.0,17,4,344,2,150,0.0,75.0,75.0,2,194,0.0,103.0,97.0
15234.0,6,10,2032,5,524,3483.0,252.0,104.8,5,1508,3541.0,1236.0,301.6
204508.0,17,2,762,2,762,0.0,381.0,381.0,0,0,0.0,0.0,0.0
10471027.0,6,7,478,4,272,3445100.0,74.0,68.0,3,206,5167545.0,74.0,68.66666666666667
8730.0,6,10,1975,5,467,1940.75,195.0,93.4,5,1508,1859.75,1236.0,301.6
56866.0,6,10,2032,5,524,12621.25,252.0,104.8,5,1508,12328.5,1236.0,301.6
37438.0,6,10,2032,5,524,8651.75,252.0,104.8,5,1508,9101.25,1236.0,301.6
2800476.0,6,2,132,1,66,0.0,66.0,66.0,1,66,0.0,66.0,66.0
120095509.0,17,28,13364,28,13364,4447981.814814814,501.0,477.2857142857143,0,0,0.0,0.0,0.0
208429.0,6,3,426,2,280,0.0,214.0,140.0,1,146,0.0,146.0,146.0
228364.0,17,2,180,1,90,0.0,90.0,90.0,1,90,0.0,90.0,90.0
209237.0,6,4,492,2,280,0.0,214.0,140.0,2,212,0.0,146.0,106.0
303697.0,6,6,412,4,272,101232.33333333331,74.0,68.0,2,140,0.0,74.0,70.0
2872238.0,6,4,270,2,134,0.0,68.0,67.0,2,136,0.0,70.0,68.0
55329.0,6,13,1479,7,882,9221.5,291.0,126.0,6,597,9595.2,259.0,99.5
135132831.0,17,6,1206,6,1206,27026566.2,201.0,201.0,0,0,0.0,0.0,0.0
228463.0,17,2,180,1,90,0.0,90.0,90.0,1,90,0.0,90.0,90.0
108102201.0,17,5,955,5,955,27025550.25,191.0,191.0,0,0,0.0,0.0,0.0
1321778.0,6,4,264,2,132,0.0,66.0,66.0,2,132,0.0,66.0,66.0
314640.0,17,4,1400,4,1400,104880.0,350.0,350.0,0,0,0.0,0.0,0.0
2801897.0,6,2,132,1,66,0.0,66.0,66.0,1,66,0.0,66.0,66.0
147999.0,17,2,180,1,90,0.0,90.0,90.0,1,90,0.0,90.0,90.0
42599.0,6,14,4740,7,653,6940.0,249.0,93.28571428571428,7,4087,6788.5,1514.0,583.8571428571429
107138772.0,6,32,2236,16,1165,7142584.8,139.0,72.8125,16,1071,7128154.466666667,123.0,66.9375
90044511.0,17,27,12943,27,12943,3463250.423076923,501.0,479.3703703703704,0,0,0.0,0.0,0.0
103560.0,17,2,286,2,286,0.0,143.0,143.0,0,0,0.0,0.0,0.0
313345.0,17,4,1400,4,1400,104448.33333333331,350.0,350.0,0,0,0.0,0.0,0.0
3011309.0,6,12,2172,7,664,501790.3333333333,252.0,94.85714285714286,5,1508,1762.75,1236.0,301.6
302370.0,6,2,132,1,66,0.0,66.0,66.0,1,66,0.0,66.0,66.0
90256591.0,6,12,1832,8,1016,12893798.714285716,188.0,127.0,4,816,30030467.33333333,204.0,204.0
797575.0,17,2,397,1,75,0.0,75.0,75.0,1,322,0.0,322.0,322.0
14639021.0,6,20,1607,10,975,1592152.3333333333,315.0,97.5,10,632,1592128.2222222222,78.0,63.2
122008902.0,17,15,907,8,475,17429843.14285714,174.0,59.375,7,432,17000149.166666668,174.0,61.71428571428572
0.0,17,1,342,1,342,0.0,342.0,342.0,0,0,0.0,0.0,0.0
27843.0,6,14,4740,7,653,4314.666666666667,249.0,93.28571428571428,7,4087,4498.333333333333,1514.0,583.8571428571429
27312339.0,17,5,1710,5,1710,6828084.75,342.0,342.0,0,0,0.0,0.0,0.0
320531.0,6,6,412,4,272,106843.66666666669,74.0,68.0,2,140,0.0,74.0,70.0
90744178.0,6,24,1829,13,989,7558294.25,95.0,76.07692307692308,11,840,9042048.3,95.0,76.36363636363636
10905113.0,6,8,544,4,272,3589664.6666666665,74.0,68.0,4,272,3589606.333333333,74.0,68.0
314.0,17,2,174,1,79,0.0,79.0,79.0,1,95,0.0,95.0,95.0
49777.0,6,14,4740,7,653,8158.0,249.0,93.28571428571428,7,4087,8157.166666666667,1514.0,583.8571428571429
28588.0,6,14,4740,7,653,4513.0,249.0,93.28571428571428,7,4087,4583.833333333333,1514.0,583.8571428571429
318.0,17,2,174,1,79,0.0,79.0,79.0,1,95,0.0,95.0,95.0
108420037.0,6,198,22420,99,15664,1104229.7653061224,284.0,158.22222222222223,99,6756,1104205.6326530613,140.0,68.24242424242425
100786262.0,17,12,778,6,389,20074908.2,174.0,64.83333333333333,6,389,20125059.6,174.0,64.83333333333333
120276010.0,6,233,26228,117,18276,1036862.1551724138,284.0,156.2051282051282,116,7952,1036839.9565217393,140.0,68.55172413793103
580249.0,6,4,508,2,238,0.0,172.0,119.0,2,270,0.0,135.0,135.0
104057.0,17,2,286,2,286,0.0,143.0,143.0,0,0,0.0,0.0,0.0
108104666.0,17,5,1005,5,1005,27026166.5,201.0,201.0,0,0,0.0,0.0,0.0
120097560.0,6,35,2542,17,1194,6882045.4375,123.0,70.23529411764706,18,1348,6477222.176470588,139.0,74.88888888888889
108108265.0,17,5,955,5,955,27027066.25,191.0,191.0,0,0,0.0,0.0,0.0
8966.0,17,2,582,1,83,0.0,83.0,83.0,1,499,0.0,499.0,499.0
108102586.0,17,5,1005,5,1005,27025646.5,201.0,201.0,0,0,0.0,0.0,0.0
24855.0,6,14,4740,7,653,3035.6666666666665,249.0,93.28571428571428,7,4087,3707.3333333333335,1514.0,583.8571428571429
113334866.0,6,48,3168,24,1584,4927602.869565218,66.0,66.0,24,1584,4918205.130434782,66.0,66.0
228172.0,17,2,180,1,90,0.0,90.0,90.0,1,90,0.0,90.0,90.0
120669526.0,17,14,864,7,432,16834211.333333332,174.0,61.71428571428572,7,432,16833494.5,174.0,61.71428571428572
100000847.0,17,11,473,6,258,20000169.4,43.0,43.0,5,215,19998909.0,43.0,43.0
73905.0,6,10,2032,5,524,17729.5,252.0,104.8,5,1508,18248.0,1236.0,301.6
310193.0,17,4,704,2,148,0.0,74.0,74.0,2,556,0.0,280.0,278.0
3906.0,17,4,704,2,148,0.0,74.0,74.0,2,556,0.0,280.0,278.0
59261752.0,17,9,3086,8,2736,5161846.285714285,342.0,342.0,1,350,0.0,350.0,350.0
90047639.0,17,28,13364,28,13364,3335097.7407407407,501.0,477.2857142857143,0,0,0.0,0.0,0.0
25306.0,6,14,4740,7,653,4039.8333333333335,249.0,93.28571428571428,7,4087,3937.6666666666665,1514.0,583.8571428571429
69531631.0,6,18,1280,10,694,7725736.777777778,95.0,69.4,8,586,9903419.285714284,95.0,73.25
29521.0,6,10,2032,5,524,6858.0,252.0,104.8,5,1508,6887.5,1236.0,301.6
206837.0,6,4,492,2,280,0.0,214.0,140.0,2,212,0.0,146.0,106.0
119356077.0,6,19,1395,10,745,13256775.222222222,95.0,74.5,9,650,14919193.375,95.0,72.22222222222223
125830797.0,6,62,12135,31,6111,3222755.066666667,1514.0,197.1290322580645,31,6024,4187312.2666666666,1514.0,194.32258064516128
20058.0,17,2,582,1,83,0.0,83.0,83.0,1,499,0.0,499.0,499.0
56731.0,6,10,2032,5,524,13940.5,252.0,104.8,5,1508,12391.5,1236.0,301.6
146645.0,6,3,373,2,238,0.0,172.0,119.0,1,135,0.0,135.0,135.0
236674.0,17,2,180,1,90,0.0,90.0,90.0,1,90,0.0,90.0,90.0
298961.0,6,6,412,4,272,99653.66666666669,74.0,68.0,2,140,0.0,74.0,70.0
8542249.0,17,3,1034,2,684,0.0,342.0,342.0,1,350,0.0,350.0,350.0
1998.0,6,2,169,2,169,0.0,103.0,84.5,0,0,0.0,0.0,0.0
29631.0,6,14,4740,7,653,4820.166666666667,249.0,93.28571428571428,7,4087,4433.0,1514.0,583.8571428571429
0.0,17,1,55,1,55,0.0,55.0,55.0,0,0,0.0,0.0,0.0
2377.0,17,4,344,2,150,0.0,75.0,75.0,2,194,0.0,103.0,97.0
90094488.0,6,11,1644,4,816,30030733.666666668,204.0,204.0,7,828,15006618.166666666,188.0,118.28571428571428
5621091.0,6,5,336,2,134,0.0,68.0,67.0,3,202,1421528.5,70.0,67.33333333333333
135136429.0,17,6,1146,6,1146,27027285.8,191.0,191.0,0,0,0.0,0.0,0.0
44006.0,6,10,2032,5,524,10754.75,252.0,104.8,5,1508,8880.0,1236.0,301.6
302389.0,6,2,132,1,66,0.0,66.0,66.0,1,66,0.0,66.0,66.0
298.0,17,2,174,1,79,0.0,79.0,79.0,1,95,0.0,95.0,95.0
139420.0,6,13,1394,7,797,23236.666666666668,253.0,113.85714285714286,6,597,26405.2,259.0,99.5
108591.0,17,2,286,2,286,0.0,143.0,143.0,0,0,0.0,0.0,0.0
90656951.0,6,15,2302,9,1204,11315560.125,188.0,133.77777777777777,6,1098,18093522.0,204.0,183.0
330.0,17,2,250,1,93,0.0,93.0,93.0,1,157,0.0,157.0,157.0
220741.0,6,3,426,2,280,0.0,214.0,140.0,1,146,0.0,146.0,146.0
60468.0,6,14,4740,7,653,9560.0,249.0,93.28571428571428,7,4087,9936.333333333334,1514.0,583.8571428571429
89361474.0,17,14,4788,14,4788,6873959.538461538,342.0,342.0,0,0,0.0,0.0,0.0
108102898.0,17,5,955,5,955,27025724.5,191.0,191.0,0,0,0.0,0.0,0.0
38545.0,6,10,2032,5,524,8550.75,252.0,104.8,5,1508,9094.5,1236.0,301.6
5618370.0,6,5,336,2,134,0.0,68.0,67.0,3,202,1520374.5,70.0,67.33333333333333
108111870.0,17,5,1005,5,1005,27027967.5,201.0,201.0,0,0,0.0,0.0,0.0
120202540.0,6,232,26200,116,7952,1038135.3826086957,140.0,68.55172413793103,116,18248,1045213.7130434784,284.0,157.31034482758622
46054.0,6,14,4740,7,653,7547.666666666667,249.0,93.28571428571428,7,4087,6600.833333333333,1514.0,583.8571428571429
299707.0,6,6,412,4,272,99902.33333333331,74.0,68.0,2,140,0.0,74.0,70.0
103005578.0,17,14,864,7,432,17167596.333333332,174.0,61.71428571428572,7,432,17166831.666666668,174.0,61.71428571428572
127797908.0,6,30,1974,15,948,8415203.92857143,123.0,63.2,15,1026,8415217.57142857,123.0,68.4
33559.0,6,14,4740,7,653,5013.666666666667,249.0,93.28571428571428,7,4087,5061.666666666667,1514.0,583.8571428571429
146111.0,6,3,337,2,214,0.0,160.0,107.0,1,123,0.0,123.0,123.0
90229716.0,6,24,1829,11,840,8997458.7,95.0,76.36363636363636,13,989,7501163.166666667,95.0,76.07692307692308
102764.0,17,2,286,2,286,0.0,143.0,143.0,0,0,0.0,0.0,0.0
20065.0,6,10,2032,5,524,4756.25,252.0,104.8,5,1508,4768.5,1236.0,301.6
138007567.0,17,17,1255,9,649,17250945.875,174.0,72.11111111111111,8,606,16857326.285714287,174.0,75.75
16046.000000000002,6,12,1393,6,796,2635.2,271.0,132.66666666666666,6,597,2949.0,259.0,99.5
69209.0,17,2,626,1,72,0.0,72.0,72.0,1,554,0.0,554.0,554.0
120044116.0,17,29,13785,29,13785,4287289.857142857,501.0,475.3448275862069,0,0,0.0,0.0,0.0
5611134.0,6,5,336,2,134,0.0,68.0,67.0,3,202,1422895.0,70.0,67.33333333333333
848602.0,6,9,1267,6,796,169720.4,458.0,132.66666666666666,3,471,287893.5,331.0,157.0
111700410.0,6,30,1990,15,1042,7963184.214285715,139.0,69.46666666666667,15,948,7963191.142857143,123.0,63.2
6679.0,17,2,582,1,83,0.0,83.0,83.0,1,499,0.0,499.0,499.0
19036.0,6,11,1133,6,602,3131.6,264.0,100.33333333333331,5,531,3905.0,259.0,106.2
205828.0,6,10,1221,6,636,41165.6,298.0,106.0,4,585,67251.33333333333,379.0,146.25
810.0,17,4,438,2,148,0.0,74.0,74.0,2,290,0.0,147.0,145.0
17125.0,6,2,145,2,145,0.0,91.0,72.5,0,0,0.0,0.0,0.0
90254788.0,6,13,2036,8,1016,12893541.142857144,188.0,127.0,5,1020,22522972.25,204.0,204.0
516.0,17,2,174,1,79,0.0,79.0,79.0,1,95,0.0,95.0,95.0
44159.0,6,11,1133,6,602,8547.4,264.0,100.33333333333331,5,531,7820.25,259.0,106.2
207604.0,6,3,426,2,280,0.0,214.0,140.0,1,146,0.0,146.0,146.0
1015806.0,6,12,1354,6,723,202369.4,253.0,120.5,6,631,202822.8,293.0,105.16666666666669
29529.0,6,14,4740,7,653,4690.833333333333,249.0,93.28571428571428,7,4087,3112.833333333333,1514.0,583.8571428571429
15758.000000000002,6,10,1975,5,467,3699.25,195.0,93.4,5,1508,2043.75,1236.0,301.6
14641405.0,6,20,1648,10,1016,1593196.3333333333,315.0,101.6,10,632,1593131.5555555555,78.0,63.2
461.0,17,2,508,2,508,0.0,257.0,254.0,0,0,0.0,0.0,0.0
135126718.0,17,6,1146,6,1146,27025343.6,191.0,191.0,0,0,0.0,0.0,0.0
53306.0,6,10,2032,5,524,13075.25,252.0,104.8,5,1508,10740.5,1236.0,301.6
137179.0,17,2,192,1,88,0.0,88.0,88.0,1,104,0.0,104.0,104.0
2279.0,17,4,344,2,150,0.0,75.0,75.0,2,194,0.0,103.0,97.0
236794.0,6,3,373,2,238,0.0,172.0,119.0,1,135,0.0,135.0,135.0
15757.0,6,10,2032,5,524,3614.5,252.0,104.8,5,1508,3708.25,1236.0,301.6
27608.0,6,10,2032,5,524,6415.0,252.0,104.8,5,1508,5882.25,1236.0,301.6
2411.0,17,4,344,2,150,0.0,75.0,75.0,2,194,0.0,103.0,97.0
205848.0,17,2,180,1,90,0.0,90.0,90.0,1,90,0.0,90.0,90.0
112324518.0,6,187,21192,94,6426,1207790.5161290322,140.0,68.36170212765957,93,14766,1209584.0,284.0,158.7741935483871
73979.0,6,14,4740,7,653,12122.5,249.0,93.28571428571428,7,4087,11932.666666666666,1514.0,583.8571428571429
494157.0,6,5,336,2,134,0.0,68.0,67.0,3,202,193803.0,70.0,67.33333333333333
90066123.0,17,28,13364,28,13364,3335782.333333333,501.0,477.2857142857143,0,0,0.0,0.0,0.0
3091995.0,6,3,1604,2,851,0.0,785.0,425.5,1,753,0.0,753.0,753.0
15772.999999999998,6,14,4740,7,653,2332.1666666666665,249.0,93.28571428571428,7,4087,2483.1666666666665,1514.0,583.8571428571429
120317033.0,6,239,27054,120,18978,1011067.5042016808,284.0,158.15,119,8076,1010878.0423728812,140.0,67.8655462184874
102225531.0,6,192,21712,96,15154,1073792.031578947,300.0,157.85416666666666,96,6558,1073793.3578947368,140.0,68.3125
40469.0,6,10,2032,5,524,9186.0,252.0,104.8,5,1508,9898.5,1236.0,301.6
135136511.0,17,6,1206,6,1206,27027302.2,201.0,201.0,0,0,0.0,0.0,0.0
25111.0,6,10,2032,5,524,6047.25,252.0,104.8,5,1508,5585.5,1236.0,301.6
216334.0,17,2,180,1,90,0.0,90.0,90.0,1,90,0.0,90.0,90.0
90044168.0,17,28,13364,28,13364,3334969.185185185,501.0,477.2857142857143,0,0,0.0,0.0,0.0
120521628.0,6,225,25484,113,17796,1076085.9642857143,284.0,157.4867256637168,112,7688,1076332.5765765766,140.0,68.64285714285714
437406.0,6,11,1021,6,444,58725.0,162.0,74.0,5,577,73218.5,349.0,115.4
136524.0,6,2,132,1,66,0.0,66.0,66.0,1,66,0.0,66.0,66.0
506426.00000000006,6,5,336,2,134,0.0,68.0,67.0,3,202,194735.0,70.0,67.33333333333333
210911.0,17,2,414,1,88,0.0,88.0,88.0,1,326,0.0,326.0,326.0
90262474.0,6,12,1832,8,1016,12894639.142857144,188.0,127.0,4,816,30030922.666666668,204.0,204.0
56404.0,6,14,4740,7,653,8311.0,249.0,93.28571428571428,7,4087,6131.166666666667,1514.0,583.8571428571429
322858.0,17,4,1400,4,1400,107619.33333333331,350.0,350.0,0,0,0.0,0.0,0.0
0.0,17,1,55,1,55,0.0,55.0,55.0,0,0,0.0,0.0,0.0
90261619.0,6,14,1964,8,1016,12894517.0,188.0,127.0,6,948,18019834.8,204.0,158.0
117001266.0,17,13,821,7,432,19500211.0,174.0,61.71428571428572,6,389,19401016.4,174.0,64.83333333333333
33780.0,6,14,4740,7,653,5118.166666666667,249.0,93.28571428571428,7,4087,5470.5,1514.0,583.8571428571429
93000781.0,17,11,735,6,389,18600156.2,174.0,64.83333333333333,5,346,20060326.5,174.0,69.2
234249.0,6,3,373,2,238,0.0,172.0,119.0,1,135,0.0,135.0,135.0
279691.0,17,2,346,1,78,0.0,78.0,78.0,1,268,0.0,268.0,268.0
38159.0,6,10,2032,5,524,9321.5,252.0,104.8,5,1508,8976.75,1236.0,301.6
24229062.0,17,5,1718,4,1368,721041.0,342.0,342.0,1,350,0.0,350.0,350.0
47294.0,6,14,4740,7,653,7591.0,249.0,93.28571428571428,7,4087,7223.333333333333,1514.0,583.8571428571429
120170953.0,6,553,76006,277,18504,435402.0036231884,140.0,66.8014440433213,276,57502,433265.9236363637,336.0,208.3405797101449
217518.0,6,3,426,2,280,0.0,214.0,140.0,1,146,0.0,146.0,146.0
315354.0,17,4,1400,4,1400,105118.0,350.0,350.0,0,0,0.0,0.0,0.0
100344645.0,6,27,1954,13,909,7529928.0,123.0,69.92307692307692,14,1045,6950689.0,139.0,74.64285714285714
121006415.0,17,15,907,8,475,17286630.714285713,174.0,59.375,7,432,16833497.0,174.0,61.71428571428572
144821.0,17,2,180,1,70,0.0,70.0,70.0,1,110,0.0,110.0,110.0
1106242.0,6,13,1386,7,789,184373.66666666663,253.0,112.71428571428572,6,597,219980.8,259.0,99.5
23214.0,6,14,4740,7,653,3644.6666666666665,249.0,93.28571428571428,7,4087,3683.0,1514.0,583.8571428571429
45022.0,6,14,4740,7,653,6554.5,249.0,93.28571428571428,7,4087,6251.666666666667,1514.0,583.8571428571429
315212.0,17,4,1400,4,1400,105070.66666666669,350.0,350.0,0,0,0.0,0.0,0.0
207495.0,6,3,426,2,280,0.0,214.0,140.0,1,146,0.0,146.0,146.0
145009.0,17,2,180,1,70,0.0,70.0,70.0,1,110,0.0,110.0,110.0
1725665.0,6,20,7599,11,1469,172566.5,583.0,133.54545454545453,9,6130,184069.0,1484.0,681.1111111111111
18620.0,6,14,4740,7,653,2934.1666666666665,249.0,93.28571428571428,7,4087,2963.833333333333,1514.0,583.8571428571429
201574.0,17,2,180,1,90,0.0,90.0,90.0,1,90,0.0,90.0,90.0
105586356.0,17,14,864,7,432,17501860.333333332,174.0,61.71428571428572,7,432,17500173.166666668,174.0,61.71428571428572
108108324.0,17,5,1005,5,1005,27027081.0,201.0,201.0,0,0,0.0,0.0,0.0
86.0,17,2,762,2,762,0.0,381.0,381.0,0,0,0.0,0.0,0.0
71323.0,6,11,2098,6,590,14044.8,252.0,98.33333333333331,5,1508,9932.75,1236.0,301.6
108098534.0,17,5,1005,5,1005,27024633.5,201.0,201.0,0,0,0.0,0.0,0.0
34857.0,6,14,4740,7,653,5540.666666666667,249.0,93.28571428571428,7,4087,5674.5,1514.0,583.8571428571429
312351.0,17,4,1400,4,1400,104117.0,350.0,350.0,0,0,0.0,0.0,0.0
16385314.000000002,17,6,2052,6,2052,3277062.8,342.0,342.0,0,0,0.0,0.0,0.0
38320.0,6,14,4740,7,653,6276.166666666667,249.0,93.28571428571428,7,4087,5854.666666666667,1514.0,583.8571428571429
30000.0,6,10,2032,5,524,7105.5,252.0,104.8,5,1508,4936.5,1236.0,301.6
506.00000000000006,17,2,508,2,508,0.0,257.0,254.0,0,0,0.0,0.0,0.0
296439.0,17,2,180,1,90,0.0,90.0,90.0,1,90,0.0,90.0,90.0
318.0,17,2,174,1,79,0.0,79.0,79.0,1,95,0.0,95.0,95.0
36249538.0,6,26,7627,14,3735,186913.84615384616,1514.0,266.7857142857143,12,3892,3275827.8181818184,1514.0,324.3333333333333
135115086.0,17,6,1146,6,1146,27023017.2,191.0,191.0,0,0,0.0,0.0,0.0
23368119.0,17,4,1376,3,1026,338924.0,342.0,342.0,1,350,0.0,350.0,350.0
107041312.0,17,14,864,7,432,17834344.833333332,174.0,61.71428571428572,7,432,17833495.166666668,174.0,61.71428571428572
20691.0,6,11,2098,6,590,3957.4,252.0,98.33333333333331,5,1508,4599.25,1236.0,301.6
106080554.0,17,14,864,7,432,17666870.0,174.0,61.71428571428572,7,432,17667525.833333332,174.0,61.71428571428572
148030.0,17,2,180,1,90,0.0,90.0,90.0,1,90,0.0,90.0,90.0
115230616.0,6,249,28826,125,8546,929279.1612903224,140.0,68.368,124,20280,928385.268292683,300.0,163.5483870967742
0.0,17,1,90,1,90,0.0,90.0,90.0,0,0,0.0,0.0,0.0
248523.0,17,4,6056,4,6056,82841.0,1514.0,1514.0,0,0,0.0,0.0,0.0
209625.0,17,2,180,1,90,0.0,90.0,90.0,1,90,0.0,90.0,90.0
4496.0,17,2,180,1,90,0.0,90.0,90.0,1,90,0.0,90.0,90.0
115363038.0,6,34,2350,17,1225,7196713.1875,139.0,72.05882352941177,17,1125,7196701.3125,123.0,66.17647058823529
211683.0,17,2,180,1,90,0.0,90.0,90.0,1,90,0.0,90.0,90.0
90300730.0,6,16,1192,8,596,12893025.285714284,95.0,74.5,8,596,12898754.0,95.0,74.5
108099886.0,17,5,955,5,955,27024971.5,191.0,191.0,0,0,0.0,0.0,0.0
120046575.0,17,28,13364,28,13364,4446169.444444444,501.0,477.2857142857143,0,0,0.0,0.0,0.0
246839.0,6,3,337,2,214,0.0,160.0,107.0,1,123,0.0,123.0,123.0
90063673.0,17,27,12943,27,12943,3463987.423076923,501.0,479.3703703703704,0,0,0.0,0.0,0.0
39644811.0,6,5,336,2,134,0.0,68.0,67.0,3,202,19755419.0,70.0,67.33333333333333
120047283.0,17,29,13785,29,13785,4287402.964285715,501.0,475.3448275862069,0,0,0.0,0.0,0.0
47603573.0,6,8,1940,3,887,22463072.5,753.0,295.6666666666667,5,1053,11259498.5,785.0,210.6
56372.0,6,14,4740,7,653,9272.5,249.0,93.28571428571428,7,4087,7477.833333333333,1514.0,583.8571428571429
202540.0,17,4,6056,4,6056,67513.33333333333,1514.0,1514.0,0,0,0.0,0.0,0.0
233600.0,6,3,337,2,214,0.0,160.0,107.0,1,123,0.0,123.0,123.0
48680.0,6,14,4740,7,653,7067.833333333333,249.0,93.28571428571428,7,4087,7111.166666666667,1514.0,583.8571428571429
10481632.0,6,7,478,4,272,3448674.333333333,74.0,68.0,3,206,5172906.0,74.0,68.66666666666667
50057.0,6,13,1394,7,797,7717.833333333333,253.0,113.85714285714286,6,597,8491.0,259.0,99.5
47320.0,6,14,4740,7,653,7770.666666666667,249.0,93.28571428571428,7,4087,7562.0,1514.0,583.8571428571429
321894.0,17,4,1400,4,1400,107298.0,350.0,350.0,0,0,0.0,0.0,0.0
213528.0,6,3,426,2,280,0.0,214.0,140.0,1,146,0.0,146.0,146.0
90025084.0,17,28,13364,28,13364,3334262.3703703703,501.0,477.2857142857143,0,0,0.0,0.0,0.0
210059.0,17,2,180,1,90,0.0,90.0,90.0,1,90,0.0,90.0,90.0
108962906.0,6,32,2236,16,1165,7250563.8,139.0,72.8125,16,1071,7250560.733333333,123.0,66.9375
301283.0,6,6,412,4,272,100427.66666666669,74.0,68.0,2,140,0.0,74.0,70.0
10486377.0,6,7,478,4,272,3448301.0,74.0,68.0,3,206,5172306.0,74.0,68.66666666666667
0.0,6,1,172,1,172,0.0,172.0,172.0,0,0,0.0,0.0,0.0
235339.0,6,3,337,2,214,0.0,160.0,107.0,1,123,0.0,123.0,123.0
42213.0,6,10,2032,5,524,10303.5,252.0,104.8,5,1508,9760.0,1236.0,301.6
108099145.0,17,5,955,5,955,27024786.25,191.0,191.0,0,0,0.0,0.0,0.0
148813.0,17,2,414,1,88,0.0,88.0,88.0,1,326,0.0,326.0,326.0
108604890.0,6,28,1860,14,966,8337619.615384615,123.0,69.0,14,894,8337617.461538462,123.0,63.85714285714285
138656.0,6,2,132,1,66,0.0,66.0,66.0,1,66,0.0,66.0,66.0
204591.0,17,2,762,2,762,0.0,381.0,381.0,0,0,0.0,0.0,0.0
116289944.0,17,14,864,7,432,19333529.33333333,174.0,61.71428571428572,7,432,19334244.166666668,174.0,61.71428571428572
24561.0,6,14,4740,7,653,3212.1666666666665,249.0,93.28571428571428,7,4087,3957.0,1514.0,583.8571428571429
1249392.0,6,7,499,4,301,390567.0,103.0,75.25,3,198,613161.5,66.0,66.0
309496.0,17,4,1400,4,1400,103165.33333333331,350.0,350.0,0,0,0.0,0.0,0.0
90292207.0,6,16,1192,8,596,12892493.714285716,95.0,74.5,8,596,12897099.42857143,95.0,74.5
206184.0,6,3,426,2,280,0.0,214.0,140.0,1,146,0.0,146.0,146.0
211398.0,6,10,1221,6,636,42279.6,298.0,106.0,4,585,68855.0,379.0,146.25
120396517.0,6,211,23802,106,16650,1146633.4952380953,284.0,157.0754716981132,105,7152,1117673.3942307692,140.0,68.11428571428571
1309124.0,6,4,264,2,132,0.0,66.0,66.0,2,132,0.0,66.0,66.0
216824.0,6,3,426,2,280,0.0,214.0,140.0,1,146,0.0,146.0,146.0
1584948.0,6,19,7533,10,1403,176105.33333333334,583.0,140.3,9,6130,166723.375,1484.0,681.1111111111111
40524.0,6,10,2032,5,524,9822.0,252.0,104.8,5,1508,9801.75,1236.0,301.6
23102689.0,17,3,1034,2,684,0.0,342.0,342.0,1,350,0.0,350.0,350.0
538557.0,17,6,2100,6,2100,107711.4,350.0,350.0,0,0,0.0,0.0,0.0
146713.0,6,3,337,2,214,0.0,160.0,107.0,1,123,0.0,123.0,123.0
908077.0,17,5,961,3,234,453770.5,78.0,78.0,2,727,0.0,395.0,363.5
167097.0,17,4,704,2,148,0.0,74.0,74.0,2,556,0.0,280.0,278.0
104643.0,17,2,286,2,286,0.0,143.0,143.0,0,0,0.0,0.0,0.0
102108628.0,6,41,2706,21,1386,5105431.4,66.0,66.0,20,1320,5347908.315789473,66.0,66.0
2824.0,17,2,224,1,76,0.0,76.0,76.0,1,148,0.0,148.0,148.0
119000982.0,17,13,821,7,432,19833497.0,174.0,61.71428571428572,6,389,19800146.8,174.0,64.83333333333333
903376.0,6,12,2710,7,743,150562.66666666666,339.0,106.14285714285714,5,1967,156951.5,1514.0,393.4
18574.0,6,14,4740,7,653,2776.833333333333,249.0,93.28571428571428,7,4087,2394.6666666666665,1514.0,583.8571428571429
27870.0,6,14,4740,7,653,4525.0,249.0,93.28571428571428,7,4087,3947.3333333333335,1514.0,583.8571428571429
56105.0,6,12,1320,7,789,9350.833333333334,253.0,112.71428571428572,5,531,11894.0,259.0,106.2
35710.0,6,10,2032,5,524,7344.5,252.0,104.8,5,1508,8347.75,1236.0,301.6
108107347.0,17,5,955,5,955,27026836.75,191.0,191.0,0,0,0.0,0.0,0.0
135136339.0,17,6,1206,6,1206,27027267.8,201.0,201.0,0,0,0.0,0.0,0.0
102481.0,17,4,6056,4,6056,34160.333333333336,1514.0,1514.0,0,0,0.0,0.0,0.0
146153.0,6,3,337,2,214,0.0,160.0,107.0,1,123,0.0,123.0,123.0
5625946.0,6,4,270,2,134,0.0,68.0,67.0,2,136,0.0,70.0,68.0
113445729.0,6,30,1990,15,1042,8087843.285714285,139.0,69.46666666666667,15,948,8087845.285714285,123.0,63.2
21950.0,17,2,582,1,83,0.0,83.0,83.0,1,499,0.0,499.0,499.0
119597362.0,6,19,1395,10,745,13283689.777777778,95.0,74.5,9,650,14943340.25,95.0,72.22222222222223
144851.0,6,2,132,1,66,0.0,66.0,66.0,1,66,0.0,66.0,66.0
183602.0,17,2,176,1,80,0.0,80.0,80.0,1,96,0.0,96.0,96.0
3174661.0,6,18,1577,9,1003,358383.125,315.0,111.44444444444444,9,574,358085.75,78.0,63.77777777777778
3006674.0,6,3,1604,1,753,0.0,753.0,753.0,2,851,0.0,785.0,425.5
111698.0,17,2,286,2,286,0.0,143.0,143.0,0,0,0.0,0.0,0.0
13542.0,6,13,1459,7,862,2217.1666666666665,271.0,123.14285714285714,6,597,2457.6,259.0,99.5
248202.0,6,3,426,2,280,0.0,214.0,140.0,1,146,0.0,146.0,146.0
108103975.0,17,5,1005,5,1005,27025993.75,201.0,201.0,0,0,0.0,0.0,0.0
302485.0,6,2,132,1,66,0.0,66.0,66.0,1,66,0.0,66.0,66.0
135114951.0,17,6,1146,6,1146,27022990.2,191.0,191.0,0,0,0.0,0.0,0.0
55756.0,6,14,4740,7,653,9169.833333333334,249.0,93.28571428571428,7,4087,9149.0,1514.0,583.8571428571429
115373150.0,6,48,3168,24,1584,5016223.913043479,66.0,66.0,24,1584,5004371.260869565,66.0,66.0
40024.0,6,14,4740,7,653,6478.0,249.0,93.28571428571428,7,4087,6138.0,1514.0,583.8571428571429
108104299.0,17,5,955,5,955,27026074.75,191.0,191.0,0,0,0.0,0.0,0.0
134702820.0,17,14,864,7,432,19168427.33333333,174.0,61.71428571428572,7,432,19166838.666666668,174.0,61.71428571428572
118677561.0,6,34,2482,17,1194,7417320.875,123.0,70.23529411764706,17,1288,7275448.125,139.0,75.76470588235294
94434736.0,17,12,778,6,389,18801587.8,174.0,64.83333333333333,6,389,18800163.8,174.0,64.83333333333333
50764.0,17,2,180,1,90,0.0,90.0,90.0,1,90,0.0,90.0,90.0
72217.0,6,20,7606,11,978,7221.7,310.0,88.9090909090909,9,6628,8639.0,1514.0,736.4444444444445
108105580.0,17,5,1005,5,1005,27026395.0,201.0,201.0,0,0,0.0,0.0,0.0
2374.0,17,4,344,2,150,0.0,75.0,75.0,2,194,0.0,103.0,97.0
2026.0,17,4,344,2,150,0.0,75.0,75.0,2,194,0.0,103.0,97.0
164058.0,17,4,1400,4,1400,54686.0,350.0,350.0,0,0,0.0,0.0,0.0
212518.0,6,3,426,2,280,0.0,214.0,140.0,1,146,0.0,146.0,146.0
57676.0,6,14,4740,7,653,9278.833333333334,249.0,93.28571428571428,7,4087,7892.166666666667,1514.0,583.8571428571429
186093.0,17,2,180,1,90,0.0,90.0,90.0,1,90,0.0,90.0,90.0
315137.0,6,6,412,4,272,105045.66666666669,74.0,68.0,2,140,0.0,74.0,70.0
2055.0,17,4,344,2,150,0.0,75.0,75.0,2,194,0.0,103.0,97.0
90023032.0,17,28,13364,28,13364,3334186.3703703703,501.0,477.2857142857143,0,0,0.0,0.0,0.0
322749.0,17,4,1400,4,1400,107583.0,350.0,350.0,0,0,0.0,0.0,0.0
90023832.0,17,27,12943,27,12943,3462455.076923077,501.0,479.3703703703704,0,0,0.0,0.0,0.0
107582518.0,6,51,4512,29,2496,3842232.785714286,123.0,86.06896551724138,22,2016,5112668.285714285,123.0,91.63636363636364
530745.0,17,6,2100,6,2100,106149.0,350.0,350.0,0,0,0.0,0.0,0.0
302238.0,6,6,412,4,272,100746.0,74.0,68.0,2,140,0.0,74.0,70.0
36100.0,6,11,2098,6,590,7080.4,252.0,98.33333333333331,5,1508,8751.5,1236.0,301.6
175623.0,6,3,337,2,214,0.0,160.0,107.0,1,123,0.0,123.0,123.0
90053734.0,17,28,13364,28,13364,3335323.4814814813,501.0,477.2857142857143,0,0,0.0,0.0,0.0
20082.0,17,2,582,1,83,0.0,83.0,83.0,1,499,0.0,499.0,499.0
125007708.0,6,36,2602,19,1408,6944872.666666667,139.0,74.10526315789474,17,1194,7175941.25,123.0,70.23529411764706
100584727.0,17,13,1083,7,563,16666810.0,174.0,80.42857142857143,6,520,16201340.6,174.0,86.66666666666667
107830784.0,6,28,1860,14,966,8278072.076923077,123.0,69.0,14,894,8278065.153846154,123.0,63.85714285714285
107135.0,17,2,286,2,286,0.0,143.0,143.0,0,0,0.0,0.0,0.0
1785189.0,6,2,132,1,66,0.0,66.0,66.0,1,66,0.0,66.0,66.0
108106881.0,17,5,955,5,955,27026720.25,191.0,191.0,0,0,0.0,0.0,0.0
33863.0,6,10,2032,5,524,7341.75,252.0,104.8,5,1508,8173.5,1236.0,301.6
0.0,17,1,44,1,44,0.0,44.0,44.0,0,0,0.0,0.0,0.0
218967.0,6,3,426,2,280,0.0,214.0,140.0,1,146,0.0,146.0,146.0
42938.0,6,14,4740,7,653,6988.0,249.0,93.28571428571428,7,4087,6926.0,1514.0,583.8571428571429
224766.0,6,3,426,2,280,0.0,214.0,140.0,1,146,0.0,146.0,146.0
228243.0,17,2,180,1,90,0.0,90.0,90.0,1,90,0.0,90.0,90.0
120643328.0,6,44,3322,23,1774,5483787.636363637,139.0,77.1304347826087,21,1548,5522096.8,123.0,73.71428571428571
4835.0,17,2,180,1,90,0.0,90.0,90.0,1,90,0.0,90.0,90.0
228314.0,17,2,180,1,90,0.0,90.0,90.0,1,90,0.0,90.0,90.0
2694626.0,6,25,7573,14,3735,207278.92307692303,1514.0,266.7857142857143,11,3838,242985.1,1514.0,348.90909090909093
120120789.0,6,13,2036,5,1020,30030197.25,204.0,204.0,8,1016,17136550.14285714,188.0,127.0
233837.0,6,3,337,2,214,0.0,160.0,107.0,1,123,0.0,123.0,123.0
200675.0,17,4,6056,4,6056,66891.66666666667,1514.0,1514.0,0,0,0.0,0.0,0.0
242188.0,6,3,337,2,214,0.0,160.0,107.0,1,123,0.0,123.0,123.0
329.0,17,2,174,1,79,0.0,79.0,79.0,1,95,0.0,95.0,95.0
135008271.0,17,17,1255,9,649,16876033.875,174.0,72.11111111111111,8,606,16428717.285714284,174.0,75.75
221677.0,6,3,426,2,280,0.0,214.0,140.0,1,146,0.0,146.0,146.0
237363.0,17,2,180,1,90,0.0,90.0,90.0,1,90,0.0,90.0,90.0
20897.0,6,10,2032,5,524,4992.25,252.0,104.8,5,1508,4936.0,1236.0,301.6
512785.00000000006,6,5,336,2,134,0.0,68.0,67.0,3,202,193529.0,70.0,67.33333333333333
90738781.0,6,24,1829,13,989,7558182.916666667,95.0,76.07692307692308,11,840,9046426.9,95.0,76.36363636363636
206108.0,6,3,426,2,280,0.0,214.0,140.0,1,146,0.0,146.0,146.0
120401623.0,6,235,26594,118,18576,1029073.7008547008,284.0,157.42372881355934,117,8018,1028977.051724138,140.0,68.52991452991454
101240679.0,17,14,864,7,432,16834167.833333332,174.0,61.71428571428572,7,432,16833518.0,174.0,61.71428571428572
230827.0,6,3,426,2,280,0.0,214.0,140.0,1,146,0.0,146.0,146.0
90305394.0,6,16,1192,8,596,12893634.714285716,95.0,74.5,8,596,12898085.285714284,95.0,74.5
198581.0,17,2,180,1,90,0.0,90.0,90.0,1,90,0.0,90.0,90.0
121231692.0,6,222,24962,111,7622,1077003.6545454543,140.0,68.66666666666667,111,17340,1094686.990909091,284.0,156.21621621621622
5827670.0,6,5,336,2,134,0.0,68.0,67.0,3,202,1525950.0,70.0,67.33333333333333
122978177.0,6,48,3168,24,1584,4927144.739130435,66.0,66.0,24,1584,5340068.391304348,66.0,66.0
104805633.0,6,18,1468,9,650,13094515.375,95.0,72.22222222222223,9,818,13100368.5,222.0,90.88888888888889
1307723.0,17,7,490,7,490,217953.8333333333,70.0,70.0,0,0,0.0,0.0,0.0
226091.0,6,3,426,2,280,0.0,214.0,140.0,1,146,0.0,146.0,146.0
26571983.0,17,5,1718,4,1368,938011.0,342.0,342.0,1,350,0.0,350.0,350.0
31034.0,6,14,4740,7,653,5043.166666666667,249.0,93.28571428571428,7,4087,4852.166666666667,1514.0,583.8571428571429
284385.0,17,2,493,1,88,0.0,88.0,88.0,1,405,0.0,405.0,405.0
143869.0,17,2,180,1,90,0.0,90.0,90.0,1,90,0.0,90.0,90.0
373.0,17,2,160,1,80,0.0,80.0,80.0,1,80,0.0,80.0,80.0
120119452.0,6,13,2036,8,1016,17136711.285714287,188.0,127.0,5,1020,22523300.5,204.0,204.0
317704.0,17,4,1400,4,1400,105901.33333333331,350.0,350.0,0,0,0.0,0.0,0.0
205723.0,6,10,1221,6,636,41144.6,298.0,106.0,4,585,67172.33333333333,379.0,146.25
319.0,17,2,174,1,79,0.0,79.0,79.0,1,95,0.0,95.0,95.0
144325.0,17,2,180,1,90,0.0,90.0,90.0,1,90,0.0,90.0,90.0
0.0,17,1,453,1,453,0.0,453.0,453.0,0,0,0.0,0.0,0.0
328.0,17,2,166,1,75,0.0,75.0,75.0,1,91,0.0,91.0,91.0
102900.0,17,2,286,2,286,0.0,143.0,143.0,0,0,0.0,0.0,0.0
1806.0,17,2,180,1,90,0.0,90.0,90.0,1,90,0.0,90.0,90.0
120123510.0,6,15,2428,9,1204,15015438.75,188.0,133.77777777777777,6,1224,18018686.8,204.0,204.0
41544.0,6,14,4740,7,653,6789.5,249.0,93.28571428571428,7,4087,6522.666666666667,1514.0,583.8571428571429
47964.0,6,14,4740,7,653,7882.0,249.0,93.28571428571428,7,4087,7674.5,1514.0,583.8571428571429
146195.0,6,3,337,2,214,0.0,160.0,107.0,1,123,0.0,123.0,123.0
311872.0,6,3,202,2,128,0.0,74.0,64.0,1,74,0.0,74.0,74.0
312215.0,6,6,412,4,272,104071.66666666669,74.0,68.0,2,140,0.0,74.0,70.0
1163041.0,6,13,3009,8,2381,166148.7142857143,1514.0,297.625,5,628,221863.25,331.0,125.6
306999.0,6,6,412,4,272,102333.0,74.0,68.0,2,140,0.0,74.0,70.0
94541.0,6,10,2032,5,524,8881.75,252.0,104.8,5,1508,22283.0,1236.0,301.6
51050.0,6,10,2032,5,524,12555.25,252.0,104.8,5,1508,11362.75,1236.0,301.6
110942335.0,6,31,2182,16,1165,7381804.4,139.0,72.8125,15,1017,7909076.714285715,123.0,67.8
307025.0,6,6,412,4,272,102341.66666666669,74.0,68.0,2,140,0.0,74.0,70.0
119634081.0,6,47,3102,24,1584,5189657.347826087,66.0,66.0,23,1518,5135431.636363637,66.0,66.0
64004.00000000001,6,14,4740,7,653,10357.166666666666,249.0,93.28571428571428,7,4087,10519.833333333334,1514.0,583.8571428571429
102149451.0,17,14,1126,7,563,17001969.166666668,174.0,80.42857142857143,7,563,17000188.0,174.0,80.42857142857143
60902662.0,17,8,2744,7,2394,5963089.666666667,342.0,342.0,1,350,0.0,350.0,350.0
42570.0,6,14,4740,7,653,6934.833333333333,249.0,93.28571428571428,7,4087,6819.0,1514.0,583.8571428571429
187963.0,17,2,180,1,90,0.0,90.0,90.0,1,90,0.0,90.0,90.0
34445.0,6,14,4740,7,653,5284.0,249.0,93.28571428571428,7,4087,5606.833333333333,1514.0,583.8571428571429
37048.0,6,14,4740,7,653,6042.5,249.0,93.28571428571428,7,4087,5828.333333333333,1514.0,583.8571428571429
1516771.0,6,13,3010,8,2382,216681.57142857145,1514.0,297.75,5,628,310285.5,331.0,125.6
143890.0,17,2,180,1,90,0.0,90.0,90.0,1,90,0.0,90.0,90.0
35159.0,6,14,4740,7,653,5652.166666666667,249.0,93.28571428571428,7,4087,5720.5,1514.0,583.8571428571429
146285.0,6,3,337,2,214,0.0,160.0,107.0,1,123,0.0,123.0,123.0
90027387.0,17,28,13364,28,13364,3334347.6666666665,501.0,477.2857142857143,0,0,0.0,0.0,0.0
26512.0,6,14,4740,7,653,4240.166666666667,249.0,93.28571428571428,7,4087,4228.333333333333,1514.0,583.8571428571429
16129.999999999998,6,11,2098,6,590,2597.8,252.0,98.33333333333331,5,1508,3707.75,1236.0,301.6
144965.0,17,2,180,1,70,0.0,70.0,70.0,1,110,0.0,110.0,110.0
90258673.0,6,13,2036,8,1016,12894096.142857144,188.0,127.0,5,1020,22522043.75,204.0,204.0
57273.0,6,12,1320,7,789,9545.5,253.0,112.71428571428572,5,531,12901.5,259.0,106.2
33384.0,6,14,4740,7,653,4905.0,249.0,93.28571428571428,7,4087,4225.0,1514.0,583.8571428571429
310419.0,6,6,412,4,272,103473.0,74.0,68.0,2,140,0.0,74.0,70.0
277701.0,17,2,180,1,90,0.0,90.0,90.0,1,90,0.0,90.0,90.0
2592931.0,6,2,132,1,66,0.0,66.0,66.0,1,66,0.0,66.0,66.0
104262.0,17,2,286,2,286,0.0,143.0,143.0,0,0,0.0,0.0,0.0
108133.0,17,2,286,2,286,0.0,143.0,143.0,0,0,0.0,0.0,0.0
120131552.0,6,15,2428,9,1204,15016444.0,188.0,133.77777777777777,6,1224,18072052.0,204.0,204.0
123302164.0,6,48,3168,24,1584,5073345.347826087,66.0,66.0,24,1584,5223434.434782608,66.0,66.0
303147.0,6,2,132,1,66,0.0,66.0,66.0,1,66,0.0,66.0,66.0
301564.0,6,6,412,4,272,100521.33333333331,74.0,68.0,2,140,0.0,74.0,70.0
118000992.0,17,13,821,7,432,19666832.0,174.0,61.71428571428572,6,389,19801108.6,174.0,64.83333333333333
99863606.0,17,11,604,6,389,19972721.2,174.0,64.83333333333333,5,215,20000818.75,43.0,43.0
306.0,17,2,168,1,76,0.0,76.0,76.0,1,92,0.0,92.0,92.0
407.0,17,2,410,1,78,0.0,78.0,78.0,1,332,0.0,332.0,332.0
135142552.0,17,6,1146,6,1146,27028510.4,191.0,191.0,0,0,0.0,0.0,0.0
752884.0,6,2,132,1,66,0.0,66.0,66.0,1,66,0.0,66.0,66.0
2558247.0,6,30,9358,17,3897,159890.4375,1514.0,229.23529411764707,13,5461,191713.66666666663,1514.0,420.0769230769231
4999077.0,17,4,534,2,166,0.0,83.0,83.0,2,368,0.0,184.0,184.0
143950.0,17,2,180,1,90,0.0,90.0,90.0,1,90,0.0,90.0,90.0
197065.0,17,4,6056,4,6056,65688.33333333333,1514.0,1514.0,0,0,0.0,0.0,0.0
34292.0,6,14,4740,7,653,5543.666666666667,249.0,93.28571428571428,7,4087,5522.5,1514.0,583.8571428571429
2361.0,17,4,344,2,150,0.0,75.0,75.0,2,194,0.0,103.0,97.0
2013.0,17,4,344,2,150,0.0,75.0,75.0,2,194,0.0,103.0,97.0
2102.0,17,4,344,2,150,0.0,75.0,75.0,2,194,0.0,103.0,97.0
3172945.0,6,18,1495,9,921,358318.875,315.0,102.33333333333331,9,574,358294.125,78.0,63.77777777777778
15076285.0,17,6,2052,6,2052,3015257.0,342.0,342.0,0,0,0.0,0.0,0.0
228358.0,17,2,180,1,90,0.0,90.0,90.0,1,90,0.0,90.0,90.0
101129.0,6,10,2032,5,524,24457.75,252.0,104.8,5,1508,24490.0,1236.0,301.6
119799984.0,6,24,1788,13,989,9983332.0,95.0,76.07692307692308,11,799,11954614.0,95.0,72.63636363636364
205953.0,6,3,426,2,280,0.0,214.0,140.0,1,146,0.0,146.0,146.0
146276.0,6,3,337,2,214,0.0,160.0,107.0,1,123,0.0,123.0,123.0
374.0,17,2,166,1,75,0.0,75.0,75.0,1,91,0.0,91.0,91.0
342.0,17,2,267,1,83,0.0,83.0,83.0,1,184,0.0,184.0,184.0
2461.0,17,4,344,2,150,0.0,75.0,75.0,2,194,0.0,103.0,97.0
2398201.0,6,3,1602,2,850,0.0,784.0,425.0,1,752,0.0,752.0,752.0
84675.0,6,14,4740,7,653,13872.5,249.0,93.28571428571428,7,4087,7908.333333333333,1514.0,583.8571428571429
106433.0,6,14,4740,7,653,12874.166666666666,249.0,93.28571428571428,7,4087,17583.333333333332,1514.0,583.8571428571429
120005280.0,17,15,1169,8,606,17143611.42857143,174.0,75.75,7,563,16666797.5,174.0,80.42857142857143
102574.0,17,2,762,2,762,0.0,381.0,381.0,0,0,0.0,0.0,0.0
0.0,6,1,54,0,0,0.0,0.0,0.0,1,54,0.0,54.0,54.0
3574541.0,6,5,336,2,134,0.0,68.0,67.0,3,202,1424305.0,70.0,67.33333333333333
314885.0,17,4,1400,4,1400,104961.66666666669,350.0,350.0,0,0,0.0,0.0,0.0
201839.0,17,2,180,1,90,0.0,90.0,90.0,1,90,0.0,90.0,90.0
327451.0,6,6,412,4,272,109150.33333333331,74.0,68.0,2,140,0.0,74.0,70.0
28238.0,6,14,4740,7,653,4432.5,249.0,93.28571428571428,7,4087,4574.0,1514.0,583.8571428571429
923.0,17,2,762,2,762,0.0,381.0,381.0,0,0,0.0,0.0,0.0
148070.0,17,2,180,1,90,0.0,90.0,90.0,1,90,0.0,90.0,90.0
2763.0,17,2,224,1,76,0.0,76.0,76.0,1,148,0.0,148.0,148.0
308052.0,6,6,412,4,272,102684.0,74.0,68.0,2,140,0.0,74.0,70.0
148154.0,17,2,180,1,90,0.0,90.0,90.0,1,90,0.0,90.0,90.0
108412770.0,6,202,22758,101,15870,1081974.59,284.0,157.12871287128712,101,6888,1081962.29,140.0,68.1980198019802
2460.0,17,4,344,2,150,0.0,75.0,75.0,2,194,0.0,103.0,97.0
120000121.0,6,24,1870,14,1084,9230778.538461538,95.0,77.42857142857143,10,786,10182933.666666666,95.0,78.6
306377.0,6,6,412,4,272,102125.66666666669,74.0,68.0,2,140,0.0,74.0,70.0
99359822.0,17,14,1126,7,563,16533338.5,174.0,80.42857142857143,7,563,16475505.5,174.0,80.42857142857143
824.0,17,4,438,2,148,0.0,74.0,74.0,2,290,0.0,147.0,145.0
34142.0,6,13,1386,7,789,5077.333333333333,253.0,112.71428571428572,6,597,5951.0,259.0,99.5
3134872.0,17,3,1026,3,1026,1567436.0,342.0,342.0,0,0,0.0,0.0,0.0
1952.0,17,4,344,2,150,0.0,75.0,75.0,2,194,0.0,103.0,97.0
893.0,17,2,762,2,762,0.0,381.0,381.0,0,0,0.0,0.0,0.0
10474801.0,6,7,478,4,272,3444395.333333333,74.0,68.0,3,206,5166505.0,74.0,68.66666666666667
53417.0,6,12,1413,7,882,8902.833333333334,291.0,126.0,5,531,11152.25,259.0,106.2
301622.0,6,6,412,4,272,100540.66666666669,74.0,68.0,2,140,0.0,74.0,70.0
34369.0,6,10,2032,5,524,8080.0,252.0,104.8,5,1508,7765.75,1236.0,301.6
96848.0,17,2,762,2,762,0.0,381.0,381.0,0,0,0.0,0.0,0.0
1302448.0,6,4,264,2,132,0.0,66.0,66.0,2,132,0.0,66.0,66.0
6532.0,17,4,823,2,163,0.0,89.0,81.5,2,660,0.0,443.0,330.0
31283.0,6,14,4740,7,653,5092.5,249.0,93.28571428571428,7,4087,4762.333333333333,1514.0,583.8571428571429
19129.0,6,20,7606,11,978,1912.9,310.0,88.9090909090909,9,6628,2094.75,1514.0,736.4444444444445
120038249.0,17,29,13785,29,13785,4287080.321428572,501.0,475.3448275862069,0,0,0.0,0.0,0.0
90261185.0,6,14,2240,8,1016,12894455.0,188.0,127.0,6,1224,18018007.4,204.0,204.0
9681.0,17,4,823,2,163,0.0,89.0,81.5,2,660,0.0,443.0,330.0
50373.0,6,14,4740,7,653,7961.166666666667,249.0,93.28571428571428,7,4087,8256.0,1514.0,583.8571428571429
10616.0,17,2,539,1,86,0.0,86.0,86.0,1,453,0.0,453.0,453.0
19673.0,17,2,180,1,90,0.0,90.0,90.0,1,90,0.0,90.0,90.0
206967.0,6,3,426,2,280,0.0,214.0,140.0,1,146,0.0,146.0,146.0
100000916.0,17,11,473,6,258,20000183.2,43.0,43.0,5,215,19998493.75,43.0,43.0
90052123.0,17,28,13364,28,13364,3335263.814814815,501.0,477.2857142857143,0,0,0.0,0.0,0.0
120147971.0,6,210,23758,105,7226,1147277.7596153845,140.0,68.81904761904762,105,16532,1147348.0576923075,284.0,157.44761904761904
3574.0,17,2,359,1,75,0.0,75.0,75.0,1,284,0.0,284.0,284.0
6596.0,17,2,447,1,84,0.0,84.0,84.0,1,363,0.0,363.0,363.0
120294837.0,6,221,25056,111,17574,1093589.4272727272,284.0,158.32432432432432,110,7482,1095188.5779816513,140.0,68.01818181818182
2796015.0,6,2,132,1,66,0.0,66.0,66.0,1,66,0.0,66.0,66.0
318154.0,17,4,1400,4,1400,106051.33333333331,350.0,350.0,0,0,0.0,0.0,0.0
47901.0,6,14,4740,7,653,7591.666666666667,249.0,93.28571428571428,7,4087,7631.833333333333,1514.0,583.8571428571429
103487351.0,17,14,864,7,432,17167506.5,174.0,61.71428571428572,7,432,17166832.5,174.0,61.71428571428572
143894.0,17,2,180,1,90,0.0,90.0,90.0,1,90,0.0,90.0,90.0
953856.0,6,13,1513,7,882,158200.66666666666,291.0,126.0,6,631,188919.0,293.0,105.16666666666669
148014.0,17,2,180,1,90,0.0,90.0,90.0,1,90,0.0,90.0,90.0
120123218.0,6,13,2036,8,1016,17137285.14285714,188.0,127.0,5,1020,22523623.25,204.0,204.0
146643.0,6,3,373,2,238,0.0,172.0,119.0,1,135,0.0,135.0,135.0
172309.0,6,3,337,2,214,0.0,160.0,107.0,1,123,0.0,123.0,123.0
135127931.0,17,6,1146,6,1146,27025586.2,191.0,191.0,0,0,0.0,0.0,0.0
3052792.0,6,3,204,1,68,0.0,68.0,68.0,2,136,0.0,70.0,68.0
318186.0,17,4,1400,4,1400,106062.0,350.0,350.0,0,0,0.0,0.0,0.0
20300.0,17,2,582,1,83,0.0,83.0,83.0,1,499,0.0,499.0,499.0
38415.0,6,10,2032,5,524,9370.5,252.0,104.8,5,1508,9208.0,1236.0,301.6
165948.0,6,11,1132,6,556,32787.6,218.0,92.66666666666669,5,576,41216.5,304.0,115.2
2510.0,17,6,1230,3,234,1084.5,78.0,78.0,3,996,1048.0,332.0,332.0
311421.0,17,4,1400,4,1400,103807.0,350.0,350.0,0,0,0.0,0.0,0.0
66821.0,6,14,4740,7,653,10779.5,249.0,93.28571428571428,7,4087,10859.166666666666,1514.0,583.8571428571429
120006762.0,6,16,1192,8,596,17143823.14285714,95.0,74.5,8,596,17105831.85714286,95.0,74.5
43723.0,6,10,2032,5,524,9471.0,252.0,104.8,5,1508,10288.0,1236.0,301.6
153426.0,17,2,180,1,90,0.0,90.0,90.0,1,90,0.0,90.0,90.0
3183.0,17,4,344,2,150,0.0,75.0,75.0,2,194,0.0,103.0,97.0
242898.0,6,13,1386,7,789,40483.0,253.0,112.71428571428572,6,597,46840.2,259.0,99.5
235827.0,6,13,1386,7,789,39304.5,253.0,112.71428571428572,6,597,45607.2,259.0,99.5
111507672.0,6,34,2350,17,1225,6955748.875,139.0,72.05882352941177,17,1125,6955748.0,123.0,66.17647058823529
208459.0,17,2,762,2,762,0.0,381.0,381.0,0,0,0.0,0.0,0.0
228364.0,17,2,180,1,90,0.0,90.0,90.0,1,90,0.0,90.0,90.0
2381.0,17,4,344,2,150,0.0,75.0,75.0,2,194,0.0,103.0,97.0
42317.0,6,14,4740,7,653,6880.166666666667,249.0,93.28571428571428,7,4087,6688.833333333333,1514.0,583.8571428571429
123730503.0,6,49,3234,25,1650,5155437.625,66.0,66.0,24,1584,5107490.652173913,66.0,66.0
119491637.0,6,238,26738,119,18588,1010816.6355932204,284.0,156.2016806722689,119,8150,1010738.627118644,140.0,68.4873949579832
120124101.0,6,13,2036,5,1020,30031025.25,204.0,204.0,8,1016,17137152.42857143,188.0,127.0
5622991.0,6,5,336,2,134,0.0,68.0,67.0,3,202,1419265.0,70.0,67.33333333333333
60359.0,6,14,4740,7,653,9484.0,249.0,93.28571428571428,7,4087,6793.666666666667,1514.0,583.8571428571429
228257.0,17,2,180,1,90,0.0,90.0,90.0,1,90,0.0,90.0,90.0
2075.0,17,4,344,2,150,0.0,75.0,75.0,2,194,0.0,103.0,97.0
284314.0,17,2,363,1,79,0.0,79.0,79.0,1,284,0.0,284.0,284.0
197861.0,17,2,762,2,762,0.0,381.0,381.0,0,0,0.0,0.0,0.0
15867.0,6,2,145,2,145,0.0,91.0,72.5,0,0,0.0,0.0,0.0
120044762.0,17,28,13364,28,13364,4446102.296296297,501.0,477.2857142857143,0,0,0.0,0.0,0.0
176752.0,6,3,337,2,214,0.0,160.0,107.0,1,123,0.0,123.0,123.0
9833.0,17,2,582,1,83,0.0,83.0,83.0,1,499,0.0,499.0,499.0
73131.0,6,10,2032,5,524,17779.0,252.0,104.8,5,1508,17140.5,1236.0,301.6
101614164.0,6,40,2640,20,1320,5348113.894736842,66.0,66.0,20,1320,5333620.210526316,66.0,66.0
506408.0,6,4,270,2,134,0.0,68.0,67.0,2,136,0.0,70.0,68.0
24616133.0,17,5,1718,4,1368,978516.6666666666,342.0,342.0,1,350,0.0,350.0,350.0
311863.0,6,6,412,4,272,103954.33333333331,74.0,68.0,2,140,0.0,74.0,70.0
108103974.0,17,5,955,5,955,27025993.5,191.0,191.0,0,0,0.0,0.0,0.0
113751057.0,6,47,3102,24,1584,4945687.260869565,66.0,66.0,23,1518,5159994.727272728,66.0,66.0
2601572.0,6,2,132,1,66,0.0,66.0,66.0,1,66,0.0,66.0,66.0
6891.0,17,2,582,1,83,0.0,83.0,83.0,1,499,0.0,499.0,499.0
29174.0,6,14,4740,7,653,4470.5,249.0,93.28571428571428,7,4087,4676.5,1514.0,583.8571428571429
97687645.0,6,40,2640,20,1320,5141455.0,66.0,66.0,20,1320,5125213.157894737,66.0,66.0
34427.0,6,10,2032,5,524,8402.75,252.0,104.8,5,1508,7846.0,1236.0,301.6
10879.0,6,10,1066,5,490,2420.25,218.0,98.0,5,576,2500.75,304.0,115.2
121281.0,6,3,337,2,214,0.0,160.0,107.0,1,123,0.0,123.0,123.0
246329.0,6,3,337,2,214,0.0,160.0,107.0,1,123,0.0,123.0,123.0
108109321.0,17,5,1005,5,1005,27027330.25,201.0,201.0,0,0,0.0,0.0,0.0
1133259.0,6,13,3010,8,2382,161894.14285714287,1514.0,297.75,5,628,214323.75,331.0,125.6
141325.0,6,2,132,1,66,0.0,66.0,66.0,1,66,0.0,66.0,66.0
0.0,17,1,55,1,55,0.0,55.0,55.0,0,0,0.0,0.0,0.0
20843.0,6,2,145,2,145,0.0,91.0,72.5,0,0,0.0,0.0,0.0
90286414.0,6,20,1490,11,840,9024456.2,95.0,76.36363636363636,9,650,11284034.0,95.0,72.22222222222223
2283128.0,6,19,6869,10,1501,253680.88888888888,408.0,150.1,9,5368,242097.625,1514.0,596.4444444444445
96448.0,17,2,762,2,762,0.0,381.0,381.0,0,0,0.0,0.0,0.0
505784.0,6,5,336,2,134,0.0,68.0,67.0,3,202,188055.0,70.0,67.33333333333333
119041320.0,6,48,3168,24,1584,5175709.565217392,66.0,66.0,24,1584,5163864.0,66.0,66.0
804681.0,6,5,1742,3,921,402340.5,785.0,307.0,2,821,0.0,753.0,410.5
250396.0,6,3,373,2,238,0.0,172.0,119.0,1,135,0.0,135.0,135.0
12019.0,6,11,2098,6,590,1872.4,252.0,98.33333333333331,5,1508,2608.0,1236.0,301.6
272833.0,6,10,1221,6,636,54566.6,298.0,106.0,4,585,85553.33333333333,379.0,146.25
112535493.0,6,46,3036,23,1518,5105435.0,66.0,66.0,23,1518,5105434.7727272725,66.0,66.0
72930.0,6,14,4740,7,653,11432.166666666666,249.0,93.28571428571428,7,4087,11685.0,1514.0,583.8571428571429
985341.0,6,13,1420,7,789,163889.16666666666,253.0,112.71428571428572,6,631,196758.2,293.0,105.16666666666669
107401346.0,17,14,864,7,432,17834167.166666668,174.0,61.71428571428572,7,432,17833489.833333332,174.0,61.71428571428572
13465.0,6,10,2032,5,524,2970.5,252.0,104.8,5,1508,2796.5,1236.0,301.6
1666606.0,6,4,492,2,280,0.0,214.0,140.0,2,212,0.0,146.0,106.0
108102903.0,17,5,955,5,955,27025725.75,191.0,191.0,0,0,0.0,0.0,0.0
311.0,17,2,156,1,78,0.0,78.0,78.0,1,78,0.0,78.0,78.0
313.0,17,2,156,1,78,0.0,78.0,78.0,1,78,0.0,78.0,78.0
0.0,17,1,55,1,55,0.0,55.0,55.0,0,0,0.0,0.0,0.0
473442.0,17,4,1524,4,1524,157814.0,381.0,381.0,0,0,0.0,0.0,0.0
196884.0,17,2,180,1,90,0.0,90.0,90.0,1,90,0.0,90.0,90.0
10461212.0,6,6,412,3,206,5162342.0,74.0,68.66666666666667,3,206,5162216.0,74.0,68.66666666666667
149727274.0,6,15,2290,5,1020,29963910.5,204.0,204.0,10,1270,16636219.0,188.0,127.0
9364.0,17,2,582,1,83,0.0,83.0,83.0,1,499,0.0,499.0,499.0
2072.0,17,4,344,2,150,0.0,75.0,75.0,2,194,0.0,103.0,97.0
2651613.0,6,25,7573,14,3735,203970.2307692308,1514.0,266.7857142857143,11,3838,239575.3,1514.0,348.90909090909093
103154710.0,6,31,2182,16,1165,6863358.066666666,139.0,72.8125,15,1017,7353587.428571428,123.0,67.8
197176.0,17,2,180,1,90,0.0,90.0,90.0,1,90,0.0,90.0,90.0
209765.0,17,2,180,1,90,0.0,90.0,90.0,1,90,0.0,90.0,90.0
201715.0,17,2,762,2,762,0.0,381.0,381.0,0,0,0.0,0.0,0.0
120060006.0,17,29,13785,29,13785,4287857.357142857,501.0,475.3448275862069,0,0,0.0,0.0,0.0
90059563.0,17,28,13364,28,13364,3335539.3703703703,501.0,477.2857142857143,0,0,0.0,0.0,0.0
309.0,17,2,174,1,79,0.0,79.0,79.0,1,95,0.0,95.0,95.0
135130074.0,17,6,1146,6,1146,27026014.8,191.0,191.0,0,0,0.0,0.0,0.0
7775.0,17,4,344,2,150,0.0,75.0,75.0,2,194,0.0,103.0,97.0
2017311.0,17,4,525,2,150,0.0,75.0,75.0,2,375,0.0,284.0,187.5
102969.0,17,2,286,2,286,0.0,143.0,143.0,0,0,0.0,0.0,0.0
414042.0,6,3,1604,2,851,0.0,785.0,425.5,1,753,0.0,753.0,753.0
506751.0,6,5,336,2,134,0.0,68.0,67.0,3,202,191425.0,70.0,67.33333333333333
1307020.0,6,4,264,2,132,0.0,66.0,66.0,2,132,0.0,66.0,66.0
2103387.0,6,18,6803,10,1501,233709.66666666663,408.0,150.1,8,5302,237518.4285714285,1514.0,662.75
0.0,17,1,55,1,55,0.0,55.0,55.0,0,0,0.0,0.0,0.0
38394.0,6,10,2032,5,524,9388.0,252.0,104.8,5,1508,8681.5,1236.0,301.6
120005829.0,6,23,1734,12,935,10908475.636363637,95.0,77.91666666666667,11,799,12000316.1,95.0,72.63636363636364
34485.0,6,14,4740,7,653,5402.166666666667,249.0,93.28571428571428,7,4087,5558.166666666667,1514.0,583.8571428571429
4270.0,17,2,602,1,72,0.0,72.0,72.0,1,530,0.0,530.0,530.0
303.0,17,2,164,1,82,0.0,82.0,82.0,1,82,0.0,82.0,82.0
196975.0,17,2,180,1,90,0.0,90.0,90.0,1,90,0.0,90.0,90.0
298358.0,6,6,412,4,272,99452.66666666669,74.0,68.0,2,140,0.0,74.0,70.0
349.0,17,2,267,1,83,0.0,83.0,83.0,1,184,0.0,184.0,184.0
5627084.0,6,4,270,2,134,0.0,68.0,67.0,2,136,0.0,70.0,68.0
2596816.0,6,2,132,1,66,0.0,66.0,66.0,1,66,0.0,66.0,66.0
305642.0,6,6,412,4,272,101880.66666666669,74.0,68.0,2,140,0.0,74.0,70.0
45986.0,6,12,1413,7,882,7664.333333333333,291.0,126.0,5,531,10577.75,259.0,106.2
611427.0,6,4,508,2,238,0.0,172.0,119.0,2,270,0.0,135.0,135.0
2056.0,17,4,344,2,150,0.0,75.0,75.0,2,194,0.0,103.0,97.0
90206517.0,6,12,1832,8,1016,12886645.285714284,188.0,127.0,4,816,30013820.0,204.0,204.0
47452.0,6,11,2098,6,590,8896.8,252.0,98.33333333333331,5,1508,11296.5,1236.0,301.6
90030700.0,17,28,13364,28,13364,3334470.3703703703,501.0,477.2857142857143,0,0,0.0,0.0,0.0
324597.0,6,6,412,4,272,108199.0,74.0,68.0,2,140,0.0,74.0,70.0
849022.0,6,9,1268,6,797,169804.4,459.0,132.83333333333334,3,471,288199.5,331.0,157.0
300759.0,6,6,412,4,272,100253.0,74.0,68.0,2,140,0.0,74.0,70.0
63560.00000000001,6,14,4740,7,653,10136.5,249.0,93.28571428571428,7,4087,9992.833333333334,1514.0,583.8571428571429
224011.0,17,4,1524,4,1524,74670.33333333333,381.0,381.0,0,0,0.0,0.0,0.0
196840.0,17,2,180,1,90,0.0,90.0,90.0,1,90,0.0,90.0,90.0
5620722.0,6,5,336,3,202,1525786.0,70.0,67.33333333333333,2,134,0.0,68.0,67.0
232294.0,6,3,337,2,214,0.0,160.0,107.0,1,123,0.0,123.0,123.0
10471412.0,6,7,478,4,272,3444843.333333333,74.0,68.0,3,206,5167171.5,74.0,68.66666666666667
113927548.0,6,47,3102,24,1584,4941532.956521739,66.0,66.0,23,1518,5135442.409090909,66.0,66.0
129843230.0,6,35,2542,17,1194,7491120.375,123.0,70.23529411764706,18,1348,7050463.823529412,139.0,74.88888888888889
0.0,17,1,453,1,453,0.0,453.0,453.0,0,0,0.0,0.0,0.0
1034380.0,6,11,1134,6,558,206876.0,220.0,93.0,5,576,256913.0,304.0,115.2
119122024.0,6,34,2334,17,1209,7432350.5625,123.0,71.11764705882354,17,1125,7432345.625,123.0,66.17647058823529
52200.0,6,12,1320,6,723,8371.8,253.0,120.5,6,597,9837.4,259.0,99.5
216374.0,17,2,180,1,90,0.0,90.0,90.0,1,90,0.0,90.0,90.0
90058437.0,17,28,13364,28,13364,3335497.6666666665,501.0,477.2857142857143,0,0,0.0,0.0,0.0
90030089.0,17,28,13364,28,13364,3334447.7407407407,501.0,477.2857142857143,0,0,0.0,0.0,0.0
120364424.0,6,229,25928,115,18182,1055828.2807017544,284.0,158.10434782608695,114,7746,1056055.725663717,140.0,67.94736842105263
108106033.0,17,5,955,5,955,27026508.25,191.0,191.0,0,0,0.0,0.0,0.0
120427898.0,6,225,25574,113,17886,1075249.0892857143,284.0,158.28318584070797,112,7688,1075536.4684684684,140.0,68.64285714285714
108081714.0,17,5,955,5,955,27020428.5,191.0,191.0,0,0,0.0,0.0,0.0
23858.0,6,14,4740,7,653,3861.1666666666665,249.0,93.28571428571428,7,4087,3687.3333333333335,1514.0,583.8571428571429
2363.0,17,4,344,2,150,0.0,75.0,75.0,2,194,0.0,103.0,97.0
199751.0,17,2,762,2,762,0.0,381.0,381.0,0,0,0.0,0.0,0.0
242959.0,6,3,337,2,214,0.0,160.0,107.0,1,123,0.0,123.0,123.0
232460.0,6,3,337,2,214,0.0,160.0,107.0,1,123,0.0,123.0,123.0
32243.0,6,14,4740,7,653,4481.5,249.0,93.28571428571428,7,4087,5007.5,1514.0,583.8571428571429
120126143.0,6,16,2494,9,1204,15015767.875,188.0,133.77777777777777,7,1290,15061784.666666666,204.0,184.28571428571428
101760.0,17,2,286,2,286,0.0,143.0,143.0,0,0,0.0,0.0,0.0
256852.00000000003,6,3,337,2,214,0.0,160.0,107.0,1,123,0.0,123.0,123.0
21008995.0,17,3,1034,2,684,0.0,342.0,342.0,1,350,0.0,350.0,350.0
90068254.0,17,28,13364,28,13364,3335861.25925926,501.0,477.2857142857143,0,0,0.0,0.0,0.0
24489.0,6,14,4740,7,653,3912.6666666666665,249.0,93.28571428571428,7,4087,3870.8333333333335,1514.0,583.8571428571429
429151.0,6,2,132,1,66,0.0,66.0,66.0,1,66,0.0,66.0,66.0
146149.0,6,3,337,2,214,0.0,160.0,107.0,1,123,0.0,123.0,123.0
26358.0,6,10,1066,5,490,5994.75,218.0,98.0,5,576,5185.5,304.0,115.2
855805.0,6,9,1267,6,796,171161.0,458.0,132.66666666666666,3,471,290320.0,331.0,157.0
233476.0,6,3,337,2,214,0.0,160.0,107.0,1,123,0.0,123.0,123.0
51349.0,6,14,4740,7,653,8355.833333333334,249.0,93.28571428571428,7,4087,7887.166666666667,1514.0,583.8571428571429
306829.0,6,6,412,4,272,102276.33333333331,74.0,68.0,2,140,0.0,74.0,70.0
303.0,17,2,174,1,79,0.0,79.0,79.0,1,95,0.0,95.0,95.0
90027141.0,17,28,13364,28,13364,3334338.5555555555,501.0,477.2857142857143,0,0,0.0,0.0,0.0
1312037.0,17,7,490,7,490,218672.8333333333,70.0,70.0,0,0,0.0,0.0,0.0
10584.0,17,4,823,2,163,0.0,89.0,81.5,2,660,0.0,443.0,330.0
90549930.0,6,13,2036,8,1016,12935704.285714284,188.0,127.0,5,1020,22596807.5,204.0,204.0
39776.0,6,14,4740,7,653,6404.333333333333,249.0,93.28571428571428,7,4087,6438.333333333333,1514.0,583.8571428571429
2796351.0,6,2,132,1,66,0.0,66.0,66.0,1,66,0.0,66.0,66.0
123730714.0,6,49,3234,25,1650,5155446.416666667,66.0,66.0,24,1584,4938904.347826087,66.0,66.0
441.0,17,2,164,1,82,0.0,82.0,82.0,1,82,0.0,82.0,82.0
135136298.0,17,6,1206,6,1206,27027259.6,201.0,201.0,0,0,0.0,0.0,0.0
160658.0,17,2,180,1,90,0.0,90.0,90.0,1,90,0.0,90.0,90.0
149634.0,17,2,180,1,90,0.0,90.0,90.0,1,90,0.0,90.0,90.0
234575.0,6,3,373,2,238,0.0,172.0,119.0,1,135,0.0,135.0,135.0
307993.0,6,6,412,4,272,102664.33333333331,74.0,68.0,2,140,0.0,74.0,70.0
120137993.0,6,236,26644,118,8084,1019790.0854700856,140.0,68.50847457627118,118,18560,1020821.376068376,284.0,157.28813559322035
292.0,17,2,156,1,78,0.0,78.0,78.0,1,78,0.0,78.0,78.0
843025.0,6,9,1118,6,586,168605.0,248.0,97.66666666666669,3,532,283689.5,392.0,177.33333333333334
119814919.0,17,35,16705,35,16705,3523968.205882353,501.0,477.2857142857143,0,0,0.0,0.0,0.0
403.0,17,2,174,1,79,0.0,79.0,79.0,1,95,0.0,95.0,95.0
143954.0,17,2,180,1,90,0.0,90.0,90.0,1,90,0.0,90.0,90.0
40852.0,6,10,2032,5,524,9968.25,252.0,104.8,5,1508,8949.25,1236.0,301.6
101304252.0,6,188,21216,94,14778,1087083.752688172,284.0,157.2127659574468,94,6438,1087086.935483871,140.0,68.48936170212765
303141.0,6,3,202,2,128,0.0,74.0,64.0,1,74,0.0,74.0,74.0
120008543.0,6,18,1341,9,691,14999998.75,95.0,76.77777777777777,9,650,14999979.125,95.0,72.22222222222223
112852612.0,6,34,2350,17,1225,7040470.25,139.0,72.05882352941177,17,1125,7040511.125,123.0,66.17647058823529
157.0,17,2,3028,2,3028,0.0,1514.0,1514.0,0,0,0.0,0.0,0.0
22107.0,6,10,2032,5,524,5259.25,252.0,104.8,5,1508,5269.0,1236.0,301.6
308875.0,6,6,412,4,272,102958.33333333331,74.0,68.0,2,140,0.0,74.0,70.0
316053.0,17,4,1400,4,1400,105351.0,350.0,350.0,0,0,0.0,0.0,0.0
63197.0,6,10,2032,5,524,14186.25,252.0,104.8,5,1508,15515.25,1236.0,301.6
90260215.0,6,13,2036,8,1016,12894316.42857143,188.0,127.0,5,1020,22523592.75,204.0,204.0
41392.0,6,14,4740,7,653,6667.166666666667,249.0,93.28571428571428,7,4087,6762.166666666667,1514.0,583.8571428571429
40556.0,6,14,4740,7,653,6037.166666666667,249.0,93.28571428571428,7,4087,6579.666666666667,1514.0,583.8571428571429
135126852.0,17,6,1146,6,1146,27025370.4,191.0,191.0,0,0,0.0,0.0,0.0
80041.0,6,14,4740,7,653,13123.666666666666,249.0,93.28571428571428,7,4087,10946.0,1514.0,583.8571428571429
594184.0,17,2,346,1,78,0.0,78.0,78.0,1,268,0.0,268.0,268.0
2050575.0,17,8,1640,4,312,683400.6666666666,78.0,78.0,4,1328,679428.6666666666,332.0,332.0
10289.0,17,4,823,2,163,0.0,89.0,81.5,2,660,0.0,443.0,330.0
269277.0,17,2,180,1,90,0.0,90.0,90.0,1,90,0.0,90.0,90.0
47948.0,6,13,1386,7,789,7885.666666666667,253.0,112.71428571428572,6,597,7765.8,259.0,99.5
153478.0,17,2,180,1,90,0.0,90.0,90.0,1,90,0.0,90.0,90.0
149690.0,17,2,180,1,90,0.0,90.0,90.0,1,90,0.0,90.0,90.0
157309.0,6,3,337,2,214,0.0,160.0,107.0,1,123,0.0,123.0,123.0
206253.0,6,3,426,2,280,0.0,214.0,140.0,1,146,0.0,146.0,146.0
108102841.0,17,5,955,5,955,27025710.25,191.0,191.0,0,0,0.0,0.0,0.0
2439.0,17,4,344,2,150,0.0,75.0,75.0,2,194,0.0,103.0,97.0
87266.0,6,12,1328,6,731,16399.0,253.0,121.83333333333331,6,597,15684.4,259.0,99.5
77270.0,6,14,4740,7,653,12208.166666666666,249.0,93.28571428571428,7,4087,12198.333333333334,1514.0,583.8571428571429
114739675.0,6,31,2166,16,1149,7634931.4,123.0,71.8125,15,1017,8180286.285714285,123.0,67.8
153450.0,17,2,180,1,90,0.0,90.0,90.0,1,90,0.0,90.0,90.0
90035448.0,17,28,13364,28,13364,3334646.222222222,501.0,477.2857142857143,0,0,0.0,0.0,0.0
578332.0,6,4,508,2,238,0.0,172.0,119.0,2,270,0.0,135.0,135.0
120201930.0,6,210,23630,105,7226,1147874.4903846155,140.0,68.81904761904762,105,16404,1129394.0576923075,284.0,156.22857142857143
20259.0,6,10,2032,5,524,4843.25,252.0,104.8,5,1508,4503.0,1236.0,301.6
824.0,17,2,508,2,508,0.0,257.0,254.0,0,0,0.0,0.0,0.0
118365808.0,17,16,1212,8,606,16857277.42857143,174.0,75.75,8,606,16858082.42857143,174.0,75.75
10451491.0,6,7,478,4,272,3438234.333333333,74.0,68.0,3,206,5157215.5,74.0,68.66666666666667
2766406.0,6,2,132,1,66,0.0,66.0,66.0,1,66,0.0,66.0,66.0
101263773.0,6,30,2122,15,1105,7217710.642857143,139.0,73.66666666666667,15,1017,7217708.0,123.0,67.8
98310.0,17,2,762,2,762,0.0,381.0,381.0,0,0,0.0,0.0,0.0
108399.0,17,2,286,2,286,0.0,143.0,143.0,0,0,0.0,0.0,0.0
104306474.0,6,369,43680,185,12432,566883.0108695652,140.0,67.2,184,31248,568742.9617486339,284.0,169.82608695652175
120032093.0,17,29,13785,29,13785,4286860.464285715,501.0,475.3448275862069,0,0,0.0,0.0,0.0
101890065.0,6,32,2374,17,1288,6368129.0625,139.0,75.76470588235294,15,1086,6549229.357142857,123.0,72.4
309626.0,17,4,1400,4,1400,103208.66666666669,350.0,350.0,0,0,0.0,0.0,0.0
1308656.0,6,4,264,2,132,0.0,66.0,66.0,2,132,0.0,66.0,66.0
62212027.0,17,9,3086,8,2736,5144699.142857143,342.0,342.0,1,350,0.0,350.0,350.0
316480.0,17,4,1400,4,1400,105493.33333333331,350.0,350.0,0,0,0.0,0.0,0.0
18602.0,6,10,2032,5,524,4295.25,252.0,104.8,5,1508,4356.25,1236.0,301.6
2360.0,17,4,344,2,150,0.0,75.0,75.0,2,194,0.0,103.0,97.0
233459.0,6,3,337,1,123,0.0,123.0,123.0,2,214,0.0,160.0,107.0
10972435.0,6,8,544,4,272,3610245.3333333335,74.0,68.0,4,272,3610076.6666666665,74.0,68.0
75054.0,6,14,4740,7,653,11457.0,249.0,93.28571428571428,7,4087,12247.666666666666,1514.0,583.8571428571429
345.0,17,2,160,1,80,0.0,80.0,80.0,1,80,0.0,80.0,80.0
108075671.0,17,5,955,5,955,27018917.75,191.0,191.0,0,0,0.0,0.0,0.0
10765.0,17,2,586,1,81,0.0,81.0,81.0,1,505,0.0,505.0,505.0
143867.0,17,2,180,1,90,0.0,90.0,90.0,1,90,0.0,90.0,90.0
2324.0,17,4,344,2,150,0.0,75.0,75.0,2,194,0.0,103.0,97.0
43738.0,6,14,4740,7,653,7101.333333333333,249.0,93.28571428571428,7,4087,7119.666666666667,1514.0,583.8571428571429
110206845.0,6,32,2236,16,1165,7332732.933333334,139.0,72.8125,16,1071,7332733.266666667,123.0,66.9375
1181481.0,6,13,3010,8,2382,168783.0,1514.0,297.75,5,628,226431.5,331.0,125.6
5048967.0,6,8,550,4,278,1682989.0,78.0,69.5,4,272,725374.0,70.0,68.0
95195947.0,6,164,18502,82,12868,1172601.1358024692,284.0,156.9268292682927,82,5634,1172601.4938271604,140.0,68.70731707317073
2299740.0,6,25,7573,14,3735,176903.07692307694,1514.0,266.7857142857143,11,3838,205524.6,1514.0,348.90909090909093
118257115.0,17,14,864,7,432,19668034.166666668,174.0,61.71428571428572,7,432,19666831.166666668,174.0,61.71428571428572
3007107.0,6,12,2172,7,664,501011.0,252.0,94.85714285714286,5,1508,2368.5,1236.0,301.6
104360368.0,6,28,1860,14,966,8011122.538461538,123.0,69.0,14,894,8011111.461538462,123.0,63.85714285714285
44700.0,6,10,2032,5,524,10727.75,252.0,104.8,5,1508,11001.5,1236.0,301.6
113634203.0,6,694,140602,342,23164,333238.1319648094,214.0,67.73099415204679,352,117438,323116.943019943,1514.0,333.6306818181818
29273.0,6,11,2098,6,590,5550.6,252.0,98.33333333333331,5,1508,6911.25,1236.0,301.6
274254.0,6,10,1221,6,636,54850.8,298.0,106.0,4,585,80909.66666666667,379.0,146.25
146199.0,6,4,439,2,238,0.0,172.0,119.0,2,201,0.0,135.0,100.5
57537.0,6,10,2032,5,524,14142.75,252.0,104.8,5,1508,14134.5,1236.0,301.6
103522.0,17,2,286,2,286,0.0,143.0,143.0,0,0,0.0,0.0,0.0
314158.0,17,4,622,4,622,104719.33333333331,163.0,155.5,0,0,0.0,0.0,0.0
33203.0,6,14,4740,7,653,5379.0,249.0,93.28571428571428,7,4087,4884.666666666667,1514.0,583.8571428571429
1302356.0,6,4,264,2,132,0.0,66.0,66.0,2,132,0.0,66.0,66.0
340.0,17,2,174,1,79,0.0,79.0,79.0,1,95,0.0,95.0,95.0
13845273.0,17,6,2052,6,2052,2769054.6,342.0,342.0,0,0,0.0,0.0,0.0
90286401.0,6,17,1287,9,691,11279866.875,95.0,76.77777777777777,8,596,12808551.857142856,95.0,74.5
734.0,17,4,438,2,148,0.0,74.0,74.0,2,290,0.0,147.0,145.0
2300.0,17,4,344,2,150,0.0,75.0,75.0,2,194,0.0,103.0,97.0
108285.0,17,4,1400,4,1400,36095.0,350.0,350.0,0,0,0.0,0.0,0.0
2771725.0,6,2,132,1,66,0.0,66.0,66.0,1,66,0.0,66.0,66.0
207154.0,17,3,1143,3,1143,103577.0,381.0,381.0,0,0,0.0,0.0,0.0
747689.0,6,2,132,1,66,0.0,66.0,66.0,1,66,0.0,66.0,66.0
217538.0,6,3,426,2,280,0.0,214.0,140.0,1,146,0.0,146.0,146.0
226337.0,6,2,132,1,66,0.0,66.0,66.0,1,66,0.0,66.0,66.0
109851752.0,6,31,2182,16,1165,7309816.133333334,139.0,72.8125,15,1017,7831943.5,123.0,67.8
22903.0,6,10,2032,5,524,5279.0,252.0,104.8,5,1508,5155.75,1236.0,301.6
102970036.0,6,237,27710,119,8076,872627.4237288135,140.0,67.8655462184874,118,19634,871330.3247863248,336.0,166.38983050847455
153372.0,17,2,180,1,90,0.0,90.0,90.0,1,90,0.0,90.0,90.0
119240308.0,6,477,59972,239,43968,501009.6974789916,336.0,183.96652719665272,238,16004,500744.5443037975,140.0,67.24369747899159
120123199.0,6,15,2428,9,1204,15015399.875,188.0,133.77777777777777,6,1224,18018422.6,204.0,204.0
104133740.0,6,28,1876,14,982,7993684.153846154,139.0,70.14285714285714,14,894,7993683.769230769,123.0,63.85714285714285
101900518.0,6,28,1876,14,982,7821901.076923077,139.0,70.14285714285714,14,894,7821903.384615385,123.0,63.85714285714285
209690.0,6,10,1221,6,636,41938.0,298.0,106.0,4,585,68934.0,379.0,146.25
331.0,17,2,174,1,79,0.0,79.0,79.0,1,95,0.0,95.0,95.0
6028239.0,6,5,336,2,134,0.0,68.0,67.0,3,202,1472523.5,70.0,67.33333333333333
0.0,17,1,80,1,80,0.0,80.0,80.0,0,0,0.0,0.0,0.0
46667.0,6,14,4740,7,653,7510.666666666667,249.0,93.28571428571428,7,4087,7637.5,1514.0,583.8571428571429
97618554.0,17,12,778,6,389,19523710.8,174.0,64.83333333333333,6,389,19425075.4,174.0,64.83333333333333
213764.0,17,2,180,1,90,0.0,90.0,90.0,1,90,0.0,90.0,90.0
219495.0,6,3,426,2,280,0.0,214.0,140.0,1,146,0.0,146.0,146.0
36281.0,6,14,4740,7,653,5939.666666666667,249.0,93.28571428571428,7,4087,5255.666666666667,1514.0,583.8571428571429
316631.0,17,4,1400,4,1400,105543.66666666669,350.0,350.0,0,0,0.0,0.0,0.0
200097.0,17,2,180,1,90,0.0,90.0,90.0,1,90,0.0,90.0,90.0
103786508.0,6,34,2482,17,1288,6486656.75,139.0,75.76470588235294,17,1194,6473139.6875,123.0,70.23529411764706
167189.0,17,4,704,2,148,0.0,74.0,74.0,2,556,0.0,280.0,278.0
1452682.0,6,8,602,5,404,337381.75,103.0,80.8,3,198,204930.5,66.0,66.0
171707.0,17,2,180,1,90,0.0,90.0,90.0,1,90,0.0,90.0,90.0
120058481.0,17,29,13785,29,13785,4287802.892857143,501.0,475.3448275862069,0,0,0.0,0.0,0.0
2021.0,17,4,344,2,150,0.0,75.0,75.0,2,194,0.0,103.0,97.0
3034993.0,6,3,1777,1,826,0.0,826.0,826.0,2,951,0.0,885.0,475.5
5321.0,17,4,344,2,150,0.0,75.0,75.0,2,194,0.0,103.0,97.0
245742.0,17,2,180,1,90,0.0,90.0,90.0,1,90,0.0,90.0,90.0
930128.0,6,11,1131,6,600,185740.0,262.0,100.0,5,531,232322.25,259.0,106.2
2377992.0,6,25,7573,14,3735,182922.4615384616,1514.0,266.7857142857143,11,3838,211200.8,1514.0,348.90909090909093
303685.0,6,2,132,1,66,0.0,66.0,66.0,1,66,0.0,66.0,66.0
249737.0,17,5,961,3,234,124681.5,78.0,78.0,2,727,0.0,395.0,363.5
310419.0,17,4,622,4,622,103473.0,163.0,155.5,0,0,0.0,0.0,0.0
103200351.0,6,42,2772,21,1386,5160004.45,66.0,66.0,21,1386,5160005.15,66.0,66.0
120340843.0,6,553,69346,277,50834,436017.5471014493,464.0,183.5162454873646,276,18512,435159.55272727273,140.0,67.07246376811594
105142.0,17,2,700,2,700,0.0,350.0,350.0,0,0,0.0,0.0,0.0
12746.0,6,10,2032,5,524,2712.75,252.0,104.8,5,1508,2890.25,1236.0,301.6
5633829.0,6,5,336,2,134,0.0,68.0,67.0,3,202,1428938.0,70.0,67.33333333333333
205861.0,6,3,426,2,280,0.0,214.0,140.0,1,146,0.0,146.0,146.0
2635546.0,6,3,1777,2,951,0.0,885.0,475.5,1,826,0.0,826.0,826.0
301847.0,6,6,412,4,272,100615.66666666669,74.0,68.0,2,140,0.0,74.0,70.0
120227550.0,17,12,647,7,432,20037925.0,174.0,61.71428571428572,5,215,20000894.0,43.0,43.0
18666.0,6,10,1066,5,490,3879.0,218.0,98.0,5,576,3611.75,304.0,115.2
210248.0,17,2,180,1,90,0.0,90.0,90.0,1,90,0.0,90.0,90.0
23842.0,6,14,4740,7,653,3452.5,249.0,93.28571428571428,7,4087,3835.3333333333335,1514.0,583.8571428571429
21046544.0,6,26,7627,14,3735,195849.7692307692,1514.0,266.7857142857143,12,3892,1894720.818181818,1514.0,324.3333333333333
251596.0,17,4,6056,4,6056,83865.33333333334,1514.0,1514.0,0,0,0.0,0.0,0.0
48132.0,6,14,4740,7,653,7893.5,249.0,93.28571428571428,7,4087,7889.666666666667,1514.0,583.8571428571429
19981.0,6,10,2032,5,524,4349.0,252.0,104.8,5,1508,4328.5,1236.0,301.6
120311179.0,6,243,27852,122,19644,994307.26446281,300.0,161.01639344262296,121,8208,993949.6583333332,140.0,67.83471074380165
101294.0,17,4,1400,4,1400,33764.666666666664,350.0,350.0,0,0,0.0,0.0,0.0
301844.0,6,6,412,4,272,100614.66666666669,74.0,68.0,2,140,0.0,74.0,70.0
358875.0,6,4,508,2,238,0.0,172.0,119.0,2,270,0.0,135.0,135.0
96527.0,17,2,762,2,762,0.0,381.0,381.0,0,0,0.0,0.0,0.0
3174006.0,6,18,1495,9,921,358331.375,315.0,102.33333333333331,9,574,358303.625,78.0,63.77777777777778
218040.0,6,3,426,2,280,0.0,214.0,140.0,1,146,0.0,146.0,146.0
119685569.0,6,258,29716,129,20906,933362.4296875,284.0,162.06201550387595,129,8810,933362.78125,140.0,68.29457364341086
1734.0,17,2,762,2,762,0.0,381.0,381.0,0,0,0.0,0.0,0.0
235124.0,6,3,337,2,214,0.0,160.0,107.0,1,123,0.0,123.0,123.0
108097150.0,17,5,1005,5,1005,27024287.5,201.0,201.0,0,0,0.0,0.0,0.0
130231.0,17,4,1400,4,1400,43410.333333333336,350.0,350.0,0,0,0.0,0.0,0.0
104377.0,17,2,286,2,286,0.0,143.0,143.0,0,0,0.0,0.0,0.0
2448.0,17,4,344,2,150,0.0,75.0,75.0,2,194,0.0,103.0,97.0
325.0,17,2,166,1,75,0.0,75.0,75.0,1,91,0.0,91.0,91.0
81539.0,6,14,4740,7,653,12705.5,249.0,93.28571428571428,7,4087,13388.833333333334,1514.0,583.8571428571429
220656.0,17,2,180,1,90,0.0,90.0,90.0,1,90,0.0,90.0,90.0
146299.0,6,3,337,2,214,0.0,160.0,107.0,1,123,0.0,123.0,123.0
316056.0,17,4,1400,4,1400,105352.0,350.0,350.0,0,0,0.0,0.0,0.0
205883.0,17,2,180,1,90,0.0,90.0,90.0,1,90,0.0,90.0,90.0
103551.0,17,2,286,2,286,0.0,143.0,143.0,0,0,0.0,0.0,0.0
35034.0,6,14,4740,7,653,5441.166666666667,249.0,93.28571428571428,7,4087,5664.0,1514.0,583.8571428571429
11558.0,17,2,582,1,83,0.0,83.0,83.0,1,499,0.0,499.0,499.0
90018862.0,17,27,12943,27,12943,3462263.923076923,501.0,479.3703703703704,0,0,0.0,0.0,0.0
82332.0,6,10,2032,5,524,18878.0,252.0,104.8,5,1508,20293.75,1236.0,301.6
221381.0,6,10,1221,6,636,44276.2,298.0,106.0,4,585,72927.33333333333,379.0,146.25
894631.0,6,10,1333,6,796,178926.2,458.0,132.66666666666666,4,537,206507.0,331.0,134.25
288739.0,17,2,363,1,79,0.0,79.0,79.0,1,284,0.0,284.0,284.0
113949322.0,6,48,3168,24,1584,4954318.347826087,66.0,66.0,24,1584,4944918.869565218,66.0,66.0
399.0,17,2,204,1,88,0.0,88.0,88.0,1,116,0.0,116.0,116.0
103523.0,17,2,286,2,286,0.0,143.0,143.0,0,0,0.0,0.0,0.0
453.0,17,2,508,2,508,0.0,257.0,254.0,0,0,0.0,0.0,0.0
303120.0,6,2,132,1,66,0.0,66.0,66.0,1,66,0.0,66.0,66.0
68603.0,17,4,1400,4,1400,22867.666666666668,350.0,350.0,0,0,0.0,0.0,0.0
10907144.0,6,8,544,4,272,3588448.0,74.0,68.0,4,272,3588376.6666666665,74.0,68.0
108105919.0,17,5,1005,5,1005,27026479.75,201.0,201.0,0,0,0.0,0.0,0.0
300789.0,6,6,412,4,272,100263.0,74.0,68.0,2,140,0.0,74.0,70.0
302347.0,6,6,412,4,272,100782.33333333331,74.0,68.0,2,140,0.0,74.0,70.0
90012775.0,6,20,1490,10,745,10001419.444444444,95.0,74.5,10,745,9975447.888888888,95.0,74.5
308584.0,6,6,412,4,272,102861.33333333331,74.0,68.0,2,140,0.0,74.0,70.0
853.0,17,4,438,2,148,0.0,74.0,74.0,2,290,0.0,147.0,145.0
106888097.0,6,196,22220,98,6690,1097088.4432989692,140.0,68.26530612244898,98,15530,1093453.412371134,284.0,158.46938775510205
75227.0,6,14,4740,7,653,12412.833333333334,249.0,93.28571428571428,7,4087,12358.0,1514.0,583.8571428571429
2313.0,17,4,344,2,150,0.0,75.0,75.0,2,194,0.0,103.0,97.0
233182.0,6,3,337,2,214,0.0,160.0,107.0,1,123,0.0,123.0,123.0
221599.0,6,3,426,2,280,0.0,214.0,140.0,1,146,0.0,146.0,146.0
103364058.0,6,31,2166,16,1149,6876546.466666667,123.0,71.8125,15,1017,7367728.214285715,123.0,67.8
2386.0,17,4,344,2,150,0.0,75.0,75.0,2,194,0.0,103.0,97.0
43548.0,6,14,4740,7,653,7136.166666666667,249.0,93.28571428571428,7,4087,7080.5,1514.0,583.8571428571429
38289.0,6,10,2032,5,524,8327.75,252.0,104.8,5,1508,9390.75,1236.0,301.6
30315.0,6,14,4740,7,653,4549.0,249.0,93.28571428571428,7,4087,3791.5,1514.0,583.8571428571429
2083588.0,6,19,6869,11,1567,208358.8,408.0,142.45454545454547,8,5302,234786.57142857145,1514.0,662.75
205889.0,17,2,180,1,90,0.0,90.0,90.0,1,90,0.0,90.0,90.0
29322.0,6,14,4740,7,653,4452.0,249.0,93.28571428571428,7,4087,4611.666666666667,1514.0,583.8571428571429
207846.0,6,3,426,2,280,0.0,214.0,140.0,1,146,0.0,146.0,146.0
60107.0,6,14,4740,7,653,9696.666666666666,249.0,93.28571428571428,7,4087,9102.333333333334,1514.0,583.8571428571429
228362.0,17,2,180,1,90,0.0,90.0,90.0,1,90,0.0,90.0,90.0
91799916.0,6,165,18696,83,13062,1119511.1707317072,284.0,157.3734939759036,82,5634,1107888.3580246917,140.0,68.70731707317073
90293389.0,6,16,1192,8,596,12892637.142857144,95.0,74.5,8,596,12897144.142857144,95.0,74.5
209530.0,17,2,180,1,90,0.0,90.0,90.0,1,90,0.0,90.0,90.0
1573546.0,6,2,132,1,66,0.0,66.0,66.0,1,66,0.0,66.0,66.0
117667227.0,6,35,2542,18,1348,6909576.529411765,139.0,74.88888888888889,17,1194,7341422.3125,123.0,70.23529411764706
510336.0,6,5,336,2,134,0.0,68.0,67.0,3,202,195511.5,70.0,67.33333333333333
27430877.0,17,5,1718,4,1368,810060.0,342.0,342.0,1,350,0.0,350.0,350.0
3183108.0,6,3,204,2,136,0.0,70.0,68.0,1,68,0.0,68.0,68.0
101624177.0,17,14,864,7,432,16834514.166666668,174.0,61.71428571428572,7,432,16833528.0,174.0,61.71428571428572
307916.0,6,6,412,4,272,102638.66666666669,74.0,68.0,2,140,0.0,74.0,70.0
307114.0,17,4,1400,4,1400,102371.33333333331,350.0,350.0,0,0,0.0,0.0,0.0
90045697.0,17,28,13364,28,13364,3335025.814814815,501.0,477.2857142857143,0,0,0.0,0.0,0.0
101902.0,6,11,2098,6,590,20189.0,252.0,98.33333333333331,5,1508,24636.25,1236.0,301.6
110250302.0,6,207,23396,104,7086,1070391.281553398,140.0,68.13461538461539,103,16310,1070511.1274509805,284.0,158.3495145631068
115890378.0,6,48,3168,24,1584,5038712.0869565215,66.0,66.0,24,1584,5026734.130434782,66.0,66.0
2114753.0,6,19,6869,11,1567,211475.3,408.0,142.45454545454547,8,5302,240075.4285714285,1514.0,662.75
217818.0,6,3,426,2,280,0.0,214.0,140.0,1,146,0.0,146.0,146.0
2389.0,17,4,344,2,150,0.0,75.0,75.0,2,194,0.0,103.0,97.0
0.0,6,1,172,1,172,0.0,172.0,172.0,0,0,0.0,0.0,0.0
122687994.0,6,49,3234,25,1650,5111999.75,66.0,66.0,24,1584,4934000.0,66.0,66.0
501305.0,6,4,270,2,134,0.0,68.0,67.0,2,136,0.0,70.0,68.0
755862.0,6,2,132,1,66,0.0,66.0,66.0,1,66,0.0,66.0,66.0
194264.0,17,2,180,1,90,0.0,90.0,90.0,1,90,0.0,90.0,90.0
21505.0,6,13,1479,7,882,3584.1666666666665,291.0,126.0,6,597,3939.0,259.0,99.5
123250551.0,6,49,3234,25,1650,5135439.625,66.0,66.0,24,1584,5056079.608695652,66.0,66.0
364.0,17,2,160,1,80,0.0,80.0,80.0,1,80,0.0,80.0,80.0
24248.0,6,14,4740,7,653,3794.5,249.0,93.28571428571428,7,4087,3849.8333333333335,1514.0,583.8571428571429
412499.0,17,2,363,1,75,0.0,75.0,75.0,1,288,0.0,288.0,288.0
95582897.0,17,12,778,6,389,19001612.8,174.0,64.83333333333333,6,389,19000156.6,174.0,64.83333333333333
314714.0,17,4,1400,4,1400,104904.66666666669,350.0,350.0,0,0,0.0,0.0,0.0
238377.0,6,3,373,2,238,0.0,172.0,119.0,1,135,0.0,135.0,135.0
87768.0,6,14,4740,7,653,12690.833333333334,249.0,93.28571428571428,7,4087,13675.5,1514.0,583.8571428571429
48659.0,6,14,4740,7,653,7864.166666666667,249.0,93.28571428571428,7,4087,7777.5,1514.0,583.8571428571429
128929694.0,6,36,2602,19,1408,7162760.777777778,139.0,74.10526315789474,17,1194,7420497.6875,123.0,70.23529411764706
5619826.0,6,5,336,2,134,0.0,68.0,67.0,3,202,1521538.0,70.0,67.33333333333333
474807.0,6,10,967,5,390,82714.0,162.0,78.0,5,577,82644.25,349.0,115.4
25601607.0,17,5,1718,4,1368,881995.6666666666,342.0,342.0,1,350,0.0,350.0,350.0
216156.0,6,3,426,2,280,0.0,214.0,140.0,1,146,0.0,146.0,146.0
624.0,17,2,762,2,762,0.0,381.0,381.0,0,0,0.0,0.0,0.0
245820.0,6,3,337,2,214,0.0,160.0,107.0,1,123,0.0,123.0,123.0
197066.0,17,2,180,1,90,0.0,90.0,90.0,1,90,0.0,90.0,90.0
37916.0,6,14,4740,7,653,5913.833333333333,249.0,93.28571428571428,7,4087,6129.5,1514.0,583.8571428571429
0.0,17,1,350,1,350,0.0,350.0,350.0,0,0,0.0,0.0,0.0
16317885.0,17,6,2052,6,2052,3263577.0,342.0,342.0,0,0,0.0,0.0,0.0
153417.0,17,2,180,1,90,0.0,90.0,90.0,1,90,0.0,90.0,90.0
362.0,17,2,160,1,80,0.0,80.0,80.0,1,80,0.0,80.0,80.0
90215950.0,6,19,1436,9,691,11245709.625,95.0,76.77777777777777,10,745,10000065.555555556,95.0,74.5
103135418.0,6,28,1876,14,982,7916891.384615385,139.0,70.14285714285714,14,894,7916887.769230769,123.0,63.85714285714285
120127149.0,6,13,2036,8,1016,17137128.85714286,188.0,127.0,5,1020,22524418.75,204.0,204.0
56090.0,6,10,2032,5,524,13454.25,252.0,104.8,5,1508,12808.25,1236.0,301.6
13395.0,6,13,1459,7,862,2232.5,271.0,123.14285714285714,6,597,2241.0,259.0,99.5
153469.0,17,2,180,1,90,0.0,90.0,90.0,1,90,0.0,90.0,90.0
2310.0,17,4,344,2,150,0.0,75.0,75.0,2,194,0.0,103.0,97.0
208368.0,17,4,6056,4,6056,69456.0,1514.0,1514.0,0,0,0.0,0.0,0.0
10492324.0,6,7,478,4,272,3450206.333333333,74.0,68.0,3,206,5175189.0,74.0,68.66666666666667
303625.0,6,6,412,4,272,101208.33333333331,74.0,68.0,2,140,0.0,74.0,70.0
30881.0,6,14,4740,7,653,4581.5,249.0,93.28571428571428,7,4087,4950.833333333333,1514.0,583.8571428571429
44399.0,6,14,4740,7,653,6874.0,249.0,93.28571428571428,7,4087,7242.833333333333,1514.0,583.8571428571429
0.0,17,1,55,1,55,0.0,55.0,55.0,0,0,0.0,0.0,0.0
54488.0,6,10,2032,5,524,12770.25,252.0,104.8,5,1508,12734.75,1236.0,301.6
27646.0,6,14,4740,7,653,4120.166666666667,249.0,93.28571428571428,7,4087,3546.833333333333,1514.0,583.8571428571429
406.0,17,2,410,1,78,0.0,78.0,78.0,1,332,0.0,332.0,332.0
90255658.0,6,13,2036,8,1016,12893665.42857143,188.0,127.0,5,1020,22522878.0,204.0,204.0
373192.0,6,3,204,2,136,0.0,70.0,68.0,1,68,0.0,68.0,68.0
233186.0,6,3,337,2,214,0.0,160.0,107.0,1,123,0.0,123.0,123.0
329935.0,6,6,412,4,272,109978.33333333331,74.0,68.0,2,140,0.0,74.0,70.0
26106681.0,17,4,1376,3,1026,1129506.0,342.0,342.0,1,350,0.0,350.0,350.0
120007.0,17,2,180,1,70,0.0,70.0,70.0,1,110,0.0,110.0,110.0
90093390.0,6,11,1644,4,816,30030377.666666668,204.0,204.0,7,828,15015176.833333334,188.0,118.28571428571428
479684.0,6,2,145,2,145,0.0,91.0,72.5,0,0,0.0,0.0,0.0
96122425.0,17,12,778,6,389,19001662.4,174.0,64.83333333333333,6,389,19000172.6,174.0,64.83333333333333
29435.0,6,10,2032,5,524,7053.0,252.0,104.8,5,1508,6763.75,1236.0,301.6
34146.0,6,14,4740,7,653,4508.833333333333,249.0,93.28571428571428,7,4087,5553.833333333333,1514.0,583.8571428571429
41743.0,6,10,2032,5,524,9559.75,252.0,104.8,5,1508,10056.0,1236.0,301.6
90258142.0,6,12,1832,8,1016,12894020.285714284,188.0,127.0,4,816,30022251.0,204.0,204.0
1311803.0,17,7,490,7,490,218633.8333333333,70.0,70.0,0,0,0.0,0.0,0.0
116438270.0,6,211,23824,106,7292,1108852.5904761904,140.0,68.79245283018868,105,16532,1102775.9134615385,284.0,157.44761904761904
14418.0,6,10,1949,5,441,3313.25,169.0,88.2,5,1508,3350.5,1236.0,301.6
32780.0,6,14,4740,7,653,5289.0,249.0,93.28571428571428,7,4087,4521.166666666667,1514.0,583.8571428571429
108109628.0,17,5,1005,5,1005,27027407.0,201.0,201.0,0,0,0.0,0.0,0.0
122975334.0,6,48,3168,24,1584,5109736.0,66.0,66.0,24,1584,5157350.782608695,66.0,66.0
44338868.0,6,5,336,2,134,0.0,68.0,67.0,3,202,20979524.5,70.0,67.33333333333333
15479.0,6,20,7606,11,978,1547.9,310.0,88.9090909090909,9,6628,1660.0,1514.0,736.4444444444445
113309757.0,6,45,2970,23,1518,5150443.5,66.0,66.0,22,1452,5208906.857142857,66.0,66.0
90101749.0,6,13,1914,6,1086,18020119.4,204.0,181.0,7,828,15016364.5,188.0,118.28571428571428
90022219.0,17,28,13364,28,13364,3334156.25925926,501.0,477.2857142857143,0,0,0.0,0.0,0.0
1302836.0,6,4,264,2,132,0.0,66.0,66.0,2,132,0.0,66.0,66.0
45670.0,6,14,4740,7,653,7464.166666666667,249.0,93.28571428571428,7,4087,7467.5,1514.0,583.8571428571429
310498.0,6,6,412,4,272,103499.33333333331,74.0,68.0,2,140,0.0,74.0,70.0
135135794.0,17,6,1146,6,1146,27027158.8,191.0,191.0,0,0,0.0,0.0,0.0
116028860.0,6,48,3168,24,1584,5044733.043478261,66.0,66.0,24,1584,5032756.826086956,66.0,66.0
202776.0,17,4,6056,4,6056,67592.0,1514.0,1514.0,0,0,0.0,0.0,0.0
313833.0,6,6,412,4,272,104611.0,74.0,68.0,2,140,0.0,74.0,70.0
120092182.0,17,28,13364,28,13364,4447858.592592592,501.0,477.2857142857143,0,0,0.0,0.0,0.0
135132602.0,17,6,1206,6,1206,27026520.4,201.0,201.0,0,0,0.0,0.0,0.0
262227.0,6,10,1221,6,636,52445.4,298.0,106.0,4,585,81980.0,379.0,146.25
315849.0,6,6,412,4,272,105283.0,74.0,68.0,2,140,0.0,74.0,70.0
135132474.0,17,6,1206,6,1206,27026494.8,201.0,201.0,0,0,0.0,0.0,0.0
241718.0,6,3,337,2,214,0.0,160.0,107.0,1,123,0.0,123.0,123.0
1699685.0,6,23,6509,12,1529,154516.81818181818,357.0,127.41666666666669,11,4980,139154.8,1510.0,452.7272727272728
2416.0,17,4,344,2,150,0.0,75.0,75.0,2,194,0.0,103.0,97.0
113240304.0,6,30,1990,15,1042,8073948.857142857,139.0,69.46666666666667,15,948,8073948.357142857,123.0,63.2
302030.0,6,6,412,4,272,100676.66666666669,74.0,68.0,2,140,0.0,74.0,70.0
30488.0,6,14,4740,7,653,4908.666666666667,249.0,93.28571428571428,7,4087,4943.666666666667,1514.0,583.8571428571429
224863.0,6,13,1386,7,789,37477.16666666666,253.0,112.71428571428572,6,597,42149.6,259.0,99.5
90534045.0,6,15,2444,8,1016,12933435.0,188.0,127.0,7,1428,15061582.5,204.0,204.0
130161.0,6,3,337,2,214,0.0,160.0,107.0,1,123,0.0,123.0,123.0
90256703.0,6,14,2240,8,1016,12893814.714285716,188.0,127.0,6,1224,18017782.2,204.0,204.0
108109951.0,17,5,955,5,955,27027487.75,191.0,191.0,0,0,0.0,0.0,0.0
108933.0,17,2,286,2,286,0.0,143.0,143.0,0,0,0.0,0.0,0.0
22106.0,6,10,2032,5,524,4857.5,252.0,104.8,5,1508,5245.5,1236.0,301.6
120174636.0,6,474,60778,237,15950,505743.2584745763,140.0,67.29957805907173,237,44828,505733.936440678,480.0,189.1476793248945
120079396.0,6,246,27818,123,8414,970010.1721311476,140.0,68.40650406504065,123,19404,977646.6147540984,300.0,157.7560975609756
48405.0,6,14,4740,7,653,7905.333333333333,249.0,93.28571428571428,7,4087,7535.333333333333,1514.0,583.8571428571429
108107314.0,17,5,955,5,955,27026828.5,191.0,191.0,0,0,0.0,0.0,0.0
94468.0,6,14,4740,7,653,14999.5,249.0,93.28571428571428,7,4087,14608.0,1514.0,583.8571428571429
90017990.0,17,28,13364,28,13364,3333999.6296296297,501.0,477.2857142857143,0,0,0.0,0.0,0.0
2485.0,17,4,344,2,150,0.0,75.0,75.0,2,194,0.0,103.0,97.0
228451.0,17,2,180,1,90,0.0,90.0,90.0,1,90,0.0,90.0,90.0
51131.0,6,14,4740,7,653,8313.166666666666,249.0,93.28571428571428,7,4087,7430.166666666667,1514.0,583.8571428571429
817.0,17,4,438,2,148,0.0,74.0,74.0,2,290,0.0,147.0,145.0
196933.0,17,2,180,1,90,0.0,90.0,90.0,1,90,0.0,90.0,90.0
708422.0,6,6,758,3,410,318409.0,172.0,136.66666666666666,3,348,238966.5,135.0,116.0
10480657.0,6,7,478,4,272,3447946.333333333,74.0,68.0,3,206,5171831.5,74.0,68.66666666666667
201928.0,17,2,180,1,90,0.0,90.0,90.0,1,90,0.0,90.0,90.0
100900529.0,6,197,22158,99,6756,1029597.2346938776,140.0,68.24242424242425,98,15402,1029492.0206185566,284.0,157.16326530612244
108101646.0,17,5,1005,5,1005,27025411.5,201.0,201.0,0,0,0.0,0.0,0.0
153465.0,17,2,180,1,90,0.0,90.0,90.0,1,90,0.0,90.0,90.0
1300976.0,6,4,264,2,132,0.0,66.0,66.0,2,132,0.0,66.0,66.0
299.0,17,2,174,1,79,0.0,79.0,79.0,1,95,0.0,95.0,95.0
90021768.0,17,28,13364,28,13364,3334139.5555555555,501.0,477.2857142857143,0,0,0.0,0.0,0.0
298162.0,6,12,1373,7,714,49693.66666666666,298.0,102.0,5,659,70038.0,379.0,131.8
46336.0,6,14,4740,7,653,6196.666666666667,249.0,93.28571428571428,7,4087,7004.0,1514.0,583.8571428571429
107391.0,17,2,286,2,286,0.0,143.0,143.0,0,0,0.0,0.0,0.0
311599.0,17,4,1400,4,1400,103866.33333333331,350.0,350.0,0,0,0.0,0.0,0.0
234147.0,6,3,337,2,214,0.0,160.0,107.0,1,123,0.0,123.0,123.0
16825.0,6,11,1132,6,556,2904.0,218.0,92.66666666666669,5,576,3347.75,304.0,115.2
299.0,17,2,168,1,76,0.0,76.0,76.0,1,92,0.0,92.0,92.0
315836.0,17,4,1400,4,1400,105278.66666666669,350.0,350.0,0,0,0.0,0.0,0.0
90290975.0,6,19,1436,10,745,10027534.666666666,95.0,74.5,9,691,11285943.0,95.0,76.77777777777777
90258000.0,6,14,2240,8,1016,12894000.0,188.0,127.0,6,1224,18018671.6,204.0,204.0
109858.0,17,2,286,2,286,0.0,143.0,143.0,0,0,0.0,0.0,0.0
9191.0,6,10,2032,5,524,2136.75,252.0,104.8,5,1508,1707.0,1236.0,301.6
65494.0,6,14,4740,7,653,9269.166666666666,249.0,93.28571428571428,7,4087,9137.0,1514.0,583.8571428571429
143899.0,17,2,180,1,90,0.0,90.0,90.0,1,90,0.0,90.0,90.0
160079.0,17,2,180,1,90,0.0,90.0,90.0,1,90,0.0,90.0,90.0
123610550.0,6,49,3234,25,1650,5150439.583333333,66.0,66.0,24,1584,5187905.782608695,66.0,66.0
47233.0,6,14,4740,7,653,7745.166666666667,249.0,93.28571428571428,7,4087,7262.833333333333,1514.0,583.8571428571429
233383.0,6,3,337,2,214,0.0,160.0,107.0,1,123,0.0,123.0,123.0
309592.0,17,4,1400,4,1400,103197.33333333331,350.0,350.0,0,0,0.0,0.0,0.0
90269488.0,6,12,1832,8,1016,12895641.142857144,188.0,127.0,4,816,30032649.666666668,204.0,204.0
120009044.0,17,29,13785,29,13785,4286037.285714285,501.0,475.3448275862069,0,0,0.0,0.0,0.0
51586.0,6,14,4740,7,653,8440.166666666666,249.0,93.28571428571428,7,4087,8442.166666666666,1514.0,583.8571428571429
120775387.0,17,14,1126,7,563,16833596.5,174.0,80.42857142857143,7,563,16833482.833333332,174.0,80.42857142857143
120048396.0,17,28,13364,28,13364,4446236.888888889,501.0,477.2857142857143,0,0,0.0,0.0,0.0
7099.0,17,2,582,1,83,0.0,83.0,83.0,1,499,0.0,499.0,499.0
39153.0,6,10,2032,5,524,8966.25,252.0,104.8,5,1508,8479.5,1236.0,301.6
2982513.0,6,3,1602,2,850,0.0,784.0,425.0,1,752,0.0,752.0,752.0
2795334.0,6,2,132,1,66,0.0,66.0,66.0,1,66,0.0,66.0,66.0
18348.0,6,2,145,2,145,0.0,91.0,72.5,0,0,0.0,0.0,0.0
258998.0,6,10,1221,6,636,51799.6,298.0,106.0,4,585,80890.66666666667,379.0,146.25
10471980.0,6,7,478,4,272,3445060.6666666665,74.0,68.0,3,206,5167492.0,74.0,68.66666666666667
43320.0,6,14,4740,7,653,7101.666666666667,249.0,93.28571428571428,7,4087,6527.0,1514.0,583.8571428571429
108109828.0,17,5,955,5,955,27027457.0,191.0,191.0,0,0,0.0,0.0,0.0
2518789.0,6,3,204,2,136,0.0,70.0,68.0,1,68,0.0,68.0,68.0
90037555.0,17,28,13364,28,13364,3334724.25925926,501.0,477.2857142857143,0,0,0.0,0.0,0.0
102683.0,17,2,286,2,286,0.0,143.0,143.0,0,0,0.0,0.0,0.0
108102539.0,17,5,1005,5,1005,27025634.75,201.0,201.0,0,0,0.0,0.0,0.0
2378.0,17,4,344,2,150,0.0,75.0,75.0,2,194,0.0,103.0,97.0
237450.0,6,10,1221,6,636,47490.0,298.0,106.0,4,585,78043.33333333333,379.0,146.25
36978.0,6,12,1413,7,882,6163.0,291.0,126.0,5,531,8061.0,259.0,106.2
323866.0,17,4,1400,4,1400,107955.33333333331,350.0,350.0,0,0,0.0,0.0,0.0
50987.0,17,2,180,1,90,0.0,90.0,90.0,1,90,0.0,90.0,90.0
93189.0,6,14,4740,7,653,15157.666666666666,249.0,93.28571428571428,7,4087,15340.166666666666,1514.0,583.8571428571429
50740.0,6,10,2032,5,524,12208.5,252.0,104.8,5,1508,12510.75,1236.0,301.6
2796897.0,6,2,132,1,66,0.0,66.0,66.0,1,66,0.0,66.0,66.0
316449.0,17,4,1400,4,1400,105483.0,350.0,350.0,0,0,0.0,0.0,0.0
34335.0,6,10,2032,5,524,8371.5,252.0,104.8,5,1508,7339.25,1236.0,301.6
4540.0,17,2,180,1,90,0.0,90.0,90.0,1,90,0.0,90.0,90.0
102249536.0,6,29,2068,15,1105,7288114.285714285,139.0,73.66666666666667,14,963,7848749.153846154,123.0,68.78571428571429
91410362.0,6,26,1878,13,909,7617530.166666667,123.0,69.92307692307692,13,969,6767469.416666667,123.0,74.53846153846153
153392.0,6,3,337,2,214,0.0,160.0,107.0,1,123,0.0,123.0,123.0
53202.0,6,14,4740,7,653,8741.0,249.0,93.28571428571428,7,4087,8349.0,1514.0,583.8571428571429
112552821.0,6,31,2182,16,1165,7489112.466666667,139.0,72.8125,15,1017,8024081.928571428,123.0,67.8
198598.0,17,2,180,1,90,0.0,90.0,90.0,1,90,0.0,90.0,90.0
15155.0,17,2,180,1,90,0.0,90.0,90.0,1,90,0.0,90.0,90.0
21615.0,6,14,4740,7,653,2349.1666666666665,249.0,93.28571428571428,7,4087,3467.0,1514.0,583.8571428571429
232924.0,17,2,180,1,90,0.0,90.0,90.0,1,90,0.0,90.0,90.0
43664.0,6,14,4740,7,653,6824.0,249.0,93.28571428571428,7,4087,6445.333333333333,1514.0,583.8571428571429
118667709.0,6,33,2274,17,1125,7416731.8125,123.0,66.17647058823529,16,1149,7384434.0,123.0,71.8125
42816.0,6,14,4740,7,653,7012.333333333333,249.0,93.28571428571428,7,4087,6596.5,1514.0,583.8571428571429
108266737.0,6,32,2236,16,1165,7203368.2,139.0,72.8125,16,1071,7203381.133333334,123.0,66.9375
104366636.0,6,44,2904,22,1452,4969839.80952381,66.0,66.0,22,1452,4954130.238095238,66.0,66.0
17098692.0,17,10,3500,10,3500,1899854.6666666667,350.0,350.0,0,0,0.0,0.0,0.0
135134151.0,17,6,1206,6,1206,27026830.2,201.0,201.0,0,0,0.0,0.0,0.0
10157.0,17,2,582,1,83,0.0,83.0,83.0,1,499,0.0,499.0,499.0
33532.0,6,11,2098,6,590,5709.0,252.0,98.33333333333331,5,1508,7529.75,1236.0,301.6
35372.0,6,10,2032,5,524,8320.25,252.0,104.8,5,1508,8588.5,1236.0,301.6
33703.0,6,14,4740,7,653,5382.5,249.0,93.28571428571428,7,4087,5313.333333333333,1514.0,583.8571428571429
1297887.0,6,4,264,2,132,0.0,66.0,66.0,2,132,0.0,66.0,66.0
205600.0,6,10,1221,6,636,41120.0,298.0,106.0,4,585,67167.33333333333,379.0,146.25
210308.0,6,3,426,2,280,0.0,214.0,140.0,1,146,0.0,146.0,146.0
120399038.0,6,221,25024,111,17468,1094536.709090909,284.0,157.36936936936937,110,7556,1095183.6605504588,140.0,68.69090909090909
101971.0,17,2,762,2,762,0.0,381.0,381.0,0,0,0.0,0.0,0.0
153529.0,17,2,180,1,90,0.0,90.0,90.0,1,90,0.0,90.0,90.0
128932202.0,6,35,2410,18,1285,7584247.176470588,139.0,71.38888888888889,17,1125,7420658.3125,123.0,66.17647058823529
5620015.0,6,5,336,2,134,0.0,68.0,67.0,3,202,1420309.5,70.0,67.33333333333333
233130.0,6,3,337,2,214,0.0,160.0,107.0,1,123,0.0,123.0,123.0
303663.0,6,6,412,4,272,101221.0,74.0,68.0,2,140,0.0,74.0,70.0
1302595.0,6,4,264,2,132,0.0,66.0,66.0,2,132,0.0,66.0,66.0
2139922.0,6,18,6803,10,1501,237769.11111111112,408.0,150.1,8,5302,242588.4285714285,1514.0,662.75
30524.0,6,14,4740,7,653,3388.1666666666665,249.0,93.28571428571428,7,4087,4907.0,1514.0,583.8571428571429
410.0,17,2,410,1,78,0.0,78.0,78.0,1,332,0.0,332.0,332.0
154338.0,17,2,180,1,90,0.0,90.0,90.0,1,90,0.0,90.0,90.0
24238.0,6,14,4740,7,653,3539.5,249.0,93.28571428571428,7,4087,3608.8333333333335,1514.0,583.8571428571429
4553.0,17,2,618,1,72,0.0,72.0,72.0,1,546,0.0,546.0,546.0
135142441.0,17,6,1206,6,1206,27028488.2,201.0,201.0,0,0,0.0,0.0,0.0
50501.0,6,12,1413,7,882,8416.833333333334,291.0,126.0,5,531,8548.25,259.0,106.2
135063.0,6,2,132,1,66,0.0,66.0,66.0,1,66,0.0,66.0,66.0
155766.0,6,3,337,2,214,0.0,160.0,107.0,1,123,0.0,123.0,123.0
146223.0,6,3,337,2,214,0.0,160.0,107.0,1,123,0.0,123.0,123.0
10714.0,6,11,2098,6,590,2024.4,252.0,98.33333333333331,5,1508,2444.25,1236.0,301.6
2017.0,17,4,344,2,150,0.0,75.0,75.0,2,194,0.0,103.0,97.0
847319.0,6,9,1196,6,725,169463.8,387.0,120.83333333333331,3,471,287429.5,331.0,157.0
64100.00000000001,6,10,1065,5,534,15569.0,262.0,106.8,5,531,15030.75,259.0,106.2
2978.0,17,2,224,1,76,0.0,76.0,76.0,1,148,0.0,148.0,148.0
105823055.0,6,29,2068,15,1105,7543360.714285715,139.0,73.66666666666667,14,963,8123618.461538462,123.0,68.78571428571429
91980573.0,6,193,21730,97,6624,958130.96875,140.0,68.28865979381443,96,15106,957308.5157894735,284.0,157.35416666666666
120294891.0,17,14,864,7,432,16833501.833333332,174.0,61.71428571428572,7,432,16834197.666666668,174.0,61.71428571428572
513909.0,17,4,820,2,156,0.0,78.0,78.0,2,664,0.0,332.0,332.0
2319.0,17,4,344,2,150,0.0,75.0,75.0,2,194,0.0,103.0,97.0
324.0,17,2,174,1,79,0.0,79.0,79.0,1,95,0.0,95.0,95.0
90095339.0,6,10,1440,7,828,15015889.833333334,188.0,118.28571428571428,3,612,30031546.0,204.0,204.0
75954.0,6,14,4740,7,653,12533.0,249.0,93.28571428571428,7,4087,11789.333333333334,1514.0,583.8571428571429
303625.0,6,2,132,1,66,0.0,66.0,66.0,1,66,0.0,66.0,66.0
90253813.0,6,12,1832,8,1016,12893401.857142856,188.0,127.0,4,816,30030595.666666668,204.0,204.0
1028453.0,6,11,1134,6,558,205690.60000000003,220.0,93.0,5,576,255010.25,304.0,115.2
1379625.0,6,4,276,2,128,0.0,74.0,64.0,2,148,0.0,74.0,74.0
135134491.0,17,6,1206,6,1206,27026898.2,201.0,201.0,0,0,0.0,0.0,0.0
2020.0,17,4,344,2,150,0.0,75.0,75.0,2,194,0.0,103.0,97.0
108106578.0,17,5,1005,5,1005,27026644.5,201.0,201.0,0,0,0.0,0.0,0.0
2594604.0,6,2,132,1,66,0.0,66.0,66.0,1,66,0.0,66.0,66.0
205737.0,17,2,180,1,90,0.0,90.0,90.0,1,90,0.0,90.0,90.0
153378.0,17,4,6056,4,6056,51126.0,1514.0,1514.0,0,0,0.0,0.0,0.0
120125383.0,6,14,2224,9,1204,15015672.875,188.0,133.77777777777777,5,1020,22527193.5,204.0,204.0
867972.0,6,10,1336,6,799,173594.4,461.0,133.16666666666666,4,537,198480.3333333333,331.0,134.25
42358.0,6,14,4740,7,653,6845.333333333333,249.0,93.28571428571428,7,4087,6425.166666666667,1514.0,583.8571428571429
2591078.0,6,2,132,1,66,0.0,66.0,66.0,1,66,0.0,66.0,66.0
48491.0,6,14,4740,7,653,7955.5,249.0,93.28571428571428,7,4087,7854.0,1514.0,583.8571428571429
829.0,17,4,438,2,148,0.0,74.0,74.0,2,290,0.0,147.0,145.0
850366.0,6,9,1096,6,625,170073.2,287.0,104.16666666666669,3,471,288975.0,331.0,157.0
113871240.0,6,32,2220,16,1149,7576406.533333333,123.0,71.8125,16,1071,7576499.6,123.0,66.9375
40331.0,6,14,4740,7,653,6570.5,249.0,93.28571428571428,7,4087,6581.833333333333,1514.0,583.8571428571429
308727.0,6,6,412,4,272,102909.0,74.0,68.0,2,140,0.0,74.0,70.0
0.0,6,1,54,0,0,0.0,0.0,0.0,1,54,0.0,54.0,54.0
812.0,17,4,438,2,148,0.0,74.0,74.0,2,290,0.0,147.0,145.0
212079.0,6,10,1221,6,636,42415.8,298.0,106.0,4,585,69274.66666666667,379.0,146.25
23683.0,6,14,4740,7,653,3825.5,249.0,93.28571428571428,7,4087,3493.333333333333,1514.0,583.8571428571429
13645722.0,6,10,684,6,396,2729144.4,95.0,66.0,4,288,4475313.666666667,95.0,72.0
303660.0,6,2,132,1,66,0.0,66.0,66.0,1,66,0.0,66.0,66.0
38711.0,6,10,2032,5,524,8980.5,252.0,104.8,5,1508,9325.0,1236.0,301.6
119788909.0,6,23,1693,12,894,10889900.818181818,95.0,74.5,11,799,11954299.3,95.0,72.63636363636364
310821.0,6,6,412,4,272,103607.0,74.0,68.0,2,140,0.0,74.0,70.0
827.0,17,4,360,2,172,0.0,86.0,86.0,2,188,0.0,102.0,94.0
12477.0,17,4,823,2,163,0.0,89.0,81.5,2,660,0.0,443.0,330.0
196882.0,17,2,180,1,90,0.0,90.0,90.0,1,90,0.0,90.0,90.0
2421.0,17,4,344,2,150,0.0,75.0,75.0,2,194,0.0,103.0,97.0
296.0,17,2,156,1,78,0.0,78.0,78.0,1,78,0.0,78.0,78.0
100448705.0,17,13,821,7,432,16668138.333333334,174.0,61.71428571428572,6,389,20000163.8,174.0,64.83333333333333
90043065.0,17,28,13364,28,13364,3334928.333333333,501.0,477.2857142857143,0,0,0.0,0.0,0.0
1183398.0,6,13,3010,8,2382,169056.85714285713,1514.0,297.75,5,628,227685.25,331.0,125.6
302416.0,17,4,1524,4,1524,100805.33333333331,381.0,381.0,0,0,0.0,0.0,0.0
215480.0,17,2,180,1,90,0.0,90.0,90.0,1,90,0.0,90.0,90.0
108876148.0,6,39,2902,20,1531,5730323.578947368,139.0,76.55,19,1371,6036071.444444444,123.0,72.15789473684211
336.0,17,2,166,1,75,0.0,75.0,75.0,1,91,0.0,91.0,91.0
13040.0,6,10,2032,5,524,2803.0,252.0,104.8,5,1508,2597.5,1236.0,301.6
209439.0,17,2,180,1,90,0.0,90.0,90.0,1,90,0.0,90.0,90.0
103654367.0,6,44,2904,22,1452,4935922.238095238,66.0,66.0,22,1452,4921182.142857143,66.0,66.0
90532708.0,6,15,2168,8,1016,12933244.0,188.0,127.0,7,1152,15055346.166666666,204.0,164.57142857142858
34279.0,6,10,2032,5,524,7937.5,252.0,104.8,5,1508,7371.0,1236.0,301.6
108101892.0,17,5,1005,5,1005,27025473.0,201.0,201.0,0,0,0.0,0.0,0.0
135142268.0,17,6,1146,6,1146,27028453.6,191.0,191.0,0,0,0.0,0.0,0.0
90308078.0,6,16,1192,8,596,12894200.857142856,95.0,74.5,8,596,12899652.42857143,95.0,74.5
232264.0,17,2,180,1,90,0.0,90.0,90.0,1,90,0.0,90.0,90.0
135163.0,6,3,337,2,214,0.0,160.0,107.0,1,123,0.0,123.0,123.0
56698.0,6,14,4740,7,653,7848.5,249.0,93.28571428571428,7,4087,9212.166666666666,1514.0,583.8571428571429
232800.0,6,3,337,2,214,0.0,160.0,107.0,1,123,0.0,123.0,123.0
120122889.0,6,14,2224,9,1204,15015361.125,188.0,133.77777777777777,5,1020,22522770.25,204.0,204.0
9512.0,6,10,1067,5,536,2083.5,264.0,107.2,5,531,2174.0,259.0,106.2
198471.0,17,2,762,2,762,0.0,381.0,381.0,0,0,0.0,0.0,0.0
0.0,17,1,892,1,892,0.0,892.0,892.0,0,0,0.0,0.0,0.0
209572.0,17,2,180,1,90,0.0,90.0,90.0,1,90,0.0,90.0,90.0
166589.0,17,2,180,1,90,0.0,90.0,90.0,1,90,0.0,90.0,90.0
300950.0,6,6,412,4,272,100316.66666666669,74.0,68.0,2,140,0.0,74.0,70.0
142565.0,6,2,132,1,66,0.0,66.0,66.0,1,66,0.0,66.0,66.0
234005.0,6,3,373,2,238,0.0,172.0,119.0,1,135,0.0,135.0,135.0
207881.0,6,3,426,2,280,0.0,214.0,140.0,1,146,0.0,146.0,146.0
223.0,17,2,3028,2,3028,0.0,1514.0,1514.0,0,0,0.0,0.0,0.0
88989818.0,17,14,4788,14,4788,6845370.615384615,342.0,342.0,0,0,0.0,0.0,0.0
134767.0,6,2,132,1,66,0.0,66.0,66.0,1,66,0.0,66.0,66.0
314806.0,17,4,1400,4,1400,104935.33333333331,350.0,350.0,0,0,0.0,0.0,0.0
98611.0,17,2,762,2,762,0.0,381.0,381.0,0,0,0.0,0.0,0.0
33704482.0,6,5,336,2,134,0.0,68.0,67.0,3,202,16781385.0,70.0,67.33333333333333
2596828.0,6,2,132,1,66,0.0,66.0,66.0,1,66,0.0,66.0,66.0
155639.0,17,4,1524,4,1524,51879.66666666666,381.0,381.0,0,0,0.0,0.0,0.0
23398.0,6,10,2032,5,524,5614.5,252.0,104.8,5,1508,4471.0,1236.0,301.6
120000143.0,6,17,1287,9,691,15000017.875,95.0,76.77777777777777,8,596,12897625.285714284,95.0,74.5
302218.0,6,6,412,4,272,100739.33333333331,74.0,68.0,2,140,0.0,74.0,70.0
294.0,17,2,156,1,78,0.0,78.0,78.0,1,78,0.0,78.0,78.0
315906.0,17,4,1400,4,1400,105302.0,350.0,350.0,0,0,0.0,0.0,0.0
2372.0,17,4,344,2,150,0.0,75.0,75.0,2,194,0.0,103.0,97.0
135127388.0,17,6,1146,6,1146,27025477.6,191.0,191.0,0,0,0.0,0.0,0.0
90694310.0,6,21,1585,10,745,10077145.555555556,95.0,74.5,11,840,9044634.5,95.0,76.36363636363636
237629.0,6,3,337,2,214,0.0,160.0,107.0,1,123,0.0,123.0,123.0
113168431.0,6,46,3036,23,1518,5144007.863636363,66.0,66.0,23,1518,5144007.545454546,66.0,66.0
528695.0,6,5,1736,2,819,0.0,753.0,409.5,3,917,194906.0,785.0,305.6666666666667
316159.0,17,4,1400,4,1400,105386.33333333331,350.0,350.0,0,0,0.0,0.0,0.0
279916.0,17,2,363,1,79,0.0,79.0,79.0,1,284,0.0,284.0,284.0
333572.0,6,6,412,4,272,111190.66666666669,74.0,68.0,2,140,0.0,74.0,70.0
0.0,6,1,172,1,172,0.0,172.0,172.0,0,0,0.0,0.0,0.0
147963.0,17,2,180,1,90,0.0,90.0,90.0,1,90,0.0,90.0,90.0
135133044.0,17,6,1146,6,1146,27026608.8,191.0,191.0,0,0,0.0,0.0,0.0
135136797.0,17,6,1206,6,1206,27027359.4,201.0,201.0,0,0,0.0,0.0,0.0
2817681.0,6,2,132,1,66,0.0,66.0,66.0,1,66,0.0,66.0,66.0
207147.0,6,3,426,2,280,0.0,214.0,140.0,1,146,0.0,146.0,146.0
25466689.0,6,29,9249,16,3843,172050.33333333334,1514.0,240.1875,13,5406,2105120.0,1514.0,415.84615384615387
230984.0,17,2,359,1,75,0.0,75.0,75.0,1,284,0.0,284.0,284.0
120291.0,17,2,180,1,70,0.0,70.0,70.0,1,110,0.0,110.0,110.0
61237.0,6,14,4740,7,653,9582.833333333334,249.0,93.28571428571428,7,4087,9639.333333333334,1514.0,583.8571428571429
121538701.0,17,14,995,7,432,17833484.666666668,174.0,61.71428571428572,7,563,19007352.5,174.0,80.42857142857143
1532730.0,6,7,499,4,301,474709.6666666667,103.0,75.25,3,198,716314.5,66.0,66.0
242127.0,6,3,373,2,238,0.0,172.0,119.0,1,135,0.0,135.0,135.0
120126260.0,6,15,2428,9,1204,15015782.5,188.0,133.77777777777777,6,1224,18018730.0,204.0,204.0
0.0,17,1,342,1,342,0.0,342.0,342.0,0,0,0.0,0.0,0.0
228275.0,17,2,180,1,90,0.0,90.0,90.0,1,90,0.0,90.0,90.0
231832.0,17,4,1524,4,1524,77277.33333333333,381.0,381.0,0,0,0.0,0.0,0.0
26601.0,6,10,2032,5,524,6309.5,252.0,104.8,5,1508,6395.25,1236.0,301.6
24337.0,6,14,4740,7,653,3825.1666666666665,249.0,93.28571428571428,7,4087,3902.1666666666665,1514.0,583.8571428571429
106746.0,17,2,286,2,286,0.0,143.0,143.0,0,0,0.0,0.0,0.0
153483.0,17,2,180,1,90,0.0,90.0,90.0,1,90,0.0,90.0,90.0
1023511.0,6,11,1134,6,558,204702.2,220.0,93.0,5,576,255322.0,304.0,115.2
256131.0,6,12,1373,7,714,42688.5,298.0,102.0,5,659,63102.0,379.0,131.8
6509034.0,6,4,1670,2,819,0.0,753.0,409.5,2,851,0.0,785.0,425.5
1022576.0,6,11,1134,6,558,204515.2,220.0,93.0,5,576,254492.5,304.0,115.2
65404.00000000001,6,11,2098,6,590,12783.2,252.0,98.33333333333331,5,1508,15930.25,1236.0,301.6
90250846.0,6,14,2240,8,1016,12892978.0,188.0,127.0,6,1224,18017741.4,204.0,204.0
255214.0,6,3,337,2,214,0.0,160.0,107.0,1,123,0.0,123.0,123.0
202359.0,17,4,6056,4,6056,67453.0,1514.0,1514.0,0,0,0.0,0.0,0.0
50602.0,6,14,4740,7,653,7398.833333333333,249.0,93.28571428571428,7,4087,7999.666666666667,1514.0,583.8571428571429
297470.0,6,6,412,4,272,99156.66666666669,74.0,68.0,2,140,0.0,74.0,70.0
4766.0,17,2,614,1,72,0.0,72.0,72.0,1,542,0.0,542.0,542.0
37264.0,6,14,4740,7,653,6091.0,249.0,93.28571428571428,7,4087,5896.166666666667,1514.0,583.8571428571429
501306.00000000006,6,5,336,2,134,0.0,68.0,67.0,3,202,193482.5,70.0,67.33333333333333
98342283.0,6,40,2640,20,1320,5175909.631578947,66.0,66.0,20,1320,5164534.315789473,66.0,66.0
116712012.0,6,220,24868,110,17312,1068778.504587156,284.0,157.38181818181818,110,7556,1068778.256880734,140.0,68.69090909090909
302163.0,6,6,412,4,272,100721.0,74.0,68.0,2,140,0.0,74.0,70.0
41461.0,6,14,4740,7,653,6497.666666666667,249.0,93.28571428571428,7,4087,6552.333333333333,1514.0,583.8571428571429
366190.0,6,11,1021,6,444,49535.0,162.0,74.0,5,577,61704.75,349.0,115.4
513319.0,6,5,336,2,134,0.0,68.0,67.0,3,202,198130.0,70.0,67.33333333333333
9775.0,6,10,1065,5,534,2217.75,262.0,106.8,5,531,2024.0,259.0,106.2
49894.0,6,14,4740,7,653,8104.333333333333,249.0,93.28571428571428,7,4087,6333.666666666667,1514.0,583.8571428571429
3008152.0,6,3,1604,2,851,0.0,785.0,425.5,1,753,0.0,753.0,753.0
276112.0,6,10,1221,6,636,55222.4,298.0,106.0,4,585,86136.0,379.0,146.25
120024308.0,17,29,13785,29,13785,4286582.428571428,501.0,475.3448275862069,0,0,0.0,0.0,0.0
90251306.0,6,13,2036,8,1016,12893043.714285716,188.0,127.0,5,1020,22522021.0,204.0,204.0
355982.0,6,4,508,2,238,0.0,172.0,119.0,2,270,0.0,135.0,135.0
131635.0,6,13,1394,7,797,21939.166666666668,253.0,113.85714285714286,6,597,23731.4,259.0,99.5
787.0,17,4,438,2,148,0.0,74.0,74.0,2,290,0.0,147.0,145.0
103529.0,17,2,286,2,286,0.0,143.0,143.0,0,0,0.0,0.0,0.0
24167.0,6,13,1459,7,862,3759.6666666666665,271.0,123.14285714285714,6,597,3823.2,259.0,99.5
228237.0,17,2,180,1,90,0.0,90.0,90.0,1,90,0.0,90.0,90.0
90284275.0,6,14,2240,8,1016,12897753.57142857,188.0,127.0,6,1224,18023653.4,204.0,204.0
19703.0,6,14,4740,7,653,3037.833333333333,249.0,93.28571428571428,7,4087,3143.6666666666665,1514.0,583.8571428571429
208079.0,6,3,426,2,280,0.0,214.0,140.0,1,146,0.0,146.0,146.0
303243.0,6,6,412,4,272,101081.0,74.0,68.0,2,140,0.0,74.0,70.0
5004603.0,17,4,534,2,166,0.0,83.0,83.0,2,368,0.0,184.0,184.0
117017321.0,6,48,3168,24,1584,5087709.608695652,66.0,66.0,24,1584,5074286.434782608,66.0,66.0
114599833.0,6,258,30102,129,21366,893629.3671875,390.0,165.6279069767442,129,8736,893626.21875,140.0,67.72093023255815
2847103.0,6,4,270,3,202,1423551.5,70.0,67.33333333333333,1,68,0.0,68.0,68.0
138661.0,6,2,132,1,66,0.0,66.0,66.0,1,66,0.0,66.0,66.0
112535369.0,6,46,3036,23,1518,5105430.0,66.0,66.0,23,1518,5105436.454545454,66.0,66.0
5622698.0,6,4,270,2,134,0.0,68.0,67.0,2,136,0.0,70.0,68.0
28755.0,6,10,2032,5,524,6897.25,252.0,104.8,5,1508,6248.75,1236.0,301.6
9054.0,6,10,1975,5,467,2043.0,195.0,93.4,5,1508,1935.75,1236.0,301.6
3016681.0,6,12,2172,7,664,502223.3333333333,252.0,94.85714285714286,5,1508,3382.25,1236.0,301.6
5616367.0,6,5,336,2,134,0.0,68.0,67.0,3,202,1524601.0,70.0,67.33333333333333
104653.0,17,2,286,2,286,0.0,143.0,143.0,0,0,0.0,0.0,0.0
225599.0,17,2,180,1,90,0.0,90.0,90.0,1,90,0.0,90.0,90.0
120101.0,17,2,180,1,70,0.0,70.0,70.0,1,110,0.0,110.0,110.0
9313.0,17,4,823,2,163,0.0,89.0,81.5,2,660,0.0,443.0,330.0
43789.0,6,10,2032,5,524,8893.0,252.0,104.8,5,1508,10302.75,1236.0,301.6
90028574.0,17,28,13364,28,13364,3334391.6296296297,501.0,477.2857142857143,0,0,0.0,0.0,0.0
25268.0,6,10,2032,5,524,6092.75,252.0,104.8,5,1508,6012.75,1236.0,301.6
218302.0,17,2,180,1,90,0.0,90.0,90.0,1,90,0.0,90.0,90.0
334.0,17,2,166,1,75,0.0,75.0,75.0,1,91,0.0,91.0,91.0
139691.0,6,2,132,1,66,0.0,66.0,66.0,1,66,0.0,66.0,66.0
141664.0,6,2,132,1,66,0.0,66.0,66.0,1,66,0.0,66.0,66.0
47602592.0,6,8,1940,3,887,22796554.0,753.0,295.6666666666667,5,1053,11208244.5,785.0,210.6
95568.0,17,2,762,2,762,0.0,381.0,381.0,0,0,0.0,0.0,0.0
120755426.0,6,30,1974,15,948,7912155.142857143,123.0,63.2,15,1026,7912163.428571428,123.0,68.4
843369.0,6,9,1118,6,586,168673.8,248.0,97.66666666666669,3,532,283722.5,392.0,177.33333333333334
21035.0,6,14,4740,7,653,3400.0,249.0,93.28571428571428,7,4087,3370.5,1514.0,583.8571428571429
14367.0,17,2,180,1,90,0.0,90.0,90.0,1,90,0.0,90.0,90.0
9365.0,17,4,823,2,163,0.0,89.0,81.5,2,660,0.0,443.0,330.0
2497.0,17,2,180,1,90,0.0,90.0,90.0,1,90,0.0,90.0,90.0
108525.0,17,2,286,2,286,0.0,143.0,143.0,0,0,0.0,0.0,0.0
135132417.0,17,6,1206,6,1206,27026483.4,201.0,201.0,0,0,0.0,0.0,0.0
196888.0,17,2,180,1,90,0.0,90.0,90.0,1,90,0.0,90.0,90.0
145201.0,17,2,180,1,70,0.0,70.0,70.0,1,110,0.0,110.0,110.0
22029.0,6,14,4740,7,653,3460.0,249.0,93.28571428571428,7,4087,3182.5,1514.0,583.8571428571429
117746427.0,6,217,24506,109,7490,1090196.4814814816,140.0,68.71559633027523,108,17016,1092820.3738317755,284.0,157.55555555555554
41578.0,6,14,4740,7,653,6810.166666666667,249.0,93.28571428571428,7,4087,6502.833333333333,1514.0,583.8571428571429
26899090.0,17,5,1710,5,1710,6724772.5,342.0,342.0,0,0,0.0,0.0,0.0
31818.0,6,10,2032,5,524,7207.5,252.0,104.8,5,1508,7537.5,1236.0,301.6
46736.0,6,14,4740,7,653,7664.666666666667,249.0,93.28571428571428,7,4087,7649.166666666667,1514.0,583.8571428571429
947.0,17,4,820,2,156,0.0,78.0,78.0,2,664,0.0,332.0,332.0
28959.0,6,10,2032,5,524,6545.0,252.0,104.8,5,1508,6642.0,1236.0,301.6
0.0,17,1,453,1,453,0.0,453.0,453.0,0,0,0.0,0.0,0.0
103521.0,17,2,286,2,286,0.0,143.0,143.0,0,0,0.0,0.0,0.0
2460152.0,6,25,7573,14,3735,189242.4615384616,1514.0,266.7857142857143,11,3838,220565.4,1514.0,348.90909090909093
61175.0,6,14,4740,7,653,10072.833333333334,249.0,93.28571428571428,7,4087,9251.333333333334,1514.0,583.8571428571429
1178055.0,6,13,3010,8,2382,168293.57142857142,1514.0,297.75,5,628,225581.75,331.0,125.6
1423951.0,17,7,490,7,490,237325.16666666663,70.0,70.0,0,0,0.0,0.0,0.0
248381.0,6,3,337,2,214,0.0,160.0,107.0,1,123,0.0,123.0,123.0
206273.0,6,3,426,2,280,0.0,214.0,140.0,1,146,0.0,146.0,146.0
108107090.0,17,5,1005,5,1005,27026772.5,201.0,201.0,0,0,0.0,0.0,0.0
23878013.0,17,3,1034,2,684,0.0,342.0,342.0,1,350,0.0,350.0,350.0
120158555.0,6,218,24646,109,7490,1105040.0185185184,140.0,68.71559633027523,109,17156,1105039.0,284.0,157.39449541284404
306355.0,6,3,202,2,128,0.0,74.0,64.0,1,74,0.0,74.0,74.0
26154.0,6,14,4740,7,653,3899.6666666666665,249.0,93.28571428571428,7,4087,4218.0,1514.0,583.8571428571429
103000858.0,17,13,821,7,432,17166809.666666668,174.0,61.71428571428572,6,389,16600926.8,174.0,64.83333333333333
90962471.0,6,21,1585,11,840,9095475.1,95.0,76.36363636363636,10,745,10106233.444444444,95.0,74.5
5843617.0,6,13,2049,9,1505,730452.125,249.0,167.22222222222223,4,544,1945847.0,326.0,136.0
819.0,17,5,550,5,550,204.75,110.0,110.0,0,0,0.0,0.0,0.0
319.0,17,2,174,1,79,0.0,79.0,79.0,1,95,0.0,95.0,95.0
363.0,17,2,300,1,80,0.0,80.0,80.0,1,220,0.0,220.0,220.0
90359276.0,6,12,1848,7,828,15059879.333333334,188.0,118.28571428571428,5,1020,15082860.75,204.0,204.0
204735.0,17,2,762,2,762,0.0,381.0,381.0,0,0,0.0,0.0,0.0
120245232.0,6,18,1341,9,691,14999681.0,95.0,76.77777777777777,9,650,14998755.375,95.0,72.22222222222223
2333.0,17,4,344,2,150,0.0,75.0,75.0,2,194,0.0,103.0,97.0
61413.0,6,12,1328,7,797,10235.5,253.0,113.85714285714286,5,531,12680.75,259.0,106.2
135129795.0,17,6,1206,6,1206,27025959.0,201.0,201.0,0,0,0.0,0.0,0.0
286874.0,17,4,704,2,148,0.0,74.0,74.0,2,556,0.0,280.0,278.0
2583546.0,6,3,204,2,136,0.0,70.0,68.0,1,68,0.0,68.0,68.0
15945.999999999998,6,11,2098,6,590,2915.4,252.0,98.33333333333331,5,1508,3746.0,1236.0,301.6
102420.0,6,14,4740,7,653,16908.333333333332,249.0,93.28571428571428,7,4087,16934.833333333332,1514.0,583.8571428571429
14067.0,6,12,1393,6,796,2583.8,271.0,132.66666666666666,6,597,2510.0,259.0,99.5
372.0,17,2,762,2,762,0.0,381.0,381.0,0,0,0.0,0.0,0.0
300607.0,6,6,412,4,272,100202.33333333331,74.0,68.0,2,140,0.0,74.0,70.0
33781.0,6,14,4740,7,653,3449.5,249.0,93.28571428571428,7,4087,5101.5,1514.0,583.8571428571429
405.0,17,2,204,1,88,0.0,88.0,88.0,1,116,0.0,116.0,116.0
120285235.0,6,347,40540,174,28826,695290.3757225433,374.0,165.66666666666666,173,11714,693940.5174418605,140.0,67.71098265895954
91555.0,6,10,2032,5,524,22669.0,252.0,104.8,5,1508,22261.5,1236.0,301.6
209593.0,17,2,762,2,762,0.0,381.0,381.0,0,0,0.0,0.0,0.0
24119.0,6,14,4740,7,653,3889.6666666666665,249.0,93.28571428571428,7,4087,3470.5,1514.0,583.8571428571429
315667.0,17,4,1400,4,1400,105222.33333333331,350.0,350.0,0,0,0.0,0.0,0.0
90061067.0,17,28,13364,28,13364,3335595.074074074,501.0,477.2857142857143,0,0,0.0,0.0,0.0
300951.0,17,2,180,1,90,0.0,90.0,90.0,1,90,0.0,90.0,90.0
108115760.0,17,5,955,5,955,27028940.0,191.0,191.0,0,0,0.0,0.0,0.0
299213.0,6,6,412,4,272,99737.66666666669,74.0,68.0,2,140,0.0,74.0,70.0
118431429.0,17,14,864,7,432,19666823.166666668,174.0,61.71428571428572,7,432,19668322.166666668,174.0,61.71428571428572
20145.0,6,14,4740,7,653,3232.0,249.0,93.28571428571428,7,4087,3219.333333333333,1514.0,583.8571428571429
120146240.0,6,208,23552,104,7160,1158470.6990291262,140.0,68.84615384615384,104,16392,1159603.854368932,284.0,157.6153846153846
250055.00000000003,17,4,6056,4,6056,83351.66666666667,1514.0,1514.0,0,0,0.0,0.0,0.0
206556.0,6,3,426,2,280,0.0,214.0,140.0,1,146,0.0,146.0,146.0
2574828.0,6,3,1604,2,851,0.0,785.0,425.5,1,753,0.0,753.0,753.0
144003.0,17,2,180,1,90,0.0,90.0,90.0,1,90,0.0,90.0,90.0
294595.0,6,6,412,4,272,98198.33333333331,74.0,68.0,2,140,0.0,74.0,70.0
2309.0,17,4,344,2,150,0.0,75.0,75.0,2,194,0.0,103.0,97.0
19641.0,6,20,7606,11,978,1964.1,310.0,88.9090909090909,9,6628,1977.375,1514.0,736.4444444444445
104350682.0,6,35,2658,18,1395,6138275.411764706,123.0,77.5,17,1263,6508409.0625,123.0,74.29411764705883
144226.0,17,4,571,2,148,0.0,74.0,74.0,2,423,0.0,276.0,211.5
118533884.0,6,182,20666,91,14438,1314651.3666666667,284.0,158.65934065934067,91,6228,1314651.4666666666,140.0,68.43956043956044
102257.0,17,2,286,2,286,0.0,143.0,143.0,0,0,0.0,0.0,0.0
3007466.0,6,11,2106,6,598,601062.6,252.0,99.66666666666669,5,1508,2128.5,1236.0,301.6
319902.0,17,4,1400,4,1400,106634.0,350.0,350.0,0,0,0.0,0.0,0.0
834.0,17,4,438,2,148,0.0,74.0,74.0,2,290,0.0,147.0,145.0
2323.0,17,4,344,2,150,0.0,75.0,75.0,2,194,0.0,103.0,97.0
9184.0,17,2,582,1,83,0.0,83.0,83.0,1,499,0.0,499.0,499.0
2289.0,17,4,344,2,150,0.0,75.0,75.0,2,194,0.0,103.0,97.0
135143571.0,17,6,1146,6,1146,27028714.2,191.0,191.0,0,0,0.0,0.0,0.0
205176.0,17,2,180,1,90,0.0,90.0,90.0,1,90,0.0,90.0,90.0
72769.0,6,14,4740,7,653,12005.0,249.0,93.28571428571428,7,4087,11346.833333333334,1514.0,583.8571428571429
90007678.0,17,27,12943,27,12943,3461833.769230769,501.0,479.3703703703704,0,0,0.0,0.0,0.0
90545361.0,6,15,2168,8,1016,12935051.57142857,188.0,127.0,7,1152,15056740.833333334,204.0,164.57142857142858
298316.0,6,6,412,4,272,99438.66666666669,74.0,68.0,2,140,0.0,74.0,70.0
6648158.0,6,4,270,2,134,0.0,68.0,67.0,2,136,0.0,70.0,68.0
144096.0,17,2,180,1,90,0.0,90.0,90.0,1,90,0.0,90.0,90.0
100682239.0,17,14,864,7,432,16667772.0,174.0,61.71428571428572,7,432,16666803.833333334,174.0,61.71428571428572
207136.0,6,3,426,2,280,0.0,214.0,140.0,1,146,0.0,146.0,146.0
135138866.0,17,6,1146,6,1146,27027773.2,191.0,191.0,0,0,0.0,0.0,0.0
90524393.0,6,13,2036,8,1016,12932056.142857144,188.0,127.0,5,1020,22589877.0,204.0,204.0
94138686.0,6,23,1860,12,894,8558062.363636363,95.0,74.5,11,966,9388212.2,221.0,87.81818181818181
103223.0,17,2,286,2,286,0.0,143.0,143.0,0,0,0.0,0.0,0.0
90023868.0,17,28,13364,28,13364,3334217.333333333,501.0,477.2857142857143,0,0,0.0,0.0,0.0
18921.0,6,10,2032,5,524,4172.25,252.0,104.8,5,1508,4098.0,1236.0,301.6
302148.0,6,6,412,4,272,100716.0,74.0,68.0,2,140,0.0,74.0,70.0
108103222.0,17,5,955,5,955,27025805.5,191.0,191.0,0,0,0.0,0.0,0.0
29955.0,6,10,2032,5,524,7252.25,252.0,104.8,5,1508,6963.25,1236.0,301.6
206071.0,17,2,180,1,90,0.0,90.0,90.0,1,90,0.0,90.0,90.0
105581994.0,17,14,1126,7,563,17501797.833333332,174.0,80.42857142857143,7,563,17500162.333333332,174.0,80.42857142857143
300.0,17,2,156,1,78,0.0,78.0,78.0,1,78,0.0,78.0,78.0
26679402.0,17,5,1718,4,1368,819761.0,342.0,342.0,1,350,0.0,350.0,350.0
33532.0,6,14,4740,7,653,5414.333333333333,249.0,93.28571428571428,7,4087,5058.333333333333,1514.0,583.8571428571429
10452411.0,6,7,478,4,272,3438695.6666666665,74.0,68.0,3,206,5157947.0,74.0,68.66666666666667
239338.0,6,3,373,2,238,0.0,172.0,119.0,1,135,0.0,135.0,135.0
134895.0,6,2,132,1,66,0.0,66.0,66.0,1,66,0.0,66.0,66.0
103754.0,17,2,286,2,286,0.0,143.0,143.0,0,0,0.0,0.0,0.0
318897.0,17,4,1400,4,1400,106299.0,350.0,350.0,0,0,0.0,0.0,0.0
242665.0,6,3,373,2,238,0.0,172.0,119.0,1,135,0.0,135.0,135.0
217850.0,6,3,426,2,280,0.0,214.0,140.0,1,146,0.0,146.0,146.0
40959334.0,6,4,1843,3,1017,20479667.0,885.0,339.0,1,826,0.0,826.0,826.0
108261.0,17,2,286,2,286,0.0,143.0,143.0,0,0,0.0,0.0,0.0
175029.0,17,2,180,1,90,0.0,90.0,90.0,1,90,0.0,90.0,90.0
2809174.0,6,2,132,1,66,0.0,66.0,66.0,1,66,0.0,66.0,66.0
352.0,17,2,250,1,93,0.0,93.0,93.0,1,157,0.0,157.0,157.0
41984140.0,6,4,1670,3,917,20992070.0,785.0,305.6666666666667,1,753,0.0,753.0,753.0
30501.0,6,10,2032,5,524,6168.5,252.0,104.8,5,1508,7350.5,1236.0,301.6
96069.0,17,2,286,2,286,0.0,143.0,143.0,0,0,0.0,0.0,0.0
20125.0,6,10,2032,5,524,4652.75,252.0,104.8,5,1508,4757.0,1236.0,301.6
2271843.0,6,49,23728,25,19797,94660.125,1514.0,791.88,24,3931,89521.95652173914,1514.0,163.79166666666666
148082.0,17,2,180,1,90,0.0,90.0,90.0,1,90,0.0,90.0,90.0
41091.0,6,14,4740,7,653,6721.666666666667,249.0,93.28571428571428,7,4087,6062.166666666667,1514.0,583.8571428571429
152153.0,17,2,414,1,88,0.0,88.0,88.0,1,326,0.0,326.0,326.0
13045.0,6,14,4740,7,653,1977.5,249.0,93.28571428571428,7,4087,1980.5,1514.0,583.8571428571429
298028.0,6,6,412,4,272,99342.66666666669,74.0,68.0,2,140,0.0,74.0,70.0
26018.0,6,10,2032,5,524,6291.25,252.0,104.8,5,1508,6063.0,1236.0,301.6
122007447.0,17,15,907,8,475,17429635.285714287,174.0,59.375,7,432,17000226.166666668,174.0,61.71428571428572
104173003.0,6,44,2904,22,1452,4960619.19047619,66.0,66.0,22,1452,4945650.428571428,66.0,66.0
135137726.0,17,6,1146,6,1146,27027545.2,191.0,191.0,0,0,0.0,0.0,0.0
3636267.0,6,4,270,2,134,0.0,68.0,67.0,2,136,0.0,70.0,68.0
2005.0,17,4,344,2,150,0.0,75.0,75.0,2,194,0.0,103.0,97.0
310.0,17,2,164,1,82,0.0,82.0,82.0,1,82,0.0,82.0,82.0
2309.0,17,4,344,2,150,0.0,75.0,75.0,2,194,0.0,103.0,97.0
115516874.0,6,48,3168,24,1584,5022472.782608695,66.0,66.0,24,1584,5009378.0,66.0,66.0
317.0,17,2,174,1,79,0.0,79.0,79.0,1,95,0.0,95.0,95.0
232171.0,6,3,337,2,214,0.0,160.0,107.0,1,123,0.0,123.0,123.0
8280688.0,6,876,864821,573,845441,14476.727272727272,1514.0,1475.4642233856894,303,19380,26672.37086092716,1514.0,63.96039603960397
69908.0,6,14,4740,7,653,10954.833333333334,249.0,93.28571428571428,7,4087,10834.0,1514.0,583.8571428571429
52357.0,6,10,2032,5,524,12846.75,252.0,104.8,5,1508,12238.0,1236.0,301.6
26842.0,6,14,4740,7,653,4325.833333333333,249.0,93.28571428571428,7,4087,3661.3333333333335,1514.0,583.8571428571429
2404.0,17,4,344,2,150,0.0,75.0,75.0,2,194,0.0,103.0,97.0
297.0,17,2,164,1,74,0.0,74.0,74.0,1,90,0.0,90.0,90.0
300803.0,6,6,412,4,272,100267.66666666669,74.0,68.0,2,140,0.0,74.0,70.0
90022060.0,17,27,12943,27,12943,3462386.923076923,501.0,479.3703703703704,0,0,0.0,0.0,0.0
5005088.0,17,4,849,2,166,0.0,83.0,83.0,2,683,0.0,499.0,341.5
16841.0,17,2,180,1,90,0.0,90.0,90.0,1,90,0.0,90.0,90.0
39621.0,6,10,2032,5,524,9481.75,252.0,104.8,5,1508,9628.0,1236.0,301.6
49689995.0,6,8,2113,3,960,23514946.5,826.0,320.0,5,1153,11777297.75,885.0,230.6
28757.0,6,14,4740,7,653,4663.5,249.0,93.28571428571428,7,4087,4510.5,1514.0,583.8571428571429
43603.0,6,10,2032,5,524,10506.5,252.0,104.8,5,1508,9557.75,1236.0,301.6
171602.0,17,2,180,1,90,0.0,90.0,90.0,1,90,0.0,90.0,90.0
19095568.0,6,6,1981,4,1087,6365189.333333333,885.0,271.75,2,894,0.0,826.0,447.0
197213.0,17,2,180,1,90,0.0,90.0,90.0,1,90,0.0,90.0,90.0
2764637.0,6,3,1604,2,851,0.0,785.0,425.5,1,753,0.0,753.0,753.0
167291.0,17,4,1400,4,1400,55763.66666666666,350.0,350.0,0,0,0.0,0.0,0.0
90253466.0,6,16,2368,9,1204,11281683.25,188.0,133.77777777777777,7,1164,15015213.0,204.0,166.28571428571428
402272.0,6,4,508,2,238,0.0,172.0,119.0,2,270,0.0,135.0,135.0
0.0,17,1,350,1,350,0.0,350.0,350.0,0,0,0.0,0.0,0.0
5637834.0,6,4,270,2,134,0.0,68.0,67.0,2,136,0.0,70.0,68.0
59570.0,6,13,1479,7,882,9928.333333333334,291.0,126.0,6,597,9268.6,259.0,99.5
103276061.0,17,14,864,7,432,17166886.166666668,174.0,61.71428571428572,7,432,17167667.666666668,174.0,61.71428571428572
205983.0,6,3,426,2,280,0.0,214.0,140.0,1,146,0.0,146.0,146.0
228213.0,17,2,180,1,90,0.0,90.0,90.0,1,90,0.0,90.0,90.0
90283514.0,6,15,1097,8,596,12897644.857142856,95.0,74.5,7,501,14999767.333333334,95.0,71.57142857142857
332.0,17,2,166,1,75,0.0,75.0,75.0,1,91,0.0,91.0,91.0
842.0,17,4,438,2,148,0.0,74.0,74.0,2,290,0.0,147.0,145.0
5009842.0,17,4,376,2,152,0.0,76.0,76.0,2,224,0.0,148.0,112.0
147982.0,17,2,180,1,90,0.0,90.0,90.0,1,90,0.0,90.0,90.0
103056126.0,17,14,1126,7,563,17167563.833333332,174.0,80.42857142857143,7,563,17166827.666666668,174.0,80.42857142857143
120316619.0,6,241,27286,121,19144,1002638.4916666668,390.0,158.21487603305786,120,8142,1002358.5714285716,140.0,67.85
0.0,6,1,66,1,66,0.0,66.0,66.0,0,0,0.0,0.0,0.0
307500.0,6,6,412,4,272,102500.0,74.0,68.0,2,140,0.0,74.0,70.0
50290.0,6,14,4740,7,653,7274.0,249.0,93.28571428571428,7,4087,7919.0,1514.0,583.8571428571429
90300185.0,6,16,1192,8,596,12893947.0,95.0,74.5,8,596,12898394.285714284,95.0,74.5
1018938.0,6,11,1134,6,558,203787.60000000003,220.0,93.0,5,576,254269.5,304.0,115.2
17118.0,6,14,4740,7,653,2581.1666666666665,249.0,93.28571428571428,7,4087,2592.5,1514.0,583.8571428571429
29002.0,6,14,4740,7,653,4709.0,249.0,93.28571428571428,7,4087,4695.166666666667,1514.0,583.8571428571429
108128034.0,17,5,1005,5,1005,27032008.5,201.0,201.0,0,0,0.0,0.0,0.0
2339.0,17,4,344,2,150,0.0,75.0,75.0,2,194,0.0,103.0,97.0
2159170.0,6,25,7610,13,2516,179930.83333333334,1034.0,193.53846153846155,12,5094,168601.36363636365,1510.0,424.5
301314.0,6,6,412,4,272,100438.0,74.0,68.0,2,140,0.0,74.0,70.0
112492499.0,6,47,3102,24,1584,4890978.217391305,66.0,66.0,23,1518,5111987.909090909,66.0,66.0
103076299.0,6,187,21048,94,6426,1108347.3010752688,140.0,68.36170212765957,93,14622,1086833.456521739,284.0,157.2258064516129
146004.0,6,3,337,2,214,0.0,160.0,107.0,1,123,0.0,123.0,123.0
30517.0,6,10,2032,5,524,7342.75,252.0,104.8,5,1508,7059.0,1236.0,301.6
90047143.0,17,28,13364,28,13364,3335079.3703703703,501.0,477.2857142857143,0,0,0.0,0.0,0.0
120008796.0,6,248,27938,124,8480,975435.3821138212,140.0,68.38709677419355,124,19458,969867.2845528456,284.0,156.9193548387097
156.0,17,2,3028,2,3028,0.0,1514.0,1514.0,0,0,0.0,0.0,0.0
102980122.0,6,33,2428,17,1288,6436257.625,139.0,75.76470588235294,16,1140,6850921.066666666,123.0,71.25
354.0,17,2,267,1,83,0.0,83.0,83.0,1,184,0.0,184.0,184.0
111828.0,17,2,762,2,762,0.0,381.0,381.0,0,0,0.0,0.0,0.0
0.0,17,1,44,1,44,0.0,44.0,44.0,0,0,0.0,0.0,0.0
3073.0,17,2,180,1,90,0.0,90.0,90.0,1,90,0.0,90.0,90.0
70635.0,17,2,618,1,82,0.0,82.0,82.0,1,536,0.0,536.0,536.0
217864.0,6,3,426,2,280,0.0,214.0,140.0,1,146,0.0,146.0,146.0
90265405.0,6,12,1832,8,1016,12895057.857142856,188.0,127.0,4,816,30033097.0,204.0,204.0
90524828.0,6,13,2036,8,1016,12932118.285714284,188.0,127.0,5,1020,22590418.25,204.0,204.0
98637059.0,6,263,31390,132,22522,752954.6488549619,284.0,170.62121212121212,131,8868,756901.6230769231,140.0,67.69465648854961
318.0,17,2,174,1,79,0.0,79.0,79.0,1,95,0.0,95.0,95.0
2381.0,17,4,344,2,150,0.0,75.0,75.0,2,194,0.0,103.0,97.0
90018436.0,17,27,12943,27,12943,3462247.5384615385,501.0,479.3703703703704,0,0,0.0,0.0,0.0
107003959.0,6,44,2904,22,1452,5095426.619047619,66.0,66.0,22,1452,5080452.047619048,66.0,66.0
322729.0,17,4,1400,4,1400,107576.33333333331,350.0,350.0,0,0,0.0,0.0,0.0
77578056.0,6,9,842,9,842,9697257.0,97.0,93.55555555555556,0,0,0.0,0.0,0.0
219415.0,6,3,426,2,280,0.0,214.0,140.0,1,146,0.0,146.0,146.0
114117346.0,6,35,2542,18,1348,6700086.470588235,139.0,74.88888888888889,17,1194,7118845.4375,123.0,70.23529411764706
120014630.0,17,29,13785,29,13785,4286236.785714285,501.0,475.3448275862069,0,0,0.0,0.0,0.0
108105429.0,17,5,1005,5,1005,27026357.25,201.0,201.0,0,0,0.0,0.0,0.0
122361.0,6,3,373,2,238,0.0,172.0,119.0,1,135,0.0,135.0,135.0
169057.0,17,2,414,1,88,0.0,88.0,88.0,1,326,0.0,326.0,326.0
92707804.0,6,37,2442,19,1254,5150433.555555556,66.0,66.0,18,1188,5160106.0,66.0,66.0
27529.0,6,11,2098,6,590,4534.6,252.0,98.33333333333331,5,1508,6176.0,1236.0,301.6
120124585.0,6,13,2020,9,1204,15015573.125,188.0,133.77777777777777,4,816,30031796.33333333,204.0,204.0
22727.0,6,14,4740,7,653,3662.5,249.0,93.28571428571428,7,4087,3649.3333333333335,1514.0,583.8571428571429
90257007.0,6,13,2036,8,1016,12893858.142857144,188.0,127.0,5,1020,22523233.5,204.0,204.0
211797.0,17,2,180,1,90,0.0,90.0,90.0,1,90,0.0,90.0,90.0
120080763.0,17,29,13785,29,13785,4288598.678571428,501.0,475.3448275862069,0,0,0.0,0.0,0.0
41708.0,6,14,4740,7,653,6403.666666666667,249.0,93.28571428571428,7,4087,6748.0,1514.0,583.8571428571429
46432.0,6,10,2032,5,524,10832.25,252.0,104.8,5,1508,9824.5,1236.0,301.6
143934.0,17,2,180,1,90,0.0,90.0,90.0,1,90,0.0,90.0,90.0
99089021.0,6,29,2052,15,1089,7062360.214285715,123.0,72.6,14,963,7605624.307692308,123.0,68.78571428571429
773.0,17,4,438,2,148,0.0,74.0,74.0,2,290,0.0,147.0,145.0
11067.0,6,10,1066,5,490,2585.25,218.0,98.0,5,576,2160.75,304.0,115.2
108112971.0,17,5,955,5,955,27028242.75,191.0,191.0,0,0,0.0,0.0,0.0
503930.0,6,5,336,2,134,0.0,68.0,67.0,3,202,191591.5,70.0,67.33333333333333
240874.0,6,3,337,2,214,0.0,160.0,107.0,1,123,0.0,123.0,123.0
90016541.0,17,27,12943,27,12943,3462174.653846154,501.0,479.3703703703704,0,0,0.0,0.0,0.0
113582588.0,6,48,3168,24,1584,4938373.391304348,66.0,66.0,24,1584,4926391.434782608,66.0,66.0
45575.0,6,14,4740,7,653,7035.833333333333,249.0,93.28571428571428,7,4087,6252.5,1514.0,583.8571428571429
104041946.0,17,13,821,7,432,17313499.666666668,174.0,61.71428571428572,6,389,16882517.6,174.0,64.83333333333333
307076.0,6,6,412,4,272,102358.66666666669,74.0,68.0,2,140,0.0,74.0,70.0
377.0,17,2,160,1,80,0.0,80.0,80.0,1,80,0.0,80.0,80.0
315069.0,17,4,1400,4,1400,105023.0,350.0,350.0,0,0,0.0,0.0,0.0
0.0,17,1,55,1,55,0.0,55.0,55.0,0,0,0.0,0.0,0.0
14645568.0,6,19,1551,9,919,1791658.75,315.0,102.11111111111111,10,632,1592566.0,78.0,63.2
105017699.0,17,14,1126,7,563,17458681.5,174.0,80.42857142857143,7,563,17476459.5,174.0,80.42857142857143
290.0,17,2,164,1,82,0.0,82.0,82.0,1,82,0.0,82.0,82.0
17950.0,6,14,4740,7,653,2597.0,249.0,93.28571428571428,7,4087,2854.1666666666665,1514.0,583.8571428571429
34094.0,6,14,4740,7,653,5509.833333333333,249.0,93.28571428571428,7,4087,5437.0,1514.0,583.8571428571429
396.0,17,2,762,2,762,0.0,381.0,381.0,0,0,0.0,0.0,0.0
90031581.0,17,28,13364,28,13364,3334503.0,501.0,477.2857142857143,0,0,0.0,0.0,0.0
784.0,17,2,762,2,762,0.0,381.0,381.0,0,0,0.0,0.0,0.0
143859.0,17,2,180,1,90,0.0,90.0,90.0,1,90,0.0,90.0,90.0
73594.0,6,14,4740,7,653,11949.0,249.0,93.28571428571428,7,4087,10772.833333333334,1514.0,583.8571428571429
113973708.0,6,47,3102,24,1584,4942175.0,66.0,66.0,23,1518,5150441.636363637,66.0,66.0
2124.0,17,4,344,2,150,0.0,75.0,75.0,2,194,0.0,103.0,97.0
146299.0,6,3,337,2,214,0.0,160.0,107.0,1,123,0.0,123.0,123.0
90221551.0,6,16,1192,8,596,12854213.42857143,95.0,74.5,8,596,12859547.142857144,95.0,74.5
90302169.0,6,16,1192,8,596,12893262.714285716,95.0,74.5,8,596,12900049.857142856,95.0,74.5
120129641.0,6,15,2444,7,1428,20021606.83333333,204.0,204.0,8,1016,17137519.285714287,188.0,127.0
38247.0,6,14,4740,7,653,6258.5,249.0,93.28571428571428,7,4087,5359.333333333333,1514.0,583.8571428571429
87044.0,6,14,4740,7,653,11893.0,249.0,93.28571428571428,7,4087,13144.5,1514.0,583.8571428571429
273041.0,6,10,1221,6,636,54608.2,298.0,106.0,4,585,85639.66666666667,379.0,146.25
407.0,17,2,410,1,78,0.0,78.0,78.0,1,332,0.0,332.0,332.0
309058.0,6,6,412,4,272,103019.33333333331,74.0,68.0,2,140,0.0,74.0,70.0
240961.0,6,3,337,2,214,0.0,160.0,107.0,1,123,0.0,123.0,123.0
205959.0,6,3,426,2,280,0.0,214.0,140.0,1,146,0.0,146.0,146.0
28099.0,6,14,4740,7,653,3949.3333333333335,249.0,93.28571428571428,7,4087,4498.5,1514.0,583.8571428571429
118565.0,6,12,1447,6,816,23319.2,291.0,136.0,6,631,21879.6,293.0,105.16666666666669
143851.0,17,2,180,1,90,0.0,90.0,90.0,1,90,0.0,90.0,90.0
305840.0,6,6,412,4,272,101946.66666666669,74.0,68.0,2,140,0.0,74.0,70.0
90051744.0,17,28,13364,28,13364,3335249.777777778,501.0,477.2857142857143,0,0,0.0,0.0,0.0
2002.0,17,4,344,2,150,0.0,75.0,75.0,2,194,0.0,103.0,97.0
95837136.0,17,12,778,6,389,19135235.2,174.0,64.83333333333333,6,389,19062282.6,174.0,64.83333333333333
16890.0,17,2,180,1,90,0.0,90.0,90.0,1,90,0.0,90.0,90.0
311629.0,6,3,202,2,128,0.0,74.0,64.0,1,74,0.0,74.0,74.0
98207292.0,6,28,1992,14,963,7554407.076923077,123.0,68.78571428571429,14,1029,6769621.384615385,123.0,73.5
15876.999999999998,6,13,1459,7,862,2646.1666666666665,271.0,123.14285714285714,6,597,2963.0,259.0,99.5
41269.0,6,14,4740,7,653,6012.166666666667,249.0,93.28571428571428,7,4087,6493.833333333333,1514.0,583.8571428571429
16274.0,6,12,1393,6,796,3025.0,271.0,132.66666666666666,6,597,2553.8,259.0,99.5
0.0,17,1,342,1,342,0.0,342.0,342.0,0,0,0.0,0.0,0.0
90258743.0,6,12,1832,8,1016,12894106.142857144,188.0,127.0,4,816,30031433.0,204.0,204.0
123724.0,6,11,1132,6,556,24112.2,218.0,92.66666666666669,5,576,30675.25,304.0,115.2
108121991.0,17,6,1311,1,306,0.0,306.0,306.0,5,1005,27026274.0,201.0,201.0
31517.000000000004,6,14,4740,7,653,5080.5,249.0,93.28571428571428,7,4087,5118.666666666667,1514.0,583.8571428571429
323299.0,17,4,1400,4,1400,107766.33333333331,350.0,350.0,0,0,0.0,0.0,0.0
197035.0,17,2,180,1,90,0.0,90.0,90.0,1,90,0.0,90.0,90.0
10466197.0,6,6,412,3,206,5164317.5,74.0,68.66666666666667,3,206,5164166.0,74.0,68.66666666666667
75886.0,6,14,4740,7,653,11862.166666666666,249.0,93.28571428571428,7,4087,11569.0,1514.0,583.8571428571429
4431.0,17,2,598,1,72,0.0,72.0,72.0,1,526,0.0,526.0,526.0
2078.0,17,4,344,2,150,0.0,75.0,75.0,2,194,0.0,103.0,97.0
108110081.0,17,5,1005,5,1005,27027520.25,201.0,201.0,0,0,0.0,0.0,0.0
90257376.0,6,12,1832,8,1016,12893910.857142856,188.0,127.0,4,816,30030636.666666668,204.0,204.0
2453.0,17,4,344,2,150,0.0,75.0,75.0,2,194,0.0,103.0,97.0
8857.0,17,2,498,1,80,0.0,80.0,80.0,1,418,0.0,418.0,418.0
153472.0,17,2,180,1,90,0.0,90.0,90.0,1,90,0.0,90.0,90.0
297.0,17,2,164,1,82,0.0,82.0,82.0,1,82,0.0,82.0,82.0
20573.0,6,13,1479,7,882,3355.0,291.0,126.0,6,597,3581.6,259.0,99.5
120007.0,17,2,180,1,70,0.0,70.0,70.0,1,110,0.0,110.0,110.0
135126339.0,17,6,1146,6,1146,27025267.8,191.0,191.0,0,0,0.0,0.0,0.0
245345.0,6,3,337,2,214,0.0,160.0,107.0,1,123,0.0,123.0,123.0
375.0,17,2,164,1,82,0.0,82.0,82.0,1,82,0.0,82.0,82.0
295.0,17,2,156,1,78,0.0,78.0,78.0,1,78,0.0,78.0,78.0
119826898.0,17,35,16705,35,16705,3524320.529411765,501.0,477.2857142857143,0,0,0.0,0.0,0.0
35712.0,6,14,4740,7,653,5635.333333333333,249.0,93.28571428571428,7,4087,5817.833333333333,1514.0,583.8571428571429
9865.0,17,2,571,1,86,0.0,86.0,86.0,1,485,0.0,485.0,485.0
318.0,17,2,174,1,79,0.0,79.0,79.0,1,95,0.0,95.0,95.0
125005808.0,17,15,1169,8,606,17857972.57142857,174.0,75.75,7,563,17500166.5,174.0,80.42857142857143
10643.0,17,2,684,2,684,0.0,342.0,342.0,0,0,0.0,0.0,0.0
135129319.0,17,6,1146,6,1146,27025863.8,191.0,191.0,0,0,0.0,0.0,0.0
11780191.0,17,4,1368,4,1368,3926730.3333333335,342.0,342.0,0,0,0.0,0.0,0.0
207059.0,6,13,1394,7,797,34509.833333333336,253.0,113.85714285714286,6,597,40178.8,259.0,99.5
29537.0,6,13,4416,6,409,5655.2,127.0,68.16666666666667,7,4007,4756.333333333333,1514.0,572.4285714285714
155252.0,6,3,337,2,214,0.0,160.0,107.0,1,123,0.0,123.0,123.0
2357.0,17,4,344,2,150,0.0,75.0,75.0,2,194,0.0,103.0,97.0
2359.0,17,4,344,2,150,0.0,75.0,75.0,2,194,0.0,103.0,97.0
277325.0,17,2,363,1,79,0.0,79.0,79.0,1,284,0.0,284.0,284.0
298453.0,6,6,412,4,272,99484.33333333331,74.0,68.0,2,140,0.0,74.0,70.0
1020686.0,6,12,1362,6,731,202458.4,253.0,121.83333333333331,6,631,203687.6,293.0,105.16666666666669
128706173.0,6,35,2526,17,1194,7420026.0625,123.0,70.23529411764706,18,1332,6983564.647058823,123.0,74.0
2371.0,17,4,344,2,150,0.0,75.0,75.0,2,194,0.0,103.0,97.0
146796.0,6,3,337,2,214,0.0,160.0,107.0,1,123,0.0,123.0,123.0
24026381.0,17,3,1026,3,1026,12013190.5,342.0,342.0,0,0,0.0,0.0,0.0
48353.0,6,14,4740,7,653,7926.0,249.0,93.28571428571428,7,4087,6663.333333333333,1514.0,583.8571428571429
18331.0,6,11,1133,6,602,3666.2,264.0,100.33333333333331,5,531,2580.25,259.0,106.2
503317.0,6,5,336,2,134,0.0,68.0,67.0,3,202,196646.5,70.0,67.33333333333333
2819883.0,6,2,132,1,66,0.0,66.0,66.0,1,66,0.0,66.0,66.0
232946.0,6,3,337,2,214,0.0,160.0,107.0,1,123,0.0,123.0,123.0
2675360.0,6,3,1777,2,951,0.0,885.0,475.5,1,826,0.0,826.0,826.0
108104002.0,17,5,1005,5,1005,27026000.5,201.0,201.0,0,0,0.0,0.0,0.0
2358.0,17,4,344,2,150,0.0,75.0,75.0,2,194,0.0,103.0,97.0
365574.0,6,11,1021,6,444,49710.0,162.0,74.0,5,577,61482.0,349.0,115.4
118775618.0,6,48,3168,24,1584,5164157.304347826,66.0,66.0,24,1584,5150736.173913044,66.0,66.0
91907620.0,6,24,1829,13,989,7658026.083333333,95.0,76.07692307692308,11,840,9189292.2,95.0,76.36363636363636
17181.0,6,14,4740,7,653,2754.0,249.0,93.28571428571428,7,4087,2679.5,1514.0,583.8571428571429
335181.0,6,12,1254,6,648,66803.0,298.0,108.0,6,606,66758.6,260.0,101.0
143926.0,17,2,180,1,90,0.0,90.0,90.0,1,90,0.0,90.0,90.0
316.0,17,2,174,1,79,0.0,79.0,79.0,1,95,0.0,95.0,95.0
2220641.0,6,23,4355,12,1447,201876.45454545456,311.0,120.58333333333331,11,2908,201413.1,1514.0,264.3636363636364
324.0,17,2,174,1,79,0.0,79.0,79.0,1,95,0.0,95.0,95.0
207312.0,6,3,426,2,280,0.0,214.0,140.0,1,146,0.0,146.0,146.0
225599.0,17,2,414,1,88,0.0,88.0,88.0,1,326,0.0,326.0,326.0
249015.0,6,3,337,2,214,0.0,160.0,107.0,1,123,0.0,123.0,123.0
108109648.0,17,5,955,5,955,27027412.0,191.0,191.0,0,0,0.0,0.0,0.0
90290073.0,6,19,1436,10,745,10026830.888888888,95.0,74.5,9,691,11285475.375,95.0,76.77777777777777
41626.0,6,14,4740,7,653,6805.0,249.0,93.28571428571428,7,4087,6802.333333333333,1514.0,583.8571428571429
306198.0,17,2,180,1,90,0.0,90.0,90.0,1,90,0.0,90.0,90.0
315578.0,6,7,478,4,272,105192.66666666669,74.0,68.0,3,206,81638.0,74.0,68.66666666666667
216328.0,17,2,180,1,90,0.0,90.0,90.0,1,90,0.0,90.0,90.0
108106513.0,17,5,955,5,955,27026628.25,191.0,191.0,0,0,0.0,0.0,0.0
10872841.0,6,8,544,4,272,3578942.333333333,74.0,68.0,4,272,3578851.6666666665,74.0,68.0
108116047.0,17,5,1005,5,1005,27029011.75,201.0,201.0,0,0,0.0,0.0,0.0
135134700.0,17,6,1146,6,1146,27026940.0,191.0,191.0,0,0,0.0,0.0,0.0
43107.0,6,14,4740,7,653,6797.833333333333,249.0,93.28571428571428,7,4087,6899.166666666667,1514.0,583.8571428571429
2373.0,17,4,344,2,150,0.0,75.0,75.0,2,194,0.0,103.0,97.0
105148590.0,6,43,2838,22,1452,4992346.333333333,66.0,66.0,21,1386,5150433.45,66.0,66.0
86441.0,6,12,1320,6,723,15773.0,253.0,120.5,6,597,15230.6,259.0,99.5
100062.0,17,2,762,2,762,0.0,381.0,381.0,0,0,0.0,0.0,0.0
315924.0,17,4,1400,4,1400,105308.0,350.0,350.0,0,0,0.0,0.0,0.0
90022629.0,17,28,13364,28,13364,3334171.4444444445,501.0,477.2857142857143,0,0,0.0,0.0,0.0
90093031.0,6,11,1644,4,816,30030501.0,204.0,204.0,7,828,15015104.5,188.0,118.28571428571428
22027.0,6,10,2032,5,524,5166.5,252.0,104.8,5,1508,5325.5,1236.0,301.6
308113.0,6,6,412,4,272,102704.33333333331,74.0,68.0,2,140,0.0,74.0,70.0
2021766.0,17,4,525,2,150,0.0,75.0,75.0,2,375,0.0,284.0,187.5
214782.0,17,2,618,1,82,0.0,82.0,82.0,1,536,0.0,536.0,536.0
56513.0,6,14,4740,7,653,9156.833333333334,249.0,93.28571428571428,7,4087,9112.166666666666,1514.0,583.8571428571429
43568.0,6,14,4740,7,653,6123.166666666667,249.0,93.28571428571428,7,4087,6611.333333333333,1514.0,583.8571428571429
572335.0,17,4,629,3,234,556.5,78.0,78.0,1,395,0.0,395.0,395.0
90562226.0,6,162,18318,81,5568,1121644.6875,140.0,68.74074074074075,81,12750,1121732.975,284.0,157.40740740740742
32842.0,6,14,4740,7,653,5319.833333333333,249.0,93.28571428571428,7,4087,5026.0,1514.0,583.8571428571429
42800.0,6,14,4740,7,653,6970.166666666667,249.0,93.28571428571428,7,4087,6601.666666666667,1514.0,583.8571428571429
23010272.0,17,3,1034,2,684,0.0,342.0,342.0,1,350,0.0,350.0,350.0
315766.0,17,4,1400,4,1400,105255.33333333331,350.0,350.0,0,0,0.0,0.0,0.0
1303413.0,6,4,264,2,132,0.0,66.0,66.0,2,132,0.0,66.0,66.0
53532.0,6,14,4740,7,653,8706.666666666666,249.0,93.28571428571428,7,4087,7477.333333333333,1514.0,583.8571428571429
122978255.0,6,48,3168,24,1584,5003967.391304348,66.0,66.0,24,1584,5263255.347826087,66.0,66.0
251436.0,17,4,6056,4,6056,83811.99999999999,1514.0,1514.0,0,0,0.0,0.0,0.0
319418.0,6,6,412,4,272,106472.66666666669,74.0,68.0,2,140,0.0,74.0,70.0
103878.0,17,2,700,2,700,0.0,350.0,350.0,0,0,0.0,0.0,0.0
100961.0,17,2,286,2,286,0.0,143.0,143.0,0,0,0.0,0.0,0.0
0.0,17,1,347,1,347,0.0,347.0,347.0,0,0,0.0,0.0,0.0
146155.0,6,3,337,2,214,0.0,160.0,107.0,1,123,0.0,123.0,123.0
2438.0,17,4,344,2,150,0.0,75.0,75.0,2,194,0.0,103.0,97.0
91048884.0,17,12,778,6,389,18201183.2,174.0,64.83333333333333,6,389,18200192.2,174.0,64.83333333333333
2600442.0,6,2,132,1,66,0.0,66.0,66.0,1,66,0.0,66.0,66.0
120643459.0,6,31,2097,16,1149,8042897.266666667,123.0,71.8125,15,948,8052699.428571428,123.0,63.2
2651375.0,6,25,7573,14,3735,203951.92307692303,1514.0,266.7857142857143,11,3838,240315.3,1514.0,348.90909090909093
39494.0,6,14,4740,7,653,6450.333333333333,249.0,93.28571428571428,7,4087,6443.5,1514.0,583.8571428571429
204712.0,17,2,762,2,762,0.0,381.0,381.0,0,0,0.0,0.0,0.0
10894371.0,6,8,544,4,272,3586212.333333333,74.0,68.0,4,272,3586148.0,74.0,68.0
125915836.0,17,14,864,7,432,17673984.833333332,174.0,61.71428571428572,7,432,17667579.333333332,174.0,61.71428571428572
5607048.0,6,5,336,2,134,0.0,68.0,67.0,3,202,1423422.5,70.0,67.33333333333333
1499.0,17,2,762,2,762,0.0,381.0,381.0,0,0,0.0,0.0,0.0
147189.0,6,3,373,2,238,0.0,172.0,119.0,1,135,0.0,135.0,135.0
322275.0,17,4,1400,4,1400,107425.0,350.0,350.0,0,0,0.0,0.0,0.0
11109.0,6,13,1459,7,862,1632.0,271.0,123.14285714285714,6,597,2068.6,259.0,99.5
3493152.0,6,200,165143,116,155298,30375.23478260869,1510.0,1338.7758620689656,84,9845,36883.361445783135,1510.0,117.20238095238096
421925.0,6,4,508,2,238,0.0,172.0,119.0,2,270,0.0,135.0,135.0
368.0,17,2,202,1,87,0.0,87.0,87.0,1,115,0.0,115.0,115.0
90255334.0,6,12,1832,8,1016,12893619.142857144,188.0,127.0,4,816,30030577.0,204.0,204.0
1971707.0,6,20,7599,11,1469,197170.7,583.0,133.54545454545453,9,6130,213984.875,1484.0,681.1111111111111
200424.0,17,4,6056,4,6056,66808.0,1514.0,1514.0,0,0,0.0,0.0,0.0
2343.0,17,4,344,2,150,0.0,75.0,75.0,2,194,0.0,103.0,97.0
325837.0,6,10,1221,6,636,65167.4,298.0,106.0,4,585,103147.0,379.0,146.25
104822.0,17,2,700,2,700,0.0,350.0,350.0,0,0,0.0,0.0,0.0
228281.0,17,2,180,1,90,0.0,90.0,90.0,1,90,0.0,90.0,90.0
310498.0,6,6,412,4,272,103499.33333333331,74.0,68.0,2,140,0.0,74.0,70.0
217927.0,6,3,426,2,280,0.0,214.0,140.0,1,146,0.0,146.0,146.0
101438.0,17,2,286,2,286,0.0,143.0,143.0,0,0,0.0,0.0,0.0
77746.0,6,14,4740,7,653,12258.333333333334,249.0,93.28571428571428,7,4087,10632.333333333334,1514.0,583.8571428571429
69162.0,6,10,2032,5,524,17044.5,252.0,104.8,5,1508,13389.75,1236.0,301.6
103651554.0,17,14,864,7,432,17001635.0,174.0,61.71428571428572,7,432,17000180.5,174.0,61.71428571428572
123304816.0,6,48,3168,24,1584,5014151.130434782,66.0,66.0,24,1584,5282558.608695652,66.0,66.0
321.0,17,2,174,1,79,0.0,79.0,79.0,1,95,0.0,95.0,95.0
133950448.0,17,14,864,7,432,19000199.5,174.0,61.71428571428572,7,432,19906152.0,174.0,61.71428571428572
266632.0,6,10,1221,6,636,53326.4,298.0,106.0,4,585,82253.33333333333,379.0,146.25
3245.0,17,2,363,1,79,0.0,79.0,79.0,1,284,0.0,284.0,284.0
10435582.0,6,7,478,4,272,3433015.6666666665,74.0,68.0,3,206,5149420.5,74.0,68.66666666666667
3753.0,17,2,363,1,79,0.0,79.0,79.0,1,284,0.0,284.0,284.0
145938.0,6,3,337,2,214,0.0,160.0,107.0,1,123,0.0,123.0,123.0
50229.0,6,14,4740,7,653,7774.5,249.0,93.28571428571428,7,4087,7640.166666666667,1514.0,583.8571428571429
297883.0,6,6,412,4,272,99294.33333333331,74.0,68.0,2,140,0.0,74.0,70.0
105483047.0,6,29,2068,15,1105,7519086.285714285,139.0,73.66666666666667,14,963,8097478.461538462,123.0,68.78571428571429
50719.0,6,14,4740,7,653,8329.0,249.0,93.28571428571428,7,4087,8163.333333333333,1514.0,583.8571428571429
0.0,6,1,66,1,66,0.0,66.0,66.0,0,0,0.0,0.0,0.0
858617.0,6,9,1267,6,796,171723.4,458.0,132.66666666666666,3,471,293011.0,331.0,157.0
108108897.0,17,5,955,5,955,27027224.25,191.0,191.0,0,0,0.0,0.0,0.0
153415.0,17,2,180,1,90,0.0,90.0,90.0,1,90,0.0,90.0,90.0
120367880.0,6,229,25928,115,18182,1055858.596491228,284.0,158.10434782608695,114,7746,1055999.6017699116,140.0,67.94736842105263
135130611.0,17,6,1206,6,1206,27026122.2,201.0,201.0,0,0,0.0,0.0,0.0
303626.0,6,2,132,1,66,0.0,66.0,66.0,1,66,0.0,66.0,66.0
1182903.0,6,13,3010,8,2382,168986.14285714287,1514.0,297.75,5,628,226745.75,331.0,125.6
4217.0,17,2,614,1,72,0.0,72.0,72.0,1,542,0.0,542.0,542.0
146262.0,6,3,337,2,214,0.0,160.0,107.0,1,123,0.0,123.0,123.0
102445889.0,17,14,864,7,432,17001121.333333332,174.0,61.71428571428572,7,432,17000163.5,174.0,61.71428571428572
35470.0,6,14,4740,7,653,5031.166666666667,249.0,93.28571428571428,7,4087,5759.666666666667,1514.0,583.8571428571429
101648.0,17,2,762,2,762,0.0,381.0,381.0,0,0,0.0,0.0,0.0
307899.0,6,3,202,2,128,0.0,74.0,64.0,1,74,0.0,74.0,74.0
85.0,17,2,762,2,762,0.0,381.0,381.0,0,0,0.0,0.0,0.0
299686.0,6,6,412,4,272,99895.33333333331,74.0,68.0,2,140,0.0,74.0,70.0
124004475.0,17,15,907,8,475,17714925.0,174.0,59.375,7,432,17333498.833333332,174.0,61.71428571428572
135134771.0,17,6,1146,6,1146,27026954.2,191.0,191.0,0,0,0.0,0.0,0.0
14120842.0,6,18,1495,9,921,1727496.375,315.0,102.33333333333331,9,574,1727447.5,78.0,63.77777777777778
90040854.0,17,28,13364,28,13364,3334846.4444444445,501.0,477.2857142857143,0,0,0.0,0.0,0.0
107238027.0,6,44,2904,22,1452,5106572.714285715,66.0,66.0,22,1452,5093460.952380952,66.0,66.0
118451655.0,6,401,52156,201,13488,592258.275,140.0,67.1044776119403,200,38668,594090.9597989949,300.0,193.34
146043.0,6,3,337,2,214,0.0,160.0,107.0,1,123,0.0,123.0,123.0
206147.0,6,3,426,2,280,0.0,214.0,140.0,1,146,0.0,146.0,146.0
308806.0,17,2,180,1,90,0.0,90.0,90.0,1,90,0.0,90.0,90.0
847532.0,6,9,1196,6,725,169506.4,387.0,120.83333333333331,3,471,287510.0,331.0,157.0
108106604.0,17,5,955,5,955,27026651.0,191.0,191.0,0,0,0.0,0.0,0.0
265226.0,6,12,1373,7,714,44204.333333333336,298.0,102.0,5,659,61962.75,379.0,131.8
90061124.0,17,28,13364,28,13364,3335597.185185185,501.0,477.2857142857143,0,0,0.0,0.0,0.0
109218845.0,6,32,2236,16,1165,7281256.333333333,139.0,72.8125,16,1071,7266508.733333333,123.0,66.9375
10473778.0,6,7,478,4,272,3445614.0,74.0,68.0,3,206,5168310.0,74.0,68.66666666666667
16525.0,6,14,4740,7,653,2439.833333333333,249.0,93.28571428571428,7,4087,2509.1666666666665,1514.0,583.8571428571429
310998.0,17,4,622,4,622,103666.0,163.0,155.5,0,0,0.0,0.0,0.0
108106937.0,17,5,955,5,955,27026734.25,191.0,191.0,0,0,0.0,0.0,0.0
144069.0,17,2,180,1,90,0.0,90.0,90.0,1,90,0.0,90.0,90.0
196798.0,17,2,180,1,90,0.0,90.0,90.0,1,90,0.0,90.0,90.0
120001281.0,17,15,1169,8,606,17143040.14285714,174.0,75.75,7,563,17521858.666666668,174.0,80.42857142857143
12293.0,6,13,1459,7,862,1938.0,271.0,123.14285714285714,6,597,2146.4,259.0,99.5
120096284.0,17,28,13364,28,13364,4448010.518518519,501.0,477.2857142857143,0,0,0.0,0.0,0.0
0.0,17,1,55,1,55,0.0,55.0,55.0,0,0,0.0,0.0,0.0
207018.0,17,2,762,2,762,0.0,381.0,381.0,0,0,0.0,0.0,0.0
197007.0,17,2,180,1,90,0.0,90.0,90.0,1,90,0.0,90.0,90.0
108107473.0,17,5,1005,5,1005,27026868.25,201.0,201.0,0,0,0.0,0.0,0.0
144758.0,17,2,180,1,70,0.0,70.0,70.0,1,110,0.0,110.0,110.0
127693767.0,6,34,2419,18,1348,7511398.05882353,139.0,74.88888888888889,16,1071,7982094.2,123.0,66.9375
38795.0,6,14,4740,7,653,5162.5,249.0,93.28571428571428,7,4087,4094.0,1514.0,583.8571428571429
100436079.0,6,28,1992,14,1029,7709247.461538462,123.0,73.5,14,963,7709246.692307692,123.0,68.78571428571429
103120.0,17,2,286,2,286,0.0,143.0,143.0,0,0,0.0,0.0,0.0
298298.0,6,6,412,4,272,99432.66666666669,74.0,68.0,2,140,0.0,74.0,70.0
36550.0,6,14,4740,7,653,4760.333333333333,249.0,93.28571428571428,7,4087,5695.0,1514.0,583.8571428571429
218058.0,6,3,426,2,280,0.0,214.0,140.0,1,146,0.0,146.0,146.0
310.0,17,2,168,1,76,0.0,76.0,76.0,1,92,0.0,92.0,92.0
119087517.0,17,14,864,7,432,19834562.0,174.0,61.71428571428572,7,432,19833549.33333333,174.0,61.71428571428572
1173125.0,6,13,3020,8,2392,167589.2857142857,1514.0,299.0,5,628,224390.0,331.0,125.6
93100402.0,17,14,1126,7,563,15500593.833333334,174.0,80.42857142857143,7,563,15500175.666666666,174.0,80.42857142857143
121355194.0,6,223,25246,112,17624,1093290.036036036,284.0,157.35714285714286,111,7622,1084450.2727272727,140.0,68.66666666666667
239585.0,6,3,337,2,214,0.0,160.0,107.0,1,123,0.0,123.0,123.0
381.0,17,2,188,1,86,0.0,86.0,86.0,1,102,0.0,102.0,102.0
103208487.0,17,14,864,7,432,17166867.0,174.0,61.71428571428572,7,432,17167863.166666668,174.0,61.71428571428572
199816.0,17,4,1524,4,1524,66605.33333333333,381.0,381.0,0,0,0.0,0.0,0.0
0.0,6,1,66,1,66,0.0,66.0,66.0,0,0,0.0,0.0,0.0
305727.0,6,6,412,4,272,101909.0,74.0,68.0,2,140,0.0,74.0,70.0
90057209.0,17,28,13364,28,13364,3335452.185185185,501.0,477.2857142857143,0,0,0.0,0.0,0.0
1028.0,17,2,762,2,762,0.0,381.0,381.0,0,0,0.0,0.0,0.0
124867380.0,17,15,1169,7,563,17529989.0,174.0,80.42857142857143,8,606,17815374.714285713,174.0,75.75
94364829.0,6,40,2640,20,1320,4966569.947368421,66.0,66.0,20,1320,4955194.947368421,66.0,66.0
302368.0,6,2,132,1,66,0.0,66.0,66.0,1,66,0.0,66.0,66.0
90083276.0,6,14,1980,7,1152,15013684.666666666,204.0,164.57142857142858,7,828,14968120.0,188.0,118.28571428571428
2089.0,17,4,344,2,150,0.0,75.0,75.0,2,194,0.0,103.0,97.0
53866907.0,6,24,1584,12,792,4896991.545454546,66.0,66.0,12,792,4872215.363636363,66.0,66.0
302443.0,6,2,132,1,66,0.0,66.0,66.0,1,66,0.0,66.0,66.0
2975.0,17,2,762,2,762,0.0,381.0,381.0,0,0,0.0,0.0,0.0
217616.0,6,3,426,2,280,0.0,214.0,140.0,1,146,0.0,146.0,146.0
45187.0,6,14,4740,7,653,7169.333333333333,249.0,93.28571428571428,7,4087,5948.5,1514.0,583.8571428571429
2079075.0,6,19,6869,11,1567,207907.5,408.0,142.45454545454547,8,5302,234984.57142857145,1514.0,662.75
90530346.0,6,14,2240,8,1016,12932906.57142857,188.0,127.0,6,1224,18072664.4,204.0,204.0
206184.0,6,3,426,2,280,0.0,214.0,140.0,1,146,0.0,146.0,146.0
135136279.0,17,6,1146,6,1146,27027255.8,191.0,191.0,0,0,0.0,0.0,0.0
82.0,17,2,762,2,762,0.0,381.0,381.0,0,0,0.0,0.0,0.0
1062289.0,6,20,6434,12,1921,96571.72727272728,620.0,160.08333333333334,8,4513,125367.42857142857,1514.0,564.125
166821.0,17,2,180,1,90,0.0,90.0,90.0,1,90,0.0,90.0,90.0
80.0,17,2,762,2,762,0.0,381.0,381.0,0,0,0.0,0.0,0.0
51124.0,17,2,180,1,90,0.0,90.0,90.0,1,90,0.0,90.0,90.0
162337.0,17,2,180,1,90,0.0,90.0,90.0,1,90,0.0,90.0,90.0
353991.0,6,4,508,2,238,0.0,172.0,119.0,2,270,0.0,135.0,135.0
318582.0,6,3,202,2,128,0.0,74.0,64.0,1,74,0.0,74.0,74.0
14648644.0,6,19,1717,9,1085,1791982.375,324.0,120.55555555555556,10,632,1592834.0,78.0,63.2
90531069.0,6,14,2240,8,1016,12933009.857142856,188.0,127.0,6,1224,18074024.2,204.0,204.0
90042198.0,17,28,13364,28,13364,3334896.222222222,501.0,477.2857142857143,0,0,0.0,0.0,0.0
319092.0,17,4,1400,4,1400,106364.0,350.0,350.0,0,0,0.0,0.0,0.0
309094.0,17,4,1400,4,1400,103031.33333333331,350.0,350.0,0,0,0.0,0.0,0.0
318.0,17,2,174,1,79,0.0,79.0,79.0,1,95,0.0,95.0,95.0
13224.0,6,11,1133,6,602,2311.8,264.0,100.33333333333331,5,531,2990.0,259.0,106.2
120125113.0,6,13,2020,9,1204,15015639.125,188.0,133.77777777777777,4,816,30031916.33333333,204.0,204.0
45582.0,6,14,4740,7,653,7410.0,249.0,93.28571428571428,7,4087,4306.0,1514.0,583.8571428571429
2807453.0,6,2,132,1,66,0.0,66.0,66.0,1,66,0.0,66.0,66.0
207768.0,6,3,426,2,280,0.0,214.0,140.0,1,146,0.0,146.0,146.0
241924.0,6,3,337,2,214,0.0,160.0,107.0,1,123,0.0,123.0,123.0
114952.0,17,4,1400,4,1400,38317.333333333336,350.0,350.0,0,0,0.0,0.0,0.0
45632.0,6,14,4740,7,653,6765.0,249.0,93.28571428571428,7,4087,7343.5,1514.0,583.8571428571429
90094304.0,6,11,1644,4,816,30030672.33333333,204.0,204.0,7,828,15015067.333333334,188.0,118.28571428571428
321261.0,17,4,1400,4,1400,107087.0,350.0,350.0,0,0,0.0,0.0,0.0
251199.0,6,3,337,2,214,0.0,160.0,107.0,1,123,0.0,123.0,123.0
14639958.0,6,20,1607,10,975,1592518.2222222222,315.0,97.5,10,632,1592496.111111111,78.0,63.2
197619.0,17,2,180,1,90,0.0,90.0,90.0,1,90,0.0,90.0,90.0
209562.0,17,2,180,1,90,0.0,90.0,90.0,1,90,0.0,90.0,90.0
90251999.0,6,14,2240,8,1016,12893142.714285716,188.0,127.0,6,1224,18017662.4,204.0,204.0
24138050.0,17,3,1034,2,684,0.0,342.0,342.0,1,350,0.0,350.0,350.0
44876.0,6,10,2032,5,524,10993.75,252.0,104.8,5,1508,10888.75,1236.0,301.6
120326614.0,6,259,29258,130,20448,932764.449612403,284.0,157.2923076923077,129,8810,931964.140625,140.0,68.29457364341086
90258381.0,6,14,2240,8,1016,12894054.42857143,188.0,127.0,6,1224,18018671.6,204.0,204.0
13485.0,6,10,2032,5,524,3103.0,252.0,104.8,5,1508,2405.0,1236.0,301.6
673290.0,6,10,1065,5,534,167206.25,262.0,106.8,5,531,167955.0,259.0,106.2
111674766.0,6,32,2220,16,1149,7444984.4,123.0,71.8125,16,1071,7430421.066666666,123.0,66.9375
10471085.0,6,7,478,4,272,3444952.333333333,74.0,68.0,3,206,5167335.5,74.0,68.66666666666667
102688840.0,17,14,864,7,432,17000183.833333332,174.0,61.71428571428572,7,432,17001811.166666668,174.0,61.71428571428572
383900.0,17,2,363,1,75,0.0,75.0,75.0,1,288,0.0,288.0,288.0
10482218.0,6,7,478,4,272,3448659.333333333,74.0,68.0,3,206,5172896.5,74.0,68.66666666666667
125001171.0,17,15,907,8,475,17857310.14285714,174.0,59.375,7,432,17501001.833333332,174.0,61.71428571428572
153569.0,17,2,180,1,90,0.0,90.0,90.0,1,90,0.0,90.0,90.0
122687953.0,6,49,3234,25,1650,5111998.041666667,66.0,66.0,24,1584,5064911.565217392,66.0,66.0
110170209.0,17,14,864,7,432,18335482.83333333,174.0,61.71428571428572,7,432,18333494.33333333,174.0,61.71428571428572
96183212.0,6,64,14462,33,6731,3005725.375,1514.0,203.96969696969697,31,7731,3197116.7,1514.0,249.3870967741936
346246.0,6,12,1373,7,714,57707.66666666666,298.0,102.0,5,659,82542.5,379.0,131.8
2793757.0,6,2,132,1,66,0.0,66.0,66.0,1,66,0.0,66.0,66.0
154006.0,17,2,414,1,88,0.0,88.0,88.0,1,326,0.0,326.0,326.0
210569.0,17,2,414,1,88,0.0,88.0,88.0,1,326,0.0,326.0,326.0
100796652.0,6,31,2314,16,1228,6705375.333333333,139.0,76.75,15,1086,7184329.5,123.0,72.4
117344816.0,17,14,864,7,432,19500154.666666668,174.0,61.71428571428572,7,432,19500828.5,174.0,61.71428571428572
120804.0,6,3,337,2,214,0.0,160.0,107.0,1,123,0.0,123.0,123.0
108106030.0,17,5,955,5,955,27026507.5,191.0,191.0,0,0,0.0,0.0,0.0
321.0,17,2,174,1,79,0.0,79.0,79.0,1,95,0.0,95.0,95.0
1188487.0,6,13,3010,8,2382,169783.85714285713,1514.0,297.75,5,628,228196.75,331.0,125.6
2826718.0,6,11,2106,6,598,565138.4,252.0,99.66666666666669,5,1508,2077.5,1236.0,301.6
90051166.0,17,28,13364,28,13364,3335228.3703703703,501.0,477.2857142857143,0,0,0.0,0.0,0.0
314371.0,6,6,412,4,272,104790.33333333331,74.0,68.0,2,140,0.0,74.0,70.0
112902314.0,17,16,1212,8,606,16106200.42857143,174.0,75.75,8,606,15966007.285714284,174.0,75.75
120083221.0,17,28,13364,28,13364,4447526.703703703,501.0,477.2857142857143,0,0,0.0,0.0,0.0
59580.0,6,10,2032,5,524,14645.5,252.0,104.8,5,1508,13954.5,1236.0,301.6
110182521.0,17,13,1083,6,520,22004712.4,174.0,86.66666666666667,7,563,18337264.83333333,174.0,80.42857142857143
95945465.0,6,26,2343,15,1503,6849938.571428572,257.0,100.2,11,840,9593332.9,95.0,76.36363636363636
21797.0,6,10,2032,5,524,5162.5,252.0,104.8,5,1508,5018.75,1236.0,301.6
92231242.0,6,22,1578,10,735,10247305.666666666,95.0,73.5,12,843,8383740.272727272,95.0,70.25
177281.0,17,2,180,1,90,0.0,90.0,90.0,1,90,0.0,90.0,90.0
205815.0,17,2,180,1,90,0.0,90.0,90.0,1,90,0.0,90.0,90.0
230524.0,17,2,180,1,90,0.0,90.0,90.0,1,90,0.0,90.0,90.0
312334.0,6,6,412,4,272,104111.33333333331,74.0,68.0,2,140,0.0,74.0,70.0
90015881.0,17,28,13364,28,13364,3333921.5185185187,501.0,477.2857142857143,0,0,0.0,0.0,0.0
27801.0,6,14,4740,7,653,4461.166666666667,249.0,93.28571428571428,7,4087,4495.0,1514.0,583.8571428571429
64823.00000000001,6,14,4740,7,653,10643.166666666666,249.0,93.28571428571428,7,4087,10059.833333333334,1514.0,583.8571428571429
2592268.0,6,2,132,1,66,0.0,66.0,66.0,1,66,0.0,66.0,66.0
3121092.0,6,3,1604,1,753,0.0,753.0,753.0,2,851,0.0,785.0,425.5
121364.0,6,3,337,2,214,0.0,160.0,107.0,1,123,0.0,123.0,123.0
14974.0,6,14,4740,7,653,2385.1666666666665,249.0,93.28571428571428,7,4087,2360.333333333333,1514.0,583.8571428571429
3172824.0,6,17,1482,8,908,409445.0,315.0,113.5,9,574,358239.125,78.0,63.77777777777778
233973.0,6,3,373,2,238,0.0,172.0,119.0,1,135,0.0,135.0,135.0
90914474.0,17,17,5814,17,5814,5682154.625,342.0,342.0,0,0,0.0,0.0,0.0
108115055.0,17,5,1005,5,1005,27028763.75,201.0,201.0,0,0,0.0,0.0,0.0
178441.0,17,4,704,2,148,0.0,74.0,74.0,2,556,0.0,280.0,278.0
120049882.0,17,29,13785,29,13785,4287495.785714285,501.0,475.3448275862069,0,0,0.0,0.0,0.0
90117487.0,6,10,1440,7,828,15019581.166666666,188.0,118.28571428571428,3,612,30031536.0,204.0,204.0
233100.0,6,3,337,2,214,0.0,160.0,107.0,1,123,0.0,123.0,123.0
10532170.0,6,7,478,4,272,3463692.333333333,74.0,68.0,3,206,5195395.5,74.0,68.66666666666667
102011593.0,17,13,821,7,432,17001932.166666668,174.0,61.71428571428572,6,389,16400167.8,174.0,64.83333333333333
2048920.0,17,8,1640,4,312,682841.3333333333,78.0,78.0,4,1328,682840.0,332.0,332.0
135128716.0,17,6,1206,6,1206,27025743.2,201.0,201.0,0,0,0.0,0.0,0.0
166491.0,17,2,180,1,90,0.0,90.0,90.0,1,90,0.0,90.0,90.0
44468.0,6,13,1386,7,789,5676.5,253.0,112.71428571428572,6,597,7680.8,259.0,99.5
21920.0,6,11,1133,6,602,4259.8,264.0,100.33333333333331,5,531,3345.0,259.0,106.2
3049627.0,6,133,101531,73,93269,42355.93055555556,1510.0,1277.657534246575,60,8262,46457.35593220339,1510.0,137.7
317484.0,17,4,1400,4,1400,105828.0,350.0,350.0,0,0,0.0,0.0,0.0
135123269.0,17,6,1146,6,1146,27024653.8,191.0,191.0,0,0,0.0,0.0,0.0
90352836.0,6,12,1848,7,828,15058806.0,188.0,118.28571428571428,5,1020,15082514.25,204.0,204.0
109900931.0,6,34,2482,17,1288,6868808.1875,139.0,75.76470588235294,17,1194,6855298.0,123.0,70.23529411764706
22291.0,6,14,4740,7,653,3432.833333333333,249.0,93.28571428571428,7,4087,3470.6666666666665,1514.0,583.8571428571429
102918.0,17,2,286,2,286,0.0,143.0,143.0,0,0,0.0,0.0,0.0
194344.0,17,2,180,1,90,0.0,90.0,90.0,1,90,0.0,90.0,90.0
16871.0,17,2,180,1,90,0.0,90.0,90.0,1,90,0.0,90.0,90.0
139048.0,6,2,132,1,66,0.0,66.0,66.0,1,66,0.0,66.0,66.0
217508.0,6,3,426,2,280,0.0,214.0,140.0,1,146,0.0,146.0,146.0
39145.0,6,10,1065,5,534,9599.0,262.0,106.8,5,531,8537.5,259.0,106.2
42047.0,6,13,1386,7,789,6330.666666666667,253.0,112.71428571428572,6,597,7529.0,259.0,99.5
36221.0,6,14,4740,7,653,5926.666666666667,249.0,93.28571428571428,7,4087,4743.0,1514.0,583.8571428571429
120064395.0,17,28,13364,28,13364,4446829.444444444,501.0,477.2857142857143,0,0,0.0,0.0,0.0
90057544.0,17,28,13364,28,13364,3335464.592592593,501.0,477.2857142857143,0,0,0.0,0.0,0.0
16259.0,6,12,1393,6,796,2851.2,271.0,132.66666666666666,6,597,2853.0,259.0,99.5
48289.0,6,14,4740,7,653,7201.166666666667,249.0,93.28571428571428,7,4087,7735.833333333333,1514.0,583.8571428571429
232154.0,6,3,337,2,214,0.0,160.0,107.0,1,123,0.0,123.0,123.0
90254882.0,6,13,2036,8,1016,12893554.57142857,188.0,127.0,5,1020,22523231.25,204.0,204.0
266092.0,17,2,180,1,90,0.0,90.0,90.0,1,90,0.0,90.0,90.0
10466947.0,6,7,478,4,272,3443697.0,74.0,68.0,3,206,5165416.5,74.0,68.66666666666667
302472.0,6,2,132,1,66,0.0,66.0,66.0,1,66,0.0,66.0,66.0
206734.0,6,3,426,2,280,0.0,214.0,140.0,1,146,0.0,146.0,146.0
216857.0,6,3,426,2,280,0.0,214.0,140.0,1,146,0.0,146.0,146.0
38066.0,6,14,4740,7,653,5272.5,249.0,93.28571428571428,7,4087,6206.5,1514.0,583.8571428571429
54801.0,6,14,4740,7,653,8656.333333333334,249.0,93.28571428571428,7,4087,8946.333333333334,1514.0,583.8571428571429
2499.0,17,4,344,2,150,0.0,75.0,75.0,2,194,0.0,103.0,97.0
1096053.0,6,13,1386,7,789,182675.5,253.0,112.71428571428572,6,597,217433.0,259.0,99.5
0.0,17,1,80,1,80,0.0,80.0,80.0,0,0,0.0,0.0,0.0
18706.0,6,14,4740,7,653,3010.6666666666665,249.0,93.28571428571428,7,4087,2693.1666666666665,1514.0,583.8571428571429
143154.0,6,2,132,1,66,0.0,66.0,66.0,1,66,0.0,66.0,66.0
38503.0,6,14,4740,7,653,6225.333333333333,249.0,93.28571428571428,7,4087,6276.833333333333,1514.0,583.8571428571429
116651753.0,6,194,21998,97,15300,1212877.34375,284.0,157.7319587628866,97,6698,1212881.5520833333,140.0,69.05154639175258
216399.0,17,2,180,1,90,0.0,90.0,90.0,1,90,0.0,90.0,90.0
2726.0,17,4,344,2,150,0.0,75.0,75.0,2,194,0.0,103.0,97.0
2067491.0,6,24,7544,13,2516,172290.91666666666,1034.0,193.53846153846155,11,5028,176508.9,1510.0,457.09090909090907
3127933.0,6,3,1777,2,951,0.0,885.0,475.5,1,826,0.0,826.0,826.0
2054.0,17,4,344,2,150,0.0,75.0,75.0,2,194,0.0,103.0,97.0
2022085.0,17,4,525,2,150,0.0,75.0,75.0,2,375,0.0,284.0,187.5
3194760.0,6,3,1604,1,753,0.0,753.0,753.0,2,851,0.0,785.0,425.5
578582.0,6,4,508,2,238,0.0,172.0,119.0,2,270,0.0,135.0,135.0
322582.0,6,6,412,4,272,107527.33333333331,74.0,68.0,2,140,0.0,74.0,70.0
322267.0,17,4,1400,4,1400,107422.33333333331,350.0,350.0,0,0,0.0,0.0,0.0
41461.0,6,14,4740,7,653,6324.0,249.0,93.28571428571428,7,4087,6403.5,1514.0,583.8571428571429
113618280.0,6,48,3168,24,1584,4939925.217391305,66.0,66.0,24,1584,4935648.347826087,66.0,66.0
103393.0,17,2,286,2,286,0.0,143.0,143.0,0,0,0.0,0.0,0.0
2993522.0,6,4,264,4,264,997840.6666666666,66.0,66.0,0,0,0.0,0.0,0.0
90037604.0,17,28,13364,28,13364,3334726.074074074,501.0,477.2857142857143,0,0,0.0,0.0,0.0
90011177.0,17,28,13364,28,13364,3333747.296296296,501.0,477.2857142857143,0,0,0.0,0.0,0.0
97452408.0,17,12,778,6,389,19401126.8,174.0,64.83333333333333,6,389,19400170.2,174.0,64.83333333333333
15561148.0,6,7,499,4,301,3895968.6666666665,103.0,75.25,3,198,6633786.5,66.0,66.0
110200478.0,6,27,1806,14,966,8460356.76923077,123.0,69.0,13,840,9165241.916666666,123.0,64.61538461538461
2659347.0,6,28,9195,16,3843,177289.8,1514.0,240.1875,12,5352,217999.0909090909,1514.0,446.0
233852.0,6,3,373,2,238,0.0,172.0,119.0,1,135,0.0,135.0,135.0
290863.0,6,12,1373,7,714,48477.16666666666,298.0,102.0,5,659,67303.25,379.0,131.8
90090326.0,6,11,1644,7,828,15015054.333333334,188.0,118.28571428571428,4,816,20020729.666666668,204.0,204.0
0.0,17,1,381,1,381,0.0,381.0,381.0,0,0,0.0,0.0,0.0
91004491.0,17,14,1126,7,563,15167415.166666666,174.0,80.42857142857143,7,563,15000128.833333334,174.0,80.42857142857143
304958.0,17,2,604,1,75,0.0,75.0,75.0,1,529,0.0,529.0,529.0
48414.0,6,13,1394,7,797,7958.0,253.0,113.85714285714286,6,597,8057.2,259.0,99.5
791.0,17,4,438,2,148,0.0,74.0,74.0,2,290,0.0,147.0,145.0
2408.0,17,4,344,2,150,0.0,75.0,75.0,2,194,0.0,103.0,97.0
9407.0,17,2,582,1,83,0.0,83.0,83.0,1,499,0.0,499.0,499.0
311078.0,6,3,202,2,128,0.0,74.0,64.0,1,74,0.0,74.0,74.0
224320.0,6,3,426,2,280,0.0,214.0,140.0,1,146,0.0,146.0,146.0
5826528.0,6,4,270,2,134,0.0,68.0,67.0,2,136,0.0,70.0,68.0
13232.0,6,11,1131,6,600,2183.8,262.0,100.0,5,531,2965.0,259.0,106.2
32446.000000000004,6,10,2032,5,524,7468.75,252.0,104.8,5,1508,7831.25,1236.0,301.6
149081906.0,6,20,1490,11,840,14908190.6,95.0,76.36363636363636,9,650,14911721.0,95.0,72.22222222222223
117028816.0,6,48,3168,24,1584,5088209.391304348,66.0,66.0,24,1584,5074536.260869565,66.0,66.0
534202.0,6,6,758,3,410,253893.5,172.0,136.66666666666666,3,348,194771.0,135.0,116.0
61986.0,6,14,4740,7,653,10100.0,249.0,93.28571428571428,7,4087,9948.0,1514.0,583.8571428571429
245657.0,6,3,354,2,288,0.0,222.0,144.0,1,66,0.0,66.0,66.0
36322.0,6,14,4740,7,653,5885.0,249.0,93.28571428571428,7,4087,5403.833333333333,1514.0,583.8571428571429
110929.0,17,2,762,2,762,0.0,381.0,381.0,0,0,0.0,0.0,0.0
213738.0,6,10,1221,6,636,42747.6,298.0,106.0,4,585,68847.33333333333,379.0,146.25
2902123.0,6,2,132,1,66,0.0,66.0,66.0,1,66,0.0,66.0,66.0
30105794.0,6,4,270,3,202,15052897.0,70.0,67.33333333333333,1,68,0.0,68.0,68.0
147286531.0,6,22,1680,11,840,11751012.7,95.0,76.36363636363636,11,840,14727432.3,95.0,76.36363636363636
17954.0,6,10,2032,5,524,4230.75,252.0,104.8,5,1508,3895.25,1236.0,301.6
314913.0,6,6,412,4,272,104971.0,74.0,68.0,2,140,0.0,74.0,70.0
1094098.0,6,13,1479,7,882,182349.66666666663,291.0,126.0,6,597,216062.0,259.0,99.5
101891.0,17,2,700,2,700,0.0,350.0,350.0,0,0,0.0,0.0,0.0
318.0,17,2,174,1,79,0.0,79.0,79.0,1,95,0.0,95.0,95.0
108099267.0,17,5,955,5,955,27024816.75,191.0,191.0,0,0,0.0,0.0,0.0
114185040.0,6,30,1974,15,1026,8140671.785714285,123.0,68.4,15,948,8140670.928571428,123.0,63.2
121289.0,6,3,337,2,214,0.0,160.0,107.0,1,123,0.0,123.0,123.0
209418.0,17,2,180,1,90,0.0,90.0,90.0,1,90,0.0,90.0,90.0
240395.0,6,3,337,2,214,0.0,160.0,107.0,1,123,0.0,123.0,123.0
388.0,17,2,762,2,762,0.0,381.0,381.0,0,0,0.0,0.0,0.0
354250.0,17,4,704,2,148,0.0,74.0,74.0,2,556,0.0,280.0,278.0
90059384.0,17,27,12943,27,12943,3463822.461538461,501.0,479.3703703703704,0,0,0.0,0.0,0.0
120124600.0,6,14,2240,6,1224,24024920.0,204.0,204.0,8,1016,17137233.714285713,188.0,127.0
240485.0,6,3,337,2,214,0.0,160.0,107.0,1,123,0.0,123.0,123.0
907501.0,6,10,1162,6,625,181500.2,287.0,104.16666666666669,4,537,210679.66666666663,331.0,134.25
121426.0,6,3,337,2,214,0.0,160.0,107.0,1,123,0.0,123.0,123.0
319951.0,17,4,1400,4,1400,106650.33333333331,350.0,350.0,0,0,0.0,0.0,0.0
55548.0,6,10,2032,5,524,13082.0,252.0,104.8,5,1508,13630.25,1236.0,301.6
78646.0,6,14,4740,7,653,12571.0,249.0,93.28571428571428,7,4087,10634.166666666666,1514.0,583.8571428571429
107632.0,17,2,286,2,286,0.0,143.0,143.0,0,0,0.0,0.0,0.0
54354.0,6,14,4740,7,653,7714.833333333333,249.0,93.28571428571428,7,4087,8265.833333333334,1514.0,583.8571428571429
366.0,17,2,202,1,87,0.0,87.0,87.0,1,115,0.0,115.0,115.0
121128094.0,6,224,25328,112,7614,1074562.027027027,140.0,67.98214285714286,112,17714,1083804.3873873877,284.0,158.16071428571428
250042.0,17,4,6056,4,6056,83347.33333333333,1514.0,1514.0,0,0,0.0,0.0,0.0
306984.0,6,6,412,4,272,102328.0,74.0,68.0,2,140,0.0,74.0,70.0
48876.0,6,14,4740,7,653,7248.833333333333,249.0,93.28571428571428,7,4087,5622.666666666667,1514.0,583.8571428571429
24373.0,6,14,4740,7,653,3938.6666666666665,249.0,93.28571428571428,7,4087,3929.5,1514.0,583.8571428571429
19879751.0,17,6,9084,6,9084,3975950.2,1514.0,1514.0,0,0,0.0,0.0,0.0
21843.0,6,14,4740,7,653,3469.333333333333,249.0,93.28571428571428,7,4087,3481.5,1514.0,583.8571428571429
9684.0,17,4,344,2,150,0.0,75.0,75.0,2,194,0.0,103.0,97.0
23209.0,6,14,4740,7,653,3758.1666666666665,249.0,93.28571428571428,7,4087,3153.1666666666665,1514.0,583.8571428571429
0.0,17,1,347,1,347,0.0,347.0,347.0,0,0,0.0,0.0,0.0
102856.0,17,2,286,2,286,0.0,143.0,143.0,0,0,0.0,0.0,0.0
143888.0,17,2,180,1,90,0.0,90.0,90.0,1,90,0.0,90.0,90.0
6847.0,17,2,582,1,83,0.0,83.0,83.0,1,499,0.0,499.0,499.0
120124950.0,6,18,2776,9,1572,15015618.75,204.0,174.66666666666666,9,1204,14965973.875,188.0,133.77777777777777
161737.0,6,3,337,2,214,0.0,160.0,107.0,1,123,0.0,123.0,123.0
108101227.0,17,5,1005,5,1005,27025306.75,201.0,201.0,0,0,0.0,0.0,0.0
146147.0,6,3,337,2,214,0.0,160.0,107.0,1,123,0.0,123.0,123.0
92358973.0,17,14,4788,14,4788,7104536.384615385,342.0,342.0,0,0,0.0,0.0,0.0
2804106.0,6,2,132,1,66,0.0,66.0,66.0,1,66,0.0,66.0,66.0
1317.0,17,4,438,2,148,0.0,74.0,74.0,2,290,0.0,147.0,145.0
10917.0,17,4,823,2,163,0.0,89.0,81.5,2,660,0.0,443.0,330.0
205796.0,6,3,426,2,280,0.0,214.0,140.0,1,146,0.0,146.0,146.0
2594576.0,6,2,132,1,66,0.0,66.0,66.0,1,66,0.0,66.0,66.0
81304.0,6,14,4740,7,653,12589.5,249.0,93.28571428571428,7,4087,11452.833333333334,1514.0,583.8571428571429
216534.0,6,3,426,2,280,0.0,214.0,140.0,1,146,0.0,146.0,146.0
14637796.0,6,20,1607,10,975,1592350.888888889,315.0,97.5,10,632,1592325.4444444445,78.0,63.2
269292.0,6,10,1221,6,636,53858.4,298.0,106.0,4,585,82192.33333333333,379.0,146.25
285960.0,17,2,363,1,79,0.0,79.0,79.0,1,284,0.0,284.0,284.0
216536.0,17,2,180,1,90,0.0,90.0,90.0,1,90,0.0,90.0,90.0
284077.0,17,2,363,1,79,0.0,79.0,79.0,1,284,0.0,284.0,284.0
305798.0,6,6,412,4,272,101932.66666666669,74.0,68.0,2,140,0.0,74.0,70.0
175502.0,17,2,414,1,88,0.0,88.0,88.0,1,326,0.0,326.0,326.0
247136.0,17,2,180,1,90,0.0,90.0,90.0,1,90,0.0,90.0,90.0
763.0,17,4,438,2,148,0.0,74.0,74.0,2,290,0.0,147.0,145.0
46192.0,6,14,4740,7,653,7288.333333333333,249.0,93.28571428571428,7,4087,7408.0,1514.0,583.8571428571429
41638.0,6,14,4740,7,653,5644.166666666667,249.0,93.28571428571428,7,4087,6703.666666666667,1514.0,583.8571428571429
1031590.0,6,11,1134,6,558,206318.0,220.0,93.0,5,576,256310.5,304.0,115.2
2247.0,17,2,664,1,322,0.0,322.0,322.0,1,342,0.0,342.0,342.0
243830.0,6,3,337,2,214,0.0,160.0,107.0,1,123,0.0,123.0,123.0
118474467.0,6,236,27020,118,18936,1010763.641025641,284.0,160.47457627118644,118,8084,1010764.0170940172,140.0,68.50847457627118
9171.0,17,2,582,1,83,0.0,83.0,83.0,1,499,0.0,499.0,499.0
99339385.0,6,30,2260,16,1228,6608989.666666667,139.0,76.75,14,1032,7625758.384615385,123.0,73.71428571428571
143906.0,17,2,180,1,90,0.0,90.0,90.0,1,90,0.0,90.0,90.0
246145.0,6,3,337,2,214,0.0,160.0,107.0,1,123,0.0,123.0,123.0
5736265.0,6,5,336,2,134,0.0,68.0,67.0,3,202,1533499.0,70.0,67.33333333333333
228193.0,17,2,180,1,90,0.0,90.0,90.0,1,90,0.0,90.0,90.0
27105153.0,17,5,1710,5,1710,6776288.25,342.0,342.0,0,0,0.0,0.0,0.0
100313109.0,6,32,2644,18,1474,5900771.117647059,139.0,81.88888888888889,14,1170,7699657.923076923,123.0,83.57142857142857
110518142.0,6,30,1974,15,1026,7878733.928571428,123.0,68.4,15,948,7878712.357142857,123.0,63.2
813.0,17,4,438,2,148,0.0,74.0,74.0,2,290,0.0,147.0,145.0
42304.0,6,10,2032,5,524,10303.75,252.0,104.8,5,1508,9775.75,1236.0,301.6
42026.0,6,14,4740,7,653,6893.0,249.0,93.28571428571428,7,4087,6745.666666666667,1514.0,583.8571428571429
92880233.0,6,38,2508,19,1254,5159999.222222222,66.0,66.0,19,1254,5159999.444444444,66.0,66.0
108980914.0,6,28,1876,14,982,8366536.769230769,139.0,70.14285714285714,14,894,8366543.230769231,123.0,63.85714285714285
2635883.0,6,25,7573,14,3735,202760.2307692308,1514.0,266.7857142857143,11,3838,238185.9,1514.0,348.90909090909093
47354.0,6,14,4740,7,653,7717.0,249.0,93.28571428571428,7,4087,7684.666666666667,1514.0,583.8571428571429
206145.0,17,2,180,1,90,0.0,90.0,90.0,1,90,0.0,90.0,90.0
237153.0,6,3,373,2,238,0.0,172.0,119.0,1,135,0.0,135.0,135.0
303675.0,6,2,132,1,66,0.0,66.0,66.0,1,66,0.0,66.0,66.0
213714.0,17,2,180,1,90,0.0,90.0,90.0,1,90,0.0,90.0,90.0
135133282.0,17,6,1206,6,1206,27026656.4,201.0,201.0,0,0,0.0,0.0,0.0
34584.0,6,10,2032,5,524,7690.5,252.0,104.8,5,1508,7872.75,1236.0,301.6
10478635.0,6,7,478,4,272,3447432.6666666665,74.0,68.0,3,206,5171054.0,74.0,68.66666666666667
118582725.0,6,222,25090,111,17468,1076067.6454545455,284.0,157.36936936936937,111,7622,1076067.990909091,140.0,68.66666666666667
108092416.0,17,5,955,5,955,27023104.0,191.0,191.0,0,0,0.0,0.0,0.0
216403.0,17,2,180,1,90,0.0,90.0,90.0,1,90,0.0,90.0,90.0
14749.0,6,10,2032,5,524,3456.25,252.0,104.8,5,1508,3464.0,1236.0,301.6
98984.0,17,2,762,2,762,0.0,381.0,381.0,0,0,0.0,0.0,0.0
108235.0,17,2,286,2,286,0.0,143.0,143.0,0,0,0.0,0.0,0.0
115463221.0,6,220,24868,110,17312,1057321.7064220184,284.0,157.38181818181818,110,7556,1057321.513761468,140.0,68.69090909090909
90300164.0,6,16,1192,8,596,12892867.0,95.0,74.5,8,596,12898380.857142856,95.0,74.5
744149.0,6,6,758,3,410,348839.0,172.0,136.66666666666666,3,348,254937.0,135.0,116.0
90208668.0,6,16,1192,8,596,12852903.0,95.0,74.5,8,596,12857687.42857143,95.0,74.5
216769.0,17,2,180,1,90,0.0,90.0,90.0,1,90,0.0,90.0,90.0
247083.0,6,3,373,2,238,0.0,172.0,119.0,1,135,0.0,135.0,135.0
120080184.0,17,29,13785,29,13785,4288578.0,501.0,475.3448275862069,0,0,0.0,0.0,0.0
1033419.0,6,11,1134,6,558,206683.8,220.0,93.0,5,576,257212.25,304.0,115.2
90255273.0,6,16,2368,9,1204,11281909.125,188.0,133.77777777777777,7,1164,15015668.833333334,204.0,166.28571428571428
307981.0,6,6,412,4,272,102660.33333333331,74.0,68.0,2,140,0.0,74.0,70.0
108104486.0,17,5,955,5,955,27026121.5,191.0,191.0,0,0,0.0,0.0,0.0
103867.0,17,2,286,2,286,0.0,143.0,143.0,0,0,0.0,0.0,0.0
3776618.0,6,168,134149,95,125029,40176.78723404255,1510.0,1316.0947368421052,73,9120,48147.80555555556,1510.0,124.93150684931508
122530403.0,6,49,3234,25,1650,5105433.458333333,66.0,66.0,24,1584,4976981.782608695,66.0,66.0
19639.0,6,10,2032,5,524,4608.25,252.0,104.8,5,1508,4349.25,1236.0,301.6
90044046.0,17,28,13364,28,13364,3334964.6666666665,501.0,477.2857142857143,0,0,0.0,0.0,0.0
99620825.0,17,12,778,6,389,19837861.2,174.0,64.83333333333333,6,389,19892378.0,174.0,64.83333333333333
322188.0,17,4,1400,4,1400,107396.0,350.0,350.0,0,0,0.0,0.0,0.0
62937.99999999999,6,10,2032,5,524,15519.5,252.0,104.8,5,1508,11927.25,1236.0,301.6
56937.0,6,12,1362,6,731,9685.8,253.0,121.83333333333331,6,631,10205.8,293.0,105.16666666666669
303803.0,6,6,412,4,272,101267.66666666669,74.0,68.0,2,140,0.0,74.0,70.0
316887.0,17,4,1400,4,1400,105629.0,350.0,350.0,0,0,0.0,0.0,0.0
645338.0,6,2,132,1,66,0.0,66.0,66.0,1,66,0.0,66.0,66.0
308462.0,6,6,412,4,272,102820.66666666669,74.0,68.0,2,140,0.0,74.0,70.0
299654.0,6,6,412,4,272,99884.66666666669,74.0,68.0,2,140,0.0,74.0,70.0
322439.0,17,4,1400,4,1400,107479.66666666669,350.0,350.0,0,0,0.0,0.0,0.0
31472.0,6,10,2032,5,524,7514.25,252.0,104.8,5,1508,7491.25,1236.0,301.6
120143903.0,6,288,34396,144,9800,838483.972027972,140.0,68.05555555555556,144,24596,834400.0909090909,284.0,170.80555555555554
0.0,17,1,179,1,179,0.0,179.0,179.0,0,0,0.0,0.0,0.0
95323109.0,17,14,1126,7,563,15833998.5,174.0,80.42857142857143,7,563,15833467.166666666,174.0,80.42857142857143
120628953.0,6,216,24312,108,7424,1119674.2523364483,140.0,68.74074074074075,108,16888,1125500.401869159,284.0,156.37037037037038
217686.0,6,3,426,2,280,0.0,214.0,140.0,1,146,0.0,146.0,146.0
90803511.0,6,163,18272,82,5634,1121031.0,140.0,68.70731707317073,81,12638,1122034.1875,284.0,156.02469135802468
153459.0,17,2,180,1,90,0.0,90.0,90.0,1,90,0.0,90.0,90.0
90535493.0,6,13,2036,8,1016,12933641.857142856,188.0,127.0,5,1020,22591719.5,204.0,204.0
102548.0,17,2,286,2,286,0.0,143.0,143.0,0,0,0.0,0.0,0.0
867973.0,6,10,1333,6,796,173594.6,458.0,132.66666666666666,4,537,198388.3333333333,331.0,134.25
39935.0,6,14,4740,7,653,6453.5,249.0,93.28571428571428,7,4087,6111.166666666667,1514.0,583.8571428571429
9301.0,17,2,582,1,83,0.0,83.0,83.0,1,499,0.0,499.0,499.0
90298820.0,6,22,1680,12,935,8204845.363636363,95.0,77.91666666666667,10,745,10002081.666666666,95.0,74.5
10531228.0,6,7,478,4,272,3463881.333333333,74.0,68.0,3,206,5195715.0,74.0,68.66666666666667
63986.0,6,10,2032,5,524,7861.75,252.0,104.8,5,1508,15719.0,1236.0,301.6
136702.0,17,6,1230,3,234,68167.5,78.0,78.0,3,996,68142.5,332.0,332.0
307204.0,6,6,412,4,272,102401.33333333331,74.0,68.0,2,140,0.0,74.0,70.0
108103674.0,17,5,1005,5,1005,27025918.5,201.0,201.0,0,0,0.0,0.0,0.0
298531.0,6,6,412,4,272,99510.33333333331,74.0,68.0,2,140,0.0,74.0,70.0
7279.0,17,4,823,2,163,0.0,89.0,81.5,2,660,0.0,443.0,330.0
16841.0,17,2,180,1,90,0.0,90.0,90.0,1,90,0.0,90.0,90.0
508714.0,6,5,336,2,134,0.0,68.0,67.0,3,202,193276.0,70.0,67.33333333333333
5623861.0,6,4,270,2,134,0.0,68.0,67.0,2,136,0.0,70.0,68.0
45189.0,6,14,4740,7,653,6878.666666666667,249.0,93.28571428571428,7,4087,7296.5,1514.0,583.8571428571429
108107180.0,17,5,1005,5,1005,27026795.0,201.0,201.0,0,0,0.0,0.0,0.0
40602.0,6,10,2032,5,524,9832.5,252.0,104.8,5,1508,7701.0,1236.0,301.6
41648.0,6,14,4740,7,653,6774.5,249.0,93.28571428571428,7,4087,5990.0,1514.0,583.8571428571429
246613.0,6,3,337,2,214,0.0,160.0,107.0,1,123,0.0,123.0,123.0
120007242.0,17,29,13785,29,13785,4285972.928571428,501.0,475.3448275862069,0,0,0.0,0.0,0.0
153404.0,17,2,180,1,90,0.0,90.0,90.0,1,90,0.0,90.0,90.0
45758.0,6,12,1320,7,789,7626.333333333333,253.0,112.71428571428572,5,531,9940.0,259.0,106.2
90007684.0,17,28,13364,28,13364,3333617.925925926,501.0,477.2857142857143,0,0,0.0,0.0,0.0
29741.0,17,2,876,2,876,0.0,438.0,438.0,0,0,0.0,0.0,0.0
161175.0,17,2,180,1,90,0.0,90.0,90.0,1,90,0.0,90.0,90.0
197018.0,17,2,180,1,90,0.0,90.0,90.0,1,90,0.0,90.0,90.0
15092.0,17,2,180,1,90,0.0,90.0,90.0,1,90,0.0,90.0,90.0
120127806.0,6,234,26870,113,7752,1066308.6339285714,140.0,68.60176991150442,121,19118,994185.9666666668,284.0,158.0
108109098.0,17,5,955,5,955,27027274.5,191.0,191.0,0,0,0.0,0.0,0.0
299277.0,6,6,412,4,272,99759.0,74.0,68.0,2,140,0.0,74.0,70.0
102501541.0,6,30,2106,15,1089,7306097.785714285,123.0,72.6,15,1017,7306086.642857143,123.0,67.8
143967.0,17,2,180,1,90,0.0,90.0,90.0,1,90,0.0,90.0,90.0
4501.0,17,2,614,1,72,0.0,72.0,72.0,1,542,0.0,542.0,542.0
108103142.0,17,5,955,5,955,27025785.5,191.0,191.0,0,0,0.0,0.0,0.0
118700960.0,6,29,1914,15,948,8478640.0,123.0,63.2,14,966,8346197.307692308,123.0,69.0
33561.0,6,2,145,2,145,0.0,91.0,72.5,0,0,0.0,0.0,0.0
257864.0,6,3,337,2,214,0.0,160.0,107.0,1,123,0.0,123.0,123.0
48831.0,6,10,2032,5,524,11671.0,252.0,104.8,5,1508,8913.75,1236.0,301.6
168954.0,17,2,414,1,88,0.0,88.0,88.0,1,326,0.0,326.0,326.0
54611.0,6,10,2032,5,524,12974.25,252.0,104.8,5,1508,13280.75,1236.0,301.6
52415095.0,6,8,1307,8,1307,7487870.714285715,172.0,163.375,0,0,0.0,0.0,0.0
318165.0,17,4,1400,4,1400,106055.0,350.0,350.0,0,0,0.0,0.0,0.0
41527.0,6,11,1133,6,602,6863.2,264.0,100.33333333333331,5,531,8448.0,259.0,106.2
345.0,17,2,250,1,93,0.0,93.0,93.0,1,157,0.0,157.0,157.0
2348.0,17,4,344,2,150,0.0,75.0,75.0,2,194,0.0,103.0,97.0
0.0,6,1,66,1,66,0.0,66.0,66.0,0,0,0.0,0.0,0.0
301695.0,6,6,412,4,272,100565.0,74.0,68.0,2,140,0.0,74.0,70.0
171664.0,17,4,1400,4,1400,57221.333333333336,350.0,350.0,0,0,0.0,0.0,0.0
102840.0,17,2,286,2,286,0.0,143.0,143.0,0,0,0.0,0.0,0.0
758.0,17,4,438,2,148,0.0,74.0,74.0,2,290,0.0,147.0,145.0
105386409.0,6,32,2236,16,1165,7012123.666666667,139.0,72.8125,16,1071,7012123.266666667,123.0,66.9375
30874.0,6,14,4740,7,653,4607.833333333333,249.0,93.28571428571428,7,4087,4570.166666666667,1514.0,583.8571428571429
2434.0,17,4,344,2,150,0.0,75.0,75.0,2,194,0.0,103.0,97.0
1245428.0,6,7,499,4,301,383403.6666666667,103.0,75.25,3,198,613720.5,66.0,66.0
105177477.0,17,14,1126,7,563,17500159.0,174.0,80.42857142857143,7,563,17501516.666666668,174.0,80.42857142857143
10438219.0,6,7,478,4,272,3433748.6666666665,74.0,68.0,3,206,5150474.5,74.0,68.66666666666667
228635.0,17,2,180,1,90,0.0,90.0,90.0,1,90,0.0,90.0,90.0
27648942.0,17,5,1710,5,1710,6912235.5,342.0,342.0,0,0,0.0,0.0,0.0
60052.0,6,10,2032,5,524,10476.25,252.0,104.8,5,1508,13222.5,1236.0,301.6
303631.0,6,2,132,1,66,0.0,66.0,66.0,1,66,0.0,66.0,66.0
143838.0,17,2,180,1,90,0.0,90.0,90.0,1,90,0.0,90.0,90.0
2459.0,17,2,762,2,762,0.0,381.0,381.0,0,0,0.0,0.0,0.0
2900215.0,6,12,2172,7,664,483110.3333333333,252.0,94.85714285714286,5,1508,1832.5,1236.0,301.6
301938.0,6,6,412,4,272,100646.0,74.0,68.0,2,140,0.0,74.0,70.0
90259963.0,6,14,2240,8,1016,12894280.42857143,188.0,127.0,6,1224,18019078.0,204.0,204.0
246428.0,6,2,132,1,66,0.0,66.0,66.0,1,66,0.0,66.0,66.0
114719873.0,6,47,3102,24,1584,4974413.304347826,66.0,66.0,23,1518,5150438.0,66.0,66.0
44038.0,6,10,2032,5,524,9696.0,252.0,104.8,5,1508,10082.5,1236.0,301.6
2482.0,17,4,344,2,150,0.0,75.0,75.0,2,194,0.0,103.0,97.0
120045274.0,17,28,13364,28,13364,4446121.259259259,501.0,477.2857142857143,0,0,0.0,0.0,0.0
51807.0,6,14,4740,7,653,8457.666666666666,249.0,93.28571428571428,7,4087,8494.5,1514.0,583.8571428571429
146446.0,6,3,337,2,214,0.0,160.0,107.0,1,123,0.0,123.0,123.0
316.0,17,2,174,1,79,0.0,79.0,79.0,1,95,0.0,95.0,95.0
4364.0,17,2,598,1,72,0.0,72.0,72.0,1,526,0.0,526.0,526.0
108107629.0,17,5,1005,5,1005,27026907.25,201.0,201.0,0,0,0.0,0.0,0.0
26458.0,6,13,4515,6,512,5090.4,230.0,85.33333333333333,7,4003,4032.5,1514.0,571.8571428571429
68494.0,6,10,2032,5,524,16883.5,252.0,104.8,5,1508,12603.25,1236.0,301.6
810.0,17,4,438,2,148,0.0,74.0,74.0,2,290,0.0,147.0,145.0
135135279.0,17,6,1206,6,1206,27027055.8,201.0,201.0,0,0,0.0,0.0,0.0
103183426.0,17,14,864,7,432,17197237.666666668,174.0,61.71428571428572,7,432,17136490.5,174.0,61.71428571428572
9584.0,17,2,571,1,86,0.0,86.0,86.0,1,485,0.0,485.0,485.0
108109099.0,17,5,1005,5,1005,27027274.75,201.0,201.0,0,0,0.0,0.0,0.0
155046.0,6,3,337,2,214,0.0,160.0,107.0,1,123,0.0,123.0,123.0
120026445.0,17,29,13785,29,13785,4286658.75,501.0,475.3448275862069,0,0,0.0,0.0,0.0
207865.0,6,3,426,2,280,0.0,214.0,140.0,1,146,0.0,146.0,146.0
30814.0,6,10,2032,5,524,7470.25,252.0,104.8,5,1508,7084.25,1236.0,301.6
1768425.0,6,2,132,1,66,0.0,66.0,66.0,1,66,0.0,66.0,66.0
35527.0,6,14,4740,7,653,5795.833333333333,249.0,93.28571428571428,7,4087,5761.0,1514.0,583.8571428571429
43294.0,6,14,4740,7,653,4748.0,249.0,93.28571428571428,7,4087,6900.166666666667,1514.0,583.8571428571429
302103.0,17,4,1524,4,1524,100701.0,381.0,381.0,0,0,0.0,0.0,0.0
405.0,17,2,410,1,78,0.0,78.0,78.0,1,332,0.0,332.0,332.0
5009353.0,17,4,849,2,166,0.0,83.0,83.0,2,683,0.0,499.0,341.5
198770.0,17,4,6056,4,6056,66256.66666666667,1514.0,1514.0,0,0,0.0,0.0,0.0
118369585.0,6,227,25706,114,18026,1047518.4513274336,284.0,158.12280701754386,113,7680,1047560.9910714284,140.0,67.96460176991151
1296390.0,6,4,264,2,132,0.0,66.0,66.0,2,132,0.0,66.0,66.0
5620184.0,6,5,336,2,134,0.0,68.0,67.0,3,202,1417663.0,70.0,67.33333333333333
1416.0,17,4,438,2,148,0.0,74.0,74.0,2,290,0.0,147.0,145.0
325.0,17,2,174,1,79,0.0,79.0,79.0,1,95,0.0,95.0,95.0
112856947.0,6,32,2236,16,1165,7509407.133333334,139.0,72.8125,16,1071,7509408.0,123.0,66.9375
42464.0,6,10,2032,5,524,10059.0,252.0,104.8,5,1508,9971.0,1236.0,301.6
120074164.0,17,28,13364,28,13364,4447191.259259259,501.0,477.2857142857143,0,0,0.0,0.0,0.0
36893.0,6,14,4740,7,653,5075.0,249.0,93.28571428571428,7,4087,5454.666666666667,1514.0,583.8571428571429
16421015.0,6,20,6935,11,1567,1642101.5,408.0,142.45454545454547,9,5368,1548720.25,1514.0,596.4444444444445
207701.0,6,3,426,2,280,0.0,214.0,140.0,1,146,0.0,146.0,146.0
21573.0,17,2,582,1,83,0.0,83.0,83.0,1,499,0.0,499.0,499.0
209614.0,17,2,180,1,90,0.0,90.0,90.0,1,90,0.0,90.0,90.0
90256484.0,6,13,2036,8,1016,12893783.42857143,188.0,127.0,5,1020,22523066.75,204.0,204.0
90478547.0,6,13,1910,8,1016,12908671.42857143,188.0,127.0,5,894,15113435.0,204.0,178.8
91685779.0,6,166,18762,83,5700,1118077.1341463414,140.0,68.67469879518072,83,13062,1108081.4024390243,284.0,157.3734939759036
134930.0,6,4,403,3,280,67465.00000000001,160.0,93.33333333333331,1,123,0.0,123.0,123.0
108106025.0,17,5,955,5,955,27026506.25,191.0,191.0,0,0,0.0,0.0,0.0
303456.0,6,6,412,4,272,101152.0,74.0,68.0,2,140,0.0,74.0,70.0
105300.0,17,2,286,2,286,0.0,143.0,143.0,0,0,0.0,0.0,0.0
1580061.0,6,4,276,2,128,0.0,74.0,64.0,2,148,0.0,74.0,74.0
14388.0,6,11,1133,6,602,2268.0,264.0,100.33333333333331,5,531,2931.25,259.0,106.2
2488052.0,6,25,7573,14,3735,191388.6153846153,1514.0,266.7857142857143,11,3838,223138.5,1514.0,348.90909090909093
153413.0,17,2,180,1,90,0.0,90.0,90.0,1,90,0.0,90.0,90.0
120100186.0,6,225,25590,113,17976,1072323.0892857143,374.0,159.0796460176991,112,7614,1074712.9189189188,140.0,67.98214285714286
18859.0,6,11,1133,6,602,3771.8,264.0,100.33333333333331,5,531,4453.25,259.0,106.2
216533.0,6,3,426,2,280,0.0,214.0,140.0,1,146,0.0,146.0,146.0
317691.0,17,4,1400,4,1400,105897.0,350.0,350.0,0,0,0.0,0.0,0.0
35164.0,6,10,2032,5,524,8317.5,252.0,104.8,5,1508,8510.25,1236.0,301.6
3269353.0,6,3,1777,2,951,0.0,885.0,475.5,1,826,0.0,826.0,826.0
100696505.0,17,13,821,7,432,16666822.0,174.0,61.71428571428572,6,389,20000791.0,174.0,64.83333333333333
106035.0,17,2,700,2,700,0.0,350.0,350.0,0,0,0.0,0.0,0.0
325.0,17,2,166,1,75,0.0,75.0,75.0,1,91,0.0,91.0,91.0
120013268.0,6,16,1192,8,596,17144752.57142857,95.0,74.5,8,596,17109662.85714286,95.0,74.5
145652.0,6,3,337,2,214,0.0,160.0,107.0,1,123,0.0,123.0,123.0
120170125.0,6,417,53192,209,14090,577740.9855769231,140.0,67.41626794258373,208,39102,575576.4444444445,336.0,187.9903846153846
888.0,17,4,438,2,148,0.0,74.0,74.0,2,290,0.0,147.0,145.0
18458181.0,6,24,8675,14,1785,1419860.076923077,408.0,127.5,10,6890,1592835.7777777778,1514.0,689.0
851265.0,6,9,1196,6,725,170253.0,387.0,120.83333333333331,3,471,287782.0,331.0,157.0
228254.0,17,2,180,1,90,0.0,90.0,90.0,1,90,0.0,90.0,90.0
108103163.0,17,5,1005,5,1005,27025790.75,201.0,201.0,0,0,0.0,0.0,0.0
45338.0,6,14,4740,7,653,7375.833333333333,249.0,93.28571428571428,7,4087,7025.833333333333,1514.0,583.8571428571429
40082.0,6,14,4740,7,653,6279.166666666667,249.0,93.28571428571428,7,4087,5274.333333333333,1514.0,583.8571428571429
42820.0,6,10,2032,5,524,7144.0,252.0,104.8,5,1508,9099.25,1236.0,301.6
219694.0,6,4,492,2,280,0.0,214.0,140.0,2,212,0.0,146.0,106.0
153497.0,17,2,180,1,90,0.0,90.0,90.0,1,90,0.0,90.0,90.0
5644.0,17,4,823,2,163,0.0,89.0,81.5,2,660,0.0,443.0,330.0
298.0,17,2,174,1,79,0.0,79.0,79.0,1,95,0.0,95.0,95.0
14641137.0,6,20,1607,10,975,1592871.6666666667,315.0,97.5,10,632,1592843.0,78.0,63.2
84255.0,17,2,286,2,286,0.0,143.0,143.0,0,0,0.0,0.0,0.0
33534.0,6,10,2032,5,524,8109.5,252.0,104.8,5,1508,7833.75,1236.0,301.6
143872.0,17,2,180,1,90,0.0,90.0,90.0,1,90,0.0,90.0,90.0
26972.0,6,14,4740,7,653,4163.833333333333,249.0,93.28571428571428,7,4087,4160.833333333333,1514.0,583.8571428571429
62731.99999999999,6,14,4740,7,653,10023.333333333334,249.0,93.28571428571428,7,4087,9430.5,1514.0,583.8571428571429
20973.0,6,14,4740,7,653,3384.833333333333,249.0,93.28571428571428,7,4087,3357.833333333333,1514.0,583.8571428571429
85139.0,6,11,2098,6,590,14558.8,252.0,98.33333333333331,5,1508,19660.75,1236.0,301.6
14959.0,17,2,180,1,90,0.0,90.0,90.0,1,90,0.0,90.0,90.0
135140226.0,17,6,1146,6,1146,27028045.2,191.0,191.0,0,0,0.0,0.0,0.0
108098800.0,17,5,955,5,955,27024700.0,191.0,191.0,0,0,0.0,0.0,0.0
148024.0,17,2,180,1,90,0.0,90.0,90.0,1,90,0.0,90.0,90.0
300248.0,6,6,412,4,272,100082.66666666669,74.0,68.0,2,140,0.0,74.0,70.0
14150456.0,17,6,2052,6,2052,2830091.2,342.0,342.0,0,0,0.0,0.0,0.0
218343.0,17,2,180,1,90,0.0,90.0,90.0,1,90,0.0,90.0,90.0
959762.0,6,12,1354,6,723,190803.2,253.0,120.5,6,631,190916.4,293.0,105.16666666666669
54984.0,6,14,4740,7,653,8667.833333333334,249.0,93.28571428571428,7,4087,7993.166666666667,1514.0,583.8571428571429
72179637.0,6,9,842,9,842,9022454.625,97.0,93.55555555555556,0,0,0.0,0.0,0.0
221250.0,6,13,1386,7,789,36875.0,253.0,112.71428571428572,6,597,43608.2,259.0,99.5
206102.0,6,3,426,2,280,0.0,214.0,140.0,1,146,0.0,146.0,146.0
122008295.0,17,15,907,8,475,17429756.42857143,174.0,59.375,7,432,17000172.833333332,174.0,61.71428571428572
122521050.0,6,31,2034,16,1086,8168070.0,123.0,67.875,15,948,8022883.0,123.0,63.2
90256237.0,6,14,2240,8,1016,12893748.142857144,188.0,127.0,6,1224,18018374.2,204.0,204.0
108122419.0,17,5,1005,5,1005,27030604.75,201.0,201.0,0,0,0.0,0.0,0.0
29831.0,6,10,2032,5,524,6940.5,252.0,104.8,5,1508,6979.5,1236.0,301.6
313969.0,6,6,412,4,272,104656.33333333331,74.0,68.0,2,140,0.0,74.0,70.0
98370033.0,17,12,778,6,389,19600165.4,174.0,64.83333333333333,6,389,19597697.4,174.0,64.83333333333333
1210613.0,6,13,3010,8,2382,172944.7142857143,1514.0,297.75,5,628,233713.25,331.0,125.6
215233.0,6,10,1221,6,636,43046.6,298.0,106.0,4,585,70688.33333333333,379.0,146.25
24445.0,6,13,1479,7,882,3997.3333333333335,291.0,126.0,6,597,4452.6,259.0,99.5
3107515.0,6,3,1604,2,851,0.0,785.0,425.5,1,753,0.0,753.0,753.0
120456799.0,6,735,114460,371,89992,325558.9162162162,1514.0,242.56603773584905,364,24468,329278.95867768594,214.0,67.21978021978022
948499.0,6,5,1742,3,921,474249.5,785.0,307.0,2,821,0.0,753.0,410.5
120132122.0,6,12,1832,8,1016,17136211.0,188.0,127.0,4,816,30036111.33333333,204.0,204.0
7914020.0,17,4,1376,3,1026,30676.5,342.0,342.0,1,350,0.0,350.0,350.0
125795575.0,17,14,864,7,432,17668152.666666668,174.0,61.71428571428572,7,432,17666826.333333332,174.0,61.71428571428572
120546496.0,6,463,58694,232,43226,521846.30303030304,300.0,186.31896551724137,231,15468,520119.1391304348,140.0,66.96103896103897
98166441.0,17,12,778,6,389,19601590.6,174.0,64.83333333333333,6,389,19600218.8,174.0,64.83333333333333
2020846.0,17,4,525,2,150,0.0,75.0,75.0,2,375,0.0,284.0,187.5
153407.0,17,2,180,1,90,0.0,90.0,90.0,1,90,0.0,90.0,90.0
8357702.0,17,3,1034,2,684,0.0,342.0,342.0,1,350,0.0,350.0,350.0
10468807.0,6,7,478,4,272,3443783.333333333,74.0,68.0,3,206,5165553.5,74.0,68.66666666666667
153496.0,17,2,180,1,90,0.0,90.0,90.0,1,90,0.0,90.0,90.0
2465.0,17,4,344,2,150,0.0,75.0,75.0,2,194,0.0,103.0,97.0
61361.0,6,14,4740,7,653,9760.0,249.0,93.28571428571428,7,4087,8390.833333333334,1514.0,583.8571428571429
320778.0,6,6,544,3,350,80816.0,210.0,116.66666666666669,3,194,80797.0,74.0,64.66666666666667
3701.0,17,4,344,2,150,0.0,75.0,75.0,2,194,0.0,103.0,97.0
60343.0,6,14,4740,7,653,9930.666666666666,249.0,93.28571428571428,7,4087,9364.666666666666,1514.0,583.8571428571429
120012204.0,17,29,13785,29,13785,4286150.142857143,501.0,475.3448275862069,0,0,0.0,0.0,0.0
351.0,17,2,267,1,83,0.0,83.0,83.0,1,184,0.0,184.0,184.0
2437.0,17,4,344,2,150,0.0,75.0,75.0,2,194,0.0,103.0,97.0
36821.0,6,14,4740,7,653,6010.666666666667,249.0,93.28571428571428,7,4087,4977.333333333333,1514.0,583.8571428571429
54809.0,6,14,4740,7,653,8678.333333333334,249.0,93.28571428571428,7,4087,8323.166666666666,1514.0,583.8571428571429
2348.0,17,4,344,2,150,0.0,75.0,75.0,2,194,0.0,103.0,97.0
120071433.0,6,218,24662,109,7416,1104202.7685185184,140.0,68.03669724770643,109,17246,1105181.3703703703,284.0,158.22018348623854
144068.0,17,2,180,1,90,0.0,90.0,90.0,1,90,0.0,90.0,90.0
18563.0,6,14,4740,7,653,2750.833333333333,249.0,93.28571428571428,7,4087,2651.6666666666665,1514.0,583.8571428571429
2710864.0,6,25,7573,14,3735,208528.0,1514.0,266.7857142857143,11,3838,243481.3,1514.0,348.90909090909093
75136296.0,6,9,842,9,842,9392037.0,97.0,93.55555555555556,0,0,0.0,0.0,0.0
108062313.0,17,14,864,7,432,18000164.833333332,174.0,61.71428571428572,7,432,18001412.0,174.0,61.71428571428572
197190.0,6,11,1131,6,600,39438.0,262.0,100.0,5,531,1962.0,259.0,106.2
9518.0,17,2,582,1,83,0.0,83.0,83.0,1,499,0.0,499.0,499.0
35035.0,6,10,2032,5,524,8527.75,252.0,104.8,5,1508,8310.0,1236.0,301.6
844.0,17,4,438,2,148,0.0,74.0,74.0,2,290,0.0,147.0,145.0
99706.0,17,2,762,2,762,0.0,381.0,381.0,0,0,0.0,0.0,0.0
34797.0,6,14,4740,7,653,5276.0,249.0,93.28571428571428,7,4087,4815.333333333333,1514.0,583.8571428571429
316638.0,17,4,1400,4,1400,105546.0,350.0,350.0,0,0,0.0,0.0,0.0
90768512.0,6,19,1562,10,745,10079327.555555556,95.0,74.5,9,817,11344591.375,221.0,90.77777777777776
44242.0,6,14,4740,7,653,7003.333333333333,249.0,93.28571428571428,7,4087,4959.0,1514.0,583.8571428571429
96006439.0,6,26,1762,13,922,7982539.333333333,139.0,70.92307692307692,13,840,7982541.75,123.0,64.61538461538461
207905.0,17,2,762,2,762,0.0,381.0,381.0,0,0,0.0,0.0,0.0
56131.0,6,14,4740,7,653,9054.166666666666,249.0,93.28571428571428,7,4087,7970.5,1514.0,583.8571428571429
25056.0,6,14,4740,7,653,3733.6666666666665,249.0,93.28571428571428,7,4087,4046.3333333333335,1514.0,583.8571428571429
9214.0,17,2,582,1,83,0.0,83.0,83.0,1,499,0.0,499.0,499.0
120127130.0,6,15,2168,7,1152,20021188.33333333,204.0,164.57142857142858,8,1016,17137381.285714287,188.0,127.0
520489.0,6,5,336,2,134,0.0,68.0,67.0,3,202,202549.0,70.0,67.33333333333333
35167.0,6,2,145,2,145,0.0,91.0,72.5,0,0,0.0,0.0,0.0
1592.0,17,2,192,1,88,0.0,88.0,88.0,1,104,0.0,104.0,104.0
90257868.0,6,12,1832,8,1016,12893981.142857144,188.0,127.0,4,816,30031412.0,204.0,204.0
90290312.0,6,17,1287,9,691,11280700.125,95.0,76.77777777777777,8,596,12763289.857142856,95.0,74.5
31855.0,6,14,4740,7,653,3989.3333333333335,249.0,93.28571428571428,7,4087,4849.0,1514.0,583.8571428571429
531.0,17,2,166,1,75,0.0,75.0,75.0,1,91,0.0,91.0,91.0
90029520.0,17,28,13364,28,13364,3334426.6666666665,501.0,477.2857142857143,0,0,0.0,0.0,0.0
97655907.0,6,32,2520,14,1179,7495358.846153846,153.0,84.21428571428571,18,1341,5731745.764705882,95.0,74.5
116368633.0,17,18,1560,9,780,14526066.375,174.0,86.66666666666667,9,780,14530388.75,174.0,86.66666666666667
1186986.0,6,13,3015,8,2387,169569.42857142858,1514.0,298.375,5,628,227855.75,331.0,125.6
9012809.0,17,4,300,4,300,3004269.6666666665,75.0,75.0,0,0,0.0,0.0,0.0
137578.0,17,4,344,2,150,0.0,75.0,75.0,2,194,0.0,103.0,97.0
2344.0,17,4,344,2,150,0.0,75.0,75.0,2,194,0.0,103.0,97.0
48458.0,6,14,4740,7,653,7544.166666666667,249.0,93.28571428571428,7,4087,7306.5,1514.0,583.8571428571429
119989170.0,17,13,690,7,432,19991882.5,174.0,61.71428571428572,6,258,20001257.8,43.0,43.0
123630515.0,6,49,3234,25,1650,5151271.458333333,66.0,66.0,24,1584,5023479.260869565,66.0,66.0
122091334.0,6,33,2296,16,1071,7473755.933333334,123.0,66.9375,17,1225,7006645.875,139.0,72.05882352941177
8788.0,6,10,2032,5,524,1895.0,252.0,104.8,5,1508,1933.25,1236.0,301.6
316842.0,17,4,1400,4,1400,105614.0,350.0,350.0,0,0,0.0,0.0,0.0
196893.0,17,2,180,1,90,0.0,90.0,90.0,1,90,0.0,90.0,90.0
103252803.0,6,43,2838,22,1452,4916788.428571428,66.0,66.0,21,1386,5144791.75,66.0,66.0
95876127.0,6,167,18844,84,5692,1155134.060240964,140.0,67.76190476190476,83,13152,1156759.353658537,284.0,158.4578313253012
206154.0,17,2,762,2,762,0.0,381.0,381.0,0,0,0.0,0.0,0.0
2593739.0,6,2,132,1,66,0.0,66.0,66.0,1,66,0.0,66.0,66.0
69166.0,6,10,2032,5,524,17062.75,252.0,104.8,5,1508,12933.75,1236.0,301.6
120097254.0,6,230,25866,115,7812,1046180.5614035088,140.0,67.9304347826087,115,18054,1011008.8771929824,284.0,156.9913043478261
22974.0,6,14,4740,7,653,3275.5,249.0,93.28571428571428,7,4087,3524.1666666666665,1514.0,583.8571428571429
7389.0,17,2,582,1,83,0.0,83.0,83.0,1,499,0.0,499.0,499.0
538997.0,17,6,2100,6,2100,107799.4,350.0,350.0,0,0,0.0,0.0,0.0
108102663.0,17,5,1005,5,1005,27025665.75,201.0,201.0,0,0,0.0,0.0,0.0
153567.0,17,2,180,1,90,0.0,90.0,90.0,1,90,0.0,90.0,90.0
108103400.0,17,5,1005,5,1005,27025850.0,201.0,201.0,0,0,0.0,0.0,0.0
251258.0,6,3,373,2,238,0.0,172.0,119.0,1,135,0.0,135.0,135.0
107056.0,17,2,286,2,286,0.0,143.0,143.0,0,0,0.0,0.0,0.0
2509340.0,6,3,1604,2,851,0.0,785.0,425.5,1,753,0.0,753.0,753.0
2593340.0,6,2,132,1,66,0.0,66.0,66.0,1,66,0.0,66.0,66.0
11868.0,17,4,823,2,163,0.0,89.0,81.5,2,660,0.0,443.0,330.0
93354878.0,17,12,778,6,389,18601046.6,174.0,64.83333333333333,6,389,18600169.0,174.0,64.83333333333333
38787.0,6,14,4740,7,653,6156.833333333333,249.0,93.28571428571428,7,4087,6126.833333333333,1514.0,583.8571428571429
228283.0,17,2,180,1,90,0.0,90.0,90.0,1,90,0.0,90.0,90.0
129332271.0,6,34,2334,17,1125,7459076.375,123.0,66.17647058823529,17,1209,8003061.625,123.0,71.11764705882354
103042.0,17,2,700,2,700,0.0,350.0,350.0,0,0,0.0,0.0,0.0
51446.0,6,14,4740,7,653,7403.5,249.0,93.28571428571428,7,4087,8357.833333333334,1514.0,583.8571428571429
250454.0,17,4,6056,4,6056,83484.66666666667,1514.0,1514.0,0,0,0.0,0.0,0.0
16871.0,17,2,180,1,90,0.0,90.0,90.0,1,90,0.0,90.0,90.0
302674.0,6,6,412,4,272,100891.33333333331,74.0,68.0,2,140,0.0,74.0,70.0
103355177.0,6,429,52680,215,38334,482968.11682242993,336.0,178.29767441860466,214,14346,480352.38497652585,140.0,67.03738317757009
112247780.0,6,204,22964,102,15936,1111364.1584158416,284.0,156.23529411764707,102,7028,1109187.603960396,140.0,68.90196078431373
5639690.0,6,5,336,2,134,0.0,68.0,67.0,3,202,1509321.5,70.0,67.33333333333333
135129759.0,17,6,1206,6,1206,27025951.8,201.0,201.0,0,0,0.0,0.0,0.0
5012309.0,17,4,849,2,166,0.0,83.0,83.0,2,683,0.0,499.0,341.5
11487.0,6,10,1810,5,358,2551.5,130.0,71.6,5,1452,2611.75,1224.0,290.4
90525493.0,6,14,2240,8,1016,12932213.285714284,188.0,127.0,6,1224,18071466.2,204.0,204.0
23970.0,6,10,2032,5,524,5755.0,252.0,104.8,5,1508,5263.5,1236.0,301.6
307813.0,6,6,412,4,272,102604.33333333331,74.0,68.0,2,140,0.0,74.0,70.0
109210843.0,17,14,1126,7,563,18175183.666666668,174.0,80.42857142857143,7,563,18175183.166666668,174.0,80.42857142857143
116092229.0,17,15,1169,8,606,16571567.142857144,174.0,75.75,7,563,17561446.5,174.0,80.42857142857143
153532.0,17,2,180,1,90,0.0,90.0,90.0,1,90,0.0,90.0,90.0
120372437.0,6,249,28132,125,19652,970745.4596774194,284.0,157.216,124,8480,970263.9674796748,140.0,68.38709677419355
497448.0,6,5,336,2,134,0.0,68.0,67.0,3,202,191722.0,70.0,67.33333333333333
108106049.0,17,5,1005,5,1005,27026512.25,201.0,201.0,0,0,0.0,0.0,0.0
27312478.0,17,5,1710,5,1710,6828119.5,342.0,342.0,0,0,0.0,0.0,0.0
274156.0,17,2,180,1,90,0.0,90.0,90.0,1,90,0.0,90.0,90.0
121460.0,6,3,337,2,214,0.0,160.0,107.0,1,123,0.0,123.0,123.0
3055.0,17,2,224,1,76,0.0,76.0,76.0,1,148,0.0,148.0,148.0
202109.0,17,4,6056,4,6056,67369.66666666667,1514.0,1514.0,0,0,0.0,0.0,0.0
43987.0,6,10,2032,5,524,10688.75,252.0,104.8,5,1508,10350.75,1236.0,301.6
5669.0,17,4,823,2,163,0.0,89.0,81.5,2,660,0.0,443.0,330.0
2598420.0,6,2,132,1,66,0.0,66.0,66.0,1,66,0.0,66.0,66.0
128876215.0,6,37,2656,19,1408,7159789.722222222,139.0,74.10526315789474,18,1248,6980853.588235294,123.0,69.33333333333333
99226743.0,6,182,20538,91,14310,1100128.6222222222,284.0,157.25274725274724,91,6228,1100127.9444444445,140.0,68.43956043956044
113254833.0,6,46,3036,23,1518,5135437.545454546,66.0,66.0,23,1518,5135436.5,66.0,66.0
135130267.0,17,6,1146,6,1146,27026053.4,191.0,191.0,0,0,0.0,0.0,0.0
307052.0,6,6,412,4,272,102350.66666666669,74.0,68.0,2,140,0.0,74.0,70.0
220750.0,6,3,426,2,280,0.0,214.0,140.0,1,146,0.0,146.0,146.0
0.0,17,1,342,1,342,0.0,342.0,342.0,0,0,0.0,0.0,0.0
72066995.0,6,9,842,9,842,9008374.375,97.0,93.55555555555556,0,0,0.0,0.0,0.0
43184.0,6,10,2032,5,524,10577.0,252.0,104.8,5,1508,7333.25,1236.0,301.6
213932.0,6,3,426,2,280,0.0,214.0,140.0,1,146,0.0,146.0,146.0
90260010.0,6,12,1832,8,1016,12894287.142857144,188.0,127.0,4,816,30032741.33333333,204.0,204.0
305.0,17,2,174,1,79,0.0,79.0,79.0,1,95,0.0,95.0,95.0
322269.0,6,6,412,4,272,107423.0,74.0,68.0,2,140,0.0,74.0,70.0
147232.0,6,3,373,2,238,0.0,172.0,119.0,1,135,0.0,135.0,135.0
148113.0,17,2,180,1,90,0.0,90.0,90.0,1,90,0.0,90.0,90.0
234599.0,6,3,337,2,214,0.0,160.0,107.0,1,123,0.0,123.0,123.0
100356.0,17,2,762,2,762,0.0,381.0,381.0,0,0,0.0,0.0,0.0
24409.0,6,10,2032,5,524,4632.25,252.0,104.8,5,1508,5777.75,1236.0,301.6
137467.0,6,2,132,1,66,0.0,66.0,66.0,1,66,0.0,66.0,66.0
9852.0,17,2,582,1,83,0.0,83.0,83.0,1,499,0.0,499.0,499.0
90681846.0,6,21,1585,10,745,10075760.666666666,95.0,74.5,11,840,9043221.9,95.0,76.36363636363636
298174.0,6,6,412,4,272,99391.33333333331,74.0,68.0,2,140,0.0,74.0,70.0
252153.00000000003,6,2,132,1,66,0.0,66.0,66.0,1,66,0.0,66.0,66.0
144746.0,17,2,180,1,70,0.0,70.0,70.0,1,110,0.0,110.0,110.0
105062501.0,6,31,2166,16,1149,6989774.866666666,123.0,71.8125,15,1017,7489044.642857143,123.0,67.8
119087332.0,6,31,2166,16,1149,7924765.333333333,123.0,71.8125,15,1017,8490818.214285715,123.0,67.8
44667.0,6,14,4740,7,653,6934.0,249.0,93.28571428571428,7,4087,7266.833333333333,1514.0,583.8571428571429
316111.0,17,4,1400,4,1400,105370.33333333331,350.0,350.0,0,0,0.0,0.0,0.0
305045.0,6,6,412,4,272,101681.66666666669,74.0,68.0,2,140,0.0,74.0,70.0
166617.0,6,10,1065,5,534,41490.25,262.0,106.8,5,531,2891.25,259.0,106.2
108101491.0,17,5,955,5,955,27025372.75,191.0,191.0,0,0,0.0,0.0,0.0
144802.0,17,2,180,1,70,0.0,70.0,70.0,1,110,0.0,110.0,110.0
1023763.0,6,11,1134,6,558,204752.60000000003,220.0,93.0,5,576,254506.75,304.0,115.2
2468488.0,6,3,1604,2,851,0.0,785.0,425.5,1,753,0.0,753.0,753.0
251826.0,17,4,6056,4,6056,83941.99999999999,1514.0,1514.0,0,0,0.0,0.0,0.0
144133.0,17,2,180,1,90,0.0,90.0,90.0,1,90,0.0,90.0,90.0
603812.0,6,3,1604,2,851,0.0,785.0,425.5,1,753,0.0,753.0,753.0
135137406.0,17,6,1146,6,1146,27027481.2,191.0,191.0,0,0,0.0,0.0,0.0
108533.0,17,2,286,2,286,0.0,143.0,143.0,0,0,0.0,0.0,0.0
183540.0,17,2,180,1,90,0.0,90.0,90.0,1,90,0.0,90.0,90.0
2017384.0,17,4,525,2,150,0.0,75.0,75.0,2,375,0.0,284.0,187.5
104272809.0,6,32,2220,16,1149,6931601.4,123.0,71.8125,16,1071,6932157.2,123.0,66.9375
646.0,17,2,762,2,762,0.0,381.0,381.0,0,0,0.0,0.0,0.0
93571465.0,17,14,1126,7,563,15500193.833333334,174.0,80.42857142857143,7,563,15500135.333333334,174.0,80.42857142857143
300.0,17,2,168,1,76,0.0,76.0,76.0,1,92,0.0,92.0,92.0
318350.0,17,4,1400,4,1400,106116.66666666669,350.0,350.0,0,0,0.0,0.0,0.0
3328387.0,6,7,923,4,753,1040835.6666666666,571.0,188.25,3,170,1561873.0,62.0,56.66666666666666
24686.0,6,11,2098,6,590,4589.6,252.0,98.33333333333331,5,1508,5977.5,1236.0,301.6
316334.0,17,4,1400,4,1400,105444.66666666669,350.0,350.0,0,0,0.0,0.0,0.0
1420248.0,17,7,490,7,490,236708.0,70.0,70.0,0,0,0.0,0.0,0.0
246846.0,6,4,439,2,238,0.0,172.0,119.0,2,201,0.0,135.0,100.5
33776.0,6,14,4740,7,653,4759.333333333333,249.0,93.28571428571428,7,4087,5188.5,1514.0,583.8571428571429
48968.0,6,14,4740,7,653,8029.833333333333,249.0,93.28571428571428,7,4087,7701.0,1514.0,583.8571428571429
28968.0,6,14,4740,7,653,4699.333333333333,249.0,93.28571428571428,7,4087,4662.166666666667,1514.0,583.8571428571429
121871.0,6,3,337,2,214,0.0,160.0,107.0,1,123,0.0,123.0,123.0
303394.0,6,6,412,4,272,101131.33333333331,74.0,68.0,2,140,0.0,74.0,70.0
321858.0,17,4,1400,4,1400,107286.0,350.0,350.0,0,0,0.0,0.0,0.0
47665.0,6,14,4740,7,653,7499.833333333333,249.0,93.28571428571428,7,4087,7730.333333333333,1514.0,583.8571428571429
155588.0,6,3,337,2,214,0.0,160.0,107.0,1,123,0.0,123.0,123.0
304072.0,6,6,412,4,272,101357.33333333331,74.0,68.0,2,140,0.0,74.0,70.0
452.0,17,2,508,2,508,0.0,257.0,254.0,0,0,0.0,0.0,0.0
108107581.0,17,5,1005,5,1005,27026895.25,201.0,201.0,0,0,0.0,0.0,0.0
190790.0,17,2,180,1,90,0.0,90.0,90.0,1,90,0.0,90.0,90.0
100680005.0,17,12,778,6,389,20025033.8,174.0,64.83333333333333,6,389,20104219.0,174.0,64.83333333333333
144690.0,6,2,132,1,66,0.0,66.0,66.0,1,66,0.0,66.0,66.0
33896.0,6,14,4740,7,653,5395.0,249.0,93.28571428571428,7,4087,4521.833333333333,1514.0,583.8571428571429
285872.0,17,4,571,2,148,0.0,74.0,74.0,2,423,0.0,276.0,211.5
26890714.0,17,5,1718,4,1368,1035292.0,342.0,342.0,1,350,0.0,350.0,350.0
108108940.0,17,5,1005,5,1005,27027235.0,201.0,201.0,0,0,0.0,0.0,0.0
102007105.0,17,13,821,7,432,17001184.166666668,174.0,61.71428571428572,6,389,16400157.0,174.0,64.83333333333333
55505.0,6,14,4740,7,653,9013.833333333334,249.0,93.28571428571428,7,4087,7810.333333333333,1514.0,583.8571428571429
228193.0,17,2,180,1,90,0.0,90.0,90.0,1,90,0.0,90.0,90.0
1950.0,17,4,344,2,150,0.0,75.0,75.0,2,194,0.0,103.0,97.0
85155.0,6,14,4740,7,653,13845.0,249.0,93.28571428571428,7,4087,13537.833333333334,1514.0,583.8571428571429
5606312.0,6,5,336,2,134,0.0,68.0,67.0,3,202,1422230.5,70.0,67.33333333333333
322354.0,17,4,1400,4,1400,107451.33333333331,350.0,350.0,0,0,0.0,0.0,0.0
120064316.0,17,29,13785,29,13785,4288011.285714285,501.0,475.3448275862069,0,0,0.0,0.0,0.0
128786110.0,6,35,2394,18,1269,7575653.529411765,123.0,70.5,17,1125,7409926.8125,123.0,66.17647058823529
108124487.0,17,5,955,5,955,27031121.75,191.0,191.0,0,0,0.0,0.0,0.0
76566629.0,6,9,842,9,842,9570828.625,97.0,93.55555555555556,0,0,0.0,0.0,0.0
90073390.0,17,28,13364,28,13364,3336051.4814814813,501.0,477.2857142857143,0,0,0.0,0.0,0.0
1037229.0,6,11,1134,6,558,207445.8,220.0,93.0,5,576,257874.75,304.0,115.2
2444200.0,6,19,6869,10,1501,271577.7777777777,408.0,150.1,9,5368,242315.625,1514.0,596.4444444444445
15238.0,6,14,4740,7,653,2305.1666666666665,249.0,93.28571428571428,7,4087,2399.833333333333,1514.0,583.8571428571429
103990.0,17,2,286,2,286,0.0,143.0,143.0,0,0,0.0,0.0,0.0
311205.0,6,6,412,4,272,103735.0,74.0,68.0,2,140,0.0,74.0,70.0
2014.0,17,4,344,2,150,0.0,75.0,75.0,2,194,0.0,103.0,97.0
124921627.0,6,36,2602,19,1408,6940090.388888889,139.0,74.10526315789474,17,1194,7170026.125,123.0,70.23529411764706
267779.0,6,10,1221,6,636,53555.8,298.0,106.0,4,585,83864.66666666667,379.0,146.25
496219.0,6,6,758,3,410,205977.0,172.0,136.66666666666666,3,348,175768.5,135.0,116.0
2191972.0,6,19,6869,11,1567,219197.2,408.0,142.45454545454547,8,5302,250925.8571428572,1514.0,662.75
205889.0,17,2,180,1,90,0.0,90.0,90.0,1,90,0.0,90.0,90.0
104633.0,17,2,286,2,286,0.0,143.0,143.0,0,0,0.0,0.0,0.0
42159.0,6,14,4740,7,653,6867.5,249.0,93.28571428571428,7,4087,6181.666666666667,1514.0,583.8571428571429
765.0,17,4,438,2,148,0.0,74.0,74.0,2,290,0.0,147.0,145.0
56470.0,6,13,1386,7,789,9411.666666666666,253.0,112.71428571428572,6,597,8420.2,259.0,99.5
153382.0,17,2,180,1,90,0.0,90.0,90.0,1,90,0.0,90.0,90.0
308117.0,6,6,412,4,272,102705.66666666669,74.0,68.0,2,140,0.0,74.0,70.0
148118.0,17,2,180,1,90,0.0,90.0,90.0,1,90,0.0,90.0,90.0
218371.0,6,10,1221,6,636,43674.2,298.0,106.0,4,585,70373.66666666667,379.0,146.25
114326226.0,6,48,3168,24,1584,4970705.478260869,66.0,66.0,24,1584,4957317.782608695,66.0,66.0
330651.0,6,6,412,4,272,110217.0,74.0,68.0,2,140,0.0,74.0,70.0
56368.0,6,10,2032,5,524,13753.25,252.0,104.8,5,1508,13852.75,1236.0,301.6
121474520.0,6,223,25274,112,17640,1094365.045045045,284.0,157.5,111,7634,1085464.2363636363,140.0,68.77477477477477
149206762.0,6,18,1341,9,650,14940358.5,95.0,72.22222222222223,9,691,15000002.375,95.0,76.77777777777777
96145476.0,6,59,12315,30,6523,3315361.2413793104,1514.0,217.4333333333333,29,5792,3424529.571428572,1514.0,199.72413793103448
128007971.0,17,15,907,8,475,18286853.0,174.0,59.375,7,432,18000180.333333332,174.0,61.71428571428572
9820.0,17,4,823,2,163,0.0,89.0,81.5,2,660,0.0,443.0,330.0
17602.0,6,10,1065,5,534,3846.75,262.0,106.8,5,531,2497.75,259.0,106.2
305467.0,17,4,704,2,148,0.0,74.0,74.0,2,556,0.0,280.0,278.0
146142.0,6,3,337,2,214,0.0,160.0,107.0,1,123,0.0,123.0,123.0
346.0,17,2,267,1,83,0.0,83.0,83.0,1,184,0.0,184.0,184.0
33574.0,6,10,2032,5,524,7907.75,252.0,104.8,5,1508,8115.0,1236.0,301.6
217225.0,6,3,426,2,280,0.0,214.0,140.0,1,146,0.0,146.0,146.0
33997.0,6,14,4740,7,653,4962.666666666667,249.0,93.28571428571428,7,4087,4239.5,1514.0,583.8571428571429
11969438.0,6,6,433,4,301,3989812.6666666665,103.0,75.25,2,132,0.0,66.0,66.0
135139538.0,17,6,1206,6,1206,27027907.6,201.0,201.0,0,0,0.0,0.0,0.0
91186603.0,6,27,3289,14,1835,7011130.538461538,425.0,131.07142857142858,13,1454,7524092.75,359.0,111.84615384615384
0.0,17,1,90,1,90,0.0,90.0,90.0,0,0,0.0,0.0,0.0
249863.0,6,3,337,2,214,0.0,160.0,107.0,1,123,0.0,123.0,123.0
90034247.0,17,28,13364,28,13364,3334601.7407407407,501.0,477.2857142857143,0,0,0.0,0.0,0.0
54094.0,6,14,4740,7,653,8616.333333333334,249.0,93.28571428571428,7,4087,8590.666666666666,1514.0,583.8571428571429
102298569.0,6,198,22298,99,15468,1041667.5306122449,284.0,156.24242424242425,99,6830,1041667.1734693878,140.0,68.98989898989899
952405.0,6,12,1447,6,816,190154.4,291.0,136.0,6,631,189741.8,293.0,105.16666666666669
31370.000000000004,6,14,4740,7,653,5101.833333333333,249.0,93.28571428571428,7,4087,5042.666666666667,1514.0,583.8571428571429
301273.0,6,6,412,4,272,100424.33333333331,74.0,68.0,2,140,0.0,74.0,70.0
37252.0,6,14,4740,7,653,5571.333333333333,249.0,93.28571428571428,7,4087,5958.666666666667,1514.0,583.8571428571429
340.0,17,2,267,1,83,0.0,83.0,83.0,1,184,0.0,184.0,184.0
2861767.0,6,3,204,2,136,0.0,70.0,68.0,1,68,0.0,68.0,68.0
198455.0,17,2,180,1,90,0.0,90.0,90.0,1,90,0.0,90.0,90.0
243947.0,6,8,535,5,301,60986.75,85.0,60.2,3,234,42329.5,95.0,78.0
539373.0,17,6,2100,6,2100,107874.6,350.0,350.0,0,0,0.0,0.0,0.0
209516.0,17,2,180,1,90,0.0,90.0,90.0,1,90,0.0,90.0,90.0
98462715.0,6,45,3768,25,2067,4093556.0416666665,123.0,82.68,20,1701,5170879.368421053,123.0,85.05
102863.0,17,2,700,2,700,0.0,350.0,350.0,0,0,0.0,0.0,0.0
90056735.0,17,28,13364,28,13364,3335434.6296296297,501.0,477.2857142857143,0,0,0.0,0.0,0.0
228148.0,17,2,180,1,90,0.0,90.0,90.0,1,90,0.0,90.0,90.0
59475.0,6,14,4740,7,653,9396.333333333334,249.0,93.28571428571428,7,4087,8707.166666666666,1514.0,583.8571428571429
90212235.0,6,24,1829,11,840,8996418.5,95.0,76.36363636363636,13,989,7499747.333333333,95.0,76.07692307692308
305650.0,6,6,412,4,272,101883.33333333331,74.0,68.0,2,140,0.0,74.0,70.0
38415.0,6,14,4740,7,653,6072.833333333333,249.0,93.28571428571428,7,4087,5596.333333333333,1514.0,583.8571428571429
819.0,17,4,438,2,148,0.0,74.0,74.0,2,290,0.0,147.0,145.0
2594436.0,6,2,132,1,66,0.0,66.0,66.0,1,66,0.0,66.0,66.0
102170003.0,17,15,1169,7,563,17001849.333333332,174.0,80.42857142857143,8,606,14577460.857142856,174.0,75.75
349.0,17,2,267,1,83,0.0,83.0,83.0,1,184,0.0,184.0,184.0
63089.99999999999,6,14,4740,7,653,7525.5,249.0,93.28571428571428,7,4087,10274.166666666666,1514.0,583.8571428571429
90300105.0,6,16,1192,8,596,12893429.0,95.0,74.5,8,596,12899346.857142856,95.0,74.5
375.0,17,2,300,1,80,0.0,80.0,80.0,1,220,0.0,220.0,220.0
90038344.0,17,28,13364,28,13364,3334753.4814814813,501.0,477.2857142857143,0,0,0.0,0.0,0.0
228304.0,17,2,180,1,90,0.0,90.0,90.0,1,90,0.0,90.0,90.0
8008495.999999999,17,2,684,2,684,0.0,342.0,342.0,0,0,0.0,0.0,0.0
157145.0,6,3,337,2,214,0.0,160.0,107.0,1,123,0.0,123.0,123.0
31044480.0,6,5,336,2,134,0.0,68.0,67.0,3,202,15452539.5,70.0,67.33333333333333
1655209.0,6,7,499,3,198,813896.5,66.0,66.0,4,301,488269.0,103.0,75.25
26366233.0,6,16,1132,9,620,3295007.625,95.0,68.88888888888889,7,512,4393829.5,95.0,73.14285714285714
20060.0,6,14,4740,7,653,2865.1666666666665,249.0,93.28571428571428,7,4087,3177.333333333333,1514.0,583.8571428571429
90045966.0,17,28,13364,28,13364,3335035.777777778,501.0,477.2857142857143,0,0,0.0,0.0,0.0
108112938.0,17,5,955,5,955,27028234.5,191.0,191.0,0,0,0.0,0.0,0.0
137458.0,6,2,132,1,66,0.0,66.0,66.0,1,66,0.0,66.0,66.0
4176.0,17,4,344,2,150,0.0,75.0,75.0,2,194,0.0,103.0,97.0
325.0,17,2,166,1,75,0.0,75.0,75.0,1,91,0.0,91.0,91.0
6230.0,17,4,629,3,234,570.0,78.0,78.0,1,395,0.0,395.0,395.0
123455936.0,6,49,3234,25,1650,5143997.333333333,66.0,66.0,24,1584,5050101.956521739,66.0,66.0
120001285.0,6,26,1978,14,1084,9230750.615384616,95.0,77.42857142857143,12,894,10884780.909090908,95.0,74.5
121711384.0,6,34,2488,18,1348,7159493.176470588,139.0,74.88888888888889,16,1140,7433874.066666666,123.0,71.25
90093913.0,6,10,1440,7,828,15015652.166666666,188.0,118.28571428571428,3,612,30032575.0,204.0,204.0
90259588.0,6,13,2036,8,1016,12894226.857142856,188.0,127.0,5,1020,22523078.75,204.0,204.0
135143260.0,17,6,1206,6,1206,27028652.0,201.0,201.0,0,0,0.0,0.0,0.0
10512062.0,6,7,478,4,272,3458393.6666666665,74.0,68.0,3,206,5187470.0,74.0,68.66666666666667
90355593.0,6,17,2450,9,1434,11294288.625,204.0,159.33333333333334,8,1016,12907508.42857143,188.0,127.0
34155.0,6,10,2032,5,524,8245.5,252.0,104.8,5,1508,8134.25,1236.0,301.6
107453.0,17,2,286,2,286,0.0,143.0,143.0,0,0,0.0,0.0,0.0
107838761.0,6,28,1860,14,966,8295289.307692308,123.0,69.0,14,894,8278651.461538462,123.0,63.85714285714285
2494067.0,6,25,7573,14,3735,191851.3076923077,1514.0,266.7857142857143,11,3838,224573.5,1514.0,348.90909090909093
157461.0,6,11,1132,6,556,31367.6,218.0,92.66666666666669,5,576,38765.75,304.0,115.2
26608.0,6,14,4740,7,653,3713.1666666666665,249.0,93.28571428571428,7,4087,4302.666666666667,1514.0,583.8571428571429
820.0,17,4,438,2,148,0.0,74.0,74.0,2,290,0.0,147.0,145.0
2142.0,17,2,180,1,90,0.0,90.0,90.0,1,90,0.0,90.0,90.0
177996.0,17,2,180,1,90,0.0,90.0,90.0,1,90,0.0,90.0,90.0
2277.0,17,4,344,2,150,0.0,75.0,75.0,2,194,0.0,103.0,97.0
228417.0,17,2,180,1,90,0.0,90.0,90.0,1,90,0.0,90.0,90.0
39528.0,6,14,4740,7,653,5562.666666666667,249.0,93.28571428571428,7,4087,5956.833333333333,1514.0,583.8571428571429
102995.0,17,2,286,2,286,0.0,143.0,143.0,0,0,0.0,0.0,0.0
51832.0,6,10,2032,5,524,12683.75,252.0,104.8,5,1508,11158.75,1236.0,301.6
39858.0,6,14,4740,7,653,6161.666666666667,249.0,93.28571428571428,7,4087,5988.833333333333,1514.0,583.8571428571429
16103974.999999998,17,6,2052,6,2052,3220795.0,342.0,342.0,0,0,0.0,0.0,0.0
135132029.0,17,6,1206,6,1206,27026405.8,201.0,201.0,0,0,0.0,0.0,0.0
315603.0,6,6,412,4,272,105201.0,74.0,68.0,2,140,0.0,74.0,70.0
120107312.0,6,218,24646,109,7490,1104610.5185185184,140.0,68.71559633027523,109,17156,1104446.2777777778,284.0,157.39449541284404
108111668.0,17,5,1005,5,1005,27027917.0,201.0,201.0,0,0,0.0,0.0,0.0
120401456.0,6,252,28292,126,8612,956595.72,140.0,68.34920634920636,126,19680,954854.968,284.0,156.1904761904762
208627.0,6,3,426,2,280,0.0,214.0,140.0,1,146,0.0,146.0,146.0
102471308.0,17,14,864,7,432,17078551.333333332,174.0,61.71428571428572,7,432,16971271.166666668,174.0,61.71428571428572
2409.0,17,4,344,2,150,0.0,75.0,75.0,2,194,0.0,103.0,97.0
38903.0,6,14,4740,7,653,6362.0,249.0,93.28571428571428,7,4087,6268.0,1514.0,583.8571428571429
90759405.0,6,25,1924,14,1084,6978275.307692308,95.0,77.42857142857143,11,840,9047303.5,95.0,76.36363636363636
120067171.0,17,13,821,6,389,20021461.0,174.0,64.83333333333333,7,432,19984710.5,174.0,61.71428571428572
623.0,17,2,762,2,762,0.0,381.0,381.0,0,0,0.0,0.0,0.0
145906.0,6,3,337,2,214,0.0,160.0,107.0,1,123,0.0,123.0,123.0
7753.0,6,10,2032,5,524,1689.0,252.0,104.8,5,1508,1634.0,1236.0,301.6
114669172.0,6,47,3102,23,1518,5143997.136363637,66.0,66.0,24,1584,4985605.652173913,66.0,66.0
734.0,17,2,684,2,684,0.0,342.0,342.0,0,0,0.0,0.0,0.0
3955.0,17,4,344,2,150,0.0,75.0,75.0,2,194,0.0,103.0,97.0
135135379.0,17,6,1206,6,1206,27027075.8,201.0,201.0,0,0,0.0,0.0,0.0
221436.0,6,10,1221,6,636,44287.2,298.0,106.0,4,585,72614.33333333333,379.0,146.25
135140006.0,17,6,1146,6,1146,27028001.2,191.0,191.0,0,0,0.0,0.0,0.0
184233.0,17,2,180,1,90,0.0,90.0,90.0,1,90,0.0,90.0,90.0
120406920.0,6,245,27576,123,19302,986941.9672131148,284.0,156.9268292682927,122,8274,986414.694214876,140.0,67.81967213114754
333.0,17,2,166,1,75,0.0,75.0,75.0,1,91,0.0,91.0,91.0
102876.0,17,2,286,2,286,0.0,143.0,143.0,0,0,0.0,0.0,0.0
145138.0,17,2,180,1,70,0.0,70.0,70.0,1,110,0.0,110.0,110.0
2297.0,17,4,344,2,150,0.0,75.0,75.0,2,194,0.0,103.0,97.0
225774.0,6,13,1386,7,789,37629.0,253.0,112.71428571428572,6,597,43708.2,259.0,99.5
307044.0,6,6,412,4,272,102348.0,74.0,68.0,2,140,0.0,74.0,70.0
98181196.0,6,184,20760,92,14466,1076549.362637363,284.0,157.2391304347826,92,6294,1076548.9670329671,140.0,68.41304347826087
120017642.0,17,29,13785,29,13785,4286344.357142857,501.0,475.3448275862069,0,0,0.0,0.0,0.0
219925.0,6,10,1221,6,636,43985.0,298.0,106.0,4,585,72229.0,379.0,146.25
28307.0,6,14,4740,7,653,4000.8333333333335,249.0,93.28571428571428,7,4087,4323.5,1514.0,583.8571428571429
91133062.0,6,24,1829,11,840,9113306.2,95.0,76.36363636363636,13,989,7573608.166666667,95.0,76.07692307692308
146188.0,6,3,337,2,214,0.0,160.0,107.0,1,123,0.0,123.0,123.0
312742.0,17,4,1400,4,1400,104247.33333333331,350.0,350.0,0,0,0.0,0.0,0.0
5829621.0,6,5,336,2,134,0.0,68.0,67.0,3,202,1523389.0,70.0,67.33333333333333
183921.0,17,2,180,1,90,0.0,90.0,90.0,1,90,0.0,90.0,90.0
144746.0,17,2,180,1,70,0.0,70.0,70.0,1,110,0.0,110.0,110.0
299.0,17,2,164,1,82,0.0,82.0,82.0,1,82,0.0,82.0,82.0
1302527.0,6,4,264,2,132,0.0,66.0,66.0,2,132,0.0,66.0,66.0
108674008.0,6,33,2428,17,1288,6778641.75,139.0,75.76470588235294,16,1140,7230551.6,123.0,71.25
146157.0,6,3,337,2,214,0.0,160.0,107.0,1,123,0.0,123.0,123.0
311732.0,6,6,412,4,272,103910.66666666669,74.0,68.0,2,140,0.0,74.0,70.0
1095592.0,6,13,1386,7,789,182598.66666666663,253.0,112.71428571428572,6,597,218273.0,259.0,99.5
412.0,17,2,410,1,78,0.0,78.0,78.0,1,332,0.0,332.0,332.0
120036644.0,17,29,13785,29,13785,4287023.0,501.0,475.3448275862069,0,0,0.0,0.0,0.0
143871.0,17,2,180,1,90,0.0,90.0,90.0,1,90,0.0,90.0,90.0
1306904.0,6,4,264,2,132,0.0,66.0,66.0,2,132,0.0,66.0,66.0
204696.0,17,2,762,2,762,0.0,381.0,381.0,0,0,0.0,0.0,0.0
31977.0,6,14,4740,7,653,4967.833333333333,249.0,93.28571428571428,7,4087,4937.666666666667,1514.0,583.8571428571429
1153947.0,6,13,3010,8,2382,164849.57142857142,1514.0,297.75,5,628,220272.0,331.0,125.6
90012799.0,6,14,1043,7,542,15002133.166666666,95.0,77.42857142857143,7,501,14951337.666666666,95.0,71.57142857142857
135131670.0,17,6,1206,6,1206,27026334.0,201.0,201.0,0,0,0.0,0.0,0.0
63248.0,6,11,2098,6,590,12404.6,252.0,98.33333333333331,5,1508,15404.25,1236.0,301.6
101004989.0,17,13,821,7,432,16834164.833333332,174.0,61.71428571428572,6,389,16400202.4,174.0,64.83333333333333
2308.0,17,4,344,2,150,0.0,75.0,75.0,2,194,0.0,103.0,97.0
315347.0,17,4,1400,4,1400,105115.66666666669,350.0,350.0,0,0,0.0,0.0,0.0
9179.0,17,2,498,1,80,0.0,80.0,80.0,1,418,0.0,418.0,418.0
10478434.0,6,7,478,4,272,3447655.333333333,74.0,68.0,3,206,5171390.5,74.0,68.66666666666667
155036.0,6,3,337,2,214,0.0,160.0,107.0,1,123,0.0,123.0,123.0
90018372.0,17,28,13364,28,13364,3334013.777777778,501.0,477.2857142857143,0,0,0.0,0.0,0.0
22002.0,17,2,582,1,83,0.0,83.0,83.0,1,499,0.0,499.0,499.0
1302487.0,6,4,264,2,132,0.0,66.0,66.0,2,132,0.0,66.0,66.0
213995.0,6,10,1221,6,636,42799.0,298.0,106.0,4,585,69616.66666666667,379.0,146.25
120536948.0,6,603,80688,302,60526,400454.9767441861,480.0,200.4172185430464,301,20162,398451.5333333333,140.0,66.98338870431894
90531847.0,6,14,2240,8,1016,12933121.0,188.0,127.0,6,1224,18073518.2,204.0,204.0
22373.0,6,14,4740,7,653,3405.833333333333,249.0,93.28571428571428,7,4087,2995.5,1514.0,583.8571428571429
98775.0,17,2,762,2,762,0.0,381.0,381.0,0,0,0.0,0.0,0.0
35869.0,6,14,4740,7,653,5802.833333333333,249.0,93.28571428571428,7,4087,5844.833333333333,1514.0,583.8571428571429
206089.0,6,3,426,2,280,0.0,214.0,140.0,1,146,0.0,146.0,146.0
43454.0,6,14,4740,7,653,6869.333333333333,249.0,93.28571428571428,7,4087,7027.333333333333,1514.0,583.8571428571429
82.0,17,2,762,2,762,0.0,381.0,381.0,0,0,0.0,0.0,0.0
9761.0,17,2,539,1,86,0.0,86.0,86.0,1,453,0.0,453.0,453.0
90263471.0,6,12,1832,8,1016,12894781.57142857,188.0,127.0,4,816,30032705.0,204.0,204.0
122045.0,6,3,373,2,238,0.0,172.0,119.0,1,135,0.0,135.0,135.0
117901024.0,6,48,3168,24,1584,5126131.478260869,66.0,66.0,24,1584,5111788.260869565,66.0,66.0
91396245.0,6,24,1829,13,989,7616131.5,95.0,76.07692307692308,11,840,9138318.5,95.0,76.36363636363636
2377.0,17,4,344,2,150,0.0,75.0,75.0,2,194,0.0,103.0,97.0
140575.0,6,3,337,2,214,0.0,160.0,107.0,1,123,0.0,123.0,123.0
68724.0,6,11,1131,6,600,13503.6,262.0,100.0,5,531,16736.75,259.0,106.2
102937170.0,6,52,4503,23,2070,4678941.863636363,123.0,90.0,29,2433,3676312.214285714,123.0,83.89655172413794
119783261.0,17,35,16705,35,16705,3523037.088235294,501.0,477.2857142857143,0,0,0.0,0.0,0.0
204639.0,17,2,762,2,762,0.0,381.0,381.0,0,0,0.0,0.0,0.0
2025.0,17,4,344,2,150,0.0,75.0,75.0,2,194,0.0,103.0,97.0
487457.0,6,3,1604,2,851,0.0,785.0,425.5,1,753,0.0,753.0,753.0
111396.0,6,14,4740,7,653,18438.83333333333,249.0,93.28571428571428,7,4087,18073.33333333333,1514.0,583.8571428571429
284570.0,17,2,363,1,79,0.0,79.0,79.0,1,284,0.0,284.0,284.0
205975.0,6,3,426,2,280,0.0,214.0,140.0,1,146,0.0,146.0,146.0
108671466.0,6,31,2314,16,1228,7230372.666666667,139.0,76.75,15,1086,7746788.785714285,123.0,72.4
111124.0,17,2,286,2,286,0.0,143.0,143.0,0,0,0.0,0.0,0.0
3008594.0,6,12,2172,7,664,501257.6666666667,252.0,94.85714285714286,5,1508,2396.0,1236.0,301.6
108106167.0,17,5,955,5,955,27026541.75,191.0,191.0,0,0,0.0,0.0,0.0
135139053.0,17,6,1146,6,1146,27027810.6,191.0,191.0,0,0,0.0,0.0,0.0
222682.0,6,3,426,2,280,0.0,214.0,140.0,1,146,0.0,146.0,146.0
90766687.0,6,19,1436,10,745,10080030.0,95.0,74.5,9,691,11344656.5,95.0,76.77777777777777
147983.0,17,2,180,1,90,0.0,90.0,90.0,1,90,0.0,90.0,90.0
44645.0,6,14,4740,7,653,7288.166666666667,249.0,93.28571428571428,7,4087,6682.166666666667,1514.0,583.8571428571429
2000.0,17,4,344,2,150,0.0,75.0,75.0,2,194,0.0,103.0,97.0
20268509.0,6,384,363439,107,7237,191212.34905660377,209.0,67.6355140186916,277,356202,73417.98550724638,1514.0,1285.927797833935
40112.0,6,12,1320,6,723,7150.4,253.0,120.5,6,597,7278.2,259.0,99.5
120232957.0,6,18,1341,9,691,14999061.75,95.0,76.77777777777777,9,650,14998744.625,95.0,72.22222222222223
108095570.0,17,5,1005,5,1005,27023892.5,201.0,201.0,0,0,0.0,0.0,0.0
991504.0,6,12,1362,6,731,196305.0,253.0,121.83333333333331,6,631,196594.0,293.0,105.16666666666669
2621.0,17,2,180,1,90,0.0,90.0,90.0,1,90,0.0,90.0,90.0
2070.0,17,4,344,2,150,0.0,75.0,75.0,2,194,0.0,103.0,97.0
477525.0,17,2,180,1,90,0.0,90.0,90.0,1,90,0.0,90.0,90.0
36217.0,6,10,2032,5,524,8202.5,252.0,104.8,5,1508,8424.75,1236.0,301.6
2835468.0,6,12,2172,7,664,472273.1666666667,252.0,94.85714285714286,5,1508,4120.75,1236.0,301.6
403878.0,6,4,508,2,238,0.0,172.0,119.0,2,270,0.0,135.0,135.0
90020443.0,17,28,13364,28,13364,3334090.4814814813,501.0,477.2857142857143,0,0,0.0,0.0,0.0
303141.0,6,6,412,4,272,101047.0,74.0,68.0,2,140,0.0,74.0,70.0
31394.0,6,14,4740,7,653,5009.0,249.0,93.28571428571428,7,4087,4903.0,1514.0,583.8571428571429
17530.0,6,10,2032,5,524,4013.25,252.0,104.8,5,1508,3822.5,1236.0,301.6
96112605.0,6,58,12245,29,6453,3432593.035714286,1514.0,222.51724137931035,29,5792,3422558.0,1514.0,199.72413793103448
7338.0,17,2,582,1,83,0.0,83.0,83.0,1,499,0.0,499.0,499.0
5837384.0,6,5,336,2,134,0.0,68.0,67.0,3,202,1528360.0,70.0,67.33333333333333
107681.0,17,2,286,2,286,0.0,143.0,143.0,0,0,0.0,0.0,0.0
46837.0,6,14,4740,7,653,7537.0,249.0,93.28571428571428,7,4087,6486.666666666667,1514.0,583.8571428571429
2400.0,17,4,344,2,150,0.0,75.0,75.0,2,194,0.0,103.0,97.0
142263.0,6,2,132,1,66,0.0,66.0,66.0,1,66,0.0,66.0,66.0
52154.0,6,14,4740,7,653,8566.833333333334,249.0,93.28571428571428,7,4087,8044.5,1514.0,583.8571428571429
3167386.0,6,18,1495,9,921,358380.25,315.0,102.33333333333331,9,574,358357.5,78.0,63.77777777777778
110217483.0,17,16,1474,8,737,15722651.0,174.0,92.125,8,737,15722651.285714284,174.0,92.125
108103414.0,17,5,955,5,955,27025853.5,191.0,191.0,0,0,0.0,0.0,0.0
14668.0,17,2,180,1,90,0.0,90.0,90.0,1,90,0.0,90.0,90.0
206238.0,6,3,426,2,280,0.0,214.0,140.0,1,146,0.0,146.0,146.0
100840.0,17,2,762,2,762,0.0,381.0,381.0,0,0,0.0,0.0,0.0
79169.0,6,14,4740,7,653,11855.833333333334,249.0,93.28571428571428,7,4087,12241.833333333334,1514.0,583.8571428571429
6099.0,17,2,180,1,90,0.0,90.0,90.0,1,90,0.0,90.0,90.0
1241722.0,6,20,6916,11,3099,124172.2,1514.0,281.72727272727275,9,3817,127939.375,1514.0,424.1111111111111
2440690.0,6,25,7573,14,3735,187745.38461538465,1514.0,266.7857142857143,11,3838,218016.7,1514.0,348.90909090909093
19976.0,6,2,145,2,145,0.0,91.0,72.5,0,0,0.0,0.0,0.0
90233436.0,6,17,1287,8,596,12854031.42857143,95.0,74.5,9,691,11252188.125,95.0,76.77777777777777
108106686.0,17,5,1005,5,1005,27026671.5,201.0,201.0,0,0,0.0,0.0,0.0
307820.0,6,6,412,4,272,102606.66666666669,74.0,68.0,2,140,0.0,74.0,70.0
306960.0,6,6,412,4,272,102320.0,74.0,68.0,2,140,0.0,74.0,70.0
149040.0,17,2,414,1,88,0.0,88.0,88.0,1,326,0.0,326.0,326.0
120145845.0,6,214,24342,107,7370,1126645.575471698,140.0,68.8785046728972,107,16972,1126746.783018868,284.0,158.6168224299065
84000913.0,17,11,735,6,389,16800182.6,174.0,64.83333333333333,5,346,15937358.5,174.0,69.2
102933.0,17,2,286,2,286,0.0,143.0,143.0,0,0,0.0,0.0,0.0
318.0,17,2,191,1,73,0.0,73.0,73.0,1,118,0.0,118.0,118.0
233091.0,6,3,373,2,238,0.0,172.0,119.0,1,135,0.0,135.0,135.0
120446067.0,6,215,24374,108,17016,1125664.1775700934,284.0,157.55555555555554,107,7358,1126510.066037736,140.0,68.76635514018692
43935.0,6,14,4740,7,653,7196.5,249.0,93.28571428571428,7,4087,6168.166666666667,1514.0,583.8571428571429
97712641.0,6,41,3816,25,2193,4062366.375,123.0,87.72,16,1623,6499786.133333334,123.0,101.4375
321908.0,6,6,412,4,272,107302.66666666669,74.0,68.0,2,140,0.0,74.0,70.0
77522.0,6,14,4740,7,653,9981.166666666666,249.0,93.28571428571428,7,4087,11007.166666666666,1514.0,583.8571428571429
153801.0,17,2,180,1,90,0.0,90.0,90.0,1,90,0.0,90.0,90.0
16499.0,6,14,4740,7,653,2545.1666666666665,249.0,93.28571428571428,7,4087,2612.1666666666665,1514.0,583.8571428571429
0.0,6,1,172,1,172,0.0,172.0,172.0,0,0,0.0,0.0,0.0
29694.0,6,14,4740,7,653,4603.166666666667,249.0,93.28571428571428,7,4087,4588.833333333333,1514.0,583.8571428571429
2400.0,17,4,344,2,150,0.0,75.0,75.0,2,194,0.0,103.0,97.0
58772240.0,17,9,3086,8,2736,5106737.714285715,342.0,342.0,1,350,0.0,350.0,350.0
523533.0,17,6,2100,6,2100,104706.6,350.0,350.0,0,0,0.0,0.0,0.0
120124444.0,6,14,2240,6,1224,24024888.8,204.0,204.0,8,1016,17137408.285714287,188.0,127.0
120253626.0,6,47,3102,23,1518,5160001.363636363,66.0,66.0,24,1584,5228407.739130435,66.0,66.0
2452154.0,6,25,7573,14,3735,188627.2307692308,1514.0,266.7857142857143,11,3838,218755.8,1514.0,348.90909090909093
671092.0,17,2,473,1,78,0.0,78.0,78.0,1,395,0.0,395.0,395.0
196934.0,17,2,180,1,90,0.0,90.0,90.0,1,90,0.0,90.0,90.0
129008717.0,17,15,907,8,475,18429816.71428572,174.0,59.375,7,432,18166832.666666668,174.0,61.71428571428572
117405148.0,6,48,3168,24,1584,5104571.652173913,66.0,66.0,24,1584,5092583.130434782,66.0,66.0
90028813.0,17,28,13364,28,13364,3334400.4814814813,501.0,477.2857142857143,0,0,0.0,0.0,0.0
220662.0,17,2,180,1,90,0.0,90.0,90.0,1,90,0.0,90.0,90.0
202822.0,6,10,1221,6,636,40564.4,298.0,106.0,4,585,66443.33333333333,379.0,146.25
208021.0,6,3,426,2,280,0.0,214.0,140.0,1,146,0.0,146.0,146.0
19054.0,6,11,1131,6,600,3220.0,262.0,100.0,5,531,4418.0,259.0,106.2
0.0,17,1,55,1,55,0.0,55.0,55.0,0,0,0.0,0.0,0.0
311247.0,17,2,238,1,74,0.0,74.0,74.0,1,164,0.0,164.0,164.0
17414.0,17,2,180,1,90,0.0,90.0,90.0,1,90,0.0,90.0,90.0
54424.0,6,14,4740,7,653,8105.0,249.0,93.28571428571428,7,4087,8215.666666666666,1514.0,583.8571428571429
16318.0,6,10,2032,5,524,2853.5,252.0,104.8,5,1508,3819.5,1236.0,301.6
2014.0,17,4,344,2,150,0.0,75.0,75.0,2,194,0.0,103.0,97.0
24393.0,6,14,4740,7,653,3816.0,249.0,93.28571428571428,7,4087,3933.1666666666665,1514.0,583.8571428571429
25512671.0,6,5,1736,2,819,0.0,753.0,409.5,3,917,12685070.0,785.0,305.6666666666667
228394.0,17,2,180,1,90,0.0,90.0,90.0,1,90,0.0,90.0,90.0
10301.0,6,10,1975,5,467,2360.0,195.0,93.4,5,1508,2271.25,1236.0,301.6
206843.0,17,2,762,2,762,0.0,381.0,381.0,0,0,0.0,0.0,0.0
2600257.0,6,2,132,1,66,0.0,66.0,66.0,1,66,0.0,66.0,66.0
33236.0,6,10,2032,5,524,7388.75,252.0,104.8,5,1508,6624.25,1236.0,301.6
121383.0,6,3,337,2,214,0.0,160.0,107.0,1,123,0.0,123.0,123.0
2798025.0,6,2,132,1,66,0.0,66.0,66.0,1,66,0.0,66.0,66.0
5628833.0,6,4,270,2,134,0.0,68.0,67.0,2,136,0.0,70.0,68.0
113042714.0,6,32,2220,16,1149,7521792.0,123.0,71.8125,16,1071,7521789.933333334,123.0,66.9375
119138.0,17,4,1400,4,1400,39712.66666666666,350.0,350.0,0,0,0.0,0.0,0.0
305745.0,17,4,704,2,148,0.0,74.0,74.0,2,556,0.0,280.0,278.0
10474180.0,6,7,478,4,272,3445918.333333333,74.0,68.0,3,206,5168764.5,74.0,68.66666666666667
135133214.0,17,6,1206,6,1206,27026642.8,201.0,201.0,0,0,0.0,0.0,0.0
49978.0,6,14,4740,7,653,7108.333333333333,249.0,93.28571428571428,7,4087,7842.5,1514.0,583.8571428571429
39927381.0,6,4,1670,3,917,19963690.5,785.0,305.6666666666667,1,753,0.0,753.0,753.0
2793975.0,6,3,1604,1,753,0.0,753.0,753.0,2,851,0.0,785.0,425.5
538876.0,17,6,2100,6,2100,107775.2,350.0,350.0,0,0,0.0,0.0,0.0
233010.0,6,3,337,2,214,0.0,160.0,107.0,1,123,0.0,123.0,123.0
227011.0,17,2,180,1,90,0.0,90.0,90.0,1,90,0.0,90.0,90.0
256945.0,6,3,337,2,214,0.0,160.0,107.0,1,123,0.0,123.0,123.0
91637883.0,6,172,19428,86,5898,1068577.4235294117,140.0,68.5813953488372,86,13530,1068325.2117647058,284.0,157.32558139534885
217936.0,6,3,426,2,280,0.0,214.0,140.0,1,146,0.0,146.0,146.0
94861526.0,6,177,20024,89,13920,1077971.8863636365,284.0,156.40449438202248,88,6104,1078589.0114942528,140.0,69.36363636363636
20747.0,6,10,2032,5,524,4696.25,252.0,104.8,5,1508,4766.25,1236.0,301.6
90668597.0,6,24,1829,11,840,9066859.7,95.0,76.36363636363636,13,989,7534994.0,95.0,76.07692307692308
254187.0,6,3,337,2,214,0.0,160.0,107.0,1,123,0.0,123.0,123.0
225223.0,6,10,1221,6,636,45044.6,298.0,106.0,4,585,73925.66666666667,379.0,146.25
12098.0,6,11,1133,6,602,1930.2,264.0,100.33333333333331,5,531,2827.0,259.0,106.2
1415714.0,17,16,1120,16,1120,94380.93333333332,70.0,70.0,0,0,0.0,0.0,0.0
2489.0,17,4,344,2,150,0.0,75.0,75.0,2,194,0.0,103.0,97.0
496473.0,6,5,336,2,134,0.0,68.0,67.0,3,202,193694.0,70.0,67.33333333333333
153425.0,17,2,180,1,90,0.0,90.0,90.0,1,90,0.0,90.0,90.0
2606478.0,6,25,7573,14,3735,200498.3076923077,1514.0,266.7857142857143,11,3838,233157.1,1514.0,348.90909090909093
103205.0,17,2,286,2,286,0.0,143.0,143.0,0,0,0.0,0.0,0.0
108507376.0,6,28,1876,14,982,8330127.230769231,139.0,70.14285714285714,14,894,8330127.923076923,123.0,63.85714285714285
16975.0,17,2,582,1,83,0.0,83.0,83.0,1,499,0.0,499.0,499.0
601796.0,6,4,508,2,238,0.0,172.0,119.0,2,270,0.0,135.0,135.0
90263151.0,6,12,1832,8,1016,12894735.857142856,188.0,127.0,4,816,30032714.33333333,204.0,204.0
2458.0,17,4,344,2,150,0.0,75.0,75.0,2,194,0.0,103.0,97.0
92910902.0,6,173,19494,87,5964,1080359.3255813953,140.0,68.55172413793103,86,13530,1087174.6823529413,284.0,157.32558139534885
22352.0,6,10,2032,5,524,5279.75,252.0,104.8,5,1508,5293.25,1236.0,301.6
120124876.0,6,15,2428,9,1204,15015609.5,188.0,133.77777777777777,6,1224,18073203.6,204.0,204.0
109996161.0,6,28,1860,14,966,8444622.692307692,123.0,69.0,14,894,8444611.692307692,123.0,63.85714285714285
135131318.0,17,6,1146,6,1146,27026263.6,191.0,191.0,0,0,0.0,0.0,0.0
876.0,17,4,438,2,148,0.0,74.0,74.0,2,290,0.0,147.0,145.0
120124473.0,6,17,2556,10,1392,13347163.666666666,188.0,139.2,7,1164,15014292.5,204.0,166.28571428571428
204576.0,17,2,762,2,762,0.0,381.0,381.0,0,0,0.0,0.0,0.0
283698.0,17,2,180,1,90,0.0,90.0,90.0,1,90,0.0,90.0,90.0
220528.0,6,10,1221,6,636,44105.6,298.0,106.0,4,585,72225.66666666667,379.0,146.25
43424.0,6,14,4740,7,653,7119.333333333333,249.0,93.28571428571428,7,4087,6168.333333333333,1514.0,583.8571428571429
2362.0,17,4,344,2,150,0.0,75.0,75.0,2,194,0.0,103.0,97.0
217510.0,6,3,426,2,280,0.0,214.0,140.0,1,146,0.0,146.0,146.0
40416.0,6,2,132,1,66,0.0,66.0,66.0,1,66,0.0,66.0,66.0
316621.0,17,4,1400,4,1400,105540.33333333331,350.0,350.0,0,0,0.0,0.0,0.0
6626.0,17,2,582,1,83,0.0,83.0,83.0,1,499,0.0,499.0,499.0
145742.0,6,3,373,2,238,0.0,172.0,119.0,1,135,0.0,135.0,135.0
106017536.0,6,43,2838,22,1452,5048442.476190476,66.0,66.0,21,1386,5143992.4,66.0,66.0
120123621.0,6,13,2020,9,1204,15015452.625,188.0,133.77777777777777,4,816,30032768.33333333,204.0,204.0
90040941.0,17,27,12943,27,12943,3463113.1153846155,501.0,479.3703703703704,0,0,0.0,0.0,0.0
432.0,17,2,508,2,508,0.0,257.0,254.0,0,0,0.0,0.0,0.0
216682.0,6,3,426,2,280,0.0,214.0,140.0,1,146,0.0,146.0,146.0
10501095.0,6,7,478,4,272,3451991.6666666665,74.0,68.0,3,206,5177880.0,74.0,68.66666666666667
216817.0,6,3,426,2,280,0.0,214.0,140.0,1,146,0.0,146.0,146.0
34468.0,6,10,2032,5,524,8383.75,252.0,104.8,5,1508,8158.5,1236.0,301.6
90027096.0,17,27,12943,27,12943,3462580.6153846155,501.0,479.3703703703704,0,0,0.0,0.0,0.0
216557.0,17,2,180,1,90,0.0,90.0,90.0,1,90,0.0,90.0,90.0
135127943.0,17,6,1206,6,1206,27025588.6,201.0,201.0,0,0,0.0,0.0,0.0
18079.0,6,13,1459,7,862,3013.1666666666665,271.0,123.14285714285714,6,597,3078.8,259.0,99.5
99863913.0,17,12,778,6,389,19972782.6,174.0,64.83333333333333,6,389,19869047.0,174.0,64.83333333333333
3192709.0,6,12,833,6,437,637631.0,95.0,72.83333333333333,6,396,543386.2,95.0,66.0
305222.0,17,4,1400,4,1400,101740.66666666669,350.0,350.0,0,0,0.0,0.0,0.0
135146480.0,17,6,1146,6,1146,27029296.0,191.0,191.0,0,0,0.0,0.0,0.0
33707178.0,6,5,336,2,134,0.0,68.0,67.0,3,202,16785627.5,70.0,67.33333333333333
1302793.0,6,4,264,2,132,0.0,66.0,66.0,2,132,0.0,66.0,66.0
1304151.0,6,4,264,2,132,0.0,66.0,66.0,2,132,0.0,66.0,66.0
120031176.0,17,28,13364,28,13364,4445599.111111111,501.0,477.2857142857143,0,0,0.0,0.0,0.0
9009196.0,17,2,160,2,160,0.0,80.0,80.0,0,0,0.0,0.0,0.0
135784.0,17,2,762,2,762,0.0,381.0,381.0,0,0,0.0,0.0,0.0
146190.0,17,4,704,2,148,0.0,74.0,74.0,2,556,0.0,280.0,278.0
90008828.0,17,28,13364,28,13364,3333660.296296296,501.0,477.2857142857143,0,0,0.0,0.0,0.0
1502.0,17,2,762,2,762,0.0,381.0,381.0,0,0,0.0,0.0,0.0
205706.0,17,2,180,1,90,0.0,90.0,90.0,1,90,0.0,90.0,90.0
321672.0,17,2,604,1,75,0.0,75.0,75.0,1,529,0.0,529.0,529.0
111553838.0,17,13,821,7,432,18592306.33333333,174.0,61.71428571428572,6,389,18327295.6,174.0,64.83333333333333
244116.0,6,3,337,2,214,0.0,160.0,107.0,1,123,0.0,123.0,123.0
122006893.0,17,15,907,8,475,17429556.14285714,174.0,59.375,7,432,17077121.166666668,174.0,61.71428571428572
2794613.0,6,2,132,1,66,0.0,66.0,66.0,1,66,0.0,66.0,66.0
53035.0,6,10,2032,5,524,12952.25,252.0,104.8,5,1508,12109.25,1236.0,301.6
3782455.0,6,4,270,2,134,0.0,68.0,67.0,2,136,0.0,70.0,68.0
135124284.0,17,6,1206,6,1206,27024856.8,201.0,201.0,0,0,0.0,0.0,0.0
348874.0,17,2,180,1,90,0.0,90.0,90.0,1,90,0.0,90.0,90.0
146089.0,6,3,337,2,214,0.0,160.0,107.0,1,123,0.0,123.0,123.0
207019.0,6,3,426,2,280,0.0,214.0,140.0,1,146,0.0,146.0,146.0
90257651.0,6,12,1832,8,1016,12893950.142857144,188.0,127.0,4,816,30030624.0,204.0,204.0
244303.0,6,3,373,2,238,0.0,172.0,119.0,1,135,0.0,135.0,135.0
2818.0,17,4,344,2,150,0.0,75.0,75.0,2,194,0.0,103.0,97.0
178582.0,17,2,180,1,90,0.0,90.0,90.0,1,90,0.0,90.0,90.0
239566.0,6,4,439,2,238,0.0,172.0,119.0,2,201,0.0,135.0,100.5
26112.0,6,14,4740,7,653,4172.166666666667,249.0,93.28571428571428,7,4087,4116.666666666667,1514.0,583.8571428571429
1299960.0,17,7,490,7,490,216660.0,70.0,70.0,0,0,0.0,0.0,0.0
60632.0,6,14,4740,7,653,9907.833333333334,249.0,93.28571428571428,7,4087,9228.666666666666,1514.0,583.8571428571429
451434.0,17,4,360,2,140,0.0,70.0,70.0,2,220,0.0,110.0,110.0
281232.0,17,2,363,1,79,0.0,79.0,79.0,1,284,0.0,284.0,284.0
210085.0,17,2,180,1,90,0.0,90.0,90.0,1,90,0.0,90.0,90.0
49575.0,6,14,4740,7,653,8136.166666666667,249.0,93.28571428571428,7,4087,6396.5,1514.0,583.8571428571429
132720.0,6,14,4740,7,653,19117.5,249.0,93.28571428571428,7,4087,21836.666666666668,1514.0,583.8571428571429
53958.0,6,10,2032,5,524,12334.25,252.0,104.8,5,1508,12407.75,1236.0,301.6
107207.0,17,2,700,2,700,0.0,350.0,350.0,0,0,0.0,0.0,0.0
237479.0,6,3,337,2,214,0.0,160.0,107.0,1,123,0.0,123.0,123.0
112549035.0,6,201,22602,101,6962,1125399.87,140.0,68.93069306930693,100,15640,1128778.383838384,284.0,156.4
41456.0,6,13,1386,7,789,6870.666666666667,253.0,112.71428571428572,6,597,6428.2,259.0,99.5
120104510.0,6,230,25994,115,7886,1048556.6754385964,140.0,68.57391304347826,115,18108,1037278.5,284.0,157.4608695652174
120019789.0,17,28,13364,28,13364,4445177.37037037,501.0,477.2857142857143,0,0,0.0,0.0,0.0
108127196.0,17,5,955,5,955,27031799.0,191.0,191.0,0,0,0.0,0.0,0.0
35838.0,6,10,2032,5,524,8004.0,252.0,104.8,5,1508,8345.0,1236.0,301.6
147490.0,6,3,373,2,238,0.0,172.0,119.0,1,135,0.0,135.0,135.0
4398323.0,6,49,23728,25,19797,183263.4583333333,1514.0,791.88,24,3931,181937.91304347827,1514.0,163.79166666666666
350.0,17,2,250,1,93,0.0,93.0,93.0,1,157,0.0,157.0,157.0
20589.0,17,2,582,1,83,0.0,83.0,83.0,1,499,0.0,499.0,499.0
121306539.0,6,32,2157,16,1071,7421305.933333334,123.0,66.9375,16,1086,8086937.466666667,123.0,67.875
5015325.0,17,4,849,2,166,0.0,83.0,83.0,2,683,0.0,499.0,341.5
101117973.0,17,14,864,7,432,16837188.333333332,174.0,61.71428571428572,7,432,16833520.833333332,174.0,61.71428571428572
307787.0,17,4,1400,4,1400,102595.66666666669,350.0,350.0,0,0,0.0,0.0,0.0
5622663.0,6,5,336,2,134,0.0,68.0,67.0,3,202,1523860.5,70.0,67.33333333333333
2338.0,17,4,344,2,150,0.0,75.0,75.0,2,194,0.0,103.0,97.0
90002324.0,17,28,13364,28,13364,3333419.407407407,501.0,477.2857142857143,0,0,0.0,0.0,0.0
130977.0,6,12,1320,7,789,21829.5,253.0,112.71428571428572,5,531,30539.75,259.0,106.2
36832.0,6,14,4740,7,653,5672.5,249.0,93.28571428571428,7,4087,5212.333333333333,1514.0,583.8571428571429
48362.0,6,10,2032,5,524,11021.75,252.0,104.8,5,1508,11713.75,1236.0,301.6
306245.0,17,2,180,1,90,0.0,90.0,90.0,1,90,0.0,90.0,90.0
143472.0,6,2,132,1,66,0.0,66.0,66.0,1,66,0.0,66.0,66.0
331.0,17,2,160,1,80,0.0,80.0,80.0,1,80,0.0,80.0,80.0
2013.0,17,4,344,2,150,0.0,75.0,75.0,2,194,0.0,103.0,97.0
44492.0,6,10,2032,5,524,10895.5,252.0,104.8,5,1508,10909.25,1236.0,301.6
120049.0,17,2,180,1,70,0.0,70.0,70.0,1,110,0.0,110.0,110.0
119664007.0,17,35,16705,35,16705,3519529.617647059,501.0,477.2857142857143,0,0,0.0,0.0,0.0
0.0,17,1,80,1,80,0.0,80.0,80.0,0,0,0.0,0.0,0.0
79.0,17,2,762,2,762,0.0,381.0,381.0,0,0,0.0,0.0,0.0
228232.0,17,2,180,1,90,0.0,90.0,90.0,1,90,0.0,90.0,90.0
104905922.0,6,32,2236,16,1165,6979297.133333334,139.0,72.8125,16,1071,6979328.533333333,123.0,66.9375
98254858.0,6,363,48388,182,12234,542844.5193370166,140.0,67.21978021978022,181,36154,544656.6944444445,390.0,199.7458563535912
2071.0,17,4,344,2,150,0.0,75.0,75.0,2,194,0.0,103.0,97.0
95579.0,6,14,4740,7,653,15697.5,249.0,93.28571428571428,7,4087,15444.0,1514.0,583.8571428571429
90255229.0,6,12,1832,8,1016,12893604.142857144,188.0,127.0,4,816,30030971.33333333,204.0,204.0
300.0,17,2,156,1,78,0.0,78.0,78.0,1,78,0.0,78.0,78.0
16910.0,17,2,180,1,90,0.0,90.0,90.0,1,90,0.0,90.0,90.0
318.0,17,2,174,1,79,0.0,79.0,79.0,1,95,0.0,95.0,95.0
254418.0,6,3,337,2,214,0.0,160.0,107.0,1,123,0.0,123.0,123.0
3004192.0,6,11,2106,6,598,600541.8,252.0,99.66666666666669,5,1508,2148.25,1236.0,301.6
2299.0,17,4,344,2,150,0.0,75.0,75.0,2,194,0.0,103.0,97.0
2016.0,17,4,344,2,150,0.0,75.0,75.0,2,194,0.0,103.0,97.0
299443.0,6,7,478,4,272,99814.33333333331,74.0,68.0,3,206,73752.5,74.0,68.66666666666667
42263.0,6,14,4740,7,653,6914.833333333333,249.0,93.28571428571428,7,4087,6829.0,1514.0,583.8571428571429
0.0,17,1,55,1,55,0.0,55.0,55.0,0,0,0.0,0.0,0.0
340.0,17,2,267,1,83,0.0,83.0,83.0,1,184,0.0,184.0,184.0
36811.0,6,14,4740,7,653,5960.0,249.0,93.28571428571428,7,4087,5928.833333333333,1514.0,583.8571428571429
5630773.0,6,4,270,2,134,0.0,68.0,67.0,2,136,0.0,70.0,68.0
108116185.0,17,5,955,5,955,27029046.25,191.0,191.0,0,0,0.0,0.0,0.0
10532113.0,6,7,478,4,272,3465444.6666666665,74.0,68.0,3,206,5198048.0,74.0,68.66666666666667
36111.0,6,10,2032,5,524,8790.5,252.0,104.8,5,1508,7338.75,1236.0,301.6
122314665.0,6,48,3168,24,1584,4907960.478260869,66.0,66.0,24,1584,5299795.043478261,66.0,66.0
334964.0,6,6,412,4,272,111654.66666666669,74.0,68.0,2,140,0.0,74.0,70.0
5826188.0,6,4,270,2,134,0.0,68.0,67.0,2,136,0.0,70.0,68.0
96788354.0,17,14,1126,7,563,16001021.0,174.0,80.42857142857143,7,563,16000126.333333334,174.0,80.42857142857143
318.0,17,2,164,1,82,0.0,82.0,82.0,1,82,0.0,82.0,82.0
27715.0,6,14,4740,7,653,4510.833333333333,249.0,93.28571428571428,7,4087,3494.1666666666665,1514.0,583.8571428571429
2679.0,17,2,762,2,762,0.0,381.0,381.0,0,0,0.0,0.0,0.0
1314438.0,6,4,264,2,132,0.0,66.0,66.0,2,132,0.0,66.0,66.0
298932.0,6,6,412,4,272,99644.0,74.0,68.0,2,140,0.0,74.0,70.0
120092816.0,6,374,43672,187,12638,641152.2634408602,140.0,67.58288770053476,187,31034,641209.4516129033,284.0,165.9572192513369
198937.0,17,2,180,1,90,0.0,90.0,90.0,1,90,0.0,90.0,90.0
117395873.0,6,218,24678,109,17262,1084998.3148148148,300.0,158.36697247706422,109,7416,1085006.4074074074,140.0,68.03669724770643
54982.0,6,14,4740,7,653,8682.333333333334,249.0,93.28571428571428,7,4087,8614.833333333334,1514.0,583.8571428571429
118614940.0,6,48,3168,24,1584,5157171.304347826,66.0,66.0,24,1584,5145191.869565218,66.0,66.0
66924.0,6,14,4740,7,653,10990.666666666666,249.0,93.28571428571428,7,4087,10130.833333333334,1514.0,583.8571428571429
14243377.0,17,6,2052,6,2052,2848675.4,342.0,342.0,0,0,0.0,0.0,0.0
10473505.0,6,7,478,4,272,3444060.6666666665,74.0,68.0,3,206,5165995.0,74.0,68.66666666666667
208408.0,17,2,762,2,762,0.0,381.0,381.0,0,0,0.0,0.0,0.0
204456.0,17,2,762,2,762,0.0,381.0,381.0,0,0,0.0,0.0,0.0
120443193.0,6,23,1775,11,840,12044319.3,95.0,76.36363636363636,12,935,8223117.363636363,95.0,77.91666666666667
403.0,17,2,410,1,78,0.0,78.0,78.0,1,332,0.0,332.0,332.0
22227.0,6,14,4740,7,653,3434.333333333333,249.0,93.28571428571428,7,4087,3563.0,1514.0,583.8571428571429
15871.0,6,10,2032,5,524,3491.0,252.0,104.8,5,1508,3319.25,1236.0,301.6
105408.0,17,2,700,2,700,0.0,350.0,350.0,0,0,0.0,0.0,0.0
97782.0,17,2,762,2,762,0.0,381.0,381.0,0,0,0.0,0.0,0.0
132935.0,6,2,132,1,66,0.0,66.0,66.0,1,66,0.0,66.0,66.0
90951715.0,6,21,1585,11,840,9094467.4,95.0,76.36363636363636,10,745,10105066.777777778,95.0,74.5
90007694.0,17,28,13364,28,13364,3333618.296296296,501.0,477.2857142857143,0,0,0.0,0.0,0.0
40185.0,6,10,2032,5,524,8807.0,252.0,104.8,5,1508,9429.25,1236.0,301.6
5621129.0,6,5,336,2,134,0.0,68.0,67.0,3,202,1417450.0,70.0,67.33333333333333
90291880.0,6,16,1192,8,596,12891902.714285716,95.0,74.5,8,596,12896969.285714284,95.0,74.5
277712.0,17,2,363,1,79,0.0,79.0,79.0,1,284,0.0,284.0,284.0
220786.0,6,10,1221,6,636,44157.2,298.0,106.0,4,585,72760.66666666667,379.0,146.25
108103069.0,17,5,955,5,955,27025767.25,191.0,191.0,0,0,0.0,0.0,0.0
6474.0,17,4,823,2,163,0.0,89.0,81.5,2,660,0.0,443.0,330.0
11742789.0,17,4,1368,4,1368,3914263.0,342.0,342.0,0,0,0.0,0.0,0.0
90233348.0,6,16,1192,8,596,12855513.142857144,95.0,74.5,8,596,12861129.0,95.0,74.5
51624.0,6,14,4740,7,653,8480.5,249.0,93.28571428571428,7,4087,8008.333333333333,1514.0,583.8571428571429
0.0,17,1,55,1,55,0.0,55.0,55.0,0,0,0.0,0.0,0.0
886500.0,6,10,1335,6,798,177300.0,460.0,133.0,4,537,203664.0,331.0,134.25
153431.0,17,2,180,1,90,0.0,90.0,90.0,1,90,0.0,90.0,90.0
111090.0,17,4,1400,4,1400,37030.0,350.0,350.0,0,0,0.0,0.0,0.0
47035.0,6,14,4740,7,653,7709.5,249.0,93.28571428571428,7,4087,6010.5,1514.0,583.8571428571429
53386.0,6,10,2032,5,524,10595.5,252.0,104.8,5,1508,10327.75,1236.0,301.6
135127214.0,17,6,1146,6,1146,27025442.8,191.0,191.0,0,0,0.0,0.0,0.0
311683.0,17,4,622,4,622,103894.33333333331,163.0,155.5,0,0,0.0,0.0,0.0
217981.0,6,4,492,2,280,0.0,214.0,140.0,2,212,0.0,146.0,106.0
217437.0,6,3,426,2,280,0.0,214.0,140.0,1,146,0.0,146.0,146.0
120312226.0,6,214,24202,107,7358,1127335.6603773586,140.0,68.76635514018692,107,16844,1127310.933962264,284.0,157.42056074766356
205456.0,17,2,762,2,762,0.0,381.0,381.0,0,0,0.0,0.0,0.0
108108778.0,17,5,955,5,955,27027194.5,191.0,191.0,0,0,0.0,0.0,0.0
6615.0,17,4,344,2,150,0.0,75.0,75.0,2,194,0.0,103.0,97.0
108108453.0,17,5,1005,5,1005,27027113.25,201.0,201.0,0,0,0.0,0.0,0.0
36567.0,6,14,4740,7,653,5843.166666666667,249.0,93.28571428571428,7,4087,5939.666666666667,1514.0,583.8571428571429
2449105.0,6,49,23728,25,19797,102046.04166666669,1514.0,791.88,24,3931,96291.69565217392,1514.0,163.79166666666666
38182.0,6,14,4740,7,653,6167.5,249.0,93.28571428571428,7,4087,6130.166666666667,1514.0,583.8571428571429
46447.0,6,14,4740,7,653,7087.333333333333,249.0,93.28571428571428,7,4087,7344.666666666667,1514.0,583.8571428571429
120325128.0,6,228,25772,114,7746,1057723.9646017698,140.0,67.94736842105263,114,18026,1057550.0353982302,284.0,158.12280701754386
1730930.0,6,19,7533,10,1403,192325.5555555556,583.0,140.3,9,6130,183930.5,1484.0,681.1111111111111
24613.0,6,14,4740,7,653,3722.0,249.0,93.28571428571428,7,4087,3860.0,1514.0,583.8571428571429
13446.0,6,10,1067,5,536,2416.75,264.0,107.2,5,531,2867.0,259.0,106.2
12803202.0,6,5,1736,2,819,0.0,753.0,409.5,3,917,6337179.0,785.0,305.6666666666667
228438.0,17,2,180,1,90,0.0,90.0,90.0,1,90,0.0,90.0,90.0
355.0,17,2,267,1,83,0.0,83.0,83.0,1,184,0.0,184.0,184.0
441.0,17,2,762,2,762,0.0,381.0,381.0,0,0,0.0,0.0,0.0
303645.0,6,2,132,1,66,0.0,66.0,66.0,1,66,0.0,66.0,66.0
22510.0,6,2,145,2,145,0.0,91.0,72.5,0,0,0.0,0.0,0.0
10003.0,6,10,2032,5,524,2262.25,252.0,104.8,5,1508,2235.75,1236.0,301.6
493539.0,6,5,336,2,134,0.0,68.0,67.0,3,202,192868.5,70.0,67.33333333333333
101710474.0,6,29,2068,15,1105,7249531.214285715,139.0,73.66666666666667,14,963,7807153.461538462,123.0,68.78571428571429
205982.0,17,2,180,1,90,0.0,90.0,90.0,1,90,0.0,90.0,90.0
307686.0,17,4,1400,4,1400,102562.0,350.0,350.0,0,0,0.0,0.0,0.0
230271.0,17,4,1524,4,1524,76757.0,381.0,381.0,0,0,0.0,0.0,0.0
153445.0,17,2,180,1,90,0.0,90.0,90.0,1,90,0.0,90.0,90.0
129801.0,6,2,132,1,66,0.0,66.0,66.0,1,66,0.0,66.0,66.0
0.0,6,1,66,1,66,0.0,66.0,66.0,0,0,0.0,0.0,0.0
90006356.0,17,28,13364,28,13364,3333568.7407407407,501.0,477.2857142857143,0,0,0.0,0.0,0.0
4618.0,17,2,614,1,72,0.0,72.0,72.0,1,542,0.0,542.0,542.0
90026199.0,17,28,13364,28,13364,3334303.6666666665,501.0,477.2857142857143,0,0,0.0,0.0,0.0
97390451.0,17,12,778,6,389,19400798.8,174.0,64.83333333333333,6,389,19400169.0,174.0,64.83333333333333
317041.0,6,6,412,4,272,105680.33333333331,74.0,68.0,2,140,0.0,74.0,70.0
6652.0,17,2,582,1,83,0.0,83.0,83.0,1,499,0.0,499.0,499.0
49040.0,6,14,4740,7,653,8046.166666666667,249.0,93.28571428571428,7,4087,7898.0,1514.0,583.8571428571429
205882.0,17,2,180,1,90,0.0,90.0,90.0,1,90,0.0,90.0,90.0
554.0,17,2,762,2,762,0.0,381.0,381.0,0,0,0.0,0.0,0.0
90304161.0,6,16,1192,8,596,12892078.0,95.0,74.5,8,596,12898897.714285716,95.0,74.5
2300.0,17,2,762,2,762,0.0,381.0,381.0,0,0,0.0,0.0,0.0
107819.0,17,2,286,2,286,0.0,143.0,143.0,0,0,0.0,0.0,0.0
228571.0,17,2,180,1,90,0.0,90.0,90.0,1,90,0.0,90.0,90.0
29536.0,6,10,2032,5,524,6877.5,252.0,104.8,5,1508,7106.0,1236.0,301.6
91787684.0,6,423,54444,212,40296,435012.7203791469,336.0,190.0754716981132,211,14148,436027.6523809524,140.0,67.0521327014218
90255408.0,6,14,2240,8,1016,12893629.714285716,188.0,127.0,6,1224,18018591.8,204.0,204.0
2628871.0,6,3,1604,2,851,0.0,785.0,425.5,1,753,0.0,753.0,753.0
300724.0,6,6,412,4,272,100241.33333333331,74.0,68.0,2,140,0.0,74.0,70.0
32365.0,6,12,1413,7,882,5394.166666666667,291.0,126.0,5,531,6876.75,259.0,106.2
206100.0,6,3,426,2,280,0.0,214.0,140.0,1,146,0.0,146.0,146.0
4601716.0,6,5,336,2,134,0.0,68.0,67.0,3,202,1526305.5,70.0,67.33333333333333
1758230.0,6,2,132,1,66,0.0,66.0,66.0,1,66,0.0,66.0,66.0
303663.0,6,6,412,4,272,101221.0,74.0,68.0,2,140,0.0,74.0,70.0
98509198.0,6,540,86128,270,18190,366125.2713754647,214.0,67.37037037037037,270,67938,366095.936802974,1514.0,251.62222222222223
2084495.0,6,23,7479,12,2450,189499.54545454544,1034.0,204.16666666666663,11,5029,177279.9,1510.0,457.1818181818182
43099.0,6,14,4740,7,653,6169.166666666667,249.0,93.28571428571428,7,4087,6801.666666666667,1514.0,583.8571428571429
32935.0,6,14,4740,7,653,5377.333333333333,249.0,93.28571428571428,7,4087,5218.333333333333,1514.0,583.8571428571429
14026366.0,17,6,2052,6,2052,2805273.2,342.0,342.0,0,0,0.0,0.0,0.0
311934.0,17,4,1524,4,1524,103978.0,381.0,381.0,0,0,0.0,0.0,0.0
228259.0,17,2,180,1,90,0.0,90.0,90.0,1,90,0.0,90.0,90.0
143936.0,17,2,180,1,90,0.0,90.0,90.0,1,90,0.0,90.0,90.0
51254.0,6,10,2032,5,524,12586.25,252.0,104.8,5,1508,8189.5,1236.0,301.6
120126087.0,6,15,2428,9,1204,15015760.875,188.0,133.77777777777777,6,1224,18017860.6,204.0,204.0
25861.0,6,14,4740,7,653,3702.5,249.0,93.28571428571428,7,4087,4170.166666666667,1514.0,583.8571428571429
28980.0,6,14,4740,7,653,4388.833333333333,249.0,93.28571428571428,7,4087,4276.5,1514.0,583.8571428571429
303148.0,6,6,412,4,272,101049.33333333331,74.0,68.0,2,140,0.0,74.0,70.0
1538317.0,6,19,7533,10,1403,170924.11111111112,583.0,140.3,9,6130,160177.0,1484.0,681.1111111111111
103292.0,17,2,286,2,286,0.0,143.0,143.0,0,0,0.0,0.0,0.0
217551.0,6,3,426,2,280,0.0,214.0,140.0,1,146,0.0,146.0,146.0
65522.0,6,13,1386,7,789,10703.833333333334,253.0,112.71428571428572,6,597,10860.8,259.0,99.5
90876722.0,6,171,19288,86,5824,1069137.905882353,140.0,67.72093023255815,85,13464,1070777.0714285714,284.0,158.4
11462.0,6,10,2032,5,524,2446.25,252.0,104.8,5,1508,2382.5,1236.0,301.6
111429.0,6,14,4740,7,653,18446.0,249.0,93.28571428571428,7,4087,18066.166666666668,1514.0,583.8571428571429
108107891.0,17,5,1005,5,1005,27026972.75,201.0,201.0,0,0,0.0,0.0,0.0
90274182.0,6,12,1832,8,1016,12896311.714285716,188.0,127.0,4,816,30036400.33333333,204.0,204.0
740.0,17,4,438,2,148,0.0,74.0,74.0,2,290,0.0,147.0,145.0
132540.0,6,2,132,1,66,0.0,66.0,66.0,1,66,0.0,66.0,66.0
120125754.0,6,15,2428,9,1204,15015719.25,188.0,133.77777777777777,6,1224,18074037.6,204.0,204.0
2419.0,17,4,344,2,150,0.0,75.0,75.0,2,194,0.0,103.0,97.0
23551.0,17,2,180,1,90,0.0,90.0,90.0,1,90,0.0,90.0,90.0
135127248.0,17,6,1206,6,1206,27025449.6,201.0,201.0,0,0,0.0,0.0,0.0
14982.0,17,2,180,1,90,0.0,90.0,90.0,1,90,0.0,90.0,90.0
153420.0,17,2,180,1,90,0.0,90.0,90.0,1,90,0.0,90.0,90.0
779.0,17,4,438,2,148,0.0,74.0,74.0,2,290,0.0,147.0,145.0
90057119.0,17,27,12943,27,12943,3463735.346153846,501.0,479.3703703703704,0,0,0.0,0.0,0.0
45362.0,6,14,4740,7,653,7272.5,249.0,93.28571428571428,7,4087,7180.666666666667,1514.0,583.8571428571429
205947.0,6,3,426,2,280,0.0,214.0,140.0,1,146,0.0,146.0,146.0
325069.0,17,4,1400,4,1400,108356.33333333331,350.0,350.0,0,0,0.0,0.0,0.0
251718.0,6,10,1221,6,636,50343.6,298.0,106.0,4,585,78436.66666666667,379.0,146.25
2567.0,17,4,344,2,150,0.0,75.0,75.0,2,194,0.0,103.0,97.0
96593781.0,6,31,2298,16,1212,6439585.4,123.0,75.75,15,1086,6884105.642857143,123.0,72.4
117137705.0,6,47,3102,24,1584,5079284.391304348,66.0,66.0,23,1518,5155439.5,66.0,66.0
2396.0,17,4,344,2,150,0.0,75.0,75.0,2,194,0.0,103.0,97.0
227859.0,6,3,426,2,280,0.0,214.0,140.0,1,146,0.0,146.0,146.0
123520901.0,6,48,3168,24,1584,4999879.869565218,66.0,66.0,24,1584,5313945.434782608,66.0,66.0
90257808.0,6,13,2036,8,1016,12893972.57142857,188.0,127.0,5,1020,22523910.25,204.0,204.0
5831271.0,6,5,336,2,134,0.0,68.0,67.0,3,202,1526846.0,70.0,67.33333333333333
38623.0,6,10,2032,5,524,9071.5,252.0,104.8,5,1508,7397.0,1236.0,301.6
162272.0,17,2,180,1,90,0.0,90.0,90.0,1,90,0.0,90.0,90.0
3159.0,17,4,344,2,150,0.0,75.0,75.0,2,194,0.0,103.0,97.0
192371.0,17,2,180,1,90,0.0,90.0,90.0,1,90,0.0,90.0,90.0
90293631.0,6,16,1192,8,596,12892612.57142857,95.0,74.5,8,596,12897781.285714284,95.0,74.5
46829.0,6,14,4740,7,653,6993.833333333333,249.0,93.28571428571428,7,4087,7666.666666666667,1514.0,583.8571428571429
237787.0,6,3,337,2,214,0.0,160.0,107.0,1,123,0.0,123.0,123.0
323341.0,6,5,367,2,132,0.0,66.0,66.0,3,235,161670.5,103.0,78.33333333333333
100327774.0,17,12,778,6,389,19800822.8,174.0,64.83333333333333,6,389,20000165.8,174.0,64.83333333333333
303411.0,6,6,412,4,272,101137.0,74.0,68.0,2,140,0.0,74.0,70.0
90258451.0,6,13,2036,8,1016,12894064.42857143,188.0,127.0,5,1020,22522418.75,204.0,204.0
10468533.0,6,7,478,4,272,3444300.333333333,74.0,68.0,3,206,5166346.5,74.0,68.66666666666667
196837.0,17,2,180,1,90,0.0,90.0,90.0,1,90,0.0,90.0,90.0
2329.0,17,4,344,2,150,0.0,75.0,75.0,2,194,0.0,103.0,97.0
234592.0,6,3,337,2,214,0.0,160.0,107.0,1,123,0.0,123.0,123.0
109309230.0,6,240,27320,120,8216,918564.9579831932,140.0,68.46666666666667,120,19104,916702.9915966388,284.0,159.2
90259391.0,6,12,1832,8,1016,12894198.714285716,188.0,127.0,4,816,30032378.666666668,204.0,204.0
52725.0,6,14,4740,7,653,7546.5,249.0,93.28571428571428,7,4087,7250.0,1514.0,583.8571428571429
24824.0,6,14,4740,7,653,4013.6666666666665,249.0,93.28571428571428,7,4087,4001.3333333333335,1514.0,583.8571428571429
5623210.0,6,4,270,2,134,0.0,68.0,67.0,2,136,0.0,70.0,68.0
329.0,17,2,174,1,79,0.0,79.0,79.0,1,95,0.0,95.0,95.0
123839954.0,6,49,3234,25,1650,5159998.083333333,66.0,66.0,24,1584,5123904.260869565,66.0,66.0
310331.0,6,6,412,4,272,103443.66666666669,74.0,68.0,2,140,0.0,74.0,70.0
2274.0,17,4,344,2,150,0.0,75.0,75.0,2,194,0.0,103.0,97.0
3044860.0,6,3,1604,1,753,0.0,753.0,753.0,2,851,0.0,785.0,425.5
207138.0,6,3,426,2,280,0.0,214.0,140.0,1,146,0.0,146.0,146.0
90223690.0,6,22,1680,10,745,9996779.777777778,95.0,74.5,12,935,8182504.272727272,95.0,77.91666666666667
206318.0,6,3,426,2,280,0.0,214.0,140.0,1,146,0.0,146.0,146.0
135130056.0,17,6,1206,6,1206,27026011.2,201.0,201.0,0,0,0.0,0.0,0.0
905868.0,6,12,1354,6,723,179796.6,253.0,120.5,6,631,180154.6,293.0,105.16666666666669
10505662.0,6,6,412,3,206,5182477.5,74.0,68.66666666666667,3,206,5182362.0,74.0,68.66666666666667
146179.0,6,3,337,2,214,0.0,160.0,107.0,1,123,0.0,123.0,123.0
99157017.0,17,12,778,6,389,19831403.4,174.0,64.83333333333333,6,389,19737131.0,174.0,64.83333333333333
4335.0,17,2,614,1,72,0.0,72.0,72.0,1,542,0.0,542.0,542.0
120121497.0,6,16,2648,8,1632,17160213.85714286,204.0,204.0,8,1016,17136619.14285714,188.0,127.0
307780.0,6,6,412,4,272,102593.33333333331,74.0,68.0,2,140,0.0,74.0,70.0
1316950.0,6,4,264,2,132,0.0,66.0,66.0,2,132,0.0,66.0,66.0
1665454.0,6,23,6509,12,1529,151404.9090909091,357.0,127.41666666666669,11,4980,136267.9,1510.0,452.7272727272728
1928183.0,17,4,820,2,156,0.0,78.0,78.0,2,664,0.0,332.0,332.0
164726.0,17,2,414,1,88,0.0,88.0,88.0,1,326,0.0,326.0,326.0
38209.0,6,14,4740,7,653,5828.166666666667,249.0,93.28571428571428,7,4087,5749.5,1514.0,583.8571428571429
100007452.0,17,11,473,6,258,20001490.4,43.0,43.0,5,215,20000195.75,43.0,43.0
108084393.0,17,5,955,5,955,27021098.25,191.0,191.0,0,0,0.0,0.0,0.0
5005047.0,17,4,849,2,166,0.0,83.0,83.0,2,683,0.0,499.0,341.5
5154.0,17,4,571,2,148,0.0,74.0,74.0,2,423,0.0,276.0,211.5
2331.0,17,4,344,2,150,0.0,75.0,75.0,2,194,0.0,103.0,97.0
15019893.0,17,6,2718,6,2718,3003978.6,453.0,453.0,0,0,0.0,0.0,0.0
106116.0,17,2,762,2,762,0.0,381.0,381.0,0,0,0.0,0.0,0.0
103215.0,17,2,286,2,286,0.0,143.0,143.0,0,0,0.0,0.0,0.0
271705.0,6,10,1221,6,636,54341.0,298.0,106.0,4,585,84897.33333333333,379.0,146.25
240462.0,6,3,337,2,214,0.0,160.0,107.0,1,123,0.0,123.0,123.0
246088.0,6,3,337,2,214,0.0,160.0,107.0,1,123,0.0,123.0,123.0
231988.0,6,3,337,2,214,0.0,160.0,107.0,1,123,0.0,123.0,123.0
27615138.0,17,5,1710,5,1710,6903784.5,342.0,342.0,0,0,0.0,0.0,0.0
8477277.0,6,159,152298,46,3226,188383.9333333333,224.0,70.1304347826087,113,149072,75576.96428571429,1514.0,1319.2212389380531
2661.0,17,4,344,2,150,0.0,75.0,75.0,2,194,0.0,103.0,97.0
1485820.0,17,16,1120,16,1120,99054.66666666669,70.0,70.0,0,0,0.0,0.0,0.0
135137311.0,17,6,1146,6,1146,27027462.2,191.0,191.0,0,0,0.0,0.0,0.0
351.0,17,2,267,1,83,0.0,83.0,83.0,1,184,0.0,184.0,184.0
120358955.0,6,223,25246,112,17624,1084314.9099099098,284.0,157.35714285714286,111,7622,1085754.2454545454,140.0,68.66666666666667
2077.0,17,4,344,2,150,0.0,75.0,75.0,2,194,0.0,103.0,97.0
239262.0,17,2,180,1,90,0.0,90.0,90.0,1,90,0.0,90.0,90.0
330.0,17,2,166,1,75,0.0,75.0,75.0,1,91,0.0,91.0,91.0
363.0,17,2,267,1,83,0.0,83.0,83.0,1,184,0.0,184.0,184.0
2159621.0,6,24,7544,12,2450,196329.18181818185,1034.0,204.16666666666663,12,5094,167560.0,1510.0,424.5
171978.0,17,2,180,1,90,0.0,90.0,90.0,1,90,0.0,90.0,90.0
206195.0,6,3,426,2,280,0.0,214.0,140.0,1,146,0.0,146.0,146.0
2404426.0,6,3,1604,2,851,0.0,785.0,425.5,1,753,0.0,753.0,753.0
23473.0,6,11,2098,6,590,3242.4,252.0,98.33333333333331,5,1508,5405.25,1236.0,301.6
3006661.0,6,11,2106,6,598,601043.0,252.0,99.66666666666669,5,1508,1691.25,1236.0,301.6
90157931.0,6,14,1870,7,994,15025819.5,199.0,142.0,7,876,15025832.833333334,204.0,125.14285714285714
324.0,17,2,174,1,79,0.0,79.0,79.0,1,95,0.0,95.0,95.0
28551818.0,6,24,7245,13,1707,2379318.1666666665,408.0,131.30769230769232,11,5538,2475129.3,1514.0,503.45454545454544
320546.0,17,4,704,2,148,0.0,74.0,74.0,2,556,0.0,280.0,278.0
17376.0,17,2,180,1,90,0.0,90.0,90.0,1,90,0.0,90.0,90.0
219755.0,6,4,492,2,280,0.0,214.0,140.0,2,212,0.0,146.0,106.0
100000798.0,17,13,821,7,432,16666799.666666666,174.0,61.71428571428572,6,389,16000702.8,174.0,64.83333333333333
2395.0,17,4,344,2,150,0.0,75.0,75.0,2,194,0.0,103.0,97.0
281048.0,6,10,1221,6,636,56209.6,298.0,106.0,4,585,87290.0,379.0,146.25
135133633.0,17,6,1206,6,1206,27026726.6,201.0,201.0,0,0,0.0,0.0,0.0
25607.0,6,11,2098,6,590,4496.0,252.0,98.33333333333331,5,1508,6158.25,1236.0,301.6
107058931.0,6,43,2838,22,1452,5098032.476190476,66.0,66.0,21,1386,5144016.25,66.0,66.0
33180.0,6,10,2032,5,524,6344.0,252.0,104.8,5,1508,8044.75,1236.0,301.6
209568.0,17,2,180,1,90,0.0,90.0,90.0,1,90,0.0,90.0,90.0
108104716.0,17,5,1005,5,1005,27026179.0,201.0,201.0,0,0,0.0,0.0,0.0
241834.0,6,3,373,2,238,0.0,172.0,119.0,1,135,0.0,135.0,135.0
100082098.0,17,12,516,6,258,20001548.0,43.0,43.0,6,258,20000162.4,43.0,43.0
108113015.0,17,5,955,5,955,27028253.75,191.0,191.0,0,0,0.0,0.0,0.0
3594.0,17,4,571,2,148,0.0,74.0,74.0,2,423,0.0,280.0,211.5
114097451.0,6,47,3102,24,1584,4947319.478260869,66.0,66.0,23,1518,5150438.318181818,66.0,66.0
113163106.0,6,48,3168,24,1584,4920135.043478261,66.0,66.0,24,1584,4910736.0,66.0,66.0
108120630.0,17,5,1005,5,1005,27030157.5,201.0,201.0,0,0,0.0,0.0,0.0
120124258.0,6,15,2290,9,1204,15015532.25,188.0,133.77777777777777,6,1086,18080098.6,204.0,181.0
90029876.0,17,28,13364,28,13364,3334439.851851852,501.0,477.2857142857143,0,0,0.0,0.0,0.0
1752890.0,17,6,1230,3,234,876243.5,78.0,78.0,3,996,876237.0,332.0,332.0
31116.0,6,10,2032,5,524,7399.25,252.0,104.8,5,1508,7514.75,1236.0,301.6
36659.0,6,14,4740,7,653,5379.0,249.0,93.28571428571428,7,4087,5908.666666666667,1514.0,583.8571428571429
90534611.0,6,14,2240,8,1016,12933515.857142856,188.0,127.0,6,1224,18074177.4,204.0,204.0
98462894.0,6,31,2314,16,1228,6564192.933333334,139.0,76.75,15,1086,7017621.785714285,123.0,72.4
939013.0,6,12,2709,7,743,156502.16666666666,339.0,106.14285714285714,5,1966,165856.5,1514.0,393.2
0.0,17,1,179,1,179,0.0,179.0,179.0,0,0,0.0,0.0,0.0
9802.0,17,2,571,1,86,0.0,86.0,86.0,1,485,0.0,485.0,485.0
44434.0,6,10,2032,5,524,8701.5,252.0,104.8,5,1508,10882.5,1236.0,301.6
120177731.0,6,230,25978,115,7886,1048263.350877193,140.0,68.57391304347826,115,18092,1037887.9824561405,284.0,157.3217391304348
3171892.0,6,18,1536,9,962,358361.75,315.0,106.88888888888889,9,574,358325.875,78.0,63.77777777777778
147138.0,6,3,373,2,238,0.0,172.0,119.0,1,135,0.0,135.0,135.0
13861.0,6,10,2032,5,524,2822.0,252.0,104.8,5,1508,3019.0,1236.0,301.6
232986.0,6,3,337,2,214,0.0,160.0,107.0,1,123,0.0,123.0,123.0
786.0,17,4,438,2,148,0.0,74.0,74.0,2,290,0.0,147.0,145.0
97471812.0,6,29,1999,15,1017,6962272.285714285,123.0,67.8,14,982,7480112.923076923,139.0,70.14285714285714
122804285.0,17,14,995,7,432,17500156.0,174.0,61.71428571428572,7,563,19671727.0,174.0,80.42857142857143
382.0,17,2,166,1,75,0.0,75.0,75.0,1,91,0.0,91.0,91.0
5671848.0,17,5,1710,5,1710,1417962.0,342.0,342.0,0,0,0.0,0.0,0.0
123235.0,6,3,337,2,214,0.0,160.0,107.0,1,123,0.0,123.0,123.0
254648.0,6,14,4740,7,653,36546.16666666666,249.0,93.28571428571428,7,4087,36687.0,1514.0,583.8571428571429
135113950.0,17,6,1146,6,1146,27022790.0,191.0,191.0,0,0,0.0,0.0,0.0
1048356.0,6,11,1134,6,558,209671.2,220.0,93.0,5,576,260854.0,304.0,115.2
146153.0,6,3,337,2,214,0.0,160.0,107.0,1,123,0.0,123.0,123.0
10509194.0,6,7,478,4,272,3457693.0,74.0,68.0,3,206,5186446.5,74.0,68.66666666666667
63785.99999999999,6,14,4740,7,653,10007.166666666666,249.0,93.28571428571428,7,4087,10336.0,1514.0,583.8571428571429
1172014.0,6,13,3010,8,2382,167430.57142857142,1514.0,297.75,5,628,224194.5,331.0,125.6
852.0,17,4,438,2,148,0.0,74.0,74.0,2,290,0.0,147.0,145.0
228297.0,17,2,180,1,90,0.0,90.0,90.0,1,90,0.0,90.0,90.0
2801045.0,6,2,132,1,66,0.0,66.0,66.0,1,66,0.0,66.0,66.0
108118029.0,17,5,955,5,955,27029507.25,191.0,191.0,0,0,0.0,0.0,0.0
21550.0,6,14,4740,7,653,2928.333333333333,249.0,93.28571428571428,7,4087,3450.5,1514.0,583.8571428571429
19279.0,6,10,2032,5,524,4599.0,252.0,104.8,5,1508,4553.0,1236.0,301.6
46987.0,6,10,2032,5,524,11301.75,252.0,104.8,5,1508,11056.75,1236.0,301.6
5851505.0,6,5,336,2,134,0.0,68.0,67.0,3,202,1531816.0,70.0,67.33333333333333
14294.0,6,14,4740,7,653,2274.0,249.0,93.28571428571428,7,4087,2244.833333333333,1514.0,583.8571428571429
3082572.0,6,5,336,2,134,0.0,68.0,67.0,3,202,1424060.5,70.0,67.33333333333333
8937146.0,6,11,2106,6,598,1787211.6,252.0,99.66666666666669,5,1508,1841.0,1236.0,301.6
54036800.0,17,3,573,3,573,27018400.0,191.0,191.0,0,0,0.0,0.0,0.0
234172.0,6,3,337,2,214,0.0,160.0,107.0,1,123,0.0,123.0,123.0
216423.0,6,3,426,2,280,0.0,214.0,140.0,1,146,0.0,146.0,146.0
34420.0,6,14,4740,7,653,5496.833333333333,249.0,93.28571428571428,7,4087,5600.5,1514.0,583.8571428571429
120894.0,6,3,337,2,214,0.0,160.0,107.0,1,123,0.0,123.0,123.0
1302546.0,6,4,264,2,132,0.0,66.0,66.0,2,132,0.0,66.0,66.0
246395.0,6,3,337,2,214,0.0,160.0,107.0,1,123,0.0,123.0,123.0
101019611.0,17,14,864,7,432,16835839.0,174.0,61.71428571428572,7,432,16833497.333333332,174.0,61.71428571428572
1498480.0,6,20,6434,12,1921,136225.45454545456,620.0,160.08333333333334,8,4513,175032.42857142858,1514.0,564.125
2393.0,17,4,344,2,150,0.0,75.0,75.0,2,194,0.0,103.0,97.0
5623428.0,6,5,336,2,134,0.0,68.0,67.0,3,202,1425531.5,70.0,67.33333333333333
302453.0,6,2,132,1,66,0.0,66.0,66.0,1,66,0.0,66.0,66.0
2295.0,17,4,344,2,150,0.0,75.0,75.0,2,194,0.0,103.0,97.0
261757.00000000003,17,2,180,1,90,0.0,90.0,90.0,1,90,0.0,90.0,90.0
153437.0,17,2,180,1,90,0.0,90.0,90.0,1,90,0.0,90.0,90.0
56607.0,6,10,2032,5,524,13937.0,252.0,104.8,5,1508,12080.0,1236.0,301.6
108546063.0,6,44,2904,22,1452,5168860.142857143,66.0,66.0,22,1452,5155879.761904762,66.0,66.0
108281.0,17,2,286,2,286,0.0,143.0,143.0,0,0,0.0,0.0,0.0
308685.0,6,6,412,4,272,102895.0,74.0,68.0,2,140,0.0,74.0,70.0
319959.0,17,4,1400,4,1400,106653.0,350.0,350.0,0,0,0.0,0.0,0.0
135138705.0,17,6,1146,6,1146,27027741.0,191.0,191.0,0,0,0.0,0.0,0.0
52382.0,6,14,4740,7,653,8610.166666666666,249.0,93.28571428571428,7,4087,8543.166666666666,1514.0,583.8571428571429
30785.0,6,10,2032,5,524,7459.0,252.0,104.8,5,1508,7417.25,1236.0,301.6
228339.0,17,2,180,1,90,0.0,90.0,90.0,1,90,0.0,90.0,90.0
2042273.0,6,25,7065,13,2047,170189.41666666666,575.0,157.46153846153845,12,5018,157244.45454545456,1510.0,418.1666666666667
116864129.0,6,48,3168,24,1584,5081049.0869565215,66.0,66.0,24,1584,5067839.695652174,66.0,66.0
171978.0,17,2,180,1,90,0.0,90.0,90.0,1,90,0.0,90.0,90.0
90258579.0,6,17,2572,9,1204,11282322.375,188.0,133.77777777777777,8,1368,12870443.42857143,204.0,171.0
11163.0,17,4,823,2,163,0.0,89.0,81.5,2,660,0.0,443.0,330.0
269300.0,17,2,180,1,90,0.0,90.0,90.0,1,90,0.0,90.0,90.0
147321.0,17,4,704,2,148,0.0,74.0,74.0,2,556,0.0,280.0,278.0
90257916.0,6,13,2036,8,1016,12893988.0,188.0,127.0,5,1020,22523333.25,204.0,204.0
1352122.0,6,2,132,1,66,0.0,66.0,66.0,1,66,0.0,66.0,66.0
117219773.0,6,221,25040,111,17558,1065634.3,284.0,158.18018018018017,110,7482,1066961.4311926605,140.0,68.01818181818182
121461439.0,6,211,23802,106,16576,1156775.6095238095,284.0,156.37735849056602,105,7226,1138269.1826923075,140.0,68.81904761904762
86.0,17,2,762,2,762,0.0,381.0,381.0,0,0,0.0,0.0,0.0
90059176.0,17,27,12943,27,12943,3463814.461538461,501.0,479.3703703703704,0,0,0.0,0.0,0.0
315019.0,17,4,1400,4,1400,105006.33333333331,350.0,350.0,0,0,0.0,0.0,0.0
20398.0,6,10,2032,5,524,4875.75,252.0,104.8,5,1508,4762.0,1236.0,301.6
59192.0,6,14,4740,7,653,9573.333333333334,249.0,93.28571428571428,7,4087,8429.166666666666,1514.0,583.8571428571429
2005.0,17,4,344,2,150,0.0,75.0,75.0,2,194,0.0,103.0,97.0
113901351.0,6,33,2412,17,1272,7105334.125,123.0,74.82352941176471,16,1140,7579023.2,123.0,71.25
117562954.0,6,210,23630,105,16404,1128331.125,284.0,156.22857142857143,105,7226,1128331.0384615385,140.0,68.81904761904762
206195.0,17,2,762,2,762,0.0,381.0,381.0,0,0,0.0,0.0,0.0
1179716.0,6,13,3008,8,2380,168530.85714285713,1514.0,297.5,5,628,225174.0,331.0,125.6
108083.0,17,2,700,2,700,0.0,350.0,350.0,0,0,0.0,0.0,0.0
144899.0,17,2,180,1,70,0.0,70.0,70.0,1,110,0.0,110.0,110.0
108108125.0,17,5,1005,5,1005,27027031.25,201.0,201.0,0,0,0.0,0.0,0.0
3126.0,17,2,224,1,76,0.0,76.0,76.0,1,148,0.0,148.0,148.0
296351.0,6,6,412,4,272,98783.66666666669,74.0,68.0,2,140,0.0,74.0,70.0
2967801.0,6,3,1604,1,753,0.0,753.0,753.0,2,851,0.0,785.0,425.5
102844095.0,6,28,1860,14,966,7894491.615384615,123.0,69.0,14,894,7894492.0,123.0,63.85714285714285
3496.0,17,2,359,1,75,0.0,75.0,75.0,1,284,0.0,284.0,284.0
198394.0,17,2,180,1,90,0.0,90.0,90.0,1,90,0.0,90.0,90.0
314216.0,17,4,622,4,622,104738.66666666669,163.0,155.5,0,0,0.0,0.0,0.0
248306.0,6,3,373,2,238,0.0,172.0,119.0,1,135,0.0,135.0,135.0
83910.0,6,15,4806,8,719,11888.857142857143,249.0,89.875,7,4087,13420.5,1514.0,583.8571428571429
232991.0,6,3,337,2,214,0.0,160.0,107.0,1,123,0.0,123.0,123.0
119615086.0,6,238,26844,119,18694,1011853.3813559322,284.0,157.0924369747899,119,8150,1011853.1610169492,140.0,68.4873949579832
90954282.0,6,21,1585,11,840,9093968.9,95.0,76.36363636363636,10,745,10105391.555555556,95.0,74.5
305771.0,6,3,202,2,128,0.0,74.0,64.0,1,74,0.0,74.0,74.0
853.0,17,4,438,2,148,0.0,74.0,74.0,2,290,0.0,147.0,145.0
310758.0,17,4,1400,4,1400,103586.0,350.0,350.0,0,0,0.0,0.0,0.0
120122733.0,6,13,2036,8,1016,17137156.57142857,188.0,127.0,5,1020,22523255.75,204.0,204.0
1343871.0,17,16,1120,16,1120,89591.4,70.0,70.0,0,0,0.0,0.0,0.0
5000826.0,17,4,629,2,156,0.0,78.0,78.0,2,473,0.0,268.0,236.5
208056.0,6,3,426,2,280,0.0,214.0,140.0,1,146,0.0,146.0,146.0
74911.0,6,11,2098,6,590,13723.4,252.0,98.33333333333331,5,1508,15377.5,1236.0,301.6
90019398.0,17,28,13364,28,13364,3334051.777777778,501.0,477.2857142857143,0,0,0.0,0.0,0.0
76826.0,6,12,1413,7,882,12804.333333333334,291.0,126.0,5,531,14205.0,259.0,106.2
103005977.0,17,13,821,7,432,17167662.833333332,174.0,61.71428571428572,6,389,16600155.4,174.0,64.83333333333333
20315.0,17,2,582,1,83,0.0,83.0,83.0,1,499,0.0,499.0,499.0
302145.0,6,7,478,4,272,100715.0,74.0,68.0,3,206,75221.5,74.0,68.66666666666667
90551760.0,6,306,36552,153,10320,590275.8157894737,140.0,67.45098039215686,153,26232,590288.9210526316,374.0,171.45098039215685
90040326.0,17,28,13364,28,13364,3334826.888888889,501.0,477.2857142857143,0,0,0.0,0.0,0.0
120217704.0,6,222,25122,111,7548,1085470.2727272727,140.0,68.0,111,17574,1085430.0909090908,284.0,158.32432432432432
209094.0,17,2,762,2,762,0.0,381.0,381.0,0,0,0.0,0.0,0.0
205825.0,17,2,180,1,90,0.0,90.0,90.0,1,90,0.0,90.0,90.0
54725.0,6,14,4740,7,653,8988.833333333334,249.0,93.28571428571428,7,4087,8613.333333333334,1514.0,583.8571428571429
3255244.0,6,152,132053,94,123923,35002.62365591398,1510.0,1318.3297872340424,58,8130,51839.80701754386,1510.0,140.17241379310346
90012290.0,17,28,13364,28,13364,3333788.5185185187,501.0,477.2857142857143,0,0,0.0,0.0,0.0
122660019.0,6,218,24534,109,7490,1104441.0648148148,140.0,68.71559633027523,109,17044,1128282.3425925926,284.0,156.36697247706422
22003.0,6,14,4740,7,653,3559.833333333333,249.0,93.28571428571428,7,4087,3483.333333333333,1514.0,583.8571428571429
7698403.0,6,5,1736,2,819,0.0,753.0,409.5,3,917,3777463.5,785.0,305.6666666666667
282279.0,17,2,180,1,90,0.0,90.0,90.0,1,90,0.0,90.0,90.0
104558024.0,17,14,1126,7,563,17333500.0,174.0,80.42857142857143,7,563,17335940.5,174.0,80.42857142857143
106288395.0,17,14,864,7,432,17688046.5,174.0,61.71428571428572,7,432,17634297.5,174.0,61.71428571428572
793.0,17,5,550,5,550,198.25,110.0,110.0,0,0,0.0,0.0,0.0
118716438.0,6,216,24440,108,17016,1107487.6822429907,284.0,157.55555555555554,108,7424,1107488.3177570093,140.0,68.74074074074075
39750.0,6,10,2032,5,524,9688.25,252.0,104.8,5,1508,7832.0,1236.0,301.6
90256163.0,6,14,2240,8,1016,12893737.57142857,188.0,127.0,6,1224,18018197.0,204.0,204.0
206253.0,6,3,426,2,280,0.0,214.0,140.0,1,146,0.0,146.0,146.0
309948.0,6,6,412,4,272,103316.0,74.0,68.0,2,140,0.0,74.0,70.0
103328.0,17,2,286,2,286,0.0,143.0,143.0,0,0,0.0,0.0,0.0
16092216.0,17,6,2052,6,2052,3218443.2,342.0,342.0,0,0,0.0,0.0,0.0
228503.0,17,2,180,1,90,0.0,90.0,90.0,1,90,0.0,90.0,90.0
203810.0,17,2,762,2,762,0.0,381.0,381.0,0,0,0.0,0.0,0.0
25356.0,6,14,4740,7,653,3830.1666666666665,249.0,93.28571428571428,7,4087,4016.8333333333335,1514.0,583.8571428571429
3178062.0,6,18,1495,9,921,358374.875,315.0,102.33333333333331,9,574,358348.25,78.0,63.77777777777778
1404.0,17,5,550,5,550,351.0,110.0,110.0,0,0,0.0,0.0,0.0
190693.0,17,2,180,1,90,0.0,90.0,90.0,1,90,0.0,90.0,90.0
35690.0,6,14,4740,7,653,5671.0,249.0,93.28571428571428,7,4087,5393.5,1514.0,583.8571428571429
99899.0,17,2,762,2,762,0.0,381.0,381.0,0,0,0.0,0.0,0.0
102995.0,17,2,286,2,286,0.0,143.0,143.0,0,0,0.0,0.0,0.0
20399.0,6,2,145,2,145,0.0,91.0,72.5,0,0,0.0,0.0,0.0
10465940.0,6,7,478,4,272,3441946.6666666665,74.0,68.0,3,206,5162806.5,74.0,68.66666666666667
112889.0,17,2,286,2,286,0.0,143.0,143.0,0,0,0.0,0.0,0.0
1312.0,17,4,820,2,156,0.0,78.0,78.0,2,664,0.0,332.0,332.0
3342.0,17,4,344,2,150,0.0,75.0,75.0,2,194,0.0,103.0,97.0
361395.0,6,11,1021,6,444,48555.8,162.0,74.0,5,577,60514.0,349.0,115.4
155469.0,6,3,337,2,214,0.0,160.0,107.0,1,123,0.0,123.0,123.0
26870.0,6,10,2032,5,524,6491.0,252.0,104.8,5,1508,4972.75,1236.0,301.6
122111.0,6,3,337,2,214,0.0,160.0,107.0,1,123,0.0,123.0,123.0
0.0,6,1,66,1,66,0.0,66.0,66.0,0,0,0.0,0.0,0.0
121322.0,6,3,337,2,214,0.0,160.0,107.0,1,123,0.0,123.0,123.0
303442.0,6,6,412,4,272,101147.33333333331,74.0,68.0,2,140,0.0,74.0,70.0
313784.0,6,6,412,4,272,104594.66666666669,74.0,68.0,2,140,0.0,74.0,70.0
1307914.0,17,7,490,7,490,217985.66666666663,70.0,70.0,0,0,0.0,0.0,0.0
161174.0,6,2,128,1,74,0.0,74.0,74.0,1,54,0.0,54.0,54.0
123730241.0,6,49,3234,25,1650,5155426.708333333,66.0,66.0,24,1584,4975533.695652174,66.0,66.0
57337.0,6,12,1320,7,789,9556.166666666666,253.0,112.71428571428572,5,531,11729.25,259.0,106.2
126895398.0,6,31,2034,16,1086,8459693.2,123.0,67.875,15,948,8335349.857142857,123.0,63.2
96897128.0,6,203,22914,102,6954,959377.5049504952,140.0,68.17647058823529,101,15960,966629.18,284.0,158.01980198019805
108106268.0,17,5,955,5,955,27026567.0,191.0,191.0,0,0,0.0,0.0,0.0
108285.0,17,2,286,2,286,0.0,143.0,143.0,0,0,0.0,0.0,0.0
103088341.0,17,14,864,7,432,17166822.0,174.0,61.71428571428572,7,432,17168267.5,174.0,61.71428571428572
90056041.0,17,28,13364,28,13364,3335408.925925926,501.0,477.2857142857143,0,0,0.0,0.0,0.0
113852001.0,6,31,2097,16,1071,7590133.4,123.0,66.9375,15,1026,8116600.357142857,123.0,68.4
200203.0,17,4,6056,4,6056,66734.33333333333,1514.0,1514.0,0,0,0.0,0.0,0.0
122530412.0,6,49,3234,25,1650,5105433.833333333,66.0,66.0,24,1584,5127174.695652174,66.0,66.0
120217929.0,6,228,25862,114,7746,1056571.4336283186,140.0,67.94736842105263,114,18116,1047231.778761062,284.0,158.91228070175438
2594246.0,6,2,132,1,66,0.0,66.0,66.0,1,66,0.0,66.0,66.0
33782.0,6,10,2032,5,524,7630.75,252.0,104.8,5,1508,7733.75,1236.0,301.6
303638.0,6,2,132,1,66,0.0,66.0,66.0,1,66,0.0,66.0,66.0
204902.0,17,2,762,2,762,0.0,381.0,381.0,0,0,0.0,0.0,0.0
218180.0,6,3,426,2,280,0.0,214.0,140.0,1,146,0.0,146.0,146.0
596600.0,17,2,346,1,78,0.0,78.0,78.0,1,268,0.0,268.0,268.0
153390.0,17,2,180,1,90,0.0,90.0,90.0,1,90,0.0,90.0,90.0
2423.0,17,4,344,2,150,0.0,75.0,75.0,2,194,0.0,103.0,97.0
243141.0,6,3,337,2,214,0.0,160.0,107.0,1,123,0.0,123.0,123.0
38433.0,6,14,4740,7,653,6274.166666666667,249.0,93.28571428571428,7,4087,5777.166666666667,1514.0,583.8571428571429
120005188.0,17,29,13785,29,13785,4285899.571428572,501.0,475.3448275862069,0,0,0.0,0.0,0.0
104305931.0,6,44,2904,22,1452,4966949.095238095,66.0,66.0,22,1452,4953981.476190476,66.0,66.0
90208376.0,6,16,1192,8,596,12851047.714285716,95.0,74.5,8,596,12856135.57142857,95.0,74.5
696338.0,6,10,1065,5,534,173867.25,262.0,106.8,5,531,173880.5,259.0,106.2
276212.0,6,4,492,2,280,0.0,214.0,140.0,2,212,0.0,146.0,106.0
39394.0,6,14,4740,7,653,6437.166666666667,249.0,93.28571428571428,7,4087,5972.833333333333,1514.0,583.8571428571429
38500.0,6,14,4740,7,653,5626.666666666667,249.0,93.28571428571428,7,4087,6266.166666666667,1514.0,583.8571428571429
503144.00000000006,6,5,336,2,134,0.0,68.0,67.0,3,202,192456.0,70.0,67.33333333333333
90025918.0,17,28,13364,28,13364,3334293.25925926,501.0,477.2857142857143,0,0,0.0,0.0,0.0
106138027.0,6,201,22938,101,6900,1061380.27,140.0,68.31683168316832,100,16038,1061523.5656565656,284.0,160.38
153601.0,17,2,180,1,90,0.0,90.0,90.0,1,90,0.0,90.0,90.0
15344.0,6,11,1133,6,602,2765.4,264.0,100.33333333333331,5,531,3528.25,259.0,106.2
119543977.0,6,48,3168,24,1584,5197564.217391305,66.0,66.0,24,1584,5183884.304347826,66.0,66.0
208383.0,6,3,426,2,280,0.0,214.0,140.0,1,146,0.0,146.0,146.0
39080.0,6,14,4740,7,653,6389.666666666667,249.0,93.28571428571428,7,4087,6072.666666666667,1514.0,583.8571428571429
113618880.0,6,46,3036,23,1518,5150435.227272728,66.0,66.0,23,1518,5150431.590909091,66.0,66.0
310018.0,6,6,412,4,272,103339.33333333331,74.0,68.0,2,140,0.0,74.0,70.0
2395.0,17,4,344,2,150,0.0,75.0,75.0,2,194,0.0,103.0,97.0
507820.00000000006,6,5,336,2,134,0.0,68.0,67.0,3,202,195654.5,70.0,67.33333333333333
90021746.0,17,28,13364,28,13364,3334138.7407407407,501.0,477.2857142857143,0,0,0.0,0.0,0.0
0.0,17,1,55,1,55,0.0,55.0,55.0,0,0,0.0,0.0,0.0
13666.0,6,13,1459,7,862,2277.6666666666665,271.0,123.14285714285714,6,597,2379.8,259.0,99.5
29663.0,6,12,1320,6,723,5420.6,253.0,120.5,6,597,5598.2,259.0,99.5
318412.0,17,4,1400,4,1400,106137.33333333331,350.0,350.0,0,0,0.0,0.0,0.0
27375169.0,17,5,1710,5,1710,6843792.25,342.0,342.0,0,0,0.0,0.0,0.0
135159897.0,17,6,1146,6,1146,27031979.4,191.0,191.0,0,0,0.0,0.0,0.0
117626547.0,6,33,2290,17,1125,7351633.75,123.0,66.17647058823529,16,1165,7176123.666666667,139.0,72.8125
37031.0,6,14,4740,7,653,5808.833333333333,249.0,93.28571428571428,7,4087,5594.333333333333,1514.0,583.8571428571429
135131666.0,17,6,1146,6,1146,27026333.2,191.0,191.0,0,0,0.0,0.0,0.0
135138985.0,17,6,1206,6,1206,27027797.0,201.0,201.0,0,0,0.0,0.0,0.0
121398.0,6,3,337,2,214,0.0,160.0,107.0,1,123,0.0,123.0,123.0
197099.0,17,2,180,1,90,0.0,90.0,90.0,1,90,0.0,90.0,90.0
90681464.0,6,22,1680,10,745,10047276.555555556,95.0,74.5,12,935,8224102.090909091,95.0,77.91666666666667
90046578.0,17,28,13364,28,13364,3335058.4444444445,501.0,477.2857142857143,0,0,0.0,0.0,0.0
35989.0,6,14,4740,7,653,5869.0,249.0,93.28571428571428,7,4087,5699.333333333333,1514.0,583.8571428571429
195112.0,6,13,1394,7,797,32518.666666666668,253.0,113.85714285714286,6,597,36846.8,259.0,99.5
120122529.0,6,13,2020,9,1204,15015316.125,188.0,133.77777777777777,4,816,30029706.0,204.0,204.0
258103.00000000003,6,3,337,2,214,0.0,160.0,107.0,1,123,0.0,123.0,123.0
51730.0,6,14,4740,7,653,8497.666666666666,249.0,93.28571428571428,7,4087,8108.333333333333,1514.0,583.8571428571429
119706124.0,6,205,23174,103,7020,1173589.450980392,140.0,68.15533980582525,102,16154,1174873.6435643565,284.0,158.37254901960785
26614.0,6,11,2098,6,590,5322.8,252.0,98.33333333333331,5,1508,6325.5,1236.0,301.6
105768.0,17,2,700,2,700,0.0,350.0,350.0,0,0,0.0,0.0,0.0
45449.0,6,14,4740,7,653,7381.5,249.0,93.28571428571428,7,4087,7435.833333333333,1514.0,583.8571428571429
50059.0,6,14,4740,7,653,7892.0,249.0,93.28571428571428,7,4087,8205.166666666666,1514.0,583.8571428571429
49567.0,6,14,4740,7,653,7273.166666666667,249.0,93.28571428571428,7,4087,7823.333333333333,1514.0,583.8571428571429
304638.0,6,6,412,4,272,101546.0,74.0,68.0,2,140,0.0,74.0,70.0
90049606.0,17,28,13364,28,13364,3335170.592592593,501.0,477.2857142857143,0,0,0.0,0.0,0.0
131075.0,6,2,132,1,66,0.0,66.0,66.0,1,66,0.0,66.0,66.0
12592.0,6,11,1133,6,602,2236.2,264.0,100.33333333333331,5,531,2955.5,259.0,106.2
469.0,17,2,267,1,83,0.0,83.0,83.0,1,184,0.0,184.0,184.0
22670.0,6,11,1132,6,556,4322.4,218.0,92.66666666666669,5,576,5419.75,304.0,115.2
25274.0,6,10,2032,5,524,5591.25,252.0,104.8,5,1508,5753.5,1236.0,301.6
49739.0,6,14,4740,7,653,7987.0,249.0,93.28571428571428,7,4087,7907.0,1514.0,583.8571428571429
240224.0,6,3,337,2,214,0.0,160.0,107.0,1,123,0.0,123.0,123.0
113520201.0,6,46,3036,23,1518,5159997.818181818,66.0,66.0,23,1518,5159997.7727272725,66.0,66.0
2316.0,17,4,344,2,150,0.0,75.0,75.0,2,194,0.0,103.0,97.0
123006833.0,17,14,1126,7,563,20501138.83333333,174.0,80.42857142857143,7,563,17000202.5,174.0,80.42857142857143
0.0,17,1,350,1,350,0.0,350.0,350.0,0,0,0.0,0.0,0.0
121513.0,6,3,337,2,214,0.0,160.0,107.0,1,123,0.0,123.0,123.0
859912.0,6,9,1268,6,797,171982.4,459.0,132.83333333333334,3,471,292290.0,331.0,157.0
90257216.0,6,14,2240,8,1016,12893888.0,188.0,127.0,6,1224,18018659.4,204.0,204.0
201560.0,17,2,180,1,90,0.0,90.0,90.0,1,90,0.0,90.0,90.0
102975.0,17,2,286,2,286,0.0,143.0,143.0,0,0,0.0,0.0,0.0
33878.0,6,14,4740,7,653,5006.333333333333,249.0,93.28571428571428,7,4087,3681.6666666666665,1514.0,583.8571428571429
104937633.0,17,15,5130,15,5130,7495545.214285715,342.0,342.0,0,0,0.0,0.0,0.0
122283.0,6,3,373,2,238,0.0,172.0,119.0,1,135,0.0,135.0,135.0
237787.0,17,2,180,1,90,0.0,90.0,90.0,1,90,0.0,90.0,90.0
2452.0,17,4,344,2,150,0.0,75.0,75.0,2,194,0.0,103.0,97.0
314131.0,6,6,412,4,272,104710.33333333331,74.0,68.0,2,140,0.0,74.0,70.0
22238.0,6,10,2032,5,524,4964.75,252.0,104.8,5,1508,4812.75,1236.0,301.6
30379.0,6,14,4740,7,653,4936.5,249.0,93.28571428571428,7,4087,4873.833333333333,1514.0,583.8571428571429
77519.0,6,14,4740,7,653,12793.833333333334,249.0,93.28571428571428,7,4087,12511.333333333334,1514.0,583.8571428571429
10825.0,6,10,1067,5,536,2541.0,264.0,107.2,5,531,2140.0,259.0,106.2
90044549.0,17,28,13364,28,13364,3334983.296296296,501.0,477.2857142857143,0,0,0.0,0.0,0.0
118976316.0,6,37,2656,19,1408,6609795.333333333,139.0,74.10526315789474,18,1248,6985876.117647059,123.0,69.33333333333333
216435.0,17,2,762,2,762,0.0,381.0,381.0,0,0,0.0,0.0,0.0
282547.0,17,2,180,1,90,0.0,90.0,90.0,1,90,0.0,90.0,90.0
135129161.0,17,6,1146,6,1146,27025832.2,191.0,191.0,0,0,0.0,0.0,0.0
117910098.0,6,48,3168,24,1584,5126526.0,66.0,66.0,24,1584,5112859.217391305,66.0,66.0
114199984.0,6,37,2788,19,1471,6344443.555555556,139.0,77.42105263157895,18,1317,6704932.470588235,123.0,73.16666666666667
844.0,17,5,550,5,550,211.0,110.0,110.0,0,0,0.0,0.0,0.0
2582626.0,6,2,132,1,66,0.0,66.0,66.0,1,66,0.0,66.0,66.0
21206.0,6,14,4740,7,653,2940.5,249.0,93.28571428571428,7,4087,3363.1666666666665,1514.0,583.8571428571429
120001315.0,17,13,559,7,301,20000219.166666668,43.0,43.0,6,258,20000588.0,43.0,43.0
92731422.0,6,166,18762,83,5700,1120916.280487805,140.0,68.67469879518072,83,13062,1120921.8170731708,284.0,157.3734939759036
207238.0,6,3,426,2,280,0.0,214.0,140.0,1,146,0.0,146.0,146.0
2409.0,17,4,344,2,150,0.0,75.0,75.0,2,194,0.0,103.0,97.0
16221.0,6,14,4740,7,653,2404.5,249.0,93.28571428571428,7,4087,2476.833333333333,1514.0,583.8571428571429
17891.0,6,10,1810,5,358,4218.5,130.0,71.6,5,1452,4265.0,1224.0,290.4
120256500.0,6,226,25546,113,7766,1066353.482142857,140.0,68.72566371681415,113,17780,1066376.7767857143,284.0,157.34513274336285
2344.0,17,4,344,2,150,0.0,75.0,75.0,2,194,0.0,103.0,97.0
298108.0,6,6,412,4,272,99369.33333333331,74.0,68.0,2,140,0.0,74.0,70.0
228576.0,17,2,180,1,90,0.0,90.0,90.0,1,90,0.0,90.0,90.0
2016.0,17,4,344,2,150,0.0,75.0,75.0,2,194,0.0,103.0,97.0
10493224.0,17,3,1034,2,684,0.0,342.0,342.0,1,350,0.0,350.0,350.0
165734.0,17,2,414,1,88,0.0,88.0,88.0,1,326,0.0,326.0,326.0
36110.0,6,14,4740,7,653,5829.5,249.0,93.28571428571428,7,4087,4586.333333333333,1514.0,583.8571428571429
153564.0,17,2,180,1,90,0.0,90.0,90.0,1,90,0.0,90.0,90.0
153666.0,17,2,180,1,90,0.0,90.0,90.0,1,90,0.0,90.0,90.0
12310.0,17,4,823,2,163,0.0,89.0,81.5,2,660,0.0,443.0,330.0
47904.0,6,14,4740,7,653,7863.833333333333,249.0,93.28571428571428,7,4087,7625.0,1514.0,583.8571428571429
2842798.0,6,11,2106,6,598,568376.4,252.0,99.66666666666669,5,1508,2235.25,1236.0,301.6
45487.0,6,14,4740,7,653,7132.833333333333,249.0,93.28571428571428,7,4087,6962.0,1514.0,583.8571428571429
16233.0,6,14,4740,7,653,2545.1666666666665,249.0,93.28571428571428,7,4087,2567.833333333333,1514.0,583.8571428571429
242146.0,6,3,337,2,214,0.0,160.0,107.0,1,123,0.0,123.0,123.0
162315.0,17,2,180,1,90,0.0,90.0,90.0,1,90,0.0,90.0,90.0
98595261.0,6,27,1954,14,1045,7567639.846153846,139.0,74.64285714285714,13,909,8198283.833333333,123.0,69.92307692307692
209422.0,17,2,180,1,90,0.0,90.0,90.0,1,90,0.0,90.0,90.0
90010689.0,17,28,13364,28,13364,3333729.222222222,501.0,477.2857142857143,0,0,0.0,0.0,0.0
858272.0,6,9,1268,6,797,171654.4,459.0,132.83333333333334,3,471,291396.0,331.0,157.0
205905.0,17,2,180,1,90,0.0,90.0,90.0,1,90,0.0,90.0,90.0
438207.0,17,2,363,1,79,0.0,79.0,79.0,1,284,0.0,284.0,284.0
296198.0,17,2,180,1,90,0.0,90.0,90.0,1,90,0.0,90.0,90.0
13962.0,6,13,1459,7,862,2327.0,271.0,123.14285714285714,6,597,2390.0,259.0,99.5
40463237.0,6,5,336,2,134,0.0,68.0,67.0,3,202,20162248.0,70.0,67.33333333333333
100148.0,6,14,4740,7,653,9405.833333333334,249.0,93.28571428571428,7,4087,16369.0,1514.0,583.8571428571429
113515519.0,6,48,3168,24,1584,4935457.347826087,66.0,66.0,24,1584,4923614.956521739,66.0,66.0
1779142.0,6,2,132,1,66,0.0,66.0,66.0,1,66,0.0,66.0,66.0
116383604.0,17,13,821,7,432,19397267.33333333,174.0,61.71428571428572,6,389,19253469.6,174.0,64.83333333333333
104199140.0,6,192,21664,96,15106,1094568.4210526317,284.0,157.35416666666666,96,6558,1094568.6842105263,140.0,68.3125
213838.0,6,10,1221,6,636,42767.6,298.0,106.0,4,585,70158.66666666667,379.0,146.25
104000.0,17,2,286,2,286,0.0,143.0,143.0,0,0,0.0,0.0,0.0
76948.0,6,10,2032,5,524,18995.5,252.0,104.8,5,1508,10325.25,1236.0,301.6
3153644.0,6,3,1777,2,951,0.0,885.0,475.5,1,826,0.0,826.0,826.0
106489.0,17,2,762,2,762,0.0,381.0,381.0,0,0,0.0,0.0,0.0
31660.0,6,10,2032,5,524,7670.25,252.0,104.8,5,1508,7338.5,1236.0,301.6
2064.0,17,4,344,2,150,0.0,75.0,75.0,2,194,0.0,103.0,97.0
206575.0,6,3,426,2,280,0.0,214.0,140.0,1,146,0.0,146.0,146.0
533.0,17,2,508,2,508,0.0,257.0,254.0,0,0,0.0,0.0,0.0
34196.0,6,14,4740,7,653,5225.666666666667,249.0,93.28571428571428,7,4087,5438.666666666667,1514.0,583.8571428571429
108107860.0,17,5,1005,5,1005,27026965.0,201.0,201.0,0,0,0.0,0.0,0.0
46455.0,6,14,4740,7,653,7610.666666666667,249.0,93.28571428571428,7,4087,6761.0,1514.0,583.8571428571429
120051147.0,17,29,13785,29,13785,4287540.964285715,501.0,475.3448275862069,0,0,0.0,0.0,0.0
20336.0,17,2,582,1,83,0.0,83.0,83.0,1,499,0.0,499.0,499.0
2995.0,17,2,224,1,76,0.0,76.0,76.0,1,148,0.0,148.0,148.0
0.0,17,1,350,1,350,0.0,350.0,350.0,0,0,0.0,0.0,0.0
318785.0,6,6,412,4,272,106261.66666666669,74.0,68.0,2,140,0.0,74.0,70.0
228356.0,17,2,180,1,90,0.0,90.0,90.0,1,90,0.0,90.0,90.0
55020.0,6,14,4740,7,653,8880.5,249.0,93.28571428571428,7,4087,8102.0,1514.0,583.8571428571429
2616296.0,6,25,7573,14,3735,201253.53846153847,1514.0,266.7857142857143,11,3838,234968.2,1514.0,348.90909090909093
90304051.0,6,16,1192,8,596,12894160.285714284,95.0,74.5,8,596,12899506.0,95.0,74.5
70093.0,6,14,4740,7,653,11555.166666666666,249.0,93.28571428571428,7,4087,10994.833333333334,1514.0,583.8571428571429
209790.0,17,2,180,1,90,0.0,90.0,90.0,1,90,0.0,90.0,90.0
199070.0,17,2,180,1,90,0.0,90.0,90.0,1,90,0.0,90.0,90.0
256514.00000000003,17,2,180,1,90,0.0,90.0,90.0,1,90,0.0,90.0,90.0
14637191.0,6,20,1607,10,975,1592507.3333333333,315.0,97.5,10,632,1591670.5555555555,78.0,63.2
142893.0,17,2,176,1,80,0.0,80.0,80.0,1,96,0.0,96.0,96.0
2434.0,17,4,344,2,150,0.0,75.0,75.0,2,194,0.0,103.0,97.0
135134531.0,17,6,1146,6,1146,27026906.2,191.0,191.0,0,0,0.0,0.0,0.0
108106763.0,17,5,1005,5,1005,27026690.75,201.0,201.0,0,0,0.0,0.0,0.0
278439.0,6,10,1221,6,636,55687.8,298.0,106.0,4,585,87055.66666666667,379.0,146.25
91808291.0,17,15,5130,15,5130,6557735.071428572,342.0,342.0,0,0,0.0,0.0,0.0
126716.0,6,2,132,1,66,0.0,66.0,66.0,1,66,0.0,66.0,66.0
68730.0,6,14,4740,7,653,10597.166666666666,249.0,93.28571428571428,7,4087,11007.333333333334,1514.0,583.8571428571429
18794.0,6,14,4740,7,653,2892.1666666666665,249.0,93.28571428571428,7,4087,2993.833333333333,1514.0,583.8571428571429
23016.0,6,10,2032,5,524,5326.5,252.0,104.8,5,1508,5178.75,1236.0,301.6
203075.0,17,2,180,1,90,0.0,90.0,90.0,1,90,0.0,90.0,90.0
107031095.0,17,16,1212,8,606,15290156.42857143,174.0,75.75,8,606,15194046.142857144,174.0,75.75
90260276.0,6,13,2036,8,1016,12894325.142857144,188.0,127.0,5,1020,22523830.25,204.0,204.0
219943.0,6,10,1221,6,636,43988.6,298.0,106.0,4,585,72469.0,379.0,146.25
108283207.0,17,14,864,7,432,18020715.83333333,174.0,61.71428571428572,7,432,17983749.0,174.0,61.71428571428572
232917.0,6,3,337,2,214,0.0,160.0,107.0,1,123,0.0,123.0,123.0
148375046.0,6,24,1829,11,840,11866081.7,95.0,76.36363636363636,13,989,12347450.75,95.0,76.07692307692308
4296.0,17,2,626,1,72,0.0,72.0,72.0,1,554,0.0,554.0,554.0
146058.0,6,3,337,2,214,0.0,160.0,107.0,1,123,0.0,123.0,123.0
43787.0,6,14,4740,7,653,7181.666666666667,249.0,93.28571428571428,7,4087,6749.0,1514.0,583.8571428571429
93242157.0,6,40,2640,20,1320,4907481.947368421,66.0,66.0,20,1320,4890936.052631579,66.0,66.0
103190512.0,17,14,864,7,432,17165906.833333332,174.0,61.71428571428572,7,432,17166869.333333332,174.0,61.71428571428572
90090428.0,6,10,1440,7,828,15015071.333333334,188.0,118.28571428571428,3,612,30028005.0,204.0,204.0
146187.0,6,3,337,2,214,0.0,160.0,107.0,1,123,0.0,123.0,123.0
90253912.0,6,14,2240,8,1016,12893416.0,188.0,127.0,6,1224,18017334.8,204.0,204.0
143914.0,17,2,180,1,90,0.0,90.0,90.0,1,90,0.0,90.0,90.0
232321.0,6,3,337,2,214,0.0,160.0,107.0,1,123,0.0,123.0,123.0
2634384.0,6,2,132,1,66,0.0,66.0,66.0,1,66,0.0,66.0,66.0
120070175.0,6,292,35200,146,9932,822427.3172413793,140.0,68.02739726027397,146,25268,822760.5586206897,336.0,173.06849315068493
108108487.0,17,5,955,5,955,27027121.75,191.0,191.0,0,0,0.0,0.0,0.0
1706581.0,6,7,499,4,301,510513.3333333333,103.0,75.25,3,198,817960.0,66.0,66.0
14372646.0,6,291,265907,86,5835,169089.95294117648,205.0,67.84883720930233,205,260072,70439.55392156863,1514.0,1268.6439024390245
15393.0,6,11,2098,6,590,2765.0,252.0,98.33333333333331,5,1508,3570.0,1236.0,301.6
40203.0,6,14,4740,7,653,6373.166666666667,249.0,93.28571428571428,7,4087,6295.333333333333,1514.0,583.8571428571429
30986.0,6,14,4740,7,653,4557.333333333333,249.0,93.28571428571428,7,4087,4726.166666666667,1514.0,583.8571428571429
43872.0,6,14,4740,7,653,7165.0,249.0,93.28571428571428,7,4087,7134.166666666667,1514.0,583.8571428571429
119899348.0,17,35,16705,35,16705,3526451.411764706,501.0,477.2857142857143,0,0,0.0,0.0,0.0
90256956.0,6,13,2036,8,1016,12893850.857142856,188.0,127.0,5,1020,22522940.25,204.0,204.0
215311.0,6,10,1221,6,636,43062.2,298.0,106.0,4,585,70685.0,379.0,146.25
281557.0,17,2,363,1,79,0.0,79.0,79.0,1,284,0.0,284.0,284.0
137034.0,6,2,132,1,66,0.0,66.0,66.0,1,66,0.0,66.0,66.0
10430657.0,6,6,412,3,206,5146912.5,74.0,68.66666666666667,3,206,5146820.5,74.0,68.66666666666667
121175.0,6,3,337,2,214,0.0,160.0,107.0,1,123,0.0,123.0,123.0
196891.0,17,2,180,1,90,0.0,90.0,90.0,1,90,0.0,90.0,90.0
149714387.0,6,14,2086,10,1270,16634931.888888888,188.0,127.0,4,816,30030387.0,204.0,204.0
90055143.0,17,28,13364,28,13364,3335375.6666666665,501.0,477.2857142857143,0,0,0.0,0.0,0.0
298238.0,6,6,412,4,272,99412.66666666669,74.0,68.0,2,140,0.0,74.0,70.0
113951972.0,6,892,168766,444,29834,257176.96162528216,214.0,67.19369369369369,448,138932,254666.30872483223,1514.0,310.11607142857144
68082.0,6,14,4740,7,653,11136.0,249.0,93.28571428571428,7,4087,10867.5,1514.0,583.8571428571429
16673.0,6,12,1393,6,796,3150.2,271.0,132.66666666666666,6,597,2525.8,259.0,99.5
120124418.0,6,14,2240,6,1224,24024883.6,204.0,204.0,8,1016,17098401.0,188.0,127.0
10523483.0,6,7,478,4,272,3460782.333333333,74.0,68.0,3,206,5191058.0,74.0,68.66666666666667
90283237.0,6,16,1192,8,596,12891559.57142857,95.0,74.5,8,596,12895975.0,95.0,74.5
120282717.0,6,278,32026,139,9470,865776.0579710145,140.0,68.12949640287769,139,22556,865637.4565217391,374.0,162.27338129496405
220106.0,6,3,426,2,280,0.0,214.0,140.0,1,146,0.0,146.0,146.0
36194.0,6,14,4740,7,653,5883.5,249.0,93.28571428571428,7,4087,5842.333333333333,1514.0,583.8571428571429
90245079.0,6,13,2036,8,1016,12892154.142857144,188.0,127.0,5,1020,22514696.5,204.0,204.0
93042773.0,17,14,1126,7,563,15500171.833333334,174.0,80.42857142857143,7,563,15500767.833333334,174.0,80.42857142857143
11609.0,17,4,344,2,150,0.0,75.0,75.0,2,194,0.0,103.0,97.0
103815.0,17,2,286,2,286,0.0,143.0,143.0,0,0,0.0,0.0,0.0
146967.0,6,3,337,2,214,0.0,160.0,107.0,1,123,0.0,123.0,123.0
90256884.0,6,12,1832,8,1016,12893840.57142857,188.0,127.0,4,816,30031115.0,204.0,204.0
143945.0,17,2,180,1,90,0.0,90.0,90.0,1,90,0.0,90.0,90.0
68256.0,6,11,2098,6,590,13651.2,252.0,98.33333333333331,5,1508,14970.0,1236.0,301.6
311.0,17,2,174,1,79,0.0,79.0,79.0,1,95,0.0,95.0,95.0
2400.0,17,4,344,2,150,0.0,75.0,75.0,2,194,0.0,103.0,97.0
328.0,17,2,166,1,75,0.0,75.0,75.0,1,91,0.0,91.0,91.0
4200.0,17,2,598,1,72,0.0,72.0,72.0,1,526,0.0,526.0,526.0
14016.0,6,11,2098,6,590,2560.0,252.0,98.33333333333331,5,1508,3107.5,1236.0,301.6
2043665.0,17,3,1026,3,1026,1021832.5,342.0,342.0,0,0,0.0,0.0,0.0
760.0,17,4,438,2,148,0.0,74.0,74.0,2,290,0.0,147.0,145.0
1391958.0,17,16,1120,16,1120,92797.2,70.0,70.0,0,0,0.0,0.0,0.0
103146.0,17,2,762,2,762,0.0,381.0,381.0,0,0,0.0,0.0,0.0
317.0,17,2,174,1,79,0.0,79.0,79.0,1,95,0.0,95.0,95.0
322479.0,6,10,1221,6,636,64495.8,298.0,106.0,4,585,106536.33333333331,379.0,146.25
29997.0,6,14,4740,7,653,4859.166666666667,249.0,93.28571428571428,7,4087,4831.0,1514.0,583.8571428571429
108240.0,17,2,286,2,286,0.0,143.0,143.0,0,0,0.0,0.0,0.0
10459930.0,6,7,478,4,272,3439963.333333333,74.0,68.0,3,206,5159838.5,74.0,68.66666666666667
97654861.0,6,26,1746,13,906,8137905.083333333,123.0,69.6923076923077,13,840,8119881.833333333,123.0,64.61538461538461
232479.0,6,3,337,2,214,0.0,160.0,107.0,1,123,0.0,123.0,123.0
120043269.0,17,28,13364,28,13364,4446047.0,501.0,477.2857142857143,0,0,0.0,0.0,0.0
6887.0,17,2,582,1,83,0.0,83.0,83.0,1,499,0.0,499.0,499.0
45290.0,6,10,2032,5,524,10028.0,252.0,104.8,5,1508,9688.25,1236.0,301.6
44801835.0,17,9,3086,8,2736,5135740.142857143,342.0,342.0,1,350,0.0,350.0,350.0
1169928.0,6,13,3020,8,2392,167132.57142857142,1514.0,299.0,5,628,224326.0,331.0,125.6
91051383.0,6,28,2008,14,1045,6987272.153846154,139.0,74.64285714285714,14,963,6987351.538461538,123.0,68.78571428571429
22373.0,6,10,2032,5,524,5351.0,252.0,104.8,5,1508,5320.0,1236.0,301.6
40395.0,6,10,2032,5,524,9709.25,252.0,104.8,5,1508,9697.75,1236.0,301.6
114292222.0,17,16,1212,8,606,16327460.285714284,174.0,75.75,8,606,16300450.714285716,174.0,75.75
2381.0,17,4,344,2,150,0.0,75.0,75.0,2,194,0.0,103.0,97.0
1183961.0,6,13,3000,8,2372,169137.2857142857,1514.0,296.5,5,628,227094.25,331.0,125.6
106022.0,17,2,700,2,700,0.0,350.0,350.0,0,0,0.0,0.0,0.0
108103431.0,17,5,1005,5,1005,27025857.75,201.0,201.0,0,0,0.0,0.0,0.0
108109000.0,17,5,955,5,955,27027250.0,191.0,191.0,0,0,0.0,0.0,0.0
90204596.0,6,16,1192,8,596,12851933.142857144,95.0,74.5,8,596,12857115.714285716,95.0,74.5
90060246.0,17,28,13364,28,13364,3335564.6666666665,501.0,477.2857142857143,0,0,0.0,0.0,0.0
2127598.0,6,18,6803,10,1501,236399.7777777777,408.0,150.1,8,5302,241579.0,1514.0,662.75
21524.0,6,10,2032,5,524,5161.25,252.0,104.8,5,1508,3398.75,1236.0,301.6
146305.0,6,3,337,2,214,0.0,160.0,107.0,1,123,0.0,123.0,123.0
14905.0,17,2,180,1,90,0.0,90.0,90.0,1,90,0.0,90.0,90.0
116018092.0,6,39,2886,20,1515,6094859.736842105,123.0,75.75,19,1371,6433462.5,123.0,72.15789473684211
3279.0,17,2,762,2,762,0.0,381.0,381.0,0,0,0.0,0.0,0.0
0.0,17,1,72,1,72,0.0,72.0,72.0,0,0,0.0,0.0,0.0
9355.0,17,2,582,1,83,0.0,83.0,83.0,1,499,0.0,499.0,499.0
1626.0,17,2,762,2,762,0.0,381.0,381.0,0,0,0.0,0.0,0.0
1179687.0,6,13,3010,8,2382,168526.7142857143,1514.0,297.75,5,628,225938.75,331.0,125.6
35207.0,6,10,2032,5,524,7975.5,252.0,104.8,5,1508,8005.25,1236.0,301.6
103816.0,17,2,286,2,286,0.0,143.0,143.0,0,0,0.0,0.0,0.0
2441.0,17,4,344,2,150,0.0,75.0,75.0,2,194,0.0,103.0,97.0
106497.0,17,4,1400,4,1400,35499.0,350.0,350.0,0,0,0.0,0.0,0.0
315655.0,17,4,1400,4,1400,105218.33333333331,350.0,350.0,0,0,0.0,0.0,0.0
33963.0,6,12,1320,6,723,5997.8,253.0,120.5,6,597,5553.2,259.0,99.5
105522193.0,6,28,1876,14,982,8101365.923076923,139.0,70.14285714285714,14,894,8101362.076923077,123.0,63.85714285714285
2379.0,17,4,344,2,150,0.0,75.0,75.0,2,194,0.0,103.0,97.0
119001251.0,17,13,821,7,432,19833541.83333333,174.0,61.71428571428572,6,389,19801770.6,174.0,64.83333333333333
1971.0,17,2,180,1,90,0.0,90.0,90.0,1,90,0.0,90.0,90.0
91834040.0,6,24,1829,13,989,7652373.833333333,95.0,76.07692307692308,11,840,9182196.3,95.0,76.36363636363636
2332.0,17,4,344,2,150,0.0,75.0,75.0,2,194,0.0,103.0,97.0
135140801.0,17,6,1206,6,1206,27028160.2,201.0,201.0,0,0,0.0,0.0,0.0
311310.0,6,3,202,2,128,0.0,74.0,64.0,1,74,0.0,74.0,74.0
31819.0,6,10,2032,5,524,7728.75,252.0,104.8,5,1508,7676.5,1236.0,301.6
96101.0,17,2,762,2,762,0.0,381.0,381.0,0,0,0.0,0.0,0.0
24482559.0,17,5,1718,4,1368,842190.3333333334,342.0,342.0,1,350,0.0,350.0,350.0
60314.0,6,14,4740,7,653,9931.833333333334,249.0,93.28571428571428,7,4087,8328.166666666666,1514.0,583.8571428571429
1301205.0,6,4,264,2,132,0.0,66.0,66.0,2,132,0.0,66.0,66.0
3071.0,17,2,224,1,76,0.0,76.0,76.0,1,148,0.0,148.0,148.0
205972.0,6,3,426,2,280,0.0,214.0,140.0,1,146,0.0,146.0,146.0
2322.0,17,4,344,2,150,0.0,75.0,75.0,2,194,0.0,103.0,97.0
119857.0,17,4,1400,4,1400,39952.333333333336,350.0,350.0,0,0,0.0,0.0,0.0
116103541.0,6,220,24936,110,7556,1057694.8073394496,140.0,68.69090909090909,110,17380,1057642.0366972478,336.0,158.0
10489894.0,6,7,478,4,272,3450819.6666666665,74.0,68.0,3,206,5176141.0,74.0,68.66666666666667
312398.0,17,4,1400,4,1400,104132.66666666669,350.0,350.0,0,0,0.0,0.0,0.0
20269.0,6,10,2032,5,524,4820.25,252.0,104.8,5,1508,4717.25,1236.0,301.6
147967.0,17,2,180,1,90,0.0,90.0,90.0,1,90,0.0,90.0,90.0
157139.0,17,4,704,2,148,0.0,74.0,74.0,2,556,0.0,280.0,278.0
28268.0,6,10,2032,5,524,6829.0,252.0,104.8,5,1508,6652.5,1236.0,301.6
231979.0,17,4,1400,4,1400,77326.33333333333,350.0,350.0,0,0,0.0,0.0,0.0
118467512.0,6,42,3537,18,1593,6968677.176470588,123.0,88.5,24,1944,5141363.304347826,123.0,81.0
135127170.0,17,6,1146,6,1146,27025434.0,191.0,191.0,0,0,0.0,0.0,0.0
228677.0,6,10,1221,6,636,45735.4,298.0,106.0,4,585,74387.0,379.0,146.25
41447.0,6,10,2032,5,524,10133.25,252.0,104.8,5,1508,9714.5,1236.0,301.6
54274.0,6,14,4740,7,653,8672.833333333334,249.0,93.28571428571428,7,4087,8431.833333333334,1514.0,583.8571428571429
845.0,17,4,438,2,148,0.0,74.0,74.0,2,290,0.0,147.0,145.0
181073.0,6,20,8738,11,894,18107.3,226.0,81.27272727272727,9,7844,21541.25,1514.0,871.5555555555555
115280892.0,6,207,23268,104,7086,1119231.9611650486,140.0,68.13461538461539,103,16182,1121016.774509804,284.0,157.10679611650485
1302497.0,6,4,264,2,132,0.0,66.0,66.0,2,132,0.0,66.0,66.0
146305.0,6,3,337,2,214,0.0,160.0,107.0,1,123,0.0,123.0,123.0
307248.0,6,6,412,4,272,102416.0,74.0,68.0,2,140,0.0,74.0,70.0
91691590.0,6,23,1775,13,1030,7637480.083333333,95.0,79.23076923076923,10,745,10104435.666666666,95.0,74.5
142199.0,6,2,132,1,66,0.0,66.0,66.0,1,66,0.0,66.0,66.0
47608924.0,6,8,1940,3,887,22397180.0,753.0,295.6666666666667,5,1053,11207905.5,785.0,210.6
3205479.0,6,18,1495,9,921,362140.25,315.0,102.33333333333331,9,574,362104.875,78.0,63.77777777777778
14955.0,17,2,180,1,90,0.0,90.0,90.0,1,90,0.0,90.0,90.0
20260.0,17,2,582,1,83,0.0,83.0,83.0,1,499,0.0,499.0,499.0
135127335.0,17,6,1206,6,1206,27025467.0,201.0,201.0,0,0,0.0,0.0,0.0
1175.0,17,4,316,2,158,0.0,79.0,79.0,2,158,0.0,79.0,79.0
61111.0,6,14,4740,7,653,10057.0,249.0,93.28571428571428,7,4087,9704.333333333334,1514.0,583.8571428571429
2777372.0,6,2,132,1,66,0.0,66.0,66.0,1,66,0.0,66.0,66.0
165918.0,17,2,414,1,88,0.0,88.0,88.0,1,326,0.0,326.0,326.0
376694.0,6,3,1604,2,851,0.0,785.0,425.5,1,753,0.0,753.0,753.0
42774.0,6,10,2032,5,524,9389.0,252.0,104.8,5,1508,10238.75,1236.0,301.6
0.0,17,1,381,1,381,0.0,381.0,381.0,0,0,0.0,0.0,0.0
2408.0,17,4,344,2,150,0.0,75.0,75.0,2,194,0.0,103.0,97.0
166700.0,17,2,180,1,90,0.0,90.0,90.0,1,90,0.0,90.0,90.0
172306.0,17,2,180,1,90,0.0,90.0,90.0,1,90,0.0,90.0,90.0
27899.0,6,10,2032,5,524,6051.5,252.0,104.8,5,1508,6692.25,1236.0,301.6
1060.0,17,5,550,5,550,265.0,110.0,110.0,0,0,0.0,0.0,0.0
10383.0,17,2,582,1,83,0.0,83.0,83.0,1,499,0.0,499.0,499.0
100890.0,17,2,762,2,762,0.0,381.0,381.0,0,0,0.0,0.0,0.0
135139842.0,17,6,1206,6,1206,27027968.4,201.0,201.0,0,0,0.0,0.0,0.0
2595578.0,6,2,132,1,66,0.0,66.0,66.0,1,66,0.0,66.0,66.0
144867.0,17,2,180,1,70,0.0,70.0,70.0,1,110,0.0,110.0,110.0
366673.0,17,2,363,1,75,0.0,75.0,75.0,1,288,0.0,288.0,288.0
303108.0,6,2,132,1,66,0.0,66.0,66.0,1,66,0.0,66.0,66.0
161149.0,17,2,180,1,90,0.0,90.0,90.0,1,90,0.0,90.0,90.0
62961855.0,6,28,8737,14,2175,4843110.769230769,263.0,155.35714285714286,14,6562,4843153.923076923,988.0,468.7142857142857
51817.0,6,14,4740,7,653,7969.5,249.0,93.28571428571428,7,4087,7280.833333333333,1514.0,583.8571428571429
40973.0,6,10,2032,5,524,10020.5,252.0,104.8,5,1508,9153.75,1236.0,301.6
44677.0,6,14,4740,7,653,7249.333333333333,249.0,93.28571428571428,7,4087,7224.333333333333,1514.0,583.8571428571429
16496.0,6,14,4740,7,653,2421.6666666666665,249.0,93.28571428571428,7,4087,2613.333333333333,1514.0,583.8571428571429
791.0,17,5,550,5,550,197.75,110.0,110.0,0,0,0.0,0.0,0.0
137104.0,17,2,176,1,80,0.0,80.0,80.0,1,96,0.0,96.0,96.0
2426.0,17,4,344,2,150,0.0,75.0,75.0,2,194,0.0,103.0,97.0
17809.0,6,13,1459,7,862,2353.333333333333,271.0,123.14285714285714,6,597,3175.6,259.0,99.5
307117.0,6,6,412,4,272,102372.33333333331,74.0,68.0,2,140,0.0,74.0,70.0
5005029.0,17,2,162,2,162,0.0,81.0,81.0,0,0,0.0,0.0,0.0
21956.0,6,14,4740,7,653,2913.833333333333,249.0,93.28571428571428,7,4087,3521.833333333333,1514.0,583.8571428571429
304400.0,6,6,412,4,272,101466.66666666669,74.0,68.0,2,140,0.0,74.0,70.0
113520261.0,6,46,3036,23,1518,5159999.636363637,66.0,66.0,23,1518,5159991.409090909,66.0,66.0
102866.0,17,2,700,2,700,0.0,350.0,350.0,0,0,0.0,0.0,0.0
120120671.0,17,16,1212,8,606,17137219.57142857,174.0,75.75,8,606,17102907.85714286,174.0,75.75
869523.0,17,2,614,1,72,0.0,72.0,72.0,1,542,0.0,542.0,542.0
217156.0,6,3,426,2,280,0.0,214.0,140.0,1,146,0.0,146.0,146.0
1302257.0,6,4,264,2,132,0.0,66.0,66.0,2,132,0.0,66.0,66.0
90033260.0,17,27,12943,27,12943,3462817.6923076925,501.0,479.3703703703704,0,0,0.0,0.0,0.0
47384.0,6,14,4740,7,653,7789.833333333333,249.0,93.28571428571428,7,4087,6303.5,1514.0,583.8571428571429
198379.0,17,2,180,1,90,0.0,90.0,90.0,1,90,0.0,90.0,90.0
98732160.0,6,176,19872,88,6030,1125157.0919540229,140.0,68.52272727272727,88,13842,1113813.8275862068,284.0,157.29545454545453
55828.0,6,14,4740,7,653,8065.0,249.0,93.28571428571428,7,4087,7629.5,1514.0,583.8571428571429
525436.0,6,5,367,2,132,0.0,66.0,66.0,3,235,262718.0,103.0,78.33333333333333
120345066.0,6,219,24818,110,17402,1104083.1743119266,284.0,158.2,109,7416,1104583.4351851852,140.0,68.03669724770643
90253500.0,6,15,2444,8,1016,12893357.142857144,188.0,127.0,7,1428,15015172.333333334,204.0,204.0
113354142.0,6,48,3168,24,1584,4928440.956521739,66.0,66.0,24,1584,4920340.956521739,66.0,66.0
201107.0,17,2,762,2,762,0.0,381.0,381.0,0,0,0.0,0.0,0.0
108114762.0,17,5,955,5,955,27028690.5,191.0,191.0,0,0,0.0,0.0,0.0
208998.0,17,2,180,1,90,0.0,90.0,90.0,1,90,0.0,90.0,90.0
23620.0,6,10,1065,5,534,5609.75,262.0,106.8,5,531,4940.75,259.0,106.2
115717357.0,6,48,3168,24,1584,5031189.434782608,66.0,66.0,24,1584,5021793.434782608,66.0,66.0
142122.0,6,2,132,1,66,0.0,66.0,66.0,1,66,0.0,66.0,66.0
90022982.0,17,28,13364,28,13364,3334184.5185185187,501.0,477.2857142857143,0,0,0.0,0.0,0.0
316132.0,17,4,1400,4,1400,105377.33333333331,350.0,350.0,0,0,0.0,0.0,0.0
5623517.0,6,5,336,2,134,0.0,68.0,67.0,3,202,1509358.5,70.0,67.33333333333333
8826221.0,17,3,1034,2,684,0.0,342.0,342.0,1,350,0.0,350.0,350.0
1155465.0,6,13,3000,8,2372,165066.42857142858,1514.0,296.5,5,628,220710.25,331.0,125.6
310188.0,6,6,412,4,272,103396.0,74.0,68.0,2,140,0.0,74.0,70.0
90062524.0,17,28,13364,28,13364,3335649.037037037,501.0,477.2857142857143,0,0,0.0,0.0,0.0
11641.0,6,10,1066,5,490,2711.75,218.0,98.0,5,576,2692.25,304.0,115.2
304733.0,6,6,412,4,272,101577.66666666669,74.0,68.0,2,140,0.0,74.0,70.0
363464.0,6,11,1021,6,444,48905.8,162.0,74.0,5,577,60940.0,349.0,115.4
124126.0,6,3,373,2,238,0.0,172.0,119.0,1,135,0.0,135.0,135.0
5625490.0,6,4,270,2,134,0.0,68.0,67.0,2,136,0.0,70.0,68.0
2356.0,17,4,344,2,150,0.0,75.0,75.0,2,194,0.0,103.0,97.0
2351.0,17,4,344,2,150,0.0,75.0,75.0,2,194,0.0,103.0,97.0
837931.0,6,9,1118,6,586,167586.2,248.0,97.66666666666669,3,532,280993.0,392.0,177.33333333333334
146108.0,6,3,337,2,214,0.0,160.0,107.0,1,123,0.0,123.0,123.0
134149.0,17,2,762,2,762,0.0,381.0,381.0,0,0,0.0,0.0,0.0
215469.0,17,2,180,1,90,0.0,90.0,90.0,1,90,0.0,90.0,90.0
305794.0,6,6,412,4,272,101931.33333333331,74.0,68.0,2,140,0.0,74.0,70.0
90303177.0,6,15,1097,8,596,12900453.857142856,95.0,74.5,7,501,15000750.0,95.0,71.57142857142857
620261.0,6,7,1876,4,987,206753.66666666663,785.0,246.75,3,889,158298.5,753.0,296.3333333333333
26221.0,6,10,2032,5,524,6326.5,252.0,104.8,5,1508,6023.25,1236.0,301.6
198859.0,17,2,180,1,90,0.0,90.0,90.0,1,90,0.0,90.0,90.0
1161145.0,6,13,3020,8,2392,165877.85714285713,1514.0,299.0,5,628,222133.0,331.0,125.6
41852.0,6,10,2032,5,524,7143.0,252.0,104.8,5,1508,8005.75,1236.0,301.6
232413.0,6,3,337,2,214,0.0,160.0,107.0,1,123,0.0,123.0,123.0
29480.0,6,14,4740,7,653,4299.0,249.0,93.28571428571428,7,4087,4773.333333333333,1514.0,583.8571428571429
216591.0,17,2,180,1,90,0.0,90.0,90.0,1,90,0.0,90.0,90.0
300054.0,6,6,412,4,272,100018.0,74.0,68.0,2,140,0.0,74.0,70.0
120009826.0,6,18,1341,9,691,14999991.125,95.0,76.77777777777777,9,650,15000525.875,95.0,72.22222222222223
108096465.0,17,5,1005,5,1005,27024116.25,201.0,201.0,0,0,0.0,0.0,0.0
90324237.0,6,16,1192,8,596,12897366.285714284,95.0,74.5,8,596,12902332.42857143,95.0,74.5
308099.0,6,6,412,4,272,102699.66666666669,74.0,68.0,2,140,0.0,74.0,70.0
120007665.0,6,17,1246,9,650,15000958.125,95.0,72.22222222222223,8,596,17106402.714285713,95.0,74.5
300803.0,6,6,412,4,272,100267.66666666669,74.0,68.0,2,140,0.0,74.0,70.0
987706.0,17,6,1230,3,234,493664.5,78.0,78.0,3,996,493654.5,332.0,332.0
261.0,17,2,762,2,762,0.0,381.0,381.0,0,0,0.0,0.0,0.0
2408.0,17,4,344,2,150,0.0,75.0,75.0,2,194,0.0,103.0,97.0
120049263.0,17,28,13364,28,13364,4446269.0,501.0,477.2857142857143,0,0,0.0,0.0,0.0
754.0,17,4,438,2,148,0.0,74.0,74.0,2,290,0.0,147.0,145.0
57168.0,6,14,4740,7,653,9354.0,249.0,93.28571428571428,7,4087,9391.0,1514.0,583.8571428571429
9165.0,17,2,582,1,83,0.0,83.0,83.0,1,499,0.0,499.0,499.0
41056.0,6,10,2032,5,524,9998.25,252.0,104.8,5,1508,9853.25,1236.0,301.6
90256364.0,6,12,1832,8,1016,12893766.285714284,188.0,127.0,4,816,30031357.33333333,204.0,204.0
2310.0,17,4,344,2,150,0.0,75.0,75.0,2,194,0.0,103.0,97.0
301390.0,6,6,412,4,272,100463.33333333331,74.0,68.0,2,140,0.0,74.0,70.0
82783.0,6,13,1428,7,797,12703.666666666666,253.0,113.85714285714286,6,631,14073.0,293.0,105.16666666666669
47538.0,6,14,4740,7,653,7460.0,249.0,93.28571428571428,7,4087,6716.333333333333,1514.0,583.8571428571429
91442873.0,6,24,1829,13,989,7619622.416666667,95.0,76.07692307692308,11,840,9142648.8,95.0,76.36363636363636
10521638.0,6,7,478,4,272,3460074.333333333,74.0,68.0,3,206,5189991.5,74.0,68.66666666666667
149700353.0,6,15,2290,5,1020,29958836.5,204.0,204.0,10,1270,16633218.444444444,188.0,127.0
1299556.0,6,4,264,2,132,0.0,66.0,66.0,2,132,0.0,66.0,66.0
104118108.0,6,223,25368,112,7614,938000.972972973,140.0,67.98214285714286,111,17754,938146.218181818,284.0,159.94594594594594
320.0,17,2,156,1,78,0.0,78.0,78.0,1,78,0.0,78.0,78.0
118661224.0,6,36,2596,18,1248,6980072.0,123.0,69.33333333333333,18,1348,6379994.705882353,139.0,74.88888888888889
47799217.0,6,8,1940,3,887,22649023.5,753.0,295.6666666666667,5,1053,11259721.5,785.0,210.6
26163.0,6,14,4740,7,653,4151.5,249.0,93.28571428571428,7,4087,4229.166666666667,1514.0,583.8571428571429
294.0,17,2,156,1,78,0.0,78.0,78.0,1,78,0.0,78.0,78.0
307977.0,6,6,412,4,272,102659.0,74.0,68.0,2,140,0.0,74.0,70.0
895221.0,6,12,2708,7,742,149203.5,338.0,106.0,5,1966,154998.75,1514.0,393.2
74903.0,17,4,820,2,156,0.0,78.0,78.0,2,664,0.0,332.0,332.0
101232744.0,17,14,864,7,432,16834148.666666668,174.0,61.71428571428572,7,432,16833496.0,174.0,61.71428571428572
90026338.0,17,28,13364,28,13364,3334308.814814815,501.0,477.2857142857143,0,0,0.0,0.0,0.0
102754.0,17,2,286,2,286,0.0,143.0,143.0,0,0,0.0,0.0,0.0
15635.0,17,2,180,1,90,0.0,90.0,90.0,1,90,0.0,90.0,90.0
205519.0,17,2,180,1,90,0.0,90.0,90.0,1,90,0.0,90.0,90.0
46342.0,6,14,4740,7,653,4920.333333333333,249.0,93.28571428571428,7,4087,6943.5,1514.0,583.8571428571429
108110180.0,17,5,1005,5,1005,27027545.0,201.0,201.0,0,0,0.0,0.0,0.0
348.0,17,2,160,1,80,0.0,80.0,80.0,1,80,0.0,80.0,80.0
123730516.0,6,49,3234,25,1650,5155438.166666667,66.0,66.0,24,1584,5152857.260869565,66.0,66.0
44758.0,6,10,2032,5,524,10157.25,252.0,104.8,5,1508,9854.0,1236.0,301.6
221978.0,6,10,1066,5,490,53719.5,218.0,98.0,5,576,54901.75,304.0,115.2
90033786.0,17,28,13364,28,13364,3334584.6666666665,501.0,477.2857142857143,0,0,0.0,0.0,0.0
5627043.0,6,5,336,2,134,0.0,68.0,67.0,3,202,1422284.5,70.0,67.33333333333333
8992.0,17,2,582,1,83,0.0,83.0,83.0,1,499,0.0,499.0,499.0
108106391.0,17,5,1005,5,1005,27026597.75,201.0,201.0,0,0,0.0,0.0,0.0
39862.0,6,14,4740,7,653,6450.166666666667,249.0,93.28571428571428,7,4087,5971.666666666667,1514.0,583.8571428571429
1897.0,17,6,1230,3,234,637.0,78.0,78.0,3,996,741.5,332.0,332.0
2791848.0,6,2,132,1,66,0.0,66.0,66.0,1,66,0.0,66.0,66.0
110983566.0,6,37,2788,19,1471,6154340.888888889,139.0,77.42105263157895,18,1317,6516414.05882353,123.0,73.16666666666667
119579046.0,6,24,1829,11,840,11957904.6,95.0,76.36363636363636,13,989,9943803.75,95.0,76.07692307692308
329094.0,6,6,412,4,272,109698.0,74.0,68.0,2,140,0.0,74.0,70.0
228411.0,17,2,180,1,90,0.0,90.0,90.0,1,90,0.0,90.0,90.0
10469481.0,6,7,478,4,272,3444499.333333333,74.0,68.0,3,206,5166612.0,74.0,68.66666666666667
2088.0,17,4,344,2,150,0.0,75.0,75.0,2,194,0.0,103.0,97.0
46335.0,6,10,2032,5,524,10541.5,252.0,104.8,5,1508,11089.25,1236.0,301.6
47021.0,6,14,4740,7,653,7008.333333333333,249.0,93.28571428571428,7,4087,7597.666666666667,1514.0,583.8571428571429
3179998.0,6,18,1495,9,921,358150.25,315.0,102.33333333333331,9,574,358126.25,78.0,63.77777777777778
1043267.0,6,11,1134,6,558,208653.4,220.0,93.0,5,576,260069.25,304.0,115.2
21830024.0,6,6,1981,4,1087,7276674.666666667,885.0,271.75,2,894,0.0,826.0,447.0
28841.0,6,14,4740,7,653,4649.5,249.0,93.28571428571428,7,4087,4672.166666666667,1514.0,583.8571428571429
119457707.0,6,48,3168,24,1584,5193813.347826087,66.0,66.0,24,1584,5184414.173913044,66.0,66.0
10462752.0,6,7,478,4,272,3442342.333333333,74.0,68.0,3,206,5163388.0,74.0,68.66666666666667
107367423.0,6,197,22286,99,15596,1093389.5612244897,284.0,157.53535353535352,98,6690,1104244.1855670102,140.0,68.26530612244898
263209.0,6,10,1221,6,636,52641.8,298.0,106.0,4,585,81717.66666666667,379.0,146.25
44732.0,6,14,4740,7,653,7024.0,249.0,93.28571428571428,7,4087,6613.333333333333,1514.0,583.8571428571429
69897.0,17,2,180,1,90,0.0,90.0,90.0,1,90,0.0,90.0,90.0
228277.0,17,2,180,1,90,0.0,90.0,90.0,1,90,0.0,90.0,90.0
109001.0,17,2,286,2,286,0.0,143.0,143.0,0,0,0.0,0.0,0.0
228260.0,17,2,180,1,90,0.0,90.0,90.0,1,90,0.0,90.0,90.0
103129.0,17,2,286,2,286,0.0,143.0,143.0,0,0,0.0,0.0,0.0
306732.0,6,6,412,4,272,102244.0,74.0,68.0,2,140,0.0,74.0,70.0
65473.0,6,14,4740,7,653,10775.0,249.0,93.28571428571428,7,4087,10572.5,1514.0,583.8571428571429
10623.0,17,2,498,1,80,0.0,80.0,80.0,1,418,0.0,418.0,418.0
61249.0,6,11,2098,6,590,12017.2,252.0,98.33333333333331,5,1508,14269.75,1236.0,301.6
115372384.0,6,212,24012,106,16794,1096734.380952381,284.0,158.43396226415095,106,7218,1096734.1142857142,140.0,68.09433962264151
209382.0,17,2,180,1,90,0.0,90.0,90.0,1,90,0.0,90.0,90.0
90256624.0,6,13,2036,8,1016,12893803.42857143,188.0,127.0,5,1020,22523112.0,204.0,204.0
41724.0,6,14,4740,7,653,6837.833333333333,249.0,93.28571428571428,7,4087,6494.5,1514.0,583.8571428571429
54593.0,6,14,4740,7,653,8596.0,249.0,93.28571428571428,7,4087,8907.666666666666,1514.0,583.8571428571429
90260712.0,6,12,1832,8,1016,12894387.42857143,188.0,127.0,4,816,30032332.33333333,204.0,204.0
29335.0,6,14,4740,7,653,4293.666666666667,249.0,93.28571428571428,7,4087,4700.833333333333,1514.0,583.8571428571429
262047.0,6,3,337,2,214,0.0,160.0,107.0,1,123,0.0,123.0,123.0
2849.0,17,2,224,1,76,0.0,76.0,76.0,1,148,0.0,148.0,148.0
316083.0,17,4,1400,4,1400,105361.0,350.0,350.0,0,0,0.0,0.0,0.0
3675995.0,6,4,270,2,134,0.0,68.0,67.0,2,136,0.0,70.0,68.0
746971.0,6,2,132,1,66,0.0,66.0,66.0,1,66,0.0,66.0,66.0
90045365.0,17,28,13364,28,13364,3335013.5185185187,501.0,477.2857142857143,0,0,0.0,0.0,0.0
2778152.0,6,2,132,1,66,0.0,66.0,66.0,1,66,0.0,66.0,66.0
205932.0,6,3,426,2,280,0.0,214.0,140.0,1,146,0.0,146.0,146.0
2795190.0,6,2,132,1,66,0.0,66.0,66.0,1,66,0.0,66.0,66.0
90278334.0,6,16,1192,8,596,12890778.42857143,95.0,74.5,8,596,12896134.0,95.0,74.5
31098.0,6,14,4740,7,653,4960.166666666667,249.0,93.28571428571428,7,4087,4874.333333333333,1514.0,583.8571428571429
3198.0,17,2,224,1,76,0.0,76.0,76.0,1,148,0.0,148.0,148.0
60182.0,6,14,4740,7,653,9256.0,249.0,93.28571428571428,7,4087,9384.166666666666,1514.0,583.8571428571429
3789338.0,6,5,336,2,134,0.0,68.0,67.0,3,202,1529663.0,70.0,67.33333333333333
1180923.0,6,13,3020,8,2392,168703.2857142857,1514.0,299.0,5,628,226323.0,331.0,125.6
280903.0,17,2,363,1,79,0.0,79.0,79.0,1,284,0.0,284.0,284.0
338.0,17,2,164,1,74,0.0,74.0,74.0,1,90,0.0,90.0,90.0
23272703.0,6,26,7627,14,3735,180828.4615384616,1514.0,266.7857142857143,12,3892,2096035.5454545447,1514.0,324.3333333333333
104303128.0,17,16,1212,8,606,14877746.0,174.0,75.75,8,606,14892239.142857144,174.0,75.75
10834026.0,6,8,544,4,272,3565744.6666666665,74.0,68.0,4,272,3565642.333333333,74.0,68.0
79927.0,6,14,4740,7,653,12629.833333333334,249.0,93.28571428571428,7,4087,12258.5,1514.0,583.8571428571429
2037.0,17,4,344,2,150,0.0,75.0,75.0,2,194,0.0,103.0,97.0
841260.0,6,9,1118,6,586,168252.0,248.0,97.66666666666669,3,532,282764.0,392.0,177.33333333333334
123001251.0,17,15,1169,8,606,17571607.285714287,174.0,75.75,7,563,17167629.5,174.0,80.42857142857143
1318944.0,6,4,264,2,132,0.0,66.0,66.0,2,132,0.0,66.0,66.0
209687.0,6,10,1221,6,636,41937.4,298.0,106.0,4,585,68773.33333333333,379.0,146.25
2603681.0,6,25,7573,14,3735,200283.15384615384,1514.0,266.7857142857143,11,3838,233781.3,1514.0,348.90909090909093
227831.0,6,10,1221,6,636,45566.2,298.0,106.0,4,585,74654.0,379.0,146.25
135125787.0,17,6,1206,6,1206,27025157.4,201.0,201.0,0,0,0.0,0.0,0.0
10427607.0,6,7,478,4,272,3430366.333333333,74.0,68.0,3,206,5145469.0,74.0,68.66666666666667
245445.0,6,3,337,2,214,0.0,160.0,107.0,1,123,0.0,123.0,123.0
93948277.0,6,30,2106,15,1089,6695172.785714285,123.0,72.6,15,1017,6695173.5,123.0,67.8
108103625.0,17,5,1005,5,1005,27025906.25,201.0,201.0,0,0,0.0,0.0,0.0
1171.0,17,5,550,5,550,292.75,110.0,110.0,0,0,0.0,0.0,0.0
103748.0,17,2,286,2,286,0.0,143.0,143.0,0,0,0.0,0.0,0.0
35010.0,6,2,145,2,145,0.0,91.0,72.5,0,0,0.0,0.0,0.0
16799.0,6,11,1132,6,556,3318.8,218.0,92.66666666666669,5,576,3525.0,304.0,115.2
1442.0,17,2,762,2,762,0.0,381.0,381.0,0,0,0.0,0.0,0.0
122227.0,6,3,373,2,238,0.0,172.0,119.0,1,135,0.0,135.0,135.0
5826830.0,6,5,336,2,134,0.0,68.0,67.0,3,202,1525803.0,70.0,67.33333333333333
228471.0,17,2,180,1,90,0.0,90.0,90.0,1,90,0.0,90.0,90.0
10425299.0,6,6,412,3,206,5142924.0,74.0,68.66666666666667,3,206,5142797.0,74.0,68.66666666666667
2796073.0,6,2,132,1,66,0.0,66.0,66.0,1,66,0.0,66.0,66.0
302719.0,6,6,412,4,272,100906.33333333331,74.0,68.0,2,140,0.0,74.0,70.0
100326.0,17,2,762,2,762,0.0,381.0,381.0,0,0,0.0,0.0,0.0
143931.0,17,2,180,1,90,0.0,90.0,90.0,1,90,0.0,90.0,90.0
42596.0,6,13,1479,7,882,6979.5,291.0,126.0,6,597,7384.6,259.0,99.5
118767452.0,6,34,2466,17,1194,7422965.75,123.0,70.23529411764706,17,1272,6928971.25,123.0,74.82352941176471
90026766.0,17,28,13364,28,13364,3334324.6666666665,501.0,477.2857142857143,0,0,0.0,0.0,0.0
101446.0,17,2,762,2,762,0.0,381.0,381.0,0,0,0.0,0.0,0.0
3030360.0,6,3,1604,2,851,0.0,785.0,425.5,1,753,0.0,753.0,753.0
489908.0,17,2,876,2,876,0.0,438.0,438.0,0,0,0.0,0.0,0.0
2294416.0,6,49,23728,25,19797,95600.66666666669,1514.0,791.88,24,3931,90495.1304347826,1514.0,163.79166666666666
120000068.0,6,20,1531,11,840,12000006.8,95.0,76.36363636363636,9,691,11287081.0,95.0,76.77777777777777
90041653.0,17,28,13364,28,13364,3334876.037037037,501.0,477.2857142857143,0,0,0.0,0.0,0.0
113855360.0,6,47,3102,24,1584,4950222.391304348,66.0,66.0,23,1518,5160003.727272728,66.0,66.0
135115404.0,17,6,1146,6,1146,27023080.8,191.0,191.0,0,0,0.0,0.0,0.0
1029864.0,6,11,1134,6,558,205972.8,220.0,93.0,5,576,256337.75,304.0,115.2
108110896.0,17,5,1005,5,1005,27027724.0,201.0,201.0,0,0,0.0,0.0,0.0
137431.0,6,2,132,1,66,0.0,66.0,66.0,1,66,0.0,66.0,66.0
4503.0,17,2,614,1,72,0.0,72.0,72.0,1,542,0.0,542.0,542.0
90527653.0,6,14,2240,8,1016,12932521.857142856,188.0,127.0,6,1224,18067206.2,204.0,204.0
14954.0,17,2,180,1,90,0.0,90.0,90.0,1,90,0.0,90.0,90.0
300739.0,6,12,1373,7,714,50123.16666666666,298.0,102.0,5,659,71142.75,379.0,131.8
1653560.0,6,7,499,4,301,487303.3333333333,103.0,75.25,3,198,818769.0,66.0,66.0
224605.0,17,2,180,1,90,0.0,90.0,90.0,1,90,0.0,90.0,90.0
2370.0,17,4,344,2,150,0.0,75.0,75.0,2,194,0.0,103.0,97.0
308443.0,6,6,412,4,272,102814.33333333331,74.0,68.0,2,140,0.0,74.0,70.0
99899538.0,17,16,5480,15,5130,5706222.857142857,342.0,342.0,1,350,0.0,350.0,350.0
1100536.0,6,13,1394,7,797,183422.66666666663,253.0,113.85714285714286,6,597,219246.0,259.0,99.5
108168.0,17,2,286,2,286,0.0,143.0,143.0,0,0,0.0,0.0,0.0
108108127.0,17,5,955,5,955,27027031.75,191.0,191.0,0,0,0.0,0.0,0.0
91823204.0,6,31,3301,17,1748,5738950.25,427.0,102.82352941176472,14,1553,7046230.076923077,362.0,110.92857142857144
211337.0,17,2,180,1,90,0.0,90.0,90.0,1,90,0.0,90.0,90.0
1303397.0,6,4,264,2,132,0.0,66.0,66.0,2,132,0.0,66.0,66.0
120012503.0,6,278,32328,139,22932,868096.1594202898,464.0,164.97841726618705,139,9396,868096.5,140.0,67.59712230215827
43546.0,6,14,4740,7,653,7147.666666666667,249.0,93.28571428571428,7,4087,6431.333333333333,1514.0,583.8571428571429
7518.0,17,2,762,2,762,0.0,381.0,381.0,0,0,0.0,0.0,0.0
98162.0,6,14,4740,7,653,15404.333333333334,249.0,93.28571428571428,7,4087,16021.0,1514.0,583.8571428571429
354701.0,6,6,412,4,272,118233.66666666669,74.0,68.0,2,140,0.0,74.0,70.0
216542.0,17,2,180,1,90,0.0,90.0,90.0,1,90,0.0,90.0,90.0
1572022.0,6,39,25561,20,1501,82738.0,227.0,75.05,19,24060,87138.61111111111,1514.0,1266.3157894736842
90021139.0,17,27,12943,27,12943,3462351.5,501.0,479.3703703703704,0,0,0.0,0.0,0.0
113027092.0,17,13,952,7,563,18837848.666666668,174.0,80.42857142857143,6,389,18418282.0,174.0,64.83333333333333
117319047.0,6,34,2350,17,1225,7318808.0,139.0,72.05882352941177,17,1125,7318947.0,123.0,66.17647058823529
2416.0,17,4,344,2,150,0.0,75.0,75.0,2,194,0.0,103.0,97.0
197436.0,17,2,180,1,90,0.0,90.0,90.0,1,90,0.0,90.0,90.0
209498.0,17,2,180,1,90,0.0,90.0,90.0,1,90,0.0,90.0,90.0
97225976.0,6,160,18186,80,12684,1228117.7848101263,284.0,158.55,80,5502,1228108.0632911392,140.0,68.775
1029382.0,6,11,1134,6,558,205876.4,220.0,93.0,5,576,256101.25,304.0,115.2
120183199.0,6,194,21870,97,6624,1243279.6979166667,140.0,68.28865979381443,97,15246,1233775.9791666667,284.0,157.17525773195877
34282.0,6,14,4740,7,653,5517.5,249.0,93.28571428571428,7,4087,5575.833333333333,1514.0,583.8571428571429
3396.0,17,2,363,1,79,0.0,79.0,79.0,1,284,0.0,284.0,284.0
534.0,17,2,508,2,508,0.0,257.0,254.0,0,0,0.0,0.0,0.0
38278.0,6,13,1479,7,882,6379.666666666667,291.0,126.0,6,597,5086.8,259.0,99.5
128029.0,17,4,1400,4,1400,42676.333333333336,350.0,350.0,0,0,0.0,0.0,0.0
90220444.0,6,16,1192,8,596,12853814.714285716,95.0,74.5,8,596,12859392.0,95.0,74.5
33695231.0,6,5,336,2,134,0.0,68.0,67.0,3,202,15462338.0,70.0,67.33333333333333
841.0,17,4,438,2,148,0.0,74.0,74.0,2,290,0.0,147.0,145.0
198883.0,17,2,180,1,90,0.0,90.0,90.0,1,90,0.0,90.0,90.0
209365.0,17,2,180,1,90,0.0,90.0,90.0,1,90,0.0,90.0,90.0
143930.0,17,2,180,1,90,0.0,90.0,90.0,1,90,0.0,90.0,90.0
112631512.0,6,40,3094,21,1654,5631575.6,139.0,78.76190476190476,19,1440,6245288.833333333,123.0,75.78947368421052
253652.0,17,4,1400,4,1400,84550.66666666667,350.0,350.0,0,0,0.0,0.0,0.0
2373.0,17,4,344,2,150,0.0,75.0,75.0,2,194,0.0,103.0,97.0
143860.0,17,2,180,1,90,0.0,90.0,90.0,1,90,0.0,90.0,90.0
113514434.0,6,48,3168,24,1584,4935410.173913044,66.0,66.0,24,1584,4923430.304347826,66.0,66.0
12885.0,6,10,1067,5,536,2858.75,264.0,107.2,5,531,2978.25,259.0,106.2
146128.0,6,3,337,2,214,0.0,160.0,107.0,1,123,0.0,123.0,123.0
927655.0,6,12,1354,6,723,183964.0,253.0,120.5,6,631,184804.2,293.0,105.16666666666669
318.0,17,2,174,1,79,0.0,79.0,79.0,1,95,0.0,95.0,95.0
93924.0,6,10,2032,5,524,23239.0,252.0,104.8,5,1508,22551.25,1236.0,301.6
301242.0,6,6,412,4,272,100414.0,74.0,68.0,2,140,0.0,74.0,70.0
10428816.0,6,6,412,3,206,5146609.0,74.0,68.66666666666667,3,206,5146486.5,74.0,68.66666666666667
216449.0,17,2,180,1,90,0.0,90.0,90.0,1,90,0.0,90.0,90.0
120123007.0,6,15,2444,7,1428,20020501.166666668,204.0,204.0,8,1016,17137257.57142857,188.0,127.0
153436.0,17,2,180,1,90,0.0,90.0,90.0,1,90,0.0,90.0,90.0
90238041.0,6,21,1585,10,745,9996528.222222222,95.0,74.5,11,840,9002194.8,95.0,76.36363636363636
12945.0,6,11,1131,6,600,2281.8,262.0,100.0,5,531,2763.0,259.0,106.2
326256.0,17,4,1400,4,1400,108752.0,350.0,350.0,0,0,0.0,0.0,0.0
1007.0,17,4,438,2,148,0.0,74.0,74.0,2,290,0.0,147.0,145.0
175977.0,17,2,414,1,88,0.0,88.0,88.0,1,326,0.0,326.0,326.0
90291164.0,6,12,1832,8,1016,12898737.714285716,188.0,127.0,4,816,30041918.33333333,204.0,204.0
20069.0,6,14,4740,7,653,3181.1666666666665,249.0,93.28571428571428,7,4087,3193.5,1514.0,583.8571428571429
1019328.0,6,11,1134,6,558,203865.6,220.0,93.0,5,576,253707.25,304.0,115.2
107817.0,17,2,286,2,286,0.0,143.0,143.0,0,0,0.0,0.0,0.0
295.0,17,2,164,1,82,0.0,82.0,82.0,1,82,0.0,82.0,82.0
319.0,17,2,168,1,76,0.0,76.0,76.0,1,92,0.0,92.0,92.0
135133409.0,17,6,1206,6,1206,27026681.8,201.0,201.0,0,0,0.0,0.0,0.0
33879666.0,6,24,6835,13,1695,2823305.5,408.0,130.3846153846154,11,5140,2999645.3,1514.0,467.27272727272725
40474.0,6,14,4740,7,653,6617.833333333333,249.0,93.28571428571428,7,4087,6602.833333333333,1514.0,583.8571428571429
146075.0,6,3,337,2,214,0.0,160.0,107.0,1,123,0.0,123.0,123.0
766.0,17,5,550,5,550,191.5,110.0,110.0,0,0,0.0,0.0,0.0
1308753.0,6,4,264,2,132,0.0,66.0,66.0,2,132,0.0,66.0,66.0
66387.0,6,14,4740,7,653,10889.5,249.0,93.28571428571428,7,4087,9852.166666666666,1514.0,583.8571428571429
2594423.0,6,2,132,1,66,0.0,66.0,66.0,1,66,0.0,66.0,66.0
90295720.0,6,17,1287,9,691,11281110.625,95.0,76.77777777777777,8,596,12897848.714285716,95.0,74.5
19793.0,6,11,1131,6,600,3176.6,262.0,100.0,5,531,4322.25,259.0,106.2
49652.0,6,14,4740,7,653,7881.833333333333,249.0,93.28571428571428,7,4087,4572.833333333333,1514.0,583.8571428571429
100679392.0,17,14,1126,7,563,16779898.666666668,174.0,80.42857142857143,7,563,16642921.0,174.0,80.42857142857143
102708.0,17,2,762,2,762,0.0,381.0,381.0,0,0,0.0,0.0,0.0
105473672.0,6,32,2374,17,1288,6578602.625,139.0,75.76470588235294,15,1086,7518401.857142857,123.0,72.4
311170.0,17,4,1400,4,1400,103723.33333333331,350.0,350.0,0,0,0.0,0.0,0.0
27103.0,6,14,4740,7,653,4342.0,249.0,93.28571428571428,7,4087,4322.833333333333,1514.0,583.8571428571429
3494.0,17,4,344,2,150,0.0,75.0,75.0,2,194,0.0,103.0,97.0
928686.0,6,13,1513,7,882,153779.5,291.0,126.0,6,631,183874.2,293.0,105.16666666666669
5642584.0,6,5,336,2,134,0.0,68.0,67.0,3,202,1533919.0,70.0,67.33333333333333
100778317.0,6,28,1860,14,966,7735587.769230769,123.0,69.0,14,894,7735585.538461538,123.0,63.85714285714285
90372276.0,6,12,1848,5,1020,22592660.0,204.0,204.0,7,828,15061809.166666666,188.0,118.28571428571428
91422096.0,6,24,1829,13,989,7617871.583333333,95.0,76.07692307692308,11,840,9141740.5,95.0,76.36363636363636
2465.0,17,4,344,2,150,0.0,75.0,75.0,2,194,0.0,103.0,97.0
117437955.0,6,225,25282,113,7680,1048553.1696428572,140.0,67.96460176991151,112,17602,1047238.3603603604,284.0,157.16071428571428
246250.0,6,3,337,2,214,0.0,160.0,107.0,1,123,0.0,123.0,123.0
15868.0,6,10,2032,5,524,3658.75,252.0,104.8,5,1508,3716.25,1236.0,301.6
135128801.0,17,6,1146,6,1146,27025760.2,191.0,191.0,0,0,0.0,0.0,0.0
228296.0,17,2,180,1,90,0.0,90.0,90.0,1,90,0.0,90.0,90.0
1075734.0,6,4,270,2,136,0.0,70.0,68.0,2,134,0.0,68.0,67.0
25400.0,6,20,7606,11,978,2540.0,310.0,88.9090909090909,9,6628,2869.625,1514.0,736.4444444444445
20894.0,6,10,2032,5,524,4923.0,252.0,104.8,5,1508,4222.75,1236.0,301.6
228297.0,17,2,180,1,90,0.0,90.0,90.0,1,90,0.0,90.0,90.0
302404.0,6,2,132,1,66,0.0,66.0,66.0,1,66,0.0,66.0,66.0
7275097.0,6,34,8869,18,4917,427946.8823529412,1514.0,273.1666666666667,16,3952,412479.8666666666,1514.0,247.0
211315.0,6,3,426,2,280,0.0,214.0,140.0,1,146,0.0,146.0,146.0
100476232.0,17,14,1126,7,563,16666828.666666666,174.0,80.42857142857143,7,563,16668274.833333334,174.0,80.42857142857143
120123563.0,6,13,2036,5,1020,30030890.75,204.0,204.0,8,1016,17136997.714285713,188.0,127.0
100706308.0,17,12,516,6,258,20001534.8,43.0,43.0,6,258,20000174.0,43.0,43.0
310967.0,6,6,412,4,272,103655.66666666669,74.0,68.0,2,140,0.0,74.0,70.0
351.0,17,2,267,1,83,0.0,83.0,83.0,1,184,0.0,184.0,184.0
118735793.0,6,39,2902,20,1531,6249252.263157895,139.0,76.55,19,1371,6030350.277777778,123.0,72.15789473684211
197033.0,17,2,180,1,90,0.0,90.0,90.0,1,90,0.0,90.0,90.0
115908.0,17,4,1400,4,1400,38636.0,350.0,350.0,0,0,0.0,0.0,0.0
100642816.0,17,13,821,7,432,16666798.666666666,174.0,61.71428571428572,6,389,20002378.0,174.0,64.83333333333333
30657.0,6,14,4740,7,653,5002.333333333333,249.0,93.28571428571428,7,4087,4172.833333333333,1514.0,583.8571428571429
83028137.0,17,13,4454,12,4104,6794000.0,342.0,342.0,1,350,0.0,350.0,350.0
108103191.0,17,5,1005,5,1005,27025797.75,201.0,201.0,0,0,0.0,0.0,0.0
14960.0,17,2,180,1,90,0.0,90.0,90.0,1,90,0.0,90.0,90.0
848399.0,6,9,1269,6,798,169679.8,460.0,133.0,3,471,287959.0,331.0,157.0
90525739.0,6,14,2240,8,1016,12932248.42857143,188.0,127.0,6,1224,18072353.4,204.0,204.0
153405.0,17,2,180,1,90,0.0,90.0,90.0,1,90,0.0,90.0,90.0
725935.0,6,12,1373,7,714,120989.16666666669,298.0,102.0,5,659,177415.75,379.0,131.8
120122558.0,6,15,2428,9,1204,15015319.75,188.0,133.77777777777777,6,1224,18073469.8,204.0,204.0
4149.0,17,4,344,2,150,0.0,75.0,75.0,2,194,0.0,103.0,97.0
24581761.0,6,26,7627,14,3735,202167.92307692303,1514.0,266.7857142857143,12,3892,2215116.1818181816,1514.0,324.3333333333333
270638.0,6,3,337,2,214,0.0,160.0,107.0,1,123,0.0,123.0,123.0
118456198.0,6,299,34074,150,10122,795008.0402684563,140.0,67.48,149,23952,793458.2297297297,374.0,160.751677852349
305595.0,17,2,246,1,76,0.0,76.0,76.0,1,170,0.0,170.0,170.0
90005296.0,17,11,735,6,389,18001059.2,174.0,64.83333333333333,5,346,17500174.0,174.0,69.2
43687.0,6,13,1386,7,789,6856.833333333333,253.0,112.71428571428572,6,597,8217.4,259.0,99.5
10513552.0,6,7,478,4,272,3458761.0,74.0,68.0,3,206,5188027.0,74.0,68.66666666666667
108693144.0,6,34,2482,17,1288,6779842.5625,139.0,75.76470588235294,17,1194,6779840.875,123.0,70.23529411764706
54528.0,6,10,2032,5,524,13031.5,252.0,104.8,5,1508,13013.25,1236.0,301.6
2361.0,17,4,344,2,150,0.0,75.0,75.0,2,194,0.0,103.0,97.0
311622.0,17,4,1400,4,1400,103874.0,350.0,350.0,0,0,0.0,0.0,0.0
1907.0,17,2,192,1,88,0.0,88.0,88.0,1,104,0.0,104.0,104.0
121263404.0,6,37,2794,20,1531,6382284.421052632,139.0,76.55,17,1263,6941239.6875,123.0,74.29411764705883
221491.0,17,2,180,1,90,0.0,90.0,90.0,1,90,0.0,90.0,90.0
144967.0,17,2,180,1,70,0.0,70.0,70.0,1,110,0.0,110.0,110.0
153510.0,17,2,180,1,90,0.0,90.0,90.0,1,90,0.0,90.0,90.0
30869.0,6,10,2032,5,524,6896.0,252.0,104.8,5,1508,6544.5,1236.0,301.6
497.00000000000006,17,2,508,2,508,0.0,257.0,254.0,0,0,0.0,0.0,0.0
216254.0,6,3,426,2,280,0.0,214.0,140.0,1,146,0.0,146.0,146.0
206148.0,6,3,426,2,280,0.0,214.0,140.0,1,146,0.0,146.0,146.0
303674.0,6,2,132,1,66,0.0,66.0,66.0,1,66,0.0,66.0,66.0
571.0,17,2,508,2,508,0.0,257.0,254.0,0,0,0.0,0.0,0.0
120226648.0,6,208,23716,104,7160,1159384.4466019417,140.0,68.84615384615384,104,16556,1150099.524271845,336.0,159.19230769230768
61421.0,6,14,4740,7,653,5170.833333333333,249.0,93.28571428571428,7,4087,9523.666666666666,1514.0,583.8571428571429
332423.0,6,10,1221,6,636,66484.6,298.0,106.0,4,585,103122.33333333331,379.0,146.25
300404.0,6,6,412,4,272,100134.66666666669,74.0,68.0,2,140,0.0,74.0,70.0
33703.0,6,14,4740,7,653,5488.666666666667,249.0,93.28571428571428,7,4087,5342.666666666667,1514.0,583.8571428571429
259787.0,6,3,337,2,214,0.0,160.0,107.0,1,123,0.0,123.0,123.0
123836121.0,6,49,3234,25,1650,5159838.375,66.0,66.0,24,1584,5098204.913043479,66.0,66.0
52994.0,6,10,2032,5,524,12386.75,252.0,104.8,5,1508,12869.5,1236.0,301.6
256873.00000000003,6,3,337,2,214,0.0,160.0,107.0,1,123,0.0,123.0,123.0
47926409.0,6,7,2047,5,1153,11981602.25,885.0,230.6,2,894,0.0,826.0,447.0
234102.0,6,3,373,2,238,0.0,172.0,119.0,1,135,0.0,135.0,135.0
135122319.0,17,6,1146,6,1146,27024463.8,191.0,191.0,0,0,0.0,0.0,0.0
14197796.0,17,6,2052,6,2052,2839559.2,342.0,342.0,0,0,0.0,0.0,0.0
2902606.0,6,3,1777,2,951,0.0,885.0,475.5,1,826,0.0,826.0,826.0
317275.0,17,4,1400,4,1400,105758.33333333331,350.0,350.0,0,0,0.0,0.0,0.0
121229.0,6,3,337,2,214,0.0,160.0,107.0,1,123,0.0,123.0,123.0
2552574.0,6,2,134,1,68,0.0,68.0,68.0,1,66,0.0,66.0,66.0
207411.0,17,2,359,1,75,0.0,75.0,75.0,1,284,0.0,284.0,284.0
46956.0,6,14,4740,7,653,7699.166666666667,249.0,93.28571428571428,7,4087,7215.166666666667,1514.0,583.8571428571429
107960373.0,17,14,864,7,432,17834948.0,174.0,61.71428571428572,7,432,17833492.333333332,174.0,61.71428571428572
299662.0,6,6,412,4,272,99887.33333333331,74.0,68.0,2,140,0.0,74.0,70.0
91070249.0,6,207,23230,104,7086,884177.1747572816,140.0,68.13461538461539,103,16144,890571.3627450981,284.0,156.7378640776699
233494.0,6,3,373,2,238,0.0,172.0,119.0,1,135,0.0,135.0,135.0
2465.0,17,4,344,2,150,0.0,75.0,75.0,2,194,0.0,103.0,97.0
38838.0,6,14,4740,7,653,6347.833333333333,249.0,93.28571428571428,7,4087,6315.0,1514.0,583.8571428571429
117300839.0,6,221,25040,111,17484,1066371.2636363637,284.0,157.51351351351352,110,7556,1068240.4403669725,140.0,68.69090909090909
54644.0,6,14,4740,7,653,8406.166666666666,249.0,93.28571428571428,7,4087,8928.5,1514.0,583.8571428571429
106163.0,17,2,700,2,700,0.0,350.0,350.0,0,0,0.0,0.0,0.0
119643477.0,6,224,25328,112,17714,1076020.3063063065,284.0,158.16071428571428,112,7614,1076020.9099099098,140.0,67.98214285714286
137611.0,17,4,344,2,150,0.0,75.0,75.0,2,194,0.0,103.0,97.0
17699.0,17,2,180,1,90,0.0,90.0,90.0,1,90,0.0,90.0,90.0
751.0,17,4,438,2,148,0.0,74.0,74.0,2,290,0.0,147.0,145.0
2305.0,17,2,664,1,322,0.0,322.0,322.0,1,342,0.0,342.0,342.0
53628.0,6,14,4740,7,653,8498.833333333334,249.0,93.28571428571428,7,4087,8161.666666666667,1514.0,583.8571428571429
17493.0,6,11,1133,6,602,3404.6,264.0,100.33333333333331,5,531,4044.0,259.0,106.2
177371.0,17,2,180,1,90,0.0,90.0,90.0,1,90,0.0,90.0,90.0
147991.0,17,2,180,1,90,0.0,90.0,90.0,1,90,0.0,90.0,90.0
298773.0,6,6,412,4,272,99591.0,74.0,68.0,2,140,0.0,74.0,70.0
103723.0,6,11,2098,6,590,20403.0,252.0,98.33333333333331,5,1508,24183.0,1236.0,301.6
306424.0,6,10,1221,6,636,61284.8,298.0,106.0,4,585,95997.0,379.0,146.25
108106663.0,17,5,1005,5,1005,27026665.75,201.0,201.0,0,0,0.0,0.0,0.0
116899.0,17,4,1400,4,1400,38966.333333333336,350.0,350.0,0,0,0.0,0.0,0.0
2301.0,17,4,344,2,150,0.0,75.0,75.0,2,194,0.0,103.0,97.0
90089669.0,6,11,1628,7,950,15014944.833333334,188.0,135.71428571428572,4,678,20020743.666666668,204.0,169.5
2802250.0,6,2,132,1,66,0.0,66.0,66.0,1,66,0.0,66.0,66.0
209506.0,17,2,180,1,90,0.0,90.0,90.0,1,90,0.0,90.0,90.0
3179018.0,6,18,1536,9,962,358354.25,315.0,106.88888888888889,9,574,358314.375,78.0,63.77777777777778
27882.0,6,10,2032,5,524,6477.25,252.0,104.8,5,1508,5930.75,1236.0,301.6
1685626.0,17,18,1260,18,1260,99154.4705882353,70.0,70.0,0,0,0.0,0.0,0.0
5629023.0,6,5,336,2,134,0.0,68.0,67.0,3,202,1525069.5,70.0,67.33333333333333
121596560.0,17,14,864,7,432,17000203.333333332,174.0,61.71428571428572,7,432,17001081.333333332,174.0,61.71428571428572
122589.0,17,4,1400,4,1400,40863.0,350.0,350.0,0,0,0.0,0.0,0.0
39451.0,6,10,2032,5,524,8216.5,252.0,104.8,5,1508,9098.25,1236.0,301.6
146439.0,6,3,337,2,214,0.0,160.0,107.0,1,123,0.0,123.0,123.0
39876.0,6,14,4740,7,653,6456.666666666667,249.0,93.28571428571428,7,4087,5899.5,1514.0,583.8571428571429
118030993.0,6,48,3168,24,1584,5131782.304347826,66.0,66.0,24,1584,5118360.260869565,66.0,66.0
52541.0,6,10,2032,5,524,12359.0,252.0,104.8,5,1508,12694.75,1236.0,301.6
207223.0,6,3,426,2,280,0.0,214.0,140.0,1,146,0.0,146.0,146.0
200181.0,17,4,6056,4,6056,66727.0,1514.0,1514.0,0,0,0.0,0.0,0.0
303714.0,6,6,412,4,272,101238.0,74.0,68.0,2,140,0.0,74.0,70.0
219818.0,6,3,426,2,280,0.0,214.0,140.0,1,146,0.0,146.0,146.0
116433343.0,6,218,24534,109,17044,1076093.888888889,284.0,156.36697247706422,109,7490,1076093.9074074074,140.0,68.71559633027523
314.0,17,2,174,1,79,0.0,79.0,79.0,1,95,0.0,95.0,95.0
311211.0,17,4,1400,4,1400,103737.0,350.0,350.0,0,0,0.0,0.0,0.0
153472.0,17,2,180,1,90,0.0,90.0,90.0,1,90,0.0,90.0,90.0
1950265.0,17,2,876,2,876,0.0,438.0,438.0,0,0,0.0,0.0,0.0
170141.0,17,4,1524,4,1524,56713.66666666666,381.0,381.0,0,0,0.0,0.0,0.0
153433.0,17,2,180,1,90,0.0,90.0,90.0,1,90,0.0,90.0,90.0
234459.0,6,3,337,2,214,0.0,160.0,107.0,1,123,0.0,123.0,123.0
31203.0,6,14,4740,7,653,4801.333333333333,249.0,93.28571428571428,7,4087,4571.0,1514.0,583.8571428571429
19487.0,6,14,4740,7,653,3127.0,249.0,93.28571428571428,7,4087,2995.1666666666665,1514.0,583.8571428571429
197858.0,6,10,1221,6,636,39571.6,298.0,106.0,4,585,65075.333333333336,379.0,146.25
2875844.0,6,3,1777,2,951,0.0,885.0,475.5,1,826,0.0,826.0,826.0
60259.0,6,10,2032,5,524,14494.25,252.0,104.8,5,1508,13113.5,1236.0,301.6
90092576.0,6,13,2052,6,1224,18018008.0,204.0,204.0,7,828,14969976.833333334,188.0,118.28571428571428
319617.0,17,4,1400,4,1400,106539.0,350.0,350.0,0,0,0.0,0.0,0.0
6994.0,17,2,565,1,93,0.0,93.0,93.0,1,472,0.0,472.0,472.0
26579.0,6,14,4740,7,653,4288.5,249.0,93.28571428571428,7,4087,4218.166666666667,1514.0,583.8571428571429
233489.0,6,4,439,2,238,0.0,172.0,119.0,2,201,0.0,135.0,100.5
298114.0,6,6,412,4,272,99371.33333333331,74.0,68.0,2,140,0.0,74.0,70.0
1031483.0,6,11,1134,6,558,206296.60000000003,220.0,93.0,5,576,256379.25,304.0,115.2
32001.0,6,14,4740,7,653,4244.833333333333,249.0,93.28571428571428,7,4087,4855.833333333333,1514.0,583.8571428571429
205776.0,17,2,180,1,90,0.0,90.0,90.0,1,90,0.0,90.0,90.0
90262475.0,6,12,1832,8,1016,12894639.285714284,188.0,127.0,4,816,30031907.33333333,204.0,204.0
120001757.0,6,21,1585,11,840,11999872.1,95.0,76.36363636363636,10,745,13332072.0,95.0,74.5
1302949.0,6,4,264,2,132,0.0,66.0,66.0,2,132,0.0,66.0,66.0
816.0,17,4,438,2,148,0.0,74.0,74.0,2,290,0.0,147.0,145.0
257788.00000000003,6,10,1221,6,636,51557.6,298.0,106.0,4,585,80176.0,379.0,146.25
297693.0,6,10,1221,6,636,59538.6,298.0,106.0,4,585,93792.0,379.0,146.25
106015.0,17,2,700,2,700,0.0,350.0,350.0,0,0,0.0,0.0,0.0
38784.0,6,10,2032,5,524,9408.75,252.0,104.8,5,1508,8116.0,1236.0,301.6
120001001.0,17,15,907,8,475,17143000.14285714,174.0,59.375,7,432,16668518.5,174.0,61.71428571428572
101137.0,6,14,4740,7,653,16749.0,249.0,93.28571428571428,7,4087,14487.333333333334,1514.0,583.8571428571429
146182.0,6,3,337,2,214,0.0,160.0,107.0,1,123,0.0,123.0,123.0
36361.0,6,10,2032,5,524,8778.5,252.0,104.8,5,1508,7906.0,1236.0,301.6
303698.0,6,6,412,4,272,101232.66666666669,74.0,68.0,2,140,0.0,74.0,70.0
162416.0,6,11,1132,6,556,32483.2,218.0,92.66666666666669,5,576,39773.25,304.0,115.2
120261073.0,6,238,26942,119,8162,1012177.5677966102,140.0,68.58823529411765,119,18780,1012296.1694915254,300.0,157.81512605042016
2545.0,17,4,344,2,150,0.0,75.0,75.0,2,194,0.0,103.0,97.0
194343.0,17,2,180,1,90,0.0,90.0,90.0,1,90,0.0,90.0,90.0
116631910.0,6,35,2542,18,1348,6860700.588235294,139.0,74.88888888888889,17,1194,7275976.75,123.0,70.23529411764706
792.0,17,4,438,2,148,0.0,74.0,74.0,2,290,0.0,147.0,145.0
510833.0,6,5,336,2,134,0.0,68.0,67.0,3,202,194353.5,70.0,67.33333333333333
135135943.0,17,6,1206,6,1206,27027188.6,201.0,201.0,0,0,0.0,0.0,0.0
105071412.0,6,44,2904,22,1452,5003400.571428572,66.0,66.0,22,1452,4993118.095238095,66.0,66.0
153413.0,17,2,180,1,90,0.0,90.0,90.0,1,90,0.0,90.0,90.0
103367.0,17,2,286,2,286,0.0,143.0,143.0,0,0,0.0,0.0,0.0
205894.0,17,2,180,1,90,0.0,90.0,90.0,1,90,0.0,90.0,90.0
121743.0,6,3,337,2,214,0.0,160.0,107.0,1,123,0.0,123.0,123.0
9020345.0,17,4,1812,4,1812,3006781.6666666665,453.0,453.0,0,0,0.0,0.0,0.0
302431.0,6,2,132,1,66,0.0,66.0,66.0,1,66,0.0,66.0,66.0
249421.0,6,3,337,2,214,0.0,160.0,107.0,1,123,0.0,123.0,123.0
213671.0,17,2,180,1,90,0.0,90.0,90.0,1,90,0.0,90.0,90.0
106075.0,17,2,286,2,286,0.0,143.0,143.0,0,0,0.0,0.0,0.0
91086275.0,6,21,1585,10,786,10096791.111111112,95.0,78.6,11,799,9087104.0,95.0,72.63636363636364
17676.0,17,4,820,2,156,0.0,78.0,78.0,2,664,0.0,332.0,332.0
152265.0,17,4,6056,4,6056,50755.0,1514.0,1514.0,0,0,0.0,0.0,0.0
108106180.0,17,5,1005,5,1005,27026545.0,201.0,201.0,0,0,0.0,0.0,0.0
119799987.0,6,23,1734,12,894,10890907.909090908,95.0,74.5,11,840,11954557.9,95.0,76.36363636363636
103618.0,17,2,286,2,286,0.0,143.0,143.0,0,0,0.0,0.0,0.0
16706924.0,6,5,1909,2,892,0.0,826.0,446.0,3,1017,7056403.5,885.0,339.0
146264.0,6,3,337,2,214,0.0,160.0,107.0,1,123,0.0,123.0,123.0
102516.0,17,2,286,2,286,0.0,143.0,143.0,0,0,0.0,0.0,0.0
298943.0,6,6,412,4,272,99647.66666666669,74.0,68.0,2,140,0.0,74.0,70.0
107795.0,17,2,286,2,286,0.0,143.0,143.0,0,0,0.0,0.0,0.0
2507.0,17,4,344,2,150,0.0,75.0,75.0,2,194,0.0,103.0,97.0
1309046.0,17,5,961,3,234,654290.5,78.0,78.0,2,727,0.0,395.0,363.5
148780.0,17,2,414,1,88,0.0,88.0,88.0,1,326,0.0,326.0,326.0
850802.0,6,9,1196,6,725,170160.4,387.0,120.83333333333331,3,471,289106.0,331.0,157.0
135122468.0,17,6,1206,6,1206,27024493.6,201.0,201.0,0,0,0.0,0.0,0.0
90043194.0,17,28,13364,28,13364,3334933.111111111,501.0,477.2857142857143,0,0,0.0,0.0,0.0
918.0,17,4,438,2,148,0.0,74.0,74.0,2,290,0.0,147.0,145.0
322.0,17,2,174,1,79,0.0,79.0,79.0,1,95,0.0,95.0,95.0
2861556.0,6,3,1604,1,753,0.0,753.0,753.0,2,851,0.0,785.0,425.5
56020.0,6,14,4740,7,653,6048.333333333333,249.0,93.28571428571428,7,4087,8904.333333333334,1514.0,583.8571428571429
307869.0,6,6,412,4,272,102623.0,74.0,68.0,2,140,0.0,74.0,70.0
115904494.0,6,30,1974,15,1026,8263486.071428572,123.0,68.4,15,948,8263486.428571428,123.0,63.2
2017.0,17,4,344,2,150,0.0,75.0,75.0,2,194,0.0,103.0,97.0
107958.0,17,2,286,2,286,0.0,143.0,143.0,0,0,0.0,0.0,0.0
80.0,17,2,762,2,762,0.0,381.0,381.0,0,0,0.0,0.0,0.0
102001115.0,17,13,821,7,432,17000185.833333332,174.0,61.71428571428572,6,389,16401250.8,174.0,64.83333333333333
27684.0,6,13,1386,7,789,4533.833333333333,253.0,112.71428571428572,6,597,4359.6,259.0,99.5
138120.0,6,2,132,1,66,0.0,66.0,66.0,1,66,0.0,66.0,66.0
299600.0,6,6,412,4,272,99866.66666666669,74.0,68.0,2,140,0.0,74.0,70.0
90385819.0,6,15,2460,8,1632,12910749.57142857,204.0,204.0,7,828,15016048.833333334,188.0,118.28571428571428
96419250.0,17,14,1126,7,563,16000132.666666666,174.0,80.42857142857143,7,563,16001234.166666666,174.0,80.42857142857143
257926.0,6,3,337,2,214,0.0,160.0,107.0,1,123,0.0,123.0,123.0
512114.0,6,5,336,2,134,0.0,68.0,67.0,3,202,192333.0,70.0,67.33333333333333
1174675.0,6,13,3007,8,2379,167810.7142857143,1514.0,297.375,5,628,224705.25,331.0,125.6
313358.0,17,4,1400,4,1400,104452.66666666669,350.0,350.0,0,0,0.0,0.0,0.0
113378809.0,6,30,1974,15,1026,8083072.714285715,123.0,68.4,15,948,8082918.5,123.0,63.2
90035056.0,17,28,13364,28,13364,3334631.703703704,501.0,477.2857142857143,0,0,0.0,0.0,0.0
245012.0,6,3,337,2,214,0.0,160.0,107.0,1,123,0.0,123.0,123.0
108108577.0,17,5,1005,5,1005,27027144.25,201.0,201.0,0,0,0.0,0.0,0.0
30010.0,6,14,4740,7,653,4570.333333333333,249.0,93.28571428571428,7,4087,4768.5,1514.0,583.8571428571429
144058.0,17,2,180,1,90,0.0,90.0,90.0,1,90,0.0,90.0,90.0
509979.0,6,6,758,3,410,218136.5,172.0,136.66666666666666,3,348,182730.0,135.0,116.0
19885.0,17,2,582,1,83,0.0,83.0,83.0,1,499,0.0,499.0,499.0
18908.0,6,14,4740,7,653,2744.833333333333,249.0,93.28571428571428,7,4087,3019.1666666666665,1514.0,583.8571428571429
96054601.0,6,39,2574,20,1320,5041167.947368421,66.0,66.0,19,1254,5135440.944444444,66.0,66.0
31675.0,6,14,4740,7,653,5168.5,249.0,93.28571428571428,7,4087,4917.333333333333,1514.0,583.8571428571429
5004789.0,17,4,849,2,166,0.0,83.0,83.0,2,683,0.0,499.0,341.5
48560.0,6,14,4740,7,653,7968.166666666667,249.0,93.28571428571428,7,4087,7665.5,1514.0,583.8571428571429
2075.0,17,4,344,2,150,0.0,75.0,75.0,2,194,0.0,103.0,97.0
66230.0,17,2,180,1,90,0.0,90.0,90.0,1,90,0.0,90.0,90.0
30534.0,6,10,2032,5,524,7405.0,252.0,104.8,5,1508,7391.25,1236.0,301.6
197952.0,17,4,6056,4,6056,65984.0,1514.0,1514.0,0,0,0.0,0.0,0.0
323924.0,17,4,1400,4,1400,107974.66666666669,350.0,350.0,0,0,0.0,0.0,0.0
316070.0,17,6,2100,6,2100,63214.0,350.0,350.0,0,0,0.0,0.0,0.0
111335823.0,6,34,2604,18,1395,6536467.882352941,123.0,77.5,16,1209,7407637.933333334,123.0,75.5625
314488.0,6,3,202,2,128,0.0,74.0,64.0,1,74,0.0,74.0,74.0
115476901.0,6,36,2596,18,1348,6780069.117647059,139.0,74.88888888888889,18,1248,6780072.0,123.0,69.33333333333333
113590661.0,6,48,3168,24,1584,4938724.391304348,66.0,66.0,24,1584,4926589.521739131,66.0,66.0
122687972.0,6,49,3234,25,1650,5111998.833333333,66.0,66.0,24,1584,5003862.130434782,66.0,66.0
331275.0,6,6,412,4,272,110425.0,74.0,68.0,2,140,0.0,74.0,70.0
23137.0,6,14,4740,7,653,3624.5,249.0,93.28571428571428,7,4087,3705.3333333333335,1514.0,583.8571428571429
1189936.0,6,13,3015,8,2387,169990.85714285713,1514.0,298.375,5,628,228660.25,331.0,125.6
39689.0,6,14,4740,7,653,5728.666666666667,249.0,93.28571428571428,7,4087,5853.166666666667,1514.0,583.8571428571429
146185.0,6,3,337,2,214,0.0,160.0,107.0,1,123,0.0,123.0,123.0
171620.0,17,2,180,1,90,0.0,90.0,90.0,1,90,0.0,90.0,90.0
1176386.0,6,13,3010,8,2382,168055.14285714287,1514.0,297.75,5,628,225253.25,331.0,125.6
39920.0,6,10,2032,5,524,9356.5,252.0,104.8,5,1508,8741.25,1236.0,301.6
9886.0,17,2,582,1,83,0.0,83.0,83.0,1,499,0.0,499.0,499.0
323887.0,6,6,412,4,272,107962.33333333331,74.0,68.0,2,140,0.0,74.0,70.0
323.0,17,2,208,1,72,0.0,72.0,72.0,1,136,0.0,136.0,136.0
0.0,6,1,66,1,66,0.0,66.0,66.0,0,0,0.0,0.0,0.0
219671.0,6,3,426,2,280,0.0,214.0,140.0,1,146,0.0,146.0,146.0
30972.0,6,14,4740,7,653,5035.166666666667,249.0,93.28571428571428,7,4087,5024.0,1514.0,583.8571428571429
126238632.0,6,31,2034,16,1086,8415908.8,123.0,67.875,15,948,8288359.285714285,123.0,63.2
356674.0,17,2,582,1,83,0.0,83.0,83.0,1,499,0.0,499.0,499.0
108098764.0,17,5,1005,5,1005,27024691.0,201.0,201.0,0,0,0.0,0.0,0.0
24910.0,6,14,4740,7,653,3843.1666666666665,249.0,93.28571428571428,7,4087,3869.8333333333335,1514.0,583.8571428571429
90032872.0,17,28,13364,28,13364,3334550.814814815,501.0,477.2857142857143,0,0,0.0,0.0,0.0
217793.0,6,3,426,2,280,0.0,214.0,140.0,1,146,0.0,146.0,146.0
2862204.0,6,5,336,2,134,0.0,68.0,67.0,3,202,158015.0,70.0,67.33333333333333
6212.0,17,2,762,2,762,0.0,381.0,381.0,0,0,0.0,0.0,0.0
743244.0,6,11,1287,6,636,148648.8,298.0,106.0,5,651,185220.25,379.0,130.2
149028.0,17,2,414,1,88,0.0,88.0,88.0,1,326,0.0,326.0,326.0
297901.0,6,6,412,4,272,99300.33333333331,74.0,68.0,2,140,0.0,74.0,70.0
90021213.0,17,27,12943,27,12943,3462354.346153846,501.0,479.3703703703704,0,0,0.0,0.0,0.0
100588247.0,6,29,2068,15,1105,7169462.785714285,139.0,73.66666666666667,14,963,7720959.538461538,123.0,68.78571428571429
108110843.0,17,5,955,5,955,27027710.75,191.0,191.0,0,0,0.0,0.0,0.0
282600.0,17,2,180,1,90,0.0,90.0,90.0,1,90,0.0,90.0,90.0
116574733.0,6,259,30698,130,21962,902000.2790697674,464.0,168.93846153846152,129,8736,908712.640625,140.0,67.72093023255815
140894.0,6,2,132,1,66,0.0,66.0,66.0,1,66,0.0,66.0,66.0
55739.0,6,14,4740,7,653,9164.166666666666,249.0,93.28571428571428,7,4087,8686.333333333334,1514.0,583.8571428571429
100052637.0,17,12,778,6,389,19801023.8,174.0,64.83333333333333,6,389,20000158.2,174.0,64.83333333333333
263932.0,6,10,1221,6,636,52786.4,298.0,106.0,4,585,82231.33333333333,379.0,146.25
313017.0,6,3,202,2,128,0.0,74.0,64.0,1,74,0.0,74.0,74.0
5629451.0,6,5,336,2,134,0.0,68.0,67.0,3,202,1425134.5,70.0,67.33333333333333
135116819.0,17,6,1146,6,1146,27023363.8,191.0,191.0,0,0,0.0,0.0,0.0
205583.0,17,2,762,2,762,0.0,381.0,381.0,0,0,0.0,0.0,0.0
2411.0,17,4,344,2,150,0.0,75.0,75.0,2,194,0.0,103.0,97.0
2123844.0,6,18,6803,10,1501,235982.66666666663,408.0,150.1,8,5302,241157.4285714285,1514.0,662.75
125829487.0,6,60,12377,30,6489,3314497.413793104,1514.0,216.3,30,5888,4331506.275862069,1514.0,196.26666666666668
10485122.0,6,7,478,4,272,3449526.6666666665,74.0,68.0,3,206,5174147.0,74.0,68.66666666666667
2813312.0,6,2,132,1,66,0.0,66.0,66.0,1,66,0.0,66.0,66.0
120127957.0,6,14,2224,9,1204,15015994.625,188.0,133.77777777777777,5,1020,22524298.75,204.0,204.0
3009721.0,6,11,2106,6,598,601126.2,252.0,99.66666666666669,5,1508,2484.5,1236.0,301.6
124001216.0,17,15,1169,8,606,17714459.42857143,174.0,75.75,7,563,17335001.333333332,174.0,80.42857142857143
24928.0,6,14,4740,7,653,3977.6666666666665,249.0,93.28571428571428,7,4087,4019.1666666666665,1514.0,583.8571428571429
209631.0,17,2,414,1,88,0.0,88.0,88.0,1,326,0.0,326.0,326.0
108103021.0,17,5,1005,5,1005,27025755.25,201.0,201.0,0,0,0.0,0.0,0.0
119790281.0,6,23,1693,12,894,10890025.545454543,95.0,74.5,11,799,11953507.2,95.0,72.63636363636364
0.0,17,1,381,1,381,0.0,381.0,381.0,0,0,0.0,0.0,0.0
24479.0,6,11,2098,6,590,3939.2,252.0,98.33333333333331,5,1508,5764.0,1236.0,301.6
135133944.0,17,6,1206,6,1206,27026788.8,201.0,201.0,0,0,0.0,0.0,0.0
298980.0,6,6,412,4,272,99660.0,74.0,68.0,2,140,0.0,74.0,70.0
3594.0,17,2,414,1,88,0.0,88.0,88.0,1,326,0.0,326.0,326.0
321276.0,6,6,412,4,272,107092.0,74.0,68.0,2,140,0.0,74.0,70.0
906.0,17,4,438,2,148,0.0,74.0,74.0,2,290,0.0,147.0,145.0
204841.0,17,2,762,2,762,0.0,381.0,381.0,0,0,0.0,0.0,0.0
623265.0,17,2,346,1,78,0.0,78.0,78.0,1,268,0.0,268.0,268.0
27903486.0,17,5,1710,5,1710,6975871.5,342.0,342.0,0,0,0.0,0.0,0.0
122014.0,17,2,762,2,762,0.0,381.0,381.0,0,0,0.0,0.0,0.0
135134167.0,17,6,1206,6,1206,27026833.4,201.0,201.0,0,0,0.0,0.0,0.0
46297.0,6,14,4740,7,653,7592.0,249.0,93.28571428571428,7,4087,7280.666666666667,1514.0,583.8571428571429
90018088.0,17,28,13364,28,13364,3334003.25925926,501.0,477.2857142857143,0,0,0.0,0.0,0.0
178158.0,17,2,180,1,90,0.0,90.0,90.0,1,90,0.0,90.0,90.0
51728514.0,6,8,2113,3,960,24538727.0,826.0,320.0,5,1153,12237008.5,885.0,230.6
2800671.0,6,2,132,1,66,0.0,66.0,66.0,1,66,0.0,66.0,66.0
15057804.0,17,6,2718,6,2718,3011560.8,453.0,453.0,0,0,0.0,0.0,0.0
106336.0,6,11,1132,6,556,21093.0,218.0,92.66666666666669,5,576,26198.5,304.0,115.2
4201.0,17,2,598,1,72,0.0,72.0,72.0,1,526,0.0,526.0,526.0
102038037.0,17,14,864,7,432,17000172.833333332,174.0,61.71428571428572,7,432,17001588.166666668,174.0,61.71428571428572
271664.0,6,10,1221,6,636,54332.8,298.0,106.0,4,585,83633.66666666667,379.0,146.25
5010533.0,17,4,849,2,166,0.0,83.0,83.0,2,683,0.0,499.0,341.5
28430.0,6,14,4740,7,653,4617.166666666667,249.0,93.28571428571428,7,4087,4595.166666666667,1514.0,583.8571428571429
142378.0,6,2,132,1,66,0.0,66.0,66.0,1,66,0.0,66.0,66.0
238895.0,17,2,180,1,90,0.0,90.0,90.0,1,90,0.0,90.0,90.0
17530.0,6,2,145,2,145,0.0,91.0,72.5,0,0,0.0,0.0,0.0
100201371.0,17,12,778,6,389,19972044.4,174.0,64.83333333333333,6,389,20008488.0,174.0,64.83333333333333
90210278.0,6,16,1192,8,596,12852503.142857144,95.0,74.5,8,596,12857947.285714284,95.0,74.5
310823.0,6,3,202,2,128,0.0,74.0,64.0,1,74,0.0,74.0,74.0
144059.0,17,2,180,1,90,0.0,90.0,90.0,1,90,0.0,90.0,90.0
6274.0,17,4,344,2,150,0.0,75.0,75.0,2,194,0.0,103.0,97.0
324.0,17,2,166,1,75,0.0,75.0,75.0,1,91,0.0,91.0,91.0
217943.0,6,3,426,2,280,0.0,214.0,140.0,1,146,0.0,146.0,146.0
14996.0,17,2,180,1,90,0.0,90.0,90.0,1,90,0.0,90.0,90.0
266485.0,6,10,1221,6,636,53297.0,298.0,106.0,4,585,79032.33333333333,379.0,146.25
155856.0,6,14,4740,7,653,17801.666666666668,249.0,93.28571428571428,7,4087,25639.0,1514.0,583.8571428571429
106003950.0,6,28,1860,14,966,8137515.076923077,123.0,69.0,14,894,8137518.615384615,123.0,63.85714285714285
96552130.0,6,26,1746,13,906,8028009.0,123.0,69.6923076923077,13,840,8027977.166666667,123.0,64.61538461538461
312193.0,6,3,202,2,128,0.0,74.0,64.0,1,74,0.0,74.0,74.0
90029394.0,17,28,13364,28,13364,3334422.0,501.0,477.2857142857143,0,0,0.0,0.0,0.0
104204.0,17,2,286,2,286,0.0,143.0,143.0,0,0,0.0,0.0,0.0
2441.0,17,4,344,2,150,0.0,75.0,75.0,2,194,0.0,103.0,97.0
93283083.0,17,11,735,6,389,18656616.6,174.0,64.83333333333333,5,346,18420097.5,174.0,69.2
102490.0,17,2,286,2,286,0.0,143.0,143.0,0,0,0.0,0.0,0.0
90258888.0,6,12,1832,8,1016,12894126.857142856,188.0,127.0,4,816,30032148.0,204.0,204.0
10464753.0,6,7,478,4,272,3442775.6666666665,74.0,68.0,3,206,5164050.5,74.0,68.66666666666667
0.0,17,1,381,1,381,0.0,381.0,381.0,0,0,0.0,0.0,0.0
283972.0,17,2,363,1,79,0.0,79.0,79.0,1,284,0.0,284.0,284.0
24758.0,6,14,4740,7,653,4010.8333333333335,249.0,93.28571428571428,7,4087,3987.0,1514.0,583.8571428571429
116352291.0,6,231,26166,116,7952,1011759.052173913,140.0,68.55172413793103,115,18214,1011443.0438596492,300.0,158.38260869565218
43870.0,6,14,4740,7,653,7146.833333333333,249.0,93.28571428571428,7,4087,7012.833333333333,1514.0,583.8571428571429
25060.0,6,14,4740,7,653,3406.1666666666665,249.0,93.28571428571428,7,4087,3858.1666666666665,1514.0,583.8571428571429
122009422.0,17,15,907,8,475,17429917.42857143,174.0,59.375,7,432,17000210.333333332,174.0,61.71428571428572
145588.0,17,2,180,1,70,0.0,70.0,70.0,1,110,0.0,110.0,110.0
110815813.0,6,30,2122,15,1017,7915415.214285715,123.0,67.8,15,1105,7186723.214285715,139.0,73.66666666666667
128650361.0,6,34,2356,18,1285,7567668.294117647,139.0,71.38888888888889,16,1071,7896501.4,123.0,66.9375
144859.0,17,2,180,1,70,0.0,70.0,70.0,1,110,0.0,110.0,110.0
228269.0,17,2,180,1,90,0.0,90.0,90.0,1,90,0.0,90.0,90.0
1400025.0,17,7,490,7,490,233337.5,70.0,70.0,0,0,0.0,0.0,0.0
120024883.0,17,28,13364,28,13364,4445366.037037037,501.0,477.2857142857143,0,0,0.0,0.0,0.0
19717.0,6,14,4740,7,653,3177.5,249.0,93.28571428571428,7,4087,2881.6666666666665,1514.0,583.8571428571429
10466163.0,6,7,478,4,272,3443387.0,74.0,68.0,3,206,5164959.5,74.0,68.66666666666667
20024.0,17,2,582,1,83,0.0,83.0,83.0,1,499,0.0,499.0,499.0
120216162.0,6,27,2073,12,935,10906176.454545457,95.0,77.91666666666667,15,1138,8569284.642857144,95.0,75.86666666666666
39854236.0,6,5,336,2,134,0.0,68.0,67.0,3,202,19856947.5,70.0,67.33333333333333
232363.0,6,13,1394,7,797,38727.16666666666,253.0,113.85714285714286,6,597,44708.4,259.0,99.5
130832.0,6,2,132,1,66,0.0,66.0,66.0,1,66,0.0,66.0,66.0
234555.0,6,3,337,2,214,0.0,160.0,107.0,1,123,0.0,123.0,123.0
54874.0,6,14,4740,7,653,8929.333333333334,249.0,93.28571428571428,7,4087,5752.333333333333,1514.0,583.8571428571429
2356.0,17,4,344,2,150,0.0,75.0,75.0,2,194,0.0,103.0,97.0
135134347.0,17,6,1146,6,1146,27026869.4,191.0,191.0,0,0,0.0,0.0,0.0
120535724.0,6,27,2995,14,1546,9271978.76923077,427.0,110.42857142857144,13,1449,8135960.166666667,336.0,111.46153846153848
16993.0,6,10,2032,5,524,4018.25,252.0,104.8,5,1508,3568.0,1236.0,301.6
25579.0,6,14,4740,7,653,3151.0,249.0,93.28571428571428,7,4087,4122.333333333333,1514.0,583.8571428571429
102739.0,17,2,286,2,286,0.0,143.0,143.0,0,0,0.0,0.0,0.0
135130297.0,17,6,1146,6,1146,27026059.4,191.0,191.0,0,0,0.0,0.0,0.0
216841.0,6,3,426,2,280,0.0,214.0,140.0,1,146,0.0,146.0,146.0
320326.0,6,6,412,4,272,106775.33333333331,74.0,68.0,2,140,0.0,74.0,70.0
9389.0,17,2,539,1,86,0.0,86.0,86.0,1,453,0.0,453.0,453.0
12770.0,6,10,1065,5,534,2968.25,262.0,106.8,5,531,2250.0,259.0,106.2
297885.0,6,6,412,4,272,99295.0,74.0,68.0,2,140,0.0,74.0,70.0
30839.0,6,14,4740,7,653,4604.5,249.0,93.28571428571428,7,4087,4907.5,1514.0,583.8571428571429
90758878.0,6,19,1436,10,745,10079490.0,95.0,74.5,9,691,11343568.5,95.0,76.77777777777777
120433348.0,6,221,25056,111,17574,1094848.6181818182,284.0,158.32432432432432,110,7482,1095511.0917431193,140.0,68.01818181818182
40529.0,6,14,4740,7,653,6584.333333333333,249.0,93.28571428571428,7,4087,6534.333333333333,1514.0,583.8571428571429
27224.0,6,14,4740,7,653,3642.0,249.0,93.28571428571428,7,4087,4359.833333333333,1514.0,583.8571428571429
307949.0,6,6,412,4,272,102649.66666666669,74.0,68.0,2,140,0.0,74.0,70.0
205834.0,17,2,180,1,90,0.0,90.0,90.0,1,90,0.0,90.0,90.0
0.0,17,1,350,1,350,0.0,350.0,350.0,0,0,0.0,0.0,0.0
122014.0,6,3,373,2,238,0.0,172.0,119.0,1,135,0.0,135.0,135.0
909101.0,6,10,1336,6,799,181820.2,461.0,133.16666666666666,4,537,212175.3333333333,331.0,134.25
24194.0,6,14,4740,7,653,3785.8333333333335,249.0,93.28571428571428,7,4087,3741.5,1514.0,583.8571428571429
90022328.0,17,28,13364,28,13364,3334160.296296296,501.0,477.2857142857143,0,0,0.0,0.0,0.0
215422.0,6,10,1221,6,636,43084.4,298.0,106.0,4,585,70596.0,379.0,146.25
9297.0,17,2,539,1,86,0.0,86.0,86.0,1,453,0.0,453.0,453.0
90076597.0,17,27,12943,27,12943,3464484.5,501.0,479.3703703703704,0,0,0.0,0.0,0.0
185558.0,17,2,180,1,90,0.0,90.0,90.0,1,90,0.0,90.0,90.0
348.0,17,2,160,1,80,0.0,80.0,80.0,1,80,0.0,80.0,80.0
311678.0,6,6,412,4,272,103892.66666666669,74.0,68.0,2,140,0.0,74.0,70.0
101372915.0,17,14,864,7,432,16833498.833333332,174.0,61.71428571428572,7,432,16835507.666666668,174.0,61.71428571428572
91511070.0,6,509,98834,251,17022,366044.28,214.0,67.81673306772909,258,81812,355218.7392996109,1514.0,317.1007751937984
48995.0,6,14,4740,7,653,7960.0,249.0,93.28571428571428,7,4087,7973.666666666667,1514.0,583.8571428571429
90252107.0,6,13,2036,8,1016,12893158.142857144,188.0,127.0,5,1020,22522538.5,204.0,204.0
161570.0,17,2,180,1,90,0.0,90.0,90.0,1,90,0.0,90.0,90.0
12767.0,6,12,1393,6,796,2352.6,271.0,132.66666666666666,6,597,2285.6,259.0,99.5
19546.0,6,10,2032,5,524,3641.0,252.0,104.8,5,1508,4632.75,1236.0,301.6
124298.0,6,11,1132,6,556,24577.0,218.0,92.66666666666669,5,576,29706.25,304.0,115.2
32257.0,6,10,2032,5,524,7833.25,252.0,104.8,5,1508,7835.0,1236.0,301.6
119330146.0,6,26,1937,14,1043,9179242.0,95.0,74.5,12,894,10801067.818181818,95.0,74.5
306021.0,6,3,202,2,128,0.0,74.0,64.0,1,74,0.0,74.0,74.0
120138602.0,6,362,43832,181,12242,657181.9444444445,140.0,67.6353591160221,181,31590,662816.8666666667,284.0,174.5303867403315
315.0,17,2,174,1,79,0.0,79.0,79.0,1,95,0.0,95.0,95.0
101461.0,6,2,132,1,66,0.0,66.0,66.0,1,66,0.0,66.0,66.0
221622.0,6,3,426,2,280,0.0,214.0,140.0,1,146,0.0,146.0,146.0
304935.0,17,6,2100,6,2100,60987.0,350.0,350.0,0,0,0.0,0.0,0.0
15350.0,6,10,2032,5,524,3618.5,252.0,104.8,5,1508,3444.25,1236.0,301.6
90622127.0,6,28,2008,14,1045,6970932.846153846,139.0,74.64285714285714,14,963,6954282.846153846,123.0,68.78571428571429
499384.0,6,5,336,2,134,0.0,68.0,67.0,3,202,193460.0,70.0,67.33333333333333
10101121.0,17,3,1034,2,684,0.0,342.0,342.0,1,350,0.0,350.0,350.0
438329.0,6,11,1021,6,444,58843.6,162.0,74.0,5,577,73400.75,349.0,115.4
818.0,17,4,438,2,148,0.0,74.0,74.0,2,290,0.0,147.0,145.0
10471224.0,6,7,478,4,272,3444770.0,74.0,68.0,3,206,5167015.5,74.0,68.66666666666667
1304017.0,17,7,490,7,490,217336.16666666663,70.0,70.0,0,0,0.0,0.0,0.0
142561.0,6,2,132,1,66,0.0,66.0,66.0,1,66,0.0,66.0,66.0
45309.0,6,14,4740,7,653,6614.5,249.0,93.28571428571428,7,4087,6727.333333333333,1514.0,583.8571428571429
123839613.0,6,48,3168,24,1584,4953550.739130435,66.0,66.0,24,1584,5343836.869565218,66.0,66.0
143927.0,17,2,180,1,90,0.0,90.0,90.0,1,90,0.0,90.0,90.0
29126.0,6,14,4740,7,653,3930.3333333333335,249.0,93.28571428571428,7,4087,4674.166666666667,1514.0,583.8571428571429
220376.0,17,2,414,1,88,0.0,88.0,88.0,1,326,0.0,326.0,326.0
4416437.0,6,26,5154,14,2630,339725.92307692306,580.0,187.8571428571429,12,2524,381426.6363636364,732.0,210.3333333333333
310666.0,17,4,1400,4,1400,103555.33333333331,350.0,350.0,0,0,0.0,0.0,0.0
2173838.0,6,25,7610,13,2516,181153.16666666663,1034.0,193.53846153846155,12,5094,168285.45454545456,1510.0,424.5
101405.0,17,2,286,2,286,0.0,143.0,143.0,0,0,0.0,0.0,0.0
196970.0,17,2,180,1,90,0.0,90.0,90.0,1,90,0.0,90.0,90.0
212533.0,17,2,180,1,90,0.0,90.0,90.0,1,90,0.0,90.0,90.0
3191657.0,6,18,1577,9,1003,358127.375,315.0,111.44444444444444,9,574,358201.625,78.0,63.77777777777778
25312.0,6,12,1320,6,723,4146.2,253.0,120.5,6,597,4423.0,259.0,99.5
140.0,17,2,146,2,146,0.0,73.0,73.0,0,0,0.0,0.0,0.0
2316.0,17,4,344,2,150,0.0,75.0,75.0,2,194,0.0,103.0,97.0
51729.0,6,14,4740,7,653,7917.166666666667,249.0,93.28571428571428,7,4087,7255.833333333333,1514.0,583.8571428571429
41331.0,6,14,4740,7,653,6764.666666666667,249.0,93.28571428571428,7,4087,6664.833333333333,1514.0,583.8571428571429
212893.0,17,2,180,1,90,0.0,90.0,90.0,1,90,0.0,90.0,90.0
1298861.0,6,4,264,2,132,0.0,66.0,66.0,2,132,0.0,66.0,66.0
235732.0,6,3,337,2,214,0.0,160.0,107.0,1,123,0.0,123.0,123.0
90086279.0,6,12,1848,5,1020,22521004.75,204.0,204.0,7,828,15013997.333333334,188.0,118.28571428571428
95582.0,17,2,286,2,286,0.0,143.0,143.0,0,0,0.0,0.0,0.0
17602.0,6,11,1132,6,556,3520.4,218.0,92.66666666666669,5,576,3603.25,304.0,115.2
2598474.0,6,2,132,1,66,0.0,66.0,66.0,1,66,0.0,66.0,66.0
2888280.0,6,12,2172,7,664,481099.0,252.0,94.85714285714286,5,1508,2139.5,1236.0,301.6
51855.0,6,10,2032,5,524,12752.0,252.0,104.8,5,1508,12417.5,1236.0,301.6
90030108.0,17,28,13364,28,13364,3334448.4444444445,501.0,477.2857142857143,0,0,0.0,0.0,0.0
108731465.0,6,32,2220,16,1149,7234364.666666667,123.0,71.8125,16,1071,7234364.333333333,123.0,66.9375
41525.0,6,10,2032,5,524,9898.5,252.0,104.8,5,1508,10087.5,1236.0,301.6
509716.0,6,5,336,2,134,0.0,68.0,67.0,3,202,195409.0,70.0,67.33333333333333
217545.0,6,3,426,2,280,0.0,214.0,140.0,1,146,0.0,146.0,146.0
6734.0,17,2,582,1,83,0.0,83.0,83.0,1,499,0.0,499.0,499.0
33723332.0,6,5,336,2,134,0.0,68.0,67.0,3,202,16789708.0,70.0,67.33333333333333
3174267.0,6,18,1495,9,921,358364.125,315.0,102.33333333333331,9,574,358340.5,78.0,63.77777777777778
137025.0,6,3,337,2,214,0.0,160.0,107.0,1,123,0.0,123.0,123.0
90020094.0,17,28,13364,28,13364,3334077.5555555555,501.0,477.2857142857143,0,0,0.0,0.0,0.0
300051.0,6,6,412,4,272,100017.0,74.0,68.0,2,140,0.0,74.0,70.0
108738538.0,6,33,2428,17,1288,6796158.625,139.0,75.76470588235294,16,1140,7234805.8,123.0,71.25
196882.0,17,2,180,1,90,0.0,90.0,90.0,1,90,0.0,90.0,90.0
165939.0,17,2,180,1,90,0.0,90.0,90.0,1,90,0.0,90.0,90.0
8434508.0,17,3,1034,2,684,0.0,342.0,342.0,1,350,0.0,350.0,350.0
119838411.0,6,20,1490,11,840,11978946.8,95.0,76.36363636363636,9,650,14978636.5,95.0,72.22222222222223
106996533.0,17,14,864,7,432,17806129.333333332,174.0,61.71428571428572,7,432,17829360.833333332,174.0,61.71428571428572
2090.0,17,4,344,2,150,0.0,75.0,75.0,2,194,0.0,103.0,97.0
144851.0,17,2,180,1,70,0.0,70.0,70.0,1,110,0.0,110.0,110.0
1311157.0,17,7,490,7,490,218526.16666666663,70.0,70.0,0,0,0.0,0.0,0.0
334.0,17,2,160,1,80,0.0,80.0,80.0,1,80,0.0,80.0,80.0
207464.0,6,3,426,2,280,0.0,214.0,140.0,1,146,0.0,146.0,146.0
2458392.0,6,3,1604,2,851,0.0,785.0,425.5,1,753,0.0,753.0,753.0
32448.0,6,14,4740,7,653,5195.833333333333,249.0,93.28571428571428,7,4087,5268.0,1514.0,583.8571428571429
122368269.0,6,259,30910,130,22100,948591.2325581396,336.0,170.0,129,8810,932572.484375,140.0,68.29457364341086
32672.0,6,14,4740,7,653,5243.833333333333,249.0,93.28571428571428,7,4087,5035.333333333333,1514.0,583.8571428571429
2043.0,17,4,344,2,150,0.0,75.0,75.0,2,194,0.0,103.0,97.0
115305133.0,6,48,3168,24,1584,5013266.652173913,66.0,66.0,24,1584,4999809.391304348,66.0,66.0
307212.0,6,6,412,4,272,102404.0,74.0,68.0,2,140,0.0,74.0,70.0
10868080.0,6,8,544,4,272,3577356.0,74.0,68.0,4,272,3577284.0,74.0,68.0
160304.0,6,2,128,1,74,0.0,74.0,74.0,1,54,0.0,54.0,54.0
705585.0,6,10,1221,6,636,141117.0,298.0,106.0,4,585,229841.3333333333,379.0,146.25
101568.0,17,2,286,2,286,0.0,143.0,143.0,0,0,0.0,0.0,0.0
250741.0,17,4,6056,4,6056,83580.33333333334,1514.0,1514.0,0,0,0.0,0.0,0.0
146240.0,6,3,337,2,214,0.0,160.0,107.0,1,123,0.0,123.0,123.0
25039168.0,6,139,31073,72,23842,352664.338028169,566.0,331.1388888888889,67,7231,375075.1515151515,898.0,107.92537313432835
302398.0,6,2,132,1,66,0.0,66.0,66.0,1,66,0.0,66.0,66.0
251876.0,6,3,337,2,214,0.0,160.0,107.0,1,123,0.0,123.0,123.0
120050599.0,17,29,13785,29,13785,4287521.392857143,501.0,475.3448275862069,0,0,0.0,0.0,0.0
46701.0,6,14,4740,7,653,7557.833333333333,249.0,93.28571428571428,7,4087,6893.166666666667,1514.0,583.8571428571429
124001082.0,17,15,907,8,475,17714440.285714287,174.0,59.375,7,432,17301191.833333332,174.0,61.71428571428572
104551746.0,6,28,1860,14,966,8025838.0,123.0,69.0,14,894,8025837.692307692,123.0,63.85714285714285
629.0,17,2,762,2,762,0.0,381.0,381.0,0,0,0.0,0.0,0.0
113254826.0,6,46,3036,23,1518,5135437.590909091,66.0,66.0,23,1518,5135430.181818182,66.0,66.0
124584933.0,6,34,2350,17,1125,7162482.25,123.0,66.17647058823529,17,1225,7162470.75,139.0,72.05882352941177
146220.0,6,3,337,2,214,0.0,160.0,107.0,1,123,0.0,123.0,123.0
439019.0,6,11,1021,6,444,58991.8,162.0,74.0,5,577,73657.25,349.0,115.4
90055617.0,17,28,13364,28,13364,3335393.222222222,501.0,477.2857142857143,0,0,0.0,0.0,0.0
90237201.0,6,21,1585,10,745,9998296.444444444,95.0,74.5,11,840,9002193.2,95.0,76.36363636363636
10520686.0,6,6,412,3,206,5189926.5,74.0,68.66666666666667,3,206,5189887.0,74.0,68.66666666666667
1302376.0,6,4,264,2,132,0.0,66.0,66.0,2,132,0.0,66.0,66.0
1480062.0,17,16,1120,16,1120,98670.8,70.0,70.0,0,0,0.0,0.0,0.0
16944.0,17,2,180,1,90,0.0,90.0,90.0,1,90,0.0,90.0,90.0
14362.0,6,13,1459,7,862,2309.1666666666665,271.0,123.14285714285714,6,597,2513.0,259.0,99.5
2468.0,17,4,344,2,150,0.0,75.0,75.0,2,194,0.0,103.0,97.0
300083.0,6,6,412,4,272,100027.66666666669,74.0,68.0,2,140,0.0,74.0,70.0
34320.0,6,14,4740,7,653,5590.0,249.0,93.28571428571428,7,4087,5539.5,1514.0,583.8571428571429
153637.0,17,2,180,1,90,0.0,90.0,90.0,1,90,0.0,90.0,90.0
152873.0,17,2,414,1,88,0.0,88.0,88.0,1,326,0.0,326.0,326.0
135128506.0,17,8,1758,6,1146,27025701.2,191.0,191.0,2,612,0.0,306.0,306.0
123578942.0,6,32,2236,16,1071,7572948.466666667,123.0,66.9375,16,1165,7572924.8,139.0,72.8125
94079424.0,6,192,22056,96,15498,988043.9368421052,300.0,161.4375,96,6558,988031.7789473684,140.0,68.3125
291013.0,6,10,1221,6,636,58202.6,298.0,106.0,4,585,86878.0,379.0,146.25
306422.0,17,4,571,2,148,0.0,74.0,74.0,2,423,0.0,280.0,211.5
17980.0,6,10,2032,5,524,4077.75,252.0,104.8,5,1508,4155.25,1236.0,301.6
135133039.0,17,6,1146,6,1146,27026607.8,191.0,191.0,0,0,0.0,0.0,0.0
505307.0,6,5,367,2,132,0.0,66.0,66.0,3,235,252653.50000000003,103.0,78.33333333333333
852823.0,6,9,1096,6,625,170564.6,287.0,104.16666666666669,3,471,290108.5,331.0,157.0
10452105.0,6,7,478,4,272,3438560.333333333,74.0,68.0,3,206,5157749.0,74.0,68.66666666666667
90765800.0,6,19,1436,10,745,10079910.222222222,95.0,74.5,9,691,11344718.75,95.0,76.77777777777777
1466.0,17,2,762,2,762,0.0,381.0,381.0,0,0,0.0,0.0,0.0
17743.0,17,2,180,1,90,0.0,90.0,90.0,1,90,0.0,90.0,90.0
350.0,17,2,214,1,75,0.0,75.0,75.0,1,139,0.0,139.0,139.0
39241.0,6,10,1065,5,534,8855.25,262.0,106.8,5,531,6986.75,259.0,106.2
212695.0,6,10,1221,6,636,42539.0,298.0,106.0,4,585,69728.33333333333,379.0,146.25
3365635.0,6,149,141318,102,133914,33323.11881188119,1510.0,1312.8823529411766,47,7404,66551.58695652174,1510.0,157.53191489361703
2367.0,17,4,344,2,150,0.0,75.0,75.0,2,194,0.0,103.0,97.0
37121.0,6,14,4740,7,653,5848.5,249.0,93.28571428571428,7,4087,5956.333333333333,1514.0,583.8571428571429
8963060.0,17,3,1034,2,684,0.0,342.0,342.0,1,350,0.0,350.0,350.0
196979.0,17,2,180,1,90,0.0,90.0,90.0,1,90,0.0,90.0,90.0
122008923.0,17,15,907,8,475,17429846.14285714,174.0,59.375,7,432,17000158.5,174.0,61.71428571428572
38185.0,6,14,4740,7,653,6242.166666666667,249.0,93.28571428571428,7,4087,6005.0,1514.0,583.8571428571429
1879.0,17,4,344,2,150,0.0,75.0,75.0,2,194,0.0,103.0,97.0
135129948.0,17,6,1206,6,1206,27025989.6,201.0,201.0,0,0,0.0,0.0,0.0
103424.0,17,2,286,2,286,0.0,143.0,143.0,0,0,0.0,0.0,0.0
64859.0,17,4,820,2,156,0.0,78.0,78.0,2,664,0.0,332.0,332.0
5006157.0,17,4,629,2,156,0.0,78.0,78.0,2,473,0.0,268.0,236.5
310143.0,17,4,1400,4,1400,103381.0,350.0,350.0,0,0,0.0,0.0,0.0
1320040.0,17,7,490,7,490,220006.66666666663,70.0,70.0,0,0,0.0,0.0,0.0
31009.0,6,10,2032,5,524,6880.0,252.0,104.8,5,1508,6637.0,1236.0,301.6
205818.0,17,2,180,1,90,0.0,90.0,90.0,1,90,0.0,90.0,90.0
2387.0,17,2,762,2,762,0.0,381.0,381.0,0,0,0.0,0.0,0.0
1399983.0,17,7,490,7,490,233330.5,70.0,70.0,0,0,0.0,0.0,0.0
37093.0,6,14,4740,7,653,5942.166666666667,249.0,93.28571428571428,7,4087,5984.666666666667,1514.0,583.8571428571429
312388.0,6,6,412,4,272,104129.33333333331,74.0,68.0,2,140,0.0,74.0,70.0
135130441.0,17,6,1146,6,1146,27026088.2,191.0,191.0,0,0,0.0,0.0,0.0
347.0,17,2,160,1,80,0.0,80.0,80.0,1,80,0.0,80.0,80.0
71762.0,6,14,4740,7,653,11702.333333333334,249.0,93.28571428571428,7,4087,11712.666666666666,1514.0,583.8571428571429
38547.0,6,14,4740,7,653,6301.833333333333,249.0,93.28571428571428,7,4087,6285.666666666667,1514.0,583.8571428571429
7963671.0,6,4,1668,3,916,3981835.5,784.0,305.3333333333333,1,752,0.0,752.0,752.0
25496.0,6,14,4740,7,653,4123.666666666667,249.0,93.28571428571428,7,4087,4083.6666666666665,1514.0,583.8571428571429
68462.0,6,12,1328,6,731,13079.0,253.0,121.83333333333331,6,597,12406.6,259.0,99.5
116031227.0,17,14,864,7,432,19333529.83333333,174.0,61.71428571428572,7,432,19334549.83333333,174.0,61.71428571428572
1026331.0,6,11,1134,6,558,205266.2,220.0,93.0,5,576,255012.0,304.0,115.2
9078.0,17,2,571,1,86,0.0,86.0,86.0,1,485,0.0,485.0,485.0
34973.0,6,14,4740,7,653,5658.333333333333,249.0,93.28571428571428,7,4087,5693.0,1514.0,583.8571428571429
3005565.0,6,11,2106,6,598,600929.4,252.0,99.66666666666669,5,1508,1635.75,1236.0,301.6
55099.0,6,14,4740,7,653,8645.833333333334,249.0,93.28571428571428,7,4087,8924.833333333334,1514.0,583.8571428571429
31751.0,6,10,2032,5,524,7254.25,252.0,104.8,5,1508,7650.75,1236.0,301.6
119816876.0,17,35,16705,35,16705,3524025.7647058824,501.0,477.2857142857143,0,0,0.0,0.0,0.0
90041808.0,17,28,13364,28,13364,3334881.777777778,501.0,477.2857142857143,0,0,0.0,0.0,0.0
1234523.0,6,13,3000,8,2372,176360.42857142858,1514.0,296.5,5,628,240509.75,331.0,125.6
16842.0,17,2,180,1,90,0.0,90.0,90.0,1,90,0.0,90.0,90.0
305712.0,6,3,202,2,128,0.0,74.0,64.0,1,74,0.0,74.0,74.0
307916.0,6,6,412,4,272,102638.66666666669,74.0,68.0,2,140,0.0,74.0,70.0
508224.0,6,5,336,2,134,0.0,68.0,67.0,3,202,192702.0,70.0,67.33333333333333
2364.0,17,4,344,2,150,0.0,75.0,75.0,2,194,0.0,103.0,97.0
135137996.0,17,6,1146,6,1146,27027599.2,191.0,191.0,0,0,0.0,0.0,0.0
135137158.0,17,6,1146,6,1146,27027431.6,191.0,191.0,0,0,0.0,0.0,0.0
90528146.0,6,13,2036,8,1016,12932592.285714284,188.0,127.0,5,1020,22591062.0,204.0,204.0
312314.0,17,4,1400,4,1400,104104.66666666669,350.0,350.0,0,0,0.0,0.0,0.0
764.0,17,4,438,2,148,0.0,74.0,74.0,2,290,0.0,147.0,145.0
474940.0,6,3,1604,2,851,0.0,785.0,425.5,1,753,0.0,753.0,753.0
108101505.0,17,5,1005,5,1005,27025376.25,201.0,201.0,0,0,0.0,0.0,0.0
2024.0,17,4,344,2,150,0.0,75.0,75.0,2,194,0.0,103.0,97.0
108685671.0,6,32,2220,16,1149,7245711.4,123.0,71.8125,16,1071,7231998.4,123.0,66.9375
4385.0,17,2,614,1,72,0.0,72.0,72.0,1,542,0.0,542.0,542.0
209822.0,6,3,426,2,280,0.0,214.0,140.0,1,146,0.0,146.0,146.0
90259852.0,6,13,2036,8,1016,12894264.57142857,188.0,127.0,5,1020,22523819.75,204.0,204.0
45475.0,6,14,4740,7,653,6204.5,249.0,93.28571428571428,7,4087,7081.833333333333,1514.0,583.8571428571429
228173.0,17,2,180,1,90,0.0,90.0,90.0,1,90,0.0,90.0,90.0
237819.0,6,3,373,2,238,0.0,172.0,119.0,1,135,0.0,135.0,135.0
2154213.0,6,25,7611,13,2516,179517.75,1034.0,193.53846153846155,12,5095,168133.63636363635,1510.0,424.5833333333333
108089534.0,17,5,955,5,955,27022383.5,191.0,191.0,0,0,0.0,0.0,0.0
314.0,17,2,174,1,79,0.0,79.0,79.0,1,95,0.0,95.0,95.0
96889240.0,6,183,20604,92,6294,1064716.923076923,140.0,68.41304347826087,91,14310,1064983.3555555556,284.0,157.25274725274724
27200010.0,17,5,1710,5,1710,6800002.5,342.0,342.0,0,0,0.0,0.0,0.0
1471875.0,17,16,1120,16,1120,98125.0,70.0,70.0,0,0,0.0,0.0,0.0
40989.0,6,14,4740,7,653,6706.0,249.0,93.28571428571428,7,4087,6628.833333333333,1514.0,583.8571428571429
112241048.0,6,229,25928,115,7886,984570.596491228,140.0,68.57391304347826,114,18042,984213.3274336284,284.0,158.26315789473685
426.0,17,2,166,1,75,0.0,75.0,75.0,1,91,0.0,91.0,91.0
205878.0,6,4,492,2,280,0.0,214.0,140.0,2,212,0.0,146.0,106.0
883825.0,6,10,1262,6,725,176765.0,387.0,120.83333333333331,4,537,202734.66666666663,331.0,134.25
228189.0,17,2,180,1,90,0.0,90.0,90.0,1,90,0.0,90.0,90.0
16369.000000000002,6,11,2098,6,590,2884.0,252.0,98.33333333333331,5,1508,3764.75,1236.0,301.6
2372.0,17,4,344,2,150,0.0,75.0,75.0,2,194,0.0,103.0,97.0
120053656.0,17,28,13364,28,13364,4446431.703703703,501.0,477.2857142857143,0,0,0.0,0.0,0.0
120002886.0,6,18,1341,9,691,14999702.0,95.0,76.77777777777777,9,650,14999199.25,95.0,72.22222222222223
90043489.0,17,28,13364,28,13364,3334944.037037037,501.0,477.2857142857143,0,0,0.0,0.0,0.0
34426.0,6,14,4740,7,653,5216.166666666667,249.0,93.28571428571428,7,4087,5605.166666666667,1514.0,583.8571428571429
2855074.0,6,3,204,2,136,0.0,70.0,68.0,1,68,0.0,68.0,68.0
0.0,17,1,99,1,99,0.0,99.0,99.0,0,0,0.0,0.0,0.0
299051.0,6,6,412,4,272,99683.66666666669,74.0,68.0,2,140,0.0,74.0,70.0
231971.0,6,3,337,2,214,0.0,160.0,107.0,1,123,0.0,123.0,123.0
51007.0,17,2,180,1,90,0.0,90.0,90.0,1,90,0.0,90.0,90.0
2891735.0,6,12,2172,7,664,481785.8333333333,252.0,94.85714285714286,5,1508,2023.5,1236.0,301.6
90505509.0,17,12,778,6,389,18000174.2,174.0,64.83333333333333,6,389,18001465.2,174.0,64.83333333333333
101752425.0,6,218,25466,109,17976,942152.0833333334,352.0,164.91743119266056,109,7490,940079.2222222222,140.0,68.71559633027523
135137966.0,17,6,1206,6,1206,27027593.2,201.0,201.0,0,0,0.0,0.0,0.0
233140.0,6,3,337,2,214,0.0,160.0,107.0,1,123,0.0,123.0,123.0
100609.0,17,2,762,2,762,0.0,381.0,381.0,0,0,0.0,0.0,0.0
104804.0,17,2,286,2,286,0.0,143.0,143.0,0,0,0.0,0.0,0.0
90272300.0,6,12,1832,8,1016,12896042.857142856,188.0,127.0,4,816,30036230.33333333,204.0,204.0
103065753.0,17,14,864,7,432,17167576.666666668,174.0,61.71428571428572,7,432,17166841.833333332,174.0,61.71428571428572
135127633.0,17,6,1146,6,1146,27025526.6,191.0,191.0,0,0,0.0,0.0,0.0
1315555.0,6,4,264,2,132,0.0,66.0,66.0,2,132,0.0,66.0,66.0
16614.0,6,11,2098,6,590,3153.4,252.0,98.33333333333331,5,1508,3468.0,1236.0,301.6
505136.00000000006,6,4,270,2,134,0.0,68.0,67.0,2,136,0.0,70.0,68.0
2082.0,17,4,344,2,150,0.0,75.0,75.0,2,194,0.0,103.0,97.0
346.0,17,2,267,1,83,0.0,83.0,83.0,1,184,0.0,184.0,184.0
108118416.0,17,5,1005,5,1005,27029604.0,201.0,201.0,0,0,0.0,0.0,0.0
41373.0,6,14,4740,7,653,5587.833333333333,249.0,93.28571428571428,7,4087,5891.5,1514.0,583.8571428571429
90970592.0,6,21,1585,11,840,9096136.5,95.0,76.36363636363636,10,745,10106571.222222222,95.0,74.5
90027728.0,17,28,13364,28,13364,3334360.296296296,501.0,477.2857142857143,0,0,0.0,0.0,0.0
108108876.0,17,5,1005,5,1005,27027219.0,201.0,201.0,0,0,0.0,0.0,0.0
27045523.0,17,5,1718,4,1368,1817700.3333333333,342.0,342.0,1,350,0.0,350.0,350.0
316215.0,6,3,202,2,128,0.0,74.0,64.0,1,74,0.0,74.0,74.0
876112.0,6,9,1267,6,796,175222.4,458.0,132.66666666666666,3,471,300107.5,331.0,157.0
210109.0,17,2,180,1,90,0.0,90.0,90.0,1,90,0.0,90.0,90.0
90097301.0,6,13,2052,6,1224,18018653.0,204.0,204.0,7,828,14971238.0,188.0,118.28571428571428
3572228.0,6,5,336,2,134,0.0,68.0,67.0,3,202,1422783.5,70.0,67.33333333333333
110615016.0,6,205,23058,103,7106,1084460.9411764706,140.0,68.99029126213593,102,15952,1084841.3465346536,284.0,156.3921568627451
0.0,17,1,453,1,453,0.0,453.0,453.0,0,0,0.0,0.0,0.0
404.0,17,2,208,1,72,0.0,72.0,72.0,1,136,0.0,136.0,136.0
113004973.0,17,13,821,7,432,18834162.166666668,174.0,61.71428571428572,6,389,18600157.6,174.0,64.83333333333333
46359.0,6,14,4740,7,653,7552.833333333333,249.0,93.28571428571428,7,4087,7323.833333333333,1514.0,583.8571428571429
106261.0,17,2,700,2,700,0.0,350.0,350.0,0,0,0.0,0.0,0.0
10061.0,17,4,823,2,163,0.0,89.0,81.5,2,660,0.0,443.0,330.0
24087.0,6,14,4740,7,653,3633.3333333333335,249.0,93.28571428571428,7,4087,3863.3333333333335,1514.0,583.8571428571429
338510.0,17,4,1400,4,1400,112836.66666666669,350.0,350.0,0,0,0.0,0.0,0.0
299222.0,6,6,412,4,272,99740.66666666669,74.0,68.0,2,140,0.0,74.0,70.0
298691.0,6,6,412,4,272,99563.66666666669,74.0,68.0,2,140,0.0,74.0,70.0
165667.0,6,14,4740,7,653,21256.5,249.0,93.28571428571428,7,4087,27241.666666666668,1514.0,583.8571428571429
141842.0,17,2,176,1,80,0.0,80.0,80.0,1,96,0.0,96.0,96.0
309632.0,6,6,412,4,272,103210.66666666669,74.0,68.0,2,140,0.0,74.0,70.0
106915.0,17,2,286,2,286,0.0,143.0,143.0,0,0,0.0,0.0,0.0
1171997.0,6,13,3009,8,2381,167428.14285714287,1514.0,297.625,5,628,224116.0,331.0,125.6
52378.0,17,4,820,2,156,0.0,78.0,78.0,2,664,0.0,332.0,332.0
135118226.0,17,6,1146,6,1146,27023645.2,191.0,191.0,0,0,0.0,0.0,0.0
1316454.0,6,4,264,2,132,0.0,66.0,66.0,2,132,0.0,66.0,66.0
30979.0,6,2,145,2,145,0.0,91.0,72.5,0,0,0.0,0.0,0.0
120029382.0,17,28,13364,28,13364,4445532.666666667,501.0,477.2857142857143,0,0,0.0,0.0,0.0
2794134.0,6,2,132,1,66,0.0,66.0,66.0,1,66,0.0,66.0,66.0
123522.0,6,14,4740,7,653,20457.33333333333,249.0,93.28571428571428,7,4087,19405.5,1514.0,583.8571428571429
12544.0,6,10,2032,5,524,2723.25,252.0,104.8,5,1508,2897.75,1236.0,301.6
29875.0,6,14,4740,7,653,4708.333333333333,249.0,93.28571428571428,7,4087,4834.833333333333,1514.0,583.8571428571429
47856.0,6,10,2032,5,524,11700.5,252.0,104.8,5,1508,11540.0,1236.0,301.6
241703.0,6,3,337,2,214,0.0,160.0,107.0,1,123,0.0,123.0,123.0
319303.0,6,3,202,2,128,0.0,74.0,64.0,1,74,0.0,74.0,74.0
5626761.0,6,5,336,2,134,0.0,68.0,67.0,3,202,1526593.0,70.0,67.33333333333333
2430.0,17,4,344,2,150,0.0,75.0,75.0,2,194,0.0,103.0,97.0
120018664.0,17,29,13785,29,13785,4286380.857142857,501.0,475.3448275862069,0,0,0.0,0.0,0.0
29665.0,6,14,4740,7,653,4605.666666666667,249.0,93.28571428571428,7,4087,4624.5,1514.0,583.8571428571429
72366.0,6,12,1362,6,731,13871.4,253.0,121.83333333333331,6,631,13164.0,293.0,105.16666666666669
205882.0,6,3,426,2,280,0.0,214.0,140.0,1,146,0.0,146.0,146.0
321233.0,17,4,1400,4,1400,107077.66666666669,350.0,350.0,0,0,0.0,0.0,0.0
0.0,17,1,44,1,44,0.0,44.0,44.0,0,0,0.0,0.0,0.0
144839.0,17,2,180,1,70,0.0,70.0,70.0,1,110,0.0,110.0,110.0
1649355.0,6,7,499,3,198,716352.5,66.0,66.0,4,301,478548.0,103.0,75.25
121635.0,6,3,337,2,214,0.0,160.0,107.0,1,123,0.0,123.0,123.0
38718.0,6,14,4740,7,653,6254.0,249.0,93.28571428571428,7,4087,6136.5,1514.0,583.8571428571429
442876.0,6,3,1604,2,851,0.0,785.0,425.5,1,753,0.0,753.0,753.0
210627.0,6,3,426,2,280,0.0,214.0,140.0,1,146,0.0,146.0,146.0
108112918.0,17,5,1005,5,1005,27028229.5,201.0,201.0,0,0,0.0,0.0,0.0
103324.0,17,2,286,2,286,0.0,143.0,143.0,0,0,0.0,0.0,0.0
52701041.0,17,4,360,2,180,0.0,90.0,90.0,2,180,0.0,90.0,90.0
236855.0,6,3,337,2,214,0.0,160.0,107.0,1,123,0.0,123.0,123.0
55423.0,6,12,1447,6,816,9714.0,291.0,136.0,6,631,9392.0,293.0,105.16666666666669
826.0,17,4,438,2,148,0.0,74.0,74.0,2,290,0.0,147.0,145.0
1424042.0,17,16,1120,16,1120,94936.13333333332,70.0,70.0,0,0,0.0,0.0,0.0
262207.0,6,10,1221,6,636,52441.4,298.0,106.0,4,585,81606.33333333333,379.0,146.25
21828826.0,6,5,1736,2,819,0.0,753.0,409.5,3,917,9514176.0,785.0,305.6666666666667
120130167.0,6,244,27416,122,8360,977527.2561983472,140.0,68.52459016393442,122,19056,986049.652892562,284.0,156.1967213114754
216895.0,6,3,426,2,280,0.0,214.0,140.0,1,146,0.0,146.0,146.0
848102.0,6,9,1196,6,725,169620.4,387.0,120.83333333333331,3,471,287756.0,331.0,157.0
143829.0,17,2,180,1,90,0.0,90.0,90.0,1,90,0.0,90.0,90.0
1307007.0,6,4,264,2,132,0.0,66.0,66.0,2,132,0.0,66.0,66.0
155991.0,6,3,337,2,214,0.0,160.0,107.0,1,123,0.0,123.0,123.0
2704190.0,6,2,132,1,66,0.0,66.0,66.0,1,66,0.0,66.0,66.0
2398.0,17,4,344,2,150,0.0,75.0,75.0,2,194,0.0,103.0,97.0
78216.0,6,14,4740,7,653,12274.833333333334,249.0,93.28571428571428,7,4087,5702.0,1514.0,583.8571428571429
135134088.0,17,6,1206,6,1206,27026817.6,201.0,201.0,0,0,0.0,0.0,0.0
310942.0,6,6,412,4,272,103647.33333333331,74.0,68.0,2,140,0.0,74.0,70.0
90258401.0,6,13,2036,8,1016,12894057.285714284,188.0,127.0,5,1020,22520580.25,204.0,204.0
19549.0,6,14,4740,7,653,3147.0,249.0,93.28571428571428,7,4087,2622.1666666666665,1514.0,583.8571428571429
151814.0,17,2,414,1,88,0.0,88.0,88.0,1,326,0.0,326.0,326.0
33775.0,6,14,4740,7,653,5417.666666666667,249.0,93.28571428571428,7,4087,5470.833333333333,1514.0,583.8571428571429
57579.0,6,14,4740,7,653,8707.666666666666,249.0,93.28571428571428,7,4087,9432.833333333334,1514.0,583.8571428571429
90525030.0,6,16,2648,8,1016,12932147.142857144,188.0,127.0,8,1632,12907901.857142856,204.0,204.0
864.0,17,4,438,2,148,0.0,74.0,74.0,2,290,0.0,147.0,145.0
143951.0,17,2,180,1,90,0.0,90.0,90.0,1,90,0.0,90.0,90.0
120121756.0,6,15,2428,9,1204,15015219.5,188.0,133.77777777777777,6,1224,18018479.2,204.0,204.0
284146.0,17,2,363,1,79,0.0,79.0,79.0,1,284,0.0,284.0,284.0
103386060.0,17,14,864,7,432,17167878.666666668,174.0,61.71428571428572,7,432,17166891.833333332,174.0,61.71428571428572
30898.0,6,14,4740,7,653,4960.5,249.0,93.28571428571428,7,4087,5007.0,1514.0,583.8571428571429
27582.0,6,14,4740,7,653,4165.333333333333,249.0,93.28571428571428,7,4087,4413.666666666667,1514.0,583.8571428571429
1730.0,17,2,664,1,322,0.0,322.0,322.0,1,342,0.0,342.0,342.0
303089.0,6,6,412,4,272,101029.66666666669,74.0,68.0,2,140,0.0,74.0,70.0
38028.0,6,20,7606,11,978,3802.8,310.0,88.9090909090909,9,6628,4504.25,1514.0,736.4444444444445
36664.0,6,14,4740,7,653,5985.166666666667,249.0,93.28571428571428,7,4087,5971.666666666667,1514.0,583.8571428571429
1314757.0,6,4,264,2,132,0.0,66.0,66.0,2,132,0.0,66.0,66.0
239899.0,6,3,337,2,214,0.0,160.0,107.0,1,123,0.0,123.0,123.0
216354.0,17,2,180,1,90,0.0,90.0,90.0,1,90,0.0,90.0,90.0
2779711.0,6,2,132,1,66,0.0,66.0,66.0,1,66,0.0,66.0,66.0
347.0,17,2,166,1,75,0.0,75.0,75.0,1,91,0.0,91.0,91.0
3171087.0,6,3,1604,2,851,0.0,785.0,425.5,1,753,0.0,753.0,753.0
218013.0,6,3,426,2,280,0.0,214.0,140.0,1,146,0.0,146.0,146.0
119742.0,17,2,180,1,70,0.0,70.0,70.0,1,110,0.0,110.0,110.0
36441.0,6,13,1479,7,882,6073.5,291.0,126.0,6,597,6852.2,259.0,99.5
30590.0,6,14,4740,7,653,4976.333333333333,249.0,93.28571428571428,7,4087,4960.666666666667,1514.0,583.8571428571429
239359.0,17,2,180,1,90,0.0,90.0,90.0,1,90,0.0,90.0,90.0
0.0,17,1,55,1,55,0.0,55.0,55.0,0,0,0.0,0.0,0.0
143953.0,17,2,180,1,90,0.0,90.0,90.0,1,90,0.0,90.0,90.0
27432.0,6,14,4740,7,653,3863.6666666666665,249.0,93.28571428571428,7,4087,4433.833333333333,1514.0,583.8571428571429
369273.0,6,10,1221,6,636,73854.6,298.0,106.0,4,585,121704.0,379.0,146.25
251356.00000000003,17,4,6056,4,6056,83785.33333333333,1514.0,1514.0,0,0,0.0,0.0,0.0
27247722.0,17,5,1718,4,1368,1819221.0,342.0,342.0,1,350,0.0,350.0,350.0
366.0,17,2,267,1,83,0.0,83.0,83.0,1,184,0.0,184.0,184.0
0.0,6,1,66,1,66,0.0,66.0,66.0,0,0,0.0,0.0,0.0
103999636.0,17,13,821,7,432,17333272.666666668,174.0,61.71428571428572,6,389,16800167.6,174.0,64.83333333333333
135133668.0,17,6,1146,6,1146,27026733.6,191.0,191.0,0,0,0.0,0.0,0.0
143952.0,17,2,180,1,90,0.0,90.0,90.0,1,90,0.0,90.0,90.0
135135838.0,17,6,1146,6,1146,27027167.6,191.0,191.0,0,0,0.0,0.0,0.0
108101925.0,17,5,1005,5,1005,27025481.25,201.0,201.0,0,0,0.0,0.0,0.0
16271.0,17,4,823,2,163,0.0,89.0,81.5,2,660,0.0,443.0,330.0
26405.0,6,10,2032,5,524,6102.75,252.0,104.8,5,1508,3955.25,1236.0,301.6
333.0,17,2,174,1,79,0.0,79.0,79.0,1,95,0.0,95.0,95.0
146711.0,6,3,337,2,214,0.0,160.0,107.0,1,123,0.0,123.0,123.0
90531750.0,6,14,2240,8,1016,12933107.142857144,188.0,127.0,6,1224,18073620.2,204.0,204.0
162800.0,6,3,337,2,214,0.0,160.0,107.0,1,123,0.0,123.0,123.0
420.0,17,2,410,1,78,0.0,78.0,78.0,1,332,0.0,332.0,332.0
29801.0,6,14,4740,7,653,4856.666666666667,249.0,93.28571428571428,7,4087,3967.1666666666665,1514.0,583.8571428571429
102043700.0,6,29,2062,15,1017,7288805.357142857,123.0,67.8,14,1045,7081396.076923077,139.0,74.64285714285714
108103666.0,17,5,955,5,955,27025916.5,191.0,191.0,0,0,0.0,0.0,0.0
108109455.0,17,5,1005,5,1005,27027363.75,201.0,201.0,0,0,0.0,0.0,0.0
307871.0,6,6,412,4,272,102623.66666666669,74.0,68.0,2,140,0.0,74.0,70.0
108097827.0,17,5,1005,5,1005,27024456.75,201.0,201.0,0,0,0.0,0.0,0.0
14921.0,6,10,2032,5,524,3504.75,252.0,104.8,5,1508,3476.25,1236.0,301.6
120755503.0,6,245,27688,122,8348,991204.0,140.0,68.42622950819673,123,19340,989747.4590163934,284.0,157.2357723577236
217629.0,6,3,426,2,280,0.0,214.0,140.0,1,146,0.0,146.0,146.0
27233274.0,17,5,1710,5,1710,6808318.5,342.0,342.0,0,0,0.0,0.0,0.0
90286861.0,6,16,1192,8,596,12892158.57142857,95.0,74.5,8,596,12896773.42857143,95.0,74.5
130971.0,6,2,132,1,66,0.0,66.0,66.0,1,66,0.0,66.0,66.0
8562.0,6,10,666,5,323,1961.25,95.0,64.6,5,343,1459.25,115.0,68.6
99102221.0,6,187,21266,94,14906,1065615.2795698924,284.0,158.5744680851064,93,6360,1068338.4239130437,140.0,68.38709677419355
103648813.0,6,29,2068,15,1105,7388080.142857143,139.0,73.66666666666667,14,963,7956392.461538462,123.0,68.78571428571429
90524623.0,6,13,2036,8,1016,12932089.0,188.0,127.0,5,1020,22590911.25,204.0,204.0
121109.0,6,3,373,2,238,0.0,172.0,119.0,1,135,0.0,135.0,135.0
405410.0,6,4,508,2,238,0.0,172.0,119.0,2,270,0.0,135.0,135.0
42579.0,6,10,2032,5,524,10232.75,252.0,104.8,5,1508,7375.75,1236.0,301.6
13788.0,6,10,2032,5,524,3213.0,252.0,104.8,5,1508,3150.5,1236.0,301.6
143973.0,17,2,180,1,90,0.0,90.0,90.0,1,90,0.0,90.0,90.0
4421.0,17,2,614,1,72,0.0,72.0,72.0,1,542,0.0,542.0,542.0
116406100.0,17,14,864,7,432,19334192.5,174.0,61.71428571428572,7,432,19333501.0,174.0,61.71428571428572
121198.0,6,3,337,2,214,0.0,160.0,107.0,1,123,0.0,123.0,123.0
23604.0,6,14,4740,7,653,3760.3333333333335,249.0,93.28571428571428,7,4087,3216.0,1514.0,583.8571428571429
108113459.0,17,5,955,5,955,27028364.75,191.0,191.0,0,0,0.0,0.0,0.0
107958.0,17,2,286,2,286,0.0,143.0,143.0,0,0,0.0,0.0,0.0
63175.99999999999,6,14,4740,7,653,10020.833333333334,249.0,93.28571428571428,7,4087,10282.333333333334,1514.0,583.8571428571429
114710507.0,6,30,1974,15,1026,8178968.285714285,123.0,68.4,15,948,8178967.285714285,123.0,63.2
15042.0,6,11,1133,6,602,2958.6,264.0,100.33333333333331,5,531,3215.75,259.0,106.2
196973.0,17,2,180,1,90,0.0,90.0,90.0,1,90,0.0,90.0,90.0
4274.0,17,2,626,1,72,0.0,72.0,72.0,1,554,0.0,554.0,554.0
98022144.0,17,12,778,6,389,19602272.0,174.0,64.83333333333333,6,389,19600160.8,174.0,64.83333333333333
31060.0,6,14,4740,7,653,4241.333333333333,249.0,93.28571428571428,7,4087,4608.833333333333,1514.0,583.8571428571429
32277.0,6,14,4740,7,653,4351.0,249.0,93.28571428571428,7,4087,4879.333333333333,1514.0,583.8571428571429
146765.0,6,3,337,2,214,0.0,160.0,107.0,1,123,0.0,123.0,123.0
204701.0,17,2,762,2,762,0.0,381.0,381.0,0,0,0.0,0.0,0.0
41472.0,6,10,2032,5,524,10134.0,252.0,104.8,5,1508,10103.25,1236.0,301.6
14108.0,6,11,1131,6,600,2609.4,262.0,100.0,5,531,3309.0,259.0,106.2
90092749.0,6,13,2052,6,1224,18018076.2,204.0,204.0,7,828,15015047.833333334,188.0,118.28571428571428
20289.0,6,10,2032,5,524,4818.5,252.0,104.8,5,1508,3971.5,1236.0,301.6
121050723.0,6,33,2280,17,1209,7565670.1875,123.0,71.11764705882354,16,1071,7390012.133333334,123.0,66.9375
90255399.0,6,12,1832,8,1016,12893628.42857143,188.0,127.0,4,816,30030056.666666668,204.0,204.0
52821.0,6,14,4740,7,653,8371.333333333334,249.0,93.28571428571428,7,4087,8499.166666666666,1514.0,583.8571428571429
178571.0,17,2,180,1,90,0.0,90.0,90.0,1,90,0.0,90.0,90.0
225334.0,17,2,231,1,78,0.0,78.0,78.0,1,153,0.0,153.0,153.0
106993.0,17,2,286,2,286,0.0,143.0,143.0,0,0,0.0,0.0,0.0
153457.0,17,2,180,1,90,0.0,90.0,90.0,1,90,0.0,90.0,90.0
29760.0,6,10,2032,5,524,6986.25,252.0,104.8,5,1508,6273.0,1236.0,301.6
13661.0,6,14,4740,7,653,2128.6666666666665,249.0,93.28571428571428,7,4087,2139.5,1514.0,583.8571428571429
27035.0,6,14,4740,7,653,3660.0,249.0,93.28571428571428,7,4087,4369.0,1514.0,583.8571428571429
2590157.0,6,2,132,1,66,0.0,66.0,66.0,1,66,0.0,66.0,66.0
100220236.0,6,30,2122,15,1105,7143156.571428572,139.0,73.66666666666667,15,1017,7143156.928571428,123.0,67.8
299038.0,6,6,412,4,272,99679.33333333331,74.0,68.0,2,140,0.0,74.0,70.0
33129.0,6,14,4740,7,653,5075.166666666667,249.0,93.28571428571428,7,4087,5388.666666666667,1514.0,583.8571428571429
262206.0,6,3,337,2,214,0.0,160.0,107.0,1,123,0.0,123.0,123.0
35326.0,6,14,4740,7,653,4430.0,249.0,93.28571428571428,7,4087,5701.5,1514.0,583.8571428571429
2309.0,17,5,550,5,550,577.25,110.0,110.0,0,0,0.0,0.0,0.0
36966.0,6,14,4740,7,653,5118.666666666667,249.0,93.28571428571428,7,4087,5756.333333333333,1514.0,583.8571428571429
108109874.0,17,5,1005,5,1005,27027468.5,201.0,201.0,0,0,0.0,0.0,0.0
196947.0,17,2,180,1,90,0.0,90.0,90.0,1,90,0.0,90.0,90.0
28093.0,6,14,4740,7,653,3976.5,249.0,93.28571428571428,7,4087,3732.0,1514.0,583.8571428571429
2598134.0,6,2,132,1,66,0.0,66.0,66.0,1,66,0.0,66.0,66.0
210404.0,17,2,180,1,90,0.0,90.0,90.0,1,90,0.0,90.0,90.0
303966.0,6,6,412,4,272,101322.0,74.0,68.0,2,140,0.0,74.0,70.0
12588.0,6,11,2098,6,590,2101.8,252.0,98.33333333333331,5,1508,2763.25,1236.0,301.6
325.0,17,2,174,1,79,0.0,79.0,79.0,1,95,0.0,95.0,95.0
90026374.0,17,27,12943,27,12943,3462552.846153846,501.0,479.3703703703704,0,0,0.0,0.0,0.0
153493.0,17,2,180,1,90,0.0,90.0,90.0,1,90,0.0,90.0,90.0
2379.0,17,4,344,2,150,0.0,75.0,75.0,2,194,0.0,103.0,97.0
2310.0,17,4,344,2,150,0.0,75.0,75.0,2,194,0.0,103.0,97.0
298150.0,6,6,412,4,272,99383.33333333331,74.0,68.0,2,140,0.0,74.0,70.0
73003.0,6,14,4740,7,653,10806.333333333334,249.0,93.28571428571428,7,4087,11186.0,1514.0,583.8571428571429
41564.0,6,14,4740,7,653,6316.166666666667,249.0,93.28571428571428,7,4087,6664.0,1514.0,583.8571428571429
345.0,17,2,267,1,83,0.0,83.0,83.0,1,184,0.0,184.0,184.0
36986.0,6,10,1066,5,490,8012.0,218.0,98.0,5,576,9042.5,304.0,115.2
73615.0,6,14,4740,7,653,12025.0,249.0,93.28571428571428,7,4087,12074.666666666666,1514.0,583.8571428571429
289.0,17,2,174,1,79,0.0,79.0,79.0,1,95,0.0,95.0,95.0
110006022.0,17,14,864,7,432,18334337.0,174.0,61.71428571428572,7,432,18166823.33333333,174.0,61.71428571428572
35318.0,6,10,2032,5,524,8575.75,252.0,104.8,5,1508,8561.75,1236.0,301.6
206589.0,6,3,426,2,280,0.0,214.0,140.0,1,146,0.0,146.0,146.0
15101568.0,17,6,2052,6,2052,3020313.6,342.0,342.0,0,0,0.0,0.0,0.0
100765.0,17,2,762,2,762,0.0,381.0,381.0,0,0,0.0,0.0,0.0
108107500.0,17,5,955,5,955,27026875.0,191.0,191.0,0,0,0.0,0.0,0.0
100967.0,17,2,286,2,286,0.0,143.0,143.0,0,0,0.0,0.0,0.0
232919.0,6,3,337,2,214,0.0,160.0,107.0,1,123,0.0,123.0,123.0
326660.0,17,4,1400,4,1400,108886.66666666669,350.0,350.0,0,0,0.0,0.0,0.0
438905.0,6,3,1604,1,753,0.0,753.0,753.0,2,851,0.0,785.0,425.5
751060.0,6,2,132,1,66,0.0,66.0,66.0,1,66,0.0,66.0,66.0
38945.0,6,10,2032,5,524,8323.75,252.0,104.8,5,1508,9253.25,1236.0,301.6
17755.0,6,14,4740,7,653,2782.5,249.0,93.28571428571428,7,4087,2766.5,1514.0,583.8571428571429
1305673.0,6,4,264,2,132,0.0,66.0,66.0,2,132,0.0,66.0,66.0
50355.0,6,10,2032,5,524,12341.0,252.0,104.8,5,1508,11204.25,1236.0,301.6
916328.0,6,10,1336,6,799,183265.6,461.0,133.16666666666666,4,537,213526.3333333333,331.0,134.25
120124110.0,6,14,2224,9,1204,15015513.75,188.0,133.77777777777777,5,1020,22600421.5,204.0,204.0
120022387.0,17,28,13364,28,13364,4445273.592592592,501.0,477.2857142857143,0,0,0.0,0.0,0.0
114210079.0,6,48,3168,24,1584,4965655.608695652,66.0,66.0,24,1584,4953662.130434782,66.0,66.0
24749.0,6,14,4740,7,653,3294.1666666666665,249.0,93.28571428571428,7,4087,3923.6666666666665,1514.0,583.8571428571429
14340431.0,6,115,31517,60,25224,243058.15254237287,579.0,420.4,55,6293,261534.59259259253,731.0,114.41818181818182
220634.0,6,3,426,2,280,0.0,214.0,140.0,1,146,0.0,146.0,146.0
54338.0,6,14,4740,7,653,8927.166666666666,249.0,93.28571428571428,7,4087,8772.833333333334,1514.0,583.8571428571429
91254848.0,17,12,778,6,389,18200252.0,174.0,64.83333333333333,6,389,18201708.0,174.0,64.83333333333333
108104597.0,17,5,955,5,955,27026149.25,191.0,191.0,0,0,0.0,0.0,0.0
210650.0,17,2,180,1,90,0.0,90.0,90.0,1,90,0.0,90.0,90.0
242332.0,6,3,337,2,214,0.0,160.0,107.0,1,123,0.0,123.0,123.0
255388.0,6,3,354,2,288,0.0,222.0,144.0,1,66,0.0,66.0,66.0
90237045.0,6,24,1829,11,840,8998391.8,95.0,76.36363636363636,13,989,7501821.5,95.0,76.07692307692308
143951.0,17,2,180,1,90,0.0,90.0,90.0,1,90,0.0,90.0,90.0
43589.0,6,14,4740,7,653,7154.333333333333,249.0,93.28571428571428,7,4087,5217.5,1514.0,583.8571428571429
120393504.0,6,227,25742,114,17988,1065429.2389380531,284.0,157.78947368421052,113,7754,1065668.7589285714,140.0,68.61946902654867
355.0,17,2,267,1,83,0.0,83.0,83.0,1,184,0.0,184.0,184.0
311103.0,17,4,622,4,622,103701.0,163.0,155.5,0,0,0.0,0.0,0.0
5003084.0,17,4,849,2,166,0.0,83.0,83.0,2,683,0.0,499.0,341.5
108109079.0,17,5,955,5,955,27027269.75,191.0,191.0,0,0,0.0,0.0,0.0
501632.0,6,10,1221,6,636,100326.4,298.0,106.0,4,585,165812.0,379.0,146.25
33110.0,6,14,4740,7,653,5398.5,249.0,93.28571428571428,7,4087,4980.166666666667,1514.0,583.8571428571429
66023.0,17,2,180,1,90,0.0,90.0,90.0,1,90,0.0,90.0,90.0
23951.0,6,10,2032,5,524,5739.0,252.0,104.8,5,1508,5172.5,1236.0,301.6
207721.0,6,3,426,2,280,0.0,214.0,140.0,1,146,0.0,146.0,146.0
24542.0,6,14,4740,7,653,3908.3333333333335,249.0,93.28571428571428,7,4087,3931.6666666666665,1514.0,583.8571428571429
18713.0,6,14,4740,7,653,2996.833333333333,249.0,93.28571428571428,7,4087,2560.333333333333,1514.0,583.8571428571429
143948.0,17,2,180,1,90,0.0,90.0,90.0,1,90,0.0,90.0,90.0
3007578.0,6,12,2172,7,664,501152.8333333333,252.0,94.85714285714286,5,1508,1937.25,1236.0,301.6
119622007.0,6,20,1490,11,840,11956164.4,95.0,76.36363636363636,9,650,14947217.75,95.0,72.22222222222223
108106264.0,17,5,1005,5,1005,27026566.0,201.0,201.0,0,0,0.0,0.0,0.0
90252686.0,6,14,2240,8,1016,12893240.857142856,188.0,127.0,6,1224,18017067.0,204.0,204.0
206276.0,6,3,426,2,280,0.0,214.0,140.0,1,146,0.0,146.0,146.0
297011.0,17,2,180,1,90,0.0,90.0,90.0,1,90,0.0,90.0,90.0
53329.0,6,2,145,2,145,0.0,91.0,72.5,0,0,0.0,0.0,0.0
33713.0,6,14,4740,7,653,5192.333333333333,249.0,93.28571428571428,7,4087,5207.666666666667,1514.0,583.8571428571429
30584.0,6,2,145,2,145,0.0,91.0,72.5,0,0,0.0,0.0,0.0
17865.0,6,10,2032,5,524,4244.75,252.0,104.8,5,1508,3743.0,1236.0,301.6
233995.0,6,3,337,2,214,0.0,160.0,107.0,1,123,0.0,123.0,123.0
108103764.0,17,5,955,5,955,27025941.0,191.0,191.0,0,0,0.0,0.0,0.0
372.0,17,2,166,1,75,0.0,75.0,75.0,1,91,0.0,91.0,91.0
90074735.0,17,28,13364,28,13364,3336101.296296296,501.0,477.2857142857143,0,0,0.0,0.0,0.0
33983.0,6,11,2098,6,590,6673.8,252.0,98.33333333333331,5,1508,8125.75,1236.0,301.6
90291990.0,6,16,1192,8,596,12892332.0,95.0,74.5,8,596,12897356.0,95.0,74.5
320961.0,6,6,412,4,272,106987.0,74.0,68.0,2,140,0.0,74.0,70.0
303630.0,6,2,132,1,66,0.0,66.0,66.0,1,66,0.0,66.0,66.0
90048346.0,17,28,13364,28,13364,3335123.925925926,501.0,477.2857142857143,0,0,0.0,0.0,0.0
103376.0,17,2,286,2,286,0.0,143.0,143.0,0,0,0.0,0.0,0.0
9723.0,17,2,582,1,83,0.0,83.0,83.0,1,499,0.0,499.0,499.0
91418415.0,6,24,1829,13,989,7617435.5,95.0,76.07692307692308,11,840,9141226.9,95.0,76.36363636363636
112535462.0,6,46,3036,23,1518,5105438.954545454,66.0,66.0,23,1518,5105440.5,66.0,66.0
280317.0,17,2,365,1,80,0.0,80.0,80.0,1,285,0.0,285.0,285.0
318071.0,17,4,1400,4,1400,106023.66666666669,350.0,350.0,0,0,0.0,0.0,0.0
304.0,17,2,164,1,82,0.0,82.0,82.0,1,82,0.0,82.0,82.0
206581.0,17,2,180,1,90,0.0,90.0,90.0,1,90,0.0,90.0,90.0
22632211.0,6,26,7627,14,3735,187633.0769230769,1514.0,266.7857142857143,12,3892,2037792.2727272727,1514.0,324.3333333333333
90632757.0,6,15,2302,9,1204,11315862.75,188.0,133.77777777777777,6,1098,18092326.2,204.0,183.0
1302613.0,6,4,264,2,132,0.0,66.0,66.0,2,132,0.0,66.0,66.0
33085.0,6,14,4740,7,653,5311.833333333333,249.0,93.28571428571428,7,4087,5180.833333333333,1514.0,583.8571428571429
67630.0,6,14,4740,7,653,11048.833333333334,249.0,93.28571428571428,7,4087,11143.333333333334,1514.0,583.8571428571429
317990.0,6,10,1221,6,636,63598.0,298.0,106.0,4,585,100617.66666666669,379.0,146.25
42625.0,6,14,4740,7,653,6973.833333333333,249.0,93.28571428571428,7,4087,6489.0,1514.0,583.8571428571429
334.0,17,2,174,1,79,0.0,79.0,79.0,1,95,0.0,95.0,95.0
90046045.0,17,28,13364,28,13364,3335038.703703704,501.0,477.2857142857143,0,0,0.0,0.0,0.0
179987.0,17,2,180,1,90,0.0,90.0,90.0,1,90,0.0,90.0,90.0
309055.0,6,6,412,4,272,103018.33333333331,74.0,68.0,2,140,0.0,74.0,70.0
108096450.0,17,5,1005,5,1005,27024112.5,201.0,201.0,0,0,0.0,0.0,0.0
824.0,17,4,438,2,148,0.0,74.0,74.0,2,290,0.0,147.0,145.0
143985.0,17,2,180,1,90,0.0,90.0,90.0,1,90,0.0,90.0,90.0
82.0,17,2,762,2,762,0.0,381.0,381.0,0,0,0.0,0.0,0.0
113951603.0,6,48,3168,24,1584,4954417.521739131,66.0,66.0,24,1584,4940831.608695652,66.0,66.0
90053267.0,17,28,13364,28,13364,3335306.185185185,501.0,477.2857142857143,0,0,0.0,0.0,0.0
103582.0,17,2,286,2,286,0.0,143.0,143.0,0,0,0.0,0.0,0.0
52120.0,6,10,2032,5,524,11905.25,252.0,104.8,5,1508,12321.25,1236.0,301.6
2599956.0,6,2,132,1,66,0.0,66.0,66.0,1,66,0.0,66.0,66.0
172297.0,17,2,180,1,90,0.0,90.0,90.0,1,90,0.0,90.0,90.0
228299.0,17,2,180,1,90,0.0,90.0,90.0,1,90,0.0,90.0,90.0
237194.0,6,4,439,2,238,0.0,172.0,119.0,2,201,0.0,135.0,100.5
288524.0,17,2,363,1,79,0.0,79.0,79.0,1,284,0.0,284.0,284.0
228281.0,17,2,180,1,90,0.0,90.0,90.0,1,90,0.0,90.0,90.0
47069117.0,6,6,1979,2,892,0.0,826.0,446.0,4,1087,15629300.666666666,885.0,271.75
106677.0,17,2,700,2,700,0.0,350.0,350.0,0,0,0.0,0.0,0.0
155.0,17,2,3028,2,3028,0.0,1514.0,1514.0,0,0,0.0,0.0,0.0
9193.0,6,10,1067,5,536,2131.25,264.0,107.2,5,531,2017.0,259.0,106.2
146299.0,6,3,337,2,214,0.0,160.0,107.0,1,123,0.0,123.0,123.0
2424.0,17,4,344,2,150,0.0,75.0,75.0,2,194,0.0,103.0,97.0
91994350.0,17,11,735,6,389,18398870.0,174.0,64.83333333333333,5,346,17980899.25,174.0,69.2
586924.0,17,2,335,1,88,0.0,88.0,88.0,1,247,0.0,247.0,247.0
22030.0,6,10,2032,5,524,4919.75,252.0,104.8,5,1508,5181.25,1236.0,301.6
108096228.0,17,5,955,5,955,27024057.0,191.0,191.0,0,0,0.0,0.0,0.0
381934.0,6,10,1221,6,636,76386.8,298.0,106.0,4,585,125757.0,379.0,146.25
2402259.0,6,3,1604,1,753,0.0,753.0,753.0,2,851,0.0,785.0,425.5
30255.0,6,10,2032,5,524,5314.25,252.0,104.8,5,1508,7322.0,1236.0,301.6
237595.0,6,3,337,2,214,0.0,160.0,107.0,1,123,0.0,123.0,123.0
90028312.0,17,27,12943,27,12943,3462627.3846153845,501.0,479.3703703703704,0,0,0.0,0.0,0.0
45618.0,6,14,4740,7,653,6962.5,249.0,93.28571428571428,7,4087,7039.333333333333,1514.0,583.8571428571429
40268.0,6,12,1413,7,882,6711.333333333333,291.0,126.0,5,531,8636.5,259.0,106.2
116546871.0,6,48,3168,24,1584,5067255.260869565,66.0,66.0,24,1584,5054144.043478261,66.0,66.0
1504533.0,6,7,499,4,301,431691.6666666667,103.0,75.25,3,198,715651.0,66.0,66.0
284674.0,17,2,363,1,79,0.0,79.0,79.0,1,284,0.0,284.0,284.0
207459.0,17,2,180,1,90,0.0,90.0,90.0,1,90,0.0,90.0,90.0
9506.0,17,2,539,1,86,0.0,86.0,86.0,1,453,0.0,453.0,453.0
44722.0,6,10,2032,5,524,10244.5,252.0,104.8,5,1508,10449.25,1236.0,301.6
61524.0,6,11,2098,6,590,11694.4,252.0,98.33333333333331,5,1508,15106.25,1236.0,301.6
0.0,17,1,350,1,350,0.0,350.0,350.0,0,0,0.0,0.0,0.0
8788.0,6,10,2032,5,524,1938.0,252.0,104.8,5,1508,1942.5,1236.0,301.6
33167.0,6,14,4740,7,653,5409.0,249.0,93.28571428571428,7,4087,5043.666666666667,1514.0,583.8571428571429
9209783.0,17,3,4542,3,4542,4604891.5,1514.0,1514.0,0,0,0.0,0.0,0.0
113617906.0,6,46,3036,23,1518,5150436.7727272725,66.0,66.0,23,1518,5150429.2727272725,66.0,66.0
105768.0,17,2,700,2,700,0.0,350.0,350.0,0,0,0.0,0.0,0.0
54103.0,6,14,4740,7,653,8436.333333333334,249.0,93.28571428571428,7,4087,8106.333333333333,1514.0,583.8571428571429
513112.0,6,5,336,2,134,0.0,68.0,67.0,3,202,203031.0,70.0,67.33333333333333
254642.0,6,10,1221,6,636,50928.4,298.0,106.0,4,585,83643.0,379.0,146.25
90294641.0,6,16,1192,8,596,12891453.0,95.0,74.5,8,596,12898462.0,95.0,74.5
166585.0,17,2,180,1,90,0.0,90.0,90.0,1,90,0.0,90.0,90.0
42786.0,6,14,4740,7,653,7003.333333333333,249.0,93.28571428571428,7,4087,6415.833333333333,1514.0,583.8571428571429
108101922.0,17,5,1005,5,1005,27025480.5,201.0,201.0,0,0,0.0,0.0,0.0
108104252.0,17,5,1005,5,1005,27026063.0,201.0,201.0,0,0,0.0,0.0,0.0
90259418.0,6,13,2036,8,1016,12894202.57142857,188.0,127.0,5,1020,22523712.75,204.0,204.0
23914.0,6,10,2032,5,524,5734.0,252.0,104.8,5,1508,5407.75,1236.0,301.6
146219.0,6,3,337,2,214,0.0,160.0,107.0,1,123,0.0,123.0,123.0
56498.0,6,10,2032,5,524,13889.25,252.0,104.8,5,1508,11645.5,1236.0,301.6
13182.0,6,10,1065,5,534,3122.5,262.0,106.8,5,531,2975.25,259.0,106.2
2382.0,17,4,344,2,150,0.0,75.0,75.0,2,194,0.0,103.0,97.0
307748.0,6,6,412,4,272,102582.66666666669,74.0,68.0,2,140,0.0,74.0,70.0
304741.0,17,4,704,2,148,0.0,74.0,74.0,2,556,0.0,280.0,278.0
35351.0,6,10,2032,5,524,7303.75,252.0,104.8,5,1508,8495.25,1236.0,301.6
3034551.0,6,11,2106,6,598,606590.8,252.0,99.66666666666669,5,1508,2002.5,1236.0,301.6
402704.0,6,4,508,2,238,0.0,172.0,119.0,2,270,0.0,135.0,135.0
39531.0,6,14,4740,7,653,6022.0,249.0,93.28571428571428,7,4087,6084.166666666667,1514.0,583.8571428571429
148046.0,6,3,373,2,238,0.0,172.0,119.0,1,135,0.0,135.0,135.0
53570.0,6,10,2032,5,524,13034.25,252.0,104.8,5,1508,12255.5,1236.0,301.6
10469799.0,6,7,478,4,272,3444589.6666666665,74.0,68.0,3,206,5166774.5,74.0,68.66666666666667
302223.0,6,6,412,4,272,100741.0,74.0,68.0,2,140,0.0,74.0,70.0
135142744.0,17,6,1146,6,1146,27028548.8,191.0,191.0,0,0,0.0,0.0,0.0
9992.0,17,2,582,1,83,0.0,83.0,83.0,1,499,0.0,499.0,499.0
241263.0,6,3,337,2,214,0.0,160.0,107.0,1,123,0.0,123.0,123.0
120139257.0,6,242,27310,121,8282,994293.725,140.0,68.44628099173553,121,19028,999036.4083333332,284.0,157.25619834710744
148486.0,17,2,414,1,88,0.0,88.0,88.0,1,326,0.0,326.0,326.0
153496.0,17,2,180,1,90,0.0,90.0,90.0,1,90,0.0,90.0,90.0
31355.0,6,13,1479,7,882,5025.5,291.0,126.0,6,597,5792.8,259.0,99.5
135134701.0,17,6,1146,6,1146,27026940.2,191.0,191.0,0,0,0.0,0.0,0.0
106461.0,17,2,286,2,286,0.0,143.0,143.0,0,0,0.0,0.0,0.0
301021.0,6,6,412,4,272,100340.33333333331,74.0,68.0,2,140,0.0,74.0,70.0
36868.0,6,14,4740,7,653,5796.333333333333,249.0,93.28571428571428,7,4087,5106.666666666667,1514.0,583.8571428571429
196933.0,17,2,180,1,90,0.0,90.0,90.0,1,90,0.0,90.0,90.0
10430598.0,6,6,412,3,206,5146847.0,74.0,68.66666666666667,3,206,5146746.5,74.0,68.66666666666667
45950.0,6,10,2032,5,524,11275.5,252.0,104.8,5,1508,9336.0,1236.0,301.6
165864.0,17,2,180,1,90,0.0,90.0,90.0,1,90,0.0,90.0,90.0
336.0,17,2,267,1,83,0.0,83.0,83.0,1,184,0.0,184.0,184.0
90045079.0,17,28,13364,28,13364,3335002.925925926,501.0,477.2857142857143,0,0,0.0,0.0,0.0
126250438.0,17,14,864,7,432,17833501.5,174.0,61.71428571428572,7,432,17835264.666666668,174.0,61.71428571428572
93779.0,6,12,1354,6,723,18020.0,253.0,120.5,6,631,17784.0,293.0,105.16666666666669
27878.0,6,14,4740,7,653,3971.3333333333335,249.0,93.28571428571428,7,4087,4378.166666666667,1514.0,583.8571428571429
50617.0,6,14,4740,7,653,7921.0,249.0,93.28571428571428,7,4087,8294.333333333334,1514.0,583.8571428571429
225770.0,17,2,180,1,90,0.0,90.0,90.0,1,90,0.0,90.0,90.0
90259467.0,6,12,1832,8,1016,12894209.57142857,188.0,127.0,4,816,30031083.666666668,204.0,204.0
120122455.0,6,16,2278,9,1284,15015306.875,204.0,142.66666666666666,7,994,15017419.0,199.0,142.0
206269.0,6,3,426,2,280,0.0,214.0,140.0,1,146,0.0,146.0,146.0
345.0,17,2,250,1,93,0.0,93.0,93.0,1,157,0.0,157.0,157.0
303666.0,6,6,412,4,272,101222.0,74.0,68.0,2,140,0.0,74.0,70.0
38961.0,6,14,4740,7,653,6275.0,249.0,93.28571428571428,7,4087,6218.166666666667,1514.0,583.8571428571429
36305.0,6,10,2032,5,524,8786.5,252.0,104.8,5,1508,7765.25,1236.0,301.6
146153.0,6,3,337,2,214,0.0,160.0,107.0,1,123,0.0,123.0,123.0
132504.0,6,2,132,1,66,0.0,66.0,66.0,1,66,0.0,66.0,66.0
133316.0,17,2,286,2,286,0.0,143.0,143.0,0,0,0.0,0.0,0.0
135125204.0,17,6,1206,6,1206,27025040.8,201.0,201.0,0,0,0.0,0.0,0.0
117757180.0,6,31,2113,16,1071,7850478.666666667,123.0,66.9375,15,1042,8395657.42857143,139.0,69.46666666666667
301402.0,17,2,180,1,90,0.0,90.0,90.0,1,90,0.0,90.0,90.0
107339.0,17,2,286,2,286,0.0,143.0,143.0,0,0,0.0,0.0,0.0
15048214.0,17,6,2718,6,2718,3009642.8,453.0,453.0,0,0,0.0,0.0,0.0
1321513.0,6,4,264,2,132,0.0,66.0,66.0,2,132,0.0,66.0,66.0
50730.0,17,2,180,1,90,0.0,90.0,90.0,1,90,0.0,90.0,90.0
190797.0,17,2,180,1,90,0.0,90.0,90.0,1,90,0.0,90.0,90.0
90285964.0,6,19,1436,10,745,10026875.888888888,95.0,74.5,9,691,11283375.625,95.0,76.77777777777777
143738.0,6,2,132,1,66,0.0,66.0,66.0,1,66,0.0,66.0,66.0
106891856.0,6,32,2236,16,1165,7126123.733333333,139.0,72.8125,16,1071,7111692.6,123.0,66.9375
2301739.0,6,3,1604,2,851,0.0,785.0,425.5,1,753,0.0,753.0,753.0
63767480.0,6,54,11903,28,6354,2361758.5185185187,1514.0,226.92857142857144,26,5549,2537755.8,1514.0,213.42307692307693
38243.0,6,10,2032,5,524,9329.5,252.0,104.8,5,1508,8921.25,1236.0,301.6
90256845.0,6,13,2036,8,1016,12893835.0,188.0,127.0,5,1020,22523571.75,204.0,204.0
108104390.0,17,5,955,5,955,27026097.5,191.0,191.0,0,0,0.0,0.0,0.0
153498.0,17,2,180,1,90,0.0,90.0,90.0,1,90,0.0,90.0,90.0
21803.0,17,2,582,1,83,0.0,83.0,83.0,1,499,0.0,499.0,499.0
7130.0,17,2,582,1,83,0.0,83.0,83.0,1,499,0.0,499.0,499.0
297779.0,6,6,412,4,272,99259.66666666669,74.0,68.0,2,140,0.0,74.0,70.0
51090.0,6,14,4740,7,653,8387.5,249.0,93.28571428571428,7,4087,7826.166666666667,1514.0,583.8571428571429
38950166.0,17,9,3078,9,3078,4868770.75,342.0,342.0,0,0,0.0,0.0,0.0
40072.0,6,14,4740,7,653,6434.5,249.0,93.28571428571428,7,4087,6093.5,1514.0,583.8571428571429
144713.0,6,13,1386,7,789,24118.83333333333,253.0,112.71428571428572,6,597,28356.6,259.0,99.5
95000831.0,17,11,735,6,389,19000166.2,174.0,64.83333333333333,5,346,18750809.5,174.0,69.2
216794.0,17,2,180,1,90,0.0,90.0,90.0,1,90,0.0,90.0,90.0
217928.0,17,2,180,1,90,0.0,90.0,90.0,1,90,0.0,90.0,90.0
196963.0,17,2,180,1,90,0.0,90.0,90.0,1,90,0.0,90.0,90.0
110595.0,17,2,286,2,286,0.0,143.0,143.0,0,0,0.0,0.0,0.0
104105.0,17,2,286,2,286,0.0,143.0,143.0,0,0,0.0,0.0,0.0
2593458.0,6,2,132,1,66,0.0,66.0,66.0,1,66,0.0,66.0,66.0
103236.0,17,2,286,2,286,0.0,143.0,143.0,0,0,0.0,0.0,0.0
16695.0,6,14,4740,7,653,2587.333333333333,249.0,93.28571428571428,7,4087,2646.5,1514.0,583.8571428571429
76045.0,6,10,2032,5,524,17027.5,252.0,104.8,5,1508,18374.0,1236.0,301.6
217105.0,6,3,426,2,280,0.0,214.0,140.0,1,146,0.0,146.0,146.0
330.0,17,2,248,1,84,0.0,84.0,84.0,1,164,0.0,164.0,164.0
47812.0,6,14,4740,7,653,7534.666666666667,249.0,93.28571428571428,7,4087,6765.166666666667,1514.0,583.8571428571429
34612.0,6,10,2032,5,524,8324.25,252.0,104.8,5,1508,8329.75,1236.0,301.6
90035993.0,17,28,13364,28,13364,3334666.407407407,501.0,477.2857142857143,0,0,0.0,0.0,0.0
33721883.0,6,5,336,2,134,0.0,68.0,67.0,3,202,15571083.0,70.0,67.33333333333333
1177790.0,6,13,3020,8,2392,168255.7142857143,1514.0,299.0,5,628,225524.5,331.0,125.6
228243.0,17,2,180,1,90,0.0,90.0,90.0,1,90,0.0,90.0,90.0
208799.0,6,10,1221,6,636,41759.8,298.0,106.0,4,585,68351.33333333333,379.0,146.25
300965.0,6,6,412,4,272,100321.66666666669,74.0,68.0,2,140,0.0,74.0,70.0
314458.0,6,3,202,2,128,0.0,74.0,64.0,1,74,0.0,74.0,74.0
90751210.0,6,19,1436,10,745,10078360.222222222,95.0,74.5,9,691,11342971.125,95.0,76.77777777777777
90037176.0,17,27,12943,27,12943,3462968.3076923075,501.0,479.3703703703704,0,0,0.0,0.0,0.0
12004.0,17,2,582,1,83,0.0,83.0,83.0,1,499,0.0,499.0,499.0
4408.0,17,2,598,1,72,0.0,72.0,72.0,1,526,0.0,526.0,526.0
48571.0,6,14,4740,7,653,7950.666666666667,249.0,93.28571428571428,7,4087,6734.5,1514.0,583.8571428571429
12563003.0,6,22,7083,13,1707,1046916.9166666666,408.0,131.30769230769232,9,5376,1098226.0,1514.0,597.3333333333334
135134840.0,17,6,1146,6,1146,27026968.0,191.0,191.0,0,0,0.0,0.0,0.0
0.0,17,1,342,1,342,0.0,342.0,342.0,0,0,0.0,0.0,0.0
113472379.0,6,47,3102,24,1584,4933570.434782608,66.0,66.0,23,1518,5112000.181818182,66.0,66.0
307773.0,6,6,412,4,272,102591.0,74.0,68.0,2,140,0.0,74.0,70.0
281303.0,17,2,363,1,79,0.0,79.0,79.0,1,284,0.0,284.0,284.0
350445.0,6,3,1604,2,851,0.0,785.0,425.5,1,753,0.0,753.0,753.0
198475.0,17,2,180,1,90,0.0,90.0,90.0,1,90,0.0,90.0,90.0
120948940.0,6,23,1775,12,935,8265031.636363637,95.0,77.91666666666667,11,840,12089882.0,95.0,76.36363636363636
45412.0,6,10,2032,5,524,11026.25,252.0,104.8,5,1508,9610.0,1236.0,301.6
96380966.0,17,14,1126,7,563,16000341.833333334,174.0,80.42857142857143,7,563,16000135.5,174.0,80.42857142857143
301692.0,6,6,412,4,272,100564.0,74.0,68.0,2,140,0.0,74.0,70.0
4345992.0,6,8,550,4,278,1448664.0,78.0,69.5,4,272,828537.0,70.0,68.0
48461.0,6,14,4740,7,653,7074.333333333333,249.0,93.28571428571428,7,4087,7936.5,1514.0,583.8571428571429
9819.0,17,2,571,1,86,0.0,86.0,86.0,1,485,0.0,485.0,485.0
240958.0,6,3,337,1,123,0.0,123.0,123.0,2,214,0.0,160.0,107.0
1315443.0,6,4,264,2,132,0.0,66.0,66.0,2,132,0.0,66.0,66.0
144057.0,17,2,180,1,90,0.0,90.0,90.0,1,90,0.0,90.0,90.0
121883.0,6,3,337,2,214,0.0,160.0,107.0,1,123,0.0,123.0,123.0
98211135.0,6,40,2640,20,1320,5169007.105263158,66.0,66.0,20,1320,5152973.631578947,66.0,66.0
3458.0,17,2,224,1,76,0.0,76.0,76.0,1,148,0.0,148.0,148.0
204107.0,17,2,762,2,762,0.0,381.0,381.0,0,0,0.0,0.0,0.0
120156722.0,6,47,3102,23,1518,5155441.045454546,66.0,66.0,24,1584,5210370.260869565,66.0,66.0
128674756.0,17,14,864,7,432,18166824.666666668,174.0,61.71428571428572,7,432,18167875.666666668,174.0,61.71428571428572
52563.0,6,14,4740,7,653,4815.5,249.0,93.28571428571428,7,4087,8608.833333333334,1514.0,583.8571428571429
317018.0,6,6,412,4,272,105672.66666666669,74.0,68.0,2,140,0.0,74.0,70.0
25621.0,6,14,4740,7,653,4088.5,249.0,93.28571428571428,7,4087,4129.666666666667,1514.0,583.8571428571429
3380790.0,6,7,923,4,753,1058148.6666666667,571.0,188.25,3,170,1587518.5,62.0,56.66666666666666
66239.0,6,14,4740,7,653,10605.833333333334,249.0,93.28571428571428,7,4087,7679.833333333333,1514.0,583.8571428571429
118058041.0,6,948,191402,468,31554,252677.426124197,214.0,67.42307692307692,480,159848,246464.63674321503,1514.0,333.01666666666665
153409.0,17,2,180,1,90,0.0,90.0,90.0,1,90,0.0,90.0,90.0
74284.0,6,14,4740,7,653,12203.333333333334,249.0,93.28571428571428,7,4087,11755.833333333334,1514.0,583.8571428571429
98549383.0,17,12,778,6,389,19601644.2,174.0,64.83333333333333,6,389,19601198.2,174.0,64.83333333333333
2268351.0,17,4,1368,4,1368,756117.0,342.0,342.0,0,0,0.0,0.0,0.0
196905.0,17,2,180,1,90,0.0,90.0,90.0,1,90,0.0,90.0,90.0
298695.0,17,2,238,1,74,0.0,74.0,74.0,1,164,0.0,164.0,164.0
17001.0,17,2,180,1,90,0.0,90.0,90.0,1,90,0.0,90.0,90.0
44442.0,6,14,4740,7,653,7288.833333333333,249.0,93.28571428571428,7,4087,5803.666666666667,1514.0,583.8571428571429
108108675.0,17,5,955,5,955,27027168.75,191.0,191.0,0,0,0.0,0.0,0.0
144074.0,17,2,180,1,90,0.0,90.0,90.0,1,90,0.0,90.0,90.0
153405.0,17,2,180,1,90,0.0,90.0,90.0,1,90,0.0,90.0,90.0
90066458.0,17,28,13364,28,13364,3335794.7407407407,501.0,477.2857142857143,0,0,0.0,0.0,0.0
64443.0,6,14,4740,7,653,10621.333333333334,249.0,93.28571428571428,7,4087,9277.333333333334,1514.0,583.8571428571429
38471.0,6,10,2032,5,524,9384.25,252.0,104.8,5,1508,9047.0,1236.0,301.6
315524.0,17,4,1400,4,1400,105174.66666666669,350.0,350.0,0,0,0.0,0.0,0.0
302236.0,6,6,412,4,272,100745.33333333331,74.0,68.0,2,140,0.0,74.0,70.0
90290372.0,6,16,1192,8,596,12891272.0,95.0,74.5,8,596,12896181.142857144,95.0,74.5
3854.0,17,4,344,2,150,0.0,75.0,75.0,2,194,0.0,103.0,97.0
404070.0,6,3,1604,2,851,0.0,785.0,425.5,1,753,0.0,753.0,753.0
2338.0,17,4,344,2,150,0.0,75.0,75.0,2,194,0.0,103.0,97.0
103256.0,17,2,286,2,286,0.0,143.0,143.0,0,0,0.0,0.0,0.0
1086122.0,6,3,1604,1,753,0.0,753.0,753.0,2,851,0.0,785.0,425.5
120125018.0,6,15,2428,9,1204,15015627.25,188.0,133.77777777777777,6,1224,18072372.0,204.0,204.0
2333.0,17,4,344,2,150,0.0,75.0,75.0,2,194,0.0,103.0,97.0
120048337.0,17,29,13785,29,13785,4287440.607142857,501.0,475.3448275862069,0,0,0.0,0.0,0.0
41151.0,6,14,4740,7,653,6593.166666666667,249.0,93.28571428571428,7,4087,5596.166666666667,1514.0,583.8571428571429
29291.0,6,10,2032,5,524,6150.75,252.0,104.8,5,1508,4882.0,1236.0,301.6
19712.0,6,14,4740,7,653,3158.833333333333,249.0,93.28571428571428,7,4087,3148.6666666666665,1514.0,583.8571428571429
27328413.0,17,5,1710,5,1710,6832103.25,342.0,342.0,0,0,0.0,0.0,0.0
15134.0,17,2,180,1,90,0.0,90.0,90.0,1,90,0.0,90.0,90.0
45009799.0,6,7,1874,5,1053,11252449.75,785.0,210.6,2,821,0.0,753.0,410.5
2595705.0,6,2,132,1,66,0.0,66.0,66.0,1,66,0.0,66.0,66.0
36344.0,6,14,4740,7,653,5732.0,249.0,93.28571428571428,7,4087,5839.5,1514.0,583.8571428571429
135131814.0,17,6,1146,6,1146,27026362.8,191.0,191.0,0,0,0.0,0.0,0.0
208147.0,17,2,762,2,762,0.0,381.0,381.0,0,0,0.0,0.0,0.0
101721617.0,6,33,2444,17,1304,6344100.6875,139.0,76.70588235294117,16,1140,6767047.866666666,123.0,71.25
1507.0,17,2,762,2,762,0.0,381.0,381.0,0,0,0.0,0.0,0.0
135138149.0,17,6,1206,6,1206,27027629.8,201.0,201.0,0,0,0.0,0.0,0.0
108110511.0,17,5,1005,5,1005,27027627.75,201.0,201.0,0,0,0.0,0.0,0.0
3779867.0,6,5,336,2,134,0.0,68.0,67.0,3,202,1526106.0,70.0,67.33333333333333
314418.0,17,4,1400,4,1400,104806.0,350.0,350.0,0,0,0.0,0.0,0.0
108110074.0,17,5,1005,5,1005,27027518.5,201.0,201.0,0,0,0.0,0.0,0.0
90000795.0,17,11,735,6,389,18000159.0,174.0,64.83333333333333,5,346,17500989.25,174.0,69.2
216474.0,6,3,426,2,280,0.0,214.0,140.0,1,146,0.0,146.0,146.0
135127407.0,17,6,1146,6,1146,27025481.4,191.0,191.0,0,0,0.0,0.0,0.0
135132835.0,17,6,1146,6,1146,27026567.0,191.0,191.0,0,0,0.0,0.0,0.0
2021970.0,17,4,525,2,150,0.0,75.0,75.0,2,375,0.0,284.0,187.5
0.0,17,1,55,1,55,0.0,55.0,55.0,0,0,0.0,0.0,0.0
99213298.0,17,12,778,6,389,19800722.8,174.0,64.83333333333333,6,389,19800211.4,174.0,64.83333333333333
120231024.0,6,18,1341,9,691,14999094.875,95.0,76.77777777777777,9,650,14998745.625,95.0,72.22222222222223
108105314.0,17,5,955,5,955,27026328.5,191.0,191.0,0,0,0.0,0.0,0.0
95895476.0,6,26,1746,13,906,7973303.5,123.0,69.6923076923077,13,840,7973295.333333333,123.0,64.61538461538461
0.0,17,1,55,1,55,0.0,55.0,55.0,0,0,0.0,0.0,0.0
205988.0,6,3,426,2,280,0.0,214.0,140.0,1,146,0.0,146.0,146.0
135132161.0,17,6,1206,6,1206,27026432.2,201.0,201.0,0,0,0.0,0.0,0.0
2348.0,17,4,344,2,150,0.0,75.0,75.0,2,194,0.0,103.0,97.0
5629262.0,6,5,336,2,134,0.0,68.0,67.0,3,202,1427009.5,70.0,67.33333333333333
258811.0,6,3,337,2,214,0.0,160.0,107.0,1,123,0.0,123.0,123.0
198756.0,17,4,6056,4,6056,66252.0,1514.0,1514.0,0,0,0.0,0.0,0.0
30856.0,6,10,2032,5,524,6419.75,252.0,104.8,5,1508,7240.75,1236.0,301.6
108106322.0,17,5,1005,5,1005,27026580.5,201.0,201.0,0,0,0.0,0.0,0.0
145672.0,6,2,132,1,66,0.0,66.0,66.0,1,66,0.0,66.0,66.0
2322.0,17,4,344,2,150,0.0,75.0,75.0,2,194,0.0,103.0,97.0
101800350.0,6,29,2068,15,1105,7256048.5,139.0,73.66666666666667,14,963,7814104.923076923,123.0,68.78571428571429
123250548.0,6,49,3234,25,1650,5135439.5,66.0,66.0,24,1584,5182644.391304348,66.0,66.0
765002.0,6,2,132,1,66,0.0,66.0,66.0,1,66,0.0,66.0,66.0
2341.0,17,4,344,2,150,0.0,75.0,75.0,2,194,0.0,103.0,97.0
1302061.0,6,4,264,2,132,0.0,66.0,66.0,2,132,0.0,66.0,66.0
153411.0,17,2,180,1,90,0.0,90.0,90.0,1,90,0.0,90.0,90.0
4395.0,17,2,582,1,83,0.0,83.0,83.0,1,499,0.0,499.0,499.0
90310052.0,6,16,1192,8,596,12894831.57142857,95.0,74.5,8,596,12898129.0,95.0,74.5
108107512.0,17,5,1005,5,1005,27026878.0,201.0,201.0,0,0,0.0,0.0,0.0
0.0,17,1,90,1,90,0.0,90.0,90.0,0,0,0.0,0.0,0.0
341.0,17,2,160,1,80,0.0,80.0,80.0,1,80,0.0,80.0,80.0
25183.0,6,14,4740,7,653,4037.8333333333335,249.0,93.28571428571428,7,4087,3430.833333333333,1514.0,583.8571428571429
252257.0,6,3,373,2,238,0.0,172.0,119.0,1,135,0.0,135.0,135.0
110963144.0,6,34,2482,17,1288,6921715.4375,139.0,75.76470588235294,17,1194,6921716.5625,123.0,70.23529411764706
30902.0,6,14,4740,7,653,5030.0,249.0,93.28571428571428,7,4087,3733.5,1514.0,583.8571428571429
108109062.0,17,5,955,5,955,27027265.5,191.0,191.0,0,0,0.0,0.0,0.0
153308.0,17,2,180,1,90,0.0,90.0,90.0,1,90,0.0,90.0,90.0
144091.0,17,2,180,1,90,0.0,90.0,90.0,1,90,0.0,90.0,90.0
22876.0,6,14,4740,7,653,3045.833333333333,249.0,93.28571428571428,7,4087,3677.8333333333335,1514.0,583.8571428571429
103329.0,17,2,286,2,286,0.0,143.0,143.0,0,0,0.0,0.0,0.0
23571.0,6,10,2032,5,524,5623.25,252.0,104.8,5,1508,5222.75,1236.0,301.6
27084.0,6,14,4740,7,653,3967.8333333333335,249.0,93.28571428571428,7,4087,4260.333333333333,1514.0,583.8571428571429
6752.0,17,2,582,1,83,0.0,83.0,83.0,1,499,0.0,499.0,499.0
37808.0,6,10,2032,5,524,9080.0,252.0,104.8,5,1508,8940.25,1236.0,301.6
146065.0,6,3,337,2,214,0.0,160.0,107.0,1,123,0.0,123.0,123.0
228181.0,17,2,180,1,90,0.0,90.0,90.0,1,90,0.0,90.0,90.0
113175206.0,6,46,3036,23,1518,5144316.090909091,66.0,66.0,23,1518,5144315.409090909,66.0,66.0
108097752.0,17,5,955,5,955,27024438.0,191.0,191.0,0,0,0.0,0.0,0.0
146415.0,6,3,337,2,214,0.0,160.0,107.0,1,123,0.0,123.0,123.0
46235.0,6,11,2098,6,590,8120.8,252.0,98.33333333333331,5,1508,9483.5,1236.0,301.6
5728527.0,6,5,336,2,134,0.0,68.0,67.0,3,202,1574964.5,70.0,67.33333333333333
601570.0,17,3,551,2,156,0.0,78.0,78.0,1,395,0.0,395.0,395.0
90258267.0,6,13,2036,8,1016,12894038.142857144,188.0,127.0,5,1020,22523269.5,204.0,204.0
297700.0,6,6,412,4,272,99233.33333333331,74.0,68.0,2,140,0.0,74.0,70.0
342.0,17,2,267,1,83,0.0,83.0,83.0,1,184,0.0,184.0,184.0
34708.0,6,12,2966,7,626,5784.666666666667,222.0,89.42857142857143,5,2340,7123.5,1514.0,468.0
206443.0,17,2,180,1,90,0.0,90.0,90.0,1,90,0.0,90.0,90.0
10456047.0,6,7,478,4,272,3439723.0,74.0,68.0,3,206,5159476.5,74.0,68.66666666666667
143960.0,17,2,180,1,90,0.0,90.0,90.0,1,90,0.0,90.0,90.0
35668.0,6,14,4740,7,653,5520.666666666667,249.0,93.28571428571428,7,4087,5755.666666666667,1514.0,583.8571428571429
18051070.0,17,3,1034,2,684,0.0,342.0,342.0,1,350,0.0,350.0,350.0
545.0,17,5,550,5,550,136.25,110.0,110.0,0,0,0.0,0.0,0.0
28528.0,6,14,4740,7,653,4459.833333333333,249.0,93.28571428571428,7,4087,4413.666666666667,1514.0,583.8571428571429
90045565.0,17,28,13364,28,13364,3335020.925925926,501.0,477.2857142857143,0,0,0.0,0.0,0.0
306797.0,6,6,412,4,272,102265.66666666669,74.0,68.0,2,140,0.0,74.0,70.0
218256.0,6,10,1221,6,636,43651.2,298.0,106.0,4,585,69675.66666666667,379.0,146.25
980968.0,6,10,1162,6,625,196193.6,287.0,104.16666666666669,4,537,235102.0,331.0,134.25
17102.0,6,11,2098,6,590,3420.4,252.0,98.33333333333331,5,1508,2800.0,1236.0,301.6
33151.0,6,13,1386,7,789,5116.666666666667,253.0,112.71428571428572,6,597,5599.0,259.0,99.5
302161.0,6,6,412,4,272,100720.33333333331,74.0,68.0,2,140,0.0,74.0,70.0
14670759.0,6,20,1689,10,1057,1596717.5555555555,315.0,105.7,10,632,1596689.7777777778,78.0,63.2
94274881.0,6,216,24852,108,17502,879062.7476635514,284.0,162.05555555555554,108,7350,879062.0654205608,140.0,68.05555555555556
120403564.0,6,245,28042,123,19694,986914.4590163934,284.0,160.1138211382114,122,8348,987529.7438016528,140.0,68.42622950819673
285476.0,17,2,363,1,79,0.0,79.0,79.0,1,284,0.0,284.0,284.0
119184026.0,6,223,25336,112,17714,1073729.963963964,284.0,158.16071428571428,111,7622,1077291.8636363635,140.0,68.66666666666667
205870.0,17,2,180,1,90,0.0,90.0,90.0,1,90,0.0,90.0,90.0
324938.0,17,4,1400,4,1400,108312.66666666669,350.0,350.0,0,0,0.0,0.0,0.0
307678.0,6,6,412,4,272,102559.33333333331,74.0,68.0,2,140,0.0,74.0,70.0
62895.99999999999,6,14,4740,7,653,9271.0,249.0,93.28571428571428,7,4087,10269.666666666666,1514.0,583.8571428571429
506846.0,6,5,336,2,134,0.0,68.0,67.0,3,202,191965.5,70.0,67.33333333333333
120268761.0,6,218,24662,109,7416,1106056.740740741,140.0,68.03669724770643,109,17246,1106056.7962962964,284.0,158.22018348623854
3166056.0,6,18,1495,9,921,358351.125,315.0,102.33333333333331,9,574,358321.625,78.0,63.77777777777778
22578.0,6,14,4740,7,653,3218.6666666666665,249.0,93.28571428571428,7,4087,3578.1666666666665,1514.0,583.8571428571429
215313.0,17,2,180,1,90,0.0,90.0,90.0,1,90,0.0,90.0,90.0
40611.0,6,14,4740,7,653,6650.833333333333,249.0,93.28571428571428,7,4087,6428.833333333333,1514.0,583.8571428571429
120006297.0,17,13,559,7,301,20001049.5,43.0,43.0,6,258,20000153.2,43.0,43.0
3452.0,17,2,414,1,88,0.0,88.0,88.0,1,326,0.0,326.0,326.0
116341857.0,6,215,24390,108,17106,1087307.074766355,284.0,158.38888888888889,107,7284,1088843.924528302,140.0,68.07476635514018
113260838.0,6,217,24506,109,7416,1048711.462962963,140.0,68.03669724770643,108,17090,1053152.691588785,284.0,158.24074074074073
20139.0,6,14,4740,7,653,3246.6666666666665,249.0,93.28571428571428,7,4087,3172.0,1514.0,583.8571428571429
875091.0,6,12,2709,7,742,145848.5,338.0,106.0,5,1967,150618.25,1514.0,393.4
144804.0,17,2,180,1,70,0.0,70.0,70.0,1,110,0.0,110.0,110.0
90057902.0,17,28,13364,28,13364,3335477.851851852,501.0,477.2857142857143,0,0,0.0,0.0,0.0
42941.0,6,14,4740,7,653,6788.333333333333,249.0,93.28571428571428,7,4087,7007.333333333333,1514.0,583.8571428571429
90028833.0,17,28,13364,28,13364,3334401.222222222,501.0,477.2857142857143,0,0,0.0,0.0,0.0
3200197.0,6,5,336,2,134,0.0,68.0,67.0,3,202,1529285.5,70.0,67.33333333333333
219080.0,6,10,1221,6,636,43816.0,298.0,106.0,4,585,71139.66666666667,379.0,146.25
135699.0,6,2,132,1,66,0.0,66.0,66.0,1,66,0.0,66.0,66.0
528555.0,6,2,132,1,66,0.0,66.0,66.0,1,66,0.0,66.0,66.0
90391585.0,6,14,2256,7,1428,15060851.166666666,204.0,204.0,7,828,15064869.666666666,188.0,118.28571428571428
267007.0,6,3,337,2,214,0.0,160.0,107.0,1,123,0.0,123.0,123.0
228276.0,17,2,180,1,90,0.0,90.0,90.0,1,90,0.0,90.0,90.0
96701372.0,6,29,2052,15,1089,6892600.785714285,123.0,72.6,14,963,7422801.0,123.0,68.78571428571429
57288.0,6,14,4740,7,653,9417.5,249.0,93.28571428571428,7,4087,8406.833333333334,1514.0,583.8571428571429
116422084.0,6,48,3168,24,1584,5061829.739130435,66.0,66.0,24,1584,5049847.956521739,66.0,66.0
204041.0,17,2,762,2,762,0.0,381.0,381.0,0,0,0.0,0.0,0.0
1374997.0,6,7,499,4,301,457933.0,103.0,75.25,3,198,611287.0,66.0,66.0
19559.0,6,14,4740,7,653,3069.5,249.0,93.28571428571428,7,4087,3065.333333333333,1514.0,583.8571428571429
120005707.0,17,14,864,7,432,20000951.166666668,174.0,61.71428571428572,7,432,16666836.333333334,174.0,61.71428571428572
90039031.0,17,28,13364,28,13364,3334778.925925926,501.0,477.2857142857143,0,0,0.0,0.0,0.0
2792782.0,6,2,132,1,66,0.0,66.0,66.0,1,66,0.0,66.0,66.0
90010530.0,17,28,13364,28,13364,3333723.333333333,501.0,477.2857142857143,0,0,0.0,0.0,0.0
105172.0,17,2,700,2,700,0.0,350.0,350.0,0,0,0.0,0.0,0.0
90048569.0,17,28,13364,28,13364,3335132.185185185,501.0,477.2857142857143,0,0,0.0,0.0,0.0
46666.0,6,12,1328,6,731,6895.0,253.0,121.83333333333331,6,597,8681.0,259.0,99.5
2006659.0,6,4,492,2,280,0.0,214.0,140.0,2,212,0.0,146.0,106.0
2779759.0,6,2,132,1,66,0.0,66.0,66.0,1,66,0.0,66.0,66.0
239533.0,6,3,337,2,214,0.0,160.0,107.0,1,123,0.0,123.0,123.0
272644.0,6,10,1221,6,636,54528.8,298.0,106.0,4,585,85477.66666666667,379.0,146.25
4021.000000000001,17,4,704,2,148,0.0,74.0,74.0,2,556,0.0,280.0,278.0
146233.0,6,3,337,2,214,0.0,160.0,107.0,1,123,0.0,123.0,123.0
101575221.0,17,14,864,7,432,16833500.666666668,174.0,61.71428571428572,7,432,16834724.5,174.0,61.71428571428572
111459642.0,6,35,2526,18,1332,6556449.529411765,123.0,74.0,17,1194,6952712.75,123.0,70.23529411764706
17004.0,6,10,2032,5,524,3911.25,252.0,104.8,5,1508,3794.5,1236.0,301.6
32417.0,6,14,4740,7,653,5246.5,249.0,93.28571428571428,7,4087,5213.166666666667,1514.0,583.8571428571429
1698.0,17,2,684,1,342,0.0,342.0,342.0,1,342,0.0,342.0,342.0
24141.0,6,11,2098,6,590,4317.8,252.0,98.33333333333331,5,1508,4981.0,1236.0,301.6
92853.0,17,2,762,2,762,0.0,381.0,381.0,0,0,0.0,0.0,0.0
0.0,17,1,342,1,342,0.0,342.0,342.0,0,0,0.0,0.0,0.0
104394324.0,17,15,5130,15,5130,7456737.428571428,342.0,342.0,0,0,0.0,0.0,0.0
136666.0,6,2,132,1,66,0.0,66.0,66.0,1,66,0.0,66.0,66.0
108105736.0,17,5,955,5,955,27026434.0,191.0,191.0,0,0,0.0,0.0,0.0
102984082.0,6,42,2772,21,1386,5135442.9,66.0,66.0,21,1386,5135451.6,66.0,66.0
31099.0,6,10,2032,5,524,7516.25,252.0,104.8,5,1508,7517.75,1236.0,301.6
275688.0,17,2,238,1,74,0.0,74.0,74.0,1,164,0.0,164.0,164.0
27414.0,6,10,2032,5,524,6620.5,252.0,104.8,5,1508,6025.25,1236.0,301.6
120124996.0,6,14,2240,8,1016,17137648.14285714,188.0,127.0,6,1224,18017678.0,204.0,204.0
28736.0,6,14,4740,7,653,2952.6666666666665,249.0,93.28571428571428,7,4087,4562.333333333333,1514.0,583.8571428571429
121037014.0,6,31,2034,16,1086,8069134.266666667,123.0,67.875,15,948,7916766.857142857,123.0,63.2
228551.0,17,2,180,1,90,0.0,90.0,90.0,1,90,0.0,90.0,90.0
120071260.0,17,28,13364,28,13364,4447083.703703703,501.0,477.2857142857143,0,0,0.0,0.0,0.0
96719920.0,17,12,778,6,389,19343984.0,174.0,64.83333333333333,6,389,19151279.0,174.0,64.83333333333333
108109938.0,17,5,1005,5,1005,27027484.5,201.0,201.0,0,0,0.0,0.0,0.0
1168240.0,6,13,3010,8,2382,166891.42857142858,1514.0,297.75,5,628,223103.75,331.0,125.6
264908.0,6,3,337,2,214,0.0,160.0,107.0,1,123,0.0,123.0,123.0
120002135.0,6,21,1626,10,786,13333570.555555556,95.0,78.6,11,840,9001322.9,95.0,76.36363636363636
5825939.0,6,5,336,2,134,0.0,68.0,67.0,3,202,1524717.5,70.0,67.33333333333333
120121696.0,6,13,2020,9,1204,15015212.0,188.0,133.77777777777777,4,816,30030153.666666668,204.0,204.0
310347.0,6,3,202,2,128,0.0,74.0,64.0,1,74,0.0,74.0,74.0
57147.0,6,14,4740,7,653,9039.0,249.0,93.28571428571428,7,4087,8664.5,1514.0,583.8571428571429
120054295.0,17,29,13785,29,13785,4287653.392857143,501.0,475.3448275862069,0,0,0.0,0.0,0.0
135134422.0,17,6,1146,6,1146,27026884.4,191.0,191.0,0,0,0.0,0.0,0.0
2419196.0,6,49,23728,25,19797,100799.83333333331,1514.0,791.88,24,3931,95457.65217391304,1514.0,163.79166666666666
833.0,17,4,438,2,148,0.0,74.0,74.0,2,290,0.0,147.0,145.0
153462.0,17,2,180,1,90,0.0,90.0,90.0,1,90,0.0,90.0,90.0
48686.0,6,10,2032,5,524,11526.0,252.0,104.8,5,1508,11897.75,1236.0,301.6
116336611.0,6,48,3168,24,1584,5058113.521739131,66.0,66.0,24,1584,5048718.695652174,66.0,66.0
119605157.0,6,21,1585,10,745,13289461.888888888,95.0,74.5,11,840,11935031.8,95.0,76.36363636363636
2799303.0,6,2,132,1,66,0.0,66.0,66.0,1,66,0.0,66.0,66.0
105749.0,17,2,700,2,700,0.0,350.0,350.0,0,0,0.0,0.0,0.0
300586.0,6,6,412,4,272,100195.33333333331,74.0,68.0,2,140,0.0,74.0,70.0
90038446.0,17,28,13364,28,13364,3334757.25925926,501.0,477.2857142857143,0,0,0.0,0.0,0.0
1444.0,17,4,438,2,148,0.0,74.0,74.0,2,290,0.0,147.0,145.0
27069065.0,17,5,1710,5,1710,6767266.25,342.0,342.0,0,0,0.0,0.0,0.0
1009171.0,17,5,961,3,234,504396.0,78.0,78.0,2,727,0.0,395.0,363.5
135134723.0,17,6,1206,6,1206,27026944.6,201.0,201.0,0,0,0.0,0.0,0.0
146452.0,6,3,337,2,214,0.0,160.0,107.0,1,123,0.0,123.0,123.0
120728302.0,6,19,1477,9,732,15091037.75,95.0,81.33333333333333,10,745,13305390.777777778,95.0,74.5
3181743.0,6,18,1495,9,921,358387.75,315.0,102.33333333333331,9,574,358356.625,78.0,63.77777777777778
90751951.0,6,168,18996,84,5778,1074368.060240964,140.0,68.78571428571429,84,13218,1083484.4457831325,284.0,157.35714285714286
100010656.0,17,12,778,6,389,20002131.2,174.0,64.83333333333333,6,389,19879286.6,174.0,64.83333333333333
121250.0,6,3,337,2,214,0.0,160.0,107.0,1,123,0.0,123.0,123.0
205665.0,17,2,180,1,90,0.0,90.0,90.0,1,90,0.0,90.0,90.0
208745.0,6,10,1221,6,636,41749.0,298.0,106.0,4,585,68074.66666666667,379.0,146.25
91294905.0,6,240,27490,120,19348,765366.1344537815,390.0,161.23333333333332,120,8142,765366.0336134454,140.0,67.85
146314.0,6,3,337,2,214,0.0,160.0,107.0,1,123,0.0,123.0,123.0
122530414.0,6,49,3234,25,1650,5105433.916666667,66.0,66.0,24,1584,4889738.434782608,66.0,66.0
37257.0,6,10,2032,5,524,9086.5,252.0,104.8,5,1508,8946.5,1236.0,301.6
108090264.0,17,5,955,5,955,27022566.0,191.0,191.0,0,0,0.0,0.0,0.0
309831.0,17,4,1400,4,1400,103277.0,350.0,350.0,0,0,0.0,0.0,0.0
0.0,6,1,66,1,66,0.0,66.0,66.0,0,0,0.0,0.0,0.0
28891.0,6,14,4740,7,653,4632.666666666667,249.0,93.28571428571428,7,4087,4242.333333333333,1514.0,583.8571428571429
115565395.0,6,230,26022,115,18198,1011841.2631578948,284.0,158.24347826086955,115,7824,1011844.3157894736,140.0,68.03478260869565
135131979.0,17,6,1206,6,1206,27026395.8,201.0,201.0,0,0,0.0,0.0,0.0
23582.0,6,10,2032,5,524,5678.0,252.0,104.8,5,1508,4820.0,1236.0,301.6
197234.0,17,2,180,1,90,0.0,90.0,90.0,1,90,0.0,90.0,90.0
2118.0,17,4,344,2,150,0.0,75.0,75.0,2,194,0.0,103.0,97.0
108106311.0,17,5,955,5,955,27026577.75,191.0,191.0,0,0,0.0,0.0,0.0
37451.0,6,14,4740,7,653,6126.666666666667,249.0,93.28571428571428,7,4087,6105.333333333333,1514.0,583.8571428571429
36443.0,6,14,4740,7,653,5692.666666666667,249.0,93.28571428571428,7,4087,5932.166666666667,1514.0,583.8571428571429
35406.0,6,14,4740,7,653,4229.0,249.0,93.28571428571428,7,4087,5763.666666666667,1514.0,583.8571428571429
111471101.0,6,222,25158,111,17536,1011452.4363636364,284.0,157.981981981982,111,7622,1011453.0363636364,140.0,68.66666666666667
1722248.0,6,38,23072,20,1476,90644.63157894736,214.0,73.8,18,21596,101023.5294117647,1514.0,1199.7777777777778
41810.0,6,10,2032,5,524,10233.75,252.0,104.8,5,1508,8477.25,1236.0,301.6
30230.0,6,14,4740,7,653,4360.5,249.0,93.28571428571428,7,4087,4791.166666666667,1514.0,583.8571428571429
310093.0,17,4,1400,4,1400,103364.33333333331,350.0,350.0,0,0,0.0,0.0,0.0
197071.0,17,2,180,1,90,0.0,90.0,90.0,1,90,0.0,90.0,90.0
3006956.0,6,11,2106,6,598,601223.0,252.0,99.66666666666669,5,1508,1665.5,1236.0,301.6
153537.0,17,2,180,1,90,0.0,90.0,90.0,1,90,0.0,90.0,90.0
460411.0,6,3,1604,2,851,0.0,785.0,425.5,1,753,0.0,753.0,753.0
27413806.0,17,5,1710,5,1710,6853451.5,342.0,342.0,0,0,0.0,0.0,0.0
269183.0,17,2,180,1,90,0.0,90.0,90.0,1,90,0.0,90.0,90.0
38393.0,6,10,2032,5,524,8234.25,252.0,104.8,5,1508,7708.0,1236.0,301.6
108107896.0,17,5,1005,5,1005,27026974.0,201.0,201.0,0,0,0.0,0.0,0.0
215344.0,6,10,1221,6,636,43068.8,298.0,106.0,4,585,70532.0,379.0,146.25
0.0,17,1,55,1,55,0.0,55.0,55.0,0,0,0.0,0.0,0.0
2599237.0,6,2,132,1,66,0.0,66.0,66.0,1,66,0.0,66.0,66.0
2383.0,17,2,664,1,322,0.0,322.0,322.0,1,342,0.0,342.0,342.0
1242614.0,6,7,499,4,301,400609.0,103.0,75.25,3,198,614675.0,66.0,66.0
118677243.0,6,34,2466,17,1194,7417300.75,123.0,70.23529411764706,17,1272,6953347.5625,123.0,74.82352941176471
3177727.0,6,18,1495,9,921,358681.375,315.0,102.33333333333331,9,574,358656.5,78.0,63.77777777777778
108106077.0,17,5,955,5,955,27026519.25,191.0,191.0,0,0,0.0,0.0,0.0
120337395.0,6,219,24802,110,17312,1104012.7981651376,284.0,157.38181818181818,109,7490,1087480.2037037036,140.0,68.71559633027523
6107865.0,17,6,2100,6,2100,1221573.0,350.0,350.0,0,0,0.0,0.0,0.0
113168560.0,6,46,3036,23,1518,5144014.545454546,66.0,66.0,23,1518,5144012.954545454,66.0,66.0
108339416.0,6,208,23536,104,16376,1049749.912621359,284.0,157.46153846153845,104,7160,1049749.786407767,140.0,68.84615384615384
90746326.0,6,17,1287,9,691,11336962.75,95.0,76.77777777777777,8,596,12963366.714285716,95.0,74.5
307177.0,6,6,412,4,272,102392.33333333331,74.0,68.0,2,140,0.0,74.0,70.0
96129078.0,6,64,15386,33,6191,3004033.6875,1514.0,187.6060606060606,31,9195,3195508.9,1514.0,296.61290322580646
281708.0,17,2,363,1,79,0.0,79.0,79.0,1,284,0.0,284.0,284.0
59604.0,6,14,4740,7,653,9572.166666666666,249.0,93.28571428571428,7,4087,6667.833333333333,1514.0,583.8571428571429
311.0,17,2,166,1,75,0.0,75.0,75.0,1,91,0.0,91.0,91.0
313541.0,17,4,1400,4,1400,104513.66666666669,350.0,350.0,0,0,0.0,0.0,0.0
867.0,17,4,438,2,148,0.0,74.0,74.0,2,290,0.0,147.0,145.0
307337.0,6,6,412,4,272,102445.66666666669,74.0,68.0,2,140,0.0,74.0,70.0
90739562.0,6,17,1287,9,691,11337009.25,95.0,76.77777777777777,8,596,12961069.57142857,95.0,74.5
36675.0,6,14,4740,7,653,5932.0,249.0,93.28571428571428,7,4087,5305.0,1514.0,583.8571428571429
329465.0,17,2,180,1,90,0.0,90.0,90.0,1,90,0.0,90.0,90.0
36954.0,6,14,4740,7,653,6032.833333333333,249.0,93.28571428571428,7,4087,5549.833333333333,1514.0,583.8571428571429
127766908.0,6,31,2034,16,1086,8517793.866666667,123.0,67.875,15,948,8397601.785714285,123.0,63.2
90262783.0,6,12,1832,8,1016,12894683.285714284,188.0,127.0,4,816,30032677.666666668,204.0,204.0
1306525.0,6,4,264,2,132,0.0,66.0,66.0,2,132,0.0,66.0,66.0
2574104.0,6,2,132,1,66,0.0,66.0,66.0,1,66,0.0,66.0,66.0
851148.0,6,9,1196,6,725,170229.6,387.0,120.83333333333331,3,471,289191.5,331.0,157.0
4311.0,17,2,762,2,762,0.0,381.0,381.0,0,0,0.0,0.0,0.0
51308.0,6,14,4740,7,653,7310.0,249.0,93.28571428571428,7,4087,7564.5,1514.0,583.8571428571429
838626.0,6,9,1118,6,586,167725.2,248.0,97.66666666666669,3,532,282864.0,392.0,177.33333333333334
142165.0,6,2,132,1,66,0.0,66.0,66.0,1,66,0.0,66.0,66.0
255439.00000000003,6,3,337,2,214,0.0,160.0,107.0,1,123,0.0,123.0,123.0
108117287.0,17,5,1005,5,1005,27029321.75,201.0,201.0,0,0,0.0,0.0,0.0
100109485.0,17,12,778,6,389,19990108.0,174.0,64.83333333333333,6,389,19947173.6,174.0,64.83333333333333
439070.0,17,2,363,1,75,0.0,75.0,75.0,1,288,0.0,288.0,288.0
382334.0,17,2,363,1,75,0.0,75.0,75.0,1,288,0.0,288.0,288.0
29205.0,6,11,2098,6,590,5393.0,252.0,98.33333333333331,5,1508,6719.5,1236.0,301.6
127248901.0,6,35,2542,17,1194,7329000.6875,123.0,70.23529411764706,18,1348,6897895.823529412,139.0,74.88888888888889
10861.0,6,10,1067,5,536,2468.5,264.0,107.2,5,531,2463.0,259.0,106.2
162182.0,17,2,180,1,90,0.0,90.0,90.0,1,90,0.0,90.0,90.0
254624.00000000003,6,10,1221,6,636,50924.8,298.0,106.0,4,585,82236.0,379.0,146.25
3366430.0,6,7,923,4,753,1050185.6666666667,571.0,188.25,3,170,1575154.5,62.0,56.66666666666666
166722.0,17,2,180,1,90,0.0,90.0,90.0,1,90,0.0,90.0,90.0
97013760.0,17,14,1126,7,563,16166803.833333334,174.0,80.42857142857143,7,563,16168050.833333334,174.0,80.42857142857143
35304.0,6,14,4740,7,653,4934.0,249.0,93.28571428571428,7,4087,4820.666666666667,1514.0,583.8571428571429
243798.0,6,3,337,2,214,0.0,160.0,107.0,1,123,0.0,123.0,123.0
35961.0,6,14,4740,7,653,5056.333333333333,249.0,93.28571428571428,7,4087,5593.333333333333,1514.0,583.8571428571429
90302593.0,6,16,1192,8,596,12893947.57142857,95.0,74.5,8,596,12898860.0,95.0,74.5
2829457.0,6,11,2106,6,598,565722.8,252.0,99.66666666666669,5,1508,2157.75,1236.0,301.6
211409.0,6,3,426,2,280,0.0,214.0,140.0,1,146,0.0,146.0,146.0
26831.0,6,10,2032,5,524,6412.75,252.0,104.8,5,1508,6439.0,1236.0,301.6
101862.0,17,2,762,2,762,0.0,381.0,381.0,0,0,0.0,0.0,0.0
2902836.0,6,11,2106,6,598,580383.4,252.0,99.66666666666669,5,1508,2002.75,1236.0,301.6
108107820.0,17,5,955,5,955,27026955.0,191.0,191.0,0,0,0.0,0.0,0.0
90048910.0,17,28,13364,28,13364,3335144.814814815,501.0,477.2857142857143,0,0,0.0,0.0,0.0
100000895.0,17,13,1083,7,563,16666815.833333334,174.0,80.42857142857143,6,520,16000513.2,174.0,86.66666666666667
0.0,6,1,66,1,66,0.0,66.0,66.0,0,0,0.0,0.0,0.0
16663.0,6,13,1459,7,862,2588.0,271.0,123.14285714285714,6,597,2677.2,259.0,99.5
60516.0,6,10,2032,5,524,14743.5,252.0,104.8,5,1508,14861.5,1236.0,301.6
333.0,17,2,208,1,72,0.0,72.0,72.0,1,136,0.0,136.0,136.0
44879.0,6,10,1066,5,490,9984.75,218.0,98.0,5,576,10954.0,304.0,115.2
313282.0,17,4,1400,4,1400,104427.33333333331,350.0,350.0,0,0,0.0,0.0,0.0
120029334.0,6,338,38876,169,27426,713172.3571428572,300.0,162.2840236686391,169,11450,713172.7797619047,140.0,67.75147928994083
98278.0,17,2,286,2,286,0.0,143.0,143.0,0,0,0.0,0.0,0.0
103311.0,17,2,286,2,286,0.0,143.0,143.0,0,0,0.0,0.0,0.0
300173.0,6,6,412,4,272,100057.66666666669,74.0,68.0,2,140,0.0,74.0,70.0
108101496.0,17,5,955,5,955,27025374.0,191.0,191.0,0,0,0.0,0.0,0.0
56367.0,6,14,4740,7,653,9028.5,249.0,93.28571428571428,7,4087,7930.5,1514.0,583.8571428571429
1306997.0,6,4,264,2,132,0.0,66.0,66.0,2,132,0.0,66.0,66.0
2045.0,17,4,344,2,150,0.0,75.0,75.0,2,194,0.0,103.0,97.0
2301.0,17,4,344,2,150,0.0,75.0,75.0,2,194,0.0,103.0,97.0
56466.0,6,14,4740,7,653,9280.333333333334,249.0,93.28571428571428,7,4087,9250.0,1514.0,583.8571428571429
47239.0,6,2,132,1,66,0.0,66.0,66.0,1,66,0.0,66.0,66.0
1303143.0,6,4,264,2,132,0.0,66.0,66.0,2,132,0.0,66.0,66.0
59972.0,6,14,4740,7,653,7326.833333333333,249.0,93.28571428571428,7,4087,9787.166666666666,1514.0,583.8571428571429
120055971.0,17,29,13785,29,13785,4287713.25,501.0,475.3448275862069,0,0,0.0,0.0,0.0
284650.0,17,2,363,1,79,0.0,79.0,79.0,1,284,0.0,284.0,284.0
113985022.0,6,203,22914,102,7028,1128564.5742574255,140.0,68.90196078431373,101,15886,1129601.33,374.0,157.2871287128713
130632.0,6,3,337,2,214,0.0,160.0,107.0,1,123,0.0,123.0,123.0
2280.0,17,4,344,2,150,0.0,75.0,75.0,2,194,0.0,103.0,97.0
143881.0,17,2,180,1,90,0.0,90.0,90.0,1,90,0.0,90.0,90.0
541.0,17,2,508,2,508,0.0,257.0,254.0,0,0,0.0,0.0,0.0
1306906.0,6,4,264,2,132,0.0,66.0,66.0,2,132,0.0,66.0,66.0
217793.0,6,3,426,2,280,0.0,214.0,140.0,1,146,0.0,146.0,146.0
32266.000000000004,6,10,2032,5,524,7404.25,252.0,104.8,5,1508,7781.5,1236.0,301.6
207888.0,6,3,426,2,280,0.0,214.0,140.0,1,146,0.0,146.0,146.0
255440.0,6,3,337,2,214,0.0,160.0,107.0,1,123,0.0,123.0,123.0
8899.0,17,2,582,1,83,0.0,83.0,83.0,1,499,0.0,499.0,499.0
232906.0,6,3,337,2,214,0.0,160.0,107.0,1,123,0.0,123.0,123.0
27481.0,6,14,4740,7,653,4242.666666666667,249.0,93.28571428571428,7,4087,4414.166666666667,1514.0,583.8571428571429
75048267.0,6,9,842,9,842,9381033.375,97.0,93.55555555555556,0,0,0.0,0.0,0.0
11409.0,17,4,438,2,148,0.0,74.0,74.0,2,290,0.0,147.0,145.0
120128116.0,6,14,2086,9,1204,15016014.5,188.0,133.77777777777777,5,882,22533156.0,204.0,176.4
316104.0,6,6,412,4,272,105368.0,74.0,68.0,2,140,0.0,74.0,70.0
10511799.0,6,7,478,4,272,3458662.6666666665,74.0,68.0,3,206,5187866.5,74.0,68.66666666666667
41041.0,6,14,4740,7,653,6714.0,249.0,93.28571428571428,7,4087,6367.0,1514.0,583.8571428571429
1591337.0,6,41,27673,20,1478,83754.57894736843,216.0,73.9,21,26195,79371.25,1514.0,1247.3809523809523
2334.0,17,4,344,2,150,0.0,75.0,75.0,2,194,0.0,103.0,97.0
196980.0,17,2,180,1,90,0.0,90.0,90.0,1,90,0.0,90.0,90.0
0.0,17,1,55,1,55,0.0,55.0,55.0,0,0,0.0,0.0,0.0
826.0,17,4,438,2,148,0.0,74.0,74.0,2,290,0.0,147.0,145.0
301568.0,17,2,246,1,76,0.0,76.0,76.0,1,170,0.0,170.0,170.0
57785.0,6,14,4740,7,653,9387.166666666666,249.0,93.28571428571428,7,4087,9197.666666666666,1514.0,583.8571428571429
199849.0,17,4,6056,4,6056,66616.33333333333,1514.0,1514.0,0,0,0.0,0.0,0.0
213605.0,17,2,180,1,90,0.0,90.0,90.0,1,90,0.0,90.0,90.0
9728.0,17,2,571,1,86,0.0,86.0,86.0,1,485,0.0,485.0,485.0
90024730.0,17,28,13364,28,13364,3334249.25925926,501.0,477.2857142857143,0,0,0.0,0.0,0.0
5832977.0,6,5,336,2,134,0.0,68.0,67.0,3,202,1526939.0,70.0,67.33333333333333
2427.0,17,4,344,2,150,0.0,75.0,75.0,2,194,0.0,103.0,97.0
220823.0,17,2,493,1,88,0.0,88.0,88.0,1,405,0.0,405.0,405.0
169824.0,17,2,180,1,90,0.0,90.0,90.0,1,90,0.0,90.0,90.0
510283.00000000006,6,5,336,2,134,0.0,68.0,67.0,3,202,192255.5,70.0,67.33333333333333
90792.0,6,12,1320,7,789,15132.0,253.0,112.71428571428572,5,531,21108.5,259.0,106.2
16902.0,17,2,180,1,90,0.0,90.0,90.0,1,90,0.0,90.0,90.0
108101650.0,17,5,955,5,955,27025412.5,191.0,191.0,0,0,0.0,0.0,0.0
1417519.0,17,6,1230,3,234,708569.5,78.0,78.0,3,996,708555.5,332.0,332.0
2575317.0,6,2,132,1,66,0.0,66.0,66.0,1,66,0.0,66.0,66.0
1472756.0,17,16,1120,16,1120,98183.73333333334,70.0,70.0,0,0,0.0,0.0,0.0
83.0,17,2,762,2,762,0.0,381.0,381.0,0,0,0.0,0.0,0.0
298948.0,6,6,412,4,272,99649.33333333331,74.0,68.0,2,140,0.0,74.0,70.0
45439.0,6,13,1386,7,789,7573.166666666667,253.0,112.71428571428572,6,597,4804.4,259.0,99.5
304130.0,6,3,202,2,128,0.0,74.0,64.0,1,74,0.0,74.0,74.0
2313.0,17,4,344,2,150,0.0,75.0,75.0,2,194,0.0,103.0,97.0
119652839.0,6,222,24978,111,17356,1085797.4636363636,284.0,156.36036036036035,111,7622,1085797.0636363635,140.0,68.66666666666667
10510528.0,6,7,478,4,272,3458076.333333333,74.0,68.0,3,206,5186995.5,74.0,68.66666666666667
3179159.0,6,18,1495,9,921,358359.125,315.0,102.33333333333331,9,574,358304.625,78.0,63.77777777777778
660666.0,6,10,1065,5,534,164181.25,262.0,106.8,5,531,164768.25,259.0,106.2
27118.0,6,14,4740,7,653,3935.6666666666665,249.0,93.28571428571428,7,4087,4299.5,1514.0,583.8571428571429
90302719.0,6,17,1287,9,691,11281682.75,95.0,76.77777777777777,8,596,12899374.42857143,95.0,74.5
108727400.0,6,33,2412,17,1272,6781960.75,123.0,74.82352941176471,16,1140,7234092.933333334,123.0,71.25
500812.00000000006,6,5,336,2,134,0.0,68.0,67.0,3,202,191063.5,70.0,67.33333333333333
39425.0,6,12,1413,7,882,6570.833333333333,291.0,126.0,5,531,8446.5,259.0,106.2
2805042.0,6,2,132,1,66,0.0,66.0,66.0,1,66,0.0,66.0,66.0
8904313.0,17,4,1376,3,1026,929527.0,342.0,342.0,1,350,0.0,350.0,350.0
2363.0,17,4,344,2,150,0.0,75.0,75.0,2,194,0.0,103.0,97.0
108111082.0,17,5,955,5,955,27027770.5,191.0,191.0,0,0,0.0,0.0,0.0
105090512.0,6,21,1636,11,932,10509051.2,154.0,84.72727272727273,10,704,11643900.222222222,95.0,70.4
12013738.0,17,3,1026,3,1026,6006868.999999999,342.0,342.0,0,0,0.0,0.0,0.0
148042.0,17,2,180,1,90,0.0,90.0,90.0,1,90,0.0,90.0,90.0
281082.0,17,2,414,1,88,0.0,88.0,88.0,1,326,0.0,326.0,326.0
38209.0,6,10,2032,5,524,9347.5,252.0,104.8,5,1508,9170.0,1236.0,301.6
41940.0,6,14,4740,7,653,6754.833333333333,249.0,93.28571428571428,7,4087,6812.333333333333,1514.0,583.8571428571429
3007099.0,6,12,2172,7,664,501123.3333333333,252.0,94.85714285714286,5,1508,1870.5,1236.0,301.6
2437.0,17,4,344,2,150,0.0,75.0,75.0,2,194,0.0,103.0,97.0
114370714.0,6,312,37022,156,26430,736486.9483870968,336.0,169.42307692307693,156,10592,736487.270967742,140.0,67.8974358974359
90385454.0,6,1896,1750460,1381,1716458,65490.54782608696,1514.0,1242.909485879797,515,34002,175828.05058365758,78.0,66.02330097087379
103961829.0,6,211,23696,106,7292,990112.6571428572,140.0,68.79245283018868,105,16404,989788.4423076924,284.0,156.22857142857143
316909.0,6,3,202,2,128,0.0,74.0,64.0,1,74,0.0,74.0,74.0
209188.0,6,3,426,2,280,0.0,214.0,140.0,1,146,0.0,146.0,146.0
78.0,17,2,762,2,762,0.0,381.0,381.0,0,0,0.0,0.0,0.0
44683.0,6,14,4740,7,653,6900.666666666667,249.0,93.28571428571428,7,4087,7076.833333333333,1514.0,583.8571428571429
302529.0,6,6,412,4,272,100843.0,74.0,68.0,2,140,0.0,74.0,70.0
103361.0,17,2,286,2,286,0.0,143.0,143.0,0,0,0.0,0.0,0.0
135137277.0,17,6,1206,6,1206,27027455.4,201.0,201.0,0,0,0.0,0.0,0.0
55079.0,6,14,4740,7,653,9054.166666666666,249.0,93.28571428571428,7,4087,8455.0,1514.0,583.8571428571429
749365.0,17,2,333,1,87,0.0,87.0,87.0,1,246,0.0,246.0,246.0
35446.0,6,11,2098,6,590,6914.8,252.0,98.33333333333331,5,1508,8583.25,1236.0,301.6
5823802.0,6,4,270,2,134,0.0,68.0,67.0,2,136,0.0,70.0,68.0
216746.0,6,3,426,2,280,0.0,214.0,140.0,1,146,0.0,146.0,146.0
41240.0,6,10,2032,5,524,10056.5,252.0,104.8,5,1508,9422.25,1236.0,301.6
112481405.0,17,15,1169,8,606,16045952.57142857,174.0,75.75,7,563,17336598.0,174.0,80.42857142857143
5833641.0,6,4,270,2,134,0.0,68.0,67.0,2,136,0.0,70.0,68.0
90255088.0,6,13,2036,8,1016,12893584.0,188.0,127.0,5,1020,22522525.0,204.0,204.0
197601.0,17,2,180,1,90,0.0,90.0,90.0,1,90,0.0,90.0,90.0
561.0,17,2,508,2,508,0.0,257.0,254.0,0,0,0.0,0.0,0.0
32513.0,6,14,4740,7,653,4441.0,249.0,93.28571428571428,7,4087,5263.166666666667,1514.0,583.8571428571429
833.0,17,4,438,2,148,0.0,74.0,74.0,2,290,0.0,147.0,145.0
108107082.0,17,5,1005,5,1005,27026770.5,201.0,201.0,0,0,0.0,0.0,0.0
659521.0,6,11,1131,6,600,131740.0,262.0,100.0,5,531,164390.75,259.0,106.2
35606.0,6,14,4740,7,653,5307.5,249.0,93.28571428571428,7,4087,5234.166666666667,1514.0,583.8571428571429
205890.0,17,2,180,1,90,0.0,90.0,90.0,1,90,0.0,90.0,90.0
233925.0,6,3,373,2,238,0.0,172.0,119.0,1,135,0.0,135.0,135.0
228343.0,17,2,180,1,90,0.0,90.0,90.0,1,90,0.0,90.0,90.0
206213.0,6,3,426,2,280,0.0,214.0,140.0,1,146,0.0,146.0,146.0
2285.0,17,4,344,2,150,0.0,75.0,75.0,2,194,0.0,103.0,97.0
27598.0,6,14,4740,7,653,4456.833333333333,249.0,93.28571428571428,7,4087,4463.666666666667,1514.0,583.8571428571429
108107522.0,17,5,1005,5,1005,27026880.5,201.0,201.0,0,0,0.0,0.0,0.0
2322.0,17,4,344,2,150,0.0,75.0,75.0,2,194,0.0,103.0,97.0
105120804.0,17,15,5130,15,5130,7508628.857142857,342.0,342.0,0,0,0.0,0.0,0.0
39841.0,6,10,2032,5,524,9674.5,252.0,104.8,5,1508,8850.25,1236.0,301.6
0.0,17,1,381,1,381,0.0,381.0,381.0,0,0,0.0,0.0,0.0
150031.0,6,12,1328,7,797,25005.166666666668,253.0,113.85714285714286,5,531,36569.75,259.0,106.2
47608482.0,6,7,1874,3,887,22481878.0,753.0,295.6666666666667,4,987,14944179.0,785.0,246.75
2344.0,17,4,344,2,150,0.0,75.0,75.0,2,194,0.0,103.0,97.0
28557.0,6,14,4740,7,653,4218.666666666667,249.0,93.28571428571428,7,4087,4466.5,1514.0,583.8571428571429
303947.0,6,6,412,4,272,101315.66666666669,74.0,68.0,2,140,0.0,74.0,70.0
135136691.0,17,6,1146,6,1146,27027338.2,191.0,191.0,0,0,0.0,0.0,0.0
108131.0,17,2,700,2,700,0.0,350.0,350.0,0,0,0.0,0.0,0.0
28578.0,6,14,4740,7,653,4605.166666666667,249.0,93.28571428571428,7,4087,4320.666666666667,1514.0,583.8571428571429
135141329.0,17,6,1146,6,1146,27028265.8,191.0,191.0,0,0,0.0,0.0,0.0
300874.0,6,6,412,4,272,100291.33333333331,74.0,68.0,2,140,0.0,74.0,70.0
5612856.0,6,5,336,2,134,0.0,68.0,67.0,3,202,1422451.0,70.0,67.33333333333333
102669.0,17,2,286,2,286,0.0,143.0,143.0,0,0,0.0,0.0,0.0
27891.0,6,10,2032,5,524,6696.25,252.0,104.8,5,1508,5887.25,1236.0,301.6
232867.0,6,3,337,2,214,0.0,160.0,107.0,1,123,0.0,123.0,123.0
120134208.0,6,476,58980,238,16004,503926.1223628692,140.0,67.24369747899159,238,42976,506812.64556962025,464.0,180.57142857142856
215097.0,17,2,762,2,762,0.0,381.0,381.0,0,0,0.0,0.0,0.0
298.0,17,2,168,1,76,0.0,76.0,76.0,1,92,0.0,92.0,92.0
164724.0,17,2,414,1,88,0.0,88.0,88.0,1,326,0.0,326.0,326.0
1306995.0,6,4,264,2,132,0.0,66.0,66.0,2,132,0.0,66.0,66.0
108103182.0,17,5,1005,5,1005,27025795.5,201.0,201.0,0,0,0.0,0.0,0.0
117269281.0,6,47,3102,24,1584,5085249.304347826,66.0,66.0,23,1518,5150444.863636363,66.0,66.0
90255708.0,6,12,1832,8,1016,12893672.57142857,188.0,127.0,4,816,30030361.33333333,204.0,204.0
1514760.0,6,20,7599,11,1469,151476.0,583.0,133.54545454545453,9,6130,157215.625,1484.0,681.1111111111111
196985.0,17,2,180,1,90,0.0,90.0,90.0,1,90,0.0,90.0,90.0
49370.0,6,12,1328,6,731,8510.4,253.0,121.83333333333331,6,597,8127.2,259.0,99.5
102999.0,17,2,286,2,286,0.0,143.0,143.0,0,0,0.0,0.0,0.0
307.0,17,2,174,1,79,0.0,79.0,79.0,1,95,0.0,95.0,95.0
308504.0,6,6,412,4,272,102834.66666666669,74.0,68.0,2,140,0.0,74.0,70.0
310478.0,17,4,1400,4,1400,103492.66666666669,350.0,350.0,0,0,0.0,0.0,0.0
506946.0,6,5,336,2,134,0.0,68.0,67.0,3,202,194944.0,70.0,67.33333333333333
214562.0,17,2,359,1,75,0.0,75.0,75.0,1,284,0.0,284.0,284.0
37701.0,6,13,1386,7,789,5637.0,253.0,112.71428571428572,6,597,5579.0,259.0,99.5
107380.0,17,6,1230,3,234,53510.0,78.0,78.0,3,996,53485.0,332.0,332.0
16209.999999999998,6,14,4740,7,653,2494.333333333333,249.0,93.28571428571428,7,4087,2569.0,1514.0,583.8571428571429
2051.0,17,4,344,2,150,0.0,75.0,75.0,2,194,0.0,103.0,97.0
38139.0,6,14,4740,7,653,6062.833333333333,249.0,93.28571428571428,7,4087,5966.833333333333,1514.0,583.8571428571429
90303656.0,6,16,1192,8,596,12893459.142857144,95.0,74.5,8,596,12900058.285714284,95.0,74.5
838879.0,6,9,1096,6,625,167775.8,287.0,104.16666666666669,3,471,283067.5,331.0,157.0
135127890.0,17,6,1206,6,1206,27025578.0,201.0,201.0,0,0,0.0,0.0,0.0
206075.0,6,3,426,2,280,0.0,214.0,140.0,1,146,0.0,146.0,146.0
3846707.0,6,69,64911,24,1753,167248.13043478262,215.0,73.04166666666667,45,63158,87236.81818181818,1514.0,1403.5111111111112
4330.0,17,2,602,1,72,0.0,72.0,72.0,1,530,0.0,530.0,530.0
135146805.0,17,6,1146,6,1146,27029361.0,191.0,191.0,0,0,0.0,0.0,0.0
35055.0,6,14,4740,7,653,5674.333333333333,249.0,93.28571428571428,7,4087,5038.333333333333,1514.0,583.8571428571429
90366899.0,6,12,1848,7,828,15061149.833333334,188.0,118.28571428571428,5,1020,15083883.0,204.0,204.0
120124707.0,6,14,2224,9,1204,15015588.375,188.0,133.77777777777777,5,1020,22591698.0,204.0,204.0
315775.0,17,4,1400,4,1400,105258.33333333331,350.0,350.0,0,0,0.0,0.0,0.0
1721692.0,6,19,7533,10,1403,191299.11111111112,583.0,140.3,9,6130,182794.5,1484.0,681.1111111111111
271620.0,6,10,1221,6,636,54324.0,298.0,106.0,4,585,82980.0,379.0,146.25
14141.0,6,10,1067,5,536,3306.0,264.0,107.2,5,531,3077.75,259.0,106.2
147096.0,6,3,373,2,238,0.0,172.0,119.0,1,135,0.0,135.0,135.0
118455900.0,6,216,24440,108,17090,1105053.0373831776,284.0,158.24074074074073,108,7350,1105052.887850467,140.0,68.05555555555556
91879720.0,6,24,1632,12,846,8333069.818181818,123.0,70.5,12,786,8333084.909090909,123.0,65.5
2219.0,17,2,664,1,322,0.0,322.0,322.0,1,342,0.0,342.0,342.0
331626.0,6,2,132,1,66,0.0,66.0,66.0,1,66,0.0,66.0,66.0
285012.0,17,2,363,1,79,0.0,79.0,79.0,1,284,0.0,284.0,284.0
104203.0,17,2,700,2,700,0.0,350.0,350.0,0,0,0.0,0.0,0.0
90016527.0,17,25,11961,25,11961,3750688.625,501.0,478.44,0,0,0.0,0.0,0.0
1840713.0,17,2,896,2,896,0.0,453.0,448.0,0,0,0.0,0.0,0.0
125993077.0,17,14,864,7,432,17667939.833333332,174.0,61.71428571428572,7,432,17666836.5,174.0,61.71428571428572
47815.0,6,10,2032,5,524,11675.0,252.0,104.8,5,1508,9717.0,1236.0,301.6
92360.0,17,2,762,2,762,0.0,381.0,381.0,0,0,0.0,0.0,0.0
162338.0,17,2,180,1,90,0.0,90.0,90.0,1,90,0.0,90.0,90.0
80188.0,6,13,1386,7,789,13364.666666666666,253.0,112.71428571428572,6,597,15155.4,259.0,99.5
831.0,17,4,438,2,148,0.0,74.0,74.0,2,290,0.0,147.0,145.0
35930.0,6,10,2032,5,524,7585.0,252.0,104.8,5,1508,8724.0,1236.0,301.6
0.0,17,1,55,1,55,0.0,55.0,55.0,0,0,0.0,0.0,0.0
1778558.0,6,2,132,1,66,0.0,66.0,66.0,1,66,0.0,66.0,66.0
894901.0,6,10,1262,6,725,178980.2,387.0,120.83333333333331,4,537,207438.3333333333,331.0,134.25
319.0,17,2,174,1,79,0.0,79.0,79.0,1,95,0.0,95.0,95.0
118575768.0,6,236,26622,118,18612,1011718.6068376068,284.0,157.72881355932202,118,8010,1011718.2905982906,140.0,67.88135593220339
505402.0,6,5,336,2,134,0.0,68.0,67.0,3,202,192862.5,70.0,67.33333333333333
90057830.0,17,27,12943,27,12943,3463762.6923076925,501.0,479.3703703703704,0,0,0.0,0.0,0.0
237944.0,6,3,373,2,238,0.0,172.0,119.0,1,135,0.0,135.0,135.0
90049536.0,17,28,13364,28,13364,3335168.0,501.0,477.2857142857143,0,0,0.0,0.0,0.0
92766.0,6,13,1386,7,789,15461.0,253.0,112.71428571428572,6,597,15927.4,259.0,99.5
813.0,17,4,438,2,148,0.0,74.0,74.0,2,290,0.0,147.0,145.0
868.0,17,5,550,5,550,217.0,110.0,110.0,0,0,0.0,0.0,0.0
349.0,17,2,267,1,83,0.0,83.0,83.0,1,184,0.0,184.0,184.0
310371.0,17,4,622,4,622,103457.0,163.0,155.5,0,0,0.0,0.0,0.0
100583.0,17,2,762,2,762,0.0,381.0,381.0,0,0,0.0,0.0,0.0
108100473.0,17,5,1005,5,1005,27025118.25,201.0,201.0,0,0,0.0,0.0,0.0
1467862.0,17,16,1120,16,1120,97857.46666666666,70.0,70.0,0,0,0.0,0.0,0.0
3659.0,17,2,762,2,762,0.0,381.0,381.0,0,0,0.0,0.0,0.0
201925.0,17,4,6056,4,6056,67308.33333333333,1514.0,1514.0,0,0,0.0,0.0,0.0
8009316.999999999,17,2,684,2,684,0.0,342.0,342.0,0,0,0.0,0.0,0.0
100130327.0,6,178,20094,89,13998,1135400.1022727273,284.0,157.2808988764045,89,6096,1135399.7272727273,140.0,68.49438202247191
139497.0,6,2,132,1,66,0.0,66.0,66.0,1,66,0.0,66.0,66.0
101076140.0,6,31,2182,16,1165,6724026.066666666,139.0,72.8125,15,1017,7204318.0,123.0,67.8
2161.0,17,4,344,2,150,0.0,75.0,75.0,2,194,0.0,103.0,97.0
196557.0,17,4,1524,4,1524,65519.0,381.0,381.0,0,0,0.0,0.0,0.0
306090.0,6,3,202,2,128,0.0,74.0,64.0,1,74,0.0,74.0,74.0
204839.0,17,2,762,2,762,0.0,381.0,381.0,0,0,0.0,0.0,0.0
135132780.0,17,6,1146,6,1146,27026556.0,191.0,191.0,0,0,0.0,0.0,0.0
40477.0,6,10,2032,5,524,9858.25,252.0,104.8,5,1508,9544.75,1236.0,301.6
2779642.0,6,2,132,1,66,0.0,66.0,66.0,1,66,0.0,66.0,66.0
2041702.0,6,25,7065,13,2047,170141.83333333334,575.0,157.46153846153845,12,5018,157380.63636363635,1510.0,418.1666666666667
39266.0,6,14,4740,7,653,6434.0,249.0,93.28571428571428,7,4087,4498.333333333333,1514.0,583.8571428571429
258274.0,6,3,337,2,214,0.0,160.0,107.0,1,123,0.0,123.0,123.0
324208.0,17,4,1400,4,1400,108069.33333333331,350.0,350.0,0,0,0.0,0.0,0.0
128004850.0,6,31,2034,16,1086,8533656.666666666,123.0,67.875,15,948,8415391.42857143,123.0,63.2
21093.0,6,14,4740,7,653,3389.833333333333,249.0,93.28571428571428,7,4087,3380.6666666666665,1514.0,583.8571428571429
5620384.0,6,4,270,2,134,0.0,68.0,67.0,2,136,0.0,70.0,68.0
210379.0,6,3,426,2,280,0.0,214.0,140.0,1,146,0.0,146.0,146.0
748657.0,6,2,132,1,66,0.0,66.0,66.0,1,66,0.0,66.0,66.0
146455.0,6,3,337,2,214,0.0,160.0,107.0,1,123,0.0,123.0,123.0
146703.0,6,3,337,2,214,0.0,160.0,107.0,1,123,0.0,123.0,123.0
223559.0,17,2,180,1,90,0.0,90.0,90.0,1,90,0.0,90.0,90.0
59413.0,6,12,1320,6,723,11469.0,253.0,120.5,6,597,10185.0,259.0,99.5
36735.0,6,14,4740,7,653,5997.166666666667,249.0,93.28571428571428,7,4087,5869.5,1514.0,583.8571428571429
90229354.0,6,18,1503,9,650,11246996.875,95.0,72.22222222222223,9,853,11251763.875,257.0,94.77777777777776
51471.0,6,14,4740,7,653,8332.5,249.0,93.28571428571428,7,4087,7835.333333333333,1514.0,583.8571428571429
37425.0,6,14,4740,7,653,5834.333333333333,249.0,93.28571428571428,7,4087,6036.666666666667,1514.0,583.8571428571429
148036.0,17,2,180,1,90,0.0,90.0,90.0,1,90,0.0,90.0,90.0
31162.0,6,14,4740,7,653,4564.666666666667,249.0,93.28571428571428,7,4087,4633.666666666667,1514.0,583.8571428571429
960497.0,6,12,1362,6,731,190980.8,253.0,121.83333333333331,6,631,190663.0,293.0,105.16666666666669
206945.0,6,3,426,2,280,0.0,214.0,140.0,1,146,0.0,146.0,146.0
238137.0,6,3,337,2,214,0.0,160.0,107.0,1,123,0.0,123.0,123.0
197142.0,17,2,180,1,90,0.0,90.0,90.0,1,90,0.0,90.0,90.0
280630.0,17,2,363,1,79,0.0,79.0,79.0,1,284,0.0,284.0,284.0
2269.0,17,4,344,2,150,0.0,75.0,75.0,2,194,0.0,103.0,97.0
32273.000000000004,6,14,4740,7,653,5252.5,249.0,93.28571428571428,7,4087,4922.0,1514.0,583.8571428571429
301.0,17,2,164,1,82,0.0,82.0,82.0,1,82,0.0,82.0,82.0
18833.0,6,12,1393,6,796,3633.6,271.0,132.66666666666666,6,597,3439.4,259.0,99.5
298969.0,6,6,412,4,272,99656.33333333331,74.0,68.0,2,140,0.0,74.0,70.0
32742.0,6,14,4740,7,653,5280.333333333333,249.0,93.28571428571428,7,4087,5118.166666666667,1514.0,583.8571428571429
28869.0,6,10,2032,5,524,6823.75,252.0,104.8,5,1508,6392.5,1236.0,301.6
251348.00000000003,6,3,373,2,238,0.0,172.0,119.0,1,135,0.0,135.0,135.0
9358.0,17,2,571,1,86,0.0,86.0,86.0,1,485,0.0,485.0,485.0
40170.0,6,2,132,1,66,0.0,66.0,66.0,1,66,0.0,66.0,66.0
2390.0,17,4,344,2,150,0.0,75.0,75.0,2,194,0.0,103.0,97.0
24023456.0,17,3,1026,3,1026,12011728.0,342.0,342.0,0,0,0.0,0.0,0.0
108105344.0,17,5,955,5,955,27026336.0,191.0,191.0,0,0,0.0,0.0,0.0
46789.0,6,14,4740,7,653,7681.0,249.0,93.28571428571428,7,4087,7388.166666666667,1514.0,583.8571428571429
5616424.0,6,5,336,2,134,0.0,68.0,67.0,3,202,1523243.5,70.0,67.33333333333333
319.0,17,2,174,1,79,0.0,79.0,79.0,1,95,0.0,95.0,95.0
2787482.0,6,3,204,2,136,0.0,70.0,68.0,1,68,0.0,68.0,68.0
120958553.0,6,31,2034,16,1086,8063903.533333333,123.0,67.875,15,948,7911257.785714285,123.0,63.2
5619316.0,6,5,336,2,134,0.0,68.0,67.0,3,202,1526115.5,70.0,67.33333333333333
132361284.0,17,14,864,7,432,18833495.166666668,174.0,61.71428571428572,7,432,18834226.166666668,174.0,61.71428571428572
4309.0,17,2,618,1,72,0.0,72.0,72.0,1,546,0.0,546.0,546.0
90737698.0,6,19,1436,10,745,10077217.333333334,95.0,74.5,9,691,11341719.125,95.0,76.77777777777777
2474542.0,6,25,7573,14,3735,190349.38461538465,1514.0,266.7857142857143,11,3838,221596.3,1514.0,348.90909090909093
298176.0,6,6,412,4,272,99392.0,74.0,68.0,2,140,0.0,74.0,70.0
1680360.0,17,18,1260,18,1260,98844.70588235294,70.0,70.0,0,0,0.0,0.0,0.0
246520.0,6,3,337,2,214,0.0,160.0,107.0,1,123,0.0,123.0,123.0
135133337.0,17,6,1146,6,1146,27026667.4,191.0,191.0,0,0,0.0,0.0,0.0
103681339.0,6,28,1876,14,982,7958886.846153846,139.0,70.14285714285714,14,894,7958872.461538462,123.0,63.85714285714285
1453895.0,6,8,602,3,198,204736.5,66.0,66.0,5,404,337678.0,103.0,80.8
90254895.0,6,13,2036,8,1016,12893556.42857143,188.0,127.0,5,1020,22522127.5,204.0,204.0
206766.0,6,3,426,2,280,0.0,214.0,140.0,1,146,0.0,146.0,146.0
159253.0,6,3,337,2,214,0.0,160.0,107.0,1,123,0.0,123.0,123.0
3000910.0,17,2,906,2,906,0.0,453.0,453.0,0,0,0.0,0.0,0.0
121210.0,6,3,337,2,214,0.0,160.0,107.0,1,123,0.0,123.0,123.0
94625661.0,6,20,1653,11,1003,9453524.3,258.0,91.1818181818182,9,650,11827668.375,95.0,72.22222222222223
892.0,17,5,550,5,550,223.0,110.0,110.0,0,0,0.0,0.0,0.0
110063.0,17,2,286,2,286,0.0,143.0,143.0,0,0,0.0,0.0,0.0
116139899.0,17,16,1212,8,606,16568711.142857144,174.0,75.75,8,606,16541436.142857144,174.0,75.75
264343.0,17,4,1400,4,1400,88114.33333333333,350.0,350.0,0,0,0.0,0.0,0.0
110206536.0,6,209,23602,105,7226,1059678.2307692308,140.0,68.81904761904762,104,16376,1059989.2621359224,284.0,157.46153846153845
20077.0,17,2,582,1,83,0.0,83.0,83.0,1,499,0.0,499.0,499.0
123250416.0,6,49,3234,25,1650,5135434.0,66.0,66.0,24,1584,4921086.782608695,66.0,66.0
301889.0,6,6,412,4,272,100629.66666666669,74.0,68.0,2,140,0.0,74.0,70.0
209395.0,6,3,426,2,280,0.0,214.0,140.0,1,146,0.0,146.0,146.0
1018.0,17,4,438,2,148,0.0,74.0,74.0,2,290,0.0,147.0,145.0
101322.0,17,2,762,2,762,0.0,381.0,381.0,0,0,0.0,0.0,0.0
16621.0,6,14,4740,7,653,2474.6666666666665,249.0,93.28571428571428,7,4087,2401.5,1514.0,583.8571428571429
33794.0,6,14,4740,7,653,5495.333333333333,249.0,93.28571428571428,7,4087,5497.166666666667,1514.0,583.8571428571429
115510441.0,6,48,3168,24,1584,5022193.0869565215,66.0,66.0,24,1584,5008722.043478261,66.0,66.0
108099862.0,17,5,955,5,955,27024965.5,191.0,191.0,0,0,0.0,0.0,0.0
284695.0,17,2,363,1,79,0.0,79.0,79.0,1,284,0.0,284.0,284.0
130993.0,6,3,337,2,214,0.0,160.0,107.0,1,123,0.0,123.0,123.0
2795595.0,6,2,132,1,66,0.0,66.0,66.0,1,66,0.0,66.0,66.0
104254.0,17,2,700,2,700,0.0,350.0,350.0,0,0,0.0,0.0,0.0
146085.0,6,3,337,2,214,0.0,160.0,107.0,1,123,0.0,123.0,123.0
855521.0,6,9,1196,6,725,171104.2,387.0,120.83333333333331,3,471,289852.5,331.0,157.0
210334.0,6,3,426,2,280,0.0,214.0,140.0,1,146,0.0,146.0,146.0
11748.0,6,12,1393,6,796,2197.2,271.0,132.66666666666666,6,597,2162.6,259.0,99.5
119499821.0,6,46,3844,26,2143,4779992.84,139.0,82.42307692307692,20,1701,6278683.210526316,123.0,85.05
15085.0,17,2,180,1,90,0.0,90.0,90.0,1,90,0.0,90.0,90.0
51728602.0,6,8,2113,3,960,24539824.0,826.0,320.0,5,1153,12287044.5,885.0,230.6
150185.0,6,13,1386,7,789,25030.83333333333,253.0,112.71428571428572,6,597,27962.8,259.0,99.5
0.0,17,1,381,1,381,0.0,381.0,381.0,0,0,0.0,0.0,0.0
688.0,17,4,438,2,148,0.0,74.0,74.0,2,290,0.0,147.0,145.0
2781405.0,6,2,132,1,66,0.0,66.0,66.0,1,66,0.0,66.0,66.0
122978367.0,6,48,3168,24,1584,5162332.0,66.0,66.0,24,1584,5104894.739130435,66.0,66.0
71363.0,17,2,634,1,82,0.0,82.0,82.0,1,552,0.0,552.0,552.0
3105.0,17,2,224,1,76,0.0,76.0,76.0,1,148,0.0,148.0,148.0
120125638.0,6,13,2020,9,1204,15015704.75,188.0,133.77777777777777,4,816,30033624.33333333,204.0,204.0
180019.0,6,13,1420,7,789,29436.83333333333,253.0,112.71428571428572,6,631,35429.0,293.0,105.16666666666669
50704160.0,6,8,2113,3,960,24023606.0,826.0,320.0,5,1153,12031932.75,885.0,230.6
2809903.0,6,3,1604,1,753,0.0,753.0,753.0,2,851,0.0,785.0,425.5
99190108.0,17,14,1126,7,563,16500176.833333334,174.0,80.42857142857143,7,563,16500923.0,174.0,80.42857142857143
241672.0,6,3,337,2,214,0.0,160.0,107.0,1,123,0.0,123.0,123.0
1036418.0,6,11,1134,6,558,207283.6,220.0,93.0,5,576,256866.0,304.0,115.2
387.0,17,2,762,2,762,0.0,381.0,381.0,0,0,0.0,0.0,0.0
105398639.0,6,44,2904,22,1452,5018982.80952381,66.0,66.0,22,1452,5004284.0,66.0,66.0
233177.0,6,3,373,2,238,0.0,172.0,119.0,1,135,0.0,135.0,135.0
292694.0,6,26,13048,14,1095,22514.92307692308,229.0,78.21428571428571,12,11953,26101.272727272728,1514.0,996.0833333333334
495924.0,6,5,336,2,134,0.0,68.0,67.0,3,202,195742.0,70.0,67.33333333333333
237589.0,17,2,180,1,90,0.0,90.0,90.0,1,90,0.0,90.0,90.0
135162564.0,17,6,1146,6,1146,27032512.8,191.0,191.0,0,0,0.0,0.0,0.0
310603.0,6,3,202,2,128,0.0,74.0,64.0,1,74,0.0,74.0,74.0
108793.0,17,2,286,2,286,0.0,143.0,143.0,0,0,0.0,0.0,0.0
284518.0,17,2,363,1,79,0.0,79.0,79.0,1,284,0.0,284.0,284.0
86033.0,6,10,2032,5,524,21298.5,252.0,104.8,5,1508,19587.75,1236.0,301.6
103614.0,17,2,286,2,286,0.0,143.0,143.0,0,0,0.0,0.0,0.0
99385.0,6,14,4740,7,653,16094.166666666666,249.0,93.28571428571428,7,4087,15705.833333333334,1514.0,583.8571428571429
147821.0,17,2,180,1,90,0.0,90.0,90.0,1,90,0.0,90.0,90.0
19118.0,6,10,1065,5,534,3256.25,262.0,106.8,5,531,4421.75,259.0,106.2
90268951.0,6,14,1043,7,542,15044825.166666666,95.0,77.42857142857143,7,501,14997743.833333334,95.0,71.57142857142857
90526933.0,6,14,2240,8,1016,12932419.0,188.0,127.0,6,1224,18072649.8,204.0,204.0
18309.0,6,14,4740,7,653,2806.5,249.0,93.28571428571428,7,4087,2912.6666666666665,1514.0,583.8571428571429
58714.0,6,14,4740,7,653,9382.333333333334,249.0,93.28571428571428,7,4087,8664.166666666666,1514.0,583.8571428571429
228353.0,17,2,180,1,90,0.0,90.0,90.0,1,90,0.0,90.0,90.0
228548.0,17,2,180,1,90,0.0,90.0,90.0,1,90,0.0,90.0,90.0
108102140.0,17,5,1005,5,1005,27025535.0,201.0,201.0,0,0,0.0,0.0,0.0
16741.0,17,2,180,1,90,0.0,90.0,90.0,1,90,0.0,90.0,90.0
96553934.0,17,13,1083,7,563,16092322.333333334,174.0,80.42857142857143,6,520,15287400.8,174.0,86.66666666666667
259082.0,17,4,820,2,156,0.0,78.0,78.0,2,664,0.0,332.0,332.0
3350472.0,6,3,1777,2,951,0.0,885.0,475.5,1,826,0.0,826.0,826.0
59051.0,6,14,4740,7,653,9716.833333333334,249.0,93.28571428571428,7,4087,8510.166666666666,1514.0,583.8571428571429
90031646.0,17,28,13364,28,13364,3334505.407407407,501.0,477.2857142857143,0,0,0.0,0.0,0.0
120017584.0,17,28,13364,28,13364,4445095.703703703,501.0,477.2857142857143,0,0,0.0,0.0,0.0
38185.0,6,14,4740,7,653,6170.666666666667,249.0,93.28571428571428,7,4087,5641.833333333333,1514.0,583.8571428571429
148444.0,17,2,414,1,88,0.0,88.0,88.0,1,326,0.0,326.0,326.0
10423584.0,6,7,478,4,272,3429363.333333333,74.0,68.0,3,206,5143947.0,74.0,68.66666666666667
333.0,17,2,166,1,75,0.0,75.0,75.0,1,91,0.0,91.0,91.0
38906.0,6,14,4740,7,653,6074.833333333333,249.0,93.28571428571428,7,4087,6302.5,1514.0,583.8571428571429
13152.0,6,13,1459,7,862,2192.0,271.0,123.14285714285714,6,597,1817.8,259.0,99.5
141191.0,6,2,132,1,66,0.0,66.0,66.0,1,66,0.0,66.0,66.0
108099323.0,17,5,1005,5,1005,27024830.75,201.0,201.0,0,0,0.0,0.0,0.0
13956697.0,17,6,2052,6,2052,2791339.4,342.0,342.0,0,0,0.0,0.0,0.0
108106979.0,17,5,1005,5,1005,27026744.75,201.0,201.0,0,0,0.0,0.0,0.0
50441.0,6,14,4740,7,653,8238.166666666666,249.0,93.28571428571428,7,4087,7399.666666666667,1514.0,583.8571428571429
190862.0,17,2,180,1,90,0.0,90.0,90.0,1,90,0.0,90.0,90.0
207159.0,6,3,426,2,280,0.0,214.0,140.0,1,146,0.0,146.0,146.0
5628541.0,6,5,336,2,134,0.0,68.0,67.0,3,202,1524277.5,70.0,67.33333333333333
24355.0,6,14,4740,7,653,3782.8333333333335,249.0,93.28571428571428,7,4087,3477.1666666666665,1514.0,583.8571428571429
293.0,17,2,164,1,82,0.0,82.0,82.0,1,82,0.0,82.0,82.0
12935209.0,17,20,7552,20,7552,680800.4736842106,394.0,377.6,0,0,0.0,0.0,0.0
304.0,17,2,156,1,78,0.0,78.0,78.0,1,78,0.0,78.0,78.0
120230747.0,6,316,35874,158,10724,763421.5732484077,140.0,67.87341772151899,158,25150,760512.5605095541,300.0,159.1772151898734
1042458.0,6,13,1386,7,789,173742.99999999997,253.0,112.71428571428572,6,597,206536.8,259.0,99.5
238367.0,6,10,1221,6,636,47673.4,298.0,106.0,4,585,78178.33333333333,379.0,146.25
206093.0,6,3,426,2,280,0.0,214.0,140.0,1,146,0.0,146.0,146.0
5621452.0,6,4,270,2,134,0.0,68.0,67.0,2,136,0.0,70.0,68.0
3009859.0,6,12,2172,7,664,501533.0,252.0,94.85714285714286,5,1508,2599.25,1236.0,301.6
243520.0,17,2,180,1,90,0.0,90.0,90.0,1,90,0.0,90.0,90.0
196995.0,17,2,180,1,90,0.0,90.0,90.0,1,90,0.0,90.0,90.0
153415.0,17,2,180,1,90,0.0,90.0,90.0,1,90,0.0,90.0,90.0
100640.0,17,2,762,2,762,0.0,381.0,381.0,0,0,0.0,0.0,0.0
239228.0,17,2,180,1,90,0.0,90.0,90.0,1,90,0.0,90.0,90.0
2581567.0,6,25,7573,14,3735,198582.0769230769,1514.0,266.7857142857143,11,3838,232897.7,1514.0,348.90909090909093
114124160.0,6,48,3168,24,1584,4961920.0,66.0,66.0,24,1584,4949940.565217392,66.0,66.0
90040924.0,17,28,13364,28,13364,3334849.037037037,501.0,477.2857142857143,0,0,0.0,0.0,0.0
219475.0,6,3,426,2,280,0.0,214.0,140.0,1,146,0.0,146.0,146.0
309308.0,6,6,412,4,272,103102.66666666669,74.0,68.0,2,140,0.0,74.0,70.0
27228784.0,17,5,1710,5,1710,6807196.0,342.0,342.0,0,0,0.0,0.0,0.0
2933.0,17,2,224,1,76,0.0,76.0,76.0,1,148,0.0,148.0,148.0
3855.0,17,4,704,2,148,0.0,74.0,74.0,2,556,0.0,280.0,278.0
2797420.0,6,2,132,1,66,0.0,66.0,66.0,1,66,0.0,66.0,66.0
2031.0,17,4,344,2,150,0.0,75.0,75.0,2,194,0.0,103.0,97.0
153590.0,17,2,180,1,90,0.0,90.0,90.0,1,90,0.0,90.0,90.0
70101.0,6,14,4740,7,653,10500.333333333334,249.0,93.28571428571428,7,4087,10108.666666666666,1514.0,583.8571428571429
153390.0,17,2,180,1,90,0.0,90.0,90.0,1,90,0.0,90.0,90.0
90290776.0,6,16,1192,8,596,12891278.142857144,95.0,74.5,8,596,12897226.142857144,95.0,74.5
297099.0,17,2,246,1,76,0.0,76.0,76.0,1,170,0.0,170.0,170.0
103033.0,17,2,286,2,286,0.0,143.0,143.0,0,0,0.0,0.0,0.0
27351.0,6,11,2098,6,590,5184.2,252.0,98.33333333333331,5,1508,5310.75,1236.0,301.6
146119.0,6,3,337,2,214,0.0,160.0,107.0,1,123,0.0,123.0,123.0
108099257.0,17,5,955,5,955,27024814.25,191.0,191.0,0,0,0.0,0.0,0.0
90027971.0,17,28,13364,28,13364,3334369.296296296,501.0,477.2857142857143,0,0,0.0,0.0,0.0
135131925.0,17,6,1206,6,1206,27026385.0,201.0,201.0,0,0,0.0,0.0,0.0
148259.0,17,2,414,1,88,0.0,88.0,88.0,1,326,0.0,326.0,326.0
284345.0,17,2,363,1,79,0.0,79.0,79.0,1,284,0.0,284.0,284.0
147386.0,6,3,373,2,238,0.0,172.0,119.0,1,135,0.0,135.0,135.0
42998.0,6,10,2032,5,524,9867.75,252.0,104.8,5,1508,7552.0,1236.0,301.6
108102060.0,17,5,1005,5,1005,27025515.0,201.0,201.0,0,0,0.0,0.0,0.0
311409.0,6,6,412,4,272,103803.0,74.0,68.0,2,140,0.0,74.0,70.0
26164.0,6,14,4740,7,653,4251.5,249.0,93.28571428571428,7,4087,4016.5,1514.0,583.8571428571429
90205874.0,6,19,1436,9,691,11246247.875,95.0,76.77777777777777,10,745,10000036.333333334,95.0,74.5
2090.0,17,4,344,2,150,0.0,75.0,75.0,2,194,0.0,103.0,97.0
1805.0,17,2,192,1,88,0.0,88.0,88.0,1,104,0.0,104.0,104.0
1306279.0,6,4,264,2,132,0.0,66.0,66.0,2,132,0.0,66.0,66.0
5827854.0,6,5,336,2,134,0.0,68.0,67.0,3,202,1524678.5,70.0,67.33333333333333
42583.0,6,14,4740,7,653,6986.166666666667,249.0,93.28571428571428,7,4087,6887.333333333333,1514.0,583.8571428571429
116238582.0,6,499,61432,250,16734,466821.6144578313,140.0,66.936,249,44698,467816.3064516129,464.0,179.51004016064255
108105178.0,17,5,1005,5,1005,27026294.5,201.0,201.0,0,0,0.0,0.0,0.0
2427660.0,6,31,9357,17,3897,151728.75,1514.0,229.23529411764707,14,5460,166291.61538461538,1514.0,390.0
308.0,17,2,174,1,79,0.0,79.0,79.0,1,95,0.0,95.0,95.0
143844.0,17,2,180,1,90,0.0,90.0,90.0,1,90,0.0,90.0,90.0
91588324.0,6,30,2853,14,1159,7045255.692307692,211.0,82.78571428571429,16,1694,6091925.066666666,427.0,105.875
146099.0,6,3,337,2,214,0.0,160.0,107.0,1,123,0.0,123.0,123.0
135134460.0,17,6,1146,6,1146,27026892.0,191.0,191.0,0,0,0.0,0.0,0.0
1040276.0,6,11,1134,6,558,208055.2,220.0,93.0,5,576,258413.5,304.0,115.2
101815.0,17,2,762,2,762,0.0,381.0,381.0,0,0,0.0,0.0,0.0
121467.0,6,3,337,2,214,0.0,160.0,107.0,1,123,0.0,123.0,123.0
120768174.0,6,30,1974,15,948,7913103.928571428,123.0,63.2,15,1026,7913092.428571428,123.0,68.4
88270513.0,17,14,4788,14,4788,6790039.461538462,342.0,342.0,0,0,0.0,0.0,0.0
31161.0,6,13,1459,7,862,4896.5,271.0,123.14285714285714,6,597,3530.4,259.0,99.5
146118.0,6,3,337,2,214,0.0,160.0,107.0,1,123,0.0,123.0,123.0
10439919.0,6,6,412,3,206,5151637.0,74.0,68.66666666666667,3,206,5151552.5,74.0,68.66666666666667
9402.0,17,2,582,1,83,0.0,83.0,83.0,1,499,0.0,499.0,499.0
108110734.0,17,5,955,5,955,27027683.5,191.0,191.0,0,0,0.0,0.0,0.0
2418.0,17,4,344,2,150,0.0,75.0,75.0,2,194,0.0,103.0,97.0
33878.0,6,10,2032,5,524,7709.0,252.0,104.8,5,1508,7656.25,1236.0,301.6
90287924.0,6,18,1501,9,851,11280435.125,255.0,94.55555555555556,9,650,11284491.5,95.0,72.22222222222223
90034113.0,17,28,13364,28,13364,3334596.777777778,501.0,477.2857142857143,0,0,0.0,0.0,0.0
51100.0,17,2,180,1,90,0.0,90.0,90.0,1,90,0.0,90.0,90.0
115277293.0,6,30,1974,15,1026,8218685.785714285,123.0,68.4,15,948,8218684.857142857,123.0,63.2
19545.0,6,11,2098,6,590,3346.4,252.0,98.33333333333331,5,1508,4379.25,1236.0,301.6
10818.0,6,10,1975,5,467,2486.75,195.0,93.4,5,1508,2426.25,1236.0,301.6
43795.0,6,14,4740,7,653,5993.5,249.0,93.28571428571428,7,4087,7057.666666666667,1514.0,583.8571428571429
144766.0,17,2,180,1,70,0.0,70.0,70.0,1,110,0.0,110.0,110.0
95109001.0,6,40,2640,20,1320,5005736.894736842,66.0,66.0,20,1320,4989183.578947368,66.0,66.0
15122.0,17,2,180,1,90,0.0,90.0,90.0,1,90,0.0,90.0,90.0
108110774.0,17,5,955,5,955,27027693.5,191.0,191.0,0,0,0.0,0.0,0.0
123730532.0,6,49,3234,25,1650,5155438.833333333,66.0,66.0,24,1584,4935648.217391305,66.0,66.0
11994673.0,17,5,2265,5,2265,2998668.25,453.0,453.0,0,0,0.0,0.0,0.0
116294966.0,6,34,2334,17,1209,7255653.125,123.0,71.11764705882354,17,1125,7255653.9375,123.0,66.17647058823529
90028328.0,17,28,13364,28,13364,3334382.5185185187,501.0,477.2857142857143,0,0,0.0,0.0,0.0
248292.0,6,3,337,2,214,0.0,160.0,107.0,1,123,0.0,123.0,123.0
831.0,17,4,438,2,148,0.0,74.0,74.0,2,290,0.0,147.0,145.0
119789951.0,6,23,1693,12,894,10889995.545454543,95.0,74.5,11,799,11953216.4,95.0,72.63636363636364
300449.0,6,6,412,4,272,100149.66666666669,74.0,68.0,2,140,0.0,74.0,70.0
224880.0,6,3,426,2,280,0.0,214.0,140.0,1,146,0.0,146.0,146.0
90300989.0,6,17,1287,9,691,11281239.375,95.0,76.77777777777777,8,596,12830815.714285716,95.0,74.5
135126987.0,17,6,1146,6,1146,27025397.4,191.0,191.0,0,0,0.0,0.0,0.0
98505.0,17,2,762,2,762,0.0,381.0,381.0,0,0,0.0,0.0,0.0
111179.0,17,2,286,2,286,0.0,143.0,143.0,0,0,0.0,0.0,0.0
743718.0,6,2,132,1,66,0.0,66.0,66.0,1,66,0.0,66.0,66.0
95030871.0,17,12,778,6,389,19001090.2,174.0,64.83333333333333,6,389,19000152.0,174.0,64.83333333333333
108106216.0,17,5,955,5,955,27026554.0,191.0,191.0,0,0,0.0,0.0,0.0
108086182.0,17,5,1005,5,1005,27021545.5,201.0,201.0,0,0,0.0,0.0,0.0
119318955.0,6,243,27392,122,8348,986107.0661157024,140.0,68.42622950819673,121,19044,977125.9333333332,284.0,157.38842975206612
438468.0,6,11,1021,6,444,58945.2,162.0,74.0,5,577,73514.75,349.0,115.4
128886314.0,6,35,2410,18,1285,7581547.882352941,139.0,71.38888888888889,17,1125,7417788.1875,123.0,66.17647058823529
302370.0,6,2,132,1,66,0.0,66.0,66.0,1,66,0.0,66.0,66.0
121817516.0,17,15,907,7,432,17001072.5,174.0,61.71428571428572,8,475,17285920.42857143,174.0,59.375
216473.0,17,2,180,1,90,0.0,90.0,90.0,1,90,0.0,90.0,90.0
10989.0,6,11,1133,6,602,1948.2,264.0,100.33333333333331,5,531,2297.75,259.0,106.2
237114.0,6,10,1221,6,636,47422.8,298.0,106.0,4,585,78110.66666666667,379.0,146.25
150009.0,6,3,337,2,214,0.0,160.0,107.0,1,123,0.0,123.0,123.0
108118726.0,17,5,955,5,955,27029681.5,191.0,191.0,0,0,0.0,0.0,0.0
300837.0,6,6,412,4,272,100279.0,74.0,68.0,2,140,0.0,74.0,70.0
196915.0,17,2,180,1,90,0.0,90.0,90.0,1,90,0.0,90.0,90.0
42450.0,6,14,4740,7,653,6506.333333333333,249.0,93.28571428571428,7,4087,6935.833333333333,1514.0,583.8571428571429
108100497.0,17,5,955,5,955,27025124.25,191.0,191.0,0,0,0.0,0.0,0.0
0.0,17,1,44,1,44,0.0,44.0,44.0,0,0,0.0,0.0,0.0
16905.0,17,2,582,1,83,0.0,83.0,83.0,1,499,0.0,499.0,499.0
40537.0,6,14,4740,7,653,6310.0,249.0,93.28571428571428,7,4087,5472.666666666667,1514.0,583.8571428571429
51900.0,6,14,4740,7,653,8482.166666666666,249.0,93.28571428571428,7,4087,6747.166666666667,1514.0,583.8571428571429
4890.0,17,2,180,1,90,0.0,90.0,90.0,1,90,0.0,90.0,90.0
33463.0,6,14,4740,7,653,4759.5,249.0,93.28571428571428,7,4087,5317.166666666667,1514.0,583.8571428571429
107829.0,17,2,286,2,286,0.0,143.0,143.0,0,0,0.0,0.0,0.0
135132104.0,17,6,1206,6,1206,27026420.8,201.0,201.0,0,0,0.0,0.0,0.0
243208.0,17,2,180,1,90,0.0,90.0,90.0,1,90,0.0,90.0,90.0
53146.0,6,14,4740,7,653,6238.833333333333,249.0,93.28571428571428,7,4087,8668.833333333334,1514.0,583.8571428571429
505001.00000000006,6,5,336,2,134,0.0,68.0,67.0,3,202,193202.0,70.0,67.33333333333333
3453852.0,17,3,1026,3,1026,1726926.0,342.0,342.0,0,0,0.0,0.0,0.0
69664.0,6,13,1386,7,789,11183.833333333334,253.0,112.71428571428572,6,597,11048.0,259.0,99.5
409403.0,6,3,1604,1,753,0.0,753.0,753.0,2,851,0.0,785.0,425.5
90918564.0,6,21,1585,11,840,9091678.9,95.0,76.36363636363636,10,745,10100803.666666666,95.0,74.5
56031.0,6,14,4740,7,653,8815.5,249.0,93.28571428571428,7,4087,7429.833333333333,1514.0,583.8571428571429
121619610.0,17,14,864,7,432,17001621.0,174.0,61.71428571428572,7,432,17000203.333333332,174.0,61.71428571428572
120145035.0,6,216,24328,108,7350,1115022.6635514018,140.0,68.05555555555556,108,16978,1114760.9158878506,284.0,157.2037037037037
524600.0,6,3,204,1,68,0.0,68.0,68.0,2,136,0.0,70.0,68.0
0.0,6,1,172,1,172,0.0,172.0,172.0,0,0,0.0,0.0,0.0
10517988.0,6,7,478,4,272,3460804.6666666665,74.0,68.0,3,206,5191102.5,74.0,68.66666666666667
121311719.0,6,242,27940,121,8282,995660.1583333332,140.0,68.44628099173553,121,19658,1004256.775,284.0,162.46280991735537
1304042.0,17,7,490,7,490,217340.3333333333,70.0,70.0,0,0,0.0,0.0,0.0
508557.00000000006,6,3,204,1,68,0.0,68.0,68.0,2,136,0.0,70.0,68.0
51182.0,17,2,180,1,90,0.0,90.0,90.0,1,90,0.0,90.0,90.0
297335.0,6,6,412,4,272,99111.66666666669,74.0,68.0,2,140,0.0,74.0,70.0
121397340.0,6,227,25706,114,18026,1074312.743362832,284.0,158.12280701754386,113,7680,1066527.607142857,140.0,67.96460176991151
1163747.0,6,13,3020,8,2392,166249.57142857142,1514.0,299.0,5,628,221984.75,331.0,125.6
110966935.0,6,30,1990,15,1042,7910790.142857143,139.0,69.46666666666667,15,948,7910792.714285715,123.0,63.2
91000500.0,6,21,1585,11,840,9099640.1,95.0,76.36363636363636,10,745,10110689.0,95.0,74.5
153475.0,17,2,180,1,90,0.0,90.0,90.0,1,90,0.0,90.0,90.0
1315588.0,6,4,264,2,132,0.0,66.0,66.0,2,132,0.0,66.0,66.0
101137785.0,17,13,821,6,389,16200239.2,174.0,64.83333333333333,7,432,16834716.0,174.0,61.71428571428572
346.0,17,2,160,1,80,0.0,80.0,80.0,1,80,0.0,80.0,80.0
118894799.0,6,36,2596,18,1348,6981112.05882353,139.0,74.88888888888889,18,1248,6981110.529411765,123.0,69.33333333333333
90024992.0,17,23,10937,23,10937,4092045.090909091,501.0,475.5217391304348,0,0,0.0,0.0,0.0
10492265.0,6,7,478,4,272,3450203.333333333,74.0,68.0,3,206,5174534.5,74.0,68.66666666666667
118677096.0,6,218,24562,109,17134,1096867.4166666667,284.0,157.19266055045873,109,7428,1096868.2685185184,140.0,68.14678899082568
307338.0,6,6,412,4,272,102446.0,74.0,68.0,2,140,0.0,74.0,70.0
110254.0,17,2,286,2,286,0.0,143.0,143.0,0,0,0.0,0.0,0.0
120000042.0,6,17,1287,9,691,15000005.25,95.0,76.77777777777777,8,596,12899137.42857143,95.0,74.5
906.0,17,5,550,5,550,226.5,110.0,110.0,0,0,0.0,0.0,0.0
119935.0,17,2,180,1,70,0.0,70.0,70.0,1,110,0.0,110.0,110.0
102851.0,17,2,286,2,286,0.0,143.0,143.0,0,0,0.0,0.0,0.0
108103741.0,17,5,955,5,955,27025935.25,191.0,191.0,0,0,0.0,0.0,0.0
467449.0,6,3,204,1,68,0.0,68.0,68.0,2,136,0.0,70.0,68.0
137879.0,17,2,176,1,80,0.0,80.0,80.0,1,96,0.0,96.0,96.0
13726.0,6,11,2098,6,590,2275.6,252.0,98.33333333333331,5,1508,3003.5,1236.0,301.6
1041905.0,6,11,1134,6,558,208381.0,220.0,93.0,5,576,258728.0,304.0,115.2
44300.0,6,10,2032,5,524,10662.25,252.0,104.8,5,1508,10606.0,1236.0,301.6
217886.0,6,3,426,2,280,0.0,214.0,140.0,1,146,0.0,146.0,146.0
101311609.0,17,14,1126,7,563,16833487.0,174.0,80.42857142857143,7,563,16834407.5,174.0,80.42857142857143
27137764.0,17,5,1710,5,1710,6784441.0,342.0,342.0,0,0,0.0,0.0,0.0
54932.0,6,10,2032,5,524,13351.0,252.0,104.8,5,1508,9864.25,1236.0,301.6
207275.0,6,4,492,2,280,0.0,214.0,140.0,2,212,0.0,146.0,106.0
10451.0,6,10,2032,5,524,2400.75,252.0,104.8,5,1508,2342.5,1236.0,301.6
47110.0,6,10,2032,5,524,10048.25,252.0,104.8,5,1508,9879.75,1236.0,301.6
409778.0,6,4,508,2,238,0.0,172.0,119.0,2,270,0.0,135.0,135.0
108035.0,17,2,700,2,700,0.0,350.0,350.0,0,0,0.0,0.0,0.0
2493629.0,6,51,23848,26,19851,99745.16,1514.0,763.5,25,3997,95157.125,1514.0,159.88
241233.0,6,3,337,2,214,0.0,160.0,107.0,1,123,0.0,123.0,123.0
63958.0,6,14,4740,7,653,10475.0,249.0,93.28571428571428,7,4087,10317.5,1514.0,583.8571428571429
303094.0,6,6,412,4,272,101031.33333333331,74.0,68.0,2,140,0.0,74.0,70.0
17703.0,6,20,7606,11,978,1770.3,310.0,88.9090909090909,9,6628,1914.25,1514.0,736.4444444444445
1152883.0,6,13,3010,8,2382,164697.57142857142,1514.0,297.75,5,628,220093.25,331.0,125.6
278271.0,6,12,1373,7,714,46378.5,298.0,102.0,5,659,65519.5,379.0,131.8
43293.0,6,12,1328,7,797,7215.5,253.0,113.85714285714286,5,531,8712.0,259.0,106.2
96688.0,17,2,286,2,286,0.0,143.0,143.0,0,0,0.0,0.0,0.0
56712.0,6,14,4740,7,653,8400.666666666666,249.0,93.28571428571428,7,4087,8801.833333333334,1514.0,583.8571428571429
109003755.0,17,13,821,7,432,18167292.5,174.0,61.71428571428572,6,389,17800190.8,174.0,64.83333333333333
63871.0,6,14,4740,7,653,9879.5,249.0,93.28571428571428,7,4087,8437.166666666666,1514.0,583.8571428571429
239990.0,6,3,337,2,214,0.0,160.0,107.0,1,123,0.0,123.0,123.0
43276.0,6,14,4740,7,653,7087.333333333333,249.0,93.28571428571428,7,4087,5925.666666666667,1514.0,583.8571428571429
146162.0,6,3,337,2,214,0.0,160.0,107.0,1,123,0.0,123.0,123.0
1029655.0,6,13,1386,7,789,171609.1666666667,253.0,112.71428571428572,6,597,203323.0,259.0,99.5
44100.0,6,14,4740,7,653,6980.666666666667,249.0,93.28571428571428,7,4087,6188.5,1514.0,583.8571428571429
18997.0,17,2,582,1,83,0.0,83.0,83.0,1,499,0.0,499.0,499.0
35383.0,6,14,4740,7,653,5240.0,249.0,93.28571428571428,7,4087,5276.166666666667,1514.0,583.8571428571429
89265.0,6,10,2032,5,524,20834.75,252.0,104.8,5,1508,22067.25,1236.0,301.6
45147.0,6,14,4740,7,653,5616.833333333333,249.0,93.28571428571428,7,4087,7381.666666666667,1514.0,583.8571428571429
298538.0,6,6,412,4,272,99512.66666666669,74.0,68.0,2,140,0.0,74.0,70.0
2944.0,17,2,224,1,76,0.0,76.0,76.0,1,148,0.0,148.0,148.0
239349.0,6,3,337,2,214,0.0,160.0,107.0,1,123,0.0,123.0,123.0
281752.0,17,2,363,1,79,0.0,79.0,79.0,1,284,0.0,284.0,284.0
1068702.0,17,6,1230,3,234,534167.0,78.0,78.0,3,996,534156.0,332.0,332.0
23661.0,6,10,2032,5,524,5586.5,252.0,104.8,5,1508,5611.75,1236.0,301.6
10457924.0,6,7,478,4,272,3440547.333333333,74.0,68.0,3,206,5160712.0,74.0,68.66666666666667
324830.0,17,4,1400,4,1400,108276.66666666669,350.0,350.0,0,0,0.0,0.0,0.0
2073.0,17,4,344,2,150,0.0,75.0,75.0,2,194,0.0,103.0,97.0
90018847.0,17,28,13364,28,13364,3334031.3703703703,501.0,477.2857142857143,0,0,0.0,0.0,0.0
45906.0,6,14,4740,7,653,7285.5,249.0,93.28571428571428,7,4087,7108.666666666667,1514.0,583.8571428571429
2600778.0,6,2,132,1,66,0.0,66.0,66.0,1,66,0.0,66.0,66.0
1310057.0,6,4,264,2,132,0.0,66.0,66.0,2,132,0.0,66.0,66.0
132397.0,6,3,337,2,214,0.0,160.0,107.0,1,123,0.0,123.0,123.0
5631384.0,6,5,336,2,134,0.0,68.0,67.0,3,202,1526169.5,70.0,67.33333333333333
60532.0,6,10,2032,5,524,14819.5,252.0,104.8,5,1508,14771.5,1236.0,301.6
15016995.0,17,6,2718,6,2718,3003399.0,453.0,453.0,0,0,0.0,0.0,0.0
468869.0,6,3,1604,1,753,0.0,753.0,753.0,2,851,0.0,785.0,425.5
90257701.0,6,12,1832,8,1016,12893957.285714284,188.0,127.0,4,816,30031336.666666668,204.0,204.0
99972.0,17,4,1400,4,1400,33324.0,350.0,350.0,0,0,0.0,0.0,0.0
90711113.0,6,21,1585,10,745,10079012.555555556,95.0,74.5,11,840,9044611.2,95.0,76.36363636363636
1301317.0,6,4,264,2,132,0.0,66.0,66.0,2,132,0.0,66.0,66.0
148676.0,17,4,1524,4,1524,49558.66666666666,381.0,381.0,0,0,0.0,0.0,0.0
120123101.0,6,14,2240,6,1224,24024620.2,204.0,204.0,8,1016,17136888.85714286,188.0,127.0
219175.0,6,3,426,2,280,0.0,214.0,140.0,1,146,0.0,146.0,146.0
150370.0,17,4,1400,4,1400,50123.333333333336,350.0,350.0,0,0,0.0,0.0,0.0
335.0,17,2,166,1,75,0.0,75.0,75.0,1,91,0.0,91.0,91.0
2416820.0,6,25,7573,14,3735,185909.2307692308,1514.0,266.7857142857143,11,3838,216732.1,1514.0,348.90909090909093
31606.000000000004,6,14,4740,7,653,5102.0,249.0,93.28571428571428,7,4087,4828.833333333333,1514.0,583.8571428571429
205942.0,17,2,180,1,90,0.0,90.0,90.0,1,90,0.0,90.0,90.0
90037005.0,17,28,13364,28,13364,3334703.888888889,501.0,477.2857142857143,0,0,0.0,0.0,0.0
108119289.0,17,5,1005,5,1005,27029822.25,201.0,201.0,0,0,0.0,0.0,0.0
37886.0,6,14,4740,7,653,5757.666666666667,249.0,93.28571428571428,7,4087,6004.666666666667,1514.0,583.8571428571429
119933377.0,17,13,952,7,563,19988896.166666668,174.0,80.42857142857143,6,389,19827166.8,174.0,64.83333333333333
156323.0,17,2,180,1,90,0.0,90.0,90.0,1,90,0.0,90.0,90.0
7791.0,17,2,582,1,83,0.0,83.0,83.0,1,499,0.0,499.0,499.0
47005.0,6,10,2032,5,524,11423.5,252.0,104.8,5,1508,10171.0,1236.0,301.6
43516.0,6,14,4740,7,653,6804.666666666667,249.0,93.28571428571428,7,4087,7051.666666666667,1514.0,583.8571428571429
97240273.0,6,64,12724,31,6590,3241342.433333333,1514.0,212.5806451612904,33,6134,3031837.03125,1514.0,185.87878787878788
206269.0,6,3,426,2,280,0.0,214.0,140.0,1,146,0.0,146.0,146.0
270885.0,6,13,1394,7,797,45147.5,253.0,113.85714285714286,6,597,51671.8,259.0,99.5
113520178.0,6,46,3036,23,1518,5159997.045454546,66.0,66.0,23,1518,5159996.954545454,66.0,66.0
329.0,17,2,166,1,75,0.0,75.0,75.0,1,91,0.0,91.0,91.0
5616643.0,6,4,270,2,134,0.0,68.0,67.0,2,136,0.0,70.0,68.0
0.0,17,1,350,1,350,0.0,350.0,350.0,0,0,0.0,0.0,0.0
102890.0,17,2,286,2,286,0.0,143.0,143.0,0,0,0.0,0.0,0.0
101300347.0,6,28,1876,14,982,7775730.538461538,139.0,70.14285714285714,14,894,7775726.384615385,123.0,63.85714285714285
90960025.0,6,21,1585,11,840,9095019.5,95.0,76.36363636363636,10,745,10105934.777777778,95.0,74.5
291566.0,17,2,180,1,90,0.0,90.0,90.0,1,90,0.0,90.0,90.0
108103881.0,17,5,1005,5,1005,27025970.25,201.0,201.0,0,0,0.0,0.0,0.0
3577.0,17,2,334,1,79,0.0,79.0,79.0,1,255,0.0,255.0,255.0
366297.0,17,2,363,1,75,0.0,75.0,75.0,1,288,0.0,288.0,288.0
744.0,17,4,438,2,148,0.0,74.0,74.0,2,290,0.0,147.0,145.0
106339.0,17,2,286,2,286,0.0,143.0,143.0,0,0,0.0,0.0,0.0
90311437.0,6,22,1680,12,935,8204686.0,95.0,77.91666666666667,10,745,9950717.666666666,95.0,74.5
106393.0,17,2,762,2,762,0.0,381.0,381.0,0,0,0.0,0.0,0.0
216452.0,17,2,180,1,90,0.0,90.0,90.0,1,90,0.0,90.0,90.0
49323.0,6,14,4740,7,653,8091.333333333333,249.0,93.28571428571428,7,4087,7094.0,1514.0,583.8571428571429
5824349.0,6,4,270,2,134,0.0,68.0,67.0,2,136,0.0,70.0,68.0
6575.0,17,2,582,1,83,0.0,83.0,83.0,1,499,0.0,499.0,499.0
8700.0,17,4,823,2,163,0.0,89.0,81.5,2,660,0.0,443.0,330.0
103624.0,17,2,286,2,286,0.0,143.0,143.0,0,0,0.0,0.0,0.0
108104956.0,17,5,1005,5,1005,27026239.0,201.0,201.0,0,0,0.0,0.0,0.0
308371.0,6,6,412,4,272,102790.33333333331,74.0,68.0,2,140,0.0,74.0,70.0
229756.0,6,10,1221,6,636,45951.2,298.0,106.0,4,585,68951.66666666667,379.0,146.25
108105398.0,17,5,1005,5,1005,27026349.5,201.0,201.0,0,0,0.0,0.0,0.0
151372.0,17,2,414,1,88,0.0,88.0,88.0,1,326,0.0,326.0,326.0
156287.0,17,2,180,1,90,0.0,90.0,90.0,1,90,0.0,90.0,90.0
214885.0,6,10,1221,6,636,42977.0,298.0,106.0,4,585,70620.66666666667,379.0,146.25
29901127.0,6,4,270,3,202,14950563.5,70.0,67.33333333333333,1,68,0.0,68.0,68.0
2388.0,17,4,344,2,150,0.0,75.0,75.0,2,194,0.0,103.0,97.0
103974.0,17,2,700,2,700,0.0,350.0,350.0,0,0,0.0,0.0,0.0
114893585.0,6,48,3168,24,1584,4995373.260869565,66.0,66.0,24,1584,4983399.608695652,66.0,66.0
147959.0,17,2,180,1,90,0.0,90.0,90.0,1,90,0.0,90.0,90.0
236584.0,6,3,337,2,214,0.0,160.0,107.0,1,123,0.0,123.0,123.0
115393655.0,6,48,3168,24,1584,5017115.434782608,66.0,66.0,24,1584,5003730.782608695,66.0,66.0
122228.0,6,3,373,2,238,0.0,172.0,119.0,1,135,0.0,135.0,135.0
232918.0,6,3,337,2,214,0.0,160.0,107.0,1,123,0.0,123.0,123.0
0.0,6,1,54,1,54,0.0,54.0,54.0,0,0,0.0,0.0,0.0
106904.0,17,2,286,2,286,0.0,143.0,143.0,0,0,0.0,0.0,0.0
218620.0,6,3,426,2,280,0.0,214.0,140.0,1,146,0.0,146.0,146.0
278570.0,17,4,1524,4,1524,92856.66666666669,381.0,381.0,0,0,0.0,0.0,0.0
40493.0,6,11,2098,6,590,7832.2,252.0,98.33333333333331,5,1508,7042.25,1236.0,301.6
306585.0,6,6,412,4,272,102195.0,74.0,68.0,2,140,0.0,74.0,70.0
217596.0,6,3,426,2,280,0.0,214.0,140.0,1,146,0.0,146.0,146.0
218476.0,6,3,426,2,280,0.0,214.0,140.0,1,146,0.0,146.0,146.0
113932.0,17,4,1400,4,1400,37977.333333333336,350.0,350.0,0,0,0.0,0.0,0.0
187606.0,17,2,180,1,90,0.0,90.0,90.0,1,90,0.0,90.0,90.0
14934.0,6,11,2098,6,590,2986.8,252.0,98.33333333333331,5,1508,3266.5,1236.0,301.6
1039510.0,6,11,1134,6,558,207902.0,220.0,93.0,5,576,258369.0,304.0,115.2
3052.0,17,2,224,1,76,0.0,76.0,76.0,1,148,0.0,148.0,148.0
30744.0,17,2,507,1,86,0.0,86.0,86.0,1,421,0.0,421.0,421.0
108108870.0,17,5,1005,5,1005,27027217.5,201.0,201.0,0,0,0.0,0.0,0.0
12508372.0,6,7,499,4,301,3234829.333333333,103.0,75.25,3,198,6143493.0,66.0,66.0
2475575.0,6,25,7573,14,3735,190428.84615384616,1514.0,266.7857142857143,11,3838,221441.5,1514.0,348.90909090909093
510037.0,6,5,336,2,134,0.0,68.0,67.0,3,202,196148.0,70.0,67.33333333333333
148321085.0,6,27,2073,15,1179,10594363.214285716,95.0,78.6,12,894,10887269.636363637,95.0,74.5
2422.0,17,4,344,2,150,0.0,75.0,75.0,2,194,0.0,103.0,97.0
102709104.0,6,41,2706,21,1386,5135455.2,66.0,66.0,20,1320,5041142.0,66.0,66.0
114545121.0,6,48,3168,24,1584,4980222.652173913,66.0,66.0,24,1584,4966803.130434782,66.0,66.0
49699.0,6,14,4740,7,653,8130.833333333333,249.0,93.28571428571428,7,4087,6979.833333333333,1514.0,583.8571428571429
210522.0,17,4,6056,4,6056,70174.0,1514.0,1514.0,0,0,0.0,0.0,0.0
118672066.0,6,30,1974,15,1026,8461142.142857144,123.0,68.4,15,948,8461127.142857144,123.0,63.2
107323.0,17,2,286,2,286,0.0,143.0,143.0,0,0,0.0,0.0,0.0
119293042.0,17,14,864,7,432,19834682.33333333,174.0,61.71428571428572,7,432,19833498.166666668,174.0,61.71428571428572
13719196.0,17,6,2052,6,2052,2743839.2,342.0,342.0,0,0,0.0,0.0,0.0
305749.0,6,6,412,4,272,101916.33333333331,74.0,68.0,2,140,0.0,74.0,70.0
119251286.0,17,14,864,7,432,19833537.33333333,174.0,61.71428571428572,7,432,19834403.33333333,174.0,61.71428571428572
30409.0,6,14,4740,7,653,4674.833333333333,249.0,93.28571428571428,7,4087,4544.333333333333,1514.0,583.8571428571429
262067.0,6,3,337,2,214,0.0,160.0,107.0,1,123,0.0,123.0,123.0
1177981.0,6,13,3015,8,2387,168283.0,1514.0,298.375,5,628,226345.75,331.0,125.6
37573.0,6,14,4740,7,653,5419.833333333333,249.0,93.28571428571428,7,4087,6121.5,1514.0,583.8571428571429
429816.0,6,3,1604,1,753,0.0,753.0,753.0,2,851,0.0,785.0,425.5
44688.0,6,14,4740,7,653,6356.333333333333,249.0,93.28571428571428,7,4087,7050.166666666667,1514.0,583.8571428571429
33137.0,6,10,2032,5,524,6303.25,252.0,104.8,5,1508,8015.25,1236.0,301.6
108273.0,17,2,286,2,286,0.0,143.0,143.0,0,0,0.0,0.0,0.0
2405.0,17,4,344,2,150,0.0,75.0,75.0,2,194,0.0,103.0,97.0
305.0,17,2,174,1,79,0.0,79.0,79.0,1,95,0.0,95.0,95.0
90035649.0,17,28,13364,28,13364,3334653.6666666665,501.0,477.2857142857143,0,0,0.0,0.0,0.0
72696.0,6,14,4740,7,653,11993.0,249.0,93.28571428571428,7,4087,11664.333333333334,1514.0,583.8571428571429
10910799.0,6,7,478,3,206,5387229.0,74.0,68.66666666666667,4,272,3591440.6666666665,74.0,68.0
305030.0,6,6,412,4,272,101676.66666666669,74.0,68.0,2,140,0.0,74.0,70.0
550.0,17,2,508,2,508,0.0,257.0,254.0,0,0,0.0,0.0,0.0
317269.0,17,4,1400,4,1400,105756.33333333331,350.0,350.0,0,0,0.0,0.0,0.0
90265702.0,6,14,2240,8,1016,12895100.285714284,188.0,127.0,6,1224,18020604.2,204.0,204.0
2229.0,17,2,762,2,762,0.0,381.0,381.0,0,0,0.0,0.0,0.0
90052811.0,17,28,13364,28,13364,3335289.296296296,501.0,477.2857142857143,0,0,0.0,0.0,0.0
25054.0,17,4,823,2,163,0.0,89.0,81.5,2,660,0.0,443.0,330.0
101364404.0,6,28,1929,14,963,7797261.846153846,123.0,68.78571428571429,14,966,7780607.538461538,123.0,69.0
10480955.0,6,7,478,4,272,3446313.0,74.0,68.0,3,206,5169368.0,74.0,68.66666666666667
90531786.0,6,13,2036,8,1016,12933112.285714284,188.0,127.0,5,1020,22591850.5,204.0,204.0
120784161.0,6,351,43542,176,31758,690195.2057142857,336.0,180.4431818181818,175,11784,688276.5287356322,140.0,67.33714285714285
135127811.0,17,6,1206,6,1206,27025562.2,201.0,201.0,0,0,0.0,0.0,0.0
2803936.0,6,2,132,1,66,0.0,66.0,66.0,1,66,0.0,66.0,66.0
1612527.0,6,4,276,2,128,0.0,74.0,64.0,2,148,0.0,74.0,74.0
62276.0,6,12,1413,6,816,9254.4,291.0,136.0,6,597,11566.8,259.0,99.5
18685.0,6,10,2032,5,524,4009.75,252.0,104.8,5,1508,3779.5,1236.0,301.6
29171.0,6,10,2032,5,524,6521.25,252.0,104.8,5,1508,5536.0,1236.0,301.6
108103620.0,17,5,955,5,955,27025905.0,191.0,191.0,0,0,0.0,0.0,0.0
49672.0,6,10,2032,5,524,12205.25,252.0,104.8,5,1508,11704.75,1236.0,301.6
90045865.0,17,27,12943,27,12943,3463302.5,501.0,479.3703703703704,0,0,0.0,0.0,0.0
135124818.0,17,6,1206,6,1206,27024963.6,201.0,201.0,0,0,0.0,0.0,0.0
31856.000000000004,6,10,2032,5,524,5368.5,252.0,104.8,5,1508,7669.25,1236.0,301.6
91786394.0,6,217,25290,109,17928,849874.0185185185,374.0,164.47706422018348,108,7362,848072.8878504672,140.0,68.16666666666667
1297929.0,6,4,264,2,132,0.0,66.0,66.0,2,132,0.0,66.0,66.0
153467.0,17,2,180,1,90,0.0,90.0,90.0,1,90,0.0,90.0,90.0
2343.0,17,4,344,2,150,0.0,75.0,75.0,2,194,0.0,103.0,97.0
135121274.0,17,6,1146,6,1146,27024254.8,191.0,191.0,0,0,0.0,0.0,0.0
316426.0,17,4,1400,4,1400,105475.33333333331,350.0,350.0,0,0,0.0,0.0,0.0
120037285.0,6,2446,2127820,759,50094,157760.46569920843,66.0,66.0,1687,2077726,70740.41992882562,1514.0,1231.609958506224
15148.0,17,4,704,2,148,0.0,74.0,74.0,2,556,0.0,280.0,278.0
236755.0,6,3,337,2,214,0.0,160.0,107.0,1,123,0.0,123.0,123.0
21399.0,6,20,7606,11,978,2139.9,310.0,88.9090909090909,9,6628,2413.5,1514.0,736.4444444444445
90307503.0,6,18,1382,10,786,10027834.666666666,95.0,78.6,8,596,12695360.857142856,95.0,74.5
103716.0,17,2,700,2,700,0.0,350.0,350.0,0,0,0.0,0.0,0.0
2001407.0,17,4,525,2,150,0.0,75.0,75.0,2,375,0.0,284.0,187.5
45868.0,6,10,2032,5,524,11113.25,252.0,104.8,5,1508,10822.5,1236.0,301.6
731.0,17,4,438,2,148,0.0,74.0,74.0,2,290,0.0,147.0,145.0
2573276.0,6,3,204,2,136,0.0,70.0,68.0,1,68,0.0,68.0,68.0
90259784.0,6,14,2240,8,1016,12894254.857142856,188.0,127.0,6,1224,18019055.2,204.0,204.0
204433.0,17,2,762,2,762,0.0,381.0,381.0,0,0,0.0,0.0,0.0
2392.0,17,4,344,2,150,0.0,75.0,75.0,2,194,0.0,103.0,97.0
418587.0,6,3,204,1,68,0.0,68.0,68.0,2,136,0.0,70.0,68.0
42133.0,6,10,2032,5,524,10029.25,252.0,104.8,5,1508,10176.0,1236.0,301.6
249149.0,6,3,337,2,214,0.0,160.0,107.0,1,123,0.0,123.0,123.0
2037.0,17,4,344,2,150,0.0,75.0,75.0,2,194,0.0,103.0,97.0
62085.0,6,10,2032,5,524,15282.0,252.0,104.8,5,1508,14893.5,1236.0,301.6
146222.0,6,3,337,2,214,0.0,160.0,107.0,1,123,0.0,123.0,123.0
146062.0,6,3,337,2,214,0.0,160.0,107.0,1,123,0.0,123.0,123.0
119856780.0,6,15,2306,6,1224,23970877.2,204.0,204.0,9,1082,14981777.0,188.0,120.22222222222224
90299688.0,6,16,1192,8,596,12892849.0,95.0,74.5,8,596,12899429.857142856,95.0,74.5
160500.0,17,4,1524,4,1524,53500.0,381.0,381.0,0,0,0.0,0.0,0.0
1022660.0,6,11,1131,6,600,204062.4,262.0,100.0,5,531,255291.5,259.0,106.2
93787.0,6,11,2098,6,590,18492.0,252.0,98.33333333333331,5,1508,22575.0,1236.0,301.6
207040.0,6,3,426,2,280,0.0,214.0,140.0,1,146,0.0,146.0,146.0
249142.0,6,3,337,2,214,0.0,160.0,107.0,1,123,0.0,123.0,123.0
14012108.0,17,6,2052,6,2052,2802421.6,342.0,342.0,0,0,0.0,0.0,0.0
111678.0,17,2,286,2,286,0.0,143.0,143.0,0,0,0.0,0.0,0.0
3305674.0,6,151,127038,90,118710,37126.23595505618,1510.0,1319.0,61,8328,49890.85,1510.0,136.52459016393442
324675.0,17,4,1400,4,1400,108225.0,350.0,350.0,0,0,0.0,0.0,0.0
107871.0,17,2,286,2,286,0.0,143.0,143.0,0,0,0.0,0.0,0.0
0.0,6,1,66,1,66,0.0,66.0,66.0,0,0,0.0,0.0,0.0
413853.0,6,3,1604,1,753,0.0,753.0,753.0,2,851,0.0,785.0,425.5
2038.0,17,4,344,2,150,0.0,75.0,75.0,2,194,0.0,103.0,97.0
155447.0,6,3,337,2,214,0.0,160.0,107.0,1,123,0.0,123.0,123.0
1633.0,17,2,762,2,762,0.0,381.0,381.0,0,0,0.0,0.0,0.0
120013298.0,6,16,1192,8,596,17144756.85714286,95.0,74.5,8,596,17109121.714285713,95.0,74.5
119351284.0,6,225,25468,113,17780,1065636.4642857143,284.0,157.34513274336285,112,7688,1057493.5675675676,140.0,68.64285714285714
90258033.0,6,13,2036,8,1016,12894004.714285716,188.0,127.0,5,1020,22523744.0,204.0,204.0
240731.0,6,4,439,2,238,0.0,172.0,119.0,2,201,0.0,135.0,100.5
318925.0,17,4,1400,4,1400,106308.33333333331,350.0,350.0,0,0,0.0,0.0,0.0
117258086.0,6,48,3168,24,1584,5098177.652173913,66.0,66.0,24,1584,5086204.608695652,66.0,66.0
90950889.0,6,21,1585,11,840,9094338.8,95.0,76.36363636363636,10,745,10104249.777777778,95.0,74.5
302387.0,6,2,132,1,66,0.0,66.0,66.0,1,66,0.0,66.0,66.0
3011671.0,6,11,2106,6,598,602126.8,252.0,99.66666666666669,5,1508,1675.5,1236.0,301.6
48393.0,6,14,4740,7,653,7725.0,249.0,93.28571428571428,7,4087,7448.666666666667,1514.0,583.8571428571429
5005537.0,17,4,849,2,166,0.0,83.0,83.0,2,683,0.0,499.0,341.5
3053.0,17,4,625,2,163,0.0,89.0,81.5,2,462,0.0,245.0,231.0
396.0,17,2,152,1,76,0.0,76.0,76.0,1,76,0.0,76.0,76.0
17613.0,6,10,1932,5,480,4122.75,252.0,96.0,5,1452,3944.0,1224.0,290.4
1788791.0,6,22,6443,12,1529,162617.36363636365,357.0,127.41666666666669,10,4914,162458.33333333334,1510.0,491.4
90047484.0,17,28,13364,28,13364,3335092.0,501.0,477.2857142857143,0,0,0.0,0.0,0.0
90682057.0,6,21,1585,10,745,10075784.111111112,95.0,74.5,11,840,9043120.9,95.0,76.36363636363636
365.0,17,2,166,1,75,0.0,75.0,75.0,1,91,0.0,91.0,91.0
27551.0,6,10,2032,5,524,6558.0,252.0,104.8,5,1508,5948.75,1236.0,301.6
37862.0,6,11,1131,6,600,7111.4,262.0,100.0,5,531,8243.75,259.0,106.2
100154702.0,17,12,778,6,389,19998917.4,174.0,64.83333333333333,6,389,19972439.6,174.0,64.83333333333333
1300227.0,6,4,264,2,132,0.0,66.0,66.0,2,132,0.0,66.0,66.0
356.0,17,2,214,1,75,0.0,75.0,75.0,1,139,0.0,139.0,139.0
108101383.0,17,5,955,5,955,27025345.75,191.0,191.0,0,0,0.0,0.0,0.0
241701.0,6,3,337,2,214,0.0,160.0,107.0,1,123,0.0,123.0,123.0
120074584.0,17,29,13785,29,13785,4288378.0,501.0,475.3448275862069,0,0,0.0,0.0,0.0
2020376.0,17,4,525,2,150,0.0,75.0,75.0,2,375,0.0,284.0,187.5
120189493.0,6,220,24884,110,7556,1095144.1376146788,140.0,68.69090909090909,110,17328,1085767.1926605504,284.0,157.52727272727273
25376.0,6,14,4740,7,653,4111.833333333333,249.0,93.28571428571428,7,4087,4061.1666666666665,1514.0,583.8571428571429
114088501.0,17,16,1212,8,606,16289823.714285716,174.0,75.75,8,606,16285852.142857144,174.0,75.75
119000752.0,17,13,821,7,432,19833458.666666668,174.0,61.71428571428572,6,389,19802031.2,174.0,64.83333333333333
2153130.0,17,4,1368,4,1368,717710.0,342.0,342.0,0,0,0.0,0.0,0.0
108107225.0,17,5,1005,5,1005,27026806.25,201.0,201.0,0,0,0.0,0.0,0.0
32684763.0,6,5,336,2,134,0.0,68.0,67.0,3,202,14949629.5,70.0,67.33333333333333
40840.0,6,14,4740,7,653,6629.833333333333,249.0,93.28571428571428,7,4087,5918.333333333333,1514.0,583.8571428571429
2527037.0,6,25,7573,14,3735,194387.4615384616,1514.0,266.7857142857143,11,3838,226747.7,1514.0,348.90909090909093
35915.0,6,10,2032,5,524,7360.75,252.0,104.8,5,1508,6864.25,1236.0,301.6
85.0,17,2,762,2,762,0.0,381.0,381.0,0,0,0.0,0.0,0.0
34122.0,6,10,2032,5,524,8033.5,252.0,104.8,5,1508,7969.0,1236.0,301.6
2847261.0,6,3,204,2,136,0.0,70.0,68.0,1,68,0.0,68.0,68.0
276241.0,17,4,1400,4,1400,92080.33333333331,350.0,350.0,0,0,0.0,0.0,0.0
213705.0,17,2,180,1,90,0.0,90.0,90.0,1,90,0.0,90.0,90.0
3519395.0,6,205,178751,124,169102,28612.9674796748,1510.0,1363.725806451613,81,9649,40186.5,1510.0,119.12345679012346
120128989.0,6,13,2036,5,1020,30032247.25,204.0,204.0,8,1016,17138112.714285713,188.0,127.0
18645.0,6,10,1067,5,536,4478.5,264.0,107.2,5,531,3578.5,259.0,106.2
108801.0,17,2,286,2,286,0.0,143.0,143.0,0,0,0.0,0.0,0.0
90008888.0,17,28,13364,28,13364,3333662.5185185187,501.0,477.2857142857143,0,0,0.0,0.0,0.0
5625791.0,6,4,270,2,134,0.0,68.0,67.0,2,136,0.0,70.0,68.0
10481943.0,6,7,478,4,272,3448733.0,74.0,68.0,3,206,5172949.5,74.0,68.66666666666667
10460947.0,6,7,478,4,272,3441402.333333333,74.0,68.0,3,206,5161981.0,74.0,68.66666666666667
27629.0,6,14,4740,7,653,3753.8333333333335,249.0,93.28571428571428,7,4087,4263.833333333333,1514.0,583.8571428571429
867.0,17,5,550,5,550,216.75,110.0,110.0,0,0,0.0,0.0,0.0
348740.0,17,8,12112,8,12112,49820.0,1514.0,1514.0,0,0,0.0,0.0,0.0
90327335.0,6,16,1192,8,596,12893375.0,95.0,74.5,8,596,12902658.0,95.0,74.5
108110144.0,17,5,1005,5,1005,27027536.0,201.0,201.0,0,0,0.0,0.0,0.0
922442.0,6,12,1354,6,723,183687.6,253.0,120.5,6,631,184028.8,293.0,105.16666666666669
90535347.0,6,13,2036,8,1016,12933621.0,188.0,127.0,5,1020,22592269.25,204.0,204.0
102001373.0,17,13,821,7,432,17000228.833333332,174.0,61.71428571428572,6,389,16401290.4,174.0,64.83333333333333
135137458.0,17,6,1146,6,1146,27027491.6,191.0,191.0,0,0,0.0,0.0,0.0
120374788.0,6,299,35652,150,25596,807884.4832214765,336.0,170.64,149,10056,808964.1081081082,140.0,67.48993288590604
108105336.0,17,5,955,5,955,27026334.0,191.0,191.0,0,0,0.0,0.0,0.0
300658.0,6,6,412,4,272,100219.33333333331,74.0,68.0,2,140,0.0,74.0,70.0
68721.0,6,14,4740,7,653,11229.0,249.0,93.28571428571428,7,4087,11234.166666666666,1514.0,583.8571428571429
90300216.0,6,16,1192,8,596,12894027.857142856,95.0,74.5,8,596,12899447.285714284,95.0,74.5
108109188.0,17,5,955,5,955,27027297.0,191.0,191.0,0,0,0.0,0.0,0.0
100583.0,17,2,762,2,762,0.0,381.0,381.0,0,0,0.0,0.0,0.0
2075.0,17,4,344,2,150,0.0,75.0,75.0,2,194,0.0,103.0,97.0
117202080.0,6,77,14416,52,8883,2298080.0,1514.0,170.82692307692307,25,5533,2743540.6666666665,1514.0,221.32
119949084.0,6,848,164586,419,28246,286959.5311004785,214.0,67.4128878281623,429,136340,279744.94158878503,1514.0,317.8088578088578
69296.0,17,2,602,1,74,0.0,74.0,74.0,1,528,0.0,528.0,528.0
120125057.0,6,14,2224,9,1204,15015632.125,188.0,133.77777777777777,5,1020,22523517.25,204.0,204.0
120234360.0,6,19,1395,10,745,13332375.111111112,95.0,74.5,9,650,14998784.375,95.0,72.22222222222223
40037.0,6,14,4740,7,653,5277.166666666667,249.0,93.28571428571428,7,4087,6358.5,1514.0,583.8571428571429
119720408.0,6,220,24884,110,17328,1096374.8623853212,284.0,157.52727272727273,110,7556,1096377.0,140.0,68.69090909090909
336.0,17,2,267,1,83,0.0,83.0,83.0,1,184,0.0,184.0,184.0
0.0,17,1,453,1,453,0.0,453.0,453.0,0,0,0.0,0.0,0.0
1409465.0,17,16,1120,16,1120,93964.33333333331,70.0,70.0,0,0,0.0,0.0,0.0
197795.0,17,2,180,1,90,0.0,90.0,90.0,1,90,0.0,90.0,90.0
107219.0,17,2,286,2,286,0.0,143.0,143.0,0,0,0.0,0.0,0.0
179525.0,17,2,180,1,90,0.0,90.0,90.0,1,90,0.0,90.0,90.0
41326895.0,6,8,1307,8,1307,5903842.142857143,172.0,163.375,0,0,0.0,0.0,0.0
119788260.0,6,218,24678,109,17262,1107159.0185185184,284.0,158.36697247706422,109,7416,1107159.2314814816,140.0,68.03669724770643
36776.0,6,10,2032,5,524,7839.0,252.0,104.8,5,1508,8749.75,1236.0,301.6
2312.0,17,4,344,2,150,0.0,75.0,75.0,2,194,0.0,103.0,97.0
90311370.0,6,17,1287,9,691,11282331.75,95.0,76.77777777777777,8,596,12834487.42857143,95.0,74.5
2780281.0,6,2,132,1,66,0.0,66.0,66.0,1,66,0.0,66.0,66.0
2419.0,17,4,344,2,150,0.0,75.0,75.0,2,194,0.0,103.0,97.0
47071.0,6,14,4740,7,653,7637.166666666667,249.0,93.28571428571428,7,4087,7137.166666666667,1514.0,583.8571428571429
2310.0,17,4,344,2,150,0.0,75.0,75.0,2,194,0.0,103.0,97.0
0.0,17,1,80,1,80,0.0,80.0,80.0,0,0,0.0,0.0,0.0
120305581.0,6,225,25664,113,17976,1074156.9732142857,336.0,159.0796460176991,112,7688,1075553.5315315316,140.0,68.64285714285714
120270172.0,6,17,1287,9,691,15033771.5,95.0,76.77777777777777,8,596,17105147.285714287,95.0,74.5
60889901.0,6,3,917,1,66,0.0,66.0,66.0,2,851,0.0,785.0,425.5
135125982.0,17,6,1146,6,1146,27025196.4,191.0,191.0,0,0,0.0,0.0,0.0
197153.0,17,2,180,1,90,0.0,90.0,90.0,1,90,0.0,90.0,90.0
317285.0,17,4,1400,4,1400,105761.66666666669,350.0,350.0,0,0,0.0,0.0,0.0
19748.0,6,2,145,2,145,0.0,91.0,72.5,0,0,0.0,0.0,0.0
104162.0,17,2,286,2,286,0.0,143.0,143.0,0,0,0.0,0.0,0.0
47788.0,6,14,4740,7,653,7799.833333333333,249.0,93.28571428571428,7,4087,7758.5,1514.0,583.8571428571429
242282.0,6,3,337,1,123,0.0,123.0,123.0,2,214,0.0,160.0,107.0
114546491.0,6,925,213244,470,182326,244235.5884861408,1514.0,387.92765957446807,455,30918,251788.6651982379,214.0,67.95164835164834
751502.0,6,2,132,1,66,0.0,66.0,66.0,1,66,0.0,66.0,66.0
153523.0,17,2,180,1,90,0.0,90.0,90.0,1,90,0.0,90.0,90.0
213038.0,6,3,426,2,280,0.0,214.0,140.0,1,146,0.0,146.0,146.0
148033.0,6,3,337,2,214,0.0,160.0,107.0,1,123,0.0,123.0,123.0
112192913.0,17,15,1169,8,606,16027559.0,174.0,75.75,7,563,17836835.333333332,174.0,80.42857142857143
1940.0,17,2,508,2,508,0.0,257.0,254.0,0,0,0.0,0.0,0.0
300995.0,6,6,412,4,272,100331.66666666669,74.0,68.0,2,140,0.0,74.0,70.0
108111869.0,17,5,955,5,955,27027967.25,191.0,191.0,0,0,0.0,0.0,0.0
322.0,17,2,174,1,79,0.0,79.0,79.0,1,95,0.0,95.0,95.0
711564.0,6,4,270,2,134,0.0,68.0,67.0,2,136,0.0,70.0,68.0
41948.0,6,10,2032,5,524,9927.25,252.0,104.8,5,1508,10211.5,1236.0,301.6
135123038.0,17,6,1146,6,1146,27024607.6,191.0,191.0,0,0,0.0,0.0,0.0
384078.0,17,2,363,1,75,0.0,75.0,75.0,1,288,0.0,288.0,288.0
323.0,17,2,174,1,79,0.0,79.0,79.0,1,95,0.0,95.0,95.0
1435.0,17,5,550,5,550,358.75,110.0,110.0,0,0,0.0,0.0,0.0
116876379.0,6,48,3168,24,1584,5081581.695652174,66.0,66.0,24,1584,5067907.391304348,66.0,66.0
135128158.0,17,6,1146,6,1146,27025631.6,191.0,191.0,0,0,0.0,0.0,0.0
504853.0,6,5,336,2,134,0.0,68.0,67.0,3,202,195419.0,70.0,67.33333333333333
92797977.0,6,37,2442,19,1254,5155443.166666667,66.0,66.0,18,1188,4860152.352941177,66.0,66.0
9210641.0,17,3,1034,2,684,0.0,342.0,342.0,1,350,0.0,350.0,350.0
118425123.0,6,315,36464,158,10724,754300.1464968153,140.0,67.87341772151899,157,25740,752517.5641025641,284.0,163.94904458598725
108539612.0,6,31,2182,16,1165,7222340.866666666,139.0,72.8125,15,1017,7738223.785714285,123.0,67.8
333.0,17,2,208,1,72,0.0,72.0,72.0,1,136,0.0,136.0,136.0
110280951.0,6,275,33830,138,24566,804970.4452554744,336.0,178.0144927536232,137,9264,795697.5882352941,140.0,67.62043795620438
3586180.0,6,5,336,2,134,0.0,68.0,67.0,3,202,1429507.0,70.0,67.33333333333333
32194.0,6,14,4740,7,653,4874.833333333333,249.0,93.28571428571428,7,4087,4975.833333333333,1514.0,583.8571428571429
183588.0,17,2,180,1,90,0.0,90.0,90.0,1,90,0.0,90.0,90.0
1669.0,17,2,762,2,762,0.0,381.0,381.0,0,0,0.0,0.0,0.0
2826.0,17,4,344,2,150,0.0,75.0,75.0,2,194,0.0,103.0,97.0
1985.0,17,4,344,2,150,0.0,75.0,75.0,2,194,0.0,103.0,97.0
30778.0,6,14,4740,7,653,3615.6666666666665,249.0,93.28571428571428,7,4087,4804.333333333333,1514.0,583.8571428571429
345.0,17,2,267,1,83,0.0,83.0,83.0,1,184,0.0,184.0,184.0
5824865.0,6,5,336,2,134,0.0,68.0,67.0,3,202,1526192.5,70.0,67.33333333333333
108117745.0,17,5,1005,5,1005,27029436.25,201.0,201.0,0,0,0.0,0.0,0.0
90255379.0,6,12,1832,8,1016,12893625.57142857,188.0,127.0,4,816,30030039.0,204.0,204.0
2363.0,17,4,344,2,150,0.0,75.0,75.0,2,194,0.0,103.0,97.0
120003815.0,6,18,1341,9,691,14999999.25,95.0,76.77777777777777,9,650,14999327.125,95.0,72.22222222222223
2085.0,17,4,344,2,150,0.0,75.0,75.0,2,194,0.0,103.0,97.0
5647.0,17,2,180,1,90,0.0,90.0,90.0,1,90,0.0,90.0,90.0
317577.0,17,4,1400,4,1400,105859.0,350.0,350.0,0,0,0.0,0.0,0.0
21590.0,17,2,582,1,83,0.0,83.0,83.0,1,499,0.0,499.0,499.0
47817.0,6,14,4740,7,653,7554.0,249.0,93.28571428571428,7,4087,7776.666666666667,1514.0,583.8571428571429
90093652.0,6,10,1440,7,828,15015608.666666666,188.0,118.28571428571428,3,612,30030677.5,204.0,204.0
589984.0,6,4,508,2,238,0.0,172.0,119.0,2,270,0.0,135.0,135.0
59392.0,6,14,4740,7,653,9776.166666666666,249.0,93.28571428571428,7,4087,8138.0,1514.0,583.8571428571429
132442.0,6,2,132,1,66,0.0,66.0,66.0,1,66,0.0,66.0,66.0
103527.0,17,2,286,2,286,0.0,143.0,143.0,0,0,0.0,0.0,0.0
2034077.0,6,24,7544,12,2450,184916.0909090909,1034.0,204.16666666666663,12,5094,157267.45454545456,1510.0,424.5
108108497.0,17,5,955,5,955,27027124.25,191.0,191.0,0,0,0.0,0.0,0.0
85796.0,6,14,4740,7,653,14168.5,249.0,93.28571428571428,7,4087,12654.666666666666,1514.0,583.8571428571429
2801734.0,6,2,132,1,66,0.0,66.0,66.0,1,66,0.0,66.0,66.0
34248.0,6,10,2032,5,524,8349.5,252.0,104.8,5,1508,7528.25,1236.0,301.6
2276.0,17,4,344,2,150,0.0,75.0,75.0,2,194,0.0,103.0,97.0
316115.0,6,3,202,2,128,0.0,74.0,64.0,1,74,0.0,74.0,74.0
299666.0,6,6,412,4,272,99888.66666666669,74.0,68.0,2,140,0.0,74.0,70.0
3420.0,17,2,414,1,88,0.0,88.0,88.0,1,326,0.0,326.0,326.0
1305639.0,6,4,264,2,132,0.0,66.0,66.0,2,132,0.0,66.0,66.0
108380949.0,17,14,864,7,432,18001657.0,174.0,61.71428571428572,7,432,18000187.333333332,174.0,61.71428571428572
28047.0,6,10,2032,5,524,6788.75,252.0,104.8,5,1508,2848.25,1236.0,301.6
103677835.0,6,44,2904,22,1452,4937039.761904762,66.0,66.0,22,1452,4922062.428571428,66.0,66.0
167364.0,17,4,704,2,148,0.0,74.0,74.0,2,556,0.0,280.0,278.0
5622652.0,6,5,336,2,134,0.0,68.0,67.0,3,202,1418735.5,70.0,67.33333333333333
36576.0,6,14,4740,7,653,5969.5,249.0,93.28571428571428,7,4087,5953.833333333333,1514.0,583.8571428571429
2028.0,17,4,344,2,150,0.0,75.0,75.0,2,194,0.0,103.0,97.0
108100461.0,17,5,1005,5,1005,27025115.25,201.0,201.0,0,0,0.0,0.0,0.0
142693.0,6,2,132,1,66,0.0,66.0,66.0,1,66,0.0,66.0,66.0
144346.0,17,2,180,1,90,0.0,90.0,90.0,1,90,0.0,90.0,90.0
232519.0,17,2,180,1,90,0.0,90.0,90.0,1,90,0.0,90.0,90.0
120735072.0,17,14,864,7,432,16833501.166666668,174.0,61.71428571428572,7,432,16833994.5,174.0,61.71428571428572
2328780.0,6,3,1604,2,851,0.0,785.0,425.5,1,753,0.0,753.0,753.0
90039607.0,17,28,13364,28,13364,3334800.25925926,501.0,477.2857142857143,0,0,0.0,0.0,0.0
100028152.0,17,12,778,6,389,20000183.4,174.0,64.83333333333333,6,389,20001507.2,174.0,64.83333333333333
322.0,17,2,174,1,79,0.0,79.0,79.0,1,95,0.0,95.0,95.0
120446385.0,6,189,21344,95,14844,1281344.5212765958,284.0,156.25263157894736,94,6500,1261485.0537634408,140.0,69.14893617021276
118883116.0,6,34,2350,17,1225,7416680.875,139.0,72.05882352941177,17,1125,7416702.875,123.0,66.17647058823529
27545686.0,17,5,1710,5,1710,6886421.5,342.0,342.0,0,0,0.0,0.0,0.0
120991962.0,6,32,2242,17,1225,7561997.625,139.0,72.05882352941177,15,1017,7914193.285714285,123.0,67.8
129001263.0,17,15,907,8,475,18428751.85714286,174.0,59.375,7,432,18168918.666666668,174.0,61.71428571428572
120121712.0,6,12,1832,8,1016,17136993.85714286,188.0,127.0,4,816,30028600.0,204.0,204.0
187971.0,17,6,1230,3,234,93801.0,78.0,78.0,3,996,93777.0,332.0,332.0
121110970.0,6,33,2296,17,1225,7569435.625,139.0,72.05882352941177,16,1071,7394002.666666667,123.0,66.9375
90252982.0,6,13,2036,8,1016,12893283.142857144,188.0,127.0,5,1020,22522634.5,204.0,204.0
0.0,17,1,381,1,381,0.0,381.0,381.0,0,0,0.0,0.0,0.0
2329.0,17,4,344,2,150,0.0,75.0,75.0,2,194,0.0,103.0,97.0
10838944.0,6,8,544,4,272,3567572.333333333,74.0,68.0,4,272,3567493.333333333,74.0,68.0
113168189.0,6,46,3036,23,1518,5143996.090909091,66.0,66.0,23,1518,5143996.727272728,66.0,66.0
28610.0,6,14,4740,7,653,4615.333333333333,249.0,93.28571428571428,7,4087,4282.166666666667,1514.0,583.8571428571429
146942.0,6,3,373,2,238,0.0,172.0,119.0,1,135,0.0,135.0,135.0
69079.0,17,2,602,1,74,0.0,74.0,74.0,1,528,0.0,528.0,528.0
90319772.0,6,24,1829,13,989,7522271.666666667,95.0,76.07692307692308,11,840,8957884.2,95.0,76.36363636363636
90078864.0,6,14,1976,8,1016,12868409.142857144,188.0,127.0,6,960,12015049.0,204.0,160.0
1850.0,17,4,438,2,148,0.0,74.0,74.0,2,290,0.0,147.0,145.0
320770.0,17,4,1400,4,1400,106923.33333333331,350.0,350.0,0,0,0.0,0.0,0.0
205378.0,17,2,762,2,762,0.0,381.0,381.0,0,0,0.0,0.0,0.0
108106571.0,17,5,1005,5,1005,27026642.75,201.0,201.0,0,0,0.0,0.0,0.0
90263666.0,6,14,2240,8,1016,12894809.42857143,188.0,127.0,6,1224,18020366.0,204.0,204.0
256852.00000000003,6,3,337,2,214,0.0,160.0,107.0,1,123,0.0,123.0,123.0
404.0,17,2,174,1,79,0.0,79.0,79.0,1,95,0.0,95.0,95.0
40528.0,6,10,2032,5,524,9446.75,252.0,104.8,5,1508,9881.25,1236.0,301.6
93977695.0,6,189,21360,95,14934,999762.7127659576,284.0,157.2,94,6426,999352.870967742,140.0,68.36170212765957
2410.0,17,4,344,2,150,0.0,75.0,75.0,2,194,0.0,103.0,97.0
217534.0,6,3,426,2,280,0.0,214.0,140.0,1,146,0.0,146.0,146.0
350.0,17,2,164,1,82,0.0,82.0,82.0,1,82,0.0,82.0,82.0
204899.0,6,10,1221,6,636,40979.8,298.0,106.0,4,585,67005.33333333333,379.0,146.25
119380569.0,6,18,1341,9,691,14916860.625,95.0,76.77777777777777,9,650,14922227.625,95.0,72.22222222222223
210995.0,6,2,132,1,66,0.0,66.0,66.0,1,66,0.0,66.0,66.0
223980.0,6,3,426,2,280,0.0,214.0,140.0,1,146,0.0,146.0,146.0
146879.0,6,3,373,2,238,0.0,172.0,119.0,1,135,0.0,135.0,135.0
190974.0,17,2,180,1,90,0.0,90.0,90.0,1,90,0.0,90.0,90.0
48890004.0,6,8,1307,8,1307,6984286.285714285,172.0,163.375,0,0,0.0,0.0,0.0
0.0,17,1,55,1,55,0.0,55.0,55.0,0,0,0.0,0.0,0.0
122777.0,6,2,132,1,66,0.0,66.0,66.0,1,66,0.0,66.0,66.0
0.0,17,1,55,1,55,0.0,55.0,55.0,0,0,0.0,0.0,0.0
206957.0,6,4,492,2,280,0.0,214.0,140.0,2,212,0.0,146.0,106.0
45573.0,6,14,4740,7,653,7275.0,249.0,93.28571428571428,7,4087,7357.833333333333,1514.0,583.8571428571429
346.0,17,2,267,1,83,0.0,83.0,83.0,1,184,0.0,184.0,184.0
233213.0,17,2,180,1,90,0.0,90.0,90.0,1,90,0.0,90.0,90.0
2590605.0,6,2,132,1,66,0.0,66.0,66.0,1,66,0.0,66.0,66.0
281104.0,17,2,414,1,88,0.0,88.0,88.0,1,326,0.0,326.0,326.0
195390.0,17,2,180,1,90,0.0,90.0,90.0,1,90,0.0,90.0,90.0
5964.0,17,4,344,2,150,0.0,75.0,75.0,2,194,0.0,103.0,97.0
138768.0,6,2,132,1,66,0.0,66.0,66.0,1,66,0.0,66.0,66.0
107816287.0,17,14,864,7,432,17833501.166666668,174.0,61.71428571428572,7,432,17834048.5,174.0,61.71428571428572
735392.0,6,11,1021,6,444,98456.2,162.0,74.0,5,577,122623.75,349.0,115.4
2068802.0,6,19,6869,11,1567,206880.2,408.0,142.45454545454547,8,5302,234813.57142857145,1514.0,662.75
90261854.0,6,14,2240,8,1016,12894550.57142857,188.0,127.0,6,1224,18019616.6,204.0,204.0
193151.0,17,4,6056,4,6056,64383.66666666666,1514.0,1514.0,0,0,0.0,0.0,0.0
3116.0,17,4,344,2,150,0.0,75.0,75.0,2,194,0.0,103.0,97.0
6730.0,17,2,762,2,762,0.0,381.0,381.0,0,0,0.0,0.0,0.0
100379773.0,6,867,186656,429,29054,234497.6845794393,214.0,67.72494172494173,438,157602,229652.60640732263,1514.0,359.82191780821915
2175.0,17,4,344,2,150,0.0,75.0,75.0,2,194,0.0,103.0,97.0
196938.0,17,2,180,1,90,0.0,90.0,90.0,1,90,0.0,90.0,90.0
90100574.0,6,11,1644,4,816,30030931.666666668,204.0,204.0,7,828,15016364.833333334,188.0,118.28571428571428
6548.0,17,2,447,1,84,0.0,84.0,84.0,1,363,0.0,363.0,363.0
2586735.0,6,2,132,1,66,0.0,66.0,66.0,1,66,0.0,66.0,66.0
16509.0,6,14,4740,7,653,2352.5,249.0,93.28571428571428,7,4087,2612.5,1514.0,583.8571428571429
114743036.0,17,14,864,7,432,19000158.83333333,174.0,61.71428571428572,7,432,19001217.166666668,174.0,61.71428571428572
303593.0,17,2,180,1,90,0.0,90.0,90.0,1,90,0.0,90.0,90.0
113536315.0,6,46,3036,23,1518,5160730.181818182,66.0,66.0,23,1518,5160728.045454546,66.0,66.0
108108169.0,17,5,1005,5,1005,27027042.25,201.0,201.0,0,0,0.0,0.0,0.0
397423.0,17,2,363,1,75,0.0,75.0,75.0,1,288,0.0,288.0,288.0
1084515.0,6,13,1386,7,789,180752.5,253.0,112.71428571428572,6,597,215191.4,259.0,99.5
310618.0,6,6,412,4,272,103539.33333333331,74.0,68.0,2,140,0.0,74.0,70.0
1051497.0,6,13,1479,7,882,175249.5,291.0,126.0,6,597,207589.8,259.0,99.5
47690.0,6,10,2032,5,524,11704.75,252.0,104.8,5,1508,10518.25,1236.0,301.6
13373.0,6,12,1393,6,796,2525.2,271.0,132.66666666666666,6,597,2515.6,259.0,99.5
248685.0,6,3,337,2,214,0.0,160.0,107.0,1,123,0.0,123.0,123.0
144856.0,17,2,180,1,70,0.0,70.0,70.0,1,110,0.0,110.0,110.0
137114.0,6,2,132,1,66,0.0,66.0,66.0,1,66,0.0,66.0,66.0
129758095.0,17,14,864,7,432,18334839.5,174.0,61.71428571428572,7,432,18333496.83333333,174.0,61.71428571428572
2802111.0,6,2,132,1,66,0.0,66.0,66.0,1,66,0.0,66.0,66.0
45480.0,6,14,4740,7,653,7443.5,249.0,93.28571428571428,7,4087,6773.0,1514.0,583.8571428571429
1420163.0,17,16,1120,16,1120,94677.53333333334,70.0,70.0,0,0,0.0,0.0,0.0
146067.0,6,3,337,2,214,0.0,160.0,107.0,1,123,0.0,123.0,123.0
67795.0,6,14,4740,7,653,10645.0,249.0,93.28571428571428,7,4087,9779.166666666666,1514.0,583.8571428571429
123250359.0,6,49,3234,25,1650,5135431.625,66.0,66.0,24,1584,4998631.043478261,66.0,66.0
0.0,17,1,136,1,136,0.0,136.0,136.0,0,0,0.0,0.0,0.0
42900.0,6,14,4740,7,653,6780.333333333333,249.0,93.28571428571428,7,4087,7016.833333333333,1514.0,583.8571428571429
33705278.0,6,5,336,2,134,0.0,68.0,67.0,3,202,15463017.0,70.0,67.33333333333333
117554034.0,6,30,1990,15,1042,8381347.142857143,139.0,69.46666666666667,15,948,8381340.642857143,123.0,63.2
21016.0,6,10,2032,5,524,5042.5,252.0,104.8,5,1508,4517.75,1236.0,301.6
90038262.0,17,28,13364,28,13364,3334750.4444444445,501.0,477.2857142857143,0,0,0.0,0.0,0.0
135135411.0,17,6,1206,6,1206,27027082.2,201.0,201.0,0,0,0.0,0.0,0.0
120000024.0,6,21,1585,11,799,12000002.4,95.0,72.63636363636364,10,786,10034392.0,95.0,78.6
1313818.0,6,4,264,2,132,0.0,66.0,66.0,2,132,0.0,66.0,66.0
5546.0,17,2,762,2,762,0.0,381.0,381.0,0,0,0.0,0.0,0.0
120124577.0,6,15,2428,9,1204,15015572.125,188.0,133.77777777777777,6,1224,18073043.6,204.0,204.0
1368307.0,17,6,1230,3,234,683964.0,78.0,78.0,3,996,683936.0,332.0,332.0
1317408.0,6,4,264,2,132,0.0,66.0,66.0,2,132,0.0,66.0,66.0
209565.0,17,2,180,1,90,0.0,90.0,90.0,1,90,0.0,90.0,90.0
3509.0,17,4,438,2,148,0.0,74.0,74.0,2,290,0.0,147.0,145.0
90295032.0,6,16,1192,8,596,12892718.285714284,95.0,74.5,8,596,12898254.42857143,95.0,74.5
49477.0,6,14,4740,7,653,7856.166666666667,249.0,93.28571428571428,7,4087,7365.5,1514.0,583.8571428571429
207117.0,6,3,426,2,280,0.0,214.0,140.0,1,146,0.0,146.0,146.0
586991.0,17,2,346,1,78,0.0,78.0,78.0,1,268,0.0,268.0,268.0
331669.0,6,6,412,4,272,110556.33333333331,74.0,68.0,2,140,0.0,74.0,70.0
4198.0,17,2,598,1,72,0.0,72.0,72.0,1,526,0.0,526.0,526.0
95042481.0,17,12,778,6,389,19001035.0,174.0,64.83333333333333,6,389,19000156.6,174.0,64.83333333333333
118884469.0,6,36,2734,19,1471,6604692.722222222,139.0,77.42105263157895,17,1263,7416763.5,123.0,74.29411764705883
5827419.0,6,5,336,2,134,0.0,68.0,67.0,3,202,1527589.0,70.0,67.33333333333333
15147.0,6,11,1131,6,600,2180.4,262.0,100.0,5,531,3570.0,259.0,106.2
90048926.0,17,28,13364,28,13364,3335145.407407407,501.0,477.2857142857143,0,0,0.0,0.0,0.0
50476837.0,17,4,360,2,180,0.0,90.0,90.0,2,180,0.0,90.0,90.0
120030214.0,17,29,13785,29,13785,4286793.357142857,501.0,475.3448275862069,0,0,0.0,0.0,0.0
1679051.0,6,7,499,3,198,817741.5,66.0,66.0,4,301,488921.6666666667,103.0,75.25
91944579.0,17,16,5472,16,5472,6129638.6,342.0,342.0,0,0,0.0,0.0,0.0
27385666.0,17,5,1710,5,1710,6846416.5,342.0,342.0,0,0,0.0,0.0,0.0
149967.0,6,2,132,1,66,0.0,66.0,66.0,1,66,0.0,66.0,66.0
209357.0,17,2,180,1,90,0.0,90.0,90.0,1,90,0.0,90.0,90.0
255659.00000000003,6,3,337,2,214,0.0,160.0,107.0,1,123,0.0,123.0,123.0
822.0,17,4,438,2,148,0.0,74.0,74.0,2,290,0.0,147.0,145.0
9770.0,17,2,582,1,83,0.0,83.0,83.0,1,499,0.0,499.0,499.0
146062.0,6,3,337,2,214,0.0,160.0,107.0,1,123,0.0,123.0,123.0
108106912.0,17,5,1005,5,1005,27026728.0,201.0,201.0,0,0,0.0,0.0,0.0
108103475.0,17,5,955,5,955,27025868.75,191.0,191.0,0,0,0.0,0.0,0.0
143842.0,17,2,180,1,90,0.0,90.0,90.0,1,90,0.0,90.0,90.0
0.0,17,1,381,1,381,0.0,381.0,381.0,0,0,0.0,0.0,0.0
120264251.0,6,256,30156,128,8670,940460.0551181104,140.0,67.734375,128,21486,940613.0157480316,554.0,167.859375
123839959.0,6,49,3234,25,1650,5159998.291666667,66.0,66.0,24,1584,5097020.0,66.0,66.0
113168319.0,6,46,3036,23,1518,5144003.2727272725,66.0,66.0,23,1518,5143994.363636363,66.0,66.0
11530.0,6,10,2032,5,524,2720.5,252.0,104.8,5,1508,2561.75,1236.0,301.6
2382.0,17,2,684,1,342,0.0,342.0,342.0,1,342,0.0,342.0,342.0
40786.0,6,14,4740,7,653,6668.0,249.0,93.28571428571428,7,4087,6351.0,1514.0,583.8571428571429
98520652.0,6,30,2106,15,1089,7037189.428571428,123.0,72.6,15,1017,7021741.214285715,123.0,67.8
845559.0,6,9,1096,6,625,169111.8,287.0,104.16666666666669,3,471,284877.0,331.0,157.0
6883.0,17,2,582,1,83,0.0,83.0,83.0,1,499,0.0,499.0,499.0
31864.000000000004,6,10,2032,5,524,6805.5,252.0,104.8,5,1508,7622.0,1236.0,301.6
102812.0,17,2,286,2,286,0.0,143.0,143.0,0,0,0.0,0.0,0.0
316392.0,6,3,202,2,128,0.0,74.0,64.0,1,74,0.0,74.0,74.0
246106.0,6,3,337,2,214,0.0,160.0,107.0,1,123,0.0,123.0,123.0
228332.0,6,13,1386,7,789,38055.333333333336,253.0,112.71428571428572,6,597,43900.8,259.0,99.5
2389.0,17,4,344,2,150,0.0,75.0,75.0,2,194,0.0,103.0,97.0
147041.0,6,3,373,2,238,0.0,172.0,119.0,1,135,0.0,135.0,135.0
1561051.0,6,4,276,2,128,0.0,74.0,64.0,2,148,0.0,74.0,74.0
208596.0,17,2,762,2,762,0.0,381.0,381.0,0,0,0.0,0.0,0.0
37951.0,6,10,2032,5,524,6617.75,252.0,104.8,5,1508,8954.5,1236.0,301.6
90292111.0,6,16,1192,8,596,12891704.0,95.0,74.5,8,596,12897306.142857144,95.0,74.5
196933.0,17,2,180,1,90,0.0,90.0,90.0,1,90,0.0,90.0,90.0
3345803.0,6,7,923,4,753,1046448.6666666666,571.0,188.25,3,170,1570172.0,62.0,56.66666666666666
35551.0,6,14,4740,7,653,5798.666666666667,249.0,93.28571428571428,7,4087,5722.5,1514.0,583.8571428571429
309129.0,6,6,412,4,272,103043.0,74.0,68.0,2,140,0.0,74.0,70.0
107432981.0,6,33,2412,17,1272,6714561.3125,123.0,74.82352941176471,16,1140,7147775.266666667,123.0,71.25
311455.0,6,7,478,4,272,103818.33333333331,74.0,68.0,3,206,75422.0,74.0,68.66666666666667
16792.0,17,2,180,1,90,0.0,90.0,90.0,1,90,0.0,90.0,90.0
20456.0,17,2,582,1,83,0.0,83.0,83.0,1,499,0.0,499.0,499.0
113254835.0,6,46,3036,23,1518,5135440.727272728,66.0,66.0,23,1518,5135440.181818182,66.0,66.0
4825.0,17,2,180,1,90,0.0,90.0,90.0,1,90,0.0,90.0,90.0
78905.0,6,14,4740,7,653,13019.666666666666,249.0,93.28571428571428,7,4087,12020.0,1514.0,583.8571428571429
302181.0,6,6,412,4,272,100727.0,74.0,68.0,2,140,0.0,74.0,70.0
121261.0,6,3,337,2,214,0.0,160.0,107.0,1,123,0.0,123.0,123.0
402.0,17,5,550,5,550,100.5,110.0,110.0,0,0,0.0,0.0,0.0
423267.0,6,3,1604,1,753,0.0,753.0,753.0,2,851,0.0,785.0,425.5
5618649.0,6,5,336,2,134,0.0,68.0,67.0,3,202,1420835.0,70.0,67.33333333333333
48292.0,6,14,4740,7,653,7713.0,249.0,93.28571428571428,7,4087,7377.666666666667,1514.0,583.8571428571429
151820.0,17,2,414,1,88,0.0,88.0,88.0,1,326,0.0,326.0,326.0
153416.0,17,2,180,1,90,0.0,90.0,90.0,1,90,0.0,90.0,90.0
90095013.0,6,11,1644,4,816,30031253.666666668,204.0,204.0,7,828,15015143.833333334,188.0,118.28571428571428
157644.0,17,4,6056,4,6056,52548.0,1514.0,1514.0,0,0,0.0,0.0,0.0
108105608.0,17,5,955,5,955,27026402.0,191.0,191.0,0,0,0.0,0.0,0.0
109715851.0,6,29,2068,15,1105,7836846.5,139.0,73.66666666666667,14,963,8422890.76923077,123.0,68.78571428571429
208351.0,17,2,762,2,762,0.0,381.0,381.0,0,0,0.0,0.0,0.0
6273.0,17,2,447,1,84,0.0,84.0,84.0,1,363,0.0,363.0,363.0
119697471.0,6,218,24752,109,17262,1106316.601851852,374.0,158.36697247706422,109,7490,1106302.5648148148,140.0,68.71559633027523
33883.0,6,14,4740,7,653,5532.333333333333,249.0,93.28571428571428,7,4087,5171.333333333333,1514.0,583.8571428571429
90553167.0,6,13,2036,8,1016,12936166.714285716,188.0,127.0,5,1020,22598087.5,204.0,204.0
5621019.0,6,5,336,2,134,0.0,68.0,67.0,3,202,1524654.0,70.0,67.33333333333333
1826.0,17,4,344,2,150,0.0,75.0,75.0,2,194,0.0,103.0,97.0
1651836.0,6,20,6434,12,1921,150166.9090909091,620.0,160.08333333333334,8,4513,192536.14285714287,1514.0,564.125
13670.0,6,13,1459,7,862,2149.333333333333,271.0,123.14285714285714,6,597,2501.2,259.0,99.5
36568.0,6,10,2032,5,524,8875.5,252.0,104.8,5,1508,8716.75,1236.0,301.6
5624567.0,6,5,336,2,134,0.0,68.0,67.0,3,202,1524793.5,70.0,67.33333333333333
108102988.0,17,5,1005,5,1005,27025747.0,201.0,201.0,0,0,0.0,0.0,0.0
103735.0,17,2,286,2,286,0.0,143.0,143.0,0,0,0.0,0.0,0.0
312504.0,17,4,1524,4,1524,104168.0,381.0,381.0,0,0,0.0,0.0,0.0
15065457.0,17,6,2718,6,2718,3013091.4,453.0,453.0,0,0,0.0,0.0,0.0
18979693.0,6,9,589,4,288,6323322.0,95.0,72.0,5,301,4732815.5,85.0,60.2
90213115.0,6,19,1436,9,691,11244830.125,95.0,76.77777777777777,10,745,9999036.666666666,95.0,74.5
5626000.0,6,4,270,2,134,0.0,68.0,67.0,2,136,0.0,70.0,68.0
37603.0,6,14,4740,7,653,6158.0,249.0,93.28571428571428,7,4087,5304.833333333333,1514.0,583.8571428571429
41616.0,6,10,1066,5,490,9361.75,218.0,98.0,5,576,9549.25,304.0,115.2
303707.0,6,2,132,1,66,0.0,66.0,66.0,1,66,0.0,66.0,66.0
39633288.0,6,5,336,2,134,0.0,68.0,67.0,3,202,19750294.5,70.0,67.33333333333333
24926.0,6,14,4740,7,653,3729.6666666666665,249.0,93.28571428571428,7,4087,3954.3333333333335,1514.0,583.8571428571429
39116.0,6,14,4740,7,653,6350.833333333333,249.0,93.28571428571428,7,4087,6043.0,1514.0,583.8571428571429
90052773.0,17,28,13364,28,13364,3335287.888888889,501.0,477.2857142857143,0,0,0.0,0.0,0.0
304120.0,6,6,412,4,272,101373.33333333331,74.0,68.0,2,140,0.0,74.0,70.0
135135681.0,17,6,1146,6,1146,27027136.2,191.0,191.0,0,0,0.0,0.0,0.0
2269860.0,6,49,23728,25,19797,94577.5,1514.0,791.88,24,3931,89446.17391304347,1514.0,163.79166666666666
0.0,6,1,54,0,0,0.0,0.0,0.0,1,54,0.0,54.0,54.0
363.0,17,2,267,1,83,0.0,83.0,83.0,1,184,0.0,184.0,184.0
205887.0,17,2,180,1,90,0.0,90.0,90.0,1,90,0.0,90.0,90.0
119752111.0,17,35,16705,35,16705,3522120.911764706,501.0,477.2857142857143,0,0,0.0,0.0,0.0
120123331.0,6,13,2020,9,1204,15015416.375,188.0,133.77777777777777,4,816,30031473.666666668,204.0,204.0
36182.0,6,14,4740,7,653,5922.333333333333,249.0,93.28571428571428,7,4087,5381.166666666667,1514.0,583.8571428571429
122342.0,6,3,373,2,238,0.0,172.0,119.0,1,135,0.0,135.0,135.0
118942739.0,6,35,2542,18,1348,6983925.294117647,139.0,74.88888888888889,17,1194,7420420.25,123.0,70.23529411764706
120123184.0,6,17,2836,9,1204,15015398.0,188.0,133.77777777777777,8,1632,12908700.714285716,204.0,204.0
20067.0,6,14,4740,7,653,3146.1666666666665,249.0,93.28571428571428,7,4087,3206.333333333333,1514.0,583.8571428571429
1022750.0,6,11,1134,6,558,204550.00000000003,220.0,93.0,5,576,254549.75,304.0,115.2
247155.0,17,2,180,1,90,0.0,90.0,90.0,1,90,0.0,90.0,90.0
103160.0,17,2,286,2,286,0.0,143.0,143.0,0,0,0.0,0.0,0.0
218045.0,6,3,426,2,280,0.0,214.0,140.0,1,146,0.0,146.0,146.0
135136778.0,17,6,1146,6,1146,27027355.6,191.0,191.0,0,0,0.0,0.0,0.0
5620293.0,6,5,336,2,134,0.0,68.0,67.0,3,202,1422211.5,70.0,67.33333333333333
322606.0,6,6,412,4,272,107535.33333333331,74.0,68.0,2,140,0.0,74.0,70.0
4238.0,17,2,618,1,72,0.0,72.0,72.0,1,546,0.0,546.0,546.0
874.0,17,4,438,2,148,0.0,74.0,74.0,2,290,0.0,147.0,145.0
3915476.0,6,5,336,2,134,0.0,68.0,67.0,3,202,1528290.0,70.0,67.33333333333333
301334.0,6,6,412,4,272,100444.66666666669,74.0,68.0,2,140,0.0,74.0,70.0
460.0,17,2,508,2,508,0.0,257.0,254.0,0,0,0.0,0.0,0.0
45601.0,6,10,2032,5,524,7538.25,252.0,104.8,5,1508,11153.0,1236.0,301.6
2677.0,17,4,344,2,150,0.0,75.0,75.0,2,194,0.0,103.0,97.0
120058239.0,17,28,13364,28,13364,4446601.444444444,501.0,477.2857142857143,0,0,0.0,0.0,0.0
108103214.0,17,5,1005,5,1005,27025803.5,201.0,201.0,0,0,0.0,0.0,0.0
176016.0,17,2,180,1,90,0.0,90.0,90.0,1,90,0.0,90.0,90.0
108113274.0,17,5,955,5,955,27028318.5,191.0,191.0,0,0,0.0,0.0,0.0
137834.0,17,2,176,1,80,0.0,80.0,80.0,1,96,0.0,96.0,96.0
22722.0,6,10,2032,5,524,5450.5,252.0,104.8,5,1508,5424.5,1236.0,301.6
108103953.0,17,5,1005,5,1005,27025988.25,201.0,201.0,0,0,0.0,0.0,0.0
209594.0,17,2,180,1,90,0.0,90.0,90.0,1,90,0.0,90.0,90.0
1033195.0,6,11,1134,6,558,206639.0,220.0,93.0,5,576,255653.25,304.0,115.2
321.0,17,2,174,1,79,0.0,79.0,79.0,1,95,0.0,95.0,95.0
33493.0,6,12,1413,7,882,5582.166666666667,291.0,126.0,5,531,6930.25,259.0,106.2
90012761.0,17,28,13364,28,13364,3333805.962962963,501.0,477.2857142857143,0,0,0.0,0.0,0.0
103296998.0,17,14,1126,7,563,17189479.5,174.0,80.42857142857143,7,563,17177993.333333332,174.0,80.42857142857143
153415.0,17,2,180,1,90,0.0,90.0,90.0,1,90,0.0,90.0,90.0
130631.0,6,2,132,1,66,0.0,66.0,66.0,1,66,0.0,66.0,66.0
90018995.0,17,28,13364,28,13364,3334036.851851852,501.0,477.2857142857143,0,0,0.0,0.0,0.0
465221.0,17,2,876,2,876,0.0,438.0,438.0,0,0,0.0,0.0,0.0
5651706.0,6,159,118760,85,109331,67282.21428571429,1510.0,1286.2470588235294,74,9429,73279.31506849315,1510.0,127.41891891891892
90259325.0,6,13,2036,8,1016,12894189.285714284,188.0,127.0,5,1020,22523970.25,204.0,204.0
148632834.0,6,26,1978,13,989,9904161.75,95.0,76.07692307692308,13,989,12384735.083333334,95.0,76.07692307692308
122530439.0,6,49,3234,25,1650,5105434.958333333,66.0,66.0,24,1584,4950721.260869565,66.0,66.0
307717.0,17,4,704,2,148,0.0,74.0,74.0,2,556,0.0,280.0,278.0
19319.0,6,14,4740,7,653,2774.1666666666665,249.0,93.28571428571428,7,4087,3063.333333333333,1514.0,583.8571428571429
112123.0,17,2,286,2,286,0.0,143.0,143.0,0,0,0.0,0.0,0.0
196890.0,17,2,180,1,90,0.0,90.0,90.0,1,90,0.0,90.0,90.0
206137.0,6,3,426,2,280,0.0,214.0,140.0,1,146,0.0,146.0,146.0
104294.0,17,2,286,2,286,0.0,143.0,143.0,0,0,0.0,0.0,0.0
120010941.0,6,26,1978,14,1084,9230722.153846154,95.0,77.42857142857143,12,894,10883700.909090908,95.0,74.5
56850.0,6,14,4740,7,653,9366.5,249.0,93.28571428571428,7,4087,8952.0,1514.0,583.8571428571429
875591.0,6,10,1336,6,799,175118.2,461.0,133.16666666666666,4,537,199960.66666666663,331.0,134.25
153557.0,17,2,180,1,90,0.0,90.0,90.0,1,90,0.0,90.0,90.0
2390.0,17,4,344,2,150,0.0,75.0,75.0,2,194,0.0,103.0,97.0
2335.0,17,4,344,2,150,0.0,75.0,75.0,2,194,0.0,103.0,97.0
6784.0,17,2,565,1,93,0.0,93.0,93.0,1,472,0.0,472.0,472.0
90247564.0,6,12,1832,8,1016,12892509.142857144,188.0,127.0,4,816,30021474.33333333,204.0,204.0
101315229.0,6,188,21348,94,14922,1087097.0752688171,284.0,158.74468085106383,94,6426,1087096.311827957,140.0,68.36170212765957
112464280.0,6,46,3036,23,1518,5112001.181818182,66.0,66.0,23,1518,5112001.090909091,66.0,66.0
18017.0,6,12,1393,6,796,2578.8,271.0,132.66666666666666,6,597,3223.6,259.0,99.5
216318.0,17,2,180,1,90,0.0,90.0,90.0,1,90,0.0,90.0,90.0
5534.0,17,4,344,2,150,0.0,75.0,75.0,2,194,0.0,103.0,97.0
113255005.0,6,46,3036,23,1518,5135444.454545454,66.0,66.0,23,1518,5135445.636363637,66.0,66.0
308011.0,6,6,412,4,272,102670.33333333331,74.0,68.0,2,140,0.0,74.0,70.0
101063.0,17,2,762,2,762,0.0,381.0,381.0,0,0,0.0,0.0,0.0
9011726.0,17,4,1812,4,1812,3003908.6666666665,453.0,453.0,0,0,0.0,0.0,0.0
213694.0,17,2,180,1,90,0.0,90.0,90.0,1,90,0.0,90.0,90.0
252034.0,6,3,337,2,214,0.0,160.0,107.0,1,123,0.0,123.0,123.0
171608.0,17,2,180,1,90,0.0,90.0,90.0,1,90,0.0,90.0,90.0
437400.0,6,10,967,5,390,73289.25,162.0,78.0,5,577,73216.0,349.0,115.4
107685.0,17,2,286,2,286,0.0,143.0,143.0,0,0,0.0,0.0,0.0
106697.0,17,2,286,2,286,0.0,143.0,143.0,0,0,0.0,0.0,0.0
97679.0,17,2,762,2,762,0.0,381.0,381.0,0,0,0.0,0.0,0.0
303735.0,6,6,412,4,272,101245.0,74.0,68.0,2,140,0.0,74.0,70.0
320723.0,17,4,1400,4,1400,106907.66666666669,350.0,350.0,0,0,0.0,0.0,0.0
322973.0,17,4,1400,4,1400,107657.66666666669,350.0,350.0,0,0,0.0,0.0,0.0
90030973.0,17,27,12943,27,12943,3462729.730769231,501.0,479.3703703703704,0,0,0.0,0.0,0.0
56288.0,6,14,4740,7,653,9248.833333333334,249.0,93.28571428571428,7,4087,7957.333333333333,1514.0,583.8571428571429
197427.0,17,2,180,1,90,0.0,90.0,90.0,1,90,0.0,90.0,90.0
322.0,17,2,174,1,79,0.0,79.0,79.0,1,95,0.0,95.0,95.0
2049361.0,6,4,270,2,134,0.0,68.0,67.0,2,136,0.0,70.0,68.0
120030480.0,17,28,13364,28,13364,4445573.333333333,501.0,477.2857142857143,0,0,0.0,0.0,0.0
110963347.0,6,30,1974,15,1026,7910546.428571428,123.0,68.4,15,948,7910547.357142857,123.0,63.2
310122.0,17,4,1400,4,1400,103374.0,350.0,350.0,0,0,0.0,0.0,0.0
35109.0,6,10,2032,5,524,8539.0,252.0,104.8,5,1508,8593.75,1236.0,301.6
116293249.0,6,211,23856,106,7218,1107554.7523809525,140.0,68.09433962264151,105,16638,1108254.8076923075,284.0,158.45714285714286
108108204.0,17,5,1005,5,1005,27027051.0,201.0,201.0,0,0,0.0,0.0,0.0
224037.0,17,2,180,1,90,0.0,90.0,90.0,1,90,0.0,90.0,90.0
13219.0,6,11,1131,6,600,2282.4,262.0,100.0,5,531,2516.0,259.0,106.2
128957705.0,6,35,2394,18,1269,7585747.352941177,123.0,70.5,17,1125,7422788.8125,123.0,66.17647058823529
1378.0,17,5,550,5,550,344.5,110.0,110.0,0,0,0.0,0.0,0.0
90258616.0,6,13,2036,8,1016,12894088.0,188.0,127.0,5,1020,22522556.75,204.0,204.0
324687.0,17,4,1400,4,1400,108229.0,350.0,350.0,0,0,0.0,0.0,0.0
135142741.0,17,6,1206,6,1206,27028548.2,201.0,201.0,0,0,0.0,0.0,0.0
3313.0,17,2,414,1,88,0.0,88.0,88.0,1,326,0.0,326.0,326.0
108108753.0,17,5,955,5,955,27027188.25,191.0,191.0,0,0,0.0,0.0,0.0
33613.0,6,14,4740,7,653,5357.833333333333,249.0,93.28571428571428,7,4087,5178.833333333333,1514.0,583.8571428571429
110401748.0,6,36,3010,21,1717,5509298.8,139.0,81.76190476190476,15,1293,7870273.071428572,123.0,86.2
21858.0,6,11,2098,6,590,4072.0,252.0,98.33333333333331,5,1508,4446.75,1236.0,301.6
241335.0,6,3,373,2,238,0.0,172.0,119.0,1,135,0.0,135.0,135.0
197080.0,17,2,180,1,90,0.0,90.0,90.0,1,90,0.0,90.0,90.0
47502.0,6,10,2032,5,524,10543.5,252.0,104.8,5,1508,11342.75,1236.0,301.6
44645.0,6,10,2032,5,524,10719.5,252.0,104.8,5,1508,10681.5,1236.0,301.6
90253366.0,6,12,1832,8,1016,12893338.0,188.0,127.0,4,816,30029888.0,204.0,204.0
205999.0,6,3,426,2,280,0.0,214.0,140.0,1,146,0.0,146.0,146.0
90756971.0,6,26,2019,15,1179,6479599.214285715,95.0,78.6,11,840,9047574.9,95.0,76.36363636363636
818.0,17,4,438,2,148,0.0,74.0,74.0,2,290,0.0,147.0,145.0
146276.0,6,3,337,2,214,0.0,160.0,107.0,1,123,0.0,123.0,123.0
1027361.0,6,11,1134,6,558,205472.2,220.0,93.0,5,576,255969.75,304.0,115.2
133007251.0,17,15,907,8,475,19001035.85714286,174.0,59.375,7,432,18833505.0,174.0,61.71428571428572
103887.0,17,2,286,2,286,0.0,143.0,143.0,0,0,0.0,0.0,0.0
135137650.0,17,6,1146,6,1146,27027530.0,191.0,191.0,0,0,0.0,0.0,0.0
1403988.0,17,7,490,7,490,233998.0,70.0,70.0,0,0,0.0,0.0,0.0
128015898.0,6,33,2280,17,1209,8000993.625,123.0,71.11764705882354,16,1071,7855063.2,123.0,66.9375
120246953.0,6,706,110144,353,23668,339310.7102272727,214.0,67.04815864022663,353,86476,339268.51136363635,1514.0,244.97450424929173
2053359.0,6,19,6869,11,1567,205335.9,408.0,142.45454545454547,8,5302,231401.8571428572,1514.0,662.75
42057.0,6,14,4740,7,653,5490.5,249.0,93.28571428571428,7,4087,6701.5,1514.0,583.8571428571429
146294.0,6,3,337,2,214,0.0,160.0,107.0,1,123,0.0,123.0,123.0
302872.0,17,4,1524,4,1524,100957.33333333331,381.0,381.0,0,0,0.0,0.0,0.0
108100716.0,17,5,955,5,955,27025179.0,191.0,191.0,0,0,0.0,0.0,0.0
4083438.0,6,6,876,2,292,0.0,214.0,146.0,4,584,961243.6666666666,146.0,146.0
120379201.0,6,219,24908,110,17418,1104396.3394495412,374.0,158.34545454545454,109,7490,1105041.611111111,140.0,68.71559633027523
4805338.0,6,5,336,2,134,0.0,68.0,67.0,3,202,1522905.0,70.0,67.33333333333333
106223.0,17,2,762,2,762,0.0,381.0,381.0,0,0,0.0,0.0,0.0
4440.0,17,2,180,1,90,0.0,90.0,90.0,1,90,0.0,90.0,90.0
1302630.0,6,4,264,2,132,0.0,66.0,66.0,2,132,0.0,66.0,66.0
6967.0,17,4,823,2,163,0.0,89.0,81.5,2,660,0.0,443.0,330.0
3178293.0,6,18,1495,9,921,358457.375,315.0,102.33333333333331,9,574,358431.625,78.0,63.77777777777778
209624.0,17,2,180,1,90,0.0,90.0,90.0,1,90,0.0,90.0,90.0
232798.0,6,3,373,2,238,0.0,172.0,119.0,1,135,0.0,135.0,135.0
90090005.0,6,11,1644,7,828,15015000.833333334,188.0,118.28571428571428,4,816,20019608.666666668,204.0,204.0
5011080.0,17,4,1164,2,166,0.0,83.0,83.0,2,998,0.0,499.0,499.0
331234.0,6,3,1604,2,851,0.0,785.0,425.5,1,753,0.0,753.0,753.0
12958.0,6,14,4740,7,653,2036.5,249.0,93.28571428571428,7,4087,2013.3333333333333,1514.0,583.8571428571429
103590775.0,17,16,1212,8,606,14798682.142857144,174.0,75.75,8,606,14748796.714285716,174.0,75.75
26620.0,6,14,4740,7,653,3927.5,249.0,93.28571428571428,7,4087,3879.0,1514.0,583.8571428571429
2075.0,17,2,932,1,590,0.0,590.0,590.0,1,342,0.0,342.0,342.0
363135.0,6,11,1021,6,444,50105.2,162.0,74.0,5,577,60872.25,349.0,115.4
1165341.0,6,13,3010,8,2382,166477.2857142857,1514.0,297.75,5,628,223212.75,331.0,125.6
302616.0,17,4,1524,4,1524,100872.0,381.0,381.0,0,0,0.0,0.0,0.0
118001246.0,17,15,1169,8,606,16857320.85714286,174.0,75.75,7,563,16334514.333333334,174.0,80.42857142857143
207433.0,6,3,426,2,280,0.0,214.0,140.0,1,146,0.0,146.0,146.0
216384.0,17,2,180,1,90,0.0,90.0,90.0,1,90,0.0,90.0,90.0
107105.0,17,2,700,2,700,0.0,350.0,350.0,0,0,0.0,0.0,0.0
53874.0,6,14,4740,7,653,8089.5,249.0,93.28571428571428,7,4087,6916.166666666667,1514.0,583.8571428571429
16834.0,17,2,180,1,90,0.0,90.0,90.0,1,90,0.0,90.0,90.0
90255881.0,6,13,2036,8,1016,12893697.285714284,188.0,127.0,5,1020,22522685.75,204.0,204.0
320.0,17,2,166,1,75,0.0,75.0,75.0,1,91,0.0,91.0,91.0
81341.0,6,14,4740,7,653,13336.666666666666,249.0,93.28571428571428,7,4087,13336.833333333334,1514.0,583.8571428571429
503006.0,6,5,336,2,134,0.0,68.0,67.0,3,202,192135.0,70.0,67.33333333333333
108082605.0,17,5,955,5,955,27020651.25,191.0,191.0,0,0,0.0,0.0,0.0
56532.0,6,14,4740,7,653,9218.666666666666,249.0,93.28571428571428,7,4087,8591.0,1514.0,583.8571428571429
305669.0,6,2,1538,1,753,0.0,753.0,753.0,1,785,0.0,785.0,785.0
206031.0,6,3,426,2,280,0.0,214.0,140.0,1,146,0.0,146.0,146.0
22304.0,17,4,823,2,163,0.0,89.0,81.5,2,660,0.0,443.0,330.0
876407.0,6,9,1096,6,625,175281.4,287.0,104.16666666666669,3,471,300184.5,331.0,157.0
246692.0,6,3,337,2,214,0.0,160.0,107.0,1,123,0.0,123.0,123.0
232958.0,6,3,337,2,214,0.0,160.0,107.0,1,123,0.0,123.0,123.0
232271.0,6,3,337,2,214,0.0,160.0,107.0,1,123,0.0,123.0,123.0
2017156.0,17,4,525,2,150,0.0,75.0,75.0,2,375,0.0,284.0,187.5
113549751.0,6,47,3102,24,1584,4936931.826086956,66.0,66.0,23,1518,5153442.7727272725,66.0,66.0
71597.0,6,14,4740,7,653,11704.666666666666,249.0,93.28571428571428,7,4087,9393.0,1514.0,583.8571428571429
16530.0,6,11,2098,6,590,3218.8,252.0,98.33333333333331,5,1508,3430.5,1236.0,301.6
210722.0,17,4,6056,4,6056,70240.66666666667,1514.0,1514.0,0,0,0.0,0.0,0.0
25593.0,6,14,4740,7,653,4143.333333333333,249.0,93.28571428571428,7,4087,3978.1666666666665,1514.0,583.8571428571429
120089707.0,6,36,2580,18,1248,7064100.411764706,123.0,69.33333333333333,18,1332,6464057.705882353,123.0,74.0
90133264.0,6,38,3388,16,1485,6008884.266666667,123.0,92.8125,22,1903,3805811.4285714286,139.0,86.5
41169.0,6,10,2032,5,524,10070.75,252.0,104.8,5,1508,10112.75,1236.0,301.6
811.0,17,5,550,5,550,202.75,110.0,110.0,0,0,0.0,0.0,0.0
280680.0,17,2,363,1,79,0.0,79.0,79.0,1,284,0.0,284.0,284.0
1390077.0,17,2,876,2,876,0.0,438.0,438.0,0,0,0.0,0.0,0.0
1317661.0,6,4,264,2,132,0.0,66.0,66.0,2,132,0.0,66.0,66.0
234708.0,6,3,373,2,238,0.0,172.0,119.0,1,135,0.0,135.0,135.0
1302422.0,6,4,264,2,132,0.0,66.0,66.0,2,132,0.0,66.0,66.0
243580.0,6,3,337,2,214,0.0,160.0,107.0,1,123,0.0,123.0,123.0
135135528.0,17,6,1206,6,1206,27027105.6,201.0,201.0,0,0,0.0,0.0,0.0
2787789.0,6,20,6935,11,1567,278778.9,408.0,142.45454545454547,9,5368,290267.375,1514.0,596.4444444444445
3074902.0,6,3,1604,2,851,0.0,785.0,425.5,1,753,0.0,753.0,753.0
120117657.0,6,13,2036,8,1016,17136465.0,188.0,127.0,5,1020,22521955.0,204.0,204.0
120123028.0,6,15,2428,9,1204,15015378.5,188.0,133.77777777777777,6,1224,18018737.6,204.0,204.0
253115.0,6,3,373,2,238,0.0,172.0,119.0,1,135,0.0,135.0,135.0
190921.0,17,2,180,1,90,0.0,90.0,90.0,1,90,0.0,90.0,90.0
303136.0,6,2,132,1,66,0.0,66.0,66.0,1,66,0.0,66.0,66.0
216773.0,6,3,426,2,280,0.0,214.0,140.0,1,146,0.0,146.0,146.0
2794619.0,6,2,132,1,66,0.0,66.0,66.0,1,66,0.0,66.0,66.0
196906.0,17,2,180,1,90,0.0,90.0,90.0,1,90,0.0,90.0,90.0
90040672.0,17,28,13364,28,13364,3334839.703703704,501.0,477.2857142857143,0,0,0.0,0.0,0.0
3569.0,17,4,344,2,150,0.0,75.0,75.0,2,194,0.0,103.0,97.0
3000299.0,6,12,2172,7,664,499922.5,252.0,94.85714285714286,5,1508,2023.5,1236.0,301.6
108769118.0,6,45,2970,22,1452,5179469.904761905,66.0,66.0,23,1518,4944039.681818182,66.0,66.0
135132727.0,17,6,1146,6,1146,27026545.4,191.0,191.0,0,0,0.0,0.0,0.0
108106307.0,17,5,1005,5,1005,27026576.75,201.0,201.0,0,0,0.0,0.0,0.0
204829.0,17,2,180,1,90,0.0,90.0,90.0,1,90,0.0,90.0,90.0
10471168.0,6,6,412,3,206,5167854.5,74.0,68.66666666666667,3,206,5167744.0,74.0,68.66666666666667
105188802.0,6,39,3379,17,1539,6574300.125,123.0,90.52941176470588,22,1840,4998177.428571428,139.0,83.63636363636364
230752.0,17,2,180,1,90,0.0,90.0,90.0,1,90,0.0,90.0,90.0
143956.0,17,2,180,1,90,0.0,90.0,90.0,1,90,0.0,90.0,90.0
1307001.0,6,4,264,2,132,0.0,66.0,66.0,2,132,0.0,66.0,66.0
90034489.0,17,28,13364,28,13364,3334610.703703704,501.0,477.2857142857143,0,0,0.0,0.0,0.0
207756.0,6,3,426,2,280,0.0,214.0,140.0,1,146,0.0,146.0,146.0
82227.0,6,14,4740,7,653,13355.333333333334,249.0,93.28571428571428,7,4087,13492.0,1514.0,583.8571428571429
119740333.0,17,35,16705,35,16705,3521774.5,501.0,477.2857142857143,0,0,0.0,0.0,0.0
24019.0,6,10,2032,5,524,5772.75,252.0,104.8,5,1508,5205.0,1236.0,301.6
149019.0,6,11,1132,6,556,29506.8,218.0,92.66666666666669,5,576,35778.0,304.0,115.2
312788.0,6,3,202,2,128,0.0,74.0,64.0,1,74,0.0,74.0,74.0
120022358.0,17,28,13364,28,13364,4445272.518518519,501.0,477.2857142857143,0,0,0.0,0.0,0.0
2042.0,17,4,344,2,150,0.0,75.0,75.0,2,194,0.0,103.0,97.0
102903.0,17,2,286,2,286,0.0,143.0,143.0,0,0,0.0,0.0,0.0
217759.0,6,3,426,2,280,0.0,214.0,140.0,1,146,0.0,146.0,146.0
237391.0,17,2,180,1,90,0.0,90.0,90.0,1,90,0.0,90.0,90.0
90260185.0,6,12,1832,8,1016,12894312.142857144,188.0,127.0,4,816,30032801.0,204.0,204.0
3168124.0,6,17,1441,8,867,409441.28571428574,315.0,108.375,9,574,358229.125,78.0,63.77777777777778
113240291.0,6,34,2350,17,1225,7064016.0625,139.0,72.05882352941177,17,1125,7064017.75,123.0,66.17647058823529
14645262.0,6,20,1607,10,975,1592617.7777777778,315.0,97.5,10,632,1592461.6666666667,78.0,63.2
65404.00000000001,6,14,4740,7,653,9920.166666666666,249.0,93.28571428571428,7,4087,10057.833333333334,1514.0,583.8571428571429
218245.0,17,2,180,1,90,0.0,90.0,90.0,1,90,0.0,90.0,90.0
18001.0,6,20,7606,11,978,1800.1,310.0,88.9090909090909,9,6628,2012.75,1514.0,736.4444444444445
16383.000000000002,6,14,4740,7,653,2611.333333333333,249.0,93.28571428571428,7,4087,2566.5,1514.0,583.8571428571429
315.0,17,2,174,1,79,0.0,79.0,79.0,1,95,0.0,95.0,95.0
216997.0,6,3,426,2,280,0.0,214.0,140.0,1,146,0.0,146.0,146.0
2479.0,17,4,344,2,150,0.0,75.0,75.0,2,194,0.0,103.0,97.0
40747.0,6,10,2032,5,524,9950.75,252.0,104.8,5,1508,6748.5,1236.0,301.6
90024656.0,17,28,13364,28,13364,3334246.5185185187,501.0,477.2857142857143,0,0,0.0,0.0,0.0
240834.0,6,3,337,2,214,0.0,160.0,107.0,1,123,0.0,123.0,123.0
37924.0,6,14,4740,7,653,3968.3333333333335,249.0,93.28571428571428,7,4087,6172.833333333333,1514.0,583.8571428571429
44709.0,6,10,2032,5,524,10611.0,252.0,104.8,5,1508,10869.75,1236.0,301.6
1311380.0,17,7,490,7,490,218563.3333333333,70.0,70.0,0,0,0.0,0.0,0.0
336.0,17,2,166,1,75,0.0,75.0,75.0,1,91,0.0,91.0,91.0
20411.0,6,20,7606,11,978,2041.1,310.0,88.9090909090909,9,6628,2269.75,1514.0,736.4444444444445
1772444.0,6,2,132,1,66,0.0,66.0,66.0,1,66,0.0,66.0,66.0
567532.0,6,10,1221,6,636,113506.4,298.0,106.0,4,585,183785.3333333333,379.0,146.25
112535494.0,6,46,3036,23,1518,5105436.363636363,66.0,66.0,23,1518,5105437.363636363,66.0,66.0
26531.0,6,12,1413,7,882,4421.833333333333,291.0,126.0,5,531,5992.0,259.0,106.2
36544.0,6,14,4740,7,653,5965.166666666667,249.0,93.28571428571428,7,4087,4512.333333333333,1514.0,583.8571428571429
25335.0,6,10,2032,5,524,6120.75,252.0,104.8,5,1508,5850.75,1236.0,301.6
1268.0,17,2,762,2,762,0.0,381.0,381.0,0,0,0.0,0.0,0.0
135130475.0,17,6,1146,6,1146,27026095.0,191.0,191.0,0,0,0.0,0.0,0.0
58155.0,6,14,4740,7,653,9456.166666666666,249.0,93.28571428571428,7,4087,8790.5,1514.0,583.8571428571429
10477011.0,6,7,478,4,272,3446668.6666666665,74.0,68.0,3,206,5169905.0,74.0,68.66666666666667
147966.0,17,2,180,1,90,0.0,90.0,90.0,1,90,0.0,90.0,90.0
90134825.0,6,164,18556,82,12996,1110116.6172839506,284.0,158.4878048780488,82,5560,1110118.2716049382,140.0,67.8048780487805
57526.0,6,14,4740,7,653,9463.333333333334,249.0,93.28571428571428,7,4087,7865.666666666667,1514.0,583.8571428571429
334.0,17,2,166,1,75,0.0,75.0,75.0,1,91,0.0,91.0,91.0
90012206.0,17,27,12943,27,12943,3462007.923076923,501.0,479.3703703703704,0,0,0.0,0.0,0.0
99771305.0,17,12,778,6,389,19898400.6,174.0,64.83333333333333,6,389,19922477.8,174.0,64.83333333333333
839732.0,6,9,1118,6,586,167946.4,248.0,97.66666666666669,3,532,281879.5,392.0,177.33333333333334
14633587.0,6,20,1607,10,975,1592213.2222222222,315.0,97.5,10,632,1592157.111111111,78.0,63.2
90272906.0,6,15,1097,8,596,12896129.42857143,95.0,74.5,7,501,14995189.666666666,95.0,71.57142857142857
106642.0,17,2,286,2,286,0.0,143.0,143.0,0,0,0.0,0.0,0.0
13150.0,6,10,1066,5,490,3061.25,218.0,98.0,5,576,2982.25,304.0,115.2
108043.0,17,2,286,2,286,0.0,143.0,143.0,0,0,0.0,0.0,0.0
318643.0,6,3,202,2,128,0.0,74.0,64.0,1,74,0.0,74.0,74.0
8357.0,17,4,823,2,163,0.0,89.0,81.5,2,660,0.0,443.0,330.0
120646475.0,6,35,2526,18,1332,7096851.470588235,123.0,74.0,17,1194,6902848.125,123.0,70.23529411764706
58827844.0,17,9,3086,8,2736,5120574.857142857,342.0,342.0,1,350,0.0,350.0,350.0
1781879.0,6,2,132,1,66,0.0,66.0,66.0,1,66,0.0,66.0,66.0
204586.0,17,2,762,2,762,0.0,381.0,381.0,0,0,0.0,0.0,0.0
47206.0,6,14,4740,7,653,7267.333333333333,249.0,93.28571428571428,7,4087,7062.5,1514.0,583.8571428571429
90100071.0,6,12,1848,5,1020,22522197.5,204.0,204.0,7,828,15016436.333333334,188.0,118.28571428571428
2026.0,17,4,344,2,150,0.0,75.0,75.0,2,194,0.0,103.0,97.0
44529.0,6,14,4740,7,653,6884.0,249.0,93.28571428571428,7,4087,7283.333333333333,1514.0,583.8571428571429
2449.0,17,4,344,2,150,0.0,75.0,75.0,2,194,0.0,103.0,97.0
155817.0,6,3,337,2,214,0.0,160.0,107.0,1,123,0.0,123.0,123.0
2594980.0,6,2,132,1,66,0.0,66.0,66.0,1,66,0.0,66.0,66.0
33341.0,6,13,4416,6,409,6490.4,127.0,68.16666666666667,7,4007,4502.166666666667,1514.0,572.4285714285714
276107.0,6,10,1221,6,636,55221.4,298.0,106.0,4,585,86301.33333333333,379.0,146.25
120025907.0,17,29,13785,29,13785,4286639.535714285,501.0,475.3448275862069,0,0,0.0,0.0,0.0
5832397.0,6,4,270,2,134,0.0,68.0,67.0,2,136,0.0,70.0,68.0
123275864.0,6,34,2419,18,1348,7251521.411764706,139.0,74.88888888888889,16,1071,7691243.2,123.0,66.9375
864778.0,6,11,2651,7,742,144129.66666666666,338.0,106.0,4,1909,196524.3333333333,1514.0,477.25
28853.0,6,14,4740,7,653,4206.666666666667,249.0,93.28571428571428,7,4087,4668.833333333333,1514.0,583.8571428571429
219394.0,6,10,1221,6,636,43878.8,298.0,106.0,4,585,71749.33333333333,379.0,146.25
90261860.0,6,14,1964,8,1016,12894551.42857143,188.0,127.0,6,948,18019308.0,204.0,158.0
5145.0,17,4,344,2,150,0.0,75.0,75.0,2,194,0.0,103.0,97.0
284547.0,17,2,363,1,79,0.0,79.0,79.0,1,284,0.0,284.0,284.0
123008879.0,17,15,907,8,475,17572697.0,174.0,59.375,7,432,17172916.0,174.0,61.71428571428572
103229.0,17,2,762,2,762,0.0,381.0,381.0,0,0,0.0,0.0,0.0
1302432.0,6,4,264,2,132,0.0,66.0,66.0,2,132,0.0,66.0,66.0
24593.0,6,14,4740,7,653,3656.6666666666665,249.0,93.28571428571428,7,4087,3961.0,1514.0,583.8571428571429
2316.0,17,4,344,2,150,0.0,75.0,75.0,2,194,0.0,103.0,97.0
228211.0,17,2,180,1,90,0.0,90.0,90.0,1,90,0.0,90.0,90.0
103626.0,17,2,286,2,286,0.0,143.0,143.0,0,0,0.0,0.0,0.0
108755073.0,6,33,2412,17,1272,6783698.4375,123.0,74.82352941176471,16,1140,7235947.466666667,123.0,71.25
97068.0,6,14,4740,7,653,16064.666666666666,249.0,93.28571428571428,7,4087,16021.333333333334,1514.0,583.8571428571429
232526.0,6,3,337,2,214,0.0,160.0,107.0,1,123,0.0,123.0,123.0
135129552.0,17,6,1206,6,1206,27025910.4,201.0,201.0,0,0,0.0,0.0,0.0
92592414.0,6,38,2508,19,1254,5144008.166666667,66.0,66.0,19,1254,5144009.111111111,66.0,66.0
90299068.0,6,16,1192,8,596,12893403.142857144,95.0,74.5,8,596,12898367.57142857,95.0,74.5
135132461.0,17,6,1206,6,1206,27026492.2,201.0,201.0,0,0,0.0,0.0,0.0
90258451.0,6,13,2036,8,1016,12894064.42857143,188.0,127.0,5,1020,22523611.5,204.0,204.0
74955.0,6,14,4740,7,653,12361.5,249.0,93.28571428571428,7,4087,11588.0,1514.0,583.8571428571429
525.0,17,2,508,2,508,0.0,257.0,254.0,0,0,0.0,0.0,0.0
204685.0,17,2,762,2,762,0.0,381.0,381.0,0,0,0.0,0.0,0.0
50890.0,17,2,180,1,90,0.0,90.0,90.0,1,90,0.0,90.0,90.0
26963.0,6,14,4740,7,653,3304.6666666666665,249.0,93.28571428571428,7,4087,4191.333333333333,1514.0,583.8571428571429
7096.0,17,2,174,1,79,0.0,79.0,79.0,1,95,0.0,95.0,95.0
304642.0,6,6,412,4,272,101547.33333333331,74.0,68.0,2,140,0.0,74.0,70.0
32967.0,6,11,2098,6,590,6124.0,252.0,98.33333333333331,5,1508,7245.75,1236.0,301.6
16370.0,17,2,762,2,762,0.0,381.0,381.0,0,0,0.0,0.0,0.0
329.0,17,2,267,1,83,0.0,83.0,83.0,1,184,0.0,184.0,184.0
48275.0,6,14,4740,7,653,7914.833333333333,249.0,93.28571428571428,7,4087,7865.833333333333,1514.0,583.8571428571429
109133.0,17,4,1400,4,1400,36377.66666666666,350.0,350.0,0,0,0.0,0.0,0.0
197043.0,17,2,180,1,90,0.0,90.0,90.0,1,90,0.0,90.0,90.0
2302.0,17,4,344,2,150,0.0,75.0,75.0,2,194,0.0,103.0,97.0
135132532.0,17,6,1146,6,1146,27026506.4,191.0,191.0,0,0,0.0,0.0,0.0
212533.0,6,10,1221,6,636,42506.6,298.0,106.0,4,585,69020.0,379.0,146.25
228281.0,17,2,180,1,90,0.0,90.0,90.0,1,90,0.0,90.0,90.0
120144329.0,17,14,995,7,432,17666834.833333332,174.0,61.71428571428572,7,563,19011305.0,174.0,80.42857142857143
318687.0,17,4,1400,4,1400,106229.0,350.0,350.0,0,0,0.0,0.0,0.0
9070.0,17,2,582,1,83,0.0,83.0,83.0,1,499,0.0,499.0,499.0
40152.0,6,14,4740,7,653,6580.0,249.0,93.28571428571428,7,4087,5617.166666666667,1514.0,583.8571428571429
96081932.0,17,14,1126,7,563,15998549.833333334,174.0,80.42857142857143,7,563,16000159.0,174.0,80.42857142857143
143930.0,17,2,180,1,90,0.0,90.0,90.0,1,90,0.0,90.0,90.0
10504730.0,6,7,478,4,272,3456297.6666666665,74.0,68.0,3,206,5184330.5,74.0,68.66666666666667
107911932.0,6,28,1860,14,966,8284312.230769231,123.0,69.0,14,894,8284312.230769231,123.0,63.85714285714285
104233381.0,6,43,2838,22,1452,4963482.0,66.0,66.0,21,1386,5144014.65,66.0,66.0
16945.0,6,14,4740,7,653,2521.333333333333,249.0,93.28571428571428,7,4087,2687.0,1514.0,583.8571428571429
108098053.0,17,5,955,5,955,27024513.25,191.0,191.0,0,0,0.0,0.0,0.0
206232.0,6,3,426,2,280,0.0,214.0,140.0,1,146,0.0,146.0,146.0
143866.0,17,2,180,1,90,0.0,90.0,90.0,1,90,0.0,90.0,90.0
2336.0,17,4,344,2,150,0.0,75.0,75.0,2,194,0.0,103.0,97.0
97918340.0,6,40,2640,20,1320,5153596.842105263,66.0,66.0,20,1320,5137296.7894736845,66.0,66.0
307843.0,6,6,412,4,272,102614.33333333331,74.0,68.0,2,140,0.0,74.0,70.0
137872.0,6,2,132,1,66,0.0,66.0,66.0,1,66,0.0,66.0,66.0
107808330.0,6,29,2052,15,1089,7684909.071428572,123.0,72.6,14,963,8276302.0,123.0,68.78571428571429
119578145.0,6,23,1734,11,840,11957814.5,95.0,76.36363636363636,12,894,10846677.181818182,95.0,74.5
10568.0,6,13,1459,7,862,1625.8333333333333,271.0,123.14285714285714,6,597,1962.6,259.0,99.5
3143988.0,6,154,125808,89,117216,35727.13636363636,1510.0,1317.0337078651685,65,8592,44186.484375,1510.0,132.1846153846154
122283683.0,17,14,864,7,432,17166868.166666668,174.0,61.71428571428572,7,432,17167723.833333332,174.0,61.71428571428572
2164985.0,6,37,15535,19,10912,120276.94444444444,1514.0,574.3157894736842,18,4623,114102.4705882353,1514.0,256.8333333333333
10475708.0,6,7,478,4,272,3444853.0,74.0,68.0,3,206,5167194.0,74.0,68.66666666666667
57310.0,6,14,4740,7,653,8671.5,249.0,93.28571428571428,7,4087,8652.833333333334,1514.0,583.8571428571429
332.0,17,2,174,1,79,0.0,79.0,79.0,1,95,0.0,95.0,95.0
112979686.0,6,45,2970,23,1518,5135440.2727272725,66.0,66.0,22,1452,5026040.619047619,66.0,66.0
28353.0,6,14,4740,7,653,4327.166666666667,249.0,93.28571428571428,7,4087,4578.333333333333,1514.0,583.8571428571429
17265.0,6,10,2032,5,524,4056.5,252.0,104.8,5,1508,4053.5,1236.0,301.6
120048803.0,17,28,13364,28,13364,4446251.962962963,501.0,477.2857142857143,0,0,0.0,0.0,0.0
199457.0,17,2,180,1,90,0.0,90.0,90.0,1,90,0.0,90.0,90.0
2416791.0,6,28,9195,16,3843,161119.4,1514.0,240.1875,12,5352,197102.7272727273,1514.0,446.0
120000039.0,6,17,1287,9,691,15000004.875,95.0,76.77777777777777,8,596,12897211.857142856,95.0,74.5
108128590.0,17,5,955,5,955,27032147.5,191.0,191.0,0,0,0.0,0.0,0.0
13829.0,6,11,2098,6,590,2629.4,252.0,98.33333333333331,5,1508,3226.75,1236.0,301.6
117516291.0,6,294,34516,147,24592,803426.6780821917,374.0,167.2925170068027,147,9924,803426.7808219178,140.0,67.51020408163265
36860.0,6,14,4740,7,653,5659.166666666667,249.0,93.28571428571428,7,4087,5698.666666666667,1514.0,583.8571428571429
10908128.0,6,8,544,4,272,3590850.333333333,74.0,68.0,4,272,3590764.0,74.0,68.0
2409951.0,6,46,23530,24,19731,104780.47826086955,1514.0,822.125,22,3799,104101.14285714286,1514.0,172.6818181818182
210549.0,17,2,180,1,90,0.0,90.0,90.0,1,90,0.0,90.0,90.0
280396.0,17,2,363,1,79,0.0,79.0,79.0,1,284,0.0,284.0,284.0
206414.0,6,3,426,2,280,0.0,214.0,140.0,1,146,0.0,146.0,146.0
206381.0,6,3,426,2,280,0.0,214.0,140.0,1,146,0.0,146.0,146.0
1314849.0,6,4,264,2,132,0.0,66.0,66.0,2,132,0.0,66.0,66.0
314107.0,17,4,1400,4,1400,104702.33333333331,350.0,350.0,0,0,0.0,0.0,0.0
412.0,17,2,166,1,75,0.0,75.0,75.0,1,91,0.0,91.0,91.0
125001083.0,17,15,907,8,475,17857297.57142857,174.0,59.375,7,432,17501416.166666668,174.0,61.71428571428572
143923.0,17,2,180,1,90,0.0,90.0,90.0,1,90,0.0,90.0,90.0
318677.0,17,4,1400,4,1400,106225.66666666669,350.0,350.0,0,0,0.0,0.0,0.0
106924.0,17,2,286,2,286,0.0,143.0,143.0,0,0,0.0,0.0,0.0
0.0,6,1,172,1,172,0.0,172.0,172.0,0,0,0.0,0.0,0.0
22064.0,17,2,582,1,83,0.0,83.0,83.0,1,499,0.0,499.0,499.0
66819.0,6,14,4740,7,653,9437.5,249.0,93.28571428571428,7,4087,10486.333333333334,1514.0,583.8571428571429
80881.0,6,14,4740,7,653,12387.0,249.0,93.28571428571428,7,4087,13277.333333333334,1514.0,583.8571428571429
188147.0,6,12,1354,6,723,36546.2,253.0,120.5,6,631,36709.6,293.0,105.16666666666669
112535450.0,6,46,3036,23,1518,5105435.545454546,66.0,66.0,23,1518,5105437.545454546,66.0,66.0
0.0,17,1,55,1,55,0.0,55.0,55.0,0,0,0.0,0.0,0.0
135142421.0,17,6,1146,6,1146,27028484.2,191.0,191.0,0,0,0.0,0.0,0.0
140481.0,6,2,132,1,66,0.0,66.0,66.0,1,66,0.0,66.0,66.0
20090.0,6,14,4740,7,653,3227.6666666666665,249.0,93.28571428571428,7,4087,2941.833333333333,1514.0,583.8571428571429
366.0,17,2,202,1,87,0.0,87.0,87.0,1,115,0.0,115.0,115.0
112425.0,6,2,132,1,66,0.0,66.0,66.0,1,66,0.0,66.0,66.0
103870421.0,17,14,1126,7,563,17167648.5,174.0,80.42857142857143,7,563,17166821.666666668,174.0,80.42857142857143
107511.0,17,2,286,2,286,0.0,143.0,143.0,0,0,0.0,0.0,0.0
1314732.0,6,4,264,2,132,0.0,66.0,66.0,2,132,0.0,66.0,66.0
209266.0,6,3,426,2,280,0.0,214.0,140.0,1,146,0.0,146.0,146.0
135130989.0,17,6,1206,6,1206,27026197.8,201.0,201.0,0,0,0.0,0.0,0.0
36480.0,6,14,4740,7,653,5952.5,249.0,93.28571428571428,7,4087,5629.333333333333,1514.0,583.8571428571429
27589.0,6,10,2032,5,524,6684.75,252.0,104.8,5,1508,6622.0,1236.0,301.6
68527.0,6,14,4740,7,653,11231.0,249.0,93.28571428571428,7,4087,10231.833333333334,1514.0,583.8571428571429
18763.0,6,14,4740,7,653,2643.6666666666665,249.0,93.28571428571428,7,4087,2994.0,1514.0,583.8571428571429
108293976.0,6,251,28704,126,8538,866351.808,140.0,67.76190476190476,125,20166,856653.1774193548,336.0,161.328
226022.0,6,3,426,2,280,0.0,214.0,140.0,1,146,0.0,146.0,146.0
20090.0,6,2,145,2,145,0.0,91.0,72.5,0,0,0.0,0.0,0.0
3076.0,17,4,344,2,150,0.0,75.0,75.0,2,194,0.0,103.0,97.0
121286.0,6,3,337,2,214,0.0,160.0,107.0,1,123,0.0,123.0,123.0
327.0,17,2,166,1,75,0.0,75.0,75.0,1,91,0.0,91.0,91.0
96479.0,6,14,4740,7,653,15957.333333333334,249.0,93.28571428571428,7,4087,15904.833333333334,1514.0,583.8571428571429
3437.0,17,2,180,1,90,0.0,90.0,90.0,1,90,0.0,90.0,90.0
19191.0,6,11,2098,6,590,3696.4,252.0,98.33333333333331,5,1508,4531.25,1236.0,301.6
1080711.0,6,11,1134,6,558,216142.2,220.0,93.0,5,576,266580.75,304.0,115.2
115091522.0,6,32,2358,17,1272,7179731.6875,123.0,74.82352941176471,15,1086,8205404.0,123.0,72.4
120069015.0,17,28,13364,28,13364,4447000.555555556,501.0,477.2857142857143,0,0,0.0,0.0,0.0
14432600.0,6,20,1607,10,975,1570249.3333333333,315.0,97.5,10,632,1570209.5555555555,78.0,63.2
13620849.0,6,20,1607,10,975,1479033.4444444445,315.0,97.5,10,632,1478981.111111111,78.0,63.2
102057135.0,17,14,864,7,432,17000159.333333332,174.0,61.71428571428572,7,432,17001263.166666668,174.0,61.71428571428572
103821.0,17,2,286,2,286,0.0,143.0,143.0,0,0,0.0,0.0,0.0
49105.0,6,14,4740,7,653,8057.666666666667,249.0,93.28571428571428,7,4087,7867.333333333333,1514.0,583.8571428571429
220524.0,17,2,180,1,90,0.0,90.0,90.0,1,90,0.0,90.0,90.0
0.0,17,1,453,1,453,0.0,453.0,453.0,0,0,0.0,0.0,0.0
29059.0,6,10,2032,5,524,6821.75,252.0,104.8,5,1508,6274.75,1236.0,301.6
108114339.0,17,5,955,5,955,27028584.75,191.0,191.0,0,0,0.0,0.0,0.0
153439.0,17,2,180,1,90,0.0,90.0,90.0,1,90,0.0,90.0,90.0
61487172.0,6,8,1307,8,1307,8783881.714285715,172.0,163.375,0,0,0.0,0.0,0.0
84727.0,6,14,4740,7,653,13289.333333333334,249.0,93.28571428571428,7,4087,13255.5,1514.0,583.8571428571429
28151.0,6,14,4740,7,653,4083.5,249.0,93.28571428571428,7,4087,4347.166666666667,1514.0,583.8571428571429
108113864.0,17,5,955,5,955,27028466.0,191.0,191.0,0,0,0.0,0.0,0.0
90299543.0,6,16,1192,8,596,12893795.714285716,95.0,74.5,8,596,12898356.285714284,95.0,74.5
38791.0,6,20,7606,11,978,3736.7,310.0,88.9090909090909,9,6628,4617.0,1514.0,736.4444444444445
2491.0,17,4,344,2,150,0.0,75.0,75.0,2,194,0.0,103.0,97.0
16056.0,6,14,4740,7,653,2466.333333333333,249.0,93.28571428571428,7,4087,2446.833333333333,1514.0,583.8571428571429
270260.0,6,10,1221,6,636,54052.0,298.0,106.0,4,585,84322.0,379.0,146.25
43448.0,6,11,2098,6,590,7647.0,252.0,98.33333333333331,5,1508,9850.75,1236.0,301.6
11001121.0,17,4,1368,4,1368,3667040.3333333335,342.0,342.0,0,0,0.0,0.0,0.0
669.0,17,2,762,2,762,0.0,381.0,381.0,0,0,0.0,0.0,0.0
17791.0,6,14,4740,7,653,2528.333333333333,249.0,93.28571428571428,7,4087,2779.0,1514.0,583.8571428571429
105477044.0,6,43,2838,22,1452,5022704.047619048,66.0,66.0,21,1386,5160006.5,66.0,66.0
102214.0,17,2,286,2,286,0.0,143.0,143.0,0,0,0.0,0.0,0.0
135123968.0,17,6,1206,6,1206,27024793.6,201.0,201.0,0,0,0.0,0.0,0.0
90257667.0,6,13,2036,8,1016,12893952.42857143,188.0,127.0,5,1020,22523878.0,204.0,204.0
3174363.0,6,18,1577,9,1003,358430.875,315.0,111.44444444444444,9,574,358407.625,78.0,63.77777777777778
1014583.0,17,6,1230,3,234,507108.50000000006,78.0,78.0,3,996,507087.5,332.0,332.0
209625.0,17,2,180,1,90,0.0,90.0,90.0,1,90,0.0,90.0,90.0
108109760.0,17,5,955,5,955,27027440.0,191.0,191.0,0,0,0.0,0.0,0.0
90323476.0,6,16,1192,8,596,12895780.57142857,95.0,74.5,8,596,12902604.285714284,95.0,74.5
258506.0,6,13,1386,7,789,43084.333333333336,253.0,112.71428571428572,6,597,49840.0,259.0,99.5
90310758.0,6,16,1192,8,596,12895352.285714284,95.0,74.5,8,596,12900104.42857143,95.0,74.5
3321872.0,6,3,204,2,136,0.0,70.0,68.0,1,68,0.0,68.0,68.0
113520077.0,6,46,3036,23,1518,5159989.318181818,66.0,66.0,23,1518,5159991.7727272725,66.0,66.0
120126222.0,6,14,2224,9,1204,15015777.75,188.0,133.77777777777777,5,1020,22523900.75,204.0,204.0
90222148.0,6,20,1531,9,691,11246817.375,95.0,76.77777777777777,11,840,9000675.1,95.0,76.36363636363636
133587.0,6,2,132,1,66,0.0,66.0,66.0,1,66,0.0,66.0,66.0
111906461.0,6,33,2296,17,1225,6980667.75,139.0,72.05882352941177,16,1071,7446054.066666666,123.0,66.9375
103675.0,17,2,286,2,286,0.0,143.0,143.0,0,0,0.0,0.0,0.0
2046.0,17,2,180,1,90,0.0,90.0,90.0,1,90,0.0,90.0,90.0
121226.0,17,4,1400,4,1400,40408.66666666666,350.0,350.0,0,0,0.0,0.0,0.0
1313732.0,6,4,264,2,132,0.0,66.0,66.0,2,132,0.0,66.0,66.0
108103700.0,17,5,955,5,955,27025925.0,191.0,191.0,0,0,0.0,0.0,0.0
69109.0,6,14,4740,7,653,11277.0,249.0,93.28571428571428,7,4087,7708.666666666667,1514.0,583.8571428571429
300168.0,6,6,412,4,272,100056.0,74.0,68.0,2,140,0.0,74.0,70.0
308073.0,6,6,412,4,272,102691.0,74.0,68.0,2,140,0.0,74.0,70.0
116406322.0,6,47,3102,24,1584,5061133.869565218,66.0,66.0,23,1518,5143994.818181818,66.0,66.0
298983.0,6,6,412,4,272,99661.0,74.0,68.0,2,140,0.0,74.0,70.0
241740.0,6,3,373,2,238,0.0,172.0,119.0,1,135,0.0,135.0,135.0
198360.0,6,10,1221,6,636,39672.0,298.0,106.0,4,585,65269.333333333336,379.0,146.25
342.0,17,2,267,1,83,0.0,83.0,83.0,1,184,0.0,184.0,184.0
90530373.0,6,13,2036,8,1016,12932910.42857143,188.0,127.0,5,1020,22591698.25,204.0,204.0
197031.0,17,2,180,1,90,0.0,90.0,90.0,1,90,0.0,90.0,90.0
46855.0,6,14,4740,7,653,7447.166666666667,249.0,93.28571428571428,7,4087,7628.0,1514.0,583.8571428571429
329.0,17,2,174,1,79,0.0,79.0,79.0,1,95,0.0,95.0,95.0
26838.0,6,14,4740,7,653,3733.6666666666665,249.0,93.28571428571428,7,4087,4334.5,1514.0,583.8571428571429
90033887.0,17,28,13364,28,13364,3334588.407407407,501.0,477.2857142857143,0,0,0.0,0.0,0.0
29337.0,6,14,4740,7,653,4025.5,249.0,93.28571428571428,7,4087,4753.0,1514.0,583.8571428571429
149511.0,6,3,373,2,238,0.0,172.0,119.0,1,135,0.0,135.0,135.0
135128370.0,17,6,1146,6,1146,27025674.0,191.0,191.0,0,0,0.0,0.0,0.0
0.0,17,1,55,1,55,0.0,55.0,55.0,0,0,0.0,0.0,0.0
320.0,17,2,164,1,82,0.0,82.0,82.0,1,82,0.0,82.0,82.0
33683.0,6,10,2032,5,524,7388.5,252.0,104.8,5,1508,8073.0,1236.0,301.6
40577.0,6,10,2032,5,524,9904.5,252.0,104.8,5,1508,9712.0,1236.0,301.6
143906.0,17,2,180,1,90,0.0,90.0,90.0,1,90,0.0,90.0,90.0
25193.0,6,10,2032,5,524,6072.5,252.0,104.8,5,1508,5954.75,1236.0,301.6
25853.0,6,14,4740,7,653,4200.333333333333,249.0,93.28571428571428,7,4087,4173.333333333333,1514.0,583.8571428571429
207826.0,17,2,180,1,90,0.0,90.0,90.0,1,90,0.0,90.0,90.0
217539.0,6,3,426,2,280,0.0,214.0,140.0,1,146,0.0,146.0,146.0
90759237.0,6,19,1436,10,745,10079710.555555556,95.0,74.5,9,691,11344149.0,95.0,76.77777777777777
77861.0,6,11,2098,6,590,14710.6,252.0,98.33333333333331,5,1508,18824.25,1236.0,301.6
444595.0,6,10,967,5,390,75075.0,162.0,78.0,5,577,75010.5,349.0,115.4
30015.0,6,10,2032,5,524,7264.75,252.0,104.8,5,1508,6197.5,1236.0,301.6
108102379.0,17,5,955,5,955,27025594.75,191.0,191.0,0,0,0.0,0.0,0.0
2362.0,17,4,344,2,150,0.0,75.0,75.0,2,194,0.0,103.0,97.0
141670.0,6,2,132,1,66,0.0,66.0,66.0,1,66,0.0,66.0,66.0
1146361.0,6,13,3010,8,2382,163765.85714285713,1514.0,297.75,5,628,218436.5,331.0,125.6
108102120.0,17,5,955,5,955,27025530.0,191.0,191.0,0,0,0.0,0.0,0.0
53230.0,6,14,4740,7,653,8644.833333333334,249.0,93.28571428571428,7,4087,7610.833333333333,1514.0,583.8571428571429
228339.0,17,2,180,1,90,0.0,90.0,90.0,1,90,0.0,90.0,90.0
153401.0,17,2,180,1,90,0.0,90.0,90.0,1,90,0.0,90.0,90.0
310931.0,6,6,412,4,272,103643.66666666669,74.0,68.0,2,140,0.0,74.0,70.0
105075450.0,17,14,864,7,432,17500493.833333332,174.0,61.71428571428572,7,432,17500158.0,174.0,61.71428571428572
206651.0,6,3,426,2,280,0.0,214.0,140.0,1,146,0.0,146.0,146.0
90282532.0,6,16,1192,8,596,12891236.57142857,95.0,74.5,8,596,12896342.142857144,95.0,74.5
2082.0,17,4,344,2,150,0.0,75.0,75.0,2,194,0.0,103.0,97.0
116269.0,6,11,2098,6,590,23103.4,252.0,98.33333333333331,5,1508,28519.0,1236.0,301.6
27376194.0,17,5,1710,5,1710,6844048.5,342.0,342.0,0,0,0.0,0.0,0.0
12272.0,6,12,1393,6,796,2321.4,271.0,132.66666666666666,6,597,2121.0,259.0,99.5
137055.0,17,2,192,1,88,0.0,88.0,88.0,1,104,0.0,104.0,104.0
220881.0,17,2,180,1,90,0.0,90.0,90.0,1,90,0.0,90.0,90.0
2598144.0,6,2,132,1,66,0.0,66.0,66.0,1,66,0.0,66.0,66.0
246304.0,6,3,337,2,214,0.0,160.0,107.0,1,123,0.0,123.0,123.0
735.0,17,4,438,2,148,0.0,74.0,74.0,2,290,0.0,147.0,145.0
97001.0,6,2,132,1,66,0.0,66.0,66.0,1,66,0.0,66.0,66.0
1230704.0,17,7,490,7,490,205117.3333333333,70.0,70.0,0,0,0.0,0.0,0.0
10453313.0,6,7,478,4,272,3438907.333333333,74.0,68.0,3,206,5158264.5,74.0,68.66666666666667
120086165.0,17,28,13364,28,13364,4447635.740740741,501.0,477.2857142857143,0,0,0.0,0.0,0.0
110201576.0,6,203,22824,102,6954,1091104.712871287,140.0,68.17647058823529,101,15870,1091642.6,284.0,157.12871287128712
35751.0,6,14,4740,7,653,5458.166666666667,249.0,93.28571428571428,7,4087,5185.833333333333,1514.0,583.8571428571429
106805.0,17,2,286,2,286,0.0,143.0,143.0,0,0,0.0,0.0,0.0
41306.0,6,11,1132,6,556,6739.6,218.0,92.66666666666669,5,576,10094.0,304.0,115.2
196913.0,17,2,180,1,90,0.0,90.0,90.0,1,90,0.0,90.0,90.0
14644945.0,6,20,1607,10,975,1592937.888888889,315.0,97.5,10,632,1592885.4444444445,78.0,63.2
86406842.0,6,24,1727,12,884,7854775.818181818,95.0,73.66666666666667,12,843,7786619.454545454,95.0,70.25
111831628.0,6,36,2596,18,1348,6578331.05882353,139.0,74.88888888888889,18,1248,6565598.352941177,123.0,69.33333333333333
117905.0,17,4,1400,4,1400,39301.66666666666,350.0,350.0,0,0,0.0,0.0,0.0
90354253.0,6,11,1644,7,828,15059042.166666666,188.0,118.28571428571428,4,816,20111136.33333333,204.0,204.0
41190.0,6,10,2032,5,524,8473.0,252.0,104.8,5,1508,7965.25,1236.0,301.6
405.0,17,2,410,1,78,0.0,78.0,78.0,1,332,0.0,332.0,332.0
1302271.0,6,4,264,2,132,0.0,66.0,66.0,2,132,0.0,66.0,66.0
2557719.0,6,25,7573,14,3735,196747.6153846153,1514.0,266.7857142857143,11,3838,231156.3,1514.0,348.90909090909093
5621465.0,6,5,336,2,134,0.0,68.0,67.0,3,202,1424344.5,70.0,67.33333333333333
171363.0,17,2,414,1,88,0.0,88.0,88.0,1,326,0.0,326.0,326.0
120461452.0,6,29,3144,13,1491,8571133.583333334,356.0,114.6923076923077,16,1653,8014001.933333334,426.0,103.3125
47257.0,6,11,1133,6,602,9215.0,264.0,100.33333333333331,5,531,10537.75,259.0,106.2
307984.0,6,6,412,4,272,102661.33333333331,74.0,68.0,2,140,0.0,74.0,70.0
112464196.0,6,46,3036,23,1518,5111996.818181818,66.0,66.0,23,1518,5111997.727272728,66.0,66.0
215362.0,17,2,180,1,90,0.0,90.0,90.0,1,90,0.0,90.0,90.0
55302.0,6,10,2032,5,524,13545.75,252.0,104.8,5,1508,13192.0,1236.0,301.6
90046336.0,17,28,13364,28,13364,3335049.4814814813,501.0,477.2857142857143,0,0,0.0,0.0,0.0
234307.0,6,3,373,2,238,0.0,172.0,119.0,1,135,0.0,135.0,135.0
29160.0,6,14,4740,7,653,4733.166666666667,249.0,93.28571428571428,7,4087,4678.0,1514.0,583.8571428571429
119534456.0,6,234,26512,117,18494,1028600.75,284.0,158.06837606837607,117,8018,1028613.9913793104,140.0,68.52991452991454
233017.0,6,3,337,2,214,0.0,160.0,107.0,1,123,0.0,123.0,123.0
198386.0,17,2,180,1,90,0.0,90.0,90.0,1,90,0.0,90.0,90.0
215549.0,17,2,180,1,90,0.0,90.0,90.0,1,90,0.0,90.0,90.0
312080.0,17,4,1400,4,1400,104026.66666666669,350.0,350.0,0,0,0.0,0.0,0.0
90365098.0,6,11,1644,7,828,15060849.666666666,188.0,118.28571428571428,4,816,20110652.666666668,204.0,204.0
103691.0,17,2,286,2,286,0.0,143.0,143.0,0,0,0.0,0.0,0.0
43108.0,6,10,2032,5,524,10549.5,252.0,104.8,5,1508,9689.5,1236.0,301.6
1762584.0,6,4,276,2,128,0.0,74.0,64.0,2,148,0.0,74.0,74.0
120454825.0,6,25,1924,11,840,9142722.8,95.0,76.36363636363636,14,1084,9246154.923076924,95.0,77.42857142857143
32447.0,6,10,2032,5,524,7856.25,252.0,104.8,5,1508,7295.5,1236.0,301.6
90260535.0,6,15,2168,8,1016,12894362.142857144,188.0,127.0,7,1152,15015918.333333334,204.0,164.57142857142858
2429.0,17,4,344,2,150,0.0,75.0,75.0,2,194,0.0,103.0,97.0
5623873.0,6,5,336,2,134,0.0,68.0,67.0,3,202,1526264.5,70.0,67.33333333333333
35297.0,6,10,2032,5,524,8231.75,252.0,104.8,5,1508,8532.5,1236.0,301.6
217970.0,6,3,426,2,280,0.0,214.0,140.0,1,146,0.0,146.0,146.0
14986.0,17,2,180,1,90,0.0,90.0,90.0,1,90,0.0,90.0,90.0
207262.0,6,3,426,2,280,0.0,214.0,140.0,1,146,0.0,146.0,146.0
2031.0,17,4,344,2,150,0.0,75.0,75.0,2,194,0.0,103.0,97.0
307608.0,6,6,412,4,272,102536.0,74.0,68.0,2,140,0.0,74.0,70.0
90049304.0,17,28,13364,28,13364,3335159.407407407,501.0,477.2857142857143,0,0,0.0,0.0,0.0
26670.0,6,14,4740,7,653,4021.6666666666665,249.0,93.28571428571428,7,4087,4115.333333333333,1514.0,583.8571428571429
91146967.0,6,172,19428,86,13530,1069786.5647058825,284.0,157.32558139534885,86,5898,1069786.7294117648,140.0,68.5813953488372
41005.0,6,10,2032,5,524,10027.5,252.0,104.8,5,1508,9278.75,1236.0,301.6
443.0,17,2,267,1,83,0.0,83.0,83.0,1,184,0.0,184.0,184.0
155375.0,6,3,337,2,214,0.0,160.0,107.0,1,123,0.0,123.0,123.0
21767828.0,17,8,1371,4,306,7255833.333333333,89.0,76.5,4,1065,7205149.333333333,443.0,266.25
206836.0,17,2,180,1,90,0.0,90.0,90.0,1,90,0.0,90.0,90.0
128999141.0,17,15,907,8,475,18428448.71428572,174.0,59.375,7,432,18166866.5,174.0,61.71428571428572
135133656.0,17,6,1206,6,1206,27026731.2,201.0,201.0,0,0,0.0,0.0,0.0
107590.0,6,14,4740,7,653,17823.166666666668,249.0,93.28571428571428,7,4087,16697.5,1514.0,583.8571428571429
232279.0,6,3,337,2,214,0.0,160.0,107.0,1,123,0.0,123.0,123.0
120714597.0,6,37,2656,19,1408,6706366.5,139.0,74.10526315789474,18,1248,6500785.117647059,123.0,69.33333333333333
119552285.0,6,48,3168,24,1584,5197925.434782608,66.0,66.0,24,1584,5185950.695652174,66.0,66.0
120000087.0,6,18,1382,10,786,13333343.0,95.0,78.6,8,596,12899415.142857144,95.0,74.5
252507.0,6,3,337,2,214,0.0,160.0,107.0,1,123,0.0,123.0,123.0
144.0,17,2,700,2,700,0.0,350.0,350.0,0,0,0.0,0.0,0.0
4170.0,17,4,704,2,148,0.0,74.0,74.0,2,556,0.0,280.0,278.0
35282.0,6,14,4740,7,653,5247.833333333333,249.0,93.28571428571428,7,4087,5727.166666666667,1514.0,583.8571428571429
90042543.0,17,27,12943,27,12943,3463174.730769231,501.0,479.3703703703704,0,0,0.0,0.0,0.0
306801.0,6,6,412,4,272,102267.0,74.0,68.0,2,140,0.0,74.0,70.0
206411.0,6,3,426,2,280,0.0,214.0,140.0,1,146,0.0,146.0,146.0
111768662.0,6,44,2904,22,1452,5322317.238095238,66.0,66.0,22,1452,5307661.476190476,66.0,66.0
120273237.0,6,224,25328,112,7614,1076090.81981982,140.0,67.98214285714286,112,17714,1076164.144144144,284.0,158.16071428571428
2051093.0,17,8,1640,4,312,683568.0,78.0,78.0,4,1328,683559.6666666666,332.0,332.0
36772.0,6,14,4740,7,653,4744.5,249.0,93.28571428571428,7,4087,5604.833333333333,1514.0,583.8571428571429
49984.0,6,14,4740,7,653,7299.833333333333,249.0,93.28571428571428,7,4087,8191.166666666667,1514.0,583.8571428571429
5623688.0,6,5,336,2,134,0.0,68.0,67.0,3,202,1520012.5,70.0,67.33333333333333
2429.0,17,4,344,2,150,0.0,75.0,75.0,2,194,0.0,103.0,97.0
149356.0,17,2,414,1,88,0.0,88.0,88.0,1,326,0.0,326.0,326.0
39849.0,6,14,4740,7,653,6517.5,249.0,93.28571428571428,7,4087,6503.333333333333,1514.0,583.8571428571429
13885.0,6,11,1132,6,556,2326.6,218.0,92.66666666666669,5,576,3266.0,304.0,115.2
988581.0,6,12,1447,6,816,195744.0,291.0,136.0,6,631,196999.6,293.0,105.16666666666669
306564.0,6,6,412,4,272,102188.0,74.0,68.0,2,140,0.0,74.0,70.0
1318676.0,6,4,264,2,132,0.0,66.0,66.0,2,132,0.0,66.0,66.0
90054667.0,17,28,13364,28,13364,3335358.037037037,501.0,477.2857142857143,0,0,0.0,0.0,0.0
36300.0,6,14,4740,7,653,5882.833333333333,249.0,93.28571428571428,7,4087,5343.833333333333,1514.0,583.8571428571429
90255310.0,6,13,1898,8,1016,12893615.714285716,188.0,127.0,5,882,22523482.25,204.0,176.4
75706.0,6,14,4740,7,653,11891.0,249.0,93.28571428571428,7,4087,12350.5,1514.0,583.8571428571429
42565.0,6,10,2032,5,524,10386.0,252.0,104.8,5,1508,9936.5,1236.0,301.6
108561601.0,6,196,22092,98,15402,1116971.381443299,284.0,157.16326530612244,98,6690,1116972.824742268,140.0,68.26530612244898
322007.0,17,4,1400,4,1400,107335.66666666669,350.0,350.0,0,0,0.0,0.0,0.0
228163.0,17,2,180,1,90,0.0,90.0,90.0,1,90,0.0,90.0,90.0
19329.0,6,20,7606,11,978,1932.9,310.0,88.9090909090909,9,6628,2140.0,1514.0,736.4444444444445
108104453.0,17,5,1005,5,1005,27026113.25,201.0,201.0,0,0,0.0,0.0,0.0
62915.0,6,14,4740,7,653,9310.333333333334,249.0,93.28571428571428,7,4087,7467.166666666667,1514.0,583.8571428571429
153423.0,17,2,180,1,90,0.0,90.0,90.0,1,90,0.0,90.0,90.0
135134165.0,17,6,1146,6,1146,27026833.0,191.0,191.0,0,0,0.0,0.0,0.0
151730.0,6,3,373,2,238,0.0,172.0,119.0,1,135,0.0,135.0,135.0
1157014.0,6,13,3020,8,2392,165287.7142857143,1514.0,299.0,5,628,220371.5,331.0,125.6
123730624.0,6,49,3234,25,1650,5155442.666666667,66.0,66.0,24,1584,5035601.347826087,66.0,66.0
90037782.0,17,28,13364,28,13364,3334732.6666666665,501.0,477.2857142857143,0,0,0.0,0.0,0.0
91481795.0,17,12,778,6,389,18200212.8,174.0,64.83333333333333,6,389,18201226.2,174.0,64.83333333333333
10485827.0,6,7,478,4,272,3449739.333333333,74.0,68.0,3,206,5174510.5,74.0,68.66666666666667
135127362.0,17,6,1146,6,1146,27025472.4,191.0,191.0,0,0,0.0,0.0,0.0
27064.0,6,14,4740,7,653,4301.166666666667,249.0,93.28571428571428,7,4087,4372.166666666667,1514.0,583.8571428571429
15554.0,6,10,2032,5,524,3481.5,252.0,104.8,5,1508,3568.25,1236.0,301.6
10517275.0,6,6,412,3,206,5190367.5,74.0,68.66666666666667,3,206,5190291.0,74.0,68.66666666666667
310161.0,6,6,412,4,272,103387.0,74.0,68.0,2,140,0.0,74.0,70.0
150123.0,6,13,1394,7,797,25020.5,253.0,113.85714285714286,6,597,26210.2,259.0,99.5
135135780.0,17,6,1206,6,1206,27027156.0,201.0,201.0,0,0,0.0,0.0,0.0
113424083.0,6,46,3036,23,1518,5155628.909090909,66.0,66.0,23,1518,5155625.636363637,66.0,66.0
111032830.0,6,32,2220,16,1149,7388554.6,123.0,71.8125,16,1071,7388543.466666667,123.0,66.9375
50902.0,6,11,1131,6,600,10180.4,262.0,100.0,5,531,11270.0,259.0,106.2
2301.0,17,4,344,2,150,0.0,75.0,75.0,2,194,0.0,103.0,97.0
105431827.0,6,30,2122,15,1105,7515430.642857143,139.0,73.66666666666667,15,1017,7514671.285714285,123.0,67.8
206488.0,17,2,180,1,90,0.0,90.0,90.0,1,90,0.0,90.0,90.0
119464250.0,6,240,27088,120,18872,1002092.6554621848,284.0,157.26666666666668,120,8216,1002092.6890756304,140.0,68.46666666666667
120092073.0,6,230,25994,115,7886,1048311.649122807,140.0,68.57391304347826,115,18108,1047288.798245614,284.0,157.4608695652174
108318.0,17,2,286,2,286,0.0,143.0,143.0,0,0,0.0,0.0,0.0
209835.0,6,10,1221,6,636,41967.0,298.0,106.0,4,585,68501.0,379.0,146.25
28488.0,6,14,4740,7,653,4383.0,249.0,93.28571428571428,7,4087,4605.0,1514.0,583.8571428571429
137702809.0,17,15,1169,7,563,19668191.83333333,174.0,80.42857142857143,8,606,19649121.85714286,174.0,75.75
319338.0,17,4,1400,4,1400,106446.0,350.0,350.0,0,0,0.0,0.0,0.0
26436.0,6,14,4740,7,653,3487.0,249.0,93.28571428571428,7,4087,4168.5,1514.0,583.8571428571429
108109454.0,17,5,1005,5,1005,27027363.5,201.0,201.0,0,0,0.0,0.0,0.0
124017016.0,17,15,907,8,475,17716716.57142857,174.0,59.375,7,432,17500161.666666668,174.0,61.71428571428572
90005082.0,17,27,12943,27,12943,3461733.923076923,501.0,479.3703703703704,0,0,0.0,0.0,0.0
307139.0,6,6,412,4,272,102379.66666666669,74.0,68.0,2,140,0.0,74.0,70.0
127427155.0,6,31,2097,16,1149,8495143.666666666,123.0,71.8125,15,948,8415158.0,123.0,63.2
233233.0,6,3,337,2,214,0.0,160.0,107.0,1,123,0.0,123.0,123.0
303903.0,6,6,412,4,272,101301.0,74.0,68.0,2,140,0.0,74.0,70.0
47811906.0,6,8,1940,3,887,22661150.0,753.0,295.6666666666667,5,1053,11258109.0,785.0,210.6
669676.0,17,2,608,1,75,0.0,75.0,75.0,1,533,0.0,533.0,533.0
12291.0,17,4,823,2,163,0.0,89.0,81.5,2,660,0.0,443.0,330.0
146267.0,6,3,337,2,214,0.0,160.0,107.0,1,123,0.0,123.0,123.0
318730.0,17,4,1400,4,1400,106243.33333333331,350.0,350.0,0,0,0.0,0.0,0.0
120395469.0,6,241,27260,121,19118,1003295.575,284.0,158.0,120,8142,1002978.1176470588,140.0,67.85
439.0,17,2,176,1,88,0.0,88.0,88.0,1,88,0.0,88.0,88.0
5622560.0,6,5,336,2,134,0.0,68.0,67.0,3,202,1422384.5,70.0,67.33333333333333
113618030.0,6,46,3036,23,1518,5150435.636363637,66.0,66.0,23,1518,5150435.818181818,66.0,66.0
315803.0,6,6,412,4,272,105267.66666666669,74.0,68.0,2,140,0.0,74.0,70.0
90931305.0,6,19,1436,9,691,11366413.125,95.0,76.77777777777777,10,745,10075148.666666666,95.0,74.5
17201.0,17,2,180,1,90,0.0,90.0,90.0,1,90,0.0,90.0,90.0
108109128.0,17,5,955,5,955,27027282.0,191.0,191.0,0,0,0.0,0.0,0.0
53278.0,6,10,2032,5,524,12571.0,252.0,104.8,5,1508,12947.5,1236.0,301.6
108108138.0,17,5,1005,5,1005,27027034.5,201.0,201.0,0,0,0.0,0.0,0.0
32497.0,6,10,2032,5,524,7419.5,252.0,104.8,5,1508,6792.75,1236.0,301.6
433.0,17,2,267,1,83,0.0,83.0,83.0,1,184,0.0,184.0,184.0
10477815.0,6,7,478,4,272,3445242.0,74.0,68.0,3,206,5167742.0,74.0,68.66666666666667
30236.0,6,10,2032,5,524,7328.5,252.0,104.8,5,1508,7328.5,1236.0,301.6
4551.0,17,2,614,1,72,0.0,72.0,72.0,1,542,0.0,542.0,542.0
218966.0,6,10,1221,6,636,43793.2,298.0,106.0,4,585,71174.0,379.0,146.25
127026265.0,6,33,2280,17,1209,7939141.5625,123.0,71.11764705882354,16,1071,7788323.466666667,123.0,66.9375
41246.0,6,14,4740,7,653,6607.333333333333,249.0,93.28571428571428,7,4087,6638.166666666667,1514.0,583.8571428571429
106968530.0,6,44,2904,22,1452,5093739.523809524,66.0,66.0,22,1452,5080606.761904762,66.0,66.0
90033021.0,17,28,13364,28,13364,3334556.333333333,501.0,477.2857142857143,0,0,0.0,0.0,0.0
235219.0,6,3,337,2,214,0.0,160.0,107.0,1,123,0.0,123.0,123.0
45141.0,6,14,4740,7,653,7299.5,249.0,93.28571428571428,7,4087,6905.333333333333,1514.0,583.8571428571429
30540.0,6,14,4740,7,653,4966.0,249.0,93.28571428571428,7,4087,4435.166666666667,1514.0,583.8571428571429
48589.0,6,14,4740,7,653,7974.666666666667,249.0,93.28571428571428,7,4087,7539.666666666667,1514.0,583.8571428571429
41419.0,6,14,4740,7,653,5915.0,249.0,93.28571428571428,7,4087,6387.666666666667,1514.0,583.8571428571429
49943.0,6,12,1328,6,731,8535.6,253.0,121.83333333333331,6,597,9116.0,259.0,99.5
153.0,17,2,3028,2,3028,0.0,1514.0,1514.0,0,0,0.0,0.0,0.0
22205.0,6,14,4740,7,653,3574.833333333333,249.0,93.28571428571428,7,4087,3567.6666666666665,1514.0,583.8571428571429
118194251.0,17,16,1212,8,606,16857277.285714287,174.0,75.75,8,606,16859399.285714287,174.0,75.75
30069.0,6,11,1131,6,600,5440.6,262.0,100.0,5,531,5987.25,259.0,106.2
1565897.0,6,2,132,1,66,0.0,66.0,66.0,1,66,0.0,66.0,66.0
102479.0,17,2,762,2,762,0.0,381.0,381.0,0,0,0.0,0.0,0.0
31612.0,6,10,2032,5,524,7038.25,252.0,104.8,5,1508,7201.5,1236.0,301.6
43450.0,6,14,4740,7,653,6139.833333333333,249.0,93.28571428571428,7,4087,7006.833333333333,1514.0,583.8571428571429
117683793.0,6,325,38114,163,27200,726443.1666666666,464.0,166.87116564417178,162,10914,729555.9254658385,140.0,67.37037037037037
90769216.0,6,19,1436,10,745,10080669.888888888,95.0,74.5,9,691,11345038.875,95.0,76.77777777777777
101916.0,17,2,762,2,762,0.0,381.0,381.0,0,0,0.0,0.0,0.0
306855.0,6,6,412,4,272,102285.0,74.0,68.0,2,140,0.0,74.0,70.0
256626.00000000003,6,10,1221,6,636,51325.2,298.0,106.0,4,585,78571.0,379.0,146.25
103667.0,17,2,286,2,286,0.0,143.0,143.0,0,0,0.0,0.0,0.0
108110226.0,17,5,955,5,955,27027556.5,191.0,191.0,0,0,0.0,0.0,0.0
34728.0,17,2,582,1,83,0.0,83.0,83.0,1,499,0.0,499.0,499.0
1036271.0,6,11,1134,6,558,207254.2,220.0,93.0,5,576,255660.0,304.0,115.2
90257401.0,6,13,2036,8,1016,12893914.42857143,188.0,127.0,5,1020,22523678.0,204.0,204.0
55633.0,6,14,4740,7,653,8849.666666666666,249.0,93.28571428571428,7,4087,8409.0,1514.0,583.8571428571429
537000.0,6,4,270,2,134,0.0,68.0,67.0,2,136,0.0,70.0,68.0
214405.0,17,2,180,1,90,0.0,90.0,90.0,1,90,0.0,90.0,90.0
90009780.0,17,27,12943,27,12943,3461914.6153846155,501.0,479.3703703703704,0,0,0.0,0.0,0.0
90605679.0,6,26,1746,13,906,7532486.666666667,123.0,69.6923076923077,13,840,7532470.666666667,123.0,64.61538461538461
4808188.0,6,5,336,2,134,0.0,68.0,67.0,3,202,1646926.0,70.0,67.33333333333333
120009621.0,6,26,2019,12,935,10909965.545454543,95.0,77.91666666666667,14,1084,6924478.153846154,95.0,77.42857142857143
416.0,17,2,508,2,508,0.0,257.0,254.0,0,0,0.0,0.0,0.0
100785.0,17,2,762,2,762,0.0,381.0,381.0,0,0,0.0,0.0,0.0
48486.0,6,14,4740,7,653,7165.0,249.0,93.28571428571428,7,4087,6052.166666666667,1514.0,583.8571428571429
93112149.0,6,38,2508,19,1254,5155444.444444444,66.0,66.0,19,1254,5155438.111111111,66.0,66.0
120091458.0,6,907,202662,465,172602,258370.739224138,1514.0,371.1870967741936,442,30060,271828.0272108844,214.0,68.00904977375566
3170.0,17,4,625,2,163,0.0,89.0,81.5,2,462,0.0,245.0,231.0
108070.0,17,2,286,2,286,0.0,143.0,143.0,0,0,0.0,0.0,0.0
2801487.0,6,2,132,1,66,0.0,66.0,66.0,1,66,0.0,66.0,66.0
299.0,17,2,164,1,82,0.0,82.0,82.0,1,82,0.0,82.0,82.0
27900.0,6,14,4740,7,653,4236.166666666667,249.0,93.28571428571428,7,4087,4190.833333333333,1514.0,583.8571428571429
120353242.0,6,257,29358,129,20614,940259.703125,284.0,159.7984496124031,128,8744,931362.2677165356,140.0,68.3125
92713102.0,6,38,2508,19,1254,5135443.333333333,66.0,66.0,19,1254,5135437.444444444,66.0,66.0
2300.0,17,4,344,2,150,0.0,75.0,75.0,2,194,0.0,103.0,97.0
1298587.0,6,4,264,2,132,0.0,66.0,66.0,2,132,0.0,66.0,66.0
229719.0,6,10,2032,5,524,57068.75,252.0,104.8,5,1508,54661.0,1236.0,301.6
108097587.0,17,5,1005,5,1005,27024396.75,201.0,201.0,0,0,0.0,0.0,0.0
42331.0,6,14,4740,7,653,6932.333333333333,249.0,93.28571428571428,7,4087,6169.833333333333,1514.0,583.8571428571429
921728.0,6,12,2718,7,743,153621.33333333334,339.0,106.14285714285714,5,1975,162317.75,1514.0,395.0
36237.0,6,10,2032,5,524,7061.75,252.0,104.8,5,1508,8201.5,1236.0,301.6
2531122.0,6,25,7573,14,3735,194701.6923076923,1514.0,266.7857142857143,11,3838,225803.7,1514.0,348.90909090909093
113399066.0,6,216,24418,108,17068,1057789.5607476635,284.0,158.03703703703704,108,7350,1057791.598130841,140.0,68.05555555555556
102950855.0,17,14,864,7,432,17000777.833333332,174.0,61.71428571428572,7,432,17000227.0,174.0,61.71428571428572
124288.0,6,14,4740,7,653,7435.666666666667,249.0,93.28571428571428,7,4087,20057.33333333333,1514.0,583.8571428571429
2802536.0,6,2,132,1,66,0.0,66.0,66.0,1,66,0.0,66.0,66.0
48951.0,6,14,4740,7,653,8033.0,249.0,93.28571428571428,7,4087,7974.666666666667,1514.0,583.8571428571429
2254.0,17,4,344,2,150,0.0,75.0,75.0,2,194,0.0,103.0,97.0
829.0,17,5,550,5,550,207.25,110.0,110.0,0,0,0.0,0.0,0.0
135131244.0,17,6,1146,6,1146,27026248.8,191.0,191.0,0,0,0.0,0.0,0.0
120000998.0,17,13,559,7,301,20000166.33333333,43.0,43.0,6,258,20000962.4,43.0,43.0
130145.0,6,3,337,2,214,0.0,160.0,107.0,1,123,0.0,123.0,123.0
20142.0,17,2,582,1,83,0.0,83.0,83.0,1,499,0.0,499.0,499.0
112333297.0,6,33,2412,17,1272,7020831.0625,123.0,74.82352941176471,16,1140,7474476.8,123.0,71.25
34526.0,6,10,2032,5,524,8267.0,252.0,104.8,5,1508,7141.25,1236.0,301.6
90015777.0,17,28,13364,28,13364,3333917.6666666665,501.0,477.2857142857143,0,0,0.0,0.0,0.0
105853702.0,6,962,201266,473,31736,224232.25,214.0,67.09513742071881,489,169530,216908.4323770492,1514.0,346.6871165644172
104000.0,17,2,286,2,286,0.0,143.0,143.0,0,0,0.0,0.0,0.0
2626985.0,6,25,7573,14,3735,202075.7692307692,1514.0,266.7857142857143,11,3838,236596.8,1514.0,348.90909090909093
2804947.0,6,2,132,1,66,0.0,66.0,66.0,1,66,0.0,66.0,66.0
32848.0,6,2,145,2,145,0.0,91.0,72.5,0,0,0.0,0.0,0.0
22686.0,6,11,1133,6,602,3976.2,264.0,100.33333333333331,5,531,3896.0,259.0,106.2
1474482.0,17,16,1120,16,1120,98298.8,70.0,70.0,0,0,0.0,0.0,0.0
63784.99999999999,6,14,4740,7,653,8803.833333333334,249.0,93.28571428571428,7,4087,10245.0,1514.0,583.8571428571429
40091.0,6,14,4740,7,653,6548.5,249.0,93.28571428571428,7,4087,6378.666666666667,1514.0,583.8571428571429
90298220.0,6,16,1192,8,596,12892614.857142856,95.0,74.5,8,596,12898776.42857143,95.0,74.5
2005244.0,17,4,525,2,150,0.0,75.0,75.0,2,375,0.0,284.0,187.5
2017.0,17,4,344,2,150,0.0,75.0,75.0,2,194,0.0,103.0,97.0
108471.0,17,2,762,2,762,0.0,381.0,381.0,0,0,0.0,0.0,0.0
32776.0,6,14,4740,7,653,5277.5,249.0,93.28571428571428,7,4087,5189.833333333333,1514.0,583.8571428571429
316163.0,17,4,1400,4,1400,105387.66666666669,350.0,350.0,0,0,0.0,0.0,0.0
2063.0,17,4,344,2,150,0.0,75.0,75.0,2,194,0.0,103.0,97.0
135134636.0,17,6,1146,6,1146,27026927.2,191.0,191.0,0,0,0.0,0.0,0.0
10472747.0,6,7,478,4,272,3445695.6666666665,74.0,68.0,3,206,5168422.5,74.0,68.66666666666667
111125957.0,6,30,1974,15,1026,7922151.142857143,123.0,68.4,15,948,7922150.5,123.0,63.2
104632809.0,6,43,3676,25,2083,4359700.375,139.0,83.32,18,1593,5554835.588235294,123.0,88.5
44846.0,6,10,2032,5,524,10966.75,252.0,104.8,5,1508,10857.25,1236.0,301.6
146337.0,6,3,337,2,214,0.0,160.0,107.0,1,123,0.0,123.0,123.0
48287.0,6,14,4740,7,653,6125.833333333333,249.0,93.28571428571428,7,4087,7354.666666666667,1514.0,583.8571428571429
308034.0,6,6,412,4,272,102678.0,74.0,68.0,2,140,0.0,74.0,70.0
30467.0,6,14,4740,7,653,4900.166666666667,249.0,93.28571428571428,7,4087,3772.5,1514.0,583.8571428571429
404263.0,6,4,508,2,238,0.0,172.0,119.0,2,270,0.0,135.0,135.0
269867.0,6,3,426,2,280,0.0,214.0,140.0,1,146,0.0,146.0,146.0
15493982.0,6,6,352,1,62,0.0,62.0,62.0,5,290,3797305.75,58.0,58.0
146396.0,6,3,337,2,214,0.0,160.0,107.0,1,123,0.0,123.0,123.0
99815.0,17,2,762,2,762,0.0,381.0,381.0,0,0,0.0,0.0,0.0
116930351.0,6,23,2084,11,1231,11668494.5,361.0,111.9090909090909,12,853,10608192.727272728,95.0,71.08333333333333
121966.0,6,3,373,2,238,0.0,172.0,119.0,1,135,0.0,135.0,135.0
204018.0,17,2,762,2,762,0.0,381.0,381.0,0,0,0.0,0.0,0.0
308133.0,6,6,412,4,272,102711.0,74.0,68.0,2,140,0.0,74.0,70.0
144771.0,17,2,180,1,90,0.0,90.0,90.0,1,90,0.0,90.0,90.0
19134.0,6,14,4740,7,653,2680.333333333333,249.0,93.28571428571428,7,4087,3046.1666666666665,1514.0,583.8571428571429
12052.0,6,11,2098,6,590,2248.0,252.0,98.33333333333331,5,1508,2690.5,1236.0,301.6
307152.0,6,6,412,4,272,102384.0,74.0,68.0,2,140,0.0,74.0,70.0
104562.0,17,2,762,2,762,0.0,381.0,381.0,0,0,0.0,0.0,0.0
446374.0,6,10,967,5,390,75554.5,162.0,78.0,5,577,75483.0,349.0,115.4
301.0,17,2,174,1,79,0.0,79.0,79.0,1,95,0.0,95.0,95.0
136963.0,17,2,192,1,88,0.0,88.0,88.0,1,104,0.0,104.0,104.0
90265317.0,6,13,2036,8,1016,12895045.285714284,188.0,127.0,5,1020,22525583.25,204.0,204.0
334.0,17,2,166,1,75,0.0,75.0,75.0,1,91,0.0,91.0,91.0
297451.0,6,6,412,4,272,99150.33333333331,74.0,68.0,2,140,0.0,74.0,70.0
119848607.0,6,14,2102,9,1082,14981075.875,188.0,120.22222222222224,5,1020,22522906.0,204.0,204.0
234447.0,6,3,337,2,214,0.0,160.0,107.0,1,123,0.0,123.0,123.0
135114964.0,17,6,1146,6,1146,27022992.8,191.0,191.0,0,0,0.0,0.0,0.0
206145.0,17,2,180,1,90,0.0,90.0,90.0,1,90,0.0,90.0,90.0
2801879.0,6,2,132,1,66,0.0,66.0,66.0,1,66,0.0,66.0,66.0
18982.0,6,11,2098,6,590,2639.2,252.0,98.33333333333331,5,1508,3742.75,1236.0,301.6
32477.0,6,14,4740,7,653,5240.833333333333,249.0,93.28571428571428,7,4087,5227.333333333333,1514.0,583.8571428571429
85866.0,17,3,1143,3,1143,42933.0,381.0,381.0,0,0,0.0,0.0,0.0
0.0,17,1,90,1,90,0.0,90.0,90.0,0,0,0.0,0.0,0.0
41309.0,6,14,4740,7,653,6724.0,249.0,93.28571428571428,7,4087,6434.5,1514.0,583.8571428571429
205805.0,17,2,180,1,90,0.0,90.0,90.0,1,90,0.0,90.0,90.0
21351.0,6,10,2032,5,524,5119.0,252.0,104.8,5,1508,5035.75,1236.0,301.6
10932.0,17,2,582,1,83,0.0,83.0,83.0,1,499,0.0,499.0,499.0
205944.0,17,2,180,1,90,0.0,90.0,90.0,1,90,0.0,90.0,90.0
773.0,17,4,438,2,148,0.0,74.0,74.0,2,290,0.0,147.0,145.0
120549216.0,6,273,32162,137,22890,886391.2941176471,336.0,167.08029197080293,136,9272,869966.7407407408,140.0,68.17647058823529
384986.0,6,3,204,1,68,0.0,68.0,68.0,2,136,0.0,70.0,68.0
13457.0,6,14,4740,7,653,2084.5,249.0,93.28571428571428,7,4087,2105.333333333333,1514.0,583.8571428571429
44764.0,6,2,132,1,66,0.0,66.0,66.0,1,66,0.0,66.0,66.0
355548.0,6,13,1439,7,714,59258.0,298.0,102.0,6,725,67760.4,379.0,120.83333333333331
153338.0,17,2,180,1,90,0.0,90.0,90.0,1,90,0.0,90.0,90.0
1084440.0,6,13,1386,7,789,180740.0,253.0,112.71428571428572,6,597,214504.6,259.0,99.5
812.0,17,4,438,2,148,0.0,74.0,74.0,2,290,0.0,147.0,145.0
6937.0,17,2,582,1,83,0.0,83.0,83.0,1,499,0.0,499.0,499.0
299690.0,6,6,412,4,272,99896.66666666669,74.0,68.0,2,140,0.0,74.0,70.0
205665.0,17,2,762,2,762,0.0,381.0,381.0,0,0,0.0,0.0,0.0
345.0,17,2,250,1,93,0.0,93.0,93.0,1,157,0.0,157.0,157.0
191122.0,17,2,180,1,90,0.0,90.0,90.0,1,90,0.0,90.0,90.0
13940092.0,6,20,1607,9,921,1703646.875,315.0,102.33333333333331,11,686,1362915.3,78.0,62.36363636363637
308381.0,6,6,412,4,272,102793.66666666669,74.0,68.0,2,140,0.0,74.0,70.0
39992.0,6,14,4740,7,653,6279.5,249.0,93.28571428571428,7,4087,6010.833333333333,1514.0,583.8571428571429
10475488.0,6,7,478,4,272,3446473.0,74.0,68.0,3,206,5169600.0,74.0,68.66666666666667
34694.0,6,14,4740,7,653,5603.166666666667,249.0,93.28571428571428,7,4087,5642.5,1514.0,583.8571428571429
294222.0,6,12,1373,7,714,49037.0,298.0,102.0,5,659,69437.0,379.0,131.8
41759.0,6,14,4740,7,653,6012.5,249.0,93.28571428571428,7,4087,6183.833333333333,1514.0,583.8571428571429
93779706.0,6,40,2640,20,1320,4935774.0,66.0,66.0,20,1320,4919616.894736842,66.0,66.0
228209.0,17,2,180,1,90,0.0,90.0,90.0,1,90,0.0,90.0,90.0
62100.0,6,14,4740,7,653,10241.0,249.0,93.28571428571428,7,4087,9705.5,1514.0,583.8571428571429
107070.0,17,4,1400,4,1400,35690.0,350.0,350.0,0,0,0.0,0.0,0.0
10425308.0,6,6,412,3,206,5144689.0,74.0,68.66666666666667,3,206,5144594.5,74.0,68.66666666666667
589193.0,6,4,492,2,280,0.0,214.0,140.0,2,212,0.0,146.0,106.0
18369.0,6,10,1949,5,441,4389.25,169.0,88.2,5,1508,4322.0,1236.0,301.6
29505.0,6,10,2032,5,524,6868.25,252.0,104.8,5,1508,6809.75,1236.0,301.6
121441.0,6,3,337,2,214,0.0,160.0,107.0,1,123,0.0,123.0,123.0
3003896.0,6,118,105596,77,98588,39428.15789473684,1510.0,1280.3636363636365,41,7008,67409.825,1510.0,170.9268292682927
90028809.0,17,28,13364,28,13364,3334400.333333333,501.0,477.2857142857143,0,0,0.0,0.0,0.0
36696.0,6,14,4740,7,653,5992.333333333333,249.0,93.28571428571428,7,4087,5716.833333333333,1514.0,583.8571428571429
2398.0,17,4,344,2,150,0.0,75.0,75.0,2,194,0.0,103.0,97.0
1301464.0,6,4,264,2,132,0.0,66.0,66.0,2,132,0.0,66.0,66.0
23883.0,6,14,4740,7,653,3803.0,249.0,93.28571428571428,7,4087,3724.3333333333335,1514.0,583.8571428571429
0.0,17,1,55,1,55,0.0,55.0,55.0,0,0,0.0,0.0,0.0
4436.0,17,2,614,1,72,0.0,72.0,72.0,1,542,0.0,542.0,542.0
90083936.0,6,11,1644,4,816,30027204.33333333,204.0,204.0,7,828,15012795.333333334,188.0,118.28571428571428
242237.0,6,3,337,2,214,0.0,160.0,107.0,1,123,0.0,123.0,123.0
230889.0,17,2,359,1,75,0.0,75.0,75.0,1,284,0.0,284.0,284.0
2195.0,17,2,664,1,322,0.0,322.0,322.0,1,342,0.0,342.0,342.0
103505570.0,6,185,20842,93,6360,1125060.543478261,140.0,68.38709677419355,92,14482,1121909.5054945054,284.0,157.41304347826087
0.0,17,1,72,1,72,0.0,72.0,72.0,0,0,0.0,0.0,0.0
171603.0,17,2,180,1,90,0.0,90.0,90.0,1,90,0.0,90.0,90.0
2347.0,17,4,344,2,150,0.0,75.0,75.0,2,194,0.0,103.0,97.0
108112329.0,17,5,955,5,955,27028082.25,191.0,191.0,0,0,0.0,0.0,0.0
43089832.0,6,8,1307,8,1307,6155690.285714285,172.0,163.375,0,0,0.0,0.0,0.0
314583.0,17,4,1400,4,1400,104861.0,350.0,350.0,0,0,0.0,0.0,0.0
307503.0,6,6,412,4,272,102501.0,74.0,68.0,2,140,0.0,74.0,70.0
9193.0,17,2,582,1,83,0.0,83.0,83.0,1,499,0.0,499.0,499.0
100415179.0,17,14,864,7,432,16666799.0,174.0,61.71428571428572,7,432,16667400.5,174.0,61.71428571428572
0.0,17,1,179,1,179,0.0,179.0,179.0,0,0,0.0,0.0,0.0
3010175.0,6,12,2172,7,664,501405.5,252.0,94.85714285714286,5,1508,2591.75,1236.0,301.6
347.0,17,2,267,1,83,0.0,83.0,83.0,1,184,0.0,184.0,184.0
0.0,6,1,66,1,66,0.0,66.0,66.0,0,0,0.0,0.0,0.0
197001.0,17,2,180,1,90,0.0,90.0,90.0,1,90,0.0,90.0,90.0
308363.0,6,6,412,4,272,102787.66666666669,74.0,68.0,2,140,0.0,74.0,70.0
42699.0,6,14,4740,7,653,6762.666666666667,249.0,93.28571428571428,7,4087,6869.166666666667,1514.0,583.8571428571429
121245961.0,6,220,24884,110,7556,1095402.76146789,140.0,68.69090909090909,110,17328,1104318.6972477064,284.0,157.52727272727273
14958.0,17,2,180,1,90,0.0,90.0,90.0,1,90,0.0,90.0,90.0
144889.0,17,2,180,1,70,0.0,70.0,70.0,1,110,0.0,110.0,110.0
2306.0,17,4,344,2,150,0.0,75.0,75.0,2,194,0.0,103.0,97.0
90285865.0,6,16,2368,9,1204,11285733.125,188.0,133.77777777777777,7,1164,15020388.166666666,204.0,166.28571428571428
41483.0,6,10,2032,5,524,6739.0,252.0,104.8,5,1508,9595.0,1236.0,301.6
146136.0,6,3,337,2,214,0.0,160.0,107.0,1,123,0.0,123.0,123.0
103336.0,17,2,286,2,286,0.0,143.0,143.0,0,0,0.0,0.0,0.0
17023.0,6,14,4740,7,653,2647.833333333333,249.0,93.28571428571428,7,4087,2701.0,1514.0,583.8571428571429
873558.0,6,9,1267,6,796,174711.6,458.0,132.66666666666666,3,471,298871.0,331.0,157.0
207000.0,6,3,426,2,280,0.0,214.0,140.0,1,146,0.0,146.0,146.0
17601.0,6,14,4740,7,653,2553.6666666666665,249.0,93.28571428571428,7,4087,2796.333333333333,1514.0,583.8571428571429
3885.0,17,4,704,2,148,0.0,74.0,74.0,2,556,0.0,280.0,278.0
135133586.0,17,6,1146,6,1146,27026717.2,191.0,191.0,0,0,0.0,0.0,0.0
197217.0,17,2,180,1,90,0.0,90.0,90.0,1,90,0.0,90.0,90.0
16341.999999999998,6,14,4740,7,653,2349.5,249.0,93.28571428571428,7,4087,2583.1666666666665,1514.0,583.8571428571429
110977612.0,6,32,2220,16,1149,7384118.266666667,123.0,71.8125,16,1071,7384118.866666666,123.0,66.9375
155808.0,6,3,337,2,214,0.0,160.0,107.0,1,123,0.0,123.0,123.0
120157104.0,6,230,25978,115,7886,1046711.5614035088,140.0,68.57391304347826,115,18092,1047701.5,284.0,157.3217391304348
0.0,6,1,66,0,0,0.0,0.0,0.0,1,66,0.0,66.0,66.0
135142078.0,17,6,1206,6,1206,27028415.6,201.0,201.0,0,0,0.0,0.0,0.0
44227.0,6,14,4740,7,653,7251.833333333333,249.0,93.28571428571428,7,4087,7089.0,1514.0,583.8571428571429
3015511.0,6,12,2172,7,664,502319.8333333333,252.0,94.85714285714286,5,1508,4467.25,1236.0,301.6
17485.0,6,14,4740,7,653,2772.833333333333,249.0,93.28571428571428,7,4087,2777.6666666666665,1514.0,583.8571428571429
96916263.0,6,26,1746,13,906,8058379.416666667,123.0,69.6923076923077,13,840,8058382.25,123.0,64.61538461538461
90036546.0,17,28,13364,28,13364,3334686.888888889,501.0,477.2857142857143,0,0,0.0,0.0,0.0
198217.0,17,2,180,1,90,0.0,90.0,90.0,1,90,0.0,90.0,90.0
11413.0,6,11,2098,6,590,2115.4,252.0,98.33333333333331,5,1508,2182.75,1236.0,301.6
64401.0,6,14,4740,7,653,8165.0,249.0,93.28571428571428,7,4087,10301.0,1514.0,583.8571428571429
146784.0,6,3,337,2,214,0.0,160.0,107.0,1,123,0.0,123.0,123.0
2358.0,17,4,344,2,150,0.0,75.0,75.0,2,194,0.0,103.0,97.0
216669.0,6,3,426,2,280,0.0,214.0,140.0,1,146,0.0,146.0,146.0
193850.0,6,11,1132,6,556,37946.2,218.0,92.66666666666669,5,576,48253.5,304.0,115.2
2801887.0,6,2,132,1,66,0.0,66.0,66.0,1,66,0.0,66.0,66.0
5615204.0,6,4,270,2,136,0.0,70.0,68.0,2,134,0.0,68.0,67.0
90303741.0,6,24,1829,13,989,7521076.5,95.0,76.07692307692308,11,840,9001109.0,95.0,76.36363636363636
113673087.0,6,48,3168,24,1584,4942308.130434782,66.0,66.0,24,1584,4935655.0869565215,66.0,66.0
197554.0,17,2,180,1,90,0.0,90.0,90.0,1,90,0.0,90.0,90.0
758.0,17,4,438,2,148,0.0,74.0,74.0,2,290,0.0,147.0,145.0
148180670.0,6,21,1585,12,935,13470970.0,95.0,77.91666666666667,9,650,14863126.25,95.0,72.22222222222223
232903.0,6,3,337,2,214,0.0,160.0,107.0,1,123,0.0,123.0,123.0
90036968.0,17,27,12943,27,12943,3462960.3076923075,501.0,479.3703703703704,0,0,0.0,0.0,0.0
125059053.0,6,31,2103,15,1017,8219432.571428572,123.0,67.8,16,1086,8337241.533333333,123.0,67.875
2172.0,17,4,344,2,150,0.0,75.0,75.0,2,194,0.0,103.0,97.0
312793.0,17,4,1400,4,1400,104264.33333333331,350.0,350.0,0,0,0.0,0.0,0.0
151017.0,6,3,337,2,214,0.0,160.0,107.0,1,123,0.0,123.0,123.0
2401.0,17,4,344,2,150,0.0,75.0,75.0,2,194,0.0,103.0,97.0
284532.0,6,10,1221,6,636,56906.4,298.0,106.0,4,585,89476.66666666667,379.0,146.25
27514.0,6,11,2098,6,590,5502.8,252.0,98.33333333333331,5,1508,5701.25,1236.0,301.6
14006.0,6,11,2098,6,590,2571.0,252.0,98.33333333333331,5,1508,3264.75,1236.0,301.6
2395059.0,6,25,7573,14,3735,184235.3076923077,1514.0,266.7857142857143,11,3838,213657.4,1514.0,348.90909090909093
106600.0,17,2,286,2,286,0.0,143.0,143.0,0,0,0.0,0.0,0.0
59471032.0,17,9,3086,8,2736,5210449.428571428,342.0,342.0,1,350,0.0,350.0,350.0
3176091.0,6,18,1495,9,921,358325.125,315.0,102.33333333333331,9,574,358224.625,78.0,63.77777777777778
153819.0,17,2,180,1,90,0.0,90.0,90.0,1,90,0.0,90.0,90.0
239603.0,6,3,373,2,238,0.0,172.0,119.0,1,135,0.0,135.0,135.0
110134481.0,6,28,1860,14,966,8455265.76923077,123.0,69.0,14,894,8455264.0,123.0,63.85714285714285
29299.0,6,10,2032,5,524,6096.25,252.0,104.8,5,1508,6769.5,1236.0,301.6
110666866.0,6,31,2182,16,1165,7377791.066666666,139.0,72.8125,15,1017,7889328.214285715,123.0,67.8
130540.0,6,3,337,2,214,0.0,160.0,107.0,1,123,0.0,123.0,123.0
298693.0,6,6,412,4,272,99564.33333333331,74.0,68.0,2,140,0.0,74.0,70.0
90016781.0,17,28,13364,28,13364,3333954.851851852,501.0,477.2857142857143,0,0,0.0,0.0,0.0
0.0,17,1,161,1,161,0.0,161.0,161.0,0,0,0.0,0.0,0.0
135140658.0,17,6,1146,6,1146,27028131.6,191.0,191.0,0,0,0.0,0.0,0.0
99653.0,17,2,762,2,762,0.0,381.0,381.0,0,0,0.0,0.0,0.0
122530574.0,6,49,3234,25,1650,5105440.583333333,66.0,66.0,24,1584,4972261.0,66.0,66.0
233361.0,6,3,337,2,214,0.0,160.0,107.0,1,123,0.0,123.0,123.0
45733.0,6,14,4740,7,653,7070.5,249.0,93.28571428571428,7,4087,7268.166666666667,1514.0,583.8571428571429
2619355.0,6,2,132,1,66,0.0,66.0,66.0,1,66,0.0,66.0,66.0
5601587.0,6,5,336,2,134,0.0,68.0,67.0,3,202,1421559.0,70.0,67.33333333333333
84410.0,6,12,1328,7,797,14068.333333333334,253.0,113.85714285714286,5,531,17838.25,259.0,106.2
14639791.0,6,20,1607,10,975,1592144.2222222222,315.0,97.5,10,632,1592121.3333333333,78.0,63.2
4487.0,17,2,614,1,72,0.0,72.0,72.0,1,542,0.0,542.0,542.0
234094.0,6,3,337,2,214,0.0,160.0,107.0,1,123,0.0,123.0,123.0
209531.0,17,2,180,1,90,0.0,90.0,90.0,1,90,0.0,90.0,90.0
238740.0,17,2,180,1,90,0.0,90.0,90.0,1,90,0.0,90.0,90.0
2006078.0,6,2,132,1,66,0.0,66.0,66.0,1,66,0.0,66.0,66.0
162353.0,17,2,180,1,90,0.0,90.0,90.0,1,90,0.0,90.0,90.0
321894.0,17,4,1400,4,1400,107298.0,350.0,350.0,0,0,0.0,0.0,0.0
312.0,17,2,168,1,76,0.0,76.0,76.0,1,92,0.0,92.0,92.0
311642.0,17,4,622,4,622,103880.66666666669,163.0,155.5,0,0,0.0,0.0,0.0
144072.0,17,2,180,1,90,0.0,90.0,90.0,1,90,0.0,90.0,90.0
67747.0,6,14,4740,7,653,4564.333333333333,249.0,93.28571428571428,7,4087,10946.166666666666,1514.0,583.8571428571429
108106292.0,17,5,955,5,955,27026573.0,191.0,191.0,0,0,0.0,0.0,0.0
2473.0,17,4,344,2,150,0.0,75.0,75.0,2,194,0.0,103.0,97.0
58890.0,6,14,4740,7,653,9259.166666666666,249.0,93.28571428571428,7,4087,7230.0,1514.0,583.8571428571429
2415.0,17,4,344,2,150,0.0,75.0,75.0,2,194,0.0,103.0,97.0
10421003.0,6,6,412,3,206,5142719.5,74.0,68.66666666666667,3,206,5142622.5,74.0,68.66666666666667
504466.0,6,5,336,2,134,0.0,68.0,67.0,3,202,193139.0,70.0,67.33333333333333
112251.0,17,4,1400,4,1400,37417.0,350.0,350.0,0,0,0.0,0.0,0.0
1049545.0,6,11,1134,6,558,209909.0,220.0,93.0,5,576,261166.5,304.0,115.2
207136.0,6,3,426,2,280,0.0,214.0,140.0,1,146,0.0,146.0,146.0
3005739.0,6,12,2172,7,664,500847.5,252.0,94.85714285714286,5,1508,1841.25,1236.0,301.6
1179292.0,6,13,3010,8,2382,168470.2857142857,1514.0,297.75,5,628,225957.75,331.0,125.6
112560722.0,6,46,3036,23,1518,5106345.5,66.0,66.0,23,1518,5106584.863636363,66.0,66.0
115062586.0,6,48,3168,24,1584,5002721.130434782,66.0,66.0,24,1584,4989130.695652174,66.0,66.0
242593.0,6,3,337,2,214,0.0,160.0,107.0,1,123,0.0,123.0,123.0
121375617.0,6,31,2034,16,1086,8091707.8,123.0,67.875,15,948,7940984.142857143,123.0,63.2
3011554.0,6,12,2172,7,664,501796.0,252.0,94.85714285714286,5,1508,2502.5,1236.0,301.6
30025557.0,6,8,644,5,376,7506389.25,160.0,75.2,3,268,14896649.5,123.0,89.33333333333333
120003725.0,6,22,1639,12,894,10909429.545454543,95.0,74.5,10,745,13310452.222222222,95.0,74.5
2203426.0,6,25,7610,13,2516,183618.8333333333,1034.0,193.53846153846155,12,5094,171867.36363636365,1510.0,424.5
216547.0,17,2,180,1,90,0.0,90.0,90.0,1,90,0.0,90.0,90.0
326.0,17,2,166,1,75,0.0,75.0,75.0,1,91,0.0,91.0,91.0
9140.0,17,2,582,1,83,0.0,83.0,83.0,1,499,0.0,499.0,499.0
198526.0,6,10,1221,6,636,39705.2,298.0,106.0,4,585,64895.0,379.0,146.25
135134277.0,17,6,1146,6,1146,27026855.4,191.0,191.0,0,0,0.0,0.0,0.0
149718.0,6,13,1386,7,789,24953.0,253.0,112.71428571428572,6,597,28316.0,259.0,99.5
1320705.0,6,4,276,2,128,0.0,74.0,64.0,2,148,0.0,74.0,74.0
14130419.0,6,20,1607,10,975,1536478.888888889,315.0,97.5,10,632,1536146.4444444445,78.0,63.2
90257655.0,6,12,1832,8,1016,12893950.714285716,188.0,127.0,4,816,30030627.33333333,204.0,204.0
16374.0,6,11,1132,6,556,3150.6,218.0,92.66666666666669,5,576,3363.75,304.0,115.2
27147155.0,17,5,1718,4,1368,1689583.0,342.0,342.0,1,350,0.0,350.0,350.0
200841.0,17,4,6056,4,6056,66947.0,1514.0,1514.0,0,0,0.0,0.0,0.0
54129.0,6,14,4740,7,653,8051.666666666667,249.0,93.28571428571428,7,4087,8611.666666666666,1514.0,583.8571428571429
119570468.0,6,208,23424,104,16338,1158789.5339805826,284.0,157.09615384615384,104,7086,1158789.7669902912,140.0,68.13461538461539
90290554.0,6,16,1192,8,596,12892577.714285716,95.0,74.5,8,596,12898260.42857143,95.0,74.5
29948.0,6,11,2098,6,590,5511.6,252.0,98.33333333333331,5,1508,6714.0,1236.0,301.6
33802.0,6,12,1320,6,723,5809.2,253.0,120.5,6,597,6168.4,259.0,99.5
200296.0,17,2,180,1,90,0.0,90.0,90.0,1,90,0.0,90.0,90.0
90256961.0,6,14,2240,8,1016,12893851.57142857,188.0,127.0,6,1224,18018225.6,204.0,204.0
90319456.0,6,29,3102,15,1558,6446121.785714285,426.0,103.86666666666666,14,1544,6947125.0,334.0,110.28571428571428
229081.0,6,3,426,2,280,0.0,214.0,140.0,1,146,0.0,146.0,146.0
64443.0,6,14,4740,7,653,8649.5,249.0,93.28571428571428,7,4087,9991.833333333334,1514.0,583.8571428571429
90016043.0,17,28,13364,28,13364,3333927.5185185187,501.0,477.2857142857143,0,0,0.0,0.0,0.0
114046498.0,6,50,4326,29,2433,4073089.214285714,123.0,83.89655172413794,21,1893,5691513.85,123.0,90.14285714285714
108735221.0,6,34,2466,17,1272,6783142.25,123.0,74.82352941176471,17,1194,6783150.5,123.0,70.23529411764706
135133586.0,17,6,1146,6,1146,27026717.2,191.0,191.0,0,0,0.0,0.0,0.0
206063.0,17,2,180,1,90,0.0,90.0,90.0,1,90,0.0,90.0,90.0
2795542.0,6,2,132,1,66,0.0,66.0,66.0,1,66,0.0,66.0,66.0
18052.0,6,2,145,2,145,0.0,91.0,72.5,0,0,0.0,0.0,0.0
318219.0,6,6,412,4,272,106073.0,74.0,68.0,2,140,0.0,74.0,70.0
783049.0,6,2,132,1,66,0.0,66.0,66.0,1,66,0.0,66.0,66.0
308572.0,6,6,412,4,272,102857.33333333331,74.0,68.0,2,140,0.0,74.0,70.0
90261608.0,6,13,2036,8,1016,12894515.42857143,188.0,127.0,5,1020,22524319.75,204.0,204.0
1743.0,17,2,691,1,349,0.0,349.0,349.0,1,342,0.0,342.0,342.0
200130.0,17,2,762,2,762,0.0,381.0,381.0,0,0,0.0,0.0,0.0
46895415.0,6,7,2047,5,1153,11723853.75,885.0,230.6,2,894,0.0,826.0,447.0
121289711.0,6,235,26594,118,18576,1036664.1965811966,284.0,157.42372881355934,117,8018,1028694.6206896552,140.0,68.52991452991454
90346341.0,6,25,1686,13,840,7528861.75,123.0,64.61538461538461,12,846,7286015.272727272,123.0,70.5
125001060.0,17,15,907,8,475,17857294.285714287,174.0,59.375,7,432,17500974.666666668,174.0,61.71428571428572
278352.0,6,10,1221,6,636,55670.4,298.0,106.0,4,585,87246.66666666667,379.0,146.25
70330.0,6,14,4740,7,653,11593.833333333334,249.0,93.28571428571428,7,4087,11477.666666666666,1514.0,583.8571428571429
40198.0,6,14,4740,7,653,6425.666666666667,249.0,93.28571428571428,7,4087,6403.166666666667,1514.0,583.8571428571429
342.0,17,2,174,1,79,0.0,79.0,79.0,1,95,0.0,95.0,95.0
663.0,17,2,762,2,762,0.0,381.0,381.0,0,0,0.0,0.0,0.0
2428.0,17,4,344,2,150,0.0,75.0,75.0,2,194,0.0,103.0,97.0
436289.0,6,11,1021,6,444,58540.0,162.0,74.0,5,577,72981.5,349.0,115.4
14959.0,17,2,180,1,90,0.0,90.0,90.0,1,90,0.0,90.0,90.0
471746.0,6,3,1604,2,851,0.0,785.0,425.5,1,753,0.0,753.0,753.0
3006308.0,6,12,2172,7,664,500924.8333333333,252.0,94.85714285714286,5,1508,2130.25,1236.0,301.6
298065.0,6,6,412,4,272,99355.0,74.0,68.0,2,140,0.0,74.0,70.0
224268.0,6,10,1221,6,636,44853.6,298.0,106.0,4,585,73833.0,379.0,146.25
207184.0,6,10,1221,6,636,41436.8,298.0,106.0,4,585,67742.0,379.0,146.25
90296862.0,6,21,1585,11,840,9024544.2,95.0,76.36363636363636,10,745,10001949.222222222,95.0,74.5
37531.0,6,2,132,1,66,0.0,66.0,66.0,1,66,0.0,66.0,66.0
110968680.0,6,35,2542,18,1348,6515542.294117647,139.0,74.88888888888889,17,1194,6922762.1875,123.0,70.23529411764706
302421.0,6,2,132,1,66,0.0,66.0,66.0,1,66,0.0,66.0,66.0
146258.0,6,3,337,2,214,0.0,160.0,107.0,1,123,0.0,123.0,123.0
108096764.0,17,5,1005,5,1005,27024191.0,201.0,201.0,0,0,0.0,0.0,0.0
90022944.0,17,28,13364,28,13364,3334183.111111111,501.0,477.2857142857143,0,0,0.0,0.0,0.0
0.0,6,1,66,1,66,0.0,66.0,66.0,0,0,0.0,0.0,0.0
7841.000000000001,6,11,2098,6,590,1400.0,252.0,98.33333333333331,5,1508,1716.75,1236.0,301.6
3971.0,17,2,582,1,83,0.0,83.0,83.0,1,499,0.0,499.0,499.0
90051670.0,17,28,13364,28,13364,3335247.037037037,501.0,477.2857142857143,0,0,0.0,0.0,0.0
230795.0,6,13,1386,7,789,38465.833333333336,253.0,112.71428571428572,6,597,44687.0,259.0,99.5
2359.0,17,4,344,2,150,0.0,75.0,75.0,2,194,0.0,103.0,97.0
103836475.0,6,44,2904,22,1452,4944594.047619048,66.0,66.0,22,1452,4931472.333333333,66.0,66.0
90033882.0,17,28,13364,28,13364,3334588.222222222,501.0,477.2857142857143,0,0,0.0,0.0,0.0
1685362.0,6,23,6508,12,1529,153214.72727272726,357.0,127.41666666666669,11,4979,137805.2,1510.0,452.6363636363636
90293519.0,6,18,1468,9,650,11280938.625,95.0,72.22222222222223,9,818,11285310.0,222.0,90.88888888888889
115342740.0,17,16,1212,8,606,16428760.142857144,174.0,75.75,8,606,16430166.285714284,174.0,75.75
298238.0,6,6,412,4,272,99412.66666666669,74.0,68.0,2,140,0.0,74.0,70.0
312449.0,6,3,202,2,128,0.0,74.0,64.0,1,74,0.0,74.0,74.0
121209027.0,6,218,24646,109,7490,1109836.5555555555,140.0,68.71559633027523,109,17156,1114671.4166666667,284.0,157.39449541284404
12702.0,6,10,2032,5,524,2950.0,252.0,104.8,5,1508,2684.25,1236.0,301.6
162321.0,17,2,180,1,90,0.0,90.0,90.0,1,90,0.0,90.0,90.0
90049514.0,17,28,13364,28,13364,3335167.185185185,501.0,477.2857142857143,0,0,0.0,0.0,0.0
108102401.0,17,5,1005,5,1005,27025600.25,201.0,201.0,0,0,0.0,0.0,0.0
52207.0,6,14,4740,7,653,7808.166666666667,249.0,93.28571428571428,7,4087,8570.5,1514.0,583.8571428571429
1302604.0,6,4,264,2,132,0.0,66.0,66.0,2,132,0.0,66.0,66.0
120666114.0,6,35,2473,18,1348,7098006.705882353,139.0,74.88888888888889,17,1125,7416499.25,123.0,66.17647058823529
121305.0,6,3,337,2,214,0.0,160.0,107.0,1,123,0.0,123.0,123.0
90280900.0,6,25,1924,14,1084,6941246.846153846,95.0,77.42857142857143,11,840,8954475.9,95.0,76.36363636363636
107962383.0,6,35,2542,18,1348,6338041.823529412,139.0,74.88888888888889,17,1194,6734167.8125,123.0,70.23529411764706
3010654.0,17,2,762,2,762,0.0,381.0,381.0,0,0,0.0,0.0,0.0
7535.0,17,4,344,2,150,0.0,75.0,75.0,2,194,0.0,103.0,97.0
615829.0,17,3,551,2,156,0.0,78.0,78.0,1,395,0.0,395.0,395.0
135132594.0,17,6,1206,6,1206,27026518.8,201.0,201.0,0,0,0.0,0.0,0.0
135145610.0,17,6,1206,6,1206,27029122.0,201.0,201.0,0,0,0.0,0.0,0.0
2309.0,17,4,344,2,150,0.0,75.0,75.0,2,194,0.0,103.0,97.0
52746.0,6,14,4740,7,653,8612.5,249.0,93.28571428571428,7,4087,8620.333333333334,1514.0,583.8571428571429
90259693.0,6,12,1832,8,1016,12894241.857142856,188.0,127.0,4,816,30030560.0,204.0,204.0
395866.0,17,2,363,1,75,0.0,75.0,75.0,1,288,0.0,288.0,288.0
184748.0,17,2,180,1,90,0.0,90.0,90.0,1,90,0.0,90.0,90.0
675.0,17,2,762,2,762,0.0,381.0,381.0,0,0,0.0,0.0,0.0
2520837.0,6,25,7573,14,3735,193910.53846153847,1514.0,266.7857142857143,11,3838,225784.7,1514.0,348.90909090909093
47149.0,6,14,4740,7,653,7734.166666666667,249.0,93.28571428571428,7,4087,7657.666666666667,1514.0,583.8571428571429
121332.0,6,3,337,2,214,0.0,160.0,107.0,1,123,0.0,123.0,123.0
237298.0,17,4,6056,4,6056,79099.33333333333,1514.0,1514.0,0,0,0.0,0.0,0.0
303639.0,6,3,202,2,128,0.0,74.0,64.0,1,74,0.0,74.0,74.0
243409.0,6,3,337,2,214,0.0,160.0,107.0,1,123,0.0,123.0,123.0
110637187.0,17,14,864,7,432,18333534.83333333,174.0,61.71428571428572,7,432,18333385.33333333,174.0,61.71428571428572
2210914.0,17,2,876,2,876,0.0,438.0,438.0,0,0,0.0,0.0,0.0
119877743.0,17,34,16284,34,16284,3632658.878787879,501.0,478.9411764705882,0,0,0.0,0.0,0.0
90261129.0,6,12,1832,8,1016,12894447.0,188.0,127.0,4,816,30032410.33333333,204.0,204.0
10519527.0,6,6,412,3,206,5189812.0,74.0,68.66666666666667,3,206,5189742.5,74.0,68.66666666666667
87061.0,6,14,4740,7,653,14384.666666666666,249.0,93.28571428571428,7,4087,13443.833333333334,1514.0,583.8571428571429
312981.0,17,4,1400,4,1400,104327.0,350.0,350.0,0,0,0.0,0.0,0.0
242640.0,6,3,337,2,214,0.0,160.0,107.0,1,123,0.0,123.0,123.0
3654.0,17,4,344,2,150,0.0,75.0,75.0,2,194,0.0,103.0,97.0
1758885.0,17,3,1026,3,1026,879442.5,342.0,342.0,0,0,0.0,0.0,0.0
179730.0,17,2,180,1,90,0.0,90.0,90.0,1,90,0.0,90.0,90.0
2444.0,17,4,344,2,150,0.0,75.0,75.0,2,194,0.0,103.0,97.0
216855.0,6,3,426,2,280,0.0,214.0,140.0,1,146,0.0,146.0,146.0
87172.0,6,10,2032,5,524,20852.25,252.0,104.8,5,1508,10185.75,1236.0,301.6
216387.0,17,2,180,1,90,0.0,90.0,90.0,1,90,0.0,90.0,90.0
4401.0,17,2,614,1,72,0.0,72.0,72.0,1,542,0.0,542.0,542.0
20372.0,17,2,582,1,83,0.0,83.0,83.0,1,499,0.0,499.0,499.0
103614.0,17,2,286,2,286,0.0,143.0,143.0,0,0,0.0,0.0,0.0
5743321.0,6,5,336,2,134,0.0,68.0,67.0,3,202,1526902.0,70.0,67.33333333333333
103500.0,17,2,286,2,286,0.0,143.0,143.0,0,0,0.0,0.0,0.0
67621.0,6,14,4740,7,653,10277.666666666666,249.0,93.28571428571428,7,4087,10931.166666666666,1514.0,583.8571428571429
48454.0,6,10,2032,5,524,11821.75,252.0,104.8,5,1508,10662.5,1236.0,301.6
205793.0,17,2,180,1,90,0.0,90.0,90.0,1,90,0.0,90.0,90.0
20591.0,6,10,2032,5,524,4500.5,252.0,104.8,5,1508,4450.5,1236.0,301.6
17290.0,6,10,2032,5,524,3691.5,252.0,104.8,5,1508,3713.25,1236.0,301.6
317.0,17,2,174,1,79,0.0,79.0,79.0,1,95,0.0,95.0,95.0
2328.0,17,4,344,2,150,0.0,75.0,75.0,2,194,0.0,103.0,97.0
819.0,17,5,550,5,550,204.75,110.0,110.0,0,0,0.0,0.0,0.0
147263.0,6,3,373,2,238,0.0,172.0,119.0,1,135,0.0,135.0,135.0
291520.0,17,2,246,1,76,0.0,76.0,76.0,1,170,0.0,170.0,170.0
1475.0,17,2,166,1,75,0.0,75.0,75.0,1,91,0.0,91.0,91.0
135138139.0,17,6,1146,6,1146,27027627.8,191.0,191.0,0,0,0.0,0.0,0.0
104341.0,17,2,286,2,286,0.0,143.0,143.0,0,0,0.0,0.0,0.0
921.0,17,5,550,5,550,230.25,110.0,110.0,0,0,0.0,0.0,0.0
870095.0,6,9,1270,6,799,174019.0,461.0,133.16666666666666,3,471,297219.0,331.0,157.0
38511.0,6,14,4740,7,653,6137.0,249.0,93.28571428571428,7,4087,6280.833333333333,1514.0,583.8571428571429
36900.0,6,10,2032,5,524,6882.25,252.0,104.8,5,1508,8650.25,1236.0,301.6
2455.0,17,4,344,2,150,0.0,75.0,75.0,2,194,0.0,103.0,97.0
38268.0,6,14,4740,7,653,5917.5,249.0,93.28571428571428,7,4087,5077.666666666667,1514.0,583.8571428571429
15359892.0,6,6,444,1,74,0.0,74.0,74.0,5,370,3761956.5,74.0,74.0
848.0,17,4,438,2,148,0.0,74.0,74.0,2,290,0.0,147.0,145.0
120067291.0,17,28,13364,28,13364,4446936.703703703,501.0,477.2857142857143,0,0,0.0,0.0,0.0
2389.0,17,4,344,2,150,0.0,75.0,75.0,2,194,0.0,103.0,97.0
120039034.0,6,23,1734,12,935,10909075.818181818,95.0,77.91666666666667,11,799,11975811.6,95.0,72.63636363636364
1309124.0,6,4,264,2,132,0.0,66.0,66.0,2,132,0.0,66.0,66.0
767142.0,6,5,367,2,132,0.0,66.0,66.0,3,235,383571.0,103.0,78.33333333333333
45017671.0,17,9,3086,8,2736,5137470.0,342.0,342.0,1,350,0.0,350.0,350.0
197089.0,17,2,180,1,90,0.0,90.0,90.0,1,90,0.0,90.0,90.0
47875.0,6,10,2032,5,524,11761.0,252.0,104.8,5,1508,11087.75,1236.0,301.6
24543.0,6,10,2032,5,524,3904.25,252.0,104.8,5,1508,4432.0,1236.0,301.6
1306946.0,6,4,264,2,132,0.0,66.0,66.0,2,132,0.0,66.0,66.0
157787.0,17,2,180,1,90,0.0,90.0,90.0,1,90,0.0,90.0,90.0
302.0,17,2,156,1,78,0.0,78.0,78.0,1,78,0.0,78.0,78.0
90278366.0,6,16,1192,8,596,12891223.714285716,95.0,74.5,8,596,12895568.285714284,95.0,74.5
418.0,17,2,164,1,82,0.0,82.0,82.0,1,82,0.0,82.0,82.0
90076867.0,17,28,13364,28,13364,3336180.25925926,501.0,477.2857142857143,0,0,0.0,0.0,0.0
120415420.0,6,47,3102,23,1518,5143994.409090909,66.0,66.0,24,1584,5235442.434782608,66.0,66.0
18682811.0,6,26,7627,14,3735,193983.0,1514.0,266.7857142857143,12,3892,1679829.4545454546,1514.0,324.3333333333333
115603585.0,6,48,3168,24,1584,5026242.826086956,66.0,66.0,24,1584,5012826.304347826,66.0,66.0
2799679.0,6,2,132,1,66,0.0,66.0,66.0,1,66,0.0,66.0,66.0
837.0,17,4,438,2,148,0.0,74.0,74.0,2,290,0.0,147.0,145.0
41870.0,6,10,2032,5,524,9101.0,252.0,104.8,5,1508,8401.0,1236.0,301.6
28126863.0,17,5,1718,4,1368,1656662.3333333333,342.0,342.0,1,350,0.0,350.0,350.0
91705035.0,6,25,1924,14,1084,7050429.846153846,95.0,77.42857142857143,11,840,9095515.9,95.0,76.36363636363636
45246.0,6,14,4740,7,653,6267.0,249.0,93.28571428571428,7,4087,7231.666666666667,1514.0,583.8571428571429
1302568.0,6,4,264,2,132,0.0,66.0,66.0,2,132,0.0,66.0,66.0
201712.0,6,10,1221,6,636,40342.4,298.0,106.0,4,585,66236.66666666667,379.0,146.25
1312934.0,6,4,264,2,132,0.0,66.0,66.0,2,132,0.0,66.0,66.0
409822.0,6,3,204,2,136,0.0,70.0,68.0,1,68,0.0,68.0,68.0
97956.0,17,2,762,2,762,0.0,381.0,381.0,0,0,0.0,0.0,0.0
90299602.0,6,16,1192,8,596,12893990.0,95.0,74.5,8,596,12899299.857142856,95.0,74.5
2002.0,17,4,344,2,150,0.0,75.0,75.0,2,194,0.0,103.0,97.0
2842.0,17,2,762,2,762,0.0,381.0,381.0,0,0,0.0,0.0,0.0
14170.0,6,14,4740,7,653,2185.1666666666665,249.0,93.28571428571428,7,4087,2220.1666666666665,1514.0,583.8571428571429
344841.0,17,2,180,1,90,0.0,90.0,90.0,1,90,0.0,90.0,90.0
63210.0,6,14,4740,7,653,9493.833333333334,249.0,93.28571428571428,7,4087,10386.5,1514.0,583.8571428571429
306452.0,6,6,412,4,272,102150.66666666669,74.0,68.0,2,140,0.0,74.0,70.0
5625404.0,6,5,336,2,134,0.0,68.0,67.0,3,202,1422808.5,70.0,67.33333333333333
859736.0,6,9,1269,6,798,171947.2,460.0,133.0,3,471,292033.0,331.0,157.0
0.0,6,1,54,0,0,0.0,0.0,0.0,1,54,0.0,54.0,54.0
171608.0,17,2,180,1,90,0.0,90.0,90.0,1,90,0.0,90.0,90.0
9574.0,17,2,582,1,83,0.0,83.0,83.0,1,499,0.0,499.0,499.0
210096.0,6,10,1221,6,636,42019.2,298.0,106.0,4,585,68719.66666666667,379.0,146.25
2471146.0,6,3,1604,1,753,0.0,753.0,753.0,2,851,0.0,785.0,425.5
2038.0,17,4,344,2,150,0.0,75.0,75.0,2,194,0.0,103.0,97.0
205742.0,17,2,180,1,90,0.0,90.0,90.0,1,90,0.0,90.0,90.0
323052.0,17,4,1400,4,1400,107684.0,350.0,350.0,0,0,0.0,0.0,0.0
300674.0,6,6,412,4,272,100224.66666666669,74.0,68.0,2,140,0.0,74.0,70.0
168123.0,17,2,414,1,88,0.0,88.0,88.0,1,326,0.0,326.0,326.0
119905558.0,6,15,2168,6,1086,23980914.4,204.0,181.0,9,1082,14987701.25,188.0,120.22222222222224
205738.0,17,2,180,1,90,0.0,90.0,90.0,1,90,0.0,90.0,90.0
259847.0,6,10,1221,6,636,51969.4,298.0,106.0,4,585,81068.33333333333,379.0,146.25
90915355.0,6,21,1585,11,840,9091034.0,95.0,76.36363636363636,10,745,10101077.111111112,95.0,74.5
148003.0,17,2,180,1,90,0.0,90.0,90.0,1,90,0.0,90.0,90.0
119860478.0,17,35,16705,35,16705,3525308.1764705884,501.0,477.2857142857143,0,0,0.0,0.0,0.0
645652.0,6,3,198,2,132,0.0,66.0,66.0,1,66,0.0,66.0,66.0
36677.0,6,14,4740,7,653,5444.333333333333,249.0,93.28571428571428,7,4087,5831.166666666667,1514.0,583.8571428571429
90672477.0,6,22,1680,10,745,10047238.0,95.0,74.5,12,935,8223270.363636363,95.0,77.91666666666667
109228461.0,6,181,20526,91,6228,1213649.566666667,140.0,68.43956043956044,90,14298,1224915.202247191,284.0,158.86666666666667
68195.0,6,14,4740,7,653,11240.833333333334,249.0,93.28571428571428,7,4087,11086.333333333334,1514.0,583.8571428571429
121655104.0,6,25,1924,12,935,11059554.909090908,95.0,77.91666666666667,13,989,7617162.0,95.0,76.07692307692308
1209047.0,6,13,3000,8,2372,172721.0,1514.0,296.5,5,628,233311.25,331.0,125.6
90295135.0,6,24,1829,13,989,7520618.0,95.0,76.07692307692308,11,840,9001710.1,95.0,76.36363636363636
2285.0,17,4,344,2,150,0.0,75.0,75.0,2,194,0.0,103.0,97.0
228214.0,17,2,180,1,90,0.0,90.0,90.0,1,90,0.0,90.0,90.0
14583.0,6,10,2032,5,524,2939.0,252.0,104.8,5,1508,3064.5,1236.0,301.6
90374229.0,6,11,1644,7,828,15062371.5,188.0,118.28571428571428,4,816,20114353.666666668,204.0,204.0
850502.0,6,9,1268,6,797,170100.4,459.0,132.83333333333334,3,471,287570.0,331.0,157.0
90261147.0,6,12,1832,8,1016,12894449.57142857,188.0,127.0,4,816,30032323.33333333,204.0,204.0
49607.0,6,14,4740,7,653,8102.5,249.0,93.28571428571428,7,4087,7958.5,1514.0,583.8571428571429
108109577.0,17,5,955,5,955,27027394.25,191.0,191.0,0,0,0.0,0.0,0.0
29234.0,6,10,2032,5,524,7071.5,252.0,104.8,5,1508,5883.25,1236.0,301.6
135131077.0,17,6,1146,6,1146,27026215.4,191.0,191.0,0,0,0.0,0.0,0.0
328.0,17,2,166,1,75,0.0,75.0,75.0,1,91,0.0,91.0,91.0
233830.0,6,3,373,2,238,0.0,172.0,119.0,1,135,0.0,135.0,135.0
216664.0,6,3,426,2,280,0.0,214.0,140.0,1,146,0.0,146.0,146.0
2430.0,17,4,344,2,150,0.0,75.0,75.0,2,194,0.0,103.0,97.0
0.0,6,1,214,1,214,0.0,214.0,214.0,0,0,0.0,0.0,0.0
232964.0,6,3,337,2,214,0.0,160.0,107.0,1,123,0.0,123.0,123.0
101007670.0,17,13,821,7,432,16834611.666666668,174.0,61.71428571428572,6,389,16200183.2,174.0,64.83333333333333
19977.0,17,2,582,1,83,0.0,83.0,83.0,1,499,0.0,499.0,499.0
10909.0,6,10,1067,5,536,2563.75,264.0,107.2,5,531,2336.5,259.0,106.2
120572065.0,17,14,1126,7,563,16833512.5,174.0,80.42857142857143,7,563,16835295.833333332,174.0,80.42857142857143
2360.0,17,4,344,2,150,0.0,75.0,75.0,2,194,0.0,103.0,97.0
1182549.0,6,11,1134,6,558,236509.8,220.0,93.0,5,576,294130.5,304.0,115.2
274273.0,6,10,1221,6,636,54854.6,298.0,106.0,4,585,90560.0,379.0,146.25
911356.0,6,12,2710,7,743,151892.66666666666,339.0,106.14285714285714,5,1967,158949.75,1514.0,393.4
239153.0,17,2,180,1,90,0.0,90.0,90.0,1,90,0.0,90.0,90.0
1771100.0,6,2,132,1,66,0.0,66.0,66.0,1,66,0.0,66.0,66.0
2900046.0,6,2,132,1,66,0.0,66.0,66.0,1,66,0.0,66.0,66.0
106839079.0,6,28,1860,14,966,8201785.230769231,123.0,69.0,14,894,8201783.0,123.0,63.85714285714285
2443.0,17,2,762,2,762,0.0,381.0,381.0,0,0,0.0,0.0,0.0
123391332.0,6,31,2034,16,1086,8226088.8,123.0,67.875,15,948,8085029.285714285,123.0,63.2
228415.0,17,2,180,1,90,0.0,90.0,90.0,1,90,0.0,90.0,90.0
212768.0,6,3,426,2,280,0.0,214.0,140.0,1,146,0.0,146.0,146.0
105723537.0,6,30,2043,15,1017,7551681.214285715,123.0,67.8,15,1026,7536107.714285715,123.0,68.4
37357.0,6,10,2032,5,524,9115.0,252.0,104.8,5,1508,8997.0,1236.0,301.6
120350303.0,6,243,27444,122,19162,994630.6033057852,284.0,157.0655737704918,121,8282,968426.8916666668,140.0,68.44628099173553
91075915.0,6,168,19106,84,13340,1094705.9879518072,300.0,158.8095238095238,84,5766,1094705.939759036,140.0,68.64285714285714
14641763.0,6,19,1553,9,921,1791940.0,315.0,102.33333333333331,10,632,1592805.888888889,78.0,63.2
15922931.0,17,6,2052,6,2052,3184586.2,342.0,342.0,0,0,0.0,0.0,0.0
4050261.0,6,203,168809,116,158765,35219.66086956522,1510.0,1368.6637931034484,87,10044,42665.895348837206,1510.0,115.44827586206895
51189.0,17,2,180,1,90,0.0,90.0,90.0,1,90,0.0,90.0,90.0
104208606.0,17,14,864,7,432,17168511.333333332,174.0,61.71428571428572,7,432,17166872.166666668,174.0,61.71428571428572
26586.0,6,14,4740,7,653,4037.0,249.0,93.28571428571428,7,4087,4214.5,1514.0,583.8571428571429
23153875.0,17,3,1034,2,684,0.0,342.0,342.0,1,350,0.0,350.0,350.0
90258792.0,6,16,2368,9,1204,11282349.0,188.0,133.77777777777777,7,1164,15015788.0,204.0,166.28571428571428
90336672.0,6,16,1192,8,596,12894800.714285716,95.0,74.5,8,596,12904026.142857144,95.0,74.5
210813.0,17,2,414,1,88,0.0,88.0,88.0,1,326,0.0,326.0,326.0
120119733.0,6,15,2444,8,1016,17136665.85714286,188.0,127.0,7,1428,15015509.0,204.0,204.0
23130596.0,17,3,1034,2,684,0.0,342.0,342.0,1,350,0.0,350.0,350.0
206912.0,6,3,426,2,280,0.0,214.0,140.0,1,146,0.0,146.0,146.0
219756.0,6,3,198,2,132,0.0,66.0,66.0,1,66,0.0,66.0,66.0
90232922.0,6,24,1829,11,840,8997682.4,95.0,76.36363636363636,13,989,7501399.666666667,95.0,76.07692307692308
4885.0,17,2,180,1,90,0.0,90.0,90.0,1,90,0.0,90.0,90.0
47617048.0,6,8,2113,3,960,22463760.0,826.0,320.0,5,1153,11464811.5,885.0,230.6
124001382.0,17,15,907,8,475,17714483.14285714,174.0,59.375,7,432,17334287.666666668,174.0,61.71428571428572
2594117.0,6,2,132,1,66,0.0,66.0,66.0,1,66,0.0,66.0,66.0
108112519.0,17,5,955,5,955,27028129.75,191.0,191.0,0,0,0.0,0.0,0.0
236914.0,6,3,337,2,214,0.0,160.0,107.0,1,123,0.0,123.0,123.0
91247763.0,6,25,1924,14,1084,7014302.846153846,95.0,77.42857142857143,11,840,9095706.4,95.0,76.36363636363636
162415.0,17,2,180,1,90,0.0,90.0,90.0,1,90,0.0,90.0,90.0
313597.0,6,3,1604,2,851,0.0,785.0,425.5,1,753,0.0,753.0,753.0
144826.0,17,2,180,1,70,0.0,70.0,70.0,1,110,0.0,110.0,110.0
118714434.0,6,400,49078,200,35582,595473.9547738694,284.0,177.91,200,13496,595473.2562814071,140.0,67.48
2328.0,17,4,344,2,150,0.0,75.0,75.0,2,194,0.0,103.0,97.0
2356.0,17,4,344,2,150,0.0,75.0,75.0,2,194,0.0,103.0,97.0
228321.0,17,2,180,1,90,0.0,90.0,90.0,1,90,0.0,90.0,90.0
214188.0,17,2,180,1,90,0.0,90.0,90.0,1,90,0.0,90.0,90.0
317896.0,17,4,1400,4,1400,105965.33333333331,350.0,350.0,0,0,0.0,0.0,0.0
90179987.0,17,12,778,6,389,18000965.6,174.0,64.83333333333333,6,389,18000209.8,174.0,64.83333333333333
251971.0,17,4,6056,4,6056,83990.33333333333,1514.0,1514.0,0,0,0.0,0.0,0.0
90064195.0,17,28,13364,28,13364,3335710.925925926,501.0,477.2857142857143,0,0,0.0,0.0,0.0
239825.0,6,10,1221,6,636,47965.0,298.0,106.0,4,585,79013.66666666667,379.0,146.25
317332.0,17,4,1400,4,1400,105777.33333333331,350.0,350.0,0,0,0.0,0.0,0.0
90548164.0,6,14,2240,8,1016,12935452.0,188.0,127.0,6,1224,18077410.2,204.0,204.0
105753494.0,6,44,2904,22,1452,5035880.666666667,66.0,66.0,22,1452,5025589.047619048,66.0,66.0
2758277.0,6,25,7573,14,3735,212175.15384615384,1514.0,266.7857142857143,11,3838,245918.5,1514.0,348.90909090909093
120423878.0,6,213,24024,107,16732,1136074.3207547169,284.0,156.37383177570092,106,7292,1136981.0380952382,140.0,68.79245283018868
5005103.0,17,4,849,2,166,0.0,83.0,83.0,2,683,0.0,499.0,341.5
34664.0,6,11,2098,6,590,6768.2,252.0,98.33333333333331,5,1508,8216.5,1236.0,301.6
103316.0,6,2,132,1,66,0.0,66.0,66.0,1,66,0.0,66.0,66.0
47486.0,6,14,4740,7,653,7411.333333333333,249.0,93.28571428571428,7,4087,6965.666666666667,1514.0,583.8571428571429
90257461.0,6,13,2036,8,1016,12893923.0,188.0,127.0,5,1020,22523282.25,204.0,204.0
37300.0,6,14,4740,7,653,6037.5,249.0,93.28571428571428,7,4087,6025.5,1514.0,583.8571428571429
44556.0,6,10,2032,5,524,10912.0,252.0,104.8,5,1508,8494.5,1236.0,301.6
135126222.0,17,6,1146,6,1146,27025244.4,191.0,191.0,0,0,0.0,0.0,0.0
9470.0,17,2,582,1,83,0.0,83.0,83.0,1,499,0.0,499.0,499.0
100804768.0,17,12,778,6,389,20042802.0,174.0,64.83333333333333,6,389,20129171.0,174.0,64.83333333333333
102306343.0,6,232,27438,116,19560,887750.0782608696,284.0,168.6206896551724,116,7878,887750.452173913,140.0,67.91379310344827
100119851.0,17,12,778,6,389,20023970.2,174.0,64.83333333333333,6,389,19954708.2,174.0,64.83333333333333
307.0,17,2,168,1,76,0.0,76.0,76.0,1,92,0.0,92.0,92.0
222087.0,6,3,426,2,280,0.0,214.0,140.0,1,146,0.0,146.0,146.0
4259.0,17,2,598,1,72,0.0,72.0,72.0,1,526,0.0,526.0,526.0
475.0,17,2,166,1,75,0.0,75.0,75.0,1,91,0.0,91.0,91.0
90009806.0,17,28,13364,28,13364,3333696.5185185187,501.0,477.2857142857143,0,0,0.0,0.0,0.0
303204.0,6,2,132,1,66,0.0,66.0,66.0,1,66,0.0,66.0,66.0
107317.0,17,2,286,2,286,0.0,143.0,143.0,0,0,0.0,0.0,0.0
36238.0,6,14,4740,7,653,5917.666666666667,249.0,93.28571428571428,7,4087,5662.166666666667,1514.0,583.8571428571429
2524.0,17,4,344,2,150,0.0,75.0,75.0,2,194,0.0,103.0,97.0
228387.0,17,2,180,1,90,0.0,90.0,90.0,1,90,0.0,90.0,90.0
44689.0,6,10,2032,5,524,8173.25,252.0,104.8,5,1508,10906.75,1236.0,301.6
90287341.0,6,14,1043,7,542,15047890.166666666,95.0,77.42857142857143,7,501,15001006.833333334,95.0,71.57142857142857
29773.0,6,2,145,2,145,0.0,91.0,72.5,0,0,0.0,0.0,0.0
46776.0,6,12,1328,6,731,8658.2,253.0,121.83333333333331,6,597,8516.4,259.0,99.5
22321.0,17,4,823,2,163,0.0,89.0,81.5,2,660,0.0,443.0,330.0
153475.0,17,2,180,1,90,0.0,90.0,90.0,1,90,0.0,90.0,90.0
37951.0,6,10,2032,5,524,9092.0,252.0,104.8,5,1508,8618.0,1236.0,301.6
217981.0,6,3,426,2,280,0.0,214.0,140.0,1,146,0.0,146.0,146.0
135132660.0,17,6,1146,6,1146,27026532.0,191.0,191.0,0,0,0.0,0.0,0.0
205689.0,17,4,1400,4,1400,68563.0,350.0,350.0,0,0,0.0,0.0,0.0
205700.0,17,2,180,1,90,0.0,90.0,90.0,1,90,0.0,90.0,90.0
8466.0,17,4,344,2,150,0.0,75.0,75.0,2,194,0.0,103.0,97.0
101781426.0,6,30,2122,15,1105,7254695.785714285,139.0,73.66666666666667,15,1017,7254660.357142857,123.0,67.8
242386.0,6,3,337,2,214,0.0,160.0,107.0,1,123,0.0,123.0,123.0
132675657.0,6,129,14934,62,5054,2175010.770491803,177.0,81.51612903225806,67,9880,1752115.5606060603,284.0,147.46268656716418
109939.0,6,10,2032,5,524,23551.0,252.0,104.8,5,1508,24305.5,1236.0,301.6
123839955.0,6,49,3234,25,1650,5159998.125,66.0,66.0,24,1584,5057471.391304348,66.0,66.0
108102001.0,17,5,955,5,955,27025500.25,191.0,191.0,0,0,0.0,0.0,0.0
62717.99999999999,6,12,1328,6,731,11783.0,253.0,121.83333333333331,6,597,9945.8,259.0,99.5
144882.0,17,2,180,1,70,0.0,70.0,70.0,1,110,0.0,110.0,110.0
112806491.0,6,48,3168,24,1584,4904630.043478261,66.0,66.0,24,1584,4895233.130434782,66.0,66.0
205835.0,17,2,180,1,90,0.0,90.0,90.0,1,90,0.0,90.0,90.0
912.0,17,5,550,5,550,228.0,110.0,110.0,0,0,0.0,0.0,0.0
120021259.0,17,29,13785,29,13785,4286473.535714285,501.0,475.3448275862069,0,0,0.0,0.0,0.0
2334.0,17,4,344,2,150,0.0,75.0,75.0,2,194,0.0,103.0,97.0
117187192.0,6,35,2542,18,1348,6880658.882352941,139.0,74.88888888888889,17,1194,7310697.625,123.0,70.23529411764706
162232.0,17,2,180,1,90,0.0,90.0,90.0,1,90,0.0,90.0,90.0
112427.0,17,2,286,2,286,0.0,143.0,143.0,0,0,0.0,0.0,0.0
90036431.0,17,28,13364,28,13364,3334682.6296296297,501.0,477.2857142857143,0,0,0.0,0.0,0.0
539944.0,17,6,2100,6,2100,107988.8,350.0,350.0,0,0,0.0,0.0,0.0
120290910.0,6,230,26084,115,7886,1049850.1842105263,140.0,68.57391304347826,115,18198,1048049.9122807018,284.0,158.24347826086955
48409.0,6,12,1320,6,723,7594.8,253.0,120.5,6,597,8459.8,259.0,99.5
135126676.0,17,6,1206,6,1206,27025335.2,201.0,201.0,0,0,0.0,0.0,0.0
28377.0,6,14,4740,7,653,4582.5,249.0,93.28571428571428,7,4087,4322.0,1514.0,583.8571428571429
108101513.0,17,5,1005,5,1005,27025378.25,201.0,201.0,0,0,0.0,0.0,0.0
106971.0,17,2,700,2,700,0.0,350.0,350.0,0,0,0.0,0.0,0.0
5625028.0,6,5,336,2,134,0.0,68.0,67.0,3,202,1421261.5,70.0,67.33333333333333
39691.0,6,10,2032,5,524,9425.25,252.0,104.8,5,1508,8236.0,1236.0,301.6
93680100.0,6,25,1702,13,840,7806675.0,123.0,64.61538461538461,12,862,7590080.090909091,139.0,71.83333333333333
329.0,17,2,248,1,84,0.0,84.0,84.0,1,164,0.0,164.0,164.0
43754.0,6,14,4740,7,653,6950.333333333333,249.0,93.28571428571428,7,4087,6899.5,1514.0,583.8571428571429
108105461.0,17,5,1005,5,1005,27026365.25,201.0,201.0,0,0,0.0,0.0,0.0
226155.0,6,10,1221,6,636,45231.0,298.0,106.0,4,585,74466.33333333333,379.0,146.25
25881.0,17,4,823,2,163,0.0,89.0,81.5,2,660,0.0,443.0,330.0
493625.0,17,4,820,2,156,0.0,78.0,78.0,2,664,0.0,332.0,332.0
232908.0,6,3,337,2,214,0.0,160.0,107.0,1,123,0.0,123.0,123.0
108101983.0,17,5,955,5,955,27025495.75,191.0,191.0,0,0,0.0,0.0,0.0
49645.0,6,14,4740,7,653,8070.0,249.0,93.28571428571428,7,4087,7929.166666666667,1514.0,583.8571428571429
284933.0,17,4,1524,4,1524,94977.66666666669,381.0,381.0,0,0,0.0,0.0,0.0
103488277.0,17,14,1126,7,563,17166855.5,174.0,80.42857142857143,7,563,17167560.333333332,174.0,80.42857142857143
2053.0,17,4,344,2,150,0.0,75.0,75.0,2,194,0.0,103.0,97.0
90051514.0,17,28,13364,28,13364,3335241.25925926,501.0,477.2857142857143,0,0,0.0,0.0,0.0
56447.0,6,12,1320,6,723,9617.2,253.0,120.5,6,597,10706.8,259.0,99.5
197589.0,17,2,180,1,90,0.0,90.0,90.0,1,90,0.0,90.0,90.0
119769239.0,6,35,2473,18,1248,7045223.352941177,123.0,69.33333333333333,17,1225,7485494.1875,139.0,72.05882352941177
77403.0,6,14,4740,7,653,12669.5,249.0,93.28571428571428,7,4087,9769.0,1514.0,583.8571428571429
311.0,17,2,174,1,79,0.0,79.0,79.0,1,95,0.0,95.0,95.0
93744365.0,6,40,2640,20,1320,4933913.947368421,66.0,66.0,20,1320,4917364.105263158,66.0,66.0
2426.0,17,4,344,2,150,0.0,75.0,75.0,2,194,0.0,103.0,97.0
726103.0,6,11,1021,6,444,99231.6,162.0,74.0,5,577,123799.5,349.0,115.4
147310.0,6,3,373,2,238,0.0,172.0,119.0,1,135,0.0,135.0,135.0
33663.0,6,10,2032,5,524,7639.0,252.0,104.8,5,1508,7840.0,1236.0,301.6
108103588.0,17,5,1005,5,1005,27025897.0,201.0,201.0,0,0,0.0,0.0,0.0
143921.0,17,2,180,1,90,0.0,90.0,90.0,1,90,0.0,90.0,90.0
40503.0,6,10,2032,5,524,9858.0,252.0,104.8,5,1508,9877.25,1236.0,301.6
347.0,17,2,267,1,83,0.0,83.0,83.0,1,184,0.0,184.0,184.0
418617.0,17,2,363,1,75,0.0,75.0,75.0,1,288,0.0,288.0,288.0
90282711.0,6,14,1043,7,542,15047118.5,95.0,77.42857142857143,7,501,14999505.166666666,95.0,71.57142857142857
1168342.0,6,13,3012,8,2384,166906.0,1514.0,298.0,5,628,223149.75,331.0,125.6
120533.0,6,3,337,2,214,0.0,160.0,107.0,1,123,0.0,123.0,123.0
3006101.0,6,11,2106,6,598,600826.8,252.0,99.66666666666669,5,1508,2196.25,1236.0,301.6
219801.0,6,3,426,2,280,0.0,214.0,140.0,1,146,0.0,146.0,146.0
30955872.0,17,8,1371,4,306,10318519.666666666,89.0,76.5,4,1065,10267817.0,443.0,266.25
90280154.0,6,16,1192,8,596,12891280.714285716,95.0,74.5,8,596,12895675.57142857,95.0,74.5
144905.0,17,2,180,1,70,0.0,70.0,70.0,1,110,0.0,110.0,110.0
305784.0,6,6,412,4,272,101928.0,74.0,68.0,2,140,0.0,74.0,70.0
108108589.0,17,5,955,5,955,27027147.25,191.0,191.0,0,0,0.0,0.0,0.0
108112844.0,17,5,1005,5,1005,27028211.0,201.0,201.0,0,0,0.0,0.0,0.0
107563.0,17,2,286,2,286,0.0,143.0,143.0,0,0,0.0,0.0,0.0
72054.0,6,14,4740,7,653,11686.5,249.0,93.28571428571428,7,4087,11269.0,1514.0,583.8571428571429
121412.0,6,3,337,2,214,0.0,160.0,107.0,1,123,0.0,123.0,123.0
146257.0,6,3,337,2,214,0.0,160.0,107.0,1,123,0.0,123.0,123.0
146121.0,6,3,337,2,214,0.0,160.0,107.0,1,123,0.0,123.0,123.0
90749558.0,6,19,1436,10,745,10078179.777777778,95.0,74.5,9,691,11342352.625,95.0,76.77777777777777
104108.0,17,2,286,2,286,0.0,143.0,143.0,0,0,0.0,0.0,0.0
1314486.0,17,7,490,7,490,219081.0,70.0,70.0,0,0,0.0,0.0,0.0
320.0,17,2,174,1,79,0.0,79.0,79.0,1,95,0.0,95.0,95.0
2021923.0,17,4,525,2,150,0.0,75.0,75.0,2,375,0.0,284.0,187.5
90256858.0,6,12,1832,8,1016,12893836.857142856,188.0,127.0,4,816,30029866.0,204.0,204.0
10524368.0,6,7,478,4,272,3462398.6666666665,74.0,68.0,3,206,5193493.5,74.0,68.66666666666667
90042580.0,17,28,13364,28,13364,3334910.3703703703,501.0,477.2857142857143,0,0,0.0,0.0,0.0
98940706.0,6,195,22026,98,6690,1020007.2783505154,140.0,68.26530612244898,97,15336,1019873.1041666666,284.0,158.10309278350516
120116639.0,6,14,2224,9,1204,15014579.875,188.0,133.77777777777777,5,1020,22522251.25,204.0,204.0
20081.0,6,10,1067,5,536,4206.25,264.0,107.2,5,531,4045.0,259.0,106.2
105316.0,17,2,286,2,286,0.0,143.0,143.0,0,0,0.0,0.0,0.0
330.0,17,2,160,1,80,0.0,80.0,80.0,1,80,0.0,80.0,80.0
108100691.0,17,5,955,5,955,27025172.75,191.0,191.0,0,0,0.0,0.0,0.0
15076.0,17,2,180,1,90,0.0,90.0,90.0,1,90,0.0,90.0,90.0
44974.0,6,11,2098,6,590,8909.8,252.0,98.33333333333331,5,1508,9675.0,1236.0,301.6
2847476.0,6,4,270,3,202,1423738.0,70.0,67.33333333333333,1,68,0.0,68.0,68.0
307732.0,6,6,412,4,272,102577.33333333331,74.0,68.0,2,140,0.0,74.0,70.0
89786.0,6,15,4806,8,719,11774.714285714286,249.0,89.875,7,4087,14825.666666666666,1514.0,583.8571428571429
144314.0,17,2,180,1,90,0.0,90.0,90.0,1,90,0.0,90.0,90.0
2871404.0,6,3,204,2,134,0.0,68.0,67.0,1,70,0.0,70.0,70.0
2777.0,17,2,224,1,76,0.0,76.0,76.0,1,148,0.0,148.0,148.0
36893.0,6,14,4740,7,653,5092.0,249.0,93.28571428571428,7,4087,6013.833333333333,1514.0,583.8571428571429
42418.0,6,14,4740,7,653,6536.833333333333,249.0,93.28571428571428,7,4087,6249.5,1514.0,583.8571428571429
304747.0,6,6,412,4,272,101582.33333333331,74.0,68.0,2,140,0.0,74.0,70.0
6867.0,17,2,565,1,93,0.0,93.0,93.0,1,472,0.0,472.0,472.0
110196065.0,17,16,1474,8,737,15719423.57142857,174.0,92.125,8,737,15719424.57142857,174.0,92.125
99159576.0,6,678,124616,337,22686,295059.3154761905,214.0,67.31750741839762,341,101930,291621.8676470588,1514.0,298.9149560117302
120124872.0,6,15,2444,7,1428,20020812.0,204.0,204.0,8,1016,17098213.0,188.0,127.0
105949.0,17,2,286,2,286,0.0,143.0,143.0,0,0,0.0,0.0,0.0
216719.0,6,3,426,2,280,0.0,214.0,140.0,1,146,0.0,146.0,146.0
27202.0,6,10,2032,5,524,4915.75,252.0,104.8,5,1508,6060.0,1236.0,301.6
117422856.0,6,32,2220,16,1149,7828190.4,123.0,71.8125,16,1071,7813784.6,123.0,66.9375
281098.0,17,2,363,1,79,0.0,79.0,79.0,1,284,0.0,284.0,284.0
91713071.0,17,15,5130,15,5130,6550933.642857143,342.0,342.0,0,0,0.0,0.0,0.0
1995.0,17,4,344,2,150,0.0,75.0,75.0,2,194,0.0,103.0,97.0
297724.0,6,6,412,4,272,99241.33333333331,74.0,68.0,2,140,0.0,74.0,70.0
248138.0,6,3,337,2,214,0.0,160.0,107.0,1,123,0.0,123.0,123.0
32918.0,6,10,2032,5,524,7424.0,252.0,104.8,5,1508,7843.5,1236.0,301.6
135132480.0,17,6,1146,6,1146,27026496.0,191.0,191.0,0,0,0.0,0.0,0.0
135141362.0,17,6,1206,6,1206,27028272.4,201.0,201.0,0,0,0.0,0.0,0.0
120001604.0,6,17,1246,9,650,15000200.5,95.0,72.22222222222223,8,596,17107923.42857143,95.0,74.5
90648028.0,6,15,2302,9,1204,11317665.125,188.0,133.77777777777777,6,1098,18096984.0,204.0,183.0
5412889.0,6,6,433,3,235,1241117.5,103.0,78.33333333333333,3,198,1617410.5,66.0,66.0
198666.0,17,2,180,1,90,0.0,90.0,90.0,1,90,0.0,90.0,90.0
31708.0,6,14,4740,7,653,5165.5,249.0,93.28571428571428,7,4087,4644.833333333333,1514.0,583.8571428571429
305368.0,6,6,412,4,272,101789.33333333331,74.0,68.0,2,140,0.0,74.0,70.0
679756.0,17,2,876,2,876,0.0,438.0,438.0,0,0,0.0,0.0,0.0
2138.0,17,2,664,1,322,0.0,322.0,322.0,1,342,0.0,342.0,342.0
232771.0,6,3,337,2,214,0.0,160.0,107.0,1,123,0.0,123.0,123.0
15978.0,6,10,1067,5,536,3648.25,264.0,107.2,5,531,3537.25,259.0,106.2
113857902.0,6,48,3168,24,1584,4950343.565217392,66.0,66.0,24,1584,4936960.739130435,66.0,66.0
233008.0,6,3,337,2,214,0.0,160.0,107.0,1,123,0.0,123.0,123.0
108101239.0,17,5,955,5,955,27025309.75,191.0,191.0,0,0,0.0,0.0,0.0
2364.0,17,4,344,2,150,0.0,75.0,75.0,2,194,0.0,103.0,97.0
1053517.0,6,11,1134,6,558,210703.4,220.0,93.0,5,576,261017.25,304.0,115.2
1971.0,17,4,344,2,150,0.0,75.0,75.0,2,194,0.0,103.0,97.0
332.0,17,2,166,1,75,0.0,75.0,75.0,1,91,0.0,91.0,91.0
61099.0,6,13,1386,7,789,10183.166666666666,253.0,112.71428571428572,6,597,9466.8,259.0,99.5
149783.0,17,4,704,2,148,0.0,74.0,74.0,2,556,0.0,280.0,278.0
228084.0,17,2,180,1,90,0.0,90.0,90.0,1,90,0.0,90.0,90.0
120122935.0,6,13,2020,9,1204,15015366.875,188.0,133.77777777777777,4,816,30029959.33333333,204.0,204.0
135130682.0,17,6,1146,6,1146,27026136.4,191.0,191.0,0,0,0.0,0.0,0.0
153389.0,17,2,180,1,90,0.0,90.0,90.0,1,90,0.0,90.0,90.0
2036.0,17,4,344,2,150,0.0,75.0,75.0,2,194,0.0,103.0,97.0
161123.0,17,2,180,1,90,0.0,90.0,90.0,1,90,0.0,90.0,90.0
59388.0,6,12,1320,7,789,9898.0,253.0,112.71428571428572,5,531,11071.0,259.0,106.2
51836.0,6,14,4740,7,653,8471.833333333334,249.0,93.28571428571428,7,4087,7103.333333333333,1514.0,583.8571428571429
2368.0,17,4,344,2,150,0.0,75.0,75.0,2,194,0.0,103.0,97.0
120406188.0,6,2424,2125336,1667,2075374,71828.40816326531,1514.0,1244.9754049190162,757,49962,159252.7142857143,66.0,66.0
92110302.0,17,14,1126,7,563,15334637.5,174.0,80.42857142857143,7,563,15333470.833333334,174.0,80.42857142857143
20060.0,6,10,2032,5,524,4467.5,252.0,104.8,5,1508,4640.5,1236.0,301.6
135775022.0,17,14,864,7,432,19333495.166666668,174.0,61.71428571428572,7,432,19332948.33333333,174.0,61.71428571428572
135138165.0,17,6,1146,6,1146,27027633.0,191.0,191.0,0,0,0.0,0.0,0.0
95291983.0,17,12,778,6,389,19000155.2,174.0,64.83333333333333,6,389,19000928.8,174.0,64.83333333333333
2835196.0,6,3,1777,1,826,0.0,826.0,826.0,2,951,0.0,885.0,475.5
1306628.0,6,4,264,2,132,0.0,66.0,66.0,2,132,0.0,66.0,66.0
58828464.0,17,9,3086,8,2736,5105378.571428572,342.0,342.0,1,350,0.0,350.0,350.0
2407.0,17,2,762,2,762,0.0,381.0,381.0,0,0,0.0,0.0,0.0
1165545.0,6,13,3010,8,2382,166506.42857142858,1514.0,297.75,5,628,223217.0,331.0,125.6
2792019.0,6,2,132,1,66,0.0,66.0,66.0,1,66,0.0,66.0,66.0
19903.0,6,10,2032,5,524,3491.5,252.0,104.8,5,1508,3813.0,1236.0,301.6
10465132.0,6,7,478,4,272,3441161.0,74.0,68.0,3,206,5161692.5,74.0,68.66666666666667
4229.0,17,2,626,1,72,0.0,72.0,72.0,1,554,0.0,554.0,554.0
5626583.0,6,5,336,2,134,0.0,68.0,67.0,3,202,1424316.0,70.0,67.33333333333333
6789.0,17,2,582,1,83,0.0,83.0,83.0,1,499,0.0,499.0,499.0
145342.0,6,3,337,2,214,0.0,160.0,107.0,1,123,0.0,123.0,123.0
16844.0,6,10,1975,5,467,4004.0,195.0,93.4,5,1508,2002.5,1236.0,301.6
120536.0,17,4,1400,4,1400,40178.66666666666,350.0,350.0,0,0,0.0,0.0,0.0
2762675.0,6,3,1604,2,851,0.0,785.0,425.5,1,753,0.0,753.0,753.0
364.0,17,2,267,1,83,0.0,83.0,83.0,1,184,0.0,184.0,184.0
120901206.0,17,14,864,7,432,16834237.166666668,174.0,61.71428571428572,7,432,19975959.33333333,174.0,61.71428571428572
2416.0,17,4,344,2,150,0.0,75.0,75.0,2,194,0.0,103.0,97.0
14614.0,6,20,7606,11,978,1461.4,310.0,88.9090909090909,9,6628,1539.75,1514.0,736.4444444444445
101159181.0,6,183,20694,92,14466,1111639.3516483516,284.0,157.2391304347826,91,6228,1112472.2666666666,140.0,68.43956043956044
309447.0,6,6,412,4,272,103149.0,74.0,68.0,2,140,0.0,74.0,70.0
931.0,17,5,550,5,550,232.75,110.0,110.0,0,0,0.0,0.0,0.0
298.0,17,2,174,1,79,0.0,79.0,79.0,1,95,0.0,95.0,95.0
308034.0,6,6,412,4,272,102678.0,74.0,68.0,2,140,0.0,74.0,70.0
225224.0,6,3,426,2,280,0.0,214.0,140.0,1,146,0.0,146.0,146.0
946.0,17,5,550,5,550,236.5,110.0,110.0,0,0,0.0,0.0,0.0
302374.0,6,2,132,1,66,0.0,66.0,66.0,1,66,0.0,66.0,66.0
228526.0,17,2,180,1,90,0.0,90.0,90.0,1,90,0.0,90.0,90.0
237406.0,17,2,180,1,90,0.0,90.0,90.0,1,90,0.0,90.0,90.0
305262.0,6,6,412,4,272,101754.0,74.0,68.0,2,140,0.0,74.0,70.0
4833826.0,6,5,336,2,134,0.0,68.0,67.0,3,202,1538114.0,70.0,67.33333333333333
40265.0,6,14,4740,7,653,6049.833333333333,249.0,93.28571428571428,7,4087,6134.333333333333,1514.0,583.8571428571429
62454.0,6,12,1447,6,816,12017.2,291.0,136.0,6,631,10800.6,293.0,105.16666666666669
144065.0,17,2,180,1,90,0.0,90.0,90.0,1,90,0.0,90.0,90.0
94711534.0,6,40,2640,20,1320,4984817.578947368,66.0,66.0,20,1320,4973441.631578947,66.0,66.0
120363873.0,6,233,26372,117,18420,1037619.5948275862,284.0,157.43589743589743,116,7952,1037593.7739130434,140.0,68.55172413793103
120130950.0,6,13,2036,8,1016,17137883.0,188.0,127.0,5,1020,22517094.0,204.0,204.0
157831.0,6,3,337,2,214,0.0,160.0,107.0,1,123,0.0,123.0,123.0
51052.0,6,14,4740,7,653,8341.666666666666,249.0,93.28571428571428,7,4087,7138.833333333333,1514.0,583.8571428571429
9591.0,17,2,571,1,86,0.0,86.0,86.0,1,485,0.0,485.0,485.0
504583.0,6,4,270,2,134,0.0,68.0,67.0,2,136,0.0,70.0,68.0
54005.0,6,10,2032,5,524,8532.0,252.0,104.8,5,1508,9583.75,1236.0,301.6
6484.0,17,4,823,2,163,0.0,89.0,81.5,2,660,0.0,443.0,330.0
36542.0,6,10,2032,5,524,7769.75,252.0,104.8,5,1508,7456.0,1236.0,301.6
217381.0,6,3,426,2,280,0.0,214.0,140.0,1,146,0.0,146.0,146.0
216599.0,6,3,426,2,280,0.0,214.0,140.0,1,146,0.0,146.0,146.0
41230.0,6,14,4740,7,653,6715.666666666667,249.0,93.28571428571428,7,4087,6728.0,1514.0,583.8571428571429
90029548.0,17,28,13364,28,13364,3334427.703703704,501.0,477.2857142857143,0,0,0.0,0.0,0.0
120025759.0,6,25,1924,11,881,12002575.9,95.0,80.0909090909091,14,1043,9210411.615384616,95.0,74.5
47111.0,6,12,1413,6,816,7933.0,291.0,136.0,6,597,7129.8,259.0,99.5
108734391.0,6,34,2466,17,1272,6795899.4375,123.0,74.82352941176471,17,1194,6783085.9375,123.0,70.23529411764706
102593.0,17,2,762,2,762,0.0,381.0,381.0,0,0,0.0,0.0,0.0
90294687.0,6,16,1192,8,596,12892436.714285716,95.0,74.5,8,596,12898258.0,95.0,74.5
4419.0,17,2,602,1,72,0.0,72.0,72.0,1,530,0.0,530.0,530.0
2507.0,17,4,344,2,150,0.0,75.0,75.0,2,194,0.0,103.0,97.0
15784.0,6,10,1067,5,536,3707.0,264.0,107.2,5,531,2097.0,259.0,106.2
215436.0,17,2,180,1,90,0.0,90.0,90.0,1,90,0.0,90.0,90.0
197818.0,17,2,180,1,90,0.0,90.0,90.0,1,90,0.0,90.0,90.0
194554.0,17,4,6056,4,6056,64851.333333333336,1514.0,1514.0,0,0,0.0,0.0,0.0
108275992.0,6,227,26004,114,18312,958194.6194690266,390.0,160.6315789473684,113,7692,957272.4464285716,140.0,68.070796460177
53340.0,6,14,4740,7,653,8646.833333333334,249.0,93.28571428571428,7,4087,7488.5,1514.0,583.8571428571429
120494639.0,6,233,26464,117,18574,1038746.8879310344,300.0,158.75213675213675,116,7890,1038783.5130434782,140.0,68.01724137931035
301690.0,6,6,412,4,272,100563.33333333331,74.0,68.0,2,140,0.0,74.0,70.0
205850.0,17,2,762,2,762,0.0,381.0,381.0,0,0,0.0,0.0,0.0
32681575.000000004,6,5,336,2,134,0.0,68.0,67.0,3,202,14950532.0,70.0,67.33333333333333
320.0,17,2,174,1,79,0.0,79.0,79.0,1,95,0.0,95.0,95.0
300371.0,6,6,412,4,272,100123.66666666669,74.0,68.0,2,140,0.0,74.0,70.0
380523.0,17,2,876,2,876,0.0,438.0,438.0,0,0,0.0,0.0,0.0
310168.0,6,6,412,4,272,103389.33333333331,74.0,68.0,2,140,0.0,74.0,70.0
108749.0,17,2,286,2,286,0.0,143.0,143.0,0,0,0.0,0.0,0.0
242045.0,6,3,337,2,214,0.0,160.0,107.0,1,123,0.0,123.0,123.0
2120119.0,6,63,51481,26,1878,84804.76,208.0,72.23076923076923,37,49603,58798.30555555556,1514.0,1340.6216216216217
307039.0,6,6,412,4,272,102346.33333333331,74.0,68.0,2,140,0.0,74.0,70.0
56191.0,6,14,4740,7,653,9110.333333333334,249.0,93.28571428571428,7,4087,8594.5,1514.0,583.8571428571429
103151.0,17,2,286,2,286,0.0,143.0,143.0,0,0,0.0,0.0,0.0
165873.0,17,2,180,1,90,0.0,90.0,90.0,1,90,0.0,90.0,90.0
22696.0,6,10,2032,5,524,5184.0,252.0,104.8,5,1508,5429.25,1236.0,301.6
35105.0,6,14,4740,7,653,5081.333333333333,249.0,93.28571428571428,7,4087,5710.0,1514.0,583.8571428571429
64923.99999999999,6,14,4740,7,653,10040.166666666666,249.0,93.28571428571428,7,4087,10535.666666666666,1514.0,583.8571428571429
749760.0,6,2,132,1,66,0.0,66.0,66.0,1,66,0.0,66.0,66.0
2419.0,17,4,344,2,150,0.0,75.0,75.0,2,194,0.0,103.0,97.0
40981.0,6,10,2032,5,524,9339.5,252.0,104.8,5,1508,9354.5,1236.0,301.6
120222595.0,6,208,23564,104,7172,1159390.3786407767,140.0,68.96153846153847,104,16392,1160341.6213592233,284.0,157.6153846153846
0.0,17,1,72,1,72,0.0,72.0,72.0,0,0,0.0,0.0,0.0
216543.0,17,2,180,1,90,0.0,90.0,90.0,1,90,0.0,90.0,90.0
58712339.0,17,9,3086,8,2736,5108184.285714285,342.0,342.0,1,350,0.0,350.0,350.0
123930.0,6,4,439,2,238,0.0,172.0,119.0,2,201,0.0,135.0,100.5
843475.0,6,9,1096,6,625,168695.0,287.0,104.16666666666669,3,471,283836.0,331.0,157.0
512791.0,6,5,336,2,134,0.0,68.0,67.0,3,202,192109.0,70.0,67.33333333333333
2130300.0,6,24,7545,13,2516,177525.0,1034.0,193.53846153846155,11,5029,181774.0,1510.0,457.1818181818182
99219.0,17,4,820,2,156,0.0,78.0,78.0,2,664,0.0,332.0,332.0
216763.0,6,3,426,2,280,0.0,214.0,140.0,1,146,0.0,146.0,146.0
111020397.0,6,34,2482,17,1288,6925296.3125,139.0,75.76470588235294,17,1194,6925292.875,123.0,70.23529411764706
106566.0,17,2,286,2,286,0.0,143.0,143.0,0,0,0.0,0.0,0.0
509022.0,6,5,336,2,134,0.0,68.0,67.0,3,202,196561.5,70.0,67.33333333333333
324264.0,6,6,412,4,272,108088.0,74.0,68.0,2,140,0.0,74.0,70.0
1165770.0,6,13,3010,8,2382,166538.57142857142,1514.0,297.75,5,628,222683.25,331.0,125.6
153455.0,17,2,180,1,90,0.0,90.0,90.0,1,90,0.0,90.0,90.0
324782.0,17,4,1400,4,1400,108260.66666666669,350.0,350.0,0,0,0.0,0.0,0.0
223600.0,6,12,1373,7,714,37266.66666666666,298.0,102.0,5,659,55214.75,379.0,131.8
183917.0,6,12,1328,6,731,31794.8,253.0,121.83333333333331,6,597,35997.8,259.0,99.5
3595.0,17,4,344,2,150,0.0,75.0,75.0,2,194,0.0,103.0,97.0
3873.0,17,4,344,2,150,0.0,75.0,75.0,2,194,0.0,103.0,97.0
24115.0,6,10,2032,5,524,5816.5,252.0,104.8,5,1508,5802.75,1236.0,301.6
35446.0,6,2,145,2,145,0.0,91.0,72.5,0,0,0.0,0.0,0.0
343.0,17,2,174,1,79,0.0,79.0,79.0,1,95,0.0,95.0,95.0
311125.0,17,4,1400,4,1400,103708.33333333331,350.0,350.0,0,0,0.0,0.0,0.0
108111994.0,17,5,955,5,955,27027998.5,191.0,191.0,0,0,0.0,0.0,0.0
17262.0,6,14,4740,7,653,2497.6666666666665,249.0,93.28571428571428,7,4087,2473.833333333333,1514.0,583.8571428571429
436353.0,6,11,1021,6,444,58479.4,162.0,74.0,5,577,73015.75,349.0,115.4
293096.0,17,2,246,1,76,0.0,76.0,76.0,1,170,0.0,170.0,170.0
341233.0,6,3,1777,1,826,0.0,826.0,826.0,2,951,0.0,885.0,475.5
234887.0,6,3,373,2,238,0.0,172.0,119.0,1,135,0.0,135.0,135.0
110292951.0,6,714,143458,358,119370,308341.29411764705,1514.0,333.43575418994413,356,24088,310078.2704225352,214.0,67.66292134831461
57230.0,6,14,4740,7,653,9246.666666666666,249.0,93.28571428571428,7,4087,9336.166666666666,1514.0,583.8571428571429
30466.0,6,14,4740,7,653,4562.0,249.0,93.28571428571428,7,4087,4690.833333333333,1514.0,583.8571428571429
148356.0,17,2,180,1,90,0.0,90.0,90.0,1,90,0.0,90.0,90.0
44407.0,6,14,4740,7,653,7272.0,249.0,93.28571428571428,7,4087,7018.0,1514.0,583.8571428571429
107719235.0,6,44,2904,22,1452,5129487.380952381,66.0,66.0,22,1452,5115017.904761905,66.0,66.0
2780642.0,6,2,132,1,66,0.0,66.0,66.0,1,66,0.0,66.0,66.0
90256190.0,6,12,1832,8,1016,12893741.42857143,188.0,127.0,4,816,30030242.33333333,204.0,204.0
2071.0,17,4,344,2,150,0.0,75.0,75.0,2,194,0.0,103.0,97.0
2391.0,17,4,344,2,150,0.0,75.0,75.0,2,194,0.0,103.0,97.0
207267.0,6,3,426,2,280,0.0,214.0,140.0,1,146,0.0,146.0,146.0
105567.0,17,2,286,2,286,0.0,143.0,143.0,0,0,0.0,0.0,0.0
120082204.0,6,31,2182,16,1165,8005480.266666667,139.0,72.8125,15,1017,7848584.642857143,123.0,67.8
39201.0,6,10,2032,5,524,8708.5,252.0,104.8,5,1508,9241.75,1236.0,301.6
95926461.0,6,40,2640,20,1320,5048761.105263158,66.0,66.0,20,1320,5034416.631578947,66.0,66.0
308146.0,6,3,202,2,128,0.0,74.0,64.0,1,74,0.0,74.0,74.0
207206.0,6,3,426,2,280,0.0,214.0,140.0,1,146,0.0,146.0,146.0
209416.0,17,2,180,1,90,0.0,90.0,90.0,1,90,0.0,90.0,90.0
1743.0,17,2,932,1,590,0.0,590.0,590.0,1,342,0.0,342.0,342.0
108115450.0,17,5,1005,5,1005,27028862.5,201.0,201.0,0,0,0.0,0.0,0.0
72063.0,6,14,4740,7,653,11534.333333333334,249.0,93.28571428571428,7,4087,11869.0,1514.0,583.8571428571429
443.0,17,2,166,1,75,0.0,75.0,75.0,1,91,0.0,91.0,91.0
255924.0,6,10,1221,6,636,51184.8,298.0,106.0,4,585,83969.0,379.0,146.25
313370.0,17,4,1400,4,1400,104456.66666666669,350.0,350.0,0,0,0.0,0.0,0.0
238488.0,6,3,337,2,214,0.0,160.0,107.0,1,123,0.0,123.0,123.0
46706.0,6,14,4740,7,653,6910.333333333333,249.0,93.28571428571428,7,4087,5961.0,1514.0,583.8571428571429
106617513.0,17,14,864,7,432,17769585.5,174.0,61.71428571428572,7,432,17731005.333333332,174.0,61.71428571428572
47610385.0,6,8,1940,3,887,22795322.0,753.0,295.6666666666667,5,1053,11258724.75,785.0,210.6
302405.0,6,2,132,1,66,0.0,66.0,66.0,1,66,0.0,66.0,66.0
8078.999999999999,6,10,1975,5,467,1811.75,195.0,93.4,5,1508,1746.5,1236.0,301.6
233000.0,6,3,337,2,214,0.0,160.0,107.0,1,123,0.0,123.0,123.0
92519961.0,17,12,778,6,389,18400987.4,174.0,64.83333333333333,6,389,18200154.2,174.0,64.83333333333333
2353.0,17,4,344,2,150,0.0,75.0,75.0,2,194,0.0,103.0,97.0
1232559.0,17,7,490,7,490,205426.5,70.0,70.0,0,0,0.0,0.0,0.0
119975.0,17,2,180,1,70,0.0,70.0,70.0,1,110,0.0,110.0,110.0
0.0,17,1,381,1,381,0.0,381.0,381.0,0,0,0.0,0.0,0.0
33051.0,6,14,4740,7,653,5380.166666666667,249.0,93.28571428571428,7,4087,5303.166666666667,1514.0,583.8571428571429
47594.0,6,10,2032,5,524,11328.25,252.0,104.8,5,1508,9194.25,1236.0,301.6
30889.0,6,10,2032,5,524,7303.75,252.0,104.8,5,1508,7411.5,1236.0,301.6
265772.0,6,3,337,2,214,0.0,160.0,107.0,1,123,0.0,123.0,123.0
320286.0,17,4,1400,4,1400,106762.0,350.0,350.0,0,0,0.0,0.0,0.0
1025668.0,6,11,1134,6,558,205133.6,220.0,93.0,5,576,255523.25,304.0,115.2
197156.0,17,2,180,1,90,0.0,90.0,90.0,1,90,0.0,90.0,90.0
216351.0,17,2,180,1,90,0.0,90.0,90.0,1,90,0.0,90.0,90.0
102560.0,17,2,762,2,762,0.0,381.0,381.0,0,0,0.0,0.0,0.0
37845.0,6,14,4740,7,653,5849.833333333333,249.0,93.28571428571428,7,4087,5613.333333333333,1514.0,583.8571428571429
1399945.0,17,7,490,7,490,233324.16666666663,70.0,70.0,0,0,0.0,0.0,0.0
143950.0,17,2,180,1,90,0.0,90.0,90.0,1,90,0.0,90.0,90.0
311733.0,6,6,412,4,272,103911.0,74.0,68.0,2,140,0.0,74.0,70.0
120046088.0,17,28,13364,28,13364,4446151.407407408,501.0,477.2857142857143,0,0,0.0,0.0,0.0
45227.0,6,14,4740,7,653,6957.0,249.0,93.28571428571428,7,4087,7325.0,1514.0,583.8571428571429
2467.0,17,4,344,2,150,0.0,75.0,75.0,2,194,0.0,103.0,97.0
239627.0,6,3,373,2,238,0.0,172.0,119.0,1,135,0.0,135.0,135.0
153458.0,17,2,180,1,90,0.0,90.0,90.0,1,90,0.0,90.0,90.0
5948.0,17,4,344,2,150,0.0,75.0,75.0,2,194,0.0,103.0,97.0
108192.0,17,2,286,2,286,0.0,143.0,143.0,0,0,0.0,0.0,0.0
217679.0,6,3,426,2,280,0.0,214.0,140.0,1,146,0.0,146.0,146.0
26530.0,6,14,4740,7,653,4236.5,249.0,93.28571428571428,7,4087,3772.3333333333335,1514.0,583.8571428571429
244752.0,6,3,337,2,214,0.0,160.0,107.0,1,123,0.0,123.0,123.0
423.0,17,2,410,1,78,0.0,78.0,78.0,1,332,0.0,332.0,332.0
90255796.0,6,16,2368,9,1204,11281974.5,188.0,133.77777777777777,7,1164,15014809.5,204.0,166.28571428571428
216602.0,17,2,180,1,90,0.0,90.0,90.0,1,90,0.0,90.0,90.0
311875.0,17,4,1400,4,1400,103958.33333333331,350.0,350.0,0,0,0.0,0.0,0.0
321.0,17,2,166,1,75,0.0,75.0,75.0,1,91,0.0,91.0,91.0
26216.0,17,2,180,1,90,0.0,90.0,90.0,1,90,0.0,90.0,90.0
103702.0,17,2,286,2,286,0.0,143.0,143.0,0,0,0.0,0.0,0.0
249206.0,6,3,337,2,214,0.0,160.0,107.0,1,123,0.0,123.0,123.0
113618016.0,6,46,3036,23,1518,5150437.136363637,66.0,66.0,23,1518,5150437.2727272725,66.0,66.0
197366.0,17,2,180,1,90,0.0,90.0,90.0,1,90,0.0,90.0,90.0
228325.0,17,2,180,1,90,0.0,90.0,90.0,1,90,0.0,90.0,90.0
29190.0,6,10,2032,5,524,6997.25,252.0,104.8,5,1508,7027.75,1236.0,301.6
162038.0,17,4,1524,4,1524,54012.66666666666,381.0,381.0,0,0,0.0,0.0,0.0
90526811.0,6,13,2036,8,1016,12932401.57142857,188.0,127.0,5,1020,22590878.5,204.0,204.0
90073674.0,6,11,1644,7,828,15012279.0,188.0,118.28571428571428,4,816,20021402.0,204.0,204.0
121180.0,6,3,337,2,214,0.0,160.0,107.0,1,123,0.0,123.0,123.0
108102153.0,17,5,1005,5,1005,27025538.25,201.0,201.0,0,0,0.0,0.0,0.0
875447.0,6,10,1333,6,796,175089.4,458.0,132.66666666666666,4,537,199944.0,331.0,134.25
228298.0,17,2,180,1,90,0.0,90.0,90.0,1,90,0.0,90.0,90.0
309.0,17,2,174,1,79,0.0,79.0,79.0,1,95,0.0,95.0,95.0
120008937.0,6,24,1829,13,989,9999830.416666666,95.0,76.07692307692308,11,840,12000430.1,95.0,76.36363636363636
121491658.0,6,838,164170,425,136320,286536.929245283,1514.0,320.7529411764706,413,27850,287330.0655339806,214.0,67.43341404358354
297417.0,6,6,412,4,272,99139.0,74.0,68.0,2,140,0.0,74.0,70.0
1025142.0,6,11,1134,6,558,205028.4,220.0,93.0,5,576,254352.0,304.0,115.2
2394.0,17,4,344,2,150,0.0,75.0,75.0,2,194,0.0,103.0,97.0
217673.0,6,3,426,2,280,0.0,214.0,140.0,1,146,0.0,146.0,146.0
90246505.0,6,14,1964,8,1016,12892357.857142856,188.0,127.0,6,948,18016641.0,204.0,158.0
41120.0,6,14,4740,7,653,6668.333333333333,249.0,93.28571428571428,7,4087,5650.833333333333,1514.0,583.8571428571429
313972.0,17,4,1400,4,1400,104657.33333333331,350.0,350.0,0,0,0.0,0.0,0.0
120012259.0,17,14,864,8,475,17144608.42857143,174.0,59.375,6,389,20000212.6,174.0,64.83333333333333
104674430.0,17,14,864,7,432,17334069.0,174.0,61.71428571428572,7,432,17333500.166666668,174.0,61.71428571428572
166494.0,17,2,180,1,90,0.0,90.0,90.0,1,90,0.0,90.0,90.0
90542518.0,6,14,2240,8,1016,12934645.42857143,188.0,127.0,6,1224,18074620.6,204.0,204.0
108111855.0,17,5,1005,5,1005,27027963.75,201.0,201.0,0,0,0.0,0.0,0.0
1302453.0,6,4,264,2,132,0.0,66.0,66.0,2,132,0.0,66.0,66.0
250854.00000000003,6,10,1221,6,636,50170.8,298.0,106.0,4,585,77973.0,379.0,146.25
2694972.0,6,2,132,1,66,0.0,66.0,66.0,1,66,0.0,66.0,66.0
2361.0,17,4,344,2,150,0.0,75.0,75.0,2,194,0.0,103.0,97.0
324483.0,17,4,1400,4,1400,108161.0,350.0,350.0,0,0,0.0,0.0,0.0
90049148.0,17,28,13364,28,13364,3335153.6296296297,501.0,477.2857142857143,0,0,0.0,0.0,0.0
759.0,17,4,438,2,148,0.0,74.0,74.0,2,290,0.0,147.0,145.0
108102726.0,17,5,1005,5,1005,27025681.5,201.0,201.0,0,0,0.0,0.0,0.0
90041998.0,17,28,13364,28,13364,3334888.814814815,501.0,477.2857142857143,0,0,0.0,0.0,0.0
219966.0,6,3,426,2,280,0.0,214.0,140.0,1,146,0.0,146.0,146.0
307041.0,6,6,412,4,272,102347.0,74.0,68.0,2,140,0.0,74.0,70.0
119617.0,17,4,1524,4,1524,39872.333333333336,381.0,381.0,0,0,0.0,0.0,0.0
94387364.0,6,39,2574,20,1320,4956394.368421053,66.0,66.0,19,1254,5105447.055555556,66.0,66.0
2516.0,17,4,344,2,150,0.0,75.0,75.0,2,194,0.0,103.0,97.0
337631.0,17,2,238,1,74,0.0,74.0,74.0,1,164,0.0,164.0,164.0
49355.0,6,14,4740,7,653,5458.0,249.0,93.28571428571428,7,4087,8049.166666666667,1514.0,583.8571428571429
120294576.0,6,244,27548,122,8348,987330.7603305784,140.0,68.42622950819673,122,19200,987494.0991735538,284.0,157.37704918032787
2308.0,17,4,344,2,150,0.0,75.0,75.0,2,194,0.0,103.0,97.0
219987.0,6,3,426,2,280,0.0,214.0,140.0,1,146,0.0,146.0,146.0
9825.0,17,2,582,1,83,0.0,83.0,83.0,1,499,0.0,499.0,499.0
146629.0,17,4,704,2,148,0.0,74.0,74.0,2,556,0.0,280.0,278.0
349.0,17,2,250,1,93,0.0,93.0,93.0,1,157,0.0,157.0,157.0
303646.0,6,2,132,1,66,0.0,66.0,66.0,1,66,0.0,66.0,66.0
331.0,17,2,160,1,80,0.0,80.0,80.0,1,80,0.0,80.0,80.0
12701.0,6,11,1132,6,556,2316.4,218.0,92.66666666666669,5,576,2868.25,304.0,115.2
193006.0,17,2,180,1,90,0.0,90.0,90.0,1,90,0.0,90.0,90.0
93333437.0,6,284,32866,142,9520,656054.6028368794,140.0,67.04225352112677,142,23346,661855.659574468,284.0,164.40845070422534
33748.0,6,14,4740,7,653,4673.333333333333,249.0,93.28571428571428,7,4087,5468.666666666667,1514.0,583.8571428571429
284934.0,17,2,363,1,79,0.0,79.0,79.0,1,284,0.0,284.0,284.0
6961.0,17,2,582,1,83,0.0,83.0,83.0,1,499,0.0,499.0,499.0
26267.0,6,10,2032,5,524,6242.75,252.0,104.8,5,1508,6282.25,1236.0,301.6
108108872.0,17,5,1005,5,1005,27027218.0,201.0,201.0,0,0,0.0,0.0,0.0
117792764.0,6,237,26980,119,18896,998243.7627118644,284.0,158.78991596638656,118,8084,999759.1282051282,140.0,68.50847457627118
251057.0,17,4,6056,4,6056,83685.66666666667,1514.0,1514.0,0,0,0.0,0.0,0.0
108108785.0,17,5,955,5,955,27027196.25,191.0,191.0,0,0,0.0,0.0,0.0
2370.0,17,4,344,2,150,0.0,75.0,75.0,2,194,0.0,103.0,97.0
213247.0,17,2,414,1,88,0.0,88.0,88.0,1,326,0.0,326.0,326.0
287225.0,17,2,363,1,79,0.0,79.0,79.0,1,284,0.0,284.0,284.0
135357.0,6,2,132,1,66,0.0,66.0,66.0,1,66,0.0,66.0,66.0
113560879.0,6,46,3036,23,1518,5161846.2727272725,66.0,66.0,23,1518,5161845.954545454,66.0,66.0
25501.0,6,10,2032,5,524,5940.5,252.0,104.8,5,1508,6093.0,1236.0,301.6
183626.0,17,2,180,1,90,0.0,90.0,90.0,1,90,0.0,90.0,90.0
1645745.0,6,7,499,4,301,527623.0,103.0,75.25,3,198,715431.5,66.0,66.0
2379.0,17,4,344,2,150,0.0,75.0,75.0,2,194,0.0,103.0,97.0
108107129.0,17,5,1005,5,1005,27026782.25,201.0,201.0,0,0,0.0,0.0,0.0
108103170.0,17,5,1005,5,1005,27025792.5,201.0,201.0,0,0,0.0,0.0,0.0
34302.0,6,14,4740,7,653,5592.0,249.0,93.28571428571428,7,4087,5391.666666666667,1514.0,583.8571428571429
197903.0,17,2,180,1,90,0.0,90.0,90.0,1,90,0.0,90.0,90.0
2452.0,17,4,344,2,150,0.0,75.0,75.0,2,194,0.0,103.0,97.0
42801.0,6,14,4740,7,653,6892.833333333333,249.0,93.28571428571428,7,4087,5989.166666666667,1514.0,583.8571428571429
120215.0,6,14,4740,7,653,19916.0,249.0,93.28571428571428,7,4087,19319.166666666668,1514.0,583.8571428571429
297.0,17,2,174,1,79,0.0,79.0,79.0,1,95,0.0,95.0,95.0
120505379.0,6,211,23914,106,16688,1147670.2761904765,284.0,157.43396226415095,105,7226,1148739.5288461538,140.0,68.81904761904762
209613.0,17,2,180,1,90,0.0,90.0,90.0,1,90,0.0,90.0,90.0
120001111.0,17,15,907,8,475,17143015.85714286,174.0,59.375,7,432,16668079.666666666,174.0,61.71428571428572
90800767.0,6,29,2263,16,1233,6050392.666666667,95.0,77.0625,13,1030,7543099.833333333,95.0,79.23076923076923
120000974.0,17,13,559,7,301,20000162.33333333,43.0,43.0,6,258,20001478.8,43.0,43.0
7150.0,17,2,582,1,83,0.0,83.0,83.0,1,499,0.0,499.0,499.0
228433.0,17,2,180,1,90,0.0,90.0,90.0,1,90,0.0,90.0,90.0
5452427.0,6,10,1221,6,636,1090485.4,298.0,106.0,4,585,1812108.0,379.0,146.25
17399.0,6,14,4740,7,653,2473.333333333333,249.0,93.28571428571428,7,4087,2764.333333333333,1514.0,583.8571428571429
293051.0,17,2,180,1,90,0.0,90.0,90.0,1,90,0.0,90.0,90.0
204390.0,17,2,762,2,762,0.0,381.0,381.0,0,0,0.0,0.0,0.0
56977.0,6,14,4740,7,653,8984.5,249.0,93.28571428571428,7,4087,8027.333333333333,1514.0,583.8571428571429
1028335.0,6,11,1134,6,558,205667.0,220.0,93.0,5,576,256280.0,304.0,115.2
58463.0,6,14,4740,7,653,9585.5,249.0,93.28571428571428,7,4087,9326.833333333334,1514.0,583.8571428571429
2801004.0,6,2,132,1,66,0.0,66.0,66.0,1,66,0.0,66.0,66.0
135119846.0,17,6,1206,6,1206,27023969.2,201.0,201.0,0,0,0.0,0.0,0.0
214814.0,6,4,492,2,280,0.0,214.0,140.0,2,212,0.0,146.0,106.0
2499.0,17,4,344,2,150,0.0,75.0,75.0,2,194,0.0,103.0,97.0
204667.0,6,14,4740,7,653,32039.666666666668,249.0,93.28571428571428,7,4087,33761.166666666664,1514.0,583.8571428571429
9927.0,17,4,823,2,163,0.0,89.0,81.5,2,660,0.0,443.0,330.0
38596.0,6,10,2032,5,524,8847.75,252.0,104.8,5,1508,9088.75,1236.0,301.6
2800575.0,6,11,2106,6,598,559551.0,252.0,99.66666666666669,5,1508,2110.75,1236.0,301.6
92766487.0,6,187,21472,94,15112,997489.1075268816,300.0,160.7659574468085,93,6360,996937.4347826086,140.0,68.38709677419355
43074.0,6,14,4740,7,653,6970.0,249.0,93.28571428571428,7,4087,6918.166666666667,1514.0,583.8571428571429
313497.0,6,3,202,2,128,0.0,74.0,64.0,1,74,0.0,74.0,74.0
246972.0,6,3,337,2,214,0.0,160.0,107.0,1,123,0.0,123.0,123.0
120068319.0,6,34,2419,17,1194,6880223.8125,123.0,70.23529411764706,17,1225,7503742.5,139.0,72.05882352941177
6902.0,17,2,582,1,83,0.0,83.0,83.0,1,499,0.0,499.0,499.0
108105184.0,17,5,1005,5,1005,27026296.0,201.0,201.0,0,0,0.0,0.0,0.0
246618.0,6,3,337,2,214,0.0,160.0,107.0,1,123,0.0,123.0,123.0
110734857.0,17,14,864,7,432,18334349.5,174.0,61.71428571428572,7,432,18333494.0,174.0,61.71428571428572
15136.0,17,2,180,1,90,0.0,90.0,90.0,1,90,0.0,90.0,90.0
203550.0,17,2,762,2,762,0.0,381.0,381.0,0,0,0.0,0.0,0.0
120350.0,6,15,4806,8,719,17087.285714285714,249.0,89.875,7,4087,19591.5,1514.0,583.8571428571429
241539.0,6,3,373,2,238,0.0,172.0,119.0,1,135,0.0,135.0,135.0
96278935.0,6,23,1509,12,846,8752630.454545455,123.0,70.5,11,663,8947970.1,123.0,60.27272727272727
2434.0,17,4,344,2,150,0.0,75.0,75.0,2,194,0.0,103.0,97.0
23978.0,6,14,4740,7,653,2617.0,249.0,93.28571428571428,7,4087,3863.6666666666665,1514.0,583.8571428571429
448326.0,6,3,1604,1,753,0.0,753.0,753.0,2,851,0.0,785.0,425.5
207035.0,6,3,426,2,280,0.0,214.0,140.0,1,146,0.0,146.0,146.0
871380.0,6,10,1262,6,725,174276.0,387.0,120.83333333333331,4,537,198426.0,331.0,134.25
335.0,17,2,174,1,79,0.0,79.0,79.0,1,95,0.0,95.0,95.0
228198.0,17,2,180,1,90,0.0,90.0,90.0,1,90,0.0,90.0,90.0
120094605.0,17,28,13364,28,13364,4447948.333333333,501.0,477.2857142857143,0,0,0.0,0.0,0.0
2067844.0,6,24,7544,12,2450,187985.8181818181,1034.0,204.16666666666663,12,5094,159737.72727272726,1510.0,424.5
120001411.0,6,17,1246,9,650,15000176.375,95.0,72.22222222222223,8,596,17105322.85714286,95.0,74.5
56341.0,6,12,1320,7,789,9390.166666666666,253.0,112.71428571428572,5,531,10683.25,259.0,106.2
2056.0,17,4,344,2,150,0.0,75.0,75.0,2,194,0.0,103.0,97.0
204532.0,17,2,762,2,762,0.0,381.0,381.0,0,0,0.0,0.0,0.0
3185.0,17,2,224,1,76,0.0,76.0,76.0,1,148,0.0,148.0,148.0
72657.0,6,14,4740,7,653,11982.333333333334,249.0,93.28571428571428,7,4087,10727.333333333334,1514.0,583.8571428571429
105775256.0,6,44,2904,22,1452,5036916.952380952,66.0,66.0,22,1452,5022033.857142857,66.0,66.0
453654.0,6,6,758,3,410,197199.0,172.0,136.66666666666666,3,348,166934.5,135.0,116.0
23345.0,6,14,4740,7,653,3266.0,249.0,93.28571428571428,7,4087,3750.5,1514.0,583.8571428571429
299.0,17,2,164,1,82,0.0,82.0,82.0,1,82,0.0,82.0,82.0
348.0,17,2,164,1,82,0.0,82.0,82.0,1,82,0.0,82.0,82.0
30710.0,6,14,4740,7,653,4951.333333333333,249.0,93.28571428571428,7,4087,4890.166666666667,1514.0,583.8571428571429
68886.0,6,12,1413,7,882,11481.0,291.0,126.0,5,531,16308.75,259.0,106.2
955.0,17,5,550,5,550,238.75,110.0,110.0,0,0,0.0,0.0,0.0
2325189.0,6,20,6935,11,1567,232518.9,408.0,142.45454545454547,9,5368,247416.5,1514.0,596.4444444444445
24277183.0,6,5,1736,2,819,0.0,753.0,409.5,3,917,12073186.5,785.0,305.6666666666667
103137.0,17,2,286,2,286,0.0,143.0,143.0,0,0,0.0,0.0,0.0
110001001.0,17,13,821,7,432,18333500.166666668,174.0,61.71428571428572,6,389,18001392.6,174.0,64.83333333333333
893244.0,6,10,1262,6,725,178648.8,387.0,120.83333333333331,4,537,206909.66666666663,331.0,134.25
9277.0,17,2,582,1,83,0.0,83.0,83.0,1,499,0.0,499.0,499.0
310220.0,17,4,1400,4,1400,103406.66666666669,350.0,350.0,0,0,0.0,0.0,0.0
90302058.0,6,17,1287,8,637,12900294.0,95.0,79.625,9,650,11247244.0,95.0,72.22222222222223
216417.0,17,2,180,1,90,0.0,90.0,90.0,1,90,0.0,90.0,90.0
304854.0,6,6,412,4,272,101618.0,74.0,68.0,2,140,0.0,74.0,70.0
313766.0,6,6,412,4,272,104588.66666666669,74.0,68.0,2,140,0.0,74.0,70.0
246143.0,6,3,337,2,214,0.0,160.0,107.0,1,123,0.0,123.0,123.0
108105894.0,17,5,1005,5,1005,27026473.5,201.0,201.0,0,0,0.0,0.0,0.0
106420.0,17,2,286,2,286,0.0,143.0,143.0,0,0,0.0,0.0,0.0
304647.0,6,6,412,4,272,101549.0,74.0,68.0,2,140,0.0,74.0,70.0
206110.0,17,2,180,1,90,0.0,90.0,90.0,1,90,0.0,90.0,90.0
121410.0,6,3,337,2,214,0.0,160.0,107.0,1,123,0.0,123.0,123.0
143915.0,17,2,180,1,90,0.0,90.0,90.0,1,90,0.0,90.0,90.0
120045063.0,6,635,80354,318,21210,378691.0504731861,140.0,66.69811320754717,317,59144,379169.64240506326,464.0,186.5741324921136
35099.0,6,2,145,2,145,0.0,91.0,72.5,0,0,0.0,0.0,0.0
41647.0,6,14,4740,7,653,6771.666666666667,249.0,93.28571428571428,7,4087,6739.333333333333,1514.0,583.8571428571429
221084.0,6,10,1221,6,636,44216.8,298.0,106.0,4,585,72401.0,379.0,146.25
108110053.0,17,5,1005,5,1005,27027513.25,201.0,201.0,0,0,0.0,0.0,0.0
230394.0,17,2,359,1,75,0.0,75.0,75.0,1,284,0.0,284.0,284.0
2384.0,17,4,344,2,150,0.0,75.0,75.0,2,194,0.0,103.0,97.0
73226.0,17,2,762,2,762,0.0,381.0,381.0,0,0,0.0,0.0,0.0
100826588.0,17,11,735,5,346,25092267.25,174.0,69.2,6,389,20133118.2,174.0,64.83333333333333
834710.0,6,9,1118,6,586,166942.0,248.0,97.66666666666669,3,532,279771.5,392.0,177.33333333333334
5830811.0,6,5,336,2,134,0.0,68.0,67.0,3,202,1522961.0,70.0,67.33333333333333
5287.0,17,5,550,5,550,1321.75,110.0,110.0,0,0,0.0,0.0,0.0
48755.0,6,14,4740,7,653,7541.333333333333,249.0,93.28571428571428,7,4087,7292.166666666667,1514.0,583.8571428571429
105174.0,17,2,700,2,700,0.0,350.0,350.0,0,0,0.0,0.0,0.0
2594215.0,6,2,132,1,66,0.0,66.0,66.0,1,66,0.0,66.0,66.0
93335372.0,17,12,778,6,389,18602807.2,174.0,64.83333333333333,6,389,18600156.0,174.0,64.83333333333333
7317.0,17,2,582,1,83,0.0,83.0,83.0,1,499,0.0,499.0,499.0
37495.0,6,12,1320,7,789,6249.166666666667,253.0,112.71428571428572,5,531,6778.75,259.0,106.2
302157.0,6,6,412,4,272,100719.0,74.0,68.0,2,140,0.0,74.0,70.0
120350682.0,6,227,25706,114,18026,1065050.2831858408,284.0,158.12280701754386,113,7680,1065279.2589285714,140.0,67.96460176991151
103231.0,17,2,286,2,286,0.0,143.0,143.0,0,0,0.0,0.0,0.0
660.0,17,2,762,2,762,0.0,381.0,381.0,0,0,0.0,0.0,0.0
124001457.0,17,15,907,8,475,17714493.85714286,174.0,59.375,7,432,17334547.0,174.0,61.71428571428572
120444006.0,6,329,38574,165,27528,734414.6707317074,284.0,166.83636363636364,164,11046,732644.0858895705,140.0,67.35365853658537
4714.0,17,2,180,1,90,0.0,90.0,90.0,1,90,0.0,90.0,90.0
30097.0,6,10,2032,5,524,7079.0,252.0,104.8,5,1508,6933.0,1236.0,301.6
297630.0,6,6,412,4,272,99210.0,74.0,68.0,2,140,0.0,74.0,70.0
1627804.0,6,20,7599,11,1469,162780.4,583.0,133.54545454545453,9,6130,170838.875,1484.0,681.1111111111111
90289643.0,6,16,1192,8,596,12892281.0,95.0,74.5,8,596,12896993.714285716,95.0,74.5
37083.0,6,11,2098,6,590,6231.4,252.0,98.33333333333331,5,1508,8504.75,1236.0,301.6
237500.0,6,3,337,2,214,0.0,160.0,107.0,1,123,0.0,123.0,123.0
266863.0,17,4,1524,4,1524,88954.33333333333,381.0,381.0,0,0,0.0,0.0,0.0
37013.0,17,2,180,1,90,0.0,90.0,90.0,1,90,0.0,90.0,90.0
500.0,17,2,508,2,508,0.0,257.0,254.0,0,0,0.0,0.0,0.0
35094.0,6,14,4740,7,653,5727.0,249.0,93.28571428571428,7,4087,4885.0,1514.0,583.8571428571429
145693.0,17,2,180,1,90,0.0,90.0,90.0,1,90,0.0,90.0,90.0
24637.0,6,10,2032,5,524,5943.0,252.0,104.8,5,1508,5638.25,1236.0,301.6
66508.0,6,14,4740,7,653,9981.333333333334,249.0,93.28571428571428,7,4087,3716.8333333333335,1514.0,583.8571428571429
121011640.0,17,15,907,8,475,17287377.14285714,174.0,59.375,7,432,16833543.333333332,174.0,61.71428571428572
303905.0,6,10,1221,6,636,60781.0,298.0,106.0,4,585,95357.66666666669,379.0,146.25
3174795.0,6,18,1495,9,921,358118.5,315.0,102.33333333333331,9,574,358096.0,78.0,63.77777777777778
303704.0,6,6,412,4,272,101234.66666666669,74.0,68.0,2,140,0.0,74.0,70.0
109563.0,17,2,762,2,762,0.0,381.0,381.0,0,0,0.0,0.0,0.0
23308.0,6,14,4740,7,653,3710.3333333333335,249.0,93.28571428571428,7,4087,3743.6666666666665,1514.0,583.8571428571429
514176.0,6,5,336,2,134,0.0,68.0,67.0,3,202,192717.5,70.0,67.33333333333333
109626473.0,6,33,2428,17,1288,6851654.5625,139.0,75.76470588235294,16,1140,7294015.133333334,123.0,71.25
46204.0,6,14,4740,7,653,7006.833333333333,249.0,93.28571428571428,7,4087,7569.0,1514.0,583.8571428571429
0.0,6,1,66,1,66,0.0,66.0,66.0,0,0,0.0,0.0,0.0
135135598.0,17,6,1146,6,1146,27027119.6,191.0,191.0,0,0,0.0,0.0,0.0
2375.0,17,4,344,2,150,0.0,75.0,75.0,2,194,0.0,103.0,97.0
238598.0,6,3,337,2,214,0.0,160.0,107.0,1,123,0.0,123.0,123.0
276367.0,17,2,359,1,75,0.0,75.0,75.0,1,284,0.0,284.0,284.0
739.0,17,4,438,2,148,0.0,74.0,74.0,2,290,0.0,147.0,145.0
13519.0,6,12,1393,6,796,2478.2,271.0,132.66666666666666,6,597,2443.4,259.0,99.5
118753269.0,6,34,2482,17,1194,7422079.3125,123.0,70.23529411764706,17,1288,6785056.375,139.0,75.76470588235294
298013.0,17,2,620,1,75,0.0,75.0,75.0,1,545,0.0,545.0,545.0
99155524.0,6,186,20982,93,14622,1075437.641304348,284.0,157.2258064516129,93,6360,1075437.858695652,140.0,68.38709677419355
282240.0,17,2,363,1,79,0.0,79.0,79.0,1,284,0.0,284.0,284.0
307401.0,6,6,412,4,272,102467.0,74.0,68.0,2,140,0.0,74.0,70.0
22734.0,6,14,4740,7,653,3673.5,249.0,93.28571428571428,7,4087,3652.5,1514.0,583.8571428571429
20027.0,6,10,2032,5,524,4386.75,252.0,104.8,5,1508,4722.25,1236.0,301.6
16324.000000000002,6,13,1459,7,862,2519.0,271.0,123.14285714285714,6,597,2981.2,259.0,99.5
1446221.0,6,2,132,1,66,0.0,66.0,66.0,1,66,0.0,66.0,66.0
10505958.0,6,7,478,4,272,3456156.0,74.0,68.0,3,206,5184141.0,74.0,68.66666666666667
36797.0,6,14,4740,7,653,5986.5,249.0,93.28571428571428,7,4087,5624.0,1514.0,583.8571428571429
144828.0,17,2,180,1,70,0.0,70.0,70.0,1,110,0.0,110.0,110.0
110897415.0,6,39,3040,21,1654,5544870.75,139.0,78.76190476190476,18,1386,6511329.588235294,123.0,77.0
2796020.0,6,2,132,1,66,0.0,66.0,66.0,1,66,0.0,66.0,66.0
123860413.0,6,49,3234,25,1650,5160850.541666667,66.0,66.0,24,1584,4971260.347826087,66.0,66.0
160227.0,6,3,337,2,214,0.0,160.0,107.0,1,123,0.0,123.0,123.0
2051700.0,17,4,820,2,156,0.0,78.0,78.0,2,664,0.0,332.0,332.0
24131271.0,17,5,1718,4,1368,812468.6666666666,342.0,342.0,1,350,0.0,350.0,350.0
107118018.0,6,205,23030,103,7094,1050176.6470588236,140.0,68.87378640776699,102,15936,1057118.3366336634,284.0,156.23529411764707
319.0,17,2,166,1,75,0.0,75.0,75.0,1,91,0.0,91.0,91.0
260795.0,17,4,6056,4,6056,86931.66666666667,1514.0,1514.0,0,0,0.0,0.0,0.0
113275487.0,6,413,47882,207,13884,549881.004854369,140.0,67.07246376811594,206,33998,547493.8878048781,336.0,165.03883495145632
90288995.0,6,16,1192,8,596,12892716.0,95.0,74.5,8,596,12897788.714285716,95.0,74.5
43834.0,6,13,1386,7,789,7266.5,253.0,112.71428571428572,6,597,7955.4,259.0,99.5
410.0,17,2,410,1,78,0.0,78.0,78.0,1,332,0.0,332.0,332.0
4032.0,17,2,762,2,762,0.0,381.0,381.0,0,0,0.0,0.0,0.0
300578.0,6,6,412,4,272,100192.66666666669,74.0,68.0,2,140,0.0,74.0,70.0
14565300.0,6,7,499,3,198,6655543.0,66.0,66.0,4,301,3578102.333333333,103.0,75.25
107889.0,17,2,700,2,700,0.0,350.0,350.0,0,0,0.0,0.0,0.0
1111105.0,6,13,1394,7,797,185184.16666666663,253.0,113.85714285714286,6,597,219992.0,259.0,99.5
6896.0,17,2,582,1,83,0.0,83.0,83.0,1,499,0.0,499.0,499.0
106565287.0,17,14,864,7,432,17667685.5,174.0,61.71428571428572,7,432,17666819.666666668,174.0,61.71428571428572
5715778.0,6,4,270,2,134,0.0,68.0,67.0,2,136,0.0,70.0,68.0
90302652.0,6,16,1192,8,596,12893475.0,95.0,74.5,8,596,12898916.714285716,95.0,74.5
326463.0,17,4,1400,4,1400,108821.0,350.0,350.0,0,0,0.0,0.0,0.0
6874.0,17,2,582,1,83,0.0,83.0,83.0,1,499,0.0,499.0,499.0
303626.0,6,2,132,1,66,0.0,66.0,66.0,1,66,0.0,66.0,66.0
135132808.0,17,6,1146,6,1146,27026561.6,191.0,191.0,0,0,0.0,0.0,0.0
40636.0,6,10,2032,5,524,9897.0,252.0,104.8,5,1508,9859.25,1236.0,301.6
2316.0,17,4,344,2,150,0.0,75.0,75.0,2,194,0.0,103.0,97.0
13847.0,6,10,1065,5,534,3037.5,262.0,106.8,5,531,2574.0,259.0,106.2
53386.0,6,10,2032,5,524,12415.0,252.0,104.8,5,1508,12795.0,1236.0,301.6
3219.0,17,4,344,2,150,0.0,75.0,75.0,2,194,0.0,103.0,97.0
102506.0,17,2,286,2,286,0.0,143.0,143.0,0,0,0.0,0.0,0.0
128297.0,6,2,132,1,66,0.0,66.0,66.0,1,66,0.0,66.0,66.0
205682.0,6,3,426,2,280,0.0,214.0,140.0,1,146,0.0,146.0,146.0
4413.0,17,2,614,1,72,0.0,72.0,72.0,1,542,0.0,542.0,542.0
128857255.0,6,35,2410,18,1285,7579838.529411765,139.0,71.38888888888889,17,1125,7415992.1875,123.0,66.17647058823529
10125.0,6,10,2032,5,524,2185.25,252.0,104.8,5,1508,2260.75,1236.0,301.6
96417037.0,17,12,778,6,389,19251459.8,174.0,64.83333333333333,6,389,19163493.0,174.0,64.83333333333333
25030.0,6,14,4740,7,653,3521.6666666666665,249.0,93.28571428571428,7,4087,3983.3333333333335,1514.0,583.8571428571429
128883604.0,6,33,2296,17,1225,8055225.25,139.0,72.05882352941177,16,1071,7912154.533333333,123.0,66.9375
3019473.0,6,12,2172,7,664,502807.6666666667,252.0,94.85714285714286,5,1508,5366.5,1236.0,301.6
45754.0,6,14,4740,7,653,6605.333333333333,249.0,93.28571428571428,7,4087,6563.833333333333,1514.0,583.8571428571429
143953.0,17,2,180,1,90,0.0,90.0,90.0,1,90,0.0,90.0,90.0
228402.0,17,2,180,1,90,0.0,90.0,90.0,1,90,0.0,90.0,90.0
209765.0,17,2,180,1,90,0.0,90.0,90.0,1,90,0.0,90.0,90.0
148009.0,17,2,180,1,90,0.0,90.0,90.0,1,90,0.0,90.0,90.0
324.0,17,2,174,1,79,0.0,79.0,79.0,1,95,0.0,95.0,95.0
228388.0,17,2,180,1,90,0.0,90.0,90.0,1,90,0.0,90.0,90.0
305859.0,6,2,1536,1,752,0.0,752.0,752.0,1,784,0.0,784.0,784.0
120005932.0,17,14,864,8,475,17143704.57142857,174.0,59.375,6,389,20000166.2,174.0,64.83333333333333
108103928.0,17,5,1005,5,1005,27025982.0,201.0,201.0,0,0,0.0,0.0,0.0
1850.0,17,2,192,1,88,0.0,88.0,88.0,1,104,0.0,104.0,104.0
105023673.0,6,44,2904,22,1452,5001127.285714285,66.0,66.0,22,1452,4986153.047619048,66.0,66.0
50806.0,17,2,180,1,90,0.0,90.0,90.0,1,90,0.0,90.0,90.0
0.0,17,1,179,1,179,0.0,179.0,179.0,0,0,0.0,0.0,0.0
40008.0,6,14,4740,7,653,6452.333333333333,249.0,93.28571428571428,7,4087,6008.0,1514.0,583.8571428571429
90257860.0,6,17,2434,9,1204,11282232.5,188.0,133.77777777777777,8,1230,12870374.714285716,204.0,153.75
153538.0,17,2,180,1,90,0.0,90.0,90.0,1,90,0.0,90.0,90.0
312336.0,6,10,1221,6,636,62467.2,298.0,106.0,4,585,98385.66666666669,379.0,146.25
42009.0,6,14,4740,7,653,5643.666666666667,249.0,93.28571428571428,7,4087,6864.666666666667,1514.0,583.8571428571429
55714.0,6,12,1320,7,789,9285.666666666666,253.0,112.71428571428572,5,531,10925.75,259.0,106.2
94295355.0,6,40,2640,20,1320,4962913.421052632,66.0,66.0,20,1320,4951538.894736842,66.0,66.0
371902.0,17,2,180,1,90,0.0,90.0,90.0,1,90,0.0,90.0,90.0
293336.0,17,2,230,1,79,0.0,79.0,79.0,1,151,0.0,151.0,151.0
34291.0,6,10,2032,5,524,7442.0,252.0,104.8,5,1508,8331.5,1236.0,301.6
51348.0,6,14,4740,7,653,7963.5,249.0,93.28571428571428,7,4087,7811.833333333333,1514.0,583.8571428571429
320.0,17,2,174,1,79,0.0,79.0,79.0,1,95,0.0,95.0,95.0
233977.0,6,3,373,2,238,0.0,172.0,119.0,1,135,0.0,135.0,135.0
238173.0,6,3,373,2,238,0.0,172.0,119.0,1,135,0.0,135.0,135.0
2801721.0,6,2,132,1,66,0.0,66.0,66.0,1,66,0.0,66.0,66.0
6396.0,17,4,823,2,163,0.0,89.0,81.5,2,660,0.0,443.0,330.0
90029649.0,17,28,13364,28,13364,3334431.4444444445,501.0,477.2857142857143,0,0,0.0,0.0,0.0
51047.0,17,2,180,1,90,0.0,90.0,90.0,1,90,0.0,90.0,90.0
317845.0,17,4,1400,4,1400,105948.33333333331,350.0,350.0,0,0,0.0,0.0,0.0
104111.0,17,2,286,2,286,0.0,143.0,143.0,0,0,0.0,0.0,0.0
6852.0,17,2,582,1,83,0.0,83.0,83.0,1,499,0.0,499.0,499.0
204562.0,17,2,762,2,762,0.0,381.0,381.0,0,0,0.0,0.0,0.0
90521300.0,6,13,2036,8,1016,12931614.285714284,188.0,127.0,5,1020,22590079.75,204.0,204.0
777.0,17,4,438,2,148,0.0,74.0,74.0,2,290,0.0,147.0,145.0
155446.0,6,3,337,2,214,0.0,160.0,107.0,1,123,0.0,123.0,123.0
1532359.0,6,7,499,4,301,442820.6666666667,103.0,75.25,3,198,716287.0,66.0,66.0
299143.0,6,6,412,4,272,99714.33333333331,74.0,68.0,2,140,0.0,74.0,70.0
2605645.0,6,25,7573,14,3735,200434.2307692308,1514.0,266.7857142857143,11,3838,233085.8,1514.0,348.90909090909093
196979.0,17,2,180,1,90,0.0,90.0,90.0,1,90,0.0,90.0,90.0
779.0,17,4,438,2,148,0.0,74.0,74.0,2,290,0.0,147.0,145.0
31041.0,6,10,2032,5,524,7527.25,252.0,104.8,5,1508,7227.25,1236.0,301.6
90258791.0,6,13,2036,8,1016,12894113.0,188.0,127.0,5,1020,22522163.25,204.0,204.0
28825.0,6,14,4740,7,653,4176.666666666667,249.0,93.28571428571428,7,4087,3863.1666666666665,1514.0,583.8571428571429
324.0,17,2,174,1,79,0.0,79.0,79.0,1,95,0.0,95.0,95.0
112062258.0,6,31,2182,16,1165,7457185.666666667,139.0,72.8125,15,1017,7989691.642857143,123.0,67.8
501722.0,6,5,336,2,134,0.0,68.0,67.0,3,202,194898.5,70.0,67.33333333333333
205607.0,17,2,180,1,90,0.0,90.0,90.0,1,90,0.0,90.0,90.0
119585518.0,6,21,1585,10,745,13287279.777777778,95.0,74.5,11,840,11933741.7,95.0,76.36363636363636
255778.0,6,3,337,2,214,0.0,160.0,107.0,1,123,0.0,123.0,123.0
104403.0,17,2,286,2,286,0.0,143.0,143.0,0,0,0.0,0.0,0.0
65834.0,6,14,4740,7,653,10850.666666666666,249.0,93.28571428571428,7,4087,10832.833333333334,1514.0,583.8571428571429
106294458.0,17,14,864,7,432,17667655.833333332,174.0,61.71428571428572,7,432,17666831.5,174.0,61.71428571428572
2415.0,17,4,344,2,150,0.0,75.0,75.0,2,194,0.0,103.0,97.0
36823943.0,6,26,7627,14,3735,201559.53846153847,1514.0,266.7857142857143,12,3892,3328055.5454545454,1514.0,324.3333333333333
120069759.0,17,29,13785,29,13785,4288205.678571428,501.0,475.3448275862069,0,0,0.0,0.0,0.0
138758788.0,17,17,1255,8,606,17071186.85714286,174.0,75.75,9,649,17250915.0,174.0,72.11111111111111
121357.0,6,3,373,2,238,0.0,172.0,119.0,1,135,0.0,135.0,135.0
331124.0,17,2,180,1,90,0.0,90.0,90.0,1,90,0.0,90.0,90.0
90959653.0,6,163,18268,82,5646,1122958.6790123456,140.0,68.85365853658537,81,12622,1111241.9375,284.0,155.82716049382717
233109.0,6,3,337,2,214,0.0,160.0,107.0,1,123,0.0,123.0,123.0
49155.0,6,11,2098,6,590,9643.2,252.0,98.33333333333331,5,1508,2604.5,1236.0,301.6
14864.0,17,4,625,2,163,0.0,89.0,81.5,2,462,0.0,245.0,231.0
108967.0,17,2,286,2,286,0.0,143.0,143.0,0,0,0.0,0.0,0.0
120119823.0,6,16,2648,8,1632,17159974.714285713,204.0,204.0,8,1016,17098196.14285714,188.0,127.0
90023188.0,17,28,13364,28,13364,3334192.1481481483,501.0,477.2857142857143,0,0,0.0,0.0,0.0
115849498.0,6,47,3102,24,1584,5023487.434782608,66.0,66.0,23,1518,5150450.681818182,66.0,66.0
92832346.0,6,38,2508,19,1254,5157337.611111111,66.0,66.0,19,1254,5157332.5,66.0,66.0
308379.0,6,6,412,4,272,102793.0,74.0,68.0,2,140,0.0,74.0,70.0
90316473.0,6,16,1192,8,596,12892831.285714284,95.0,74.5,8,596,12900578.0,95.0,74.5
226019.0,6,10,1221,6,636,45203.8,298.0,106.0,4,585,73307.33333333333,379.0,146.25
344.0,17,2,166,1,75,0.0,75.0,75.0,1,91,0.0,91.0,91.0
24290.0,17,2,582,1,83,0.0,83.0,83.0,1,499,0.0,499.0,499.0
876.0,17,4,438,2,148,0.0,74.0,74.0,2,290,0.0,147.0,145.0
228222.0,17,2,180,1,90,0.0,90.0,90.0,1,90,0.0,90.0,90.0
53147.0,6,14,4740,7,653,8732.666666666666,249.0,93.28571428571428,7,4087,7251.666666666667,1514.0,583.8571428571429
314837.0,6,2,132,1,66,0.0,66.0,66.0,1,66,0.0,66.0,66.0
33304.0,6,14,4740,7,653,4967.166666666667,249.0,93.28571428571428,7,4087,5296.333333333333,1514.0,583.8571428571429
35368.0,6,14,4740,7,653,5789.5,249.0,93.28571428571428,7,4087,5298.5,1514.0,583.8571428571429
510899.0,6,5,336,2,134,0.0,68.0,67.0,3,202,194060.0,70.0,67.33333333333333
104389411.0,17,14,864,7,432,17398235.166666668,174.0,61.71428571428572,7,432,17363477.833333332,174.0,61.71428571428572
128103973.0,6,35,2548,19,1408,7116887.388888889,139.0,74.10526315789474,16,1140,7860076.333333333,123.0,71.25
2052161.0,17,6,1230,3,234,1025886.5,78.0,78.0,3,996,1025873.0,332.0,332.0
2128.0,17,2,180,1,90,0.0,90.0,90.0,1,90,0.0,90.0,90.0
90270224.0,6,13,2036,8,1016,12895746.285714284,188.0,127.0,5,1020,22525983.0,204.0,204.0
40409.0,6,14,4740,7,653,6370.0,249.0,93.28571428571428,7,4087,6597.666666666667,1514.0,583.8571428571429
496.0,17,2,762,2,762,0.0,381.0,381.0,0,0,0.0,0.0,0.0
26602.0,6,10,2032,5,524,6424.0,252.0,104.8,5,1508,5979.0,1236.0,301.6
10514279.0,6,7,478,4,272,3459275.333333333,74.0,68.0,3,206,5188819.5,74.0,68.66666666666667
2660236.0,6,25,7573,14,3735,204633.53846153847,1514.0,266.7857142857143,11,3838,240263.5,1514.0,348.90909090909093
316714.0,17,4,1400,4,1400,105571.33333333331,350.0,350.0,0,0,0.0,0.0,0.0
14797.0,17,4,438,2,148,0.0,74.0,74.0,2,290,0.0,147.0,145.0
207286.0,6,3,426,2,280,0.0,214.0,140.0,1,146,0.0,146.0,146.0
108102580.0,17,5,1005,5,1005,27025645.0,201.0,201.0,0,0,0.0,0.0,0.0
113576496.0,6,34,2488,18,1348,6668284.352941177,139.0,74.88888888888889,16,1140,7557387.533333333,123.0,71.25
45047.0,6,14,4740,7,653,7171.833333333333,249.0,93.28571428571428,7,4087,5546.833333333333,1514.0,583.8571428571429
47922651.0,6,8,1940,3,887,22967747.0,753.0,295.6666666666667,5,1053,11207611.25,785.0,210.6
162345.0,17,2,180,1,90,0.0,90.0,90.0,1,90,0.0,90.0,90.0
120044744.0,17,29,13785,29,13785,4287312.285714285,501.0,475.3448275862069,0,0,0.0,0.0,0.0
1046571.0,6,13,1386,7,789,174428.5,253.0,112.71428571428572,6,597,206290.6,259.0,99.5
3009476.0,6,12,2172,7,664,501020.1666666667,252.0,94.85714285714286,5,1508,2818.5,1236.0,301.6
35268.0,6,14,4740,7,653,5716.333333333333,249.0,93.28571428571428,7,4087,5188.333333333333,1514.0,583.8571428571429
32254.0,6,14,4740,7,653,5255.166666666667,249.0,93.28571428571428,7,4087,4689.666666666667,1514.0,583.8571428571429
2040.0,17,4,344,2,150,0.0,75.0,75.0,2,194,0.0,103.0,97.0
2277.0,17,4,344,2,150,0.0,75.0,75.0,2,194,0.0,103.0,97.0
9046.0,17,2,582,1,83,0.0,83.0,83.0,1,499,0.0,499.0,499.0
2307.0,17,4,344,2,150,0.0,75.0,75.0,2,194,0.0,103.0,97.0
101908.0,17,2,286,2,286,0.0,143.0,143.0,0,0,0.0,0.0,0.0
143922.0,17,2,180,1,90,0.0,90.0,90.0,1,90,0.0,90.0,90.0
90022484.0,17,28,13364,28,13364,3334166.074074074,501.0,477.2857142857143,0,0,0.0,0.0,0.0
46935.0,6,14,4740,7,653,7371.666666666667,249.0,93.28571428571428,7,4087,6550.0,1514.0,583.8571428571429
1307199.0,6,4,264,2,132,0.0,66.0,66.0,2,132,0.0,66.0,66.0
32679629.0,6,5,336,2,134,0.0,68.0,67.0,3,202,14950216.0,70.0,67.33333333333333
861042.0,6,9,1196,6,725,172208.4,387.0,120.83333333333331,3,471,292724.0,331.0,157.0
1310145.0,6,4,264,2,132,0.0,66.0,66.0,2,132,0.0,66.0,66.0
228385.0,17,2,180,1,90,0.0,90.0,90.0,1,90,0.0,90.0,90.0
110142063.0,17,14,864,7,432,18334542.166666668,174.0,61.71428571428572,7,432,18333494.5,174.0,61.71428571428572
148520.0,6,3,337,2,214,0.0,160.0,107.0,1,123,0.0,123.0,123.0
148465.0,17,4,1524,4,1524,49488.333333333336,381.0,381.0,0,0,0.0,0.0,0.0
19567.0,6,14,4740,7,653,3152.5,249.0,93.28571428571428,7,4087,3074.833333333333,1514.0,583.8571428571429
4355.0,17,2,598,1,72,0.0,72.0,72.0,1,526,0.0,526.0,526.0
2309.0,17,4,344,2,150,0.0,75.0,75.0,2,194,0.0,103.0,97.0
1326503.0,6,4,264,2,132,0.0,66.0,66.0,2,132,0.0,66.0,66.0
297621.0,6,6,412,4,272,99207.0,74.0,68.0,2,140,0.0,74.0,70.0
44711.0,6,10,2032,5,524,10958.75,252.0,104.8,5,1508,10307.5,1236.0,301.6
135129678.0,17,6,1146,6,1146,27025935.6,191.0,191.0,0,0,0.0,0.0,0.0
99805706.0,17,12,778,6,389,19961141.2,174.0,64.83333333333333,6,389,19911658.4,174.0,64.83333333333333
10465671.0,6,7,478,4,272,3443024.333333333,74.0,68.0,3,206,5164427.5,74.0,68.66666666666667
48546.0,6,10,2032,5,524,10586.0,252.0,104.8,5,1508,10275.5,1236.0,301.6
0.0,6,1,66,0,0,0.0,0.0,0.0,1,66,0.0,66.0,66.0
105650974.0,6,44,2904,22,1452,5030998.761904762,66.0,66.0,22,1452,5020708.285714285,66.0,66.0
9193.0,6,10,2032,5,524,2076.75,252.0,104.8,5,1508,1725.0,1236.0,301.6
103922.0,17,2,286,2,286,0.0,143.0,143.0,0,0,0.0,0.0,0.0
234077.0,17,2,180,1,90,0.0,90.0,90.0,1,90,0.0,90.0,90.0
406036.0,6,3,1604,1,753,0.0,753.0,753.0,2,851,0.0,785.0,425.5
2882717.0,6,4,270,2,134,0.0,68.0,67.0,2,136,0.0,70.0,68.0
95547.0,17,2,762,2,762,0.0,381.0,381.0,0,0,0.0,0.0,0.0
296754.0,17,2,180,1,90,0.0,90.0,90.0,1,90,0.0,90.0,90.0
197054.0,17,2,180,1,90,0.0,90.0,90.0,1,90,0.0,90.0,90.0
153539.0,17,2,180,1,90,0.0,90.0,90.0,1,90,0.0,90.0,90.0
508691.0,6,5,336,2,134,0.0,68.0,67.0,3,202,192705.0,70.0,67.33333333333333
5625060.0,6,5,336,2,134,0.0,68.0,67.0,3,202,1419721.0,70.0,67.33333333333333
96723125.0,17,12,778,6,389,19312605.8,174.0,64.83333333333333,6,389,19016887.4,174.0,64.83333333333333
28112.0,6,10,2032,5,524,6795.0,252.0,104.8,5,1508,6757.25,1236.0,301.6
40624.0,6,10,2032,5,524,9297.5,252.0,104.8,5,1508,9006.75,1236.0,301.6
142979.0,6,11,2098,6,590,28300.0,252.0,98.33333333333331,5,1508,32050.0,1236.0,301.6
21060.0,6,10,2032,5,524,4356.5,252.0,104.8,5,1508,4792.75,1236.0,301.6
26521.0,17,2,582,1,83,0.0,83.0,83.0,1,499,0.0,499.0,499.0
39645962.0,6,5,336,2,134,0.0,68.0,67.0,3,202,19746114.5,70.0,67.33333333333333
2599949.0,6,2,132,1,66,0.0,66.0,66.0,1,66,0.0,66.0,66.0
98000819.0,17,11,735,6,389,19600163.8,174.0,64.83333333333333,5,346,19500445.25,174.0,69.2
120127422.0,6,17,2556,10,1392,13347491.333333334,188.0,139.2,7,1164,15016001.166666666,204.0,166.28571428571428
317506.0,17,4,1400,4,1400,105835.33333333331,350.0,350.0,0,0,0.0,0.0,0.0
231175.0,6,13,1386,7,789,38529.16666666666,253.0,112.71428571428572,6,597,45275.2,259.0,99.5
14994.0,6,14,4740,7,653,2271.0,249.0,93.28571428571428,7,4087,2361.833333333333,1514.0,583.8571428571429
206558.0,6,3,426,2,280,0.0,214.0,140.0,1,146,0.0,146.0,146.0
217584.0,6,4,492,2,280,0.0,214.0,140.0,2,212,0.0,146.0,106.0
21110.0,6,14,4740,7,653,3390.333333333333,249.0,93.28571428571428,7,4087,3381.333333333333,1514.0,583.8571428571429
6929.0,17,2,762,2,762,0.0,381.0,381.0,0,0,0.0,0.0,0.0
33742.0,6,14,4740,7,653,5463.333333333333,249.0,93.28571428571428,7,4087,4732.333333333333,1514.0,583.8571428571429
190416.0,17,4,1400,4,1400,63472.0,350.0,350.0,0,0,0.0,0.0,0.0
41588.0,6,10,2032,5,524,9225.75,252.0,104.8,5,1508,10024.75,1236.0,301.6
47994.0,6,14,4740,7,653,7869.166666666667,249.0,93.28571428571428,7,4087,7860.666666666667,1514.0,583.8571428571429
108108929.0,17,5,1005,5,1005,27027232.25,201.0,201.0,0,0,0.0,0.0,0.0
90018185.0,17,28,13364,28,13364,3334006.851851852,501.0,477.2857142857143,0,0,0.0,0.0,0.0
45037382.0,6,6,1808,4,987,15012460.666666666,785.0,246.75,2,821,0.0,753.0,410.5
2624483.0,6,3,204,2,136,0.0,70.0,68.0,1,68,0.0,68.0,68.0
149569402.0,6,24,1788,12,894,10890010.727272728,95.0,74.5,12,894,13596523.090909092,95.0,74.5
59735.0,6,14,4740,7,653,8910.833333333334,249.0,93.28571428571428,7,4087,9598.666666666666,1514.0,583.8571428571429
20160.0,6,20,7606,11,978,2016.0,310.0,88.9090909090909,9,6628,2194.5,1514.0,736.4444444444445
39669.0,6,14,4740,7,653,4797.0,249.0,93.28571428571428,7,4087,6322.5,1514.0,583.8571428571429
201201.0,17,4,6056,4,6056,67067.0,1514.0,1514.0,0,0,0.0,0.0,0.0
119858991.0,6,14,2102,5,1020,29964175.0,204.0,204.0,9,1082,14982229.375,188.0,120.22222222222224
32813.0,6,14,4740,7,653,5310.833333333333,249.0,93.28571428571428,7,4087,4768.5,1514.0,583.8571428571429
8513.0,6,10,1067,5,536,1961.25,264.0,107.2,5,531,1862.75,259.0,106.2
884331.0,6,12,2718,7,743,147388.5,339.0,106.14285714285714,5,1975,151265.25,1514.0,395.0
496565.0,6,4,270,2,134,0.0,68.0,67.0,2,136,0.0,70.0,68.0
256064.0,6,3,337,2,214,0.0,160.0,107.0,1,123,0.0,123.0,123.0
534078.0,6,4,270,2,134,0.0,68.0,67.0,2,136,0.0,70.0,68.0
104287913.0,17,14,864,7,432,17333488.666666668,174.0,61.71428571428572,7,432,17334360.0,174.0,61.71428571428572
254466.00000000003,6,3,337,2,214,0.0,160.0,107.0,1,123,0.0,123.0,123.0
103109.0,17,2,286,2,286,0.0,143.0,143.0,0,0,0.0,0.0,0.0
310.0,17,2,174,1,79,0.0,79.0,79.0,1,95,0.0,95.0,95.0
5622751.0,6,5,336,2,134,0.0,68.0,67.0,3,202,1420917.0,70.0,67.33333333333333
205709.0,17,2,180,1,90,0.0,90.0,90.0,1,90,0.0,90.0,90.0
103902475.0,6,33,2428,17,1288,6493904.6875,139.0,75.76470588235294,16,1140,6912411.2,123.0,71.25
1192452.0,6,13,3010,8,2382,170350.2857142857,1514.0,297.75,5,628,229192.5,331.0,125.6
135129559.0,17,6,1146,6,1146,27025911.8,191.0,191.0,0,0,0.0,0.0,0.0
123455572.0,6,48,3168,24,1584,4983585.173913044,66.0,66.0,24,1584,5284361.130434782,66.0,66.0
10472188.0,6,7,478,4,272,3445252.6666666665,74.0,68.0,3,206,5167763.0,74.0,68.66666666666667
107009482.0,6,43,2838,22,1452,5081005.761904762,66.0,66.0,21,1386,5150433.85,66.0,66.0
3004610.0,6,2,132,1,66,0.0,66.0,66.0,1,66,0.0,66.0,66.0
276144.0,6,10,1221,6,636,55228.8,298.0,106.0,4,585,86662.66666666667,379.0,146.25
135139532.0,17,6,1146,6,1146,27027906.4,191.0,191.0,0,0,0.0,0.0,0.0
298989.0,6,6,412,4,272,99663.0,74.0,68.0,2,140,0.0,74.0,70.0
1165413.0,6,13,3009,8,2381,166487.57142857142,1514.0,297.625,5,628,222411.5,331.0,125.6
347.0,17,2,250,1,93,0.0,93.0,93.0,1,157,0.0,157.0,157.0
15522.0,6,10,2032,5,524,3624.25,252.0,104.8,5,1508,3452.0,1236.0,301.6
92777298.0,6,175,19716,88,6030,1066405.7241379311,140.0,68.52272727272727,87,13686,1066751.546511628,284.0,157.31034482758622
42470.0,6,10,2032,5,524,9434.25,252.0,104.8,5,1508,7223.25,1236.0,301.6
14727.0,6,11,1133,6,602,2607.0,264.0,100.33333333333331,5,531,3110.75,259.0,106.2
143087.0,17,4,704,2,148,0.0,74.0,74.0,2,556,0.0,280.0,278.0
120010632.0,6,22,1841,11,840,12001063.2,95.0,76.36363636363636,11,1001,9001300.6,256.0,91.0
135144730.0,17,6,1206,6,1206,27028946.0,201.0,201.0,0,0,0.0,0.0,0.0
301413.0,6,6,412,4,272,100471.0,74.0,68.0,2,140,0.0,74.0,70.0
892.0,17,5,550,5,550,223.0,110.0,110.0,0,0,0.0,0.0,0.0
302945.0,6,6,412,4,272,100981.66666666669,74.0,68.0,2,140,0.0,74.0,70.0
123455672.0,6,49,3234,25,1650,5143986.333333333,66.0,66.0,24,1584,4969830.956521739,66.0,66.0
317159.0,17,4,1400,4,1400,105719.66666666669,350.0,350.0,0,0,0.0,0.0,0.0
114712156.0,6,36,2596,18,1348,6747773.882352941,139.0,74.88888888888889,18,1248,6735047.470588235,123.0,69.33333333333333
197194.0,17,2,180,1,90,0.0,90.0,90.0,1,90,0.0,90.0,90.0
59421.0,6,14,4740,7,653,8812.666666666666,249.0,93.28571428571428,7,4087,9333.666666666666,1514.0,583.8571428571429
3082159.0,6,3,1602,2,850,0.0,784.0,425.0,1,752,0.0,752.0,752.0
2460.0,17,4,344,2,150,0.0,75.0,75.0,2,194,0.0,103.0,97.0
113309599.0,6,45,2970,23,1518,5150436.318181818,66.0,66.0,22,1452,5001582.19047619,66.0,66.0
11257241.0,17,4,1368,4,1368,3752413.6666666665,342.0,342.0,0,0,0.0,0.0,0.0
10460709.0,6,7,478,4,272,3441524.6666666665,74.0,68.0,3,206,5162076.5,74.0,68.66666666666667
119378812.0,6,33,2274,17,1125,7461175.75,123.0,66.17647058823529,16,1149,7278505.2,123.0,71.8125
2023.0,17,4,344,2,150,0.0,75.0,75.0,2,194,0.0,103.0,97.0
135137748.0,17,6,1206,6,1206,27027549.6,201.0,201.0,0,0,0.0,0.0,0.0
1302384.0,6,4,264,2,132,0.0,66.0,66.0,2,132,0.0,66.0,66.0
245331.0,6,3,337,2,214,0.0,160.0,107.0,1,123,0.0,123.0,123.0
14532.0,6,14,4740,7,653,2219.1666666666665,249.0,93.28571428571428,7,4087,2287.1666666666665,1514.0,583.8571428571429
107552.0,17,2,286,2,286,0.0,143.0,143.0,0,0,0.0,0.0,0.0
0.0,17,1,44,1,44,0.0,44.0,44.0,0,0,0.0,0.0,0.0
104985692.0,17,15,5130,15,5130,7498978.0,342.0,342.0,0,0,0.0,0.0,0.0
146943.0,6,3,373,2,238,0.0,172.0,119.0,1,135,0.0,135.0,135.0
125938206.0,6,33,2280,17,1209,7871137.875,123.0,71.11764705882354,16,1071,7715833.4,123.0,66.9375
91293755.0,17,12,778,6,389,18200690.2,174.0,64.83333333333333,6,389,18200165.8,174.0,64.83333333333333
135127535.0,17,6,1146,6,1146,27025507.0,191.0,191.0,0,0,0.0,0.0,0.0
306364.0,6,6,412,4,272,102121.33333333331,74.0,68.0,2,140,0.0,74.0,70.0
1025236.0,6,10,1221,6,636,205047.2,298.0,106.0,4,585,340696.3333333334,379.0,146.25
23132.0,6,10,2032,5,524,5565.25,252.0,104.8,5,1508,5517.75,1236.0,301.6
90286236.0,6,16,1192,8,596,12891593.0,95.0,74.5,8,596,12897181.285714284,95.0,74.5
28424.0,6,14,4740,7,653,4460.5,249.0,93.28571428571428,7,4087,4602.666666666667,1514.0,583.8571428571429
311801.0,6,6,412,4,272,103933.66666666669,74.0,68.0,2,140,0.0,74.0,70.0
4268431.0,6,187,153034,107,143452,40268.21698113208,1510.0,1340.6728971962616,80,9582,50164.696202531646,1510.0,119.775
120024070.0,6,251,28730,126,8538,960192.56,140.0,67.76190476190476,125,20192,959557.0725806452,284.0,161.536
31825.0,6,11,2098,6,590,6047.6,252.0,98.33333333333331,5,1508,7414.25,1236.0,301.6
351.0,17,2,174,1,79,0.0,79.0,79.0,1,95,0.0,95.0,95.0
2410.0,17,4,344,2,150,0.0,75.0,75.0,2,194,0.0,103.0,97.0
29386.0,6,14,4740,7,653,4660.333333333333,249.0,93.28571428571428,7,4087,4264.166666666667,1514.0,583.8571428571429
0.0,17,1,72,1,72,0.0,72.0,72.0,0,0,0.0,0.0,0.0
53651.0,6,10,2032,5,524,8542.75,252.0,104.8,5,1508,12382.5,1236.0,301.6
17963.0,6,14,4740,7,653,2663.833333333333,249.0,93.28571428571428,7,4087,2801.0,1514.0,583.8571428571429
102324662.0,6,42,2772,21,1386,5105437.4,66.0,66.0,21,1386,5105436.4,66.0,66.0
2397.0,17,4,344,2,150,0.0,75.0,75.0,2,194,0.0,103.0,97.0
1549825.0,6,18,6507,10,1598,172202.77777777778,505.0,159.8,8,4909,178004.2857142857,1510.0,613.625
236361.0,6,3,337,2,214,0.0,160.0,107.0,1,123,0.0,123.0,123.0
46760.0,6,14,4740,7,653,7126.5,249.0,93.28571428571428,7,4087,6894.333333333333,1514.0,583.8571428571429
113634556.0,6,211,23786,105,16494,1088219.2307692308,284.0,157.0857142857143,106,7292,1080184.6952380952,140.0,68.79245283018868
98039.0,17,2,762,2,762,0.0,381.0,381.0,0,0,0.0,0.0,0.0
135134891.0,17,6,1146,6,1146,27026978.2,191.0,191.0,0,0,0.0,0.0,0.0
102680.0,17,2,286,2,286,0.0,143.0,143.0,0,0,0.0,0.0,0.0
60966.0,6,14,4740,7,653,9979.333333333334,249.0,93.28571428571428,7,4087,8823.0,1514.0,583.8571428571429
21399.0,17,2,582,1,83,0.0,83.0,83.0,1,499,0.0,499.0,499.0
9911.0,17,2,539,1,86,0.0,86.0,86.0,1,453,0.0,453.0,453.0
16444.0,6,19,7540,11,978,1644.4,310.0,88.9090909090909,8,6562,2027.571428571429,1514.0,820.25
111022242.0,6,32,2236,16,1165,7387091.266666667,139.0,72.8125,16,1071,7387090.466666667,123.0,66.9375
233063.0,6,3,337,2,214,0.0,160.0,107.0,1,123,0.0,123.0,123.0
303989.0,6,6,412,4,272,101329.66666666669,74.0,68.0,2,140,0.0,74.0,70.0
24214.0,6,10,2032,5,524,5817.5,252.0,104.8,5,1508,4310.25,1236.0,301.6
90298047.0,6,16,1192,8,596,12893040.42857143,95.0,74.5,8,596,12899343.142857144,95.0,74.5
135140651.0,17,6,1206,6,1206,27028130.2,201.0,201.0,0,0,0.0,0.0,0.0
1303248.0,6,4,264,2,132,0.0,66.0,66.0,2,132,0.0,66.0,66.0
2598528.0,6,2,132,1,66,0.0,66.0,66.0,1,66,0.0,66.0,66.0
130425.0,6,3,337,2,214,0.0,160.0,107.0,1,123,0.0,123.0,123.0
608422.0,17,2,346,1,78,0.0,78.0,78.0,1,268,0.0,268.0,268.0
108103898.0,17,5,1005,5,1005,27025974.5,201.0,201.0,0,0,0.0,0.0,0.0
2594135.0,6,2,132,1,66,0.0,66.0,66.0,1,66,0.0,66.0,66.0
252502.0,17,2,180,1,90,0.0,90.0,90.0,1,90,0.0,90.0,90.0
2452.0,17,4,344,2,150,0.0,75.0,75.0,2,194,0.0,103.0,97.0
108108737.0,17,5,955,5,955,27027184.25,191.0,191.0,0,0,0.0,0.0,0.0
74090.0,6,14,4740,7,653,10297.0,249.0,93.28571428571428,7,4087,11361.5,1514.0,583.8571428571429
135125948.0,17,6,1206,6,1206,27025189.6,201.0,201.0,0,0,0.0,0.0,0.0
108102753.0,17,5,1005,5,1005,27025688.25,201.0,201.0,0,0,0.0,0.0,0.0
205400.0,17,3,1143,3,1143,102700.0,381.0,381.0,0,0,0.0,0.0,0.0
3169656.0,6,18,1495,9,921,358270.5,315.0,102.33333333333331,9,574,358246.125,78.0,63.77777777777778
85431.0,6,10,2032,5,524,19658.25,252.0,104.8,5,1508,17659.25,1236.0,301.6
284121.0,17,2,363,1,79,0.0,79.0,79.0,1,284,0.0,284.0,284.0
20505.0,6,14,4740,7,653,3219.0,249.0,93.28571428571428,7,4087,2416.1666666666665,1514.0,583.8571428571429
67610.0,6,14,4740,7,653,11062.833333333334,249.0,93.28571428571428,7,4087,11061.166666666666,1514.0,583.8571428571429
120238029.0,6,216,24424,108,7424,1116033.2242990655,140.0,68.74074074074075,108,17000,1096609.0373831776,284.0,157.40740740740742
169775.0,17,2,180,1,90,0.0,90.0,90.0,1,90,0.0,90.0,90.0
120127127.0,6,13,2036,5,1020,30031781.75,204.0,204.0,8,1016,17137221.85714286,188.0,127.0
100513147.0,17,12,516,6,258,20000179.4,43.0,43.0,6,258,20001312.4,43.0,43.0
296.0,17,2,164,1,82,0.0,82.0,82.0,1,82,0.0,82.0,82.0
233079.0,6,3,337,2,214,0.0,160.0,107.0,1,123,0.0,123.0,123.0
47597347.0,6,8,1940,3,887,22471498.0,753.0,295.6666666666667,5,1053,11259170.5,785.0,210.6
58892.0,6,10,2032,5,524,14396.5,252.0,104.8,5,1508,11876.5,1236.0,301.6
153462.0,17,2,180,1,90,0.0,90.0,90.0,1,90,0.0,90.0,90.0
115135642.0,6,39,3024,21,1638,5756782.1,123.0,78.0,18,1386,6759963.470588235,123.0,77.0
242584.0,6,3,337,2,214,0.0,160.0,107.0,1,123,0.0,123.0,123.0
53084007.0,6,27,11527,15,2262,3791714.785714286,408.0,150.8,12,9265,4515132.818181818,1514.0,772.0833333333334
116613457.0,6,210,23774,105,16622,1119214.8076923075,284.0,158.3047619047619,105,7152,1119214.5673076925,140.0,68.11428571428571
367.0,17,2,762,2,762,0.0,381.0,381.0,0,0,0.0,0.0,0.0
102751.0,6,10,2032,5,524,24438.75,252.0,104.8,5,1508,25352.0,1236.0,301.6
216578.0,17,2,180,1,90,0.0,90.0,90.0,1,90,0.0,90.0,90.0
92363858.0,6,27,2073,15,1138,6595848.357142857,95.0,75.86666666666666,12,935,8395602.090909092,95.0,77.91666666666667
68017.0,6,12,1320,7,789,11336.166666666666,253.0,112.71428571428572,5,531,15659.0,259.0,106.2
92195900.0,6,176,19872,88,6030,1055531.4942528736,140.0,68.52272727272727,88,13842,1050238.08045977,284.0,157.29545454545453
2094.0,17,4,344,2,150,0.0,75.0,75.0,2,194,0.0,103.0,97.0
122688007.0,6,49,3234,25,1650,5112000.291666667,66.0,66.0,24,1584,4960971.347826087,66.0,66.0
103345.0,17,2,762,2,762,0.0,381.0,381.0,0,0,0.0,0.0,0.0
10422238.0,6,7,478,4,272,3428827.0,74.0,68.0,3,206,5143079.5,74.0,68.66666666666667
141208.0,6,2,132,1,66,0.0,66.0,66.0,1,66,0.0,66.0,66.0
29452.0,6,14,4740,7,653,4437.5,249.0,93.28571428571428,7,4087,4413.833333333333,1514.0,583.8571428571429
207859.0,6,3,426,2,280,0.0,214.0,140.0,1,146,0.0,146.0,146.0
10482153.0,6,7,478,4,272,3448871.6666666665,74.0,68.0,3,206,5173190.0,74.0,68.66666666666667
401.0,17,2,166,1,75,0.0,75.0,75.0,1,91,0.0,91.0,91.0
110554154.0,6,33,2296,17,1225,6909634.625,139.0,72.05882352941177,16,1071,6690203.0,123.0,66.9375
4190.0,17,4,344,2,150,0.0,75.0,75.0,2,194,0.0,103.0,97.0
186951.0,17,4,1524,4,1524,62317.0,381.0,381.0,0,0,0.0,0.0,0.0
216280.0,17,2,180,1,90,0.0,90.0,90.0,1,90,0.0,90.0,90.0
144953.0,17,2,180,1,70,0.0,70.0,70.0,1,110,0.0,110.0,110.0
12912.0,6,14,4740,7,653,1955.3333333333333,249.0,93.28571428571428,7,4087,1999.0,1514.0,583.8571428571429
55986.0,6,14,4740,7,653,9066.833333333334,249.0,93.28571428571428,7,4087,8790.0,1514.0,583.8571428571429
302291.0,6,3,202,2,128,0.0,74.0,64.0,1,74,0.0,74.0,74.0
197543.0,17,2,180,1,90,0.0,90.0,90.0,1,90,0.0,90.0,90.0
120000969.0,17,13,559,7,301,20000161.5,43.0,43.0,6,258,20001453.4,43.0,43.0
104405.0,17,2,286,2,286,0.0,143.0,143.0,0,0,0.0,0.0,0.0
205784.0,6,10,1221,6,636,41156.8,298.0,106.0,4,585,67390.0,379.0,146.25
108001169.0,17,13,821,7,432,18000194.833333332,174.0,61.71428571428572,6,389,17600790.8,174.0,64.83333333333333
233656.0,6,3,337,2,214,0.0,160.0,107.0,1,123,0.0,123.0,123.0
322158.0,17,4,1400,4,1400,107386.0,350.0,350.0,0,0,0.0,0.0,0.0
105368337.0,6,33,2428,17,1288,6585521.0625,139.0,75.76470588235294,16,1140,7010897.933333334,123.0,71.25
409.0,17,2,267,1,83,0.0,83.0,83.0,1,184,0.0,184.0,184.0
309880.0,6,6,412,4,272,103293.33333333331,74.0,68.0,2,140,0.0,74.0,70.0
62929527.0,17,11,3770,10,3420,4531628.555555556,342.0,342.0,1,350,0.0,350.0,350.0
50511.0,6,2,145,2,145,0.0,91.0,72.5,0,0,0.0,0.0,0.0
9004596.0,17,4,316,4,316,3001532.0,79.0,79.0,0,0,0.0,0.0,0.0
90255203.0,6,13,2036,8,1016,12893600.42857143,188.0,127.0,5,1020,22522012.0,204.0,204.0
90028953.0,17,28,13364,28,13364,3334405.6666666665,501.0,477.2857142857143,0,0,0.0,0.0,0.0
160134.0,17,2,180,1,90,0.0,90.0,90.0,1,90,0.0,90.0,90.0
135541.0,6,2,132,1,66,0.0,66.0,66.0,1,66,0.0,66.0,66.0
288759.0,6,12,1373,7,714,48126.5,298.0,102.0,5,659,68209.0,379.0,131.8
501252.00000000006,6,5,336,2,134,0.0,68.0,67.0,3,202,196544.5,70.0,67.33333333333333
5827745.0,6,4,270,2,134,0.0,68.0,67.0,2,136,0.0,70.0,68.0
11885.0,6,13,1459,7,862,1746.3333333333333,271.0,123.14285714285714,6,597,2214.4,259.0,99.5
82979076.0,17,14,4796,13,4446,6243036.833333333,342.0,342.0,1,350,0.0,350.0,350.0
40844.0,6,14,4740,7,653,6569.833333333333,249.0,93.28571428571428,7,4087,5782.5,1514.0,583.8571428571429
324.0,17,2,166,1,75,0.0,75.0,75.0,1,91,0.0,91.0,91.0
1489810.0,6,4,276,2,128,0.0,74.0,64.0,2,148,0.0,74.0,74.0
108103521.0,17,5,955,5,955,27025880.25,191.0,191.0,0,0,0.0,0.0,0.0
59704.0,6,14,4740,7,653,8973.0,249.0,93.28571428571428,7,4087,9810.5,1514.0,583.8571428571429
4649.0,17,4,809,2,144,0.0,72.0,72.0,2,665,0.0,538.0,332.5
120048936.0,17,28,13364,28,13364,4446256.888888889,501.0,477.2857142857143,0,0,0.0,0.0,0.0
104517.0,17,4,1400,4,1400,34839.0,350.0,350.0,0,0,0.0,0.0,0.0
103696.0,17,2,286,2,286,0.0,143.0,143.0,0,0,0.0,0.0,0.0
57539.0,6,14,4740,7,653,8967.666666666666,249.0,93.28571428571428,7,4087,6539.833333333333,1514.0,583.8571428571429
2059030.0,17,8,1640,4,312,686215.3333333334,78.0,78.0,4,1328,686207.0,332.0,332.0
999267.0,6,12,1354,6,723,198875.6,253.0,120.5,6,631,197248.2,293.0,105.16666666666669
103739419.0,6,493,62442,247,16524,421704.9552845528,140.0,66.89878542510121,246,45918,422503.67346938775,480.0,186.65853658536585
218143.0,6,3,426,2,280,0.0,214.0,140.0,1,146,0.0,146.0,146.0
16849.0,17,2,180,1,90,0.0,90.0,90.0,1,90,0.0,90.0,90.0
135130349.0,17,6,1206,6,1206,27026069.8,201.0,201.0,0,0,0.0,0.0,0.0
99963.0,17,2,762,2,762,0.0,381.0,381.0,0,0,0.0,0.0,0.0
326.0,17,2,174,1,79,0.0,79.0,79.0,1,95,0.0,95.0,95.0
45749.0,6,10,2032,5,524,11115.75,252.0,104.8,5,1508,9630.0,1236.0,301.6
205080.0,17,2,180,1,90,0.0,90.0,90.0,1,90,0.0,90.0,90.0
281459.0,17,2,363,1,79,0.0,79.0,79.0,1,284,0.0,284.0,284.0
10484756.0,6,7,478,4,272,3447953.333333333,74.0,68.0,3,206,5171815.0,74.0,68.66666666666667
5623540.0,6,4,270,2,134,0.0,68.0,67.0,2,136,0.0,70.0,68.0
322925.0,17,4,1400,4,1400,107641.66666666669,350.0,350.0,0,0,0.0,0.0,0.0
108071.0,17,2,286,2,286,0.0,143.0,143.0,0,0,0.0,0.0,0.0
21293.0,6,14,4740,7,653,2848.6666666666665,249.0,93.28571428571428,7,4087,3338.333333333333,1514.0,583.8571428571429
196764.0,17,2,180,1,90,0.0,90.0,90.0,1,90,0.0,90.0,90.0
0.0,6,1,66,1,66,0.0,66.0,66.0,0,0,0.0,0.0,0.0
884671.0,6,10,1334,6,797,176934.2,459.0,132.83333333333334,4,537,203978.0,331.0,134.25
103309475.0,6,42,2772,21,1386,5150438.05,66.0,66.0,21,1386,5150434.85,66.0,66.0
23410.0,6,14,4740,7,653,3735.3333333333335,249.0,93.28571428571428,7,4087,3761.6666666666665,1514.0,583.8571428571429
20715.0,6,14,4740,7,653,2880.0,249.0,93.28571428571428,7,4087,2885.333333333333,1514.0,583.8571428571429
3785259.0,6,5,336,3,202,1527390.5,70.0,67.33333333333333,2,134,0.0,68.0,67.0
15380.0,6,10,2032,5,524,3614.25,252.0,104.8,5,1508,3528.25,1236.0,301.6
363082.0,6,11,1021,6,444,48808.4,162.0,74.0,5,577,60857.5,349.0,115.4
44990.0,6,14,4740,7,653,7374.833333333333,249.0,93.28571428571428,7,4087,7323.833333333333,1514.0,583.8571428571429
0.0,17,1,342,1,342,0.0,342.0,342.0,0,0,0.0,0.0,0.0
1027795.0,6,11,1134,6,558,205559.0,220.0,93.0,5,576,255711.0,304.0,115.2
321239.0,6,6,412,4,272,107079.66666666669,74.0,68.0,2,140,0.0,74.0,70.0
373.0,17,2,174,1,79,0.0,79.0,79.0,1,95,0.0,95.0,95.0
39218.0,6,12,1320,6,723,7265.6,253.0,120.5,6,597,7428.6,259.0,99.5
90036168.0,17,28,13364,28,13364,3334672.888888889,501.0,477.2857142857143,0,0,0.0,0.0,0.0
156269.0,6,3,337,2,214,0.0,160.0,107.0,1,123,0.0,123.0,123.0
309554.0,17,4,1400,4,1400,103184.66666666669,350.0,350.0,0,0,0.0,0.0,0.0
204750.0,17,2,762,2,762,0.0,381.0,381.0,0,0,0.0,0.0,0.0
108106861.0,17,5,955,5,955,27026715.25,191.0,191.0,0,0,0.0,0.0,0.0
108115817.0,17,5,955,5,955,27028954.25,191.0,191.0,0,0,0.0,0.0,0.0
324.0,17,2,174,1,79,0.0,79.0,79.0,1,95,0.0,95.0,95.0
0.0,17,1,347,1,347,0.0,347.0,347.0,0,0,0.0,0.0,0.0
91383471.0,6,22,1680,12,935,8305240.090909091,95.0,77.91666666666667,10,745,10153440.666666666,95.0,74.5
246169.0,6,3,373,2,238,0.0,172.0,119.0,1,135,0.0,135.0,135.0
353.0,17,2,267,1,83,0.0,83.0,83.0,1,184,0.0,184.0,184.0
877027.0,6,12,2718,7,743,146171.16666666666,339.0,106.14285714285714,5,1975,151053.75,1514.0,395.0
51779.0,6,10,1065,5,534,12077.25,262.0,106.8,5,531,12031.75,259.0,106.2
11694707.0,17,4,1368,4,1368,3898235.6666666665,342.0,342.0,0,0,0.0,0.0,0.0
94209722.0,17,12,778,6,389,18600970.6,174.0,64.83333333333333,6,389,18800161.2,174.0,64.83333333333333
107233.0,17,2,286,2,286,0.0,143.0,143.0,0,0,0.0,0.0,0.0
1310089.0,6,4,264,2,132,0.0,66.0,66.0,2,132,0.0,66.0,66.0
730702.0,6,5,336,2,134,0.0,68.0,67.0,3,202,191644.0,70.0,67.33333333333333
17694.0,6,14,4740,7,653,2776.0,249.0,93.28571428571428,7,4087,2813.5,1514.0,583.8571428571429
120124324.0,6,13,2036,5,1020,30031081.0,204.0,204.0,8,1016,17136899.85714286,188.0,127.0
2327.0,17,4,344,2,150,0.0,75.0,75.0,2,194,0.0,103.0,97.0
97085475.0,17,12,778,6,389,19401608.0,174.0,64.83333333333333,6,389,19400166.0,174.0,64.83333333333333
53556.0,6,14,4740,7,653,8763.666666666666,249.0,93.28571428571428,7,4087,8131.166666666667,1514.0,583.8571428571429
299033.0,6,6,412,4,272,99677.66666666669,74.0,68.0,2,140,0.0,74.0,70.0
155124.0,6,3,337,2,214,0.0,160.0,107.0,1,123,0.0,123.0,123.0
220322.0,6,3,426,2,280,0.0,214.0,140.0,1,146,0.0,146.0,146.0
39077.0,6,14,4740,7,653,6288.666666666667,249.0,93.28571428571428,7,4087,5823.166666666667,1514.0,583.8571428571429
5825182.0,6,5,336,2,134,0.0,68.0,67.0,3,202,1523996.5,70.0,67.33333333333333
92009301.0,17,11,735,6,389,18401860.2,174.0,64.83333333333333,5,346,20017503.0,174.0,69.2
221385.0,17,2,180,1,90,0.0,90.0,90.0,1,90,0.0,90.0,90.0
118868925.0,6,39,2902,20,1531,6244890.47368421,139.0,76.55,19,1371,6591840.111111111,123.0,72.15789473684211
152491.0,17,4,6056,4,6056,50830.333333333336,1514.0,1514.0,0,0,0.0,0.0,0.0
437380.0,6,11,1021,6,444,58664.6,162.0,74.0,5,577,73237.25,349.0,115.4
3673523.0,6,177,141855,100,132472,37106.292929292926,1510.0,1324.72,77,9383,44226.07894736842,1510.0,121.85714285714286
113478847.0,6,48,3168,24,1584,4933862.913043479,66.0,66.0,24,1584,4922000.434782608,66.0,66.0
123456037.0,6,49,3234,25,1650,5144001.541666667,66.0,66.0,24,1584,5174785.826086956,66.0,66.0
47553.0,6,10,2032,5,524,11653.0,252.0,104.8,5,1508,11635.75,1236.0,301.6
112000975.0,17,13,821,7,432,18666829.166666668,174.0,61.71428571428572,6,389,18401043.2,174.0,64.83333333333333
126991869.0,17,14,864,7,432,17833503.666666668,174.0,61.71428571428572,7,432,17835338.0,174.0,61.71428571428572
0.0,17,1,438,1,438,0.0,438.0,438.0,0,0,0.0,0.0,0.0
31188.0,6,13,1479,7,882,5198.0,291.0,126.0,6,597,4620.6,259.0,99.5
298689.0,6,6,412,4,272,99563.0,74.0,68.0,2,140,0.0,74.0,70.0
90010536.0,17,28,13364,28,13364,3333723.5555555555,501.0,477.2857142857143,0,0,0.0,0.0,0.0
147967.0,17,2,180,1,90,0.0,90.0,90.0,1,90,0.0,90.0,90.0
90054557.0,17,28,13364,28,13364,3335353.962962963,501.0,477.2857142857143,0,0,0.0,0.0,0.0
108644449.0,6,33,2428,17,1288,6776796.3125,139.0,75.76470588235294,16,1140,7228582.4,123.0,71.25
10470760.0,6,7,478,4,272,3443599.0,74.0,68.0,3,206,5165284.5,74.0,68.66666666666667
2220.0,17,2,691,1,349,0.0,349.0,349.0,1,342,0.0,342.0,342.0
217882.0,6,3,426,2,280,0.0,214.0,140.0,1,146,0.0,146.0,146.0
144820.0,17,2,180,1,70,0.0,70.0,70.0,1,110,0.0,110.0,110.0
36329.0,6,10,2032,5,524,8661.25,252.0,104.8,5,1508,8779.0,1236.0,301.6
507292.0,6,5,336,2,134,0.0,68.0,67.0,3,202,195657.5,70.0,67.33333333333333
3008471.0,6,3,1604,2,851,0.0,785.0,425.5,1,753,0.0,753.0,753.0
276758.0,17,2,180,1,90,0.0,90.0,90.0,1,90,0.0,90.0,90.0
4169.0,17,4,344,2,150,0.0,75.0,75.0,2,194,0.0,103.0,97.0
104571964.0,6,44,2904,22,1452,4979617.333333333,66.0,66.0,22,1452,4964877.333333333,66.0,66.0
113449697.0,6,242,27542,121,19260,943709.2083333334,284.0,159.17355371900825,121,8282,943705.9,140.0,68.44628099173553
2451.0,17,4,344,2,150,0.0,75.0,75.0,2,194,0.0,103.0,97.0
2063.0,17,4,344,2,150,0.0,75.0,75.0,2,194,0.0,103.0,97.0
122687694.0,6,48,3168,24,1584,4997017.173913044,66.0,66.0,24,1584,5211308.956521739,66.0,66.0
242125.0,6,3,373,2,238,0.0,172.0,119.0,1,135,0.0,135.0,135.0
434.0,17,2,410,1,78,0.0,78.0,78.0,1,332,0.0,332.0,332.0
228307.0,17,2,180,1,90,0.0,90.0,90.0,1,90,0.0,90.0,90.0
54486.0,6,14,4740,7,653,8069.5,249.0,93.28571428571428,7,4087,7459.0,1514.0,583.8571428571429
1814.0,17,2,691,1,349,0.0,349.0,349.0,1,342,0.0,342.0,342.0
96075557.0,6,26,1746,13,906,7989250.75,123.0,69.6923076923077,13,840,7989250.083333333,123.0,64.61538461538461
108109505.0,17,5,955,5,955,27027376.25,191.0,191.0,0,0,0.0,0.0,0.0
197173.0,17,2,180,1,90,0.0,90.0,90.0,1,90,0.0,90.0,90.0
2048848.0,17,5,961,3,234,1024235.5,78.0,78.0,2,727,0.0,395.0,363.5
318.0,17,2,164,1,82,0.0,82.0,82.0,1,82,0.0,82.0,82.0
206594.0,17,2,180,1,90,0.0,90.0,90.0,1,90,0.0,90.0,90.0
34286.0,6,11,2098,6,590,6857.2,252.0,98.33333333333331,5,1508,5515.25,1236.0,301.6
100163257.0,17,14,1126,7,563,16666932.333333334,174.0,80.42857142857143,7,563,16666848.0,174.0,80.42857142857143
317.0,17,2,166,1,75,0.0,75.0,75.0,1,91,0.0,91.0,91.0
123102.0,6,3,337,2,214,0.0,160.0,107.0,1,123,0.0,123.0,123.0
308163.0,6,6,412,4,272,102721.0,74.0,68.0,2,140,0.0,74.0,70.0
120122403.0,6,12,1832,8,1016,17137007.714285713,188.0,127.0,4,816,30031275.33333333,204.0,204.0
146054.0,6,3,337,2,214,0.0,160.0,107.0,1,123,0.0,123.0,123.0
1303499.0,6,4,264,2,132,0.0,66.0,66.0,2,132,0.0,66.0,66.0
299746.0,6,6,412,4,272,99915.33333333331,74.0,68.0,2,140,0.0,74.0,70.0
100255.0,17,2,762,2,762,0.0,381.0,381.0,0,0,0.0,0.0,0.0
32022.000000000004,6,2,145,2,145,0.0,91.0,72.5,0,0,0.0,0.0,0.0
120999554.0,6,30,2053,15,948,8330743.571428572,123.0,63.2,15,1105,7929589.857142857,139.0,73.66666666666667
22040.0,6,11,1132,6,556,3398.2,218.0,92.66666666666669,5,576,4865.5,304.0,115.2
80887.0,6,14,4740,7,653,11091.833333333334,249.0,93.28571428571428,7,4087,11169.666666666666,1514.0,583.8571428571429
865005.0,6,9,1270,6,799,173001.0,461.0,133.16666666666666,3,471,294628.5,331.0,157.0
146525.0,6,3,337,2,214,0.0,160.0,107.0,1,123,0.0,123.0,123.0
144783.0,17,2,180,1,70,0.0,70.0,70.0,1,110,0.0,110.0,110.0
90253924.0,6,12,1832,8,1016,12893417.714285716,188.0,127.0,4,816,30030137.33333333,204.0,204.0
51703.0,6,14,4740,7,653,8456.0,249.0,93.28571428571428,7,4087,8477.333333333334,1514.0,583.8571428571429
50271.0,6,10,2032,5,524,12343.25,252.0,104.8,5,1508,10935.25,1236.0,301.6
121162828.0,6,39,2902,20,1531,6376990.947368421,139.0,76.55,19,1371,6164552.166666667,123.0,72.15789473684211
102240239.0,6,42,2772,21,1386,5111999.7,66.0,66.0,21,1386,5111987.2,66.0,66.0
242093.0,6,3,373,2,238,0.0,172.0,119.0,1,135,0.0,135.0,135.0
22256.0,17,2,582,1,83,0.0,83.0,83.0,1,499,0.0,499.0,499.0
235213.0,6,3,337,2,214,0.0,160.0,107.0,1,123,0.0,123.0,123.0
44313.0,6,14,4740,7,653,7146.833333333333,249.0,93.28571428571428,7,4087,7198.5,1514.0,583.8571428571429
142187.0,17,4,571,2,148,0.0,74.0,74.0,2,423,0.0,276.0,211.5
107419.0,17,2,286,2,286,0.0,143.0,143.0,0,0,0.0,0.0,0.0
146835.0,6,3,373,2,238,0.0,172.0,119.0,1,135,0.0,135.0,135.0
90295759.0,6,16,1192,8,596,12892355.42857143,95.0,74.5,8,596,12898737.42857143,95.0,74.5
0.0,17,1,453,1,453,0.0,453.0,453.0,0,0,0.0,0.0,0.0
90757385.0,6,30,2317,17,1287,5669145.25,95.0,75.70588235294117,13,1030,7540446.25,95.0,79.23076923076923
90256825.0,6,16,2368,9,1204,11282103.125,188.0,133.77777777777777,7,1164,15015402.0,204.0,166.28571428571428
7816.0,6,11,2041,6,533,1440.8,195.0,88.83333333333333,5,1508,1687.5,1236.0,301.6
447874.0,6,11,1021,6,444,60764.6,162.0,74.0,5,577,75876.75,349.0,115.4
120339377.0,6,429,88118,217,73608,557126.7453703703,1514.0,339.2073732718894,212,14510,565435.7582938388,214.0,68.44339622641509
54713.0,6,14,4740,7,653,8463.5,249.0,93.28571428571428,7,4087,8368.666666666666,1514.0,583.8571428571429
108113001.0,17,5,1005,5,1005,27028250.25,201.0,201.0,0,0,0.0,0.0,0.0
96435.0,6,2,132,1,66,0.0,66.0,66.0,1,66,0.0,66.0,66.0
90060952.0,17,28,13364,28,13364,3335590.814814815,501.0,477.2857142857143,0,0,0.0,0.0,0.0
90531300.0,6,13,2036,8,1016,12933042.857142856,188.0,127.0,5,1020,22591537.5,204.0,204.0
106797.0,17,2,286,2,286,0.0,143.0,143.0,0,0,0.0,0.0,0.0
299909.0,6,6,412,4,272,99969.66666666669,74.0,68.0,2,140,0.0,74.0,70.0
1303548.0,6,4,264,2,132,0.0,66.0,66.0,2,132,0.0,66.0,66.0
527396.0,17,6,2100,6,2100,105479.2,350.0,350.0,0,0,0.0,0.0,0.0
120119396.0,6,16,2632,9,1204,15014924.5,188.0,133.77777777777777,7,1428,15060416.0,204.0,204.0
322507.0,17,4,1400,4,1400,107502.33333333331,350.0,350.0,0,0,0.0,0.0,0.0
90164399.0,6,21,1713,10,914,9995466.0,223.0,91.4,11,799,8995903.7,95.0,72.63636363636364
90749715.0,6,22,1680,12,894,8246267.363636363,95.0,74.5,10,786,10082246.888888888,95.0,78.6
103864.0,17,2,286,2,286,0.0,143.0,143.0,0,0,0.0,0.0,0.0
310348.0,17,4,1400,4,1400,103449.33333333331,350.0,350.0,0,0,0.0,0.0,0.0
2367433.0,6,49,23728,25,19797,98643.04166666669,1514.0,791.88,24,3931,93030.26086956522,1514.0,163.79166666666666
217272.0,6,3,426,2,280,0.0,214.0,140.0,1,146,0.0,146.0,146.0
2450494.0,6,3,1604,1,753,0.0,753.0,753.0,2,851,0.0,785.0,425.5
509999.0,6,5,336,2,134,0.0,68.0,67.0,3,202,194882.0,70.0,67.33333333333333
63324.00000000001,6,14,4740,7,653,10393.166666666666,249.0,93.28571428571428,7,4087,9166.0,1514.0,583.8571428571429
90033977.0,17,28,13364,28,13364,3334591.7407407407,501.0,477.2857142857143,0,0,0.0,0.0,0.0
105057.0,17,2,700,2,700,0.0,350.0,350.0,0,0,0.0,0.0,0.0
107049717.0,17,14,864,7,432,17834013.0,174.0,61.71428571428572,7,432,17833509.833333332,174.0,61.71428571428572
10449120.0,6,7,478,4,272,3437687.6666666665,74.0,68.0,3,206,5156455.0,74.0,68.66666666666667
18850.0,6,2,145,2,145,0.0,91.0,72.5,0,0,0.0,0.0,0.0
33626.0,6,11,2098,6,590,6525.0,252.0,98.33333333333331,5,1508,8144.5,1236.0,301.6
27149572.0,17,5,1710,5,1710,6787393.0,342.0,342.0,0,0,0.0,0.0,0.0
298915.0,6,6,412,4,272,99638.33333333331,74.0,68.0,2,140,0.0,74.0,70.0
228337.0,17,2,180,1,90,0.0,90.0,90.0,1,90,0.0,90.0,90.0
315780.0,6,6,412,4,272,105260.0,74.0,68.0,2,140,0.0,74.0,70.0
14911.0,17,4,823,2,163,0.0,89.0,81.5,2,660,0.0,443.0,330.0
322791.0,17,4,1400,4,1400,107597.0,350.0,350.0,0,0,0.0,0.0,0.0
4555214.0,6,164,126353,88,117035,52358.7816091954,1510.0,1329.9431818181818,76,9318,56492.56,1510.0,122.60526315789474
146419.0,6,3,337,2,214,0.0,160.0,107.0,1,123,0.0,123.0,123.0
108083878.0,17,5,1005,5,1005,27020969.5,201.0,201.0,0,0,0.0,0.0,0.0
1681866.0,6,22,6443,12,1529,152896.9090909091,357.0,127.41666666666669,10,4914,153063.11111111112,1510.0,491.4
216529.0,17,2,180,1,90,0.0,90.0,90.0,1,90,0.0,90.0,90.0
113273296.0,6,48,3168,24,1584,4924925.913043479,66.0,66.0,24,1584,4920344.652173913,66.0,66.0
3534.0,17,4,344,2,150,0.0,75.0,75.0,2,194,0.0,103.0,97.0
207278.0,6,3,426,2,280,0.0,214.0,140.0,1,146,0.0,146.0,146.0
228217.0,17,2,180,1,90,0.0,90.0,90.0,1,90,0.0,90.0,90.0
113171264.0,6,46,3036,23,1518,5144136.181818182,66.0,66.0,23,1518,5144136.590909091,66.0,66.0
97348027.0,6,301,39018,151,10188,648986.8466666667,140.0,67.47019867549669,150,28830,651874.5570469799,336.0,192.2
892.0,17,4,438,2,148,0.0,74.0,74.0,2,290,0.0,147.0,145.0
1587.0,17,2,192,1,88,0.0,88.0,88.0,1,104,0.0,104.0,104.0
10831954.0,6,8,544,4,272,3565329.333333333,74.0,68.0,4,272,3565260.0,74.0,68.0
135136044.0,17,6,1206,6,1206,27027208.8,201.0,201.0,0,0,0.0,0.0,0.0
12015.0,6,10,1067,5,536,2839.25,264.0,107.2,5,531,2012.0,259.0,106.2
0.0,6,1,66,1,66,0.0,66.0,66.0,0,0,0.0,0.0,0.0
119857895.0,6,16,2234,7,1152,19975675.83333333,204.0,164.57142857142858,9,1082,14982027.375,188.0,120.22222222222224
90020.0,6,14,4740,7,653,14840.333333333334,249.0,93.28571428571428,7,4087,14301.0,1514.0,583.8571428571429
2393.0,17,4,344,2,150,0.0,75.0,75.0,2,194,0.0,103.0,97.0
1190882.0,6,13,3010,8,2382,170126.0,1514.0,297.75,5,628,228829.75,331.0,125.6
120424525.0,6,217,24596,109,17172,1115041.898148148,284.0,157.54128440366972,108,7424,1115912.1028037383,140.0,68.74074074074075
108111023.0,17,5,1005,5,1005,27027755.75,201.0,201.0,0,0,0.0,0.0,0.0
223894.0,6,12,1373,7,714,37315.66666666666,298.0,102.0,5,659,54830.5,379.0,131.8
927.0,17,4,438,2,148,0.0,74.0,74.0,2,290,0.0,147.0,145.0
12042557.0,17,5,2265,5,2265,3010639.25,453.0,453.0,0,0,0.0,0.0,0.0
27064024.0,17,5,1710,5,1710,6766006.0,342.0,342.0,0,0,0.0,0.0,0.0
113995.0,17,4,1400,4,1400,37998.333333333336,350.0,350.0,0,0,0.0,0.0,0.0
104211864.0,6,190,21532,95,15040,1106344.4361702127,284.0,158.31578947368422,95,6492,1106345.7872340423,140.0,68.33684210526316
108294.0,17,2,286,2,286,0.0,143.0,143.0,0,0,0.0,0.0,0.0
39936.0,6,14,4740,7,653,5999.666666666667,249.0,93.28571428571428,7,4087,5818.166666666667,1514.0,583.8571428571429
2977541.0,6,3,1604,1,753,0.0,753.0,753.0,2,851,0.0,785.0,425.5
36825.0,6,14,4740,7,653,4356.5,249.0,93.28571428571428,7,4087,4986.333333333333,1514.0,583.8571428571429
233793.0,6,3,337,2,214,0.0,160.0,107.0,1,123,0.0,123.0,123.0
90267221.0,6,13,2036,8,1016,12895317.285714284,188.0,127.0,5,1020,22525399.0,204.0,204.0
105237519.0,17,15,5130,15,5130,7516965.642857143,342.0,342.0,0,0,0.0,0.0,0.0
12484.0,6,11,1133,6,602,2177.4,264.0,100.33333333333331,5,531,2511.25,259.0,106.2
14642832.0,6,20,1607,10,975,1593087.4444444445,315.0,97.5,10,632,1593058.0,78.0,63.2
2327.0,17,4,344,2,150,0.0,75.0,75.0,2,194,0.0,103.0,97.0
57065.0,6,10,2032,5,524,13641.75,252.0,104.8,5,1508,13967.75,1236.0,301.6
27755.0,6,14,4740,7,653,4501.833333333333,249.0,93.28571428571428,7,4087,4429.166666666667,1514.0,583.8571428571429
143846.0,17,2,180,1,90,0.0,90.0,90.0,1,90,0.0,90.0,90.0
103757.0,17,2,286,2,286,0.0,143.0,143.0,0,0,0.0,0.0,0.0
238835.0,17,2,180,1,90,0.0,90.0,90.0,1,90,0.0,90.0,90.0
5631220.0,6,4,270,2,134,0.0,68.0,67.0,2,136,0.0,70.0,68.0
146115.0,6,3,337,2,214,0.0,160.0,107.0,1,123,0.0,123.0,123.0
52236.0,6,14,4740,7,653,8262.0,249.0,93.28571428571428,7,4087,8558.666666666666,1514.0,583.8571428571429
44860.0,6,13,1386,7,789,7081.0,253.0,112.71428571428572,6,597,7832.2,259.0,99.5
84488.0,6,14,4740,7,653,8089.833333333333,249.0,93.28571428571428,7,4087,13857.666666666666,1514.0,583.8571428571429
109447992.0,6,194,21870,97,15172,1137842.1458333333,284.0,156.41237113402062,97,6698,1137841.9791666667,140.0,69.05154639175258
310571.0,17,4,1400,4,1400,103523.66666666669,350.0,350.0,0,0,0.0,0.0,0.0
304235.0,6,6,412,4,272,101411.66666666669,74.0,68.0,2,140,0.0,74.0,70.0
298745.0,6,6,412,4,272,99581.66666666669,74.0,68.0,2,140,0.0,74.0,70.0
822.0,17,4,438,2,148,0.0,74.0,74.0,2,290,0.0,147.0,145.0
135137714.0,17,6,1146,6,1146,27027542.8,191.0,191.0,0,0,0.0,0.0,0.0
90069131.0,17,28,13364,28,13364,3335893.7407407407,501.0,477.2857142857143,0,0,0.0,0.0,0.0
15132.0,6,10,2032,5,524,3565.75,252.0,104.8,5,1508,3528.25,1236.0,301.6
135130181.0,17,6,1146,6,1146,27026036.2,191.0,191.0,0,0,0.0,0.0,0.0
216339.0,17,2,180,1,90,0.0,90.0,90.0,1,90,0.0,90.0,90.0
108103779.0,17,5,955,5,955,27025944.75,191.0,191.0,0,0,0.0,0.0,0.0
23010.0,6,14,4740,7,653,3654.6666666666665,249.0,93.28571428571428,7,4087,3593.0,1514.0,583.8571428571429
128827.0,6,13,1386,7,789,21471.166666666668,253.0,112.71428571428572,6,597,23505.4,259.0,99.5
99728795.0,6,30,2122,15,1105,7108072.928571428,139.0,73.66666666666667,15,1017,7108072.071428572,123.0,67.8
90034050.0,17,28,13364,28,13364,3334594.4444444445,501.0,477.2857142857143,0,0,0.0,0.0,0.0
246148.0,6,3,337,2,214,0.0,160.0,107.0,1,123,0.0,123.0,123.0
41595.0,6,14,4740,7,653,6626.666666666667,249.0,93.28571428571428,7,4087,6298.0,1514.0,583.8571428571429
90090415.0,6,26,1746,13,906,7489546.083333333,123.0,69.6923076923077,13,840,7489544.666666667,123.0,64.61538461538461
8163.0,17,2,614,1,72,0.0,72.0,72.0,1,542,0.0,542.0,542.0
90367902.0,6,13,2052,6,1224,18072325.2,204.0,204.0,7,828,15060920.833333334,188.0,118.28571428571428
2431000.0,6,3,204,2,136,0.0,70.0,68.0,1,68,0.0,68.0,68.0
236661.0,6,3,337,2,214,0.0,160.0,107.0,1,123,0.0,123.0,123.0
121537203.0,6,257,30190,129,21446,949509.3984375,336.0,166.24806201550388,128,8744,940820.5984251968,140.0,68.3125
1176746.0,6,13,3010,8,2382,168106.57142857142,1514.0,297.75,5,628,225986.0,331.0,125.6
219320.0,6,3,426,2,280,0.0,214.0,140.0,1,146,0.0,146.0,146.0
120511626.0,17,13,821,7,432,20085271.0,174.0,61.71428571428572,6,389,20106577.4,174.0,64.83333333333333
2328.0,17,4,344,2,150,0.0,75.0,75.0,2,194,0.0,103.0,97.0
41415.0,6,10,2032,5,524,10061.25,252.0,104.8,5,1508,10107.25,1236.0,301.6
120123823.0,6,14,2240,6,1224,24024764.6,204.0,204.0,8,1016,17137078.0,188.0,127.0
108113070.0,17,5,1005,5,1005,27028267.5,201.0,201.0,0,0,0.0,0.0,0.0
90039373.0,17,27,12943,27,12943,3463052.8076923075,501.0,479.3703703703704,0,0,0.0,0.0,0.0
130122.0,6,3,337,2,214,0.0,160.0,107.0,1,123,0.0,123.0,123.0
108100787.0,17,5,1005,5,1005,27025196.75,201.0,201.0,0,0,0.0,0.0,0.0
89430.0,6,14,4740,7,653,13236.166666666666,249.0,93.28571428571428,7,4087,14077.833333333334,1514.0,583.8571428571429
256523.0,6,3,337,2,214,0.0,160.0,107.0,1,123,0.0,123.0,123.0
123006158.0,17,15,1169,8,606,17572308.285714287,174.0,75.75,7,563,17166882.0,174.0,80.42857142857143
30252.0,6,14,4740,7,653,4807.833333333333,249.0,93.28571428571428,7,4087,4782.833333333333,1514.0,583.8571428571429
10425723.0,6,6,412,3,206,5144131.0,74.0,68.66666666666667,3,206,5144064.0,74.0,68.66666666666667
308472.0,6,6,412,4,272,102824.0,74.0,68.0,2,140,0.0,74.0,70.0
299991.0,6,6,412,4,272,99997.0,74.0,68.0,2,140,0.0,74.0,70.0
70558.0,6,14,4740,7,653,7321.333333333333,249.0,93.28571428571428,7,4087,11567.0,1514.0,583.8571428571429
2394.0,17,4,344,2,150,0.0,75.0,75.0,2,194,0.0,103.0,97.0
109883448.0,6,28,1860,14,966,8435943.307692308,123.0,69.0,14,894,8435960.461538462,123.0,63.85714285714285
90257038.0,6,12,1832,8,1016,12893862.57142857,188.0,127.0,4,816,30031215.666666668,204.0,204.0
54958.0,6,11,2098,6,590,10359.4,252.0,98.33333333333331,5,1508,11738.5,1236.0,301.6
108100799.0,17,5,1005,5,1005,27025199.75,201.0,201.0,0,0,0.0,0.0,0.0
123250508.0,6,49,3234,25,1650,5135437.833333333,66.0,66.0,24,1584,5144375.913043479,66.0,66.0
10509929.0,6,7,478,4,272,3457515.333333333,74.0,68.0,3,206,5186150.5,74.0,68.66666666666667
1440473.0,6,8,602,5,404,334245.25,103.0,80.8,3,198,204939.0,66.0,66.0
1039618.0,6,13,1386,7,789,173269.66666666666,253.0,112.71428571428572,6,597,205767.8,259.0,99.5
300.0,17,2,168,1,76,0.0,76.0,76.0,1,92,0.0,92.0,92.0
506980.0,6,5,336,2,134,0.0,68.0,67.0,3,202,193073.5,70.0,67.33333333333333
120386057.0,6,319,37548,160,26758,757145.0125786164,300.0,167.2375,159,10790,755430.8607594937,140.0,67.86163522012579
318857.0,6,6,412,4,272,106285.66666666669,74.0,68.0,2,140,0.0,74.0,70.0
122129.0,6,3,337,2,214,0.0,160.0,107.0,1,123,0.0,123.0,123.0
54670.0,6,10,2032,5,524,10502.0,252.0,104.8,5,1508,13141.25,1236.0,301.6
15793.999999999998,6,10,2032,5,524,3626.75,252.0,104.8,5,1508,2928.5,1236.0,301.6
302375.0,6,2,132,1,66,0.0,66.0,66.0,1,66,0.0,66.0,66.0
99603.0,17,2,762,2,762,0.0,381.0,381.0,0,0,0.0,0.0,0.0
120289229.0,6,18,1382,9,691,14999966.5,95.0,76.77777777777777,9,691,15035797.25,95.0,76.77777777777777
121900637.0,6,47,3102,23,1518,5151997.227272728,66.0,66.0,24,1584,5300013.391304348,66.0,66.0
2048.0,17,4,344,2,150,0.0,75.0,75.0,2,194,0.0,103.0,97.0
5011545.0,17,4,1164,2,166,0.0,83.0,83.0,2,998,0.0,499.0,499.0
24267.0,6,10,2032,5,524,5706.25,252.0,104.8,5,1508,5724.5,1236.0,301.6
108106463.0,17,5,955,5,955,27026615.75,191.0,191.0,0,0,0.0,0.0,0.0
34171.0,6,14,4740,7,653,4804.833333333333,249.0,93.28571428571428,7,4087,4838.166666666667,1514.0,583.8571428571429
145374.0,17,2,180,1,70,0.0,70.0,70.0,1,110,0.0,110.0,110.0
309945.0,17,4,1400,4,1400,103315.0,350.0,350.0,0,0,0.0,0.0,0.0
234077.0,6,3,373,2,238,0.0,172.0,119.0,1,135,0.0,135.0,135.0
21473.0,17,2,582,1,83,0.0,83.0,83.0,1,499,0.0,499.0,499.0
35694.0,6,14,4740,7,653,5823.333333333333,249.0,93.28571428571428,7,4087,5734.833333333333,1514.0,583.8571428571429
96534749.0,17,14,1126,7,563,16001199.5,174.0,80.42857142857143,7,563,15999163.333333334,174.0,80.42857142857143
135126675.0,17,6,1206,6,1206,27025335.0,201.0,201.0,0,0,0.0,0.0,0.0
122001173.0,17,15,1169,8,606,17428739.0,174.0,75.75,7,563,17000156.166666668,174.0,80.42857142857143
90259016.0,6,13,2036,8,1016,12894145.142857144,188.0,127.0,5,1020,22523418.75,204.0,204.0
105061.0,17,2,762,2,762,0.0,381.0,381.0,0,0,0.0,0.0,0.0
94907117.0,6,26,1746,13,906,7890942.416666667,123.0,69.6923076923077,13,840,7890923.583333333,123.0,64.61538461538461
313.0,17,2,174,1,79,0.0,79.0,79.0,1,95,0.0,95.0,95.0
120533680.0,6,211,23802,106,16650,1147939.8095238097,284.0,157.0754716981132,105,7152,1149015.923076923,140.0,68.11428571428571
334.0,17,2,174,1,79,0.0,79.0,79.0,1,95,0.0,95.0,95.0
111431378.0,6,27,2235,15,1341,7958458.0,257.0,89.4,12,894,10104312.363636363,95.0,74.5
58966539.0,17,9,3086,8,2736,5117337.0,342.0,342.0,1,350,0.0,350.0,350.0
121265.0,6,3,337,2,214,0.0,160.0,107.0,1,123,0.0,123.0,123.0
5624379.0,6,5,336,2,134,0.0,68.0,67.0,3,202,1418809.0,70.0,67.33333333333333
14638470.0,6,20,1648,10,1016,1592926.3333333333,315.0,101.6,10,632,1592888.2222222222,78.0,63.2
128012716.0,6,35,2473,18,1348,7530159.764705882,139.0,74.88888888888889,17,1125,7421519.375,123.0,66.17647058823529
30340.0,6,10,2032,5,524,7376.0,252.0,104.8,5,1508,7109.5,1236.0,301.6
21985.0,17,2,582,1,83,0.0,83.0,83.0,1,499,0.0,499.0,499.0
236124.0,6,3,373,2,238,0.0,172.0,119.0,1,135,0.0,135.0,135.0
329.0,17,2,166,1,75,0.0,75.0,75.0,1,91,0.0,91.0,91.0
21552.0,6,10,2032,5,524,5145.25,252.0,104.8,5,1508,5095.5,1236.0,301.6
102161780.0,17,14,864,7,432,17000908.333333332,174.0,61.71428571428572,7,432,17000253.0,174.0,61.71428571428572
309568.0,6,6,412,4,272,103189.33333333331,74.0,68.0,2,140,0.0,74.0,70.0
1162443.0,6,13,3012,8,2384,166063.2857142857,1514.0,298.0,5,628,222479.5,331.0,125.6
51707740.0,6,14,982,6,437,10341046.6,95.0,72.83333333333333,8,545,7385732.428571428,95.0,68.125
119573346.0,6,20,1490,10,745,13285927.333333334,95.0,74.5,10,745,13256989.666666666,95.0,74.5
108098291.0,17,5,955,5,955,27024572.75,191.0,191.0,0,0,0.0,0.0,0.0
16070.000000000002,6,10,1067,5,536,3834.0,264.0,107.2,5,531,2374.5,259.0,106.2
1472061.0,17,16,1120,16,1120,98137.4,70.0,70.0,0,0,0.0,0.0,0.0
387705.0,6,3,202,2,128,0.0,74.0,64.0,1,74,0.0,74.0,74.0
16129.999999999998,6,10,2032,5,524,3807.0,252.0,104.8,5,1508,3516.25,1236.0,301.6
309573.0,6,3,202,2,128,0.0,74.0,64.0,1,74,0.0,74.0,74.0
2299.0,17,4,344,2,150,0.0,75.0,75.0,2,194,0.0,103.0,97.0
114354436.0,6,34,2488,18,1348,6714038.411764706,139.0,74.88888888888889,16,1140,7609239.733333333,123.0,71.25
48836054.0,6,8,1940,3,887,22881640.0,753.0,295.6666666666667,5,1053,11514430.75,785.0,210.6
51780.0,6,11,2098,6,590,10215.0,252.0,98.33333333333331,5,1508,12705.25,1236.0,301.6
393.0,17,2,174,1,79,0.0,79.0,79.0,1,95,0.0,95.0,95.0
37783.0,6,14,4740,7,653,6133.0,249.0,93.28571428571428,7,4087,6019.833333333333,1514.0,583.8571428571429
113733975.0,6,46,3036,23,1518,5155441.863636363,66.0,66.0,23,1518,5155448.545454546,66.0,66.0
2867.0,17,2,762,2,762,0.0,381.0,381.0,0,0,0.0,0.0,0.0
4395.0,17,2,614,1,72,0.0,72.0,72.0,1,542,0.0,542.0,542.0
251279.0,6,3,373,2,238,0.0,172.0,119.0,1,135,0.0,135.0,135.0
206022.0,17,2,180,1,90,0.0,90.0,90.0,1,90,0.0,90.0,90.0
103361233.0,6,43,2838,21,1386,5168048.95,66.0,66.0,22,1452,4921951.095238095,66.0,66.0
2058887.0,6,24,7544,12,2450,187171.54545454544,1034.0,204.16666666666663,12,5094,159428.0,1510.0,424.5
102001168.0,17,13,1083,7,563,17000194.666666668,174.0,80.42857142857143,6,520,17101975.4,174.0,86.66666666666667
102089693.0,17,14,864,7,432,16834387.666666668,174.0,61.71428571428572,7,432,16833490.166666668,174.0,61.71428571428572
165.0,17,2,762,2,762,0.0,381.0,381.0,0,0,0.0,0.0,0.0
146319.0,6,3,337,2,214,0.0,160.0,107.0,1,123,0.0,123.0,123.0
300107.0,6,6,412,4,272,100035.66666666669,74.0,68.0,2,140,0.0,74.0,70.0
36943.0,6,14,4740,7,653,5931.5,249.0,93.28571428571428,7,4087,5912.166666666667,1514.0,583.8571428571429
90047667.0,17,28,13364,28,13364,3335098.777777778,501.0,477.2857142857143,0,0,0.0,0.0,0.0
209321.0,17,2,180,1,90,0.0,90.0,90.0,1,90,0.0,90.0,90.0
4567.0,17,2,614,1,72,0.0,72.0,72.0,1,542,0.0,542.0,542.0
106115.0,17,2,700,2,700,0.0,350.0,350.0,0,0,0.0,0.0,0.0
104542.0,17,2,286,2,286,0.0,143.0,143.0,0,0,0.0,0.0,0.0
25619729.0,17,5,1718,4,1368,816675.0,342.0,342.0,1,350,0.0,350.0,350.0
120124338.0,6,13,2036,5,1020,30031084.5,204.0,204.0,8,1016,17137160.57142857,188.0,127.0
257537.00000000003,6,10,1221,6,636,51507.4,298.0,106.0,4,585,80430.33333333333,379.0,146.25
237311.0,17,2,180,1,90,0.0,90.0,90.0,1,90,0.0,90.0,90.0
1168532.0,6,13,3011,8,2383,166933.14285714287,1514.0,297.875,5,628,223350.25,331.0,125.6
13076.0,6,11,2098,6,590,2585.0,252.0,98.33333333333331,5,1508,3038.0,1236.0,301.6
107852.0,17,2,700,2,700,0.0,350.0,350.0,0,0,0.0,0.0,0.0
13058.0,6,11,1132,6,556,2611.6,218.0,92.66666666666669,5,576,2780.75,304.0,115.2
1511.0,17,4,438,2,148,0.0,74.0,74.0,2,290,0.0,147.0,145.0
979640.0,6,13,1513,7,882,162741.5,291.0,126.0,6,631,195534.0,293.0,105.16666666666669
114134271.0,6,48,3168,24,1584,4962359.608695652,66.0,66.0,24,1584,4949099.695652174,66.0,66.0
232473.0,6,3,337,2,214,0.0,160.0,107.0,1,123,0.0,123.0,123.0
21001235.0,17,3,1034,2,684,0.0,342.0,342.0,1,350,0.0,350.0,350.0
29708.0,6,10,2032,5,524,7063.75,252.0,104.8,5,1508,6344.25,1236.0,301.6
5626159.0,6,4,270,2,134,0.0,68.0,67.0,2,136,0.0,70.0,68.0
206434.0,6,3,426,2,280,0.0,214.0,140.0,1,146,0.0,146.0,146.0
90738702.0,6,21,1711,11,799,9069444.3,95.0,72.63636363636364,10,912,10081742.333333334,221.0,91.2
10519203.0,6,7,478,4,272,3460728.333333333,74.0,68.0,3,206,5190983.0,74.0,68.66666666666667
120067111.0,17,29,13785,29,13785,4288111.107142857,501.0,475.3448275862069,0,0,0.0,0.0,0.0
9015.0,6,10,2032,5,524,2026.5,252.0,104.8,5,1508,2016.5,1236.0,301.6
143953.0,17,2,180,1,90,0.0,90.0,90.0,1,90,0.0,90.0,90.0
1064460.0,6,3,1604,1,753,0.0,753.0,753.0,2,851,0.0,785.0,425.5
8720245.0,6,5,1736,2,819,0.0,753.0,409.5,3,917,4291247.5,785.0,305.6666666666667
328.0,17,2,160,1,80,0.0,80.0,80.0,1,80,0.0,80.0,80.0
90057721.0,17,28,13364,28,13364,3335471.1481481483,501.0,477.2857142857143,0,0,0.0,0.0,0.0
67958.0,6,14,4740,7,653,11195.0,249.0,93.28571428571428,7,4087,10381.333333333334,1514.0,583.8571428571429
328.0,17,2,208,1,72,0.0,72.0,72.0,1,136,0.0,136.0,136.0
105858185.0,6,204,22964,102,15936,1046069.207920792,284.0,156.23529411764707,102,7028,1046069.1386138614,140.0,68.90196078431373
0.0,17,1,350,1,350,0.0,350.0,350.0,0,0,0.0,0.0,0.0
2464.0,17,4,344,2,150,0.0,75.0,75.0,2,194,0.0,103.0,97.0
30539.0,6,14,4740,7,653,4807.666666666667,249.0,93.28571428571428,7,4087,4956.5,1514.0,583.8571428571429
299542.0,6,6,412,4,272,99847.33333333331,74.0,68.0,2,140,0.0,74.0,70.0
111179054.0,6,233,26462,117,18584,958440.1206896552,284.0,158.83760683760684,116,7878,957724.0608695652,140.0,67.91379310344827
119529842.0,17,35,16705,35,16705,3515583.588235294,501.0,477.2857142857143,0,0,0.0,0.0,0.0
27438103.0,17,5,1710,5,1710,6859525.75,342.0,342.0,0,0,0.0,0.0,0.0
98468831.0,17,12,778,6,389,19693766.2,174.0,64.83333333333333,6,389,19624783.6,174.0,64.83333333333333
25055.0,6,14,4740,7,653,4006.8333333333335,249.0,93.28571428571428,7,4087,4015.0,1514.0,583.8571428571429
313922.0,17,4,1400,4,1400,104640.66666666669,350.0,350.0,0,0,0.0,0.0,0.0
90533489.0,6,13,2036,8,1016,12933355.57142857,188.0,127.0,5,1020,22592215.75,204.0,204.0
90286484.0,6,16,1192,8,596,12891777.857142856,95.0,74.5,8,596,12896721.57142857,95.0,74.5
317579.0,17,4,1400,4,1400,105859.66666666669,350.0,350.0,0,0,0.0,0.0,0.0
104343.0,17,2,762,2,762,0.0,381.0,381.0,0,0,0.0,0.0,0.0
4608806.0,6,5,336,2,134,0.0,68.0,67.0,3,202,1532451.5,70.0,67.33333333333333
35125.0,6,14,4740,7,653,5682.666666666667,249.0,93.28571428571428,7,4087,4524.166666666667,1514.0,583.8571428571429
69087.0,6,14,4740,7,653,10710.166666666666,249.0,93.28571428571428,7,4087,10916.0,1514.0,583.8571428571429
306690.0,6,6,412,4,272,102230.0,74.0,68.0,2,140,0.0,74.0,70.0
117465598.0,6,205,23136,103,16182,1151623.5098039217,284.0,157.10679611650485,102,6954,1152698.3564356435,140.0,68.17647058823529
310182.0,6,6,412,4,272,103394.0,74.0,68.0,2,140,0.0,74.0,70.0
206222.0,6,3,426,2,280,0.0,214.0,140.0,1,146,0.0,146.0,146.0
379.0,17,2,267,1,83,0.0,83.0,83.0,1,184,0.0,184.0,184.0
2616313.0,6,25,7573,14,3735,201254.84615384616,1514.0,266.7857142857143,11,3838,236475.2,1514.0,348.90909090909093
38333.0,6,14,4740,7,653,6263.5,249.0,93.28571428571428,7,4087,5745.333333333333,1514.0,583.8571428571429
18524.0,6,10,2032,5,524,3537.0,252.0,104.8,5,1508,3496.0,1236.0,301.6
103578787.0,6,28,1860,14,966,7951005.538461538,123.0,69.0,14,894,7951001.769230769,123.0,63.85714285714285
96805795.0,17,12,778,6,389,19200510.4,174.0,64.83333333333333,6,389,19200175.6,174.0,64.83333333333333
228236.0,17,2,180,1,90,0.0,90.0,90.0,1,90,0.0,90.0,90.0
30025025.0,17,14,6682,14,6682,2309617.3076923075,501.0,477.2857142857143,0,0,0.0,0.0,0.0
325688.0,6,6,412,4,272,108562.66666666669,74.0,68.0,2,140,0.0,74.0,70.0
120000034.0,6,17,1287,9,691,15000004.25,95.0,76.77777777777777,8,596,12897561.857142856,95.0,74.5
90240276.0,6,12,1832,8,1016,12891468.0,188.0,127.0,4,816,30023663.0,204.0,204.0
0.0,6,1,172,1,172,0.0,172.0,172.0,0,0,0.0,0.0,0.0
0.0,17,1,381,1,381,0.0,381.0,381.0,0,0,0.0,0.0,0.0
122064.0,6,3,373,2,238,0.0,172.0,119.0,1,135,0.0,135.0,135.0
39293.0,6,10,1975,5,467,9603.5,195.0,93.4,5,1508,2051.75,1236.0,301.6
40578.0,6,14,4740,7,653,6609.333333333333,249.0,93.28571428571428,7,4087,5952.5,1514.0,583.8571428571429
64231.0,6,14,4740,7,653,10142.333333333334,249.0,93.28571428571428,7,4087,10448.833333333334,1514.0,583.8571428571429
120819061.0,6,391,45864,196,32772,619584.9282051282,390.0,167.20408163265307,195,13092,617489.2010309278,140.0,67.13846153846154
90025776.0,17,27,12943,27,12943,3462529.846153846,501.0,479.3703703703704,0,0,0.0,0.0,0.0
857817.0,6,9,1096,6,625,171563.4,287.0,104.16666666666669,3,471,291000.0,331.0,157.0
9481.0,17,2,539,1,86,0.0,86.0,86.0,1,453,0.0,453.0,453.0
120377092.0,6,229,25912,115,18092,1055939.403508772,284.0,157.3217391304348,114,7820,1056070.1769911505,140.0,68.59649122807018
308058.0,6,3,202,2,128,0.0,74.0,64.0,1,74,0.0,74.0,74.0
229244.0,17,4,1524,4,1524,76414.66666666667,381.0,381.0,0,0,0.0,0.0,0.0
579989.0,6,4,508,2,238,0.0,172.0,119.0,2,270,0.0,135.0,135.0
170487.0,6,11,1131,6,600,33716.6,262.0,100.0,5,531,3144.25,259.0,106.2
0.0,6,1,66,1,66,0.0,66.0,66.0,0,0,0.0,0.0,0.0
120000023.0,6,22,1680,12,935,10909093.0,95.0,77.91666666666667,10,745,9949003.444444444,95.0,74.5
15613.0,17,2,180,1,90,0.0,90.0,90.0,1,90,0.0,90.0,90.0
34166.0,6,14,4740,7,653,5111.833333333333,249.0,93.28571428571428,7,4087,4616.166666666667,1514.0,583.8571428571429
51520691.0,6,8,2113,3,960,24439537.0,826.0,320.0,5,1153,12236930.75,885.0,230.6
31268.0,6,14,4740,7,653,5064.5,249.0,93.28571428571428,7,4087,4980.5,1514.0,583.8571428571429
116819023.0,6,48,3168,24,1584,5079087.956521739,66.0,66.0,24,1584,5065416.913043479,66.0,66.0
95281748.0,6,460,61344,230,15402,416071.2794759825,140.0,66.96521739130435,230,45942,412509.81222707423,480.0,199.7478260869565
0.0,6,1,66,1,66,0.0,66.0,66.0,0,0,0.0,0.0,0.0
18339.0,6,14,4740,7,653,2939.0,249.0,93.28571428571428,7,4087,2921.6666666666665,1514.0,583.8571428571429
94396643.0,6,29,2068,15,1105,6727202.357142857,139.0,73.66666666666667,14,963,7244682.923076923,123.0,68.78571428571429
66149220.0,17,11,4983,11,4983,6614922.0,453.0,453.0,0,0,0.0,0.0,0.0
2358919.0,6,49,23728,25,19797,98288.29166666669,1514.0,791.88,24,3931,92798.65217391304,1514.0,163.79166666666666
297.0,17,2,164,1,82,0.0,82.0,82.0,1,82,0.0,82.0,82.0
100677752.0,17,12,778,6,389,20057339.0,174.0,64.83333333333333,6,389,20103360.2,174.0,64.83333333333333
135139137.0,17,6,1146,6,1146,27027827.4,191.0,191.0,0,0,0.0,0.0,0.0
862218.0,6,9,1267,6,796,172443.6,458.0,132.66666666666666,3,471,293024.0,331.0,157.0
45727.0,6,10,2032,5,524,10413.5,252.0,104.8,5,1508,9414.75,1236.0,301.6
293784.0,17,2,246,1,76,0.0,76.0,76.0,1,170,0.0,170.0,170.0
153390.0,17,2,180,1,90,0.0,90.0,90.0,1,90,0.0,90.0,90.0
14645056.0,6,20,1607,10,975,1593229.5555555555,315.0,97.5,10,632,1593206.7777777778,78.0,63.2
38216.0,6,14,4740,7,653,6246.0,249.0,93.28571428571428,7,4087,4605.5,1514.0,583.8571428571429
135144959.0,17,6,1146,6,1146,27028991.8,191.0,191.0,0,0,0.0,0.0,0.0
33580.0,6,14,4740,7,653,4402.0,249.0,93.28571428571428,7,4087,5305.833333333333,1514.0,583.8571428571429
2801307.0,6,2,132,1,66,0.0,66.0,66.0,1,66,0.0,66.0,66.0
110513.0,17,2,286,2,286,0.0,143.0,143.0,0,0,0.0,0.0,0.0
295.0,17,2,164,1,82,0.0,82.0,82.0,1,82,0.0,82.0,82.0
108112148.0,17,5,955,5,955,27028037.0,191.0,191.0,0,0,0.0,0.0,0.0
206884.0,6,3,426,2,280,0.0,214.0,140.0,1,146,0.0,146.0,146.0
316643.0,6,6,412,4,272,105547.66666666669,74.0,68.0,2,140,0.0,74.0,70.0
37973.0,6,14,4740,7,653,6202.5,249.0,93.28571428571428,7,4087,5886.166666666667,1514.0,583.8571428571429
90060540.0,17,28,13364,28,13364,3335575.5555555555,501.0,477.2857142857143,0,0,0.0,0.0,0.0
210714.0,6,10,1221,6,636,42142.8,298.0,106.0,4,585,69301.33333333333,379.0,146.25
109921.0,17,2,286,2,286,0.0,143.0,143.0,0,0,0.0,0.0,0.0
322673.0,6,6,412,4,272,107557.66666666669,74.0,68.0,2,140,0.0,74.0,70.0
146171.0,6,3,337,2,214,0.0,160.0,107.0,1,123,0.0,123.0,123.0
371443.0,6,3,1604,1,753,0.0,753.0,753.0,2,851,0.0,785.0,425.5
1477.0,17,2,762,2,762,0.0,381.0,381.0,0,0,0.0,0.0,0.0
21149.0,6,11,2098,6,590,3763.4,252.0,98.33333333333331,5,1508,4145.0,1236.0,301.6
864870.0,6,9,1196,6,725,172974.0,387.0,120.83333333333331,3,471,294613.5,331.0,157.0
205706.0,17,2,180,1,90,0.0,90.0,90.0,1,90,0.0,90.0,90.0
90024836.0,17,28,13364,28,13364,3334253.185185185,501.0,477.2857142857143,0,0,0.0,0.0,0.0
2799160.0,6,2,132,1,66,0.0,66.0,66.0,1,66,0.0,66.0,66.0
90052452.0,17,28,13364,28,13364,3335276.0,501.0,477.2857142857143,0,0,0.0,0.0,0.0
216532.0,17,2,180,1,90,0.0,90.0,90.0,1,90,0.0,90.0,90.0
108092609.0,17,5,955,5,955,27023152.25,191.0,191.0,0,0,0.0,0.0,0.0
121292.0,6,3,337,2,214,0.0,160.0,107.0,1,123,0.0,123.0,123.0
228320.0,17,2,180,1,90,0.0,90.0,90.0,1,90,0.0,90.0,90.0
120046910.0,17,29,13785,29,13785,4287389.642857143,501.0,475.3448275862069,0,0,0.0,0.0,0.0
144009.0,17,2,180,1,90,0.0,90.0,90.0,1,90,0.0,90.0,90.0
4756.0,17,2,614,1,72,0.0,72.0,72.0,1,542,0.0,542.0,542.0
37915.0,6,14,4740,7,653,5889.666666666667,249.0,93.28571428571428,7,4087,5895.0,1514.0,583.8571428571429
18183.0,17,2,582,1,83,0.0,83.0,83.0,1,499,0.0,499.0,499.0
18330.0,6,14,4740,7,653,2699.5,249.0,93.28571428571428,7,4087,2915.0,1514.0,583.8571428571429
121401.0,6,3,337,2,214,0.0,160.0,107.0,1,123,0.0,123.0,123.0
307091.0,6,6,412,4,272,102363.66666666669,74.0,68.0,2,140,0.0,74.0,70.0
104575.0,17,2,286,2,286,0.0,143.0,143.0,0,0,0.0,0.0,0.0
122016.0,6,14,4740,7,653,20205.33333333333,249.0,93.28571428571428,7,4087,19877.5,1514.0,583.8571428571429
18627.0,6,10,2032,5,524,3381.25,252.0,104.8,5,1508,4495.0,1236.0,301.6
44843.0,6,14,4740,7,653,7270.666666666667,249.0,93.28571428571428,7,4087,7253.333333333333,1514.0,583.8571428571429
165122.0,17,2,414,1,88,0.0,88.0,88.0,1,326,0.0,326.0,326.0
219821.0,6,10,1221,6,636,43964.2,298.0,106.0,4,585,71979.33333333333,379.0,146.25
298431.0,6,6,412,4,272,99477.0,74.0,68.0,2,140,0.0,74.0,70.0
105134.0,17,2,286,2,286,0.0,143.0,143.0,0,0,0.0,0.0,0.0
97899752.0,6,177,20044,89,6096,1112497.181818182,140.0,68.49438202247191,88,13948,1120943.8620689656,374.0,158.5
31995.000000000004,6,14,4740,7,653,4838.833333333333,249.0,93.28571428571428,7,4087,4912.5,1514.0,583.8571428571429
216547.0,17,2,180,1,90,0.0,90.0,90.0,1,90,0.0,90.0,90.0
217822.0,6,3,426,2,280,0.0,214.0,140.0,1,146,0.0,146.0,146.0
313708.0,17,4,622,4,622,104569.33333333331,163.0,155.5,0,0,0.0,0.0,0.0
205960.0,6,3,426,2,280,0.0,214.0,140.0,1,146,0.0,146.0,146.0
90254414.0,6,13,2036,8,1016,12893487.714285716,188.0,127.0,5,1020,22522456.0,204.0,204.0
90527287.0,6,14,2240,8,1016,12932469.57142857,188.0,127.0,6,1224,18072379.2,204.0,204.0
856556.0,6,9,1096,6,625,171311.2,287.0,104.16666666666669,3,471,290311.0,331.0,157.0
120000983.0,17,15,907,8,475,17142997.57142857,174.0,59.375,7,432,16668061.333333334,174.0,61.71428571428572
153480.0,17,2,180,1,90,0.0,90.0,90.0,1,90,0.0,90.0,90.0
348.0,17,2,267,1,83,0.0,83.0,83.0,1,184,0.0,184.0,184.0
114451955.0,6,221,25024,111,7622,1040472.3181818182,140.0,68.66666666666667,110,17402,1047957.6880733944,284.0,158.2
311856.0,6,3,202,2,128,0.0,74.0,64.0,1,74,0.0,74.0,74.0
132464803.0,17,14,995,8,606,18923543.285714287,174.0,75.75,6,389,18573656.4,174.0,64.83333333333333
118739434.0,6,34,2419,17,1194,7421214.625,123.0,70.23529411764706,17,1225,7407651.8125,139.0,72.05882352941177
124042.0,6,15,4806,8,719,17521.85714285714,249.0,89.875,7,4087,19309.5,1514.0,583.8571428571429
119342916.0,17,35,16705,35,16705,3510085.7647058824,501.0,477.2857142857143,0,0,0.0,0.0,0.0
111313.0,17,2,286,2,286,0.0,143.0,143.0,0,0,0.0,0.0,0.0
120738403.0,6,19,1477,10,786,13333321.666666666,95.0,78.6,9,691,15090659.25,95.0,76.77777777777777
114902948.0,6,34,2350,17,1225,7167943.3125,139.0,72.05882352941177,17,1125,7167944.25,123.0,66.17647058823529
135133485.0,17,6,1146,6,1146,27026697.0,191.0,191.0,0,0,0.0,0.0,0.0
65658.0,6,14,4740,7,653,10600.833333333334,249.0,93.28571428571428,7,4087,8522.333333333334,1514.0,583.8571428571429
52209.0,6,14,4740,7,653,8251.833333333334,249.0,93.28571428571428,7,4087,8406.0,1514.0,583.8571428571429
43790.0,6,14,4740,7,653,7167.833333333333,249.0,93.28571428571428,7,4087,5737.166666666667,1514.0,583.8571428571429
120186679.0,17,14,864,7,432,20031113.166666668,174.0,61.71428571428572,7,432,19928011.83333333,174.0,61.71428571428572
283138.0,6,12,1373,7,714,47189.66666666666,298.0,102.0,5,659,65907.25,379.0,131.8
311623.0,17,4,1400,4,1400,103874.33333333331,350.0,350.0,0,0,0.0,0.0,0.0
300455.0,6,6,412,4,272,100151.66666666669,74.0,68.0,2,140,0.0,74.0,70.0
2690630.0,6,3,1602,1,752,0.0,752.0,752.0,2,850,0.0,784.0,425.0
49738.0,6,14,4740,7,653,8161.333333333333,249.0,93.28571428571428,7,4087,7569.5,1514.0,583.8571428571429
27257250.0,17,3,1034,2,684,0.0,342.0,342.0,1,350,0.0,350.0,350.0
90280369.0,6,16,1192,8,596,12891208.57142857,95.0,74.5,8,596,12896242.57142857,95.0,74.5
242072.0,6,3,337,2,214,0.0,160.0,107.0,1,123,0.0,123.0,123.0
19468.0,6,2,145,2,145,0.0,91.0,72.5,0,0,0.0,0.0,0.0
146228.0,6,3,337,2,214,0.0,160.0,107.0,1,123,0.0,123.0,123.0
27357437.0,17,5,1710,5,1710,6839359.25,342.0,342.0,0,0,0.0,0.0,0.0
45322.0,6,10,2032,5,524,11044.25,252.0,104.8,5,1508,11168.0,1236.0,301.6
281266.0,17,2,363,1,79,0.0,79.0,79.0,1,284,0.0,284.0,284.0
1808.0,17,2,664,1,322,0.0,322.0,322.0,1,342,0.0,342.0,342.0
0.0,6,1,54,1,54,0.0,54.0,54.0,0,0,0.0,0.0,0.0
18706.0,6,14,4740,7,653,2997.1666666666665,249.0,93.28571428571428,7,4087,2833.833333333333,1514.0,583.8571428571429
90287336.0,6,16,1192,8,596,12891422.57142857,95.0,74.5,8,596,12897127.857142856,95.0,74.5
120335368.0,6,217,24580,109,17156,1114216.3703703703,284.0,157.39449541284404,108,7424,1115989.7757009345,140.0,68.74074074074075
90021699.0,17,28,13364,28,13364,3334137.0,501.0,477.2857142857143,0,0,0.0,0.0,0.0
481088.0,17,2,346,1,78,0.0,78.0,78.0,1,268,0.0,268.0,268.0
205823.0,6,3,426,2,280,0.0,214.0,140.0,1,146,0.0,146.0,146.0
135136856.0,17,6,1146,6,1146,27027371.2,191.0,191.0,0,0,0.0,0.0,0.0
1428090.0,17,16,1120,16,1120,95206.0,70.0,70.0,0,0,0.0,0.0,0.0
47132.0,6,12,1320,6,723,8127.2,253.0,120.5,6,597,9101.4,259.0,99.5
314506.0,17,4,1400,4,1400,104835.33333333331,350.0,350.0,0,0,0.0,0.0,0.0
480531.0,6,3,1604,1,753,0.0,753.0,753.0,2,851,0.0,785.0,425.5
160095.0,17,2,180,1,90,0.0,90.0,90.0,1,90,0.0,90.0,90.0
196890.0,17,2,180,1,90,0.0,90.0,90.0,1,90,0.0,90.0,90.0
54054.0,6,14,4740,7,653,8197.5,249.0,93.28571428571428,7,4087,8667.833333333334,1514.0,583.8571428571429
233760.0,6,3,337,2,214,0.0,160.0,107.0,1,123,0.0,123.0,123.0
350.0,17,2,267,1,83,0.0,83.0,83.0,1,184,0.0,184.0,184.0
2849025.0,6,11,2106,6,598,569400.8,252.0,99.66666666666669,5,1508,2376.25,1236.0,301.6
5629358.0,6,4,270,2,134,0.0,68.0,67.0,2,136,0.0,70.0,68.0
90043240.0,17,28,13364,28,13364,3334934.814814815,501.0,477.2857142857143,0,0,0.0,0.0,0.0
21255.0,6,10,2032,5,524,4793.5,252.0,104.8,5,1508,5000.75,1236.0,301.6
10464206.0,6,7,478,4,272,3441453.6666666665,74.0,68.0,3,206,5162054.5,74.0,68.66666666666667
2620261.0,6,25,7573,14,3735,201558.53846153847,1514.0,266.7857142857143,11,3838,237504.5,1514.0,348.90909090909093
361468.0,6,3,204,1,68,0.0,68.0,68.0,2,136,0.0,70.0,68.0
4607.0,17,4,758,2,144,0.0,72.0,72.0,2,614,0.0,542.0,307.0
90295941.0,6,19,1436,10,745,10028054.111111112,95.0,74.5,9,691,11286465.125,95.0,76.77777777777777
2316.0,17,4,344,2,150,0.0,75.0,75.0,2,194,0.0,103.0,97.0
146089.0,6,3,337,2,214,0.0,160.0,107.0,1,123,0.0,123.0,123.0
148023.0,17,2,180,1,90,0.0,90.0,90.0,1,90,0.0,90.0,90.0
2077.0,17,4,344,2,150,0.0,75.0,75.0,2,194,0.0,103.0,97.0
119615841.0,6,374,43132,187,30494,641938.7365591398,284.0,163.06951871657753,187,12638,641938.7795698924,140.0,67.58288770053476
35089.0,6,10,2032,5,524,8541.75,252.0,104.8,5,1508,7840.5,1236.0,301.6
30578.0,6,14,4740,7,653,4881.833333333333,249.0,93.28571428571428,7,4087,4448.833333333333,1514.0,583.8571428571429
199716.0,17,4,6056,4,6056,66572.0,1514.0,1514.0,0,0,0.0,0.0,0.0
20570.0,17,2,582,1,83,0.0,83.0,83.0,1,499,0.0,499.0,499.0
90095572.0,6,10,1440,7,828,15015928.666666666,188.0,118.28571428571428,3,612,30031372.5,204.0,204.0
90049813.0,17,28,13364,28,13364,3335178.25925926,501.0,477.2857142857143,0,0,0.0,0.0,0.0
147580.0,6,3,337,2,214,0.0,160.0,107.0,1,123,0.0,123.0,123.0
205722.0,17,2,180,1,90,0.0,90.0,90.0,1,90,0.0,90.0,90.0
90748126.0,6,22,1680,12,894,8245576.0,95.0,74.5,10,786,10082169.222222222,95.0,78.6
316.0,17,2,168,1,76,0.0,76.0,76.0,1,92,0.0,92.0,92.0
304.0,17,2,156,1,78,0.0,78.0,78.0,1,78,0.0,78.0,78.0
10471947.0,6,7,478,4,272,3443517.0,74.0,68.0,3,206,5165191.5,74.0,68.66666666666667
9549006.0,17,3,1034,2,684,0.0,342.0,342.0,1,350,0.0,350.0,350.0
0.0,6,1,97,1,97,0.0,97.0,97.0,0,0,0.0,0.0,0.0
1307008.0,6,4,264,2,132,0.0,66.0,66.0,2,132,0.0,66.0,66.0
316204.0,17,4,1400,4,1400,105401.33333333331,350.0,350.0,0,0,0.0,0.0,0.0
161919.0,6,3,337,2,214,0.0,160.0,107.0,1,123,0.0,123.0,123.0
2841869.0,6,5,336,2,134,0.0,68.0,67.0,3,202,1420934.5,70.0,67.33333333333333
13213.0,6,11,1131,6,600,2469.4,262.0,100.0,5,531,2639.75,259.0,106.2
1778144.0,6,4,276,2,128,0.0,74.0,64.0,2,148,0.0,74.0,74.0
111029654.0,6,33,2296,17,1225,6925852.4375,139.0,72.05882352941177,16,1071,7387576.2,123.0,66.9375
59096.0,6,14,4740,7,653,8091.833333333333,249.0,93.28571428571428,7,4087,6840.833333333333,1514.0,583.8571428571429
2346.0,17,4,344,2,150,0.0,75.0,75.0,2,194,0.0,103.0,97.0
2414.0,17,4,344,2,150,0.0,75.0,75.0,2,194,0.0,103.0,97.0
54401.0,6,14,4740,7,653,8314.833333333334,249.0,93.28571428571428,7,4087,8928.5,1514.0,583.8571428571429
352380.0,6,3,1604,2,851,0.0,785.0,425.5,1,753,0.0,753.0,753.0
298788.0,6,6,412,4,272,99596.0,74.0,68.0,2,140,0.0,74.0,70.0
165866.0,17,2,180,1,90,0.0,90.0,90.0,1,90,0.0,90.0,90.0
120188030.0,6,542,70564,271,52382,444378.7703703704,300.0,193.29151291512915,271,18182,444378.7962962963,140.0,67.09225092250922
26948.0,6,10,2032,5,524,6517.75,252.0,104.8,5,1508,6451.5,1236.0,301.6
3006590.0,6,11,2106,6,598,601131.6,252.0,99.66666666666669,5,1508,1612.25,1236.0,301.6
90032639.0,17,28,13364,28,13364,3334542.185185185,501.0,477.2857142857143,0,0,0.0,0.0,0.0
112535583.0,6,46,3036,23,1518,5105443.409090909,66.0,66.0,23,1518,5105451.090909091,66.0,66.0
114304387.0,6,48,3168,24,1584,4969755.956521739,66.0,66.0,24,1584,4956084.956521739,66.0,66.0
1520.0,17,2,762,2,762,0.0,381.0,381.0,0,0,0.0,0.0,0.0
2108.0,17,4,344,2,150,0.0,75.0,75.0,2,194,0.0,103.0,97.0
255698.0,6,12,1373,7,714,42616.333333333336,298.0,102.0,5,659,59788.0,379.0,131.8
220532.0,6,3,426,2,280,0.0,214.0,140.0,1,146,0.0,146.0,146.0
16875.0,17,2,180,1,90,0.0,90.0,90.0,1,90,0.0,90.0,90.0
304070.0,6,6,412,4,272,101356.66666666669,74.0,68.0,2,140,0.0,74.0,70.0
208222.0,17,4,6056,4,6056,69407.33333333333,1514.0,1514.0,0,0,0.0,0.0,0.0
2330.0,17,4,344,2,150,0.0,75.0,75.0,2,194,0.0,103.0,97.0
32313.0,6,2,145,2,145,0.0,91.0,72.5,0,0,0.0,0.0,0.0
63861.0,6,14,4740,7,653,10301.0,249.0,93.28571428571428,7,4087,10416.0,1514.0,583.8571428571429
153462.0,17,2,180,1,90,0.0,90.0,90.0,1,90,0.0,90.0,90.0
91058998.0,17,12,778,6,389,18201372.4,174.0,64.83333333333333,6,389,18200162.6,174.0,64.83333333333333
2400.0,17,4,344,2,150,0.0,75.0,75.0,2,194,0.0,103.0,97.0
363914.0,6,3,1604,2,851,0.0,785.0,425.5,1,753,0.0,753.0,753.0
112464329.0,6,46,3036,23,1518,5112000.227272728,66.0,66.0,23,1518,5112003.409090909,66.0,66.0
206221.0,6,3,426,2,280,0.0,214.0,140.0,1,146,0.0,146.0,146.0
147954.0,17,2,180,1,90,0.0,90.0,90.0,1,90,0.0,90.0,90.0
123630558.0,6,49,3234,25,1650,5151273.25,66.0,66.0,24,1584,5117281.217391305,66.0,66.0
107329.0,17,2,286,2,286,0.0,143.0,143.0,0,0,0.0,0.0,0.0
1028275.0,6,11,1134,6,558,205655.0,220.0,93.0,5,576,255747.25,304.0,115.2
117515174.0,6,228,25734,114,17914,1038052.5398230088,374.0,157.140350877193,114,7820,1038052.3982300884,140.0,68.59649122807018
2591773.0,6,2,132,1,66,0.0,66.0,66.0,1,66,0.0,66.0,66.0
243377.0,6,3,337,2,214,0.0,160.0,107.0,1,123,0.0,123.0,123.0
119091493.0,17,35,16705,35,16705,3502690.970588235,501.0,477.2857142857143,0,0,0.0,0.0,0.0
724.0,17,4,438,2,148,0.0,74.0,74.0,2,290,0.0,147.0,145.0
230226.0,17,2,180,1,90,0.0,90.0,90.0,1,90,0.0,90.0,90.0
34758.0,6,14,4740,7,653,5628.166666666667,249.0,93.28571428571428,7,4087,5577.5,1514.0,583.8571428571429
722316.0,6,10,1065,5,534,179787.5,262.0,106.8,5,531,180190.25,259.0,106.2
251759.0,6,3,337,2,214,0.0,160.0,107.0,1,123,0.0,123.0,123.0
51482.0,6,14,4740,7,653,8134.666666666667,249.0,93.28571428571428,7,4087,8306.0,1514.0,583.8571428571429
63986.0,6,12,1320,7,789,10664.333333333334,253.0,112.71428571428572,5,531,12975.0,259.0,106.2
2794785.0,6,2,132,1,66,0.0,66.0,66.0,1,66,0.0,66.0,66.0
198903.0,17,2,180,1,90,0.0,90.0,90.0,1,90,0.0,90.0,90.0
120413672.0,6,261,30666,131,21864,926259.0153846154,284.0,166.90076335877862,130,8802,926254.4186046512,140.0,67.70769230769231
4477.0,17,2,614,1,72,0.0,72.0,72.0,1,542,0.0,542.0,542.0
115048571.0,17,15,1169,8,606,16435510.142857144,174.0,75.75,7,563,15844010.166666666,174.0,80.42857142857143
98899474.0,6,197,22376,99,6756,1009178.306122449,140.0,68.24242424242425,98,15620,1015909.412371134,284.0,159.3877551020408
108101901.0,17,5,955,5,955,27025475.25,191.0,191.0,0,0,0.0,0.0,0.0
203671.0,17,4,6056,4,6056,67890.33333333333,1514.0,1514.0,0,0,0.0,0.0,0.0
1252613.0,17,7,490,7,490,208768.8333333333,70.0,70.0,0,0,0.0,0.0,0.0
107237.0,17,2,286,2,286,0.0,143.0,143.0,0,0,0.0,0.0,0.0
3077.0,17,2,180,1,90,0.0,90.0,90.0,1,90,0.0,90.0,90.0
120235199.0,6,19,1395,10,745,13332889.0,95.0,74.5,9,650,15000000.625,95.0,72.22222222222223
504171.00000000006,6,4,270,2,134,0.0,68.0,67.0,2,136,0.0,70.0,68.0
296.0,17,2,156,1,78,0.0,78.0,78.0,1,78,0.0,78.0,78.0
53438.0,6,14,4740,7,653,8462.666666666666,249.0,93.28571428571428,7,4087,8314.166666666666,1514.0,583.8571428571429
20916.0,6,20,7606,11,978,2091.6,310.0,88.9090909090909,9,6628,2120.5,1514.0,736.4444444444445
12169936.0,17,10,4530,10,4530,1352215.111111111,453.0,453.0,0,0,0.0,0.0,0.0
15678195.0,6,5,1736,2,819,0.0,753.0,409.5,3,917,6439085.0,785.0,305.6666666666667
304205.0,6,6,412,4,272,101401.66666666669,74.0,68.0,2,140,0.0,74.0,70.0
5621559.0,6,5,336,2,134,0.0,68.0,67.0,3,202,1418897.5,70.0,67.33333333333333
927058.0,6,13,1420,7,789,154509.66666666666,253.0,112.71428571428572,6,631,184647.4,293.0,105.16666666666669
90301996.0,6,16,1192,8,596,12893388.57142857,95.0,74.5,8,596,12899434.57142857,95.0,74.5
90747632.0,6,19,1436,10,745,10078101.888888888,95.0,74.5,9,691,11342412.0,95.0,76.77777777777777
216409.0,17,2,180,1,90,0.0,90.0,90.0,1,90,0.0,90.0,90.0
511482.0,6,5,336,2,134,0.0,68.0,67.0,3,202,195625.0,70.0,67.33333333333333
38002.0,6,14,4740,7,653,6157.5,249.0,93.28571428571428,7,4087,6067.166666666667,1514.0,583.8571428571429
122007643.0,17,15,907,8,475,17429663.285714287,174.0,59.375,7,432,17000212.166666668,174.0,61.71428571428572
207538.0,6,3,426,2,280,0.0,214.0,140.0,1,146,0.0,146.0,146.0
307038.0,6,6,412,4,272,102346.0,74.0,68.0,2,140,0.0,74.0,70.0
102683104.0,17,14,864,7,432,17000170.333333332,174.0,61.71428571428572,7,432,17001229.166666668,174.0,61.71428571428572
299.0,17,2,168,1,76,0.0,76.0,76.0,1,92,0.0,92.0,92.0
221334.0,17,2,180,1,90,0.0,90.0,90.0,1,90,0.0,90.0,90.0
30551.0,6,10,2032,5,524,7408.25,252.0,104.8,5,1508,7274.5,1236.0,301.6
228237.0,17,2,180,1,90,0.0,90.0,90.0,1,90,0.0,90.0,90.0
162365.0,17,2,180,1,90,0.0,90.0,90.0,1,90,0.0,90.0,90.0
119689148.0,6,23,1734,12,894,10880831.636363637,95.0,74.5,11,840,11952101.4,95.0,76.36363636363636
4434.0,17,2,626,1,72,0.0,72.0,72.0,1,554,0.0,554.0,554.0
34791.0,17,2,180,1,90,0.0,90.0,90.0,1,90,0.0,90.0,90.0
2219.0,17,2,932,1,590,0.0,590.0,590.0,1,342,0.0,342.0,342.0
42567.0,6,14,4740,7,653,6922.666666666667,249.0,93.28571428571428,7,4087,6954.166666666667,1514.0,583.8571428571429
138566.0,17,4,1524,4,1524,46188.66666666666,381.0,381.0,0,0,0.0,0.0,0.0
299899.0,6,6,412,4,272,99966.33333333331,74.0,68.0,2,140,0.0,74.0,70.0
123610481.0,6,49,3234,25,1650,5150436.708333333,66.0,66.0,24,1584,5018799.130434782,66.0,66.0
146128.0,6,3,337,2,214,0.0,160.0,107.0,1,123,0.0,123.0,123.0
209758.0,17,2,180,1,90,0.0,90.0,90.0,1,90,0.0,90.0,90.0
90257501.0,6,12,1832,8,1016,12893928.714285716,188.0,127.0,4,816,30030539.33333333,204.0,204.0
323838.0,17,4,1400,4,1400,107946.0,350.0,350.0,0,0,0.0,0.0,0.0
10330.0,6,10,2032,5,524,2256.75,252.0,104.8,5,1508,2331.0,1236.0,301.6
143953.0,17,2,180,1,90,0.0,90.0,90.0,1,90,0.0,90.0,90.0
6990.0,17,2,582,1,83,0.0,83.0,83.0,1,499,0.0,499.0,499.0
300078.0,6,6,412,4,272,100026.0,74.0,68.0,2,140,0.0,74.0,70.0
213631.0,17,2,180,1,90,0.0,90.0,90.0,1,90,0.0,90.0,90.0
411.0,17,2,410,1,78,0.0,78.0,78.0,1,332,0.0,332.0,332.0
0.0,17,1,44,1,44,0.0,44.0,44.0,0,0,0.0,0.0,0.0
2938677.0,6,3,1604,1,753,0.0,753.0,753.0,2,851,0.0,785.0,425.5
114387553.0,6,48,3168,24,1584,4973371.869565218,66.0,66.0,24,1584,4959776.304347826,66.0,66.0
108109774.0,17,5,955,5,955,27027443.5,191.0,191.0,0,0,0.0,0.0,0.0
103334.0,17,2,286,2,286,0.0,143.0,143.0,0,0,0.0,0.0,0.0
153399.0,17,2,180,1,90,0.0,90.0,90.0,1,90,0.0,90.0,90.0
96438319.0,6,40,2640,20,1320,5075701.0,66.0,66.0,20,1320,5059448.947368421,66.0,66.0
215350.0,6,10,1221,6,636,43070.0,298.0,106.0,4,585,70743.0,379.0,146.25
102380811.0,17,14,864,7,432,17000197.833333332,174.0,61.71428571428572,7,432,17000851.833333332,174.0,61.71428571428572
100271226.0,17,14,864,7,432,16667416.666666666,174.0,61.71428571428572,7,432,16666846.333333334,174.0,61.71428571428572
14316113.0,17,4,6056,4,6056,4772037.666666667,1514.0,1514.0,0,0,0.0,0.0,0.0
4672.0,17,4,344,2,150,0.0,75.0,75.0,2,194,0.0,103.0,97.0
41104.0,6,14,4740,7,653,5809.0,249.0,93.28571428571428,7,4087,6699.666666666667,1514.0,583.8571428571429
268216.0,6,10,1221,6,636,53643.2,298.0,106.0,4,585,83943.0,379.0,146.25
135139328.0,17,6,1146,6,1146,27027865.6,191.0,191.0,0,0,0.0,0.0,0.0
90063969.0,17,28,13364,28,13364,3335702.5555555555,501.0,477.2857142857143,0,0,0.0,0.0,0.0
135122199.0,17,6,1146,6,1146,27024439.8,191.0,191.0,0,0,0.0,0.0,0.0
2295.0,17,4,344,2,150,0.0,75.0,75.0,2,194,0.0,103.0,97.0
611557.0,6,2,132,1,66,0.0,66.0,66.0,1,66,0.0,66.0,66.0
303625.0,6,2,132,1,66,0.0,66.0,66.0,1,66,0.0,66.0,66.0
18990.0,6,12,1393,6,796,3561.6,271.0,132.66666666666666,6,597,3596.2,259.0,99.5
22841.0,6,2,145,2,145,0.0,91.0,72.5,0,0,0.0,0.0,0.0
108110987.0,17,5,1005,5,1005,27027746.75,201.0,201.0,0,0,0.0,0.0,0.0
5004852.0,17,4,534,2,166,0.0,83.0,83.0,2,368,0.0,184.0,184.0
236786.0,17,2,180,1,90,0.0,90.0,90.0,1,90,0.0,90.0,90.0
45589.0,6,14,4740,7,653,7482.333333333333,249.0,93.28571428571428,7,4087,7179.5,1514.0,583.8571428571429
37479.0,6,14,4740,7,653,6127.5,249.0,93.28571428571428,7,4087,5577.666666666667,1514.0,583.8571428571429
216503.0,17,2,180,1,90,0.0,90.0,90.0,1,90,0.0,90.0,90.0
90050712.0,17,28,13364,28,13364,3335211.5555555555,501.0,477.2857142857143,0,0,0.0,0.0,0.0
17870653.0,17,3,1034,2,684,0.0,342.0,342.0,1,350,0.0,350.0,350.0
153415.0,17,2,180,1,90,0.0,90.0,90.0,1,90,0.0,90.0,90.0
13739.0,6,10,2032,5,524,1837.5,252.0,104.8,5,1508,3174.5,1236.0,301.6
37631.0,17,4,823,2,163,0.0,89.0,81.5,2,660,0.0,443.0,330.0
216633.0,6,3,426,2,280,0.0,214.0,140.0,1,146,0.0,146.0,146.0
121344.0,6,3,337,2,214,0.0,160.0,107.0,1,123,0.0,123.0,123.0
296.0,17,2,164,1,82,0.0,82.0,82.0,1,82,0.0,82.0,82.0
153441.0,17,2,180,1,90,0.0,90.0,90.0,1,90,0.0,90.0,90.0
50909.0,17,2,180,1,90,0.0,90.0,90.0,1,90,0.0,90.0,90.0
107019.0,17,2,286,2,286,0.0,143.0,143.0,0,0,0.0,0.0,0.0
103185.0,17,2,762,2,762,0.0,381.0,381.0,0,0,0.0,0.0,0.0
1775574.0,6,2,132,1,66,0.0,66.0,66.0,1,66,0.0,66.0,66.0
15482800.0,17,8,1141,4,306,5160823.333333333,89.0,76.5,4,835,5160832.666666667,443.0,208.75
293784.0,6,6,412,4,272,97928.0,74.0,68.0,2,140,0.0,74.0,70.0
100705321.0,17,12,778,6,389,19959226.6,174.0,64.83333333333333,6,389,20109280.8,174.0,64.83333333333333
103062.0,17,2,286,2,286,0.0,143.0,143.0,0,0,0.0,0.0,0.0
63081.0,6,14,4740,7,653,10340.166666666666,249.0,93.28571428571428,7,4087,10355.333333333334,1514.0,583.8571428571429
309.0,17,2,164,1,82,0.0,82.0,82.0,1,82,0.0,82.0,82.0
91159656.0,6,27,2073,12,935,8287241.454545454,95.0,77.91666666666667,15,1138,6492744.428571428,95.0,75.86666666666666
1026339.0,6,20,6434,12,1921,93303.54545454546,620.0,160.08333333333334,8,4513,118130.14285714286,1514.0,564.125
119582156.0,6,25,1924,11,840,11958215.6,95.0,76.36363636363636,14,1084,9178204.384615384,95.0,77.42857142857143
107251355.0,6,32,2374,17,1288,6689702.5625,139.0,75.76470588235294,15,1086,7645389.714285715,123.0,72.4
223410.0,6,3,426,2,280,0.0,214.0,140.0,1,146,0.0,146.0,146.0
120048085.0,17,29,13785,29,13785,4287431.607142857,501.0,475.3448275862069,0,0,0.0,0.0,0.0
163229.0,17,4,1524,4,1524,54409.66666666666,381.0,381.0,0,0,0.0,0.0,0.0
2302.0,17,4,344,2,150,0.0,75.0,75.0,2,194,0.0,103.0,97.0
103141.0,17,2,286,2,286,0.0,143.0,143.0,0,0,0.0,0.0,0.0
247083.0,17,4,6056,4,6056,82361.0,1514.0,1514.0,0,0,0.0,0.0,0.0
35754406.0,6,5,336,2,134,0.0,68.0,67.0,3,202,17805769.0,70.0,67.33333333333333
216559.0,17,2,180,1,90,0.0,90.0,90.0,1,90,0.0,90.0,90.0
232957.0,6,3,373,2,238,0.0,172.0,119.0,1,135,0.0,135.0,135.0
66461.0,6,14,4740,7,653,10520.5,249.0,93.28571428571428,7,4087,10863.666666666666,1514.0,583.8571428571429
206314.0,17,2,180,1,90,0.0,90.0,90.0,1,90,0.0,90.0,90.0
90013229.0,17,28,13364,28,13364,3333823.296296296,501.0,477.2857142857143,0,0,0.0,0.0,0.0
28529.0,6,14,4740,7,653,4315.833333333333,249.0,93.28571428571428,7,4087,4542.166666666667,1514.0,583.8571428571429
211457.0,17,4,6056,4,6056,70485.66666666667,1514.0,1514.0,0,0,0.0,0.0,0.0
5176.0,17,4,344,2,150,0.0,75.0,75.0,2,194,0.0,103.0,97.0
89736.0,6,2,132,1,66,0.0,66.0,66.0,1,66,0.0,66.0,66.0
101080073.0,17,14,864,7,432,16834938.333333332,174.0,61.71428571428572,7,432,16833496.166666668,174.0,61.71428571428572
34537.0,6,14,4740,7,653,5015.833333333333,249.0,93.28571428571428,7,4087,5451.166666666667,1514.0,583.8571428571429
329.0,17,2,160,1,80,0.0,80.0,80.0,1,80,0.0,80.0,80.0
246790.0,6,3,354,2,288,0.0,222.0,144.0,1,66,0.0,66.0,66.0
90253254.0,6,15,1097,8,596,12893322.0,95.0,74.5,7,501,14993832.0,95.0,71.57142857142857
10436677.0,6,6,412,3,206,5148113.0,74.0,68.66666666666667,3,206,5147978.5,74.0,68.66666666666667
120202735.0,6,298,35082,149,10130,806551.3851351351,140.0,67.98657718120805,149,24952,812065.4864864865,390.0,167.46308724832215
257315.00000000003,17,4,6056,4,6056,85771.66666666667,1514.0,1514.0,0,0,0.0,0.0,0.0
12607.0,6,11,1133,6,602,2521.4,264.0,100.33333333333331,5,531,2363.5,259.0,106.2
146071.0,6,3,337,2,214,0.0,160.0,107.0,1,123,0.0,123.0,123.0
120001006.0,17,13,559,7,301,20000167.666666668,43.0,43.0,6,258,20001621.0,43.0,43.0
46784883.0,6,8,1940,3,887,22265683.0,753.0,295.6666666666667,5,1053,11259306.0,785.0,210.6
203050.0,17,2,762,2,762,0.0,381.0,381.0,0,0,0.0,0.0,0.0
298699.0,6,6,412,4,272,99566.33333333331,74.0,68.0,2,140,0.0,74.0,70.0
24970.0,6,14,4740,7,653,3748.6666666666665,249.0,93.28571428571428,7,4087,3522.833333333333,1514.0,583.8571428571429
1203739.0,17,7,490,7,490,200623.16666666663,70.0,70.0,0,0,0.0,0.0,0.0
96741.0,17,2,762,2,762,0.0,381.0,381.0,0,0,0.0,0.0,0.0
108113551.0,17,5,1005,5,1005,27028387.75,201.0,201.0,0,0,0.0,0.0,0.0
1985.0,17,4,344,2,150,0.0,75.0,75.0,2,194,0.0,103.0,97.0
595786.0,17,2,346,1,78,0.0,78.0,78.0,1,268,0.0,268.0,268.0
5622123.0,6,4,270,2,134,0.0,68.0,67.0,2,136,0.0,70.0,68.0
145084.0,17,2,180,1,70,0.0,70.0,70.0,1,110,0.0,110.0,110.0
2039.0,17,4,344,2,150,0.0,75.0,75.0,2,194,0.0,103.0,97.0
90037295.0,17,28,13364,28,13364,3334714.6296296297,501.0,477.2857142857143,0,0,0.0,0.0,0.0
219662.0,6,10,1221,6,636,43932.4,298.0,106.0,4,585,71970.0,379.0,146.25
2343.0,17,4,344,2,150,0.0,75.0,75.0,2,194,0.0,103.0,97.0
74770.0,6,11,2098,6,590,14041.8,252.0,98.33333333333331,5,1508,18466.5,1236.0,301.6
135135408.0,17,6,1206,6,1206,27027081.6,201.0,201.0,0,0,0.0,0.0,0.0
317413.0,17,4,1400,4,1400,105804.33333333331,350.0,350.0,0,0,0.0,0.0,0.0
2422.0,17,4,344,2,150,0.0,75.0,75.0,2,194,0.0,103.0,97.0
35179061.0,6,7,1874,3,887,17515598.0,753.0,295.6666666666667,4,987,11679637.333333334,785.0,246.75
33501859.000000004,6,5,336,2,134,0.0,68.0,67.0,3,202,16678935.500000002,70.0,67.33333333333333
52174.0,6,14,4740,7,653,8227.166666666666,249.0,93.28571428571428,7,4087,8138.5,1514.0,583.8571428571429
120345532.0,6,271,31924,136,22718,891448.3851851852,336.0,167.0441176470588,135,9206,890288.671641791,140.0,68.19259259259259
10914995.0,6,8,544,4,272,3592967.333333333,74.0,68.0,4,272,3592914.333333333,74.0,68.0
3027693.0,6,11,2106,6,598,604240.4,252.0,99.66666666666669,5,1508,4971.5,1236.0,301.6
118918149.0,6,37,2656,19,1408,6594569.5,139.0,74.10526315789474,18,1248,6982490.117647059,123.0,69.33333333333333
834606.0,6,9,1118,6,586,166921.2,248.0,97.66666666666669,3,532,281018.5,392.0,177.33333333333334
303233.0,6,2,132,1,66,0.0,66.0,66.0,1,66,0.0,66.0,66.0
216400.0,17,2,180,1,90,0.0,90.0,90.0,1,90,0.0,90.0,90.0
90032306.0,17,28,13364,28,13364,3334529.851851852,501.0,477.2857142857143,0,0,0.0,0.0,0.0
5619123.0,6,5,336,2,134,0.0,68.0,67.0,3,202,1422832.5,70.0,67.33333333333333
120052882.0,17,28,13364,28,13364,4446403.037037037,501.0,477.2857142857143,0,0,0.0,0.0,0.0
135134722.0,17,6,1206,6,1206,27026944.4,201.0,201.0,0,0,0.0,0.0,0.0
2547472.0,6,12,1362,6,731,508345.0,253.0,121.83333333333331,6,631,507892.2,293.0,105.16666666666669
90368208.0,6,12,1848,5,1020,22591749.75,204.0,204.0,7,828,15061151.666666666,188.0,118.28571428571428
38872.0,6,14,4740,7,653,6351.833333333333,249.0,93.28571428571428,7,4087,6079.0,1514.0,583.8571428571429
90047333.0,17,28,13364,28,13364,3335086.407407407,501.0,477.2857142857143,0,0,0.0,0.0,0.0
186113.0,17,2,180,1,90,0.0,90.0,90.0,1,90,0.0,90.0,90.0
90256535.0,6,16,2368,9,1204,11282066.875,188.0,133.77777777777777,7,1164,15015099.333333334,204.0,166.28571428571428
90005650.0,6,14,1043,7,542,15000941.666666666,95.0,77.42857142857143,7,501,14952732.833333334,95.0,71.57142857142857
104042.0,17,2,286,2,286,0.0,143.0,143.0,0,0,0.0,0.0,0.0
148024.0,17,2,180,1,90,0.0,90.0,90.0,1,90,0.0,90.0,90.0
215479.0,17,2,180,1,90,0.0,90.0,90.0,1,90,0.0,90.0,90.0
18506.0,6,14,4740,7,653,2348.333333333333,249.0,93.28571428571428,7,4087,2899.1666666666665,1514.0,583.8571428571429
759.0,17,4,438,2,148,0.0,74.0,74.0,2,290,0.0,147.0,145.0
135130958.0,17,6,1146,6,1146,27026191.6,191.0,191.0,0,0,0.0,0.0,0.0
108107195.0,17,5,955,5,955,27026798.75,191.0,191.0,0,0,0.0,0.0,0.0
25618.0,6,2,145,2,145,0.0,91.0,72.5,0,0,0.0,0.0,0.0
14633097.0,6,20,1607,10,975,1592489.6666666667,315.0,97.5,10,632,1592456.4444444445,78.0,63.2
0.0,6,1,66,1,66,0.0,66.0,66.0,0,0,0.0,0.0,0.0
135136261.0,17,6,1206,6,1206,27027252.2,201.0,201.0,0,0,0.0,0.0,0.0
91713973.0,6,27,1938,14,1029,7038320.153846154,123.0,73.5,13,909,7624847.833333333,123.0,69.92307692307692
2331.0,17,4,344,2,150,0.0,75.0,75.0,2,194,0.0,103.0,97.0
15068.0,6,14,4740,7,653,2390.833333333333,249.0,93.28571428571428,7,4087,2381.0,1514.0,583.8571428571429
242708.0,6,3,337,2,214,0.0,160.0,107.0,1,123,0.0,123.0,123.0
10435540.0,6,7,478,4,272,3432161.333333333,74.0,68.0,3,206,5148127.0,74.0,68.66666666666667
146199.0,6,3,337,2,214,0.0,160.0,107.0,1,123,0.0,123.0,123.0
2805555.0,6,2,132,1,66,0.0,66.0,66.0,1,66,0.0,66.0,66.0
143925.0,17,2,180,1,90,0.0,90.0,90.0,1,90,0.0,90.0,90.0
304912.0,6,6,412,4,272,101637.33333333331,74.0,68.0,2,140,0.0,74.0,70.0
5005551.0,17,4,849,2,166,0.0,83.0,83.0,2,683,0.0,499.0,341.5
321100.0,6,3,202,2,128,0.0,74.0,64.0,1,74,0.0,74.0,74.0
107135.0,17,2,286,2,286,0.0,143.0,143.0,0,0,0.0,0.0,0.0
153338.0,17,2,180,1,90,0.0,90.0,90.0,1,90,0.0,90.0,90.0
53583.0,6,14,4740,7,653,8678.833333333334,249.0,93.28571428571428,7,4087,8634.833333333334,1514.0,583.8571428571429
122975265.0,6,48,3168,24,1584,5041454.217391305,66.0,66.0,24,1584,5225634.695652174,66.0,66.0
109692126.0,17,13,821,7,432,18163341.0,174.0,61.71428571428572,6,389,18000160.6,174.0,64.83333333333333
2875456.0,6,23,6506,12,1529,261405.0909090909,357.0,127.41666666666669,11,4977,254177.3,1510.0,452.45454545454544
96473.0,17,2,762,2,762,0.0,381.0,381.0,0,0,0.0,0.0,0.0
98959220.0,6,269,31426,135,9132,738501.6417910447,140.0,67.64444444444445,134,22294,742261.2481203007,284.0,166.37313432835822
120294459.0,6,21,1626,11,840,11999998.4,95.0,76.36363636363636,10,786,13365851.666666666,95.0,78.6
87605.0,6,14,4740,7,653,14115.5,249.0,93.28571428571428,7,4087,9341.166666666666,1514.0,583.8571428571429
118665946.0,6,35,2542,18,1348,6980349.764705882,139.0,74.88888888888889,17,1194,6778628.9375,123.0,70.23529411764706
242081.0,6,3,337,2,214,0.0,160.0,107.0,1,123,0.0,123.0,123.0
135134638.0,17,6,1206,6,1206,27026927.6,201.0,201.0,0,0,0.0,0.0,0.0
299.0,17,2,164,1,82,0.0,82.0,82.0,1,82,0.0,82.0,82.0
245209.0,6,3,337,2,214,0.0,160.0,107.0,1,123,0.0,123.0,123.0
94212544.0,6,166,18762,83,13062,1146308.487804878,284.0,157.3734939759036,83,5700,1146308.2073170731,140.0,68.67469879518072
110249291.0,6,32,2220,16,1149,7335545.4,123.0,71.8125,16,1071,7335542.933333334,123.0,66.9375
307692.0,6,6,412,4,272,102564.0,74.0,68.0,2,140,0.0,74.0,70.0
246102.0,6,3,337,2,214,0.0,160.0,107.0,1,123,0.0,123.0,123.0
167500.0,17,2,180,1,90,0.0,90.0,90.0,1,90,0.0,90.0,90.0
33517.0,6,14,4740,7,653,5196.0,249.0,93.28571428571428,7,4087,5393.833333333333,1514.0,583.8571428571429
339.0,17,2,160,1,80,0.0,80.0,80.0,1,80,0.0,80.0,80.0
118441076.0,6,181,20366,91,6302,1316011.9555555556,140.0,69.25274725274726,90,14064,1308899.8539325842,284.0,156.26666666666668
28793.0,6,14,4740,7,653,4680.0,249.0,93.28571428571428,7,4087,4639.833333333333,1514.0,583.8571428571429
90011509.0,17,27,12943,27,12943,3461981.1153846155,501.0,479.3703703703704,0,0,0.0,0.0,0.0
302348.0,6,2,132,1,66,0.0,66.0,66.0,1,66,0.0,66.0,66.0
91724742.0,6,27,2073,15,1138,6548232.571428572,95.0,75.86666666666666,12,935,8271186.0,95.0,77.91666666666667
83978.0,6,14,4740,7,653,13861.333333333334,249.0,93.28571428571428,7,4087,13678.0,1514.0,583.8571428571429
2363.0,17,4,344,2,150,0.0,75.0,75.0,2,194,0.0,103.0,97.0
1074340.0,6,13,1386,7,789,179056.66666666666,253.0,112.71428571428572,6,597,212987.0,259.0,99.5
29922.0,6,10,2032,5,524,6816.75,252.0,104.8,5,1508,6716.5,1236.0,301.6
228068.0,17,2,180,1,90,0.0,90.0,90.0,1,90,0.0,90.0,90.0
213090.0,6,10,1221,6,636,42618.0,298.0,106.0,4,585,69926.33333333333,379.0,146.25
203830.0,17,3,1143,3,1143,101915.0,381.0,381.0,0,0,0.0,0.0,0.0
113828788.0,6,48,3168,24,1584,4949077.739130435,66.0,66.0,24,1584,4939679.913043479,66.0,66.0
18313.0,17,2,582,1,83,0.0,83.0,83.0,1,499,0.0,499.0,499.0
135127065.0,17,6,1146,6,1146,27025413.0,191.0,191.0,0,0,0.0,0.0,0.0
21827.0,6,10,2032,5,524,5236.5,252.0,104.8,5,1508,5213.0,1236.0,301.6
113598870.0,6,34,2350,17,1225,7099929.375,139.0,72.05882352941177,17,1125,7086418.25,123.0,66.17647058823529
312.0,17,2,174,1,79,0.0,79.0,79.0,1,95,0.0,95.0,95.0
216775.0,6,3,426,2,280,0.0,214.0,140.0,1,146,0.0,146.0,146.0
305681.0,6,6,412,4,272,101893.66666666669,74.0,68.0,2,140,0.0,74.0,70.0
135131250.0,17,6,1146,6,1146,27026250.0,191.0,191.0,0,0,0.0,0.0,0.0
27026056.0,17,2,382,2,382,0.0,191.0,191.0,0,0,0.0,0.0,0.0
1056872.0,6,11,1131,6,600,211238.6,262.0,100.0,5,531,263928.0,259.0,106.2
9984.0,17,4,823,2,163,0.0,89.0,81.5,2,660,0.0,443.0,330.0
94261.0,6,14,4740,7,653,14499.333333333334,249.0,93.28571428571428,7,4087,14688.166666666666,1514.0,583.8571428571429
135140445.0,17,6,1206,6,1206,27028089.0,201.0,201.0,0,0,0.0,0.0,0.0
122368058.0,17,14,864,7,432,17166875.833333332,174.0,61.71428571428572,7,432,17167962.0,174.0,61.71428571428572
2420.0,17,2,691,1,349,0.0,349.0,349.0,1,342,0.0,342.0,342.0
488469.0,6,3,204,2,136,0.0,70.0,68.0,1,68,0.0,68.0,68.0
232810.0,6,3,337,2,214,0.0,160.0,107.0,1,123,0.0,123.0,123.0
5368.0,17,2,762,2,762,0.0,381.0,381.0,0,0,0.0,0.0,0.0
6916.0,17,2,582,1,83,0.0,83.0,83.0,1,499,0.0,499.0,499.0
119791632.0,6,19,1395,10,745,13282706.0,95.0,74.5,9,650,14942511.25,95.0,72.22222222222223
342747.0,17,6,1230,3,234,171184.0,78.0,78.0,3,996,171128.5,332.0,332.0
100000871.0,17,11,473,6,258,20000174.2,43.0,43.0,5,215,20008824.0,43.0,43.0
27404.0,6,10,778,5,379,6669.5,107.0,75.8,5,399,6322.25,127.0,79.8
308.0,17,2,174,1,79,0.0,79.0,79.0,1,95,0.0,95.0,95.0
136430.0,6,2,132,1,66,0.0,66.0,66.0,1,66,0.0,66.0,66.0
153436.0,17,2,180,1,90,0.0,90.0,90.0,1,90,0.0,90.0,90.0
1309245.0,6,4,264,2,132,0.0,66.0,66.0,2,132,0.0,66.0,66.0
91957690.0,6,178,20126,89,14104,1042641.9886363636,284.0,158.47191011235955,89,6022,1042641.8295454546,140.0,67.66292134831461
0.0,6,1,54,0,0,0.0,0.0,0.0,1,54,0.0,54.0,54.0
10935547.0,6,8,544,4,272,3598359.6666666665,74.0,68.0,4,272,3598275.6666666665,74.0,68.0
205651.0,17,2,180,1,90,0.0,90.0,90.0,1,90,0.0,90.0,90.0
315674.0,17,4,1400,4,1400,105224.66666666669,350.0,350.0,0,0,0.0,0.0,0.0
109507079.0,6,208,23632,104,16546,1061086.4466019417,300.0,159.09615384615384,104,7086,1061086.475728155,140.0,68.13461538461539
2060.0,17,4,344,2,150,0.0,75.0,75.0,2,194,0.0,103.0,97.0
91551270.0,17,12,778,6,389,18200270.4,174.0,64.83333333333333,6,389,18200145.0,174.0,64.83333333333333
72485.0,6,14,4740,7,653,11743.0,249.0,93.28571428571428,7,4087,11945.333333333334,1514.0,583.8571428571429
9212.0,17,2,539,1,86,0.0,86.0,86.0,1,453,0.0,453.0,453.0
232090.0,6,3,337,2,214,0.0,160.0,107.0,1,123,0.0,123.0,123.0
8724.0,6,10,1067,5,536,1880.0,264.0,107.2,5,531,1987.75,259.0,106.2
6450.0,17,2,762,2,762,0.0,381.0,381.0,0,0,0.0,0.0,0.0
307272.0,6,6,412,4,272,102424.0,74.0,68.0,2,140,0.0,74.0,70.0
139313.0,6,2,132,1,66,0.0,66.0,66.0,1,66,0.0,66.0,66.0
90036177.0,17,28,13364,28,13364,3334673.222222222,501.0,477.2857142857143,0,0,0.0,0.0,0.0
90034384.0,17,27,12943,27,12943,3462860.923076923,501.0,479.3703703703704,0,0,0.0,0.0,0.0
117251401.0,6,33,2365,16,1140,7151036.333333333,123.0,71.25,17,1225,7328088.3125,139.0,72.05882352941177
17396.0,6,14,4740,7,653,2576.333333333333,249.0,93.28571428571428,7,4087,2719.1666666666665,1514.0,583.8571428571429
31971.0,6,14,4740,7,653,4986.166666666667,249.0,93.28571428571428,7,4087,5081.0,1514.0,583.8571428571429
217776.0,6,3,426,2,280,0.0,214.0,140.0,1,146,0.0,146.0,146.0
0.0,17,1,453,1,453,0.0,453.0,453.0,0,0,0.0,0.0,0.0
317549.0,17,4,1400,4,1400,105849.66666666669,350.0,350.0,0,0,0.0,0.0,0.0
148438.0,17,2,414,1,88,0.0,88.0,88.0,1,326,0.0,326.0,326.0
98027644.0,6,28,2008,14,1045,7523973.384615385,139.0,74.64285714285714,14,963,7523978.461538462,123.0,68.78571428571429
305.0,17,2,168,1,76,0.0,76.0,76.0,1,92,0.0,92.0,92.0
206628.0,6,3,426,2,280,0.0,214.0,140.0,1,146,0.0,146.0,146.0
311782.0,17,4,1400,4,1400,103927.33333333331,350.0,350.0,0,0,0.0,0.0,0.0
2587905.0,6,2,132,1,66,0.0,66.0,66.0,1,66,0.0,66.0,66.0
101640812.0,17,14,864,7,432,16833514.833333332,174.0,61.71428571428572,7,432,16834299.666666668,174.0,61.71428571428572
117450535.0,6,221,24806,111,7622,1067732.1363636365,140.0,68.66666666666667,110,17184,1067724.2201834864,284.0,156.21818181818182
106549.0,17,2,286,2,286,0.0,143.0,143.0,0,0,0.0,0.0,0.0
5616256.0,6,5,336,2,134,0.0,68.0,67.0,3,202,1420948.5,70.0,67.33333333333333
108117995.0,17,5,955,5,955,27029498.75,191.0,191.0,0,0,0.0,0.0,0.0
2296.0,17,4,344,2,150,0.0,75.0,75.0,2,194,0.0,103.0,97.0
346.0,17,2,267,1,83,0.0,83.0,83.0,1,184,0.0,184.0,184.0
222141.0,6,12,1373,7,714,37023.5,298.0,102.0,5,659,54587.75,379.0,131.8
120115705.0,6,222,25106,111,7548,1084519.0727272728,140.0,68.0,111,17558,1076075.981818182,284.0,158.18018018018017
151727.0,17,2,180,1,90,0.0,90.0,90.0,1,90,0.0,90.0,90.0
90762760.0,6,17,1287,9,691,11339831.0,95.0,76.77777777777777,8,596,12965315.42857143,95.0,74.5
10544255.0,6,7,478,4,272,3467820.0,74.0,68.0,3,206,5201583.5,74.0,68.66666666666667
114920892.0,6,33,2428,17,1288,7182555.75,139.0,75.76470588235294,16,1140,7646986.933333334,123.0,71.25
322122.0,17,4,704,2,148,0.0,74.0,74.0,2,556,0.0,280.0,278.0
2475.0,17,4,344,2,150,0.0,75.0,75.0,2,194,0.0,103.0,97.0
171642.0,17,2,180,1,90,0.0,90.0,90.0,1,90,0.0,90.0,90.0
83.0,17,2,762,2,762,0.0,381.0,381.0,0,0,0.0,0.0,0.0
45572.0,6,10,1066,5,490,10987.25,218.0,98.0,5,576,11191.0,304.0,115.2
233238.0,6,3,337,2,214,0.0,160.0,107.0,1,123,0.0,123.0,123.0
120537685.0,6,211,23914,106,16688,1147977.9523809524,284.0,157.43396226415095,105,7226,1149193.2211538462,140.0,68.81904761904762
37864.0,6,14,4740,7,653,5795.666666666667,249.0,93.28571428571428,7,4087,5565.666666666667,1514.0,583.8571428571429
107964.0,17,2,286,2,286,0.0,143.0,143.0,0,0,0.0,0.0,0.0
511.0,17,2,508,2,508,0.0,257.0,254.0,0,0,0.0,0.0,0.0
124006887.0,17,15,907,8,475,17715269.57142857,174.0,59.375,7,432,17333493.166666668,174.0,61.71428571428572
2163579.0,6,2,892,1,826,0.0,826.0,826.0,1,66,0.0,66.0,66.0
2401.0,17,4,344,2,150,0.0,75.0,75.0,2,194,0.0,103.0,97.0
120125062.0,6,14,2224,9,1204,15015632.75,188.0,133.77777777777777,5,1020,22592842.25,204.0,204.0
298318.0,6,6,412,4,272,99439.33333333331,74.0,68.0,2,140,0.0,74.0,70.0
307148.0,6,6,412,4,272,102382.66666666669,74.0,68.0,2,140,0.0,74.0,70.0
90699165.0,6,21,1585,10,745,10077685.0,95.0,74.5,11,840,9043819.4,95.0,76.36363636363636
153515.0,17,2,180,1,90,0.0,90.0,90.0,1,90,0.0,90.0,90.0
3432.0,17,4,344,2,150,0.0,75.0,75.0,2,194,0.0,103.0,97.0
16963.0,17,2,180,1,90,0.0,90.0,90.0,1,90,0.0,90.0,90.0
90254492.0,6,12,1832,8,1016,12893498.857142856,188.0,127.0,4,816,30029890.666666668,204.0,204.0
75783.0,6,14,4740,7,653,12354.5,249.0,93.28571428571428,7,4087,12351.833333333334,1514.0,583.8571428571429
111424.0,17,4,1400,4,1400,37141.333333333336,350.0,350.0,0,0,0.0,0.0,0.0
34697.0,6,14,4740,7,653,5613.0,249.0,93.28571428571428,7,4087,5608.333333333333,1514.0,583.8571428571429
316426.0,6,6,412,4,272,105475.33333333331,74.0,68.0,2,140,0.0,74.0,70.0
39119.0,6,10,2032,5,524,9338.0,252.0,104.8,5,1508,9101.0,1236.0,301.6
44600.0,6,14,4740,7,653,7280.5,249.0,93.28571428571428,7,4087,6454.0,1514.0,583.8571428571429
141178.0,6,2,132,1,66,0.0,66.0,66.0,1,66,0.0,66.0,66.0
323019.0,6,6,412,4,272,107673.0,74.0,68.0,2,140,0.0,74.0,70.0
271074.0,6,10,1221,6,636,54214.8,298.0,106.0,4,585,84551.66666666667,379.0,146.25
2861515.0,6,3,1604,2,851,0.0,785.0,425.5,1,753,0.0,753.0,753.0
108113555.0,17,5,1005,5,1005,27028388.75,201.0,201.0,0,0,0.0,0.0,0.0
90050299.0,17,28,13364,28,13364,3335196.25925926,501.0,477.2857142857143,0,0,0.0,0.0,0.0
121724.0,6,3,337,2,214,0.0,160.0,107.0,1,123,0.0,123.0,123.0
90064141.0,17,28,13364,28,13364,3335708.925925926,501.0,477.2857142857143,0,0,0.0,0.0,0.0
112378020.0,6,217,24378,109,7416,1040537.2222222222,140.0,68.03669724770643,108,16962,1048237.6355140188,284.0,157.05555555555554
108105425.0,17,5,955,5,955,27026356.25,191.0,191.0,0,0,0.0,0.0,0.0
90259547.0,6,12,1832,8,1016,12894221.0,188.0,127.0,4,816,30030792.0,204.0,204.0
541895.0,17,6,2100,6,2100,108379.0,350.0,350.0,0,0,0.0,0.0,0.0
120044247.0,17,28,13364,28,13364,4446083.222222222,501.0,477.2857142857143,0,0,0.0,0.0,0.0
125011409.0,17,15,907,8,475,17858772.714285713,174.0,59.375,7,432,17500172.333333332,174.0,61.71428571428572
2303.0,17,4,344,2,150,0.0,75.0,75.0,2,194,0.0,103.0,97.0
2035.0,17,4,344,2,150,0.0,75.0,75.0,2,194,0.0,103.0,97.0
309609.0,17,4,1400,4,1400,103203.0,350.0,350.0,0,0,0.0,0.0,0.0
106088939.0,17,14,864,7,432,17681489.833333332,174.0,61.71428571428572,7,432,17629317.333333332,174.0,61.71428571428572
148104.0,17,4,704,2,148,0.0,74.0,74.0,2,556,0.0,280.0,278.0
90031164.0,17,28,13364,28,13364,3334487.5555555555,501.0,477.2857142857143,0,0,0.0,0.0,0.0
1853616.0,6,4,276,2,128,0.0,74.0,64.0,2,148,0.0,74.0,74.0
205867.0,6,3,426,2,280,0.0,214.0,140.0,1,146,0.0,146.0,146.0
3067.0,17,2,224,1,76,0.0,76.0,76.0,1,148,0.0,148.0,148.0
27250270.0,17,5,1710,5,1710,6812567.5,342.0,342.0,0,0,0.0,0.0,0.0
90253558.0,6,13,2036,8,1016,12893365.42857143,188.0,127.0,5,1020,22522836.25,204.0,204.0
90255858.0,6,15,2168,8,1016,12893694.0,188.0,127.0,7,1152,15015682.166666666,204.0,164.57142857142858
1309563.0,6,4,264,2,132,0.0,66.0,66.0,2,132,0.0,66.0,66.0
924965.0,6,12,2717,7,742,154160.83333333334,338.0,106.0,5,1975,162315.5,1514.0,395.0
89254699.0,17,14,4788,14,4788,6865746.076923077,342.0,342.0,0,0,0.0,0.0,0.0
153442.0,17,2,180,1,90,0.0,90.0,90.0,1,90,0.0,90.0,90.0
2491.0,17,2,762,2,762,0.0,381.0,381.0,0,0,0.0,0.0,0.0
26392.0,6,14,4740,7,653,4195.5,249.0,93.28571428571428,7,4087,4248.833333333333,1514.0,583.8571428571429
781934.0,6,14,4740,7,653,129844.0,249.0,93.28571428571428,7,4087,129906.66666666669,1514.0,583.8571428571429
2798881.0,6,2,132,1,66,0.0,66.0,66.0,1,66,0.0,66.0,66.0
43711.0,6,10,2032,5,524,10634.75,252.0,104.8,5,1508,10693.5,1236.0,301.6
339.0,17,2,216,1,84,0.0,84.0,84.0,1,132,0.0,132.0,132.0
141971.0,6,2,132,1,66,0.0,66.0,66.0,1,66,0.0,66.0,66.0
90027279.0,17,28,13364,28,13364,3334343.6666666665,501.0,477.2857142857143,0,0,0.0,0.0,0.0
119914870.0,6,20,2770,10,1270,13323874.444444444,188.0,127.0,10,1500,13321219.0,204.0,150.0
2004.0,17,4,344,2,150,0.0,75.0,75.0,2,194,0.0,103.0,97.0
90264866.0,6,13,2036,8,1016,12894980.857142856,188.0,127.0,5,1020,22525032.75,204.0,204.0
299255.0,6,6,412,4,272,99751.66666666669,74.0,68.0,2,140,0.0,74.0,70.0
39835.0,6,14,4740,7,653,6003.166666666667,249.0,93.28571428571428,7,4087,6017.833333333333,1514.0,583.8571428571429
90041415.0,17,27,12943,27,12943,3463131.346153846,501.0,479.3703703703704,0,0,0.0,0.0,0.0
108716980.0,6,33,2428,17,1288,6794811.25,139.0,75.76470588235294,16,1140,7234138.533333333,123.0,71.25
105830.0,17,2,286,2,286,0.0,143.0,143.0,0,0,0.0,0.0,0.0
90623187.0,17,12,778,6,389,18124637.4,174.0,64.83333333333333,6,389,17999920.4,174.0,64.83333333333333
153453.0,17,2,180,1,90,0.0,90.0,90.0,1,90,0.0,90.0,90.0
102444.0,17,2,286,2,286,0.0,143.0,143.0,0,0,0.0,0.0,0.0
31586.000000000004,6,14,4740,7,653,4476.5,249.0,93.28571428571428,7,4087,5126.5,1514.0,583.8571428571429
119338697.0,6,24,1829,14,1084,9176221.076923076,95.0,77.42857142857143,10,745,13206772.222222222,95.0,74.5
15864320.0,6,27,7775,14,2115,1220332.3076923075,408.0,151.07142857142858,13,5660,993778.9166666666,1514.0,435.38461538461536
25709763.0,6,5,1736,2,819,0.0,753.0,409.5,3,917,12790225.0,785.0,305.6666666666667
90227735.0,6,22,1680,10,745,9997212.444444444,95.0,74.5,12,935,8182943.454545454,95.0,77.91666666666667
30249.0,6,10,2032,5,524,7324.25,252.0,104.8,5,1508,7220.0,1236.0,301.6
135129776.0,17,6,1206,6,1206,27025955.2,201.0,201.0,0,0,0.0,0.0,0.0
130782.0,6,2,132,1,66,0.0,66.0,66.0,1,66,0.0,66.0,66.0
90035537.0,17,27,12943,27,12943,3462905.269230769,501.0,479.3703703703704,0,0,0.0,0.0,0.0
47475.0,6,14,4740,7,653,7140.5,249.0,93.28571428571428,7,4087,4737.666666666667,1514.0,583.8571428571429
12598.0,6,10,1975,5,467,2879.0,195.0,93.4,5,1508,2948.5,1236.0,301.6
146336.0,6,3,373,2,238,0.0,172.0,119.0,1,135,0.0,135.0,135.0
146944.0,6,3,337,2,214,0.0,160.0,107.0,1,123,0.0,123.0,123.0
97743648.0,6,30,2106,15,1089,6966282.357142857,123.0,72.6,15,1017,6966281.642857143,123.0,67.8
149627.0,17,2,180,1,90,0.0,90.0,90.0,1,90,0.0,90.0,90.0
216774.0,6,3,426,2,280,0.0,214.0,140.0,1,146,0.0,146.0,146.0
297560.0,6,6,412,4,272,99186.66666666669,74.0,68.0,2,140,0.0,74.0,70.0
1163253.0,6,13,3011,8,2383,166179.0,1514.0,297.875,5,628,221820.25,331.0,125.6
120142317.0,6,236,26660,118,8084,1011889.752136752,140.0,68.50847457627118,118,18576,1019794.94017094,284.0,157.42372881355934
35829.0,6,14,4740,7,653,5621.5,249.0,93.28571428571428,7,4087,5787.833333333333,1514.0,583.8571428571429
42389.0,6,14,4740,7,653,6943.5,249.0,93.28571428571428,7,4087,6693.333333333333,1514.0,583.8571428571429
437.0,17,2,166,1,75,0.0,75.0,75.0,1,91,0.0,91.0,91.0
108104934.0,17,5,955,5,955,27026233.5,191.0,191.0,0,0,0.0,0.0,0.0
135125077.0,17,6,1206,6,1206,27025015.4,201.0,201.0,0,0,0.0,0.0,0.0
108104072.0,17,5,1005,5,1005,27026018.0,201.0,201.0,0,0,0.0,0.0,0.0
218676.0,6,10,1221,6,636,43735.2,298.0,106.0,4,585,71562.33333333333,379.0,146.25
103960.0,17,2,286,2,286,0.0,143.0,143.0,0,0,0.0,0.0,0.0
2333.0,17,4,344,2,150,0.0,75.0,75.0,2,194,0.0,103.0,97.0
90025829.0,17,28,13364,28,13364,3334289.962962963,501.0,477.2857142857143,0,0,0.0,0.0,0.0
2317385.0,6,3,1604,2,851,0.0,785.0,425.5,1,753,0.0,753.0,753.0
153519.0,17,2,180,1,90,0.0,90.0,90.0,1,90,0.0,90.0,90.0
91449948.0,6,24,1829,13,989,7619833.25,95.0,76.07692307692308,11,840,9143690.8,95.0,76.36363636363636
2590022.0,6,2,132,1,66,0.0,66.0,66.0,1,66,0.0,66.0,66.0
314349.0,6,6,412,4,272,104783.0,74.0,68.0,2,140,0.0,74.0,70.0
108498488.0,6,278,32200,139,22804,784661.5579710145,464.0,164.05755395683454,139,9396,784652.9275362319,140.0,67.59712230215827
120008068.0,6,18,1341,9,691,14999938.625,95.0,76.77777777777777,9,650,14998953.0,95.0,72.22222222222223
232959.0,6,3,337,2,214,0.0,160.0,107.0,1,123,0.0,123.0,123.0
52014.0,6,14,4740,7,653,7663.666666666667,249.0,93.28571428571428,7,4087,8533.0,1514.0,583.8571428571429
138911.0,6,2,132,1,66,0.0,66.0,66.0,1,66,0.0,66.0,66.0
335.0,17,2,166,1,75,0.0,75.0,75.0,1,91,0.0,91.0,91.0
90028373.0,17,27,12943,27,12943,3462629.730769231,501.0,479.3703703703704,0,0,0.0,0.0,0.0
115634.0,6,13,1386,7,789,19272.33333333333,253.0,112.71428571428572,6,597,22138.6,259.0,99.5
119692.0,17,2,180,1,70,0.0,70.0,70.0,1,110,0.0,110.0,110.0
121254.0,6,3,337,2,214,0.0,160.0,107.0,1,123,0.0,123.0,123.0
112129.0,17,4,1400,4,1400,37376.333333333336,350.0,350.0,0,0,0.0,0.0,0.0
5628902.0,6,4,270,2,136,0.0,70.0,68.0,2,134,0.0,68.0,67.0
901.0,17,4,438,2,148,0.0,74.0,74.0,2,290,0.0,147.0,145.0
3006498.0,6,12,2172,7,664,501023.6666666667,252.0,94.85714285714286,5,1508,1984.0,1236.0,301.6
297445.0,6,6,412,4,272,99148.33333333331,74.0,68.0,2,140,0.0,74.0,70.0
20697731.0,17,6,782,3,391,10268815.0,174.0,130.33333333333334,3,391,9123023.5,174.0,130.33333333333334
206222.0,6,3,426,2,280,0.0,214.0,140.0,1,146,0.0,146.0,146.0
90038429.0,17,28,13364,28,13364,3334756.6296296297,501.0,477.2857142857143,0,0,0.0,0.0,0.0
100632480.0,17,12,516,6,258,20000829.8,43.0,43.0,6,258,20000194.0,43.0,43.0
204527.0,17,2,762,2,762,0.0,381.0,381.0,0,0,0.0,0.0,0.0
2357.0,17,4,344,2,150,0.0,75.0,75.0,2,194,0.0,103.0,97.0
194.0,17,5,550,5,550,48.5,110.0,110.0,0,0,0.0,0.0,0.0
90029761.0,17,28,13364,28,13364,3334435.592592593,501.0,477.2857142857143,0,0,0.0,0.0,0.0
103464407.0,6,249,29100,125,8472,834390.3790322581,140.0,67.776,124,20628,839343.5853658536,284.0,166.3548387096774
204766.0,17,2,762,2,762,0.0,381.0,381.0,0,0,0.0,0.0,0.0
90287992.0,6,15,1097,8,596,12898284.57142857,95.0,74.5,7,501,14999121.0,95.0,71.57142857142857
2590781.0,6,2,132,1,66,0.0,66.0,66.0,1,66,0.0,66.0,66.0
153467.0,17,2,180,1,90,0.0,90.0,90.0,1,90,0.0,90.0,90.0
135136558.0,17,6,1206,6,1206,27027311.6,201.0,201.0,0,0,0.0,0.0,0.0
108106626.0,17,5,955,5,955,27026656.5,191.0,191.0,0,0,0.0,0.0,0.0
116986930.0,6,33,2274,17,1125,7311683.125,123.0,66.17647058823529,16,1149,7118938.933333334,123.0,71.8125
216655.0,6,3,426,2,280,0.0,214.0,140.0,1,146,0.0,146.0,146.0
205963.0,6,3,426,2,280,0.0,214.0,140.0,1,146,0.0,146.0,146.0
7647.0,17,2,582,1,83,0.0,83.0,83.0,1,499,0.0,499.0,499.0
43497.0,6,14,4740,7,653,7130.5,249.0,93.28571428571428,7,4087,6923.333333333333,1514.0,583.8571428571429
256470.0,6,13,1428,7,797,42745.0,253.0,113.85714285714286,6,631,49650.2,293.0,105.16666666666669
90302391.0,6,16,1192,8,596,12893675.142857144,95.0,74.5,8,596,12900077.857142856,95.0,74.5
148042.0,17,2,180,1,90,0.0,90.0,90.0,1,90,0.0,90.0,90.0
113607858.0,6,200,22664,100,15842,1145380.4242424243,284.0,158.42,100,6822,1145380.01010101,140.0,68.22
246134.0,6,3,337,2,214,0.0,160.0,107.0,1,123,0.0,123.0,123.0
90257933.0,6,12,1832,8,1016,12893990.42857143,188.0,127.0,4,816,30031341.0,204.0,204.0
263174.0,6,10,1221,6,636,52634.8,298.0,106.0,4,585,82313.66666666667,379.0,146.25
144914.0,17,2,180,1,70,0.0,70.0,70.0,1,110,0.0,110.0,110.0
118000957.0,17,15,1169,8,606,16857279.57142857,174.0,75.75,7,563,16334280.666666666,174.0,80.42857142857143
41011.0,6,14,4740,7,653,5944.5,249.0,93.28571428571428,7,4087,6072.5,1514.0,583.8571428571429
321368.0,17,4,1400,4,1400,107122.66666666669,350.0,350.0,0,0,0.0,0.0,0.0
3244.0,17,2,224,1,76,0.0,76.0,76.0,1,148,0.0,148.0,148.0
35431.0,6,14,4740,7,653,5745.166666666667,249.0,93.28571428571428,7,4087,5418.666666666667,1514.0,583.8571428571429
310021.0,6,3,202,2,128,0.0,74.0,64.0,1,74,0.0,74.0,74.0
108099741.0,17,5,955,5,955,27024935.25,191.0,191.0,0,0,0.0,0.0,0.0
13731.0,6,12,1393,6,796,2616.4,271.0,132.66666666666666,6,597,2155.0,259.0,99.5
21909.0,17,2,582,1,83,0.0,83.0,83.0,1,499,0.0,499.0,499.0
2470198.0,6,25,7573,14,3735,190015.2307692308,1514.0,266.7857142857143,11,3838,220753.5,1514.0,348.90909090909093
98005480.0,17,13,1083,7,563,16334246.666666666,174.0,80.42857142857143,6,520,15600129.0,174.0,86.66666666666667
325644.0,6,6,412,4,272,108548.0,74.0,68.0,2,140,0.0,74.0,70.0
0.0,17,1,80,1,80,0.0,80.0,80.0,0,0,0.0,0.0,0.0
53184.0,6,13,1386,7,789,8864.0,253.0,112.71428571428572,6,597,8719.2,259.0,99.5
90023205.0,17,28,13364,28,13364,3334192.777777778,501.0,477.2857142857143,0,0,0.0,0.0,0.0
665300.0,6,4,508,2,238,0.0,172.0,119.0,2,270,0.0,135.0,135.0
304637.0,6,6,412,4,272,101545.66666666669,74.0,68.0,2,140,0.0,74.0,70.0
35898.0,6,13,1386,7,789,5363.333333333333,253.0,112.71428571428572,6,597,5234.6,259.0,99.5
120120313.0,6,14,2224,9,1204,15015039.125,188.0,133.77777777777777,5,1020,22524007.0,204.0,204.0
322.0,17,2,174,1,79,0.0,79.0,79.0,1,95,0.0,95.0,95.0
196807.0,17,2,180,1,90,0.0,90.0,90.0,1,90,0.0,90.0,90.0
153481.0,17,2,180,1,90,0.0,90.0,90.0,1,90,0.0,90.0,90.0
3050877.0,6,3,1602,2,850,0.0,784.0,425.0,1,752,0.0,752.0,752.0
13647.0,6,11,2098,6,590,2471.0,252.0,98.33333333333331,5,1508,3109.25,1236.0,301.6
323553.0,17,4,1400,4,1400,107851.0,350.0,350.0,0,0,0.0,0.0,0.0
10462181.0,6,7,478,4,272,3442100.0,74.0,68.0,3,206,5163054.5,74.0,68.66666666666667
43946.0,6,13,1386,7,789,5709.333333333333,253.0,112.71428571428572,6,597,7978.6,259.0,99.5
514622.0,6,6,758,3,410,230042.5,172.0,136.66666666666666,3,348,184906.5,135.0,116.0
187808.0,6,10,1065,5,534,46334.25,262.0,106.8,5,531,2784.0,259.0,106.2
118551571.0,6,210,23662,105,16510,1137850.1057692308,284.0,157.23809523809524,105,7152,1137850.3365384615,140.0,68.11428571428571
46544.0,6,14,4740,7,653,6258.0,249.0,93.28571428571428,7,4087,7616.5,1514.0,583.8571428571429
120046257.0,17,29,13785,29,13785,4287366.321428572,501.0,475.3448275862069,0,0,0.0,0.0,0.0
580066.0,6,4,508,2,238,0.0,172.0,119.0,2,270,0.0,135.0,135.0
439389.0,6,15,1725,8,1050,62769.857142857145,253.0,131.25,7,675,70533.0,259.0,96.42857142857144
205713.0,17,2,180,1,90,0.0,90.0,90.0,1,90,0.0,90.0,90.0
143972.0,17,2,180,1,90,0.0,90.0,90.0,1,90,0.0,90.0,90.0
146041.0,6,3,337,2,214,0.0,160.0,107.0,1,123,0.0,123.0,123.0
120219394.0,6,227,26590,105,7406,1152497.4807692308,140.0,70.53333333333333,122,19184,988084.5867768596,284.0,157.24590163934425
3008495.0,6,11,2106,6,598,601421.6,252.0,99.66666666666669,5,1508,2267.75,1236.0,301.6
302519.0,6,6,412,4,272,100839.66666666669,74.0,68.0,2,140,0.0,74.0,70.0
120119164.0,6,12,1832,8,1016,17136705.57142857,188.0,127.0,4,816,30030556.0,204.0,204.0
6988.0,17,2,180,1,90,0.0,90.0,90.0,1,90,0.0,90.0,90.0
207181.0,6,3,426,2,280,0.0,214.0,140.0,1,146,0.0,146.0,146.0
213762.0,17,2,180,1,90,0.0,90.0,90.0,1,90,0.0,90.0,90.0
1504901.0,6,4,276,2,128,0.0,74.0,64.0,2,148,0.0,74.0,74.0
252571.0,17,4,1524,4,1524,84190.33333333333,381.0,381.0,0,0,0.0,0.0,0.0
90271568.0,6,12,1832,8,1016,12895938.285714284,188.0,127.0,4,816,30036288.666666668,204.0,204.0
5623850.0,6,4,270,2,134,0.0,68.0,67.0,2,136,0.0,70.0,68.0
67475.0,6,14,4740,7,653,10456.5,249.0,93.28571428571428,7,4087,11106.5,1514.0,583.8571428571429
36868.0,6,2,145,2,145,0.0,91.0,72.5,0,0,0.0,0.0,0.0
3866.0,17,4,344,2,150,0.0,75.0,75.0,2,194,0.0,103.0,97.0
119401518.0,6,343,40462,172,11574,698254.4912280702,140.0,67.29069767441861,171,28888,700974.2764705883,300.0,168.93567251461988
118554930.0,6,264,30038,132,21104,903357.0305343512,284.0,159.87878787878788,132,8934,903356.5954198472,140.0,67.68181818181819
315687.0,17,4,1400,4,1400,105229.0,350.0,350.0,0,0,0.0,0.0,0.0
210117.0,6,3,426,2,280,0.0,214.0,140.0,1,146,0.0,146.0,146.0
217604.0,6,3,426,2,280,0.0,214.0,140.0,1,146,0.0,146.0,146.0
584.0,17,2,508,2,508,0.0,257.0,254.0,0,0,0.0,0.0,0.0
1553070.0,6,32,18850,17,1281,97066.875,217.0,75.3529411764706,15,17569,110287.64285714286,1514.0,1171.2666666666669
2591719.0,6,2,132,1,66,0.0,66.0,66.0,1,66,0.0,66.0,66.0
90099727.0,6,11,1644,4,816,30032457.33333333,204.0,204.0,7,828,15016236.333333334,188.0,118.28571428571428
245829.0,6,3,337,2,214,0.0,160.0,107.0,1,123,0.0,123.0,123.0
1440738.0,6,8,602,3,198,205583.0,66.0,66.0,5,404,336039.25,103.0,80.8
107950869.0,17,13,952,7,563,17991811.5,174.0,80.42857142857143,6,389,20032221.6,174.0,64.83333333333333
135126072.0,17,6,1146,6,1146,27025214.4,191.0,191.0,0,0,0.0,0.0,0.0
106749360.0,6,29,2068,15,1105,7609548.428571428,139.0,73.66666666666667,14,963,8194756.153846154,123.0,68.78571428571429
1103524.0,6,13,1386,7,789,183920.66666666663,253.0,112.71428571428572,6,597,218479.8,259.0,99.5
90253854.0,6,13,2036,8,1016,12893407.714285716,188.0,127.0,5,1020,22522493.75,204.0,204.0
90255208.0,6,12,1832,8,1016,12893601.142857144,188.0,127.0,4,816,30029940.666666668,204.0,204.0
101321932.0,17,14,864,7,432,16834954.5,174.0,61.71428571428572,7,432,16833495.333333332,174.0,61.71428571428572
2780128.0,6,2,132,1,66,0.0,66.0,66.0,1,66,0.0,66.0,66.0
2161810.0,17,2,876,2,876,0.0,438.0,438.0,0,0,0.0,0.0,0.0
2368.0,17,4,344,2,150,0.0,75.0,75.0,2,194,0.0,103.0,97.0
324.0,17,2,174,1,79,0.0,79.0,79.0,1,95,0.0,95.0,95.0
201438.0,6,2,132,1,66,0.0,66.0,66.0,1,66,0.0,66.0,66.0
204481.0,17,2,762,2,762,0.0,381.0,381.0,0,0,0.0,0.0,0.0
178202.0,17,2,180,1,90,0.0,90.0,90.0,1,90,0.0,90.0,90.0
318681.0,17,4,1400,4,1400,106227.0,350.0,350.0,0,0,0.0,0.0,0.0
215343.0,17,2,180,1,90,0.0,90.0,90.0,1,90,0.0,90.0,90.0
112615929.0,6,422,51764,211,37542,535241.4238095238,390.0,177.92417061611374,211,14222,535524.1571428571,140.0,67.40284360189574
2797207.0,6,2,132,1,66,0.0,66.0,66.0,1,66,0.0,66.0,66.0
2419209.0,6,23,4355,12,1447,219928.0909090909,311.0,120.58333333333331,11,2908,220183.0,1514.0,264.3636363636364
212447.0,6,3,426,2,280,0.0,214.0,140.0,1,146,0.0,146.0,146.0
117491229.0,6,48,3168,24,1584,5108314.304347826,66.0,66.0,24,1584,5098917.913043479,66.0,66.0
2339031.0,6,3,1777,1,826,0.0,826.0,826.0,2,951,0.0,885.0,475.5
143264.0,17,4,344,2,150,0.0,75.0,75.0,2,194,0.0,103.0,97.0
228173.0,17,2,180,1,90,0.0,90.0,90.0,1,90,0.0,90.0,90.0
209500.0,17,2,180,1,90,0.0,90.0,90.0,1,90,0.0,90.0,90.0
511976.0,17,6,1230,3,234,255801.50000000003,78.0,78.0,3,996,255783.50000000003,332.0,332.0
9681526.0,17,4,1376,3,1026,1031189.5,342.0,342.0,1,350,0.0,350.0,350.0
90297051.0,6,16,1192,8,596,12892927.285714284,95.0,74.5,8,596,12898233.142857144,95.0,74.5
296877.0,6,10,1221,6,636,59375.4,298.0,106.0,4,585,90651.66666666669,379.0,146.25
120110680.0,6,636,86594,318,65310,378248.7728706625,480.0,205.377358490566,318,21284,378248.858044164,140.0,66.93081761006289
43726.0,6,14,4740,7,653,7010.833333333333,249.0,93.28571428571428,7,4087,6699.833333333333,1514.0,583.8571428571429
27693805.0,17,5,1710,5,1710,6923451.25,342.0,342.0,0,0,0.0,0.0,0.0
35484.0,6,14,4740,7,653,5557.333333333333,249.0,93.28571428571428,7,4087,5566.833333333333,1514.0,583.8571428571429
13823.0,17,2,180,1,90,0.0,90.0,90.0,1,90,0.0,90.0,90.0
90039458.0,17,28,13364,28,13364,3334794.7407407407,501.0,477.2857142857143,0,0,0.0,0.0,0.0
99059575.0,6,193,21906,97,15336,1031870.5729166666,284.0,158.10309278350516,96,6570,1031898.7157894736,140.0,68.4375
108108902.0,17,5,955,5,955,27027225.5,191.0,191.0,0,0,0.0,0.0,0.0
90028997.0,17,27,12943,27,12943,3462653.730769231,501.0,479.3703703703704,0,0,0.0,0.0,0.0
39372.0,6,14,4740,7,653,6154.5,249.0,93.28571428571428,7,4087,6094.5,1514.0,583.8571428571429
2056.0,17,4,344,2,150,0.0,75.0,75.0,2,194,0.0,103.0,97.0
109932.0,17,2,700,2,700,0.0,350.0,350.0,0,0,0.0,0.0,0.0
408257.0,6,11,1021,6,444,62509.2,162.0,74.0,5,577,72093.5,349.0,115.4
120060603.0,17,28,13364,28,13364,4446689.0,501.0,477.2857142857143,0,0,0.0,0.0,0.0
316.0,17,2,174,1,79,0.0,79.0,79.0,1,95,0.0,95.0,95.0
47682.0,6,14,4740,7,653,7781.0,249.0,93.28571428571428,7,4087,7801.833333333333,1514.0,583.8571428571429
298486.0,6,6,412,4,272,99495.33333333331,74.0,68.0,2,140,0.0,74.0,70.0
47521.0,6,13,1386,7,789,5748.166666666667,253.0,112.71428571428572,6,597,9244.0,259.0,99.5
100222.0,17,2,762,2,762,0.0,381.0,381.0,0,0,0.0,0.0,0.0
90037020.0,6,13,989,6,447,12054160.4,95.0,74.5,7,542,15003956.333333334,95.0,77.42857142857143
364391.0,6,11,1021,6,444,49066.0,162.0,74.0,5,577,61132.25,349.0,115.4
120051986.0,17,29,13785,29,13785,4287570.928571428,501.0,475.3448275862069,0,0,0.0,0.0,0.0
135135642.0,17,6,1206,6,1206,27027128.4,201.0,201.0,0,0,0.0,0.0,0.0
103514.0,17,2,286,2,286,0.0,143.0,143.0,0,0,0.0,0.0,0.0
204820.0,17,3,1143,3,1143,102410.0,381.0,381.0,0,0,0.0,0.0,0.0
32002.000000000004,6,14,4740,7,653,3069.833333333333,249.0,93.28571428571428,7,4087,5151.666666666667,1514.0,583.8571428571429
2362.0,17,4,344,2,150,0.0,75.0,75.0,2,194,0.0,103.0,97.0
2466.0,17,4,625,2,163,0.0,89.0,81.5,2,462,0.0,245.0,231.0
3074818.0,6,3,204,2,134,0.0,68.0,67.0,1,70,0.0,70.0,70.0
120110333.0,6,13,2020,9,1204,15013791.625,188.0,133.77777777777777,4,816,30026125.33333333,204.0,204.0
2025.0,17,4,344,2,150,0.0,75.0,75.0,2,194,0.0,103.0,97.0
258662.0,6,10,1221,6,636,51732.4,298.0,106.0,4,585,79566.33333333333,379.0,146.25
113995.0,17,2,762,2,762,0.0,381.0,381.0,0,0,0.0,0.0,0.0
10414138.0,6,6,412,3,206,5139065.0,74.0,68.66666666666667,3,206,5138950.0,74.0,68.66666666666667
233336.0,6,3,337,2,214,0.0,160.0,107.0,1,123,0.0,123.0,123.0
2184679.0,6,18,6803,10,1501,242742.11111111112,408.0,150.1,8,5302,248707.0,1514.0,662.75
307605.0,17,4,704,2,148,0.0,74.0,74.0,2,556,0.0,280.0,278.0
935295.0,17,10,3776,10,3776,103921.66666666669,394.0,377.6,0,0,0.0,0.0,0.0
228268.0,17,2,180,1,90,0.0,90.0,90.0,1,90,0.0,90.0,90.0
12812.0,17,2,180,1,90,0.0,90.0,90.0,1,90,0.0,90.0,90.0
14034.0,6,10,2032,5,524,2764.0,252.0,104.8,5,1508,3187.0,1236.0,301.6
43611.0,6,2,132,1,66,0.0,66.0,66.0,1,66,0.0,66.0,66.0
90019701.0,17,28,13364,28,13364,3334063.0,501.0,477.2857142857143,0,0,0.0,0.0,0.0
284304.0,17,2,363,1,79,0.0,79.0,79.0,1,284,0.0,284.0,284.0
90033153.0,17,28,13364,28,13364,3334561.222222222,501.0,477.2857142857143,0,0,0.0,0.0,0.0
207043.0,6,3,426,2,280,0.0,214.0,140.0,1,146,0.0,146.0,146.0
100113957.0,17,12,516,6,258,20000193.4,43.0,43.0,6,258,20004143.6,43.0,43.0
304845.0,17,4,1524,4,1524,101615.0,381.0,381.0,0,0,0.0,0.0,0.0
90531838.0,6,14,2240,8,1016,12933119.714285716,188.0,127.0,6,1224,18073253.2,204.0,204.0
105653901.0,6,44,2904,22,1452,5031138.142857143,66.0,66.0,22,1452,5016399.285714285,66.0,66.0
225992.0,6,3,426,2,280,0.0,214.0,140.0,1,146,0.0,146.0,146.0
111359219.0,6,30,1974,15,1026,7938815.642857143,123.0,68.4,15,948,7938815.5,123.0,63.2
108197897.0,6,31,2166,16,1149,7198792.533333333,123.0,71.8125,15,1017,7712993.071428572,123.0,67.8
28670.0,6,11,2098,6,590,5529.2,252.0,98.33333333333331,5,1508,6598.5,1236.0,301.6
92503.0,6,20,9507,11,879,9250.3,211.0,79.9090909090909,9,8628,10383.75,1514.0,958.6666666666666
344.0,17,2,164,1,82,0.0,82.0,82.0,1,82,0.0,82.0,82.0
318710.0,17,4,1400,4,1400,106236.66666666669,350.0,350.0,0,0,0.0,0.0,0.0
441105.0,6,11,1021,6,444,59610.0,162.0,74.0,5,577,74271.0,349.0,115.4
260193.0,6,10,1221,6,636,52038.6,298.0,106.0,4,585,80964.66666666667,379.0,146.25
122197474.0,6,47,3102,23,1518,5159994.227272728,66.0,66.0,24,1584,5312922.565217392,66.0,66.0
307624.0,6,3,202,2,128,0.0,74.0,64.0,1,74,0.0,74.0,74.0
95090250.0,6,192,21868,96,15298,998672.1157894736,300.0,159.35416666666666,96,6570,998671.2631578948,140.0,68.4375
106411576.0,6,214,24106,107,16822,1001852.5943396228,284.0,157.21495327102804,107,7284,1001852.462264151,140.0,68.07476635514018
104145.0,17,2,286,2,286,0.0,143.0,143.0,0,0,0.0,0.0,0.0
94821739.0,6,40,2640,20,1320,4990617.842105263,66.0,66.0,20,1320,4976123.157894737,66.0,66.0
27940.0,6,14,4740,7,653,4459.333333333333,249.0,93.28571428571428,7,4087,4000.8333333333335,1514.0,583.8571428571429
378866.0,6,3,204,2,136,0.0,70.0,68.0,1,68,0.0,68.0,68.0
103417.0,17,2,286,2,286,0.0,143.0,143.0,0,0,0.0,0.0,0.0
216114.0,6,3,426,2,280,0.0,214.0,140.0,1,146,0.0,146.0,146.0
2369.0,17,4,344,2,150,0.0,75.0,75.0,2,194,0.0,103.0,97.0
147966.0,17,2,180,1,90,0.0,90.0,90.0,1,90,0.0,90.0,90.0
310242.0,17,4,1400,4,1400,103414.0,350.0,350.0,0,0,0.0,0.0,0.0
120000110.0,6,17,1287,9,691,15000013.75,95.0,76.77777777777777,8,596,12895558.714285716,95.0,74.5
304563.0,6,6,412,4,272,101521.0,74.0,68.0,2,140,0.0,74.0,70.0
103439.0,17,2,286,2,286,0.0,143.0,143.0,0,0,0.0,0.0,0.0
108104498.0,17,5,1005,5,1005,27026124.5,201.0,201.0,0,0,0.0,0.0,0.0
315099.0,17,4,1400,4,1400,105033.0,350.0,350.0,0,0,0.0,0.0,0.0
153427.0,17,2,180,1,90,0.0,90.0,90.0,1,90,0.0,90.0,90.0
204546.0,17,2,762,2,762,0.0,381.0,381.0,0,0,0.0,0.0,0.0
16783.0,6,14,4740,7,653,2542.333333333333,249.0,93.28571428571428,7,4087,2657.6666666666665,1514.0,583.8571428571429
135132279.0,17,6,1146,6,1146,27026455.8,191.0,191.0,0,0,0.0,0.0,0.0
312.0,17,2,174,1,79,0.0,79.0,79.0,1,95,0.0,95.0,95.0
49025.0,6,14,4740,7,653,8001.5,249.0,93.28571428571428,7,4087,8011.166666666667,1514.0,583.8571428571429
51934.0,6,11,2098,6,590,9388.0,252.0,98.33333333333331,5,1508,11542.0,1236.0,301.6
30829.0,6,14,4740,7,653,4314.666666666667,249.0,93.28571428571428,7,4087,4961.166666666667,1514.0,583.8571428571429
122008592.0,6,47,3882,26,2127,4880343.68,123.0,81.8076923076923,21,1755,5590287.15,123.0,83.57142857142857
120007961.0,6,36,2602,19,1408,6667108.944444444,139.0,74.10526315789474,17,1194,6862905.8125,123.0,70.23529411764706
145791.0,6,3,337,2,214,0.0,160.0,107.0,1,123,0.0,123.0,123.0
24237.0,6,14,4740,7,653,2864.6666666666665,249.0,93.28571428571428,7,4087,3648.0,1514.0,583.8571428571429
123851956.0,6,49,3234,25,1650,5160498.166666667,66.0,66.0,24,1584,5031620.869565218,66.0,66.0
35684.0,6,10,2032,5,524,8689.25,252.0,104.8,5,1508,8002.25,1236.0,301.6
206826.0,6,3,426,2,280,0.0,214.0,140.0,1,146,0.0,146.0,146.0
90207129.0,6,22,1680,10,786,9996794.222222222,95.0,78.6,12,894,8181482.545454546,95.0,74.5
298517.0,6,6,412,4,272,99505.66666666669,74.0,68.0,2,140,0.0,74.0,70.0
1044560.0,6,13,1386,7,789,174093.33333333334,253.0,112.71428571428572,6,597,208187.2,259.0,99.5
107214.0,17,2,286,2,286,0.0,143.0,143.0,0,0,0.0,0.0,0.0
59530.0,6,10,2032,5,524,11359.25,252.0,104.8,5,1508,14292.0,1236.0,301.6
62864.0,6,14,4740,7,653,9650.166666666666,249.0,93.28571428571428,7,4087,9697.666666666666,1514.0,583.8571428571429
2588329.0,6,2,132,1,66,0.0,66.0,66.0,1,66,0.0,66.0,66.0
122530456.0,6,49,3234,25,1650,5105435.666666667,66.0,66.0,24,1584,4906336.043478261,66.0,66.0
1036044.0,6,11,1134,6,558,207208.8,220.0,93.0,5,576,256429.5,304.0,115.2
1503.0,17,5,550,5,550,375.75,110.0,110.0,0,0,0.0,0.0,0.0
306511.0,6,6,412,4,272,102170.33333333331,74.0,68.0,2,140,0.0,74.0,70.0
120000016.0,6,20,1531,11,840,12000001.6,95.0,76.36363636363636,9,691,11356951.875,95.0,76.77777777777777
1240153.0,17,7,490,7,490,206692.16666666663,70.0,70.0,0,0,0.0,0.0,0.0
120116097.0,6,13,2020,9,1204,15014512.125,188.0,133.77777777777777,4,816,30027020.0,204.0,204.0
438698.0,6,11,1021,6,444,58942.0,162.0,74.0,5,577,73588.5,349.0,115.4
21035595.0,6,6,1981,4,1087,7011865.0,885.0,271.75,2,894,0.0,826.0,447.0
31872.0,6,14,4740,7,653,4616.5,249.0,93.28571428571428,7,4087,4873.0,1514.0,583.8571428571429
234052.0,6,3,373,2,238,0.0,172.0,119.0,1,135,0.0,135.0,135.0
120048489.0,17,29,13785,29,13785,4287446.035714285,501.0,475.3448275862069,0,0,0.0,0.0,0.0
107812776.0,6,28,1860,14,966,8276687.307692308,123.0,69.0,14,894,8276687.307692308,123.0,63.85714285714285
2003.0,17,4,344,2,150,0.0,75.0,75.0,2,194,0.0,103.0,97.0
98663.0,17,2,286,2,286,0.0,143.0,143.0,0,0,0.0,0.0,0.0
233193.0,6,3,337,2,214,0.0,160.0,107.0,1,123,0.0,123.0,123.0
299110.0,6,6,412,4,272,99703.33333333331,74.0,68.0,2,140,0.0,74.0,70.0
107351.0,17,2,286,2,286,0.0,143.0,143.0,0,0,0.0,0.0,0.0
335.0,17,2,762,2,762,0.0,381.0,381.0,0,0,0.0,0.0,0.0
95695726.0,17,14,4796,13,4446,6228756.0,342.0,342.0,1,350,0.0,350.0,350.0
757.0,17,4,438,2,148,0.0,74.0,74.0,2,290,0.0,147.0,145.0
108102066.0,17,5,1005,5,1005,27025516.5,201.0,201.0,0,0,0.0,0.0,0.0
298243.0,6,6,412,4,272,99414.33333333331,74.0,68.0,2,140,0.0,74.0,70.0
322205.0,17,4,1400,4,1400,107401.66666666669,350.0,350.0,0,0,0.0,0.0,0.0
102946.0,17,2,286,2,286,0.0,143.0,143.0,0,0,0.0,0.0,0.0
574349.0,6,4,508,2,238,0.0,172.0,119.0,2,270,0.0,135.0,135.0
2805410.0,6,2,132,1,66,0.0,66.0,66.0,1,66,0.0,66.0,66.0
15590.0,6,14,4740,7,653,2407.333333333333,249.0,93.28571428571428,7,4087,2414.333333333333,1514.0,583.8571428571429
26531.0,6,2,145,2,145,0.0,91.0,72.5,0,0,0.0,0.0,0.0
105031.0,17,2,762,2,762,0.0,381.0,381.0,0,0,0.0,0.0,0.0
17135.0,6,10,2032,5,524,3459.5,252.0,104.8,5,1508,3903.75,1236.0,301.6
503123.0,6,5,336,2,134,0.0,68.0,67.0,3,202,191723.0,70.0,67.33333333333333
58428.0,6,14,4740,7,653,9610.666666666666,249.0,93.28571428571428,7,4087,8807.5,1514.0,583.8571428571429
207205.0,6,3,426,2,280,0.0,214.0,140.0,1,146,0.0,146.0,146.0
13399.0,6,13,1459,7,862,2233.1666666666665,271.0,123.14285714285714,6,597,2131.4,259.0,99.5
119441298.0,17,35,16705,35,16705,3512979.3529411764,501.0,477.2857142857143,0,0,0.0,0.0,0.0
354.0,17,2,267,1,83,0.0,83.0,83.0,1,184,0.0,184.0,184.0
135137976.0,17,6,1146,6,1146,27027595.2,191.0,191.0,0,0,0.0,0.0,0.0
113520383.0,6,46,3036,23,1518,5160005.363636363,66.0,66.0,23,1518,5160006.363636363,66.0,66.0
35387.0,6,11,2098,6,590,6497.0,252.0,98.33333333333331,5,1508,7779.5,1236.0,301.6
90293142.0,6,16,1192,8,596,12893244.57142857,95.0,74.5,8,596,12898374.0,95.0,74.5
10510153.0,6,6,412,3,206,5184763.0,74.0,68.66666666666667,3,206,5184657.5,74.0,68.66666666666667
312865.0,17,4,1400,4,1400,104288.33333333331,350.0,350.0,0,0,0.0,0.0,0.0
1034980.0,6,11,1134,6,558,206996.0,220.0,93.0,5,576,256724.0,304.0,115.2
21992.0,6,14,4740,7,653,3512.1666666666665,249.0,93.28571428571428,7,4087,3503.5,1514.0,583.8571428571429
123730525.0,6,49,3234,25,1650,5155438.541666667,66.0,66.0,24,1584,5113856.608695652,66.0,66.0
23379.0,6,14,4740,7,653,3540.833333333333,249.0,93.28571428571428,7,4087,3756.8333333333335,1514.0,583.8571428571429
131477.0,6,3,337,2,214,0.0,160.0,107.0,1,123,0.0,123.0,123.0
108106048.0,17,5,955,5,955,27026512.0,191.0,191.0,0,0,0.0,0.0,0.0
14634172.0,6,20,1607,10,975,1593061.7777777778,315.0,97.5,10,632,1593026.2222222222,78.0,63.2
196983.0,17,2,180,1,90,0.0,90.0,90.0,1,90,0.0,90.0,90.0
100770485.0,6,30,2106,15,1089,7183136.785714285,123.0,72.6,15,1017,7183172.0,123.0,67.8
264223.0,17,4,1400,4,1400,88074.33333333333,350.0,350.0,0,0,0.0,0.0,0.0
196930.0,17,2,180,1,90,0.0,90.0,90.0,1,90,0.0,90.0,90.0
65980.0,6,14,4740,7,653,10705.0,249.0,93.28571428571428,7,4087,10562.666666666666,1514.0,583.8571428571429
85.0,17,2,700,2,700,0.0,350.0,350.0,0,0,0.0,0.0,0.0
100210999.0,17,11,604,6,389,19890466.4,174.0,64.83333333333333,5,215,19995429.25,43.0,43.0
660.0,17,2,762,2,762,0.0,381.0,381.0,0,0,0.0,0.0,0.0
1158172.0,6,13,3018,8,2390,165453.14285714287,1514.0,298.75,5,628,221430.25,331.0,125.6
40919.0,6,10,2032,5,524,9957.75,252.0,104.8,5,1508,8076.75,1236.0,301.6
184750.0,17,2,180,1,90,0.0,90.0,90.0,1,90,0.0,90.0,90.0
307285.0,6,6,412,4,272,102428.33333333331,74.0,68.0,2,140,0.0,74.0,70.0
2370150.0,6,25,7573,14,3735,182319.2307692308,1514.0,266.7857142857143,11,3838,209848.5,1514.0,348.90909090909093
32578.000000000004,6,14,4740,7,653,4061.0,249.0,93.28571428571428,7,4087,5297.333333333333,1514.0,583.8571428571429
90076072.0,17,28,13364,28,13364,3336150.814814815,501.0,477.2857142857143,0,0,0.0,0.0,0.0
90765626.0,6,17,1287,9,691,11339536.125,95.0,76.77777777777777,8,596,12964199.57142857,95.0,74.5
23229.0,6,11,1133,6,602,4496.2,264.0,100.33333333333331,5,531,4810.5,259.0,106.2
114839381.0,6,29,1920,15,1026,8202812.928571428,123.0,68.4,14,894,8049136.0,123.0,63.85714285714285
205847.0,17,2,180,1,90,0.0,90.0,90.0,1,90,0.0,90.0,90.0
97802005.0,6,25,1686,13,840,8150167.083333333,123.0,64.61538461538461,12,846,7964734.181818182,123.0,70.5
2004.0,17,4,344,2,150,0.0,75.0,75.0,2,194,0.0,103.0,97.0
31710.000000000004,6,14,4740,7,653,5062.166666666667,249.0,93.28571428571428,7,4087,4681.5,1514.0,583.8571428571429
121299580.0,6,202,22742,101,6962,1194346.28,140.0,68.93069306930693,101,15780,1204720.84,284.0,156.23762376237624
317431.0,17,4,1400,4,1400,105810.33333333331,350.0,350.0,0,0,0.0,0.0,0.0
125024110.0,17,15,1169,8,606,17860587.14285714,174.0,75.75,7,563,17498951.333333332,174.0,80.42857142857143
297781.0,6,6,412,4,272,99260.33333333331,74.0,68.0,2,140,0.0,74.0,70.0
108346824.0,17,14,864,7,432,17837269.666666668,174.0,61.71428571428572,7,432,17833494.0,174.0,61.71428571428572
4400.0,17,2,614,1,72,0.0,72.0,72.0,1,542,0.0,542.0,542.0
79418.0,6,10,2032,5,524,19437.75,252.0,104.8,5,1508,9749.0,1236.0,301.6
232140.0,6,3,337,2,214,0.0,160.0,107.0,1,123,0.0,123.0,123.0
197374.0,17,2,180,1,90,0.0,90.0,90.0,1,90,0.0,90.0,90.0
122142.0,6,3,373,2,238,0.0,172.0,119.0,1,135,0.0,135.0,135.0
203339.0,17,2,180,1,90,0.0,90.0,90.0,1,90,0.0,90.0,90.0
120070859.0,17,28,13364,28,13364,4447068.851851852,501.0,477.2857142857143,0,0,0.0,0.0,0.0
153404.0,17,2,180,1,90,0.0,90.0,90.0,1,90,0.0,90.0,90.0
90073056.0,6,13,2052,6,1224,18014390.0,204.0,204.0,7,828,15008779.166666666,188.0,118.28571428571428
10462050.0,6,6,412,3,206,5160162.5,74.0,68.66666666666667,3,206,5160053.0,74.0,68.66666666666667
25336309.0,6,5,1736,2,819,0.0,753.0,409.5,3,917,12597239.5,785.0,305.6666666666667
326.0,17,2,174,1,79,0.0,79.0,79.0,1,95,0.0,95.0,95.0
108105738.0,17,5,1005,5,1005,27026434.5,201.0,201.0,0,0,0.0,0.0,0.0
209258.0,6,10,1221,6,636,41851.6,298.0,106.0,4,585,68527.66666666667,379.0,146.25
234579.0,6,3,373,2,238,0.0,172.0,119.0,1,135,0.0,135.0,135.0
2440.0,17,4,344,2,150,0.0,75.0,75.0,2,194,0.0,103.0,97.0
28151.0,6,14,4740,7,653,4566.166666666667,249.0,93.28571428571428,7,4087,4372.5,1514.0,583.8571428571429
8833.0,17,4,823,2,163,0.0,89.0,81.5,2,660,0.0,443.0,330.0
3016.0,17,4,625,2,163,0.0,89.0,81.5,2,462,0.0,245.0,231.0
3524.0,17,2,414,1,88,0.0,88.0,88.0,1,326,0.0,326.0,326.0
1415917.0,17,16,1120,16,1120,94394.46666666666,70.0,70.0,0,0,0.0,0.0,0.0
90180381.0,6,18,1469,9,819,11246979.0,223.0,91.0,9,650,11246952.125,95.0,72.22222222222223
103866.0,17,2,286,2,286,0.0,143.0,143.0,0,0,0.0,0.0,0.0
39101.0,6,14,4740,7,653,6144.166666666667,249.0,93.28571428571428,7,4087,6355.5,1514.0,583.8571428571429
22505.0,6,10,1066,5,490,4898.0,218.0,98.0,5,576,4855.5,304.0,115.2
26073.0,6,14,4740,7,653,3795.5,249.0,93.28571428571428,7,4087,4139.166666666667,1514.0,583.8571428571429
90705796.0,6,18,1341,10,745,10077260.333333334,95.0,74.5,8,596,8703765.57142857,95.0,74.5
2327215.0,6,3,1604,2,851,0.0,785.0,425.5,1,753,0.0,753.0,753.0
320.0,17,2,166,1,75,0.0,75.0,75.0,1,91,0.0,91.0,91.0
3008803.0,6,11,2106,6,598,601584.2,252.0,99.66666666666669,5,1508,2176.25,1236.0,301.6
120020305.0,17,28,13364,28,13364,4445196.481481481,501.0,477.2857142857143,0,0,0.0,0.0,0.0
242115.0,6,3,337,2,214,0.0,160.0,107.0,1,123,0.0,123.0,123.0
122975197.0,6,48,3168,24,1584,5047831.652173913,66.0,66.0,24,1584,5219258.391304348,66.0,66.0
153358.0,17,2,180,1,90,0.0,90.0,90.0,1,90,0.0,90.0,90.0
102231404.0,6,204,23136,102,16170,1010060.5742574256,284.0,158.52941176470588,102,6966,1010062.0891089108,140.0,68.29411764705883
104159.0,17,2,286,2,286,0.0,143.0,143.0,0,0,0.0,0.0,0.0
64787.0,6,10,2032,5,524,15246.75,252.0,104.8,5,1508,15331.0,1236.0,301.6
60167.0,6,14,4740,7,653,8987.166666666666,249.0,93.28571428571428,7,4087,7237.666666666667,1514.0,583.8571428571429
1027245.0,6,11,1134,6,558,205449.0,220.0,93.0,5,576,254867.0,304.0,115.2
5632.0,6,2,258,1,54,0.0,54.0,54.0,1,204,0.0,204.0,204.0
46791895.0,6,8,2113,3,960,22012626.0,826.0,320.0,5,1153,11003128.0,885.0,230.6
102308038.0,17,14,864,7,432,16834752.5,174.0,61.71428571428572,7,432,16833508.666666668,174.0,61.71428571428572
15970.000000000002,6,10,2032,5,524,3591.0,252.0,104.8,5,1508,3730.5,1236.0,301.6
93092.0,6,13,1386,7,789,15515.333333333334,253.0,112.71428571428572,6,597,14882.8,259.0,99.5
27549.0,6,10,2032,5,524,6586.0,252.0,104.8,5,1508,6358.0,1236.0,301.6
90099448.0,6,11,1644,4,816,30032293.0,204.0,204.0,7,828,15016362.5,188.0,118.28571428571428
761046.0,6,6,758,3,410,291974.0,172.0,136.66666666666666,3,348,264756.5,135.0,116.0
83.0,17,2,762,2,762,0.0,381.0,381.0,0,0,0.0,0.0,0.0
108106952.0,17,5,1005,5,1005,27026738.0,201.0,201.0,0,0,0.0,0.0,0.0
0.0,6,1,66,1,66,0.0,66.0,66.0,0,0,0.0,0.0,0.0
2370.0,17,4,344,2,150,0.0,75.0,75.0,2,194,0.0,103.0,97.0
108099909.0,17,5,955,5,955,27024977.25,191.0,191.0,0,0,0.0,0.0,0.0
244438.0,6,3,337,2,214,0.0,160.0,107.0,1,123,0.0,123.0,123.0
321090.0,17,4,1400,4,1400,107030.0,350.0,350.0,0,0,0.0,0.0,0.0
10538499.0,6,7,478,4,272,3466570.0,74.0,68.0,3,206,5199739.5,74.0,68.66666666666667
107000971.0,17,13,821,7,432,17833495.166666668,174.0,61.71428571428572,6,389,17400701.2,174.0,64.83333333333333
2157576.0,6,24,7543,13,2516,179798.0,1034.0,193.53846153846155,11,5027,184802.3,1510.0,457.0
1168802.0,6,13,3009,8,2381,166971.7142857143,1514.0,297.625,5,628,223327.25,331.0,125.6
103254.0,17,2,286,2,286,0.0,143.0,143.0,0,0,0.0,0.0,0.0
304155.0,17,4,1400,4,1400,101385.0,350.0,350.0,0,0,0.0,0.0,0.0
206472.0,6,3,426,2,280,0.0,214.0,140.0,1,146,0.0,146.0,146.0
58658.0,6,14,4740,7,653,9559.166666666666,249.0,93.28571428571428,7,4087,9166.0,1514.0,583.8571428571429
2094534.0,6,19,6869,11,1567,209453.4,408.0,142.45454545454547,8,5302,236554.7142857143,1514.0,662.75
228288.0,17,2,180,1,90,0.0,90.0,90.0,1,90,0.0,90.0,90.0
90274062.0,6,14,2240,8,1016,12896294.57142857,188.0,127.0,6,1224,18022543.0,204.0,204.0
748.0,17,4,438,2,148,0.0,74.0,74.0,2,290,0.0,147.0,145.0
172021.0,17,2,180,1,90,0.0,90.0,90.0,1,90,0.0,90.0,90.0
37516.0,6,14,4740,7,653,5778.833333333333,249.0,93.28571428571428,7,4087,5299.333333333333,1514.0,583.8571428571429
205631.0,17,2,180,1,90,0.0,90.0,90.0,1,90,0.0,90.0,90.0
13040.0,6,10,1066,5,490,3089.75,218.0,98.0,5,576,2397.25,304.0,115.2
381.0,17,2,152,1,76,0.0,76.0,76.0,1,76,0.0,76.0,76.0
220483.0,6,3,426,2,280,0.0,214.0,140.0,1,146,0.0,146.0,146.0
38547.0,6,14,4740,7,653,6174.833333333333,249.0,93.28571428571428,7,4087,5088.833333333333,1514.0,583.8571428571429
20695.0,17,2,582,1,83,0.0,83.0,83.0,1,499,0.0,499.0,499.0
0.0,17,1,381,1,381,0.0,381.0,381.0,0,0,0.0,0.0,0.0
117201352.0,6,223,25236,112,7614,1055868.036036036,140.0,67.98214285714286,111,17622,1056977.2545454546,300.0,158.75675675675674
153551.0,17,2,180,1,90,0.0,90.0,90.0,1,90,0.0,90.0,90.0
9998.0,17,4,823,2,163,0.0,89.0,81.5,2,660,0.0,443.0,330.0
239883.0,17,2,180,1,70,0.0,70.0,70.0,1,110,0.0,110.0,110.0
120225937.0,6,2458,2128124,1688,2077304,71266.11558980438,1514.0,1230.6303317535544,770,50820,155732.38621586477,66.0,66.0
281089.0,17,2,363,1,79,0.0,79.0,79.0,1,284,0.0,284.0,284.0
147947.0,17,2,180,1,90,0.0,90.0,90.0,1,90,0.0,90.0,90.0
146126.0,6,3,337,2,214,0.0,160.0,107.0,1,123,0.0,123.0,123.0
0.0,6,1,54,0,0,0.0,0.0,0.0,1,54,0.0,54.0,54.0
9890.0,17,2,582,1,83,0.0,83.0,83.0,1,499,0.0,499.0,499.0
115025453.0,17,14,864,7,432,19166836.33333333,174.0,61.71428571428572,7,432,19167487.166666668,174.0,61.71428571428572
2389.0,17,4,344,2,150,0.0,75.0,75.0,2,194,0.0,103.0,97.0
3587.0,17,2,174,1,79,0.0,79.0,79.0,1,95,0.0,95.0,95.0
2798810.0,6,2,132,1,66,0.0,66.0,66.0,1,66,0.0,66.0,66.0
120004994.0,6,17,1246,9,650,15000624.25,95.0,72.22222222222223,8,596,17106789.714285713,95.0,74.5
239218.0,17,2,180,1,90,0.0,90.0,90.0,1,90,0.0,90.0,90.0
240823.0,6,3,373,2,238,0.0,172.0,119.0,1,135,0.0,135.0,135.0
153427.0,17,2,180,1,90,0.0,90.0,90.0,1,90,0.0,90.0,90.0
13388.0,6,10,2032,5,524,2491.0,252.0,104.8,5,1508,3063.75,1236.0,301.6
51147.0,6,14,4740,7,653,8251.166666666666,249.0,93.28571428571428,7,4087,7917.666666666667,1514.0,583.8571428571429
120030422.0,17,29,13785,29,13785,4286800.785714285,501.0,475.3448275862069,0,0,0.0,0.0,0.0
0.0,17,1,453,1,453,0.0,453.0,453.0,0,0,0.0,0.0,0.0
10458838.0,6,6,412,3,206,5161188.0,74.0,68.66666666666667,3,206,5161051.0,74.0,68.66666666666667
108623.0,17,2,286,2,286,0.0,143.0,143.0,0,0,0.0,0.0,0.0
199595.0,17,4,6056,4,6056,66531.66666666667,1514.0,1514.0,0,0,0.0,0.0,0.0
34939.0,6,10,2032,5,524,8154.25,252.0,104.8,5,1508,8037.5,1236.0,301.6
120345418.0,6,211,23930,106,16778,1146146.8380952382,284.0,158.28301886792454,105,7152,1147275.923076923,140.0,68.11428571428571
19181.0,6,20,7606,11,978,1918.1,310.0,88.9090909090909,9,6628,1992.375,1514.0,736.4444444444445
228208.0,17,2,180,1,90,0.0,90.0,90.0,1,90,0.0,90.0,90.0
334.0,17,2,166,1,75,0.0,75.0,75.0,1,91,0.0,91.0,91.0
2419.0,17,4,344,2,150,0.0,75.0,75.0,2,194,0.0,103.0,97.0
36594.0,6,11,2098,6,590,6705.6,252.0,98.33333333333331,5,1508,8395.75,1236.0,301.6
130008.0,6,14,4740,7,653,19919.0,249.0,93.28571428571428,7,4087,19609.5,1514.0,583.8571428571429
472.0,17,2,250,1,93,0.0,93.0,93.0,1,157,0.0,157.0,157.0
323.0,17,2,174,1,79,0.0,79.0,79.0,1,95,0.0,95.0,95.0
118072.0,17,2,700,2,700,0.0,350.0,350.0,0,0,0.0,0.0,0.0
135111000.0,17,6,1146,6,1146,27022200.0,191.0,191.0,0,0,0.0,0.0,0.0
297.0,17,2,168,1,76,0.0,76.0,76.0,1,92,0.0,92.0,92.0
4176.0,17,2,598,1,72,0.0,72.0,72.0,1,526,0.0,526.0,526.0
302.0,17,2,156,1,78,0.0,78.0,78.0,1,78,0.0,78.0,78.0
139050.0,6,2,132,1,66,0.0,66.0,66.0,1,66,0.0,66.0,66.0
3007655.0,6,12,2172,7,664,501166.0,252.0,94.85714285714286,5,1508,2341.5,1236.0,301.6
120391624.0,6,217,24468,109,17044,1114737.259259259,284.0,156.36697247706422,108,7424,1115599.261682243,140.0,68.74074074074075
142218.0,6,2,132,1,66,0.0,66.0,66.0,1,66,0.0,66.0,66.0
129939008.0,17,17,1517,9,780,16242376.0,174.0,86.66666666666667,8,737,15706079.285714284,174.0,92.125
951094.0,6,5,1742,3,921,475547.0,785.0,307.0,2,821,0.0,753.0,410.5
3082999.0,6,4,270,2,134,0.0,68.0,67.0,2,136,0.0,70.0,68.0
3043.0,17,2,224,1,76,0.0,76.0,76.0,1,148,0.0,148.0,148.0
3004765.0,6,11,2106,6,598,600768.6,252.0,99.66666666666669,5,1508,1647.0,1236.0,301.6
17066.0,6,13,1459,7,862,2538.833333333333,271.0,123.14285714285714,6,597,3253.0,259.0,99.5
4487.0,17,2,614,1,72,0.0,72.0,72.0,1,542,0.0,542.0,542.0
874352.0,6,9,1196,6,725,174870.4,387.0,120.83333333333331,3,471,299527.0,331.0,157.0
31543.0,6,14,4740,7,653,4192.666666666667,249.0,93.28571428571428,7,4087,5022.0,1514.0,583.8571428571429
30944.0,6,10,2032,5,524,6749.75,252.0,104.8,5,1508,7322.5,1236.0,301.6
2798914.0,6,3,1777,2,951,0.0,885.0,475.5,1,826,0.0,826.0,826.0
120001299.0,17,13,559,7,301,20000216.5,43.0,43.0,6,258,20001178.4,43.0,43.0
108107460.0,17,5,955,5,955,27026865.0,191.0,191.0,0,0,0.0,0.0,0.0
90301104.0,6,16,1192,8,596,12892899.857142856,95.0,74.5,8,596,12899611.142857144,95.0,74.5
2268.0,17,4,344,2,150,0.0,75.0,75.0,2,194,0.0,103.0,97.0
47027.0,6,13,1479,7,882,7714.0,291.0,126.0,6,597,8318.0,259.0,99.5
10446090.0,6,7,478,4,272,3435410.0,74.0,68.0,3,206,5152994.0,74.0,68.66666666666667
1178120.0,6,13,3014,8,2386,168302.85714285713,1514.0,298.25,5,628,226354.75,331.0,125.6
148610.0,17,2,414,1,88,0.0,88.0,88.0,1,326,0.0,326.0,326.0
317075.0,17,4,1400,4,1400,105691.66666666669,350.0,350.0,0,0,0.0,0.0,0.0
196942.0,17,2,180,1,90,0.0,90.0,90.0,1,90,0.0,90.0,90.0
127005097.0,17,15,907,8,475,18143585.285714287,174.0,59.375,7,432,17833501.0,174.0,61.71428571428572
200694.0,17,4,6056,4,6056,66898.0,1514.0,1514.0,0,0,0.0,0.0,0.0
217708.0,6,3,426,2,280,0.0,214.0,140.0,1,146,0.0,146.0,146.0
135135636.0,17,6,1146,6,1146,27027127.2,191.0,191.0,0,0,0.0,0.0,0.0
47480.0,6,14,4740,7,653,7543.833333333333,249.0,93.28571428571428,7,4087,7588.0,1514.0,583.8571428571429
319339.0,17,4,1400,4,1400,106446.33333333331,350.0,350.0,0,0,0.0,0.0,0.0
30390.0,6,10,2032,5,524,7360.0,252.0,104.8,5,1508,6610.75,1236.0,301.6
143980.0,17,2,180,1,90,0.0,90.0,90.0,1,90,0.0,90.0,90.0
101505467.0,6,300,37804,150,27670,679801.1208053691,374.0,184.46666666666667,150,10134,679800.8053691275,140.0,67.56
246144.0,6,3,337,2,214,0.0,160.0,107.0,1,123,0.0,123.0,123.0
106443.0,17,2,286,2,286,0.0,143.0,143.0,0,0,0.0,0.0,0.0
53778.0,6,10,2032,5,524,12606.75,252.0,104.8,5,1508,12211.25,1236.0,301.6
233288.0,6,3,337,2,214,0.0,160.0,107.0,1,123,0.0,123.0,123.0
2365.0,17,4,344,2,150,0.0,75.0,75.0,2,194,0.0,103.0,97.0
363797.0,6,11,1021,6,444,48890.6,162.0,74.0,5,577,61033.0,349.0,115.4
16141.0,6,14,4740,7,653,2461.5,249.0,93.28571428571428,7,4087,2380.5,1514.0,583.8571428571429
10919298.0,6,7,478,3,206,5391559.5,74.0,68.66666666666667,4,272,3594279.6666666665,74.0,68.0
27151767.0,17,5,1710,5,1710,6787941.75,342.0,342.0,0,0,0.0,0.0,0.0
216485.0,6,3,426,2,280,0.0,214.0,140.0,1,146,0.0,146.0,146.0
2790390.0,6,2,132,1,66,0.0,66.0,66.0,1,66,0.0,66.0,66.0
17921.0,6,14,4740,7,653,2830.6666666666665,249.0,93.28571428571428,7,4087,2833.833333333333,1514.0,583.8571428571429
23687.0,6,10,2032,5,524,5693.25,252.0,104.8,5,1508,5452.75,1236.0,301.6
281395.0,17,2,414,1,88,0.0,88.0,88.0,1,326,0.0,326.0,326.0
30822.0,6,12,1320,6,723,5546.4,253.0,120.5,6,597,4999.0,259.0,99.5
307041.0,6,6,412,4,272,102347.0,74.0,68.0,2,140,0.0,74.0,70.0
135128312.0,17,6,1146,6,1146,27025662.4,191.0,191.0,0,0,0.0,0.0,0.0
1312453.0,17,7,490,7,490,218742.16666666663,70.0,70.0,0,0,0.0,0.0,0.0
108100507.0,17,5,1005,5,1005,27025126.75,201.0,201.0,0,0,0.0,0.0,0.0
90740242.0,6,23,1775,13,989,7558247.666666667,95.0,76.07692307692308,10,786,10081343.888888888,95.0,78.6
135137413.0,17,6,1206,6,1206,27027482.6,201.0,201.0,0,0,0.0,0.0,0.0
7199.0,17,2,582,1,83,0.0,83.0,83.0,1,499,0.0,499.0,499.0
764453.0,6,11,1131,6,600,152368.2,262.0,100.0,5,531,190550.75,259.0,106.2
103006520.0,17,13,821,7,432,17167753.333333332,174.0,61.71428571428572,6,389,16533686.2,174.0,64.83333333333333
3147378.0,6,3,1604,2,851,0.0,785.0,425.5,1,753,0.0,753.0,753.0
644698.0,17,2,876,2,876,0.0,438.0,438.0,0,0,0.0,0.0,0.0
5005563.0,17,4,849,2,166,0.0,83.0,83.0,2,683,0.0,499.0,341.5
380566.0,6,10,1221,6,636,76113.2,298.0,106.0,4,585,121472.0,379.0,146.25
2402.0,17,4,344,2,150,0.0,75.0,75.0,2,194,0.0,103.0,97.0
0.0,17,1,381,1,381,0.0,381.0,381.0,0,0,0.0,0.0,0.0
120123863.0,6,13,2036,5,1020,30030965.75,204.0,204.0,8,1016,17136843.714285713,188.0,127.0
106629814.0,17,16,1212,8,606,15210012.857142856,174.0,75.75,8,606,15188409.0,174.0,75.75
19833.0,17,2,582,1,83,0.0,83.0,83.0,1,499,0.0,499.0,499.0
135135916.0,17,6,1206,6,1206,27027183.2,201.0,201.0,0,0,0.0,0.0,0.0
108094183.0,17,5,1005,5,1005,27023545.75,201.0,201.0,0,0,0.0,0.0,0.0
170216.0,17,2,1500,1,994,0.0,994.0,994.0,1,506,0.0,506.0,506.0
3495099.0,6,166,141640,100,132982,35304.030303030304,1510.0,1329.82,66,8658,49091.09230769231,1510.0,131.1818181818182
312114.0,17,4,1400,4,1400,104038.0,350.0,350.0,0,0,0.0,0.0,0.0
1302492.0,6,4,264,2,132,0.0,66.0,66.0,2,132,0.0,66.0,66.0
121315.0,6,3,337,2,214,0.0,160.0,107.0,1,123,0.0,123.0,123.0
218121.0,6,3,426,2,280,0.0,214.0,140.0,1,146,0.0,146.0,146.0
197212.0,17,2,180,1,90,0.0,90.0,90.0,1,90,0.0,90.0,90.0
154489.0,17,2,414,1,88,0.0,88.0,88.0,1,326,0.0,326.0,326.0
318682.0,17,4,1400,4,1400,106227.33333333331,350.0,350.0,0,0,0.0,0.0,0.0
190889.0,17,2,180,1,90,0.0,90.0,90.0,1,90,0.0,90.0,90.0
100617.0,17,2,762,2,762,0.0,381.0,381.0,0,0,0.0,0.0,0.0
90366473.0,6,16,2384,8,1368,12909306.142857144,204.0,171.0,8,1016,12874526.857142856,188.0,127.0
313176.0,17,4,1400,4,1400,104392.0,350.0,350.0,0,0,0.0,0.0,0.0
120128865.0,6,638,90176,319,21350,375552.11635220126,140.0,66.92789968652038,319,68826,377740.6446540881,336.0,215.75548589341693
90047504.0,17,28,13364,28,13364,3335092.7407407407,501.0,477.2857142857143,0,0,0.0,0.0,0.0
2392.0,17,2,762,2,762,0.0,381.0,381.0,0,0,0.0,0.0,0.0
232615.0,17,4,6056,4,6056,77538.33333333333,1514.0,1514.0,0,0,0.0,0.0,0.0
2057.0,17,4,344,2,150,0.0,75.0,75.0,2,194,0.0,103.0,97.0
320873.0,17,4,1400,4,1400,106957.66666666669,350.0,350.0,0,0,0.0,0.0,0.0
90792119.0,6,20,1531,11,840,9072682.5,95.0,76.36363636363636,9,691,11347607.75,95.0,76.77777777777777
5006923.0,17,4,849,2,166,0.0,83.0,83.0,2,683,0.0,499.0,341.5
283090.0,17,2,180,1,90,0.0,90.0,90.0,1,90,0.0,90.0,90.0
325862.0,6,3,1604,1,753,0.0,753.0,753.0,2,851,0.0,785.0,425.5
35794.0,6,14,4740,7,653,5285.666666666667,249.0,93.28571428571428,7,4087,5111.833333333333,1514.0,583.8571428571429
2338.0,17,4,344,2,150,0.0,75.0,75.0,2,194,0.0,103.0,97.0
120162086.0,6,234,26448,117,7944,1028665.3706896552,140.0,67.8974358974359,117,18504,1028938.6293103448,300.0,158.15384615384616
4235.0,17,2,762,2,762,0.0,381.0,381.0,0,0,0.0,0.0,0.0
107841644.0,6,28,1860,14,966,8278883.692307692,123.0,69.0,14,894,8278896.076923077,123.0,63.85714285714285
121357.0,6,3,337,2,214,0.0,160.0,107.0,1,123,0.0,123.0,123.0
120043678.0,17,29,13785,29,13785,4287274.214285715,501.0,475.3448275862069,0,0,0.0,0.0,0.0
205765.0,17,2,762,2,762,0.0,381.0,381.0,0,0,0.0,0.0,0.0
312609.0,6,3,202,2,128,0.0,74.0,64.0,1,74,0.0,74.0,74.0
108107955.0,17,5,955,5,955,27026988.75,191.0,191.0,0,0,0.0,0.0,0.0
120322088.0,6,257,28908,129,20164,940016.3125,284.0,156.31007751937983,128,8744,932001.8267716536,140.0,68.3125
299829.0,6,12,1373,7,714,49971.5,298.0,102.0,5,659,68397.25,379.0,131.8
307311.0,6,6,412,4,272,102437.0,74.0,68.0,2,140,0.0,74.0,70.0
9319.0,17,2,571,1,86,0.0,86.0,86.0,1,485,0.0,485.0,485.0
120069434.0,6,32,2167,16,1165,7990248.666666667,139.0,72.8125,16,1002,7990250.733333333,123.0,62.625
90307971.0,6,16,1192,8,596,12893954.142857144,95.0,74.5,8,596,12899409.57142857,95.0,74.5
44194.0,6,10,2032,5,524,10819.25,252.0,104.8,5,1508,9659.75,1236.0,301.6
156602.0,6,3,337,2,214,0.0,160.0,107.0,1,123,0.0,123.0,123.0
40539.0,6,14,4740,7,653,6641.833333333333,249.0,93.28571428571428,7,4087,6291.333333333333,1514.0,583.8571428571429
54036.0,6,14,4740,7,653,8260.166666666666,249.0,93.28571428571428,7,4087,8778.166666666666,1514.0,583.8571428571429
95094804.0,17,12,778,6,389,19000188.6,174.0,64.83333333333333,6,389,19000668.6,174.0,64.83333333333333
10483960.0,6,7,478,4,272,3447436.0,74.0,68.0,3,206,5171070.5,74.0,68.66666666666667
43627.0,6,10,2032,5,524,8899.75,252.0,104.8,5,1508,10574.0,1236.0,301.6
2523.0,17,2,762,2,762,0.0,381.0,381.0,0,0,0.0,0.0,0.0
135125434.0,17,6,1206,6,1206,27025086.8,201.0,201.0,0,0,0.0,0.0,0.0
153452.0,17,2,180,1,90,0.0,90.0,90.0,1,90,0.0,90.0,90.0
2084786.0,6,19,6869,11,1567,208478.6,408.0,142.45454545454547,8,5302,234964.7142857143,1514.0,662.75
38911401.0,6,33,10980,18,3951,147438.5294117647,1514.0,219.5,15,7029,2763930.1428571427,1514.0,468.6
102313652.0,6,180,20300,90,14064,1147173.6853932585,284.0,156.26666666666668,90,6236,1147173.573033708,140.0,69.28888888888889
101031.0,17,2,762,2,762,0.0,381.0,381.0,0,0,0.0,0.0,0.0
228390.0,17,2,180,1,90,0.0,90.0,90.0,1,90,0.0,90.0,90.0
237831.0,6,4,492,2,280,0.0,214.0,140.0,2,212,0.0,146.0,106.0
48630465.0,6,14,982,6,437,9720816.0,95.0,72.83333333333333,8,545,6946220.857142857,95.0,68.125
42654.0,6,14,4740,7,653,5596.0,249.0,93.28571428571428,7,4087,6820.333333333333,1514.0,583.8571428571429
241087.0,6,3,373,2,238,0.0,172.0,119.0,1,135,0.0,135.0,135.0
90728132.0,6,177,20044,89,14014,1031001.5,284.0,157.46067415730337,88,6030,1030893.6781609196,140.0,68.52272727272727
11907.0,6,10,1065,5,534,2695.75,262.0,106.8,5,531,2760.75,259.0,106.2
135126676.0,17,6,1146,6,1146,27025335.2,191.0,191.0,0,0,0.0,0.0,0.0
1325321.0,6,4,264,2,132,0.0,66.0,66.0,2,132,0.0,66.0,66.0
29737.0,6,14,4740,7,653,3983.6666666666665,249.0,93.28571428571428,7,4087,4744.0,1514.0,583.8571428571429
322629.0,17,4,1400,4,1400,107543.0,350.0,350.0,0,0,0.0,0.0,0.0
109694.0,17,2,286,2,286,0.0,143.0,143.0,0,0,0.0,0.0,0.0
38090.0,6,10,2032,5,524,9276.75,252.0,104.8,5,1508,8904.0,1236.0,301.6
444581.0,6,3,1604,1,753,0.0,753.0,753.0,2,851,0.0,785.0,425.5
108109587.0,17,5,1005,5,1005,27027396.75,201.0,201.0,0,0,0.0,0.0,0.0
117791759.0,6,48,3168,24,1584,5121380.826086956,66.0,66.0,24,1584,5111984.391304348,66.0,66.0
120015740.0,17,28,13364,28,13364,4445027.407407408,501.0,477.2857142857143,0,0,0.0,0.0,0.0
2906133.0,6,3,204,2,136,0.0,70.0,68.0,1,68,0.0,68.0,68.0
66120.0,6,10,2032,5,524,16284.5,252.0,104.8,5,1508,15549.75,1236.0,301.6
390.0,17,2,208,1,72,0.0,72.0,72.0,1,136,0.0,136.0,136.0
149611.0,17,2,180,1,90,0.0,90.0,90.0,1,90,0.0,90.0,90.0
339475.0,6,6,412,4,272,113158.33333333331,74.0,68.0,2,140,0.0,74.0,70.0
233792.0,6,3,337,2,214,0.0,160.0,107.0,1,123,0.0,123.0,123.0
140203.0,6,2,132,1,66,0.0,66.0,66.0,1,66,0.0,66.0,66.0
1026914.0,6,11,1134,6,558,205382.8,220.0,93.0,5,576,255815.25,304.0,115.2
10515832.0,6,7,478,4,272,3458542.6666666665,74.0,68.0,3,206,5187654.0,74.0,68.66666666666667
110988035.0,6,32,2236,16,1165,7384788.266666667,139.0,72.8125,16,1071,7384800.733333333,123.0,66.9375
25394.0,6,10,2032,5,524,5700.0,252.0,104.8,5,1508,5919.25,1236.0,301.6
104681.0,17,2,286,2,286,0.0,143.0,143.0,0,0,0.0,0.0,0.0
196943.0,17,2,180,1,90,0.0,90.0,90.0,1,90,0.0,90.0,90.0
118126138.0,6,706,145408,350,23692,338388.5759312321,214.0,67.69142857142857,356,121716,332677.4788732394,1514.0,341.8988764044944
1321511.0,6,4,264,2,132,0.0,66.0,66.0,2,132,0.0,66.0,66.0
43575.0,6,14,4740,7,653,7140.333333333333,249.0,93.28571428571428,7,4087,7015.5,1514.0,583.8571428571429
103350.0,17,2,286,2,286,0.0,143.0,143.0,0,0,0.0,0.0,0.0
107795.0,17,2,286,2,286,0.0,143.0,143.0,0,0,0.0,0.0,0.0
1453610.0,6,8,602,5,404,337364.5,103.0,80.8,3,198,204890.0,66.0,66.0
318531.0,17,4,1400,4,1400,106177.0,350.0,350.0,0,0,0.0,0.0,0.0
120121404.0,6,15,2428,9,1204,15015175.5,188.0,133.77777777777777,6,1224,18018394.8,204.0,204.0
67849.0,6,10,2032,5,524,16564.75,252.0,104.8,5,1508,16651.5,1236.0,301.6
204157.0,17,2,762,2,762,0.0,381.0,381.0,0,0,0.0,0.0,0.0
415507.0,6,4,508,2,238,0.0,172.0,119.0,2,270,0.0,135.0,135.0
233033.0,6,3,337,2,214,0.0,160.0,107.0,1,123,0.0,123.0,123.0
2313.0,17,4,344,2,150,0.0,75.0,75.0,2,194,0.0,103.0,97.0
23848.0,6,14,4740,7,653,3760.8333333333335,249.0,93.28571428571428,7,4087,3761.6666666666665,1514.0,583.8571428571429
90297343.0,6,16,1192,8,596,12892728.57142857,95.0,74.5,8,596,12898124.57142857,95.0,74.5
218013.0,6,3,426,2,280,0.0,214.0,140.0,1,146,0.0,146.0,146.0
317187.0,17,4,1400,4,1400,105729.0,350.0,350.0,0,0,0.0,0.0,0.0
108204.0,17,2,286,2,286,0.0,143.0,143.0,0,0,0.0,0.0,0.0
109957627.0,6,204,22980,102,7028,1080449.98019802,140.0,68.90196078431373,102,15952,1080539.1782178218,284.0,156.3921568627451
144060.0,17,2,180,1,90,0.0,90.0,90.0,1,90,0.0,90.0,90.0
32148.000000000004,6,14,4740,7,653,4934.833333333333,249.0,93.28571428571428,7,4087,4998.666666666667,1514.0,583.8571428571429
117608242.0,6,32,2220,16,1149,7826148.0,123.0,71.8125,16,1071,7826147.333333333,123.0,66.9375
90340428.0,6,12,1832,8,1016,12905775.42857143,188.0,127.0,4,816,30044972.33333333,204.0,204.0
216847.0,6,3,426,2,280,0.0,214.0,140.0,1,146,0.0,146.0,146.0
400648.0,17,8,12112,8,12112,57235.42857142857,1514.0,1514.0,0,0,0.0,0.0,0.0
2302.0,17,4,344,2,150,0.0,75.0,75.0,2,194,0.0,103.0,97.0
15242.0,17,2,180,1,90,0.0,90.0,90.0,1,90,0.0,90.0,90.0
2427.0,17,4,344,2,150,0.0,75.0,75.0,2,194,0.0,103.0,97.0
124252855.0,6,31,2113,16,1165,8283523.666666667,139.0,72.8125,15,948,8415441.642857144,123.0,63.2
21285.0,6,14,4740,7,653,3188.0,249.0,93.28571428571428,7,4087,3403.0,1514.0,583.8571428571429
75822.0,6,14,4740,7,653,12518.166666666666,249.0,93.28571428571428,7,4087,11364.833333333334,1514.0,583.8571428571429
27514.0,6,14,4740,7,653,4475.166666666667,249.0,93.28571428571428,7,4087,4447.833333333333,1514.0,583.8571428571429
104173.0,17,2,700,2,700,0.0,350.0,350.0,0,0,0.0,0.0,0.0
3864.0,17,4,704,2,148,0.0,74.0,74.0,2,556,0.0,280.0,278.0
233343.0,6,3,337,2,214,0.0,160.0,107.0,1,123,0.0,123.0,123.0
2762.0,17,4,344,2,150,0.0,75.0,75.0,2,194,0.0,103.0,97.0
236853.0,6,3,373,2,238,0.0,172.0,119.0,1,135,0.0,135.0,135.0
113254812.0,6,48,3168,24,1584,4922519.043478261,66.0,66.0,24,1584,4921961.956521739,66.0,66.0
90040672.0,17,28,13364,28,13364,3334839.703703704,501.0,477.2857142857143,0,0,0.0,0.0,0.0
135131546.0,17,6,1206,6,1206,27026309.2,201.0,201.0,0,0,0.0,0.0,0.0
95073163.0,6,184,20760,92,14466,1042394.5934065934,284.0,157.2391304347826,92,6294,1042395.131868132,140.0,68.41304347826087
340394.0,6,10,1221,6,636,68078.8,298.0,106.0,4,585,108068.66666666669,379.0,146.25
13489.0,6,13,1459,7,862,2248.1666666666665,271.0,123.14285714285714,6,597,2348.0,259.0,99.5
158549.0,17,2,414,1,88,0.0,88.0,88.0,1,326,0.0,326.0,326.0
228368.0,17,2,180,1,90,0.0,90.0,90.0,1,90,0.0,90.0,90.0
120146282.0,6,230,25978,115,7886,1046696.7280701754,140.0,68.57391304347826,115,18092,1043895.0789473684,284.0,157.3217391304348
11597.0,17,4,823,2,163,0.0,89.0,81.5,2,660,0.0,443.0,330.0
2050242.0,17,5,961,3,234,1024937.5,78.0,78.0,2,727,0.0,395.0,363.5
90290829.0,6,16,1192,8,596,12892116.42857143,95.0,74.5,8,596,12897417.714285716,95.0,74.5
215437.0,17,2,180,1,90,0.0,90.0,90.0,1,90,0.0,90.0,90.0
39819.0,6,11,2098,6,590,7245.4,252.0,98.33333333333331,5,1508,8859.5,1236.0,301.6
257229.0,6,3,337,2,214,0.0,160.0,107.0,1,123,0.0,123.0,123.0
0.0,17,1,90,1,90,0.0,90.0,90.0,0,0,0.0,0.0,0.0
90035221.0,17,28,13364,28,13364,3334637.814814815,501.0,477.2857142857143,0,0,0.0,0.0,0.0
0.0,17,1,72,1,72,0.0,72.0,72.0,0,0,0.0,0.0,0.0
199841.0,17,4,6056,4,6056,66613.66666666667,1514.0,1514.0,0,0,0.0,0.0,0.0
12478.0,6,13,1459,7,862,2079.6666666666665,271.0,123.14285714285714,6,597,2161.4,259.0,99.5
47532.0,6,10,2032,5,524,11639.5,252.0,104.8,5,1508,11420.75,1236.0,301.6
90288888.0,6,16,1192,8,596,12891632.857142856,95.0,74.5,8,596,12897692.142857144,95.0,74.5
108108649.0,17,5,1005,5,1005,27027162.25,201.0,201.0,0,0,0.0,0.0,0.0
13310996.0,6,5,330,3,198,6655498.0,66.0,66.0,2,132,0.0,66.0,66.0
0.0,17,1,304,1,304,0.0,304.0,304.0,0,0,0.0,0.0,0.0
297222.0,6,10,1221,6,636,59444.4,298.0,106.0,4,585,93028.0,379.0,146.25
131166.0,6,3,337,2,214,0.0,160.0,107.0,1,123,0.0,123.0,123.0
0.0,17,1,90,1,90,0.0,90.0,90.0,0,0,0.0,0.0,0.0
114203.0,17,4,1400,4,1400,38067.66666666666,350.0,350.0,0,0,0.0,0.0,0.0
15719.0,6,14,4740,7,653,2476.6666666666665,249.0,93.28571428571428,7,4087,2438.0,1514.0,583.8571428571429
27997.0,6,10,2032,5,524,6768.5,252.0,104.8,5,1508,6607.25,1236.0,301.6
106955725.0,6,438,78660,216,14626,493667.44651162793,214.0,67.71296296296296,222,64034,475657.70588235295,1514.0,288.44144144144144
6830.0,17,2,582,1,83,0.0,83.0,83.0,1,499,0.0,499.0,499.0
144803.0,17,2,180,1,70,0.0,70.0,70.0,1,110,0.0,110.0,110.0
16774.0,6,11,1131,6,600,2991.4,262.0,100.0,5,531,3472.25,259.0,106.2
229466.0,17,2,359,1,75,0.0,75.0,75.0,1,284,0.0,284.0,284.0
37116.0,6,2,145,2,145,0.0,91.0,72.5,0,0,0.0,0.0,0.0
99616.0,17,2,762,2,762,0.0,381.0,381.0,0,0,0.0,0.0,0.0
9601.0,17,2,582,1,83,0.0,83.0,83.0,1,499,0.0,499.0,499.0
146239.0,6,3,337,2,214,0.0,160.0,107.0,1,123,0.0,123.0,123.0
80053.0,6,10,2032,5,524,19495.5,252.0,104.8,5,1508,16447.75,1236.0,301.6
16809.0,6,10,2032,5,524,3941.5,252.0,104.8,5,1508,3943.0,1236.0,301.6
825.0,17,4,438,2,148,0.0,74.0,74.0,2,290,0.0,147.0,145.0
162271.0,17,2,180,1,90,0.0,90.0,90.0,1,90,0.0,90.0,90.0
492092.0,6,10,1221,6,636,98418.4,298.0,106.0,4,585,162566.0,379.0,146.25
124857043.0,17,15,1169,8,606,17836720.42857143,174.0,75.75,7,563,17456444.333333332,174.0,80.42857142857143
315847.0,17,4,1400,4,1400,105282.33333333331,350.0,350.0,0,0,0.0,0.0,0.0
3069629.0,6,3,1604,2,851,0.0,785.0,425.5,1,753,0.0,753.0,753.0
6300203.0,17,5,1710,5,1710,1575050.75,342.0,342.0,0,0,0.0,0.0,0.0
90285938.0,6,16,1192,8,596,12891652.285714284,95.0,74.5,8,596,12897235.42857143,95.0,74.5
103925.0,17,2,286,2,286,0.0,143.0,143.0,0,0,0.0,0.0,0.0
36810.0,6,14,4740,7,653,4157.0,249.0,93.28571428571428,7,4087,5985.833333333333,1514.0,583.8571428571429
298951.0,6,6,412,4,272,99650.33333333331,74.0,68.0,2,140,0.0,74.0,70.0
205980.0,6,3,426,2,280,0.0,214.0,140.0,1,146,0.0,146.0,146.0
101487.0,17,2,762,2,762,0.0,381.0,381.0,0,0,0.0,0.0,0.0
10475074.0,6,7,478,4,272,3446134.6666666665,74.0,68.0,3,206,5169091.0,74.0,68.66666666666667
822.0,17,4,438,2,148,0.0,74.0,74.0,2,290,0.0,147.0,145.0
293242.0,17,2,224,1,76,0.0,76.0,76.0,1,148,0.0,148.0,148.0
224174.0,17,2,414,1,88,0.0,88.0,88.0,1,326,0.0,326.0,326.0
238261.0,6,3,337,2,214,0.0,160.0,107.0,1,123,0.0,123.0,123.0
108178.0,17,2,286,2,286,0.0,143.0,143.0,0,0,0.0,0.0,0.0
326.0,17,2,166,1,75,0.0,75.0,75.0,1,91,0.0,91.0,91.0
5612609.0,6,5,336,2,134,0.0,68.0,67.0,3,202,1524611.5,70.0,67.33333333333333
2446.0,17,4,344,2,150,0.0,75.0,75.0,2,194,0.0,103.0,97.0
52569.0,6,14,4740,7,653,8635.0,249.0,93.28571428571428,7,4087,7475.666666666667,1514.0,583.8571428571429
108105191.0,17,5,955,5,955,27026297.75,191.0,191.0,0,0,0.0,0.0,0.0
1470.0,17,2,762,2,762,0.0,381.0,381.0,0,0,0.0,0.0,0.0
0.0,17,1,136,1,136,0.0,136.0,136.0,0,0,0.0,0.0,0.0
143884.0,17,2,180,1,90,0.0,90.0,90.0,1,90,0.0,90.0,90.0
90008281.0,17,28,13364,28,13364,3333640.037037037,501.0,477.2857142857143,0,0,0.0,0.0,0.0
0.0,17,1,179,1,179,0.0,179.0,179.0,0,0,0.0,0.0,0.0
71860.0,6,10,2032,5,524,17348.0,252.0,104.8,5,1508,16510.75,1236.0,301.6
165847.0,17,2,180,1,90,0.0,90.0,90.0,1,90,0.0,90.0,90.0
104919399.0,17,14,864,7,432,17333907.166666668,174.0,61.71428571428572,7,432,17333493.833333332,174.0,61.71428571428572
46024.0,6,10,2032,5,524,10780.75,252.0,104.8,5,1508,11157.75,1236.0,301.6
221500.0,17,2,414,1,88,0.0,88.0,88.0,1,326,0.0,326.0,326.0
80.0,17,2,762,2,762,0.0,381.0,381.0,0,0,0.0,0.0,0.0
117329156.0,6,47,3102,24,1584,5087610.391304348,66.0,66.0,23,1518,5155437.954545454,66.0,66.0
135136916.0,17,6,1206,6,1206,27027383.2,201.0,201.0,0,0,0.0,0.0,0.0
439327.0,17,2,363,1,79,0.0,79.0,79.0,1,284,0.0,284.0,284.0
135132954.0,17,6,1206,6,1206,27026590.8,201.0,201.0,0,0,0.0,0.0,0.0
213708.0,17,2,180,1,90,0.0,90.0,90.0,1,90,0.0,90.0,90.0
40265.0,6,14,4740,7,653,6220.833333333333,249.0,93.28571428571428,7,4087,6572.166666666667,1514.0,583.8571428571429
127270.0,17,4,1400,4,1400,42423.333333333336,350.0,350.0,0,0,0.0,0.0,0.0
33613.0,6,14,4740,7,653,5252.666666666667,249.0,93.28571428571428,7,4087,3852.3333333333335,1514.0,583.8571428571429
276345.0,17,2,180,1,90,0.0,90.0,90.0,1,90,0.0,90.0,90.0
35528.0,6,10,2032,5,524,8545.25,252.0,104.8,5,1508,7252.5,1236.0,301.6
21765.0,17,2,180,1,90,0.0,90.0,90.0,1,90,0.0,90.0,90.0
153430.0,17,2,180,1,90,0.0,90.0,90.0,1,90,0.0,90.0,90.0
95882951.0,6,183,20636,92,6220,1053658.802197802,140.0,67.6086956521739,91,14416,1054009.3666666667,284.0,158.41758241758242
108105778.0,17,5,1005,5,1005,27026444.5,201.0,201.0,0,0,0.0,0.0,0.0
101438787.0,17,14,1126,7,563,16834374.0,174.0,80.42857142857143,7,563,16833492.166666668,174.0,80.42857142857143
232969.0,6,3,337,2,214,0.0,160.0,107.0,1,123,0.0,123.0,123.0
13454.0,17,4,823,2,163,0.0,89.0,81.5,2,660,0.0,443.0,330.0
4139.0,17,2,610,1,72,0.0,72.0,72.0,1,538,0.0,538.0,538.0
321115.0,17,4,704,2,148,0.0,74.0,74.0,2,556,0.0,280.0,278.0
326717.0,6,6,412,4,272,108905.66666666669,74.0,68.0,2,140,0.0,74.0,70.0
13325.0,6,12,1393,6,796,2533.2,271.0,132.66666666666666,6,597,2427.8,259.0,99.5
2369.0,17,4,344,2,150,0.0,75.0,75.0,2,194,0.0,103.0,97.0
120119175.0,6,13,2020,9,1204,15014896.875,188.0,133.77777777777777,4,816,30029883.0,204.0,204.0
205710.0,6,3,426,2,280,0.0,214.0,140.0,1,146,0.0,146.0,146.0
106881.0,17,2,286,2,286,0.0,143.0,143.0,0,0,0.0,0.0,0.0
23972.0,6,14,4740,7,653,3505.833333333333,249.0,93.28571428571428,7,4087,3190.333333333333,1514.0,583.8571428571429
313589.0,17,4,1400,4,1400,104529.66666666669,350.0,350.0,0,0,0.0,0.0,0.0
0.0,17,1,381,1,381,0.0,381.0,381.0,0,0,0.0,0.0,0.0
120000084.0,6,31,3620,17,2077,7500005.25,425.0,122.17647058823528,14,1543,8540899.923076924,358.0,110.21428571428572
51184.0,6,4,301,2,132,0.0,66.0,66.0,2,169,0.0,103.0,84.5
108762989.0,6,26,1876,13,938,9063582.416666666,95.0,72.15384615384616,13,938,9045132.5,95.0,72.15384615384616
305980.0,6,6,412,4,272,101993.33333333331,74.0,68.0,2,140,0.0,74.0,70.0
120128213.0,6,12,1832,8,1016,17137850.14285714,188.0,127.0,4,816,30031373.33333333,204.0,204.0
120076362.0,6,16,2356,9,1204,15009545.25,188.0,133.77777777777777,7,1152,15007908.0,204.0,164.57142857142858
42639.0,6,14,4740,7,653,6982.0,249.0,93.28571428571428,7,4087,6951.666666666667,1514.0,583.8571428571429
51141.0,17,2,180,1,90,0.0,90.0,90.0,1,90,0.0,90.0,90.0
15902.0,6,10,2032,5,524,3585.0,252.0,104.8,5,1508,2968.25,1236.0,301.6
137352.0,6,2,132,1,66,0.0,66.0,66.0,1,66,0.0,66.0,66.0
148131.0,17,2,180,1,90,0.0,90.0,90.0,1,90,0.0,90.0,90.0
144417.0,17,2,180,1,90,0.0,90.0,90.0,1,90,0.0,90.0,90.0
2301398.0,6,25,7573,14,3735,177030.61538461538,1514.0,266.7857142857143,11,3838,205106.3,1514.0,348.90909090909093
1299210.0,6,4,264,2,132,0.0,66.0,66.0,2,132,0.0,66.0,66.0
120131601.0,6,13,2036,8,1016,17136709.85714286,188.0,127.0,5,1020,22526686.5,204.0,204.0
147877.0,17,2,180,1,90,0.0,90.0,90.0,1,90,0.0,90.0,90.0
116289.0,17,4,1400,4,1400,38763.0,350.0,350.0,0,0,0.0,0.0,0.0
105502.0,17,2,286,2,286,0.0,143.0,143.0,0,0,0.0,0.0,0.0
149891984.0,17,36,17126,36,17126,4282628.114285714,501.0,475.72222222222223,0,0,0.0,0.0,0.0
334825.0,6,2,132,1,66,0.0,66.0,66.0,1,66,0.0,66.0,66.0
318286.0,17,4,1400,4,1400,106095.33333333331,350.0,350.0,0,0,0.0,0.0,0.0
113520378.0,6,46,3036,23,1518,5160005.636363637,66.0,66.0,23,1518,5160005.0,66.0,66.0
147933.0,17,2,180,1,90,0.0,90.0,90.0,1,90,0.0,90.0,90.0
120021946.0,17,29,13785,29,13785,4286498.071428572,501.0,475.3448275862069,0,0,0.0,0.0,0.0
120035727.0,17,28,13364,28,13364,4445767.666666667,501.0,477.2857142857143,0,0,0.0,0.0,0.0
135127016.0,17,6,1206,6,1206,27025403.2,201.0,201.0,0,0,0.0,0.0,0.0
57384.0,6,14,4740,7,653,9440.333333333334,249.0,93.28571428571428,7,4087,8450.166666666666,1514.0,583.8571428571429
28920.0,17,2,180,1,90,0.0,90.0,90.0,1,90,0.0,90.0,90.0
316389.0,17,4,1400,4,1400,105463.0,350.0,350.0,0,0,0.0,0.0,0.0
22328.0,6,10,2032,5,524,5368.75,252.0,104.8,5,1508,5344.0,1236.0,301.6
302983.0,6,6,412,4,272,100994.33333333331,74.0,68.0,2,140,0.0,74.0,70.0
21836.0,6,10,2032,5,524,5247.5,252.0,104.8,5,1508,5174.75,1236.0,301.6
90529208.0,6,15,2444,8,1016,12932744.0,188.0,127.0,7,1428,15060968.5,204.0,204.0
135132855.0,17,6,1206,6,1206,27026571.0,201.0,201.0,0,0,0.0,0.0,0.0
436718.0,6,10,1221,6,636,87343.6,298.0,106.0,4,585,139770.33333333334,379.0,146.25
120090478.0,6,337,58822,170,47270,709325.0650887574,1514.0,278.05882352941177,167,11552,722132.969879518,214.0,69.17365269461078
49795.0,6,14,4740,7,653,7763.333333333333,249.0,93.28571428571428,7,4087,8164.333333333333,1514.0,583.8571428571429
1231597.0,17,7,490,7,490,205266.16666666663,70.0,70.0,0,0,0.0,0.0,0.0
258059.0,6,10,1221,6,636,51611.8,298.0,106.0,4,585,80615.33333333333,379.0,146.25
83357.0,6,12,1320,7,789,13892.833333333334,253.0,112.71428571428572,5,531,18148.75,259.0,106.2
120001013.0,6,20,1490,11,799,12000101.3,95.0,72.63636363636364,9,691,14943010.375,95.0,76.77777777777777
241499.0,6,3,337,2,214,0.0,160.0,107.0,1,123,0.0,123.0,123.0
12155.0,6,11,2098,6,590,2266.4,252.0,98.33333333333331,5,1508,2796.5,1236.0,301.6
209355.0,17,2,180,1,90,0.0,90.0,90.0,1,90,0.0,90.0,90.0
48476.0,6,14,4740,7,653,7958.833333333333,249.0,93.28571428571428,7,4087,7486.0,1514.0,583.8571428571429
383620.0,17,2,180,1,90,0.0,90.0,90.0,1,90,0.0,90.0,90.0
1022349.0,6,11,1134,6,558,204469.8,220.0,93.0,5,576,254409.0,304.0,115.2
110831.0,17,2,286,2,286,0.0,143.0,143.0,0,0,0.0,0.0,0.0
242605.0,6,3,337,2,214,0.0,160.0,107.0,1,123,0.0,123.0,123.0
3931510.0,6,164,130261,92,121208,43203.4065934066,1510.0,1317.4782608695652,72,9053,50942.112676056335,1510.0,125.73611111111111
2047369.0,6,24,7545,12,2450,186124.45454545456,1034.0,204.16666666666663,12,5095,158189.18181818182,1510.0,424.5833333333333
119304333.0,6,232,26200,116,18248,1035557.4695652174,284.0,157.31034482758622,116,7952,1035556.9304347826,140.0,68.55172413793103
38144.0,6,11,2098,6,590,6613.6,252.0,98.33333333333331,5,1508,9254.0,1236.0,301.6
3107189.0,6,25,7626,13,2524,258932.41666666663,1034.0,194.15384615384616,12,5102,254651.36363636365,1510.0,425.1666666666667
303229.0,6,6,412,4,272,101076.33333333331,74.0,68.0,2,140,0.0,74.0,70.0
298573.0,6,6,412,4,272,99524.33333333331,74.0,68.0,2,140,0.0,74.0,70.0
39942.0,6,14,4740,7,653,6479.333333333333,249.0,93.28571428571428,7,4087,6336.666666666667,1514.0,583.8571428571429
204469.0,17,4,1524,4,1524,68156.33333333333,381.0,381.0,0,0,0.0,0.0,0.0
90527977.0,6,15,2444,8,1016,12932568.142857144,188.0,127.0,7,1428,15061145.666666666,204.0,204.0
17724616.0,6,5,1736,2,819,0.0,753.0,409.5,3,917,7572125.5,785.0,305.6666666666667
223348.0,17,4,1524,4,1524,74449.33333333333,381.0,381.0,0,0,0.0,0.0,0.0
2692342.0,6,2,132,1,66,0.0,66.0,66.0,1,66,0.0,66.0,66.0
2350.0,17,4,344,2,150,0.0,75.0,75.0,2,194,0.0,103.0,97.0
421.0,17,2,410,1,78,0.0,78.0,78.0,1,332,0.0,332.0,332.0
270139.0,6,10,1221,6,636,54027.8,298.0,106.0,4,585,84696.66666666667,379.0,146.25
219734.0,6,3,426,2,280,0.0,214.0,140.0,1,146,0.0,146.0,146.0
131845481.0,17,14,864,7,432,18666824.0,174.0,61.71428571428572,7,432,20080960.0,174.0,61.71428571428572
508596.00000000006,6,5,336,2,134,0.0,68.0,67.0,3,202,195500.5,70.0,67.33333333333333
143888.0,17,2,180,1,90,0.0,90.0,90.0,1,90,0.0,90.0,90.0
38621499.0,6,5,336,2,134,0.0,68.0,67.0,3,202,19241285.0,70.0,67.33333333333333
120128350.0,6,13,2020,9,1204,15016043.75,188.0,133.77777777777777,4,816,30032715.0,204.0,204.0
120191224.0,6,238,26866,119,8150,1011629.7288135592,140.0,68.4873949579832,119,18716,1011738.5677966102,284.0,157.27731092436974
118094256.0,6,48,3168,24,1584,5134532.869565218,66.0,66.0,24,1584,5121423.869565218,66.0,66.0
92047204.0,17,16,5472,16,5472,6136480.266666667,342.0,342.0,0,0,0.0,0.0,0.0
50993.0,6,14,4740,7,653,8376.666666666666,249.0,93.28571428571428,7,4087,8008.5,1514.0,583.8571428571429
145574.0,6,3,373,2,238,0.0,172.0,119.0,1,135,0.0,135.0,135.0
90259033.0,6,12,1832,8,1016,12894147.57142857,188.0,127.0,4,816,30031307.33333333,204.0,204.0
2083.0,17,4,344,2,150,0.0,75.0,75.0,2,194,0.0,103.0,97.0
135138662.0,17,6,1146,6,1146,27027732.4,191.0,191.0,0,0,0.0,0.0,0.0
14643251.0,6,20,1607,10,975,1592578.111111111,315.0,97.5,10,632,1592557.888888889,78.0,63.2
23391.0,6,10,2032,5,524,5643.5,252.0,104.8,5,1508,5016.75,1236.0,301.6
319289.0,6,6,412,4,272,106429.66666666669,74.0,68.0,2,140,0.0,74.0,70.0
171706.0,17,2,180,1,90,0.0,90.0,90.0,1,90,0.0,90.0,90.0
39636708.0,6,5,336,2,134,0.0,68.0,67.0,3,202,19750403.0,70.0,67.33333333333333
34599.0,6,10,2032,5,524,8416.25,252.0,104.8,5,1508,8344.25,1236.0,301.6
233449.0,6,3,337,2,214,0.0,160.0,107.0,1,123,0.0,123.0,123.0
245278.0,6,3,337,2,214,0.0,160.0,107.0,1,123,0.0,123.0,123.0
62342.0,6,14,4740,7,653,9407.5,249.0,93.28571428571428,7,4087,9467.0,1514.0,583.8571428571429
49564.0,6,14,4740,7,653,7956.666666666667,249.0,93.28571428571428,7,4087,8121.833333333333,1514.0,583.8571428571429
1301579.0,6,4,264,2,132,0.0,66.0,66.0,2,132,0.0,66.0,66.0
301.0,17,2,164,1,82,0.0,82.0,82.0,1,82,0.0,82.0,82.0
108574.0,17,2,286,2,286,0.0,143.0,143.0,0,0,0.0,0.0,0.0
66898.0,6,14,4740,7,653,10908.5,249.0,93.28571428571428,7,4087,10922.166666666666,1514.0,583.8571428571429
3034.0,17,2,224,1,76,0.0,76.0,76.0,1,148,0.0,148.0,148.0
30896087.0,6,26,7627,14,3735,199891.84615384616,1514.0,266.7857142857143,12,3892,2789120.090909091,1514.0,324.3333333333333
1492.0,17,2,762,2,762,0.0,381.0,381.0,0,0,0.0,0.0,0.0
99005977.0,17,11,735,6,389,19801195.4,174.0,64.83333333333333,5,346,19750160.5,174.0,69.2
108109457.0,17,5,955,5,955,27027364.25,191.0,191.0,0,0,0.0,0.0,0.0
128009031.0,17,15,907,8,475,18287004.42857143,174.0,59.375,7,432,18000162.166666668,174.0,61.71428571428572
5619202.0,6,4,270,2,134,0.0,68.0,67.0,2,136,0.0,70.0,68.0
141192.0,6,2,132,1,66,0.0,66.0,66.0,1,66,0.0,66.0,66.0
22793.0,6,10,2032,5,524,4850.5,252.0,104.8,5,1508,5023.25,1236.0,301.6
153463.0,17,2,180,1,90,0.0,90.0,90.0,1,90,0.0,90.0,90.0
49833.0,6,10,2032,5,524,12228.5,252.0,104.8,5,1508,12128.5,1236.0,301.6
204593.0,17,2,180,1,90,0.0,90.0,90.0,1,90,0.0,90.0,90.0
1235726.0,17,7,490,7,490,205954.3333333333,70.0,70.0,0,0,0.0,0.0,0.0
153359.0,17,2,180,1,90,0.0,90.0,90.0,1,90,0.0,90.0,90.0
731.0,17,4,438,2,148,0.0,74.0,74.0,2,290,0.0,147.0,145.0
59198.0,6,10,2032,5,524,14571.25,252.0,104.8,5,1508,11014.5,1236.0,301.6
2580898.0,6,2,132,1,66,0.0,66.0,66.0,1,66,0.0,66.0,66.0
1416064.0,17,16,1120,16,1120,94404.26666666666,70.0,70.0,0,0,0.0,0.0,0.0
1027187.0,6,11,1134,6,558,205437.4,220.0,93.0,5,576,253997.25,304.0,115.2
90075295.0,6,10,1440,7,828,15012549.166666666,188.0,118.28571428571428,3,612,30031904.0,204.0,204.0
825191.0,6,6,758,3,410,410232.0,172.0,136.66666666666666,3,348,290822.5,135.0,116.0
3192.0,17,2,180,1,90,0.0,90.0,90.0,1,90,0.0,90.0,90.0
311.0,17,2,166,1,75,0.0,75.0,75.0,1,91,0.0,91.0,91.0
23002.0,6,14,4740,7,653,3673.8333333333335,249.0,93.28571428571428,7,4087,3279.5,1514.0,583.8571428571429
120124522.0,6,15,2444,7,1428,20020753.666666668,204.0,204.0,8,1016,17136522.42857143,188.0,127.0
114209754.0,6,48,3168,24,1584,4965641.478260869,66.0,66.0,24,1584,4952373.304347826,66.0,66.0
124445436.0,6,32,2173,16,1071,7630664.2,123.0,66.9375,16,1102,8296268.466666667,139.0,68.875
214835.0,17,2,180,1,90,0.0,90.0,90.0,1,90,0.0,90.0,90.0
90526671.0,6,13,2036,8,1016,12932381.57142857,188.0,127.0,5,1020,22591049.5,204.0,204.0
490.0,17,2,166,1,75,0.0,75.0,75.0,1,91,0.0,91.0,91.0
25218436.0,6,140,31128,72,23843,355189.23943661974,566.0,331.15277777777777,68,7285,372111.5223880597,898.0,107.13235294117646
90292824.0,6,16,1192,8,596,12892319.0,95.0,74.5,8,596,12896990.857142856,95.0,74.5
13241.0,6,2,145,2,145,0.0,91.0,72.5,0,0,0.0,0.0,0.0
103396.0,17,2,286,2,286,0.0,143.0,143.0,0,0,0.0,0.0,0.0
209593.0,17,2,180,1,90,0.0,90.0,90.0,1,90,0.0,90.0,90.0
3885.0,17,2,582,1,83,0.0,83.0,83.0,1,499,0.0,499.0,499.0
254744.00000000003,6,10,1221,6,636,50948.8,298.0,106.0,4,585,79489.0,379.0,146.25
107004.0,17,2,286,2,286,0.0,143.0,143.0,0,0,0.0,0.0,0.0
21674.0,6,10,2032,5,524,4801.25,252.0,104.8,5,1508,5014.75,1236.0,301.6
90035268.0,17,28,13364,28,13364,3334639.5555555555,501.0,477.2857142857143,0,0,0.0,0.0,0.0
1064756.0,6,3,204,1,68,0.0,68.0,68.0,2,136,0.0,70.0,68.0
22637.0,6,14,4740,7,653,3664.6666666666665,249.0,93.28571428571428,7,4087,3287.6666666666665,1514.0,583.8571428571429
252378.0,17,4,6056,4,6056,84126.0,1514.0,1514.0,0,0,0.0,0.0,0.0
145.0,17,2,700,2,700,0.0,350.0,350.0,0,0,0.0,0.0,0.0
205729.0,17,2,180,1,90,0.0,90.0,90.0,1,90,0.0,90.0,90.0
120463503.0,6,223,25118,112,17496,1085256.7837837837,284.0,156.21428571428572,111,7622,1085680.4090909092,140.0,68.66666666666667
245615.0,6,3,337,2,214,0.0,160.0,107.0,1,123,0.0,123.0,123.0
24721.0,6,14,4740,7,653,3949.6666666666665,249.0,93.28571428571428,7,4087,3971.0,1514.0,583.8571428571429
40189.0,6,14,4740,7,653,6295.666666666667,249.0,93.28571428571428,7,4087,6418.833333333333,1514.0,583.8571428571429
108108436.0,17,5,1005,5,1005,27027109.0,201.0,201.0,0,0,0.0,0.0,0.0
2792281.0,6,2,132,1,66,0.0,66.0,66.0,1,66,0.0,66.0,66.0
240099.0,17,2,180,1,90,0.0,90.0,90.0,1,90,0.0,90.0,90.0
333141.0,6,6,412,4,272,111047.0,74.0,68.0,2,140,0.0,74.0,70.0
90067894.0,17,28,13364,28,13364,3335847.925925926,501.0,477.2857142857143,0,0,0.0,0.0,0.0
116071.0,17,2,286,2,286,0.0,143.0,143.0,0,0,0.0,0.0,0.0
4184.0,17,4,438,2,148,0.0,74.0,74.0,2,290,0.0,147.0,145.0
27746.0,6,16,4872,8,719,3870.714285714286,249.0,89.875,8,4153,3802.571428571429,1514.0,519.125
54952.0,6,10,2032,5,524,13324.0,252.0,104.8,5,1508,13206.0,1236.0,301.6
9010.0,17,2,582,1,83,0.0,83.0,83.0,1,499,0.0,499.0,499.0
119567812.0,6,23,1734,11,840,11956781.2,95.0,76.36363636363636,12,894,10846124.727272728,95.0,74.5
318995.0,17,4,1524,4,1524,106331.66666666669,381.0,381.0,0,0,0.0,0.0,0.0
7109.0,17,2,582,1,83,0.0,83.0,83.0,1,499,0.0,499.0,499.0
35605.0,6,14,4740,7,653,5811.5,249.0,93.28571428571428,7,4087,5780.833333333333,1514.0,583.8571428571429
153393.0,17,2,180,1,90,0.0,90.0,90.0,1,90,0.0,90.0,90.0
779.0,17,4,438,2,148,0.0,74.0,74.0,2,290,0.0,147.0,145.0
160246.0,17,2,180,1,90,0.0,90.0,90.0,1,90,0.0,90.0,90.0
90002894.0,17,28,13364,28,13364,3333440.5185185187,501.0,477.2857142857143,0,0,0.0,0.0,0.0
1734418.0,17,3,1026,3,1026,867209.0,342.0,342.0,0,0,0.0,0.0,0.0
84965.0,6,12,1320,6,723,14266.6,253.0,120.5,6,597,14137.8,259.0,99.5
127202299.0,6,36,2586,19,1392,7066794.388888889,123.0,73.26315789473684,17,1194,7312420.4375,123.0,70.23529411764706
19687.0,6,14,4740,7,653,3158.5,249.0,93.28571428571428,7,4087,3143.6666666666665,1514.0,583.8571428571429
105859746.0,6,43,2838,22,1452,5040927.619047619,66.0,66.0,21,1386,5160000.95,66.0,66.0
19212.0,6,12,1320,6,723,3367.8,253.0,120.5,6,597,3468.8,259.0,99.5
3300.0,17,2,224,1,76,0.0,76.0,76.0,1,148,0.0,148.0,148.0
90039074.0,17,28,13364,28,13364,3334780.5185185187,501.0,477.2857142857143,0,0,0.0,0.0,0.0
108103375.0,17,5,955,5,955,27025843.75,191.0,191.0,0,0,0.0,0.0,0.0
116855428.0,6,48,3168,24,1584,5080670.782608695,66.0,66.0,24,1584,5068160.217391305,66.0,66.0
284462.0,17,2,363,1,79,0.0,79.0,79.0,1,284,0.0,284.0,284.0
31960.000000000004,6,13,4416,6,409,6248.8,127.0,68.16666666666667,7,4007,4198.0,1514.0,572.4285714285714
2091.0,17,4,344,2,150,0.0,75.0,75.0,2,194,0.0,103.0,97.0
90257639.0,6,12,1832,8,1016,12893948.42857143,188.0,127.0,4,816,30030921.0,204.0,204.0
31547.0,6,14,4740,7,653,4477.0,249.0,93.28571428571428,7,4087,3844.1666666666665,1514.0,583.8571428571429
16415109.999999998,6,26,9161,14,2127,1262700.7692307692,408.0,151.92857142857142,12,7034,1117420.5454545454,1514.0,586.1666666666666
32612.000000000004,6,10,2032,5,524,7937.5,252.0,104.8,5,1508,7110.5,1236.0,301.6
119867424.0,17,35,16705,35,16705,3525512.470588235,501.0,477.2857142857143,0,0,0.0,0.0,0.0
111534973.0,17,17,1530,9,810,13941871.625,90.0,90.0,8,720,11563573.57142857,90.0,90.0
108094886.0,6,31,2166,16,1149,7191937.266666667,123.0,71.8125,15,1017,7705644.214285715,123.0,67.8
88205.0,6,2,132,1,66,0.0,66.0,66.0,1,66,0.0,66.0,66.0
126005974.0,17,15,907,8,475,18000853.42857143,174.0,59.375,7,432,17666829.333333332,174.0,61.71428571428572
3075211.0,6,4,270,2,134,0.0,68.0,67.0,2,136,0.0,70.0,68.0
250378.0,6,3,373,2,238,0.0,172.0,119.0,1,135,0.0,135.0,135.0
325.0,17,2,174,1,79,0.0,79.0,79.0,1,95,0.0,95.0,95.0
138397.0,6,2,132,1,66,0.0,66.0,66.0,1,66,0.0,66.0,66.0
299268.0,6,2,138,1,68,0.0,68.0,68.0,1,70,0.0,70.0,70.0
90260171.0,6,13,2036,8,1016,12894310.142857144,188.0,127.0,5,1020,22523688.25,204.0,204.0
12820.0,6,12,1393,6,796,2432.8,271.0,132.66666666666666,6,597,2117.0,259.0,99.5
14668955.0,6,19,1553,9,921,1792301.875,315.0,102.33333333333331,10,632,1592849.888888889,78.0,63.2
24286.0,6,10,2032,5,524,3394.5,252.0,104.8,5,1508,5509.5,1236.0,301.6
135137929.0,17,6,1206,6,1206,27027585.8,201.0,201.0,0,0,0.0,0.0,0.0
411.0,17,2,410,1,78,0.0,78.0,78.0,1,332,0.0,332.0,332.0
99997.0,17,2,762,2,762,0.0,381.0,381.0,0,0,0.0,0.0,0.0
0.0,17,1,44,1,44,0.0,44.0,44.0,0,0,0.0,0.0,0.0
146272.0,6,3,337,2,214,0.0,160.0,107.0,1,123,0.0,123.0,123.0
79803.0,6,14,4740,7,653,12791.5,249.0,93.28571428571428,7,4087,12814.333333333334,1514.0,583.8571428571429
204374.0,17,2,762,2,762,0.0,381.0,381.0,0,0,0.0,0.0,0.0
196923.0,17,2,180,1,90,0.0,90.0,90.0,1,90,0.0,90.0,90.0
40583.0,6,14,4740,7,653,5222.333333333333,249.0,93.28571428571428,7,4087,6396.166666666667,1514.0,583.8571428571429
108091224.0,17,5,1005,5,1005,27022806.0,201.0,201.0,0,0,0.0,0.0,0.0
90582616.0,6,26,1762,13,922,7530576.583333333,139.0,70.92307692307692,13,840,7530577.25,123.0,64.61538461538461
260090.0,6,10,1221,6,636,52018.0,298.0,106.0,4,585,81319.66666666667,379.0,146.25
92016277.0,6,38,2508,19,1254,5112001.611111111,66.0,66.0,19,1254,5111995.777777778,66.0,66.0
116974.0,17,4,1400,4,1400,38991.333333333336,350.0,350.0,0,0,0.0,0.0,0.0
38570.0,6,14,4740,7,653,5516.166666666667,249.0,93.28571428571428,7,4087,6068.833333333333,1514.0,583.8571428571429
17221.0,6,14,4740,7,653,2276.5,249.0,93.28571428571428,7,4087,2739.0,1514.0,583.8571428571429
52643.0,6,10,2032,5,524,11494.0,252.0,104.8,5,1508,12608.5,1236.0,301.6
196837.0,17,2,180,1,90,0.0,90.0,90.0,1,90,0.0,90.0,90.0
2800589.0,6,2,132,1,66,0.0,66.0,66.0,1,66,0.0,66.0,66.0
102984152.0,6,42,2772,21,1386,5135440.25,66.0,66.0,21,1386,5135438.85,66.0,66.0
11014.0,6,11,2098,6,590,2041.4,252.0,98.33333333333331,5,1508,2082.5,1236.0,301.6
2604301.0,6,2,132,1,66,0.0,66.0,66.0,1,66,0.0,66.0,66.0
141574.0,17,4,571,2,148,0.0,74.0,74.0,2,423,0.0,280.0,211.5
422167.0,6,3,204,2,136,0.0,70.0,68.0,1,68,0.0,68.0,68.0
0.0,6,1,54,0,0,0.0,0.0,0.0,1,54,0.0,54.0,54.0
38613765.0,6,5,336,2,134,0.0,68.0,67.0,3,202,19242532.5,70.0,67.33333333333333
27830.0,6,14,4740,7,653,4484.333333333333,249.0,93.28571428571428,7,4087,4366.833333333333,1514.0,583.8571428571429
302239.0,6,6,412,4,272,100746.33333333331,74.0,68.0,2,140,0.0,74.0,70.0
301980.0,6,6,412,4,272,100660.0,74.0,68.0,2,140,0.0,74.0,70.0
45066.0,6,10,2032,5,524,11034.75,252.0,104.8,5,1508,11001.5,1236.0,301.6
90252690.0,6,13,2036,8,1016,12893241.42857143,188.0,127.0,5,1020,22522251.5,204.0,204.0
145399.0,6,3,337,2,214,0.0,160.0,107.0,1,123,0.0,123.0,123.0
325911.0,6,6,412,4,272,108637.0,74.0,68.0,2,140,0.0,74.0,70.0
120028275.0,17,29,13785,29,13785,4286724.107142857,501.0,475.3448275862069,0,0,0.0,0.0,0.0
207957.0,6,10,1221,6,636,41591.4,298.0,106.0,4,585,68057.0,379.0,146.25
4329.0,17,2,762,2,762,0.0,381.0,381.0,0,0,0.0,0.0,0.0
233286.0,6,3,337,2,214,0.0,160.0,107.0,1,123,0.0,123.0,123.0
22759.0,6,10,2032,5,524,5283.25,252.0,104.8,5,1508,5423.0,1236.0,301.6
346.0,17,2,160,1,80,0.0,80.0,80.0,1,80,0.0,80.0,80.0
131366.0,6,3,337,2,214,0.0,160.0,107.0,1,123,0.0,123.0,123.0
233586.0,6,3,373,2,238,0.0,172.0,119.0,1,135,0.0,135.0,135.0
135133774.0,17,6,1206,6,1206,27026754.8,201.0,201.0,0,0,0.0,0.0,0.0
14495.0,6,10,2032,5,524,3394.75,252.0,104.8,5,1508,2835.5,1236.0,301.6
139246.0,6,2,132,1,66,0.0,66.0,66.0,1,66,0.0,66.0,66.0
797.0,17,4,438,2,148,0.0,74.0,74.0,2,290,0.0,147.0,145.0
2491967.0,6,25,7573,14,3735,191689.7692307692,1514.0,266.7857142857143,11,3838,224577.0,1514.0,348.90909090909093
8186.000000000001,17,2,582,1,83,0.0,83.0,83.0,1,499,0.0,499.0,499.0
24782.0,6,14,4740,7,653,3579.1666666666665,249.0,93.28571428571428,7,4087,3610.6666666666665,1514.0,583.8571428571429
10474514.0,6,7,478,4,272,3445968.333333333,74.0,68.0,3,206,5168811.0,74.0,68.66666666666667
90293562.0,6,16,1192,8,596,12892279.285714284,95.0,74.5,8,596,12898397.42857143,95.0,74.5
119279537.0,6,319,36982,160,10856,750185.7672955975,140.0,67.85,159,26126,752796.1455696203,284.0,164.31446540880503
324950.0,6,6,412,4,272,108316.66666666669,74.0,68.0,2,140,0.0,74.0,70.0
32328.000000000004,6,10,2032,5,524,7855.25,252.0,104.8,5,1508,7288.0,1236.0,301.6
61768.0,6,14,4740,7,653,10166.666666666666,249.0,93.28571428571428,7,4087,8530.333333333334,1514.0,583.8571428571429
121988280.0,17,15,1169,8,606,17426897.14285714,174.0,75.75,7,563,17000167.5,174.0,80.42857142857143
92735613.0,17,12,778,6,389,18400851.0,174.0,64.83333333333333,6,389,18400177.2,174.0,64.83333333333333
246312.0,6,3,337,2,214,0.0,160.0,107.0,1,123,0.0,123.0,123.0
101789.0,17,2,762,2,762,0.0,381.0,381.0,0,0,0.0,0.0,0.0
108105623.0,17,5,955,5,955,27026405.75,191.0,191.0,0,0,0.0,0.0,0.0
284321.0,17,2,363,1,79,0.0,79.0,79.0,1,284,0.0,284.0,284.0
78842.0,6,14,4740,7,653,12751.666666666666,249.0,93.28571428571428,7,4087,12942.833333333334,1514.0,583.8571428571429
1178756.0,6,13,3011,8,2383,168393.7142857143,1514.0,297.875,5,628,225820.5,331.0,125.6
303098.0,6,2,132,1,66,0.0,66.0,66.0,1,66,0.0,66.0,66.0
115056169.0,6,48,3168,24,1584,5002442.130434782,66.0,66.0,24,1584,4990446.130434782,66.0,66.0
17191.0,6,11,1131,6,600,2677.8,262.0,100.0,5,531,3589.0,259.0,106.2
109940516.0,6,28,1860,14,966,8440348.846153846,123.0,69.0,14,894,8440347.23076923,123.0,63.85714285714285
135134071.0,17,6,1146,6,1146,27026814.2,191.0,191.0,0,0,0.0,0.0,0.0
108088080.0,17,5,1005,5,1005,27022020.0,201.0,201.0,0,0,0.0,0.0,0.0
19029853.0,17,3,1034,2,684,0.0,342.0,342.0,1,350,0.0,350.0,350.0
91794.0,6,11,2098,6,590,18358.8,252.0,98.33333333333331,5,1508,14085.75,1236.0,301.6
299331.0,6,6,412,4,272,99777.0,74.0,68.0,2,140,0.0,74.0,70.0
205725.0,6,3,426,2,280,0.0,214.0,140.0,1,146,0.0,146.0,146.0
98937525.0,6,173,19584,87,13686,1150436.3372093022,284.0,157.31034482758622,86,5898,1128690.7411764706,140.0,68.5813953488372
204658.0,17,2,762,2,762,0.0,381.0,381.0,0,0,0.0,0.0,0.0
94598300.0,6,40,2640,20,1320,4978857.894736842,66.0,66.0,20,1320,4967483.368421053,66.0,66.0
90039090.0,17,28,13364,28,13364,3334781.111111111,501.0,477.2857142857143,0,0,0.0,0.0,0.0
358.0,17,2,267,1,83,0.0,83.0,83.0,1,184,0.0,184.0,184.0
120258572.0,6,262,29546,131,8942,918780.0461538462,140.0,68.25954198473282,131,20604,918670.676923077,284.0,157.2824427480916
194250.0,17,4,1524,4,1524,64750.0,381.0,381.0,0,0,0.0,0.0,0.0
2725.0,17,2,762,2,762,0.0,381.0,381.0,0,0,0.0,0.0,0.0
336.0,17,2,174,1,79,0.0,79.0,79.0,1,95,0.0,95.0,95.0
308096.0,6,6,412,4,272,102698.66666666669,74.0,68.0,2,140,0.0,74.0,70.0
1034355.0,6,11,1134,6,558,206871.0,220.0,93.0,5,576,257786.25,304.0,115.2
113609546.0,6,46,3036,23,1518,5150437.409090909,66.0,66.0,23,1518,5150430.954545454,66.0,66.0
3207066.0,6,14,2304,8,730,458152.28571428574,252.0,91.25,6,1574,41611.0,1236.0,262.3333333333333
90528349.0,6,14,2240,8,1016,12932621.285714284,188.0,127.0,6,1224,18073207.0,204.0,204.0
309648.0,6,6,412,4,272,103216.0,74.0,68.0,2,140,0.0,74.0,70.0
309792.0,6,6,412,4,272,103264.0,74.0,68.0,2,140,0.0,74.0,70.0
120119882.0,6,13,2036,8,1016,17136776.57142857,188.0,127.0,5,1020,22522724.75,204.0,204.0
36864.0,6,10,2032,5,524,8968.5,252.0,104.8,5,1508,8663.0,1236.0,301.6
315506.0,6,3,202,2,128,0.0,74.0,64.0,1,74,0.0,74.0,74.0
143305.0,17,2,176,1,80,0.0,80.0,80.0,1,96,0.0,96.0,96.0
109511.0,17,2,286,2,286,0.0,143.0,143.0,0,0,0.0,0.0,0.0
306160.0,6,6,412,4,272,102053.33333333331,74.0,68.0,2,140,0.0,74.0,70.0
1343761.0,17,16,1120,16,1120,89584.06666666667,70.0,70.0,0,0,0.0,0.0,0.0
90035164.0,17,28,13364,28,13364,3334635.703703704,501.0,477.2857142857143,0,0,0.0,0.0,0.0
90069473.0,17,28,13364,28,13364,3335906.407407407,501.0,477.2857142857143,0,0,0.0,0.0,0.0
10147.0,17,4,823,2,163,0.0,89.0,81.5,2,660,0.0,443.0,330.0
346.0,17,2,267,1,83,0.0,83.0,83.0,1,184,0.0,184.0,184.0
288273.0,17,2,180,1,90,0.0,90.0,90.0,1,90,0.0,90.0,90.0
203116.0,17,2,180,1,90,0.0,90.0,90.0,1,90,0.0,90.0,90.0
21290.0,6,10,2032,5,524,5089.75,252.0,104.8,5,1508,5081.5,1236.0,301.6
284022.0,6,10,1221,6,636,56804.4,298.0,106.0,4,585,93022.66666666669,379.0,146.25
310.0,17,2,164,1,82,0.0,82.0,82.0,1,82,0.0,82.0,82.0
3263405.0,6,162,133116,94,124326,35090.37634408602,1510.0,1322.6170212765958,68,8790,43805.0447761194,1510.0,129.26470588235293
306980.0,6,2,132,1,66,0.0,66.0,66.0,1,66,0.0,66.0,66.0
90287336.0,6,16,1192,8,596,12891381.57142857,95.0,74.5,8,596,12895340.285714284,95.0,74.5
300299.0,6,6,412,4,272,100099.66666666669,74.0,68.0,2,140,0.0,74.0,70.0
5622801.0,6,4,270,2,134,0.0,68.0,67.0,2,136,0.0,70.0,68.0
146145.0,6,3,337,2,214,0.0,160.0,107.0,1,123,0.0,123.0,123.0
1038125.0,6,11,1134,6,558,207625.0,220.0,93.0,5,576,257285.5,304.0,115.2
123456194.0,6,49,3234,25,1650,5144008.083333333,66.0,66.0,24,1584,5180913.869565218,66.0,66.0
31610.0,6,10,2032,5,524,7675.5,252.0,104.8,5,1508,7606.0,1236.0,301.6
103008813.0,6,41,2706,21,1386,5150440.65,66.0,66.0,20,1320,5035605.947368421,66.0,66.0
120366700.0,6,602,104276,303,84024,398565.2317880795,1514.0,277.3069306930693,299,20252,397257.5302013423,214.0,67.7324414715719
55101.0,6,14,4740,7,653,9064.333333333334,249.0,93.28571428571428,7,4087,8891.666666666666,1514.0,583.8571428571429
14132.0,6,11,1131,6,600,2557.8,262.0,100.0,5,531,3207.0,259.0,106.2
194955.0,6,33,18317,17,1291,12184.6875,215.0,75.94117647058823,16,17026,12773.133333333331,1514.0,1064.125
316647.0,6,6,412,4,272,105549.0,74.0,68.0,2,140,0.0,74.0,70.0
774.0,17,4,438,2,148,0.0,74.0,74.0,2,290,0.0,147.0,145.0
2424.0,17,4,344,2,150,0.0,75.0,75.0,2,194,0.0,103.0,97.0
299700.0,6,6,412,4,272,99900.0,74.0,68.0,2,140,0.0,74.0,70.0
297700.0,6,6,412,4,272,99233.33333333331,74.0,68.0,2,140,0.0,74.0,70.0
149672.0,17,2,180,1,90,0.0,90.0,90.0,1,90,0.0,90.0,90.0
112009796.0,17,13,821,6,389,22401959.2,174.0,64.83333333333333,7,432,18666838.666666668,174.0,61.71428571428572
10468334.0,6,6,412,3,206,5166104.0,74.0,68.66666666666667,3,206,5166012.0,74.0,68.66666666666667
153481.0,17,2,180,1,90,0.0,90.0,90.0,1,90,0.0,90.0,90.0
90284359.0,6,24,2716,13,1455,7523696.583333333,337.0,111.92307692307692,11,1261,8999462.7,426.0,114.63636363636364
70196.0,6,10,2032,5,524,16339.5,252.0,104.8,5,1508,16366.25,1236.0,301.6
307203.0,6,6,412,4,272,102401.0,74.0,68.0,2,140,0.0,74.0,70.0
103200244.0,6,42,2772,21,1386,5159996.0,66.0,66.0,21,1386,5159999.7,66.0,66.0
91905559.0,6,27,2073,15,1138,6562216.714285715,95.0,75.86666666666666,12,935,8352765.363636363,95.0,77.91666666666667
26747.0,6,14,4740,7,653,4272.5,249.0,93.28571428571428,7,4087,3871.5,1514.0,583.8571428571429
3627894.0,17,3,1026,3,1026,1813947.0,342.0,342.0,0,0,0.0,0.0,0.0
280592.0,17,2,365,1,80,0.0,80.0,80.0,1,285,0.0,285.0,285.0
242135.0,6,3,337,2,214,0.0,160.0,107.0,1,123,0.0,123.0,123.0
82.0,17,2,762,2,762,0.0,381.0,381.0,0,0,0.0,0.0,0.0
146615.0,6,3,337,2,214,0.0,160.0,107.0,1,123,0.0,123.0,123.0
14877.0,6,11,1131,6,600,2737.8,262.0,100.0,5,531,3385.0,259.0,106.2
30655.0,6,14,4740,7,653,3992.5,249.0,93.28571428571428,7,4087,4763.166666666667,1514.0,583.8571428571429
2370.0,17,4,344,2,150,0.0,75.0,75.0,2,194,0.0,103.0,97.0
14970.0,17,2,180,1,90,0.0,90.0,90.0,1,90,0.0,90.0,90.0
122530438.0,6,49,3234,25,1650,5105434.916666667,66.0,66.0,24,1584,5015804.826086956,66.0,66.0
129648840.0,17,14,864,7,432,18334380.666666668,174.0,61.71428571428572,7,432,18333495.5,174.0,61.71428571428572
299523.0,17,2,346,1,78,0.0,78.0,78.0,1,268,0.0,268.0,268.0
232175.0,6,3,337,2,214,0.0,160.0,107.0,1,123,0.0,123.0,123.0
117130609.0,6,31,2166,16,1149,7795082.666666667,123.0,71.8125,15,1017,8351822.642857143,123.0,67.8
292690.0,17,6,1230,3,234,146154.5,78.0,78.0,3,996,146077.0,332.0,332.0
153452.0,17,2,180,1,90,0.0,90.0,90.0,1,90,0.0,90.0,90.0
5529642.0,6,5,336,2,134,0.0,68.0,67.0,3,202,1526248.0,70.0,67.33333333333333
217974.0,6,3,426,2,280,0.0,214.0,140.0,1,146,0.0,146.0,146.0
1186363.0,6,13,3010,8,2382,169480.42857142858,1514.0,297.75,5,628,226903.0,331.0,125.6
90535206.0,6,14,2240,8,1016,12933600.857142856,188.0,127.0,6,1224,18073913.6,204.0,204.0
32086.000000000004,6,10,2032,5,524,7777.25,252.0,104.8,5,1508,7061.25,1236.0,301.6
156352.0,17,2,180,1,90,0.0,90.0,90.0,1,90,0.0,90.0,90.0
153416.0,17,2,180,1,90,0.0,90.0,90.0,1,90,0.0,90.0,90.0
125495107.0,6,32,2236,16,1071,7700729.133333334,123.0,66.9375,16,1165,7700724.0,139.0,72.8125
144004.0,17,2,180,1,90,0.0,90.0,90.0,1,90,0.0,90.0,90.0
10439005.0,6,7,478,4,272,3433862.6666666665,74.0,68.0,3,206,5150690.0,74.0,68.66666666666667
111533796.0,6,30,1974,15,1026,7951279.714285715,123.0,68.4,15,948,7951282.714285715,123.0,63.2
433.0,17,2,508,2,508,0.0,257.0,254.0,0,0,0.0,0.0,0.0
90259724.0,6,13,2036,8,1016,12894246.285714284,188.0,127.0,5,1020,22523850.0,204.0,204.0
111347.0,17,2,286,2,286,0.0,143.0,143.0,0,0,0.0,0.0,0.0
209493.0,17,2,180,1,90,0.0,90.0,90.0,1,90,0.0,90.0,90.0
1334121.0,17,7,490,7,490,222353.5,70.0,70.0,0,0,0.0,0.0,0.0
90298931.0,6,16,1192,8,596,12893370.285714284,95.0,74.5,8,596,12899064.0,95.0,74.5
735.0,17,4,438,2,148,0.0,74.0,74.0,2,290,0.0,147.0,145.0
24654.0,6,10,2032,5,524,4871.25,252.0,104.8,5,1508,5781.25,1236.0,301.6
25890.0,6,11,2098,6,590,4559.8,252.0,98.33333333333331,5,1508,6190.0,1236.0,301.6
90273959.0,6,21,1585,11,840,9023415.3,95.0,76.36363636363636,10,745,9948700.777777778,95.0,74.5
2964355.0,6,5,336,2,134,0.0,68.0,67.0,3,202,197852.0,70.0,67.33333333333333
7695.0,17,2,602,1,72,0.0,72.0,72.0,1,530,0.0,530.0,530.0
120067791.0,6,30,1990,15,1042,8560857.92857143,139.0,69.46666666666667,15,948,8560848.42857143,123.0,63.2
351.0,17,2,214,1,75,0.0,75.0,75.0,1,139,0.0,139.0,139.0
844.0,17,4,438,2,148,0.0,74.0,74.0,2,290,0.0,147.0,145.0
309839.0,6,3,202,2,128,0.0,74.0,64.0,1,74,0.0,74.0,74.0
52986.0,6,14,4740,7,653,8709.5,249.0,93.28571428571428,7,4087,8611.833333333334,1514.0,583.8571428571429
111824.0,17,4,1400,4,1400,37274.66666666666,350.0,350.0,0,0,0.0,0.0,0.0
103029.0,17,2,762,2,762,0.0,381.0,381.0,0,0,0.0,0.0,0.0
108109882.0,17,5,955,5,955,27027470.5,191.0,191.0,0,0,0.0,0.0,0.0
2017.0,17,2,180,1,90,0.0,90.0,90.0,1,90,0.0,90.0,90.0
108109500.0,17,5,955,5,955,27027375.0,191.0,191.0,0,0,0.0,0.0,0.0
0.0,17,1,43,1,43,0.0,43.0,43.0,0,0,0.0,0.0,0.0
245668.0,6,3,337,2,214,0.0,160.0,107.0,1,123,0.0,123.0,123.0
200342.0,17,2,762,2,762,0.0,381.0,381.0,0,0,0.0,0.0,0.0
2784061.0,6,3,1604,1,753,0.0,753.0,753.0,2,851,0.0,785.0,425.5
107905.0,17,2,286,2,286,0.0,143.0,143.0,0,0,0.0,0.0,0.0
36116.0,6,14,4740,7,653,5895.333333333333,249.0,93.28571428571428,7,4087,5359.333333333333,1514.0,583.8571428571429
922.0,17,4,438,2,148,0.0,74.0,74.0,2,290,0.0,147.0,145.0
20186.0,17,2,582,1,83,0.0,83.0,83.0,1,499,0.0,499.0,499.0
5617767.0,6,4,270,2,134,0.0,68.0,67.0,2,136,0.0,70.0,68.0
17651.0,6,10,2032,5,524,4158.0,252.0,104.8,5,1508,4056.5,1236.0,301.6
2329.0,17,4,344,2,150,0.0,75.0,75.0,2,194,0.0,103.0,97.0
48517.0,6,14,4740,7,653,7145.0,249.0,93.28571428571428,7,4087,7909.333333333333,1514.0,583.8571428571429
90523682.0,6,15,2444,8,1016,12931954.57142857,188.0,127.0,7,1428,15060039.333333334,204.0,204.0
724158.0,17,4,883,2,156,0.0,78.0,78.0,2,727,0.0,395.0,363.5
101000991.0,17,13,821,7,432,16833498.5,174.0,61.71428571428572,6,389,16201452.2,174.0,64.83333333333333
311464.0,6,3,202,2,128,0.0,74.0,64.0,1,74,0.0,74.0,74.0
120122527.0,6,18,2422,9,1138,15015315.875,199.0,126.44444444444444,9,1284,14994669.5,204.0,142.66666666666666
0.0,17,1,55,1,55,0.0,55.0,55.0,0,0,0.0,0.0,0.0
40461.0,6,14,4740,7,653,6567.0,249.0,93.28571428571428,7,4087,6371.666666666667,1514.0,583.8571428571429
143991.0,17,2,180,1,90,0.0,90.0,90.0,1,90,0.0,90.0,90.0
205437.0,17,2,762,2,762,0.0,381.0,381.0,0,0,0.0,0.0,0.0
326553.0,6,6,412,4,272,108851.0,74.0,68.0,2,140,0.0,74.0,70.0
36956386.0,6,6,402,3,200,18436791.0,68.0,66.66666666666667,3,202,18423016.5,70.0,67.33333333333333
26039.0,6,14,4740,7,653,4231.166666666667,249.0,93.28571428571428,7,4087,3910.1666666666665,1514.0,583.8571428571429
12842295.0,6,7,499,3,198,6141516.0,66.0,66.0,4,301,3439487.333333333,103.0,75.25
14759.0,6,14,4740,7,653,2198.5,249.0,93.28571428571428,7,4087,2247.5,1514.0,583.8571428571429
299272.0,6,6,412,4,272,99757.33333333331,74.0,68.0,2,140,0.0,74.0,70.0
120033759.0,6,543,74076,272,18248,442929.0,140.0,67.08823529411765,271,55828,443747.2851851852,480.0,206.0073800738008
90302202.0,6,16,1192,8,596,12893782.857142856,95.0,74.5,8,596,12898977.857142856,95.0,74.5
216522.0,17,2,180,1,90,0.0,90.0,90.0,1,90,0.0,90.0,90.0
90254787.0,6,12,1832,8,1016,12893541.0,188.0,127.0,4,816,30028307.0,204.0,204.0
108447.0,17,2,286,2,286,0.0,143.0,143.0,0,0,0.0,0.0,0.0
6894.0,17,2,582,1,83,0.0,83.0,83.0,1,499,0.0,499.0,499.0
306337.0,6,6,412,4,272,102112.33333333331,74.0,68.0,2,140,0.0,74.0,70.0
103008253.0,17,14,1126,7,563,17167529.5,174.0,80.42857142857143,7,563,17166860.833333332,174.0,80.42857142857143
135131507.0,17,6,1146,6,1146,27026301.4,191.0,191.0,0,0,0.0,0.0,0.0
90059626.0,17,27,12943,27,12943,3463831.769230769,501.0,479.3703703703704,0,0,0.0,0.0,0.0
103269.0,17,2,286,2,286,0.0,143.0,143.0,0,0,0.0,0.0,0.0
3272.0,17,2,224,1,76,0.0,76.0,76.0,1,148,0.0,148.0,148.0
17601.0,6,10,2032,5,524,4153.5,252.0,104.8,5,1508,3092.5,1236.0,301.6
254768.0,6,12,1373,7,714,42461.333333333336,298.0,102.0,5,659,63053.25,379.0,131.8
90209648.0,6,17,1287,8,596,12853175.0,95.0,74.5,9,691,11250617.5,95.0,76.77777777777777
90057165.0,17,28,13364,28,13364,3335450.5555555555,501.0,477.2857142857143,0,0,0.0,0.0,0.0
90047642.0,17,28,13364,28,13364,3335097.851851852,501.0,477.2857142857143,0,0,0.0,0.0,0.0
251268.0,6,3,337,2,214,0.0,160.0,107.0,1,123,0.0,123.0,123.0
30967.0,6,14,4740,7,653,4714.166666666667,249.0,93.28571428571428,7,4087,4984.5,1514.0,583.8571428571429
144991.0,17,2,180,1,70,0.0,70.0,70.0,1,110,0.0,110.0,110.0
45759.0,6,14,4740,7,653,7180.666666666667,249.0,93.28571428571428,7,4087,7447.333333333333,1514.0,583.8571428571429
108442597.0,6,44,2904,22,1452,5163933.19047619,66.0,66.0,22,1452,5149275.19047619,66.0,66.0
108671050.0,6,34,2482,17,1288,6778460.9375,139.0,75.76470588235294,17,1194,6778457.4375,123.0,70.23529411764706
208513.0,6,3,426,2,280,0.0,214.0,140.0,1,146,0.0,146.0,146.0
155420.0,6,3,337,2,214,0.0,160.0,107.0,1,123,0.0,123.0,123.0
10474671.0,6,7,478,4,272,3445926.6666666665,74.0,68.0,3,206,5168784.0,74.0,68.66666666666667
90764154.0,6,19,1436,10,745,10080362.888888888,95.0,74.5,9,691,11344608.125,95.0,76.77777777777777
122001073.0,17,15,907,8,475,17428724.714285713,174.0,59.375,7,432,17001177.166666668,174.0,61.71428571428572
300487.0,6,6,412,4,272,100162.33333333331,74.0,68.0,2,140,0.0,74.0,70.0
327.0,17,2,152,1,76,0.0,76.0,76.0,1,76,0.0,76.0,76.0
243391.0,6,3,337,2,214,0.0,160.0,107.0,1,123,0.0,123.0,123.0
217102.0,6,3,426,2,280,0.0,214.0,140.0,1,146,0.0,146.0,146.0
47620.0,6,14,4740,7,653,7765.5,249.0,93.28571428571428,7,4087,7538.833333333333,1514.0,583.8571428571429
3987.0,17,2,762,2,762,0.0,381.0,381.0,0,0,0.0,0.0,0.0
365252.0,6,11,1021,6,444,49385.6,162.0,74.0,5,577,61428.25,349.0,115.4
232682.0,6,10,1221,6,636,46536.4,298.0,106.0,4,585,75282.0,379.0,146.25
135131915.0,17,6,1206,6,1206,27026383.0,201.0,201.0,0,0,0.0,0.0,0.0
144912.0,17,2,180,1,70,0.0,70.0,70.0,1,110,0.0,110.0,110.0
2317.0,17,4,344,2,150,0.0,75.0,75.0,2,194,0.0,103.0,97.0
2407.0,17,4,344,2,150,0.0,75.0,75.0,2,194,0.0,103.0,97.0
206542.0,6,3,426,2,280,0.0,214.0,140.0,1,146,0.0,146.0,146.0
0.0,17,1,90,1,90,0.0,90.0,90.0,0,0,0.0,0.0,0.0
26853.0,6,14,4740,7,653,4063.3333333333335,249.0,93.28571428571428,7,4087,3831.0,1514.0,583.8571428571429
50105.0,6,14,4740,7,653,5818.333333333333,249.0,93.28571428571428,7,4087,8058.666666666667,1514.0,583.8571428571429
98058803.0,6,187,21064,94,6426,1054395.7311827955,140.0,68.36170212765957,93,14638,1055787.1304347827,284.0,157.3978494623656
120121596.0,6,15,2444,8,1016,17137409.0,188.0,127.0,7,1428,15012807.333333334,204.0,204.0
146049.0,6,3,337,2,214,0.0,160.0,107.0,1,123,0.0,123.0,123.0
105394509.0,17,14,864,7,432,17501675.666666668,174.0,61.71428571428572,7,432,17500186.0,174.0,61.71428571428572
41719.0,6,14,4740,7,653,6832.333333333333,249.0,93.28571428571428,7,4087,5807.833333333333,1514.0,583.8571428571429
2949911.0,6,3,1604,1,753,0.0,753.0,753.0,2,851,0.0,785.0,425.5
290261.0,6,10,1221,6,636,58052.2,298.0,106.0,4,585,91290.0,379.0,146.25
99983652.0,6,193,21804,97,15172,1041496.375,284.0,156.41237113402062,96,6632,1048151.8210526316,140.0,69.08333333333333
14454.0,6,14,4740,7,653,2236.833333333333,249.0,93.28571428571428,7,4087,2274.833333333333,1514.0,583.8571428571429
99133719.0,17,12,778,6,389,19800165.2,174.0,64.83333333333333,6,389,19801283.4,174.0,64.83333333333333
333.0,17,2,166,1,75,0.0,75.0,75.0,1,91,0.0,91.0,91.0
104721342.0,6,34,2482,17,1288,6545083.875,139.0,75.76470588235294,17,1194,6531568.1875,123.0,70.23529411764706
32878.0,6,14,4740,7,653,5369.666666666667,249.0,93.28571428571428,7,4087,4839.166666666667,1514.0,583.8571428571429
51234.0,6,10,2032,5,524,12602.75,252.0,104.8,5,1508,11325.75,1236.0,301.6
13182.0,17,2,180,1,90,0.0,90.0,90.0,1,90,0.0,90.0,90.0
146071.0,6,3,337,2,214,0.0,160.0,107.0,1,123,0.0,123.0,123.0
300977.0,6,6,412,4,272,100325.66666666669,74.0,68.0,2,140,0.0,74.0,70.0
870708.0,6,10,1334,6,797,174141.6,459.0,132.83333333333334,4,537,199345.3333333333,331.0,134.25
14718.0,6,11,2098,6,590,2463.4,252.0,98.33333333333331,5,1508,3253.5,1236.0,301.6
39147.0,6,14,4740,7,653,6402.666666666667,249.0,93.28571428571428,7,4087,6370.666666666667,1514.0,583.8571428571429
5006213.0,17,4,534,2,166,0.0,83.0,83.0,2,368,0.0,184.0,184.0
206236.0,17,2,762,2,762,0.0,381.0,381.0,0,0,0.0,0.0,0.0
316.0,17,2,174,1,79,0.0,79.0,79.0,1,95,0.0,95.0,95.0
90046829.0,17,27,12943,27,12943,3463339.576923077,501.0,479.3703703703704,0,0,0.0,0.0,0.0
108104677.0,17,5,955,5,955,27026169.25,191.0,191.0,0,0,0.0,0.0,0.0
2520.0,17,4,344,2,150,0.0,75.0,75.0,2,194,0.0,103.0,97.0
143375.0,6,2,132,1,66,0.0,66.0,66.0,1,66,0.0,66.0,66.0
398031.0,6,12,1373,7,714,66338.5,298.0,102.0,5,659,92923.25,379.0,131.8
111791517.0,6,30,1990,15,1042,7969692.0,139.0,69.46666666666667,15,948,7969689.928571428,123.0,63.2
5620226.0,6,4,270,2,134,0.0,68.0,67.0,2,136,0.0,70.0,68.0
153412.0,17,2,180,1,90,0.0,90.0,90.0,1,90,0.0,90.0,90.0
102858.0,17,2,286,2,286,0.0,143.0,143.0,0,0,0.0,0.0,0.0
974520.0,6,13,1428,7,797,162420.0,253.0,113.85714285714286,6,631,193189.4,293.0,105.16666666666669
326.0,17,2,174,1,79,0.0,79.0,79.0,1,95,0.0,95.0,95.0
15390956.0,6,25,7308,14,1785,1183919.6923076925,408.0,127.5,11,5523,1132375.8,1514.0,502.09090909090907
135137568.0,17,6,1206,6,1206,27027513.6,201.0,201.0,0,0,0.0,0.0,0.0
160269.0,6,2,128,1,74,0.0,74.0,74.0,1,54,0.0,54.0,54.0
1170080.0,6,13,3010,8,2382,167154.2857142857,1514.0,297.75,5,628,223603.5,331.0,125.6
123456168.0,6,49,3234,25,1650,5144007.0,66.0,66.0,24,1584,5102638.608695652,66.0,66.0
90257037.0,6,13,2036,8,1016,12893862.42857143,188.0,127.0,5,1020,22523261.25,204.0,204.0
12138.0,6,11,1133,6,602,2363.2,264.0,100.33333333333331,5,531,2329.25,259.0,106.2
202488.0,17,2,359,1,75,0.0,75.0,75.0,1,284,0.0,284.0,284.0
108104346.0,17,5,1005,5,1005,27026086.5,201.0,201.0,0,0,0.0,0.0,0.0
114899084.0,6,34,2350,17,1225,7167693.1875,139.0,72.05882352941177,17,1125,7167691.5,123.0,66.17647058823529
10864257.0,6,7,478,3,206,5364077.5,74.0,68.66666666666667,4,272,3575971.6666666665,74.0,68.0
10483966.0,6,6,412,3,206,5171159.0,74.0,68.66666666666667,3,206,5171062.5,74.0,68.66666666666667
220988.0,6,10,1221,6,636,44197.6,298.0,106.0,4,585,72538.33333333333,379.0,146.25
146301.0,6,3,337,2,214,0.0,160.0,107.0,1,123,0.0,123.0,123.0
232981.0,6,3,337,2,214,0.0,160.0,107.0,1,123,0.0,123.0,123.0
100801322.0,6,33,2428,17,1288,6300082.625,139.0,75.76470588235294,16,1140,6706432.933333334,123.0,71.25
3465.0,17,2,414,1,88,0.0,88.0,88.0,1,326,0.0,326.0,326.0
90210511.0,6,21,1585,10,745,9996830.777777778,95.0,74.5,11,840,9000508.9,95.0,76.36363636363636
90309656.0,6,19,1436,10,745,10028465.333333334,95.0,74.5,9,691,11287831.875,95.0,76.77777777777777
343.0,17,2,160,1,80,0.0,80.0,80.0,1,80,0.0,80.0,80.0
121011491.0,17,15,1169,8,606,17287355.85714286,174.0,75.75,7,563,16833496.833333332,174.0,80.42857142857143
255064.0,6,3,337,2,214,0.0,160.0,107.0,1,123,0.0,123.0,123.0
237414.0,17,2,180,1,90,0.0,90.0,90.0,1,90,0.0,90.0,90.0
107313.0,17,2,286,2,286,0.0,143.0,143.0,0,0,0.0,0.0,0.0
2188653.0,6,24,7544,13,2516,182387.75,1034.0,193.53846153846155,11,5028,188299.2,1510.0,457.09090909090907
2569452.0,6,14,1332,6,558,513890.4,220.0,93.0,8,774,364832.7142857143,304.0,96.75
104271516.0,17,13,4446,13,4446,8689293.0,342.0,342.0,0,0,0.0,0.0,0.0
120059140.0,17,12,647,7,432,20009856.666666668,174.0,61.71428571428572,5,215,20000732.25,43.0,43.0
9218.0,17,2,539,1,86,0.0,86.0,86.0,1,453,0.0,453.0,453.0
10438199.0,6,7,478,4,272,3433686.333333333,74.0,68.0,3,206,5150383.5,74.0,68.66666666666667
300.0,17,2,156,1,78,0.0,78.0,78.0,1,78,0.0,78.0,78.0
5682.0,17,2,231,1,78,0.0,78.0,78.0,1,153,0.0,153.0,153.0
277722.0,17,2,363,1,79,0.0,79.0,79.0,1,284,0.0,284.0,284.0
206267.0,17,2,762,2,762,0.0,381.0,381.0,0,0,0.0,0.0,0.0
48954.0,6,10,2032,5,524,12005.5,252.0,104.8,5,1508,11555.5,1236.0,301.6
751029.0,6,2,132,1,66,0.0,66.0,66.0,1,66,0.0,66.0,66.0
322787.0,17,4,1400,4,1400,107595.66666666669,350.0,350.0,0,0,0.0,0.0,0.0
648.0,17,2,762,2,762,0.0,381.0,381.0,0,0,0.0,0.0,0.0
135138233.0,17,6,1206,6,1206,27027646.6,201.0,201.0,0,0,0.0,0.0,0.0
610054.0,17,2,335,1,88,0.0,88.0,88.0,1,247,0.0,247.0,247.0
135128663.0,17,6,1146,6,1146,27025732.6,191.0,191.0,0,0,0.0,0.0,0.0
23584.0,6,14,4740,7,653,3234.0,249.0,93.28571428571428,7,4087,3564.833333333333,1514.0,583.8571428571429
337.0,17,2,267,1,83,0.0,83.0,83.0,1,184,0.0,184.0,184.0
9549.0,17,4,823,2,163,0.0,89.0,81.5,2,660,0.0,443.0,330.0
36458.0,6,14,4740,7,653,5955.833333333333,249.0,93.28571428571428,7,4087,5908.666666666667,1514.0,583.8571428571429
21713.0,6,10,2032,5,524,5200.5,252.0,104.8,5,1508,4847.25,1236.0,301.6
197028.0,17,2,180,1,90,0.0,90.0,90.0,1,90,0.0,90.0,90.0
814.0,17,4,438,2,148,0.0,74.0,74.0,2,290,0.0,147.0,145.0
103621.0,17,2,286,2,286,0.0,143.0,143.0,0,0,0.0,0.0,0.0
190967.0,17,2,180,1,90,0.0,90.0,90.0,1,90,0.0,90.0,90.0
15883987.0,17,6,2052,6,2052,3176797.4,342.0,342.0,0,0,0.0,0.0,0.0
39419.0,6,14,4740,7,653,6445.5,249.0,93.28571428571428,7,4087,6084.5,1514.0,583.8571428571429
2608.0,17,4,344,2,150,0.0,75.0,75.0,2,194,0.0,103.0,97.0
501134.0,6,5,336,2,134,0.0,68.0,67.0,3,202,194904.5,70.0,67.33333333333333
539550.0,17,6,2100,6,2100,107910.0,350.0,350.0,0,0,0.0,0.0,0.0
54355.0,6,14,4740,7,653,8440.0,249.0,93.28571428571428,7,4087,8341.166666666666,1514.0,583.8571428571429
11574.0,6,10,1066,5,490,2724.5,218.0,98.0,5,576,2391.25,304.0,115.2
179425.0,6,11,1131,6,600,35665.6,262.0,100.0,5,531,3545.25,259.0,106.2
112000938.0,17,13,821,7,432,18666823.0,174.0,61.71428571428572,6,389,18200923.2,174.0,64.83333333333333
51189.0,6,14,4740,7,653,8400.333333333334,249.0,93.28571428571428,7,4087,7171.333333333333,1514.0,583.8571428571429
235868.0,17,2,604,1,75,0.0,75.0,75.0,1,529,0.0,529.0,529.0
144091.0,17,2,180,1,90,0.0,90.0,90.0,1,90,0.0,90.0,90.0
177315.0,17,2,180,1,90,0.0,90.0,90.0,1,90,0.0,90.0,90.0
32680573.000000004,6,5,336,2,134,0.0,68.0,67.0,3,202,15052864.5,70.0,67.33333333333333
204372.0,17,2,762,2,762,0.0,381.0,381.0,0,0,0.0,0.0,0.0
2329.0,17,4,344,2,150,0.0,75.0,75.0,2,194,0.0,103.0,97.0
120241190.0,6,210,23854,105,7152,1149404.2403846155,140.0,68.11428571428571,105,16702,1148119.1442307692,300.0,159.06666666666666
71262.0,6,15,4806,8,719,10034.714285714286,249.0,89.875,7,4087,11399.333333333334,1514.0,583.8571428571429
5628689.0,6,5,336,2,134,0.0,68.0,67.0,3,202,1423378.0,70.0,67.33333333333333
1448086.0,6,7,499,3,198,716346.0,66.0,66.0,4,301,471822.3333333333,103.0,75.25
108103670.0,17,5,1005,5,1005,27025917.5,201.0,201.0,0,0,0.0,0.0,0.0
120155407.0,6,234,26422,117,8018,1035822.474137931,140.0,68.52991452991454,117,18404,1033907.448275862,284.0,157.2991452991453
44570.0,6,14,4740,7,653,7307.333333333333,249.0,93.28571428571428,7,4087,6735.0,1514.0,583.8571428571429
121278.0,6,3,337,2,214,0.0,160.0,107.0,1,123,0.0,123.0,123.0
54483.0,6,14,4740,7,653,8615.666666666666,249.0,93.28571428571428,7,4087,8169.166666666667,1514.0,583.8571428571429
31502.000000000004,6,13,4519,6,512,6106.4,230.0,85.33333333333333,7,4007,4762.0,1514.0,572.4285714285714
233385.0,6,3,337,2,214,0.0,160.0,107.0,1,123,0.0,123.0,123.0
5005649.0,17,4,849,2,166,0.0,83.0,83.0,2,683,0.0,499.0,341.5
321330.0,17,4,1400,4,1400,107110.0,350.0,350.0,0,0,0.0,0.0,0.0
143876.0,17,2,180,1,90,0.0,90.0,90.0,1,90,0.0,90.0,90.0
12686.0,6,11,1131,6,600,2199.2,262.0,100.0,5,531,2663.0,259.0,106.2
6430.0,17,4,823,2,163,0.0,89.0,81.5,2,660,0.0,443.0,330.0
120363449.0,6,225,25484,113,17870,1074673.6517857143,284.0,158.141592920354,112,7614,1075075.1531531531,140.0,67.98214285714286
112464177.0,6,46,3036,23,1518,5111996.045454546,66.0,66.0,23,1518,5111996.727272728,66.0,66.0
9968.0,17,2,582,1,83,0.0,83.0,83.0,1,499,0.0,499.0,499.0
234001.0,6,3,337,2,214,0.0,160.0,107.0,1,123,0.0,123.0,123.0
57506.0,6,14,4740,7,653,9420.666666666666,249.0,93.28571428571428,7,4087,8908.5,1514.0,583.8571428571429
307849.0,6,6,412,4,272,102616.33333333331,74.0,68.0,2,140,0.0,74.0,70.0
104315.0,17,2,286,2,286,0.0,143.0,143.0,0,0,0.0,0.0,0.0
90037174.0,17,27,12943,27,12943,3462968.230769231,501.0,479.3703703703704,0,0,0.0,0.0,0.0
108102357.0,17,5,1005,5,1005,27025589.25,201.0,201.0,0,0,0.0,0.0,0.0
204621.0,17,2,180,1,90,0.0,90.0,90.0,1,90,0.0,90.0,90.0
0.0,17,1,55,1,55,0.0,55.0,55.0,0,0,0.0,0.0,0.0
65545.0,6,12,1320,7,789,10924.166666666666,253.0,112.71428571428572,5,531,10247.25,259.0,106.2
90782575.0,6,27,2073,15,1138,6480117.285714285,95.0,75.86666666666666,12,935,8183577.363636363,95.0,77.91666666666667
90288317.0,6,24,1829,13,989,7520262.0,95.0,76.07692307692308,11,840,9000319.3,95.0,76.36363636363636
241352.0,6,3,373,2,238,0.0,172.0,119.0,1,135,0.0,135.0,135.0
21283.0,6,10,2032,5,524,4406.75,252.0,104.8,5,1508,5082.25,1236.0,301.6
1039008.0,6,11,1134,6,558,207801.6,220.0,93.0,5,576,256522.0,304.0,115.2
61707.0,6,14,4740,7,653,10110.833333333334,249.0,93.28571428571428,7,4087,9276.0,1514.0,583.8571428571429
106849866.0,6,34,2482,17,1288,6664615.5625,139.0,75.76470588235294,17,1194,6664608.625,123.0,70.23529411764706
19531.0,6,14,4740,7,653,3146.833333333333,249.0,93.28571428571428,7,4087,3116.0,1514.0,583.8571428571429
108106391.0,17,5,955,5,955,27026597.75,191.0,191.0,0,0,0.0,0.0,0.0
247364.0,6,3,337,2,214,0.0,160.0,107.0,1,123,0.0,123.0,123.0
509.0,17,2,508,2,508,0.0,257.0,254.0,0,0,0.0,0.0,0.0
90292993.0,6,16,1192,8,596,12891796.57142857,95.0,74.5,8,596,12898399.714285716,95.0,74.5
313193.0,6,6,412,4,272,104397.66666666669,74.0,68.0,2,140,0.0,74.0,70.0
207986.0,17,2,620,1,75,0.0,75.0,75.0,1,545,0.0,545.0,545.0
656509.0,17,2,346,1,78,0.0,78.0,78.0,1,268,0.0,268.0,268.0
100130933.0,17,14,1126,7,563,16666805.5,174.0,80.42857142857143,7,563,16667718.833333334,174.0,80.42857142857143
228652.0,17,2,180,1,90,0.0,90.0,90.0,1,90,0.0,90.0,90.0
246273.0,6,3,337,2,214,0.0,160.0,107.0,1,123,0.0,123.0,123.0
130422.0,6,2,132,1,66,0.0,66.0,66.0,1,66,0.0,66.0,66.0
207071.0,6,3,426,2,280,0.0,214.0,140.0,1,146,0.0,146.0,146.0
166416.0,17,4,704,2,148,0.0,74.0,74.0,2,556,0.0,280.0,278.0
48901.0,6,13,1386,7,789,8150.166666666667,253.0,112.71428571428572,6,597,6280.4,259.0,99.5
116711375.0,6,32,2236,16,1165,7766371.4,139.0,72.8125,16,1071,7766369.8,123.0,66.9375
135136252.0,17,6,1146,6,1146,27027250.4,191.0,191.0,0,0,0.0,0.0,0.0
321.0,17,2,168,1,76,0.0,76.0,76.0,1,92,0.0,92.0,92.0
1177048.0,6,13,3009,8,2381,168149.7142857143,1514.0,297.625,5,628,225203.5,331.0,125.6
153458.0,17,2,180,1,90,0.0,90.0,90.0,1,90,0.0,90.0,90.0
5834866.0,6,5,336,2,134,0.0,68.0,67.0,3,202,1528215.0,70.0,67.33333333333333
18127.0,6,10,2032,5,524,4270.25,252.0,104.8,5,1508,4182.75,1236.0,301.6
95550.0,6,14,4740,7,653,15232.666666666666,249.0,93.28571428571428,7,4087,15427.333333333334,1514.0,583.8571428571429
33829.0,6,14,4740,7,653,4617.5,249.0,93.28571428571428,7,4087,5505.5,1514.0,583.8571428571429
115165507.0,17,14,864,7,432,19166863.666666668,174.0,61.71428571428572,7,432,19167675.83333333,174.0,61.71428571428572
110133252.0,6,28,1860,14,966,8455196.23076923,123.0,69.0,14,894,8455192.846153846,123.0,63.85714285714285
77486.0,6,13,4519,6,512,15333.6,230.0,85.33333333333333,7,4007,6285.166666666667,1514.0,572.4285714285714
255259.0,6,3,337,2,214,0.0,160.0,107.0,1,123,0.0,123.0,123.0
103414.0,17,2,286,2,286,0.0,143.0,143.0,0,0,0.0,0.0,0.0
298097.0,6,6,412,4,272,99365.66666666669,74.0,68.0,2,140,0.0,74.0,70.0
55017889.0,17,12,912,12,912,5001626.2727272725,78.0,76.0,0,0,0.0,0.0,0.0
143880.0,17,2,180,1,90,0.0,90.0,90.0,1,90,0.0,90.0,90.0
917678.0,6,12,1447,6,816,182379.0,291.0,136.0,6,631,182810.0,293.0,105.16666666666669
526.0,17,2,508,2,508,0.0,257.0,254.0,0,0,0.0,0.0,0.0
2795647.0,6,2,132,1,66,0.0,66.0,66.0,1,66,0.0,66.0,66.0
35519.0,6,14,4740,7,653,5801.833333333333,249.0,93.28571428571428,7,4087,5515.666666666667,1514.0,583.8571428571429
13579.0,6,10,2032,5,524,3112.25,252.0,104.8,5,1508,2703.25,1236.0,301.6
455417.0,6,3,204,1,68,0.0,68.0,68.0,2,136,0.0,70.0,68.0
117539472.0,6,32,2220,16,1149,7821561.866666666,123.0,71.8125,16,1071,7821561.6,123.0,66.9375
200726.0,17,4,1400,4,1400,66908.66666666667,350.0,350.0,0,0,0.0,0.0,0.0
2013.0,17,4,344,2,150,0.0,75.0,75.0,2,194,0.0,103.0,97.0
216863.0,6,3,426,2,280,0.0,214.0,140.0,1,146,0.0,146.0,146.0
242280.0,6,3,337,2,214,0.0,160.0,107.0,1,123,0.0,123.0,123.0
10869769.0,6,8,544,4,272,3576051.6666666665,74.0,68.0,4,272,3575984.333333333,74.0,68.0
48650.0,6,14,4740,7,653,7987.666666666667,249.0,93.28571428571428,7,4087,6457.0,1514.0,583.8571428571429
79373.0,6,15,4806,8,719,11234.142857142857,249.0,89.875,7,4087,12954.666666666666,1514.0,583.8571428571429
309459.0,17,4,1400,4,1400,103153.0,350.0,350.0,0,0,0.0,0.0,0.0
315340.0,17,4,1400,4,1400,105113.33333333331,350.0,350.0,0,0,0.0,0.0,0.0
135137729.0,17,6,1146,6,1146,27027545.8,191.0,191.0,0,0,0.0,0.0,0.0
28539.0,17,4,438,2,148,0.0,74.0,74.0,2,290,0.0,147.0,145.0
203399.0,17,4,6056,4,6056,67799.66666666667,1514.0,1514.0,0,0,0.0,0.0,0.0
317.0,17,2,174,1,79,0.0,79.0,79.0,1,95,0.0,95.0,95.0
120157695.0,6,12,1832,8,1016,17137612.0,188.0,127.0,4,816,30035360.0,204.0,204.0
114156774.0,6,48,3168,24,1584,4963338.0,66.0,66.0,24,1584,4951494.0,66.0,66.0
66337.0,6,12,1328,7,797,11056.166666666666,253.0,113.85714285714286,5,531,11579.75,259.0,106.2
151923.0,17,2,414,1,88,0.0,88.0,88.0,1,326,0.0,326.0,326.0
27021171.0,17,2,402,2,402,0.0,201.0,201.0,0,0,0.0,0.0,0.0
316454.0,17,4,1400,4,1400,105484.66666666669,350.0,350.0,0,0,0.0,0.0,0.0
120120496.0,6,17,2556,10,1392,13346721.777777778,188.0,139.2,7,1164,15015008.833333334,204.0,166.28571428571428
2602657.0,6,2,132,1,66,0.0,66.0,66.0,1,66,0.0,66.0,66.0
100762367.0,17,13,821,7,432,16793727.833333332,174.0,61.71428571428572,6,389,16177650.2,174.0,64.83333333333333
250184.00000000003,6,3,337,2,214,0.0,160.0,107.0,1,123,0.0,123.0,123.0
114032586.0,6,48,3168,24,1584,4957938.521739131,66.0,66.0,24,1584,4945950.434782608,66.0,66.0
216666.0,17,2,180,1,90,0.0,90.0,90.0,1,90,0.0,90.0,90.0
228247.0,17,2,180,1,90,0.0,90.0,90.0,1,90,0.0,90.0,90.0
108444.0,17,2,286,2,286,0.0,143.0,143.0,0,0,0.0,0.0,0.0
103973.0,17,2,286,2,286,0.0,143.0,143.0,0,0,0.0,0.0,0.0
245530.0,6,3,337,2,214,0.0,160.0,107.0,1,123,0.0,123.0,123.0
128001134.0,17,15,907,8,475,18285876.285714287,174.0,59.375,7,432,18001566.666666668,174.0,61.71428571428572
9267007.0,17,3,1034,2,684,0.0,342.0,342.0,1,350,0.0,350.0,350.0
143853.0,17,2,180,1,90,0.0,90.0,90.0,1,90,0.0,90.0,90.0
108109681.0,17,5,1005,5,1005,27027420.25,201.0,201.0,0,0,0.0,0.0,0.0
1034092.0,6,11,1134,6,558,206818.4,220.0,93.0,5,576,257051.25,304.0,115.2
107536.0,17,2,700,2,700,0.0,350.0,350.0,0,0,0.0,0.0,0.0
15197.0,6,10,1065,5,534,3413.75,262.0,106.8,5,531,3477.5,259.0,106.2
5005025.0,17,4,849,2,166,0.0,83.0,83.0,2,683,0.0,499.0,341.5
2527215.0,6,3,1604,1,753,0.0,753.0,753.0,2,851,0.0,785.0,425.5
191172.0,17,2,180,1,90,0.0,90.0,90.0,1,90,0.0,90.0,90.0
66547132.00000001,6,9,1479,9,1479,8318391.5,172.0,164.33333333333334,0,0,0.0,0.0,0.0
90259351.0,6,13,2036,8,1016,12894193.0,188.0,127.0,5,1020,22523522.25,204.0,204.0
216344.0,17,2,180,1,90,0.0,90.0,90.0,1,90,0.0,90.0,90.0
58088849.0,6,103,11590,52,8076,1138997.0392156865,284.0,155.30769230769232,51,3514,1151258.2,140.0,68.90196078431373
33489.0,6,10,2032,5,524,7255.75,252.0,104.8,5,1508,7613.75,1236.0,301.6
228233.0,17,2,180,1,90,0.0,90.0,90.0,1,90,0.0,90.0,90.0
2079881.0,6,61,45343,28,2018,77032.62962962964,216.0,72.07142857142857,33,43325,64718.43749999999,1514.0,1312.878787878788
303145.0,6,2,132,1,66,0.0,66.0,66.0,1,66,0.0,66.0,66.0
248406.0,17,2,180,1,70,0.0,70.0,70.0,1,110,0.0,110.0,110.0
27611081.0,17,5,1710,5,1710,6902770.25,342.0,342.0,0,0,0.0,0.0,0.0
136576.0,6,2,132,1,66,0.0,66.0,66.0,1,66,0.0,66.0,66.0
108104527.0,17,5,1005,5,1005,27026131.75,201.0,201.0,0,0,0.0,0.0,0.0
120247.0,17,2,180,1,70,0.0,70.0,70.0,1,110,0.0,110.0,110.0
120123928.0,6,14,2224,9,1204,15015491.0,188.0,133.77777777777777,5,1020,22591734.75,204.0,204.0
146280.0,6,3,337,2,214,0.0,160.0,107.0,1,123,0.0,123.0,123.0
128521726.0,17,14,864,7,432,18166814.5,174.0,61.71428571428572,7,432,18168347.666666668,174.0,61.71428571428572
3255.0,17,2,363,1,79,0.0,79.0,79.0,1,284,0.0,284.0,284.0
123302903.0,6,48,3168,24,1584,5004927.956521739,66.0,66.0,24,1584,5291708.521739131,66.0,66.0
206298.0,6,3,426,2,280,0.0,214.0,140.0,1,146,0.0,146.0,146.0
197035.0,17,2,180,1,90,0.0,90.0,90.0,1,90,0.0,90.0,90.0
157.0,17,2,3028,2,3028,0.0,1514.0,1514.0,0,0,0.0,0.0,0.0
1978746.0,6,7,499,4,301,588771.0,103.0,75.25,3,198,921086.0,66.0,66.0
43974.0,6,14,4740,7,653,7157.166666666667,249.0,93.28571428571428,7,4087,6422.833333333333,1514.0,583.8571428571429
12190.0,6,10,2032,5,524,2466.5,252.0,104.8,5,1508,2539.5,1236.0,301.6
332496.0,6,3,202,2,128,0.0,74.0,64.0,1,74,0.0,74.0,74.0
2664710.0,6,3,1777,2,951,0.0,885.0,475.5,1,826,0.0,826.0,826.0
67484.0,6,14,4740,7,653,10942.666666666666,249.0,93.28571428571428,7,4087,11115.333333333334,1514.0,583.8571428571429
3134074.0,6,3,1604,2,851,0.0,785.0,425.5,1,753,0.0,753.0,753.0
31199.0,6,14,4740,7,653,5075.666666666667,249.0,93.28571428571428,7,4087,5064.666666666667,1514.0,583.8571428571429
209426.0,6,3,426,2,280,0.0,214.0,140.0,1,146,0.0,146.0,146.0
156485.0,6,3,337,2,214,0.0,160.0,107.0,1,123,0.0,123.0,123.0
205861.0,17,2,180,1,90,0.0,90.0,90.0,1,90,0.0,90.0,90.0
120256649.0,6,47,3102,23,1518,5105439.136363637,66.0,66.0,24,1584,5219165.043478261,66.0,66.0
90247673.0,6,13,2036,8,1016,12892524.714285716,188.0,127.0,5,1020,22521174.5,204.0,204.0
90296712.0,6,16,1192,8,596,12892628.57142857,95.0,74.5,8,596,12898864.142857144,95.0,74.5
377132.0,17,2,363,1,75,0.0,75.0,75.0,1,288,0.0,288.0,288.0
90045542.0,6,388,49266,194,13038,466500.81865284976,140.0,67.20618556701031,194,36228,462511.6113989637,374.0,186.7422680412371
3506.0,17,2,762,2,762,0.0,381.0,381.0,0,0,0.0,0.0,0.0
46626.0,6,10,2032,5,524,11428.0,252.0,104.8,5,1508,11426.0,1236.0,301.6
106610092.0,6,32,2236,16,1165,7091602.266666667,139.0,72.8125,16,1071,7089100.533333333,123.0,66.9375
108098841.0,17,5,955,5,955,27024710.25,191.0,191.0,0,0,0.0,0.0,0.0
228155.0,17,2,180,1,90,0.0,90.0,90.0,1,90,0.0,90.0,90.0
141658.0,6,2,132,1,66,0.0,66.0,66.0,1,66,0.0,66.0,66.0
120024558.0,6,23,1734,11,840,12002455.8,95.0,76.36363636363636,12,894,10888984.363636363,95.0,74.5
1029395.0,6,11,1134,6,558,205879.0,220.0,93.0,5,576,256363.0,304.0,115.2
232763.0,6,3,337,2,214,0.0,160.0,107.0,1,123,0.0,123.0,123.0
32432.000000000004,6,14,4740,7,653,5283.333333333333,249.0,93.28571428571428,7,4087,5273.833333333333,1514.0,583.8571428571429
90032868.0,17,28,13364,28,13364,3334550.6666666665,501.0,477.2857142857143,0,0,0.0,0.0,0.0
30904.0,6,14,4740,7,653,4349.166666666667,249.0,93.28571428571428,7,4087,5010.833333333333,1514.0,583.8571428571429
103781.0,17,2,286,2,286,0.0,143.0,143.0,0,0,0.0,0.0,0.0
120121977.0,6,16,2648,8,1632,17160282.42857143,204.0,204.0,8,1016,17136998.0,188.0,127.0
309242.0,6,10,1221,6,636,61848.4,298.0,106.0,4,585,97294.33333333331,379.0,146.25
216359.0,17,2,180,1,90,0.0,90.0,90.0,1,90,0.0,90.0,90.0
220715.0,6,3,426,2,280,0.0,214.0,140.0,1,146,0.0,146.0,146.0
19975.0,6,14,4740,7,653,3140.833333333333,249.0,93.28571428571428,7,4087,3099.6666666666665,1514.0,583.8571428571429
16027.0,6,14,4740,7,653,2561.6666666666665,249.0,93.28571428571428,7,4087,1693.0,1514.0,583.8571428571429
94168113.0,17,12,778,6,389,18800163.6,174.0,64.83333333333333,6,389,18801715.0,174.0,64.83333333333333
121357.0,6,3,337,2,214,0.0,160.0,107.0,1,123,0.0,123.0,123.0
127291.0,17,4,1400,4,1400,42430.333333333336,350.0,350.0,0,0,0.0,0.0,0.0
250246.00000000003,6,3,337,2,214,0.0,160.0,107.0,1,123,0.0,123.0,123.0
106802.0,17,2,286,2,286,0.0,143.0,143.0,0,0,0.0,0.0,0.0
108115695.0,17,5,955,5,955,27028923.75,191.0,191.0,0,0,0.0,0.0,0.0
153510.0,17,2,180,1,90,0.0,90.0,90.0,1,90,0.0,90.0,90.0
349.0,17,2,267,1,83,0.0,83.0,83.0,1,184,0.0,184.0,184.0
108101026.0,17,5,955,5,955,27025256.5,191.0,191.0,0,0,0.0,0.0,0.0
233238.0,6,3,337,2,214,0.0,160.0,107.0,1,123,0.0,123.0,123.0
201713.0,17,2,180,1,90,0.0,90.0,90.0,1,90,0.0,90.0,90.0
465622.0,6,3,1777,2,951,0.0,885.0,475.5,1,826,0.0,826.0,826.0
153431.0,17,2,180,1,90,0.0,90.0,90.0,1,90,0.0,90.0,90.0
90056780.0,17,27,12943,27,12943,3463722.3076923075,501.0,479.3703703703704,0,0,0.0,0.0,0.0
120006414.0,6,29,1930,15,948,8571886.714285715,123.0,63.2,14,982,8446409.384615384,139.0,70.14285714285714
0.0,6,1,66,1,66,0.0,66.0,66.0,0,0,0.0,0.0,0.0
1091.0,17,4,820,2,156,0.0,78.0,78.0,2,664,0.0,332.0,332.0
320051.0,17,4,1400,4,1400,106683.66666666669,350.0,350.0,0,0,0.0,0.0,0.0
46657.0,6,10,2032,5,524,11101.25,252.0,104.8,5,1508,10635.5,1236.0,301.6
118113489.0,6,30,1974,15,1026,8421262.857142856,123.0,68.4,15,948,8421260.857142856,123.0,63.2
92113763.0,6,38,2508,19,1254,5105437.666666667,66.0,66.0,19,1254,5105434.888888889,66.0,66.0
116858675.0,6,34,2350,17,1225,7290162.625,139.0,72.05882352941177,17,1125,7290127.375,123.0,66.17647058823529
105534667.0,6,28,1860,14,966,8101434.0,123.0,69.0,14,894,8101434.076923077,123.0,63.85714285714285
128472195.0,17,14,864,7,432,18166834.166666668,174.0,61.71428571428572,7,432,18168302.33333333,174.0,61.71428571428572
108107977.0,17,5,955,5,955,27026994.25,191.0,191.0,0,0,0.0,0.0,0.0
2391.0,17,4,344,2,150,0.0,75.0,75.0,2,194,0.0,103.0,97.0
232989.0,6,3,337,2,214,0.0,160.0,107.0,1,123,0.0,123.0,123.0
2090.0,17,4,344,2,150,0.0,75.0,75.0,2,194,0.0,103.0,97.0
16761.0,6,13,1459,7,862,2152.1666666666665,271.0,123.14285714285714,6,597,2992.4,259.0,99.5
135138532.0,17,6,1146,6,1146,27027706.4,191.0,191.0,0,0,0.0,0.0,0.0
927.0,17,4,438,2,148,0.0,74.0,74.0,2,290,0.0,147.0,145.0
7170359.0,17,4,1376,3,1026,81794.5,342.0,342.0,1,350,0.0,350.0,350.0
228294.0,17,2,180,1,90,0.0,90.0,90.0,1,90,0.0,90.0,90.0
114303956.0,6,48,3168,24,1584,4969737.217391305,66.0,66.0,24,1584,4956307.0869565215,66.0,66.0
318936.0,17,4,1400,4,1400,106312.0,350.0,350.0,0,0,0.0,0.0,0.0
90540974.0,6,13,2036,8,1016,12934424.857142856,188.0,127.0,5,1020,22591138.25,204.0,204.0
108371.0,17,2,286,2,286,0.0,143.0,143.0,0,0,0.0,0.0,0.0
121304309.0,6,222,25196,111,7548,1085850.518181818,140.0,68.0,111,17648,1095294.1545454543,374.0,158.99099099099098
103267.0,17,2,286,2,286,0.0,143.0,143.0,0,0,0.0,0.0,0.0
322098.0,6,6,412,4,272,107366.0,74.0,68.0,2,140,0.0,74.0,70.0
218163.0,6,3,426,2,280,0.0,214.0,140.0,1,146,0.0,146.0,146.0
1317904.0,6,4,264,2,132,0.0,66.0,66.0,2,132,0.0,66.0,66.0
105116095.0,17,15,5130,15,5130,7508292.5,342.0,342.0,0,0,0.0,0.0,0.0
326372.0,6,6,412,4,272,108790.66666666669,74.0,68.0,2,140,0.0,74.0,70.0
2049068.0,17,6,1039,4,312,682887.0,78.0,78.0,2,727,0.0,395.0,363.5
2450.0,17,4,344,2,150,0.0,75.0,75.0,2,194,0.0,103.0,97.0
14646900.0,6,20,1689,10,1057,1592850.888888889,315.0,105.7,10,632,1592823.2222222222,78.0,63.2
512423.0,6,5,336,2,134,0.0,68.0,67.0,3,202,195969.5,70.0,67.33333333333333
102777.0,17,2,286,2,286,0.0,143.0,143.0,0,0,0.0,0.0,0.0
2047.0,17,4,344,2,150,0.0,75.0,75.0,2,194,0.0,103.0,97.0
153426.0,17,2,180,1,90,0.0,90.0,90.0,1,90,0.0,90.0,90.0
108107074.0,17,5,955,5,955,27026768.5,191.0,191.0,0,0,0.0,0.0,0.0
783.0,17,2,762,2,762,0.0,381.0,381.0,0,0,0.0,0.0,0.0
217897.0,6,3,426,2,280,0.0,214.0,140.0,1,146,0.0,146.0,146.0
303714.0,6,2,132,1,66,0.0,66.0,66.0,1,66,0.0,66.0,66.0
45048.0,6,10,2032,5,524,10935.0,252.0,104.8,5,1508,10391.25,1236.0,301.6
2041.0,17,4,344,2,150,0.0,75.0,75.0,2,194,0.0,103.0,97.0
27283994.0,17,5,1710,5,1710,6820998.5,342.0,342.0,0,0,0.0,0.0,0.0
2556505.0,6,25,7573,14,3735,196654.2307692308,1514.0,266.7857142857143,11,3838,230535.3,1514.0,348.90909090909093
120118163.0,6,14,2240,8,1016,17136521.85714286,188.0,127.0,6,1224,18018096.2,204.0,204.0
106562.0,17,2,286,2,286,0.0,143.0,143.0,0,0,0.0,0.0,0.0
5628632.0,6,5,336,2,134,0.0,68.0,67.0,3,202,1526046.5,70.0,67.33333333333333
142058.0,6,2,132,1,66,0.0,66.0,66.0,1,66,0.0,66.0,66.0
23590849.0,6,8,912,5,634,5843629.75,222.0,126.8,3,278,11687211.0,146.0,92.66666666666669
38103.0,6,14,4740,7,653,6235.166666666667,249.0,93.28571428571428,7,4087,5952.166666666667,1514.0,583.8571428571429
108101727.0,17,5,955,5,955,27025431.75,191.0,191.0,0,0,0.0,0.0,0.0
95858.0,6,2,132,1,66,0.0,66.0,66.0,1,66,0.0,66.0,66.0
10480398.0,6,7,478,4,272,3447935.333333333,74.0,68.0,3,206,5171801.0,74.0,68.66666666666667
302932.0,6,6,412,4,272,100977.33333333331,74.0,68.0,2,140,0.0,74.0,70.0
30081.0,6,14,4740,7,653,4771.166666666667,249.0,93.28571428571428,7,4087,4633.166666666667,1514.0,583.8571428571429
150.0,17,2,700,2,700,0.0,350.0,350.0,0,0,0.0,0.0,0.0
18551722.0,6,5,1736,2,819,0.0,753.0,409.5,3,917,9205860.5,785.0,305.6666666666667
104468.0,17,2,762,2,762,0.0,381.0,381.0,0,0,0.0,0.0,0.0
92264315.0,6,24,1870,13,1030,7684808.083333333,95.0,79.23076923076923,11,840,9197945.2,95.0,76.36363636363636
27629.0,6,14,4740,7,653,4433.5,249.0,93.28571428571428,7,4087,4308.666666666667,1514.0,583.8571428571429
92410033.0,6,26,1746,13,906,7682848.166666667,123.0,69.6923076923077,13,840,7682850.583333333,123.0,64.61538461538461
228320.0,17,2,180,1,90,0.0,90.0,90.0,1,90,0.0,90.0,90.0
38198.0,6,14,4740,7,653,5999.833333333333,249.0,93.28571428571428,7,4087,5908.166666666667,1514.0,583.8571428571429
302402.0,6,2,132,1,66,0.0,66.0,66.0,1,66,0.0,66.0,66.0
10453153.0,6,7,478,4,272,3438947.333333333,74.0,68.0,3,206,5158316.0,74.0,68.66666666666667
1019955.0,6,11,1134,6,558,203991.0,220.0,93.0,5,576,253810.5,304.0,115.2
307115.0,6,6,412,4,272,102371.66666666669,74.0,68.0,2,140,0.0,74.0,70.0
146162.0,6,3,337,2,214,0.0,160.0,107.0,1,123,0.0,123.0,123.0
30927.0,6,10,2032,5,524,7529.0,252.0,104.8,5,1508,7445.0,1236.0,301.6
114871220.0,6,34,2350,17,1225,7166672.9375,139.0,72.05882352941177,17,1125,7166679.6875,123.0,66.17647058823529
112294283.0,6,30,1990,15,1042,8005612.0,139.0,69.46666666666667,15,948,8005613.5,123.0,63.2
102244.0,17,2,700,2,700,0.0,350.0,350.0,0,0,0.0,0.0,0.0
313098.0,6,3,1604,2,851,0.0,785.0,425.5,1,753,0.0,753.0,753.0
1771146.0,6,2,132,1,66,0.0,66.0,66.0,1,66,0.0,66.0,66.0
57467.0,6,14,4740,7,653,9283.333333333334,249.0,93.28571428571428,7,4087,7800.333333333333,1514.0,583.8571428571429
8926.0,17,2,582,1,83,0.0,83.0,83.0,1,499,0.0,499.0,499.0
2057.0,17,4,344,2,150,0.0,75.0,75.0,2,194,0.0,103.0,97.0
2214653.0,6,3,1604,1,753,0.0,753.0,753.0,2,851,0.0,785.0,425.5
1166564.0,6,13,3020,8,2392,166652.0,1514.0,299.0,5,628,222777.5,331.0,125.6
102748.0,17,2,286,2,286,0.0,143.0,143.0,0,0,0.0,0.0,0.0
135127473.0,17,6,1146,6,1146,27025494.6,191.0,191.0,0,0,0.0,0.0,0.0
118036985.0,17,13,952,7,563,19672830.83333333,174.0,80.42857142857143,6,389,19650591.4,174.0,64.83333333333333
113144008.0,17,14,864,7,432,18857334.666666668,174.0,61.71428571428572,7,432,18810679.33333333,174.0,61.71428571428572
10440207.0,6,7,478,4,272,3434839.0,74.0,68.0,3,206,5152165.0,74.0,68.66666666666667
49324.0,6,11,2098,6,590,9526.6,252.0,98.33333333333331,5,1508,9733.0,1236.0,301.6
28015213.0,17,5,1718,4,1368,901893.6666666666,342.0,342.0,1,350,0.0,350.0,350.0
756.0,17,4,438,2,148,0.0,74.0,74.0,2,290,0.0,147.0,145.0
208649.0,6,10,1221,6,636,41729.8,298.0,106.0,4,585,68400.66666666667,379.0,146.25
100520754.0,17,12,516,6,258,20000168.0,43.0,43.0,6,258,20000630.6,43.0,43.0
1040372.0,6,11,1134,6,558,208074.4,220.0,93.0,5,576,254773.25,304.0,115.2
119608983.0,6,214,24202,107,16844,1126356.2641509434,284.0,157.42056074766356,107,7358,1126356.6037735848,140.0,68.76635514018692
2289.0,17,4,344,2,150,0.0,75.0,75.0,2,194,0.0,103.0,97.0
124724112.0,17,14,864,7,432,17500189.666666668,174.0,61.71428571428572,7,432,17501650.333333332,174.0,61.71428571428572
452777.0,6,4,492,2,280,0.0,214.0,140.0,2,212,0.0,146.0,106.0
2427.0,17,4,344,2,150,0.0,75.0,75.0,2,194,0.0,103.0,97.0
100294.0,17,2,762,2,762,0.0,381.0,381.0,0,0,0.0,0.0,0.0
41219.0,6,14,4740,7,653,5899.333333333333,249.0,93.28571428571428,7,4087,6363.666666666667,1514.0,583.8571428571429
15838.999999999998,6,14,4740,7,653,2364.6666666666665,249.0,93.28571428571428,7,4087,2237.6666666666665,1514.0,583.8571428571429
2463.0,17,4,344,2,150,0.0,75.0,75.0,2,194,0.0,103.0,97.0
207924.0,6,4,504,3,358,103962.0,214.0,119.33333333333331,1,146,0.0,146.0,146.0
19111.0,6,10,1067,5,536,4581.25,264.0,107.2,5,531,3617.25,259.0,106.2
302749.0,6,6,412,4,272,100916.33333333331,74.0,68.0,2,140,0.0,74.0,70.0
90206673.0,6,16,1192,8,596,12852065.142857144,95.0,74.5,8,596,12857301.0,95.0,74.5
24130.0,6,10,2032,5,524,5782.75,252.0,104.8,5,1508,5601.0,1236.0,301.6
234036.0,6,3,337,2,214,0.0,160.0,107.0,1,123,0.0,123.0,123.0
10482172.0,6,7,478,4,272,3448447.6666666665,74.0,68.0,3,206,5172557.0,74.0,68.66666666666667
432802.0,6,2,145,2,145,0.0,91.0,72.5,0,0,0.0,0.0,0.0
116005789.0,17,13,821,7,432,19334298.166666668,174.0,61.71428571428572,6,389,19200203.8,174.0,64.83333333333333
3327.0,17,4,344,2,150,0.0,75.0,75.0,2,194,0.0,103.0,97.0
647.0,17,2,762,2,762,0.0,381.0,381.0,0,0,0.0,0.0,0.0
113168302.0,6,46,3036,23,1518,5144002.227272728,66.0,66.0,23,1518,5144001.318181818,66.0,66.0
67747.0,6,12,1328,7,797,11291.166666666666,253.0,113.85714285714286,5,531,13232.75,259.0,106.2
120117290.0,6,12,1832,8,1016,17136270.14285714,188.0,127.0,4,816,30031102.0,204.0,204.0
38391.0,6,14,4740,7,653,6225.333333333333,249.0,93.28571428571428,7,4087,6264.5,1514.0,583.8571428571429
17460242.0,6,22,7083,13,1707,1455020.1666666667,408.0,131.30769230769232,9,5376,1667189.0,1514.0,597.3333333333334
25870.0,6,14,4740,7,653,3813.5,249.0,93.28571428571428,7,4087,3606.6666666666665,1514.0,583.8571428571429
1308208.0,17,7,490,7,490,218034.66666666663,70.0,70.0,0,0,0.0,0.0,0.0
220752.0,6,3,426,2,280,0.0,214.0,140.0,1,146,0.0,146.0,146.0
1024328.0,6,11,1134,6,558,204865.6,220.0,93.0,5,576,255193.5,304.0,115.2
108108826.0,17,5,1005,5,1005,27027206.5,201.0,201.0,0,0,0.0,0.0,0.0
24528.0,6,14,4740,7,653,3963.1666666666665,249.0,93.28571428571428,7,4087,3942.5,1514.0,583.8571428571429
113733726.0,6,46,3036,23,1518,5155436.5,66.0,66.0,23,1518,5155438.090909091,66.0,66.0
57786.0,6,12,1320,6,723,10179.0,253.0,120.5,6,597,10245.4,259.0,99.5
58730.0,6,14,4740,7,653,9661.666666666666,249.0,93.28571428571428,7,4087,9648.666666666666,1514.0,583.8571428571429
124332060.0,17,14,864,7,432,17501033.666666668,174.0,61.71428571428572,7,432,20019408.33333333,174.0,61.71428571428572
90300244.0,6,16,1192,8,596,12893609.42857143,95.0,74.5,8,596,12899440.0,95.0,74.5
37970.0,6,14,4740,7,653,6197.0,249.0,93.28571428571428,7,4087,6165.166666666667,1514.0,583.8571428571429
2547.0,17,4,344,2,150,0.0,75.0,75.0,2,194,0.0,103.0,97.0
209578.0,17,2,180,1,90,0.0,90.0,90.0,1,90,0.0,90.0,90.0
90286330.0,6,14,2240,8,1016,12898047.142857144,188.0,127.0,6,1224,18023284.2,204.0,204.0
143921.0,17,2,180,1,90,0.0,90.0,90.0,1,90,0.0,90.0,90.0
793.0,17,4,438,2,148,0.0,74.0,74.0,2,290,0.0,147.0,145.0
186454.0,17,2,180,1,90,0.0,90.0,90.0,1,90,0.0,90.0,90.0
90018576.0,17,28,13364,28,13364,3334021.333333333,501.0,477.2857142857143,0,0,0.0,0.0,0.0
2370.0,17,4,344,2,150,0.0,75.0,75.0,2,194,0.0,103.0,97.0
306747.0,6,6,412,4,272,102249.0,74.0,68.0,2,140,0.0,74.0,70.0
512354.0,6,5,336,2,134,0.0,68.0,67.0,3,202,193801.0,70.0,67.33333333333333
115483221.0,6,223,25252,112,7614,1040389.3783783783,140.0,67.98214285714286,111,17638,1047155.9545454546,300.0,158.9009009009009
32522.000000000004,6,10,2032,5,524,6582.75,252.0,104.8,5,1508,7821.0,1236.0,301.6
2091.0,17,4,344,2,150,0.0,75.0,75.0,2,194,0.0,103.0,97.0
40781.0,6,10,2032,5,524,9910.5,252.0,104.8,5,1508,8487.5,1236.0,301.6
243887.0,6,3,337,2,214,0.0,160.0,107.0,1,123,0.0,123.0,123.0
31677.0,6,14,4740,7,653,5084.666666666667,249.0,93.28571428571428,7,4087,4563.5,1514.0,583.8571428571429
113614491.0,6,46,3036,23,1518,5150441.545454546,66.0,66.0,23,1518,5150441.863636363,66.0,66.0
41403.0,6,14,4740,7,653,6310.833333333333,249.0,93.28571428571428,7,4087,5143.666666666667,1514.0,583.8571428571429
101108458.0,17,14,864,7,432,16834732.166666668,174.0,61.71428571428572,7,432,16833553.166666668,174.0,61.71428571428572
2611.0,17,2,762,2,762,0.0,381.0,381.0,0,0,0.0,0.0,0.0
90098512.0,6,11,1644,4,816,30031900.666666668,204.0,204.0,7,828,15016234.5,188.0,118.28571428571428
248624.0,17,4,6056,4,6056,82874.66666666667,1514.0,1514.0,0,0,0.0,0.0,0.0
317158.0,17,4,1400,4,1400,105719.33333333331,350.0,350.0,0,0,0.0,0.0,0.0
28888.0,6,14,4740,7,653,4693.333333333333,249.0,93.28571428571428,7,4087,3421.833333333333,1514.0,583.8571428571429
90053160.0,17,28,13364,28,13364,3335302.222222222,501.0,477.2857142857143,0,0,0.0,0.0,0.0
358.0,17,2,166,1,75,0.0,75.0,75.0,1,91,0.0,91.0,91.0
100338.0,17,2,762,2,762,0.0,381.0,381.0,0,0,0.0,0.0,0.0
153515.0,17,2,180,1,90,0.0,90.0,90.0,1,90,0.0,90.0,90.0
109589.0,17,2,286,2,286,0.0,143.0,143.0,0,0,0.0,0.0,0.0
217717.0,6,3,426,2,280,0.0,214.0,140.0,1,146,0.0,146.0,146.0
42971.0,6,10,2032,5,524,10447.5,252.0,104.8,5,1508,9000.75,1236.0,301.6
301510.0,6,6,412,4,272,100503.33333333331,74.0,68.0,2,140,0.0,74.0,70.0
330357.0,6,3,204,2,136,0.0,70.0,68.0,1,68,0.0,68.0,68.0
46157.0,6,14,4740,7,653,7106.333333333333,249.0,93.28571428571428,7,4087,5221.333333333333,1514.0,583.8571428571429
97818.0,17,2,286,2,286,0.0,143.0,143.0,0,0,0.0,0.0,0.0
146691.0,6,3,337,2,214,0.0,160.0,107.0,1,123,0.0,123.0,123.0
25600.0,6,14,4740,7,653,4145.5,249.0,93.28571428571428,7,4087,4129.166666666667,1514.0,583.8571428571429
17736.0,6,11,2098,6,590,3496.2,252.0,98.33333333333331,5,1508,4103.75,1236.0,301.6
21924.0,17,2,582,1,83,0.0,83.0,83.0,1,499,0.0,499.0,499.0
312192.0,6,6,412,4,272,104064.0,74.0,68.0,2,140,0.0,74.0,70.0
474.0,17,2,508,2,508,0.0,257.0,254.0,0,0,0.0,0.0,0.0
2795190.0,6,2,132,1,66,0.0,66.0,66.0,1,66,0.0,66.0,66.0
207493.0,6,3,426,2,280,0.0,214.0,140.0,1,146,0.0,146.0,146.0
444130.0,6,11,1021,6,444,60119.2,162.0,74.0,5,577,74930.5,349.0,115.4
4646.0,17,2,614,1,72,0.0,72.0,72.0,1,542,0.0,542.0,542.0
119318946.0,6,48,3168,24,1584,5187780.260869565,66.0,66.0,24,1584,5178381.739130435,66.0,66.0
153550.0,17,2,180,1,90,0.0,90.0,90.0,1,90,0.0,90.0,90.0
303623.0,6,2,132,1,66,0.0,66.0,66.0,1,66,0.0,66.0,66.0
314.0,17,2,174,1,79,0.0,79.0,79.0,1,95,0.0,95.0,95.0
14291.0,17,2,180,1,90,0.0,90.0,90.0,1,90,0.0,90.0,90.0
196855.0,17,2,180,1,90,0.0,90.0,90.0,1,90,0.0,90.0,90.0
14641033.0,6,20,1607,10,975,1592466.6666666667,315.0,97.5,10,632,1592446.2222222222,78.0,63.2
264308.0,6,10,1221,6,636,52861.6,298.0,106.0,4,585,82634.66666666667,379.0,146.25
60062.0,6,14,4740,7,653,9219.5,249.0,93.28571428571428,7,4087,8988.166666666666,1514.0,583.8571428571429
241020.0,6,3,337,2,214,0.0,160.0,107.0,1,123,0.0,123.0,123.0
108099670.0,17,5,955,5,955,27024917.5,191.0,191.0,0,0,0.0,0.0,0.0
103375.0,17,2,762,2,762,0.0,381.0,381.0,0,0,0.0,0.0,0.0
31881.0,6,10,2032,5,524,7647.75,252.0,104.8,5,1508,7566.0,1236.0,301.6
235926.0,6,3,373,2,238,0.0,172.0,119.0,1,135,0.0,135.0,135.0
303558.0,6,12,1373,7,714,50593.0,298.0,102.0,5,659,71165.75,379.0,131.8
2532353.0,6,20,6655,11,1672,253235.3,505.0,152.0,9,4983,278734.5,1510.0,553.6666666666666
108098677.0,17,5,955,5,955,27024669.25,191.0,191.0,0,0,0.0,0.0,0.0
101180043.0,6,65,8562,38,3797,2734595.756756757,268.0,99.92105263157896,27,4765,2926273.423076923,590.0,176.4814814814815
90297442.0,6,16,1192,8,596,12893302.57142857,95.0,74.5,8,596,12898886.285714284,95.0,74.5
2643135.0,6,3,1777,2,951,0.0,885.0,475.5,1,826,0.0,826.0,826.0
104539.0,17,2,286,2,286,0.0,143.0,143.0,0,0,0.0,0.0,0.0
322688.0,17,4,1400,4,1400,107562.66666666669,350.0,350.0,0,0,0.0,0.0,0.0
108104753.0,17,5,1005,5,1005,27026188.25,201.0,201.0,0,0,0.0,0.0,0.0
331.0,17,2,208,1,72,0.0,72.0,72.0,1,136,0.0,136.0,136.0
863675.0,6,9,1270,6,799,172735.0,461.0,133.16666666666666,3,471,293745.0,331.0,157.0
219228.0,17,2,180,1,90,0.0,90.0,90.0,1,90,0.0,90.0,90.0
99535052.0,6,27,1816,14,894,7656542.461538462,123.0,63.85714285714285,13,922,8092173.5,139.0,70.92307692307692
14634987.0,6,19,1551,9,919,1791904.75,315.0,102.11111111111111,10,632,1592731.888888889,78.0,63.2
3181776.0,6,3,1777,2,951,0.0,885.0,475.5,1,826,0.0,826.0,826.0
215141.0,6,10,1221,6,636,43028.2,298.0,106.0,4,585,70465.66666666667,379.0,146.25
112240908.0,6,37,2804,19,1487,6223612.944444444,139.0,78.26315789473684,18,1317,6589707.823529412,123.0,73.16666666666667
303811.0,6,6,412,4,272,101270.33333333331,74.0,68.0,2,140,0.0,74.0,70.0
1388271.0,17,16,1120,16,1120,92551.4,70.0,70.0,0,0,0.0,0.0,0.0
78.0,17,2,762,2,762,0.0,381.0,381.0,0,0,0.0,0.0,0.0
123057.0,6,3,337,2,214,0.0,160.0,107.0,1,123,0.0,123.0,123.0
115218400.0,6,47,3102,24,1584,5009481.826086956,66.0,66.0,23,1518,5112000.363636363,66.0,66.0
242130.0,6,3,337,2,214,0.0,160.0,107.0,1,123,0.0,123.0,123.0
90029080.0,17,28,13364,28,13364,3334410.3703703703,501.0,477.2857142857143,0,0,0.0,0.0,0.0
299179.0,6,6,412,4,272,99726.33333333331,74.0,68.0,2,140,0.0,74.0,70.0
120088202.0,6,262,29890,131,8942,917902.7923076923,140.0,68.25954198473282,131,20948,918318.6384615384,374.0,159.9083969465649
90050937.0,17,28,13364,28,13364,3335219.888888889,501.0,477.2857142857143,0,0,0.0,0.0,0.0
272913.0,17,2,180,1,90,0.0,90.0,90.0,1,90,0.0,90.0,90.0
28155.0,6,14,4740,7,653,4457.333333333333,249.0,93.28571428571428,7,4087,4469.333333333333,1514.0,583.8571428571429
108124633.0,17,5,955,5,955,27031158.25,191.0,191.0,0,0,0.0,0.0,0.0
108103179.0,17,5,1005,5,1005,27025794.75,201.0,201.0,0,0,0.0,0.0,0.0
970243.0,17,10,3744,10,3744,107804.77777777778,390.0,374.4,0,0,0.0,0.0,0.0
215462.0,17,2,180,1,90,0.0,90.0,90.0,1,90,0.0,90.0,90.0
90209361.0,6,21,1585,10,745,9996778.333333334,95.0,74.5,11,840,9000440.4,95.0,76.36363636363636
141779.0,6,2,132,1,66,0.0,66.0,66.0,1,66,0.0,66.0,66.0
2268.0,17,4,344,2,150,0.0,75.0,75.0,2,194,0.0,103.0,97.0
103407.0,17,2,286,2,286,0.0,143.0,143.0,0,0,0.0,0.0,0.0
90058033.0,17,27,12943,27,12943,3463770.5,501.0,479.3703703703704,0,0,0.0,0.0,0.0
305557.0,6,3,202,2,128,0.0,74.0,64.0,1,74,0.0,74.0,74.0
21902.0,17,2,180,1,90,0.0,90.0,90.0,1,90,0.0,90.0,90.0
22658.0,6,10,2032,5,524,5041.25,252.0,104.8,5,1508,5406.0,1236.0,301.6
90099310.0,6,11,1644,4,816,30031846.0,204.0,204.0,7,828,15016167.0,188.0,118.28571428571428
53419.0,6,14,4740,7,653,8780.166666666666,249.0,93.28571428571428,7,4087,8124.166666666667,1514.0,583.8571428571429
295694.0,6,6,412,4,272,98564.66666666669,74.0,68.0,2,140,0.0,74.0,70.0
12645.0,17,2,582,1,83,0.0,83.0,83.0,1,499,0.0,499.0,499.0
845972.0,6,9,1096,6,625,169194.4,287.0,104.16666666666669,3,471,286607.5,331.0,157.0
90263262.0,6,12,1832,8,1016,12894751.714285716,188.0,127.0,4,816,30030868.33333333,204.0,204.0
108101946.0,17,5,1005,5,1005,27025486.5,201.0,201.0,0,0,0.0,0.0,0.0
299382.0,6,6,412,4,272,99794.0,74.0,68.0,2,140,0.0,74.0,70.0
90257942.0,6,13,2036,8,1016,12893991.714285716,188.0,127.0,5,1020,22523520.0,204.0,204.0
2601433.0,6,2,132,1,66,0.0,66.0,66.0,1,66,0.0,66.0,66.0
98791812.0,6,30,2185,15,1017,7022584.928571428,123.0,67.8,15,1168,6507490.142857143,139.0,77.86666666666666
205257.0,17,2,762,2,762,0.0,381.0,381.0,0,0,0.0,0.0,0.0
340315.0,17,2,582,1,83,0.0,83.0,83.0,1,499,0.0,499.0,499.0
120147347.0,6,240,26960,120,8216,1006393.9159663866,140.0,68.46666666666667,120,18744,1002731.4957983192,284.0,156.2
42134.0,6,14,4740,7,653,6532.5,249.0,93.28571428571428,7,4087,6886.5,1514.0,583.8571428571429
26137.0,17,2,180,1,90,0.0,90.0,90.0,1,90,0.0,90.0,90.0
26308.0,6,10,2032,5,524,6365.5,252.0,104.8,5,1508,6258.0,1236.0,301.6
103082.0,17,2,286,2,286,0.0,143.0,143.0,0,0,0.0,0.0,0.0
5027.0,17,4,344,2,150,0.0,75.0,75.0,2,194,0.0,103.0,97.0
2383261.0,6,48,23662,25,19797,99302.54166666669,1514.0,791.88,23,3865,98160.72727272728,1514.0,168.04347826086956
323.0,17,2,164,1,82,0.0,82.0,82.0,1,82,0.0,82.0,82.0
120126383.0,6,14,2240,6,1224,24025276.6,204.0,204.0,8,1016,17137424.0,188.0,127.0
38266.0,6,14,4740,7,653,6096.0,249.0,93.28571428571428,7,4087,6187.0,1514.0,583.8571428571429
108106334.0,17,5,955,5,955,27026583.5,191.0,191.0,0,0,0.0,0.0,0.0
108101279.0,17,5,955,5,955,27025319.75,191.0,191.0,0,0,0.0,0.0,0.0
2012.0,17,4,344,2,150,0.0,75.0,75.0,2,194,0.0,103.0,97.0
107805.0,17,2,286,2,286,0.0,143.0,143.0,0,0,0.0,0.0,0.0
197284.0,17,2,180,1,90,0.0,90.0,90.0,1,90,0.0,90.0,90.0
90529936.0,6,14,2240,8,1016,12932848.0,188.0,127.0,6,1224,18073261.2,204.0,204.0
90042988.0,17,28,13364,28,13364,3334925.4814814813,501.0,477.2857142857143,0,0,0.0,0.0,0.0
9744.0,6,11,2098,6,590,1755.4,252.0,98.33333333333331,5,1508,2142.25,1236.0,301.6
10454845.0,6,6,412,3,206,5159543.0,74.0,68.66666666666667,3,206,5159452.0,74.0,68.66666666666667
196859.0,17,2,180,1,90,0.0,90.0,90.0,1,90,0.0,90.0,90.0
2835824.0,6,11,2106,6,598,566971.6,252.0,99.66666666666669,5,1508,1864.0,1236.0,301.6
10484173.0,6,6,412,3,206,5173669.5,74.0,68.66666666666667,3,206,5173584.5,74.0,68.66666666666667
298101.0,17,2,246,1,76,0.0,76.0,76.0,1,170,0.0,170.0,170.0
90523437.0,6,13,2036,8,1016,12931919.57142857,188.0,127.0,5,1020,22590035.0,204.0,204.0
23230.0,6,14,4740,7,653,3524.833333333333,249.0,93.28571428571428,7,4087,3737.3333333333335,1514.0,583.8571428571429
2396.0,17,4,344,2,150,0.0,75.0,75.0,2,194,0.0,103.0,97.0
146618.0,6,3,373,2,238,0.0,172.0,119.0,1,135,0.0,135.0,135.0
171678.0,17,2,180,1,90,0.0,90.0,90.0,1,90,0.0,90.0,90.0
82864422.0,17,15,5138,14,4788,5882209.615384615,342.0,342.0,1,350,0.0,350.0,350.0
90769443.0,6,20,1531,11,840,9072174.0,95.0,76.36363636363636,9,691,11285214.25,95.0,76.77777777777777
120245717.0,6,226,25534,113,7754,1069412.6785714286,140.0,68.61946902654867,113,17780,1066342.9017857143,284.0,157.34513274336285
207160.0,6,3,426,2,280,0.0,214.0,140.0,1,146,0.0,146.0,146.0
176642.0,17,4,704,2,148,0.0,74.0,74.0,2,556,0.0,280.0,278.0
33805.0,6,14,4740,7,653,5451.5,249.0,93.28571428571428,7,4087,5415.166666666667,1514.0,583.8571428571429
24425.0,6,10,2032,5,524,5533.75,252.0,104.8,5,1508,5830.0,1236.0,301.6
208235.0,6,3,426,2,280,0.0,214.0,140.0,1,146,0.0,146.0,146.0
1101745.0,6,11,1134,6,558,220349.0,220.0,93.0,5,576,274378.75,304.0,115.2
57372.0,6,10,2032,5,524,14135.5,252.0,104.8,5,1508,14048.5,1236.0,301.6
16059.0,6,14,4740,7,653,2512.333333333333,249.0,93.28571428571428,7,4087,2483.0,1514.0,583.8571428571429
105031.0,17,2,700,2,700,0.0,350.0,350.0,0,0,0.0,0.0,0.0
828.0,17,4,438,2,148,0.0,74.0,74.0,2,290,0.0,147.0,145.0
114449207.0,6,30,2128,16,1165,7629947.133333334,139.0,72.8125,14,963,7251888.0,123.0,68.78571428571429
318309.0,6,6,412,4,272,106103.0,74.0,68.0,2,140,0.0,74.0,70.0
284865.0,17,2,363,1,79,0.0,79.0,79.0,1,284,0.0,284.0,284.0
261160.0,6,3,337,2,214,0.0,160.0,107.0,1,123,0.0,123.0,123.0
357130.0,17,4,704,2,148,0.0,74.0,74.0,2,556,0.0,280.0,278.0
120000975.0,17,15,1169,8,606,17142996.42857143,174.0,75.75,7,563,16668504.666666666,174.0,80.42857142857143
135130626.0,17,6,1206,6,1206,27026125.2,201.0,201.0,0,0,0.0,0.0,0.0
92517996.0,6,29,3108,14,1551,7100966.692307692,361.0,110.78571428571428,15,1557,6593759.071428572,426.0,103.8
277172.0,6,6,386,4,247,92390.66666666669,85.0,61.75,2,139,0.0,85.0,69.5
33405.0,6,14,4740,7,653,3128.5,249.0,93.28571428571428,7,4087,5436.666666666667,1514.0,583.8571428571429
117018650.0,6,231,26060,116,7952,1017553.4782608696,140.0,68.55172413793103,115,18108,1017482.4736842106,284.0,157.4608695652174
25966.0,6,10,2032,5,524,5340.0,252.0,104.8,5,1508,5867.25,1236.0,301.6
99218231.0,17,14,1126,7,563,16500123.5,174.0,80.42857142857143,7,563,16501046.0,174.0,80.42857142857143
318344.0,17,4,1400,4,1400,106114.66666666669,350.0,350.0,0,0,0.0,0.0,0.0
108056081.0,17,5,1005,5,1005,27014020.25,201.0,201.0,0,0,0.0,0.0,0.0
91162048.0,6,25,1924,11,840,9116204.8,95.0,76.36363636363636,14,1084,6991307.538461538,95.0,77.42857142857143
12777.0,6,10,2032,5,524,2937.25,252.0,104.8,5,1508,2898.0,1236.0,301.6
307377.0,6,6,412,4,272,102459.0,74.0,68.0,2,140,0.0,74.0,70.0
108114358.0,17,5,1005,5,1005,27028589.5,201.0,201.0,0,0,0.0,0.0,0.0
93232977.0,6,39,2574,20,1320,4890960.105263158,66.0,66.0,19,1254,5150433.388888889,66.0,66.0
960930.0,6,12,1354,6,723,191484.2,253.0,120.5,6,631,190858.6,293.0,105.16666666666669
1196192.0,6,13,3010,8,2382,170884.57142857142,1514.0,297.75,5,628,230895.75,331.0,125.6
105604842.0,17,14,864,7,432,17500162.666666668,174.0,61.71428571428572,7,432,17500646.0,174.0,61.71428571428572
157469.0,6,3,337,2,214,0.0,160.0,107.0,1,123,0.0,123.0,123.0
21068230.0,6,6,1981,4,1087,7022743.333333333,885.0,271.75,2,894,0.0,826.0,447.0
36697.0,6,14,4740,7,653,5864.833333333333,249.0,93.28571428571428,7,4087,5870.166666666667,1514.0,583.8571428571429
232260.0,6,3,337,2,214,0.0,160.0,107.0,1,123,0.0,123.0,123.0
41815.0,6,14,4740,7,653,6319.0,249.0,93.28571428571428,7,4087,5055.666666666667,1514.0,583.8571428571429
120479675.0,17,14,864,7,432,16833500.0,174.0,61.71428571428572,7,432,16837894.0,174.0,61.71428571428572
175873.0,6,4,264,2,132,0.0,66.0,66.0,2,132,0.0,66.0,66.0
58718.0,6,12,1328,7,797,9786.333333333334,253.0,113.85714285714286,5,531,11082.75,259.0,106.2
27442439.0,17,5,1710,5,1710,6860609.75,342.0,342.0,0,0,0.0,0.0,0.0
191180.0,17,2,180,1,90,0.0,90.0,90.0,1,90,0.0,90.0,90.0
2427.0,17,4,344,2,150,0.0,75.0,75.0,2,194,0.0,103.0,97.0
35449.0,6,10,2032,5,524,8638.0,252.0,104.8,5,1508,7787.5,1236.0,301.6
92707939.0,6,37,2442,19,1254,5150441.055555556,66.0,66.0,18,1188,5210430.647058823,66.0,66.0
308927.0,6,6,412,4,272,102975.66666666669,74.0,68.0,2,140,0.0,74.0,70.0
2007.0,17,4,344,2,150,0.0,75.0,75.0,2,194,0.0,103.0,97.0
223684.0,6,10,1221,6,636,44736.8,298.0,106.0,4,585,71271.0,379.0,146.25
331522.0,6,6,412,4,272,110507.33333333331,74.0,68.0,2,140,0.0,74.0,70.0
108101697.0,17,5,955,5,955,27025424.25,191.0,191.0,0,0,0.0,0.0,0.0
17137.0,6,10,2032,5,524,3908.5,252.0,104.8,5,1508,3584.0,1236.0,301.6
1028606.0,6,11,1134,6,558,205721.2,220.0,93.0,5,576,255330.25,304.0,115.2
17944.0,6,10,1067,5,536,4224.75,264.0,107.2,5,531,3115.0,259.0,106.2
285387.0,17,4,704,2,148,0.0,74.0,74.0,2,556,0.0,280.0,278.0
119853296.0,6,15,2306,6,1224,23969879.0,204.0,204.0,9,1082,14981481.125,188.0,120.22222222222224
120244329.0,6,210,23758,105,7226,1148251.4038461538,140.0,68.81904761904762,105,16532,1148190.6346153845,284.0,157.44761904761904
73910.0,6,10,2032,5,524,15379.0,252.0,104.8,5,1508,15324.75,1236.0,301.6
108105638.0,17,5,955,5,955,27026409.5,191.0,191.0,0,0,0.0,0.0,0.0
303278.0,6,6,412,4,272,101092.66666666669,74.0,68.0,2,140,0.0,74.0,70.0
1077600.0,6,13,1386,7,789,179600.0,253.0,112.71428571428572,6,597,214514.6,259.0,99.5
1164198.0,6,13,3010,8,2382,166314.0,1514.0,297.75,5,628,222141.75,331.0,125.6
1316350.0,6,4,264,2,132,0.0,66.0,66.0,2,132,0.0,66.0,66.0
29752.0,6,10,2032,5,524,7198.0,252.0,104.8,5,1508,7054.0,1236.0,301.6
36215.0,6,14,4740,7,653,5904.0,249.0,93.28571428571428,7,4087,5898.833333333333,1514.0,583.8571428571429
92096560.0,6,174,19682,87,13792,1068387.1162790698,284.0,158.5287356321839,87,5890,1068387.6279069767,140.0,67.70114942528735
143917.0,17,2,180,1,90,0.0,90.0,90.0,1,90,0.0,90.0,90.0
105534955.0,6,20,1490,10,745,11726106.111111112,95.0,74.5,10,745,11698767.111111112,95.0,74.5
2461.0,17,4,344,2,150,0.0,75.0,75.0,2,194,0.0,103.0,97.0
5625717.0,6,5,336,2,134,0.0,68.0,67.0,3,202,1526621.0,70.0,67.33333333333333
33343.0,6,10,2032,5,524,8109.5,252.0,104.8,5,1508,7314.5,1236.0,301.6
106875602.0,6,44,2904,22,1452,5089314.380952381,66.0,66.0,22,1452,5074344.761904762,66.0,66.0
123839934.0,6,49,3234,25,1650,5159997.25,66.0,66.0,24,1584,5179131.0869565215,66.0,66.0
813.0,17,5,550,5,550,203.25,110.0,110.0,0,0,0.0,0.0,0.0
305882.0,6,6,412,4,272,101960.66666666669,74.0,68.0,2,140,0.0,74.0,70.0
1497.0,17,5,550,5,550,374.25,110.0,110.0,0,0,0.0,0.0,0.0
113315688.0,6,30,1974,15,1026,8078567.714285715,123.0,68.4,15,948,8078560.571428572,123.0,63.2
305625.0,6,6,412,4,272,101875.0,74.0,68.0,2,140,0.0,74.0,70.0
300375.0,6,6,412,4,272,100125.0,74.0,68.0,2,140,0.0,74.0,70.0
2901899.0,6,2,132,1,66,0.0,66.0,66.0,1,66,0.0,66.0,66.0
27893.0,6,14,4740,7,653,4437.166666666667,249.0,93.28571428571428,7,4087,4270.666666666667,1514.0,583.8571428571429
4445.0,17,4,344,2,150,0.0,75.0,75.0,2,194,0.0,103.0,97.0
108095517.0,17,5,955,5,955,27023879.25,191.0,191.0,0,0,0.0,0.0,0.0
2120.0,17,4,344,2,150,0.0,75.0,75.0,2,194,0.0,103.0,97.0
222567.0,6,10,1221,6,636,44513.4,298.0,106.0,4,585,73166.0,379.0,146.25
103114.0,17,2,286,2,286,0.0,143.0,143.0,0,0,0.0,0.0,0.0
322069.0,17,4,1400,4,1400,107356.33333333331,350.0,350.0,0,0,0.0,0.0,0.0
0.0,6,1,66,1,66,0.0,66.0,66.0,0,0,0.0,0.0,0.0
30213.0,6,14,4740,7,653,4575.166666666667,249.0,93.28571428571428,7,4087,4845.333333333333,1514.0,583.8571428571429
2135353.0,6,23,4355,12,1447,194123.0,311.0,120.58333333333331,11,2908,191815.4,1514.0,264.3636363636364
108102562.0,17,5,1005,5,1005,27025640.5,201.0,201.0,0,0,0.0,0.0,0.0
51279.0,6,14,4740,7,653,8398.833333333334,249.0,93.28571428571428,7,4087,8326.166666666666,1514.0,583.8571428571429
52615.0,6,14,4740,7,653,8647.833333333334,249.0,93.28571428571428,7,4087,8150.833333333333,1514.0,583.8571428571429
206584.0,6,3,426,2,280,0.0,214.0,140.0,1,146,0.0,146.0,146.0
90665080.0,6,30,3199,15,1601,6476077.142857143,360.0,106.73333333333332,15,1598,6458335.571428572,426.0,106.53333333333332
162378.0,17,2,180,1,90,0.0,90.0,90.0,1,90,0.0,90.0,90.0
304960.0,6,6,412,4,272,101653.33333333331,74.0,68.0,2,140,0.0,74.0,70.0
39034.0,6,14,4740,7,653,5728.166666666667,249.0,93.28571428571428,7,4087,6212.833333333333,1514.0,583.8571428571429
93258152.0,17,12,778,6,389,18651630.4,174.0,64.83333333333333,6,389,18543835.8,174.0,64.83333333333333
37541.0,6,10,2032,5,524,6136.0,252.0,104.8,5,1508,8723.25,1236.0,301.6
147943.0,17,2,180,1,90,0.0,90.0,90.0,1,90,0.0,90.0,90.0
120120180.0,6,13,2020,9,1204,15015022.5,188.0,133.77777777777777,4,816,30029019.33333333,204.0,204.0
792.0,17,4,438,2,148,0.0,74.0,74.0,2,290,0.0,147.0,145.0
162866.0,6,3,337,2,214,0.0,160.0,107.0,1,123,0.0,123.0,123.0
197001.0,17,2,180,1,90,0.0,90.0,90.0,1,90,0.0,90.0,90.0
5617621.0,6,4,270,2,134,0.0,68.0,67.0,2,136,0.0,70.0,68.0
743.0,17,4,438,2,148,0.0,74.0,74.0,2,290,0.0,147.0,145.0
32904.0,6,14,4740,7,653,5305.5,249.0,93.28571428571428,7,4087,5134.166666666667,1514.0,583.8571428571429
7113.0,17,2,582,1,83,0.0,83.0,83.0,1,499,0.0,499.0,499.0
239433.0,6,10,1221,6,636,47886.6,298.0,106.0,4,585,78564.33333333333,379.0,146.25
117775723.0,6,48,3168,24,1584,5120683.608695652,66.0,66.0,24,1584,5111285.347826087,66.0,66.0
108106210.0,17,5,1005,5,1005,27026552.5,201.0,201.0,0,0,0.0,0.0,0.0
246306.0,6,3,337,2,214,0.0,160.0,107.0,1,123,0.0,123.0,123.0
9223.0,17,2,498,1,80,0.0,80.0,80.0,1,418,0.0,418.0,418.0
103250.0,17,2,286,2,286,0.0,143.0,143.0,0,0,0.0,0.0,0.0
3970810.0,6,5,336,2,134,0.0,68.0,67.0,3,202,1535996.5,70.0,67.33333333333333
207109.0,6,3,426,2,280,0.0,214.0,140.0,1,146,0.0,146.0,146.0
153444.0,17,2,180,1,90,0.0,90.0,90.0,1,90,0.0,90.0,90.0
101194148.0,17,14,864,7,432,16667574.5,174.0,61.71428571428572,7,432,16833497.5,174.0,61.71428571428572
3579275.0,6,5,336,2,134,0.0,68.0,67.0,3,202,1424069.5,70.0,67.33333333333333
29037.0,6,10,2032,5,524,6916.75,252.0,104.8,5,1508,6424.0,1236.0,301.6
121784051.0,6,49,4075,27,2266,4684001.961538462,139.0,83.92592592592592,22,1809,5699128.714285715,123.0,82.22727272727273
60297.0,6,14,4740,7,653,9605.166666666666,249.0,93.28571428571428,7,4087,9360.333333333334,1514.0,583.8571428571429
31605.0,6,14,4740,7,653,5124.0,249.0,93.28571428571428,7,4087,5075.0,1514.0,583.8571428571429
108107937.0,17,5,1005,5,1005,27026984.25,201.0,201.0,0,0,0.0,0.0,0.0
103490.0,17,2,286,2,286,0.0,143.0,143.0,0,0,0.0,0.0,0.0
25394.0,6,14,4740,7,653,4101.333333333333,249.0,93.28571428571428,7,4087,4094.6666666666665,1514.0,583.8571428571429
223846.0,17,4,1400,4,1400,74615.33333333333,350.0,350.0,0,0,0.0,0.0,0.0
146467.0,6,3,337,2,214,0.0,160.0,107.0,1,123,0.0,123.0,123.0
228241.0,17,2,180,1,90,0.0,90.0,90.0,1,90,0.0,90.0,90.0
121396.0,6,3,337,2,214,0.0,160.0,107.0,1,123,0.0,123.0,123.0
120480617.0,6,215,24374,108,17016,1125987.074766355,284.0,157.55555555555554,107,7358,1127924.7735849055,140.0,68.76635514018692
1307046.0,6,4,264,2,132,0.0,66.0,66.0,2,132,0.0,66.0,66.0
44545.0,6,14,4740,7,653,6888.833333333333,249.0,93.28571428571428,7,4087,5967.166666666667,1514.0,583.8571428571429
2928642.0,6,12,2172,7,664,487976.5,252.0,94.85714285714286,5,1508,1805.0,1236.0,301.6
204807.0,17,2,762,2,762,0.0,381.0,381.0,0,0,0.0,0.0,0.0
233848.0,6,3,337,2,214,0.0,160.0,107.0,1,123,0.0,123.0,123.0
48864.0,6,14,4740,7,653,7787.333333333333,249.0,93.28571428571428,7,4087,7391.333333333333,1514.0,583.8571428571429
48462.0,6,14,4740,7,653,6935.333333333333,249.0,93.28571428571428,7,4087,7896.333333333333,1514.0,583.8571428571429
196853.0,17,2,180,1,90,0.0,90.0,90.0,1,90,0.0,90.0,90.0
153359.0,17,2,180,1,90,0.0,90.0,90.0,1,90,0.0,90.0,90.0
166752.0,17,2,180,1,90,0.0,90.0,90.0,1,90,0.0,90.0,90.0
188307.0,17,2,180,1,90,0.0,90.0,90.0,1,90,0.0,90.0,90.0
179721.0,17,2,180,1,90,0.0,90.0,90.0,1,90,0.0,90.0,90.0
147909.0,17,2,180,1,90,0.0,90.0,90.0,1,90,0.0,90.0,90.0
108103162.0,17,5,955,5,955,27025790.5,191.0,191.0,0,0,0.0,0.0,0.0
18252.0,6,14,4740,7,653,2907.5,249.0,93.28571428571428,7,4087,2902.833333333333,1514.0,583.8571428571429
0.0,6,1,54,0,0,0.0,0.0,0.0,1,54,0.0,54.0,54.0
2785542.0,6,2,132,1,66,0.0,66.0,66.0,1,66,0.0,66.0,66.0
96918720.0,6,26,1762,13,922,8076560.0,139.0,70.92307692307692,13,840,8058538.75,123.0,64.61538461538461
1497189.0,6,7,499,4,301,434835.0,103.0,75.25,3,198,715779.5,66.0,66.0
107987.0,17,2,286,2,286,0.0,143.0,143.0,0,0,0.0,0.0,0.0
38114.0,6,12,1328,6,731,6494.0,253.0,121.83333333333331,6,597,6983.2,259.0,99.5
34017.0,6,14,4740,7,653,5543.666666666667,249.0,93.28571428571428,7,4087,5272.166666666667,1514.0,583.8571428571429
1162213.0,6,13,3010,8,2382,166030.42857142858,1514.0,297.75,5,628,221662.75,331.0,125.6
40249.0,6,13,1479,7,882,6565.0,291.0,126.0,6,597,5938.0,259.0,99.5
5636906.0,6,5,336,2,134,0.0,68.0,67.0,3,202,1426375.5,70.0,67.33333333333333
206204.0,6,3,426,2,280,0.0,214.0,140.0,1,146,0.0,146.0,146.0
32214.0,6,14,4740,7,653,5206.166666666667,249.0,93.28571428571428,7,4087,5106.333333333333,1514.0,583.8571428571429
240794.0,6,3,337,2,214,0.0,160.0,107.0,1,123,0.0,123.0,123.0
9882.0,17,4,823,2,163,0.0,89.0,81.5,2,660,0.0,443.0,330.0
153448.0,17,2,180,1,90,0.0,90.0,90.0,1,90,0.0,90.0,90.0
24634.0,6,14,4740,7,653,3975.6666666666665,249.0,93.28571428571428,7,4087,3963.8333333333335,1514.0,583.8571428571429
2800603.0,6,2,132,1,66,0.0,66.0,66.0,1,66,0.0,66.0,66.0
2405.0,17,4,344,2,150,0.0,75.0,75.0,2,194,0.0,103.0,97.0
35221.0,6,10,2032,5,524,7429.25,252.0,104.8,5,1508,8434.75,1236.0,301.6
15087.0,6,11,1131,6,600,2803.4,262.0,100.0,5,531,3472.5,259.0,106.2
2780206.0,6,2,132,1,66,0.0,66.0,66.0,1,66,0.0,66.0,66.0
90030925.0,17,28,13364,28,13364,3334478.703703704,501.0,477.2857142857143,0,0,0.0,0.0,0.0
98532.0,17,3,1050,3,1050,49266.0,350.0,350.0,0,0,0.0,0.0,0.0
9464.0,17,2,582,1,83,0.0,83.0,83.0,1,499,0.0,499.0,499.0
123351.0,6,3,337,2,214,0.0,160.0,107.0,1,123,0.0,123.0,123.0
302022.0,6,6,412,4,272,100674.0,74.0,68.0,2,140,0.0,74.0,70.0
4602420.0,6,5,336,2,134,0.0,68.0,67.0,3,202,1526137.5,70.0,67.33333333333333
1877533.0,6,19,7533,10,1403,208614.7777777777,583.0,140.3,9,6130,202705.125,1484.0,681.1111111111111
481352.0,17,2,374,1,73,0.0,73.0,73.0,1,301,0.0,301.0,301.0
1307045.0,6,4,264,2,132,0.0,66.0,66.0,2,132,0.0,66.0,66.0
728.0,17,4,438,2,148,0.0,74.0,74.0,2,290,0.0,147.0,145.0
2307.0,17,4,344,2,150,0.0,75.0,75.0,2,194,0.0,103.0,97.0
2307.0,17,4,344,2,150,0.0,75.0,75.0,2,194,0.0,103.0,97.0
13080087.0,6,26,7627,14,3735,195247.92307692303,1514.0,266.7857142857143,12,3892,1170490.181818182,1514.0,324.3333333333333
5624021.0,6,5,336,2,134,0.0,68.0,67.0,3,202,1410982.0,70.0,67.33333333333333
123855672.0,6,48,3168,24,1584,5115143.434782608,66.0,66.0,24,1584,5187611.347826087,66.0,66.0
905.0,17,4,438,2,148,0.0,74.0,74.0,2,290,0.0,147.0,145.0
110125516.0,6,28,1860,14,966,8454602.076923076,123.0,69.0,14,894,8454598.076923076,123.0,63.85714285714285
1218984.0,6,11,1134,6,558,243796.8,220.0,93.0,5,576,303371.25,304.0,115.2
2806484.0,6,2,132,1,66,0.0,66.0,66.0,1,66,0.0,66.0,66.0
43643.0,6,10,2032,5,524,10678.75,252.0,104.8,5,1508,10618.0,1236.0,301.6
94895766.0,6,26,1746,13,906,7890892.166666667,123.0,69.6923076923077,13,840,7890891.666666667,123.0,64.61538461538461
120122098.0,6,13,2020,9,1204,15015262.25,188.0,133.77777777777777,4,816,30030260.33333333,204.0,204.0
103644255.0,6,44,2904,22,1452,4935440.714285715,66.0,66.0,22,1452,4920467.619047619,66.0,66.0
217530.0,6,3,426,2,280,0.0,214.0,140.0,1,146,0.0,146.0,146.0
117837910.0,6,31,2097,16,1071,7855860.666666667,123.0,66.9375,15,1026,8401453.07142857,123.0,68.4
90280619.0,6,15,1097,8,596,12897231.285714284,95.0,74.5,7,501,14998662.0,95.0,71.57142857142857
108110193.0,17,5,955,5,955,27027548.25,191.0,191.0,0,0,0.0,0.0,0.0
101605.0,17,2,700,2,700,0.0,350.0,350.0,0,0,0.0,0.0,0.0
519.0,17,2,508,2,508,0.0,257.0,254.0,0,0,0.0,0.0,0.0
1973583.0,6,2,132,1,66,0.0,66.0,66.0,1,66,0.0,66.0,66.0
90771446.0,6,21,1585,11,799,9072970.5,95.0,72.63636363636364,10,786,10084517.444444444,95.0,78.6
52181.0,6,14,4740,7,653,8577.5,249.0,93.28571428571428,7,4087,8061.5,1514.0,583.8571428571429
748846.0,6,11,1021,6,444,100137.2,162.0,74.0,5,577,125089.5,349.0,115.4
124006996.0,17,15,907,7,432,17334459.166666668,174.0,61.71428571428572,8,475,17714473.14285714,174.0,59.375
90012970.0,17,28,13364,28,13364,3333813.703703704,501.0,477.2857142857143,0,0,0.0,0.0,0.0
35404.0,6,14,4740,7,653,5784.833333333333,249.0,93.28571428571428,7,4087,5729.0,1514.0,583.8571428571429
107175760.0,17,14,864,7,432,17834147.0,174.0,61.71428571428572,7,432,17833490.5,174.0,61.71428571428572
166486.0,17,2,493,1,88,0.0,88.0,88.0,1,405,0.0,405.0,405.0
228357.0,17,2,180,1,90,0.0,90.0,90.0,1,90,0.0,90.0,90.0
232774.0,6,3,337,2,214,0.0,160.0,107.0,1,123,0.0,123.0,123.0
108100367.0,17,5,1005,5,1005,27025091.75,201.0,201.0,0,0,0.0,0.0,0.0
2797296.0,6,2,132,1,66,0.0,66.0,66.0,1,66,0.0,66.0,66.0
301692.0,6,6,412,4,272,100564.0,74.0,68.0,2,140,0.0,74.0,70.0
578886.0,6,4,508,2,238,0.0,172.0,119.0,2,270,0.0,135.0,135.0
3367.0,17,2,398,1,88,0.0,88.0,88.0,1,310,0.0,310.0,310.0
93408000.0,17,16,5472,16,5472,6227200.0,342.0,342.0,0,0,0.0,0.0,0.0
28140.0,6,20,7606,11,978,2814.0,310.0,88.9090909090909,9,6628,3244.375,1514.0,736.4444444444445
216615.0,17,2,180,1,90,0.0,90.0,90.0,1,90,0.0,90.0,90.0
96910254.0,6,201,22618,101,6888,969102.54,140.0,68.1980198019802,100,15730,975553.7070707072,284.0,157.3
206107.0,6,3,426,2,280,0.0,214.0,140.0,1,146,0.0,146.0,146.0
228152.0,17,2,180,1,90,0.0,90.0,90.0,1,90,0.0,90.0,90.0
143890.0,17,2,180,1,90,0.0,90.0,90.0,1,90,0.0,90.0,90.0
90021970.0,17,27,12943,27,12943,3462383.461538461,501.0,479.3703703703704,0,0,0.0,0.0,0.0
128008102.0,17,15,907,8,475,18286871.71428572,174.0,59.375,7,432,18000157.0,174.0,61.71428571428572
68137.0,6,13,1386,7,789,11324.5,253.0,112.71428571428572,6,597,10771.6,259.0,99.5
113644059.0,6,48,3168,24,1584,4941046.043478261,66.0,66.0,24,1584,4935651.695652174,66.0,66.0
0.0,17,1,90,1,90,0.0,90.0,90.0,0,0,0.0,0.0,0.0
297.0,17,2,156,1,78,0.0,78.0,78.0,1,78,0.0,78.0,78.0
31567.0,6,10,2032,5,524,7642.75,252.0,104.8,5,1508,5625.5,1236.0,301.6
216711.0,17,2,180,1,90,0.0,90.0,90.0,1,90,0.0,90.0,90.0
135136275.0,17,6,1206,6,1206,27027255.0,201.0,201.0,0,0,0.0,0.0,0.0
120133616.0,6,264,30324,132,9008,910696.496183206,140.0,68.24242424242425,132,21316,910634.7251908396,284.0,161.4848484848485
306825.0,6,6,412,4,272,102275.0,74.0,68.0,2,140,0.0,74.0,70.0
1468256.0,17,16,1120,16,1120,97883.73333333334,70.0,70.0,0,0,0.0,0.0,0.0
252658.0,6,3,373,2,238,0.0,172.0,119.0,1,135,0.0,135.0,135.0
10510202.0,6,7,478,4,272,3456200.6666666665,74.0,68.0,3,206,5184216.5,74.0,68.66666666666667
115612.0,17,2,286,2,286,0.0,143.0,143.0,0,0,0.0,0.0,0.0
146201.0,6,3,337,2,214,0.0,160.0,107.0,1,123,0.0,123.0,123.0
200575.0,17,4,6056,4,6056,66858.33333333333,1514.0,1514.0,0,0,0.0,0.0,0.0
13619002.0,6,20,1607,10,975,1478666.2222222222,315.0,97.5,10,632,1478632.111111111,78.0,63.2
2451712.0,6,3,204,1,68,0.0,68.0,68.0,2,136,0.0,70.0,68.0
111125.0,17,2,286,2,286,0.0,143.0,143.0,0,0,0.0,0.0,0.0
2253.0,17,4,344,2,150,0.0,75.0,75.0,2,194,0.0,103.0,97.0
326.0,17,2,160,1,80,0.0,80.0,80.0,1,80,0.0,80.0,80.0
197098.0,17,2,180,1,90,0.0,90.0,90.0,1,90,0.0,90.0,90.0
14450.0,6,12,1393,6,796,2614.0,271.0,132.66666666666666,6,597,2633.6,259.0,99.5
212653.0,17,2,180,1,90,0.0,90.0,90.0,1,90,0.0,90.0,90.0
56150.0,6,10,2032,5,524,13797.5,252.0,104.8,5,1508,13547.5,1236.0,301.6
437482.0,6,11,1021,6,444,59253.0,162.0,74.0,5,577,73253.75,349.0,115.4
40555.0,6,11,1132,6,556,8012.8,218.0,92.66666666666669,5,576,7190.75,304.0,115.2
105053587.0,6,44,2904,22,1452,5002551.761904762,66.0,66.0,22,1452,4988083.571428572,66.0,66.0
312821.0,6,6,412,4,272,104273.66666666669,74.0,68.0,2,140,0.0,74.0,70.0
228451.0,17,2,180,1,90,0.0,90.0,90.0,1,90,0.0,90.0,90.0
232937.0,6,3,337,2,214,0.0,160.0,107.0,1,123,0.0,123.0,123.0
206255.0,6,3,426,2,280,0.0,214.0,140.0,1,146,0.0,146.0,146.0
40122.0,6,14,4740,7,653,6579.666666666667,249.0,93.28571428571428,7,4087,6416.833333333333,1514.0,583.8571428571429
218439.0,6,3,426,2,280,0.0,214.0,140.0,1,146,0.0,146.0,146.0
90052665.0,17,28,13364,28,13364,3335283.888888889,501.0,477.2857142857143,0,0,0.0,0.0,0.0
90671018.0,6,21,1585,10,745,10074557.555555556,95.0,74.5,11,840,9042185.7,95.0,76.36363636363636
27190931.0,17,5,1710,5,1710,6797732.75,342.0,342.0,0,0,0.0,0.0,0.0
90008345.0,17,28,13364,28,13364,3333642.407407407,501.0,477.2857142857143,0,0,0.0,0.0,0.0
159874.0,6,3,337,2,214,0.0,160.0,107.0,1,123,0.0,123.0,123.0
301568.0,6,6,412,4,272,100522.66666666669,74.0,68.0,2,140,0.0,74.0,70.0
285015.0,17,2,363,1,79,0.0,79.0,79.0,1,284,0.0,284.0,284.0
249322.0,6,3,337,2,214,0.0,160.0,107.0,1,123,0.0,123.0,123.0
206224.0,6,3,426,2,280,0.0,214.0,140.0,1,146,0.0,146.0,146.0
40699.0,6,10,2032,5,524,7332.75,252.0,104.8,5,1508,9216.5,1236.0,301.6
90255620.0,6,12,1832,8,1016,12893660.0,188.0,127.0,4,816,30030905.33333333,204.0,204.0
42991.0,6,14,4740,7,653,6789.833333333333,249.0,93.28571428571428,7,4087,6784.333333333333,1514.0,583.8571428571429
107143.0,17,2,286,2,286,0.0,143.0,143.0,0,0,0.0,0.0,0.0
103001274.0,17,13,821,7,432,17166879.0,174.0,61.71428571428572,6,389,16801546.2,174.0,64.83333333333333
236907.0,6,3,373,2,238,0.0,172.0,119.0,1,135,0.0,135.0,135.0
242562.0,6,13,1386,7,789,40427.0,253.0,112.71428571428572,6,597,44719.0,259.0,99.5
90365862.0,6,11,1644,7,828,15060977.0,188.0,118.28571428571428,4,816,20111705.666666668,204.0,204.0
90033192.0,17,28,13364,28,13364,3334562.6666666665,501.0,477.2857142857143,0,0,0.0,0.0,0.0
48494.0,6,10,2032,5,524,10055.75,252.0,104.8,5,1508,11731.25,1236.0,301.6
109193979.0,17,16,1474,8,737,15576437.285714284,174.0,92.125,8,737,15576437.285714284,174.0,92.125
102452994.0,17,15,1169,8,606,14613270.0,174.0,75.75,7,563,17010731.666666668,174.0,80.42857142857143
89428.0,6,14,4740,7,653,14339.333333333334,249.0,93.28571428571428,7,4087,14764.0,1514.0,583.8571428571429
116406639.0,6,34,2334,17,1209,7261260.1875,123.0,71.11764705882354,17,1125,7261927.75,123.0,66.17647058823529
20793.0,6,14,4740,7,653,3262.1666666666665,249.0,93.28571428571428,7,4087,3301.6666666666665,1514.0,583.8571428571429
197851.0,17,2,180,1,90,0.0,90.0,90.0,1,90,0.0,90.0,90.0
16303.999999999998,6,11,1132,6,556,3260.8,218.0,92.66666666666669,5,576,3182.25,304.0,115.2
145123.0,17,2,180,1,70,0.0,70.0,70.0,1,110,0.0,110.0,110.0
143899.0,17,2,180,1,90,0.0,90.0,90.0,1,90,0.0,90.0,90.0
107827950.0,6,28,1860,14,966,8294457.692307692,123.0,69.0,14,894,8277831.0,123.0,63.85714285714285
104881604.0,17,14,864,7,432,17334229.0,174.0,61.71428571428572,7,432,17333545.0,174.0,61.71428571428572
228363.0,17,2,180,1,90,0.0,90.0,90.0,1,90,0.0,90.0,90.0
90060915.0,17,28,13364,28,13364,3335589.4444444445,501.0,477.2857142857143,0,0,0.0,0.0,0.0
90529424.0,6,15,2168,8,1016,12932774.857142856,188.0,127.0,7,1152,15060922.333333334,204.0,164.57142857142858
32287.000000000004,6,14,4740,7,653,4974.0,249.0,93.28571428571428,7,4087,5244.666666666667,1514.0,583.8571428571429
299018.0,6,6,412,4,272,99672.66666666669,74.0,68.0,2,140,0.0,74.0,70.0
1996.0,17,4,344,2,150,0.0,75.0,75.0,2,194,0.0,103.0,97.0
100140019.0,17,14,1126,7,563,16663516.166666666,174.0,80.42857142857143,7,563,16670336.5,174.0,80.42857142857143
40920.0,6,14,4740,7,653,6574.166666666667,249.0,93.28571428571428,7,4087,5986.666666666667,1514.0,583.8571428571429
313090.0,17,4,1400,4,1400,104363.33333333331,350.0,350.0,0,0,0.0,0.0,0.0
835870.0,6,9,1118,6,586,167174.0,248.0,97.66666666666669,3,532,280111.5,392.0,177.33333333333334
146082.0,6,3,337,2,214,0.0,160.0,107.0,1,123,0.0,123.0,123.0
209432.0,17,2,180,1,90,0.0,90.0,90.0,1,90,0.0,90.0,90.0
135132706.0,17,6,1146,6,1146,27026541.2,191.0,191.0,0,0,0.0,0.0,0.0
228293.0,17,2,180,1,90,0.0,90.0,90.0,1,90,0.0,90.0,90.0
306971.0,6,6,412,4,272,102323.66666666669,74.0,68.0,2,140,0.0,74.0,70.0
899.0,17,2,762,2,762,0.0,381.0,381.0,0,0,0.0,0.0,0.0
217732.0,6,3,426,2,280,0.0,214.0,140.0,1,146,0.0,146.0,146.0
45225.0,6,10,2032,5,524,10705.25,252.0,104.8,5,1508,10845.25,1236.0,301.6
107333.0,17,2,286,2,286,0.0,143.0,143.0,0,0,0.0,0.0,0.0
113254728.0,6,46,3036,23,1518,5135438.181818182,66.0,66.0,23,1518,5135431.818181818,66.0,66.0
213579.0,6,12,1373,7,714,35596.5,298.0,102.0,5,659,52623.5,379.0,131.8
2336.0,17,4,344,2,150,0.0,75.0,75.0,2,194,0.0,103.0,97.0
108041.0,17,2,286,2,286,0.0,143.0,143.0,0,0,0.0,0.0,0.0
149579.0,17,2,180,1,90,0.0,90.0,90.0,1,90,0.0,90.0,90.0
9659.0,17,2,582,1,83,0.0,83.0,83.0,1,499,0.0,499.0,499.0
125842288.0,6,65,12905,31,6720,3226424.2,1514.0,216.7741935483871,34,6185,3806861.424242424,1514.0,181.91176470588235
2389.0,17,4,344,2,150,0.0,75.0,75.0,2,194,0.0,103.0,97.0
455529.0,17,4,360,2,140,0.0,70.0,70.0,2,220,0.0,110.0,110.0
120001206.0,17,14,864,8,475,17143029.42857143,174.0,59.375,6,389,20001147.8,174.0,64.83333333333333
113520156.0,6,46,3036,23,1518,5159995.545454546,66.0,66.0,23,1518,5159996.090909091,66.0,66.0
29601.0,6,14,4740,7,653,4583.0,249.0,93.28571428571428,7,4087,4752.5,1514.0,583.8571428571429
148044.0,17,2,180,1,90,0.0,90.0,90.0,1,90,0.0,90.0,90.0
108108350.0,17,5,955,5,955,27027087.5,191.0,191.0,0,0,0.0,0.0,0.0
19384.0,6,11,1133,6,602,3661.4,264.0,100.33333333333331,5,531,3678.75,259.0,106.2
4601502.0,6,5,336,2,134,0.0,68.0,67.0,3,202,1524800.0,70.0,67.33333333333333
140847.0,6,2,132,1,66,0.0,66.0,66.0,1,66,0.0,66.0,66.0
96756.0,6,14,4740,7,653,9410.333333333334,249.0,93.28571428571428,7,4087,14796.166666666666,1514.0,583.8571428571429
135143014.0,17,6,1146,6,1146,27028602.8,191.0,191.0,0,0,0.0,0.0,0.0
333.0,17,2,160,1,80,0.0,80.0,80.0,1,80,0.0,80.0,80.0
186045.0,17,2,180,1,90,0.0,90.0,90.0,1,90,0.0,90.0,90.0
128988.0,6,2,132,1,66,0.0,66.0,66.0,1,66,0.0,66.0,66.0
17513.0,6,11,2098,6,590,3394.8,252.0,98.33333333333331,5,1508,4111.0,1236.0,301.6
209703.0,6,10,1221,6,636,41940.6,298.0,106.0,4,585,68725.66666666667,379.0,146.25
304788.0,6,6,412,4,272,101596.0,74.0,68.0,2,140,0.0,74.0,70.0
90255732.0,6,12,1832,8,1016,12893676.0,188.0,127.0,4,816,30030733.0,204.0,204.0
16146.0,6,2,145,2,145,0.0,91.0,72.5,0,0,0.0,0.0,0.0
143918.0,17,2,180,1,90,0.0,90.0,90.0,1,90,0.0,90.0,90.0
16015.999999999998,6,13,1459,7,862,2549.0,271.0,123.14285714285714,6,597,2862.6,259.0,99.5
249809.0,6,3,426,2,280,0.0,214.0,140.0,1,146,0.0,146.0,146.0
307453.0,6,6,412,4,272,102484.33333333331,74.0,68.0,2,140,0.0,74.0,70.0
90253355.0,6,12,1832,8,1016,12893336.42857143,188.0,127.0,4,816,30027977.0,204.0,204.0
60411.0,6,14,4740,7,653,9660.0,249.0,93.28571428571428,7,4087,9674.5,1514.0,583.8571428571429
2591031.0,6,2,132,1,66,0.0,66.0,66.0,1,66,0.0,66.0,66.0
135133658.0,17,6,1206,6,1206,27026731.6,201.0,201.0,0,0,0.0,0.0,0.0
168307.0,17,2,614,1,72,0.0,72.0,72.0,1,542,0.0,542.0,542.0
118701785.0,6,34,2482,17,1194,7418836.0,123.0,70.23529411764706,17,1288,6794714.125,139.0,75.76470588235294
108669888.0,6,37,2788,19,1471,6025223.055555556,139.0,77.42105263157895,18,1317,6379648.411764706,123.0,73.16666666666667
120411107.0,17,13,821,7,432,20068517.83333333,174.0,61.71428571428572,6,389,20069273.0,174.0,64.83333333333333
153474.0,17,2,180,1,90,0.0,90.0,90.0,1,90,0.0,90.0,90.0
103616.0,17,2,762,2,762,0.0,381.0,381.0,0,0,0.0,0.0,0.0
107870180.0,6,28,1860,14,966,8297706.153846154,123.0,69.0,14,894,8281897.692307692,123.0,63.85714285714285
77728.0,6,13,4519,6,512,15413.4,230.0,85.33333333333333,7,4007,6018.5,1514.0,572.4285714285714
40197.0,6,14,4740,7,653,6513.666666666667,249.0,93.28571428571428,7,4087,5193.0,1514.0,583.8571428571429
120465133.0,6,21,1585,11,840,9043078.4,95.0,76.36363636363636,10,745,13379338.333333334,95.0,74.5
306869.0,6,6,412,4,272,102289.66666666669,74.0,68.0,2,140,0.0,74.0,70.0
298931.0,6,6,412,4,272,99643.66666666669,74.0,68.0,2,140,0.0,74.0,70.0
32094.0,6,10,2032,5,524,7810.25,252.0,104.8,5,1508,7227.5,1236.0,301.6
228534.0,17,2,180,1,90,0.0,90.0,90.0,1,90,0.0,90.0,90.0
57696.0,6,10,2032,5,524,13555.0,252.0,104.8,5,1508,13193.25,1236.0,301.6
107969.0,17,2,286,2,286,0.0,143.0,143.0,0,0,0.0,0.0,0.0
144424.0,17,2,180,1,90,0.0,90.0,90.0,1,90,0.0,90.0,90.0
120801837.0,6,221,25068,111,17574,1098198.518181818,284.0,158.32432432432432,110,7494,1098761.266055046,140.0,68.12727272727273
90257371.0,6,14,2240,8,1016,12893910.142857144,188.0,127.0,6,1224,18018420.0,204.0,204.0
1998.0,17,4,344,2,150,0.0,75.0,75.0,2,194,0.0,103.0,97.0
0.0,17,1,350,1,350,0.0,350.0,350.0,0,0,0.0,0.0,0.0
299223.0,6,6,412,4,272,99741.0,74.0,68.0,2,140,0.0,74.0,70.0
349.0,17,2,267,1,83,0.0,83.0,83.0,1,184,0.0,184.0,184.0
222080.0,6,3,426,2,280,0.0,214.0,140.0,1,146,0.0,146.0,146.0
218016.0,6,3,426,2,280,0.0,214.0,140.0,1,146,0.0,146.0,146.0
120054259.0,6,47,3102,23,1518,5135437.181818182,66.0,66.0,24,1584,5207784.478260869,66.0,66.0
90257527.0,6,13,2036,8,1016,12893932.42857143,188.0,127.0,5,1020,22523088.5,204.0,204.0
41913.0,6,14,4740,7,653,6159.333333333333,249.0,93.28571428571428,7,4087,6722.666666666667,1514.0,583.8571428571429
144025.0,17,4,1400,4,1400,48008.333333333336,350.0,350.0,0,0,0.0,0.0,0.0
121258.0,6,3,337,2,214,0.0,160.0,107.0,1,123,0.0,123.0,123.0
3172778.0,6,18,1495,9,921,358349.375,315.0,102.33333333333331,9,574,358327.0,78.0,63.77777777777778
415.0,17,2,174,1,79,0.0,79.0,79.0,1,95,0.0,95.0,95.0
20132.0,17,2,582,1,83,0.0,83.0,83.0,1,499,0.0,499.0,499.0
68359.0,6,14,4740,7,653,10809.666666666666,249.0,93.28571428571428,7,4087,8533.0,1514.0,583.8571428571429
104257668.0,6,188,21204,94,14778,1118736.9139784947,284.0,157.2127659574468,94,6426,1118736.5806451612,140.0,68.36170212765957
36836.0,6,10,2032,5,524,8668.75,252.0,104.8,5,1508,8956.75,1236.0,301.6
90257148.0,6,13,2036,8,1016,12893878.285714284,188.0,127.0,5,1020,22523040.25,204.0,204.0
120121912.0,6,17,2852,9,1836,15015239.0,204.0,204.0,8,1016,17097298.57142857,188.0,127.0
108212.0,17,2,286,2,286,0.0,143.0,143.0,0,0,0.0,0.0,0.0
96168758.0,6,182,20554,91,14400,1066152.1,284.0,158.24175824175825,91,6154,1066150.888888889,140.0,67.62637362637362
308.0,17,2,174,1,79,0.0,79.0,79.0,1,95,0.0,95.0,95.0
119484852.0,6,232,26252,116,18300,1037127.947826087,464.0,157.75862068965515,116,7952,1037127.8,140.0,68.55172413793103
40516.0,6,10,2032,5,524,9246.0,252.0,104.8,5,1508,8951.25,1236.0,301.6
209845.0,6,10,1221,6,636,41969.0,298.0,106.0,4,585,67196.0,379.0,146.25
307517.0,6,6,412,4,272,102505.66666666669,74.0,68.0,2,140,0.0,74.0,70.0
321542.0,6,6,412,4,272,107180.66666666669,74.0,68.0,2,140,0.0,74.0,70.0
206028.0,6,3,426,2,280,0.0,214.0,140.0,1,146,0.0,146.0,146.0
117979528.0,6,528,81638,267,64042,442722.3872180451,1514.0,239.85767790262173,261,17596,452939.1423076923,214.0,67.4176245210728
251482.0,17,2,180,1,90,0.0,90.0,90.0,1,90,0.0,90.0,90.0
108097429.0,17,5,955,5,955,27024357.25,191.0,191.0,0,0,0.0,0.0,0.0
752815.0,6,2,132,1,66,0.0,66.0,66.0,1,66,0.0,66.0,66.0
312.0,17,2,174,1,79,0.0,79.0,79.0,1,95,0.0,95.0,95.0
116130938.0,6,47,3102,24,1584,5035761.521739131,66.0,66.0,23,1518,5150439.454545454,66.0,66.0
106218.0,17,2,700,2,700,0.0,350.0,350.0,0,0,0.0,0.0,0.0
310366.0,17,4,571,2,148,0.0,74.0,74.0,2,423,0.0,276.0,211.5
8680.0,17,2,582,1,83,0.0,83.0,83.0,1,499,0.0,499.0,499.0
12223.0,17,2,762,2,762,0.0,381.0,381.0,0,0,0.0,0.0,0.0
28050.0,6,10,2032,5,524,6247.75,252.0,104.8,5,1508,6615.5,1236.0,301.6
2800899.0,6,2,132,1,66,0.0,66.0,66.0,1,66,0.0,66.0,66.0
90219009.0,6,16,1192,8,596,12854591.57142857,95.0,74.5,8,596,12859106.42857143,95.0,74.5
205838.0,6,3,426,2,280,0.0,214.0,140.0,1,146,0.0,146.0,146.0
20153.0,17,2,582,1,83,0.0,83.0,83.0,1,499,0.0,499.0,499.0
4363.0,17,4,344,2,150,0.0,75.0,75.0,2,194,0.0,103.0,97.0
263616.0,6,3,337,2,214,0.0,160.0,107.0,1,123,0.0,123.0,123.0
120311950.0,6,228,25772,114,7820,1057552.9469026548,140.0,68.59649122807018,114,17952,1057366.0530973452,284.0,157.47368421052633
2352.0,17,4,344,2,150,0.0,75.0,75.0,2,194,0.0,103.0,97.0
90224299.0,6,19,1436,9,691,11246770.875,95.0,76.77777777777777,10,745,10001002.333333334,95.0,74.5
4211.0,17,4,344,2,150,0.0,75.0,75.0,2,194,0.0,103.0,97.0
108108659.0,17,5,955,5,955,27027164.75,191.0,191.0,0,0,0.0,0.0,0.0
339.0,17,2,152,1,76,0.0,76.0,76.0,1,76,0.0,76.0,76.0
312028.0,6,6,412,4,272,104009.33333333331,74.0,68.0,2,140,0.0,74.0,70.0
126391.0,6,2,132,1,66,0.0,66.0,66.0,1,66,0.0,66.0,66.0
308130.0,6,6,412,4,272,102710.0,74.0,68.0,2,140,0.0,74.0,70.0
58772.0,6,14,4740,7,653,9185.0,249.0,93.28571428571428,7,4087,9164.166666666666,1514.0,583.8571428571429
120119103.0,6,15,2428,9,1204,15014887.875,188.0,133.77777777777777,6,1224,18017999.6,204.0,204.0
72930.0,6,10,1066,5,490,17850.0,218.0,98.0,5,576,17974.5,304.0,115.2
135130643.0,17,6,1206,6,1206,27026128.6,201.0,201.0,0,0,0.0,0.0,0.0
2012.0,17,4,344,2,150,0.0,75.0,75.0,2,194,0.0,103.0,97.0
99020.0,17,2,762,2,762,0.0,381.0,381.0,0,0,0.0,0.0,0.0
108104042.0,17,5,1005,5,1005,27026010.5,201.0,201.0,0,0,0.0,0.0,0.0
120127585.0,6,13,2020,9,1204,15015948.125,188.0,133.77777777777777,4,816,30031533.33333333,204.0,204.0
299380.0,6,6,412,4,272,99793.33333333331,74.0,68.0,2,140,0.0,74.0,70.0
106994.0,17,2,286,2,286,0.0,143.0,143.0,0,0,0.0,0.0,0.0
2021004.0,17,4,525,2,150,0.0,75.0,75.0,2,375,0.0,284.0,187.5
48056.0,6,12,1328,6,731,7905.6,253.0,121.83333333333331,6,597,8022.8,259.0,99.5
25343.0,6,10,2032,5,524,5994.75,252.0,104.8,5,1508,5679.0,1236.0,301.6
725.0,17,2,762,2,762,0.0,381.0,381.0,0,0,0.0,0.0,0.0
0.0,17,1,350,1,350,0.0,350.0,350.0,0,0,0.0,0.0,0.0
169125.0,17,2,414,1,88,0.0,88.0,88.0,1,326,0.0,326.0,326.0
43009.0,6,10,2032,5,524,10521.5,252.0,104.8,5,1508,10386.25,1236.0,301.6
135723109.0,17,18,1560,9,780,14444256.375,174.0,86.66666666666667,9,780,16876966.625,174.0,86.66666666666667
120020807.0,17,29,13785,29,13785,4286457.392857143,501.0,475.3448275862069,0,0,0.0,0.0,0.0
102978.0,17,2,286,2,286,0.0,143.0,143.0,0,0,0.0,0.0,0.0
1318486.0,6,4,264,2,132,0.0,66.0,66.0,2,132,0.0,66.0,66.0
307.0,17,2,168,1,76,0.0,76.0,76.0,1,92,0.0,92.0,92.0
1298702.0,6,4,264,2,132,0.0,66.0,66.0,2,132,0.0,66.0,66.0
12600.0,6,11,2098,6,590,2326.6,252.0,98.33333333333331,5,1508,2914.75,1236.0,301.6
10287.0,17,2,539,1,86,0.0,86.0,86.0,1,453,0.0,453.0,453.0
58937.0,6,14,4740,7,653,9331.166666666666,249.0,93.28571428571428,7,4087,8631.833333333334,1514.0,583.8571428571429
23100849.0,17,3,1034,2,684,0.0,342.0,342.0,1,350,0.0,350.0,350.0
90012162.0,17,28,13364,28,13364,3333783.777777778,501.0,477.2857142857143,0,0,0.0,0.0,0.0
1172555.0,6,13,3020,8,2392,167507.85714285713,1514.0,299.0,5,628,224226.5,331.0,125.6
27683430.0,17,5,1710,5,1710,6920857.5,342.0,342.0,0,0,0.0,0.0,0.0
108105965.0,17,5,1005,5,1005,27026491.25,201.0,201.0,0,0,0.0,0.0,0.0
748423.0,6,2,132,1,66,0.0,66.0,66.0,1,66,0.0,66.0,66.0
120123840.0,6,14,2240,6,1224,24024768.0,204.0,204.0,8,1016,17136923.14285714,188.0,127.0
1134733.0,6,13,3017,8,2389,162104.7142857143,1514.0,298.625,5,628,215532.25,331.0,125.6
215420.0,17,2,180,1,90,0.0,90.0,90.0,1,90,0.0,90.0,90.0
116001160.0,17,13,821,7,432,19333526.666666668,174.0,61.71428571428572,6,389,19200746.4,174.0,64.83333333333333
107469.0,17,2,286,2,286,0.0,143.0,143.0,0,0,0.0,0.0,0.0
231882.0,17,4,1400,4,1400,77294.0,350.0,350.0,0,0,0.0,0.0,0.0
2593521.0,6,2,132,1,66,0.0,66.0,66.0,1,66,0.0,66.0,66.0
146404.0,6,3,337,2,214,0.0,160.0,107.0,1,123,0.0,123.0,123.0
93535242.0,6,40,2640,20,1320,4922907.47368421,66.0,66.0,20,1320,4911531.0,66.0,66.0
90262901.0,6,13,2036,8,1016,12894700.142857144,188.0,127.0,5,1020,22524573.75,204.0,204.0
120028022.0,6,1000,232132,509,198838,235849.41732283463,1514.0,390.6444007858546,491,33294,244513.28367346936,214.0,67.80855397148676
52333.0,6,10,2032,5,524,12852.5,252.0,104.8,5,1508,12834.75,1236.0,301.6
114070218.0,6,48,3168,24,1584,4959574.695652174,66.0,66.0,24,1584,4945903.739130435,66.0,66.0
90531235.0,6,14,2240,8,1016,12933033.57142857,188.0,127.0,6,1224,18073263.4,204.0,204.0
146612.0,6,3,337,2,214,0.0,160.0,107.0,1,123,0.0,123.0,123.0
962230.0,6,2,132,1,66,0.0,66.0,66.0,1,66,0.0,66.0,66.0
720895.0,6,11,1131,6,600,143780.8,262.0,100.0,5,531,179907.0,259.0,106.2
185966.0,17,2,180,1,90,0.0,90.0,90.0,1,90,0.0,90.0,90.0
135137230.0,17,6,1146,6,1146,27027446.0,191.0,191.0,0,0,0.0,0.0,0.0
321894.0,17,4,1400,4,1400,107298.0,350.0,350.0,0,0,0.0,0.0,0.0
1596920.0,6,19,7533,10,1403,177435.55555555556,583.0,140.3,9,6130,167274.0,1484.0,681.1111111111111
90030243.0,17,28,13364,28,13364,3334453.4444444445,501.0,477.2857142857143,0,0,0.0,0.0,0.0
120020543.0,17,28,13364,28,13364,4445205.296296297,501.0,477.2857142857143,0,0,0.0,0.0,0.0
49690.0,6,10,2032,5,524,11953.75,252.0,104.8,5,1508,12169.75,1236.0,301.6
9762.0,6,10,1066,5,490,2140.0,218.0,98.0,5,576,2074.25,304.0,115.2
51139.0,6,14,4740,7,653,8391.5,249.0,93.28571428571428,7,4087,7640.0,1514.0,583.8571428571429
128931480.0,6,39,2908,21,1591,6446574.0,139.0,75.76190476190476,18,1317,6984827.176470588,123.0,73.16666666666667
90258364.0,6,14,2240,8,1016,12894052.0,188.0,127.0,6,1224,18016002.8,204.0,204.0
10955.0,6,11,2098,6,590,2191.0,252.0,98.33333333333331,5,1508,2371.25,1236.0,301.6
29577.0,6,11,2098,6,590,5790.4,252.0,98.33333333333331,5,1508,6423.0,1236.0,301.6
92708023.0,6,37,2442,19,1254,5150445.722222222,66.0,66.0,18,1188,5288201.647058823,66.0,66.0
90214533.0,6,18,1503,9,650,11246567.375,95.0,72.22222222222223,9,853,11251156.625,257.0,94.77777777777776
2751469.0,6,3,1604,1,753,0.0,753.0,753.0,2,851,0.0,785.0,425.5
12015428.0,17,3,1026,3,1026,6007714.0,342.0,342.0,0,0,0.0,0.0,0.0
113440107.0,6,34,2482,17,1288,7090006.6875,139.0,75.76470588235294,17,1194,7077198.8125,123.0,70.23529411764706
107266163.0,6,204,22980,102,16026,1059910.98019802,284.0,157.11764705882354,102,6954,1059910.2475247525,140.0,68.17647058823529
12658.0,6,11,2098,6,590,2364.4,252.0,98.33333333333331,5,1508,2911.25,1236.0,301.6
704.0,17,4,438,2,148,0.0,74.0,74.0,2,290,0.0,147.0,145.0
2056.0,17,4,344,2,150,0.0,75.0,75.0,2,194,0.0,103.0,97.0
17890.0,6,2,145,2,145,0.0,91.0,72.5,0,0,0.0,0.0,0.0
73945.0,6,2,132,1,66,0.0,66.0,66.0,1,66,0.0,66.0,66.0
153302.0,17,2,180,1,90,0.0,90.0,90.0,1,90,0.0,90.0,90.0
108105082.0,17,5,1005,5,1005,27026270.5,201.0,201.0,0,0,0.0,0.0,0.0
272970.0,6,10,1221,6,636,54594.0,298.0,106.0,4,585,85247.66666666667,379.0,146.25
121485.0,6,3,337,2,214,0.0,160.0,107.0,1,123,0.0,123.0,123.0
108109676.0,17,5,1005,5,1005,27027419.0,201.0,201.0,0,0,0.0,0.0,0.0
103180.0,17,2,286,2,286,0.0,143.0,143.0,0,0,0.0,0.0,0.0
108123931.0,17,5,1005,5,1005,27030982.75,201.0,201.0,0,0,0.0,0.0,0.0
298519.0,6,6,412,4,272,99506.33333333331,74.0,68.0,2,140,0.0,74.0,70.0
10555620.0,6,6,412,3,206,5209222.0,74.0,68.66666666666667,3,206,5209168.5,74.0,68.66666666666667
148047.0,17,2,180,1,90,0.0,90.0,90.0,1,90,0.0,90.0,90.0
35227.0,6,14,4740,7,653,5761.166666666667,249.0,93.28571428571428,7,4087,5357.166666666667,1514.0,583.8571428571429
30280.0,6,14,4740,7,653,4667.833333333333,249.0,93.28571428571428,7,4087,4861.0,1514.0,583.8571428571429
309.0,17,2,174,1,79,0.0,79.0,79.0,1,95,0.0,95.0,95.0
334.0,17,2,160,1,80,0.0,80.0,80.0,1,80,0.0,80.0,80.0
37641.0,6,10,2032,5,524,7312.5,252.0,104.8,5,1508,8838.0,1236.0,301.6
197505.0,17,2,180,1,90,0.0,90.0,90.0,1,90,0.0,90.0,90.0
25746.0,6,10,2032,5,524,6225.25,252.0,104.8,5,1508,5890.25,1236.0,301.6
121505.0,6,3,337,2,214,0.0,160.0,107.0,1,123,0.0,123.0,123.0
105057.0,17,2,700,2,700,0.0,350.0,350.0,0,0,0.0,0.0,0.0
3928.0,17,4,704,2,148,0.0,74.0,74.0,2,556,0.0,280.0,278.0
245196.0,6,3,337,2,214,0.0,160.0,107.0,1,123,0.0,123.0,123.0
36167.0,6,11,2098,6,590,6417.4,252.0,98.33333333333331,5,1508,8775.75,1236.0,301.6
216583.0,17,2,180,1,90,0.0,90.0,90.0,1,90,0.0,90.0,90.0
135931250.0,17,15,1169,8,606,19418750.0,174.0,75.75,7,563,19429095.33333333,174.0,80.42857142857143
299.0,17,2,174,1,79,0.0,79.0,79.0,1,95,0.0,95.0,95.0
14359843.0,17,6,2052,6,2052,2871968.6,342.0,342.0,0,0,0.0,0.0,0.0
97302123.0,6,235,27864,118,8010,831642.0769230769,140.0,67.88135593220339,117,19854,829829.1637931034,336.0,169.69230769230768
2797458.0,6,2,132,1,66,0.0,66.0,66.0,1,66,0.0,66.0,66.0
103147.0,17,2,286,2,286,0.0,143.0,143.0,0,0,0.0,0.0,0.0
431643.0,6,3,1604,1,753,0.0,753.0,753.0,2,851,0.0,785.0,425.5
108102676.0,17,5,955,5,955,27025669.0,191.0,191.0,0,0,0.0,0.0,0.0
307613.0,6,6,412,4,272,102537.66666666669,74.0,68.0,2,140,0.0,74.0,70.0
1308084.0,17,7,490,7,490,218014.0,70.0,70.0,0,0,0.0,0.0,0.0
103683.0,17,2,286,2,286,0.0,143.0,143.0,0,0,0.0,0.0,0.0
303009.0,6,6,412,4,272,101003.0,74.0,68.0,2,140,0.0,74.0,70.0
339.0,17,2,166,1,75,0.0,75.0,75.0,1,91,0.0,91.0,91.0
117021.0,17,2,700,2,700,0.0,350.0,350.0,0,0,0.0,0.0,0.0
119260316.0,6,34,2334,17,1209,7440276.9375,123.0,71.11764705882354,17,1125,7440272.9375,123.0,66.17647058823529
1475397.0,17,16,1120,16,1120,98359.8,70.0,70.0,0,0,0.0,0.0,0.0
205997.0,17,2,180,1,90,0.0,90.0,90.0,1,90,0.0,90.0,90.0
1022446.0,6,11,1134,6,558,204489.2,220.0,93.0,5,576,254767.25,304.0,115.2
2600372.0,6,2,132,1,66,0.0,66.0,66.0,1,66,0.0,66.0,66.0
39782.0,6,10,2032,5,524,9394.5,252.0,104.8,5,1508,7398.5,1236.0,301.6
5605971.0,6,4,270,2,134,0.0,68.0,67.0,2,136,0.0,70.0,68.0
783.0,17,4,438,2,148,0.0,74.0,74.0,2,290,0.0,147.0,145.0
304184.0,6,3,202,2,128,0.0,74.0,64.0,1,74,0.0,74.0,74.0
144962.0,17,2,180,1,90,0.0,90.0,90.0,1,90,0.0,90.0,90.0
113257180.0,6,46,3036,23,1518,5135435.954545454,66.0,66.0,23,1518,5135549.636363637,66.0,66.0
38606.0,6,14,4740,7,653,6304.666666666667,249.0,93.28571428571428,7,4087,6297.0,1514.0,583.8571428571429
303430.0,6,6,412,4,272,101143.33333333331,74.0,68.0,2,140,0.0,74.0,70.0
22576.0,6,10,2032,5,524,5274.25,252.0,104.8,5,1508,4933.25,1236.0,301.6
903488.0,17,4,820,2,156,0.0,78.0,78.0,2,664,0.0,332.0,332.0
2394.0,17,4,344,2,150,0.0,75.0,75.0,2,194,0.0,103.0,97.0
14008.0,6,11,2098,6,590,2406.0,252.0,98.33333333333331,5,1508,3126.25,1236.0,301.6
344.0,17,2,250,1,93,0.0,93.0,93.0,1,157,0.0,157.0,157.0
206146.0,6,3,426,2,280,0.0,214.0,140.0,1,146,0.0,146.0,146.0
2798423.0,6,2,132,1,66,0.0,66.0,66.0,1,66,0.0,66.0,66.0
234343.0,6,3,373,2,238,0.0,172.0,119.0,1,135,0.0,135.0,135.0
258149.00000000003,6,3,337,2,214,0.0,160.0,107.0,1,123,0.0,123.0,123.0
117201376.0,6,48,3168,24,1584,5095712.0,66.0,66.0,24,1584,5083861.217391305,66.0,66.0
90262282.0,6,13,2036,8,1016,12894611.714285716,188.0,127.0,5,1020,22524373.25,204.0,204.0
306636.0,6,6,412,4,272,102212.0,74.0,68.0,2,140,0.0,74.0,70.0
105250.0,17,2,700,2,700,0.0,350.0,350.0,0,0,0.0,0.0,0.0
211178.0,6,10,1221,6,636,42235.6,298.0,106.0,4,585,69284.66666666667,379.0,146.25
143937.0,17,2,180,1,90,0.0,90.0,90.0,1,90,0.0,90.0,90.0
2072.0,17,4,344,2,150,0.0,75.0,75.0,2,194,0.0,103.0,97.0
33896.0,6,2,132,1,66,0.0,66.0,66.0,1,66,0.0,66.0,66.0
104873.0,17,2,700,2,700,0.0,350.0,350.0,0,0,0.0,0.0,0.0
2459.0,17,2,762,2,762,0.0,381.0,381.0,0,0,0.0,0.0,0.0
105255138.0,6,208,23552,104,16466,1019804.2233009709,284.0,158.32692307692307,104,7086,1019804.1941747572,140.0,68.13461538461539
103656.0,17,2,286,2,286,0.0,143.0,143.0,0,0,0.0,0.0,0.0
231605.0,6,3,337,2,214,0.0,160.0,107.0,1,123,0.0,123.0,123.0
1544397.0,6,7,499,4,301,444813.0,103.0,75.25,3,198,716289.0,66.0,66.0
134644812.0,17,16,1212,8,606,16428919.57142857,174.0,75.75,8,606,16428705.714285716,174.0,75.75
144843.0,17,2,180,1,70,0.0,70.0,70.0,1,110,0.0,110.0,110.0
105446333.0,17,14,864,7,432,17500943.0,174.0,61.71428571428572,7,432,17500239.666666668,174.0,61.71428571428572
39000.0,6,14,4740,7,653,6329.5,249.0,93.28571428571428,7,4087,5908.333333333333,1514.0,583.8571428571429
10523808.0,6,7,478,4,272,3462310.333333333,74.0,68.0,3,206,5193376.0,74.0,68.66666666666667
117493968.0,6,215,24284,108,7424,1098074.4672897195,140.0,68.74074074074075,107,16860,1098510.8113207547,284.0,157.57009345794393
306807.0,6,6,412,4,272,102269.0,74.0,68.0,2,140,0.0,74.0,70.0
310848.0,6,6,412,4,272,103616.0,74.0,68.0,2,140,0.0,74.0,70.0
2546622.0,6,14,1332,6,558,509324.4,220.0,93.0,8,774,361483.7142857143,304.0,96.75
231731.0,6,3,337,2,214,0.0,160.0,107.0,1,123,0.0,123.0,123.0
1596180.0,6,20,7599,11,1469,159618.0,583.0,133.54545454545453,9,6130,164144.125,1484.0,681.1111111111111
4432.0,17,2,614,1,72,0.0,72.0,72.0,1,542,0.0,542.0,542.0
309831.0,6,6,412,4,272,103277.0,74.0,68.0,2,140,0.0,74.0,70.0
57446.0,6,14,4740,7,653,9451.333333333334,249.0,93.28571428571428,7,4087,8761.333333333334,1514.0,583.8571428571429
1052454.0,6,13,1394,7,797,175409.0,253.0,113.85714285714286,6,597,206448.4,259.0,99.5
205863.0,17,2,180,1,90,0.0,90.0,90.0,1,90,0.0,90.0,90.0
103459.0,6,14,4740,7,653,17125.333333333332,249.0,93.28571428571428,7,4087,17041.0,1514.0,583.8571428571429
143729.0,17,4,1400,4,1400,47909.66666666666,350.0,350.0,0,0,0.0,0.0,0.0
37160.0,6,14,4740,7,653,6081.666666666667,249.0,93.28571428571428,7,4087,6061.5,1514.0,583.8571428571429
113830472.0,6,34,2350,17,1225,7100919.3125,139.0,72.05882352941177,17,1125,7100924.0,123.0,66.17647058823529
90263712.0,6,13,2036,8,1016,12894816.0,188.0,127.0,5,1020,22524077.5,204.0,204.0
47878.0,6,10,2032,5,524,11707.75,252.0,104.8,5,1508,10388.0,1236.0,301.6
90291502.0,6,16,1192,8,596,12891789.42857143,95.0,74.5,8,596,12897689.57142857,95.0,74.5
114084344.0,6,48,3168,24,1584,4960188.869565218,66.0,66.0,24,1584,4946767.695652174,66.0,66.0
96256287.0,6,40,2640,20,1320,5066120.368421053,66.0,66.0,20,1320,5049564.263157895,66.0,66.0
821.0,17,4,438,2,148,0.0,74.0,74.0,2,290,0.0,147.0,145.0
18670.0,6,14,4740,7,653,3001.5,249.0,93.28571428571428,7,4087,2461.1666666666665,1514.0,583.8571428571429
108107003.0,17,5,955,5,955,27026750.75,191.0,191.0,0,0,0.0,0.0,0.0
101896408.0,6,369,44654,184,12440,556726.1038251367,140.0,67.6086956521739,185,32214,553766.4836956522,374.0,174.12972972972972
16598.0,6,20,7606,11,978,1659.8,310.0,88.9090909090909,9,6628,1696.25,1514.0,736.4444444444445
76894605.0,17,14,4788,14,4788,5914969.615384615,342.0,342.0,0,0,0.0,0.0,0.0
90254779.0,6,14,2240,8,1016,12893539.857142856,188.0,127.0,6,1224,18018208.2,204.0,204.0
113254823.0,6,46,3036,23,1518,5135439.636363637,66.0,66.0,23,1518,5135437.818181818,66.0,66.0
321657.0,6,10,1221,6,636,64331.4,298.0,106.0,4,585,91310.0,379.0,146.25
173134.0,17,4,1400,4,1400,57711.333333333336,350.0,350.0,0,0,0.0,0.0,0.0
33965.0,6,14,4740,7,653,5075.5,249.0,93.28571428571428,7,4087,5238.333333333333,1514.0,583.8571428571429
216789.0,6,3,426,2,280,0.0,214.0,140.0,1,146,0.0,146.0,146.0
50929.0,6,14,4740,7,653,8310.5,249.0,93.28571428571428,7,4087,6808.0,1514.0,583.8571428571429
43897.0,6,10,2032,5,524,10749.25,252.0,104.8,5,1508,9439.5,1236.0,301.6
1178341.0,6,13,3016,8,2388,168334.42857142858,1514.0,298.5,5,628,225658.25,331.0,125.6
485209.0,6,3,204,1,68,0.0,68.0,68.0,2,136,0.0,70.0,68.0
90283971.0,6,28,3049,14,1503,6941566.384615385,426.0,107.35714285714286,14,1546,6944298.0,335.0,110.42857142857144
23308.0,6,14,4740,7,653,3347.0,249.0,93.28571428571428,7,4087,3365.6666666666665,1514.0,583.8571428571429
128868916.0,6,37,2656,19,1408,7159384.222222222,139.0,74.10526315789474,18,1248,6980476.05882353,123.0,69.33333333333333
114991619.0,6,48,3168,24,1584,4999635.608695652,66.0,66.0,24,1584,4986374.0869565215,66.0,66.0
21241.0,6,10,1913,5,461,4897.25,233.0,92.2,5,1452,4182.0,1224.0,290.4
290957.0,17,2,582,1,83,0.0,83.0,83.0,1,499,0.0,499.0,499.0
2333745.0,6,3,1604,1,753,0.0,753.0,753.0,2,851,0.0,785.0,425.5
111343252.0,6,24,2696,12,1526,10121873.0,215.0,127.16666666666669,12,1170,10112461.181818182,204.0,97.5
112464247.0,6,46,3036,23,1518,5111999.227272728,66.0,66.0,23,1518,5111998.954545454,66.0,66.0
90760015.0,6,20,1531,11,840,9071676.4,95.0,76.36363636363636,9,691,11344082.375,95.0,76.77777777777777
39926.0,6,14,4740,7,653,4783.5,249.0,93.28571428571428,7,4087,6498.166666666667,1514.0,583.8571428571429
9357.0,17,2,571,1,86,0.0,86.0,86.0,1,485,0.0,485.0,485.0
3114246.0,6,3,1604,1,753,0.0,753.0,753.0,2,851,0.0,785.0,425.5
21104.0,6,14,4740,7,653,3248.6666666666665,249.0,93.28571428571428,7,4087,3375.6666666666665,1514.0,583.8571428571429
6884.0,17,2,582,1,83,0.0,83.0,83.0,1,499,0.0,499.0,499.0
90287789.0,6,12,1832,8,1016,12898255.57142857,188.0,127.0,4,816,30041502.33333333,204.0,204.0
135135980.0,17,6,1146,6,1146,27027196.0,191.0,191.0,0,0,0.0,0.0,0.0
108100499.0,17,5,1005,5,1005,27025124.75,201.0,201.0,0,0,0.0,0.0,0.0
90039105.0,17,27,12943,27,12943,3463042.5,501.0,479.3703703703704,0,0,0.0,0.0,0.0
509491.0,6,5,336,2,134,0.0,68.0,67.0,3,202,195511.0,70.0,67.33333333333333
120495251.0,6,221,24912,111,17356,1095411.3727272728,284.0,156.36036036036035,110,7556,1095985.4587155962,140.0,68.69090909090909
10874493.0,6,8,544,4,272,3579089.333333333,74.0,68.0,4,272,3579021.333333333,74.0,68.0
1925.0,17,4,344,2,150,0.0,75.0,75.0,2,194,0.0,103.0,97.0
90297778.0,6,21,1585,11,840,9025578.4,95.0,76.36363636363636,10,745,10001082.0,95.0,74.5
147078.0,6,3,373,2,238,0.0,172.0,119.0,1,135,0.0,135.0,135.0
42374.0,6,10,2032,5,524,9780.0,252.0,104.8,5,1508,10321.0,1236.0,301.6
4596.0,17,2,598,1,72,0.0,72.0,72.0,1,526,0.0,526.0,526.0
135140005.0,17,6,1206,6,1206,27028001.0,201.0,201.0,0,0,0.0,0.0,0.0
2780809.0,6,2,132,1,66,0.0,66.0,66.0,1,66,0.0,66.0,66.0
120009200.0,6,23,1734,12,935,10909064.0,95.0,77.91666666666667,11,799,11999751.2,95.0,72.63636363636364
108087.0,17,2,286,2,286,0.0,143.0,143.0,0,0,0.0,0.0,0.0
206207.0,17,2,762,2,762,0.0,381.0,381.0,0,0,0.0,0.0,0.0
2204440.0,6,23,7478,12,2450,200403.63636363635,1034.0,204.16666666666663,11,5028,189726.0,1510.0,457.09090909090907
206610.0,6,10,1221,6,636,41322.0,298.0,106.0,4,585,67742.66666666667,379.0,146.25
90022813.0,17,28,13364,28,13364,3334178.25925926,501.0,477.2857142857143,0,0,0.0,0.0,0.0
121364.0,6,3,337,2,214,0.0,160.0,107.0,1,123,0.0,123.0,123.0
135136497.0,17,6,1206,6,1206,27027299.4,201.0,201.0,0,0,0.0,0.0,0.0
243071.0,6,3,337,2,214,0.0,160.0,107.0,1,123,0.0,123.0,123.0
113450973.0,6,36,2596,18,1348,6673586.647058823,139.0,74.88888888888889,18,1248,6660841.94117647,123.0,69.33333333333333
125424846.0,17,15,1169,8,606,17917835.14285714,174.0,75.75,7,563,17670128.333333332,174.0,80.42857142857143
7073.0,17,2,582,1,83,0.0,83.0,83.0,1,499,0.0,499.0,499.0
90312310.0,6,13,1898,8,1016,12901758.57142857,188.0,127.0,5,882,22537656.75,204.0,176.4
113168302.0,6,47,3102,24,1584,4920349.695652174,66.0,66.0,23,1518,5144002.090909091,66.0,66.0
3007010.0,6,11,2106,6,598,601225.4,252.0,99.66666666666669,5,1508,2114.5,1236.0,301.6
128955525.0,6,37,2640,19,1392,7164195.833333333,123.0,73.26315789473684,18,1248,6985503.294117647,123.0,69.33333333333333
1026217.0,6,11,1134,6,558,205243.4,220.0,93.0,5,576,255645.0,304.0,115.2
143932.0,17,2,180,1,90,0.0,90.0,90.0,1,90,0.0,90.0,90.0
108107278.0,17,5,955,5,955,27026819.5,191.0,191.0,0,0,0.0,0.0,0.0
106482341.0,6,182,20678,91,14438,1180747.322222222,284.0,158.65934065934067,91,6240,1180747.2222222222,140.0,68.57142857142857
113592241.0,6,35,2542,18,1348,6668574.294117647,139.0,74.88888888888889,17,1194,7085347.6875,123.0,70.23529411764706
2445.0,17,4,344,2,150,0.0,75.0,75.0,2,194,0.0,103.0,97.0
42474.0,6,14,4740,7,653,6960.166666666667,249.0,93.28571428571428,7,4087,6943.166666666667,1514.0,583.8571428571429
122001090.0,17,15,907,8,475,17428727.14285714,174.0,59.375,7,432,17001464.0,174.0,61.71428571428572
1432696.0,17,16,1120,16,1120,95513.06666666668,70.0,70.0,0,0,0.0,0.0,0.0
1043116.0,6,11,1134,6,558,208623.2,220.0,93.0,5,576,256858.25,304.0,115.2
2914.0,17,2,224,1,76,0.0,76.0,76.0,1,148,0.0,148.0,148.0
197410.0,17,2,180,1,90,0.0,90.0,90.0,1,90,0.0,90.0,90.0
302332.0,6,6,412,4,272,100777.33333333331,74.0,68.0,2,140,0.0,74.0,70.0
94310402.0,6,25,1686,13,840,7859200.166666667,123.0,64.61538461538461,12,846,7646360.454545454,123.0,70.5
90263359.0,6,12,1832,8,1016,12894765.57142857,188.0,127.0,4,816,30032437.33333333,204.0,204.0
19982.0,6,14,4740,7,653,3054.833333333333,249.0,93.28571428571428,7,4087,3194.6666666666665,1514.0,583.8571428571429
307452.0,6,6,412,4,272,102484.0,74.0,68.0,2,140,0.0,74.0,70.0
240741.0,6,3,337,2,214,0.0,160.0,107.0,1,123,0.0,123.0,123.0
120013689.0,6,32,2151,16,1149,7986504.666666667,123.0,71.8125,16,1002,7986506.933333334,123.0,62.625
9625.0,17,2,582,1,83,0.0,83.0,83.0,1,499,0.0,499.0,499.0
3090727.0,6,3,1604,2,851,0.0,785.0,425.5,1,753,0.0,753.0,753.0
218955.0,6,3,426,2,280,0.0,214.0,140.0,1,146,0.0,146.0,146.0
41814.0,6,14,4740,7,653,5919.833333333333,249.0,93.28571428571428,7,4087,5607.0,1514.0,583.8571428571429
15001.0,6,14,4740,7,653,2355.833333333333,249.0,93.28571428571428,7,4087,2308.333333333333,1514.0,583.8571428571429
29975.0,6,10,2032,5,524,6572.75,252.0,104.8,5,1508,6679.0,1236.0,301.6
100250828.0,17,14,1126,7,563,16667643.0,174.0,80.42857142857143,7,563,16666793.166666666,174.0,80.42857142857143
93016403.0,6,38,2508,19,1254,5150436.833333333,66.0,66.0,19,1254,5150443.388888889,66.0,66.0
1467856.0,17,16,1120,16,1120,97857.06666666668,70.0,70.0,0,0,0.0,0.0,0.0
135135443.0,17,6,1206,6,1206,27027088.6,201.0,201.0,0,0,0.0,0.0,0.0
148890.0,6,2,819,1,753,0.0,753.0,753.0,1,66,0.0,66.0,66.0
313.0,17,2,156,1,78,0.0,78.0,78.0,1,78,0.0,78.0,78.0
263136.0,6,3,337,2,214,0.0,160.0,107.0,1,123,0.0,123.0,123.0
2085.0,17,4,344,2,150,0.0,75.0,75.0,2,194,0.0,103.0,97.0
118565291.0,6,33,2280,17,1209,7396829.3125,123.0,71.11764705882354,16,1071,7889950.4,123.0,66.9375
322.0,17,2,174,1,79,0.0,79.0,79.0,1,95,0.0,95.0,95.0
103962.0,17,2,286,2,286,0.0,143.0,143.0,0,0,0.0,0.0,0.0
90764635.0,6,19,1436,10,745,10079839.888888888,95.0,74.5,9,691,11344742.5,95.0,76.77777777777777
126144796.0,6,36,2602,19,1408,7008044.222222222,139.0,74.10526315789474,17,1194,7246410.1875,123.0,70.23529411764706
6662.0,17,2,582,1,83,0.0,83.0,83.0,1,499,0.0,499.0,499.0
2840.0,17,4,344,2,150,0.0,75.0,75.0,2,194,0.0,103.0,97.0
4514.0,17,2,180,1,90,0.0,90.0,90.0,1,90,0.0,90.0,90.0
92533955.0,6,30,2106,15,1089,6594152.357142857,123.0,72.6,15,1017,6594147.0,123.0,67.8
49598.0,6,14,4740,7,653,7975.666666666667,249.0,93.28571428571428,7,4087,7483.0,1514.0,583.8571428571429
54057.0,6,14,4740,7,653,8882.166666666666,249.0,93.28571428571428,7,4087,8483.166666666666,1514.0,583.8571428571429
3140798.0,6,27,7758,14,2590,241599.84615384616,1034.0,185.0,13,5168,235982.16666666663,1510.0,397.5384615384616
248912.0,6,3,337,2,214,0.0,160.0,107.0,1,123,0.0,123.0,123.0
245236.0,6,3,337,2,214,0.0,160.0,107.0,1,123,0.0,123.0,123.0
205131.0,17,2,762,2,762,0.0,381.0,381.0,0,0,0.0,0.0,0.0
0.0,6,1,54,1,54,0.0,54.0,54.0,0,0,0.0,0.0,0.0
1040260.0,6,11,1134,6,558,208052.00000000003,220.0,93.0,5,576,257681.25,304.0,115.2
9975.0,17,4,823,2,163,0.0,89.0,81.5,2,660,0.0,443.0,330.0
47609739.0,6,7,2047,3,960,22558033.5,826.0,320.0,4,1087,14945904.0,885.0,271.75
108099458.0,17,5,955,5,955,27024864.5,191.0,191.0,0,0,0.0,0.0,0.0
219679.0,6,3,426,2,280,0.0,214.0,140.0,1,146,0.0,146.0,146.0
309569.0,6,6,412,4,272,103189.66666666669,74.0,68.0,2,140,0.0,74.0,70.0
144022.0,6,2,132,1,66,0.0,66.0,66.0,1,66,0.0,66.0,66.0
0.0,17,1,90,1,90,0.0,90.0,90.0,0,0,0.0,0.0,0.0
505867.0,6,5,336,2,134,0.0,68.0,67.0,3,202,193236.0,70.0,67.33333333333333
12996268.0,17,20,7552,20,7552,684014.1052631579,394.0,377.6,0,0,0.0,0.0,0.0
2363.0,17,4,344,2,150,0.0,75.0,75.0,2,194,0.0,103.0,97.0
112558528.0,6,32,2220,16,1149,7489512.533333333,123.0,71.8125,16,1071,7489511.533333333,123.0,66.9375
250422.0,17,2,359,1,75,0.0,75.0,75.0,1,284,0.0,284.0,284.0
29157.0,6,14,4740,7,653,4500.333333333333,249.0,93.28571428571428,7,4087,4597.833333333333,1514.0,583.8571428571429
1302020.0,6,4,264,2,132,0.0,66.0,66.0,2,132,0.0,66.0,66.0
167816.0,6,13,1394,7,797,27969.33333333333,253.0,113.85714285714286,6,597,32322.6,259.0,99.5
331444.0,6,7,478,4,272,110481.33333333331,74.0,68.0,3,206,89969.0,74.0,68.66666666666667
345.0,17,2,174,1,79,0.0,79.0,79.0,1,95,0.0,95.0,95.0
2590791.0,6,2,132,1,66,0.0,66.0,66.0,1,66,0.0,66.0,66.0
10432210.0,6,7,478,4,272,3431784.0,74.0,68.0,3,206,5147536.0,74.0,68.66666666666667
52210.0,6,14,4740,7,653,8394.333333333334,249.0,93.28571428571428,7,4087,8271.666666666666,1514.0,583.8571428571429
240843.0,6,3,337,2,214,0.0,160.0,107.0,1,123,0.0,123.0,123.0
105425821.0,17,14,864,7,432,17501944.5,174.0,61.71428571428572,7,432,17500195.666666668,174.0,61.71428571428572
580.0,17,2,410,1,78,0.0,78.0,78.0,1,332,0.0,332.0,332.0
301879.0,6,6,412,4,272,100626.33333333331,74.0,68.0,2,140,0.0,74.0,70.0
108101147.0,17,5,1005,5,1005,27025286.75,201.0,201.0,0,0,0.0,0.0,0.0
100692790.0,17,12,778,6,389,20027591.0,174.0,64.83333333333333,6,389,20106768.4,174.0,64.83333333333333
108014546.0,6,30,2106,15,1089,7699897.714285715,123.0,72.6,15,1017,7699908.0,123.0,67.8
303165.0,6,6,412,4,272,101055.0,74.0,68.0,2,140,0.0,74.0,70.0
4165.0,17,2,626,1,72,0.0,72.0,72.0,1,554,0.0,554.0,554.0
116000948.0,17,13,821,7,432,19333491.33333333,174.0,61.71428571428572,6,389,19993840.6,174.0,64.83333333333333
90257673.0,6,12,1832,8,1016,12893953.285714284,188.0,127.0,4,816,30031112.33333333,204.0,204.0
14316.0,6,11,1131,6,600,2731.0,262.0,100.0,5,531,3244.0,259.0,106.2
116674848.0,6,48,3168,24,1584,5072819.478260869,66.0,66.0,24,1584,5059729.956521739,66.0,66.0
2123.0,17,4,344,2,150,0.0,75.0,75.0,2,194,0.0,103.0,97.0
323399.0,6,6,412,4,272,107799.66666666669,74.0,68.0,2,140,0.0,74.0,70.0
320154.0,17,4,1400,4,1400,106718.0,350.0,350.0,0,0,0.0,0.0,0.0
118553402.0,6,328,38106,164,27060,726000.3435582822,570.0,165.0,164,11046,726001.4601226994,140.0,67.35365853658537
90263009.0,6,13,2036,8,1016,12894715.57142857,188.0,127.0,5,1020,22522885.0,204.0,204.0
216352.0,17,2,180,1,90,0.0,90.0,90.0,1,90,0.0,90.0,90.0
196939.0,17,2,180,1,90,0.0,90.0,90.0,1,90,0.0,90.0,90.0
1031412.0,6,10,1065,5,534,257612.50000000003,262.0,106.8,5,531,257565.75,259.0,106.2
143958.0,17,2,180,1,90,0.0,90.0,90.0,1,90,0.0,90.0,90.0
1578585.0,6,4,276,2,128,0.0,74.0,64.0,2,148,0.0,74.0,74.0
269299.0,17,2,180,1,90,0.0,90.0,90.0,1,90,0.0,90.0,90.0
90286206.0,6,16,1192,8,596,12892050.57142857,95.0,74.5,8,596,12897074.42857143,95.0,74.5
108100913.0,17,5,1005,5,1005,27025228.25,201.0,201.0,0,0,0.0,0.0,0.0
323302.0,17,4,1400,4,1400,107767.33333333331,350.0,350.0,0,0,0.0,0.0,0.0
336.0,17,2,267,1,83,0.0,83.0,83.0,1,184,0.0,184.0,184.0
564768.0,6,12,2212,6,694,112745.8,233.0,115.66666666666669,6,1518,111501.6,1224.0,253.0
90020846.0,6,21,1585,10,745,10002316.222222222,95.0,74.5,11,840,8975945.1,95.0,76.36363636363636
90201887.0,6,36,2376,18,1188,5305993.352941177,66.0,66.0,18,1188,5293279.470588235,66.0,66.0
0.0,17,1,44,1,44,0.0,44.0,44.0,0,0,0.0,0.0,0.0
33053.0,6,14,4740,7,653,5060.166666666667,249.0,93.28571428571428,7,4087,5107.0,1514.0,583.8571428571429
120549959.0,6,281,33548,141,24012,861071.1357142857,300.0,170.29787234042553,140,9536,859854.54676259,140.0,68.11428571428571
108105703.0,17,5,1005,5,1005,27026425.75,201.0,201.0,0,0,0.0,0.0,0.0
110853471.0,6,30,1974,15,1026,7902673.214285715,123.0,68.4,15,948,7902672.785714285,123.0,63.2
303122.0,6,2,132,1,66,0.0,66.0,66.0,1,66,0.0,66.0,66.0
93728289.0,17,12,778,6,389,18713874.8,174.0,64.83333333333333,6,389,18615245.0,174.0,64.83333333333333
0.0,6,1,66,1,66,0.0,66.0,66.0,0,0,0.0,0.0,0.0
206158.0,17,2,180,1,90,0.0,90.0,90.0,1,90,0.0,90.0,90.0
1314559.0,6,4,264,2,132,0.0,66.0,66.0,2,132,0.0,66.0,66.0
302455.0,6,2,132,1,66,0.0,66.0,66.0,1,66,0.0,66.0,66.0
235016.0,6,3,373,2,238,0.0,172.0,119.0,1,135,0.0,135.0,135.0
2077900.0,6,19,6869,11,1567,207790.0,408.0,142.45454545454547,8,5302,235002.57142857145,1514.0,662.75
90288176.0,6,16,2368,9,1204,11286022.0,188.0,133.77777777777777,7,1164,15020994.333333334,204.0,166.28571428571428
16313.000000000002,6,10,2032,5,524,3804.75,252.0,104.8,5,1508,3806.5,1236.0,301.6
108106124.0,17,5,955,5,955,27026531.0,191.0,191.0,0,0,0.0,0.0,0.0
120124831.0,6,15,2428,9,1204,15015603.875,188.0,133.77777777777777,6,1224,18073914.6,204.0,204.0
2442.0,17,4,344,2,150,0.0,75.0,75.0,2,194,0.0,103.0,97.0
207148.0,17,2,180,1,90,0.0,90.0,90.0,1,90,0.0,90.0,90.0
233910.0,6,3,337,2,214,0.0,160.0,107.0,1,123,0.0,123.0,123.0
307773.0,6,6,412,4,272,102591.0,74.0,68.0,2,140,0.0,74.0,70.0
307941.0,6,6,412,4,272,102647.0,74.0,68.0,2,140,0.0,74.0,70.0
300761.0,6,2,1538,1,753,0.0,753.0,753.0,1,785,0.0,785.0,785.0
815.0,17,4,438,2,148,0.0,74.0,74.0,2,290,0.0,147.0,145.0
207759.0,6,3,426,2,280,0.0,214.0,140.0,1,146,0.0,146.0,146.0
363688.0,6,11,1021,6,444,49280.4,162.0,74.0,5,577,60956.0,349.0,115.4
9147.0,17,2,582,1,83,0.0,83.0,83.0,1,499,0.0,499.0,499.0
321.0,17,2,164,1,82,0.0,82.0,82.0,1,82,0.0,82.0,82.0
107874.0,17,2,286,2,286,0.0,143.0,143.0,0,0,0.0,0.0,0.0
209589.0,17,2,180,1,90,0.0,90.0,90.0,1,90,0.0,90.0,90.0
109826055.0,6,33,2428,17,1288,6850638.125,139.0,75.76470588235294,16,1140,7307347.066666666,123.0,71.25
143870.0,17,2,180,1,90,0.0,90.0,90.0,1,90,0.0,90.0,90.0
2339.0,17,4,344,2,150,0.0,75.0,75.0,2,194,0.0,103.0,97.0
90761129.0,6,19,1436,10,745,10080070.0,95.0,74.5,9,691,11344124.125,95.0,76.77777777777777
147111.0,6,3,373,2,238,0.0,172.0,119.0,1,135,0.0,135.0,135.0
118001052.0,17,15,1169,8,606,16857293.14285714,174.0,75.75,7,563,16334532.0,174.0,80.42857142857143
38190.0,6,12,1320,6,723,7221.0,253.0,120.5,6,597,6852.4,259.0,99.5
113377807.0,6,46,3036,23,1518,5140440.409090909,66.0,66.0,23,1518,5140488.681818182,66.0,66.0
112622724.0,6,31,2182,16,1165,7494531.0,139.0,72.8125,15,1017,8029738.571428572,123.0,67.8
307312.0,6,6,412,4,272,102437.33333333331,74.0,68.0,2,140,0.0,74.0,70.0
90053656.0,17,28,13364,28,13364,3335320.592592593,501.0,477.2857142857143,0,0,0.0,0.0,0.0
9879.0,6,10,2032,5,524,2249.75,252.0,104.8,5,1508,1858.5,1236.0,301.6
118094841.0,17,14,864,7,432,19666862.33333333,174.0,61.71428571428572,7,432,19668723.83333333,174.0,61.71428571428572
2644561.0,6,3,1604,1,753,0.0,753.0,753.0,2,851,0.0,785.0,425.5
2988019.0,6,5,336,2,134,0.0,68.0,67.0,3,202,1423632.5,70.0,67.33333333333333
90257499.0,6,12,1832,8,1016,12893928.42857143,188.0,127.0,4,816,30030761.0,204.0,204.0
52504.0,6,14,4740,7,653,8509.166666666666,249.0,93.28571428571428,7,4087,8593.0,1514.0,583.8571428571429
38854.0,6,14,4740,7,653,6137.0,249.0,93.28571428571428,7,4087,6267.5,1514.0,583.8571428571429
4314.0,17,2,614,1,72,0.0,72.0,72.0,1,542,0.0,542.0,542.0
2169400.0,6,24,7544,13,2516,180783.3333333333,1034.0,193.53846153846155,11,5028,185884.4,1510.0,457.09090909090907
254241.0,6,10,1221,6,636,50848.2,298.0,106.0,4,585,79288.66666666667,379.0,146.25
59271.0,6,14,4740,7,653,9750.333333333334,249.0,93.28571428571428,7,4087,9717.333333333334,1514.0,583.8571428571429
19967.0,6,2,145,2,145,0.0,91.0,72.5,0,0,0.0,0.0,0.0
71170.0,6,14,4740,7,653,11737.166666666666,249.0,93.28571428571428,7,4087,9384.666666666666,1514.0,583.8571428571429
0.0,17,1,55,1,55,0.0,55.0,55.0,0,0,0.0,0.0,0.0
111281399.0,6,32,2236,16,1165,7404358.8,139.0,72.8125,16,1071,7404356.0,123.0,66.9375
90284369.0,6,16,1192,8,596,12891516.857142856,95.0,74.5,8,596,12895743.42857143,95.0,74.5
217744.0,6,3,426,2,280,0.0,214.0,140.0,1,146,0.0,146.0,146.0
82.0,17,2,762,2,762,0.0,381.0,381.0,0,0,0.0,0.0,0.0
37014.0,6,14,4740,7,653,6007.0,249.0,93.28571428571428,7,4087,5832.666666666667,1514.0,583.8571428571429
335639.0,6,6,412,4,272,111879.66666666669,74.0,68.0,2,140,0.0,74.0,70.0
1398049.0,6,2,132,1,66,0.0,66.0,66.0,1,66,0.0,66.0,66.0
433928.0,6,3,1604,2,851,0.0,785.0,425.5,1,753,0.0,753.0,753.0
90256262.0,6,16,2368,9,1204,11282032.75,188.0,133.77777777777777,7,1164,15015430.666666666,204.0,166.28571428571428
323618.0,17,4,1400,4,1400,107872.66666666669,350.0,350.0,0,0,0.0,0.0,0.0
121264.0,6,3,337,2,214,0.0,160.0,107.0,1,123,0.0,123.0,123.0
225826.0,6,12,1373,7,714,37637.66666666666,298.0,102.0,5,659,55327.75,379.0,131.8
3005388.0,6,3,1604,2,851,0.0,785.0,425.5,1,753,0.0,753.0,753.0
90245802.0,6,13,2036,8,1016,12892257.42857143,188.0,127.0,5,1020,22520172.5,204.0,204.0
123840208.0,6,49,3234,25,1650,5160008.666666667,66.0,66.0,24,1584,4950114.521739131,66.0,66.0
183555.0,17,2,180,1,90,0.0,90.0,90.0,1,90,0.0,90.0,90.0
108115254.0,17,5,1005,5,1005,27028813.5,201.0,201.0,0,0,0.0,0.0,0.0
1172878.0,6,13,3010,8,2382,167554.0,1514.0,297.75,5,628,224340.5,331.0,125.6
120125185.0,6,14,2224,9,1204,15015648.125,188.0,133.77777777777777,5,1020,22524482.0,204.0,204.0
46834.0,6,13,4412,6,409,9183.0,127.0,68.16666666666667,7,4003,7584.166666666667,1514.0,571.8571428571429
41156.0,6,14,4740,7,653,6696.666666666667,249.0,93.28571428571428,7,4087,6049.833333333333,1514.0,583.8571428571429
20438.0,6,10,1065,5,534,4381.5,262.0,106.8,5,531,4709.0,259.0,106.2
2493148.0,6,3,1777,2,951,0.0,885.0,475.5,1,826,0.0,826.0,826.0
30467.0,6,14,4740,7,653,4960.333333333333,249.0,93.28571428571428,7,4087,4251.666666666667,1514.0,583.8571428571429
135130583.0,17,6,1206,6,1206,27026116.6,201.0,201.0,0,0,0.0,0.0,0.0
97640436.0,6,26,1746,13,906,8136703.0,123.0,69.6923076923077,13,840,8118683.25,123.0,64.61538461538461
205801.0,17,2,180,1,90,0.0,90.0,90.0,1,90,0.0,90.0,90.0
2362.0,17,4,344,2,150,0.0,75.0,75.0,2,194,0.0,103.0,97.0
15594.0,6,14,4740,7,653,2486.833333333333,249.0,93.28571428571428,7,4087,2461.333333333333,1514.0,583.8571428571429
143932.0,17,2,180,1,90,0.0,90.0,90.0,1,90,0.0,90.0,90.0
108109582.0,17,5,955,5,955,27027395.5,191.0,191.0,0,0,0.0,0.0,0.0
108109788.0,17,5,955,5,955,27027447.0,191.0,191.0,0,0,0.0,0.0,0.0
33685.0,6,14,4740,7,653,5493.166666666667,249.0,93.28571428571428,7,4087,5439.333333333333,1514.0,583.8571428571429
5005246.0,17,4,849,2,166,0.0,83.0,83.0,2,683,0.0,499.0,341.5
488300.0,6,3,1604,2,851,0.0,785.0,425.5,1,753,0.0,753.0,753.0
33169.0,6,14,4740,7,653,5161.833333333333,249.0,93.28571428571428,7,4087,5343.666666666667,1514.0,583.8571428571429
1036963.0,6,11,1134,6,558,207392.6,220.0,93.0,5,576,258476.5,304.0,115.2
14170579.0,17,6,2052,6,2052,2834115.8,342.0,342.0,0,0,0.0,0.0,0.0
105273928.0,17,17,2060,9,1299,13125147.75,394.0,144.33333333333334,8,761,15000702.285714284,250.0,95.125
39006.0,6,14,4740,7,653,6308.166666666667,249.0,93.28571428571428,7,4087,5642.5,1514.0,583.8571428571429
28675.0,6,14,4740,7,653,4601.333333333333,249.0,93.28571428571428,7,4087,4592.5,1514.0,583.8571428571429
104787002.0,17,13,4446,13,4446,8732250.166666666,342.0,342.0,0,0,0.0,0.0,0.0
10259.0,6,10,1065,5,534,2340.0,262.0,106.8,5,531,2226.0,259.0,106.2
2793774.0,6,2,132,1,66,0.0,66.0,66.0,1,66,0.0,66.0,66.0
120118691.0,6,13,2036,8,1016,17136614.57142857,188.0,127.0,5,1020,22522890.25,204.0,204.0
2006563.0,6,24,6503,14,2100,154351.0,544.0,150.0,10,4403,208704.22222222225,1514.0,440.3
14588.0,6,10,2032,5,524,2994.0,252.0,104.8,5,1508,3004.25,1236.0,301.6
301465.0,6,6,412,4,272,100488.33333333331,74.0,68.0,2,140,0.0,74.0,70.0
1038385.0,6,11,1134,6,558,207677.00000000003,220.0,93.0,5,576,258379.5,304.0,115.2
46700.0,6,14,4740,7,653,7660.0,249.0,93.28571428571428,7,4087,7326.0,1514.0,583.8571428571429
153387.0,17,2,180,1,90,0.0,90.0,90.0,1,90,0.0,90.0,90.0
131613.0,6,3,337,2,214,0.0,160.0,107.0,1,123,0.0,123.0,123.0
246344.0,6,3,337,2,214,0.0,160.0,107.0,1,123,0.0,123.0,123.0
33650.0,6,10,1066,5,490,7666.75,218.0,98.0,5,576,7717.75,304.0,115.2
108104970.0,17,5,1005,5,1005,27026242.5,201.0,201.0,0,0,0.0,0.0,0.0
49009.0,6,10,2032,5,524,11729.0,252.0,104.8,5,1508,11036.5,1236.0,301.6
146208.0,6,3,337,2,214,0.0,160.0,107.0,1,123,0.0,123.0,123.0
60894.0,6,10,2032,5,524,12779.5,252.0,104.8,5,1508,13363.75,1236.0,301.6
3335054.0,6,4,270,2,134,0.0,68.0,67.0,2,136,0.0,70.0,68.0
90547217.0,6,15,2444,8,1016,12935316.714285716,188.0,127.0,7,1428,15058292.0,204.0,204.0
205632.0,17,2,180,1,90,0.0,90.0,90.0,1,90,0.0,90.0,90.0
14033.0,6,14,4740,7,653,2033.0,249.0,93.28571428571428,7,4087,2203.333333333333,1514.0,583.8571428571429
90081692.0,17,28,13364,28,13364,3336358.962962963,501.0,477.2857142857143,0,0,0.0,0.0,0.0
75612.0,6,12,1413,6,816,14337.0,291.0,136.0,6,597,11458.6,259.0,99.5
10493119.0,6,7,478,4,272,3452038.6666666665,74.0,68.0,3,206,5177954.5,74.0,68.66666666666667
2836442.0,6,2,132,1,66,0.0,66.0,66.0,1,66,0.0,66.0,66.0
90255989.0,6,13,2036,8,1016,12893712.714285716,188.0,127.0,5,1020,22523493.75,204.0,204.0
88977.0,17,2,762,2,762,0.0,381.0,381.0,0,0,0.0,0.0,0.0
216896.0,6,3,426,2,280,0.0,214.0,140.0,1,146,0.0,146.0,146.0
90039292.0,17,27,12943,27,12943,3463049.6923076925,501.0,479.3703703703704,0,0,0.0,0.0,0.0
59398.0,6,14,4740,7,653,9728.666666666666,249.0,93.28571428571428,7,4087,9406.333333333334,1514.0,583.8571428571429
104110.0,17,2,700,2,700,0.0,350.0,350.0,0,0,0.0,0.0,0.0
108101266.0,17,5,955,5,955,27025316.5,191.0,191.0,0,0,0.0,0.0,0.0
216674.0,17,2,180,1,90,0.0,90.0,90.0,1,90,0.0,90.0,90.0
502854.0,6,4,270,2,134,0.0,68.0,67.0,2,136,0.0,70.0,68.0
137899.0,6,2,132,1,66,0.0,66.0,66.0,1,66,0.0,66.0,66.0
301219.0,17,2,180,1,90,0.0,90.0,90.0,1,90,0.0,90.0,90.0
222569.0,6,10,1221,6,636,44513.8,298.0,106.0,4,585,73150.33333333333,379.0,146.25
242175.0,6,10,1221,6,636,48435.0,298.0,106.0,4,585,79429.33333333333,379.0,146.25
143921.0,17,2,180,1,90,0.0,90.0,90.0,1,90,0.0,90.0,90.0
307348.0,6,6,412,4,272,102449.33333333331,74.0,68.0,2,140,0.0,74.0,70.0
771.0,17,4,438,2,148,0.0,74.0,74.0,2,290,0.0,147.0,145.0
56519.0,6,14,4740,7,653,8697.166666666666,249.0,93.28571428571428,7,4087,8730.833333333334,1514.0,583.8571428571429
196980.0,17,2,180,1,90,0.0,90.0,90.0,1,90,0.0,90.0,90.0
135136342.0,17,6,1206,6,1206,27027268.4,201.0,201.0,0,0,0.0,0.0,0.0
101211.0,17,2,762,2,762,0.0,381.0,381.0,0,0,0.0,0.0,0.0
2032.0,17,4,344,2,150,0.0,75.0,75.0,2,194,0.0,103.0,97.0
300167.0,6,6,412,4,272,100055.66666666669,74.0,68.0,2,140,0.0,74.0,70.0
334.0,17,2,166,1,75,0.0,75.0,75.0,1,91,0.0,91.0,91.0
91392804.0,6,22,1680,12,935,8307525.0,95.0,77.91666666666667,10,745,10154401.111111112,95.0,74.5
135130995.0,17,6,1206,6,1206,27026199.0,201.0,201.0,0,0,0.0,0.0,0.0
90093292.0,6,12,1848,5,1020,22522695.5,204.0,204.0,7,828,15015169.666666666,188.0,118.28571428571428
90018661.0,17,27,12943,27,12943,3462256.1923076925,501.0,479.3703703703704,0,0,0.0,0.0,0.0
2018462.0,17,4,525,2,150,0.0,75.0,75.0,2,375,0.0,284.0,187.5
1479544.0,6,20,7599,11,1469,147954.4,583.0,133.54545454545453,9,6130,152873.25,1484.0,681.1111111111111
47659.0,6,14,4740,7,653,7550.0,249.0,93.28571428571428,7,4087,7286.833333333333,1514.0,583.8571428571429
124215100.0,6,30,2037,15,948,8323158.5,123.0,63.2,15,1089,8415894.57142857,123.0,72.6
130833.0,6,2,132,1,66,0.0,66.0,66.0,1,66,0.0,66.0,66.0
94387786.0,6,40,2640,20,1320,4967778.210526316,66.0,66.0,20,1320,4951920.210526316,66.0,66.0
38641.0,6,14,4740,7,653,6320.166666666667,249.0,93.28571428571428,7,4087,6202.166666666667,1514.0,583.8571428571429
235605.0,6,3,373,2,238,0.0,172.0,119.0,1,135,0.0,135.0,135.0
98377450.0,6,29,2052,15,1089,7026960.714285715,123.0,72.6,14,963,7550853.307692308,123.0,68.78571428571429
135141157.0,17,6,1146,6,1146,27028231.4,191.0,191.0,0,0,0.0,0.0,0.0
0.0,17,1,90,1,90,0.0,90.0,90.0,0,0,0.0,0.0,0.0
42667.0,6,10,1975,5,467,10456.5,195.0,93.4,5,1508,10298.75,1236.0,301.6
190551.0,17,6,1230,3,234,95086.5,78.0,78.0,3,996,95066.5,332.0,332.0
280156.0,17,2,363,1,79,0.0,79.0,79.0,1,284,0.0,284.0,284.0
34601.0,6,10,2032,5,524,8428.0,252.0,104.8,5,1508,7958.25,1236.0,301.6
194640.0,17,2,762,2,762,0.0,381.0,381.0,0,0,0.0,0.0,0.0
38520.0,6,10,2032,5,524,8180.25,252.0,104.8,5,1508,9092.25,1236.0,301.6
34645.0,6,14,4740,7,653,5536.5,249.0,93.28571428571428,7,4087,5199.5,1514.0,583.8571428571429
15029.0,17,2,180,1,90,0.0,90.0,90.0,1,90,0.0,90.0,90.0
104357.0,17,2,286,2,286,0.0,143.0,143.0,0,0,0.0,0.0,0.0
5618827.0,6,4,270,2,134,0.0,68.0,67.0,2,136,0.0,70.0,68.0
3052530.0,6,3,204,2,136,0.0,70.0,68.0,1,68,0.0,68.0,68.0
50819.0,17,2,180,1,90,0.0,90.0,90.0,1,90,0.0,90.0,90.0
197119.0,17,2,180,1,90,0.0,90.0,90.0,1,90,0.0,90.0,90.0
92457854.0,6,1919,1659674,1322,1620260,69988.66691900075,1514.0,1225.6127080181543,597,39414,155116.83389261746,78.0,66.02010050251256
99311.0,17,2,762,2,762,0.0,381.0,381.0,0,0,0.0,0.0,0.0
40621.0,6,14,4740,7,653,6560.0,249.0,93.28571428571428,7,4087,5659.0,1514.0,583.8571428571429
239334.0,6,3,337,2,214,0.0,160.0,107.0,1,123,0.0,123.0,123.0
67131.0,17,2,180,1,90,0.0,90.0,90.0,1,90,0.0,90.0,90.0
232627.0,6,3,337,2,214,0.0,160.0,107.0,1,123,0.0,123.0,123.0
47578.0,6,10,2032,5,524,11552.25,252.0,104.8,5,1508,11083.5,1236.0,301.6
220876.0,17,2,414,1,88,0.0,88.0,88.0,1,326,0.0,326.0,326.0
325579.0,17,4,1400,4,1400,108526.33333333331,350.0,350.0,0,0,0.0,0.0,0.0
135134151.0,17,6,1146,6,1146,27026830.2,191.0,191.0,0,0,0.0,0.0,0.0
2020617.0,17,6,1039,4,312,673412.3333333334,78.0,78.0,2,727,0.0,395.0,363.5
2489.0,17,4,344,2,150,0.0,75.0,75.0,2,194,0.0,103.0,97.0
508851.00000000006,6,5,336,2,134,0.0,68.0,67.0,3,202,194370.5,70.0,67.33333333333333
299155.0,6,6,412,4,272,99718.33333333331,74.0,68.0,2,140,0.0,74.0,70.0
108104000.0,17,5,1005,5,1005,27026000.0,201.0,201.0,0,0,0.0,0.0,0.0
93554722.0,17,12,778,6,389,18678930.6,174.0,64.83333333333333,6,389,18686320.8,174.0,64.83333333333333
1676940.0,17,2,876,2,876,0.0,438.0,438.0,0,0,0.0,0.0,0.0
0.0,17,1,453,1,453,0.0,453.0,453.0,0,0,0.0,0.0,0.0
47979.0,6,14,4740,7,653,7759.333333333333,249.0,93.28571428571428,7,4087,6965.833333333333,1514.0,583.8571428571429
157015.0,6,3,337,2,214,0.0,160.0,107.0,1,123,0.0,123.0,123.0
1156992.0,6,13,3000,8,2372,165284.57142857142,1514.0,296.5,5,628,221083.0,331.0,125.6
107648.0,17,2,286,2,286,0.0,143.0,143.0,0,0,0.0,0.0,0.0
101209.0,17,2,762,2,762,0.0,381.0,381.0,0,0,0.0,0.0,0.0
120114414.0,6,344,42338,172,11648,701345.269005848,140.0,67.72093023255815,172,30690,697521.8538011695,374.0,178.43023255813952
111237474.0,6,30,1990,15,1042,7930113.214285715,139.0,69.46666666666667,15,948,7930116.714285715,123.0,63.2
90059290.0,17,28,13364,28,13364,3335529.25925926,501.0,477.2857142857143,0,0,0.0,0.0,0.0
57074.0,6,10,2032,5,524,13406.0,252.0,104.8,5,1508,12343.5,1236.0,301.6
25813.0,6,10,2032,5,524,6233.5,252.0,104.8,5,1508,5548.5,1236.0,301.6
102756.0,17,2,286,2,286,0.0,143.0,143.0,0,0,0.0,0.0,0.0
72149.0,17,2,762,2,762,0.0,381.0,381.0,0,0,0.0,0.0,0.0
108104472.0,17,5,1005,5,1005,27026118.0,201.0,201.0,0,0,0.0,0.0,0.0
71659.0,6,14,4740,7,653,11768.166666666666,249.0,93.28571428571428,7,4087,10726.333333333334,1514.0,583.8571428571429
315395.0,17,4,1400,4,1400,105131.66666666669,350.0,350.0,0,0,0.0,0.0,0.0
503.0,17,2,508,2,508,0.0,257.0,254.0,0,0,0.0,0.0,0.0
58470.0,6,14,4740,7,653,9621.166666666666,249.0,93.28571428571428,7,4087,8048.833333333333,1514.0,583.8571428571429
318.0,17,2,174,1,79,0.0,79.0,79.0,1,95,0.0,95.0,95.0
4299.0,17,2,618,1,72,0.0,72.0,72.0,1,546,0.0,546.0,546.0
0.0,17,1,90,1,90,0.0,90.0,90.0,0,0,0.0,0.0,0.0
1074549.0,6,11,1134,6,558,214909.8,220.0,93.0,5,576,267858.75,304.0,115.2
19046.0,6,2,145,2,145,0.0,91.0,72.5,0,0,0.0,0.0,0.0
113997021.0,6,48,3168,24,1584,4956392.217391305,66.0,66.0,24,1584,4942969.695652174,66.0,66.0
2552035.0,6,23,4355,12,1447,232003.18181818185,311.0,120.58333333333331,11,2908,234641.9,1514.0,264.3636363636364
118786929.0,6,48,3168,24,1584,5164649.0869565215,66.0,66.0,24,1584,5152669.956521739,66.0,66.0
299464.0,6,6,412,4,272,99821.33333333331,74.0,68.0,2,140,0.0,74.0,70.0
108112236.0,17,5,1005,5,1005,27028059.0,201.0,201.0,0,0,0.0,0.0,0.0
90023289.0,17,28,13364,28,13364,3334195.888888889,501.0,477.2857142857143,0,0,0.0,0.0,0.0
90529.0,6,14,4740,7,653,13714.166666666666,249.0,93.28571428571428,7,4087,14142.833333333334,1514.0,583.8571428571429
90259176.0,6,12,1832,8,1016,12894168.0,188.0,127.0,4,816,30030926.33333333,204.0,204.0
113419661.0,6,45,2970,23,1518,5155439.136363637,66.0,66.0,22,1452,4990812.238095238,66.0,66.0
2589661.0,6,2,132,1,66,0.0,66.0,66.0,1,66,0.0,66.0,66.0
1751494.0,6,2,132,1,66,0.0,66.0,66.0,1,66,0.0,66.0,66.0
1675820.0,6,23,6509,12,1529,152347.27272727274,357.0,127.41666666666669,11,4980,137430.0,1510.0,452.7272727272728
1309113.0,6,4,264,2,132,0.0,66.0,66.0,2,132,0.0,66.0,66.0
60048.0,6,14,4740,7,653,9539.166666666666,249.0,93.28571428571428,7,4087,9804.166666666666,1514.0,583.8571428571429
0.0,6,1,66,1,66,0.0,66.0,66.0,0,0,0.0,0.0,0.0
197002.0,17,2,180,1,90,0.0,90.0,90.0,1,90,0.0,90.0,90.0
16264.0,6,10,2032,5,524,3816.25,252.0,104.8,5,1508,3609.5,1236.0,301.6
308142.0,6,6,412,4,272,102714.0,74.0,68.0,2,140,0.0,74.0,70.0
112993.0,17,2,286,2,286,0.0,143.0,143.0,0,0,0.0,0.0,0.0
120550910.0,6,706,108224,355,84688,340539.2937853108,1514.0,238.55774647887324,351,23536,341186.1228571429,214.0,67.05413105413105
120057053.0,17,29,13785,29,13785,4287751.892857143,501.0,475.3448275862069,0,0,0.0,0.0,0.0
2440.0,17,4,344,2,150,0.0,75.0,75.0,2,194,0.0,103.0,97.0
27669064.0,17,5,1710,5,1710,6917266.0,342.0,342.0,0,0,0.0,0.0,0.0
300097.0,6,6,412,4,272,100032.33333333331,74.0,68.0,2,140,0.0,74.0,70.0
102044627.0,6,201,22766,101,6962,1020446.27,140.0,68.93069306930693,100,15804,1020382.4747474748,336.0,158.04
116215244.0,17,16,1212,8,606,16572768.42857143,174.0,75.75,8,606,16571564.857142856,174.0,75.75
1315511.0,6,4,264,2,132,0.0,66.0,66.0,2,132,0.0,66.0,66.0
0.0,6,1,160,1,160,0.0,160.0,160.0,0,0,0.0,0.0,0.0
120377879.0,6,225,25468,113,17780,1074802.4910714286,284.0,157.34513274336285,112,7688,1075196.162162162,140.0,68.64285714285714
143945.0,17,2,180,1,90,0.0,90.0,90.0,1,90,0.0,90.0,90.0
2597655.0,6,2,132,1,66,0.0,66.0,66.0,1,66,0.0,66.0,66.0
825.0,17,4,438,2,148,0.0,74.0,74.0,2,290,0.0,147.0,145.0
153438.0,17,2,180,1,90,0.0,90.0,90.0,1,90,0.0,90.0,90.0
1302503.0,6,4,264,2,132,0.0,66.0,66.0,2,132,0.0,66.0,66.0
111420315.0,6,212,23868,106,16650,1059190.9142857145,284.0,157.0754716981132,106,7218,1059191.8857142858,140.0,68.09433962264151
90297365.0,6,21,1585,11,840,9024758.2,95.0,76.36363636363636,10,745,10002233.222222222,95.0,74.5
47131.0,6,10,2032,5,524,10029.75,252.0,104.8,5,1508,10411.0,1236.0,301.6
103785.0,17,2,286,2,286,0.0,143.0,143.0,0,0,0.0,0.0,0.0
146029.0,6,3,337,2,214,0.0,160.0,107.0,1,123,0.0,123.0,123.0
10269.0,6,10,1975,5,467,2310.75,195.0,93.4,5,1508,1921.5,1236.0,301.6
311705.0,17,4,1400,4,1400,103901.66666666669,350.0,350.0,0,0,0.0,0.0,0.0
118635607.0,6,36,2596,18,1248,6978539.764705882,123.0,69.33333333333333,18,1348,6391194.176470588,139.0,74.88888888888889
120140603.0,6,14,2224,9,1204,15017575.375,188.0,133.77777777777777,5,1020,22593070.25,204.0,204.0
308481.0,6,6,412,4,272,102827.0,74.0,68.0,2,140,0.0,74.0,70.0
0.0,17,1,55,1,55,0.0,55.0,55.0,0,0,0.0,0.0,0.0
29086.0,6,14,4740,7,653,4468.5,249.0,93.28571428571428,7,4087,3501.1666666666665,1514.0,583.8571428571429
15087752.0,6,7,499,4,301,3787333.3333333335,103.0,75.25,3,198,6141473.5,66.0,66.0
120056765.0,17,29,13785,29,13785,4287741.607142857,501.0,475.3448275862069,0,0,0.0,0.0,0.0
120023769.0,17,29,13785,29,13785,4286563.178571428,501.0,475.3448275862069,0,0,0.0,0.0,0.0
123610494.0,6,49,3234,25,1650,5150437.25,66.0,66.0,24,1584,5029887.565217392,66.0,66.0
135133035.0,17,6,1146,6,1146,27026607.0,191.0,191.0,0,0,0.0,0.0,0.0
43140.0,6,10,2032,5,524,10453.25,252.0,104.8,5,1508,10483.75,1236.0,301.6
119000931.0,17,13,821,7,432,19833488.5,174.0,61.71428571428572,6,389,19800784.2,174.0,64.83333333333333
333172.0,6,6,412,4,272,111057.33333333331,74.0,68.0,2,140,0.0,74.0,70.0
108103691.0,17,5,955,5,955,27025922.75,191.0,191.0,0,0,0.0,0.0,0.0
120025723.0,17,29,13785,29,13785,4286632.964285715,501.0,475.3448275862069,0,0,0.0,0.0,0.0
235909.0,6,13,1394,7,797,39318.16666666666,253.0,113.85714285714286,6,597,44580.8,259.0,99.5
55038.0,6,2,132,1,66,0.0,66.0,66.0,1,66,0.0,66.0,66.0
246978.0,17,2,180,1,90,0.0,90.0,90.0,1,90,0.0,90.0,90.0
13713372.0,6,18,1495,9,921,1676313.25,315.0,102.33333333333331,9,574,1676284.125,78.0,63.77777777777778
37513.0,6,14,4740,7,653,6123.333333333333,249.0,93.28571428571428,7,4087,6095.833333333333,1514.0,583.8571428571429
168263.0,17,2,414,1,88,0.0,88.0,88.0,1,326,0.0,326.0,326.0
135136765.0,17,6,1206,6,1206,27027353.0,201.0,201.0,0,0,0.0,0.0,0.0
216729.0,6,3,426,2,280,0.0,214.0,140.0,1,146,0.0,146.0,146.0
15442.0,6,14,4740,7,653,2370.333333333333,249.0,93.28571428571428,7,4087,2430.0,1514.0,583.8571428571429
90038058.0,17,28,13364,28,13364,3334742.888888889,501.0,477.2857142857143,0,0,0.0,0.0,0.0
1172099.0,6,13,3000,8,2372,167442.7142857143,1514.0,296.5,5,628,224077.25,331.0,125.6
375194.0,6,2,132,1,66,0.0,66.0,66.0,1,66,0.0,66.0,66.0
22686.0,6,14,4740,7,653,3316.833333333333,249.0,93.28571428571428,7,4087,3590.0,1514.0,583.8571428571429
106246510.0,6,30,2122,15,1105,7589036.428571428,139.0,73.66666666666667,15,1017,7573588.785714285,123.0,67.8
284674.0,17,2,363,1,79,0.0,79.0,79.0,1,284,0.0,284.0,284.0
437095.0,6,11,1021,6,444,58614.0,162.0,74.0,5,577,73185.25,349.0,115.4
1303169.0,6,4,264,2,132,0.0,66.0,66.0,2,132,0.0,66.0,66.0
26333.0,6,14,4740,7,653,4280.0,249.0,93.28571428571428,7,4087,4251.5,1514.0,583.8571428571429
66033.0,6,14,4740,7,653,10788.333333333334,249.0,93.28571428571428,7,4087,10817.0,1514.0,583.8571428571429
103749.0,6,14,4740,7,653,16927.0,249.0,93.28571428571428,7,4087,7953.5,1514.0,583.8571428571429
0.0,6,1,66,1,66,0.0,66.0,66.0,0,0,0.0,0.0,0.0
104143.0,17,2,286,2,286,0.0,143.0,143.0,0,0,0.0,0.0,0.0
90260601.0,6,12,1832,8,1016,12894371.57142857,188.0,127.0,4,816,30030356.0,204.0,204.0
27361505.0,17,5,1710,5,1710,6840376.25,342.0,342.0,0,0,0.0,0.0,0.0
25319.0,6,14,4740,7,653,4046.6666666666665,249.0,93.28571428571428,7,4087,4082.0,1514.0,583.8571428571429
94536076.0,17,14,4796,13,4446,6227635.25,342.0,342.0,1,350,0.0,350.0,350.0
299515.0,6,6,412,4,272,99838.33333333331,74.0,68.0,2,140,0.0,74.0,70.0
1801679.0,17,3,1026,3,1026,900839.5,342.0,342.0,0,0,0.0,0.0,0.0
90278870.0,6,25,2769,13,1453,7523239.166666667,338.0,111.76923076923076,12,1316,8180000.181818182,426.0,109.66666666666669
213090.0,17,2,762,2,762,0.0,381.0,381.0,0,0,0.0,0.0,0.0
2379.0,17,4,344,2,150,0.0,75.0,75.0,2,194,0.0,103.0,97.0
120005393.0,6,21,1585,11,840,11999997.6,95.0,76.36363636363636,10,745,13332586.777777778,95.0,74.5
112802.0,6,14,4740,7,653,18454.33333333333,249.0,93.28571428571428,7,4087,18051.666666666668,1514.0,583.8571428571429
90259256.0,6,12,1832,8,1016,12894179.42857143,188.0,127.0,4,816,30030647.33333333,204.0,204.0
27077855.0,17,5,1718,4,1368,1804416.6666666667,342.0,342.0,1,350,0.0,350.0,350.0
2344.0,17,4,344,2,150,0.0,75.0,75.0,2,194,0.0,103.0,97.0
120123434.0,6,14,2224,9,1204,15015429.25,188.0,133.77777777777777,5,1020,22523679.75,204.0,204.0
206158.0,6,3,426,2,280,0.0,214.0,140.0,1,146,0.0,146.0,146.0
284246.0,17,2,363,1,79,0.0,79.0,79.0,1,284,0.0,284.0,284.0
297572.0,6,6,412,4,272,99190.66666666669,74.0,68.0,2,140,0.0,74.0,70.0
167582.0,17,2,180,1,90,0.0,90.0,90.0,1,90,0.0,90.0,90.0
36522.0,6,14,4740,7,653,5680.666666666667,249.0,93.28571428571428,7,4087,5897.833333333333,1514.0,583.8571428571429
118041885.0,6,30,1974,15,1026,8416141.57142857,123.0,68.4,15,948,8416156.714285715,123.0,63.2
33449.0,6,14,4740,7,653,5190.666666666667,249.0,93.28571428571428,7,4087,4000.6666666666665,1514.0,583.8571428571429
98794183.0,6,30,2254,15,1086,7056696.357142857,123.0,72.4,15,1168,6737083.428571428,139.0,77.86666666666666
193888.0,17,2,762,2,762,0.0,381.0,381.0,0,0,0.0,0.0,0.0
2097.0,17,4,344,2,150,0.0,75.0,75.0,2,194,0.0,103.0,97.0
100130125.0,17,12,778,6,389,20000157.0,174.0,64.83333333333333,6,389,20000942.2,174.0,64.83333333333333
92915677.0,6,163,18400,82,5634,1147107.12345679,140.0,68.70731707317073,81,12766,1148471.4125,284.0,157.60493827160494
503582.0,6,5,336,2,134,0.0,68.0,67.0,3,202,193774.0,70.0,67.33333333333333
196946.0,17,2,180,1,90,0.0,90.0,90.0,1,90,0.0,90.0,90.0
146406.0,6,3,337,2,214,0.0,160.0,107.0,1,123,0.0,123.0,123.0
111329542.0,6,32,2220,16,1149,7407584.333333333,123.0,71.8125,16,1071,7407582.4,123.0,66.9375
120512411.0,6,31,2034,16,1086,8034160.733333333,123.0,67.875,15,948,7879364.142857143,123.0,63.2
26756.0,6,11,2098,6,590,4207.4,252.0,98.33333333333331,5,1508,6326.25,1236.0,301.6
298265.0,6,6,412,4,272,99421.66666666669,74.0,68.0,2,140,0.0,74.0,70.0
90059469.0,17,28,13364,28,13364,3335535.888888889,501.0,477.2857142857143,0,0,0.0,0.0,0.0
303083.0,6,2,132,1,66,0.0,66.0,66.0,1,66,0.0,66.0,66.0
197016.0,17,2,180,1,90,0.0,90.0,90.0,1,90,0.0,90.0,90.0
163003.0,6,3,337,2,214,0.0,160.0,107.0,1,123,0.0,123.0,123.0
209621.0,17,2,180,1,90,0.0,90.0,90.0,1,90,0.0,90.0,90.0
10506939.0,6,7,478,4,272,3456881.333333333,74.0,68.0,3,206,5185227.5,74.0,68.66666666666667
120000300.0,6,17,1287,9,691,15000037.5,95.0,76.77777777777777,8,596,17105586.285714287,95.0,74.5
9701.0,17,2,582,1,83,0.0,83.0,83.0,1,499,0.0,499.0,499.0
298359.0,6,6,412,4,272,99453.0,74.0,68.0,2,140,0.0,74.0,70.0
1175228.0,6,13,3011,8,2383,167889.7142857143,1514.0,297.875,5,628,224918.0,331.0,125.6
120038047.0,17,28,13364,28,13364,4445853.592592592,501.0,477.2857142857143,0,0,0.0,0.0,0.0
30444.0,6,14,4740,7,653,4945.333333333333,249.0,93.28571428571428,7,4087,4934.0,1514.0,583.8571428571429
143886.0,17,2,180,1,90,0.0,90.0,90.0,1,90,0.0,90.0,90.0
864965.0,6,10,1336,6,799,172993.0,461.0,133.16666666666666,4,537,197497.3333333333,331.0,134.25
220304.0,6,12,1373,7,714,36717.333333333336,298.0,102.0,5,659,53767.0,379.0,131.8
3043104.0,6,3,204,1,68,0.0,68.0,68.0,2,136,0.0,70.0,68.0
21498.0,17,2,582,1,83,0.0,83.0,83.0,1,499,0.0,499.0,499.0
25389358.0,17,5,1718,4,1368,738799.0,342.0,342.0,1,350,0.0,350.0,350.0
223472.0,6,10,1221,6,636,44694.4,298.0,106.0,4,585,72910.66666666667,379.0,146.25
46371.0,6,13,1386,7,789,7233.333333333333,253.0,112.71428571428572,6,597,6976.6,259.0,99.5
100119690.0,17,12,778,6,389,19972296.6,174.0,64.83333333333333,6,389,19992154.4,174.0,64.83333333333333
308101.0,17,4,1400,4,1400,102700.33333333331,350.0,350.0,0,0,0.0,0.0,0.0
120123256.0,6,13,2036,8,1016,17137655.85714286,188.0,127.0,5,1020,22523548.0,204.0,204.0
862213.0,6,9,1268,6,797,172442.6,459.0,132.83333333333334,3,471,293218.0,331.0,157.0
16268180.000000002,17,6,2052,6,2052,3253636.0,342.0,342.0,0,0,0.0,0.0,0.0
97877866.0,6,179,20160,90,6162,1099751.3033707866,140.0,68.46666666666667,89,13998,1100453.7159090908,284.0,157.2808988764045
90257507.0,6,13,2036,8,1016,12893929.57142857,188.0,127.0,5,1020,22523083.0,204.0,204.0
224233.0,6,3,426,2,280,0.0,214.0,140.0,1,146,0.0,146.0,146.0
39480.0,6,14,4740,7,653,6460.833333333333,249.0,93.28571428571428,7,4087,5061.666666666667,1514.0,583.8571428571429
1848160.0,6,7,499,4,301,552631.3333333334,103.0,75.25,3,198,819005.5,66.0,66.0
215218.0,17,2,180,1,90,0.0,90.0,90.0,1,90,0.0,90.0,90.0
20800.0,6,14,4740,7,653,3289.0,249.0,93.28571428571428,7,4087,2899.0,1514.0,583.8571428571429
462882.0,6,3,204,1,68,0.0,68.0,68.0,2,136,0.0,70.0,68.0
1190906.0,6,13,3009,8,2381,170129.42857142858,1514.0,297.625,5,628,229596.0,331.0,125.6
16156.0,6,11,1131,6,600,3004.0,262.0,100.0,5,531,3392.25,259.0,106.2
120005586.0,6,24,1829,13,1030,9999997.833333334,95.0,79.23076923076923,11,799,11971757.8,95.0,72.63636363636364
81052.0,6,14,4740,7,653,13376.166666666666,249.0,93.28571428571428,7,4087,12503.833333333334,1514.0,583.8571428571429
108107655.0,17,5,955,5,955,27026913.75,191.0,191.0,0,0,0.0,0.0,0.0
103617.0,17,2,762,2,762,0.0,381.0,381.0,0,0,0.0,0.0,0.0
63516.0,6,12,1413,6,816,11774.0,291.0,136.0,6,597,11008.8,259.0,99.5
348994.0,6,4,508,2,238,0.0,172.0,119.0,2,270,0.0,135.0,135.0
160195.0,17,2,180,1,90,0.0,90.0,90.0,1,90,0.0,90.0,90.0
120067128.0,17,29,13785,29,13785,4288111.714285715,501.0,475.3448275862069,0,0,0.0,0.0,0.0
34364.0,6,14,4740,7,653,5553.666666666667,249.0,93.28571428571428,7,4087,4765.333333333333,1514.0,583.8571428571429
41391.0,6,14,4740,7,653,6226.0,249.0,93.28571428571428,7,4087,6738.666666666667,1514.0,583.8571428571429
135129898.0,17,6,1146,6,1146,27025979.6,191.0,191.0,0,0,0.0,0.0,0.0
530822.0,17,6,2100,6,2100,106164.4,350.0,350.0,0,0,0.0,0.0,0.0
312795.0,6,6,412,4,272,104265.0,74.0,68.0,2,140,0.0,74.0,70.0
196832.0,17,2,180,1,90,0.0,90.0,90.0,1,90,0.0,90.0,90.0
17401076.0,6,22,7083,12,1641,1581916.0,408.0,136.75,10,5442,1523431.3333333333,1514.0,544.2
454.0,17,2,508,2,508,0.0,257.0,254.0,0,0,0.0,0.0,0.0
205214.0,17,2,762,2,762,0.0,381.0,381.0,0,0,0.0,0.0,0.0
5830420.0,6,5,336,2,134,0.0,68.0,67.0,3,202,1517121.0,70.0,67.33333333333333
435788.0,6,10,1221,6,636,87157.6,298.0,106.0,4,585,138280.66666666666,379.0,146.25
108107644.0,17,5,1005,5,1005,27026911.0,201.0,201.0,0,0,0.0,0.0,0.0
310937.0,17,4,1400,4,1400,103645.66666666669,350.0,350.0,0,0,0.0,0.0,0.0
90256059.0,6,13,2036,8,1016,12893722.714285716,188.0,127.0,5,1020,22523732.75,204.0,204.0
121009301.0,17,15,907,8,475,17287043.0,174.0,59.375,7,432,16833488.833333332,174.0,61.71428571428572
90242253.0,6,14,1043,7,501,15040375.5,95.0,71.57142857142857,7,542,15005725.5,95.0,77.42857142857143
239200.0,17,2,180,1,90,0.0,90.0,90.0,1,90,0.0,90.0,90.0
235652.0,6,12,1373,7,714,39275.333333333336,298.0,102.0,5,659,56323.25,379.0,131.8
2316.0,17,4,344,2,150,0.0,75.0,75.0,2,194,0.0,103.0,97.0
8152361.000000001,17,3,1034,2,684,0.0,342.0,342.0,1,350,0.0,350.0,350.0
206363.0,6,3,426,2,280,0.0,214.0,140.0,1,146,0.0,146.0,146.0
4501.0,17,4,809,2,144,0.0,72.0,72.0,2,665,0.0,538.0,332.5
400610.0,6,4,508,2,238,0.0,172.0,119.0,2,270,0.0,135.0,135.0
1544.0,17,2,192,1,88,0.0,88.0,88.0,1,104,0.0,104.0,104.0
62872.0,6,14,4740,7,653,9661.666666666666,249.0,93.28571428571428,7,4087,8049.166666666667,1514.0,583.8571428571429
216555.0,6,3,426,2,280,0.0,214.0,140.0,1,146,0.0,146.0,146.0
135136352.0,17,6,1146,6,1146,27027270.4,191.0,191.0,0,0,0.0,0.0,0.0
153692.0,17,2,180,1,90,0.0,90.0,90.0,1,90,0.0,90.0,90.0
104675.0,17,2,700,2,700,0.0,350.0,350.0,0,0,0.0,0.0,0.0
117062376.0,6,34,2350,17,1225,7303605.0,139.0,72.05882352941177,17,1125,7303614.4375,123.0,66.17647058823529
90051595.0,17,28,13364,28,13364,3335244.25925926,501.0,477.2857142857143,0,0,0.0,0.0,0.0
121330188.0,6,218,24646,109,7490,1106421.4722222222,140.0,68.71559633027523,109,17156,1115827.4814814816,284.0,157.39449541284404
108669.0,17,2,286,2,286,0.0,143.0,143.0,0,0,0.0,0.0,0.0
93671967.0,6,490,63658,245,16392,383848.9918032787,140.0,66.90612244897959,245,47266,380563.6147540984,390.0,192.92244897959185
234033.0,6,3,373,2,238,0.0,172.0,119.0,1,135,0.0,135.0,135.0
90362151.0,6,12,1848,7,828,15060358.5,188.0,118.28571428571428,5,1020,15083227.0,204.0,204.0
213746.0,17,2,180,1,90,0.0,90.0,90.0,1,90,0.0,90.0,90.0
29197.0,6,14,4740,7,653,4745.833333333333,249.0,93.28571428571428,7,4087,4602.833333333333,1514.0,583.8571428571429
111948015.0,6,51,4120,27,2203,4297389.192307692,139.0,81.5925925925926,24,1917,4857922.956521739,123.0,79.875
135138354.0,17,6,1146,6,1146,27027670.8,191.0,191.0,0,0,0.0,0.0,0.0
117006383.0,17,15,1169,8,606,16715197.57142857,174.0,75.75,7,563,16166801.5,174.0,80.42857142857143
1653242.0,6,8,602,5,404,388802.25,103.0,80.8,3,198,204815.5,66.0,66.0
10523219.0,6,7,478,4,272,3462070.6666666665,74.0,68.0,3,206,5192975.5,74.0,68.66666666666667
403688.0,6,4,508,2,238,0.0,172.0,119.0,2,270,0.0,135.0,135.0
92175084.0,6,28,2168,16,1233,6141788.333333333,95.0,77.0625,12,935,8310175.363636363,95.0,77.91666666666667
79948.0,6,14,4740,7,653,12230.0,249.0,93.28571428571428,7,4087,8819.5,1514.0,583.8571428571429
1194261.0,6,13,3019,8,2391,170608.7142857143,1514.0,298.875,5,628,229645.5,331.0,125.6
219473.0,6,3,426,2,280,0.0,214.0,140.0,1,146,0.0,146.0,146.0
748062.0,6,12,1373,7,714,124677.0,298.0,102.0,5,659,182677.5,379.0,131.8
3656.0,17,2,346,1,78,0.0,78.0,78.0,1,268,0.0,268.0,268.0
120078218.0,17,29,13785,29,13785,4288507.785714285,501.0,475.3448275862069,0,0,0.0,0.0,0.0
99669.0,6,14,4740,7,653,15525.5,249.0,93.28571428571428,7,4087,13259.333333333334,1514.0,583.8571428571429
25220.0,6,10,2032,5,524,4778.75,252.0,104.8,5,1508,5517.75,1236.0,301.6
90253650.0,6,13,2036,8,1016,12893378.57142857,188.0,127.0,5,1020,22520547.0,204.0,204.0
21619145.0,6,6,1981,4,1087,7206381.666666667,885.0,271.75,2,894,0.0,826.0,447.0
107362.0,17,2,286,2,286,0.0,143.0,143.0,0,0,0.0,0.0,0.0
148409.0,17,2,180,1,90,0.0,90.0,90.0,1,90,0.0,90.0,90.0
26177.0,6,14,4740,7,653,3946.6666666666665,249.0,93.28571428571428,7,4087,3457.5,1514.0,583.8571428571429
3469.0,17,4,344,2,150,0.0,75.0,75.0,2,194,0.0,103.0,97.0
1309185.0,6,4,264,2,132,0.0,66.0,66.0,2,132,0.0,66.0,66.0
22792.0,6,11,1132,6,556,3765.0,218.0,92.66666666666669,5,576,4743.5,304.0,115.2
171632.0,17,2,180,1,90,0.0,90.0,90.0,1,90,0.0,90.0,90.0
103191.0,17,2,286,2,286,0.0,143.0,143.0,0,0,0.0,0.0,0.0
149589.0,17,2,180,1,90,0.0,90.0,90.0,1,90,0.0,90.0,90.0
93674744.0,6,180,20316,90,6162,1043169.4943820224,140.0,68.46666666666667,90,14154,1043220.9325842696,284.0,157.26666666666668
9084.0,17,2,582,1,83,0.0,83.0,83.0,1,499,0.0,499.0,499.0
196880.0,17,2,180,1,90,0.0,90.0,90.0,1,90,0.0,90.0,90.0
218612.0,6,3,426,2,280,0.0,214.0,140.0,1,146,0.0,146.0,146.0
146243.0,6,3,337,2,214,0.0,160.0,107.0,1,123,0.0,123.0,123.0
90221187.0,6,24,1829,11,840,8996530.9,95.0,76.36363636363636,13,989,7500440.75,95.0,76.07692307692308
320.0,17,2,174,1,79,0.0,79.0,79.0,1,95,0.0,95.0,95.0
44080.0,6,14,4740,7,653,5377.0,249.0,93.28571428571428,7,4087,6684.333333333333,1514.0,583.8571428571429
135143987.0,17,6,1206,6,1206,27028797.4,201.0,201.0,0,0,0.0,0.0,0.0
146161.0,6,3,337,2,214,0.0,160.0,107.0,1,123,0.0,123.0,123.0
32755.0,6,14,4740,7,653,5311.5,249.0,93.28571428571428,7,4087,5232.666666666667,1514.0,583.8571428571429
143964.0,17,2,180,1,90,0.0,90.0,90.0,1,90,0.0,90.0,90.0
5835601.0,6,5,336,2,134,0.0,68.0,67.0,3,202,1523704.0,70.0,67.33333333333333
37686.0,6,12,1320,6,723,6792.2,253.0,120.5,6,597,5177.4,259.0,99.5
33828.0,6,14,4740,7,653,5376.166666666667,249.0,93.28571428571428,7,4087,4690.666666666667,1514.0,583.8571428571429
120009413.0,17,13,559,7,301,20001568.83333333,43.0,43.0,6,258,20000174.4,43.0,43.0
35920.0,6,14,4740,7,653,5297.0,249.0,93.28571428571428,7,4087,5522.666666666667,1514.0,583.8571428571429
100979138.0,17,14,864,7,432,16803366.666666668,174.0,61.71428571428572,7,432,16787169.0,174.0,61.71428571428572
312173.0,6,6,412,4,272,104057.66666666669,74.0,68.0,2,140,0.0,74.0,70.0
17635.0,6,14,4740,7,653,2519.6666666666665,249.0,93.28571428571428,7,4087,2520.0,1514.0,583.8571428571429
51505.0,6,14,4740,7,653,8402.333333333334,249.0,93.28571428571428,7,4087,8159.666666666667,1514.0,583.8571428571429
285239.0,17,2,363,1,79,0.0,79.0,79.0,1,284,0.0,284.0,284.0
302404.0,6,2,132,1,66,0.0,66.0,66.0,1,66,0.0,66.0,66.0
1316669.0,6,4,264,2,132,0.0,66.0,66.0,2,132,0.0,66.0,66.0
294152.0,6,10,1221,6,636,58830.4,298.0,106.0,4,585,92305.0,379.0,146.25
146317.0,6,3,337,2,214,0.0,160.0,107.0,1,123,0.0,123.0,123.0
29912.0,6,14,4740,7,653,4165.5,249.0,93.28571428571428,7,4087,4713.666666666667,1514.0,583.8571428571429
281368.0,17,2,363,1,79,0.0,79.0,79.0,1,284,0.0,284.0,284.0
119409402.0,17,14,864,7,432,19875081.666666668,174.0,61.71428571428572,7,432,16684200.0,174.0,61.71428571428572
375.0,17,2,267,1,83,0.0,83.0,83.0,1,184,0.0,184.0,184.0
25868.0,17,2,180,1,90,0.0,90.0,90.0,1,90,0.0,90.0,90.0
120043459.0,17,28,13364,28,13364,4446054.037037037,501.0,477.2857142857143,0,0,0.0,0.0,0.0
2729629.0,6,25,7573,14,3735,209971.4615384616,1514.0,266.7857142857143,11,3838,247270.1,1514.0,348.90909090909093
3032.0,17,4,625,2,163,0.0,89.0,81.5,2,462,0.0,245.0,231.0
128020448.0,6,31,2034,16,1086,8534696.533333333,123.0,67.875,15,948,8415670.07142857,123.0,63.2
114616115.0,6,47,3102,24,1584,4983297.260869565,66.0,66.0,23,1518,5143997.045454546,66.0,66.0
249296.0,6,3,337,2,214,0.0,160.0,107.0,1,123,0.0,123.0,123.0
278674.0,17,2,192,1,88,0.0,88.0,88.0,1,104,0.0,104.0,104.0
3809.0,17,4,344,2,150,0.0,75.0,75.0,2,194,0.0,103.0,97.0
27442.0,6,10,2032,5,524,6609.0,252.0,104.8,5,1508,6063.0,1236.0,301.6
58041.0,6,14,4740,7,653,8957.833333333334,249.0,93.28571428571428,7,4087,7439.333333333333,1514.0,583.8571428571429
107264.0,17,2,286,2,286,0.0,143.0,143.0,0,0,0.0,0.0,0.0
116478337.0,6,48,3168,24,1584,5064275.521739131,66.0,66.0,24,1584,5050535.434782608,66.0,66.0
354.0,17,2,267,1,83,0.0,83.0,83.0,1,184,0.0,184.0,184.0
39559.0,6,14,4740,7,653,6467.833333333333,249.0,93.28571428571428,7,4087,6454.5,1514.0,583.8571428571429
147950.0,17,2,180,1,90,0.0,90.0,90.0,1,90,0.0,90.0,90.0
2798996.0,6,2,132,1,66,0.0,66.0,66.0,1,66,0.0,66.0,66.0
123730623.0,6,49,3234,25,1650,5155442.625,66.0,66.0,24,1584,5040628.130434782,66.0,66.0
23493.0,17,4,823,2,163,0.0,89.0,81.5,2,660,0.0,443.0,330.0
385348.0,6,3,204,1,68,0.0,68.0,68.0,2,136,0.0,70.0,68.0
1023497.0,6,11,1134,6,558,204699.4,220.0,93.0,5,576,255299.75,304.0,115.2
121303.0,6,3,337,2,214,0.0,160.0,107.0,1,123,0.0,123.0,123.0
320.0,17,2,156,1,78,0.0,78.0,78.0,1,78,0.0,78.0,78.0
142389.0,6,2,132,1,66,0.0,66.0,66.0,1,66,0.0,66.0,66.0
117312089.0,6,229,25912,115,18092,1029053.4122807018,284.0,157.3217391304348,114,7820,1029044.6902654868,140.0,68.59649122807018
197164.0,17,2,180,1,90,0.0,90.0,90.0,1,90,0.0,90.0,90.0
1774011.0,6,2,132,1,66,0.0,66.0,66.0,1,66,0.0,66.0,66.0
109573899.0,6,32,2220,16,1149,7290536.333333333,123.0,71.8125,16,1071,7290537.866666666,123.0,66.9375
300193.0,6,6,412,4,272,100064.33333333331,74.0,68.0,2,140,0.0,74.0,70.0
42942.0,6,14,4740,7,653,7042.666666666667,249.0,93.28571428571428,7,4087,6970.166666666667,1514.0,583.8571428571429
108101815.0,17,5,1005,5,1005,27025453.75,201.0,201.0,0,0,0.0,0.0,0.0
312156.0,17,4,1400,4,1400,104052.0,350.0,350.0,0,0,0.0,0.0,0.0
52224.0,6,14,4740,7,653,8580.333333333334,249.0,93.28571428571428,7,4087,7897.0,1514.0,583.8571428571429
2877718.0,6,11,2106,6,598,575352.0,252.0,99.66666666666669,5,1508,4404.75,1236.0,301.6
143961.0,17,2,180,1,90,0.0,90.0,90.0,1,90,0.0,90.0,90.0
108103439.0,17,5,955,5,955,27025859.75,191.0,191.0,0,0,0.0,0.0,0.0
0.0,17,1,90,1,90,0.0,90.0,90.0,0,0,0.0,0.0,0.0
117598888.0,6,30,2043,15,1017,8399920.57142857,123.0,67.8,15,1026,8384300.071428572,123.0,68.4
39593.0,6,14,4740,7,653,6479.0,249.0,93.28571428571428,7,4087,6318.666666666667,1514.0,583.8571428571429
46845.0,6,10,2032,5,524,6740.25,252.0,104.8,5,1508,7944.5,1236.0,301.6
223574.0,6,3,426,2,280,0.0,214.0,140.0,1,146,0.0,146.0,146.0
69669.0,6,12,1320,6,723,12630.6,253.0,120.5,6,597,12122.8,259.0,99.5
90256368.0,6,14,1964,8,1016,12893766.857142856,188.0,127.0,6,948,18009367.6,204.0,158.0
216628.0,17,2,180,1,90,0.0,90.0,90.0,1,90,0.0,90.0,90.0
207119.0,6,3,426,2,280,0.0,214.0,140.0,1,146,0.0,146.0,146.0
118719435.0,6,38,2842,19,1471,6595524.166666667,139.0,77.42105263157895,19,1371,6583498.277777778,123.0,72.15789473684211
8191542.0,6,7,499,4,301,2730062.333333333,103.0,75.25,3,198,3985305.0,66.0,66.0
127907842.0,6,35,2473,18,1348,7523990.705882353,139.0,74.88888888888889,17,1125,7421117.6875,123.0,66.17647058823529
871029.0,6,12,1354,6,723,173258.8,253.0,120.5,6,631,173804.8,293.0,105.16666666666669
95661812.0,17,14,4796,13,4446,6227811.333333333,342.0,342.0,1,350,0.0,350.0,350.0
135131777.0,17,6,1146,6,1146,27026355.4,191.0,191.0,0,0,0.0,0.0,0.0
206182.0,17,2,180,1,90,0.0,90.0,90.0,1,90,0.0,90.0,90.0
4343.0,17,2,626,1,72,0.0,72.0,72.0,1,554,0.0,554.0,554.0
9734.0,17,2,582,1,83,0.0,83.0,83.0,1,499,0.0,499.0,499.0
108097303.0,17,5,955,5,955,27024325.75,191.0,191.0,0,0,0.0,0.0,0.0
7117.0,17,2,582,1,83,0.0,83.0,83.0,1,499,0.0,499.0,499.0
1041600.0,6,13,1386,7,789,173600.00000000003,253.0,112.71428571428572,6,597,207542.4,259.0,99.5
128856188.0,6,37,2656,19,1408,7158677.111111111,139.0,74.10526315789474,18,1248,6980371.529411765,123.0,69.33333333333333
123730603.0,6,49,3234,25,1650,5155441.791666667,66.0,66.0,24,1584,5197443.130434782,66.0,66.0
11485.0,17,4,823,2,163,0.0,89.0,81.5,2,660,0.0,443.0,330.0
145882.0,17,2,180,1,90,0.0,90.0,90.0,1,90,0.0,90.0,90.0
2339.0,17,4,344,2,150,0.0,75.0,75.0,2,194,0.0,103.0,97.0
3235.0,17,2,224,1,76,0.0,76.0,76.0,1,148,0.0,148.0,148.0
102219.0,17,2,286,2,286,0.0,143.0,143.0,0,0,0.0,0.0,0.0
114001178.0,17,15,1169,8,606,16285882.57142857,174.0,75.75,7,563,15667466.833333334,174.0,80.42857142857143
90321401.0,6,19,1436,10,745,10030190.222222222,95.0,74.5,9,691,11289847.5,95.0,76.77777777777777
120450471.0,6,22,1680,10,745,10103893.888888888,95.0,74.5,12,935,10927275.181818182,95.0,77.91666666666667
306571.0,6,6,412,4,272,102190.33333333331,74.0,68.0,2,140,0.0,74.0,70.0
321.0,17,2,174,1,79,0.0,79.0,79.0,1,95,0.0,95.0,95.0
330937.0,6,6,412,4,272,110312.33333333331,74.0,68.0,2,140,0.0,74.0,70.0
95543951.0,6,182,20538,91,6228,1052518.3333333333,140.0,68.43956043956044,91,14310,1053886.2333333334,284.0,157.25274725274724
10526954.0,6,6,412,3,206,5195332.0,74.0,68.66666666666667,3,206,5195222.0,74.0,68.66666666666667
102627153.0,6,36,2596,18,1348,6036891.352941177,139.0,74.88888888888889,18,1248,6024170.882352941,123.0,69.33333333333333
113520217.0,6,46,3036,23,1518,5159997.681818182,66.0,66.0,23,1518,5159998.545454546,66.0,66.0
25054.0,6,14,4740,7,653,3986.8333333333335,249.0,93.28571428571428,7,4087,3726.0,1514.0,583.8571428571429
216758.0,6,3,426,2,280,0.0,214.0,140.0,1,146,0.0,146.0,146.0
50330.0,6,14,4740,7,653,8256.5,249.0,93.28571428571428,7,4087,7765.333333333333,1514.0,583.8571428571429
92713124.0,6,38,2508,19,1254,5135436.888888889,66.0,66.0,19,1254,5135441.833333333,66.0,66.0
98030204.0,17,14,1126,7,563,16334911.5,174.0,80.42857142857143,7,563,16333460.5,174.0,80.42857142857143
1192331.0,6,13,3010,8,2382,170333.0,1514.0,297.75,5,628,229143.25,331.0,125.6
9107.0,17,2,582,1,83,0.0,83.0,83.0,1,499,0.0,499.0,499.0
599091.0,17,2,346,1,78,0.0,78.0,78.0,1,268,0.0,268.0,268.0
213974.0,17,2,180,1,90,0.0,90.0,90.0,1,90,0.0,90.0,90.0
146985.0,6,3,373,2,238,0.0,172.0,119.0,1,135,0.0,135.0,135.0
206118.0,17,2,180,1,90,0.0,90.0,90.0,1,90,0.0,90.0,90.0
304.0,17,2,164,1,82,0.0,82.0,82.0,1,82,0.0,82.0,82.0
116838902.0,6,47,3102,24,1584,5079941.695652174,66.0,66.0,23,1518,5160002.409090909,66.0,66.0
238631.0,6,3,337,2,214,0.0,160.0,107.0,1,123,0.0,123.0,123.0
355.0,17,2,160,1,80,0.0,80.0,80.0,1,80,0.0,80.0,80.0
131222.0,17,2,762,2,762,0.0,381.0,381.0,0,0,0.0,0.0,0.0
387506.0,6,3,204,2,136,0.0,70.0,68.0,1,68,0.0,68.0,68.0
220490.0,17,2,180,1,90,0.0,90.0,90.0,1,90,0.0,90.0,90.0
108110481.0,17,5,1005,5,1005,27027620.25,201.0,201.0,0,0,0.0,0.0,0.0
36554.0,6,14,4740,7,653,5494.666666666667,249.0,93.28571428571428,7,4087,5213.166666666667,1514.0,583.8571428571429
143900.0,17,2,180,1,90,0.0,90.0,90.0,1,90,0.0,90.0,90.0
305535.0,6,6,412,4,272,101845.0,74.0,68.0,2,140,0.0,74.0,70.0
2545890.0,6,25,7573,14,3735,195837.6923076923,1514.0,266.7857142857143,11,3838,227952.0,1514.0,348.90909090909093
221223.0,6,3,426,2,280,0.0,214.0,140.0,1,146,0.0,146.0,146.0
304619.0,6,6,412,4,272,101539.66666666669,74.0,68.0,2,140,0.0,74.0,70.0
15136.0,17,2,180,1,90,0.0,90.0,90.0,1,90,0.0,90.0,90.0
253617.0,6,3,337,2,214,0.0,160.0,107.0,1,123,0.0,123.0,123.0
65353.99999999999,6,14,4740,7,653,10177.0,249.0,93.28571428571428,7,4087,10665.666666666666,1514.0,583.8571428571429
102516.0,17,2,762,2,762,0.0,381.0,381.0,0,0,0.0,0.0,0.0
14016.0,6,14,4740,7,653,2180.6666666666665,249.0,93.28571428571428,7,4087,2199.833333333333,1514.0,583.8571428571429
14650059.0,6,22,1719,11,1029,1433533.0,315.0,93.54545454545456,11,690,1433517.9,78.0,62.72727272727273
90031907.0,17,28,13364,28,13364,3334515.074074074,501.0,477.2857142857143,0,0,0.0,0.0,0.0
110955813.0,6,33,2343,17,1194,6934711.625,123.0,70.23529411764706,16,1149,7396937.0,123.0,71.8125
90057763.0,17,28,13364,28,13364,3335472.703703704,501.0,477.2857142857143,0,0,0.0,0.0,0.0
96551856.0,17,14,1126,7,563,16065290.833333334,174.0,80.42857142857143,7,563,15915555.833333334,174.0,80.42857142857143
9573.0,17,2,582,1,83,0.0,83.0,83.0,1,499,0.0,499.0,499.0
209491.0,17,2,180,1,90,0.0,90.0,90.0,1,90,0.0,90.0,90.0
228508.0,17,2,180,1,90,0.0,90.0,90.0,1,90,0.0,90.0,90.0
144021.0,17,2,180,1,90,0.0,90.0,90.0,1,90,0.0,90.0,90.0
90258755.0,6,14,2240,8,1016,12894107.857142856,188.0,127.0,6,1224,18018811.2,204.0,204.0
2119.0,17,2,664,1,322,0.0,322.0,322.0,1,342,0.0,342.0,342.0
2801801.0,6,2,132,1,66,0.0,66.0,66.0,1,66,0.0,66.0,66.0
2004996.0,17,4,525,2,150,0.0,75.0,75.0,2,375,0.0,284.0,187.5
14516.0,6,10,1949,5,441,2969.75,169.0,88.2,5,1508,3033.75,1236.0,301.6
103653103.0,17,14,1126,7,563,17166886.0,174.0,80.42857142857143,7,563,17167457.666666668,174.0,80.42857142857143
315353.0,6,3,202,2,128,0.0,74.0,64.0,1,74,0.0,74.0,74.0
10183.0,6,11,2098,6,590,1995.8,252.0,98.33333333333331,5,1508,2182.0,1236.0,301.6
6863.0,17,2,582,1,83,0.0,83.0,83.0,1,499,0.0,499.0,499.0
235402.0,6,3,337,2,214,0.0,160.0,107.0,1,123,0.0,123.0,123.0
10427710.0,6,7,478,4,272,3430580.6666666665,74.0,68.0,3,206,5145763.5,74.0,68.66666666666667
2376.0,17,4,344,2,150,0.0,75.0,75.0,2,194,0.0,103.0,97.0
204204.0,17,2,762,2,762,0.0,381.0,381.0,0,0,0.0,0.0,0.0
11849.0,6,10,2032,5,524,2400.25,252.0,104.8,5,1508,2659.0,1236.0,301.6
218513.0,6,3,426,2,280,0.0,214.0,140.0,1,146,0.0,146.0,146.0
57068.0,6,14,4740,7,653,7967.333333333333,249.0,93.28571428571428,7,4087,9366.0,1514.0,583.8571428571429
335.0,17,2,166,1,75,0.0,75.0,75.0,1,91,0.0,91.0,91.0
284396.0,17,2,363,1,79,0.0,79.0,79.0,1,284,0.0,284.0,284.0
123456135.0,6,49,3234,25,1650,5144005.625,66.0,66.0,24,1584,5037213.652173913,66.0,66.0
294883.0,17,2,246,1,76,0.0,76.0,76.0,1,170,0.0,170.0,170.0
48632.0,6,10,2032,5,524,11951.25,252.0,104.8,5,1508,11653.25,1236.0,301.6
117677570.0,6,48,3168,24,1584,5116416.0869565215,66.0,66.0,24,1584,5102739.782608695,66.0,66.0
0.0,17,1,179,1,179,0.0,179.0,179.0,0,0,0.0,0.0,0.0
129008714.0,17,15,907,8,475,18429816.285714287,174.0,59.375,7,432,18166861.166666668,174.0,61.71428571428572
90216360.0,6,16,1192,8,596,12852687.285714284,95.0,74.5,8,596,12857148.0,95.0,74.5
541773.0,17,6,2100,6,2100,108354.6,350.0,350.0,0,0,0.0,0.0,0.0
24865.0,6,14,4740,7,653,4032.5,249.0,93.28571428571428,7,4087,4014.5,1514.0,583.8571428571429
250537.0,6,3,337,2,214,0.0,160.0,107.0,1,123,0.0,123.0,123.0
204366.0,17,2,762,2,762,0.0,381.0,381.0,0,0,0.0,0.0,0.0
0.0,17,1,55,1,55,0.0,55.0,55.0,0,0,0.0,0.0,0.0
4402.0,17,2,602,1,72,0.0,72.0,72.0,1,530,0.0,530.0,530.0
2595965.0,6,2,132,1,66,0.0,66.0,66.0,1,66,0.0,66.0,66.0
309801.0,6,6,412,4,272,103267.0,74.0,68.0,2,140,0.0,74.0,70.0
90014352.0,17,28,13364,28,13364,3333864.888888889,501.0,477.2857142857143,0,0,0.0,0.0,0.0
49097.0,6,14,4740,7,653,7709.166666666667,249.0,93.28571428571428,7,4087,7657.166666666667,1514.0,583.8571428571429
15005.0,6,14,4740,7,653,2341.1666666666665,249.0,93.28571428571428,7,4087,2361.833333333333,1514.0,583.8571428571429
110779.0,17,2,286,2,286,0.0,143.0,143.0,0,0,0.0,0.0,0.0
108108487.0,17,5,1005,5,1005,27027121.75,201.0,201.0,0,0,0.0,0.0,0.0
153466.0,17,2,180,1,90,0.0,90.0,90.0,1,90,0.0,90.0,90.0
207200.0,6,10,1221,6,636,41440.0,298.0,106.0,4,585,67574.66666666667,379.0,146.25
824.0,17,4,438,2,148,0.0,74.0,74.0,2,290,0.0,147.0,145.0
90935960.0,6,19,1436,9,691,11366995.0,95.0,76.77777777777777,10,745,10075210.666666666,95.0,74.5
299874.0,6,6,412,4,272,99958.0,74.0,68.0,2,140,0.0,74.0,70.0
246676.0,6,3,337,2,214,0.0,160.0,107.0,1,123,0.0,123.0,123.0
120200923.0,6,23,1859,11,1006,11999543.0,220.0,91.45454545454544,12,853,10905159.454545457,95.0,71.08333333333333
209744.0,6,3,426,2,280,0.0,214.0,140.0,1,146,0.0,146.0,146.0
90190900.0,6,17,1287,8,596,12849554.0,95.0,74.5,9,691,11248130.75,95.0,76.77777777777777
284104.0,17,2,363,1,79,0.0,79.0,79.0,1,284,0.0,284.0,284.0
104312463.0,17,15,5130,15,5130,7450890.214285715,342.0,342.0,0,0,0.0,0.0,0.0
135132602.0,17,6,1206,6,1206,27026520.4,201.0,201.0,0,0,0.0,0.0,0.0
120493222.0,6,2449,2114042,759,50094,158962.03430079157,66.0,66.0,1690,2063948,70729.43812907046,1514.0,1221.2710059171598
105497.0,17,2,286,2,286,0.0,143.0,143.0,0,0,0.0,0.0,0.0
96712716.0,6,26,1746,13,906,8041398.5,123.0,69.6923076923077,13,840,8041400.75,123.0,64.61538461538461
108105717.0,17,5,1005,5,1005,27026429.25,201.0,201.0,0,0,0.0,0.0,0.0
1612.0,6,2,177,1,123,0.0,123.0,123.0,1,54,0.0,54.0,54.0
305447.0,6,6,412,4,272,101815.66666666669,74.0,68.0,2,140,0.0,74.0,70.0
0.0,6,1,66,1,66,0.0,66.0,66.0,0,0,0.0,0.0,0.0
58822371.0,17,9,3086,8,2736,5108608.0,342.0,342.0,1,350,0.0,350.0,350.0
39073.0,6,14,4740,7,653,5986.0,249.0,93.28571428571428,7,4087,5394.0,1514.0,583.8571428571429
90267756.0,6,12,1832,8,1016,12895393.714285716,188.0,127.0,4,816,30028176.666666668,204.0,204.0
3523.0,17,2,414,1,88,0.0,88.0,88.0,1,326,0.0,326.0,326.0
45116.0,6,14,4740,7,653,7408.5,249.0,93.28571428571428,7,4087,6205.166666666667,1514.0,583.8571428571429
3412869.0,6,7,923,4,753,1065595.6666666667,571.0,188.25,3,170,1598604.5,62.0,56.66666666666666
108749843.0,6,32,2220,16,1149,7235591.6,123.0,71.8125,16,1071,7235589.933333334,123.0,66.9375
102324634.0,6,42,2772,21,1386,5105438.2,66.0,66.0,21,1386,5105437.4,66.0,66.0
299345.0,6,6,412,4,272,99781.66666666669,74.0,68.0,2,140,0.0,74.0,70.0
150467.0,17,2,414,1,88,0.0,88.0,88.0,1,326,0.0,326.0,326.0
142361.0,17,4,571,2,148,0.0,74.0,74.0,2,423,0.0,276.0,211.5
14501.0,6,14,4740,7,653,2218.333333333333,249.0,93.28571428571428,7,4087,2270.833333333333,1514.0,583.8571428571429
27279452.0,17,5,1710,5,1710,6819863.0,342.0,342.0,0,0,0.0,0.0,0.0
5005523.0,17,2,168,2,168,0.0,84.0,84.0,0,0,0.0,0.0,0.0
373.0,17,2,176,1,88,0.0,88.0,88.0,1,88,0.0,88.0,88.0
108120977.0,17,5,955,5,955,27030244.25,191.0,191.0,0,0,0.0,0.0,0.0
45455.0,6,13,1479,7,882,7575.833333333333,291.0,126.0,6,597,7522.0,259.0,99.5
10519040.0,6,7,478,4,272,3460890.6666666665,74.0,68.0,3,206,5191202.5,74.0,68.66666666666667
696.0,17,4,438,2,148,0.0,74.0,74.0,2,290,0.0,147.0,145.0
327.0,17,2,208,1,72,0.0,72.0,72.0,1,136,0.0,136.0,136.0
90036893.0,17,28,13364,28,13364,3334699.7407407407,501.0,477.2857142857143,0,0,0.0,0.0,0.0
108182.0,17,2,286,2,286,0.0,143.0,143.0,0,0,0.0,0.0,0.0
143707.0,6,2,132,1,66,0.0,66.0,66.0,1,66,0.0,66.0,66.0
120125097.0,6,14,2224,9,1204,15015637.125,188.0,133.77777777777777,5,1020,22521322.5,204.0,204.0
5001783.0,17,2,174,2,174,0.0,87.0,87.0,0,0,0.0,0.0,0.0
90269056.0,6,12,1832,8,1016,12895579.42857143,188.0,127.0,4,816,30034871.666666668,204.0,204.0
90484579.0,6,182,20538,91,6228,996178.1444444444,140.0,68.43956043956044,91,14310,997501.411111111,284.0,157.25274725274724
38449.0,6,14,4740,7,653,6285.5,249.0,93.28571428571428,7,4087,5903.666666666667,1514.0,583.8571428571429
91198348.0,6,25,1702,13,840,7599862.333333333,123.0,64.61538461538461,12,862,7364345.636363637,139.0,71.83333333333333
120245326.0,6,342,40210,171,11582,702483.0470588235,140.0,67.73099415204679,171,28628,702533.1294117647,284.0,167.41520467836258
108117077.0,17,5,1005,5,1005,27029269.25,201.0,201.0,0,0,0.0,0.0,0.0
233167.0,6,3,337,2,214,0.0,160.0,107.0,1,123,0.0,123.0,123.0
105129533.0,17,15,5130,15,5130,7509252.357142857,342.0,342.0,0,0,0.0,0.0,0.0
100635950.0,17,12,778,6,389,20127190.0,174.0,64.83333333333333,6,389,19989701.8,174.0,64.83333333333333
108101660.0,17,5,1005,5,1005,27025415.0,201.0,201.0,0,0,0.0,0.0,0.0
857058.0,6,9,1096,6,625,171411.6,287.0,104.16666666666669,3,471,290779.0,331.0,157.0
108103367.0,17,5,955,5,955,27025841.75,191.0,191.0,0,0,0.0,0.0,0.0
143399.0,6,2,132,1,66,0.0,66.0,66.0,1,66,0.0,66.0,66.0
25358.0,6,14,4740,7,653,3809.6666666666665,249.0,93.28571428571428,7,4087,4033.0,1514.0,583.8571428571429
23631.0,6,14,4740,7,653,3525.1666666666665,249.0,93.28571428571428,7,4087,3709.0,1514.0,583.8571428571429
309957.0,6,6,412,4,272,103319.0,74.0,68.0,2,140,0.0,74.0,70.0
90046523.0,17,28,13364,28,13364,3335056.407407407,501.0,477.2857142857143,0,0,0.0,0.0,0.0
143844.0,17,2,180,1,90,0.0,90.0,90.0,1,90,0.0,90.0,90.0
208890.0,17,2,180,1,90,0.0,90.0,90.0,1,90,0.0,90.0,90.0
14657628.0,6,20,1607,10,975,1592081.7777777778,315.0,97.5,10,632,1592269.111111111,78.0,63.2
120130735.0,6,12,1832,8,1016,17138373.714285713,188.0,127.0,4,816,30034468.0,204.0,204.0
255199.0,6,3,337,2,214,0.0,160.0,107.0,1,123,0.0,123.0,123.0
2368.0,17,4,344,2,150,0.0,75.0,75.0,2,194,0.0,103.0,97.0
161152.0,6,2,132,1,66,0.0,66.0,66.0,1,66,0.0,66.0,66.0
3424.0,17,4,344,2,150,0.0,75.0,75.0,2,194,0.0,103.0,97.0
294282.0,17,2,246,1,76,0.0,76.0,76.0,1,170,0.0,170.0,170.0
1190685.0,6,13,3010,8,2382,170097.85714285713,1514.0,297.75,5,628,228748.5,331.0,125.6
3033261.0,6,158,125007,88,116085,34865.06896551724,1510.0,1319.1477272727273,70,8922,39452.31884057971,1510.0,127.45714285714286
143958.0,17,2,180,1,90,0.0,90.0,90.0,1,90,0.0,90.0,90.0
97228.0,17,2,762,2,762,0.0,381.0,381.0,0,0,0.0,0.0,0.0
19708.0,17,2,762,2,762,0.0,381.0,381.0,0,0,0.0,0.0,0.0
10816.0,6,11,2098,6,590,1889.8,252.0,98.33333333333331,5,1508,2425.25,1236.0,301.6
330139.0,6,6,412,4,272,110046.33333333331,74.0,68.0,2,140,0.0,74.0,70.0
120936151.0,6,28,2168,12,935,8355884.909090909,95.0,77.91666666666667,16,1233,8046660.133333334,95.0,77.0625
55421.0,6,10,2032,5,524,13609.5,252.0,104.8,5,1508,12427.25,1236.0,301.6
104054078.0,6,205,23046,103,7020,1020138.0196078432,140.0,68.15533980582525,102,16026,1019908.2772277228,284.0,157.11764705882354
2304.0,17,4,344,2,150,0.0,75.0,75.0,2,194,0.0,103.0,97.0
109176653.0,6,203,22824,102,7028,1080956.9603960395,140.0,68.90196078431373,101,15796,1071017.9,284.0,156.3960396039604
569356.0,6,3,198,2,132,0.0,66.0,66.0,1,66,0.0,66.0,66.0
1107064.0,17,2,620,1,75,0.0,75.0,75.0,1,545,0.0,545.0,545.0
107261.0,17,2,286,2,286,0.0,143.0,143.0,0,0,0.0,0.0,0.0
153580.0,17,2,180,1,90,0.0,90.0,90.0,1,90,0.0,90.0,90.0
96255425.0,17,12,778,6,389,19200157.4,174.0,64.83333333333333,6,389,19201987.0,174.0,64.83333333333333
161112.0,6,2,128,1,74,0.0,74.0,74.0,1,54,0.0,54.0,54.0
144148.0,17,2,180,1,90,0.0,90.0,90.0,1,90,0.0,90.0,90.0
120183515.0,6,234,26438,117,7944,1030013.4827586206,140.0,67.8974358974359,117,18494,1029003.8965517242,284.0,158.06837606837607
2832.0,17,4,344,2,150,0.0,75.0,75.0,2,194,0.0,103.0,97.0
97063216.0,6,30,2122,15,1105,6917673.285714285,139.0,73.66666666666667,15,1017,6917674.571428572,123.0,67.8
213598.0,17,2,180,1,90,0.0,90.0,90.0,1,90,0.0,90.0,90.0
2389.0,17,4,344,2,150,0.0,75.0,75.0,2,194,0.0,103.0,97.0
2615390.0,6,25,7573,14,3735,201183.84615384616,1514.0,266.7857142857143,11,3838,235413.6,1514.0,348.90909090909093
323830.0,6,6,412,4,272,107943.33333333331,74.0,68.0,2,140,0.0,74.0,70.0
228441.0,17,2,180,1,90,0.0,90.0,90.0,1,90,0.0,90.0,90.0
221412.0,6,4,504,3,358,110706.0,214.0,119.33333333333331,1,146,0.0,146.0,146.0
15018.0,17,2,180,1,90,0.0,90.0,90.0,1,90,0.0,90.0,90.0
321452.0,17,4,1400,4,1400,107150.66666666669,350.0,350.0,0,0,0.0,0.0,0.0
120038983.0,17,28,13364,28,13364,4445888.259259259,501.0,477.2857142857143,0,0,0.0,0.0,0.0
25114205.0,6,140,31127,72,23842,353721.1971830986,566.0,331.1388888888889,68,7285,370450.2388059702,898.0,107.13235294117646
119604943.0,6,19,1395,10,745,13282608.444444444,95.0,74.5,9,650,14941894.75,95.0,72.22222222222223
1948219.0,6,4,492,2,280,0.0,214.0,140.0,2,212,0.0,146.0,106.0
246244.0,6,3,337,2,214,0.0,160.0,107.0,1,123,0.0,123.0,123.0
2308.0,17,4,344,2,150,0.0,75.0,75.0,2,194,0.0,103.0,97.0
0.0,17,1,350,1,350,0.0,350.0,350.0,0,0,0.0,0.0,0.0
98456498.0,6,37,2904,19,1518,5457814.388888889,123.0,79.89473684210526,18,1386,5778859.823529412,123.0,77.0
40438.0,6,10,2032,5,524,9877.25,252.0,104.8,5,1508,9405.5,1236.0,301.6
120004186.0,6,22,1680,12,935,10909471.454545457,95.0,77.91666666666667,10,745,10105002.333333334,95.0,74.5
90024662.0,17,27,12943,27,12943,3462487.0,501.0,479.3703703703704,0,0,0.0,0.0,0.0
2330.0,17,4,344,2,150,0.0,75.0,75.0,2,194,0.0,103.0,97.0
120032.0,17,2,180,1,70,0.0,70.0,70.0,1,110,0.0,110.0,110.0
70617.0,6,14,4740,7,653,11601.5,249.0,93.28571428571428,7,4087,10843.166666666666,1514.0,583.8571428571429
9025.0,17,2,539,1,86,0.0,86.0,86.0,1,453,0.0,453.0,453.0
198931.0,17,2,180,1,90,0.0,90.0,90.0,1,90,0.0,90.0,90.0
2806713.0,6,2,132,1,66,0.0,66.0,66.0,1,66,0.0,66.0,66.0
51932.0,6,14,4740,7,653,8266.333333333334,249.0,93.28571428571428,7,4087,7525.666666666667,1514.0,583.8571428571429
300971.0,6,6,412,4,272,100323.66666666669,74.0,68.0,2,140,0.0,74.0,70.0
121399.0,6,3,337,2,214,0.0,160.0,107.0,1,123,0.0,123.0,123.0
3004533.0,6,11,2106,6,598,600735.0,252.0,99.66666666666669,5,1508,1683.5,1236.0,301.6
209031.0,6,3,426,2,280,0.0,214.0,140.0,1,146,0.0,146.0,146.0
108102495.0,17,5,1005,5,1005,27025623.75,201.0,201.0,0,0,0.0,0.0,0.0
119501415.0,6,211,23786,106,16560,1138108.7142857143,284.0,156.2264150943396,105,7226,1146778.1153846155,140.0,68.81904761904762
91247937.0,17,12,778,6,389,18249587.4,174.0,64.83333333333333,6,389,18104205.2,174.0,64.83333333333333
303663.0,6,2,132,1,66,0.0,66.0,66.0,1,66,0.0,66.0,66.0
135129734.0,17,6,1146,6,1146,27025946.8,191.0,191.0,0,0,0.0,0.0,0.0
317013.0,17,4,1400,4,1400,105671.0,350.0,350.0,0,0,0.0,0.0,0.0
5623437.0,6,5,336,2,134,0.0,68.0,67.0,3,202,1523074.5,70.0,67.33333333333333
143922.0,17,2,180,1,90,0.0,90.0,90.0,1,90,0.0,90.0,90.0
9299835.0,17,3,1034,2,684,0.0,342.0,342.0,1,350,0.0,350.0,350.0
135122832.0,17,6,1146,6,1146,27024566.4,191.0,191.0,0,0,0.0,0.0,0.0
331.0,17,2,208,1,72,0.0,72.0,72.0,1,136,0.0,136.0,136.0
92707858.0,6,37,2442,19,1254,5150436.555555556,66.0,66.0,18,1188,4996502.411764706,66.0,66.0
31354.0,6,10,2032,5,524,7580.25,252.0,104.8,5,1508,7271.75,1236.0,301.6
120124162.0,6,14,2224,9,1204,15015520.25,188.0,133.77777777777777,5,1020,22590060.5,204.0,204.0
10537756.0,6,7,478,4,272,3467358.333333333,74.0,68.0,3,206,5200920.5,74.0,68.66666666666667
153412.0,17,2,180,1,90,0.0,90.0,90.0,1,90,0.0,90.0,90.0
33754.0,6,14,4740,7,653,5284.0,249.0,93.28571428571428,7,4087,5110.166666666667,1514.0,583.8571428571429
62363.0,6,14,4740,7,653,9744.666666666666,249.0,93.28571428571428,7,4087,10203.833333333334,1514.0,583.8571428571429
2314.0,17,4,344,2,150,0.0,75.0,75.0,2,194,0.0,103.0,97.0
0.0,17,1,84,1,84,0.0,84.0,84.0,0,0,0.0,0.0,0.0
120083522.0,6,326,41124,163,11054,739767.4691358025,140.0,67.8159509202454,163,30070,736980.074074074,480.0,184.478527607362
311406.0,6,6,412,4,272,103802.0,74.0,68.0,2,140,0.0,74.0,70.0
31407.0,6,14,4740,7,653,3228.1666666666665,249.0,93.28571428571428,7,4087,5096.0,1514.0,583.8571428571429
112019615.0,6,30,1974,15,1026,7985981.214285715,123.0,68.4,15,948,7985980.642857143,123.0,63.2
120026776.0,17,29,13785,29,13785,4286670.571428572,501.0,475.3448275862069,0,0,0.0,0.0,0.0
0.0,17,1,99,1,99,0.0,99.0,99.0,0,0,0.0,0.0,0.0
190942.0,17,2,180,1,90,0.0,90.0,90.0,1,90,0.0,90.0,90.0
267752.0,6,10,1221,6,636,53550.4,298.0,106.0,4,585,83475.33333333333,379.0,146.25
103614332.0,6,25,2807,13,1450,8634527.666666666,425.0,111.53846153846152,12,1357,9397184.272727272,336.0,113.08333333333331
146183.0,6,3,337,2,214,0.0,160.0,107.0,1,123,0.0,123.0,123.0
707.0,17,4,438,2,148,0.0,74.0,74.0,2,290,0.0,147.0,145.0
45643.0,6,10,1066,5,490,8597.5,218.0,98.0,5,576,10935.75,304.0,115.2
155105.0,17,2,180,1,90,0.0,90.0,90.0,1,90,0.0,90.0,90.0
170089.0,17,4,571,2,148,0.0,74.0,74.0,2,423,0.0,280.0,211.5
14640066.0,6,20,1607,10,975,1592137.5555555555,315.0,97.5,10,632,1592103.3333333333,78.0,63.2
146152.0,6,3,337,2,214,0.0,160.0,107.0,1,123,0.0,123.0,123.0
90062645.0,17,28,13364,28,13364,3335653.5185185187,501.0,477.2857142857143,0,0,0.0,0.0,0.0
250874.0,17,4,6056,4,6056,83624.66666666667,1514.0,1514.0,0,0,0.0,0.0,0.0
233564.0,6,3,337,2,214,0.0,160.0,107.0,1,123,0.0,123.0,123.0
115295349.0,6,48,3168,24,1584,5012841.260869565,66.0,66.0,24,1584,5003454.695652174,66.0,66.0
172894.0,17,2,604,1,75,0.0,75.0,75.0,1,529,0.0,529.0,529.0
2592440.0,6,2,132,1,66,0.0,66.0,66.0,1,66,0.0,66.0,66.0
213819.0,17,2,180,1,90,0.0,90.0,90.0,1,90,0.0,90.0,90.0
322097.0,17,4,1400,4,1400,107365.66666666669,350.0,350.0,0,0,0.0,0.0,0.0
135131354.0,17,6,1206,6,1206,27026270.8,201.0,201.0,0,0,0.0,0.0,0.0
108109428.0,17,5,1005,5,1005,27027357.0,201.0,201.0,0,0,0.0,0.0,0.0
2395.0,17,4,344,2,150,0.0,75.0,75.0,2,194,0.0,103.0,97.0
21701.0,6,14,4740,7,653,3422.6666666666665,249.0,93.28571428571428,7,4087,3429.333333333333,1514.0,583.8571428571429
10534154.0,6,7,478,4,272,3464146.6666666665,74.0,68.0,3,206,5196114.0,74.0,68.66666666666667
107152.0,17,2,286,2,286,0.0,143.0,143.0,0,0,0.0,0.0,0.0
205627.0,17,2,180,1,90,0.0,90.0,90.0,1,90,0.0,90.0,90.0
2597445.0,6,3,204,2,136,0.0,70.0,68.0,1,68,0.0,68.0,68.0
148089.0,17,2,180,1,90,0.0,90.0,90.0,1,90,0.0,90.0,90.0
313945.0,17,4,1400,4,1400,104648.33333333331,350.0,350.0,0,0,0.0,0.0,0.0
7168419.0,6,15,2287,9,775,896052.375,267.0,86.11111111111111,6,1512,801113.2,616.0,252.0
228356.0,17,2,180,1,90,0.0,90.0,90.0,1,90,0.0,90.0,90.0
198588.0,17,2,180,1,90,0.0,90.0,90.0,1,90,0.0,90.0,90.0
100904.0,17,2,762,2,762,0.0,381.0,381.0,0,0,0.0,0.0,0.0
8727.0,6,10,2032,5,524,1967.5,252.0,104.8,5,1508,1942.5,1236.0,301.6
101045394.0,6,215,24888,108,17604,944349.476635514,300.0,163.0,107,7284,943424.641509434,140.0,68.07476635514018
308179.0,17,4,1400,4,1400,102726.33333333331,350.0,350.0,0,0,0.0,0.0,0.0
402.0,17,2,410,1,78,0.0,78.0,78.0,1,332,0.0,332.0,332.0
12929890.0,6,6,433,4,301,4309963.333333333,103.0,75.25,2,132,0.0,66.0,66.0
149862381.0,17,36,17126,36,17126,4281782.314285714,501.0,475.72222222222223,0,0,0.0,0.0,0.0
148847.0,17,2,414,1,88,0.0,88.0,88.0,1,326,0.0,326.0,326.0
2139343.0,6,37,15535,19,10912,118852.38888888888,1514.0,574.3157894736842,18,4623,112648.0,1514.0,256.8333333333333
103523399.0,6,28,1876,14,982,7946722.307692308,139.0,70.14285714285714,14,894,7946724.846153846,123.0,63.85714285714285
120000087.0,6,17,1287,9,691,15000010.875,95.0,76.77777777777777,8,596,12895240.857142856,95.0,74.5
105106081.0,17,14,864,7,432,17501185.333333332,174.0,61.71428571428572,7,432,17500160.166666668,174.0,61.71428571428572
2370.0,17,4,344,2,150,0.0,75.0,75.0,2,194,0.0,103.0,97.0
1423517.0,17,16,1120,16,1120,94901.13333333332,70.0,70.0,0,0,0.0,0.0,0.0
90043367.0,17,27,12943,27,12943,3463206.423076923,501.0,479.3703703703704,0,0,0.0,0.0,0.0
90680521.0,6,15,2302,9,1204,11315667.0,188.0,133.77777777777777,6,1098,18103852.4,204.0,183.0
205997.0,17,2,180,1,90,0.0,90.0,90.0,1,90,0.0,90.0,90.0
296.0,17,2,156,1,78,0.0,78.0,78.0,1,78,0.0,78.0,78.0
30748.0,6,13,1459,7,862,3773.1666666666665,271.0,123.14285714285714,6,597,4450.0,259.0,99.5
3088.0,17,4,344,2,150,0.0,75.0,75.0,2,194,0.0,103.0,97.0
2373.0,17,4,344,2,150,0.0,75.0,75.0,2,194,0.0,103.0,97.0
196930.0,17,2,180,1,90,0.0,90.0,90.0,1,90,0.0,90.0,90.0
206907.0,6,3,426,2,280,0.0,214.0,140.0,1,146,0.0,146.0,146.0
535.0,17,2,508,2,508,0.0,257.0,254.0,0,0,0.0,0.0,0.0
3179578.0,6,3,1604,1,753,0.0,753.0,753.0,2,851,0.0,785.0,425.5
98460896.0,6,34,2466,17,1272,6153806.0,123.0,74.82352941176471,17,1194,6140298.0625,123.0,70.23529411764706
20334.0,6,14,4740,7,653,3022.1666666666665,249.0,93.28571428571428,7,4087,2690.333333333333,1514.0,583.8571428571429
209589.0,17,2,180,1,90,0.0,90.0,90.0,1,90,0.0,90.0,90.0
3175278.0,6,18,1495,9,921,358963.875,315.0,102.33333333333331,9,574,358951.125,78.0,63.77777777777778
113278671.0,6,1032,237518,504,34152,225158.5149105368,214.0,67.76190476190476,528,203366,214915.2087286528,1514.0,385.1628787878788
232257.0,6,3,337,2,214,0.0,160.0,107.0,1,123,0.0,123.0,123.0
281410.0,17,2,363,1,79,0.0,79.0,79.0,1,284,0.0,284.0,284.0
56180379.0,17,9,3086,8,2736,5198700.428571428,342.0,342.0,1,350,0.0,350.0,350.0
42064.0,6,11,2098,6,590,7536.6,252.0,98.33333333333331,5,1508,9207.5,1236.0,301.6
244221.0,6,3,373,2,238,0.0,172.0,119.0,1,135,0.0,135.0,135.0
120005303.0,6,18,1341,9,691,14999935.875,95.0,76.77777777777777,9,650,14998331.25,95.0,72.22222222222223
2350.0,17,4,344,2,150,0.0,75.0,75.0,2,194,0.0,103.0,97.0
108108928.0,17,5,1005,5,1005,27027232.0,201.0,201.0,0,0,0.0,0.0,0.0
4222.0,17,2,598,1,72,0.0,72.0,72.0,1,526,0.0,526.0,526.0
302.0,17,2,168,1,76,0.0,76.0,76.0,1,92,0.0,92.0,92.0
130056.0,6,3,337,2,214,0.0,160.0,107.0,1,123,0.0,123.0,123.0
103716.0,17,2,286,2,286,0.0,143.0,143.0,0,0,0.0,0.0,0.0
4384.0,17,2,180,1,90,0.0,90.0,90.0,1,90,0.0,90.0,90.0
5010156.0,17,4,376,2,152,0.0,76.0,76.0,2,224,0.0,148.0,112.0
2369.0,17,4,344,2,150,0.0,75.0,75.0,2,194,0.0,103.0,97.0
207449.0,6,3,426,2,280,0.0,214.0,140.0,1,146,0.0,146.0,146.0
28855.0,6,14,4740,7,653,4622.0,249.0,93.28571428571428,7,4087,4364.666666666667,1514.0,583.8571428571429
104070.0,17,2,286,2,286,0.0,143.0,143.0,0,0,0.0,0.0,0.0
312084.0,17,4,1400,4,1400,104028.0,350.0,350.0,0,0,0.0,0.0,0.0
113254884.0,6,46,3036,23,1518,5135439.727272728,66.0,66.0,23,1518,5135441.136363637,66.0,66.0
209574.0,17,2,180,1,90,0.0,90.0,90.0,1,90,0.0,90.0,90.0
597.0,17,2,508,2,508,0.0,257.0,254.0,0,0,0.0,0.0,0.0
241974.0,6,3,337,2,214,0.0,160.0,107.0,1,123,0.0,123.0,123.0
124006596.0,17,15,907,8,475,17715228.0,174.0,59.375,7,432,17333496.666666668,174.0,61.71428571428572
218669.0,6,12,1373,7,714,36444.833333333336,298.0,102.0,5,659,53647.0,379.0,131.8
44131.0,6,14,4740,7,653,4699.833333333333,249.0,93.28571428571428,7,4087,6945.166666666667,1514.0,583.8571428571429
385118.0,6,3,1604,1,753,0.0,753.0,753.0,2,851,0.0,785.0,425.5
1171030.0,6,13,3010,8,2382,167290.0,1514.0,297.75,5,628,223981.25,331.0,125.6
120540985.0,17,15,907,7,432,16833560.5,174.0,61.71428571428572,8,475,17143793.42857143,174.0,59.375
147748.0,17,4,820,2,156,0.0,78.0,78.0,2,664,0.0,332.0,332.0
146090.0,6,3,337,2,214,0.0,160.0,107.0,1,123,0.0,123.0,123.0
135123172.0,17,6,1146,6,1146,27024634.4,191.0,191.0,0,0,0.0,0.0,0.0
31382.0,6,14,4740,7,653,5120.0,249.0,93.28571428571428,7,4087,4300.833333333333,1514.0,583.8571428571429
153507.0,17,2,180,1,90,0.0,90.0,90.0,1,90,0.0,90.0,90.0
1031107.0,6,11,1134,6,558,206221.4,220.0,93.0,5,576,256394.0,304.0,115.2
108105494.0,17,5,955,5,955,27026373.5,191.0,191.0,0,0,0.0,0.0,0.0
2028.0,17,4,344,2,150,0.0,75.0,75.0,2,194,0.0,103.0,97.0
22738.0,6,14,4740,7,653,3617.3333333333335,249.0,93.28571428571428,7,4087,3632.3333333333335,1514.0,583.8571428571429
40271.0,6,14,4740,7,653,6428.0,249.0,93.28571428571428,7,4087,6335.333333333333,1514.0,583.8571428571429
33439.0,6,10,1065,5,534,7832.25,262.0,106.8,5,531,7628.5,259.0,106.2
104824368.0,6,31,2314,16,1228,6973877.0,139.0,76.75,15,1086,7471978.357142857,123.0,72.4
47739.0,6,14,4740,7,653,7345.833333333333,249.0,93.28571428571428,7,4087,7197.166666666667,1514.0,583.8571428571429
91371725.0,6,22,1680,10,786,10152413.888888888,95.0,78.6,12,894,8283481.454545454,95.0,74.5
97444.0,17,2,762,2,762,0.0,381.0,381.0,0,0,0.0,0.0,0.0
108114351.0,17,5,1005,5,1005,27028587.75,201.0,201.0,0,0,0.0,0.0,0.0
2061.0,17,4,344,2,150,0.0,75.0,75.0,2,194,0.0,103.0,97.0
108109331.0,17,5,955,5,955,27027332.75,191.0,191.0,0,0,0.0,0.0,0.0
120009293.0,6,23,1734,12,935,10909078.454545457,95.0,77.91666666666667,11,799,12000704.5,95.0,72.63636363636364
52473.0,6,10,2032,5,524,12898.0,252.0,104.8,5,1508,11233.25,1236.0,301.6
120121158.0,6,13,2036,8,1016,17137331.285714287,188.0,127.0,5,1020,22521874.0,204.0,204.0
111516.0,17,4,1400,4,1400,37172.0,350.0,350.0,0,0,0.0,0.0,0.0
3038886.0,6,3,1604,2,851,0.0,785.0,425.5,1,753,0.0,753.0,753.0
46251.0,6,14,4740,7,653,7011.333333333333,249.0,93.28571428571428,7,4087,7571.0,1514.0,583.8571428571429
412.0,17,2,160,1,80,0.0,80.0,80.0,1,80,0.0,80.0,80.0
313230.0,17,4,1400,4,1400,104410.0,350.0,350.0,0,0,0.0,0.0,0.0
206152.0,6,3,426,2,280,0.0,214.0,140.0,1,146,0.0,146.0,146.0
61534.0,6,14,4740,7,653,10133.833333333334,249.0,93.28571428571428,7,4087,5696.333333333333,1514.0,583.8571428571429
28521.0,6,14,4740,7,653,3541.333333333333,249.0,93.28571428571428,7,4087,4573.333333333333,1514.0,583.8571428571429
956133.0,6,2,132,1,66,0.0,66.0,66.0,1,66,0.0,66.0,66.0
302930.0,6,6,412,4,272,100976.66666666669,74.0,68.0,2,140,0.0,74.0,70.0
304453.0,6,6,412,4,272,101484.33333333331,74.0,68.0,2,140,0.0,74.0,70.0
96397.0,6,12,1328,7,797,16066.166666666666,253.0,113.85714285714286,5,531,18227.75,259.0,106.2
301259.0,17,2,180,1,90,0.0,90.0,90.0,1,90,0.0,90.0,90.0
310432.0,17,4,1400,4,1400,103477.33333333331,350.0,350.0,0,0,0.0,0.0,0.0
120393907.0,6,655,84692,328,62802,368177.0856269113,464.0,191.46951219512195,327,21890,366097.7852760736,140.0,66.94189602446484
1306900.0,6,4,264,2,132,0.0,66.0,66.0,2,132,0.0,66.0,66.0
148044.0,17,2,180,1,90,0.0,90.0,90.0,1,90,0.0,90.0,90.0
2347.0,17,4,344,2,150,0.0,75.0,75.0,2,194,0.0,103.0,97.0
497461.0,6,3,1604,2,851,0.0,785.0,425.5,1,753,0.0,753.0,753.0
97698862.0,6,66,12892,33,6760,3053089.4375,1514.0,204.84848484848484,33,6132,3044868.90625,1514.0,185.8181818181818
50979.0,17,2,180,1,90,0.0,90.0,90.0,1,90,0.0,90.0,90.0
316687.0,17,4,1400,4,1400,105562.33333333331,350.0,350.0,0,0,0.0,0.0,0.0
59588.0,6,10,2032,5,524,13751.75,252.0,104.8,5,1508,12262.0,1236.0,301.6
241972.0,6,3,337,2,214,0.0,160.0,107.0,1,123,0.0,123.0,123.0
135137027.0,17,6,1146,6,1146,27027405.4,191.0,191.0,0,0,0.0,0.0,0.0
381480.0,6,12,1373,7,714,63580.0,298.0,102.0,5,659,94396.0,379.0,131.8
31335.0,6,10,2032,5,524,7620.25,252.0,104.8,5,1508,5925.75,1236.0,301.6
228456.0,17,2,180,1,90,0.0,90.0,90.0,1,90,0.0,90.0,90.0
235525.0,6,3,373,2,238,0.0,172.0,119.0,1,135,0.0,135.0,135.0
44297.0,6,14,4740,7,653,7002.833333333333,249.0,93.28571428571428,7,4087,6777.666666666667,1514.0,583.8571428571429
2456.0,17,4,344,2,150,0.0,75.0,75.0,2,194,0.0,103.0,97.0
10524277.0,6,7,478,4,272,3462644.333333333,74.0,68.0,3,206,5193839.0,74.0,68.66666666666667
296339.0,17,2,246,1,76,0.0,76.0,76.0,1,170,0.0,170.0,170.0
36567351.0,6,5,336,2,134,0.0,68.0,67.0,3,202,18216494.5,70.0,67.33333333333333
219821.0,6,3,426,2,280,0.0,214.0,140.0,1,146,0.0,146.0,146.0
298589.0,6,6,412,4,272,99529.66666666669,74.0,68.0,2,140,0.0,74.0,70.0
39998.0,6,14,4740,7,653,4800.333333333333,249.0,93.28571428571428,7,4087,6077.666666666667,1514.0,583.8571428571429
411.0,17,2,214,1,75,0.0,75.0,75.0,1,139,0.0,139.0,139.0
21684.0,6,10,2032,5,524,5215.5,252.0,104.8,5,1508,4802.25,1236.0,301.6
90292319.0,6,16,1192,8,596,12892394.142857144,95.0,74.5,8,596,12896938.714285716,95.0,74.5
123014161.0,17,15,907,8,475,17573451.57142857,174.0,59.375,7,432,17333547.833333332,174.0,61.71428571428572
93112042.0,6,38,2508,19,1254,5155436.888888889,66.0,66.0,19,1254,5155436.944444444,66.0,66.0
2337.0,17,4,344,2,150,0.0,75.0,75.0,2,194,0.0,103.0,97.0
298.0,17,2,156,1,78,0.0,78.0,78.0,1,78,0.0,78.0,78.0
135116629.0,17,6,1146,6,1146,27023325.8,191.0,191.0,0,0,0.0,0.0,0.0
20377.0,17,2,582,1,83,0.0,83.0,83.0,1,499,0.0,499.0,499.0
17927.0,6,10,2032,5,524,3696.0,252.0,104.8,5,1508,4132.0,1236.0,301.6
104579081.0,17,15,5130,15,5130,7469934.357142857,342.0,342.0,0,0,0.0,0.0,0.0
2800296.0,6,2,132,1,66,0.0,66.0,66.0,1,66,0.0,66.0,66.0
38850.0,6,11,2098,6,590,7563.8,252.0,98.33333333333331,5,1508,9297.75,1236.0,301.6
135131164.0,17,6,1206,6,1206,27026232.8,201.0,201.0,0,0,0.0,0.0,0.0
6783.0,17,2,582,1,83,0.0,83.0,83.0,1,499,0.0,499.0,499.0
471.0,17,2,508,2,508,0.0,257.0,254.0,0,0,0.0,0.0,0.0
205966.0,6,3,426,2,280,0.0,214.0,140.0,1,146,0.0,146.0,146.0
90279314.0,6,17,1287,9,691,11279824.875,95.0,76.77777777777777,8,596,12831324.857142856,95.0,74.5
113594780.0,6,31,2176,16,1071,7572954.666666667,123.0,66.9375,15,1105,7400478.714285715,139.0,73.66666666666667
144015.0,17,2,180,1,90,0.0,90.0,90.0,1,90,0.0,90.0,90.0
171615.0,17,2,180,1,90,0.0,90.0,90.0,1,90,0.0,90.0,90.0
27074304.0,17,5,1710,5,1710,6768576.0,342.0,342.0,0,0,0.0,0.0,0.0
2307.0,17,4,344,2,150,0.0,75.0,75.0,2,194,0.0,103.0,97.0
160179.0,17,2,180,1,90,0.0,90.0,90.0,1,90,0.0,90.0,90.0
148786.0,17,2,180,1,90,0.0,90.0,90.0,1,90,0.0,90.0,90.0
94580620.0,17,12,778,6,389,18800161.0,174.0,64.83333333333333,6,389,18800077.6,174.0,64.83333333333333
301398.0,6,6,412,4,272,100466.0,74.0,68.0,2,140,0.0,74.0,70.0
43412.0,6,10,2032,5,524,9194.75,252.0,104.8,5,1508,10290.5,1236.0,301.6
120116929.0,6,19,2838,10,1392,13328571.111111112,188.0,139.2,9,1446,11260932.5,204.0,160.66666666666666
120532074.0,6,239,27022,120,18872,1012874.5714285716,284.0,157.26666666666668,119,8150,1012726.1101694916,140.0,68.4873949579832
90060052.0,17,28,13364,28,13364,3335557.4814814813,501.0,477.2857142857143,0,0,0.0,0.0,0.0
66609.0,6,10,2032,5,524,16418.25,252.0,104.8,5,1508,14871.25,1236.0,301.6
3426.0,17,4,344,2,150,0.0,75.0,75.0,2,194,0.0,103.0,97.0
96875575.0,17,14,1126,7,563,16119249.833333334,174.0,80.42857142857143,7,563,16112305.166666666,174.0,80.42857142857143
90054662.0,17,28,13364,28,13364,3335357.851851852,501.0,477.2857142857143,0,0,0.0,0.0,0.0
27007.0,6,14,4740,7,653,3891.1666666666665,249.0,93.28571428571428,7,4087,4350.666666666667,1514.0,583.8571428571429
38765438.0,6,14,982,6,437,7752630.8,95.0,72.83333333333333,8,545,5537183.285714285,95.0,68.125
14315827.0,6,6,433,2,132,0.0,66.0,66.0,4,301,4771942.333333333,103.0,75.25
27946.0,6,10,2032,5,524,4543.0,252.0,104.8,5,1508,6728.0,1236.0,301.6
125001187.0,17,15,907,8,475,17857312.42857143,174.0,59.375,7,432,17500933.833333332,174.0,61.71428571428572
108110265.0,17,5,955,5,955,27027566.25,191.0,191.0,0,0,0.0,0.0,0.0
15073.0,17,2,180,1,90,0.0,90.0,90.0,1,90,0.0,90.0,90.0
2032.0,17,2,664,1,322,0.0,322.0,322.0,1,342,0.0,342.0,342.0
70848.0,6,14,4740,7,653,11567.166666666666,249.0,93.28571428571428,7,4087,11486.666666666666,1514.0,583.8571428571429
93367124.0,6,40,2640,20,1320,4914059.157894737,66.0,66.0,20,1320,4898066.421052632,66.0,66.0
235325.0,6,3,337,2,214,0.0,160.0,107.0,1,123,0.0,123.0,123.0
318.0,17,2,166,1,75,0.0,75.0,75.0,1,91,0.0,91.0,91.0
106775307.0,17,14,864,7,432,17666835.5,174.0,61.71428571428572,7,432,17667554.5,174.0,61.71428571428572
144890.0,17,2,180,1,70,0.0,70.0,70.0,1,110,0.0,110.0,110.0
314543.0,17,4,1400,4,1400,104847.66666666669,350.0,350.0,0,0,0.0,0.0,0.0
938461.0,17,4,820,2,156,0.0,78.0,78.0,2,664,0.0,332.0,332.0
106960334.0,6,33,2428,17,1288,6671148.1875,139.0,75.76470588235294,16,1140,7115892.666666667,123.0,71.25
0.0,17,1,44,1,44,0.0,44.0,44.0,0,0,0.0,0.0,0.0
25567.0,17,2,582,1,83,0.0,83.0,83.0,1,499,0.0,499.0,499.0
100375370.0,17,12,516,6,258,20001389.0,43.0,43.0,6,258,20000165.8,43.0,43.0
213490.0,6,3,426,2,280,0.0,214.0,140.0,1,146,0.0,146.0,146.0
10528144.0,6,6,412,3,206,5193384.0,74.0,68.66666666666667,3,206,5193293.5,74.0,68.66666666666667
10565492.0,6,7,478,4,272,3474815.333333333,74.0,68.0,3,206,5212096.5,74.0,68.66666666666667
196865.0,17,2,180,1,90,0.0,90.0,90.0,1,90,0.0,90.0,90.0
90259283.0,6,12,1832,8,1016,12894183.285714284,188.0,127.0,4,816,30032450.666666668,204.0,204.0
204575.0,17,2,762,2,762,0.0,381.0,381.0,0,0,0.0,0.0,0.0
233815.0,6,3,337,2,214,0.0,160.0,107.0,1,123,0.0,123.0,123.0
47316.0,6,14,4740,7,653,7713.166666666667,249.0,93.28571428571428,7,4087,7511.833333333333,1514.0,583.8571428571429
36776.0,6,14,4740,7,653,5593.0,249.0,93.28571428571428,7,4087,5919.0,1514.0,583.8571428571429
31726.0,6,12,1413,7,882,5287.666666666667,291.0,126.0,5,531,7148.25,259.0,106.2
107272.0,17,2,286,2,286,0.0,143.0,143.0,0,0,0.0,0.0,0.0
107485.0,17,2,700,2,700,0.0,350.0,350.0,0,0,0.0,0.0,0.0
108106732.0,17,5,1005,5,1005,27026683.0,201.0,201.0,0,0,0.0,0.0,0.0
65655.0,6,14,4740,7,653,10544.0,249.0,93.28571428571428,7,4087,9833.166666666666,1514.0,583.8571428571429
1403846.0,17,16,1120,16,1120,93589.73333333334,70.0,70.0,0,0,0.0,0.0,0.0
2841930.0,6,4,270,3,202,1420965.0,70.0,67.33333333333333,1,68,0.0,68.0,68.0
130731.0,6,3,337,2,214,0.0,160.0,107.0,1,123,0.0,123.0,123.0
4001494.0,6,5,336,2,134,0.0,68.0,67.0,3,202,1534486.0,70.0,67.33333333333333
25479.0,6,14,4740,7,653,4107.333333333333,249.0,93.28571428571428,7,4087,4108.0,1514.0,583.8571428571429
179767.0,17,2,180,1,90,0.0,90.0,90.0,1,90,0.0,90.0,90.0
202821.0,17,2,762,2,762,0.0,381.0,381.0,0,0,0.0,0.0,0.0
228215.0,17,2,180,1,90,0.0,90.0,90.0,1,90,0.0,90.0,90.0
3014889.0,6,3,1777,2,951,0.0,885.0,475.5,1,826,0.0,826.0,826.0
59612.0,6,14,4740,7,653,9808.833333333334,249.0,93.28571428571428,7,4087,8231.833333333334,1514.0,583.8571428571429
146131.0,6,3,337,2,214,0.0,160.0,107.0,1,123,0.0,123.0,123.0
121454.0,6,3,337,2,214,0.0,160.0,107.0,1,123,0.0,123.0,123.0
811.0,17,5,550,5,550,202.75,110.0,110.0,0,0,0.0,0.0,0.0
120121327.0,6,1006,159400,503,125968,238856.2788844621,570.0,250.4333996023857,503,33432,238856.46812749005,140.0,66.46520874751491
106668.0,17,2,286,2,286,0.0,143.0,143.0,0,0,0.0,0.0,0.0
124012641.0,17,17,1255,9,649,15501580.125,174.0,72.11111111111111,8,606,14833425.857142856,174.0,75.75
10529091.0,6,7,478,4,272,3464388.6666666665,74.0,68.0,3,206,5196478.0,74.0,68.66666666666667
3577507.0,6,5,336,2,134,0.0,68.0,67.0,3,202,1526049.0,70.0,67.33333333333333
90927366.0,6,153,17274,77,5304,1196412.7105263155,140.0,68.88311688311688,76,11970,1202008.9466666668,284.0,157.5
838.0,17,5,550,5,550,209.5,110.0,110.0,0,0,0.0,0.0,0.0
80023.0,6,14,4740,7,653,13215.833333333334,249.0,93.28571428571428,7,4087,7767.0,1514.0,583.8571428571429
31647.0,6,10,2032,5,524,7684.5,252.0,104.8,5,1508,7417.5,1236.0,301.6
0.0,17,1,90,1,90,0.0,90.0,90.0,0,0,0.0,0.0,0.0
113431438.0,6,45,2970,23,1518,5155974.454545454,66.0,66.0,22,1452,5037698.619047619,66.0,66.0
113254991.0,6,46,3036,23,1518,5135440.318181818,66.0,66.0,23,1518,5135441.7727272725,66.0,66.0
99758346.0,17,12,778,6,389,19919636.8,174.0,64.83333333333333,6,389,19776731.4,174.0,64.83333333333333
27857.0,6,10,2032,5,524,6618.25,252.0,104.8,5,1508,6636.5,1236.0,301.6
720491.0,6,2,132,1,66,0.0,66.0,66.0,1,66,0.0,66.0,66.0
333.0,17,2,166,1,75,0.0,75.0,75.0,1,91,0.0,91.0,91.0
111998521.0,6,36,2596,18,1348,6575452.05882353,139.0,74.88888888888889,18,1248,6575461.823529412,123.0,69.33333333333333
251321.00000000003,17,2,876,2,876,0.0,438.0,438.0,0,0,0.0,0.0,0.0
307200.0,6,6,412,4,272,102400.0,74.0,68.0,2,140,0.0,74.0,70.0
120168.0,17,2,180,1,70,0.0,70.0,70.0,1,110,0.0,110.0,110.0
16634.0,6,11,1132,6,556,2918.4,218.0,92.66666666666669,5,576,3865.75,304.0,115.2
108103520.0,17,5,955,5,955,27025880.0,191.0,191.0,0,0,0.0,0.0,0.0
219690.0,6,10,1221,6,636,43938.0,298.0,106.0,4,585,71780.66666666667,379.0,146.25
858488.0,6,9,1196,6,725,171697.6,387.0,120.83333333333331,3,471,292681.5,331.0,157.0
108946.0,17,2,286,2,286,0.0,143.0,143.0,0,0,0.0,0.0,0.0
211140.0,6,10,1221,6,636,42228.0,298.0,106.0,4,585,69005.0,379.0,146.25
27753.0,6,14,4740,7,653,3756.8333333333335,249.0,93.28571428571428,7,4087,4448.0,1514.0,583.8571428571429
44176.0,6,10,2032,5,524,10180.0,252.0,104.8,5,1508,9629.5,1236.0,301.6
298858.0,17,2,238,1,74,0.0,74.0,74.0,1,164,0.0,164.0,164.0
35039.0,6,10,2032,5,524,8411.75,252.0,104.8,5,1508,7915.5,1236.0,301.6
192366.0,17,2,180,1,90,0.0,90.0,90.0,1,90,0.0,90.0,90.0
32994.0,17,4,344,2,150,0.0,75.0,75.0,2,194,0.0,103.0,97.0
90840868.0,6,661,120906,335,98946,271978.6467065868,1514.0,295.3611940298508,326,21960,278816.36615384615,214.0,67.36196319018404
193917.0,17,2,180,1,90,0.0,90.0,90.0,1,90,0.0,90.0,90.0
40094.0,6,14,4740,7,653,5936.0,249.0,93.28571428571428,7,4087,3883.0,1514.0,583.8571428571429
219752.0,6,3,426,2,280,0.0,214.0,140.0,1,146,0.0,146.0,146.0
20420.0,17,2,180,1,90,0.0,90.0,90.0,1,90,0.0,90.0,90.0
38821.0,6,10,2032,5,524,7378.0,252.0,104.8,5,1508,8701.75,1236.0,301.6
1671658.0,6,8,602,3,198,205796.5,66.0,66.0,5,404,392861.25,103.0,80.8
135140556.0,17,6,1206,6,1206,27028111.2,201.0,201.0,0,0,0.0,0.0,0.0
115243698.0,6,48,3168,24,1584,5010595.565217392,66.0,66.0,24,1584,4997501.304347826,66.0,66.0
352.0,17,2,267,1,83,0.0,83.0,83.0,1,184,0.0,184.0,184.0
216707.0,6,3,426,2,280,0.0,214.0,140.0,1,146,0.0,146.0,146.0
97439550.0,6,25,1686,13,840,8119962.5,123.0,64.61538461538461,12,846,7931860.454545454,123.0,70.5
216690.0,6,3,426,2,280,0.0,214.0,140.0,1,146,0.0,146.0,146.0
148119.0,17,2,180,1,90,0.0,90.0,90.0,1,90,0.0,90.0,90.0
28067.0,6,14,4740,7,653,3977.6666666666665,249.0,93.28571428571428,7,4087,4232.333333333333,1514.0,583.8571428571429
2907172.0,6,3,1604,1,753,0.0,753.0,753.0,2,851,0.0,785.0,425.5
108109364.0,17,5,955,5,955,27027341.0,191.0,191.0,0,0,0.0,0.0,0.0
112213577.0,17,14,864,7,432,18667520.83333333,174.0,61.71428571428572,7,432,18666832.83333333,174.0,61.71428571428572
106576.0,17,2,700,2,700,0.0,350.0,350.0,0,0,0.0,0.0,0.0
103306.0,17,2,286,2,286,0.0,143.0,143.0,0,0,0.0,0.0,0.0
89192.0,17,3,1143,3,1143,44596.0,381.0,381.0,0,0,0.0,0.0,0.0
504433.0,6,5,336,2,134,0.0,68.0,67.0,3,202,192122.5,70.0,67.33333333333333
119999247.0,17,35,16705,35,16705,3529389.617647059,501.0,477.2857142857143,0,0,0.0,0.0,0.0
45014.0,6,10,2032,5,524,10905.0,252.0,104.8,5,1508,9195.75,1236.0,301.6
18435.0,6,11,2098,6,590,2669.8,252.0,98.33333333333331,5,1508,4145.5,1236.0,301.6
109258857.0,17,14,864,7,432,18166841.666666668,174.0,61.71428571428572,7,432,18167494.666666668,174.0,61.71428571428572
2790.0,17,4,344,2,150,0.0,75.0,75.0,2,194,0.0,103.0,97.0
306277.0,6,6,412,4,272,102092.33333333331,74.0,68.0,2,140,0.0,74.0,70.0
302421.0,6,2,132,1,66,0.0,66.0,66.0,1,66,0.0,66.0,66.0
90271622.0,6,16,1192,8,596,12895946.0,95.0,74.5,8,596,12854687.857142856,95.0,74.5
806.0,17,4,438,2,148,0.0,74.0,74.0,2,290,0.0,147.0,145.0
2169.0,17,2,684,1,342,0.0,342.0,342.0,1,342,0.0,342.0,342.0
2021851.0,17,4,525,2,150,0.0,75.0,75.0,2,375,0.0,284.0,187.5
122464.0,6,3,337,2,214,0.0,160.0,107.0,1,123,0.0,123.0,123.0
42182.0,6,14,4740,7,653,6856.0,249.0,93.28571428571428,7,4087,6861.0,1514.0,583.8571428571429
149940723.0,17,36,17126,36,17126,4284020.657142857,501.0,475.72222222222223,0,0,0.0,0.0,0.0
309.0,17,2,208,1,72,0.0,72.0,72.0,1,136,0.0,136.0,136.0
228132.0,17,2,180,1,90,0.0,90.0,90.0,1,90,0.0,90.0,90.0
105776.0,17,2,700,2,700,0.0,350.0,350.0,0,0,0.0,0.0,0.0
1241686.0,6,10,1334,6,797,248337.2,459.0,132.83333333333334,4,537,322029.0,331.0,134.25
373.0,17,2,174,1,79,0.0,79.0,79.0,1,95,0.0,95.0,95.0
99251163.0,6,26,1746,13,906,8252940.666666667,123.0,69.6923076923077,13,840,8252940.583333333,123.0,64.61538461538461
217153.0,17,2,180,1,90,0.0,90.0,90.0,1,90,0.0,90.0,90.0
160134.0,17,2,180,1,90,0.0,90.0,90.0,1,90,0.0,90.0,90.0
29585.0,6,2,145,2,145,0.0,91.0,72.5,0,0,0.0,0.0,0.0
503095.0,6,6,758,3,410,214102.5,172.0,136.66666666666666,3,348,179281.5,135.0,116.0
104494903.0,17,14,864,7,432,17415817.166666668,174.0,61.71428571428572,7,432,17335053.5,174.0,61.71428571428572
5004170.0,17,4,849,2,166,0.0,83.0,83.0,2,683,0.0,499.0,341.5
115042846.0,6,202,22758,101,6888,1142106.52,140.0,68.1980198019802,101,15870,1131880.27,284.0,157.12871287128712
108107653.0,17,5,1005,5,1005,27026913.25,201.0,201.0,0,0,0.0,0.0,0.0
300848.0,6,6,412,4,272,100282.66666666669,74.0,68.0,2,140,0.0,74.0,70.0
208657.0,6,3,426,2,280,0.0,214.0,140.0,1,146,0.0,146.0,146.0
248034.0,6,3,337,2,214,0.0,160.0,107.0,1,123,0.0,123.0,123.0
220011.0,17,2,180,1,90,0.0,90.0,90.0,1,90,0.0,90.0,90.0
16931.0,6,14,4740,7,653,2712.1666666666665,249.0,93.28571428571428,7,4087,2685.0,1514.0,583.8571428571429
120125567.0,6,13,2020,9,1204,15015695.875,188.0,133.77777777777777,4,816,30032127.666666668,204.0,204.0
118650135.0,6,218,24550,109,17134,1096619.0833333333,284.0,157.19266055045873,109,7416,1096619.7962962964,140.0,68.03669724770643
14929.0,6,10,2032,5,524,3302.75,252.0,104.8,5,1508,3285.25,1236.0,301.6
0.0,6,1,66,1,66,0.0,66.0,66.0,0,0,0.0,0.0,0.0
0.0,6,1,66,1,66,0.0,66.0,66.0,0,0,0.0,0.0,0.0
43174.0,6,14,4740,7,653,7025.0,249.0,93.28571428571428,7,4087,7057.833333333333,1514.0,583.8571428571429
22942.0,6,14,4740,7,653,3116.333333333333,249.0,93.28571428571428,7,4087,3617.5,1514.0,583.8571428571429
162761.0,6,3,337,2,214,0.0,160.0,107.0,1,123,0.0,123.0,123.0
108108947.0,17,5,1005,5,1005,27027236.75,201.0,201.0,0,0,0.0,0.0,0.0
90096986.0,6,10,1440,7,828,15016164.333333334,188.0,118.28571428571428,3,612,30033665.5,204.0,204.0
123969134.0,6,31,2050,16,1102,8264608.933333334,139.0,68.875,15,948,8126172.5,123.0,63.2
36598.0,6,10,2032,5,524,8900.25,252.0,104.8,5,1508,7296.0,1236.0,301.6
206334.0,6,3,426,2,280,0.0,214.0,140.0,1,146,0.0,146.0,146.0
118105014.0,17,14,864,7,432,19666821.0,174.0,61.71428571428572,7,432,19669097.83333333,174.0,61.71428571428572
197171.0,17,2,180,1,90,0.0,90.0,90.0,1,90,0.0,90.0,90.0
485.0,17,2,508,2,508,0.0,257.0,254.0,0,0,0.0,0.0,0.0
249891.0,6,3,337,2,214,0.0,160.0,107.0,1,123,0.0,123.0,123.0
120015394.0,6,522,96388,263,78776,457252.8778625954,1514.0,299.52851711026614,259,17612,464342.05426356586,214.0,68.0
18803.0,6,14,4740,7,653,3025.1666666666665,249.0,93.28571428571428,7,4087,2752.1666666666665,1514.0,583.8571428571429
10478410.0,6,7,478,4,272,3445516.0,74.0,68.0,3,206,5168154.0,74.0,68.66666666666667
2197.0,17,2,684,1,342,0.0,342.0,342.0,1,342,0.0,342.0,342.0
486.0,17,2,508,2,508,0.0,257.0,254.0,0,0,0.0,0.0,0.0
360944.0,6,11,1021,6,444,48504.4,162.0,74.0,5,577,60440.5,349.0,115.4
2517446.0,6,3,1777,1,826,0.0,826.0,826.0,2,951,0.0,885.0,475.5
317278.0,17,4,1400,4,1400,105759.33333333331,350.0,350.0,0,0,0.0,0.0,0.0
90525869.0,6,14,2240,8,1016,12932267.0,188.0,127.0,6,1224,18071809.2,204.0,204.0
18425.0,6,10,2032,5,524,4350.5,252.0,104.8,5,1508,2704.25,1236.0,301.6
1306195.0,6,4,264,2,132,0.0,66.0,66.0,2,132,0.0,66.0,66.0
136237.0,6,2,132,1,66,0.0,66.0,66.0,1,66,0.0,66.0,66.0
120365817.0,6,253,29116,127,20504,955284.261904762,284.0,161.4488188976378,126,8612,954709.384,140.0,68.34920634920636
205736.0,17,2,180,1,90,0.0,90.0,90.0,1,90,0.0,90.0,90.0
323285.0,17,4,1400,4,1400,107761.66666666669,350.0,350.0,0,0,0.0,0.0,0.0
183422.0,17,4,1524,4,1524,61140.66666666666,381.0,381.0,0,0,0.0,0.0,0.0
57331.0,6,10,2032,5,524,14065.5,252.0,104.8,5,1508,13645.0,1236.0,301.6
121173.0,6,3,337,2,214,0.0,160.0,107.0,1,123,0.0,123.0,123.0
31543.0,6,10,2032,5,524,6667.25,252.0,104.8,5,1508,7396.25,1236.0,301.6
119555503.0,6,22,1639,12,894,10864311.181818182,95.0,74.5,10,745,13278619.222222222,95.0,74.5
135136768.0,17,6,1146,6,1146,27027353.6,191.0,191.0,0,0,0.0,0.0,0.0
229350.0,6,3,426,2,280,0.0,214.0,140.0,1,146,0.0,146.0,146.0
95546446.0,17,14,4796,13,4446,6223829.25,342.0,342.0,1,350,0.0,350.0,350.0
2415.0,17,4,344,2,150,0.0,75.0,75.0,2,194,0.0,103.0,97.0
2045.0,17,4,344,2,150,0.0,75.0,75.0,2,194,0.0,103.0,97.0
305271.0,6,6,412,4,272,101757.0,74.0,68.0,2,140,0.0,74.0,70.0
39809.0,6,14,4740,7,653,6354.5,249.0,93.28571428571428,7,4087,6297.5,1514.0,583.8571428571429
42686.0,6,14,4740,7,653,5869.833333333333,249.0,93.28571428571428,7,4087,6302.333333333333,1514.0,583.8571428571429
2795346.0,6,2,132,1,66,0.0,66.0,66.0,1,66,0.0,66.0,66.0
35248.0,6,10,2032,5,524,8503.5,252.0,104.8,5,1508,5938.0,1236.0,301.6
90529380.0,6,13,2036,8,1016,12932768.57142857,188.0,127.0,5,1020,22591755.25,204.0,204.0
120094424.0,6,222,25106,111,7548,1084326.2818181815,140.0,68.0,111,17558,1075973.790909091,284.0,158.18018018018017
10467385.0,6,7,478,4,272,3443594.6666666665,74.0,68.0,3,206,5165248.0,74.0,68.66666666666667
26409830.0,17,5,1718,4,1368,801378.3333333334,342.0,342.0,1,350,0.0,350.0,350.0
47902.0,6,14,4740,7,653,7866.333333333333,249.0,93.28571428571428,7,4087,7687.5,1514.0,583.8571428571429
108103940.0,17,5,1005,5,1005,27025985.0,201.0,201.0,0,0,0.0,0.0,0.0
50221.0,6,10,2032,5,524,12343.25,252.0,104.8,5,1508,9477.5,1236.0,301.6
149088819.0,6,20,1490,11,840,14908881.9,95.0,76.36363636363636,9,650,14920612.5,95.0,72.22222222222223
2350043.0,6,2,132,1,66,0.0,66.0,66.0,1,66,0.0,66.0,66.0
228572.0,17,2,180,1,90,0.0,90.0,90.0,1,90,0.0,90.0,90.0
135129737.0,17,6,1206,6,1206,27025947.4,201.0,201.0,0,0,0.0,0.0,0.0
135141063.0,17,6,1206,6,1206,27028212.6,201.0,201.0,0,0,0.0,0.0,0.0
42358.0,6,14,4740,7,653,6632.166666666667,249.0,93.28571428571428,7,4087,6742.333333333333,1514.0,583.8571428571429
12693.0,6,13,1459,7,862,2001.1666666666667,271.0,123.14285714285714,6,597,2364.4,259.0,99.5
379520.0,6,3,204,2,136,0.0,70.0,68.0,1,68,0.0,68.0,68.0
1063944.0,6,3,204,2,136,0.0,70.0,68.0,1,68,0.0,68.0,68.0
430.0,17,2,410,1,78,0.0,78.0,78.0,1,332,0.0,332.0,332.0
90306022.0,6,16,1192,8,596,12894423.285714284,95.0,74.5,8,596,12900036.57142857,95.0,74.5
103359.0,17,2,286,2,286,0.0,143.0,143.0,0,0,0.0,0.0,0.0
13945325.0,6,18,1536,9,962,1704154.75,315.0,106.88888888888889,9,574,1704131.125,78.0,63.77777777777778
297586.0,6,6,412,4,272,99195.33333333331,74.0,68.0,2,140,0.0,74.0,70.0
108101236.0,17,5,1005,5,1005,27025309.0,201.0,201.0,0,0,0.0,0.0,0.0
811.0,17,4,438,2,148,0.0,74.0,74.0,2,290,0.0,147.0,145.0
234003.0,6,3,373,2,238,0.0,172.0,119.0,1,135,0.0,135.0,135.0
209551.0,17,2,180,1,90,0.0,90.0,90.0,1,90,0.0,90.0,90.0
16015487.0,17,2,684,2,684,0.0,342.0,342.0,0,0,0.0,0.0,0.0
8996.0,6,10,1975,5,467,1993.25,195.0,93.4,5,1508,1958.0,1236.0,301.6
123609834.0,6,31,2050,16,1102,8240655.6,139.0,68.875,15,948,8100605.571428572,123.0,63.2
1161534.0,6,13,3017,8,2389,165933.42857142858,1514.0,298.625,5,628,221601.25,331.0,125.6
120156199.0,17,16,1212,8,606,17142299.14285714,174.0,75.75,8,606,17106323.0,174.0,75.75
160498.0,17,2,414,1,88,0.0,88.0,88.0,1,326,0.0,326.0,326.0
90256546.0,6,13,2036,8,1016,12893792.285714284,188.0,127.0,5,1020,22520733.75,204.0,204.0
24515.0,6,14,4740,7,653,3831.0,249.0,93.28571428571428,7,4087,3681.0,1514.0,583.8571428571429
255514.00000000003,6,3,337,2,214,0.0,160.0,107.0,1,123,0.0,123.0,123.0
315581.0,6,3,202,2,128,0.0,74.0,64.0,1,74,0.0,74.0,74.0
92417029.0,17,16,5472,16,5472,6161135.266666667,342.0,342.0,0,0,0.0,0.0,0.0
1313936.0,6,4,264,2,132,0.0,66.0,66.0,2,132,0.0,66.0,66.0
3177544.0,6,18,1495,9,921,359632.375,315.0,102.33333333333331,9,574,359603.75,78.0,63.77777777777778
312.0,17,2,174,1,79,0.0,79.0,79.0,1,95,0.0,95.0,95.0
15090.0,17,2,180,1,90,0.0,90.0,90.0,1,90,0.0,90.0,90.0
13680005.0,6,18,1495,9,921,1672622.875,315.0,102.33333333333331,9,574,1672595.125,78.0,63.77777777777778
106551.0,17,2,700,2,700,0.0,350.0,350.0,0,0,0.0,0.0,0.0
654.0,17,2,762,2,762,0.0,381.0,381.0,0,0,0.0,0.0,0.0
196653.0,17,2,180,1,90,0.0,90.0,90.0,1,90,0.0,90.0,90.0
90296629.0,6,16,1192,8,596,12893139.57142857,95.0,74.5,8,596,12898955.42857143,95.0,74.5
27421819.0,17,5,1710,5,1710,6855454.75,342.0,342.0,0,0,0.0,0.0,0.0
303913.0,6,6,412,4,272,101304.33333333331,74.0,68.0,2,140,0.0,74.0,70.0
11061719.0,17,4,1368,4,1368,3687239.6666666665,342.0,342.0,0,0,0.0,0.0,0.0
243920.0,6,3,337,2,214,0.0,160.0,107.0,1,123,0.0,123.0,123.0
142542.0,6,2,132,1,66,0.0,66.0,66.0,1,66,0.0,66.0,66.0
120024516.0,17,29,13785,29,13785,4286589.857142857,501.0,475.3448275862069,0,0,0.0,0.0,0.0
34752.0,6,10,2032,5,524,8460.25,252.0,104.8,5,1508,7956.75,1236.0,301.6
1761781.0,6,23,6508,12,1529,160161.9090909091,357.0,127.41666666666669,11,4979,145208.1,1510.0,452.6363636363636
39754.0,6,10,2032,5,524,9517.0,252.0,104.8,5,1508,9408.5,1236.0,301.6
106170.0,17,2,286,2,286,0.0,143.0,143.0,0,0,0.0,0.0,0.0
108108552.0,17,5,1005,5,1005,27027138.0,201.0,201.0,0,0,0.0,0.0,0.0
10947667.0,6,8,544,4,272,3603772.0,74.0,68.0,4,272,3603700.0,74.0,68.0
119785768.0,6,22,1598,11,799,11954203.4,95.0,72.63636363636364,11,799,11973006.1,95.0,72.63636363636364
4705.0,17,2,614,1,72,0.0,72.0,72.0,1,542,0.0,542.0,542.0
120286424.0,6,299,35444,150,25314,807291.4362416108,284.0,168.76,149,10130,808110.4459459459,140.0,67.98657718120805
90283282.0,6,16,1192,8,596,12890930.142857144,95.0,74.5,8,596,12895953.142857144,95.0,74.5
6176583.0,6,27,9227,15,2193,441184.5,408.0,146.2,12,7034,530369.8181818182,1514.0,586.1666666666666
1121807.0,6,13,1394,7,797,186967.8333333333,253.0,113.85714285714286,6,597,222584.6,259.0,99.5
135136318.0,17,6,1206,6,1206,27027263.6,201.0,201.0,0,0,0.0,0.0,0.0
115574193.0,17,14,864,7,432,19166848.166666668,174.0,61.71428571428572,7,432,19167633.666666668,174.0,61.71428571428572
3071429.0,6,11,1979,6,527,603162.8,233.0,87.83333333333333,5,1452,19415.0,1224.0,290.4
2794125.0,6,2,132,1,66,0.0,66.0,66.0,1,66,0.0,66.0,66.0
101415.0,17,2,762,2,762,0.0,381.0,381.0,0,0,0.0,0.0,0.0
90256572.0,6,12,1832,8,1016,12893796.0,188.0,127.0,4,816,30030359.0,204.0,204.0
233760.0,6,10,1221,6,636,46752.0,298.0,106.0,4,585,76685.66666666667,379.0,146.25
2967.0,17,2,224,1,76,0.0,76.0,76.0,1,148,0.0,148.0,148.0
197325.0,17,2,180,1,90,0.0,90.0,90.0,1,90,0.0,90.0,90.0
910.0,17,4,820,2,156,0.0,78.0,78.0,2,664,0.0,332.0,332.0
361790.0,6,11,1021,6,444,48600.0,162.0,74.0,5,577,60573.25,349.0,115.4
54348.0,6,14,4740,7,653,8920.0,249.0,93.28571428571428,7,4087,8379.333333333334,1514.0,583.8571428571429
196833.0,17,2,180,1,90,0.0,90.0,90.0,1,90,0.0,90.0,90.0
0.0,17,1,55,1,55,0.0,55.0,55.0,0,0,0.0,0.0,0.0
135141309.0,17,6,1206,6,1206,27028261.8,201.0,201.0,0,0,0.0,0.0,0.0
118695.0,17,2,286,2,286,0.0,143.0,143.0,0,0,0.0,0.0,0.0
15651.000000000002,6,10,2032,5,524,3674.5,252.0,104.8,5,1508,3619.5,1236.0,301.6
301910.0,6,6,412,4,272,100636.66666666669,74.0,68.0,2,140,0.0,74.0,70.0
178653.0,17,2,180,1,90,0.0,90.0,90.0,1,90,0.0,90.0,90.0
121507433.0,6,33,2359,16,1071,7587741.733333333,123.0,66.9375,17,1288,6969986.4375,139.0,75.76470588235294
90591093.0,6,27,1938,14,1029,6951952.0,123.0,73.5,13,909,7531285.0,123.0,69.92307692307692
108102459.0,17,5,1005,5,1005,27025614.75,201.0,201.0,0,0,0.0,0.0,0.0
46551.0,6,14,4740,7,653,6967.666666666667,249.0,93.28571428571428,7,4087,6438.333333333333,1514.0,583.8571428571429
60482.0,6,14,4740,7,653,9890.666666666666,249.0,93.28571428571428,7,4087,9193.166666666666,1514.0,583.8571428571429
95187248.0,6,40,2640,20,1320,5009855.157894737,66.0,66.0,20,1320,4995350.421052632,66.0,66.0
12390.0,6,13,1459,7,862,1754.3333333333333,271.0,123.14285714285714,6,597,2317.8,259.0,99.5
25195.0,6,10,2032,5,524,5825.25,252.0,104.8,5,1508,6033.25,1236.0,301.6
90301447.0,6,16,1192,8,596,12893702.42857143,95.0,74.5,8,596,12899383.142857144,95.0,74.5
36342.0,6,14,4740,7,653,5894.5,249.0,93.28571428571428,7,4087,5647.166666666667,1514.0,583.8571428571429
51727257.0,6,8,2113,3,960,24539854.5,826.0,320.0,5,1153,12288200.0,885.0,230.6
103166.0,17,2,286,2,286,0.0,143.0,143.0,0,0,0.0,0.0,0.0
216849.0,6,3,426,2,280,0.0,214.0,140.0,1,146,0.0,146.0,146.0
120124510.0,6,13,2036,5,1020,30031127.5,204.0,204.0,8,1016,17137504.285714287,188.0,127.0
120194923.0,6,220,24740,110,7556,1095138.275229358,140.0,68.69090909090909,110,17184,1095140.6605504588,284.0,156.21818181818182
119788673.0,6,23,1693,12,894,10889879.363636363,95.0,74.5,11,799,11952684.6,95.0,72.63636363636364
135131623.0,17,6,1206,6,1206,27026324.6,201.0,201.0,0,0,0.0,0.0,0.0
58782.0,6,14,4740,7,653,9168.0,249.0,93.28571428571428,7,4087,9234.333333333334,1514.0,583.8571428571429
103703.0,17,2,286,2,286,0.0,143.0,143.0,0,0,0.0,0.0,0.0
0.0,6,1,66,1,66,0.0,66.0,66.0,0,0,0.0,0.0,0.0
23086828.0,17,3,1034,2,684,0.0,342.0,342.0,1,350,0.0,350.0,350.0
25073.0,6,11,2098,6,590,5014.6,252.0,98.33333333333331,5,1508,4739.0,1236.0,301.6
120006268.0,6,18,1341,9,691,14999986.5,95.0,76.77777777777777,9,650,14999998.75,95.0,72.22222222222223
153417.0,17,2,180,1,90,0.0,90.0,90.0,1,90,0.0,90.0,90.0
135140758.0,17,6,1206,6,1206,27028151.6,201.0,201.0,0,0,0.0,0.0,0.0
90258707.0,6,12,1832,8,1016,12894101.0,188.0,127.0,4,816,30031108.33333333,204.0,204.0
20262.0,6,14,4740,7,653,2728.333333333333,249.0,93.28571428571428,7,4087,3029.833333333333,1514.0,583.8571428571429
31708.0,6,14,4740,7,653,4873.0,249.0,93.28571428571428,7,4087,4769.166666666667,1514.0,583.8571428571429
65654.0,6,14,4740,7,653,10788.0,249.0,93.28571428571428,7,4087,9930.666666666666,1514.0,583.8571428571429
506489.0,6,5,336,2,134,0.0,68.0,67.0,3,202,194727.0,70.0,67.33333333333333
103443.0,17,2,286,2,286,0.0,143.0,143.0,0,0,0.0,0.0,0.0
281435.0,6,3,337,2,214,0.0,160.0,107.0,1,123,0.0,123.0,123.0
102330.0,17,2,700,2,700,0.0,350.0,350.0,0,0,0.0,0.0,0.0
135132409.0,17,6,1146,6,1146,27026481.8,191.0,191.0,0,0,0.0,0.0,0.0
90280757.0,6,19,1436,10,745,10026446.555555556,95.0,74.5,9,691,11284505.375,95.0,76.77777777777777
45262.0,6,14,4740,7,653,6430.666666666667,249.0,93.28571428571428,7,4087,7390.333333333333,1514.0,583.8571428571429
1304837.0,6,4,264,2,132,0.0,66.0,66.0,2,132,0.0,66.0,66.0
284727.0,17,4,704,2,148,0.0,74.0,74.0,2,556,0.0,280.0,278.0
4157.0,17,4,704,2,148,0.0,74.0,74.0,2,556,0.0,280.0,278.0
245544.0,6,3,337,2,214,0.0,160.0,107.0,1,123,0.0,123.0,123.0
144115.0,17,2,180,1,90,0.0,90.0,90.0,1,90,0.0,90.0,90.0
65880.0,6,14,4740,7,653,9888.833333333334,249.0,93.28571428571428,7,4087,9639.666666666666,1514.0,583.8571428571429
3051241.0,6,3,204,1,68,0.0,68.0,68.0,2,136,0.0,70.0,68.0
100412668.0,17,12,778,6,389,19962540.6,174.0,64.83333333333333,6,389,20050752.4,174.0,64.83333333333333
488.0,17,2,508,2,508,0.0,257.0,254.0,0,0,0.0,0.0,0.0
304.0,17,2,156,1,78,0.0,78.0,78.0,1,78,0.0,78.0,78.0
298841.0,6,6,412,4,272,99613.66666666669,74.0,68.0,2,140,0.0,74.0,70.0
32012.0,6,13,1386,7,789,4901.0,253.0,112.71428571428572,6,597,5131.0,259.0,99.5
100792332.0,6,28,1876,14,982,7736614.538461538,139.0,70.14285714285714,14,894,7736640.923076923,123.0,63.85714285714285
135134934.0,17,6,1146,6,1146,27026986.8,191.0,191.0,0,0,0.0,0.0,0.0
108109231.0,17,5,1005,5,1005,27027307.75,201.0,201.0,0,0,0.0,0.0,0.0
2152.0,17,2,664,1,322,0.0,322.0,322.0,1,342,0.0,342.0,342.0
320304.0,6,10,1221,6,636,64060.8,298.0,106.0,4,585,101259.0,379.0,146.25
36995.0,6,14,4740,7,653,5691.166666666667,249.0,93.28571428571428,7,4087,5502.833333333333,1514.0,583.8571428571429
104286749.0,6,28,1876,14,982,8006291.769230769,139.0,70.14285714285714,14,894,8006289.153846154,123.0,63.85714285714285
47961.0,6,14,4740,7,653,7872.5,249.0,93.28571428571428,7,4087,6776.166666666667,1514.0,583.8571428571429
1166835.0,6,13,3010,8,2382,166690.7142857143,1514.0,297.75,5,628,222891.25,331.0,125.6
209750.0,17,2,180,1,90,0.0,90.0,90.0,1,90,0.0,90.0,90.0
30738.0,6,14,4740,7,653,4846.333333333333,249.0,93.28571428571428,7,4087,4672.5,1514.0,583.8571428571429
106305.0,17,2,286,2,286,0.0,143.0,143.0,0,0,0.0,0.0,0.0
91594532.0,6,25,1924,11,840,9159453.2,95.0,76.36363636363636,14,1084,7026577.0,95.0,77.42857142857143
2159224.0,6,24,7544,12,2450,196293.0909090909,1034.0,204.16666666666663,12,5094,168475.9090909091,1510.0,424.5
23822.0,6,10,2032,5,524,5693.75,252.0,104.8,5,1508,5432.75,1236.0,301.6
103089.0,17,2,286,2,286,0.0,143.0,143.0,0,0,0.0,0.0,0.0
218256.0,6,10,1221,6,636,43651.2,298.0,106.0,4,585,71482.33333333333,379.0,146.25
2191839.0,6,3,1604,2,851,0.0,785.0,425.5,1,753,0.0,753.0,753.0
204758.0,6,10,1221,6,636,40951.6,298.0,106.0,4,585,66938.33333333333,379.0,146.25
120123943.0,6,14,2224,9,1204,15015492.875,188.0,133.77777777777777,5,1020,22523056.5,204.0,204.0
90258439.0,6,14,2240,8,1016,12894062.714285716,188.0,127.0,6,1224,18019141.8,204.0,204.0
305867.0,6,6,412,4,272,101955.66666666669,74.0,68.0,2,140,0.0,74.0,70.0
153469.0,17,2,180,1,90,0.0,90.0,90.0,1,90,0.0,90.0,90.0
119986067.0,17,35,16705,35,16705,3529001.970588235,501.0,477.2857142857143,0,0,0.0,0.0,0.0
310437.0,6,6,412,4,272,103479.0,74.0,68.0,2,140,0.0,74.0,70.0
53947.0,6,14,4740,7,653,8581.833333333334,249.0,93.28571428571428,7,4087,8644.666666666666,1514.0,583.8571428571429
40484083.0,6,9,630,4,280,13423276.333333334,78.0,70.0,5,350,10085633.75,78.0,70.0
92122538.0,17,16,5472,16,5472,6141502.533333333,342.0,342.0,0,0,0.0,0.0,0.0
108101695.0,17,5,955,5,955,27025423.75,191.0,191.0,0,0,0.0,0.0,0.0
36402.0,17,2,582,1,83,0.0,83.0,83.0,1,499,0.0,499.0,499.0
4515.0,17,2,614,1,72,0.0,72.0,72.0,1,542,0.0,542.0,542.0
26441.0,6,14,4740,7,653,4081.1666666666665,249.0,93.28571428571428,7,4087,4127.5,1514.0,583.8571428571429
338.0,17,2,174,1,79,0.0,79.0,79.0,1,95,0.0,95.0,95.0
2427.0,17,4,344,2,150,0.0,75.0,75.0,2,194,0.0,103.0,97.0
220310.0,6,3,426,2,280,0.0,214.0,140.0,1,146,0.0,146.0,146.0
200936.0,17,4,6056,4,6056,66978.66666666667,1514.0,1514.0,0,0,0.0,0.0,0.0
703.0,17,4,438,2,148,0.0,74.0,74.0,2,290,0.0,147.0,145.0
135132615.0,17,6,1206,6,1206,27026523.0,201.0,201.0,0,0,0.0,0.0,0.0
137710.0,6,2,132,1,66,0.0,66.0,66.0,1,66,0.0,66.0,66.0
144862.0,17,2,180,1,70,0.0,70.0,70.0,1,110,0.0,110.0,110.0
113520248.0,6,46,3036,23,1518,5159999.227272728,66.0,66.0,23,1518,5159989.909090909,66.0,66.0
140137.0,6,12,1362,6,731,26620.2,253.0,121.83333333333331,6,631,27252.8,293.0,105.16666666666669
2801257.0,6,2,132,1,66,0.0,66.0,66.0,1,66,0.0,66.0,66.0
10213728.0,6,4,264,2,132,0.0,66.0,66.0,2,132,0.0,66.0,66.0
2331.0,17,4,344,2,150,0.0,75.0,75.0,2,194,0.0,103.0,97.0
108109421.0,17,5,955,5,955,27027355.25,191.0,191.0,0,0,0.0,0.0,0.0
282689.0,6,12,1373,7,714,47114.833333333336,298.0,102.0,5,659,65502.5,379.0,131.8
135126142.0,17,6,1206,6,1206,27025228.4,201.0,201.0,0,0,0.0,0.0,0.0
13779240.0,6,18,1493,9,919,1685506.75,315.0,102.11111111111111,9,574,1685482.625,78.0,63.77777777777778
205762.0,6,3,426,2,280,0.0,214.0,140.0,1,146,0.0,146.0,146.0
178726.0,17,4,704,2,148,0.0,74.0,74.0,2,556,0.0,280.0,278.0
2814211.0,6,2,132,1,66,0.0,66.0,66.0,1,66,0.0,66.0,66.0
10443452.0,6,7,478,4,272,3435796.0,74.0,68.0,3,206,5153615.0,74.0,68.66666666666667
297864.0,6,6,412,4,272,99288.0,74.0,68.0,2,140,0.0,74.0,70.0
92832142.0,6,26,2019,11,881,9283214.2,95.0,80.0909090909091,15,1138,6612140.142857143,95.0,75.86666666666666
509828.0,6,5,336,2,134,0.0,68.0,67.0,3,202,195449.5,70.0,67.33333333333333
272918.0,6,10,1221,6,636,54583.6,298.0,106.0,4,585,85224.0,379.0,146.25
298797.0,17,4,6056,4,6056,99599.0,1514.0,1514.0,0,0,0.0,0.0,0.0
109222429.0,6,35,2526,18,1332,6424848.764705882,123.0,74.0,17,1194,6812876.3125,123.0,70.23529411764706
195674.0,17,4,6056,4,6056,65224.66666666666,1514.0,1514.0,0,0,0.0,0.0,0.0
108098612.0,17,5,1005,5,1005,27024653.0,201.0,201.0,0,0,0.0,0.0,0.0
2598787.0,6,2,132,1,66,0.0,66.0,66.0,1,66,0.0,66.0,66.0
318133.0,17,4,1400,4,1400,106044.33333333331,350.0,350.0,0,0,0.0,0.0,0.0
236253.0,6,3,373,2,238,0.0,172.0,119.0,1,135,0.0,135.0,135.0
201502.0,17,4,6056,4,6056,67167.33333333333,1514.0,1514.0,0,0,0.0,0.0,0.0
147417.0,6,3,373,2,238,0.0,172.0,119.0,1,135,0.0,135.0,135.0
120568359.0,6,259,29670,130,20860,934638.4418604652,284.0,160.46153846153845,129,8810,933907.1875,140.0,68.29457364341086
312869.0,17,4,1400,4,1400,104289.66666666669,350.0,350.0,0,0,0.0,0.0,0.0
207679.0,6,10,1221,6,636,41535.8,298.0,106.0,4,585,67844.33333333333,379.0,146.25
2403.0,17,4,344,2,150,0.0,75.0,75.0,2,194,0.0,103.0,97.0
107159.0,17,2,286,2,286,0.0,143.0,143.0,0,0,0.0,0.0,0.0
117247879.0,6,217,24490,109,7490,1085628.509259259,140.0,68.71559633027523,108,17000,1086074.7943925234,284.0,157.40740740740742
90258191.0,6,13,1898,8,1016,12894027.285714284,188.0,127.0,5,882,22523930.5,204.0,176.4
2114.0,17,2,932,1,590,0.0,590.0,590.0,1,342,0.0,342.0,342.0
90301238.0,6,18,1503,9,853,11281960.125,257.0,94.77777777777776,9,650,11286804.5,95.0,72.22222222222223
120300715.0,6,245,27688,123,19340,986071.4344262296,284.0,157.2357723577236,122,8348,985712.8429752066,140.0,68.42622950819673
13918358.0,6,18,1495,9,921,1701936.0,315.0,102.33333333333331,9,574,1701900.0,78.0,63.77777777777778
104174.0,17,2,762,2,762,0.0,381.0,381.0,0,0,0.0,0.0,0.0
49790.0,6,14,4740,7,653,7063.666666666667,249.0,93.28571428571428,7,4087,8159.0,1514.0,583.8571428571429
317.0,17,2,166,1,75,0.0,75.0,75.0,1,91,0.0,91.0,91.0
2597991.0,6,2,132,1,66,0.0,66.0,66.0,1,66,0.0,66.0,66.0
228279.0,17,2,180,1,90,0.0,90.0,90.0,1,90,0.0,90.0,90.0
2383.0,17,4,344,2,150,0.0,75.0,75.0,2,194,0.0,103.0,97.0
186975.0,17,2,180,1,90,0.0,90.0,90.0,1,90,0.0,90.0,90.0
121321.0,6,3,337,2,214,0.0,160.0,107.0,1,123,0.0,123.0,123.0
120175.0,17,2,180,1,70,0.0,70.0,70.0,1,110,0.0,110.0,110.0
33213.0,6,14,4740,7,653,4858.0,249.0,93.28571428571428,7,4087,5289.833333333333,1514.0,583.8571428571429
51259.0,6,10,2032,5,524,12484.75,252.0,104.8,5,1508,12562.5,1236.0,301.6
332.0,17,2,267,1,83,0.0,83.0,83.0,1,184,0.0,184.0,184.0
104829.0,17,2,762,2,762,0.0,381.0,381.0,0,0,0.0,0.0,0.0
301485.0,6,6,412,4,272,100495.0,74.0,68.0,2,140,0.0,74.0,70.0
2798094.0,6,2,132,1,66,0.0,66.0,66.0,1,66,0.0,66.0,66.0
212667.0,6,3,426,2,280,0.0,214.0,140.0,1,146,0.0,146.0,146.0
106276.0,17,2,286,2,286,0.0,143.0,143.0,0,0,0.0,0.0,0.0
77967765.0,17,14,4788,14,4788,5997520.384615385,342.0,342.0,0,0,0.0,0.0,0.0
60930409.0,17,9,3086,8,2736,5143332.0,342.0,342.0,1,350,0.0,350.0,350.0
306912.0,6,6,412,4,272,102304.0,74.0,68.0,2,140,0.0,74.0,70.0
108101954.0,17,5,1005,5,1005,27025488.5,201.0,201.0,0,0,0.0,0.0,0.0
18665.0,6,10,1913,5,461,4229.75,233.0,92.2,5,1452,4244.5,1224.0,290.4
54816.0,6,10,2032,5,524,12093.75,252.0,104.8,5,1508,12820.5,1236.0,301.6
7203.0,17,2,231,1,78,0.0,78.0,78.0,1,153,0.0,153.0,153.0
135133913.0,17,6,1146,6,1146,27026782.6,191.0,191.0,0,0,0.0,0.0,0.0
49012.0,6,14,4740,7,653,8029.833333333333,249.0,93.28571428571428,7,4087,8031.166666666667,1514.0,583.8571428571429
307977.0,6,6,412,4,272,102659.0,74.0,68.0,2,140,0.0,74.0,70.0
128001131.0,17,15,907,8,475,18285875.85714286,174.0,59.375,7,432,18001001.166666668,174.0,61.71428571428572
49839.0,6,14,4740,7,653,8195.5,249.0,93.28571428571428,7,4087,8174.333333333333,1514.0,583.8571428571429
228397.0,17,2,180,1,90,0.0,90.0,90.0,1,90,0.0,90.0,90.0
120019502.0,6,23,1860,12,894,10909090.545454543,95.0,74.5,11,966,12000736.5,221.0,87.81818181818181
2083.0,17,4,344,2,150,0.0,75.0,75.0,2,194,0.0,103.0,97.0
298.0,17,2,156,1,78,0.0,78.0,78.0,1,78,0.0,78.0,78.0
44850.0,6,14,4740,7,653,6492.666666666667,249.0,93.28571428571428,7,4087,7230.333333333333,1514.0,583.8571428571429
120099037.0,6,240,26960,120,8216,1002365.1008403362,140.0,68.46666666666667,120,18744,993755.8235294118,284.0,156.2
750.0,17,4,438,2,148,0.0,74.0,74.0,2,290,0.0,147.0,145.0
206110.0,6,3,426,2,280,0.0,214.0,140.0,1,146,0.0,146.0,146.0
120121727.0,6,13,2036,5,1020,30030431.75,204.0,204.0,8,1016,17136857.714285713,188.0,127.0
90081893.0,6,16,1192,8,596,12835136.142857144,95.0,74.5,8,596,12839610.57142857,95.0,74.5
103455.0,17,2,286,2,286,0.0,143.0,143.0,0,0,0.0,0.0,0.0
234244.0,6,3,337,2,214,0.0,160.0,107.0,1,123,0.0,123.0,123.0
18006.0,6,13,1459,7,862,2745.5,271.0,123.14285714285714,6,597,3245.8,259.0,99.5
241214.0,6,3,337,2,214,0.0,160.0,107.0,1,123,0.0,123.0,123.0
20191.0,6,14,4740,7,653,3131.1666666666665,249.0,93.28571428571428,7,4087,2594.1666666666665,1514.0,583.8571428571429
3029641.0,6,15,4814,8,727,431880.0,249.0,90.875,7,4087,4691.666666666667,1514.0,583.8571428571429
116718657.0,6,32,2236,16,1165,7766852.333333333,139.0,72.8125,16,1071,7766816.4,123.0,66.9375
120021378.0,17,28,13364,28,13364,4445236.222222222,501.0,477.2857142857143,0,0,0.0,0.0,0.0
110429.0,17,2,286,2,286,0.0,143.0,143.0,0,0,0.0,0.0,0.0
438.0,17,2,762,2,762,0.0,381.0,381.0,0,0,0.0,0.0,0.0
118929033.0,6,36,2596,18,1348,6995825.470588235,139.0,74.88888888888889,18,1248,6983101.882352941,123.0,69.33333333333333
123001421.0,17,15,1169,8,606,17571631.57142857,174.0,75.75,7,563,17169661.333333332,174.0,80.42857142857143
0.0,17,1,55,1,55,0.0,55.0,55.0,0,0,0.0,0.0,0.0
34711.0,6,14,4740,7,653,5060.5,249.0,93.28571428571428,7,4087,4387.166666666667,1514.0,583.8571428571429
31557.0,6,14,4740,7,653,4371.166666666667,249.0,93.28571428571428,7,4087,4605.666666666667,1514.0,583.8571428571429
108104253.0,17,5,955,5,955,27026063.25,191.0,191.0,0,0,0.0,0.0,0.0
106706.0,17,2,286,2,286,0.0,143.0,143.0,0,0,0.0,0.0,0.0
120042461.0,6,19,1395,10,745,13333083.222222222,95.0,74.5,9,650,14999022.25,95.0,72.22222222222223
41523.0,6,14,4740,7,653,6755.333333333333,249.0,93.28571428571428,7,4087,6282.0,1514.0,583.8571428571429
2423.0,17,4,344,2,150,0.0,75.0,75.0,2,194,0.0,103.0,97.0
95611648.0,6,39,2574,20,1320,5032178.7894736845,66.0,66.0,19,1254,5168135.277777778,66.0,66.0
99719028.0,6,23,1440,12,717,9065366.181818182,123.0,59.75,11,723,8951762.0,123.0,65.72727272727273
509714.0,6,5,336,2,134,0.0,68.0,67.0,3,202,194322.0,70.0,67.33333333333333
108075.0,17,2,286,2,286,0.0,143.0,143.0,0,0,0.0,0.0,0.0
209563.0,17,2,180,1,90,0.0,90.0,90.0,1,90,0.0,90.0,90.0
90257548.0,6,12,1832,8,1016,12893935.42857143,188.0,127.0,4,816,30031726.33333333,204.0,204.0
108101073.0,17,5,955,5,955,27025268.25,191.0,191.0,0,0,0.0,0.0,0.0
316457.0,17,4,1400,4,1400,105485.66666666669,350.0,350.0,0,0,0.0,0.0,0.0
8745.0,17,4,823,2,163,0.0,89.0,81.5,2,660,0.0,443.0,330.0
24002.0,6,10,2032,5,524,5747.5,252.0,104.8,5,1508,4980.5,1236.0,301.6
28999.0,6,11,2098,6,590,5076.8,252.0,98.33333333333331,5,1508,5554.25,1236.0,301.6
104858974.0,6,44,2904,22,1452,4993284.476190476,66.0,66.0,22,1452,4978985.952380952,66.0,66.0
148582.0,17,2,414,1,88,0.0,88.0,88.0,1,326,0.0,326.0,326.0
805.0,17,5,550,5,550,201.25,110.0,110.0,0,0,0.0,0.0,0.0
1309246.0,17,7,490,7,490,218207.66666666663,70.0,70.0,0,0,0.0,0.0,0.0
103378.0,17,2,286,2,286,0.0,143.0,143.0,0,0,0.0,0.0,0.0
6297.0,17,2,180,1,90,0.0,90.0,90.0,1,90,0.0,90.0,90.0
112380215.0,6,244,28268,122,19994,926974.3719008263,284.0,163.88524590163934,122,8274,926973.8842975206,140.0,67.81967213114754
233873.0,6,3,337,2,214,0.0,160.0,107.0,1,123,0.0,123.0,123.0
41408.0,6,14,4740,7,653,6454.333333333333,249.0,93.28571428571428,7,4087,6163.666666666667,1514.0,583.8571428571429
263425.0,17,4,1524,4,1524,87808.33333333333,381.0,381.0,0,0,0.0,0.0,0.0
852624.0,6,9,1269,6,798,170524.8,460.0,133.0,3,471,288500.5,331.0,157.0
100478634.0,17,12,778,6,389,20008963.2,174.0,64.83333333333333,6,389,20063707.8,174.0,64.83333333333333
10476387.0,6,7,478,4,272,3445458.6666666665,74.0,68.0,3,206,5168097.5,74.0,68.66666666666667
119753718.0,17,34,16284,34,16284,3628900.5454545454,501.0,478.9411764705882,0,0,0.0,0.0,0.0
1308786.0,6,4,264,2,132,0.0,66.0,66.0,2,132,0.0,66.0,66.0
1180.0,17,4,438,2,148,0.0,74.0,74.0,2,290,0.0,147.0,145.0
34535.0,6,2,145,2,145,0.0,91.0,72.5,0,0,0.0,0.0,0.0
236468.0,6,3,337,2,214,0.0,160.0,107.0,1,123,0.0,123.0,123.0
23302.0,6,10,2032,5,524,5349.75,252.0,104.8,5,1508,5166.75,1236.0,301.6
299.0,17,2,164,1,82,0.0,82.0,82.0,1,82,0.0,82.0,82.0
315712.0,17,4,1400,4,1400,105237.33333333331,350.0,350.0,0,0,0.0,0.0,0.0
883.0,17,4,438,2,148,0.0,74.0,74.0,2,290,0.0,147.0,145.0
2296.0,17,4,344,2,150,0.0,75.0,75.0,2,194,0.0,103.0,97.0
23780.0,6,10,2032,5,524,5716.25,252.0,104.8,5,1508,5114.75,1236.0,301.6
222601.0,6,3,426,2,280,0.0,214.0,140.0,1,146,0.0,146.0,146.0
843160.0,6,9,1096,6,625,168632.0,287.0,104.16666666666669,3,471,285311.5,331.0,157.0
321198.0,17,4,1400,4,1400,107066.0,350.0,350.0,0,0,0.0,0.0,0.0
120028455.0,17,28,13364,28,13364,4445498.333333333,501.0,477.2857142857143,0,0,0.0,0.0,0.0
138131.0,6,2,132,1,66,0.0,66.0,66.0,1,66,0.0,66.0,66.0
20545.0,6,14,4740,7,653,3198.833333333333,249.0,93.28571428571428,7,4087,3293.5,1514.0,583.8571428571429
159939.0,6,2,128,1,74,0.0,74.0,74.0,1,54,0.0,54.0,54.0
130034.0,6,3,337,2,214,0.0,160.0,107.0,1,123,0.0,123.0,123.0
103040045.0,6,41,2706,21,1386,5152002.25,66.0,66.0,20,1320,5147657.105263158,66.0,66.0
52921.0,6,14,4740,7,653,8638.833333333334,249.0,93.28571428571428,7,4087,8696.0,1514.0,583.8571428571429
1321384.0,6,4,264,2,132,0.0,66.0,66.0,2,132,0.0,66.0,66.0
257174.0,6,3,337,2,214,0.0,160.0,107.0,1,123,0.0,123.0,123.0
66065.0,6,14,4740,7,653,10841.333333333334,249.0,93.28571428571428,7,4087,9219.166666666666,1514.0,583.8571428571429
298186.0,6,6,412,4,272,99395.33333333331,74.0,68.0,2,140,0.0,74.0,70.0
135132593.0,17,6,1206,6,1206,27026518.6,201.0,201.0,0,0,0.0,0.0,0.0
2316.0,17,4,344,2,150,0.0,75.0,75.0,2,194,0.0,103.0,97.0
2801882.0,6,2,132,1,66,0.0,66.0,66.0,1,66,0.0,66.0,66.0
125335.0,17,2,180,1,70,0.0,70.0,70.0,1,110,0.0,110.0,110.0
1300669.0,6,4,264,2,132,0.0,66.0,66.0,2,132,0.0,66.0,66.0
90292996.0,6,16,1192,8,596,12892470.42857143,95.0,74.5,8,596,12897693.285714284,95.0,74.5
82.0,17,2,762,2,762,0.0,381.0,381.0,0,0,0.0,0.0,0.0
92749670.0,17,16,5472,16,5472,6183311.333333333,342.0,342.0,0,0,0.0,0.0,0.0
105152656.0,17,14,864,7,432,17500161.833333332,174.0,61.71428571428572,7,432,17500817.833333332,174.0,61.71428571428572
293815.0,6,6,412,4,272,97938.33333333331,74.0,68.0,2,140,0.0,74.0,70.0
320213.0,17,4,1400,4,1400,106737.66666666669,350.0,350.0,0,0,0.0,0.0,0.0
1765.0,17,2,664,1,322,0.0,322.0,322.0,1,342,0.0,342.0,342.0
33623.0,6,14,4740,7,653,5456.333333333333,249.0,93.28571428571428,7,4087,5462.333333333333,1514.0,583.8571428571429
93698265.0,6,35,2950,20,1657,4920129.105263158,139.0,82.85,15,1293,6675706.071428572,123.0,86.2
90255833.0,6,13,2036,8,1016,12893690.42857143,188.0,127.0,5,1020,22523118.25,204.0,204.0
13696568.0,6,18,1495,9,921,1672720.5,315.0,102.33333333333331,9,574,1672710.75,78.0,63.77777777777778
104326535.0,17,15,5130,15,5130,7451895.357142857,342.0,342.0,0,0,0.0,0.0,0.0
10530088.0,6,7,478,4,272,3464604.333333333,74.0,68.0,3,206,5196825.0,74.0,68.66666666666667
123236372.0,6,35,2394,18,1269,7249198.352941177,123.0,70.5,17,1125,7065470.6875,123.0,66.17647058823529
46137.0,6,14,4740,7,653,6462.833333333333,249.0,93.28571428571428,7,4087,7564.666666666667,1514.0,583.8571428571429
43599.0,6,14,4740,7,653,6930.5,249.0,93.28571428571428,7,4087,6867.666666666667,1514.0,583.8571428571429
206685.0,17,4,6056,4,6056,68895.0,1514.0,1514.0,0,0,0.0,0.0,0.0
119554776.0,6,236,26676,118,18666,1019996.52991453,284.0,158.1864406779661,118,8010,1019996.94017094,140.0,67.88135593220339
108106238.0,17,5,1005,5,1005,27026559.5,201.0,201.0,0,0,0.0,0.0,0.0
10465609.0,6,7,478,4,272,3442771.6666666665,74.0,68.0,3,206,5164045.5,74.0,68.66666666666667
35804.0,6,10,2032,5,524,8491.5,252.0,104.8,5,1508,6675.5,1236.0,301.6
228254.0,17,2,180,1,90,0.0,90.0,90.0,1,90,0.0,90.0,90.0
8174856.999999999,17,3,1034,2,684,0.0,342.0,342.0,1,350,0.0,350.0,350.0
23734.0,6,10,2032,5,524,5607.75,252.0,104.8,5,1508,5387.5,1236.0,301.6
121409410.0,6,215,24230,108,16872,1134667.38317757,284.0,156.22222222222223,107,7358,1125913.066037736,140.0,68.76635514018692
146277.0,6,3,337,2,214,0.0,160.0,107.0,1,123,0.0,123.0,123.0
120256658.0,6,360,42044,180,12176,667239.9832402235,140.0,67.64444444444445,180,29868,667177.1340782123,374.0,165.93333333333334
744002.0,17,2,876,2,876,0.0,438.0,438.0,0,0,0.0,0.0,0.0
119909978.0,17,35,16705,35,16705,3526764.0588235296,501.0,477.2857142857143,0,0,0.0,0.0,0.0
27156.0,6,14,4740,7,653,4039.3333333333335,249.0,93.28571428571428,7,4087,3908.6666666666665,1514.0,583.8571428571429
120011.0,17,2,180,1,70,0.0,70.0,70.0,1,110,0.0,110.0,110.0
2810447.0,6,2,132,1,66,0.0,66.0,66.0,1,66,0.0,66.0,66.0
947902.0,6,10,1221,6,636,189580.4,298.0,106.0,4,585,310103.0,379.0,146.25
190877.0,17,2,180,1,90,0.0,90.0,90.0,1,90,0.0,90.0,90.0
35145.0,6,2,145,2,145,0.0,91.0,72.5,0,0,0.0,0.0,0.0
39419.0,6,14,4740,7,653,6395.333333333333,249.0,93.28571428571428,7,4087,6237.333333333333,1514.0,583.8571428571429
4527.0,17,2,614,1,72,0.0,72.0,72.0,1,542,0.0,542.0,542.0
1855570.0,17,6,1230,3,234,927598.0,78.0,78.0,3,996,927577.5,332.0,332.0
120068295.0,17,28,13364,28,13364,4446973.888888889,501.0,477.2857142857143,0,0,0.0,0.0,0.0
112120139.0,6,53,4488,29,2433,4004290.6785714286,123.0,83.89655172413794,24,2055,4865388.173913044,123.0,85.625
10524872.0,6,7,478,4,272,3462732.0,74.0,68.0,3,206,5194027.5,74.0,68.66666666666667
112035437.0,6,815,183046,397,26868,282578.0303030303,214.0,67.67758186397985,418,156178,266697.896882494,1514.0,373.6315789473685
108109707.0,17,5,1005,5,1005,27027426.75,201.0,201.0,0,0,0.0,0.0,0.0
48737210.0,6,8,1940,3,887,22889139.0,753.0,295.6666666666667,5,1053,11515971.25,785.0,210.6
10469402.0,6,6,412,3,206,5166484.0,74.0,68.66666666666667,3,206,5166264.5,74.0,68.66666666666667
301189.0,6,10,1221,6,636,60237.8,298.0,106.0,4,585,94503.0,379.0,146.25
215777.0,6,10,1221,6,636,43155.4,298.0,106.0,4,585,70646.0,379.0,146.25
0.0,6,1,66,1,66,0.0,66.0,66.0,0,0,0.0,0.0,0.0
323376.0,6,10,1221,6,636,64675.2,298.0,106.0,4,585,102353.0,379.0,146.25
1583.0,17,2,762,2,762,0.0,381.0,381.0,0,0,0.0,0.0,0.0
103171.0,17,2,286,2,286,0.0,143.0,143.0,0,0,0.0,0.0,0.0
115652962.0,6,47,3102,24,1584,5028378.608695652,66.0,66.0,23,1518,5159993.863636363,66.0,66.0
206148.0,6,3,426,2,280,0.0,214.0,140.0,1,146,0.0,146.0,146.0
108685603.0,6,32,2220,16,1149,7245706.866666666,123.0,71.8125,16,1071,7231295.266666667,123.0,66.9375
0.0,17,1,453,1,453,0.0,453.0,453.0,0,0,0.0,0.0,0.0
105071.0,17,2,286,2,286,0.0,143.0,143.0,0,0,0.0,0.0,0.0
40252.0,6,12,1320,7,789,6708.666666666667,253.0,112.71428571428572,5,531,7707.25,259.0,106.2
339.0,17,2,208,1,72,0.0,72.0,72.0,1,136,0.0,136.0,136.0
334044.0,6,3,1604,1,753,0.0,753.0,753.0,2,851,0.0,785.0,425.5
4141.0,17,2,610,1,72,0.0,72.0,72.0,1,538,0.0,538.0,538.0
43779.0,6,14,4740,7,653,6252.0,249.0,93.28571428571428,7,4087,7157.0,1514.0,583.8571428571429
747.0,17,4,438,2,148,0.0,74.0,74.0,2,290,0.0,147.0,145.0
305554.0,6,6,412,4,272,101851.33333333331,74.0,68.0,2,140,0.0,74.0,70.0
108105844.0,17,5,1005,5,1005,27026461.0,201.0,201.0,0,0,0.0,0.0,0.0
90014157.0,17,28,13364,28,13364,3333857.6666666665,501.0,477.2857142857143,0,0,0.0,0.0,0.0
110688.0,17,2,286,2,286,0.0,143.0,143.0,0,0,0.0,0.0,0.0
145202.0,17,2,180,1,70,0.0,70.0,70.0,1,110,0.0,110.0,110.0
143258.0,6,2,132,1,66,0.0,66.0,66.0,1,66,0.0,66.0,66.0
19927.0,6,10,2032,5,524,4732.75,252.0,104.8,5,1508,4263.5,1236.0,301.6
2339.0,17,4,344,2,150,0.0,75.0,75.0,2,194,0.0,103.0,97.0
1305661.0,6,4,264,2,132,0.0,66.0,66.0,2,132,0.0,66.0,66.0
0.0,17,1,55,1,55,0.0,55.0,55.0,0,0,0.0,0.0,0.0
19958.0,6,10,1067,5,536,4710.75,264.0,107.2,5,531,4185.25,259.0,106.2
108109928.0,17,5,1005,5,1005,27027482.0,201.0,201.0,0,0,0.0,0.0,0.0
40495.0,6,10,2032,5,524,8752.75,252.0,104.8,5,1508,9095.75,1236.0,301.6
96352709.0,17,12,778,6,389,19238758.8,174.0,64.83333333333333,6,389,19198671.4,174.0,64.83333333333333
298244.0,6,6,412,4,272,99414.66666666669,74.0,68.0,2,140,0.0,74.0,70.0
282423.0,17,2,180,1,90,0.0,90.0,90.0,1,90,0.0,90.0,90.0
307224.0,6,6,412,4,272,102408.0,74.0,68.0,2,140,0.0,74.0,70.0
108102521.0,17,5,955,5,955,27025630.25,191.0,191.0,0,0,0.0,0.0,0.0
315.0,17,2,174,1,79,0.0,79.0,79.0,1,95,0.0,95.0,95.0
233066.0,6,3,337,2,214,0.0,160.0,107.0,1,123,0.0,123.0,123.0
1310967.0,6,4,264,2,132,0.0,66.0,66.0,2,132,0.0,66.0,66.0
102956.0,17,2,286,2,286,0.0,143.0,143.0,0,0,0.0,0.0,0.0
228085.0,17,2,180,1,90,0.0,90.0,90.0,1,90,0.0,90.0,90.0
153477.0,17,2,180,1,90,0.0,90.0,90.0,1,90,0.0,90.0,90.0
117099602.0,6,48,3168,24,1584,5091287.043478261,66.0,66.0,24,1584,5078054.304347826,66.0,66.0
302615.0,6,6,412,4,272,100871.66666666669,74.0,68.0,2,140,0.0,74.0,70.0
300708.0,6,6,412,4,272,100236.0,74.0,68.0,2,140,0.0,74.0,70.0
122978331.0,6,48,3168,24,1584,5045625.0,66.0,66.0,24,1584,5221603.826086956,66.0,66.0
120000673.0,6,17,1287,9,691,15000084.125,95.0,76.77777777777777,8,596,12857810.0,95.0,74.5
135136904.0,17,6,1146,6,1146,27027380.8,191.0,191.0,0,0,0.0,0.0,0.0
115138488.0,6,47,3102,24,1584,4992362.913043479,66.0,66.0,23,1518,5155443.409090909,66.0,66.0
234063.0,6,3,373,2,238,0.0,172.0,119.0,1,135,0.0,135.0,135.0
1161516.0,6,13,3010,8,2382,165930.85714285713,1514.0,297.75,5,628,222220.25,331.0,125.6
236837.0,17,2,180,1,90,0.0,90.0,90.0,1,90,0.0,90.0,90.0
126425029.0,17,14,864,7,432,17834220.333333332,174.0,61.71428571428572,7,432,19894674.666666668,174.0,61.71428571428572
14645925.0,6,19,1553,9,921,1791483.875,315.0,102.33333333333331,10,632,1592396.888888889,78.0,63.2
2059.0,17,4,344,2,150,0.0,75.0,75.0,2,194,0.0,103.0,97.0
0.0,17,1,179,1,179,0.0,179.0,179.0,0,0,0.0,0.0,0.0
120218135.0,6,254,29558,127,8678,947583.5555555556,140.0,68.33070866141732,127,20880,947577.8571428572,554.0,164.40944881889763
92016311.0,6,38,2508,19,1254,5112003.111111111,66.0,66.0,19,1254,5112002.722222222,66.0,66.0
90029679.0,17,28,13364,28,13364,3334432.5555555555,501.0,477.2857142857143,0,0,0.0,0.0,0.0
29055.0,6,10,2032,5,524,6862.0,252.0,104.8,5,1508,6996.5,1236.0,301.6
135131268.0,17,6,1146,6,1146,27026253.6,191.0,191.0,0,0,0.0,0.0,0.0
297780.0,6,6,412,4,272,99260.0,74.0,68.0,2,140,0.0,74.0,70.0
119351825.0,6,317,38110,159,10790,755391.2974683545,140.0,67.86163522012579,158,27320,753601.280254777,336.0,172.91139240506328
241977.0,6,3,337,2,214,0.0,160.0,107.0,1,123,0.0,123.0,123.0
107217.0,17,2,286,2,286,0.0,143.0,143.0,0,0,0.0,0.0,0.0
122304.0,6,3,373,2,238,0.0,172.0,119.0,1,135,0.0,135.0,135.0
7955.0,17,4,438,2,148,0.0,74.0,74.0,2,290,0.0,147.0,145.0
120012466.0,6,24,1829,13,989,9999989.583333334,95.0,76.07692307692308,11,840,12000951.1,95.0,76.36363636363636
3585.0,17,2,224,1,76,0.0,76.0,76.0,1,148,0.0,148.0,148.0
107987.0,17,2,700,2,700,0.0,350.0,350.0,0,0,0.0,0.0,0.0
120046075.0,17,28,13364,28,13364,4446150.925925926,501.0,477.2857142857143,0,0,0.0,0.0,0.0
108113949.0,17,5,1005,5,1005,27028487.25,201.0,201.0,0,0,0.0,0.0,0.0
108107527.0,17,5,955,5,955,27026881.75,191.0,191.0,0,0,0.0,0.0,0.0
2353.0,17,4,344,2,150,0.0,75.0,75.0,2,194,0.0,103.0,97.0
94844778.0,6,171,19288,86,5824,1115820.9176470588,140.0,67.72093023255815,85,13464,1116942.738095238,284.0,158.4
105039.0,6,14,4740,7,653,16727.333333333332,249.0,93.28571428571428,7,4087,15710.833333333334,1514.0,583.8571428571429
10660.0,6,10,2032,5,524,2435.25,252.0,104.8,5,1508,2412.0,1236.0,301.6
90047536.0,6,11,1644,4,816,30015070.33333333,204.0,204.0,7,828,15000345.5,188.0,118.28571428571428
135134866.0,17,6,1146,6,1146,27026973.2,191.0,191.0,0,0,0.0,0.0,0.0
304818.0,17,4,704,2,148,0.0,74.0,74.0,2,556,0.0,280.0,278.0
18496.0,6,10,2032,5,524,4104.0,252.0,104.8,5,1508,4295.5,1236.0,301.6
4453.0,17,2,610,1,72,0.0,72.0,72.0,1,538,0.0,538.0,538.0
303638.0,6,2,132,1,66,0.0,66.0,66.0,1,66,0.0,66.0,66.0
10474022.0,6,7,478,4,272,3444255.0,74.0,68.0,3,206,5166218.5,74.0,68.66666666666667
222280.0,17,4,6056,4,6056,74093.33333333333,1514.0,1514.0,0,0,0.0,0.0,0.0
33703.0,6,14,4740,7,653,5441.333333333333,249.0,93.28571428571428,7,4087,5177.5,1514.0,583.8571428571429
144018.0,17,2,180,1,90,0.0,90.0,90.0,1,90,0.0,90.0,90.0
12017097.0,17,3,1026,3,1026,6008548.5,342.0,342.0,0,0,0.0,0.0,0.0
179728.0,17,2,180,1,90,0.0,90.0,90.0,1,90,0.0,90.0,90.0
18810.0,6,2,145,2,145,0.0,91.0,72.5,0,0,0.0,0.0,0.0
69958.0,6,14,4740,7,653,11203.5,249.0,93.28571428571428,7,4087,9941.666666666666,1514.0,583.8571428571429
107567.0,17,2,286,2,286,0.0,143.0,143.0,0,0,0.0,0.0,0.0
144006.0,17,2,180,1,90,0.0,90.0,90.0,1,90,0.0,90.0,90.0
132955.0,6,3,337,2,214,0.0,160.0,107.0,1,123,0.0,123.0,123.0
233825.0,6,3,337,2,214,0.0,160.0,107.0,1,123,0.0,123.0,123.0
853287.0,6,9,1268,6,797,170657.4,459.0,132.83333333333334,3,471,290354.0,331.0,157.0
1659.0,17,4,438,2,148,0.0,74.0,74.0,2,290,0.0,147.0,145.0
320446.0,6,6,412,4,272,106815.33333333331,74.0,68.0,2,140,0.0,74.0,70.0
143973.0,17,2,180,1,90,0.0,90.0,90.0,1,90,0.0,90.0,90.0
5614994.0,6,5,336,2,134,0.0,68.0,67.0,3,202,1424140.0,70.0,67.33333333333333
123303008.0,6,48,3168,24,1584,5094945.304347826,66.0,66.0,24,1584,5201697.130434782,66.0,66.0
90075817.0,17,28,13364,28,13364,3336141.3703703703,501.0,477.2857142857143,0,0,0.0,0.0,0.0
660.0,17,4,438,2,148,0.0,74.0,74.0,2,290,0.0,147.0,145.0
153392.0,17,2,180,1,90,0.0,90.0,90.0,1,90,0.0,90.0,90.0
209491.0,17,2,180,1,90,0.0,90.0,90.0,1,90,0.0,90.0,90.0
108989.0,17,2,286,2,286,0.0,143.0,143.0,0,0,0.0,0.0,0.0
10493946.0,6,7,478,4,272,3450806.0,74.0,68.0,3,206,5176111.0,74.0,68.66666666666667
242893.0,6,3,337,2,214,0.0,160.0,107.0,1,123,0.0,123.0,123.0
3051586.0,6,4,270,3,202,1525793.0,70.0,67.33333333333333,1,68,0.0,68.0,68.0
2593964.0,6,2,132,1,66,0.0,66.0,66.0,1,66,0.0,66.0,66.0
118305350.0,6,219,24712,110,7556,1085370.1834862386,140.0,68.69090909090909,109,17156,1085713.4722222222,284.0,157.39449541284404
90256454.0,6,15,2444,8,1016,12893779.142857144,188.0,127.0,7,1428,15015075.166666666,204.0,204.0
121933.0,6,3,337,2,214,0.0,160.0,107.0,1,123,0.0,123.0,123.0
311611.0,6,3,202,2,128,0.0,74.0,64.0,1,74,0.0,74.0,74.0
147159.0,6,3,373,2,238,0.0,172.0,119.0,1,135,0.0,135.0,135.0
15620199.0,17,12,4200,12,4200,1420018.0909090908,350.0,350.0,0,0,0.0,0.0,0.0
394.0,17,2,166,1,75,0.0,75.0,75.0,1,91,0.0,91.0,91.0
143910.0,17,2,180,1,90,0.0,90.0,90.0,1,90,0.0,90.0,90.0
317690.0,6,6,412,4,272,105896.66666666669,74.0,68.0,2,140,0.0,74.0,70.0
90259250.0,6,12,1832,8,1016,12894178.57142857,188.0,127.0,4,816,30031824.0,204.0,204.0
299834.0,17,2,180,1,90,0.0,90.0,90.0,1,90,0.0,90.0,90.0
46584211.0,6,8,1940,3,887,21940252.5,753.0,295.6666666666667,5,1053,11254441.0,785.0,210.6
232258.0,6,3,337,2,214,0.0,160.0,107.0,1,123,0.0,123.0,123.0
10514911.0,6,6,412,3,206,5188682.0,74.0,68.66666666666667,3,206,5188586.0,74.0,68.66666666666667
326884.0,6,6,412,4,272,108961.33333333331,74.0,68.0,2,140,0.0,74.0,70.0
42526.0,6,14,4740,7,653,6342.333333333333,249.0,93.28571428571428,7,4087,6282.5,1514.0,583.8571428571429
39022.0,6,14,4740,7,653,6335.5,249.0,93.28571428571428,7,4087,5530.833333333333,1514.0,583.8571428571429
251931.00000000003,17,4,6056,4,6056,83977.0,1514.0,1514.0,0,0,0.0,0.0,0.0
161518.0,17,4,1524,4,1524,53839.333333333336,381.0,381.0,0,0,0.0,0.0,0.0
90022157.0,17,28,13364,28,13364,3334153.962962963,501.0,477.2857142857143,0,0,0.0,0.0,0.0
245342.0,6,3,337,2,214,0.0,160.0,107.0,1,123,0.0,123.0,123.0
121259.0,6,3,337,2,214,0.0,160.0,107.0,1,123,0.0,123.0,123.0
144032.0,17,2,180,1,90,0.0,90.0,90.0,1,90,0.0,90.0,90.0
96233847.0,6,26,1746,13,906,8019487.25,123.0,69.6923076923077,13,840,8001479.583333333,123.0,64.61538461538461
90038463.0,17,28,13364,28,13364,3334757.888888889,501.0,477.2857142857143,0,0,0.0,0.0,0.0
2272190.0,6,49,23728,25,19797,94674.58333333331,1514.0,791.88,24,3931,89423.65217391304,1514.0,163.79166666666666
108108117.0,17,5,955,5,955,27027029.25,191.0,191.0,0,0,0.0,0.0,0.0
43438.0,6,14,4740,7,653,6140.333333333333,249.0,93.28571428571428,7,4087,6956.833333333333,1514.0,583.8571428571429
315675.0,17,4,1400,4,1400,105225.0,350.0,350.0,0,0,0.0,0.0,0.0
375081.0,6,11,1021,6,444,51296.2,162.0,74.0,5,577,63892.75,349.0,115.4
32205.0,6,14,4740,7,653,4030.6666666666665,249.0,93.28571428571428,7,4087,4975.333333333333,1514.0,583.8571428571429
443.0,17,2,267,1,83,0.0,83.0,83.0,1,184,0.0,184.0,184.0
171661.0,17,2,180,1,90,0.0,90.0,90.0,1,90,0.0,90.0,90.0
2441.0,17,4,344,2,150,0.0,75.0,75.0,2,194,0.0,103.0,97.0
855928.0,6,9,1096,6,625,171185.6,287.0,104.16666666666669,3,471,290211.0,331.0,157.0
315390.0,17,4,1400,4,1400,105130.0,350.0,350.0,0,0,0.0,0.0,0.0
217810.0,6,3,426,2,280,0.0,214.0,140.0,1,146,0.0,146.0,146.0
100061220.0,17,11,604,6,389,19915659.0,174.0,64.83333333333333,5,215,20001576.5,43.0,43.0
49673.0,6,10,2032,5,524,12196.5,252.0,104.8,5,1508,10631.0,1236.0,301.6
59948.0,6,14,4740,7,653,9132.166666666666,249.0,93.28571428571428,7,4087,8826.0,1514.0,583.8571428571429
42165.0,6,14,4740,7,653,6900.833333333333,249.0,93.28571428571428,7,4087,6850.5,1514.0,583.8571428571429
153430.0,17,2,180,1,90,0.0,90.0,90.0,1,90,0.0,90.0,90.0
209598.0,17,2,180,1,90,0.0,90.0,90.0,1,90,0.0,90.0,90.0
222554.0,6,10,1221,6,636,44510.8,298.0,106.0,4,585,72901.66666666667,379.0,146.25
103309985.0,6,43,2838,22,1452,4919510.714285715,66.0,66.0,21,1386,5144003.2,66.0,66.0
90031512.0,17,28,13364,28,13364,3334500.4444444445,501.0,477.2857142857143,0,0,0.0,0.0,0.0
118923951.0,6,47,3102,24,1584,5157034.391304348,66.0,66.0,23,1518,5155443.818181818,66.0,66.0
906.0,17,5,550,5,550,226.5,110.0,110.0,0,0,0.0,0.0,0.0
206384.0,6,3,426,2,280,0.0,214.0,140.0,1,146,0.0,146.0,146.0
27742.0,6,14,4740,7,653,4406.5,249.0,93.28571428571428,7,4087,4486.333333333333,1514.0,583.8571428571429
300805.0,6,6,412,4,272,100268.33333333331,74.0,68.0,2,140,0.0,74.0,70.0
108101263.0,17,5,1005,5,1005,27025315.75,201.0,201.0,0,0,0.0,0.0,0.0
122441.0,6,3,373,2,238,0.0,172.0,119.0,1,135,0.0,135.0,135.0
316318.0,17,4,1400,4,1400,105439.33333333331,350.0,350.0,0,0,0.0,0.0,0.0
216386.0,17,2,180,1,90,0.0,90.0,90.0,1,90,0.0,90.0,90.0
1984026.0,6,23,6507,12,1529,180366.0,357.0,127.41666666666669,11,4978,167484.9,1510.0,452.54545454545456
1861.0,17,2,176,1,80,0.0,80.0,80.0,1,96,0.0,96.0,96.0
11611.0,6,10,2032,5,524,2676.25,252.0,104.8,5,1508,2458.5,1236.0,301.6
696.0,17,2,508,2,508,0.0,257.0,254.0,0,0,0.0,0.0,0.0
10493885.0,6,7,478,4,272,3452069.6666666665,74.0,68.0,3,206,5177998.5,74.0,68.66666666666667
41312.0,6,14,4740,7,653,6750.5,249.0,93.28571428571428,7,4087,6740.166666666667,1514.0,583.8571428571429
90528996.0,6,15,2444,8,1016,12932713.714285716,188.0,127.0,7,1428,15060833.833333334,204.0,204.0
307450.0,6,6,412,4,272,102483.33333333331,74.0,68.0,2,140,0.0,74.0,70.0
283660.0,17,2,414,1,88,0.0,88.0,88.0,1,326,0.0,326.0,326.0
2914729.0,6,3,1602,1,752,0.0,752.0,752.0,2,850,0.0,784.0,425.0
108100632.0,17,5,1005,5,1005,27025158.0,201.0,201.0,0,0,0.0,0.0,0.0
246236.0,6,3,337,2,214,0.0,160.0,107.0,1,123,0.0,123.0,123.0
132728.0,6,2,132,1,66,0.0,66.0,66.0,1,66,0.0,66.0,66.0
148035.0,17,2,180,1,90,0.0,90.0,90.0,1,90,0.0,90.0,90.0
843851.0,6,9,1196,6,725,168770.2,387.0,120.83333333333331,3,471,285597.0,331.0,157.0
302399.0,6,2,132,1,66,0.0,66.0,66.0,1,66,0.0,66.0,66.0
210577.0,17,2,180,1,90,0.0,90.0,90.0,1,90,0.0,90.0,90.0
153542.0,17,2,180,1,90,0.0,90.0,90.0,1,90,0.0,90.0,90.0
860006.0,6,9,1268,6,797,172001.2,459.0,132.83333333333334,3,471,292207.0,331.0,157.0
243305.0,6,3,337,2,214,0.0,160.0,107.0,1,123,0.0,123.0,123.0
41253.0,6,14,4740,7,653,6760.0,249.0,93.28571428571428,7,4087,5763.666666666667,1514.0,583.8571428571429
94163732.0,6,26,1762,13,922,7829003.5,139.0,70.92307692307692,13,840,7829005.333333333,123.0,64.61538461538461
1440848.0,6,7,499,4,301,466514.3333333333,103.0,75.25,3,198,614021.5,66.0,66.0
9852.0,17,2,571,1,86,0.0,86.0,86.0,1,485,0.0,485.0,485.0
146203.0,6,3,337,2,214,0.0,160.0,107.0,1,123,0.0,123.0,123.0
234650.0,6,3,373,2,238,0.0,172.0,119.0,1,135,0.0,135.0,135.0
540220.0,6,10,1221,6,636,108044.0,298.0,106.0,4,585,174259.33333333334,379.0,146.25
18896.0,6,11,1132,6,556,3062.4,218.0,92.66666666666669,5,576,4323.75,304.0,115.2
120926819.0,6,33,2296,17,1225,7557926.1875,139.0,72.05882352941177,16,1071,7381578.333333333,123.0,66.9375
232920.0,6,3,337,2,214,0.0,160.0,107.0,1,123,0.0,123.0,123.0
2374.0,17,2,932,1,590,0.0,590.0,590.0,1,342,0.0,342.0,342.0
14754891.0,6,20,1607,10,975,1603724.5555555555,315.0,97.5,10,632,1603925.111111111,78.0,63.2
207149.0,6,3,426,2,280,0.0,214.0,140.0,1,146,0.0,146.0,146.0
250901.0,17,4,6056,4,6056,83633.66666666667,1514.0,1514.0,0,0,0.0,0.0,0.0
123610566.0,6,49,3234,25,1650,5150440.25,66.0,66.0,24,1584,5065486.0,66.0,66.0
108107255.0,17,5,955,5,955,27026813.75,191.0,191.0,0,0,0.0,0.0,0.0
2258.0,17,4,344,2,150,0.0,75.0,75.0,2,194,0.0,103.0,97.0
358.0,17,2,160,1,80,0.0,80.0,80.0,1,80,0.0,80.0,80.0
167473.0,17,4,704,2,148,0.0,74.0,74.0,2,556,0.0,280.0,278.0
33656.0,6,14,4740,7,653,5364.333333333333,249.0,93.28571428571428,7,4087,5114.333333333333,1514.0,583.8571428571429
120121813.0,6,16,2510,8,1494,17160259.0,204.0,186.75,8,1016,17135384.42857143,188.0,127.0
198751.0,17,2,180,1,90,0.0,90.0,90.0,1,90,0.0,90.0,90.0
2599744.0,6,2,132,1,66,0.0,66.0,66.0,1,66,0.0,66.0,66.0
16526.0,6,12,1393,6,796,2788.4,271.0,132.66666666666666,6,597,3056.2,259.0,99.5
100590612.0,17,12,778,6,389,20118122.4,174.0,64.83333333333333,6,389,19989820.0,174.0,64.83333333333333
104713.0,17,2,582,1,83,0.0,83.0,83.0,1,499,0.0,499.0,499.0
60488.0,6,14,4740,7,653,9895.666666666666,249.0,93.28571428571428,7,4087,8683.0,1514.0,583.8571428571429
8428511.0,17,4,1376,3,1026,903221.5,342.0,342.0,1,350,0.0,350.0,350.0
13805.0,17,2,582,1,83,0.0,83.0,83.0,1,499,0.0,499.0,499.0
207731.0,6,3,426,2,280,0.0,214.0,140.0,1,146,0.0,146.0,146.0
37474.0,6,14,4740,7,653,6087.5,249.0,93.28571428571428,7,4087,5022.333333333333,1514.0,583.8571428571429
108801982.0,6,21,1585,10,745,12089109.111111112,95.0,74.5,11,840,10855203.9,95.0,76.36363636363636
106459.0,17,2,286,2,286,0.0,143.0,143.0,0,0,0.0,0.0,0.0
48121.0,6,11,2098,6,590,9624.2,252.0,98.33333333333331,5,1508,8596.25,1236.0,301.6
20699.0,6,14,4740,7,653,3229.833333333333,249.0,93.28571428571428,7,4087,3121.833333333333,1514.0,583.8571428571429
36704.0,6,14,4740,7,653,5309.833333333333,249.0,93.28571428571428,7,4087,5979.666666666667,1514.0,583.8571428571429
2782205.0,6,2,132,1,66,0.0,66.0,66.0,1,66,0.0,66.0,66.0
334469.0,6,6,412,4,272,111489.66666666669,74.0,68.0,2,140,0.0,74.0,70.0
1478022.0,17,16,1120,16,1120,98534.8,70.0,70.0,0,0,0.0,0.0,0.0
45006.0,6,10,2032,5,524,11040.5,252.0,104.8,5,1508,11022.25,1236.0,301.6
118725893.0,6,33,2274,17,1125,7420342.4375,123.0,66.17647058823529,16,1149,7249334.866666666,123.0,71.8125
1038275.0,6,11,1134,6,558,207655.0,220.0,93.0,5,576,257438.25,304.0,115.2
1234802.0,6,13,3012,8,2384,176400.2857142857,1514.0,298.0,5,628,236837.5,331.0,125.6
120024312.0,17,28,13364,28,13364,4445344.888888889,501.0,477.2857142857143,0,0,0.0,0.0,0.0
17914.0,6,14,4740,7,653,2698.5,249.0,93.28571428571428,7,4087,2845.1666666666665,1514.0,583.8571428571429
689.0,17,4,438,2,148,0.0,74.0,74.0,2,290,0.0,147.0,145.0
42320251.0,6,26,7627,14,3735,190433.84615384616,1514.0,266.7857142857143,12,3892,3828668.909090909,1514.0,324.3333333333333
701.0,17,4,438,2,148,0.0,74.0,74.0,2,290,0.0,147.0,145.0
12733.0,6,12,1393,6,796,2415.8,271.0,132.66666666666666,6,597,2380.8,259.0,99.5
77195.0,6,13,1394,7,797,11878.0,253.0,113.85714285714286,6,597,14540.2,259.0,99.5
1302334.0,6,4,264,2,132,0.0,66.0,66.0,2,132,0.0,66.0,66.0
255581.0,6,3,337,2,214,0.0,160.0,107.0,1,123,0.0,123.0,123.0
207455.0,6,3,426,2,280,0.0,214.0,140.0,1,146,0.0,146.0,146.0
2081387.0,6,27,11985,15,4361,148670.5,1510.0,290.7333333333333,12,7624,161623.9090909091,1510.0,635.3333333333334
106736489.0,6,30,2106,15,1089,7608604.571428572,123.0,72.6,15,1017,7608606.928571428,123.0,67.8
14650663.0,6,20,1607,10,975,1593049.5555555555,315.0,97.5,10,632,1593022.3333333333,78.0,63.2
2235.0,17,2,180,1,90,0.0,90.0,90.0,1,90,0.0,90.0,90.0
122975301.0,6,48,3168,24,1584,5183711.173913044,66.0,66.0,24,1584,5083374.521739131,66.0,66.0
98003191.0,17,12,778,6,389,19600638.2,174.0,64.83333333333333,6,389,19400160.2,174.0,64.83333333333333
2329.0,17,4,344,2,150,0.0,75.0,75.0,2,194,0.0,103.0,97.0
51824.0,6,14,4740,7,653,7105.333333333333,249.0,93.28571428571428,7,4087,8278.0,1514.0,583.8571428571429
147381.0,6,3,373,2,238,0.0,172.0,119.0,1,135,0.0,135.0,135.0
246907.0,6,3,337,2,214,0.0,160.0,107.0,1,123,0.0,123.0,123.0
2803330.0,6,2,132,1,66,0.0,66.0,66.0,1,66,0.0,66.0,66.0
1984.0,17,4,344,2,150,0.0,75.0,75.0,2,194,0.0,103.0,97.0
1313563.0,17,2,180,1,90,0.0,90.0,90.0,1,90,0.0,90.0,90.0
27366968.0,17,5,1710,5,1710,6841742.0,342.0,342.0,0,0,0.0,0.0,0.0
895575.0,6,12,2708,7,742,149262.5,338.0,106.0,5,1966,155740.5,1514.0,393.2
33649.0,6,10,2032,5,524,8118.25,252.0,104.8,5,1508,7850.5,1236.0,301.6
92880290.0,6,38,2508,19,1254,5160001.888888889,66.0,66.0,19,1254,5160002.611111111,66.0,66.0
108099485.0,17,5,1005,5,1005,27024871.25,201.0,201.0,0,0,0.0,0.0,0.0
81522.0,6,10,2032,5,524,18656.5,252.0,104.8,5,1508,18327.0,1236.0,301.6
108104663.0,17,5,1005,5,1005,27026165.75,201.0,201.0,0,0,0.0,0.0,0.0
352.0,17,2,267,1,83,0.0,83.0,83.0,1,184,0.0,184.0,184.0
109011343.0,6,31,2176,16,1071,7267422.866666666,123.0,66.9375,15,1105,7221864.857142857,139.0,73.66666666666667
9399.0,17,2,571,1,86,0.0,86.0,86.0,1,485,0.0,485.0,485.0
90028704.0,17,28,13364,28,13364,3334396.4444444445,501.0,477.2857142857143,0,0,0.0,0.0,0.0
162458.0,17,2,180,1,90,0.0,90.0,90.0,1,90,0.0,90.0,90.0
53820.0,6,14,4740,7,653,8777.666666666666,249.0,93.28571428571428,7,4087,8751.333333333334,1514.0,583.8571428571429
147166.0,6,3,373,2,238,0.0,172.0,119.0,1,135,0.0,135.0,135.0
113243520.0,6,48,3168,24,1584,4923631.304347826,66.0,66.0,24,1584,4914235.869565218,66.0,66.0
121465.0,6,3,337,2,214,0.0,160.0,107.0,1,123,0.0,123.0,123.0
37314.0,6,14,4740,7,653,5082.5,249.0,93.28571428571428,7,4087,6071.5,1514.0,583.8571428571429
308249.0,6,7,478,4,272,102749.66666666669,74.0,68.0,3,206,80554.5,74.0,68.66666666666667
90253809.0,6,12,1832,8,1016,12893401.285714284,188.0,127.0,4,816,30029704.33333333,204.0,204.0
90269564.0,6,14,2240,8,1016,12895652.0,188.0,127.0,6,1224,18017853.6,204.0,204.0
6028.0,17,2,180,1,90,0.0,90.0,90.0,1,90,0.0,90.0,90.0
4585.0,17,2,180,1,90,0.0,90.0,90.0,1,90,0.0,90.0,90.0
116521850.0,6,48,3168,24,1584,5066167.391304348,66.0,66.0,24,1584,5056769.521739131,66.0,66.0
92255239.0,17,16,5472,16,5472,6150349.266666667,342.0,342.0,0,0,0.0,0.0,0.0
120011641.0,6,23,1734,12,935,10909085.909090908,95.0,77.91666666666667,11,799,11973706.5,95.0,72.63636363636364
34673.0,6,14,4740,7,653,4352.0,249.0,93.28571428571428,7,4087,5608.5,1514.0,583.8571428571429
102900.0,17,2,286,2,286,0.0,143.0,143.0,0,0,0.0,0.0,0.0
94860914.0,6,40,2640,20,1320,4992679.684210527,66.0,66.0,20,1320,4976433.263157895,66.0,66.0
302619.0,6,6,412,4,272,100873.0,74.0,68.0,2,140,0.0,74.0,70.0
51713.0,6,14,4740,7,653,8247.166666666666,249.0,93.28571428571428,7,4087,8418.833333333334,1514.0,583.8571428571429
47932.0,6,14,4740,7,653,7852.5,249.0,93.28571428571428,7,4087,7392.5,1514.0,583.8571428571429
120004708.0,6,23,1734,12,935,10909083.363636363,95.0,77.91666666666667,11,799,11973434.2,95.0,72.63636363636364
52942.0,6,14,4740,7,653,8657.0,249.0,93.28571428571428,7,4087,7746.166666666667,1514.0,583.8571428571429
143897.0,17,2,180,1,90,0.0,90.0,90.0,1,90,0.0,90.0,90.0
511456.0,6,5,336,2,134,0.0,68.0,67.0,3,202,186080.5,70.0,67.33333333333333
1245127.0,6,7,499,3,198,614114.0,66.0,66.0,4,301,400653.6666666667,103.0,75.25
41993037.0,6,4,1670,3,917,20996518.5,785.0,305.6666666666667,1,753,0.0,753.0,753.0
90920314.0,6,21,1585,11,840,9090885.6,95.0,76.36363636363636,10,745,10101218.888888888,95.0,74.5
111946.0,17,2,286,2,286,0.0,143.0,143.0,0,0,0.0,0.0,0.0
208451.0,6,3,426,2,280,0.0,214.0,140.0,1,146,0.0,146.0,146.0
257242.00000000003,17,2,180,1,90,0.0,90.0,90.0,1,90,0.0,90.0,90.0
14135.0,6,14,4740,7,653,2247.0,249.0,93.28571428571428,7,4087,2215.833333333333,1514.0,583.8571428571429
250072.00000000003,6,3,373,2,238,0.0,172.0,119.0,1,135,0.0,135.0,135.0
39742.0,6,14,4740,7,653,6097.666666666667,249.0,93.28571428571428,7,4087,6427.166666666667,1514.0,583.8571428571429
306164.0,6,6,412,4,272,102054.66666666669,74.0,68.0,2,140,0.0,74.0,70.0
120051858.0,17,29,13785,29,13785,4287566.357142857,501.0,475.3448275862069,0,0,0.0,0.0,0.0
66218.0,6,14,4740,7,653,10580.666666666666,249.0,93.28571428571428,7,4087,9371.666666666666,1514.0,583.8571428571429
104248015.0,6,204,22980,102,16026,1030027.7029702972,284.0,157.11764705882354,102,6954,1030027.7029702972,140.0,68.17647058823529
1308572.0,6,4,264,2,132,0.0,66.0,66.0,2,132,0.0,66.0,66.0
839.0,17,5,550,5,550,209.75,110.0,110.0,0,0,0.0,0.0,0.0
4211.0,17,2,626,1,72,0.0,72.0,72.0,1,554,0.0,554.0,554.0
838142.0,6,9,1118,6,586,167628.4,248.0,97.66666666666669,3,532,281177.5,392.0,177.33333333333334
323.0,17,2,174,1,79,0.0,79.0,79.0,1,95,0.0,95.0,95.0
102079552.0,6,30,2106,15,1089,7291396.571428572,123.0,72.6,15,1017,7275924.785714285,123.0,67.8
155933.0,17,2,180,1,90,0.0,90.0,90.0,1,90,0.0,90.0,90.0
34522.0,6,14,4740,7,653,4053.1666666666665,249.0,93.28571428571428,7,4087,5618.833333333333,1514.0,583.8571428571429
0.0,17,1,381,1,381,0.0,381.0,381.0,0,0,0.0,0.0,0.0
232295.0,6,3,337,2,214,0.0,160.0,107.0,1,123,0.0,123.0,123.0
135138236.0,17,6,1146,6,1146,27027647.2,191.0,191.0,0,0,0.0,0.0,0.0
2805016.0,6,2,132,1,66,0.0,66.0,66.0,1,66,0.0,66.0,66.0
120693347.0,6,269,30728,135,21588,900696.6194029851,284.0,159.9111111111111,134,9140,894923.1428571428,140.0,68.2089552238806
90029946.0,17,28,13364,28,13364,3334442.4444444445,501.0,477.2857142857143,0,0,0.0,0.0,0.0
294.0,17,2,164,1,82,0.0,82.0,82.0,1,82,0.0,82.0,82.0
332.0,17,2,166,1,75,0.0,75.0,75.0,1,91,0.0,91.0,91.0
5428.0,17,4,344,2,150,0.0,75.0,75.0,2,194,0.0,103.0,97.0
152171.0,17,2,414,1,88,0.0,88.0,88.0,1,326,0.0,326.0,326.0
92989876.0,6,157,17718,79,5436,1192177.8974358975,140.0,68.81012658227849,78,12282,1180827.3376623376,284.0,157.46153846153845
173241.0,17,4,704,2,148,0.0,74.0,74.0,2,556,0.0,280.0,278.0
8951.0,6,10,2032,5,524,2016.5,252.0,104.8,5,1508,1864.0,1236.0,301.6
232294.0,6,3,337,2,214,0.0,160.0,107.0,1,123,0.0,123.0,123.0
1040683.0,6,11,1134,6,558,208136.6,220.0,93.0,5,576,256655.0,304.0,115.2
169961.0,17,2,1500,1,994,0.0,994.0,994.0,1,506,0.0,506.0,506.0
148221.0,17,4,1524,4,1524,49407.0,381.0,381.0,0,0,0.0,0.0,0.0
90321585.0,6,16,1192,8,596,12894297.142857144,95.0,74.5,8,596,12899431.285714284,95.0,74.5
26613.0,6,14,4740,7,653,4327.666666666667,249.0,93.28571428571428,7,4087,3939.6666666666665,1514.0,583.8571428571429
216412.0,17,2,180,1,90,0.0,90.0,90.0,1,90,0.0,90.0,90.0
232228.0,6,3,337,2,214,0.0,160.0,107.0,1,123,0.0,123.0,123.0
90758232.0,6,19,1436,10,745,10079478.666666666,95.0,74.5,9,691,11343641.25,95.0,76.77777777777777
2098.0,17,4,344,2,150,0.0,75.0,75.0,2,194,0.0,103.0,97.0
8935.0,17,2,498,1,80,0.0,80.0,80.0,1,418,0.0,418.0,418.0
291893.0,6,10,1221,6,636,58378.6,298.0,106.0,4,585,90567.0,379.0,146.25
35392.0,6,10,2032,5,524,8642.5,252.0,104.8,5,1508,8456.25,1236.0,301.6
90007592.0,17,28,13364,28,13364,3333614.5185185187,501.0,477.2857142857143,0,0,0.0,0.0,0.0
3045975.0,6,4,270,3,202,1522987.5,70.0,67.33333333333333,1,68,0.0,68.0,68.0
122975429.0,6,48,3168,24,1584,5212772.782608695,66.0,66.0,24,1584,5054319.130434782,66.0,66.0
2363.0,17,4,344,2,150,0.0,75.0,75.0,2,194,0.0,103.0,97.0
308305.0,17,2,180,1,90,0.0,90.0,90.0,1,90,0.0,90.0,90.0
143840.0,17,2,180,1,90,0.0,90.0,90.0,1,90,0.0,90.0,90.0
104300121.0,6,33,2428,17,1288,6505267.75,139.0,75.76470588235294,16,1140,6938952.266666667,123.0,71.25
232479.0,6,3,337,2,214,0.0,160.0,107.0,1,123,0.0,123.0,123.0
153438.0,17,2,180,1,90,0.0,90.0,90.0,1,90,0.0,90.0,90.0
228218.0,17,2,180,1,90,0.0,90.0,90.0,1,90,0.0,90.0,90.0
135140172.0,17,6,1146,6,1146,27028034.4,191.0,191.0,0,0,0.0,0.0,0.0
2048141.0,17,6,1039,4,312,682538.6666666666,78.0,78.0,2,727,0.0,395.0,363.5
228178.0,17,2,180,1,90,0.0,90.0,90.0,1,90,0.0,90.0,90.0
135139516.0,17,6,1206,6,1206,27027903.2,201.0,201.0,0,0,0.0,0.0,0.0
75725.0,6,14,4740,7,653,12175.333333333334,249.0,93.28571428571428,7,4087,11293.666666666666,1514.0,583.8571428571429
369.0,17,2,283,1,78,0.0,78.0,78.0,1,205,0.0,205.0,205.0
97877699.0,6,181,20382,91,6228,1087529.9888888889,140.0,68.43956043956044,90,14154,1088239.8764044945,284.0,157.26666666666668
340.0,17,2,250,1,93,0.0,93.0,93.0,1,157,0.0,157.0,157.0
26836.0,6,14,4740,7,653,4017.6666666666665,249.0,93.28571428571428,7,4087,4172.833333333333,1514.0,583.8571428571429
58614.0,6,14,4740,7,653,9060.333333333334,249.0,93.28571428571428,7,4087,7352.166666666667,1514.0,583.8571428571429
6586.0,17,4,344,2,150,0.0,75.0,75.0,2,194,0.0,103.0,97.0
90058653.0,17,28,13364,28,13364,3335505.6666666665,501.0,477.2857142857143,0,0,0.0,0.0,0.0
6787.0,17,2,582,1,83,0.0,83.0,83.0,1,499,0.0,499.0,499.0
2809100.0,6,2,132,1,66,0.0,66.0,66.0,1,66,0.0,66.0,66.0
119360688.0,17,35,16705,35,16705,3510608.470588235,501.0,477.2857142857143,0,0,0.0,0.0,0.0
90744293.0,6,17,1287,9,691,11336708.875,95.0,76.77777777777777,8,596,12963100.142857144,95.0,74.5
206764.0,6,10,1066,5,490,50766.75,218.0,98.0,5,576,51107.0,304.0,115.2
90749335.0,6,18,1341,9,691,11343666.875,95.0,76.77777777777777,9,650,11306388.25,95.0,72.22222222222223
110303570.0,17,14,864,7,432,18334226.83333333,174.0,61.71428571428572,7,432,18333508.83333333,174.0,61.71428571428572
2162.0,17,2,180,1,90,0.0,90.0,90.0,1,90,0.0,90.0,90.0
33571.0,6,14,4740,7,653,4396.0,249.0,93.28571428571428,7,4087,4879.833333333333,1514.0,583.8571428571429
105205.0,17,2,700,2,700,0.0,350.0,350.0,0,0,0.0,0.0,0.0
5005566.0,17,4,849,2,166,0.0,83.0,83.0,2,683,0.0,499.0,341.5
282177.0,17,2,363,1,79,0.0,79.0,79.0,1,284,0.0,284.0,284.0
206158.0,17,2,180,1,90,0.0,90.0,90.0,1,90,0.0,90.0,90.0
81679.0,6,14,4740,7,653,11249.0,249.0,93.28571428571428,7,4087,12837.5,1514.0,583.8571428571429
309150.0,17,4,1400,4,1400,103050.0,350.0,350.0,0,0,0.0,0.0,0.0
217671.0,17,2,180,1,90,0.0,90.0,90.0,1,90,0.0,90.0,90.0
90093476.0,6,13,2052,6,1224,18018444.4,204.0,204.0,7,828,14970384.333333334,188.0,118.28571428571428
4522.0,17,2,602,1,72,0.0,72.0,72.0,1,530,0.0,530.0,530.0
40305.0,6,14,4740,7,653,6594.333333333333,249.0,93.28571428571428,7,4087,6035.0,1514.0,583.8571428571429
2599827.0,6,2,132,1,66,0.0,66.0,66.0,1,66,0.0,66.0,66.0
349.0,17,2,267,1,83,0.0,83.0,83.0,1,184,0.0,184.0,184.0
108110412.0,17,5,955,5,955,27027603.0,191.0,191.0,0,0,0.0,0.0,0.0
189186.0,17,2,762,2,762,0.0,381.0,381.0,0,0,0.0,0.0,0.0
113431568.0,6,47,3102,24,1584,4920348.608695652,66.0,66.0,23,1518,5135426.0,66.0,66.0
2301.0,17,4,344,2,150,0.0,75.0,75.0,2,194,0.0,103.0,97.0
121439805.0,6,217,24612,109,17262,1124442.638888889,284.0,158.36697247706422,108,7350,1106852.0654205608,140.0,68.05555555555556
3816.0,17,4,344,2,150,0.0,75.0,75.0,2,194,0.0,103.0,97.0
153434.0,17,2,180,1,90,0.0,90.0,90.0,1,90,0.0,90.0,90.0
204837.0,17,2,180,1,90,0.0,90.0,90.0,1,90,0.0,90.0,90.0
130438.0,6,3,337,2,214,0.0,160.0,107.0,1,123,0.0,123.0,123.0
135133437.0,17,6,1206,6,1206,27026687.4,201.0,201.0,0,0,0.0,0.0,0.0
108105728.0,17,5,1005,5,1005,27026432.0,201.0,201.0,0,0,0.0,0.0,0.0
36944.0,6,14,4740,7,653,5936.666666666667,249.0,93.28571428571428,7,4087,5821.166666666667,1514.0,583.8571428571429
179836.0,17,2,180,1,90,0.0,90.0,90.0,1,90,0.0,90.0,90.0
35505.0,6,14,4740,7,653,5636.666666666667,249.0,93.28571428571428,7,4087,5775.0,1514.0,583.8571428571429
108100662.0,17,5,955,5,955,27025165.5,191.0,191.0,0,0,0.0,0.0,0.0
210790.0,6,3,426,2,280,0.0,214.0,140.0,1,146,0.0,146.0,146.0
209657.0,17,2,180,1,90,0.0,90.0,90.0,1,90,0.0,90.0,90.0
2400.0,17,4,344,2,150,0.0,75.0,75.0,2,194,0.0,103.0,97.0
26658093.0,17,5,1710,5,1710,6664523.25,342.0,342.0,0,0,0.0,0.0,0.0
27346.0,6,10,2032,5,524,6613.25,252.0,104.8,5,1508,6668.25,1236.0,301.6
119621676.0,6,274,31328,137,22064,877987.5955882353,284.0,161.05109489051094,137,9264,877987.3382352941,140.0,67.62043795620438
9205.0,17,2,582,1,83,0.0,83.0,83.0,1,499,0.0,499.0,499.0
542857.0,6,2,132,1,66,0.0,66.0,66.0,1,66,0.0,66.0,66.0
6615.0,17,4,344,2,150,0.0,75.0,75.0,2,194,0.0,103.0,97.0
135130985.0,17,6,1206,6,1206,27026197.0,201.0,201.0,0,0,0.0,0.0,0.0
41677.0,6,12,1320,7,789,6946.166666666667,253.0,112.71428571428572,5,531,8958.5,259.0,106.2
1970.0,17,4,344,2,150,0.0,75.0,75.0,2,194,0.0,103.0,97.0
2423.0,17,4,344,2,150,0.0,75.0,75.0,2,194,0.0,103.0,97.0
392.0,17,2,166,1,75,0.0,75.0,75.0,1,91,0.0,91.0,91.0
103019319.0,6,30,2122,15,1105,7358522.785714285,139.0,73.66666666666667,15,1017,7343074.928571428,123.0,67.8
146327.0,6,3,337,2,214,0.0,160.0,107.0,1,123,0.0,123.0,123.0
207131.0,6,3,426,2,280,0.0,214.0,140.0,1,146,0.0,146.0,146.0
65015.0,6,14,4740,7,653,10708.833333333334,249.0,93.28571428571428,7,4087,10657.833333333334,1514.0,583.8571428571429
38794.0,6,14,4740,7,653,5912.333333333333,249.0,93.28571428571428,7,4087,5789.666666666667,1514.0,583.8571428571429
8071.999999999999,17,2,582,1,83,0.0,83.0,83.0,1,499,0.0,499.0,499.0
99618.0,17,2,762,2,762,0.0,381.0,381.0,0,0,0.0,0.0,0.0
102379.0,17,2,286,2,286,0.0,143.0,143.0,0,0,0.0,0.0,0.0
120000957.0,17,15,907,8,475,17142993.85714286,174.0,59.375,7,432,16667825.333333334,174.0,61.71428571428572
332.0,17,2,248,1,84,0.0,84.0,84.0,1,164,0.0,164.0,164.0
228155.0,17,2,180,1,90,0.0,90.0,90.0,1,90,0.0,90.0,90.0
298.0,17,2,164,1,82,0.0,82.0,82.0,1,82,0.0,82.0,82.0
1306987.0,6,4,264,2,132,0.0,66.0,66.0,2,132,0.0,66.0,66.0
28526.0,6,14,4740,7,653,4364.833333333333,249.0,93.28571428571428,7,4087,4612.333333333333,1514.0,583.8571428571429
217254.0,17,2,359,1,75,0.0,75.0,75.0,1,284,0.0,284.0,284.0
228382.0,6,13,1394,7,797,38063.66666666666,253.0,113.85714285714286,6,597,43903.6,259.0,99.5
141776.0,17,4,704,2,148,0.0,74.0,74.0,2,556,0.0,280.0,278.0
120000306.0,6,20,1531,11,840,12000030.6,95.0,76.36363636363636,9,691,11341727.375,95.0,76.77777777777777
446833.0,6,11,1021,6,444,60721.4,162.0,74.0,5,577,75612.25,349.0,115.4
315289.0,17,4,1400,4,1400,105096.33333333331,350.0,350.0,0,0,0.0,0.0,0.0
122687769.0,6,48,3168,24,1584,4937313.739130435,66.0,66.0,24,1584,5271012.260869565,66.0,66.0
106035.0,17,2,700,2,700,0.0,350.0,350.0,0,0,0.0,0.0,0.0
63371.0,6,13,1513,7,882,10561.833333333334,291.0,126.0,6,631,10843.2,293.0,105.16666666666669
54372.0,6,14,4740,7,653,7896.5,249.0,93.28571428571428,7,4087,8899.166666666666,1514.0,583.8571428571429
57818.0,6,14,4740,7,653,9505.666666666666,249.0,93.28571428571428,7,4087,8182.666666666667,1514.0,583.8571428571429
2326.0,17,4,344,2,150,0.0,75.0,75.0,2,194,0.0,103.0,97.0
32003.0,6,14,4740,7,653,4752.166666666667,249.0,93.28571428571428,7,4087,4724.5,1514.0,583.8571428571429
320157.0,17,4,1400,4,1400,106719.0,350.0,350.0,0,0,0.0,0.0,0.0
38037.0,6,10,2032,5,524,9265.5,252.0,104.8,5,1508,8735.75,1236.0,301.6
1314472.0,6,4,264,2,132,0.0,66.0,66.0,2,132,0.0,66.0,66.0
306810.0,6,3,202,2,128,0.0,74.0,64.0,1,74,0.0,74.0,74.0
232582.0,6,3,337,2,214,0.0,160.0,107.0,1,123,0.0,123.0,123.0
108116346.0,17,5,1005,5,1005,27029086.5,201.0,201.0,0,0,0.0,0.0,0.0
120136102.0,6,241,27154,121,8282,1001134.1833333332,140.0,68.44628099173553,120,18872,1001691.462184874,284.0,157.26666666666668
237423.0,6,3,337,2,214,0.0,160.0,107.0,1,123,0.0,123.0,123.0
305855.0,6,6,412,4,272,101951.66666666669,74.0,68.0,2,140,0.0,74.0,70.0
3058956.0,6,3,1777,2,951,0.0,885.0,475.5,1,826,0.0,826.0,826.0
51214.0,6,10,2032,5,524,11944.75,252.0,104.8,5,1508,12471.5,1236.0,301.6
0.0,6,1,54,0,0,0.0,0.0,0.0,1,54,0.0,54.0,54.0
2597085.0,6,2,132,1,66,0.0,66.0,66.0,1,66,0.0,66.0,66.0
126001361.0,17,15,907,8,475,18000194.42857143,174.0,59.375,7,432,17667124.5,174.0,61.71428571428572
308970.0,17,4,1400,4,1400,102990.0,350.0,350.0,0,0,0.0,0.0,0.0
23758.0,6,13,1459,7,862,3882.5,271.0,123.14285714285714,6,597,2942.6,259.0,99.5
52642.0,6,14,4740,7,653,8656.5,249.0,93.28571428571428,7,4087,7292.166666666667,1514.0,583.8571428571429
135124223.0,17,6,1146,6,1146,27024844.6,191.0,191.0,0,0,0.0,0.0,0.0
58854782.0,17,9,3086,8,2736,5109319.571428572,342.0,342.0,1,350,0.0,350.0,350.0
233418.0,6,3,337,2,214,0.0,160.0,107.0,1,123,0.0,123.0,123.0
1467832.0,17,16,1120,16,1120,97855.46666666666,70.0,70.0,0,0,0.0,0.0,0.0
104347.0,17,2,286,2,286,0.0,143.0,143.0,0,0,0.0,0.0,0.0
42417.0,6,10,2032,5,524,10065.5,252.0,104.8,5,1508,8026.75,1236.0,301.6
1151179.0,6,13,3010,8,2382,164454.14285714287,1514.0,297.75,5,628,219655.0,331.0,125.6
302235.0,6,6,412,4,272,100745.0,74.0,68.0,2,140,0.0,74.0,70.0
90013951.0,17,27,12943,27,12943,3462075.0384615385,501.0,479.3703703703704,0,0,0.0,0.0,0.0
25336.0,6,14,4740,7,653,4048.3333333333335,249.0,93.28571428571428,7,4087,3871.0,1514.0,583.8571428571429
90764945.0,6,19,1436,10,745,10080041.0,95.0,74.5,9,691,11345101.5,95.0,76.77777777777777
135130356.0,17,6,1206,6,1206,27026071.2,201.0,201.0,0,0,0.0,0.0,0.0
2705920.0,6,2,132,1,66,0.0,66.0,66.0,1,66,0.0,66.0,66.0
108105481.0,17,5,955,5,955,27026370.25,191.0,191.0,0,0,0.0,0.0,0.0
30735.0,6,14,4740,7,653,4954.5,249.0,93.28571428571428,7,4087,4986.5,1514.0,583.8571428571429
158.0,17,2,3028,2,3028,0.0,1514.0,1514.0,0,0,0.0,0.0,0.0
41235.0,6,14,4740,7,653,6436.333333333333,249.0,93.28571428571428,7,4087,6441.666666666667,1514.0,583.8571428571429
31985.0,6,10,2032,5,524,6061.0,252.0,104.8,5,1508,7762.0,1236.0,301.6
37178.0,6,2,145,2,145,0.0,91.0,72.5,0,0,0.0,0.0,0.0
102986.0,17,2,286,2,286,0.0,143.0,143.0,0,0,0.0,0.0,0.0
198035.0,17,2,180,1,90,0.0,90.0,90.0,1,90,0.0,90.0,90.0
931467.0,17,10,3736,10,3736,103496.33333333331,390.0,373.6,0,0,0.0,0.0,0.0
90026981.0,17,28,13364,28,13364,3334332.6296296297,501.0,477.2857142857143,0,0,0.0,0.0,0.0
127816222.0,6,35,2542,17,1194,7364437.5625,123.0,70.23529411764706,18,1348,6931235.0,139.0,74.88888888888889
24816.0,6,14,4740,7,653,3873.5,249.0,93.28571428571428,7,4087,3995.1666666666665,1514.0,583.8571428571429
6103678.0,17,6,2100,6,2100,1220735.6,350.0,350.0,0,0,0.0,0.0,0.0
14633794.0,6,21,1661,10,975,1591947.888888889,315.0,97.5,11,686,1432734.0,78.0,62.36363636363637
90202321.0,6,16,1192,8,596,12851991.285714284,95.0,74.5,8,596,12856799.57142857,95.0,74.5
90094379.0,6,10,1440,7,828,15015729.833333334,188.0,118.28571428571428,3,612,30032510.5,204.0,204.0
108095915.0,17,5,1005,5,1005,27023978.75,201.0,201.0,0,0,0.0,0.0,0.0
44100.0,6,14,4740,7,653,7226.5,249.0,93.28571428571428,7,4087,6874.333333333333,1514.0,583.8571428571429
90309067.0,6,18,1465,9,650,11282247.125,95.0,72.22222222222223,9,815,11288086.0,219.0,90.55555555555556
2799445.0,6,2,132,1,66,0.0,66.0,66.0,1,66,0.0,66.0,66.0
32727.0,6,14,4740,7,653,5341.0,249.0,93.28571428571428,7,4087,4806.333333333333,1514.0,583.8571428571429
233710.0,6,3,337,2,214,0.0,160.0,107.0,1,123,0.0,123.0,123.0
135158090.0,17,6,1146,6,1146,27031618.0,191.0,191.0,0,0,0.0,0.0,0.0
27412129.0,17,5,1710,5,1710,6853032.25,342.0,342.0,0,0,0.0,0.0,0.0
113345697.0,6,47,3102,24,1584,4928062.913043479,66.0,66.0,23,1518,5151998.5,66.0,66.0
144758.0,6,2,132,1,66,0.0,66.0,66.0,1,66,0.0,66.0,66.0
2441983.0,6,25,7609,13,2516,202813.5833333333,1034.0,193.53846153846155,12,5093,194271.45454545456,1510.0,424.4166666666667
92588778.0,6,37,2442,19,1254,5143821.0,66.0,66.0,18,1188,5047536.294117647,66.0,66.0
120060844.0,17,15,1038,7,432,16833501.0,174.0,61.71428571428572,8,606,17109204.42857143,174.0,75.75
198135.0,17,4,1400,4,1400,66045.0,350.0,350.0,0,0,0.0,0.0,0.0
107856863.0,6,28,1860,14,966,8280077.0,123.0,69.0,14,894,8280075.846153846,123.0,63.85714285714285
108107596.0,17,5,955,5,955,27026899.0,191.0,191.0,0,0,0.0,0.0,0.0
204495.0,17,2,762,2,762,0.0,381.0,381.0,0,0,0.0,0.0,0.0
13593550.0,6,247,232770,68,4638,202888.8059701493,208.0,68.20588235294117,179,228132,76356.23595505618,1514.0,1274.4804469273745
5623146.0,6,5,336,2,134,0.0,68.0,67.0,3,202,1526493.0,70.0,67.33333333333333
283998.0,17,2,363,1,79,0.0,79.0,79.0,1,284,0.0,284.0,284.0
28928.0,6,14,4740,7,653,4598.166666666667,249.0,93.28571428571428,7,4087,4627.0,1514.0,583.8571428571429
106265763.0,17,14,864,7,432,17666849.666666668,174.0,61.71428571428572,7,432,17667802.166666668,174.0,61.71428571428572
90250907.0,6,16,2368,9,1204,11281363.375,188.0,133.77777777777777,7,1164,15014707.833333334,204.0,166.28571428571428
103422.0,17,2,286,2,286,0.0,143.0,143.0,0,0,0.0,0.0,0.0
228429.0,17,2,180,1,90,0.0,90.0,90.0,1,90,0.0,90.0,90.0
143938.0,17,2,180,1,90,0.0,90.0,90.0,1,90,0.0,90.0,90.0
297953.0,6,6,412,4,272,99317.66666666669,74.0,68.0,2,140,0.0,74.0,70.0
215161.0,6,12,1373,7,714,35860.166666666664,298.0,102.0,5,659,53019.75,379.0,131.8
197975.0,17,2,180,1,90,0.0,90.0,90.0,1,90,0.0,90.0,90.0
148036.0,17,2,180,1,90,0.0,90.0,90.0,1,90,0.0,90.0,90.0
220691.0,6,3,426,2,280,0.0,214.0,140.0,1,146,0.0,146.0,146.0
125001074.0,17,15,907,8,475,17857296.285714287,174.0,59.375,7,432,17500957.666666668,174.0,61.71428571428572
90046837.0,17,28,13364,28,13364,3335068.037037037,501.0,477.2857142857143,0,0,0.0,0.0,0.0
37690.0,6,14,4740,7,653,6125.666666666667,249.0,93.28571428571428,7,4087,5962.0,1514.0,583.8571428571429
90056893.0,17,28,13364,28,13364,3335440.4814814813,501.0,477.2857142857143,0,0,0.0,0.0,0.0
13311.0,6,14,4740,7,653,1943.0,249.0,93.28571428571428,7,4087,2085.5,1514.0,583.8571428571429
2173.0,17,4,344,2,150,0.0,75.0,75.0,2,194,0.0,103.0,97.0
23057242.0,17,3,1034,2,684,0.0,342.0,342.0,1,350,0.0,350.0,350.0
325.0,17,2,160,1,80,0.0,80.0,80.0,1,80,0.0,80.0,80.0
102365.0,17,2,286,2,286,0.0,143.0,143.0,0,0,0.0,0.0,0.0
205980.0,17,2,180,1,90,0.0,90.0,90.0,1,90,0.0,90.0,90.0
33996.0,6,10,2032,5,524,8278.25,252.0,104.8,5,1508,7496.75,1236.0,301.6
217018.0,17,2,616,1,75,0.0,75.0,75.0,1,541,0.0,541.0,541.0
1568247.0,6,2,132,1,66,0.0,66.0,66.0,1,66,0.0,66.0,66.0
104004.0,17,2,286,2,286,0.0,143.0,143.0,0,0,0.0,0.0,0.0
201019.0,17,2,762,2,762,0.0,381.0,381.0,0,0,0.0,0.0,0.0
61752.0,6,10,2032,5,524,14475.75,252.0,104.8,5,1508,13115.25,1236.0,301.6
119375621.0,17,35,16705,35,16705,3511047.6764705884,501.0,477.2857142857143,0,0,0.0,0.0,0.0
253426.0,6,3,337,2,214,0.0,160.0,107.0,1,123,0.0,123.0,123.0
205123.0,17,2,762,2,762,0.0,381.0,381.0,0,0,0.0,0.0,0.0
104500.0,17,2,286,2,286,0.0,143.0,143.0,0,0,0.0,0.0,0.0
298155.0,17,2,180,1,90,0.0,90.0,90.0,1,90,0.0,90.0,90.0
42003.0,6,10,2032,5,524,10268.25,252.0,104.8,5,1508,9796.25,1236.0,301.6
0.0,6,1,60,1,60,0.0,60.0,60.0,0,0,0.0,0.0,0.0
280846.0,17,4,704,2,148,0.0,74.0,74.0,2,556,0.0,280.0,278.0
13103.0,6,14,4740,7,653,1887.8333333333333,249.0,93.28571428571428,7,4087,2046.5,1514.0,583.8571428571429
217622.0,6,3,426,2,280,0.0,214.0,140.0,1,146,0.0,146.0,146.0
321495.0,17,4,1400,4,1400,107165.0,350.0,350.0,0,0,0.0,0.0,0.0
103444.0,17,2,286,2,286,0.0,143.0,143.0,0,0,0.0,0.0,0.0
108651228.0,6,43,2838,22,1452,5173855.952380952,66.0,66.0,21,1386,5144001.15,66.0,66.0
50426.0,6,14,4740,7,653,7921.333333333333,249.0,93.28571428571428,7,4087,7236.0,1514.0,583.8571428571429
53590.0,6,14,4740,7,653,8804.0,249.0,93.28571428571428,7,4087,8723.166666666666,1514.0,583.8571428571429
115126681.0,17,16,1474,8,737,16423850.42857143,174.0,92.125,8,737,16423851.285714284,174.0,92.125
118537428.0,17,16,1212,8,606,16858522.42857143,174.0,75.75,8,606,16857303.714285713,174.0,75.75
120183815.0,6,364,43102,182,12308,659441.1049723757,140.0,67.62637362637362,182,30794,659535.8342541436,464.0,169.1978021978022
204591.0,17,2,762,2,762,0.0,381.0,381.0,0,0,0.0,0.0,0.0
90039856.0,17,28,13364,28,13364,3334809.4814814813,501.0,477.2857142857143,0,0,0.0,0.0,0.0
21658.0,6,14,4740,7,653,3173.6666666666665,249.0,93.28571428571428,7,4087,3463.0,1514.0,583.8571428571429
149098.0,6,3,337,2,214,0.0,160.0,107.0,1,123,0.0,123.0,123.0
3176451.0,6,18,1495,9,921,358291.875,315.0,102.33333333333331,9,574,358259.5,78.0,63.77777777777778
108102004.0,17,5,955,5,955,27025501.0,191.0,191.0,0,0,0.0,0.0,0.0
3006764.0,6,11,2106,6,598,601125.6,252.0,99.66666666666669,5,1508,1780.25,1236.0,301.6
108139064.0,17,5,1005,5,1005,27034766.0,201.0,201.0,0,0,0.0,0.0,0.0
7510.0,17,4,823,2,163,0.0,89.0,81.5,2,660,0.0,443.0,330.0
120045390.0,17,29,13785,29,13785,4287335.357142857,501.0,475.3448275862069,0,0,0.0,0.0,0.0
107850026.0,6,28,1860,14,966,8279562.461538462,123.0,69.0,14,894,8279562.230769231,123.0,63.85714285714285
126169.0,6,10,1066,5,490,30623.5,218.0,98.0,5,576,31183.25,304.0,115.2
2370.0,17,4,344,2,150,0.0,75.0,75.0,2,194,0.0,103.0,97.0
585613.0,6,4,508,2,238,0.0,172.0,119.0,2,270,0.0,135.0,135.0
12608.0,6,12,1393,6,796,2267.4,271.0,132.66666666666666,6,597,2184.6,259.0,99.5
235078.0,17,2,180,1,90,0.0,90.0,90.0,1,90,0.0,90.0,90.0
304.0,17,2,164,1,82,0.0,82.0,82.0,1,82,0.0,82.0,82.0
120181420.0,6,234,26310,117,8018,1028967.0689655172,140.0,68.52991452991454,117,18292,1028905.2844827586,284.0,156.34188034188034
42778.0,6,14,4740,7,653,6704.666666666667,249.0,93.28571428571428,7,4087,6353.833333333333,1514.0,583.8571428571429
121295.0,6,4,439,2,238,0.0,172.0,119.0,2,201,0.0,135.0,100.5
283515.0,17,2,363,1,79,0.0,79.0,79.0,1,284,0.0,284.0,284.0
10532048.0,6,7,478,4,272,3465525.6666666665,74.0,68.0,3,206,5198160.5,74.0,68.66666666666667
105512.0,17,2,700,2,700,0.0,350.0,350.0,0,0,0.0,0.0,0.0
28157.0,6,14,4740,7,653,4218.333333333333,249.0,93.28571428571428,7,4087,4539.833333333333,1514.0,583.8571428571429
80276.0,6,14,4740,7,653,13256.833333333334,249.0,93.28571428571428,7,4087,11193.5,1514.0,583.8571428571429
112205.0,17,2,286,2,286,0.0,143.0,143.0,0,0,0.0,0.0,0.0
2410.0,17,4,344,2,150,0.0,75.0,75.0,2,194,0.0,103.0,97.0
108104371.0,17,5,1005,5,1005,27026092.75,201.0,201.0,0,0,0.0,0.0,0.0
157837.0,17,2,180,1,90,0.0,90.0,90.0,1,90,0.0,90.0,90.0
3576698.0,6,5,336,2,134,0.0,68.0,67.0,3,202,1425065.0,70.0,67.33333333333333
3010009.0,6,11,2106,6,598,601800.0,252.0,99.66666666666669,5,1508,2613.75,1236.0,301.6
4309.0,17,2,614,1,72,0.0,72.0,72.0,1,542,0.0,542.0,542.0
135138377.0,17,6,1206,6,1206,27027675.4,201.0,201.0,0,0,0.0,0.0,0.0
786.0,17,4,438,2,148,0.0,74.0,74.0,2,290,0.0,147.0,145.0
119859581.0,6,14,2102,5,1020,29964469.0,204.0,204.0,9,1082,14982275.5,188.0,120.22222222222224
11821.0,6,10,2032,5,524,2715.25,252.0,104.8,5,1508,1778.75,1236.0,301.6
21906.0,6,11,1133,6,602,3994.2,264.0,100.33333333333331,5,531,4693.5,259.0,106.2
54721.0,6,13,1394,7,797,7800.0,253.0,113.85714285714286,6,597,10422.2,259.0,99.5
221069.0,6,3,426,2,280,0.0,214.0,140.0,1,146,0.0,146.0,146.0
50868.0,17,2,180,1,90,0.0,90.0,90.0,1,90,0.0,90.0,90.0
1183581.0,6,13,3008,8,2380,169083.0,1514.0,297.5,5,628,226927.25,331.0,125.6
267689.0,6,14,4740,7,653,43620.833333333336,249.0,93.28571428571428,7,4087,8948.666666666666,1514.0,583.8571428571429
76874.0,6,10,1066,5,490,18239.25,218.0,98.0,5,576,19017.0,304.0,115.2
120123600.0,6,15,2428,9,1204,15015450.0,188.0,133.77777777777777,6,1224,18021838.2,204.0,204.0
120006280.0,17,14,864,7,432,20001046.666666668,174.0,61.71428571428572,7,432,16666835.333333334,174.0,61.71428571428572
93467386.0,17,14,1126,7,563,15500138.166666666,174.0,80.42857142857143,7,563,15500772.5,174.0,80.42857142857143
302616.0,6,6,412,4,272,100872.0,74.0,68.0,2,140,0.0,74.0,70.0
208042.0,6,4,492,2,280,0.0,214.0,140.0,2,212,0.0,146.0,106.0
106368386.0,17,14,864,7,432,17666842.166666668,174.0,61.71428571428572,7,432,17667673.166666668,174.0,61.71428571428572
206233.0,6,3,426,2,280,0.0,214.0,140.0,1,146,0.0,146.0,146.0
10153.0,17,4,823,2,163,0.0,89.0,81.5,2,660,0.0,443.0,330.0
90295309.0,6,19,1436,10,745,10027662.666666666,95.0,74.5,9,691,11285370.875,95.0,76.77777777777777
2801995.0,6,2,132,1,66,0.0,66.0,66.0,1,66,0.0,66.0,66.0
90260728.0,6,12,1832,8,1016,12894389.714285716,188.0,127.0,4,816,30031993.33333333,204.0,204.0
90920714.0,6,21,1585,11,840,9091131.8,95.0,76.36363636363636,10,745,10101577.444444444,95.0,74.5
233964.0,6,3,337,2,214,0.0,160.0,107.0,1,123,0.0,123.0,123.0
90256832.0,6,15,2074,8,1080,12893833.142857144,204.0,135.0,7,994,15015592.833333334,199.0,142.0
49546.0,6,14,4740,7,653,8088.5,249.0,93.28571428571428,7,4087,6892.166666666667,1514.0,583.8571428571429
259751.0,6,10,1221,6,636,51950.2,298.0,106.0,4,585,79956.66666666667,379.0,146.25
26976907.0,17,5,1710,5,1710,6744226.75,342.0,342.0,0,0,0.0,0.0,0.0
27576.0,6,10,2032,5,524,6594.25,252.0,104.8,5,1508,5895.25,1236.0,301.6
233670.0,6,3,373,2,238,0.0,172.0,119.0,1,135,0.0,135.0,135.0
143898.0,17,2,180,1,90,0.0,90.0,90.0,1,90,0.0,90.0,90.0
107089.0,17,2,762,2,762,0.0,381.0,381.0,0,0,0.0,0.0,0.0
299096.0,6,6,412,4,272,99698.66666666669,74.0,68.0,2,140,0.0,74.0,70.0
2033.0,17,4,344,2,150,0.0,75.0,75.0,2,194,0.0,103.0,97.0
108105189.0,17,5,955,5,955,27026297.25,191.0,191.0,0,0,0.0,0.0,0.0
191044.0,17,2,180,1,90,0.0,90.0,90.0,1,90,0.0,90.0,90.0
90258105.0,6,13,2036,8,1016,12894015.0,188.0,127.0,5,1020,22523214.75,204.0,204.0
2336.0,17,4,344,2,150,0.0,75.0,75.0,2,194,0.0,103.0,97.0
98269263.0,17,12,778,6,389,19600154.0,174.0,64.83333333333333,6,389,19601866.4,174.0,64.83333333333333
846.0,17,5,550,5,550,211.5,110.0,110.0,0,0,0.0,0.0,0.0
120068690.0,6,234,26602,117,8018,1028333.5775862068,140.0,68.52991452991454,117,18584,1035020.75,284.0,158.83760683760684
313610.0,17,4,1400,4,1400,104536.66666666669,350.0,350.0,0,0,0.0,0.0,0.0
90894450.0,6,21,1585,10,745,10099383.333333334,95.0,74.5,11,840,6158690.0,95.0,76.36363636363636
309790.0,6,6,412,4,272,103263.33333333331,74.0,68.0,2,140,0.0,74.0,70.0
135138200.0,17,6,1146,6,1146,27027640.0,191.0,191.0,0,0,0.0,0.0,0.0
10526387.0,6,7,478,4,272,3461640.0,74.0,68.0,3,206,5192333.0,74.0,68.66666666666667
90244117.0,6,13,2036,8,1016,12892016.714285716,188.0,127.0,5,1020,22519668.0,204.0,204.0
12022833.0,17,3,1026,3,1026,6011416.5,342.0,342.0,0,0,0.0,0.0,0.0
312402.0,6,3,202,2,128,0.0,74.0,64.0,1,74,0.0,74.0,74.0
2599849.0,6,2,132,1,66,0.0,66.0,66.0,1,66,0.0,66.0,66.0
220123.0,6,10,1221,6,636,44024.6,298.0,106.0,4,585,72021.33333333333,379.0,146.25
216560.0,17,2,180,1,90,0.0,90.0,90.0,1,90,0.0,90.0,90.0
394.0,17,2,160,1,80,0.0,80.0,80.0,1,80,0.0,80.0,80.0
62291.0,6,14,4740,7,653,9814.166666666666,249.0,93.28571428571428,7,4087,9092.166666666666,1514.0,583.8571428571429
109036.0,17,2,286,2,286,0.0,143.0,143.0,0,0,0.0,0.0,0.0
24069702.0,17,5,1718,4,1368,804572.6666666666,342.0,342.0,1,350,0.0,350.0,350.0
103827.0,17,3,1050,3,1050,51913.5,350.0,350.0,0,0,0.0,0.0,0.0
90032253.0,17,28,13364,28,13364,3334527.888888889,501.0,477.2857142857143,0,0,0.0,0.0,0.0
2483882.0,6,3,204,2,136,0.0,70.0,68.0,1,68,0.0,68.0,68.0
120123960.0,6,16,2648,8,1632,17160565.714285713,204.0,204.0,8,1016,17098491.0,188.0,127.0
81503.0,6,10,2032,5,524,20147.75,252.0,104.8,5,1508,17772.5,1236.0,301.6
118044975.0,6,30,1974,15,1026,8416375.642857144,123.0,68.4,15,948,8416377.642857144,123.0,63.2
108710203.0,6,32,2236,16,1165,7232956.2,139.0,72.8125,16,1071,7232958.466666667,123.0,66.9375
298162.0,6,6,412,4,272,99387.33333333331,74.0,68.0,2,140,0.0,74.0,70.0
99984.0,17,2,286,2,286,0.0,143.0,143.0,0,0,0.0,0.0,0.0
90257125.0,6,13,2036,8,1016,12893875.0,188.0,127.0,5,1020,22523876.25,204.0,204.0
363861.0,6,11,1021,6,444,48885.8,162.0,74.0,5,577,60998.5,349.0,115.4
1026064.0,6,11,1134,6,558,205212.8,220.0,93.0,5,576,254397.5,304.0,115.2
104405490.0,6,31,2166,16,1149,6945984.4,123.0,71.8125,15,1017,7442127.714285715,123.0,67.8
147383.0,6,3,337,2,214,0.0,160.0,107.0,1,123,0.0,123.0,123.0
101983.0,17,2,762,2,762,0.0,381.0,381.0,0,0,0.0,0.0,0.0
310.0,17,2,168,1,76,0.0,76.0,76.0,1,92,0.0,92.0,92.0
320152.0,17,4,1400,4,1400,106717.33333333331,350.0,350.0,0,0,0.0,0.0,0.0
27653.0,6,14,4740,7,653,4489.833333333333,249.0,93.28571428571428,7,4087,3993.8333333333335,1514.0,583.8571428571429
313814.0,17,4,1400,4,1400,104604.66666666669,350.0,350.0,0,0,0.0,0.0,0.0
21372612.0,6,6,1981,4,1087,7124204.0,885.0,271.75,2,894,0.0,826.0,447.0
311474.0,17,4,622,4,622,103824.66666666669,163.0,155.5,0,0,0.0,0.0,0.0
352.0,17,2,174,1,79,0.0,79.0,79.0,1,95,0.0,95.0,95.0
228263.0,17,2,180,1,90,0.0,90.0,90.0,1,90,0.0,90.0,90.0
2015.0,17,4,344,2,150,0.0,75.0,75.0,2,194,0.0,103.0,97.0
310580.0,17,4,1400,4,1400,103526.66666666669,350.0,350.0,0,0,0.0,0.0,0.0
50841.0,6,14,4740,7,653,8246.666666666666,249.0,93.28571428571428,7,4087,8093.0,1514.0,583.8571428571429
747313.0,6,2,132,1,66,0.0,66.0,66.0,1,66,0.0,66.0,66.0
113737585.0,6,32,2220,16,1149,7568121.266666667,123.0,71.8125,16,1071,7568118.533333333,123.0,66.9375
301851.0,6,7,478,4,272,100617.0,74.0,68.0,3,206,75694.0,74.0,68.66666666666667
114119650.0,6,46,3036,23,1518,5187256.818181818,66.0,66.0,23,1518,5172189.136363637,66.0,66.0
130925.0,6,3,337,2,214,0.0,160.0,107.0,1,123,0.0,123.0,123.0
40466.0,6,14,4740,7,653,4134.0,249.0,93.28571428571428,7,4087,6311.333333333333,1514.0,583.8571428571429
106870.0,17,2,286,2,286,0.0,143.0,143.0,0,0,0.0,0.0,0.0
117146957.0,6,48,3168,24,1584,5093345.956521739,66.0,66.0,24,1584,5081373.304347826,66.0,66.0
45584.0,6,12,1413,7,882,7597.333333333333,291.0,126.0,5,531,9272.0,259.0,106.2
121096.0,6,3,337,2,214,0.0,160.0,107.0,1,123,0.0,123.0,123.0
2022053.0,17,4,525,2,150,0.0,75.0,75.0,2,375,0.0,284.0,187.5
293.0,17,2,168,1,76,0.0,76.0,76.0,1,92,0.0,92.0,92.0
120115958.0,6,14,2240,6,1224,24023191.6,204.0,204.0,8,1016,17097622.85714286,188.0,127.0
4070.0,17,4,704,2,148,0.0,74.0,74.0,2,556,0.0,280.0,278.0
24242.0,6,10,2032,5,524,5451.25,252.0,104.8,5,1508,5685.5,1236.0,301.6
3676.0,17,4,344,2,150,0.0,75.0,75.0,2,194,0.0,103.0,97.0
2306.0,17,4,344,2,150,0.0,75.0,75.0,2,194,0.0,103.0,97.0
304.0,17,2,168,1,76,0.0,76.0,76.0,1,92,0.0,92.0,92.0
90036353.0,17,11,735,6,389,17975245.8,174.0,64.83333333333333,5,346,17640030.25,174.0,69.2
9901.0,17,2,582,1,83,0.0,83.0,83.0,1,499,0.0,499.0,499.0
14633400.0,6,19,1594,9,962,1791448.75,315.0,106.88888888888889,10,632,1592374.111111111,78.0,63.2
104772942.0,6,44,2904,22,1452,4989187.714285715,66.0,66.0,22,1452,4976065.619047619,66.0,66.0
216307.0,6,3,426,2,280,0.0,214.0,140.0,1,146,0.0,146.0,146.0
2370.0,17,4,344,2,150,0.0,75.0,75.0,2,194,0.0,103.0,97.0
43540.0,6,10,2032,5,524,10583.75,252.0,104.8,5,1508,8322.0,1236.0,301.6
1315522.0,6,4,264,2,132,0.0,66.0,66.0,2,132,0.0,66.0,66.0
1182910.0,6,13,3010,8,2382,168987.14285714287,1514.0,297.75,5,628,227545.0,331.0,125.6
2070.0,17,4,344,2,150,0.0,75.0,75.0,2,194,0.0,103.0,97.0
754714.0,6,2,132,1,66,0.0,66.0,66.0,1,66,0.0,66.0,66.0
44431.0,17,2,180,1,90,0.0,90.0,90.0,1,90,0.0,90.0,90.0
92897.0,6,2,132,1,66,0.0,66.0,66.0,1,66,0.0,66.0,66.0
934325.0,6,12,1447,6,816,180704.4,291.0,136.0,6,631,185979.2,293.0,105.16666666666669
44671.0,6,14,4740,7,653,6817.666666666667,249.0,93.28571428571428,7,4087,6426.333333333333,1514.0,583.8571428571429
121525.0,6,3,337,2,214,0.0,160.0,107.0,1,123,0.0,123.0,123.0
217726.0,6,3,426,2,280,0.0,214.0,140.0,1,146,0.0,146.0,146.0
27072.0,6,14,4740,7,653,4036.3333333333335,249.0,93.28571428571428,7,4087,4247.0,1514.0,583.8571428571429
51968.0,6,10,2032,5,524,12722.75,252.0,104.8,5,1508,11137.0,1236.0,301.6
121122057.0,6,228,25772,114,7746,1055540.5044247787,140.0,67.94736842105263,114,18026,1065505.7345132744,284.0,158.12280701754386
110261983.0,6,32,2374,17,1288,6891373.9375,139.0,75.76470588235294,15,1086,7860402.285714285,123.0,72.4
2310.0,17,4,344,2,150,0.0,75.0,75.0,2,194,0.0,103.0,97.0
146233.0,6,3,337,2,214,0.0,160.0,107.0,1,123,0.0,123.0,123.0
120249862.0,6,19,1395,10,745,13332930.333333334,95.0,74.5,9,650,15000003.625,95.0,72.22222222222223
299589.0,6,6,412,4,272,99863.0,74.0,68.0,2,140,0.0,74.0,70.0
2014701.0,6,18,6803,10,1501,223855.66666666663,408.0,150.1,8,5302,224940.4285714285,1514.0,662.75
5824225.0,6,5,336,2,134,0.0,68.0,67.0,3,202,1520602.0,70.0,67.33333333333333
144021.0,17,2,180,1,90,0.0,90.0,90.0,1,90,0.0,90.0,90.0
120005961.0,17,14,864,8,475,17143708.714285713,174.0,59.375,6,389,20046292.2,174.0,64.83333333333333
2172.0,17,4,344,2,150,0.0,75.0,75.0,2,194,0.0,103.0,97.0
148078.0,17,2,180,1,90,0.0,90.0,90.0,1,90,0.0,90.0,90.0
26652.0,6,10,2032,5,524,5685.5,252.0,104.8,5,1508,6320.25,1236.0,301.6
90020641.0,17,28,13364,28,13364,3334097.814814815,501.0,477.2857142857143,0,0,0.0,0.0,0.0
113049734.0,17,22,9966,22,9966,5383320.666666667,453.0,453.0,0,0,0.0,0.0,0.0
94611.0,6,2,132,1,66,0.0,66.0,66.0,1,66,0.0,66.0,66.0
108096747.0,17,5,955,5,955,27024186.75,191.0,191.0,0,0,0.0,0.0,0.0
107630.0,17,2,286,2,286,0.0,143.0,143.0,0,0,0.0,0.0,0.0
90260613.0,6,12,1832,8,1016,12894373.285714284,188.0,127.0,4,816,30031412.0,204.0,204.0
2326.0,17,4,344,2,150,0.0,75.0,75.0,2,194,0.0,103.0,97.0
90093564.0,6,12,1848,5,1020,22522825.5,204.0,204.0,7,828,15015198.5,188.0,118.28571428571428
2320.0,17,4,344,2,150,0.0,75.0,75.0,2,194,0.0,103.0,97.0
108115621.0,17,5,1005,5,1005,27028905.25,201.0,201.0,0,0,0.0,0.0,0.0
868238.0,6,10,1336,6,799,173647.6,461.0,133.16666666666666,4,537,197584.0,331.0,134.25
322028.0,17,4,1400,4,1400,107342.66666666669,350.0,350.0,0,0,0.0,0.0,0.0
98866710.0,6,191,21800,96,6558,1040702.2105263158,140.0,68.3125,95,15242,1044468.670212766,336.0,160.44210526315788
322238.0,17,4,1400,4,1400,107412.66666666669,350.0,350.0,0,0,0.0,0.0,0.0
0.0,6,1,66,0,0,0.0,0.0,0.0,1,66,0.0,66.0,66.0
197947.0,17,2,180,1,90,0.0,90.0,90.0,1,90,0.0,90.0,90.0
104909921.0,17,14,1126,7,563,17484986.833333332,174.0,80.42857142857143,7,563,17378126.666666668,174.0,80.42857142857143
332.0,17,2,208,1,72,0.0,72.0,72.0,1,136,0.0,136.0,136.0
92754475.0,6,170,19206,85,13374,1101659.142857143,284.0,157.34117647058824,85,5832,1101659.4166666667,140.0,68.61176470588235
166316.0,17,4,1400,4,1400,55438.66666666666,350.0,350.0,0,0,0.0,0.0,0.0
5805860.0,6,4,270,2,134,0.0,68.0,67.0,2,136,0.0,70.0,68.0
1391848.0,17,16,1120,16,1120,92789.86666666668,70.0,70.0,0,0,0.0,0.0,0.0
512.0,17,2,508,2,508,0.0,257.0,254.0,0,0,0.0,0.0,0.0
120004462.0,6,22,1639,12,894,10909496.545454543,95.0,74.5,10,745,13310509.666666666,95.0,74.5
128800.0,6,2,132,1,66,0.0,66.0,66.0,1,66,0.0,66.0,66.0
1771368.0,6,2,132,1,66,0.0,66.0,66.0,1,66,0.0,66.0,66.0
119818768.0,17,35,16705,35,16705,3524081.411764706,501.0,477.2857142857143,0,0,0.0,0.0,0.0
366897.0,6,11,1021,6,444,49611.4,162.0,74.0,5,577,61832.0,349.0,115.4
49874.0,6,10,2032,5,524,12170.0,252.0,104.8,5,1508,12141.0,1236.0,301.6
20781.0,6,11,2098,6,590,3637.0,252.0,98.33333333333331,5,1508,4135.5,1236.0,301.6
325207.0,6,6,412,4,272,108402.33333333331,74.0,68.0,2,140,0.0,74.0,70.0
171699.0,17,2,180,1,90,0.0,90.0,90.0,1,90,0.0,90.0,90.0
48157.0,6,14,4740,7,653,6857.5,249.0,93.28571428571428,7,4087,6976.0,1514.0,583.8571428571429
121956814.0,6,33,2280,17,1209,7622300.875,123.0,71.11764705882354,16,1071,7451133.866666666,123.0,66.9375
44009.0,6,14,4740,7,653,7225.333333333333,249.0,93.28571428571428,7,4087,6776.833333333333,1514.0,583.8571428571429
320.0,17,2,174,1,79,0.0,79.0,79.0,1,95,0.0,95.0,95.0
206023.0,6,3,426,2,280,0.0,214.0,140.0,1,146,0.0,146.0,146.0
331.0,17,2,166,1,75,0.0,75.0,75.0,1,91,0.0,91.0,91.0
199549.0,17,4,6056,4,6056,66516.33333333333,1514.0,1514.0,0,0,0.0,0.0,0.0
108109876.0,17,5,955,5,955,27027469.0,191.0,191.0,0,0,0.0,0.0,0.0
285360.0,17,2,363,1,79,0.0,79.0,79.0,1,284,0.0,284.0,284.0
2375.0,17,4,344,2,150,0.0,75.0,75.0,2,194,0.0,103.0,97.0
135136072.0,17,6,1146,6,1146,27027214.4,191.0,191.0,0,0,0.0,0.0,0.0
5064.0,17,4,344,2,150,0.0,75.0,75.0,2,194,0.0,103.0,97.0
363845.0,6,11,1021,6,444,48936.0,162.0,74.0,5,577,60964.0,349.0,115.4
90066878.0,17,27,12943,27,12943,3464110.6923076925,501.0,479.3703703703704,0,0,0.0,0.0,0.0
90288999.0,6,16,1192,8,596,12891375.285714284,95.0,74.5,8,596,12895872.857142856,95.0,74.5
35453.0,6,14,4740,7,653,5788.0,249.0,93.28571428571428,7,4087,4814.333333333333,1514.0,583.8571428571429
4173.0,17,4,344,2,150,0.0,75.0,75.0,2,194,0.0,103.0,97.0
4327.0,17,4,344,2,150,0.0,75.0,75.0,2,194,0.0,103.0,97.0
108109.0,17,2,286,2,286,0.0,143.0,143.0,0,0,0.0,0.0,0.0
108095896.0,17,5,955,5,955,27023974.0,191.0,191.0,0,0,0.0,0.0,0.0
155044.0,17,2,180,1,90,0.0,90.0,90.0,1,90,0.0,90.0,90.0
78611222.0,6,9,842,9,842,9826402.75,97.0,93.55555555555556,0,0,0.0,0.0,0.0
25093.0,6,14,4740,7,653,4009.5,249.0,93.28571428571428,7,4087,3784.6666666666665,1514.0,583.8571428571429
270910.0,6,10,1221,6,636,54182.0,298.0,106.0,4,585,84863.33333333333,379.0,146.25
123455847.0,6,48,3168,24,1584,5084636.391304348,66.0,66.0,24,1584,5183187.521739131,66.0,66.0
18628.0,6,14,4740,7,653,2961.333333333333,249.0,93.28571428571428,7,4087,2919.1666666666665,1514.0,583.8571428571429
1015226.0,6,3,204,2,136,0.0,70.0,68.0,1,68,0.0,68.0,68.0
142381.0,6,2,132,1,66,0.0,66.0,66.0,1,66,0.0,66.0,66.0
946168.0,6,12,1447,6,816,188004.2,291.0,136.0,6,631,188322.8,293.0,105.16666666666669
3043743.0,6,3,1604,1,753,0.0,753.0,753.0,2,851,0.0,785.0,425.5
209629.0,17,2,180,1,90,0.0,90.0,90.0,1,90,0.0,90.0,90.0
2321.0,17,4,344,2,150,0.0,75.0,75.0,2,194,0.0,103.0,97.0
54011.0,6,12,1328,6,731,10095.4,253.0,121.83333333333331,6,597,10280.6,259.0,99.5
111541025.0,17,16,1605,8,737,15239046.857142856,174.0,92.125,8,868,14427697.714285716,174.0,108.5
2048.0,17,4,344,2,150,0.0,75.0,75.0,2,194,0.0,103.0,97.0
10443818.0,6,7,478,4,272,3435819.333333333,74.0,68.0,3,206,5153591.0,74.0,68.66666666666667
65810.0,6,14,4740,7,653,10585.5,249.0,93.28571428571428,7,4087,10341.5,1514.0,583.8571428571429
26117.0,6,14,4740,7,653,4193.5,249.0,93.28571428571428,7,4087,4216.5,1514.0,583.8571428571429
108097200.0,17,5,1005,5,1005,27024300.0,201.0,201.0,0,0,0.0,0.0,0.0
199509.0,17,4,6056,4,6056,66503.0,1514.0,1514.0,0,0,0.0,0.0,0.0
420.0,17,2,166,1,75,0.0,75.0,75.0,1,91,0.0,91.0,91.0
262941.0,6,12,1373,7,714,43823.5,298.0,102.0,5,659,61437.75,379.0,131.8
303.0,17,2,164,1,82,0.0,82.0,82.0,1,82,0.0,82.0,82.0
33695.0,6,11,2098,6,590,6161.2,252.0,98.33333333333331,5,1508,8165.0,1236.0,301.6
120415493.0,6,222,25090,112,7688,1084824.2612612613,140.0,68.64285714285714,110,17402,1086013.5688073395,284.0,158.2
2286.0,17,4,344,2,150,0.0,75.0,75.0,2,194,0.0,103.0,97.0
35934.0,6,14,4740,7,653,5824.0,249.0,93.28571428571428,7,4087,5575.833333333333,1514.0,583.8571428571429
90071970.0,17,28,13364,28,13364,3335998.888888889,501.0,477.2857142857143,0,0,0.0,0.0,0.0
108107949.0,17,5,955,5,955,27026987.25,191.0,191.0,0,0,0.0,0.0,0.0
135139920.0,17,6,1146,6,1146,27027984.0,191.0,191.0,0,0,0.0,0.0,0.0
10528355.0,6,7,478,4,272,3463761.0,74.0,68.0,3,206,5195538.5,74.0,68.66666666666667
303.0,17,2,156,1,78,0.0,78.0,78.0,1,78,0.0,78.0,78.0
32398.000000000004,6,14,4740,7,653,5183.166666666667,249.0,93.28571428571428,7,4087,4643.0,1514.0,583.8571428571429
120002877.0,6,25,1924,12,935,10909352.454545457,95.0,77.91666666666667,13,989,7500507.833333333,95.0,76.07692307692308
285024.0,17,2,180,1,90,0.0,90.0,90.0,1,90,0.0,90.0,90.0
44856.0,6,13,1386,7,789,6929.333333333333,253.0,112.71428571428572,6,597,7701.6,259.0,99.5
298895.0,6,6,412,4,272,99631.66666666669,74.0,68.0,2,140,0.0,74.0,70.0
2611.0,17,2,664,1,322,0.0,322.0,322.0,1,342,0.0,342.0,342.0
208796.0,6,3,426,2,280,0.0,214.0,140.0,1,146,0.0,146.0,146.0
5971.0,17,2,180,1,90,0.0,90.0,90.0,1,90,0.0,90.0,90.0
36537.0,6,10,2032,5,524,8898.25,252.0,104.8,5,1508,7829.0,1236.0,301.6
27322.0,6,10,2032,5,524,6061.0,252.0,104.8,5,1508,6387.25,1236.0,301.6
205179.0,17,2,762,2,762,0.0,381.0,381.0,0,0,0.0,0.0,0.0
207306.0,6,3,426,2,280,0.0,214.0,140.0,1,146,0.0,146.0,146.0
16887.0,17,2,180,1,90,0.0,90.0,90.0,1,90,0.0,90.0,90.0
49526.0,6,14,4740,7,653,7486.166666666667,249.0,93.28571428571428,7,4087,7809.666666666667,1514.0,583.8571428571429
125991784.0,6,35,2410,18,1285,7411281.411764706,139.0,71.38888888888889,17,1125,7236816.5625,123.0,66.17647058823529
306837.0,6,6,412,4,272,102279.0,74.0,68.0,2,140,0.0,74.0,70.0
0.0,17,1,381,1,381,0.0,381.0,381.0,0,0,0.0,0.0,0.0
108108984.0,17,5,955,5,955,27027246.0,191.0,191.0,0,0,0.0,0.0,0.0
145628.0,6,3,337,2,214,0.0,160.0,107.0,1,123,0.0,123.0,123.0
90304723.0,6,16,1192,8,596,12894709.714285716,95.0,74.5,8,596,12900092.0,95.0,74.5
222787.0,6,3,426,2,280,0.0,214.0,140.0,1,146,0.0,146.0,146.0
283963.0,17,4,571,2,148,0.0,74.0,74.0,2,423,0.0,276.0,211.5
76374.0,6,14,4740,7,653,12405.333333333334,249.0,93.28571428571428,7,4087,12588.166666666666,1514.0,583.8571428571429
205903.0,6,3,426,2,280,0.0,214.0,140.0,1,146,0.0,146.0,146.0
2304.0,17,4,344,2,150,0.0,75.0,75.0,2,194,0.0,103.0,97.0
90020693.0,17,28,13364,28,13364,3334099.7407407407,501.0,477.2857142857143,0,0,0.0,0.0,0.0
403.0,17,2,176,1,88,0.0,88.0,88.0,1,88,0.0,88.0,88.0
32555.0,6,14,4740,7,653,4364.833333333333,249.0,93.28571428571428,7,4087,5265.833333333333,1514.0,583.8571428571429
117243794.0,6,221,24934,111,7622,1065852.6727272726,140.0,68.66666666666667,110,17312,1067306.486238532,284.0,157.38181818181818
10533056.0,6,7,478,4,272,3464102.6666666665,74.0,68.0,3,206,5196059.0,74.0,68.66666666666667
135131781.0,17,6,1206,6,1206,27026356.2,201.0,201.0,0,0,0.0,0.0,0.0
333.0,17,2,267,1,83,0.0,83.0,83.0,1,184,0.0,184.0,184.0
5626372.0,6,5,336,2,134,0.0,68.0,67.0,3,202,1526071.5,70.0,67.33333333333333
108107067.0,17,5,955,5,955,27026766.75,191.0,191.0,0,0,0.0,0.0,0.0
108099912.0,17,5,955,5,955,27024978.0,191.0,191.0,0,0,0.0,0.0,0.0
2624737.0,6,3,204,2,136,0.0,70.0,68.0,1,68,0.0,68.0,68.0
108109650.0,17,5,1005,5,1005,27027412.5,201.0,201.0,0,0,0.0,0.0,0.0
1012271.0,17,4,820,2,156,0.0,78.0,78.0,2,664,0.0,332.0,332.0
197957.0,17,2,180,1,90,0.0,90.0,90.0,1,90,0.0,90.0,90.0
108104319.0,17,5,955,5,955,27026079.75,191.0,191.0,0,0,0.0,0.0,0.0
16816.0,6,10,1065,5,534,3753.25,262.0,106.8,5,531,3861.75,259.0,106.2
99579.0,17,2,762,2,762,0.0,381.0,381.0,0,0,0.0,0.0,0.0
107349.0,17,2,286,2,286,0.0,143.0,143.0,0,0,0.0,0.0,0.0
122094.0,6,3,373,2,238,0.0,172.0,119.0,1,135,0.0,135.0,135.0
213635.0,17,2,180,1,90,0.0,90.0,90.0,1,90,0.0,90.0,90.0
68707.0,6,14,4740,7,653,11160.333333333334,249.0,93.28571428571428,7,4087,10634.166666666666,1514.0,583.8571428571429
107971.0,17,2,286,2,286,0.0,143.0,143.0,0,0,0.0,0.0,0.0
105021980.0,17,15,5130,15,5130,7501570.0,342.0,342.0,0,0,0.0,0.0,0.0
108107021.0,17,5,1005,5,1005,27026755.25,201.0,201.0,0,0,0.0,0.0,0.0
1772406.0,6,2,132,1,66,0.0,66.0,66.0,1,66,0.0,66.0,66.0
90292473.0,6,21,1711,11,799,9024732.1,95.0,72.63636363636364,10,912,10031074.222222222,221.0,91.2
302448.0,6,2,132,1,66,0.0,66.0,66.0,1,66,0.0,66.0,66.0
100082.0,17,2,286,2,286,0.0,143.0,143.0,0,0,0.0,0.0,0.0
848716.0,6,9,1096,6,625,169743.2,287.0,104.16666666666669,3,471,286572.5,331.0,157.0
197933.0,17,2,180,1,90,0.0,90.0,90.0,1,90,0.0,90.0,90.0
117825395.0,6,30,2043,15,1017,8416069.92857143,123.0,67.8,15,1026,8416068.714285715,123.0,68.4
149642.0,17,2,180,1,90,0.0,90.0,90.0,1,90,0.0,90.0,90.0
81673.0,6,14,4740,7,653,12608.166666666666,249.0,93.28571428571428,7,4087,12415.0,1514.0,583.8571428571429
303642.0,6,2,132,1,66,0.0,66.0,66.0,1,66,0.0,66.0,66.0
2793059.0,6,2,132,1,66,0.0,66.0,66.0,1,66,0.0,66.0,66.0
2018.0,17,4,344,2,150,0.0,75.0,75.0,2,194,0.0,103.0,97.0
104595.0,17,2,762,2,762,0.0,381.0,381.0,0,0,0.0,0.0,0.0
58828351.0,17,8,2744,7,2394,5959318.5,342.0,342.0,1,350,0.0,350.0,350.0
108104960.0,17,5,955,5,955,27026240.0,191.0,191.0,0,0,0.0,0.0,0.0
501015.0,17,2,363,1,79,0.0,79.0,79.0,1,284,0.0,284.0,284.0
2593395.0,6,2,132,1,66,0.0,66.0,66.0,1,66,0.0,66.0,66.0
41329.0,6,14,4740,7,653,6706.666666666667,249.0,93.28571428571428,7,4087,6216.833333333333,1514.0,583.8571428571429
1025658.0,6,11,1134,6,558,205131.6,220.0,93.0,5,576,256017.25,304.0,115.2
162375.0,17,2,180,1,90,0.0,90.0,90.0,1,90,0.0,90.0,90.0
820.0,17,2,762,2,762,0.0,381.0,381.0,0,0,0.0,0.0,0.0
2387.0,17,4,344,2,150,0.0,75.0,75.0,2,194,0.0,103.0,97.0
12698.0,6,10,1065,5,534,2929.25,262.0,106.8,5,531,2203.25,259.0,106.2
143872.0,17,2,180,1,90,0.0,90.0,90.0,1,90,0.0,90.0,90.0
2347.0,17,4,344,2,150,0.0,75.0,75.0,2,194,0.0,103.0,97.0
120135809.0,6,39,3034,20,1594,6311507.368421053,139.0,79.7,19,1440,6662224.444444444,123.0,75.78947368421052
116327772.0,6,255,29328,128,8670,915966.7086614174,140.0,67.734375,127,20658,906816.0793650794,300.0,162.66141732283464
143991.0,17,2,180,1,90,0.0,90.0,90.0,1,90,0.0,90.0,90.0
2332.0,17,4,344,2,150,0.0,75.0,75.0,2,194,0.0,103.0,97.0
120023381.0,17,28,13364,28,13364,4445310.407407408,501.0,477.2857142857143,0,0,0.0,0.0,0.0
90290023.0,6,17,1287,9,691,11280610.625,95.0,76.77777777777777,8,596,12897693.42857143,95.0,74.5
93000818.0,17,11,735,6,389,18600163.6,174.0,64.83333333333333,5,346,18251415.25,174.0,69.2
332021.0,17,2,180,1,90,0.0,90.0,90.0,1,90,0.0,90.0,90.0
2573.0,17,4,344,2,150,0.0,75.0,75.0,2,194,0.0,103.0,97.0
15914.000000000002,6,11,2098,6,590,3029.0,252.0,98.33333333333331,5,1508,2449.25,1236.0,301.6
233107.0,6,3,337,2,214,0.0,160.0,107.0,1,123,0.0,123.0,123.0
3197718.0,6,18,1495,9,921,361840.5,315.0,102.33333333333331,9,574,361809.25,78.0,63.77777777777778
146128.0,6,3,337,2,214,0.0,160.0,107.0,1,123,0.0,123.0,123.0
90749016.0,6,27,2998,14,1506,6980693.538461538,425.0,107.57142857142856,13,1492,7539370.583333333,337.0,114.76923076923076
42245.0,6,10,2032,5,524,9428.25,252.0,104.8,5,1508,9671.5,1236.0,301.6
162359.0,17,2,180,1,90,0.0,90.0,90.0,1,90,0.0,90.0,90.0
34756.0,6,14,4740,7,653,3753.3333333333335,249.0,93.28571428571428,7,4087,5651.333333333333,1514.0,583.8571428571429
31758.0,6,14,4740,7,653,4990.166666666667,249.0,93.28571428571428,7,4087,4884.5,1514.0,583.8571428571429
94000805.0,17,11,735,6,389,18800161.0,174.0,64.83333333333333,5,346,18502564.0,174.0,69.2
135137332.0,17,6,1146,6,1146,27027466.4,191.0,191.0,0,0,0.0,0.0,0.0
26388.0,6,10,2032,5,524,6207.25,252.0,104.8,5,1508,6321.25,1236.0,301.6
205640.0,17,2,762,2,762,0.0,381.0,381.0,0,0,0.0,0.0,0.0
153419.0,17,2,180,1,90,0.0,90.0,90.0,1,90,0.0,90.0,90.0
31355.0,6,10,2032,5,524,7623.25,252.0,104.8,5,1508,7622.25,1236.0,301.6
0.0,17,1,44,1,44,0.0,44.0,44.0,0,0,0.0,0.0,0.0
46658.0,6,14,4740,7,653,7092.833333333333,249.0,93.28571428571428,7,4087,7558.666666666667,1514.0,583.8571428571429
3385934.0,6,7,923,4,753,1060045.6666666667,571.0,188.25,3,170,1590663.0,62.0,56.66666666666666
27655.0,6,14,4740,7,653,4477.833333333333,249.0,93.28571428571428,7,4087,4468.0,1514.0,583.8571428571429
102886.0,17,2,286,2,286,0.0,143.0,143.0,0,0,0.0,0.0,0.0
183049.0,6,13,1394,7,797,30508.166666666668,253.0,113.85714285714286,6,597,34320.6,259.0,99.5
196891.0,17,2,180,1,90,0.0,90.0,90.0,1,90,0.0,90.0,90.0
10395.0,17,4,823,2,163,0.0,89.0,81.5,2,660,0.0,443.0,330.0
834.0,17,4,438,2,148,0.0,74.0,74.0,2,290,0.0,147.0,145.0
302275.0,6,6,412,4,272,100758.33333333331,74.0,68.0,2,140,0.0,74.0,70.0
90031327.0,17,28,13364,28,13364,3334493.592592593,501.0,477.2857142857143,0,0,0.0,0.0,0.0
148027.0,17,2,180,1,90,0.0,90.0,90.0,1,90,0.0,90.0,90.0
3163348.0,6,15,2266,8,1146,451906.8571428572,580.0,143.25,7,1120,492613.5,732.0,160.0
128007248.0,17,15,907,8,475,18286749.71428572,174.0,59.375,7,432,18000189.333333332,174.0,61.71428571428572
232523.0,6,3,337,2,214,0.0,160.0,107.0,1,123,0.0,123.0,123.0
301275.0,6,10,1221,6,636,60255.0,298.0,106.0,4,585,98867.66666666669,379.0,146.25
1591.0,17,2,762,2,762,0.0,381.0,381.0,0,0,0.0,0.0,0.0
135122471.0,17,6,1146,6,1146,27024494.2,191.0,191.0,0,0,0.0,0.0,0.0
2530287.0,6,25,7573,14,3735,194637.4615384616,1514.0,266.7857142857143,11,3838,226670.4,1514.0,348.90909090909093
33934.0,6,14,4740,7,653,4888.666666666667,249.0,93.28571428571428,7,4087,5005.5,1514.0,583.8571428571429
210868.0,17,4,1400,4,1400,70289.33333333333,350.0,350.0,0,0,0.0,0.0,0.0
310831.0,17,4,1400,4,1400,103610.33333333331,350.0,350.0,0,0,0.0,0.0,0.0
201414.0,17,4,6056,4,6056,67138.0,1514.0,1514.0,0,0,0.0,0.0,0.0
149081475.0,6,20,1490,11,840,14908147.5,95.0,76.36363636363636,9,650,14920261.25,95.0,72.22222222222223
101637.0,17,2,762,2,762,0.0,381.0,381.0,0,0,0.0,0.0,0.0
5621728.0,6,5,336,2,134,0.0,68.0,67.0,3,202,1525936.5,70.0,67.33333333333333
0.0,17,1,72,1,72,0.0,72.0,72.0,0,0,0.0,0.0,0.0
118706130.0,6,33,2274,17,1125,7419105.9375,123.0,66.17647058823529,16,1149,7247939.066666666,123.0,71.8125
120108077.0,6,230,25940,115,7886,1045757.0789473684,140.0,68.57391304347826,115,18054,1046350.254385965,284.0,156.9913043478261
2590597.0,6,2,132,1,66,0.0,66.0,66.0,1,66,0.0,66.0,66.0
343.0,17,2,160,1,80,0.0,80.0,80.0,1,80,0.0,80.0,80.0
29100.0,6,14,4740,7,653,4432.0,249.0,93.28571428571428,7,4087,4691.166666666667,1514.0,583.8571428571429
94112.0,17,4,1400,4,1400,31370.666666666668,350.0,350.0,0,0,0.0,0.0,0.0
299.0,17,2,164,1,82,0.0,82.0,82.0,1,82,0.0,82.0,82.0
119176538.0,6,225,25548,113,17934,1064076.232142857,300.0,158.7079646017699,112,7614,1065417.5675675676,140.0,67.98214285714286
2611.0,17,2,762,2,762,0.0,381.0,381.0,0,0,0.0,0.0,0.0
207100.0,6,3,426,2,280,0.0,214.0,140.0,1,146,0.0,146.0,146.0
123810442.0,6,49,3234,25,1650,5158768.416666667,66.0,66.0,24,1584,5087753.0869565215,66.0,66.0
52001.0,6,14,4740,7,653,8480.333333333334,249.0,93.28571428571428,7,4087,8029.333333333333,1514.0,583.8571428571429
90033726.0,17,27,12943,27,12943,3462835.6153846155,501.0,479.3703703703704,0,0,0.0,0.0,0.0
479.0,17,2,166,1,75,0.0,75.0,75.0,1,91,0.0,91.0,91.0
3023470.0,17,3,1026,3,1026,1511735.0,342.0,342.0,0,0,0.0,0.0,0.0
26967.0,6,14,4740,7,653,4328.166666666667,249.0,93.28571428571428,7,4087,4216.833333333333,1514.0,583.8571428571429
816.0,17,4,438,2,148,0.0,74.0,74.0,2,290,0.0,147.0,145.0
318.0,17,2,174,1,79,0.0,79.0,79.0,1,95,0.0,95.0,95.0
90019770.0,17,28,13364,28,13364,3334065.5555555555,501.0,477.2857142857143,0,0,0.0,0.0,0.0
90037165.0,17,28,13364,28,13364,3334709.814814815,501.0,477.2857142857143,0,0,0.0,0.0,0.0
111263.0,6,11,2098,6,590,21597.8,252.0,98.33333333333331,5,1508,27193.25,1236.0,301.6
2329.0,17,4,344,2,150,0.0,75.0,75.0,2,194,0.0,103.0,97.0
0.0,17,1,749,1,749,0.0,749.0,749.0,0,0,0.0,0.0,0.0
13418.0,6,10,2032,5,524,2647.0,252.0,104.8,5,1508,3078.5,1236.0,301.6
308177.0,17,4,1400,4,1400,102725.66666666669,350.0,350.0,0,0,0.0,0.0,0.0
110022.0,17,2,286,2,286,0.0,143.0,143.0,0,0,0.0,0.0,0.0
120122350.0,6,15,2340,7,1260,20020391.666666668,199.0,180.0,8,1080,17136814.714285713,204.0,135.0
104662391.0,17,14,4788,14,4788,8050953.153846154,342.0,342.0,0,0,0.0,0.0,0.0
2445.0,17,4,344,2,150,0.0,75.0,75.0,2,194,0.0,103.0,97.0
901.0,17,5,550,5,550,225.25,110.0,110.0,0,0,0.0,0.0,0.0
120337844.0,6,205,23136,103,16182,1179782.7843137255,284.0,157.10679611650485,102,6954,1172029.5742574255,140.0,68.17647058823529
115001116.0,17,17,1709,9,948,14375139.5,394.0,105.33333333333331,8,761,13572744.857142856,250.0,95.125
309784.0,6,6,412,4,272,103261.33333333331,74.0,68.0,2,140,0.0,74.0,70.0
120726284.0,6,22,1721,12,976,8267805.090909091,95.0,81.33333333333333,10,745,13408624.111111112,95.0,74.5
90291967.0,6,14,1043,7,542,15048661.166666666,95.0,77.42857142857143,7,501,15001081.166666666,95.0,71.57142857142857
135131804.0,17,6,1146,6,1146,27026360.8,191.0,191.0,0,0,0.0,0.0,0.0
216437.0,17,2,180,1,90,0.0,90.0,90.0,1,90,0.0,90.0,90.0
27001.0,6,14,4740,7,653,4256.5,249.0,93.28571428571428,7,4087,3924.0,1514.0,583.8571428571429
108108107.0,17,5,1005,5,1005,27027026.75,201.0,201.0,0,0,0.0,0.0,0.0
217983.0,6,3,426,2,280,0.0,214.0,140.0,1,146,0.0,146.0,146.0
553.0,17,2,762,2,762,0.0,381.0,381.0,0,0,0.0,0.0,0.0
108106985.0,17,5,955,5,955,27026746.25,191.0,191.0,0,0,0.0,0.0,0.0
122401.0,6,3,373,2,238,0.0,172.0,119.0,1,135,0.0,135.0,135.0
33415.0,6,11,2098,6,590,6683.0,252.0,98.33333333333331,5,1508,6611.5,1236.0,301.6
9199.0,17,2,539,1,86,0.0,86.0,86.0,1,453,0.0,453.0,453.0
51757.0,6,10,2032,5,524,12720.25,252.0,104.8,5,1508,12569.5,1236.0,301.6
119282437.0,6,233,26356,117,8018,1028296.8706896552,140.0,68.52991452991454,116,18338,1029282.5565217392,284.0,158.08620689655172
209192.0,6,12,1373,7,714,34865.333333333336,298.0,102.0,5,659,51469.75,379.0,131.8
2347.0,17,4,344,2,150,0.0,75.0,75.0,2,194,0.0,103.0,97.0
91699160.0,6,24,1885,13,948,7637966.833333333,95.0,72.92307692307692,11,937,9169195.5,155.0,85.18181818181819
135137022.0,17,6,1146,6,1146,27027404.4,191.0,191.0,0,0,0.0,0.0,0.0
297081.0,6,6,412,4,272,99027.0,74.0,68.0,2,140,0.0,74.0,70.0
79.0,17,2,762,2,762,0.0,381.0,381.0,0,0,0.0,0.0,0.0
212303.0,6,3,426,2,280,0.0,214.0,140.0,1,146,0.0,146.0,146.0
228250.0,17,2,180,1,90,0.0,90.0,90.0,1,90,0.0,90.0,90.0
1297269.0,6,4,264,2,132,0.0,66.0,66.0,2,132,0.0,66.0,66.0
2181.0,17,4,344,2,150,0.0,75.0,75.0,2,194,0.0,103.0,97.0
41704.0,6,14,4740,7,653,6791.666666666667,249.0,93.28571428571428,7,4087,6418.0,1514.0,583.8571428571429
125017274.0,17,15,907,8,475,17859610.57142857,174.0,59.375,7,432,17500176.833333332,174.0,61.71428571428572
1694795.0,17,5,961,3,234,847209.5,78.0,78.0,2,727,0.0,395.0,363.5
232978.0,6,3,337,2,214,0.0,160.0,107.0,1,123,0.0,123.0,123.0
1054458.0,6,3,1604,1,753,0.0,753.0,753.0,2,851,0.0,785.0,425.5
126577.0,6,2,132,1,66,0.0,66.0,66.0,1,66,0.0,66.0,66.0
47536.0,6,11,2098,6,590,9507.2,252.0,98.33333333333331,5,1508,9934.75,1236.0,301.6
102718742.0,6,41,2706,21,1386,5135937.1,66.0,66.0,20,1320,5160946.842105263,66.0,66.0
260869.00000000003,6,3,337,2,214,0.0,160.0,107.0,1,123,0.0,123.0,123.0
196969.0,17,2,180,1,90,0.0,90.0,90.0,1,90,0.0,90.0,90.0
40652.0,6,14,4740,7,653,6344.666666666667,249.0,93.28571428571428,7,4087,5869.5,1514.0,583.8571428571429
206035.0,17,2,180,1,90,0.0,90.0,90.0,1,90,0.0,90.0,90.0
90045556.0,17,28,13364,28,13364,3335020.592592593,501.0,477.2857142857143,0,0,0.0,0.0,0.0
240259.0,6,3,373,2,238,0.0,172.0,119.0,1,135,0.0,135.0,135.0
217719.0,6,3,426,2,280,0.0,214.0,140.0,1,146,0.0,146.0,146.0
117623293.0,6,48,3168,24,1584,5114056.217391305,66.0,66.0,24,1584,5104657.956521739,66.0,66.0
221971.0,6,3,426,2,280,0.0,214.0,140.0,1,146,0.0,146.0,146.0
204677.0,17,2,762,2,762,0.0,381.0,381.0,0,0,0.0,0.0,0.0
15113.0,17,4,823,2,163,0.0,89.0,81.5,2,660,0.0,443.0,330.0
317270.0,17,4,1400,4,1400,105756.66666666669,350.0,350.0,0,0,0.0,0.0,0.0
5822193.0,6,5,336,2,134,0.0,68.0,67.0,3,202,1527011.5,70.0,67.33333333333333
90051801.0,17,28,13364,28,13364,3335251.888888889,501.0,477.2857142857143,0,0,0.0,0.0,0.0
32681616.0,6,5,336,2,134,0.0,68.0,67.0,3,202,15052970.0,70.0,67.33333333333333
1560489.0,17,6,1039,4,312,520036.6666666667,78.0,78.0,2,727,0.0,395.0,363.5
595074.0,6,4,508,2,238,0.0,172.0,119.0,2,270,0.0,135.0,135.0
759.0,17,4,438,2,148,0.0,74.0,74.0,2,290,0.0,147.0,145.0
2081.0,17,4,344,2,150,0.0,75.0,75.0,2,194,0.0,103.0,97.0
312289.0,17,4,1400,4,1400,104096.33333333331,350.0,350.0,0,0,0.0,0.0,0.0
135129155.0,17,6,1146,6,1146,27025831.0,191.0,191.0,0,0,0.0,0.0,0.0
120000017.0,6,17,1287,9,691,15000002.125,95.0,76.77777777777777,8,596,12898408.42857143,95.0,74.5
64755.99999999999,6,10,2032,5,524,15942.75,252.0,104.8,5,1508,15033.75,1236.0,301.6
118030599.0,6,30,1974,15,1026,8415339.92857143,123.0,68.4,15,948,8415335.57142857,123.0,63.2
9908.0,17,2,571,1,86,0.0,86.0,86.0,1,485,0.0,485.0,485.0
49625.0,6,14,4740,7,653,7958.0,249.0,93.28571428571428,7,4087,7728.166666666667,1514.0,583.8571428571429
120202806.0,6,224,25324,112,17624,1080969.7117117117,284.0,157.35714285714286,112,7700,1080969.7027027027,140.0,68.75
10511559.0,6,7,478,4,272,3456888.6666666665,74.0,68.0,3,206,5185262.0,74.0,68.66666666666667
247884.0,6,3,373,2,238,0.0,172.0,119.0,1,135,0.0,135.0,135.0
90259882.0,6,13,2036,8,1016,12894268.857142856,188.0,127.0,5,1020,22522945.25,204.0,204.0
28055.0,6,10,2032,5,524,5793.0,252.0,104.8,5,1508,6538.25,1236.0,301.6
90259385.0,6,16,2368,9,1204,11282423.125,188.0,133.77777777777777,7,1164,15015324.666666666,204.0,166.28571428571428
371.0,17,2,166,1,75,0.0,75.0,75.0,1,91,0.0,91.0,91.0
90246068.0,6,14,1964,8,1016,12892295.42857143,188.0,127.0,6,948,18016628.4,204.0,158.0
101724381.0,17,14,864,7,432,16834410.333333332,174.0,61.71428571428572,7,432,16833534.0,174.0,61.71428571428572
2220752.0,6,3,1777,2,951,0.0,885.0,475.5,1,826,0.0,826.0,826.0
4372.0,17,2,180,1,90,0.0,90.0,90.0,1,90,0.0,90.0,90.0
34623.0,6,14,4740,7,653,5597.833333333333,249.0,93.28571428571428,7,4087,5074.5,1514.0,583.8571428571429
112322017.0,17,14,864,7,432,18720336.166666668,174.0,61.71428571428572,7,432,18637741.83333333,174.0,61.71428571428572
120028464.0,17,29,13785,29,13785,4286730.857142857,501.0,475.3448275862069,0,0,0.0,0.0,0.0
301240.0,6,6,412,4,272,100413.33333333331,74.0,68.0,2,140,0.0,74.0,70.0
31111.0,6,14,4740,7,653,4928.5,249.0,93.28571428571428,7,4087,5011.666666666667,1514.0,583.8571428571429
11736102.0,17,4,1368,4,1368,3912034.0,342.0,342.0,0,0,0.0,0.0,0.0
314883.0,17,4,1400,4,1400,104961.0,350.0,350.0,0,0,0.0,0.0,0.0
3281992.0,6,18,1495,9,921,370733.75,315.0,102.33333333333331,9,574,370691.5,78.0,63.77777777777778
26230.0,6,14,4740,7,653,4261.0,249.0,93.28571428571428,7,4087,2849.5,1514.0,583.8571428571429
29821.0,6,10,2032,5,524,7221.5,252.0,104.8,5,1508,6925.75,1236.0,301.6
125022773.0,17,15,1038,8,606,17860396.14285714,174.0,75.75,7,432,19898604.83333333,174.0,61.71428571428572
133970.0,6,2,132,1,66,0.0,66.0,66.0,1,66,0.0,66.0,66.0
97691626.0,17,29,12129,29,12129,3488986.6428571427,453.0,418.2413793103448,0,0,0.0,0.0,0.0
106857.0,17,2,286,2,286,0.0,143.0,143.0,0,0,0.0,0.0,0.0
90021147.0,17,28,13364,28,13364,3334116.5555555555,501.0,477.2857142857143,0,0,0.0,0.0,0.0
27030376.0,17,5,1710,5,1710,6757594.0,342.0,342.0,0,0,0.0,0.0,0.0
35921.0,6,10,2032,5,524,4632.75,252.0,104.8,5,1508,8217.25,1236.0,301.6
90256520.0,6,14,2102,8,1016,12893788.57142857,188.0,127.0,6,1086,18018826.2,204.0,181.0
2805.0,17,4,344,2,150,0.0,75.0,75.0,2,194,0.0,103.0,97.0
3060690.0,6,3,204,2,134,0.0,68.0,67.0,1,70,0.0,70.0,70.0
333.0,17,2,208,1,72,0.0,72.0,72.0,1,136,0.0,136.0,136.0
270767.0,6,3,337,2,214,0.0,160.0,107.0,1,123,0.0,123.0,123.0
2386.0,17,4,344,2,150,0.0,75.0,75.0,2,194,0.0,103.0,97.0
31645.0,6,14,4740,7,653,4515.333333333333,249.0,93.28571428571428,7,4087,5136.666666666667,1514.0,583.8571428571429
2318643.0,6,3,1604,2,851,0.0,785.0,425.5,1,753,0.0,753.0,753.0
1029558.0,6,11,1134,6,558,205911.6,220.0,93.0,5,576,256056.5,304.0,115.2
871425.0,6,9,1267,6,796,174285.0,458.0,132.66666666666666,3,471,298175.0,331.0,157.0
153390.0,17,2,180,1,90,0.0,90.0,90.0,1,90,0.0,90.0,90.0
188972.0,17,2,180,1,90,0.0,90.0,90.0,1,90,0.0,90.0,90.0
2379.0,17,4,344,2,150,0.0,75.0,75.0,2,194,0.0,103.0,97.0
282255.0,17,4,704,2,148,0.0,74.0,74.0,2,556,0.0,280.0,278.0
150160.0,6,2,132,1,66,0.0,66.0,66.0,1,66,0.0,66.0,66.0
246219.0,6,3,337,2,214,0.0,160.0,107.0,1,123,0.0,123.0,123.0
4477.0,17,2,618,1,72,0.0,72.0,72.0,1,546,0.0,546.0,546.0
323.0,17,2,174,1,79,0.0,79.0,79.0,1,95,0.0,95.0,95.0
102688985.0,6,32,2236,16,1165,6831582.8,139.0,72.8125,16,1071,6831582.6,123.0,66.9375
120000013.0,6,23,1775,13,1030,10000001.083333334,95.0,79.23076923076923,10,745,9949225.222222222,95.0,74.5
2930983.0,6,11,2106,6,598,586012.4,252.0,99.66666666666669,5,1508,1636.0,1236.0,301.6
97651863.0,17,12,778,6,389,19400182.0,174.0,64.83333333333333,6,389,19400905.2,174.0,64.83333333333333
104855782.0,17,14,4788,14,4788,8065829.384615385,342.0,342.0,0,0,0.0,0.0,0.0
28692.0,6,14,4740,7,653,4517.5,249.0,93.28571428571428,7,4087,4459.0,1514.0,583.8571428571429
120052626.0,17,28,13364,28,13364,4446393.555555556,501.0,477.2857142857143,0,0,0.0,0.0,0.0
108964405.0,6,35,2542,18,1348,6409670.882352941,139.0,74.88888888888889,17,1194,6796754.5,123.0,70.23529411764706
1173983.0,6,13,3000,8,2372,167711.85714285713,1514.0,296.5,5,628,224541.75,331.0,125.6
20043.0,6,11,1133,6,602,3508.6,264.0,100.33333333333331,5,531,4649.0,259.0,106.2
3014227.0,6,12,2172,7,664,502316.6666666667,252.0,94.85714285714286,5,1508,3507.25,1236.0,301.6
15668.000000000002,6,14,4740,7,653,2343.1666666666665,249.0,93.28571428571428,7,4087,2475.0,1514.0,583.8571428571429
102554005.0,6,43,3597,18,1593,6032588.529411765,123.0,88.5,25,2004,4264073.166666667,123.0,80.16
1306925.0,6,4,264,2,132,0.0,66.0,66.0,2,132,0.0,66.0,66.0
500067.00000000006,6,4,270,2,134,0.0,68.0,67.0,2,136,0.0,70.0,68.0
232086.0,6,3,337,2,214,0.0,160.0,107.0,1,123,0.0,123.0,123.0
21483.0,6,14,4740,7,653,3471.6666666666665,249.0,93.28571428571428,7,4087,2680.1666666666665,1514.0,583.8571428571429
2011.0,17,4,344,2,150,0.0,75.0,75.0,2,194,0.0,103.0,97.0
356.0,17,2,208,1,72,0.0,72.0,72.0,1,136,0.0,136.0,136.0
22661.0,6,10,2032,5,524,5008.25,252.0,104.8,5,1508,5391.0,1236.0,301.6
275515.0,17,2,180,1,90,0.0,90.0,90.0,1,90,0.0,90.0,90.0
865359.0,6,10,1335,6,798,173071.8,460.0,133.0,4,537,197522.66666666663,331.0,134.25
107767.0,17,2,286,2,286,0.0,143.0,143.0,0,0,0.0,0.0,0.0
113766926.0,6,48,3168,24,1584,4946388.0869565215,66.0,66.0,24,1584,4936987.913043479,66.0,66.0
143801.0,17,2,180,1,90,0.0,90.0,90.0,1,90,0.0,90.0,90.0
121278.0,6,3,337,2,214,0.0,160.0,107.0,1,123,0.0,123.0,123.0
90019290.0,17,28,13364,28,13364,3334047.777777778,501.0,477.2857142857143,0,0,0.0,0.0,0.0
102773115.0,17,14,864,7,432,17102231.5,174.0,61.71428571428572,7,432,16910160.333333332,174.0,61.71428571428572
145209.0,17,2,180,1,70,0.0,70.0,70.0,1,110,0.0,110.0,110.0
2804156.0,6,2,132,1,66,0.0,66.0,66.0,1,66,0.0,66.0,66.0
108127734.0,17,5,1005,5,1005,27031933.5,201.0,201.0,0,0,0.0,0.0,0.0
43823.0,6,10,2032,5,524,10344.5,252.0,104.8,5,1508,8792.75,1236.0,301.6
41902.0,6,14,4740,7,653,6779.5,249.0,93.28571428571428,7,4087,6652.0,1514.0,583.8571428571429
310081.0,6,6,412,4,272,103360.33333333331,74.0,68.0,2,140,0.0,74.0,70.0
93702902.0,17,14,4796,13,4446,6228747.25,342.0,342.0,1,350,0.0,350.0,350.0
281170.0,17,2,414,1,88,0.0,88.0,88.0,1,326,0.0,326.0,326.0
225838.0,6,3,426,2,280,0.0,214.0,140.0,1,146,0.0,146.0,146.0
2331.0,17,4,344,2,150,0.0,75.0,75.0,2,194,0.0,103.0,97.0
32075.0,6,10,1065,5,534,7853.5,262.0,106.8,5,531,7607.5,259.0,106.2
72129452.0,6,9,842,9,842,9016181.5,97.0,93.55555555555556,0,0,0.0,0.0,0.0
95429448.0,6,35,2812,19,1534,5301636.0,139.0,80.73684210526316,16,1278,6347430.333333333,123.0,79.875
116001219.0,17,15,1169,8,606,16571602.714285716,174.0,75.75,7,563,16000769.0,174.0,80.42857142857143
213727.0,6,10,1221,6,636,42745.4,298.0,106.0,4,585,69930.66666666667,379.0,146.25
234479.0,6,3,337,2,214,0.0,160.0,107.0,1,123,0.0,123.0,123.0
147095.0,6,3,373,2,238,0.0,172.0,119.0,1,135,0.0,135.0,135.0
228390.0,17,2,180,1,90,0.0,90.0,90.0,1,90,0.0,90.0,90.0
153403.0,17,2,180,1,90,0.0,90.0,90.0,1,90,0.0,90.0,90.0
10433060.0,6,7,478,4,272,3432341.333333333,74.0,68.0,3,206,5148431.5,74.0,68.66666666666667
28016.0,6,14,4740,7,653,4519.666666666667,249.0,93.28571428571428,7,4087,4528.5,1514.0,583.8571428571429
307968.0,6,6,412,4,272,102656.0,74.0,68.0,2,140,0.0,74.0,70.0
2402.0,17,4,344,2,150,0.0,75.0,75.0,2,194,0.0,103.0,97.0
713.0,17,4,438,2,148,0.0,74.0,74.0,2,290,0.0,147.0,145.0
1481320.0,6,6,396,3,198,587176.5,66.0,66.0,3,198,587183.5,66.0,66.0
13808078.0,6,275,254864,82,5584,170470.0987654321,206.0,68.09756097560975,193,249280,71876.28125,1514.0,1291.6062176165804
41989.0,6,14,4740,7,653,6837.0,249.0,93.28571428571428,7,4087,6483.0,1514.0,583.8571428571429
118300696.0,6,31,2166,16,1149,7872310.266666667,123.0,71.8125,15,1017,8434616.857142856,123.0,67.8
310478.0,6,3,202,2,128,0.0,74.0,64.0,1,74,0.0,74.0,74.0
103686.0,17,2,286,2,286,0.0,143.0,143.0,0,0,0.0,0.0,0.0
308591.0,17,4,1400,4,1400,102863.66666666669,350.0,350.0,0,0,0.0,0.0,0.0
114645359.0,17,14,864,7,432,19000947.666666668,174.0,61.71428571428572,7,432,19000187.83333333,174.0,61.71428571428572
206721.0,6,3,426,2,280,0.0,214.0,140.0,1,146,0.0,146.0,146.0
27494160.0,17,5,1710,5,1710,6873540.0,342.0,342.0,0,0,0.0,0.0,0.0
10506482.0,6,7,478,4,272,3456481.6666666665,74.0,68.0,3,206,5184622.5,74.0,68.66666666666667
108106589.0,17,5,955,5,955,27026647.25,191.0,191.0,0,0,0.0,0.0,0.0
35129.0,6,11,2098,6,590,6600.6,252.0,98.33333333333331,5,1508,6048.0,1236.0,301.6
22707.0,6,14,4740,7,653,3673.5,249.0,93.28571428571428,7,4087,3367.1666666666665,1514.0,583.8571428571429
1048739.0,6,11,1134,6,558,209747.8,220.0,93.0,5,576,260031.75,304.0,115.2
301953.0,6,6,412,4,272,100651.0,74.0,68.0,2,140,0.0,74.0,70.0
115949454.0,17,14,864,7,432,19324909.0,174.0,61.71428571428572,7,432,19283842.33333333,174.0,61.71428571428572
2351.0,17,4,344,2,150,0.0,75.0,75.0,2,194,0.0,103.0,97.0
92912.0,17,2,286,2,286,0.0,143.0,143.0,0,0,0.0,0.0,0.0
114258191.0,6,199,22508,100,6896,1154123.1414141415,140.0,68.96,99,15612,1144862.8673469387,284.0,157.6969696969697
26929.0,6,14,4740,7,653,4276.166666666667,249.0,93.28571428571428,7,4087,4305.5,1514.0,583.8571428571429
2347.0,17,4,344,2,150,0.0,75.0,75.0,2,194,0.0,103.0,97.0
25083.0,6,10,2032,5,524,5600.75,252.0,104.8,5,1508,5680.25,1236.0,301.6
120056466.0,17,28,13364,28,13364,4446535.777777778,501.0,477.2857142857143,0,0,0.0,0.0,0.0
6911.0,17,2,582,1,83,0.0,83.0,83.0,1,499,0.0,499.0,499.0
90959432.0,6,21,1585,11,840,9095547.3,95.0,76.36363636363636,10,745,10105442.777777778,95.0,74.5
105972.0,17,2,286,2,286,0.0,143.0,143.0,0,0,0.0,0.0,0.0
143919.0,17,2,180,1,90,0.0,90.0,90.0,1,90,0.0,90.0,90.0
40743.0,6,11,2098,6,590,2703.6,252.0,98.33333333333331,5,1508,9931.5,1236.0,301.6
2417.0,17,4,344,2,150,0.0,75.0,75.0,2,194,0.0,103.0,97.0
26268.0,17,4,344,2,150,0.0,75.0,75.0,2,194,0.0,103.0,97.0
36893.0,6,2,145,2,145,0.0,91.0,72.5,0,0,0.0,0.0,0.0
196987.0,17,2,180,1,90,0.0,90.0,90.0,1,90,0.0,90.0,90.0
135144911.0,17,6,1206,6,1206,27028982.2,201.0,201.0,0,0,0.0,0.0,0.0
144772.0,17,2,180,1,70,0.0,70.0,70.0,1,110,0.0,110.0,110.0
102725887.0,17,14,1126,7,563,17094149.0,174.0,80.42857142857143,7,563,17030216.333333332,174.0,80.42857142857143
190907.0,17,2,180,1,90,0.0,90.0,90.0,1,90,0.0,90.0,90.0
49194.0,6,14,4740,7,653,7654.5,249.0,93.28571428571428,7,4087,7968.0,1514.0,583.8571428571429
328.0,17,2,166,1,75,0.0,75.0,75.0,1,91,0.0,91.0,91.0
98028148.0,17,14,1126,7,563,16333460.833333334,174.0,80.42857142857143,7,563,16334070.833333334,174.0,80.42857142857143
98733.0,6,2,132,1,66,0.0,66.0,66.0,1,66,0.0,66.0,66.0
136706.0,6,2,132,1,66,0.0,66.0,66.0,1,66,0.0,66.0,66.0
200041.0,17,4,6056,4,6056,66680.33333333333,1514.0,1514.0,0,0,0.0,0.0,0.0
108108505.0,17,5,955,5,955,27027126.25,191.0,191.0,0,0,0.0,0.0,0.0
108105014.0,17,5,955,5,955,27026253.5,191.0,191.0,0,0,0.0,0.0,0.0
46575608.0,6,8,1940,3,887,22135510.0,753.0,295.6666666666667,5,1053,11000726.75,785.0,210.6
103339.0,17,2,286,2,286,0.0,143.0,143.0,0,0,0.0,0.0,0.0
2821452.0,6,3,1604,2,851,0.0,785.0,425.5,1,753,0.0,753.0,753.0
98343726.0,17,12,778,6,389,19636728.4,174.0,64.83333333333333,6,389,19619249.8,174.0,64.83333333333333
108334232.0,6,26,2906,13,1452,9021536.916666666,426.0,111.6923076923077,13,1454,9027004.083333334,361.0,111.84615384615384
253041.00000000003,17,8,12112,8,12112,36148.71428571428,1514.0,1514.0,0,0,0.0,0.0,0.0
120105725.0,6,34,2350,17,1225,7493119.0625,139.0,72.05882352941177,17,1125,7493121.4375,123.0,66.17647058823529
40177.0,6,14,4740,7,653,6185.666666666667,249.0,93.28571428571428,7,4087,6236.0,1514.0,583.8571428571429
135134986.0,17,6,1146,6,1146,27026997.2,191.0,191.0,0,0,0.0,0.0,0.0
120552911.0,6,213,24008,107,16716,1137291.6132075472,284.0,156.22429906542055,106,7292,1138020.1333333333,140.0,68.79245283018868
43458.0,6,14,4740,7,653,6749.666666666667,249.0,93.28571428571428,7,4087,6935.833333333333,1514.0,583.8571428571429
201665.0,17,2,180,1,90,0.0,90.0,90.0,1,90,0.0,90.0,90.0
89259959.0,17,14,4788,14,4788,6866150.692307692,342.0,342.0,0,0,0.0,0.0,0.0
202211.0,17,4,6056,4,6056,67403.66666666667,1514.0,1514.0,0,0,0.0,0.0,0.0
15522341.0,6,26,7627,14,3735,194910.15384615384,1514.0,266.7857142857143,12,3892,1391340.0909090908,1514.0,324.3333333333333
30191.0,6,14,4740,7,653,4753.333333333333,249.0,93.28571428571428,7,4087,4020.8333333333335,1514.0,583.8571428571429
90255871.0,6,12,1832,8,1016,12893695.857142856,188.0,127.0,4,816,30030691.0,204.0,204.0
209618.0,17,2,180,1,90,0.0,90.0,90.0,1,90,0.0,90.0,90.0
2118.0,17,4,344,2,150,0.0,75.0,75.0,2,194,0.0,103.0,97.0
0.0,17,1,55,1,55,0.0,55.0,55.0,0,0,0.0,0.0,0.0
106236784.0,6,44,2904,22,1452,5058894.476190476,66.0,66.0,22,1452,5045915.857142857,66.0,66.0
90954985.0,6,21,1626,11,881,9089769.0,95.0,80.0909090909091,10,745,9999985.222222222,95.0,74.5
227134.0,6,13,1394,7,797,37855.66666666666,253.0,113.85714285714286,6,597,43349.6,259.0,99.5
2793628.0,6,3,1604,2,851,0.0,785.0,425.5,1,753,0.0,753.0,753.0
3107130.0,6,3,204,2,136,0.0,70.0,68.0,1,68,0.0,68.0,68.0
207457.0,6,10,1221,6,636,41491.4,298.0,106.0,4,585,67917.66666666667,379.0,146.25
2798746.0,6,2,132,1,66,0.0,66.0,66.0,1,66,0.0,66.0,66.0
90310976.0,6,17,1287,9,691,11282719.5,95.0,76.77777777777777,8,596,12900057.42857143,95.0,74.5
107840632.0,6,28,1860,14,966,8295433.230769231,123.0,69.0,14,894,8278809.846153846,123.0,63.85714285714285
34756.0,6,10,2032,5,524,8175.25,252.0,104.8,5,1508,7661.5,1236.0,301.6
300267.0,6,6,412,4,272,100089.0,74.0,68.0,2,140,0.0,74.0,70.0
2967.0,17,2,224,1,76,0.0,76.0,76.0,1,148,0.0,148.0,148.0
135130943.0,17,6,1206,6,1206,27026188.6,201.0,201.0,0,0,0.0,0.0,0.0
109259.0,6,11,1131,6,600,21387.0,262.0,100.0,5,531,3518.75,259.0,106.2
35774.0,6,10,2032,5,524,8678.25,252.0,104.8,5,1508,8626.75,1236.0,301.6
302363.0,6,2,132,1,66,0.0,66.0,66.0,1,66,0.0,66.0,66.0
90029034.0,17,28,13364,28,13364,3334408.6666666665,501.0,477.2857142857143,0,0,0.0,0.0,0.0
102512.0,17,2,286,2,286,0.0,143.0,143.0,0,0,0.0,0.0,0.0
105557.0,6,2,132,1,66,0.0,66.0,66.0,1,66,0.0,66.0,66.0
36817.0,6,14,4740,7,653,6018.333333333333,249.0,93.28571428571428,7,4087,4826.833333333333,1514.0,583.8571428571429
60908.0,6,14,4740,7,653,8553.0,249.0,93.28571428571428,7,4087,9609.166666666666,1514.0,583.8571428571429
16891.0,17,2,180,1,90,0.0,90.0,90.0,1,90,0.0,90.0,90.0
377861.0,6,12,1373,7,714,62976.833333333336,298.0,102.0,5,659,93362.75,379.0,131.8
1319987.0,6,4,264,2,132,0.0,66.0,66.0,2,132,0.0,66.0,66.0
46588010.0,6,8,2113,3,960,22105041.5,826.0,320.0,5,1153,11003226.25,885.0,230.6
135137481.0,17,6,1206,6,1206,27027496.2,201.0,201.0,0,0,0.0,0.0,0.0
138889.0,17,4,344,2,150,0.0,75.0,75.0,2,194,0.0,103.0,97.0
119853603.0,6,15,2306,6,1224,23970234.4,204.0,204.0,9,1082,14981564.625,188.0,120.22222222222224
33799.0,6,14,4740,7,653,5350.666666666667,249.0,93.28571428571428,7,4087,5397.0,1514.0,583.8571428571429
147410.0,6,3,373,2,238,0.0,172.0,119.0,1,135,0.0,135.0,135.0
306699.0,6,6,412,4,272,102233.0,74.0,68.0,2,140,0.0,74.0,70.0
108107639.0,17,5,1005,5,1005,27026909.75,201.0,201.0,0,0,0.0,0.0,0.0
210435.0,6,3,426,2,280,0.0,214.0,140.0,1,146,0.0,146.0,146.0
47343.0,6,14,4740,7,653,7251.5,249.0,93.28571428571428,7,4087,7678.5,1514.0,583.8571428571429
4532.0,17,2,626,1,72,0.0,72.0,72.0,1,554,0.0,554.0,554.0
143974.0,17,2,180,1,90,0.0,90.0,90.0,1,90,0.0,90.0,90.0
123309846.0,6,48,3168,24,1584,4962518.913043479,66.0,66.0,24,1584,5326767.521739131,66.0,66.0
3210.0,17,2,334,1,79,0.0,79.0,79.0,1,255,0.0,255.0,255.0
106941.0,17,2,286,2,286,0.0,143.0,143.0,0,0,0.0,0.0,0.0
2367.0,17,4,344,2,150,0.0,75.0,75.0,2,194,0.0,103.0,97.0
1639991.0,6,7,499,4,301,474929.3333333333,103.0,75.25,3,198,716715.5,66.0,66.0
204626.0,17,2,762,2,762,0.0,381.0,381.0,0,0,0.0,0.0,0.0
284318.0,17,2,363,1,79,0.0,79.0,79.0,1,284,0.0,284.0,284.0
105202462.0,17,15,5130,15,5130,7514461.571428572,342.0,342.0,0,0,0.0,0.0,0.0
32681981.0,6,5,336,2,134,0.0,68.0,67.0,3,202,14950811.0,70.0,67.33333333333333
146965.0,6,3,373,2,238,0.0,172.0,119.0,1,135,0.0,135.0,135.0
198967.0,17,4,6056,4,6056,66322.33333333333,1514.0,1514.0,0,0,0.0,0.0,0.0
215727.0,6,3,426,2,280,0.0,214.0,140.0,1,146,0.0,146.0,146.0
19999.0,6,11,2098,6,590,3825.0,252.0,98.33333333333331,5,1508,3743.25,1236.0,301.6
108079037.0,17,5,1005,5,1005,27019759.25,201.0,201.0,0,0,0.0,0.0,0.0
1426.0,17,2,762,2,762,0.0,381.0,381.0,0,0,0.0,0.0,0.0
341.0,17,2,267,1,83,0.0,83.0,83.0,1,184,0.0,184.0,184.0
149839156.0,17,36,17126,36,17126,4281118.742857143,501.0,475.72222222222223,0,0,0.0,0.0,0.0
6764.0,17,2,582,1,83,0.0,83.0,83.0,1,499,0.0,499.0,499.0
487.0,17,2,508,2,508,0.0,257.0,254.0,0,0,0.0,0.0,0.0
237458.0,6,3,337,2,214,0.0,160.0,107.0,1,123,0.0,123.0,123.0
104342.0,17,2,700,2,700,0.0,350.0,350.0,0,0,0.0,0.0,0.0
103782.0,17,2,286,2,286,0.0,143.0,143.0,0,0,0.0,0.0,0.0
300199.0,6,6,412,4,272,100066.33333333331,74.0,68.0,2,140,0.0,74.0,70.0
619056.0,17,2,346,1,78,0.0,78.0,78.0,1,268,0.0,268.0,268.0
10519909.0,6,7,478,4,272,3461131.0,74.0,68.0,3,206,5191608.5,74.0,68.66666666666667
218485.0,6,3,426,2,280,0.0,214.0,140.0,1,146,0.0,146.0,146.0
213710.0,17,2,180,1,90,0.0,90.0,90.0,1,90,0.0,90.0,90.0
108102452.0,17,5,1005,5,1005,27025613.0,201.0,201.0,0,0,0.0,0.0,0.0
105832618.0,6,44,2904,22,1452,5039648.476190476,66.0,66.0,22,1452,5029356.619047619,66.0,66.0
108105571.0,17,5,955,5,955,27026392.75,191.0,191.0,0,0,0.0,0.0,0.0
10482.0,17,2,582,1,83,0.0,83.0,83.0,1,499,0.0,499.0,499.0
135130738.0,17,6,1206,6,1206,27026147.6,201.0,201.0,0,0,0.0,0.0,0.0
8233464.0,17,5,1710,5,1710,2058366.0,342.0,342.0,0,0,0.0,0.0,0.0
104181043.0,17,14,864,7,432,17334235.666666668,174.0,61.71428571428572,7,432,17333486.333333332,174.0,61.71428571428572
107242.0,17,2,286,2,286,0.0,143.0,143.0,0,0,0.0,0.0,0.0
107774.0,17,2,286,2,286,0.0,143.0,143.0,0,0,0.0,0.0,0.0
326504.0,6,6,412,4,272,108834.66666666669,74.0,68.0,2,140,0.0,74.0,70.0
145534.0,6,3,337,2,214,0.0,160.0,107.0,1,123,0.0,123.0,123.0
90051755.0,17,28,13364,28,13364,3335250.185185185,501.0,477.2857142857143,0,0,0.0,0.0,0.0
135127045.0,17,6,1146,6,1146,27025409.0,191.0,191.0,0,0,0.0,0.0,0.0
102379.0,17,2,762,2,762,0.0,381.0,381.0,0,0,0.0,0.0,0.0
215583.0,6,10,1221,6,636,43116.6,298.0,106.0,4,585,71003.66666666667,379.0,146.25
37754.0,6,10,2032,5,524,7377.25,252.0,104.8,5,1508,8278.5,1236.0,301.6
300073.0,6,6,412,4,272,100024.33333333331,74.0,68.0,2,140,0.0,74.0,70.0
22534.0,6,10,2032,5,524,4240.5,252.0,104.8,5,1508,5273.75,1236.0,301.6
228104.0,17,2,180,1,90,0.0,90.0,90.0,1,90,0.0,90.0,90.0
150347.0,17,2,180,1,90,0.0,90.0,90.0,1,90,0.0,90.0,90.0
2573956.0,6,2,132,1,66,0.0,66.0,66.0,1,66,0.0,66.0,66.0
339.0,17,2,160,1,80,0.0,80.0,80.0,1,80,0.0,80.0,80.0
220427.0,17,2,180,1,90,0.0,90.0,90.0,1,90,0.0,90.0,90.0
115908500.0,6,47,3102,24,1584,5026049.652173913,66.0,66.0,23,1518,5150426.636363637,66.0,66.0
369.0,17,2,267,1,83,0.0,83.0,83.0,1,184,0.0,184.0,184.0
31753.000000000004,6,14,4740,7,653,5114.5,249.0,93.28571428571428,7,4087,5007.833333333333,1514.0,583.8571428571429
121658935.0,17,14,864,7,432,17001016.5,174.0,61.71428571428572,7,432,17000157.333333332,174.0,61.71428571428572
29880.0,6,10,2032,5,524,4671.0,252.0,104.8,5,1508,6184.25,1236.0,301.6
298.0,17,2,156,1,78,0.0,78.0,78.0,1,78,0.0,78.0,78.0
96019917.0,6,184,20924,93,6434,1043694.75,140.0,69.18279569892474,91,14490,1055429.433333333,284.0,159.23076923076923
319316.0,17,4,1400,4,1400,106438.66666666669,350.0,350.0,0,0,0.0,0.0,0.0
257355.0,17,4,6056,4,6056,85784.99999999999,1514.0,1514.0,0,0,0.0,0.0,0.0
0.0,17,1,90,1,90,0.0,90.0,90.0,0,0,0.0,0.0,0.0
9143.0,17,2,539,1,86,0.0,86.0,86.0,1,453,0.0,453.0,453.0
303452.0,6,6,412,4,272,101150.66666666669,74.0,68.0,2,140,0.0,74.0,70.0
144564.0,17,2,180,1,70,0.0,70.0,70.0,1,110,0.0,110.0,110.0
321621.0,17,4,1400,4,1400,107207.0,350.0,350.0,0,0,0.0,0.0,0.0
88502.0,6,10,2032,5,524,20132.75,252.0,104.8,5,1508,19008.25,1236.0,301.6
120552233.0,6,229,25800,115,17980,1057475.7280701755,284.0,156.34782608695653,114,7820,1057726.0353982302,140.0,68.59649122807018
23035413.0,17,3,1034,2,684,0.0,342.0,342.0,1,350,0.0,350.0,350.0
2313136.0,6,3,1777,1,826,0.0,826.0,826.0,2,951,0.0,885.0,475.5
122001430.0,17,15,907,8,475,17428775.714285713,174.0,59.375,7,432,17001011.166666668,174.0,61.71428571428572
2310607.0,6,2,132,1,66,0.0,66.0,66.0,1,66,0.0,66.0,66.0
216584.0,6,3,426,2,280,0.0,214.0,140.0,1,146,0.0,146.0,146.0
113168390.0,6,46,3036,23,1518,5144005.909090909,66.0,66.0,23,1518,5144006.363636363,66.0,66.0
35548.0,6,14,4740,7,653,4704.5,249.0,93.28571428571428,7,4087,5605.666666666667,1514.0,583.8571428571429
1511340.0,6,7,499,3,198,716569.0,66.0,66.0,4,301,438332.3333333333,103.0,75.25
43097.0,17,2,180,1,90,0.0,90.0,90.0,1,90,0.0,90.0,90.0
206180.0,6,3,426,2,280,0.0,214.0,140.0,1,146,0.0,146.0,146.0
32697.0,6,13,1479,7,882,5449.5,291.0,126.0,6,597,4795.4,259.0,99.5
90779560.0,6,161,18252,81,12750,1134744.5,284.0,157.40740740740742,80,5502,1135994.7848101263,140.0,68.775
146162.0,6,3,337,2,214,0.0,160.0,107.0,1,123,0.0,123.0,123.0
1415849.0,17,16,1120,16,1120,94389.93333333332,70.0,70.0,0,0,0.0,0.0,0.0
108109278.0,17,5,1005,5,1005,27027319.5,201.0,201.0,0,0,0.0,0.0,0.0
120172818.0,6,216,24296,108,7424,1116487.7943925234,140.0,68.74074074074075,108,16872,1106842.0373831776,284.0,156.22222222222223
233117.0,6,3,337,2,214,0.0,160.0,107.0,1,123,0.0,123.0,123.0
72543.0,6,14,4740,7,653,11244.666666666666,249.0,93.28571428571428,7,4087,11729.5,1514.0,583.8571428571429
2322.0,17,4,344,2,150,0.0,75.0,75.0,2,194,0.0,103.0,97.0
103644.0,17,2,286,2,286,0.0,143.0,143.0,0,0,0.0,0.0,0.0
121570885.0,17,14,864,7,432,17000162.0,174.0,61.71428571428572,7,432,19947687.0,174.0,61.71428571428572
115058799.0,6,48,3168,24,1584,5002556.478260869,66.0,66.0,24,1584,4989289.347826087,66.0,66.0
2080.0,17,4,344,2,150,0.0,75.0,75.0,2,194,0.0,103.0,97.0
3118896.0,6,3,1604,1,753,0.0,753.0,753.0,2,851,0.0,785.0,425.5
228195.0,17,2,180,1,90,0.0,90.0,90.0,1,90,0.0,90.0,90.0
113171597.0,6,219,24744,110,7482,1038271.5321100918,140.0,68.01818181818182,109,17262,1038296.5185185184,284.0,158.36697247706422
2843565.0,6,5,336,3,202,1421782.5,70.0,67.33333333333333,2,134,0.0,68.0,67.0
118922531.0,6,35,2542,18,1348,6982701.235294118,139.0,74.88888888888889,17,1194,7419144.375,123.0,70.23529411764706
209463.0,17,2,180,1,90,0.0,90.0,90.0,1,90,0.0,90.0,90.0
34808.0,6,14,4740,7,653,5649.833333333333,249.0,93.28571428571428,7,4087,5344.0,1514.0,583.8571428571429
108107132.0,17,5,1005,5,1005,27026783.0,201.0,201.0,0,0,0.0,0.0,0.0
41339.0,6,14,4740,7,653,6717.166666666667,249.0,93.28571428571428,7,4087,5553.333333333333,1514.0,583.8571428571429
5005052.0,17,4,849,2,166,0.0,83.0,83.0,2,683,0.0,499.0,341.5
120653989.0,6,33,2296,17,1225,7540874.3125,139.0,72.05882352941177,16,1071,7364292.333333333,123.0,66.9375
103805175.0,6,32,2236,16,1165,6905954.8,139.0,72.8125,16,1071,6905953.8,123.0,66.9375
0.0,17,1,90,1,90,0.0,90.0,90.0,0,0,0.0,0.0,0.0
102355.0,17,2,762,2,762,0.0,381.0,381.0,0,0,0.0,0.0,0.0
31963.0,6,14,4740,7,653,4424.0,249.0,93.28571428571428,7,4087,5056.0,1514.0,583.8571428571429
147852.0,6,3,337,2,214,0.0,160.0,107.0,1,123,0.0,123.0,123.0
306913.0,6,6,412,4,272,102304.33333333331,74.0,68.0,2,140,0.0,74.0,70.0
10459390.0,6,7,478,4,272,3439634.0,74.0,68.0,3,206,5159358.5,74.0,68.66666666666667
303167.0,6,2,132,1,66,0.0,66.0,66.0,1,66,0.0,66.0,66.0
21720.0,17,2,582,1,83,0.0,83.0,83.0,1,499,0.0,499.0,499.0
24449.0,6,14,4740,7,653,3949.5,249.0,93.28571428571428,7,4087,3900.5,1514.0,583.8571428571429
93092948.0,17,12,778,6,389,18400812.6,174.0,64.83333333333333,6,389,18600169.4,174.0,64.83333333333333
389467.0,6,12,1373,7,714,64911.16666666666,298.0,102.0,5,659,92104.0,379.0,131.8
108680968.0,6,32,2220,16,1149,7245397.866666666,123.0,71.8125,16,1071,7230988.8,123.0,66.9375
120008.0,17,2,180,1,70,0.0,70.0,70.0,1,110,0.0,110.0,110.0
246269.0,6,3,337,2,214,0.0,160.0,107.0,1,123,0.0,123.0,123.0
513120.0,6,5,336,2,134,0.0,68.0,67.0,3,202,194349.5,70.0,67.33333333333333
54821.0,6,14,4740,7,653,8821.5,249.0,93.28571428571428,7,4087,8345.0,1514.0,583.8571428571429
108109166.0,17,5,955,5,955,27027291.5,191.0,191.0,0,0,0.0,0.0,0.0
4658.0,17,2,180,1,90,0.0,90.0,90.0,1,90,0.0,90.0,90.0
438594.0,6,11,1021,6,444,58910.4,162.0,74.0,5,577,73471.0,349.0,115.4
232683.0,6,3,337,2,214,0.0,160.0,107.0,1,123,0.0,123.0,123.0
38826099.0,6,5,336,2,134,0.0,68.0,67.0,3,202,19340972.0,70.0,67.33333333333333
90231492.0,6,19,1436,9,691,11247158.5,95.0,76.77777777777777,10,745,10001727.0,95.0,74.5
103581.0,17,2,286,2,286,0.0,143.0,143.0,0,0,0.0,0.0,0.0
209380.0,17,2,180,1,90,0.0,90.0,90.0,1,90,0.0,90.0,90.0
55261.0,6,14,4740,7,653,8992.333333333334,249.0,93.28571428571428,7,4087,8619.166666666666,1514.0,583.8571428571429
120330316.0,6,234,26438,117,8018,1030068.2672413794,140.0,68.52991452991454,117,18420,1030302.025862069,284.0,157.43589743589743
120147044.0,6,14,2240,6,1224,24029408.8,204.0,204.0,8,1016,17098185.42857143,188.0,127.0
1035587.0,6,11,1134,6,558,207117.4,220.0,93.0,5,576,256274.5,304.0,115.2
48945.0,6,14,4740,7,653,7400.0,249.0,93.28571428571428,7,4087,7840.666666666667,1514.0,583.8571428571429
2816019.0,6,2,132,1,66,0.0,66.0,66.0,1,66,0.0,66.0,66.0
96089445.0,6,58,12279,29,6486,3431765.8928571427,1514.0,223.6551724137931,29,5793,3422801.1428571427,1514.0,199.7586206896552
20749.0,6,11,2098,6,590,3915.6,252.0,98.33333333333331,5,1508,4908.75,1236.0,301.6
1173884.0,6,13,3020,8,2392,167697.7142857143,1514.0,299.0,5,628,224577.75,331.0,125.6
101073142.0,6,22,1639,12,894,9184735.181818182,95.0,74.5,10,745,11230014.111111112,95.0,74.5
120659945.0,6,34,2413,17,1125,7419208.125,123.0,66.17647058823529,17,1288,6917061.25,139.0,75.76470588235294
90526424.0,6,13,2036,8,1016,12932346.285714284,188.0,127.0,5,1020,22590466.5,204.0,204.0
55229.0,6,10,2032,5,524,7572.75,252.0,104.8,5,1508,12263.25,1236.0,301.6
109578588.0,17,14,864,7,432,18167475.0,174.0,61.71428571428572,7,432,18166830.33333333,174.0,61.71428571428572
39794.0,6,10,2032,5,524,9470.0,252.0,104.8,5,1508,9119.25,1236.0,301.6
31109.0,6,14,4740,7,653,5001.666666666667,249.0,93.28571428571428,7,4087,4832.666666666667,1514.0,583.8571428571429
0.0,17,1,80,1,80,0.0,80.0,80.0,0,0,0.0,0.0,0.0
115312475.0,6,48,3168,24,1584,5013585.869565218,66.0,66.0,24,1584,5000130.173913044,66.0,66.0
414.0,17,2,156,1,78,0.0,78.0,78.0,1,78,0.0,78.0,78.0
99584586.0,17,11,604,6,389,19916917.2,174.0,64.83333333333333,5,215,20001000.25,43.0,43.0
205919.0,17,2,180,1,90,0.0,90.0,90.0,1,90,0.0,90.0,90.0
143994.0,17,2,180,1,90,0.0,90.0,90.0,1,90,0.0,90.0,90.0
75069218.0,6,9,842,9,842,9383652.25,97.0,93.55555555555556,0,0,0.0,0.0,0.0
3807422.0,6,5,336,2,134,0.0,68.0,67.0,3,202,1542382.5,70.0,67.33333333333333
145931.0,17,4,704,2,148,0.0,74.0,74.0,2,556,0.0,280.0,278.0
70351.0,6,14,4740,7,653,7496.333333333333,249.0,93.28571428571428,7,4087,10525.333333333334,1514.0,583.8571428571429
186021.0,17,2,180,1,90,0.0,90.0,90.0,1,90,0.0,90.0,90.0
1690145.0,6,20,7599,11,1469,169014.5,583.0,133.54545454545453,9,6130,177412.375,1484.0,681.1111111111111
120212614.0,6,401,48582,201,13488,601063.07,140.0,67.1044776119403,200,35094,598912.472361809,426.0,175.47
120045789.0,17,28,13364,28,13364,4446140.333333333,501.0,477.2857142857143,0,0,0.0,0.0,0.0
60375.0,6,14,4740,7,653,9755.666666666666,249.0,93.28571428571428,7,4087,9912.333333333334,1514.0,583.8571428571429
39757.0,6,14,4740,7,653,6503.666666666667,249.0,93.28571428571428,7,4087,6445.666666666667,1514.0,583.8571428571429
114285052.0,6,34,2350,17,1225,7129332.6875,139.0,72.05882352941177,17,1125,7129332.625,123.0,66.17647058823529
302401.0,6,2,132,1,66,0.0,66.0,66.0,1,66,0.0,66.0,66.0
506590.0,6,5,336,2,134,0.0,68.0,67.0,3,202,195664.0,70.0,67.33333333333333
196862.0,17,2,180,1,90,0.0,90.0,90.0,1,90,0.0,90.0,90.0
186055.0,17,2,180,1,90,0.0,90.0,90.0,1,90,0.0,90.0,90.0
247084.0,17,2,180,1,90,0.0,90.0,90.0,1,90,0.0,90.0,90.0
217999.0,6,3,426,2,280,0.0,214.0,140.0,1,146,0.0,146.0,146.0
5825959.0,6,5,336,2,134,0.0,68.0,67.0,3,202,1526041.5,70.0,67.33333333333333
3385746.0,6,5,336,2,134,0.0,68.0,67.0,3,202,1527904.5,70.0,67.33333333333333
120118513.0,6,14,2224,9,1204,15014814.125,188.0,133.77777777777777,5,1020,22589160.75,204.0,204.0
135132613.0,17,6,1146,6,1146,27026522.6,191.0,191.0,0,0,0.0,0.0,0.0
283872.0,17,2,363,1,79,0.0,79.0,79.0,1,284,0.0,284.0,284.0
19912.0,6,14,4740,7,653,2916.1666666666665,249.0,93.28571428571428,7,4087,3186.333333333333,1514.0,583.8571428571429
363211.0,6,11,1021,6,444,48841.6,162.0,74.0,5,577,60878.5,349.0,115.4
160047.0,6,2,128,1,74,0.0,74.0,74.0,1,54,0.0,54.0,54.0
121343.0,6,3,337,2,214,0.0,160.0,107.0,1,123,0.0,123.0,123.0
2627340.0,6,25,7573,14,3735,202103.0769230769,1514.0,266.7857142857143,11,3838,235919.6,1514.0,348.90909090909093
90297953.0,6,16,1192,8,596,12892621.57142857,95.0,74.5,8,596,12898965.285714284,95.0,74.5
120276647.0,6,18,1382,9,691,14999990.625,95.0,76.77777777777777,9,691,15032919.375,95.0,76.77777777777777
5002967.0,17,2,162,2,162,0.0,81.0,81.0,0,0,0.0,0.0,0.0
107835934.0,6,28,1860,14,966,8278467.153846154,123.0,69.0,14,894,8278467.615384615,123.0,63.85714285714285
120180730.0,6,230,26010,115,7812,1046997.4649122808,140.0,67.9304347826087,115,18198,1037876.5175438595,284.0,158.24347826086955
4998173.0,17,4,534,2,166,0.0,83.0,83.0,2,368,0.0,184.0,184.0
90255556.0,6,14,2240,8,1016,12893650.857142856,188.0,127.0,6,1224,18018215.4,204.0,204.0
228310.0,17,2,180,1,90,0.0,90.0,90.0,1,90,0.0,90.0,90.0
108111593.0,17,5,1005,5,1005,27027898.25,201.0,201.0,0,0,0.0,0.0,0.0
121310.0,6,3,337,2,214,0.0,160.0,107.0,1,123,0.0,123.0,123.0
309539.0,17,4,704,2,148,0.0,74.0,74.0,2,556,0.0,280.0,278.0
46503.0,6,14,4740,7,653,7384.0,249.0,93.28571428571428,7,4087,6333.833333333333,1514.0,583.8571428571429
90540719.0,6,13,2036,8,1016,12934388.42857143,188.0,127.0,5,1020,22592696.25,204.0,204.0
120120071.0,6,19,2964,10,1392,13346674.555555556,188.0,139.2,9,1572,11261416.0,204.0,174.66666666666666
105916.0,17,4,1400,4,1400,35305.333333333336,350.0,350.0,0,0,0.0,0.0,0.0
428.0,17,2,267,1,83,0.0,83.0,83.0,1,184,0.0,184.0,184.0
507389.0,6,5,336,2,134,0.0,68.0,67.0,3,202,195883.5,70.0,67.33333333333333
123010107.0,17,15,907,8,475,17572872.42857143,174.0,59.375,7,432,17125274.333333332,174.0,61.71428571428572
27022.0,6,14,4740,7,653,3687.0,249.0,93.28571428571428,7,4087,4303.333333333333,1514.0,583.8571428571429
135129184.0,17,6,1206,6,1206,27025836.8,201.0,201.0,0,0,0.0,0.0,0.0
120124442.0,6,13,2020,9,1204,15015555.25,188.0,133.77777777777777,4,816,30033383.666666668,204.0,204.0
1183243.0,6,13,1386,7,789,197207.16666666663,253.0,112.71428571428572,6,597,234368.0,259.0,99.5
206160.0,6,3,426,2,280,0.0,214.0,140.0,1,146,0.0,146.0,146.0
311312.0,17,4,1400,4,1400,103770.66666666669,350.0,350.0,0,0,0.0,0.0,0.0
90032248.0,17,28,13364,28,13364,3334527.703703704,501.0,477.2857142857143,0,0,0.0,0.0,0.0
307471.0,6,6,412,4,272,102490.33333333331,74.0,68.0,2,140,0.0,74.0,70.0
120125964.0,6,15,2428,9,1204,15015745.5,188.0,133.77777777777777,6,1224,18074614.6,204.0,204.0
107023.0,17,2,286,2,286,0.0,143.0,143.0,0,0,0.0,0.0,0.0
20564.0,6,11,1133,6,602,3771.6,264.0,100.33333333333331,5,531,4525.75,259.0,106.2
167062.0,6,13,1394,7,797,27843.666666666668,253.0,113.85714285714286,6,597,31866.4,259.0,99.5
41059.0,6,14,4740,7,653,6672.5,249.0,93.28571428571428,7,4087,5546.333333333333,1514.0,583.8571428571429
108106485.0,17,5,1005,5,1005,27026621.25,201.0,201.0,0,0,0.0,0.0,0.0
119998066.0,6,18,1341,10,745,13333118.444444444,95.0,74.5,8,596,17107094.85714286,95.0,74.5
120134368.0,6,217,24580,109,17156,1112355.259259259,284.0,157.39449541284404,108,7424,1116274.6355140186,140.0,68.74074074074075
35721.0,6,14,4740,7,653,5834.833333333333,249.0,93.28571428571428,7,4087,4325.0,1514.0,583.8571428571429
115718329.0,6,47,3102,24,1584,5031220.521739131,66.0,66.0,23,1518,5143903.363636363,66.0,66.0
16058549.0,17,6,2052,6,2052,3211709.8,342.0,342.0,0,0,0.0,0.0,0.0
145405.0,6,3,337,2,214,0.0,160.0,107.0,1,123,0.0,123.0,123.0
205757.0,17,2,180,1,90,0.0,90.0,90.0,1,90,0.0,90.0,90.0
2052051.0,6,25,7610,13,2516,171004.25,1034.0,193.53846153846155,12,5094,159225.0909090909,1510.0,424.5
127812.0,6,3,337,2,214,0.0,160.0,107.0,1,123,0.0,123.0,123.0
162278.0,17,2,180,1,90,0.0,90.0,90.0,1,90,0.0,90.0,90.0
207221.0,6,3,426,2,280,0.0,214.0,140.0,1,146,0.0,146.0,146.0
1170392.0,6,13,3014,8,2386,167198.85714285713,1514.0,298.25,5,628,224454.75,331.0,125.6
1208136.0,17,7,490,7,490,201356.0,70.0,70.0,0,0,0.0,0.0,0.0
178406.0,17,2,180,1,90,0.0,90.0,90.0,1,90,0.0,90.0,90.0
49906.0,6,14,4740,7,653,7897.5,249.0,93.28571428571428,7,4087,7745.333333333333,1514.0,583.8571428571429
116639046.0,6,48,3168,24,1584,5071262.869565218,66.0,66.0,24,1584,5057677.217391305,66.0,66.0
0.0,6,1,70,0,0,0.0,0.0,0.0,1,70,0.0,70.0,70.0
379.0,17,2,267,1,83,0.0,83.0,83.0,1,184,0.0,184.0,184.0
103750.0,17,2,286,2,286,0.0,143.0,143.0,0,0,0.0,0.0,0.0
104086.0,17,2,286,2,286,0.0,143.0,143.0,0,0,0.0,0.0,0.0
148031.0,17,2,180,1,90,0.0,90.0,90.0,1,90,0.0,90.0,90.0
108175323.0,6,43,2838,22,1452,5151193.571428572,66.0,66.0,21,1386,5159993.35,66.0,66.0
2798740.0,6,2,132,1,66,0.0,66.0,66.0,1,66,0.0,66.0,66.0
1306796.0,6,4,264,2,132,0.0,66.0,66.0,2,132,0.0,66.0,66.0
41526.0,6,14,4740,7,653,6579.0,249.0,93.28571428571428,7,4087,6790.0,1514.0,583.8571428571429
135132601.0,17,6,1146,6,1146,27026520.2,191.0,191.0,0,0,0.0,0.0,0.0
283915.0,17,4,1400,4,1400,94638.33333333331,350.0,350.0,0,0,0.0,0.0,0.0
27434844.0,17,5,1710,5,1710,6858711.0,342.0,342.0,0,0,0.0,0.0,0.0
198565.0,17,2,180,1,90,0.0,90.0,90.0,1,90,0.0,90.0,90.0
333.0,17,2,166,1,75,0.0,75.0,75.0,1,91,0.0,91.0,91.0
306154.0,6,5,337,2,163,0.0,97.0,81.5,3,174,153077.0,66.0,58.0
4581.0,17,2,602,1,72,0.0,72.0,72.0,1,530,0.0,530.0,530.0
1791239.0,6,22,6443,12,1529,162839.9090909091,357.0,127.41666666666669,10,4914,164089.44444444444,1510.0,491.4
1153.0,17,5,550,5,550,288.25,110.0,110.0,0,0,0.0,0.0,0.0
412.0,17,2,410,1,78,0.0,78.0,78.0,1,332,0.0,332.0,332.0
27527.0,6,11,2098,6,590,4755.6,252.0,98.33333333333331,5,1508,5828.75,1236.0,301.6
115437696.0,6,48,3168,24,1584,5019030.260869565,66.0,66.0,24,1584,5005573.0869565215,66.0,66.0
350.0,17,2,267,1,83,0.0,83.0,83.0,1,184,0.0,184.0,184.0
135131024.0,17,6,1206,6,1206,27026204.8,201.0,201.0,0,0,0.0,0.0,0.0
103213.0,17,2,286,2,286,0.0,143.0,143.0,0,0,0.0,0.0,0.0
53619.0,6,11,2098,6,590,10579.2,252.0,98.33333333333331,5,1508,13131.0,1236.0,301.6
90010970.0,17,27,12943,27,12943,3461960.3846153845,501.0,479.3703703703704,0,0,0.0,0.0,0.0
90254750.0,6,14,2240,8,1016,12893535.714285716,188.0,127.0,6,1224,18018275.2,204.0,204.0
120067282.0,6,228,25772,114,7820,1055349.1415929203,140.0,68.59649122807018,114,17952,1055376.9557522123,284.0,157.47368421052633
2303.0,17,4,344,2,150,0.0,75.0,75.0,2,194,0.0,103.0,97.0
272025.0,6,3,337,2,214,0.0,160.0,107.0,1,123,0.0,123.0,123.0
3174373.0,6,18,1495,9,921,358371.125,315.0,102.33333333333331,9,574,358343.875,78.0,63.77777777777778
14172145.0,17,6,2052,6,2052,2834429.0,342.0,342.0,0,0,0.0,0.0,0.0
118874444.0,6,34,2350,17,1225,7416174.25,139.0,72.05882352941177,17,1125,7416170.0,123.0,66.17647058823529
5022.0,17,2,180,1,90,0.0,90.0,90.0,1,90,0.0,90.0,90.0
16687549.0,6,20,1650,9,960,2047409.5,315.0,106.66666666666669,11,690,1637902.7,78.0,62.72727272727273
209663.0,17,2,180,1,90,0.0,90.0,90.0,1,90,0.0,90.0,90.0
76994.0,6,10,2032,5,524,17956.5,252.0,104.8,5,1508,18569.5,1236.0,301.6
1302482.0,6,4,264,2,132,0.0,66.0,66.0,2,132,0.0,66.0,66.0
82459.0,6,12,1328,7,797,13743.166666666666,253.0,113.85714285714286,5,531,14696.5,259.0,106.2
135130935.0,17,6,1146,6,1146,27026187.0,191.0,191.0,0,0,0.0,0.0,0.0
499.0,17,2,508,2,508,0.0,257.0,254.0,0,0,0.0,0.0,0.0
108089214.0,17,5,955,5,955,27022303.5,191.0,191.0,0,0,0.0,0.0,0.0
41830.0,6,10,2032,5,524,9003.0,252.0,104.8,5,1508,10039.75,1236.0,301.6
104354.0,17,2,286,2,286,0.0,143.0,143.0,0,0,0.0,0.0,0.0
307211.0,6,6,412,4,272,102403.66666666669,74.0,68.0,2,140,0.0,74.0,70.0
208863.0,6,12,1373,7,714,34810.5,298.0,102.0,5,659,51433.0,379.0,131.8
306777.0,6,6,412,4,272,102259.0,74.0,68.0,2,140,0.0,74.0,70.0
1242991.0,6,7,499,4,301,399881.6666666667,103.0,75.25,3,198,614981.5,66.0,66.0
146076.0,6,3,337,2,214,0.0,160.0,107.0,1,123,0.0,123.0,123.0
2082.0,17,4,344,2,150,0.0,75.0,75.0,2,194,0.0,103.0,97.0
33016.0,6,10,2032,5,524,7429.25,252.0,104.8,5,1508,7665.75,1236.0,301.6
298918.0,6,6,412,4,272,99639.33333333331,74.0,68.0,2,140,0.0,74.0,70.0
135134414.0,17,6,1146,6,1146,27026882.8,191.0,191.0,0,0,0.0,0.0,0.0
48135.0,6,14,4740,7,653,7762.333333333333,249.0,93.28571428571428,7,4087,6837.666666666667,1514.0,583.8571428571429
1031037.0,6,11,1134,6,558,206207.4,220.0,93.0,5,576,255490.5,304.0,115.2
111844376.0,6,30,1974,15,1026,7973477.571428572,123.0,68.4,15,948,7973477.428571428,123.0,63.2
4282.0,17,2,582,1,83,0.0,83.0,83.0,1,499,0.0,499.0,499.0
18609.0,6,11,1131,6,600,3493.8,262.0,100.0,5,531,3325.0,259.0,106.2
90203394.0,6,16,1192,8,596,12851722.0,95.0,74.5,8,596,12856962.0,95.0,74.5
119006007.0,17,13,821,7,432,19834334.5,174.0,61.71428571428572,6,389,19800163.8,174.0,64.83333333333333
53727.0,6,10,2032,5,524,12997.75,252.0,104.8,5,1508,12983.25,1236.0,301.6
538479.0,17,6,2100,6,2100,107695.8,350.0,350.0,0,0,0.0,0.0,0.0
5629505.0,6,5,336,2,134,0.0,68.0,67.0,3,202,1424192.0,70.0,67.33333333333333
1027234.0,6,11,1134,6,558,205446.8,220.0,93.0,5,576,255796.5,304.0,115.2
1315951.0,17,7,490,7,490,219325.16666666663,70.0,70.0,0,0,0.0,0.0,0.0
135142811.0,17,6,1206,6,1206,27028562.2,201.0,201.0,0,0,0.0,0.0,0.0
393381.0,6,12,1373,7,714,65563.5,298.0,102.0,5,659,93205.25,379.0,131.8
303613.0,6,2,132,1,66,0.0,66.0,66.0,1,66,0.0,66.0,66.0
92592213.0,6,38,2508,19,1254,5143997.444444444,66.0,66.0,19,1254,5143997.5,66.0,66.0
507212.0,6,5,336,2,134,0.0,68.0,67.0,3,202,195687.0,70.0,67.33333333333333
135134823.0,17,6,1206,6,1206,27026964.6,201.0,201.0,0,0,0.0,0.0,0.0
141751.0,6,11,1132,6,556,27816.2,218.0,92.66666666666669,5,576,35009.75,304.0,115.2
91019027.0,6,168,18984,84,13218,1094021.7951807228,284.0,157.35714285714286,84,5766,1094022.4337349397,140.0,68.64285714285714
5621484.0,6,5,336,2,134,0.0,68.0,67.0,3,202,1426224.0,70.0,67.33333333333333
113628954.0,6,46,3036,23,1518,5150894.181818182,66.0,66.0,23,1518,5150887.954545454,66.0,66.0
823.0,17,5,550,5,550,205.75,110.0,110.0,0,0,0.0,0.0,0.0
307862.0,6,6,412,4,272,102620.66666666669,74.0,68.0,2,140,0.0,74.0,70.0
120000016.0,6,23,1775,13,989,10000001.333333334,95.0,76.07692307692308,10,786,10086701.333333334,95.0,78.6
1778188.0,6,2,132,1,66,0.0,66.0,66.0,1,66,0.0,66.0,66.0
37943.0,6,14,4740,7,653,5418.333333333333,249.0,93.28571428571428,7,4087,5556.166666666667,1514.0,583.8571428571429
146821.0,6,3,337,2,214,0.0,160.0,107.0,1,123,0.0,123.0,123.0
25827.0,6,14,4740,7,653,4184.0,249.0,93.28571428571428,7,4087,4165.166666666667,1514.0,583.8571428571429
104124.0,6,14,4740,7,653,17155.833333333332,249.0,93.28571428571428,7,4087,16580.166666666668,1514.0,583.8571428571429
388.0,17,2,174,1,79,0.0,79.0,79.0,1,95,0.0,95.0,95.0
303913.0,6,6,412,4,272,101304.33333333331,74.0,68.0,2,140,0.0,74.0,70.0
207281.0,17,2,762,2,762,0.0,381.0,381.0,0,0,0.0,0.0,0.0
120277297.0,6,224,25324,112,7700,1076149.81981982,140.0,68.75,112,17624,1076087.936936937,284.0,157.35714285714286
778.0,17,4,438,2,148,0.0,74.0,74.0,2,290,0.0,147.0,145.0
90015574.0,17,27,12943,27,12943,3462137.461538461,501.0,479.3703703703704,0,0,0.0,0.0,0.0
199639.0,17,2,180,1,90,0.0,90.0,90.0,1,90,0.0,90.0,90.0
16110591.0,17,6,2052,6,2052,3222118.2,342.0,342.0,0,0,0.0,0.0,0.0
3013220.0,6,12,2172,7,664,501914.0,252.0,94.85714285714286,5,1508,2837.75,1236.0,301.6
284192.0,17,2,363,1,79,0.0,79.0,79.0,1,284,0.0,284.0,284.0
3021479.0,6,11,1979,6,527,604091.6,233.0,87.83333333333333,5,1452,3946.25,1224.0,290.4
210450.0,6,3,426,2,280,0.0,214.0,140.0,1,146,0.0,146.0,146.0
108102355.0,17,5,1005,5,1005,27025588.75,201.0,201.0,0,0,0.0,0.0,0.0
43083.0,6,14,4740,7,653,6597.166666666667,249.0,93.28571428571428,7,4087,6841.833333333333,1514.0,583.8571428571429
235479.0,6,3,337,2,214,0.0,160.0,107.0,1,123,0.0,123.0,123.0
120410337.0,6,271,31850,136,22644,891928.4222222222,464.0,166.5,135,9206,890924.9402985075,140.0,68.19259259259259
38580.0,6,14,4740,7,653,6272.166666666667,249.0,93.28571428571428,7,4087,6222.666666666667,1514.0,583.8571428571429
108102508.0,17,5,955,5,955,27025627.0,191.0,191.0,0,0,0.0,0.0,0.0
107180.0,17,2,286,2,286,0.0,143.0,143.0,0,0,0.0,0.0,0.0
122005624.0,17,15,907,8,475,17429374.85714286,174.0,59.375,7,432,17000163.333333332,174.0,61.71428571428572
91811253.0,17,12,778,6,389,18200867.0,174.0,64.83333333333333,6,389,18200155.4,174.0,64.83333333333333
53071.0,6,14,4740,7,653,8632.833333333334,249.0,93.28571428571428,7,4087,8468.0,1514.0,583.8571428571429
108105100.0,17,5,955,5,955,27026275.0,191.0,191.0,0,0,0.0,0.0,0.0
108112197.0,17,5,955,5,955,27028049.25,191.0,191.0,0,0,0.0,0.0,0.0
1929904.0,17,2,876,2,876,0.0,438.0,438.0,0,0,0.0,0.0,0.0
13275.0,6,10,2032,5,524,2760.0,252.0,104.8,5,1508,2754.0,1236.0,301.6
108108450.0,17,5,1005,5,1005,27027112.5,201.0,201.0,0,0,0.0,0.0,0.0
107141.0,17,2,286,2,286,0.0,143.0,143.0,0,0,0.0,0.0,0.0
108107332.0,17,5,955,5,955,27026833.0,191.0,191.0,0,0,0.0,0.0,0.0
109451465.0,6,206,23420,103,16326,1070922.8725490195,374.0,158.50485436893203,103,7094,1070944.0294117648,140.0,68.87378640776699
283530.0,6,10,1221,6,636,56706.0,298.0,106.0,4,585,89082.66666666667,379.0,146.25
251270.0,6,3,337,2,214,0.0,160.0,107.0,1,123,0.0,123.0,123.0
5009091.0,17,4,849,2,166,0.0,83.0,83.0,2,683,0.0,499.0,341.5
196830.0,17,2,180,1,90,0.0,90.0,90.0,1,90,0.0,90.0,90.0
23767.0,6,10,2032,5,524,5714.25,252.0,104.8,5,1508,5115.25,1236.0,301.6
33421.0,6,14,4740,7,653,5274.333333333333,249.0,93.28571428571428,7,4087,5219.333333333333,1514.0,583.8571428571429
196729.0,17,2,180,1,90,0.0,90.0,90.0,1,90,0.0,90.0,90.0
90069545.0,17,28,13364,28,13364,3335909.074074074,501.0,477.2857142857143,0,0,0.0,0.0,0.0
115789.0,17,4,820,2,156,0.0,78.0,78.0,2,664,0.0,332.0,332.0
106067.0,17,2,762,2,762,0.0,381.0,381.0,0,0,0.0,0.0,0.0
113413014.0,6,30,1974,15,1026,8085523.785714285,123.0,68.4,15,948,8085511.642857143,123.0,63.2
302376.0,6,2,132,1,66,0.0,66.0,66.0,1,66,0.0,66.0,66.0
135126494.0,17,6,1146,6,1146,27025298.8,191.0,191.0,0,0,0.0,0.0,0.0
16267.0,6,11,1133,6,602,3100.2,264.0,100.33333333333331,5,531,3705.0,259.0,106.2
51664.0,6,2,132,1,66,0.0,66.0,66.0,1,66,0.0,66.0,66.0
100651612.0,17,12,516,6,258,20000164.4,43.0,43.0,6,258,19997929.2,43.0,43.0
213243.0,6,10,1221,6,636,42648.6,298.0,106.0,4,585,69713.0,379.0,146.25
29039.0,6,10,2032,5,524,7038.0,252.0,104.8,5,1508,5892.75,1236.0,301.6
21478.0,17,2,582,1,83,0.0,83.0,83.0,1,499,0.0,499.0,499.0
32722.0,6,14,4740,7,653,4744.5,249.0,93.28571428571428,7,4087,5313.166666666667,1514.0,583.8571428571429
2380.0,17,4,344,2,150,0.0,75.0,75.0,2,194,0.0,103.0,97.0
329.0,17,2,166,1,75,0.0,75.0,75.0,1,91,0.0,91.0,91.0
29345.0,6,14,4740,7,653,4713.166666666667,249.0,93.28571428571428,7,4087,4335.0,1514.0,583.8571428571429
299566.0,6,7,478,4,272,99855.33333333331,74.0,68.0,3,206,73337.0,74.0,68.66666666666667
153431.0,17,2,180,1,90,0.0,90.0,90.0,1,90,0.0,90.0,90.0
167260.0,17,2,180,1,90,0.0,90.0,90.0,1,90,0.0,90.0,90.0
4510.0,17,2,614,1,72,0.0,72.0,72.0,1,542,0.0,542.0,542.0
51816.0,6,14,4740,7,653,8211.833333333334,249.0,93.28571428571428,7,4087,7538.333333333333,1514.0,583.8571428571429
56444678.0,6,8,1307,8,1307,8063525.428571428,172.0,163.375,0,0,0.0,0.0,0.0
123610551.0,6,49,3234,25,1650,5150439.625,66.0,66.0,24,1584,5121396.130434782,66.0,66.0
90092927.0,6,14,1976,8,1016,12870418.142857144,188.0,127.0,6,960,12011952.2,204.0,160.0
48679.0,6,10,2032,5,524,11597.0,252.0,104.8,5,1508,10539.25,1236.0,301.6
20028.0,17,2,582,1,83,0.0,83.0,83.0,1,499,0.0,499.0,499.0
153368.0,17,2,180,1,90,0.0,90.0,90.0,1,90,0.0,90.0,90.0
1608599.0,6,4,492,2,280,0.0,214.0,140.0,2,212,0.0,146.0,106.0
55167.0,6,10,1065,5,534,11364.5,262.0,106.8,5,531,9647.0,259.0,106.2
247185.0,6,3,373,2,238,0.0,172.0,119.0,1,135,0.0,135.0,135.0
36457963.0,6,26,7643,14,3751,188647.2307692308,1514.0,267.92857142857144,12,3892,3295673.5454545454,1514.0,324.3333333333333
32978.0,6,11,2098,6,590,6199.0,252.0,98.33333333333331,5,1508,7896.25,1236.0,301.6
91000777.0,17,13,1083,7,563,15166796.166666666,174.0,80.42857142857143,6,520,14200771.8,174.0,86.66666666666667
205752.0,17,2,180,1,90,0.0,90.0,90.0,1,90,0.0,90.0,90.0
107498.0,17,2,286,2,286,0.0,143.0,143.0,0,0,0.0,0.0,0.0
172227.0,17,4,1524,4,1524,57409.0,381.0,381.0,0,0,0.0,0.0,0.0
21628.0,17,2,582,1,83,0.0,83.0,83.0,1,499,0.0,499.0,499.0
153388.0,17,2,180,1,90,0.0,90.0,90.0,1,90,0.0,90.0,90.0
57472.0,6,10,2032,5,524,14147.5,252.0,104.8,5,1508,14091.5,1236.0,301.6
92125225.0,17,16,5472,16,5472,6141681.666666667,342.0,342.0,0,0,0.0,0.0,0.0
50064.0,6,14,4740,7,653,7719.833333333333,249.0,93.28571428571428,7,4087,6944.0,1514.0,583.8571428571429
108102412.0,17,5,955,5,955,27025603.0,191.0,191.0,0,0,0.0,0.0,0.0
146154.0,6,3,337,1,123,0.0,123.0,123.0,2,214,0.0,160.0,107.0
1775445.0,6,2,132,1,66,0.0,66.0,66.0,1,66,0.0,66.0,66.0
507346.0,6,5,336,2,134,0.0,68.0,67.0,3,202,191511.5,70.0,67.33333333333333
886183.0,6,9,1268,6,797,177236.6,459.0,132.83333333333334,3,471,305285.5,331.0,157.0
125247470.0,6,34,2350,17,1125,7203945.5,123.0,66.17647058823529,17,1225,7203935.375,139.0,72.05882352941177
120056999.0,17,28,13364,28,13364,4446555.518518519,501.0,477.2857142857143,0,0,0.0,0.0,0.0
57280.0,6,13,1479,7,882,9546.666666666666,291.0,126.0,6,597,9564.6,259.0,99.5
120046261.0,17,29,13785,29,13785,4287366.464285715,501.0,475.3448275862069,0,0,0.0,0.0,0.0
27160277.0,17,5,1710,5,1710,6790069.25,342.0,342.0,0,0,0.0,0.0,0.0
2038.0,17,4,344,2,150,0.0,75.0,75.0,2,194,0.0,103.0,97.0
264834.0,6,10,1221,6,636,52966.8,298.0,106.0,4,585,80507.0,379.0,146.25
122530427.0,6,49,3234,25,1650,5105434.458333333,66.0,66.0,24,1584,4955773.391304348,66.0,66.0
233934.0,6,3,337,2,214,0.0,160.0,107.0,1,123,0.0,123.0,123.0
228328.0,17,2,180,1,90,0.0,90.0,90.0,1,90,0.0,90.0,90.0
335.0,17,2,166,1,75,0.0,75.0,75.0,1,91,0.0,91.0,91.0
2314.0,17,4,344,2,150,0.0,75.0,75.0,2,194,0.0,103.0,97.0
17394.0,6,10,2032,5,524,4110.25,252.0,104.8,5,1508,3480.75,1236.0,301.6
25445.0,6,10,2032,5,524,5567.5,252.0,104.8,5,1508,5345.75,1236.0,301.6
90259308.0,6,13,2036,8,1016,12894186.857142856,188.0,127.0,5,1020,22523740.75,204.0,204.0
256663.0,17,2,180,1,90,0.0,90.0,90.0,1,90,0.0,90.0,90.0
56924714.0,17,9,3086,8,2736,5110909.857142857,342.0,342.0,1,350,0.0,350.0,350.0
29126.0,6,11,2098,6,590,5189.8,252.0,98.33333333333331,5,1508,6756.75,1236.0,301.6
20601.0,17,2,539,1,86,0.0,86.0,86.0,1,453,0.0,453.0,453.0
120458993.0,6,19,1436,11,840,12045899.3,95.0,76.36363636363636,8,596,17104220.57142857,95.0,74.5
312712.0,17,4,1400,4,1400,104237.33333333331,350.0,350.0,0,0,0.0,0.0,0.0
153436.0,17,2,180,1,90,0.0,90.0,90.0,1,90,0.0,90.0,90.0
209598.0,17,2,180,1,90,0.0,90.0,90.0,1,90,0.0,90.0,90.0
19908.0,17,2,582,1,83,0.0,83.0,83.0,1,499,0.0,499.0,499.0
354.0,17,2,267,1,83,0.0,83.0,83.0,1,184,0.0,184.0,184.0
136086.0,6,2,132,1,66,0.0,66.0,66.0,1,66,0.0,66.0,66.0
90212149.0,6,16,1192,8,596,12852918.57142857,95.0,74.5,8,596,12858219.714285716,95.0,74.5
50941.0,6,12,1413,6,816,10019.2,291.0,136.0,6,597,8926.4,259.0,99.5
41150.0,6,14,4740,7,653,6750.333333333333,249.0,93.28571428571428,7,4087,5803.833333333333,1514.0,583.8571428571429
125878977.0,17,14,864,7,432,17667939.666666668,174.0,61.71428571428572,7,432,17666851.666666668,174.0,61.71428571428572
320.0,17,2,174,1,79,0.0,79.0,79.0,1,95,0.0,95.0,95.0
316.0,17,2,156,1,78,0.0,78.0,78.0,1,78,0.0,78.0,78.0
90526361.0,6,14,2240,8,1016,12932337.285714284,188.0,127.0,6,1224,18072651.8,204.0,204.0
2602398.0,6,2,132,1,66,0.0,66.0,66.0,1,66,0.0,66.0,66.0
5520458.0,6,5,336,2,134,0.0,68.0,67.0,3,202,1525779.5,70.0,67.33333333333333
135123600.0,17,6,1146,6,1146,27024720.0,191.0,191.0,0,0,0.0,0.0,0.0
93622990.0,6,18,1503,9,853,11696812.375,257.0,94.77777777777776,9,650,11702309.125,95.0,72.22222222222223
2326.0,17,4,344,2,150,0.0,75.0,75.0,2,194,0.0,103.0,97.0
9207936.0,17,3,1034,2,684,0.0,342.0,342.0,1,350,0.0,350.0,350.0
211532.0,17,2,414,1,88,0.0,88.0,88.0,1,326,0.0,326.0,326.0
240887.0,6,3,373,2,238,0.0,172.0,119.0,1,135,0.0,135.0,135.0
90014512.0,17,28,13364,28,13364,3333870.814814815,501.0,477.2857142857143,0,0,0.0,0.0,0.0
0.0,6,1,66,1,66,0.0,66.0,66.0,0,0,0.0,0.0,0.0
134711.0,6,3,337,2,214,0.0,160.0,107.0,1,123,0.0,123.0,123.0
121659759.0,6,34,2419,18,1348,7156456.411764706,139.0,74.88888888888889,16,1071,7962591.8,123.0,66.9375
241861.0,6,3,337,2,214,0.0,160.0,107.0,1,123,0.0,123.0,123.0
4332450.0,6,127,90734,61,4222,72207.5,222.0,69.21311475409836,66,86512,65443.61538461538,1514.0,1310.7878787878788
38740.0,6,11,1132,6,556,7748.0,218.0,92.66666666666669,5,576,7189.0,304.0,115.2
50881.0,17,2,180,1,90,0.0,90.0,90.0,1,90,0.0,90.0,90.0
110720229.0,6,295,34656,148,24732,753198.8367346938,374.0,167.1081081081081,147,9924,756770.8835616439,140.0,67.51020408163265
135132687.0,17,6,1206,6,1206,27026537.4,201.0,201.0,0,0,0.0,0.0,0.0
754.0,17,4,438,2,148,0.0,74.0,74.0,2,290,0.0,147.0,145.0
0.0,17,1,381,1,381,0.0,381.0,381.0,0,0,0.0,0.0,0.0
1179028.0,6,13,3010,8,2382,168432.57142857142,1514.0,297.75,5,628,226608.75,331.0,125.6
190853.0,17,2,180,1,90,0.0,90.0,90.0,1,90,0.0,90.0,90.0
120036207.0,6,326,37946,163,26892,739692.3024691358,284.0,164.98159509202455,163,11054,739697.0,140.0,67.8159509202454
47789.0,6,10,2032,5,524,11030.75,252.0,104.8,5,1508,11178.5,1236.0,301.6
121562.0,6,3,337,2,214,0.0,160.0,107.0,1,123,0.0,123.0,123.0
321874.0,17,4,1400,4,1400,107291.33333333331,350.0,350.0,0,0,0.0,0.0,0.0
34199.0,6,14,4740,7,653,5535.666666666667,249.0,93.28571428571428,7,4087,5561.0,1514.0,583.8571428571429
284.0,17,2,174,1,79,0.0,79.0,79.0,1,95,0.0,95.0,95.0
2687331.0,6,25,7573,14,3735,206717.7692307692,1514.0,266.7857142857143,11,3838,242403.6,1514.0,348.90909090909093
164084.0,17,4,1400,4,1400,54694.66666666666,350.0,350.0,0,0,0.0,0.0,0.0
108098998.0,17,5,955,5,955,27024749.5,191.0,191.0,0,0,0.0,0.0,0.0
196995.0,17,2,180,1,90,0.0,90.0,90.0,1,90,0.0,90.0,90.0
5627574.0,6,5,336,2,134,0.0,68.0,67.0,3,202,1526138.5,70.0,67.33333333333333
27389908.0,17,5,1710,5,1710,6847477.0,342.0,342.0,0,0,0.0,0.0,0.0
22676.0,6,14,4740,7,653,3669.0,249.0,93.28571428571428,7,4087,3448.5,1514.0,583.8571428571429
90255470.0,6,14,2240,8,1016,12893638.57142857,188.0,127.0,6,1224,18018648.2,204.0,204.0
146319.0,6,3,337,2,214,0.0,160.0,107.0,1,123,0.0,123.0,123.0
3565114.0,6,5,336,2,134,0.0,68.0,67.0,3,202,1423790.5,70.0,67.33333333333333
1483732.0,17,16,1120,16,1120,98915.46666666666,70.0,70.0,0,0,0.0,0.0,0.0
430569.0,6,4,508,2,238,0.0,172.0,119.0,2,270,0.0,135.0,135.0
155113.0,17,2,432,1,86,0.0,86.0,86.0,1,346,0.0,346.0,346.0
119802169.0,17,34,16284,34,16284,3630368.757575758,501.0,478.9411764705882,0,0,0.0,0.0,0.0
235127.0,6,3,373,2,238,0.0,172.0,119.0,1,135,0.0,135.0,135.0
115003798.0,6,218,24752,109,7490,1057179.4814814816,140.0,68.71559633027523,109,17262,1058133.5833333333,374.0,158.36697247706422
107813.0,17,2,286,2,286,0.0,143.0,143.0,0,0,0.0,0.0,0.0
16576.0,6,14,4740,7,653,2486.6666666666665,249.0,93.28571428571428,7,4087,2617.0,1514.0,583.8571428571429
103338.0,17,2,286,2,286,0.0,143.0,143.0,0,0,0.0,0.0,0.0
48647.0,6,10,2032,5,524,11882.5,252.0,104.8,5,1508,10485.75,1236.0,301.6
9858.0,17,2,582,1,83,0.0,83.0,83.0,1,499,0.0,499.0,499.0
362.0,17,2,267,1,83,0.0,83.0,83.0,1,184,0.0,184.0,184.0
103801.0,17,2,286,2,286,0.0,143.0,143.0,0,0,0.0,0.0,0.0
114763700.0,6,48,3168,24,1584,4989726.0869565215,66.0,66.0,24,1584,4976636.0869565215,66.0,66.0
9667.0,17,2,582,1,83,0.0,83.0,83.0,1,499,0.0,499.0,499.0
135128731.0,17,6,1206,6,1206,27025746.2,201.0,201.0,0,0,0.0,0.0,0.0
207278.0,6,10,1221,6,636,41455.6,298.0,106.0,4,585,68209.0,379.0,146.25
90052383.0,17,28,13364,28,13364,3335273.4444444445,501.0,477.2857142857143,0,0,0.0,0.0,0.0
21967273.0,17,3,1034,2,684,0.0,342.0,342.0,1,350,0.0,350.0,350.0
122254502.0,6,31,2034,16,1086,8150300.133333334,123.0,67.875,15,948,8003882.642857143,123.0,63.2
228342.0,17,2,180,1,90,0.0,90.0,90.0,1,90,0.0,90.0,90.0
146169.0,6,3,337,2,214,0.0,160.0,107.0,1,123,0.0,123.0,123.0
867.0,17,4,438,2,148,0.0,74.0,74.0,2,290,0.0,147.0,145.0
320285.0,17,4,1400,4,1400,106761.66666666669,350.0,350.0,0,0,0.0,0.0,0.0
135117213.0,17,6,1206,6,1206,27023442.6,201.0,201.0,0,0,0.0,0.0,0.0
108106394.0,17,5,955,5,955,27026598.5,191.0,191.0,0,0,0.0,0.0,0.0
1171840.0,6,13,3010,8,2382,167405.7142857143,1514.0,297.75,5,628,224050.75,331.0,125.6
246835.0,17,2,180,1,90,0.0,90.0,90.0,1,90,0.0,90.0,90.0
121227296.0,6,30,1974,15,948,7945888.714285715,123.0,63.2,15,1026,7945867.642857143,123.0,68.4
1132634.0,6,11,1134,6,558,226526.8,220.0,93.0,5,576,281264.0,304.0,115.2
20987.0,6,14,4740,7,653,3248.6666666666665,249.0,93.28571428571428,7,4087,3316.833333333333,1514.0,583.8571428571429
246241.0,6,3,337,2,214,0.0,160.0,107.0,1,123,0.0,123.0,123.0
2313.0,17,4,344,2,150,0.0,75.0,75.0,2,194,0.0,103.0,97.0
2238.0,17,4,344,2,150,0.0,75.0,75.0,2,194,0.0,103.0,97.0
23163409.0,17,3,1034,2,684,0.0,342.0,342.0,1,350,0.0,350.0,350.0
6821.0,17,2,582,1,83,0.0,83.0,83.0,1,499,0.0,499.0,499.0
90037413.0,17,28,13364,28,13364,3334719.0,501.0,477.2857142857143,0,0,0.0,0.0,0.0
201628.0,17,2,180,1,90,0.0,90.0,90.0,1,90,0.0,90.0,90.0
120121569.0,6,14,2224,9,1204,15015196.125,188.0,133.77777777777777,5,1020,22590616.25,204.0,204.0
16351.999999999998,6,14,4740,7,653,2434.833333333333,249.0,93.28571428571428,7,4087,2587.6666666666665,1514.0,583.8571428571429
93181592.0,17,12,778,6,389,18601099.0,174.0,64.83333333333333,6,389,18400216.6,174.0,64.83333333333333
100869.0,17,2,762,2,762,0.0,381.0,381.0,0,0,0.0,0.0,0.0
102009759.0,17,13,821,7,432,17001626.5,174.0,61.71428571428572,6,389,16400154.0,174.0,64.83333333333333
13394.0,6,13,1459,7,862,2111.1666666666665,271.0,123.14285714285714,6,597,2478.4,259.0,99.5
10467194.0,6,7,478,4,272,3441736.0,74.0,68.0,3,206,5162483.0,74.0,68.66666666666667
153568.0,17,2,180,1,90,0.0,90.0,90.0,1,90,0.0,90.0,90.0
147972.0,17,2,180,1,90,0.0,90.0,90.0,1,90,0.0,90.0,90.0
222073.0,6,3,426,2,280,0.0,214.0,140.0,1,146,0.0,146.0,146.0
153503.0,17,2,180,1,90,0.0,90.0,90.0,1,90,0.0,90.0,90.0
2836.0,17,2,224,1,76,0.0,76.0,76.0,1,148,0.0,148.0,148.0
116329094.0,17,15,1169,8,606,16618442.0,174.0,75.75,7,563,16091752.0,174.0,80.42857142857143
30189.0,6,14,4740,7,653,4906.166666666667,249.0,93.28571428571428,7,4087,4493.166666666667,1514.0,583.8571428571429
100136.0,17,2,762,2,762,0.0,381.0,381.0,0,0,0.0,0.0,0.0
120052099.0,17,29,13785,29,13785,4287574.964285715,501.0,475.3448275862069,0,0,0.0,0.0,0.0
90066431.0,17,28,13364,28,13364,3335793.7407407407,501.0,477.2857142857143,0,0,0.0,0.0,0.0
171780.0,17,2,180,1,90,0.0,90.0,90.0,1,90,0.0,90.0,90.0
90258540.0,6,13,2036,8,1016,12894077.142857144,188.0,127.0,5,1020,22523438.25,204.0,204.0
2387.0,17,4,344,2,150,0.0,75.0,75.0,2,194,0.0,103.0,97.0
120159853.0,6,290,34544,145,9792,828698.4236111111,140.0,67.53103448275863,145,24752,828731.0416666666,464.0,170.70344827586206
39055.0,6,13,1479,7,882,6472.333333333333,291.0,126.0,6,597,5455.6,259.0,99.5
254769.00000000003,6,3,373,2,238,0.0,172.0,119.0,1,135,0.0,135.0,135.0
840134.0,6,9,1096,6,625,168026.8,287.0,104.16666666666669,3,471,283831.5,331.0,157.0
10874988.0,6,8,544,4,272,3579625.6666666665,74.0,68.0,4,272,3579534.333333333,74.0,68.0
43561.0,6,12,1413,7,882,7260.166666666667,291.0,126.0,5,531,9652.0,259.0,106.2
9562.0,17,4,823,2,163,0.0,89.0,81.5,2,660,0.0,443.0,330.0
410981.0,17,2,363,1,75,0.0,75.0,75.0,1,288,0.0,288.0,288.0
35198.0,6,10,2032,5,524,6196.5,252.0,104.8,5,1508,8524.25,1236.0,301.6
103313.0,17,2,286,2,286,0.0,143.0,143.0,0,0,0.0,0.0,0.0
2365.0,17,4,344,2,150,0.0,75.0,75.0,2,194,0.0,103.0,97.0
1034221.0,6,11,1134,6,558,206844.2,220.0,93.0,5,576,257469.25,304.0,115.2
300050.0,6,6,412,4,272,100016.66666666669,74.0,68.0,2,140,0.0,74.0,70.0
144033.0,17,2,180,1,90,0.0,90.0,90.0,1,90,0.0,90.0,90.0
38700.0,6,10,2032,5,524,8935.5,252.0,104.8,5,1508,9231.5,1236.0,301.6
1015642.0,6,4,492,2,280,0.0,214.0,140.0,2,212,0.0,146.0,106.0
33837.0,6,11,2098,6,590,5548.2,252.0,98.33333333333331,5,1508,7951.75,1236.0,301.6
43883.0,6,12,1413,7,882,7313.833333333333,291.0,126.0,5,531,9605.75,259.0,106.2
5620540.0,6,4,270,2,134,0.0,68.0,67.0,2,136,0.0,70.0,68.0
120028012.0,17,28,13364,28,13364,4445481.925925926,501.0,477.2857142857143,0,0,0.0,0.0,0.0
48692053.0,6,12,833,7,491,8115342.166666667,95.0,70.14285714285714,5,342,12113099.25,95.0,68.4
321296.0,17,4,1400,4,1400,107098.66666666669,350.0,350.0,0,0,0.0,0.0,0.0
442832.0,6,10,967,5,390,74641.75,162.0,78.0,5,577,74547.75,349.0,115.4
208575.0,6,4,492,2,280,0.0,214.0,140.0,2,212,0.0,146.0,106.0
104352.0,17,2,286,2,286,0.0,143.0,143.0,0,0,0.0,0.0,0.0
123014197.0,6,35,2542,17,1194,7064235.125,123.0,70.23529411764706,18,1348,6785013.352941177,139.0,74.88888888888889
232360.0,6,3,337,2,214,0.0,160.0,107.0,1,123,0.0,123.0,123.0
101109226.0,17,14,1388,7,694,16824709.333333332,174.0,99.14285714285714,7,694,16824707.666666668,174.0,99.14285714285714
3648650.0,6,23,6506,12,1529,331695.45454545453,357.0,127.41666666666669,11,4977,334015.3,1510.0,452.45454545454544
2386.0,17,4,344,2,150,0.0,75.0,75.0,2,194,0.0,103.0,97.0
90260802.0,6,12,1832,8,1016,12894400.285714284,188.0,127.0,4,816,30031548.33333333,204.0,204.0
857.0,17,4,438,2,148,0.0,74.0,74.0,2,290,0.0,147.0,145.0
146066.0,6,3,337,2,214,0.0,160.0,107.0,1,123,0.0,123.0,123.0
100846710.0,17,13,821,7,432,16807785.0,174.0,61.71428571428572,6,389,16337045.8,174.0,64.83333333333333
99382.0,17,2,762,2,762,0.0,381.0,381.0,0,0,0.0,0.0,0.0
39270.0,6,14,4740,7,653,6056.166666666667,249.0,93.28571428571428,7,4087,6294.166666666667,1514.0,583.8571428571429
3285383.0,6,3,1604,1,753,0.0,753.0,753.0,2,851,0.0,785.0,425.5
209434.0,17,2,180,1,90,0.0,90.0,90.0,1,90,0.0,90.0,90.0
872043.0,6,9,1270,6,799,174408.6,461.0,133.16666666666666,3,471,299734.5,331.0,157.0
511524.0,6,5,336,2,134,0.0,68.0,67.0,3,202,188527.0,70.0,67.33333333333333
4215664.0,6,5,1736,2,819,0.0,753.0,409.5,3,917,2038613.5,785.0,305.6666666666667
69840.0,6,14,4740,7,653,11474.333333333334,249.0,93.28571428571428,7,4087,10964.333333333334,1514.0,583.8571428571429
143892.0,17,2,180,1,90,0.0,90.0,90.0,1,90,0.0,90.0,90.0
4460.0,17,4,344,2,150,0.0,75.0,75.0,2,194,0.0,103.0,97.0
14822.0,6,11,1133,6,602,2680.8,264.0,100.33333333333331,5,531,3276.75,259.0,106.2
1022894.0,6,11,1134,6,558,204578.8,220.0,93.0,5,576,254583.5,304.0,115.2
228291.0,17,2,180,1,90,0.0,90.0,90.0,1,90,0.0,90.0,90.0
120000011.0,6,17,1287,9,691,15000001.375,95.0,76.77777777777777,8,596,12898218.714285716,95.0,74.5
53930.0,6,10,2032,5,524,13245.75,252.0,104.8,5,1508,12757.0,1236.0,301.6
101607.0,17,2,286,2,286,0.0,143.0,143.0,0,0,0.0,0.0,0.0
10391.0,17,2,582,1,83,0.0,83.0,83.0,1,499,0.0,499.0,499.0
228277.0,17,2,180,1,90,0.0,90.0,90.0,1,90,0.0,90.0,90.0
114369152.0,6,195,21920,98,6764,1179063.4226804124,140.0,69.0204081632653,97,15156,1187716.8333333333,284.0,156.24742268041237
71776.0,6,14,4740,7,653,11836.5,249.0,93.28571428571428,7,4087,11317.666666666666,1514.0,583.8571428571429
16922.0,17,2,180,1,90,0.0,90.0,90.0,1,90,0.0,90.0,90.0
16869.0,17,2,180,1,90,0.0,90.0,90.0,1,90,0.0,90.0,90.0
1314798.0,6,4,264,2,132,0.0,66.0,66.0,2,132,0.0,66.0,66.0
144031.0,17,2,180,1,90,0.0,90.0,90.0,1,90,0.0,90.0,90.0
75352.0,6,10,1066,5,490,18293.5,218.0,98.0,5,576,18632.0,304.0,115.2
41320.0,6,10,2032,5,524,10090.75,252.0,104.8,5,1508,9630.75,1236.0,301.6
135129922.0,17,6,1206,6,1206,27025984.4,201.0,201.0,0,0,0.0,0.0,0.0
90092588.0,6,11,1644,4,816,30030497.33333333,204.0,204.0,7,828,15015180.666666666,188.0,118.28571428571428
305.0,17,2,174,1,79,0.0,79.0,79.0,1,95,0.0,95.0,95.0
10236.0,17,2,582,1,83,0.0,83.0,83.0,1,499,0.0,499.0,499.0
351331.0,17,2,180,1,90,0.0,90.0,90.0,1,90,0.0,90.0,90.0
22424.0,6,10,2032,5,524,4235.75,252.0,104.8,5,1508,4719.75,1236.0,301.6
320635.0,17,4,1400,4,1400,106878.33333333331,350.0,350.0,0,0,0.0,0.0,0.0
206091.0,17,2,180,1,90,0.0,90.0,90.0,1,90,0.0,90.0,90.0
120495323.0,17,13,821,6,389,20170652.8,174.0,64.83333333333333,7,432,20056064.83333333,174.0,61.71428571428572
90213819.0,6,17,1287,8,596,12853489.857142856,95.0,74.5,9,691,11251161.375,95.0,76.77777777777777
708.0,17,4,438,2,148,0.0,74.0,74.0,2,290,0.0,147.0,145.0
31394.0,6,10,2032,5,524,6042.0,252.0,104.8,5,1508,6478.25,1236.0,301.6
103001.0,17,2,762,2,762,0.0,381.0,381.0,0,0,0.0,0.0,0.0
217803.0,6,3,426,2,280,0.0,214.0,140.0,1,146,0.0,146.0,146.0
103855.0,17,2,762,2,762,0.0,381.0,381.0,0,0,0.0,0.0,0.0
2053.0,17,4,344,2,150,0.0,75.0,75.0,2,194,0.0,103.0,97.0
132346.0,6,2,132,1,66,0.0,66.0,66.0,1,66,0.0,66.0,66.0
2351.0,17,4,344,2,150,0.0,75.0,75.0,2,194,0.0,103.0,97.0
98911.0,17,2,762,2,762,0.0,381.0,381.0,0,0,0.0,0.0,0.0
13534.0,6,13,1459,7,862,2145.333333333333,271.0,123.14285714285714,6,597,2291.8,259.0,99.5
16003677.0,17,6,2052,6,2052,3200735.4,342.0,342.0,0,0,0.0,0.0,0.0
5834912.0,6,5,336,2,134,0.0,68.0,67.0,3,202,1523936.0,70.0,67.33333333333333
216334.0,17,2,180,1,90,0.0,90.0,90.0,1,90,0.0,90.0,90.0
90425356.0,17,12,778,6,389,18000154.4,174.0,64.83333333333333,6,389,18001079.2,174.0,64.83333333333333
291699.0,6,12,1373,7,714,48616.5,298.0,102.0,5,659,67616.5,379.0,131.8
0.0,17,1,381,1,381,0.0,381.0,381.0,0,0,0.0,0.0,0.0
0.0,6,1,54,1,54,0.0,54.0,54.0,0,0,0.0,0.0,0.0
299.0,17,2,156,1,78,0.0,78.0,78.0,1,78,0.0,78.0,78.0
90302427.0,6,24,1829,13,989,7520671.083333333,95.0,76.07692307692308,11,840,8954125.3,95.0,76.36363636363636
153555.0,17,2,180,1,90,0.0,90.0,90.0,1,90,0.0,90.0,90.0
1567312.0,6,2,132,1,66,0.0,66.0,66.0,1,66,0.0,66.0,66.0
51008.0,6,10,2032,5,524,12511.5,252.0,104.8,5,1508,12530.75,1236.0,301.6
99240195.0,17,12,778,6,389,19800920.4,174.0,64.83333333333333,6,389,19800164.6,174.0,64.83333333333333
36661.0,6,14,4740,7,653,5951.5,249.0,93.28571428571428,7,4087,5347.666666666667,1514.0,583.8571428571429
107348.0,17,2,286,2,286,0.0,143.0,143.0,0,0,0.0,0.0,0.0
105048003.0,17,14,1126,7,563,17500164.166666668,174.0,80.42857142857143,7,563,17501102.0,174.0,80.42857142857143
3216328.0,6,3,1777,1,826,0.0,826.0,826.0,2,951,0.0,885.0,475.5
31693.0,6,14,4740,7,653,4101.0,249.0,93.28571428571428,7,4087,4985.833333333333,1514.0,583.8571428571429
223110.0,6,12,1373,7,714,37185.0,298.0,102.0,5,659,49881.0,379.0,131.8
299583.0,6,10,1221,6,636,59916.6,298.0,106.0,4,585,94476.66666666669,379.0,146.25
24635.0,6,14,4740,7,653,3428.333333333333,249.0,93.28571428571428,7,4087,3963.3333333333335,1514.0,583.8571428571429
0.0,6,1,160,1,160,0.0,160.0,160.0,0,0,0.0,0.0,0.0
203911.0,17,2,762,2,762,0.0,381.0,381.0,0,0,0.0,0.0,0.0
120343089.0,6,299,35456,150,25326,807671.7382550335,570.0,168.84,149,10130,806123.3513513514,140.0,67.98657718120805
5621952.0,6,4,270,2,134,0.0,68.0,67.0,2,136,0.0,70.0,68.0
2415.0,17,4,344,2,150,0.0,75.0,75.0,2,194,0.0,103.0,97.0
402877.0,6,10,1221,6,636,80575.4,298.0,106.0,4,585,127871.0,379.0,146.25
232227.0,6,3,337,2,214,0.0,160.0,107.0,1,123,0.0,123.0,123.0
6820.0,17,2,582,1,83,0.0,83.0,83.0,1,499,0.0,499.0,499.0
110753677.0,6,29,1920,15,1026,7910976.928571428,123.0,68.4,14,894,7735780.846153846,123.0,63.85714285714285
352.0,17,2,267,1,83,0.0,83.0,83.0,1,184,0.0,184.0,184.0
104102.0,17,2,286,2,286,0.0,143.0,143.0,0,0,0.0,0.0,0.0
191156.0,17,2,180,1,90,0.0,90.0,90.0,1,90,0.0,90.0,90.0
16863.0,17,2,180,1,90,0.0,90.0,90.0,1,90,0.0,90.0,90.0
90288943.0,6,16,1192,8,596,12891083.142857144,95.0,74.5,8,596,12896841.57142857,95.0,74.5
109163834.0,17,14,1126,7,563,18167484.0,174.0,80.42857142857143,7,563,18167487.33333333,174.0,80.42857142857143
2687778.0,6,25,7610,13,2516,223981.5,1034.0,193.53846153846155,12,5094,210253.7272727273,1510.0,424.5
190398.0,17,2,180,1,90,0.0,90.0,90.0,1,90,0.0,90.0,90.0
120027077.0,17,28,13364,28,13364,4445447.296296297,501.0,477.2857142857143,0,0,0.0,0.0,0.0
98367.0,17,4,1400,4,1400,32789.0,350.0,350.0,0,0,0.0,0.0,0.0
71146.0,17,2,604,1,75,0.0,75.0,75.0,1,529,0.0,529.0,529.0
120150710.0,6,212,23980,106,7292,1136566.066666667,140.0,68.79245283018868,106,16688,1136431.066666667,284.0,157.43396226415095
110131903.0,6,28,1876,14,982,8455090.307692308,139.0,70.14285714285714,14,894,8455093.0,123.0,63.85714285714285
232055.0,6,3,337,2,214,0.0,160.0,107.0,1,123,0.0,123.0,123.0
37655.0,6,13,1479,7,882,6121.166666666667,291.0,126.0,6,597,5453.8,259.0,99.5
120047073.0,6,32,2173,16,1071,7337482.066666666,123.0,66.9375,16,1102,8003010.466666667,139.0,68.875
40222.0,6,14,4740,7,653,6591.166666666667,249.0,93.28571428571428,7,4087,6425.833333333333,1514.0,583.8571428571429
3318687.0,6,7,923,4,753,1037583.0,571.0,188.25,3,170,1556937.0,62.0,56.66666666666666
24021.0,6,14,4740,7,653,3781.3333333333335,249.0,93.28571428571428,7,4087,3085.0,1514.0,583.8571428571429
204590.0,17,2,762,2,762,0.0,381.0,381.0,0,0,0.0,0.0,0.0
5830529.0,6,5,336,2,134,0.0,68.0,67.0,3,202,1527638.5,70.0,67.33333333333333
21552.0,6,14,4740,7,653,3299.0,249.0,93.28571428571428,7,4087,3262.1666666666665,1514.0,583.8571428571429
299768.0,17,2,246,1,76,0.0,76.0,76.0,1,170,0.0,170.0,170.0
16946.0,6,2,145,2,145,0.0,91.0,72.5,0,0,0.0,0.0,0.0
125165633.0,6,31,2034,16,1086,8344375.533333333,123.0,67.875,15,948,8211853.571428572,123.0,63.2
106375.0,17,2,286,2,286,0.0,143.0,143.0,0,0,0.0,0.0,0.0
105603416.0,6,28,1860,14,966,8106749.153846154,123.0,69.0,14,894,8106748.384615385,123.0,63.85714285714285
306325.0,6,3,202,2,128,0.0,74.0,64.0,1,74,0.0,74.0,74.0
95655.0,6,2,132,1,66,0.0,66.0,66.0,1,66,0.0,66.0,66.0
242049.0,6,3,337,2,214,0.0,160.0,107.0,1,123,0.0,123.0,123.0
1116.0,17,4,438,2,148,0.0,74.0,74.0,2,290,0.0,147.0,145.0
102237.0,17,2,762,2,762,0.0,381.0,381.0,0,0,0.0,0.0,0.0
26806.0,6,14,4740,7,653,4304.5,249.0,93.28571428571428,7,4087,3786.6666666666665,1514.0,583.8571428571429
0.0,6,1,66,1,66,0.0,66.0,66.0,0,0,0.0,0.0,0.0
7022.0,17,2,582,1,83,0.0,83.0,83.0,1,499,0.0,499.0,499.0
352.0,17,2,267,1,83,0.0,83.0,83.0,1,184,0.0,184.0,184.0
110867779.0,6,44,2904,22,1452,5279418.047619048,66.0,66.0,22,1452,5264532.142857143,66.0,66.0
720067.0,6,12,1447,6,816,143171.6,291.0,136.0,6,631,142932.0,293.0,105.16666666666669
891086.0,17,2,246,1,76,0.0,76.0,76.0,1,170,0.0,170.0,170.0
4374.0,17,2,626,1,72,0.0,72.0,72.0,1,554,0.0,554.0,554.0
5620876.0,6,4,270,2,134,0.0,68.0,67.0,2,136,0.0,70.0,68.0
108101113.0,17,5,1005,5,1005,27025278.25,201.0,201.0,0,0,0.0,0.0,0.0
120124975.0,6,13,2020,9,1204,15015621.875,188.0,133.77777777777777,4,816,30031832.33333333,204.0,204.0
1556006.0,6,4,276,2,128,0.0,74.0,64.0,2,148,0.0,74.0,74.0
0.0,6,1,172,1,172,0.0,172.0,172.0,0,0,0.0,0.0,0.0
444533.0,6,3,1604,2,851,0.0,785.0,425.5,1,753,0.0,753.0,753.0
105248714.0,6,43,2838,22,1452,4998739.666666667,66.0,66.0,21,1386,5135431.6,66.0,66.0
298013.0,6,6,412,4,272,99337.66666666669,74.0,68.0,2,140,0.0,74.0,70.0
118064870.0,6,32,2226,16,1155,7856594.6,192.0,72.1875,16,1071,7856592.266666667,123.0,66.9375
3709010.0,6,5,336,2,134,0.0,68.0,67.0,3,202,1526048.0,70.0,67.33333333333333
307503.0,6,6,412,4,272,102501.0,74.0,68.0,2,140,0.0,74.0,70.0
414.0,17,2,166,1,75,0.0,75.0,75.0,1,91,0.0,91.0,91.0
2048698.0,17,6,1230,3,234,1024131.5,78.0,78.0,3,996,1024122.5,332.0,332.0
303306.0,6,6,412,4,272,101102.0,74.0,68.0,2,140,0.0,74.0,70.0
2346.0,17,4,344,2,150,0.0,75.0,75.0,2,194,0.0,103.0,97.0
205920.0,17,2,762,2,762,0.0,381.0,381.0,0,0,0.0,0.0,0.0
157796.0,17,2,180,1,90,0.0,90.0,90.0,1,90,0.0,90.0,90.0
83.0,17,2,762,2,762,0.0,381.0,381.0,0,0,0.0,0.0,0.0
120359250.0,6,214,24090,107,7284,1127752.1226415094,140.0,68.07476635514018,107,16806,1135292.7264150945,284.0,157.06542056074767
22696.0,6,14,4740,7,653,3584.1666666666665,249.0,93.28571428571428,7,4087,3319.0,1514.0,583.8571428571429
133684423.0,17,17,1517,9,780,16710552.875,174.0,86.66666666666667,8,737,16288574.42857143,174.0,92.125
241952.0,6,3,337,2,214,0.0,160.0,107.0,1,123,0.0,123.0,123.0
442429.0,6,3,204,2,136,0.0,70.0,68.0,1,68,0.0,68.0,68.0
161191.0,17,4,820,2,156,0.0,78.0,78.0,2,664,0.0,332.0,332.0
16484.0,6,14,4740,7,653,2364.0,249.0,93.28571428571428,7,4087,2508.0,1514.0,583.8571428571429
228315.0,17,2,180,1,90,0.0,90.0,90.0,1,90,0.0,90.0,90.0
219067.0,6,3,426,2,280,0.0,214.0,140.0,1,146,0.0,146.0,146.0
2592967.0,6,2,132,1,66,0.0,66.0,66.0,1,66,0.0,66.0,66.0
121226681.0,6,224,25312,112,7688,1075348.936936937,140.0,68.64285714285714,112,17624,1084700.4414414414,284.0,157.35714285714286
94372244.0,17,12,778,6,389,18801062.8,174.0,64.83333333333333,6,389,18600185.4,174.0,64.83333333333333
67168.0,6,14,4740,7,653,10483.5,249.0,93.28571428571428,7,4087,10421.166666666666,1514.0,583.8571428571429
260355.0,6,3,337,2,214,0.0,160.0,107.0,1,123,0.0,123.0,123.0
1236504.0,17,7,490,7,490,206084.0,70.0,70.0,0,0,0.0,0.0,0.0
317241.0,17,4,1400,4,1400,105747.0,350.0,350.0,0,0,0.0,0.0,0.0
121807.0,6,14,4740,7,653,20178.0,249.0,93.28571428571428,7,4087,18098.666666666668,1514.0,583.8571428571429
90299290.0,6,21,1585,11,840,9025137.2,95.0,76.36363636363636,10,745,10001297.888888888,95.0,74.5
51635.0,6,14,4740,7,653,8249.333333333334,249.0,93.28571428571428,7,4087,8464.5,1514.0,583.8571428571429
2383918.0,6,25,7573,14,3735,183378.3076923077,1514.0,266.7857142857143,11,3838,211103.2,1514.0,348.90909090909093
31778.0,6,11,2098,6,590,6355.6,252.0,98.33333333333331,5,1508,6072.75,1236.0,301.6
2817936.0,6,11,2106,6,598,562894.6,252.0,99.66666666666669,5,1508,4157.25,1236.0,301.6
323.0,17,2,174,1,79,0.0,79.0,79.0,1,95,0.0,95.0,95.0
81650.0,6,14,4740,7,653,12128.0,249.0,93.28571428571428,7,4087,12124.5,1514.0,583.8571428571429
149685.0,17,2,180,1,90,0.0,90.0,90.0,1,90,0.0,90.0,90.0
539.0,17,2,508,2,508,0.0,257.0,254.0,0,0,0.0,0.0,0.0
123839998.0,6,49,3234,25,1650,5159999.916666667,66.0,66.0,24,1584,4982936.826086956,66.0,66.0
56076.0,6,10,2032,5,524,12087.0,252.0,104.8,5,1508,9982.0,1236.0,301.6
28780.0,6,14,4740,7,653,4368.833333333333,249.0,93.28571428571428,7,4087,4656.666666666667,1514.0,583.8571428571429
122975375.0,6,48,3168,24,1584,5073895.782608695,66.0,66.0,24,1584,5193204.130434782,66.0,66.0
144331.0,17,2,180,1,90,0.0,90.0,90.0,1,90,0.0,90.0,90.0
298653.0,6,6,412,4,272,99551.0,74.0,68.0,2,140,0.0,74.0,70.0
233790.0,6,3,373,2,238,0.0,172.0,119.0,1,135,0.0,135.0,135.0
135130483.0,17,6,1206,6,1206,27026096.6,201.0,201.0,0,0,0.0,0.0,0.0
302382.0,6,2,132,1,66,0.0,66.0,66.0,1,66,0.0,66.0,66.0
122530661.0,6,49,3234,25,1650,5105444.208333333,66.0,66.0,24,1584,5105762.826086956,66.0,66.0
120291754.0,6,217,24660,109,17310,1113812.537037037,300.0,158.80733944954127,108,7350,1114522.074766355,140.0,68.05555555555556
27465.0,6,14,4740,7,653,3596.1666666666665,249.0,93.28571428571428,7,4087,4274.333333333333,1514.0,583.8571428571429
11204.0,6,10,2032,5,524,2368.75,252.0,104.8,5,1508,2495.5,1236.0,301.6
143978.0,17,2,180,1,90,0.0,90.0,90.0,1,90,0.0,90.0,90.0
447170.0,6,3,204,2,136,0.0,70.0,68.0,1,68,0.0,68.0,68.0
27257.0,6,14,4740,7,653,4361.166666666667,249.0,93.28571428571428,7,4087,4372.333333333333,1514.0,583.8571428571429
21364.0,6,14,4740,7,653,3372.1666666666665,249.0,93.28571428571428,7,4087,3426.0,1514.0,583.8571428571429
108708963.0,6,34,2482,17,1288,6780789.0,139.0,75.76470588235294,17,1194,6780803.4375,123.0,70.23529411764706
246742.0,6,3,337,2,214,0.0,160.0,107.0,1,123,0.0,123.0,123.0
105390238.0,17,14,864,7,432,17501186.666666668,174.0,61.71428571428572,7,432,17500080.833333332,174.0,61.71428571428572
33128.0,6,10,2032,5,524,8071.25,252.0,104.8,5,1508,6880.25,1236.0,301.6
20572.0,6,14,4740,7,653,3318.333333333333,249.0,93.28571428571428,7,4087,3291.5,1514.0,583.8571428571429
120065853.0,17,29,13785,29,13785,4288066.178571428,501.0,475.3448275862069,0,0,0.0,0.0,0.0
4084.0,17,4,571,2,148,0.0,74.0,74.0,2,423,0.0,276.0,211.5
100068497.0,17,13,821,6,389,20001050.4,174.0,64.83333333333333,7,432,16666798.0,174.0,61.71428571428572
26368.0,6,14,4740,7,653,4059.6666666666665,249.0,93.28571428571428,7,4087,4257.333333333333,1514.0,583.8571428571429
299637.0,6,6,412,4,272,99879.0,74.0,68.0,2,140,0.0,74.0,70.0
332.0,17,2,166,1,75,0.0,75.0,75.0,1,91,0.0,91.0,91.0
201556.0,17,2,180,1,90,0.0,90.0,90.0,1,90,0.0,90.0,90.0
868470.0,6,9,1096,6,625,173694.0,287.0,104.16666666666669,3,471,296285.5,331.0,157.0
314.0,17,2,174,1,79,0.0,79.0,79.0,1,95,0.0,95.0,95.0
218284.0,6,3,426,2,280,0.0,214.0,140.0,1,146,0.0,146.0,146.0
320.0,17,2,168,1,76,0.0,76.0,76.0,1,92,0.0,92.0,92.0
156859.0,6,3,337,2,214,0.0,160.0,107.0,1,123,0.0,123.0,123.0
14116.0,6,20,7606,11,978,1411.6,310.0,88.9090909090909,9,6628,1487.25,1514.0,736.4444444444445
109678742.0,6,31,2176,16,1071,7311916.133333334,123.0,66.9375,15,1105,7105553.0,139.0,73.66666666666667
118517966.0,6,216,24440,108,17090,1105633.308411215,284.0,158.24074074074073,108,7350,1105633.981308411,140.0,68.05555555555556
255115.0,6,3,337,2,214,0.0,160.0,107.0,1,123,0.0,123.0,123.0
26789.0,6,10,2032,5,524,6323.5,252.0,104.8,5,1508,6381.75,1236.0,301.6
42505.0,6,14,4740,7,653,6954.666666666667,249.0,93.28571428571428,7,4087,5978.333333333333,1514.0,583.8571428571429
206320.0,6,3,426,2,280,0.0,214.0,140.0,1,146,0.0,146.0,146.0
111866.0,6,14,4740,7,653,11691.0,249.0,93.28571428571428,7,4087,18031.33333333333,1514.0,583.8571428571429
138009917.0,17,17,1255,9,649,17251239.625,174.0,72.11111111111111,8,606,16857318.57142857,174.0,75.75
14649991.0,6,20,1648,10,1016,1593063.3333333333,315.0,101.6,10,632,1593034.5555555555,78.0,63.2
153449.0,17,2,180,1,90,0.0,90.0,90.0,1,90,0.0,90.0,90.0
9085.0,17,2,582,1,83,0.0,83.0,83.0,1,499,0.0,499.0,499.0
512964.0,6,5,336,2,134,0.0,68.0,67.0,3,202,196558.0,70.0,67.33333333333333
310975.0,6,6,412,4,272,103658.33333333331,74.0,68.0,2,140,0.0,74.0,70.0
119449585.0,6,30,1974,15,1026,8516701.0,123.0,68.4,15,948,8516681.5,123.0,63.2
108113670.0,17,5,955,5,955,27028417.5,191.0,191.0,0,0,0.0,0.0,0.0
308253.0,6,6,412,4,272,102751.0,74.0,68.0,2,140,0.0,74.0,70.0
9054.0,17,2,582,1,83,0.0,83.0,83.0,1,499,0.0,499.0,499.0
228747.0,17,2,180,1,90,0.0,90.0,90.0,1,90,0.0,90.0,90.0
38145.0,6,14,4740,7,653,4299.333333333333,249.0,93.28571428571428,7,4087,5173.5,1514.0,583.8571428571429
297246.0,6,6,412,4,272,99082.0,74.0,68.0,2,140,0.0,74.0,70.0
1870.0,17,2,180,1,90,0.0,90.0,90.0,1,90,0.0,90.0,90.0
120152787.0,6,216,24456,108,7350,1115221.0280373832,140.0,68.05555555555556,108,17106,1115117.1028037383,284.0,158.38888888888889
25191.0,6,10,1066,5,490,4941.25,218.0,98.0,5,576,6088.25,304.0,115.2
207019.0,6,3,426,2,280,0.0,214.0,140.0,1,146,0.0,146.0,146.0
156431.0,6,3,337,2,214,0.0,160.0,107.0,1,123,0.0,123.0,123.0
108109448.0,17,5,1005,5,1005,27027362.0,201.0,201.0,0,0,0.0,0.0,0.0
34231.0,6,14,4740,7,653,5345.166666666667,249.0,93.28571428571428,7,4087,5197.5,1514.0,583.8571428571429
843202.0,6,9,1118,6,586,168640.4,248.0,97.66666666666669,3,532,283612.5,392.0,177.33333333333334
13637.0,6,11,1133,6,602,2527.4,264.0,100.33333333333331,5,531,3132.75,259.0,106.2
63461.0,6,14,4740,7,653,10419.0,249.0,93.28571428571428,7,4087,9574.166666666666,1514.0,583.8571428571429
209475.0,17,2,180,1,90,0.0,90.0,90.0,1,90,0.0,90.0,90.0
122008210.0,17,15,907,8,475,17429744.285714287,174.0,59.375,7,432,17000157.5,174.0,61.71428571428572
246972.0,17,2,180,1,90,0.0,90.0,90.0,1,90,0.0,90.0,90.0
101946933.0,6,28,1860,14,966,7826343.538461538,123.0,69.0,14,894,7826342.230769231,123.0,63.85714285714285
135131606.0,17,6,1146,6,1146,27026321.2,191.0,191.0,0,0,0.0,0.0,0.0
263336.0,6,10,1221,6,636,52667.2,298.0,106.0,4,585,82312.0,379.0,146.25
112654.0,17,4,1400,4,1400,37551.333333333336,350.0,350.0,0,0,0.0,0.0,0.0
5590657.0,17,5,1710,5,1710,1397664.25,342.0,342.0,0,0,0.0,0.0,0.0
130119.0,17,4,1524,4,1524,43373.0,381.0,381.0,0,0,0.0,0.0,0.0
2339.0,17,4,344,2,150,0.0,75.0,75.0,2,194,0.0,103.0,97.0
108108124.0,17,5,1005,5,1005,27027031.0,201.0,201.0,0,0,0.0,0.0,0.0
2021095.0,17,4,525,2,150,0.0,75.0,75.0,2,375,0.0,284.0,187.5
104816451.0,17,14,4788,14,4788,8062803.923076923,342.0,342.0,0,0,0.0,0.0,0.0
108105593.0,17,5,955,5,955,27026398.25,191.0,191.0,0,0,0.0,0.0,0.0
122030.0,6,3,337,2,214,0.0,160.0,107.0,1,123,0.0,123.0,123.0
2431.0,17,4,344,2,150,0.0,75.0,75.0,2,194,0.0,103.0,97.0
105247050.0,6,28,1876,14,982,8079339.0,139.0,70.14285714285714,14,894,8079339.615384615,123.0,63.85714285714285
33390.0,6,11,2098,6,590,6401.0,252.0,98.33333333333331,5,1508,6926.75,1236.0,301.6
108739.0,17,2,286,2,286,0.0,143.0,143.0,0,0,0.0,0.0,0.0
2802990.0,6,2,132,1,66,0.0,66.0,66.0,1,66,0.0,66.0,66.0
49103.0,6,14,4740,7,653,7675.333333333333,249.0,93.28571428571428,7,4087,2973.333333333333,1514.0,583.8571428571429
162234.0,17,2,180,1,90,0.0,90.0,90.0,1,90,0.0,90.0,90.0
2364.0,17,4,344,2,150,0.0,75.0,75.0,2,194,0.0,103.0,97.0
120061706.0,17,29,13785,29,13785,4287918.071428572,501.0,475.3448275862069,0,0,0.0,0.0,0.0
209762.0,6,3,426,2,280,0.0,214.0,140.0,1,146,0.0,146.0,146.0
9496.0,17,2,539,1,86,0.0,86.0,86.0,1,453,0.0,453.0,453.0
135141893.0,17,6,1206,6,1206,27028378.6,201.0,201.0,0,0,0.0,0.0,0.0
12612.0,6,13,1459,7,862,1930.0,271.0,123.14285714285714,6,597,2371.2,259.0,99.5
4186.0,17,2,582,1,83,0.0,83.0,83.0,1,499,0.0,499.0,499.0
90058475.0,17,27,12943,27,12943,3463787.5,501.0,479.3703703703704,0,0,0.0,0.0,0.0
91700843.0,6,164,18540,82,12906,1129448.3703703703,284.0,157.390243902439,82,5634,1129443.5308641975,140.0,68.70731707317073
107664.0,6,12,1354,6,723,20767.6,253.0,120.5,6,631,21152.4,293.0,105.16666666666669
52473.0,6,10,2032,5,524,12886.75,252.0,104.8,5,1508,11160.5,1236.0,301.6
1201494.0,6,13,3011,8,2383,171642.0,1514.0,297.875,5,628,231559.75,331.0,125.6
111018.0,17,2,286,2,286,0.0,143.0,143.0,0,0,0.0,0.0,0.0
26893856.0,17,5,1718,4,1368,905171.3333333334,342.0,342.0,1,350,0.0,350.0,350.0
120258597.0,6,377,45686,189,32982,639673.3882978724,336.0,174.5079365079365,188,12704,637603.2620320856,140.0,67.57446808510639
16858.0,6,14,4740,7,653,2635.5,249.0,93.28571428571428,7,4087,2671.6666666666665,1514.0,583.8571428571429
236669.0,6,3,337,2,214,0.0,160.0,107.0,1,123,0.0,123.0,123.0
79.0,17,2,700,2,700,0.0,350.0,350.0,0,0,0.0,0.0,0.0
81270.0,6,10,2032,5,524,18709.25,252.0,104.8,5,1508,16859.0,1236.0,301.6
119584868.0,6,21,1585,10,745,13287207.555555556,95.0,74.5,11,840,11933629.7,95.0,76.36363636363636
56649.0,6,14,4740,7,653,9107.0,249.0,93.28571428571428,7,4087,6682.0,1514.0,583.8571428571429
352.0,17,2,267,1,83,0.0,83.0,83.0,1,184,0.0,184.0,184.0
478345.0,6,3,1604,1,753,0.0,753.0,753.0,2,851,0.0,785.0,425.5
49524.0,6,14,4740,7,653,3852.1666666666665,249.0,93.28571428571428,7,4087,8066.5,1514.0,583.8571428571429
135131687.0,17,6,1146,6,1146,27026337.4,191.0,191.0,0,0,0.0,0.0,0.0
40007.0,6,14,4740,7,653,6394.166666666667,249.0,93.28571428571428,7,4087,5981.5,1514.0,583.8571428571429
111209.0,17,2,286,2,286,0.0,143.0,143.0,0,0,0.0,0.0,0.0
71889.0,6,12,1320,7,789,11981.5,253.0,112.71428571428572,5,531,16415.0,259.0,106.2
202906.0,6,10,1221,6,636,40581.2,298.0,106.0,4,585,65788.66666666667,379.0,146.25
0.0,17,1,44,1,44,0.0,44.0,44.0,0,0,0.0,0.0,0.0
17719.0,6,20,7606,11,978,1771.9,310.0,88.9090909090909,9,6628,2023.375,1514.0,736.4444444444445
323071.0,17,4,1400,4,1400,107690.33333333331,350.0,350.0,0,0,0.0,0.0,0.0
45146.0,6,14,4740,7,653,6932.833333333333,249.0,93.28571428571428,7,4087,6398.666666666667,1514.0,583.8571428571429
13778.0,6,10,1067,5,536,2590.0,264.0,107.2,5,531,3137.75,259.0,106.2
833.0,17,4,438,2,148,0.0,74.0,74.0,2,290,0.0,147.0,145.0
4224.0,17,2,762,2,762,0.0,381.0,381.0,0,0,0.0,0.0,0.0
5627552.0,6,4,270,2,134,0.0,68.0,67.0,2,136,0.0,70.0,68.0
123301782.0,6,48,3168,24,1584,4940946.130434782,66.0,66.0,24,1584,5355648.130434782,66.0,66.0
4340.0,17,2,614,1,72,0.0,72.0,72.0,1,542,0.0,542.0,542.0
58628.0,6,14,4740,7,653,9329.833333333334,249.0,93.28571428571428,7,4087,8739.166666666666,1514.0,583.8571428571429
146246.0,6,3,337,2,214,0.0,160.0,107.0,1,123,0.0,123.0,123.0
22578.0,6,10,2032,5,524,5407.5,252.0,104.8,5,1508,5251.5,1236.0,301.6
30422.0,6,14,4740,7,653,4872.333333333333,249.0,93.28571428571428,7,4087,4782.0,1514.0,583.8571428571429
103029.0,17,2,286,2,286,0.0,143.0,143.0,0,0,0.0,0.0,0.0
139718.0,6,11,1132,6,556,27517.6,218.0,92.66666666666669,5,576,34596.0,304.0,115.2
2467973.0,6,28,9195,16,3843,164531.53333333333,1514.0,240.1875,12,5352,201414.18181818185,1514.0,446.0
39815084.0,6,8,1307,8,1307,5687869.142857143,172.0,163.375,0,0,0.0,0.0,0.0
100244748.0,17,14,1388,7,694,16680775.5,174.0,99.14285714285714,7,694,16680772.166666666,174.0,99.14285714285714
2445.0,17,4,344,2,150,0.0,75.0,75.0,2,194,0.0,103.0,97.0
205202.0,17,2,762,2,762,0.0,381.0,381.0,0,0,0.0,0.0,0.0
96088433.0,6,192,21664,96,15106,1009302.5263157894,284.0,157.35416666666666,96,6558,1009295.347368421,140.0,68.3125
311823.0,17,4,1400,4,1400,103941.0,350.0,350.0,0,0,0.0,0.0,0.0
57833.0,6,10,2032,5,524,14292.0,252.0,104.8,5,1508,13842.5,1236.0,301.6
414225.0,17,2,762,2,762,0.0,381.0,381.0,0,0,0.0,0.0,0.0
135132308.0,17,6,1206,6,1206,27026461.6,201.0,201.0,0,0,0.0,0.0,0.0
305029.0,17,4,571,2,148,0.0,74.0,74.0,2,423,0.0,280.0,211.5
120202089.0,6,228,25788,114,7820,1056404.07079646,140.0,68.59649122807018,114,17968,1056336.061946903,284.0,157.6140350877193
0.0,17,1,44,1,44,0.0,44.0,44.0,0,0,0.0,0.0,0.0
38310.0,6,10,2032,5,524,8922.75,252.0,104.8,5,1508,7858.75,1236.0,301.6
2013.0,17,4,344,2,150,0.0,75.0,75.0,2,194,0.0,103.0,97.0
90254227.0,6,13,2036,8,1016,12893461.0,188.0,127.0,5,1020,22521421.0,204.0,204.0
36394.0,6,10,2032,5,524,8506.5,252.0,104.8,5,1508,7142.25,1236.0,301.6
90088055.0,6,10,1440,7,828,15014675.833333334,188.0,118.28571428571428,3,612,30028631.5,204.0,204.0
18322.0,6,10,2032,5,524,4340.25,252.0,104.8,5,1508,3998.75,1236.0,301.6
1029244.0,6,11,1134,6,558,205848.8,220.0,93.0,5,576,255372.25,304.0,115.2
90124612.0,6,14,1976,8,1016,12874944.57142857,188.0,127.0,6,960,12018990.6,204.0,160.0
120001008.0,17,15,907,8,475,17143001.14285714,174.0,59.375,7,432,16667616.0,174.0,61.71428571428572
157734.0,6,10,1066,5,490,38561.25,218.0,98.0,5,576,39155.0,304.0,115.2
112142.0,6,10,2032,5,524,27745.5,252.0,104.8,5,1508,27760.25,1236.0,301.6
9384.0,17,2,582,1,83,0.0,83.0,83.0,1,499,0.0,499.0,499.0
120105319.0,6,250,29008,125,8546,954515.5483870968,140.0,68.368,125,20462,962127.008064516,284.0,163.696
2941407.0,6,4,270,3,202,1470703.5,70.0,67.33333333333333,1,68,0.0,68.0,68.0
318.0,17,2,174,1,79,0.0,79.0,79.0,1,95,0.0,95.0,95.0
90034886.0,17,28,13364,28,13364,3334625.407407407,501.0,477.2857142857143,0,0,0.0,0.0,0.0
711403.0,6,6,686,3,374,307456.0,160.0,124.66666666666669,3,312,233077.5,123.0,104.0
2217.0,17,4,344,2,150,0.0,75.0,75.0,2,194,0.0,103.0,97.0
502881.0,6,5,336,2,134,0.0,68.0,67.0,3,202,191775.0,70.0,67.33333333333333
15720.000000000002,6,14,4740,7,653,2513.0,249.0,93.28571428571428,7,4087,2470.333333333333,1514.0,583.8571428571429
102953.0,17,2,700,2,700,0.0,350.0,350.0,0,0,0.0,0.0,0.0
90258156.0,6,16,2368,9,1204,11282269.5,188.0,133.77777777777777,7,1164,15014874.833333334,204.0,166.28571428571428
1180920.0,6,13,3019,8,2391,168702.85714285713,1514.0,298.875,5,628,226293.25,331.0,125.6
858680.0,6,9,1196,6,725,171736.0,387.0,120.83333333333331,3,471,291532.5,331.0,157.0
317.0,17,2,174,1,79,0.0,79.0,79.0,1,95,0.0,95.0,95.0
209397.0,17,2,180,1,90,0.0,90.0,90.0,1,90,0.0,90.0,90.0
99202.0,17,2,762,2,762,0.0,381.0,381.0,0,0,0.0,0.0,0.0
3043623.0,6,3,1604,2,851,0.0,785.0,425.5,1,753,0.0,753.0,753.0
18934.0,6,11,1133,6,602,3131.0,264.0,100.33333333333331,5,531,4307.25,259.0,106.2
56876.0,6,14,4740,7,653,9352.833333333334,249.0,93.28571428571428,7,4087,8710.5,1514.0,583.8571428571429
276871.0,17,2,180,1,90,0.0,90.0,90.0,1,90,0.0,90.0,90.0
41518.0,6,10,2032,5,524,9838.0,252.0,104.8,5,1508,9140.75,1236.0,301.6
305967.0,17,4,704,2,148,0.0,74.0,74.0,2,556,0.0,280.0,278.0
2349.0,17,4,344,2,150,0.0,75.0,75.0,2,194,0.0,103.0,97.0
351.0,17,2,208,1,72,0.0,72.0,72.0,1,136,0.0,136.0,136.0
160160.0,17,2,180,1,90,0.0,90.0,90.0,1,90,0.0,90.0,90.0
110822737.0,6,33,2359,17,1194,6926421.0625,123.0,70.23529411764706,16,1165,7373630.066666666,139.0,72.8125
3224961.0,6,5,336,2,134,0.0,68.0,67.0,3,202,1423637.0,70.0,67.33333333333333
220004.0,6,3,426,2,280,0.0,214.0,140.0,1,146,0.0,146.0,146.0
28231.0,6,14,4740,7,653,4361.833333333333,249.0,93.28571428571428,7,4087,4571.333333333333,1514.0,583.8571428571429
1302516.0,6,4,264,2,132,0.0,66.0,66.0,2,132,0.0,66.0,66.0
40250.0,6,14,4740,7,653,6487.0,249.0,93.28571428571428,7,4087,6169.0,1514.0,583.8571428571429
20051.0,17,2,582,1,83,0.0,83.0,83.0,1,499,0.0,499.0,499.0
99318940.0,17,14,1126,7,563,16500137.0,174.0,80.42857142857143,7,563,16501545.5,174.0,80.42857142857143
108103285.0,17,5,1005,5,1005,27025821.25,201.0,201.0,0,0,0.0,0.0,0.0
50646.0,6,10,2032,5,524,12455.0,252.0,104.8,5,1508,11950.75,1236.0,301.6
153431.0,17,2,180,1,90,0.0,90.0,90.0,1,90,0.0,90.0,90.0
143841.0,17,2,180,1,90,0.0,90.0,90.0,1,90,0.0,90.0,90.0
10465121.0,6,7,478,4,272,3442891.333333333,74.0,68.0,3,206,5164205.5,74.0,68.66666666666667
16890.0,17,2,180,1,90,0.0,90.0,90.0,1,90,0.0,90.0,90.0
10625.0,17,2,582,1,83,0.0,83.0,83.0,1,499,0.0,499.0,499.0
75970.0,6,10,2032,5,524,18244.5,252.0,104.8,5,1508,18031.5,1236.0,301.6
31581.0,6,10,2032,5,524,7646.0,252.0,104.8,5,1508,7416.0,1236.0,301.6
597600.0,17,2,473,1,78,0.0,78.0,78.0,1,395,0.0,395.0,395.0
10421698.0,6,6,412,3,206,5142705.0,74.0,68.66666666666667,3,206,5142553.0,74.0,68.66666666666667
752.0,17,5,550,5,550,188.0,110.0,110.0,0,0,0.0,0.0,0.0
232942.0,6,3,337,2,214,0.0,160.0,107.0,1,123,0.0,123.0,123.0
115041635.0,6,47,3102,24,1584,4988400.0,66.0,66.0,23,1518,5150431.681818182,66.0,66.0
2997503.0,17,2,906,2,906,0.0,453.0,453.0,0,0,0.0,0.0,0.0
90046989.0,17,28,13364,28,13364,3335073.6666666665,501.0,477.2857142857143,0,0,0.0,0.0,0.0
1390456.0,6,4,276,2,128,0.0,74.0,64.0,2,148,0.0,74.0,74.0
135136409.0,17,6,1206,6,1206,27027281.8,201.0,201.0,0,0,0.0,0.0,0.0
15072001.0,17,6,2052,6,2052,3014400.2,342.0,342.0,0,0,0.0,0.0,0.0
109197576.0,6,32,2220,16,1149,7265451.4,123.0,71.8125,16,1071,7265450.4,123.0,66.9375
108098161.0,17,5,955,5,955,27024540.25,191.0,191.0,0,0,0.0,0.0,0.0
39046.0,6,14,4740,7,653,5634.666666666667,249.0,93.28571428571428,7,4087,6266.166666666667,1514.0,583.8571428571429
34886.0,6,14,4740,7,653,5272.333333333333,249.0,93.28571428571428,7,4087,4791.833333333333,1514.0,583.8571428571429
3390855.0,17,3,1026,3,1026,1695427.5,342.0,342.0,0,0,0.0,0.0,0.0
1511602.0,6,20,6434,12,1921,137418.36363636365,620.0,160.08333333333334,8,4513,177159.85714285713,1514.0,564.125
249833.0,6,3,337,2,214,0.0,160.0,107.0,1,123,0.0,123.0,123.0
227899.0,6,3,426,2,280,0.0,214.0,140.0,1,146,0.0,146.0,146.0
90766408.0,6,24,1829,13,989,7560350.5,95.0,76.07692307692308,11,840,9046469.0,95.0,76.36363636363636
108093939.0,17,5,1005,5,1005,27023484.75,201.0,201.0,0,0,0.0,0.0,0.0
2142.0,17,4,344,2,150,0.0,75.0,75.0,2,194,0.0,103.0,97.0
143980.0,17,2,180,1,90,0.0,90.0,90.0,1,90,0.0,90.0,90.0
58054.0,6,14,4740,7,653,9213.0,249.0,93.28571428571428,7,4087,9087.833333333334,1514.0,583.8571428571429
311991.0,17,4,622,4,622,103997.0,163.0,155.5,0,0,0.0,0.0,0.0
29637.0,6,14,4740,7,653,4764.166666666667,249.0,93.28571428571428,7,4087,4128.666666666667,1514.0,583.8571428571429
90259880.0,6,12,1832,8,1016,12894268.57142857,188.0,127.0,4,816,30031121.33333333,204.0,204.0
146186.0,6,3,337,2,214,0.0,160.0,107.0,1,123,0.0,123.0,123.0
232570.0,6,3,337,2,214,0.0,160.0,107.0,1,123,0.0,123.0,123.0
1175934.0,6,13,3010,8,2382,167990.57142857142,1514.0,297.75,5,628,225191.75,331.0,125.6
100556855.0,6,588,98624,291,19576,346682.2103448276,214.0,67.27147766323024,297,79048,339712.91891891893,1514.0,266.15488215488216
3791173.0,6,5,336,2,134,0.0,68.0,67.0,3,202,1526309.0,70.0,67.33333333333333
118924148.0,6,36,2596,18,1348,6995538.117647059,139.0,74.88888888888889,18,1248,6982814.529411765,123.0,69.33333333333333
2798561.0,6,2,132,1,66,0.0,66.0,66.0,1,66,0.0,66.0,66.0
90255320.0,6,14,2240,8,1016,12893617.142857144,188.0,127.0,6,1224,18018679.4,204.0,204.0
127001358.0,17,15,907,8,475,18143051.14285714,174.0,59.375,7,432,17834529.166666668,174.0,61.71428571428572
90089538.0,6,10,1440,7,828,15014923.0,188.0,118.28571428571428,3,612,30031285.5,204.0,204.0
208673.0,6,10,1221,6,636,41734.6,298.0,106.0,4,585,68280.66666666667,379.0,146.25
102085629.0,17,14,864,7,432,17000193.833333332,174.0,61.71428571428572,7,432,17000913.833333332,174.0,61.71428571428572
1170201.0,6,13,3010,8,2382,167171.57142857142,1514.0,297.75,5,628,223590.25,331.0,125.6
9088.0,17,2,582,1,83,0.0,83.0,83.0,1,499,0.0,499.0,499.0
1174785.0,6,13,3009,8,2381,167826.42857142858,1514.0,297.625,5,628,224663.5,331.0,125.6
90025894.0,17,28,13364,28,13364,3334292.3703703703,501.0,477.2857142857143,0,0,0.0,0.0,0.0
321.0,17,2,164,1,82,0.0,82.0,82.0,1,82,0.0,82.0,82.0
722.0,17,4,438,2,148,0.0,74.0,74.0,2,290,0.0,147.0,145.0
6058.0,17,4,344,2,150,0.0,75.0,75.0,2,194,0.0,103.0,97.0
32614.0,6,11,2098,6,590,4192.0,252.0,98.33333333333331,5,1508,7284.75,1236.0,301.6
0.0,6,1,54,0,0,0.0,0.0,0.0,1,54,0.0,54.0,54.0
289640.0,6,12,1373,7,714,48273.333333333336,298.0,102.0,5,659,65378.25,379.0,131.8
101319087.0,6,268,31590,134,22512,760179.3082706766,284.0,168.0,134,9078,760178.6240601504,140.0,67.74626865671642
854792.0,6,9,1096,6,625,170958.4,287.0,104.16666666666669,3,471,291196.5,331.0,157.0
299.0,17,2,168,1,76,0.0,76.0,76.0,1,92,0.0,92.0,92.0
228464.0,17,2,180,1,90,0.0,90.0,90.0,1,90,0.0,90.0,90.0
0.0,6,1,66,1,66,0.0,66.0,66.0,0,0,0.0,0.0,0.0
18834.0,6,2,145,2,145,0.0,91.0,72.5,0,0,0.0,0.0,0.0
849624.0,6,9,1267,6,796,169924.8,458.0,132.66666666666666,3,471,288491.0,331.0,157.0
333.0,17,2,166,1,75,0.0,75.0,75.0,1,91,0.0,91.0,91.0
3549117.0,6,175,142228,99,132910,36215.47959183674,1510.0,1342.5252525252524,76,9318,43295.22666666667,1510.0,122.60526315789474
26748.0,6,14,4740,7,653,4265.5,249.0,93.28571428571428,7,4087,4320.666666666667,1514.0,583.8571428571429
801658.0,6,5,1742,3,921,400829.0,785.0,307.0,2,821,0.0,753.0,410.5
105010677.0,17,14,864,7,432,17500721.5,174.0,61.71428571428572,7,432,17500166.0,174.0,61.71428571428572
0.0,6,1,66,0,0,0.0,0.0,0.0,1,66,0.0,66.0,66.0
9308.0,17,2,571,1,86,0.0,86.0,86.0,1,485,0.0,485.0,485.0
216386.0,17,2,180,1,90,0.0,90.0,90.0,1,90,0.0,90.0,90.0
325154.0,6,6,412,4,272,108384.66666666669,74.0,68.0,2,140,0.0,74.0,70.0
1026275.0,6,11,1134,6,558,205255.0,220.0,93.0,5,576,255362.5,304.0,115.2
44574.0,6,14,4740,7,653,7053.333333333333,249.0,93.28571428571428,7,4087,7260.0,1514.0,583.8571428571429
324259.0,17,4,1400,4,1400,108086.33333333331,350.0,350.0,0,0,0.0,0.0,0.0
128868546.0,6,37,2656,19,1408,7159363.666666667,139.0,74.10526315789474,18,1248,6980443.529411765,123.0,69.33333333333333
113637215.0,6,32,2236,16,1165,7561414.266666667,139.0,72.8125,16,1071,7561413.2,123.0,66.9375
301073.0,6,6,412,4,272,100357.66666666669,74.0,68.0,2,140,0.0,74.0,70.0
139301.0,6,2,132,1,66,0.0,66.0,66.0,1,66,0.0,66.0,66.0
60942825.0,6,4,268,2,132,0.0,66.0,66.0,2,136,0.0,70.0,68.0
241454.0,6,3,337,2,214,0.0,160.0,107.0,1,123,0.0,123.0,123.0
14316734.0,17,6,2052,6,2052,2863346.8,342.0,342.0,0,0,0.0,0.0,0.0
50278.0,6,14,4740,7,653,7733.5,249.0,93.28571428571428,7,4087,7512.833333333333,1514.0,583.8571428571429
15740.0,6,14,4740,7,653,2167.833333333333,249.0,93.28571428571428,7,4087,2482.1666666666665,1514.0,583.8571428571429
41551.0,6,14,4740,7,653,6806.166666666667,249.0,93.28571428571428,7,4087,6260.666666666667,1514.0,583.8571428571429
106442.0,17,2,700,2,700,0.0,350.0,350.0,0,0,0.0,0.0,0.0
100089.0,17,2,762,2,762,0.0,381.0,381.0,0,0,0.0,0.0,0.0
38831.0,6,10,2032,5,524,9479.5,252.0,104.8,5,1508,8605.75,1236.0,301.6
339.0,17,2,250,1,93,0.0,93.0,93.0,1,157,0.0,157.0,157.0
2374792.0,6,3,1604,1,753,0.0,753.0,753.0,2,851,0.0,785.0,425.5
687.0,17,2,762,2,762,0.0,381.0,381.0,0,0,0.0,0.0,0.0
216690.0,6,3,426,2,280,0.0,214.0,140.0,1,146,0.0,146.0,146.0
93789117.0,6,31,2314,16,1228,6238207.533333333,139.0,76.75,15,1086,6683792.0,123.0,72.4
314296.0,6,6,412,4,272,104765.33333333331,74.0,68.0,2,140,0.0,74.0,70.0
321875.0,17,4,1400,4,1400,107291.66666666669,350.0,350.0,0,0,0.0,0.0,0.0
3354.0,17,2,335,1,88,0.0,88.0,88.0,1,247,0.0,247.0,247.0
42890.0,6,14,4740,7,653,6800.5,249.0,93.28571428571428,7,4087,6957.166666666667,1514.0,583.8571428571429
791.0,17,4,438,2,148,0.0,74.0,74.0,2,290,0.0,147.0,145.0
117237523.0,6,215,24300,108,7350,1095677.785046729,140.0,68.05555555555556,107,16950,1086377.0,284.0,158.41121495327104
136233.0,6,13,1394,7,797,22705.5,253.0,113.85714285714286,6,597,26426.8,259.0,99.5
2930.0,17,2,224,1,76,0.0,76.0,76.0,1,148,0.0,148.0,148.0
99883512.0,17,15,5138,14,4788,6140212.153846154,342.0,342.0,1,350,0.0,350.0,350.0
50590.0,6,12,1320,6,723,9428.8,253.0,120.5,6,597,8652.8,259.0,99.5
330.0,17,2,208,1,72,0.0,72.0,72.0,1,136,0.0,136.0,136.0
120134458.0,6,13,2036,5,1020,30033614.5,204.0,204.0,8,1016,17138356.285714287,188.0,127.0
36395.0,6,10,2032,5,524,8801.75,252.0,104.8,5,1508,8155.5,1236.0,301.6
90527486.0,6,13,2036,8,1016,12932498.0,188.0,127.0,5,1020,22590301.5,204.0,204.0
301914.0,6,6,412,4,272,100638.0,74.0,68.0,2,140,0.0,74.0,70.0
90030364.0,17,28,13364,28,13364,3334457.925925926,501.0,477.2857142857143,0,0,0.0,0.0,0.0
120100685.0,6,14,2240,6,1224,24020137.0,204.0,204.0,8,1016,17133795.85714286,188.0,127.0
108104051.0,17,5,955,5,955,27026012.75,191.0,191.0,0,0,0.0,0.0,0.0
3251478.0,6,147,131049,92,123117,35730.52747252747,1510.0,1338.2282608695652,55,7932,54527.09259259259,1510.0,144.21818181818182
333.0,17,2,166,1,75,0.0,75.0,75.0,1,91,0.0,91.0,91.0
1105684.0,6,11,1134,6,558,221136.8,220.0,93.0,5,576,275345.25,304.0,115.2
135157746.0,17,6,1206,6,1206,27031549.2,201.0,201.0,0,0,0.0,0.0,0.0
38658.0,6,10,2032,5,524,9435.5,252.0,104.8,5,1508,8346.25,1236.0,301.6
232843.0,6,3,337,2,214,0.0,160.0,107.0,1,123,0.0,123.0,123.0
130147.0,6,2,132,1,66,0.0,66.0,66.0,1,66,0.0,66.0,66.0
135178059.0,17,6,1146,6,1146,27035611.8,191.0,191.0,0,0,0.0,0.0,0.0
42183.0,6,12,1328,7,797,7030.5,253.0,113.85714285714286,5,531,8869.5,259.0,106.2
64627.00000000001,6,14,4740,7,653,10629.833333333334,249.0,93.28571428571428,7,4087,10607.166666666666,1514.0,583.8571428571429
108110173.0,17,5,1005,5,1005,27027543.25,201.0,201.0,0,0,0.0,0.0,0.0
156737.0,6,3,337,2,214,0.0,160.0,107.0,1,123,0.0,123.0,123.0
318096.0,17,4,1400,4,1400,106032.0,350.0,350.0,0,0,0.0,0.0,0.0
308057.0,6,6,412,4,272,102685.66666666669,74.0,68.0,2,140,0.0,74.0,70.0
9411.0,17,2,565,1,93,0.0,93.0,93.0,1,472,0.0,472.0,472.0
148034.0,17,2,180,1,90,0.0,90.0,90.0,1,90,0.0,90.0,90.0
90257829.0,6,13,2036,8,1016,12893975.57142857,188.0,127.0,5,1020,22523335.75,204.0,204.0
207492.0,6,3,426,2,280,0.0,214.0,140.0,1,146,0.0,146.0,146.0
2264.0,17,4,344,2,150,0.0,75.0,75.0,2,194,0.0,103.0,97.0
90216475.0,6,21,1585,10,745,9997436.444444444,95.0,74.5,11,840,9001120.3,95.0,76.36363636363636
2352.0,17,4,344,2,150,0.0,75.0,75.0,2,194,0.0,103.0,97.0
33405.0,6,14,4740,7,653,4927.333333333333,249.0,93.28571428571428,7,4087,4170.833333333333,1514.0,583.8571428571429
31857.000000000004,6,14,4740,7,653,5180.166666666667,249.0,93.28571428571428,7,4087,5063.5,1514.0,583.8571428571429
45367.0,6,14,4740,7,653,7433.166666666667,249.0,93.28571428571428,7,4087,6797.166666666667,1514.0,583.8571428571429
112464401.0,6,46,3036,23,1518,5112006.0,66.0,66.0,23,1518,5112006.2727272725,66.0,66.0
100651778.0,17,12,778,6,389,20127664.6,174.0,64.83333333333333,6,389,20098153.4,174.0,64.83333333333333
5624119.0,6,5,336,2,134,0.0,68.0,67.0,3,202,1526712.0,70.0,67.33333333333333
120373656.0,6,241,27324,121,19108,1003113.8,300.0,157.91735537190084,120,8216,1002991.43697479,140.0,68.46666666666667
5621401.0,6,5,336,2,134,0.0,68.0,67.0,3,202,1525053.5,70.0,67.33333333333333
241757.0,6,3,337,2,214,0.0,160.0,107.0,1,123,0.0,123.0,123.0
1610314.0,6,4,276,2,128,0.0,74.0,64.0,2,148,0.0,74.0,74.0
66459.0,6,14,4740,7,653,10177.666666666666,249.0,93.28571428571428,7,4087,9418.5,1514.0,583.8571428571429
7317.0,17,4,344,2,150,0.0,75.0,75.0,2,194,0.0,103.0,97.0
311554.0,17,2,333,1,87,0.0,87.0,87.0,1,246,0.0,246.0,246.0
3008742.0,6,11,2106,6,598,601492.2,252.0,99.66666666666669,5,1508,2852.25,1236.0,301.6
90273066.0,6,17,1287,8,637,12896152.285714284,95.0,79.625,9,650,11248709.0,95.0,72.22222222222223
50030.0,6,10,2032,5,524,12303.75,252.0,104.8,5,1508,11580.75,1236.0,301.6
253060.0,6,10,1221,6,636,50612.0,298.0,106.0,4,585,78963.66666666667,379.0,146.25
303975.0,6,6,412,4,272,101325.0,74.0,68.0,2,140,0.0,74.0,70.0
218137.0,6,3,426,2,280,0.0,214.0,140.0,1,146,0.0,146.0,146.0
153437.0,17,2,180,1,90,0.0,90.0,90.0,1,90,0.0,90.0,90.0
108104659.0,17,5,955,5,955,27026164.75,191.0,191.0,0,0,0.0,0.0,0.0
54400.0,6,14,4740,7,653,7703.166666666667,249.0,93.28571428571428,7,4087,8911.833333333334,1514.0,583.8571428571429
33180.0,6,10,2032,5,524,8063.75,252.0,104.8,5,1508,6827.75,1236.0,301.6
143927.0,17,2,180,1,90,0.0,90.0,90.0,1,90,0.0,90.0,90.0
1288014.0,17,7,490,7,490,214669.0,70.0,70.0,0,0,0.0,0.0,0.0
33505.0,6,14,4740,7,653,5297.666666666667,249.0,93.28571428571428,7,4087,5389.0,1514.0,583.8571428571429
245588.0,6,3,337,2,214,0.0,160.0,107.0,1,123,0.0,123.0,123.0
157426.0,6,3,337,2,214,0.0,160.0,107.0,1,123,0.0,123.0,123.0
90296103.0,6,16,1192,8,596,12892320.57142857,95.0,74.5,8,596,12897987.714285716,95.0,74.5
15894975.0,17,10,3500,10,3500,1766108.3333333333,350.0,350.0,0,0,0.0,0.0,0.0
306621.0,6,6,412,4,272,102207.0,74.0,68.0,2,140,0.0,74.0,70.0
208989.0,6,3,426,2,280,0.0,214.0,140.0,1,146,0.0,146.0,146.0
46996.0,6,14,4740,7,653,7661.5,249.0,93.28571428571428,7,4087,7625.5,1514.0,583.8571428571429
1989.0,17,4,344,2,150,0.0,75.0,75.0,2,194,0.0,103.0,97.0
37026.0,6,11,2098,6,590,4526.2,252.0,98.33333333333331,5,1508,8807.5,1236.0,301.6
103629.0,17,2,286,2,286,0.0,143.0,143.0,0,0,0.0,0.0,0.0
26181.0,6,10,2032,5,524,6157.75,252.0,104.8,5,1508,6163.75,1236.0,301.6
61419.0,6,10,2032,5,524,15099.5,252.0,104.8,5,1508,15000.25,1236.0,301.6
614892.0,17,3,551,2,156,0.0,78.0,78.0,1,395,0.0,395.0,395.0
5633125.0,6,5,336,2,134,0.0,68.0,67.0,3,202,1530981.0,70.0,67.33333333333333
2823886.0,6,12,2172,7,664,470472.3333333333,252.0,94.85714285714286,5,1508,1867.75,1236.0,301.6
135133560.0,17,6,1146,6,1146,27026712.0,191.0,191.0,0,0,0.0,0.0,0.0
304215.0,17,2,333,1,87,0.0,87.0,87.0,1,246,0.0,246.0,246.0
98750231.0,6,29,2052,15,1089,7038169.642857143,123.0,72.6,14,963,7579569.538461538,123.0,68.78571428571429
2288330.0,6,49,23728,25,19797,95347.08333333331,1514.0,791.88,24,3931,89458.0,1514.0,163.79166666666666
311481.0,17,4,1400,4,1400,103827.0,350.0,350.0,0,0,0.0,0.0,0.0
366.0,17,2,267,1,83,0.0,83.0,83.0,1,184,0.0,184.0,184.0
301299.0,6,6,412,4,272,100433.0,74.0,68.0,2,140,0.0,74.0,70.0
42671.0,6,10,2032,5,524,7643.25,252.0,104.8,5,1508,10105.0,1236.0,301.6
58092.0,6,13,1394,7,797,9291.666666666666,253.0,113.85714285714286,6,597,11238.4,259.0,99.5
108110149.0,17,5,955,5,955,27027537.25,191.0,191.0,0,0,0.0,0.0,0.0
90029093.0,17,28,13364,28,13364,3334410.851851852,501.0,477.2857142857143,0,0,0.0,0.0,0.0
11577.0,17,4,823,2,163,0.0,89.0,81.5,2,660,0.0,443.0,330.0
108098339.0,17,5,1005,5,1005,27024584.75,201.0,201.0,0,0,0.0,0.0,0.0
234118.0,6,3,337,2,214,0.0,160.0,107.0,1,123,0.0,123.0,123.0
0.0,17,1,55,1,55,0.0,55.0,55.0,0,0,0.0,0.0,0.0
122688022.0,6,49,3234,25,1650,5112000.916666667,66.0,66.0,24,1584,5049919.260869565,66.0,66.0
121006530.0,17,14,864,8,475,17286647.14285714,174.0,59.375,6,389,16400163.0,174.0,64.83333333333333
313.0,17,2,174,1,79,0.0,79.0,79.0,1,95,0.0,95.0,95.0
54232.0,6,10,2032,5,524,10848.25,252.0,104.8,5,1508,13267.75,1236.0,301.6
211072.0,6,10,1221,6,636,42214.4,298.0,106.0,4,585,69493.0,379.0,146.25
22497.0,6,10,2032,5,524,5385.25,252.0,104.8,5,1508,5349.0,1236.0,301.6
108100889.0,17,5,1005,5,1005,27025222.25,201.0,201.0,0,0,0.0,0.0,0.0
108104567.0,17,5,955,5,955,27026141.75,191.0,191.0,0,0,0.0,0.0,0.0
111000918.0,17,13,821,7,432,18500153.0,174.0,61.71428571428572,6,389,18200549.2,174.0,64.83333333333333
108103130.0,17,5,955,5,955,27025782.5,191.0,191.0,0,0,0.0,0.0,0.0
108031.0,17,2,286,2,286,0.0,143.0,143.0,0,0,0.0,0.0,0.0
5014373.0,17,4,849,2,166,0.0,83.0,83.0,2,683,0.0,499.0,341.5
121845816.0,17,14,864,7,432,17000880.333333332,174.0,61.71428571428572,7,432,17000161.833333332,174.0,61.71428571428572
45862.0,6,13,1394,7,797,6330.833333333333,253.0,113.85714285714286,6,597,8460.0,259.0,99.5
108110740.0,17,5,1005,5,1005,27027685.0,201.0,201.0,0,0,0.0,0.0,0.0
21685.0,17,2,582,1,83,0.0,83.0,83.0,1,499,0.0,499.0,499.0
228487.0,17,2,180,1,90,0.0,90.0,90.0,1,90,0.0,90.0,90.0
150001646.0,17,36,17126,36,17126,4285761.314285714,501.0,475.72222222222223,0,0,0.0,0.0,0.0
122870785.0,17,14,864,7,432,17168259.666666668,174.0,61.71428571428572,7,432,17166939.5,174.0,61.71428571428572
19668.0,6,10,2032,5,524,4658.0,252.0,104.8,5,1508,4644.5,1236.0,301.6
0.0,17,1,55,1,55,0.0,55.0,55.0,0,0,0.0,0.0,0.0
37556.0,6,14,4740,7,653,6089.5,249.0,93.28571428571428,7,4087,6070.0,1514.0,583.8571428571429
202109.0,17,4,6056,4,6056,67369.66666666667,1514.0,1514.0,0,0,0.0,0.0,0.0
120000005.0,6,17,1287,9,691,15000000.625,95.0,76.77777777777777,8,596,12900085.42857143,95.0,74.5
2487104.0,6,25,7573,14,3735,191315.6923076923,1514.0,266.7857142857143,11,3838,223551.0,1514.0,348.90909090909093
3060.0,17,2,224,1,76,0.0,76.0,76.0,1,148,0.0,148.0,148.0
303123.0,6,2,132,1,66,0.0,66.0,66.0,1,66,0.0,66.0,66.0
32945.0,6,10,1810,5,358,4351.75,130.0,71.6,5,1452,7631.0,1224.0,290.4
218038.0,6,3,426,2,280,0.0,214.0,140.0,1,146,0.0,146.0,146.0
90590679.0,6,15,2444,8,1016,12941525.57142857,188.0,127.0,7,1428,15070135.333333334,204.0,204.0
318875.0,6,6,412,4,272,106291.66666666669,74.0,68.0,2,140,0.0,74.0,70.0
10436758.0,6,7,478,4,272,3433587.0,74.0,68.0,3,206,5150248.5,74.0,68.66666666666667
324.0,17,2,166,1,75,0.0,75.0,75.0,1,91,0.0,91.0,91.0
216828.0,6,3,426,2,280,0.0,214.0,140.0,1,146,0.0,146.0,146.0
2801076.0,6,2,132,1,66,0.0,66.0,66.0,1,66,0.0,66.0,66.0
2597942.0,6,2,132,1,66,0.0,66.0,66.0,1,66,0.0,66.0,66.0
10448752.0,6,7,478,4,272,3437236.333333333,74.0,68.0,3,206,5155730.5,74.0,68.66666666666667
90259315.0,6,12,1832,8,1016,12894187.857142856,188.0,127.0,4,816,30031387.0,204.0,204.0
13124.0,17,2,180,1,90,0.0,90.0,90.0,1,90,0.0,90.0,90.0
10560866.0,6,7,478,4,272,3473284.6666666665,74.0,68.0,3,206,5209846.5,74.0,68.66666666666667
203281.0,17,4,6056,4,6056,67760.33333333333,1514.0,1514.0,0,0,0.0,0.0,0.0
14507282.0,17,6,2052,6,2052,2901456.4,342.0,342.0,0,0,0.0,0.0,0.0
46444.0,6,14,4740,7,653,7618.333333333333,249.0,93.28571428571428,7,4087,6234.666666666667,1514.0,583.8571428571429
528215.0,6,5,336,2,134,0.0,68.0,67.0,3,202,208827.5,70.0,67.33333333333333
120036500.0,17,28,13364,28,13364,4445796.296296297,501.0,477.2857142857143,0,0,0.0,0.0,0.0
102187.0,17,2,762,2,762,0.0,381.0,381.0,0,0,0.0,0.0,0.0
304886.0,6,6,412,4,272,101628.66666666669,74.0,68.0,2,140,0.0,74.0,70.0
99112.0,17,2,762,2,762,0.0,381.0,381.0,0,0,0.0,0.0,0.0
61555.0,6,14,4740,7,653,10133.833333333334,249.0,93.28571428571428,7,4087,9694.0,1514.0,583.8571428571429
33627.0,6,10,2032,5,524,8168.0,252.0,104.8,5,1508,7841.25,1236.0,301.6
136190.0,6,2,132,1,66,0.0,66.0,66.0,1,66,0.0,66.0,66.0
50035.0,6,14,4740,7,653,7817.166666666667,249.0,93.28571428571428,7,4087,7898.666666666667,1514.0,583.8571428571429
149756306.0,6,19,2826,11,1458,14975630.6,188.0,132.54545454545453,8,1368,17122123.0,204.0,171.0
128008685.0,17,15,907,8,475,18286955.0,174.0,59.375,7,432,18000064.666666668,174.0,61.71428571428572
196990.0,17,2,180,1,90,0.0,90.0,90.0,1,90,0.0,90.0,90.0
1412.0,17,4,820,2,156,0.0,78.0,78.0,2,664,0.0,332.0,332.0
0.0,6,1,66,1,66,0.0,66.0,66.0,0,0,0.0,0.0,0.0
228134.0,17,2,180,1,90,0.0,90.0,90.0,1,90,0.0,90.0,90.0
139885.0,17,4,1524,4,1524,46628.333333333336,381.0,381.0,0,0,0.0,0.0,0.0
38352.0,6,13,1386,7,789,6123.166666666667,253.0,112.71428571428572,6,597,6604.6,259.0,99.5
36763.0,6,14,4740,7,653,5615.5,249.0,93.28571428571428,7,4087,5602.833333333333,1514.0,583.8571428571429
120955096.0,6,32,2226,17,1209,7559693.5,123.0,71.11764705882354,15,1017,7911046.0,123.0,67.8
120035051.0,17,29,13785,29,13785,4286966.107142857,501.0,475.3448275862069,0,0,0.0,0.0,0.0
207366.0,6,3,426,2,280,0.0,214.0,140.0,1,146,0.0,146.0,146.0
4211.0,17,2,582,1,83,0.0,83.0,83.0,1,499,0.0,499.0,499.0
901167.0,6,10,1262,6,725,180233.4,387.0,120.83333333333331,4,537,208503.66666666663,331.0,134.25
108099877.0,17,5,1005,5,1005,27024969.25,201.0,201.0,0,0,0.0,0.0,0.0
90919471.0,6,21,1585,11,840,9091001.1,95.0,76.36363636363636,10,745,10100678.333333334,95.0,74.5
1432476.0,17,16,1120,16,1120,95498.4,70.0,70.0,0,0,0.0,0.0,0.0
2800820.0,6,2,132,1,66,0.0,66.0,66.0,1,66,0.0,66.0,66.0
344.0,17,2,267,1,83,0.0,83.0,83.0,1,184,0.0,184.0,184.0
93501862.0,6,258,42706,129,8810,724043.2734375,214.0,68.29457364341086,129,33896,725270.3671875,1514.0,262.7596899224806
1406861.0,6,8,602,5,404,326339.25,103.0,80.8,3,198,204290.5,66.0,66.0
228468.0,17,2,180,1,90,0.0,90.0,90.0,1,90,0.0,90.0,90.0
90303594.0,6,19,1436,10,745,10028553.666666666,95.0,74.5,9,691,11285975.625,95.0,76.77777777777777
30279.0,6,14,4740,7,653,4840.333333333333,249.0,93.28571428571428,7,4087,4907.0,1514.0,583.8571428571429
1475663.0,17,16,1120,16,1120,98377.53333333334,70.0,70.0,0,0,0.0,0.0,0.0
209425.0,17,2,180,1,90,0.0,90.0,90.0,1,90,0.0,90.0,90.0
2735963.0,6,3,1777,2,951,0.0,885.0,475.5,1,826,0.0,826.0,826.0
837085.0,6,9,1118,6,586,167417.0,248.0,97.66666666666669,3,532,282167.0,392.0,177.33333333333334
2405.0,17,4,344,2,150,0.0,75.0,75.0,2,194,0.0,103.0,97.0
2039.0,17,4,344,2,150,0.0,75.0,75.0,2,194,0.0,103.0,97.0
219288.0,6,10,1221,6,636,43857.6,298.0,106.0,4,585,71612.33333333333,379.0,146.25
284187.0,17,2,363,1,79,0.0,79.0,79.0,1,284,0.0,284.0,284.0
2848871.0,6,3,204,2,136,0.0,70.0,68.0,1,68,0.0,68.0,68.0
171697.0,17,2,180,1,90,0.0,90.0,90.0,1,90,0.0,90.0,90.0
875670.0,6,10,1335,6,798,175134.0,460.0,133.0,4,537,200015.3333333333,331.0,134.25
492.00000000000006,17,2,166,1,75,0.0,75.0,75.0,1,91,0.0,91.0,91.0
14046384.0,17,6,2052,6,2052,2809276.8,342.0,342.0,0,0,0.0,0.0,0.0
202269.0,17,4,6056,4,6056,67423.0,1514.0,1514.0,0,0,0.0,0.0,0.0
0.0,17,1,350,1,350,0.0,350.0,350.0,0,0,0.0,0.0,0.0
2592652.0,6,2,132,1,66,0.0,66.0,66.0,1,66,0.0,66.0,66.0
32932.0,6,10,2032,5,524,8002.25,252.0,104.8,5,1508,6704.5,1236.0,301.6
307501.0,17,4,571,2,148,0.0,74.0,74.0,2,423,0.0,280.0,211.5
301338.0,6,6,412,4,272,100446.0,74.0,68.0,2,140,0.0,74.0,70.0
120013965.0,6,18,1506,8,761,16116457.42857143,219.0,95.125,10,745,13308594.222222222,95.0,74.5
225017.0,17,2,180,1,90,0.0,90.0,90.0,1,90,0.0,90.0,90.0
2632298.0,17,2,180,1,90,0.0,90.0,90.0,1,90,0.0,90.0,90.0
352.0,17,2,174,1,79,0.0,79.0,79.0,1,95,0.0,95.0,95.0
90031249.0,17,28,13364,28,13364,3334490.703703704,501.0,477.2857142857143,0,0,0.0,0.0,0.0
51246.0,17,2,180,1,90,0.0,90.0,90.0,1,90,0.0,90.0,90.0
0.0,17,1,55,1,55,0.0,55.0,55.0,0,0,0.0,0.0,0.0
119461548.0,6,223,25044,112,7688,1076230.162162162,140.0,68.64285714285714,111,17356,1076557.6454545455,284.0,156.36036036036035
122314591.0,6,48,3168,24,1584,5005256.130434782,66.0,66.0,24,1584,5202490.304347826,66.0,66.0
233108.0,6,3,337,2,214,0.0,160.0,107.0,1,123,0.0,123.0,123.0
287128.0,17,2,359,1,75,0.0,75.0,75.0,1,284,0.0,284.0,284.0
43047.0,6,10,2032,5,524,10162.0,252.0,104.8,5,1508,10448.25,1236.0,301.6
108105083.0,17,5,955,5,955,27026270.75,191.0,191.0,0,0,0.0,0.0,0.0
219558.0,6,3,426,2,280,0.0,214.0,140.0,1,146,0.0,146.0,146.0
112297.0,17,4,1400,4,1400,37432.333333333336,350.0,350.0,0,0,0.0,0.0,0.0
46742.0,6,10,2032,5,524,11428.5,252.0,104.8,5,1508,10460.25,1236.0,301.6
233259.0,6,4,439,2,238,0.0,172.0,119.0,2,201,0.0,135.0,100.5
297.0,17,2,174,1,79,0.0,79.0,79.0,1,95,0.0,95.0,95.0
301049.0,6,6,412,4,272,100349.66666666669,74.0,68.0,2,140,0.0,74.0,70.0
224393.0,6,10,1221,6,636,44878.6,298.0,106.0,4,585,73573.66666666667,379.0,146.25
206381.0,6,3,426,2,280,0.0,214.0,140.0,1,146,0.0,146.0,146.0
308694.0,6,6,412,4,272,102898.0,74.0,68.0,2,140,0.0,74.0,70.0
53942.0,6,10,2032,5,524,12382.75,252.0,104.8,5,1508,10340.25,1236.0,301.6
90261357.0,6,16,1192,8,596,12857951.0,95.0,74.5,8,596,12860380.0,95.0,74.5
90079975.0,17,28,13364,28,13364,3336295.3703703703,501.0,477.2857142857143,0,0,0.0,0.0,0.0
217479.0,6,3,426,2,280,0.0,214.0,140.0,1,146,0.0,146.0,146.0
2422.0,17,4,344,2,150,0.0,75.0,75.0,2,194,0.0,103.0,97.0
248857.0,17,4,6056,4,6056,82952.33333333333,1514.0,1514.0,0,0,0.0,0.0,0.0
120172.0,17,2,180,1,70,0.0,70.0,70.0,1,110,0.0,110.0,110.0
243183.0,17,2,180,1,90,0.0,90.0,90.0,1,90,0.0,90.0,90.0
90013858.0,17,28,13364,28,13364,3333846.592592593,501.0,477.2857142857143,0,0,0.0,0.0,0.0
32735.0,6,10,2032,5,524,7943.0,252.0,104.8,5,1508,7718.0,1236.0,301.6
1989.0,17,4,344,2,150,0.0,75.0,75.0,2,194,0.0,103.0,97.0
207379.0,6,3,426,2,280,0.0,214.0,140.0,1,146,0.0,146.0,146.0
309638.0,17,4,1400,4,1400,103212.66666666669,350.0,350.0,0,0,0.0,0.0,0.0
103700.0,17,2,286,2,286,0.0,143.0,143.0,0,0,0.0,0.0,0.0
32439.000000000004,6,14,4740,7,653,5222.5,249.0,93.28571428571428,7,4087,5221.0,1514.0,583.8571428571429
33743212.0,6,7,1874,3,887,15472168.5,753.0,295.6666666666667,4,987,10381351.333333334,785.0,246.75
34688263.0,6,5,336,2,134,0.0,68.0,67.0,3,202,17326043.0,70.0,67.33333333333333
93986274.0,6,39,2574,20,1320,4946633.157894737,66.0,66.0,19,1254,5143997.833333333,66.0,66.0
117600194.0,6,48,3168,24,1584,5113051.913043479,66.0,66.0,24,1584,5099953.478260869,66.0,66.0
319300.0,17,4,1400,4,1400,106433.33333333331,350.0,350.0,0,0,0.0,0.0,0.0
90564217.0,6,26,1746,13,906,7529034.416666667,123.0,69.6923076923077,13,840,7529036.916666667,123.0,64.61538461538461
2589625.0,6,2,132,1,66,0.0,66.0,66.0,1,66,0.0,66.0,66.0
245629.0,6,3,337,2,214,0.0,160.0,107.0,1,123,0.0,123.0,123.0
147907.0,17,2,180,1,90,0.0,90.0,90.0,1,90,0.0,90.0,90.0
100508818.0,17,14,864,7,432,16667177.666666666,174.0,61.71428571428572,7,432,16666834.166666666,174.0,61.71428571428572
90256648.0,6,12,1832,8,1016,12893806.857142856,188.0,127.0,4,816,30031836.33333333,204.0,204.0
113520234.0,6,46,3036,23,1518,5159999.136363637,66.0,66.0,23,1518,5159999.636363637,66.0,66.0
2085406.0,6,25,7611,13,2516,173783.83333333334,1034.0,193.53846153846155,12,5095,161569.63636363635,1510.0,424.5833333333333
103249000.0,6,29,2062,15,1017,7374928.571428572,123.0,67.8,14,1045,7364203.230769231,139.0,74.64285714285714
108108562.0,17,5,1005,5,1005,27027140.5,201.0,201.0,0,0,0.0,0.0,0.0
83.0,17,2,762,2,762,0.0,381.0,381.0,0,0,0.0,0.0,0.0
290122.0,17,2,180,1,90,0.0,90.0,90.0,1,90,0.0,90.0,90.0
32676.0,6,14,4740,7,653,4786.166666666667,249.0,93.28571428571428,7,4087,5169.333333333333,1514.0,583.8571428571429
203733.0,17,2,762,2,762,0.0,381.0,381.0,0,0,0.0,0.0,0.0
21214.0,6,14,4740,7,653,3298.6666666666665,249.0,93.28571428571428,7,4087,3402.0,1514.0,583.8571428571429
24649.0,6,10,2032,5,524,5759.5,252.0,104.8,5,1508,5892.75,1236.0,301.6
228274.0,17,2,180,1,90,0.0,90.0,90.0,1,90,0.0,90.0,90.0
232998.0,6,3,373,2,238,0.0,172.0,119.0,1,135,0.0,135.0,135.0
246143.0,6,3,337,2,214,0.0,160.0,107.0,1,123,0.0,123.0,123.0
44000457.0,17,7,563,4,303,14666819.0,174.0,75.75,3,260,19691435.5,174.0,86.66666666666667
10911857.0,6,7,478,3,206,5387555.0,74.0,68.66666666666667,4,272,3591642.333333333,74.0,68.0
135140807.0,17,6,1206,6,1206,27028161.4,201.0,201.0,0,0,0.0,0.0,0.0
205857.0,17,2,180,1,90,0.0,90.0,90.0,1,90,0.0,90.0,90.0
108101023.0,17,5,955,5,955,27025255.75,191.0,191.0,0,0,0.0,0.0,0.0
10092.0,17,2,582,1,83,0.0,83.0,83.0,1,499,0.0,499.0,499.0
322225.0,17,4,1400,4,1400,107408.33333333331,350.0,350.0,0,0,0.0,0.0,0.0
91944450.0,6,841,174838,428,146976,214822.0983606557,1514.0,343.4018691588785,413,27862,222643.5266990291,214.0,67.46246973365618
146185.0,6,3,337,2,214,0.0,160.0,107.0,1,123,0.0,123.0,123.0
91169988.0,6,164,18556,82,12996,1122884.7283950618,284.0,158.4878048780488,82,5560,1122884.827160494,140.0,67.8048780487805
46158.0,6,14,4740,7,653,7560.333333333333,249.0,93.28571428571428,7,4087,6833.833333333333,1514.0,583.8571428571429
135135591.0,17,6,1206,6,1206,27027118.2,201.0,201.0,0,0,0.0,0.0,0.0
4081144.0,17,2,876,2,876,0.0,438.0,438.0,0,0,0.0,0.0,0.0
3841319.0,6,5,336,2,134,0.0,68.0,67.0,3,202,532837.5,70.0,67.33333333333333
310251.0,6,3,202,2,128,0.0,74.0,64.0,1,74,0.0,74.0,74.0
210565.0,17,2,180,1,90,0.0,90.0,90.0,1,90,0.0,90.0,90.0
24361.0,6,11,2098,6,590,4683.6,252.0,98.33333333333331,5,1508,5509.75,1236.0,301.6
153504.0,17,2,180,1,90,0.0,90.0,90.0,1,90,0.0,90.0,90.0
135131810.0,17,6,1206,6,1206,27026362.0,201.0,201.0,0,0,0.0,0.0,0.0
233686.0,6,3,337,2,214,0.0,160.0,107.0,1,123,0.0,123.0,123.0
108105921.0,17,5,1005,5,1005,27026480.25,201.0,201.0,0,0,0.0,0.0,0.0
103333.0,17,2,286,2,286,0.0,143.0,143.0,0,0,0.0,0.0,0.0
2311.0,17,4,344,2,150,0.0,75.0,75.0,2,194,0.0,103.0,97.0
223331.0,17,2,414,1,88,0.0,88.0,88.0,1,326,0.0,326.0,326.0
97548082.0,17,12,1040,6,520,15600132.6,174.0,86.66666666666667,6,520,15600982.8,174.0,86.66666666666667
105918.0,17,2,700,2,700,0.0,350.0,350.0,0,0,0.0,0.0,0.0
216503.0,17,2,180,1,90,0.0,90.0,90.0,1,90,0.0,90.0,90.0
2479812.0,6,3,1602,2,850,0.0,784.0,425.0,1,752,0.0,752.0,752.0
90297006.0,6,16,1192,8,596,12893766.714285716,95.0,74.5,8,596,12898225.42857143,95.0,74.5
211189.0,17,2,180,1,90,0.0,90.0,90.0,1,90,0.0,90.0,90.0
120254466.0,6,241,27260,121,19118,1002120.55,284.0,158.0,120,8142,1002863.3613445378,140.0,67.85
197057.0,17,2,180,1,90,0.0,90.0,90.0,1,90,0.0,90.0,90.0
160.0,17,2,3028,2,3028,0.0,1514.0,1514.0,0,0,0.0,0.0,0.0
120236473.0,6,210,23758,105,7226,1148036.9807692308,140.0,68.81904761904762,105,16532,1148346.0673076925,284.0,157.44761904761904
29058.0,6,14,4740,7,653,3548.333333333333,249.0,93.28571428571428,7,4087,4542.833333333333,1514.0,583.8571428571429
2329.0,17,4,344,2,150,0.0,75.0,75.0,2,194,0.0,103.0,97.0
60434.0,6,14,4740,7,653,9218.166666666666,249.0,93.28571428571428,7,4087,9432.5,1514.0,583.8571428571429
100093161.0,6,182,20538,91,14310,1109755.8444444444,284.0,157.25274725274724,91,6228,1109754.9222222222,140.0,68.43956043956044
118882226.0,6,37,2656,19,1408,6592573.666666667,139.0,74.10526315789474,18,1248,6980366.764705882,123.0,69.33333333333333
1314553.0,6,4,264,2,132,0.0,66.0,66.0,2,132,0.0,66.0,66.0
120053272.0,17,29,13785,29,13785,4287616.857142857,501.0,475.3448275862069,0,0,0.0,0.0,0.0
320171.0,17,4,1400,4,1400,106723.66666666669,350.0,350.0,0,0,0.0,0.0,0.0
298154.0,6,6,412,4,272,99384.66666666669,74.0,68.0,2,140,0.0,74.0,70.0
326.0,17,2,166,1,75,0.0,75.0,75.0,1,91,0.0,91.0,91.0
55496.0,6,14,4740,7,653,8066.166666666667,249.0,93.28571428571428,7,4087,8294.333333333334,1514.0,583.8571428571429
2847.0,17,2,224,1,76,0.0,76.0,76.0,1,148,0.0,148.0,148.0
108111698.0,17,5,1005,5,1005,27027924.5,201.0,201.0,0,0,0.0,0.0,0.0
219576.0,17,4,1400,4,1400,73192.0,350.0,350.0,0,0,0.0,0.0,0.0
604648.0,17,2,346,1,78,0.0,78.0,78.0,1,268,0.0,268.0,268.0
17466.0,17,2,614,1,72,0.0,72.0,72.0,1,542,0.0,542.0,542.0
2231555.0,6,25,7610,13,2516,183812.66666666663,1034.0,193.53846153846155,12,5094,174589.18181818182,1510.0,424.5
119497100.0,6,230,26010,115,18198,1046332.9736842106,284.0,158.24347826086955,115,7812,1046332.7894736842,140.0,67.9304347826087
106546.0,17,2,286,2,286,0.0,143.0,143.0,0,0,0.0,0.0,0.0
120053848.0,17,28,13364,28,13364,4446438.814814814,501.0,477.2857142857143,0,0,0.0,0.0,0.0
22202.0,6,10,2032,5,524,5313.0,252.0,104.8,5,1508,5205.0,1236.0,301.6
228360.0,17,2,180,1,90,0.0,90.0,90.0,1,90,0.0,90.0,90.0
118053394.0,6,47,3102,23,1518,5144001.090909091,66.0,66.0,24,1584,5132742.347826087,66.0,66.0
327070.0,17,4,1400,4,1400,109023.33333333331,350.0,350.0,0,0,0.0,0.0,0.0
90694786.0,6,21,1585,10,745,10077198.444444444,95.0,74.5,11,840,9043537.3,95.0,76.36363636363636
120425584.0,6,279,31584,140,22188,866371.1079136691,284.0,158.4857142857143,139,9396,865172.7028985508,140.0,67.59712230215827
12196.0,17,4,823,2,163,0.0,89.0,81.5,2,660,0.0,443.0,330.0
21659.0,6,11,2098,6,590,4143.4,252.0,98.33333333333331,5,1508,4559.0,1236.0,301.6
2807539.0,6,2,132,1,66,0.0,66.0,66.0,1,66,0.0,66.0,66.0
0.0,6,1,54,0,0,0.0,0.0,0.0,1,54,0.0,54.0,54.0
120005859.0,6,762,117388,381,91872,315263.2710526316,1514.0,241.13385826771653,381,25516,315263.56052631576,214.0,66.97112860892389
121226.0,6,3,337,2,214,0.0,160.0,107.0,1,123,0.0,123.0,123.0
54625.0,6,14,4740,7,653,8780.833333333334,249.0,93.28571428571428,7,4087,8512.666666666666,1514.0,583.8571428571429
114896602.0,6,48,3168,24,1584,4995504.434782608,66.0,66.0,24,1584,4981209.260869565,66.0,66.0
206020.0,6,3,426,2,280,0.0,214.0,140.0,1,146,0.0,146.0,146.0
250762.0,6,3,337,2,214,0.0,160.0,107.0,1,123,0.0,123.0,123.0
135131673.0,17,6,1206,6,1206,27026334.6,201.0,201.0,0,0,0.0,0.0,0.0
10096.0,6,10,1067,5,536,2288.0,264.0,107.2,5,531,2293.5,259.0,106.2
149619.0,17,2,180,1,90,0.0,90.0,90.0,1,90,0.0,90.0,90.0
206038.0,6,3,426,2,280,0.0,214.0,140.0,1,146,0.0,146.0,146.0
121268506.0,6,34,2551,18,1411,7133441.529411765,139.0,78.38888888888889,16,1140,7431425.866666666,123.0,71.25
106063.0,17,2,286,2,286,0.0,143.0,143.0,0,0,0.0,0.0,0.0
23218.0,6,10,2032,5,524,5171.5,252.0,104.8,5,1508,5313.75,1236.0,301.6
1279122.0,17,5,961,3,234,639374.5,78.0,78.0,2,727,0.0,395.0,363.5
828.0,17,4,438,2,148,0.0,74.0,74.0,2,290,0.0,147.0,145.0
53018.0,17,2,180,1,90,0.0,90.0,90.0,1,90,0.0,90.0,90.0
14378.0,17,4,704,2,148,0.0,74.0,74.0,2,556,0.0,280.0,278.0
10451956.0,6,7,478,4,272,3438665.0,74.0,68.0,3,206,5157917.0,74.0,68.66666666666667
91883834.0,6,26,1762,13,922,7639005.75,139.0,70.92307692307692,13,840,7639004.25,123.0,64.61538461538461
215890.0,6,3,426,2,280,0.0,214.0,140.0,1,146,0.0,146.0,146.0
104575.0,17,2,286,2,286,0.0,143.0,143.0,0,0,0.0,0.0,0.0
305435.0,6,6,412,4,272,101811.66666666669,74.0,68.0,2,140,0.0,74.0,70.0
147903.0,17,2,180,1,90,0.0,90.0,90.0,1,90,0.0,90.0,90.0
0.0,6,1,66,1,66,0.0,66.0,66.0,0,0,0.0,0.0,0.0
105383592.0,6,31,2229,16,1140,7025545.733333333,123.0,71.25,15,1089,7527295.071428572,123.0,72.6
110051.0,17,2,286,2,286,0.0,143.0,143.0,0,0,0.0,0.0,0.0
2314.0,17,4,344,2,150,0.0,75.0,75.0,2,194,0.0,103.0,97.0
1706549.0,17,3,1026,3,1026,853274.5,342.0,342.0,0,0,0.0,0.0,0.0
2412.0,17,4,344,2,150,0.0,75.0,75.0,2,194,0.0,103.0,97.0
59924.0,6,12,1320,6,723,11574.2,253.0,120.5,6,597,9116.6,259.0,99.5
50878.0,6,14,4740,7,653,5415.5,249.0,93.28571428571428,7,4087,7852.166666666667,1514.0,583.8571428571429
108114124.0,17,5,955,5,955,27028531.0,191.0,191.0,0,0,0.0,0.0,0.0
206089.0,6,3,426,2,280,0.0,214.0,140.0,1,146,0.0,146.0,146.0
203746.0,17,2,180,1,90,0.0,90.0,90.0,1,90,0.0,90.0,90.0
196772.0,17,2,180,1,90,0.0,90.0,90.0,1,90,0.0,90.0,90.0
2345795.0,6,25,7573,14,3735,180445.7692307692,1514.0,266.7857142857143,11,3838,207920.3,1514.0,348.90909090909093
143803.0,17,2,180,1,90,0.0,90.0,90.0,1,90,0.0,90.0,90.0
53208.0,6,11,2098,6,590,10464.8,252.0,98.33333333333331,5,1508,12761.75,1236.0,301.6
10469723.0,6,7,478,4,272,3443209.333333333,74.0,68.0,3,206,5164680.0,74.0,68.66666666666667
242063.0,6,3,337,2,214,0.0,160.0,107.0,1,123,0.0,123.0,123.0
2990.0,17,2,224,1,76,0.0,76.0,76.0,1,148,0.0,148.0,148.0
137197.0,6,2,132,1,66,0.0,66.0,66.0,1,66,0.0,66.0,66.0
108108772.0,17,5,955,5,955,27027193.0,191.0,191.0,0,0,0.0,0.0,0.0
35359.0,6,14,4740,7,653,5704.333333333333,249.0,93.28571428571428,7,4087,5301.0,1514.0,583.8571428571429
108105084.0,17,5,955,5,955,27026271.0,191.0,191.0,0,0,0.0,0.0,0.0
794239.0,6,6,758,3,410,289789.5,172.0,136.66666666666666,3,348,281828.5,135.0,116.0
5007734.0,17,4,849,2,166,0.0,83.0,83.0,2,683,0.0,499.0,341.5
135156124.0,17,6,1206,6,1206,27031224.8,201.0,201.0,0,0,0.0,0.0,0.0
14655029.0,6,20,1607,10,975,1592485.3333333333,315.0,97.5,10,632,1592643.111111111,78.0,63.2
111001013.0,17,13,821,7,432,18500168.83333333,174.0,61.71428571428572,6,389,18201058.4,174.0,64.83333333333333
241247.0,6,3,337,2,214,0.0,160.0,107.0,1,123,0.0,123.0,123.0
506140.00000000006,6,4,270,2,134,0.0,68.0,67.0,2,136,0.0,70.0,68.0
146728.0,6,3,337,2,214,0.0,160.0,107.0,1,123,0.0,123.0,123.0
145059.0,6,10,1066,5,490,35815.5,218.0,98.0,5,576,35588.0,304.0,115.2
347.0,17,2,160,1,80,0.0,80.0,80.0,1,80,0.0,80.0,80.0
0.0,6,1,66,1,66,0.0,66.0,66.0,0,0,0.0,0.0,0.0
185196.0,6,12,1447,6,816,36617.4,291.0,136.0,6,631,34994.6,293.0,105.16666666666669
26662371.0,17,5,1718,4,1368,823534.6666666666,342.0,342.0,1,350,0.0,350.0,350.0
120226235.0,6,250,28426,125,8472,963034.9838709678,140.0,67.776,125,19954,962868.6532258064,284.0,159.632
108707054.0,6,31,2166,16,1149,7247136.933333334,123.0,71.8125,15,1017,7750157.214285715,123.0,67.8
281979.0,17,2,363,1,79,0.0,79.0,79.0,1,284,0.0,284.0,284.0
90257520.0,6,12,1832,8,1016,12893931.42857143,188.0,127.0,4,816,30030816.666666668,204.0,204.0
204020.0,17,2,180,1,90,0.0,90.0,90.0,1,90,0.0,90.0,90.0
146108.0,6,3,337,2,214,0.0,160.0,107.0,1,123,0.0,123.0,123.0
118347375.0,6,207,23268,104,7086,1149003.640776699,140.0,68.13461538461539,103,16182,1139768.637254902,284.0,157.10679611650485
343.0,17,2,267,1,83,0.0,83.0,83.0,1,184,0.0,184.0,184.0
114522317.0,6,30,1974,15,1026,8164734.5,123.0,68.4,15,948,8164734.928571428,123.0,63.2
50007.0,6,14,4740,7,653,8179.5,249.0,93.28571428571428,7,4087,6946.0,1514.0,583.8571428571429
1212544.0,6,13,3010,8,2382,173220.57142857142,1514.0,297.75,5,628,234200.5,331.0,125.6
51814.0,6,14,4740,7,653,8515.166666666666,249.0,93.28571428571428,7,4087,8361.333333333334,1514.0,583.8571428571429
2181791.0,6,3,1604,2,851,0.0,785.0,425.5,1,753,0.0,753.0,753.0
2482780.0,6,3,1604,2,851,0.0,785.0,425.5,1,753,0.0,753.0,753.0
309194.0,6,6,412,4,272,103064.66666666669,74.0,68.0,2,140,0.0,74.0,70.0
2907.0,17,2,762,2,762,0.0,381.0,381.0,0,0,0.0,0.0,0.0
317.0,17,2,174,1,79,0.0,79.0,79.0,1,95,0.0,95.0,95.0
120784005.0,6,36,2533,18,1248,6517470.176470588,123.0,69.33333333333333,18,1285,7104568.823529412,139.0,71.38888888888889
102477.0,17,2,762,2,762,0.0,381.0,381.0,0,0,0.0,0.0,0.0
205718.0,6,10,1221,6,636,41143.6,298.0,106.0,4,585,67432.0,379.0,146.25
90297394.0,6,16,1192,8,596,12893761.714285716,95.0,74.5,8,596,12897724.57142857,95.0,74.5
44879.0,6,10,2032,5,524,10960.75,252.0,104.8,5,1508,10801.25,1236.0,301.6
1471841.0,17,16,1120,16,1120,98122.73333333334,70.0,70.0,0,0,0.0,0.0,0.0
120124846.0,6,15,2152,9,1204,15015605.75,188.0,133.77777777777777,6,948,18018705.8,204.0,158.0
126827647.0,6,33,2280,17,1209,7926727.9375,123.0,71.11764705882354,16,1071,7774941.333333333,123.0,66.9375
18290.0,6,10,2032,5,524,4046.25,252.0,104.8,5,1508,4010.5,1236.0,301.6
90234223.0,6,13,989,6,488,18005862.0,95.0,81.33333333333333,7,501,14999736.5,95.0,71.57142857142857
108563.0,17,2,286,2,286,0.0,143.0,143.0,0,0,0.0,0.0,0.0
29588796.0,6,63,7076,32,2186,954477.2903225806,140.0,68.3125,31,4890,951374.0,284.0,157.74193548387098
1888.0,17,4,344,2,150,0.0,75.0,75.0,2,194,0.0,103.0,97.0
146077.0,6,3,337,2,214,0.0,160.0,107.0,1,123,0.0,123.0,123.0
359.0,17,2,174,1,79,0.0,79.0,79.0,1,95,0.0,95.0,95.0
113883658.0,6,47,3102,24,1584,4938205.913043479,66.0,66.0,23,1518,5150446.727272728,66.0,66.0
782.0,17,4,438,2,148,0.0,74.0,74.0,2,290,0.0,147.0,145.0
28049.0,6,14,4740,7,653,4455.666666666667,249.0,93.28571428571428,7,4087,4148.5,1514.0,583.8571428571429
2020.0,17,4,344,2,150,0.0,75.0,75.0,2,194,0.0,103.0,97.0
281780.0,17,2,363,1,79,0.0,79.0,79.0,1,284,0.0,284.0,284.0
309313.0,6,3,202,2,128,0.0,74.0,64.0,1,74,0.0,74.0,74.0
90258901.0,6,13,2036,8,1016,12894128.714285716,188.0,127.0,5,1020,22523503.75,204.0,204.0
8922.0,17,2,498,1,80,0.0,80.0,80.0,1,418,0.0,418.0,418.0
4397.0,17,2,614,1,72,0.0,72.0,72.0,1,542,0.0,542.0,542.0
135129044.0,17,6,1146,6,1146,27025808.8,191.0,191.0,0,0,0.0,0.0,0.0
119247038.0,6,253,29094,127,20482,946405.0634920635,284.0,161.2755905511811,126,8612,946625.584,140.0,68.34920634920636
1301548.0,6,4,264,2,132,0.0,66.0,66.0,2,132,0.0,66.0,66.0
5006503.0,17,4,846,2,164,0.0,82.0,82.0,2,682,0.0,536.0,341.0
218648.0,6,3,426,2,280,0.0,214.0,140.0,1,146,0.0,146.0,146.0
28484.0,6,14,4740,7,653,4618.333333333333,249.0,93.28571428571428,7,4087,4580.833333333333,1514.0,583.8571428571429
298652.0,6,2,132,1,66,0.0,66.0,66.0,1,66,0.0,66.0,66.0
2026.0,17,4,344,2,150,0.0,75.0,75.0,2,194,0.0,103.0,97.0
204375.0,17,2,762,2,762,0.0,381.0,381.0,0,0,0.0,0.0,0.0
46517.0,6,14,4740,7,653,7587.666666666667,249.0,93.28571428571428,7,4087,7051.166666666667,1514.0,583.8571428571429
120124416.0,6,13,2036,5,1020,30031104.0,204.0,204.0,8,1016,17137478.85714286,188.0,127.0
315724.0,17,4,1400,4,1400,105241.33333333331,350.0,350.0,0,0,0.0,0.0,0.0
112093.0,6,12,1354,6,723,21044.0,253.0,120.5,6,631,21805.4,293.0,105.16666666666669
276074.0,6,10,1221,6,636,55214.8,298.0,106.0,4,585,86651.33333333333,379.0,146.25
90037822.0,17,28,13364,28,13364,3334734.1481481483,501.0,477.2857142857143,0,0,0.0,0.0,0.0
32201.0,6,10,2032,5,524,6816.5,252.0,104.8,5,1508,5583.75,1236.0,301.6
27410.0,6,10,1066,5,490,6245.0,218.0,98.0,5,576,5917.5,304.0,115.2
104822424.0,17,15,5130,15,5130,7487316.0,342.0,342.0,0,0,0.0,0.0,0.0
318389.0,6,3,202,2,128,0.0,74.0,64.0,1,74,0.0,74.0,74.0
153435.0,17,2,180,1,90,0.0,90.0,90.0,1,90,0.0,90.0,90.0
268461.0,17,2,180,1,90,0.0,90.0,90.0,1,90,0.0,90.0,90.0
57166.0,6,14,4740,7,653,7933.833333333333,249.0,93.28571428571428,7,4087,8919.333333333334,1514.0,583.8571428571429
104173.0,17,2,286,2,286,0.0,143.0,143.0,0,0,0.0,0.0,0.0
31882.0,6,11,1131,6,600,6166.8,262.0,100.0,5,531,7679.0,259.0,106.2
92367297.0,6,23,1775,13,1030,7696455.333333333,95.0,79.23076923076923,10,745,10262170.444444444,95.0,74.5
206481.0,17,2,180,1,90,0.0,90.0,90.0,1,90,0.0,90.0,90.0
11212.0,6,11,2098,6,590,2107.8,252.0,98.33333333333331,5,1508,2529.25,1236.0,301.6
97405.0,6,10,2032,5,524,23051.25,252.0,104.8,5,1508,8195.75,1236.0,301.6
588876.0,6,4,508,2,238,0.0,172.0,119.0,2,270,0.0,135.0,135.0
206309.0,6,3,426,2,280,0.0,214.0,140.0,1,146,0.0,146.0,146.0
313820.0,17,4,1400,4,1400,104606.66666666669,350.0,350.0,0,0,0.0,0.0,0.0
23410.0,6,13,1386,7,789,2876.6666666666665,253.0,112.71428571428572,6,597,3856.6,259.0,99.5
4083.0,17,2,582,1,83,0.0,83.0,83.0,1,499,0.0,499.0,499.0
13320920.0,6,20,1607,10,975,1444226.5555555555,315.0,97.5,10,632,1444353.5555555555,78.0,63.2
104884271.0,17,15,5130,15,5130,7491733.642857143,342.0,342.0,0,0,0.0,0.0,0.0
10459689.0,6,7,478,4,272,3441228.0,74.0,68.0,3,206,5161743.5,74.0,68.66666666666667
34036.0,6,14,4740,7,653,5525.833333333333,249.0,93.28571428571428,7,4087,5123.666666666667,1514.0,583.8571428571429
153408.0,17,2,180,1,90,0.0,90.0,90.0,1,90,0.0,90.0,90.0
296727.0,6,6,412,4,272,98909.0,74.0,68.0,2,140,0.0,74.0,70.0
103214.0,17,2,286,2,286,0.0,143.0,143.0,0,0,0.0,0.0,0.0
50897.0,17,2,180,1,90,0.0,90.0,90.0,1,90,0.0,90.0,90.0
135127867.0,17,6,1146,6,1146,27025573.4,191.0,191.0,0,0,0.0,0.0,0.0
120123878.0,6,13,2036,5,1020,30030969.5,204.0,204.0,8,1016,17137074.714285713,188.0,127.0
351.0,17,2,267,1,83,0.0,83.0,83.0,1,184,0.0,184.0,184.0
214832.0,17,2,359,1,75,0.0,75.0,75.0,1,284,0.0,284.0,284.0
198828.0,17,4,6056,4,6056,66276.0,1514.0,1514.0,0,0,0.0,0.0,0.0
393.0,17,2,174,1,79,0.0,79.0,79.0,1,95,0.0,95.0,95.0
2305.0,17,4,344,2,150,0.0,75.0,75.0,2,194,0.0,103.0,97.0
146155.0,6,3,337,2,214,0.0,160.0,107.0,1,123,0.0,123.0,123.0
196866.0,17,2,180,1,90,0.0,90.0,90.0,1,90,0.0,90.0,90.0
228289.0,17,2,180,1,90,0.0,90.0,90.0,1,90,0.0,90.0,90.0
90250121.0,6,16,1192,8,596,12886057.285714284,95.0,74.5,8,596,12888906.0,95.0,74.5
259509.0,6,3,337,2,214,0.0,160.0,107.0,1,123,0.0,123.0,123.0
127012398.0,17,15,907,8,475,18144628.285714287,174.0,59.375,7,432,17833499.333333332,174.0,61.71428571428572
130087.0,6,3,337,2,214,0.0,160.0,107.0,1,123,0.0,123.0,123.0
2255149.0,17,2,896,2,896,0.0,453.0,448.0,0,0,0.0,0.0,0.0
90213938.0,6,19,1436,9,691,11246371.75,95.0,76.77777777777777,10,745,10000903.666666666,95.0,74.5
160525.0,6,3,373,2,238,0.0,172.0,119.0,1,135,0.0,135.0,135.0
104014180.0,6,44,2904,22,1452,4953056.19047619,66.0,66.0,22,1452,4939942.666666667,66.0,66.0
123302143.0,6,48,3168,24,1584,4980147.347826087,66.0,66.0,24,1584,5316460.608695652,66.0,66.0
196897.0,17,2,180,1,90,0.0,90.0,90.0,1,90,0.0,90.0,90.0
108105433.0,17,5,955,5,955,27026358.25,191.0,191.0,0,0,0.0,0.0,0.0
228320.0,17,2,180,1,90,0.0,90.0,90.0,1,90,0.0,90.0,90.0
39144.0,6,10,2032,5,524,9438.25,252.0,104.8,5,1508,9486.75,1236.0,301.6
113694536.0,6,46,3036,23,1518,5154077.5,66.0,66.0,23,1518,5154064.681818182,66.0,66.0
120061972.0,17,29,13785,29,13785,4287927.571428572,501.0,475.3448275862069,0,0,0.0,0.0,0.0
52577.0,6,14,4740,7,653,8639.5,249.0,93.28571428571428,7,4087,8387.0,1514.0,583.8571428571429
247210.0,17,4,6056,4,6056,82403.33333333333,1514.0,1514.0,0,0,0.0,0.0,0.0
6686.0,17,2,582,1,83,0.0,83.0,83.0,1,499,0.0,499.0,499.0
1306860.0,6,4,264,2,132,0.0,66.0,66.0,2,132,0.0,66.0,66.0
101057332.0,17,14,864,7,432,16833362.333333332,174.0,61.71428571428572,7,432,16833497.833333332,174.0,61.71428571428572
123840037.0,6,49,3234,25,1650,5160001.541666667,66.0,66.0,24,1584,5097776.434782608,66.0,66.0
2086.0,17,4,344,2,150,0.0,75.0,75.0,2,194,0.0,103.0,97.0
894495.0,6,10,1333,6,796,178899.0,458.0,132.66666666666666,4,537,207290.0,331.0,134.25
27181797.0,17,5,1710,5,1710,6795449.25,342.0,342.0,0,0,0.0,0.0,0.0
42801.0,6,14,4740,7,653,6272.0,249.0,93.28571428571428,7,4087,6986.333333333333,1514.0,583.8571428571429
90029360.0,17,27,12943,27,12943,3462667.6923076925,501.0,479.3703703703704,0,0,0.0,0.0,0.0
1310860.0,6,4,264,2,132,0.0,66.0,66.0,2,132,0.0,66.0,66.0
90296342.0,6,15,1097,8,596,12899477.42857143,95.0,74.5,7,501,15000117.333333334,95.0,71.57142857142857
780.0,17,4,438,2,148,0.0,74.0,74.0,2,290,0.0,147.0,145.0
90360494.0,6,15,2306,8,1016,12908642.0,188.0,127.0,7,1290,15031768.5,204.0,184.28571428571428
24535.0,6,14,4740,7,653,3435.0,249.0,93.28571428571428,7,4087,3788.0,1514.0,583.8571428571429
103578353.0,6,44,2904,22,1452,4932302.523809524,66.0,66.0,22,1452,4917503.714285715,66.0,66.0
205164.0,17,2,762,2,762,0.0,381.0,381.0,0,0,0.0,0.0,0.0
9251.0,17,2,582,1,83,0.0,83.0,83.0,1,499,0.0,499.0,499.0
847322.0,6,9,1096,6,625,169464.4,287.0,104.16666666666669,3,471,285882.0,331.0,157.0
313658.0,17,4,1400,4,1400,104552.66666666669,350.0,350.0,0,0,0.0,0.0,0.0
445613.0,6,10,1221,6,636,89122.6,298.0,106.0,4,585,142659.33333333334,379.0,146.25
32877.0,6,14,4740,7,653,4111.333333333333,249.0,93.28571428571428,7,4087,4344.333333333333,1514.0,583.8571428571429
9901.0,17,4,823,2,163,0.0,89.0,81.5,2,660,0.0,443.0,330.0
123850579.0,6,49,3234,25,1650,5160440.791666667,66.0,66.0,24,1584,5036017.391304348,66.0,66.0
68834.0,6,14,4740,7,653,10773.333333333334,249.0,93.28571428571428,7,4087,10761.333333333334,1514.0,583.8571428571429
82.0,17,2,762,2,762,0.0,381.0,381.0,0,0,0.0,0.0,0.0
90526044.0,6,13,2036,8,1016,12932292.0,188.0,127.0,5,1020,22586127.0,204.0,204.0
10479578.0,6,7,478,4,272,3447616.333333333,74.0,68.0,3,206,5171283.0,74.0,68.66666666666667
207309.0,6,3,426,2,280,0.0,214.0,140.0,1,146,0.0,146.0,146.0
300894.0,6,6,412,4,272,100298.0,74.0,68.0,2,140,0.0,74.0,70.0
353996.0,6,3,204,1,68,0.0,68.0,68.0,2,136,0.0,70.0,68.0
90294270.0,6,16,1192,8,596,12892546.285714284,95.0,74.5,8,596,12898760.57142857,95.0,74.5
101159018.0,17,14,864,7,432,16833511.0,174.0,61.71428571428572,7,432,16834927.333333332,174.0,61.71428571428572
39200.0,6,12,1413,6,816,7166.2,291.0,136.0,6,597,6518.0,259.0,99.5
318344.0,17,4,1400,4,1400,106114.66666666669,350.0,350.0,0,0,0.0,0.0,0.0
118414843.0,6,219,24818,110,17402,1086374.7064220184,284.0,158.2,109,7416,1086671.6574074074,140.0,68.03669724770643
33231.0,6,14,4740,7,653,5041.0,249.0,93.28571428571428,7,4087,5236.833333333333,1514.0,583.8571428571429
207122.0,6,3,426,2,280,0.0,214.0,140.0,1,146,0.0,146.0,146.0
90254348.0,6,12,1832,8,1016,12893478.285714284,188.0,127.0,4,816,30030014.0,204.0,204.0
40643.0,6,14,4740,7,653,5272.333333333333,249.0,93.28571428571428,7,4087,6323.333333333333,1514.0,583.8571428571429
146307.0,6,3,337,2,214,0.0,160.0,107.0,1,123,0.0,123.0,123.0
42851.0,6,10,2032,5,524,10143.75,252.0,104.8,5,1508,9578.5,1236.0,301.6
0.0,17,1,90,1,90,0.0,90.0,90.0,0,0,0.0,0.0,0.0
302.0,17,2,174,1,79,0.0,79.0,79.0,1,95,0.0,95.0,95.0
120004367.0,6,18,1341,9,691,14999997.75,95.0,76.77777777777777,9,650,14998882.5,95.0,72.22222222222223
90255209.0,6,14,2102,8,1016,12893601.285714284,188.0,127.0,6,1086,18018772.4,204.0,181.0
51388.0,6,14,4740,7,653,7811.833333333333,249.0,93.28571428571428,7,4087,7973.333333333333,1514.0,583.8571428571429
307842.0,6,6,412,4,272,102614.0,74.0,68.0,2,140,0.0,74.0,70.0
2580815.0,6,26,7627,14,3735,198524.2307692308,1514.0,266.7857142857143,12,3892,211484.2727272728,1514.0,324.3333333333333
293736.0,17,2,246,1,76,0.0,76.0,76.0,1,170,0.0,170.0,170.0
20721.0,6,10,2032,5,524,3625.25,252.0,104.8,5,1508,4590.25,1236.0,301.6
306680.0,6,6,412,4,272,102226.66666666669,74.0,68.0,2,140,0.0,74.0,70.0
109645658.0,17,14,864,7,432,18247452.0,174.0,61.71428571428572,7,432,18165361.83333333,174.0,61.71428571428572
108112349.0,17,5,955,5,955,27028087.25,191.0,191.0,0,0,0.0,0.0,0.0
28136.0,6,14,4740,7,653,4404.833333333333,249.0,93.28571428571428,7,4087,4332.0,1514.0,583.8571428571429
1476580.0,17,16,1120,16,1120,98438.66666666669,70.0,70.0,0,0,0.0,0.0,0.0
127117235.0,6,36,2596,18,1248,6890062.647058823,123.0,69.33333333333333,18,1348,7025426.0,139.0,74.88888888888889
26368.0,6,14,4740,7,653,4110.666666666667,249.0,93.28571428571428,7,4087,4206.5,1514.0,583.8571428571429
20997.0,6,14,4740,7,653,2782.333333333333,249.0,93.28571428571428,7,4087,3360.6666666666665,1514.0,583.8571428571429
29708.0,6,14,4740,7,653,4826.5,249.0,93.28571428571428,7,4087,4816.666666666667,1514.0,583.8571428571429
171604.0,17,2,180,1,90,0.0,90.0,90.0,1,90,0.0,90.0,90.0
322200.0,17,4,1400,4,1400,107400.0,350.0,350.0,0,0,0.0,0.0,0.0
2020.0,17,4,344,2,150,0.0,75.0,75.0,2,194,0.0,103.0,97.0
5714.0,17,4,344,2,150,0.0,75.0,75.0,2,194,0.0,103.0,97.0
16817.0,17,2,180,1,90,0.0,90.0,90.0,1,90,0.0,90.0,90.0
843094.0,6,9,1096,6,625,168618.8,287.0,104.16666666666669,3,471,285215.5,331.0,157.0
2062.0,17,4,344,2,150,0.0,75.0,75.0,2,194,0.0,103.0,97.0
371.0,17,2,160,1,80,0.0,80.0,80.0,1,80,0.0,80.0,80.0
120119399.0,6,252,28356,126,8612,946106.928,140.0,68.34920634920636,126,19744,955335.168,300.0,156.6984126984127
119269593.0,6,227,25706,114,17952,1055483.1238938053,284.0,157.47368421052633,113,7754,1056654.6875,140.0,68.61946902654867
90992636.0,6,192,22056,96,15498,955546.5894736842,300.0,161.4375,96,6558,955551.1263157896,140.0,68.3125
2418.0,17,4,344,2,150,0.0,75.0,75.0,2,194,0.0,103.0,97.0
90256616.0,6,14,2240,8,1016,12893802.285714284,188.0,127.0,6,1224,18018122.6,204.0,204.0
90046796.0,17,28,13364,28,13364,3335066.5185185187,501.0,477.2857142857143,0,0,0.0,0.0,0.0
10473948.0,6,7,478,4,272,3445660.0,74.0,68.0,3,206,5168379.0,74.0,68.66666666666667
4899.0,17,4,704,2,148,0.0,74.0,74.0,2,556,0.0,280.0,278.0
43122.0,6,10,2032,5,524,10251.5,252.0,104.8,5,1508,9518.5,1236.0,301.6
299237.0,6,6,412,4,272,99745.66666666669,74.0,68.0,2,140,0.0,74.0,70.0
2259.0,17,4,344,2,150,0.0,75.0,75.0,2,194,0.0,103.0,97.0
120118041.0,6,278,32000,139,9470,864568.7463768116,140.0,68.12949640287769,139,22530,864454.3115942029,300.0,162.0863309352518
190816.0,17,2,180,1,90,0.0,90.0,90.0,1,90,0.0,90.0,90.0
178703.0,17,4,1524,4,1524,59567.66666666666,381.0,381.0,0,0,0.0,0.0,0.0
120052419.0,17,28,13364,28,13364,4446385.888888889,501.0,477.2857142857143,0,0,0.0,0.0,0.0
108107309.0,17,5,955,5,955,27026827.25,191.0,191.0,0,0,0.0,0.0,0.0
33354.0,6,10,2032,5,524,8034.25,252.0,104.8,5,1508,8013.25,1236.0,301.6
90729443.0,6,15,1138,7,542,15121573.833333334,95.0,77.42857142857143,8,596,12920010.0,95.0,74.5
308039.0,6,6,412,4,272,102679.66666666669,74.0,68.0,2,140,0.0,74.0,70.0
890011.0,6,12,2710,7,742,148335.16666666666,338.0,106.0,5,1968,153592.75,1514.0,393.6
308803.0,6,6,412,4,272,102934.33333333331,74.0,68.0,2,140,0.0,74.0,70.0
140886.0,6,2,132,1,66,0.0,66.0,66.0,1,66,0.0,66.0,66.0
19275.0,6,2,145,2,145,0.0,91.0,72.5,0,0,0.0,0.0,0.0
993006.0,6,2,132,1,66,0.0,66.0,66.0,1,66,0.0,66.0,66.0
108108839.0,17,5,955,5,955,27027209.75,191.0,191.0,0,0,0.0,0.0,0.0
320.0,17,2,164,1,82,0.0,82.0,82.0,1,82,0.0,82.0,82.0
2589520.0,6,2,132,1,66,0.0,66.0,66.0,1,66,0.0,66.0,66.0
2497.0,17,4,344,2,150,0.0,75.0,75.0,2,194,0.0,103.0,97.0
9201.0,17,2,539,1,86,0.0,86.0,86.0,1,453,0.0,453.0,453.0
130861.0,6,3,337,2,214,0.0,160.0,107.0,1,123,0.0,123.0,123.0
68487.0,6,12,1328,7,797,11414.5,253.0,113.85714285714286,5,531,14907.25,259.0,106.2
90009995.0,17,27,12943,27,12943,3461922.8846153845,501.0,479.3703703703704,0,0,0.0,0.0,0.0
860017.0,6,9,1270,6,799,172003.4,461.0,133.16666666666666,3,471,292153.0,331.0,157.0
103901.0,17,2,286,2,286,0.0,143.0,143.0,0,0,0.0,0.0,0.0
309647.0,17,4,1400,4,1400,103215.66666666669,350.0,350.0,0,0,0.0,0.0,0.0
120250961.0,6,220,24884,110,7482,1095587.5779816513,140.0,68.01818181818182,110,17402,1095660.5321100918,284.0,158.2
305255.0,6,6,412,4,272,101751.66666666669,74.0,68.0,2,140,0.0,74.0,70.0
4420.0,17,2,604,1,75,0.0,75.0,75.0,1,529,0.0,529.0,529.0
1302484.0,6,4,264,2,132,0.0,66.0,66.0,2,132,0.0,66.0,66.0
28453.0,6,10,2032,5,524,6879.25,252.0,104.8,5,1508,6812.75,1236.0,301.6
39345.0,6,10,1066,5,490,9338.5,218.0,98.0,5,576,9240.0,304.0,115.2
10458665.0,6,7,478,4,272,3440385.0,74.0,68.0,3,206,5160505.0,74.0,68.66666666666667
2420.0,17,4,344,2,150,0.0,75.0,75.0,2,194,0.0,103.0,97.0
44359.0,6,10,2032,5,524,10611.0,252.0,104.8,5,1508,9507.25,1236.0,301.6
31073.0,6,14,4740,7,653,4770.0,249.0,93.28571428571428,7,4087,4108.166666666667,1514.0,583.8571428571429
121016163.0,17,15,907,8,475,17288023.285714287,174.0,59.375,7,432,16833496.5,174.0,61.71428571428572
40172.0,6,14,4740,7,653,6567.333333333333,249.0,93.28571428571428,7,4087,6248.833333333333,1514.0,583.8571428571429
149648.0,17,2,180,1,90,0.0,90.0,90.0,1,90,0.0,90.0,90.0
319900.0,17,4,1400,4,1400,106633.33333333331,350.0,350.0,0,0,0.0,0.0,0.0
120124207.0,6,17,2556,10,1392,13347134.111111112,188.0,139.2,7,1164,15015447.0,204.0,166.28571428571428
216372.0,17,2,180,1,90,0.0,90.0,90.0,1,90,0.0,90.0,90.0
126193224.0,6,33,2343,16,1071,7900197.0,123.0,66.9375,17,1272,7406431.75,123.0,74.82352941176471
36033.0,6,14,4740,7,653,5840.833333333333,249.0,93.28571428571428,7,4087,5436.166666666667,1514.0,583.8571428571429
0.0,17,1,342,1,342,0.0,342.0,342.0,0,0,0.0,0.0,0.0
234005.0,6,3,337,2,214,0.0,160.0,107.0,1,123,0.0,123.0,123.0
348.0,17,2,267,1,83,0.0,83.0,83.0,1,184,0.0,184.0,184.0
90069050.0,17,28,13364,28,13364,3335890.7407407407,501.0,477.2857142857143,0,0,0.0,0.0,0.0
148633.0,17,2,414,1,88,0.0,88.0,88.0,1,326,0.0,326.0,326.0
2305.0,17,2,664,1,322,0.0,322.0,322.0,1,342,0.0,342.0,342.0
207192.0,17,2,762,2,762,0.0,381.0,381.0,0,0,0.0,0.0,0.0
221476.0,6,12,1373,7,714,36912.66666666666,298.0,102.0,5,659,54732.25,379.0,131.8
90679728.0,6,21,1585,10,745,10075525.333333334,95.0,74.5,11,840,9041882.0,95.0,76.36363636363636
313752.0,17,4,1400,4,1400,104584.0,350.0,350.0,0,0,0.0,0.0,0.0
181824.0,17,2,180,1,90,0.0,90.0,90.0,1,90,0.0,90.0,90.0
90034348.0,17,28,13364,28,13364,3334605.4814814813,501.0,477.2857142857143,0,0,0.0,0.0,0.0
0.0,6,1,160,1,160,0.0,160.0,160.0,0,0,0.0,0.0,0.0
297318.0,6,6,412,4,272,99106.0,74.0,68.0,2,140,0.0,74.0,70.0
209892.0,17,2,180,1,90,0.0,90.0,90.0,1,90,0.0,90.0,90.0
2486.0,17,4,344,2,150,0.0,75.0,75.0,2,194,0.0,103.0,97.0
191187.0,17,2,180,1,90,0.0,90.0,90.0,1,90,0.0,90.0,90.0
254020.00000000003,6,3,337,2,214,0.0,160.0,107.0,1,123,0.0,123.0,123.0
99990.0,17,2,762,2,762,0.0,381.0,381.0,0,0,0.0,0.0,0.0
21836.0,17,3,1026,3,1026,10918.0,342.0,342.0,0,0,0.0,0.0,0.0
146898.0,6,3,337,2,214,0.0,160.0,107.0,1,123,0.0,123.0,123.0
297616.0,6,6,412,4,272,99205.33333333331,74.0,68.0,2,140,0.0,74.0,70.0
105271.0,17,2,762,2,762,0.0,381.0,381.0,0,0,0.0,0.0,0.0
205825.0,17,2,180,1,90,0.0,90.0,90.0,1,90,0.0,90.0,90.0
147155.0,6,3,373,2,238,0.0,172.0,119.0,1,135,0.0,135.0,135.0
120377492.0,6,227,25706,114,17952,1065287.539823009,284.0,157.47368421052633,113,7754,1065540.8839285714,140.0,68.61946902654867
4530.0,17,2,614,1,72,0.0,72.0,72.0,1,542,0.0,542.0,542.0
107466.0,17,2,286,2,286,0.0,143.0,143.0,0,0,0.0,0.0,0.0
121200.0,6,3,337,2,214,0.0,160.0,107.0,1,123,0.0,123.0,123.0
249148.0,6,3,337,2,214,0.0,160.0,107.0,1,123,0.0,123.0,123.0
3383467.0,6,18,1495,9,921,383816.5,315.0,102.33333333333331,9,574,384177.875,78.0,63.77777777777778
110367430.0,6,30,1974,15,1026,7867964.285714285,123.0,68.4,15,948,7867971.571428572,123.0,63.2
301121.0,17,4,6056,4,6056,100373.66666666669,1514.0,1514.0,0,0,0.0,0.0,0.0
122670546.0,17,14,1126,7,563,17333490.0,174.0,80.42857142857143,7,563,17167513.166666668,174.0,80.42857142857143
2441.0,17,4,344,2,150,0.0,75.0,75.0,2,194,0.0,103.0,97.0
207007.0,6,3,426,2,280,0.0,214.0,140.0,1,146,0.0,146.0,146.0
118057604.0,17,16,1212,8,606,16857470.714285713,174.0,75.75,8,606,16857283.285714287,174.0,75.75
4480.0,17,2,614,1,72,0.0,72.0,72.0,1,542,0.0,542.0,542.0
2009.0,17,4,344,2,150,0.0,75.0,75.0,2,194,0.0,103.0,97.0
143894.0,17,2,180,1,90,0.0,90.0,90.0,1,90,0.0,90.0,90.0
108105199.0,17,5,1005,5,1005,27026299.75,201.0,201.0,0,0,0.0,0.0,0.0
372466.0,6,3,204,2,136,0.0,70.0,68.0,1,68,0.0,68.0,68.0
748237.0,6,2,132,1,66,0.0,66.0,66.0,1,66,0.0,66.0,66.0
209763.0,17,2,180,1,90,0.0,90.0,90.0,1,90,0.0,90.0,90.0
868561.0,6,9,1096,6,625,173712.2,287.0,104.16666666666669,3,471,295414.5,331.0,157.0
90231984.0,6,16,1192,8,596,12855139.142857144,95.0,74.5,8,596,12859537.0,95.0,74.5
697.0,17,4,438,2,148,0.0,74.0,74.0,2,290,0.0,147.0,145.0
304557.0,6,6,412,4,272,101519.0,74.0,68.0,2,140,0.0,74.0,70.0
108109089.0,17,5,1005,5,1005,27027272.25,201.0,201.0,0,0,0.0,0.0,0.0
90047532.0,17,28,13364,28,13364,3335093.777777778,501.0,477.2857142857143,0,0,0.0,0.0,0.0
72211.0,6,14,4740,7,653,11430.5,249.0,93.28571428571428,7,4087,10995.333333333334,1514.0,583.8571428571429
5618623.0,6,5,336,2,134,0.0,68.0,67.0,3,202,1420685.0,70.0,67.33333333333333
869.0,17,4,438,2,148,0.0,74.0,74.0,2,290,0.0,147.0,145.0
95373451.0,6,49,4552,29,2575,3406194.6785714286,139.0,88.79310344827586,20,1977,5008271.7894736845,123.0,98.85
48214.0,6,14,4740,7,653,7726.166666666667,249.0,93.28571428571428,7,4087,7644.166666666667,1514.0,583.8571428571429
102983.0,17,2,286,2,286,0.0,143.0,143.0,0,0,0.0,0.0,0.0
24314.0,6,10,1913,5,461,5781.25,233.0,92.2,5,1452,3488.25,1224.0,290.4
364661.0,6,10,1221,6,636,72932.2,298.0,106.0,4,585,119203.33333333331,379.0,146.25
121285937.0,6,35,2473,18,1348,7134466.882352941,139.0,74.88888888888889,17,1125,7088423.625,123.0,66.17647058823529
90050612.0,17,28,13364,28,13364,3335207.851851852,501.0,477.2857142857143,0,0,0.0,0.0,0.0
26626.0,6,10,2032,5,524,6427.25,252.0,104.8,5,1508,6348.75,1236.0,301.6
246222.0,6,3,337,2,214,0.0,160.0,107.0,1,123,0.0,123.0,123.0
2597491.0,6,4,1670,2,819,0.0,753.0,409.5,2,851,0.0,785.0,425.5
2169425.0,6,25,7611,13,2516,180785.41666666663,1034.0,193.53846153846155,12,5095,169004.63636363635,1510.0,424.5833333333333
2288.0,17,2,664,1,322,0.0,322.0,322.0,1,342,0.0,342.0,342.0
927350.0,6,10,1162,6,625,185470.0,287.0,104.16666666666669,4,537,218209.66666666663,331.0,134.25
153368.0,17,2,180,1,90,0.0,90.0,90.0,1,90,0.0,90.0,90.0
306309.0,6,6,412,4,272,102103.0,74.0,68.0,2,140,0.0,74.0,70.0
90026834.0,17,28,13364,28,13364,3334327.185185185,501.0,477.2857142857143,0,0,0.0,0.0,0.0
336.0,17,2,160,1,80,0.0,80.0,80.0,1,80,0.0,80.0,80.0
10481665.0,6,7,478,4,272,3445664.0,74.0,68.0,3,206,5168396.5,74.0,68.66666666666667
25421.0,6,10,2032,5,524,6142.25,252.0,104.8,5,1508,4634.25,1236.0,301.6
101763265.0,6,242,27410,121,8282,841309.3166666667,140.0,68.44628099173553,121,19128,841102.8916666667,300.0,158.08264462809916
123455925.0,6,49,3234,25,1650,5143996.875,66.0,66.0,24,1584,4987430.782608695,66.0,66.0
2293.0,17,4,344,2,150,0.0,75.0,75.0,2,194,0.0,103.0,97.0
113252075.0,6,46,3036,23,1518,5135443.863636363,66.0,66.0,23,1518,5135456.0,66.0,66.0
307456.0,6,6,412,4,272,102485.33333333331,74.0,68.0,2,140,0.0,74.0,70.0
28346.0,6,14,4740,7,653,4509.333333333333,249.0,93.28571428571428,7,4087,4526.0,1514.0,583.8571428571429
229668.0,17,2,180,1,90,0.0,90.0,90.0,1,90,0.0,90.0,90.0
207272.0,6,3,426,2,280,0.0,214.0,140.0,1,146,0.0,146.0,146.0
120130472.0,6,13,2020,9,1204,15016309.0,188.0,133.77777777777777,4,816,30030854.666666668,204.0,204.0
32181115.0,6,9,754,5,482,8005037.5,210.0,96.4,4,272,10673310.333333334,74.0,68.0
749.0,17,4,438,2,148,0.0,74.0,74.0,2,290,0.0,147.0,145.0
120757.0,6,3,373,2,238,0.0,172.0,119.0,1,135,0.0,135.0,135.0
144712.0,17,2,180,1,70,0.0,70.0,70.0,1,110,0.0,110.0,110.0
444.0,17,2,166,1,75,0.0,75.0,75.0,1,91,0.0,91.0,91.0
135529.0,6,3,337,2,214,0.0,160.0,107.0,1,123,0.0,123.0,123.0
120204150.0,6,18,1341,9,691,14999873.375,95.0,76.77777777777777,9,650,14999866.0,95.0,72.22222222222223
1814.0,17,4,344,2,150,0.0,75.0,75.0,2,194,0.0,103.0,97.0
3050737.0,6,3,204,1,68,0.0,68.0,68.0,2,136,0.0,70.0,68.0
103567.0,17,2,286,2,286,0.0,143.0,143.0,0,0,0.0,0.0,0.0
232292.0,6,3,337,2,214,0.0,160.0,107.0,1,123,0.0,123.0,123.0
90783607.0,6,20,1531,11,840,9073787.2,95.0,76.36363636363636,9,691,11347504.5,95.0,76.77777777777777
127022143.0,6,34,2403,18,1332,7471890.764705882,123.0,74.0,16,1071,7942868.133333334,123.0,66.9375
135127891.0,17,6,1206,6,1206,27025578.2,201.0,201.0,0,0,0.0,0.0,0.0
217415.0,6,3,426,2,280,0.0,214.0,140.0,1,146,0.0,146.0,146.0
66526.0,6,14,4740,7,653,9832.833333333334,249.0,93.28571428571428,7,4087,10955.0,1514.0,583.8571428571429
62658.00000000001,6,10,2032,5,524,14403.25,252.0,104.8,5,1508,10099.75,1236.0,301.6
1208133.0,17,7,490,7,490,201355.5,70.0,70.0,0,0,0.0,0.0,0.0
309153.0,17,4,1400,4,1400,103051.0,350.0,350.0,0,0,0.0,0.0,0.0
125194.0,6,14,4740,7,653,20333.666666666668,249.0,93.28571428571428,7,4087,19619.5,1514.0,583.8571428571429
107647.0,17,2,286,2,286,0.0,143.0,143.0,0,0,0.0,0.0,0.0
104277890.0,6,186,20998,93,14638,1131116.0543478262,284.0,157.3978494623656,93,6360,1131112.7391304348,140.0,68.38709677419355
382714.0,17,2,363,1,75,0.0,75.0,75.0,1,288,0.0,288.0,288.0
93609866.0,6,39,2574,20,1320,4926821.52631579,66.0,66.0,19,1254,5144006.888888889,66.0,66.0
103715.0,17,2,286,2,286,0.0,143.0,143.0,0,0,0.0,0.0,0.0
1310058.0,6,4,264,2,132,0.0,66.0,66.0,2,132,0.0,66.0,66.0
23303.0,6,11,2098,6,590,4476.2,252.0,98.33333333333331,5,1508,5579.5,1236.0,301.6
24020398.0,17,3,1026,3,1026,12010199.000000002,342.0,342.0,0,0,0.0,0.0,0.0
4514.0,17,2,614,1,72,0.0,72.0,72.0,1,542,0.0,542.0,542.0
1569600.0,6,2,132,1,66,0.0,66.0,66.0,1,66,0.0,66.0,66.0
904441.0,6,10,1162,6,625,180888.2,287.0,104.16666666666669,4,537,209610.0,331.0,134.25
64587.00000000001,6,14,4740,7,653,7909.0,249.0,93.28571428571428,7,4087,10623.0,1514.0,583.8571428571429
111648627.0,6,23,1775,10,745,12405403.0,95.0,74.5,13,1030,9282473.5,95.0,79.23076923076923
91823309.0,6,183,20476,92,6294,1009047.3516483516,140.0,68.41304347826087,91,14182,1008670.5666666668,284.0,155.84615384615384
228192.0,17,2,180,1,90,0.0,90.0,90.0,1,90,0.0,90.0,90.0
297424.0,17,2,246,1,76,0.0,76.0,76.0,1,170,0.0,170.0,170.0
90298970.0,6,16,1192,8,596,12893447.714285716,95.0,74.5,8,596,12899410.714285716,95.0,74.5
35098311.0,6,190,42095,97,33083,365607.40625,566.0,341.0618556701031,93,9012,378391.3695652174,898.0,96.90322580645162
4212136.0,6,117,96985,71,89649,60173.37142857143,1510.0,1262.661971830986,46,7336,86845.97777777778,1510.0,159.47826086956522
884150.0,6,9,1267,6,796,176830.0,458.0,132.66666666666666,3,471,304055.5,331.0,157.0
23970.0,6,14,4740,7,653,3728.1666666666665,249.0,93.28571428571428,7,4087,3582.333333333333,1514.0,583.8571428571429
13309.0,6,13,1459,7,862,1946.3333333333333,271.0,123.14285714285714,6,597,2428.6,259.0,99.5
216766.0,6,3,426,2,280,0.0,214.0,140.0,1,146,0.0,146.0,146.0
100507676.0,17,12,778,6,389,20101535.2,174.0,64.83333333333333,6,389,19894419.8,174.0,64.83333333333333
1059164.0,6,3,1604,1,753,0.0,753.0,753.0,2,851,0.0,785.0,425.5
1029856.0,6,11,1134,6,558,205971.2,220.0,93.0,5,576,255343.5,304.0,115.2
61689.0,6,10,2032,5,524,14704.5,252.0,104.8,5,1508,15097.25,1236.0,301.6
101205.0,17,2,762,2,762,0.0,381.0,381.0,0,0,0.0,0.0,0.0
205835.0,17,2,180,1,90,0.0,90.0,90.0,1,90,0.0,90.0,90.0
17891.0,6,11,1133,6,602,3525.6,264.0,100.33333333333331,5,531,3844.5,259.0,106.2
216576.0,17,2,180,1,90,0.0,90.0,90.0,1,90,0.0,90.0,90.0
3371290.0,6,3,1777,1,826,0.0,826.0,826.0,2,951,0.0,885.0,475.5
12979.0,6,13,1459,7,862,2042.8333333333333,271.0,123.14285714285714,6,597,2279.6,259.0,99.5
5730.0,17,4,823,2,163,0.0,89.0,81.5,2,660,0.0,443.0,330.0
71931.0,6,14,4740,7,653,11515.666666666666,249.0,93.28571428571428,7,4087,11832.333333333334,1514.0,583.8571428571429
493715.0,6,5,336,2,134,0.0,68.0,67.0,3,202,194373.0,70.0,67.33333333333333
1310184.0,6,4,264,2,132,0.0,66.0,66.0,2,132,0.0,66.0,66.0
206091.0,6,3,426,2,280,0.0,214.0,140.0,1,146,0.0,146.0,146.0
446283.0,17,4,360,2,140,0.0,70.0,70.0,2,220,0.0,110.0,110.0
108106943.0,17,5,955,5,955,27026735.75,191.0,191.0,0,0,0.0,0.0,0.0
303194.0,6,2,132,1,66,0.0,66.0,66.0,1,66,0.0,66.0,66.0
100023252.0,17,12,516,6,258,20000170.2,43.0,43.0,6,258,20002908.6,43.0,43.0
115046209.0,17,16,1212,8,606,16429534.0,174.0,75.75,8,606,16428712.285714284,174.0,75.75
14935.0,6,10,1065,5,534,3496.0,262.0,106.8,5,531,2676.25,259.0,106.2
209508.0,17,2,180,1,90,0.0,90.0,90.0,1,90,0.0,90.0,90.0
90024400.0,17,28,13364,28,13364,3334237.037037037,501.0,477.2857142857143,0,0,0.0,0.0,0.0
69190.0,6,14,4740,7,653,11254.0,249.0,93.28571428571428,7,4087,10357.333333333334,1514.0,583.8571428571429
48056.0,6,14,4740,7,653,7679.833333333333,249.0,93.28571428571428,7,4087,6629.0,1514.0,583.8571428571429
44236.0,6,14,4740,7,653,6846.5,249.0,93.28571428571428,7,4087,7217.666666666667,1514.0,583.8571428571429
107508.0,17,2,286,2,286,0.0,143.0,143.0,0,0,0.0,0.0,0.0
107862.0,17,2,286,2,286,0.0,143.0,143.0,0,0,0.0,0.0,0.0
25471.0,6,10,2032,5,524,6117.0,252.0,104.8,5,1508,5988.75,1236.0,301.6
20176.0,6,14,4740,7,653,3071.5,249.0,93.28571428571428,7,4087,3226.833333333333,1514.0,583.8571428571429
10467477.0,6,7,478,4,272,3443587.6666666665,74.0,68.0,3,206,5165288.5,74.0,68.66666666666667
104619571.0,6,29,2052,15,1089,7457415.0,123.0,72.6,14,963,8031060.538461538,123.0,68.78571428571429
209981.0,6,3,426,2,280,0.0,214.0,140.0,1,146,0.0,146.0,146.0
90757035.0,6,17,1287,9,691,11339279.25,95.0,76.77777777777777,8,596,12963814.142857144,95.0,74.5
40788.0,6,14,4740,7,653,6420.5,249.0,93.28571428571428,7,4087,6447.0,1514.0,583.8571428571429
115291194.0,6,213,24062,107,7284,1087652.7735849055,140.0,68.07476635514018,106,16778,1088055.7904761904,284.0,158.28301886792454
196848.0,17,2,180,1,90,0.0,90.0,90.0,1,90,0.0,90.0,90.0
135130990.0,17,6,1146,6,1146,27026198.0,191.0,191.0,0,0,0.0,0.0,0.0
3006764.0,6,12,2172,7,664,501029.3333333333,252.0,94.85714285714286,5,1508,1783.0,1236.0,301.6
312828.0,6,3,202,2,128,0.0,74.0,64.0,1,74,0.0,74.0,74.0
43440.0,6,11,2098,6,590,8126.0,252.0,98.33333333333331,5,1508,10683.75,1236.0,301.6
36880.0,6,14,4740,7,653,6026.166666666667,249.0,93.28571428571428,7,4087,5450.166666666667,1514.0,583.8571428571429
106371454.0,6,30,2106,15,1089,7582530.0,123.0,72.6,15,1017,7582541.428571428,123.0,67.8
231694.0,6,3,426,2,280,0.0,214.0,140.0,1,146,0.0,146.0,146.0
122413.0,6,3,373,2,238,0.0,172.0,119.0,1,135,0.0,135.0,135.0
191818.0,17,2,180,1,90,0.0,90.0,90.0,1,90,0.0,90.0,90.0
2847295.0,6,12,2172,7,664,474368.3333333333,252.0,94.85714285714286,5,1508,2087.75,1236.0,301.6
55295.0,6,14,4740,7,653,9095.166666666666,249.0,93.28571428571428,7,4087,8880.833333333334,1514.0,583.8571428571429
24239.0,6,14,4740,7,653,3367.1666666666665,249.0,93.28571428571428,7,4087,3898.6666666666665,1514.0,583.8571428571429
0.0,17,1,55,1,55,0.0,55.0,55.0,0,0,0.0,0.0,0.0
45719.0,6,10,2032,5,524,10598.5,252.0,104.8,5,1508,5817.0,1236.0,301.6
284258.0,17,2,363,1,79,0.0,79.0,79.0,1,284,0.0,284.0,284.0
75047.0,6,14,4740,7,653,12290.166666666666,249.0,93.28571428571428,7,4087,12353.0,1514.0,583.8571428571429
153464.0,17,2,180,1,90,0.0,90.0,90.0,1,90,0.0,90.0,90.0
316.0,17,2,174,1,79,0.0,79.0,79.0,1,95,0.0,95.0,95.0
0.0,17,1,80,1,80,0.0,80.0,80.0,0,0,0.0,0.0,0.0
304849.0,6,6,412,4,272,101616.33333333331,74.0,68.0,2,140,0.0,74.0,70.0
120224996.0,6,216,24440,108,7350,1115879.738317757,140.0,68.05555555555556,108,17090,1096563.710280374,284.0,158.24074074074073
90006255.0,6,14,1043,7,542,15001042.5,95.0,77.42857142857143,7,501,14950103.0,95.0,71.57142857142857
10438089.0,6,6,412,3,206,5148718.0,74.0,68.66666666666667,3,206,5148572.5,74.0,68.66666666666667
3649656.0,6,5,336,2,134,0.0,68.0,67.0,3,202,538504.5,70.0,67.33333333333333
10461544.0,6,7,478,4,272,3441721.333333333,74.0,68.0,3,206,5162513.0,74.0,68.66666666666667
228391.0,17,2,180,1,90,0.0,90.0,90.0,1,90,0.0,90.0,90.0
115251219.0,6,29,1914,15,948,8232229.928571428,123.0,63.2,14,966,8081207.153846154,123.0,69.0
90004437.0,17,27,12943,27,12943,3461709.1153846155,501.0,479.3703703703704,0,0,0.0,0.0,0.0
107842470.0,6,28,1860,14,966,8295574.615384615,123.0,69.0,14,894,8278944.230769231,123.0,63.85714285714285
144035.0,17,2,180,1,90,0.0,90.0,90.0,1,90,0.0,90.0,90.0
30978.0,6,13,1459,7,862,4931.166666666667,271.0,123.14285714285714,6,597,5054.4,259.0,99.5
310620.0,6,6,412,4,272,103540.0,74.0,68.0,2,140,0.0,74.0,70.0
120050711.0,17,28,13364,28,13364,4446322.62962963,501.0,477.2857142857143,0,0,0.0,0.0,0.0
209198.0,6,10,1221,6,636,41839.6,298.0,106.0,4,585,68483.66666666667,379.0,146.25
99099793.0,17,12,778,6,389,19800164.0,174.0,64.83333333333333,6,389,19801495.0,174.0,64.83333333333333
108111553.0,17,5,955,5,955,27027888.25,191.0,191.0,0,0,0.0,0.0,0.0
113254979.0,6,46,3036,23,1518,5135437.363636363,66.0,66.0,23,1518,5135435.590909091,66.0,66.0
104548267.0,6,29,2046,15,1017,7467733.357142857,123.0,67.8,14,1029,7257432.153846154,123.0,73.5
90275130.0,6,12,1832,8,1016,12896447.142857144,188.0,127.0,4,816,30036723.666666668,204.0,204.0
144821.0,17,2,180,1,70,0.0,70.0,70.0,1,110,0.0,110.0,110.0
136078.0,6,2,132,1,66,0.0,66.0,66.0,1,66,0.0,66.0,66.0
90056140.0,17,28,13364,28,13364,3335412.592592593,501.0,477.2857142857143,0,0,0.0,0.0,0.0
38766.0,6,14,4740,7,653,4368.166666666667,249.0,93.28571428571428,7,4087,5880.666666666667,1514.0,583.8571428571429
3238.0,17,4,344,2,150,0.0,75.0,75.0,2,194,0.0,103.0,97.0
32635.0,6,13,1479,7,882,5439.166666666667,291.0,126.0,6,597,5649.2,259.0,99.5
6767.0,17,2,582,1,83,0.0,83.0,83.0,1,499,0.0,499.0,499.0
51729501.0,6,8,2113,3,960,24539227.0,826.0,320.0,5,1153,12237460.75,885.0,230.6
90255356.0,6,12,1832,8,1016,12893622.285714284,188.0,127.0,4,816,30030224.666666668,204.0,204.0
2272355.0,6,49,23728,25,19797,94681.45833333331,1514.0,791.88,24,3931,89456.60869565218,1514.0,163.79166666666666
56035.0,6,14,4740,7,653,9141.166666666666,249.0,93.28571428571428,7,4087,7786.833333333333,1514.0,583.8571428571429
15968741.0,6,26,7627,14,3735,208710.0769230769,1514.0,266.7857142857143,12,3892,1432024.0,1514.0,324.3333333333333
1177711.0,6,13,3011,8,2383,168244.42857142858,1514.0,297.875,5,628,225447.25,331.0,125.6
134615.0,6,10,1066,5,490,33039.0,218.0,98.0,5,576,33452.25,304.0,115.2
1301.0,17,2,762,2,762,0.0,381.0,381.0,0,0,0.0,0.0,0.0
120117564.0,6,13,2036,5,1020,30029391.0,204.0,204.0,8,1016,17136303.57142857,188.0,127.0
67526.0,6,14,4740,7,653,10930.166666666666,249.0,93.28571428571428,7,4087,11066.0,1514.0,583.8571428571429
108108495.0,17,5,1005,5,1005,27027123.75,201.0,201.0,0,0,0.0,0.0,0.0
146357.0,6,3,337,2,214,0.0,160.0,107.0,1,123,0.0,123.0,123.0
2054.0,17,4,438,2,148,0.0,74.0,74.0,2,290,0.0,147.0,145.0
34143.0,6,14,4740,7,653,4951.833333333333,249.0,93.28571428571428,7,4087,5478.166666666667,1514.0,583.8571428571429
123447325.0,17,14,864,7,432,17334250.666666668,174.0,61.71428571428572,7,432,17333490.0,174.0,61.71428571428572
206005.0,17,2,180,1,90,0.0,90.0,90.0,1,90,0.0,90.0,90.0
206962.0,17,2,762,2,762,0.0,381.0,381.0,0,0,0.0,0.0,0.0
135136005.0,17,6,1206,6,1206,27027201.0,201.0,201.0,0,0,0.0,0.0,0.0
90261012.0,6,14,2240,8,1016,12894430.285714284,188.0,127.0,6,1224,18019351.6,204.0,204.0
135135990.0,17,6,1206,6,1206,27027198.0,201.0,201.0,0,0,0.0,0.0,0.0
113519520.0,6,46,3036,23,1518,5159966.0,66.0,66.0,23,1518,5159966.181818182,66.0,66.0
1704563.0,6,22,6443,12,1529,154960.27272727274,357.0,127.41666666666669,10,4914,155438.77777777778,1510.0,491.4
102589.0,17,2,286,2,286,0.0,143.0,143.0,0,0,0.0,0.0,0.0
120124538.0,6,13,2020,9,1204,15015567.25,188.0,133.77777777777777,4,816,30030996.666666668,204.0,204.0
108100498.0,17,5,955,5,955,27025124.5,191.0,191.0,0,0,0.0,0.0,0.0
103508.0,17,2,286,2,286,0.0,143.0,143.0,0,0,0.0,0.0,0.0
207073.0,6,3,426,2,280,0.0,214.0,140.0,1,146,0.0,146.0,146.0
104344.0,6,14,4740,7,653,15994.666666666666,249.0,93.28571428571428,7,4087,16393.333333333332,1514.0,583.8571428571429
274254.0,6,3,337,2,214,0.0,160.0,107.0,1,123,0.0,123.0,123.0
90025193.0,17,28,13364,28,13364,3334266.407407407,501.0,477.2857142857143,0,0,0.0,0.0,0.0
2825837.0,6,2,132,1,66,0.0,66.0,66.0,1,66,0.0,66.0,66.0
1112725.0,6,4,492,2,280,0.0,214.0,140.0,2,212,0.0,146.0,106.0
1417831.0,17,16,1120,16,1120,94522.06666666668,70.0,70.0,0,0,0.0,0.0,0.0
237492.0,17,2,180,1,90,0.0,90.0,90.0,1,90,0.0,90.0,90.0
51513.0,6,14,4740,7,653,7959.666666666667,249.0,93.28571428571428,7,4087,7631.0,1514.0,583.8571428571429
103223036.0,17,14,864,7,432,17167978.833333332,174.0,61.71428571428572,7,432,17166836.666666668,174.0,61.71428571428572
92113844.0,6,38,2508,19,1254,5105442.388888889,66.0,66.0,19,1254,5105449.888888889,66.0,66.0
33846.0,6,10,2032,5,524,8110.0,252.0,104.8,5,1508,7999.0,1236.0,301.6
24420.0,6,14,4740,7,653,3904.1666666666665,249.0,93.28571428571428,7,4087,3235.0,1514.0,583.8571428571429
319.0,17,2,168,1,76,0.0,76.0,76.0,1,92,0.0,92.0,92.0
10470044.0,6,7,478,4,272,3444672.0,74.0,68.0,3,206,5166912.0,74.0,68.66666666666667
282158.0,17,2,180,1,90,0.0,90.0,90.0,1,90,0.0,90.0,90.0
315722.0,17,4,1400,4,1400,105240.66666666669,350.0,350.0,0,0,0.0,0.0,0.0
32948.0,6,14,4740,7,653,5018.166666666667,249.0,93.28571428571428,7,4087,5024.166666666667,1514.0,583.8571428571429
42006.0,6,14,4740,7,653,6689.666666666667,249.0,93.28571428571428,7,4087,6586.5,1514.0,583.8571428571429
25688.0,6,10,2032,5,524,5245.0,252.0,104.8,5,1508,5914.5,1236.0,301.6
108111263.0,17,5,955,5,955,27027815.75,191.0,191.0,0,0,0.0,0.0,0.0
217794.0,6,3,426,2,280,0.0,214.0,140.0,1,146,0.0,146.0,146.0
94132569.0,6,164,18556,82,12922,1159472.950617284,284.0,157.58536585365854,82,5634,1159472.740740741,140.0,68.70731707317073
90768511.0,6,19,1565,10,745,10079873.222222222,95.0,74.5,9,820,11345503.375,224.0,91.11111111111111
108105154.0,17,5,955,5,955,27026288.5,191.0,191.0,0,0,0.0,0.0,0.0
256522.0,6,3,373,2,238,0.0,172.0,119.0,1,135,0.0,135.0,135.0
22634.0,17,2,582,1,83,0.0,83.0,83.0,1,499,0.0,499.0,499.0
120241360.0,6,18,1341,9,691,14998921.875,95.0,76.77777777777777,9,650,14998758.0,95.0,72.22222222222223
120004674.0,6,20,1531,11,840,12000467.4,95.0,76.36363636363636,9,691,11342647.625,95.0,76.77777777777777
108107970.0,17,5,955,5,955,27026992.5,191.0,191.0,0,0,0.0,0.0,0.0
43859.0,6,14,4740,7,653,7188.833333333333,249.0,93.28571428571428,7,4087,6910.333333333333,1514.0,583.8571428571429
115018.0,6,2,132,1,66,0.0,66.0,66.0,1,66,0.0,66.0,66.0
1150614.0,6,13,3005,8,2377,164373.42857142858,1514.0,297.125,5,628,219532.0,331.0,125.6
57515.0,6,10,2032,5,524,14056.75,252.0,104.8,5,1508,13393.75,1236.0,301.6
220279.0,6,3,426,2,280,0.0,214.0,140.0,1,146,0.0,146.0,146.0
325.0,17,2,174,1,79,0.0,79.0,79.0,1,95,0.0,95.0,95.0
96698675.0,6,42,3462,23,1884,4385592.2727272725,123.0,81.91304347826087,19,1578,5360058.277777778,123.0,83.05263157894737
209022.0,6,3,426,2,280,0.0,214.0,140.0,1,146,0.0,146.0,146.0
750.0,17,4,438,2,148,0.0,74.0,74.0,2,290,0.0,147.0,145.0
3086431.0,6,3,204,2,136,0.0,70.0,68.0,1,68,0.0,68.0,68.0
21847.0,6,10,2032,5,524,5225.25,252.0,104.8,5,1508,5046.75,1236.0,301.6
2524.0,17,4,344,2,150,0.0,75.0,75.0,2,194,0.0,103.0,97.0
228151.0,17,2,180,1,90,0.0,90.0,90.0,1,90,0.0,90.0,90.0
90287751.0,6,12,1832,8,1016,12898250.142857144,188.0,127.0,4,816,30043239.33333333,204.0,204.0
856536.0,6,9,1118,6,586,171307.2,248.0,97.66666666666669,3,532,290304.0,392.0,177.33333333333334
219491.0,6,3,426,2,280,0.0,214.0,140.0,1,146,0.0,146.0,146.0
149719727.0,6,15,2290,5,1020,29962676.25,204.0,204.0,10,1270,16635399.444444444,188.0,127.0
50252.0,6,14,4740,7,653,7707.833333333333,249.0,93.28571428571428,7,4087,7943.0,1514.0,583.8571428571429
120539.0,6,3,337,2,214,0.0,160.0,107.0,1,123,0.0,123.0,123.0
443.0,17,2,166,1,75,0.0,75.0,75.0,1,91,0.0,91.0,91.0
109646413.0,17,14,864,7,432,18166820.166666668,174.0,61.71428571428572,7,432,18168176.5,174.0,61.71428571428572
9296.0,17,2,582,1,83,0.0,83.0,83.0,1,499,0.0,499.0,499.0
107458.0,17,4,1400,4,1400,35819.333333333336,350.0,350.0,0,0,0.0,0.0,0.0
316627.0,17,4,1400,4,1400,105542.33333333331,350.0,350.0,0,0,0.0,0.0,0.0
2795613.0,6,2,132,1,66,0.0,66.0,66.0,1,66,0.0,66.0,66.0
0.0,17,1,90,1,90,0.0,90.0,90.0,0,0,0.0,0.0,0.0
120018688.0,17,28,13364,28,13364,4445136.592592592,501.0,477.2857142857143,0,0,0.0,0.0,0.0
32103.0,6,20,7606,11,978,3210.3,310.0,88.9090909090909,9,6628,3759.125,1514.0,736.4444444444445
45003069.0,17,9,3086,8,2736,5135829.571428572,342.0,342.0,1,350,0.0,350.0,350.0
10491675.0,6,7,478,4,272,3450053.6666666665,74.0,68.0,3,206,5174950.5,74.0,68.66666666666667
216340.0,17,2,180,1,90,0.0,90.0,90.0,1,90,0.0,90.0,90.0
262848.0,6,3,337,2,214,0.0,160.0,107.0,1,123,0.0,123.0,123.0
90295227.0,6,16,1192,8,596,12892617.714285716,95.0,74.5,8,596,12898396.142857144,95.0,74.5
2070.0,17,4,344,2,150,0.0,75.0,75.0,2,194,0.0,103.0,97.0
20198.0,6,11,2098,6,590,2970.6,252.0,98.33333333333331,5,1508,4785.5,1236.0,301.6
197111.0,17,2,180,1,90,0.0,90.0,90.0,1,90,0.0,90.0,90.0
103339252.0,17,14,864,7,432,17166829.166666668,174.0,61.71428571428572,7,432,17168201.0,174.0,61.71428571428572
105492988.0,17,14,1126,7,563,17502030.0,174.0,80.42857142857143,7,563,17555675.166666668,174.0,80.42857142857143
5625322.0,6,5,336,2,134,0.0,68.0,67.0,3,202,1421281.5,70.0,67.33333333333333
3406.0,17,2,762,2,762,0.0,381.0,381.0,0,0,0.0,0.0,0.0
348.0,17,2,267,1,83,0.0,83.0,83.0,1,184,0.0,184.0,184.0
308037.0,6,6,412,4,272,102679.0,74.0,68.0,2,140,0.0,74.0,70.0
211798.0,17,2,180,1,90,0.0,90.0,90.0,1,90,0.0,90.0,90.0
108106856.0,17,5,955,5,955,27026714.0,191.0,191.0,0,0,0.0,0.0,0.0
90041255.0,17,28,13364,28,13364,3334861.296296296,501.0,477.2857142857143,0,0,0.0,0.0,0.0
232402.0,6,3,337,2,214,0.0,160.0,107.0,1,123,0.0,123.0,123.0
108102820.0,17,5,1005,5,1005,27025705.0,201.0,201.0,0,0,0.0,0.0,0.0
155770.0,6,3,337,2,214,0.0,160.0,107.0,1,123,0.0,123.0,123.0
86791451.0,6,29,2121,16,1162,5785486.933333334,95.0,72.625,13,959,7231822.916666667,95.0,73.76923076923077
92710069.0,6,38,2508,19,1254,5135444.333333333,66.0,66.0,19,1254,5135442.333333333,66.0,66.0
111033533.0,6,30,1974,15,1026,7915532.928571428,123.0,68.4,15,948,7915536.357142857,123.0,63.2
143883.0,17,2,180,1,90,0.0,90.0,90.0,1,90,0.0,90.0,90.0
39008.0,6,14,4740,7,653,6379.5,249.0,93.28571428571428,7,4087,6361.666666666667,1514.0,583.8571428571429
1352822.0,6,7,499,4,301,445194.0,103.0,75.25,3,198,612511.0,66.0,66.0
108109436.0,17,5,955,5,955,27027359.0,191.0,191.0,0,0,0.0,0.0,0.0
160217.0,17,2,180,1,90,0.0,90.0,90.0,1,90,0.0,90.0,90.0
2794978.0,6,2,132,1,66,0.0,66.0,66.0,1,66,0.0,66.0,66.0
25655.0,6,14,4740,7,653,4032.0,249.0,93.28571428571428,7,4087,3856.3333333333335,1514.0,583.8571428571429
360.0,17,2,267,1,83,0.0,83.0,83.0,1,184,0.0,184.0,184.0
457982.0,6,10,1221,6,636,91596.4,298.0,106.0,4,585,146829.0,379.0,146.25
52386.0,6,11,2098,6,590,8971.4,252.0,98.33333333333331,5,1508,5826.75,1236.0,301.6
56773.0,6,10,2032,5,524,13978.25,252.0,104.8,5,1508,12948.0,1236.0,301.6
264799.0,6,10,1221,6,636,52959.8,298.0,106.0,4,585,82843.33333333333,379.0,146.25
112861777.0,6,30,1990,15,1042,8046138.642857143,139.0,69.46666666666667,15,948,8046134.285714285,123.0,63.2
90254061.0,6,16,2368,9,1204,11281757.625,188.0,133.77777777777777,7,1164,15015501.666666666,204.0,166.28571428571428
35449.0,6,10,1066,5,490,8160.25,218.0,98.0,5,576,8664.0,304.0,115.2
45014.0,6,14,4740,7,653,7380.166666666667,249.0,93.28571428571428,7,4087,6974.166666666667,1514.0,583.8571428571429
90259027.0,6,13,2036,8,1016,12894146.714285716,188.0,127.0,5,1020,22523672.0,204.0,204.0
0.0,6,1,66,1,66,0.0,66.0,66.0,0,0,0.0,0.0,0.0
224084.0,6,10,1221,6,636,44816.8,298.0,106.0,4,585,72516.0,379.0,146.25
128004491.0,17,15,907,8,475,18286355.85714286,174.0,59.375,7,432,18000165.5,174.0,61.71428571428572
307392.0,6,3,202,2,128,0.0,74.0,64.0,1,74,0.0,74.0,74.0
48632953.0,6,8,1940,3,887,22904137.5,753.0,295.6666666666667,5,1053,11534725.25,785.0,210.6
44790.0,6,10,2032,5,524,10857.75,252.0,104.8,5,1508,10358.0,1236.0,301.6
120123263.0,6,15,2428,9,1204,15015407.875,188.0,133.77777777777777,6,1224,18019270.4,204.0,204.0
0.0,17,1,55,1,55,0.0,55.0,55.0,0,0,0.0,0.0,0.0
27685.0,6,10,2032,5,524,6380.5,252.0,104.8,5,1508,6066.0,1236.0,301.6
51145.0,6,14,4740,7,653,8113.5,249.0,93.28571428571428,7,4087,6045.833333333333,1514.0,583.8571428571429
3577908.0,6,5,336,2,134,0.0,68.0,67.0,3,202,1425377.0,70.0,67.33333333333333
26437.0,6,10,2032,5,524,5063.75,252.0,104.8,5,1508,6034.5,1236.0,301.6
114086335.0,6,48,3168,24,1584,4960275.434782608,66.0,66.0,24,1584,4946695.565217392,66.0,66.0
12038105.0,17,5,2265,5,2265,3009526.25,453.0,453.0,0,0,0.0,0.0,0.0
281229.0,17,2,363,1,79,0.0,79.0,79.0,1,284,0.0,284.0,284.0
0.0,17,1,179,1,179,0.0,179.0,179.0,0,0,0.0,0.0,0.0
16832.0,17,2,180,1,90,0.0,90.0,90.0,1,90,0.0,90.0,90.0
1165620.0,6,13,3017,8,2389,166517.14285714287,1514.0,298.625,5,628,222534.25,331.0,125.6
120053666.0,17,28,13364,28,13364,4446432.074074074,501.0,477.2857142857143,0,0,0.0,0.0,0.0
283868.0,17,2,363,1,79,0.0,79.0,79.0,1,284,0.0,284.0,284.0
198666.0,17,2,180,1,90,0.0,90.0,90.0,1,90,0.0,90.0,90.0
20911.0,6,10,2032,5,524,4916.75,252.0,104.8,5,1508,3202.0,1236.0,301.6
352.0,17,2,267,1,83,0.0,83.0,83.0,1,184,0.0,184.0,184.0
16001.000000000002,6,11,2098,6,590,3200.2,252.0,98.33333333333331,5,1508,2599.75,1236.0,301.6
2439.0,17,4,344,2,150,0.0,75.0,75.0,2,194,0.0,103.0,97.0
107519.0,17,2,286,2,286,0.0,143.0,143.0,0,0,0.0,0.0,0.0
143948.0,17,2,180,1,90,0.0,90.0,90.0,1,90,0.0,90.0,90.0
159095.0,6,2,128,1,74,0.0,74.0,74.0,1,54,0.0,54.0,54.0
2589288.0,6,2,132,1,66,0.0,66.0,66.0,1,66,0.0,66.0,66.0
135143608.0,17,6,1146,6,1146,27028721.6,191.0,191.0,0,0,0.0,0.0,0.0
297442.0,6,6,412,4,272,99147.33333333331,74.0,68.0,2,140,0.0,74.0,70.0
108105628.0,17,5,1005,5,1005,27026407.0,201.0,201.0,0,0,0.0,0.0,0.0
90018587.0,6,25,1702,13,840,7501548.916666667,123.0,64.61538461538461,12,862,7426533.454545454,139.0,71.83333333333333
107800.0,17,2,286,2,286,0.0,143.0,143.0,0,0,0.0,0.0,0.0
53880.0,6,14,4740,7,653,7717.833333333333,249.0,93.28571428571428,7,4087,8815.833333333334,1514.0,583.8571428571429
313241.0,17,4,1400,4,1400,104413.66666666669,350.0,350.0,0,0,0.0,0.0,0.0
274534.0,6,10,1221,6,636,54906.8,298.0,106.0,4,585,85960.33333333333,379.0,146.25
13714495.0,6,264,250144,75,5112,185331.01351351352,208.0,68.16,189,245032,72877.41489361702,1514.0,1296.4656084656085
220589.0,6,3,426,2,280,0.0,214.0,140.0,1,146,0.0,146.0,146.0
16081.000000000002,6,14,4740,7,653,2533.5,249.0,93.28571428571428,7,4087,2543.5,1514.0,583.8571428571429
17731.0,6,2,145,2,145,0.0,91.0,72.5,0,0,0.0,0.0,0.0
108108535.0,17,5,1005,5,1005,27027133.75,201.0,201.0,0,0,0.0,0.0,0.0
135141215.0,17,6,1146,6,1146,27028243.0,191.0,191.0,0,0,0.0,0.0,0.0
137690.0,6,2,132,1,66,0.0,66.0,66.0,1,66,0.0,66.0,66.0
844200.0,6,9,1118,6,586,168840.0,248.0,97.66666666666669,3,532,284277.5,392.0,177.33333333333334
113593724.0,6,35,2542,18,1348,6681983.764705882,139.0,74.88888888888889,17,1194,7086086.0,123.0,70.23529411764706
255142.0,6,3,337,2,214,0.0,160.0,107.0,1,123,0.0,123.0,123.0
756338.0,6,6,758,3,410,351992.0,172.0,136.66666666666666,3,348,261595.0,135.0,116.0
0.0,6,1,172,1,172,0.0,172.0,172.0,0,0,0.0,0.0,0.0
270448.0,6,10,1221,6,636,54089.6,298.0,106.0,4,585,81822.33333333333,379.0,146.25
70923.0,6,11,2098,6,590,14184.6,252.0,98.33333333333331,5,1508,17068.75,1236.0,301.6
135129968.0,17,6,1146,6,1146,27025993.6,191.0,191.0,0,0,0.0,0.0,0.0
27713.0,6,10,2032,5,524,6082.5,252.0,104.8,5,1508,6348.25,1236.0,301.6
90011930.0,17,28,13364,28,13364,3333775.185185185,501.0,477.2857142857143,0,0,0.0,0.0,0.0
90059740.0,17,28,13364,28,13364,3335545.925925926,501.0,477.2857142857143,0,0,0.0,0.0,0.0
101665803.0,6,33,2428,17,1288,6340618.3125,139.0,75.76470588235294,16,1140,6763314.333333333,123.0,71.25
44581.0,6,14,4740,7,653,7306.666666666667,249.0,93.28571428571428,7,4087,7072.666666666667,1514.0,583.8571428571429
284636.0,17,2,363,1,79,0.0,79.0,79.0,1,284,0.0,284.0,284.0
102733.0,17,2,286,2,286,0.0,143.0,143.0,0,0,0.0,0.0,0.0
96217718.0,17,12,778,6,389,19200848.8,174.0,64.83333333333333,6,389,19200208.8,174.0,64.83333333333333
2803539.0,6,2,132,1,66,0.0,66.0,66.0,1,66,0.0,66.0,66.0
322657.0,6,3,1604,1,753,0.0,753.0,753.0,2,851,0.0,785.0,425.5
90013216.0,17,27,12943,27,12943,3462046.769230769,501.0,479.3703703703704,0,0,0.0,0.0,0.0
207378.0,6,3,426,2,280,0.0,214.0,140.0,1,146,0.0,146.0,146.0
28332.0,6,14,4740,7,653,4479.0,249.0,93.28571428571428,7,4087,4498.5,1514.0,583.8571428571429
20024.0,6,10,2032,5,524,4777.5,252.0,104.8,5,1508,4492.0,1236.0,301.6
2932658.0,6,3,1604,2,851,0.0,785.0,425.5,1,753,0.0,753.0,753.0
104796677.0,17,14,4788,14,4788,8061282.846153846,342.0,342.0,0,0,0.0,0.0,0.0
162423.0,17,2,180,1,90,0.0,90.0,90.0,1,90,0.0,90.0,90.0
40496160.0,6,26,7627,14,3735,204324.0769230769,1514.0,266.7857142857143,12,3892,3661797.454545455,1514.0,324.3333333333333
100803511.0,6,33,2359,17,1194,6300194.1875,123.0,70.23529411764706,16,1165,6720135.866666666,139.0,72.8125
274331.0,6,10,1221,6,636,54866.2,298.0,106.0,4,585,86076.0,379.0,146.25
135133917.0,17,6,1206,6,1206,27026783.4,201.0,201.0,0,0,0.0,0.0,0.0
101056816.0,17,14,864,7,432,16833500.333333332,174.0,61.71428571428572,7,432,16835250.5,174.0,61.71428571428572
15277.0,17,4,823,2,163,0.0,89.0,81.5,2,660,0.0,443.0,330.0
332294.0,6,10,1221,6,636,66458.8,298.0,106.0,4,585,104471.33333333331,379.0,146.25
320.0,17,2,174,1,79,0.0,79.0,79.0,1,95,0.0,95.0,95.0
41552.0,6,14,4740,7,653,6706.166666666667,249.0,93.28571428571428,7,4087,6532.333333333333,1514.0,583.8571428571429
220528.0,17,2,180,1,90,0.0,90.0,90.0,1,90,0.0,90.0,90.0
199422.0,17,4,6056,4,6056,66474.0,1514.0,1514.0,0,0,0.0,0.0,0.0
311119.0,6,6,412,4,272,103706.33333333331,74.0,68.0,2,140,0.0,74.0,70.0
36436.0,6,14,4740,7,653,5140.666666666667,249.0,93.28571428571428,7,4087,5621.333333333333,1514.0,583.8571428571429
1439.0,17,5,550,5,550,359.75,110.0,110.0,0,0,0.0,0.0,0.0
281654.0,17,2,363,1,79,0.0,79.0,79.0,1,284,0.0,284.0,284.0
14657.0,6,14,4740,7,653,2229.5,249.0,93.28571428571428,7,4087,2312.333333333333,1514.0,583.8571428571429
298861.0,6,6,412,4,272,99620.33333333331,74.0,68.0,2,140,0.0,74.0,70.0
45581.0,6,14,4740,7,653,7285.666666666667,249.0,93.28571428571428,7,4087,7142.833333333333,1514.0,583.8571428571429
226063.0,6,3,426,2,280,0.0,214.0,140.0,1,146,0.0,146.0,146.0
113766212.0,6,47,3102,24,1584,4936969.391304348,66.0,66.0,23,1518,5105433.090909091,66.0,66.0
1166099.0,6,13,3010,8,2382,166585.57142857142,1514.0,297.75,5,628,222587.25,331.0,125.6
32957.0,6,14,4740,7,653,5301.166666666667,249.0,93.28571428571428,7,4087,5161.666666666667,1514.0,583.8571428571429
108098756.0,17,5,1005,5,1005,27024689.0,201.0,201.0,0,0,0.0,0.0,0.0
245496.0,6,3,337,2,214,0.0,160.0,107.0,1,123,0.0,123.0,123.0
120654502.0,6,214,24090,108,16872,1127612.168224299,284.0,156.22222222222223,106,7218,1137603.9523809524,140.0,68.09433962264151
1780333.0,6,2,132,1,66,0.0,66.0,66.0,1,66,0.0,66.0,66.0
14636316.0,6,20,1607,10,975,1592771.5555555555,315.0,97.5,10,632,1592725.888888889,78.0,63.2
235855.0,6,3,337,2,214,0.0,160.0,107.0,1,123,0.0,123.0,123.0
4508.0,17,2,626,1,72,0.0,72.0,72.0,1,554,0.0,554.0,554.0
228272.0,17,2,180,1,90,0.0,90.0,90.0,1,90,0.0,90.0,90.0
908.0,17,4,438,2,148,0.0,74.0,74.0,2,290,0.0,147.0,145.0
103235081.0,17,14,864,7,432,17167705.833333332,174.0,61.71428571428572,7,432,17166861.166666668,174.0,61.71428571428572
108100901.0,17,5,1005,5,1005,27025225.25,201.0,201.0,0,0,0.0,0.0,0.0
791.0,17,5,550,5,550,197.75,110.0,110.0,0,0,0.0,0.0,0.0
103332712.0,6,44,2904,22,1452,4920605.333333333,66.0,66.0,22,1452,4914291.095238095,66.0,66.0
17979.0,6,14,4740,7,653,2403.333333333333,249.0,93.28571428571428,7,4087,2805.1666666666665,1514.0,583.8571428571429
228182.0,17,2,180,1,90,0.0,90.0,90.0,1,90,0.0,90.0,90.0
219953.0,6,10,1221,6,636,43990.6,298.0,106.0,4,585,71570.66666666667,379.0,146.25
1468812.0,6,19,7533,10,1403,163201.33333333334,583.0,140.3,9,6130,151772.5,1484.0,681.1111111111111
102811.0,17,2,286,2,286,0.0,143.0,143.0,0,0,0.0,0.0,0.0
98191.0,17,2,762,2,762,0.0,381.0,381.0,0,0,0.0,0.0,0.0
2303.0,17,4,344,2,150,0.0,75.0,75.0,2,194,0.0,103.0,97.0
37160.0,6,14,4740,7,653,5628.5,249.0,93.28571428571428,7,4087,5995.166666666667,1514.0,583.8571428571429
119316355.0,6,215,24284,108,7424,1115106.1214953272,140.0,68.74074074074075,107,16860,1115760.075471698,284.0,157.57009345794393
11894.0,6,14,4740,7,653,1718.5,249.0,93.28571428571428,7,4087,1845.5,1514.0,583.8571428571429
36230.0,6,14,4740,7,653,5766.0,249.0,93.28571428571428,7,4087,5372.0,1514.0,583.8571428571429
90299559.0,6,14,1043,7,542,15049926.5,95.0,77.42857142857143,7,501,14999447.166666666,95.0,71.57142857142857
1156474.0,6,13,3010,8,2382,165210.57142857142,1514.0,297.75,5,628,220934.5,331.0,125.6
297199.0,17,2,180,1,90,0.0,90.0,90.0,1,90,0.0,90.0,90.0
10021.0,17,4,823,2,163,0.0,89.0,81.5,2,660,0.0,443.0,330.0
15543.0,6,14,4740,7,653,2333.6666666666665,249.0,93.28571428571428,7,4087,2450.5,1514.0,583.8571428571429
317568.0,6,10,1221,6,636,63513.6,298.0,106.0,4,585,100511.0,379.0,146.25
32210.000000000004,6,14,4740,7,653,5150.0,249.0,93.28571428571428,7,4087,5131.833333333333,1514.0,583.8571428571429
120128168.0,6,230,26084,115,7886,1046530.5614035088,140.0,68.57391304347826,115,18198,1046511.7807017544,390.0,158.24347826086955
6707.0,17,4,823,2,163,0.0,89.0,81.5,2,660,0.0,443.0,330.0
367.0,17,2,267,1,83,0.0,83.0,83.0,1,184,0.0,184.0,184.0
96611.0,6,14,4740,7,653,15974.333333333334,249.0,93.28571428571428,7,4087,13456.666666666666,1514.0,583.8571428571429
300.0,17,2,164,1,82,0.0,82.0,82.0,1,82,0.0,82.0,82.0
17900.0,6,20,7606,11,978,1781.4,310.0,88.9090909090909,9,6628,1849.75,1514.0,736.4444444444445
18843.0,6,10,2032,5,524,4378.75,252.0,104.8,5,1508,4404.75,1236.0,301.6
120181095.0,6,1106,248960,542,36598,222146.20147874308,214.0,67.5239852398524,564,212362,213064.92362344585,1514.0,376.52836879432624
146144.0,6,3,337,2,214,0.0,160.0,107.0,1,123,0.0,123.0,123.0
108094208.0,17,5,955,5,955,27023552.0,191.0,191.0,0,0,0.0,0.0,0.0
328.0,17,2,166,1,75,0.0,75.0,75.0,1,91,0.0,91.0,91.0
203277.0,17,2,762,2,762,0.0,381.0,381.0,0,0,0.0,0.0,0.0
17777.0,6,10,2032,5,524,3977.75,252.0,104.8,5,1508,4111.5,1236.0,301.6
112619405.0,6,31,2166,16,1149,7493567.333333333,123.0,71.8125,15,1017,8028826.0,123.0,67.8
90255311.0,6,13,2036,8,1016,12893615.857142856,188.0,127.0,5,1020,22522609.25,204.0,204.0
55675544.0,17,9,3086,8,2736,5106253.571428572,342.0,342.0,1,350,0.0,350.0,350.0
143178.0,6,2,132,1,66,0.0,66.0,66.0,1,66,0.0,66.0,66.0
443.0,17,2,160,1,80,0.0,80.0,80.0,1,80,0.0,80.0,80.0
141822.0,6,2,132,1,66,0.0,66.0,66.0,1,66,0.0,66.0,66.0
205693.0,17,2,762,2,762,0.0,381.0,381.0,0,0,0.0,0.0,0.0
2430.0,17,4,344,2,150,0.0,75.0,75.0,2,194,0.0,103.0,97.0
276195.0,17,2,180,1,90,0.0,90.0,90.0,1,90,0.0,90.0,90.0
72171.0,6,13,1386,7,789,12028.5,253.0,112.71428571428572,6,597,12197.0,259.0,99.5
304232.0,6,6,412,4,272,101410.66666666669,74.0,68.0,2,140,0.0,74.0,70.0
47796.0,6,14,4740,7,653,7841.333333333333,249.0,93.28571428571428,7,4087,7614.0,1514.0,583.8571428571429
206677.0,6,3,426,2,280,0.0,214.0,140.0,1,146,0.0,146.0,146.0
239238.0,17,2,180,1,90,0.0,90.0,90.0,1,90,0.0,90.0,90.0
2111178.0,6,25,7611,13,2516,175931.5,1034.0,193.53846153846155,12,5095,163960.81818181818,1510.0,424.5833333333333
26239.0,6,14,4740,7,653,3861.3333333333335,249.0,93.28571428571428,7,4087,3856.0,1514.0,583.8571428571429
119806541.0,6,214,24202,107,16844,1128108.5,284.0,157.42056074766356,107,7358,1128118.2358490566,140.0,68.76635514018692
108111047.0,17,5,955,5,955,27027761.75,191.0,191.0,0,0,0.0,0.0,0.0
306898.0,6,2,132,1,66,0.0,66.0,66.0,1,66,0.0,66.0,66.0
120002051.0,6,16,1192,8,596,17143150.14285714,95.0,74.5,8,596,17107644.14285714,95.0,74.5
308108.0,6,6,412,4,272,102702.66666666669,74.0,68.0,2,140,0.0,74.0,70.0
32180.0,6,14,4740,7,653,3661.6666666666665,249.0,93.28571428571428,7,4087,5044.333333333333,1514.0,583.8571428571429
9787.0,17,2,571,1,86,0.0,86.0,86.0,1,485,0.0,485.0,485.0
108332485.0,17,8,1818,6,1206,21666497.0,201.0,201.0,2,612,0.0,306.0,306.0
20420.0,6,14,4740,7,653,2466.833333333333,249.0,93.28571428571428,7,4087,3266.1666666666665,1514.0,583.8571428571429
1323725.0,6,4,264,2,132,0.0,66.0,66.0,2,132,0.0,66.0,66.0
108097528.0,17,5,1005,5,1005,27024382.0,201.0,201.0,0,0,0.0,0.0,0.0
419029.0,6,3,204,2,136,0.0,70.0,68.0,1,68,0.0,68.0,68.0
90064511.0,17,27,12943,27,12943,3464019.653846154,501.0,479.3703703703704,0,0,0.0,0.0,0.0
29407951.0,6,11,738,5,342,7351263.25,95.0,68.4,6,396,5878982.0,95.0,66.0
99013097.0,17,14,1126,7,563,16500960.333333334,174.0,80.42857142857143,7,563,16500139.5,174.0,80.42857142857143
304140.0,6,6,412,4,272,101380.0,74.0,68.0,2,140,0.0,74.0,70.0
101009449.0,17,13,821,7,432,16834908.166666668,174.0,61.71428571428572,6,389,20000183.6,174.0,64.83333333333333
870663.0,6,10,1336,6,799,174132.6,461.0,133.16666666666666,4,537,198359.66666666663,331.0,134.25
296032.0,17,2,363,1,79,0.0,79.0,79.0,1,284,0.0,284.0,284.0
102014837.0,6,189,21376,95,14950,1085264.2234042552,284.0,157.3684210526316,94,6426,1085784.9784946237,140.0,68.36170212765957
120001426.0,6,17,1287,9,691,15000178.25,95.0,76.77777777777777,8,596,12857746.142857144,95.0,74.5
108111222.0,17,5,1005,5,1005,27027805.5,201.0,201.0,0,0,0.0,0.0,0.0
2779709.0,6,2,132,1,66,0.0,66.0,66.0,1,66,0.0,66.0,66.0
892.0,17,4,438,2,148,0.0,74.0,74.0,2,290,0.0,147.0,145.0
5623856.0,6,5,336,2,134,0.0,68.0,67.0,3,202,1525639.5,70.0,67.33333333333333
2445.0,17,4,344,2,150,0.0,75.0,75.0,2,194,0.0,103.0,97.0
307304.0,6,6,412,4,272,102434.66666666669,74.0,68.0,2,140,0.0,74.0,70.0
16626.0,6,10,2032,5,524,3934.25,252.0,104.8,5,1508,3711.75,1236.0,301.6
17020.0,6,20,7606,11,978,1702.0,310.0,88.9090909090909,9,6628,1828.125,1514.0,736.4444444444445
766.0,17,4,438,2,148,0.0,74.0,74.0,2,290,0.0,147.0,145.0
120205315.0,6,242,27182,121,8282,995405.4083333332,140.0,68.44628099173553,121,18900,994814.375,284.0,156.19834710743802
301630.0,6,6,412,4,272,100543.33333333331,74.0,68.0,2,140,0.0,74.0,70.0
298931.0,6,10,1221,6,636,59786.2,298.0,106.0,4,585,94272.33333333331,379.0,146.25
131090.0,6,13,1394,7,797,21848.33333333333,253.0,113.85714285714286,6,597,24239.6,259.0,99.5
0.0,17,1,453,1,453,0.0,453.0,453.0,0,0,0.0,0.0,0.0
114638421.0,6,30,1974,15,1026,8173054.142857143,123.0,68.4,15,948,8173051.428571428,123.0,63.2
338003.0,6,6,412,4,272,112667.66666666669,74.0,68.0,2,140,0.0,74.0,70.0
90049707.0,17,28,13364,28,13364,3335174.333333333,501.0,477.2857142857143,0,0,0.0,0.0,0.0
284708.0,17,2,363,1,79,0.0,79.0,79.0,1,284,0.0,284.0,284.0
209467.0,17,2,180,1,90,0.0,90.0,90.0,1,90,0.0,90.0,90.0
22741.0,6,11,1133,6,602,4449.6,264.0,100.33333333333331,5,531,5099.5,259.0,106.2
108100844.0,17,5,955,5,955,27025211.0,191.0,191.0,0,0,0.0,0.0,0.0
25853.0,6,14,4740,7,653,3882.0,249.0,93.28571428571428,7,4087,3763.1666666666665,1514.0,583.8571428571429
101322697.0,6,180,20316,90,14154,1135908.3483146068,284.0,157.26666666666668,90,6162,1135908.573033708,140.0,68.46666666666667
101207.0,17,2,762,2,762,0.0,381.0,381.0,0,0,0.0,0.0,0.0
120029215.0,17,28,13364,28,13364,4445526.481481481,501.0,477.2857142857143,0,0,0.0,0.0,0.0
311529.0,6,3,202,2,128,0.0,74.0,64.0,1,74,0.0,74.0,74.0
142024.0,17,4,704,2,148,0.0,74.0,74.0,2,556,0.0,280.0,278.0
421747.0,6,3,204,2,136,0.0,70.0,68.0,1,68,0.0,68.0,68.0
141620.0,6,2,132,1,66,0.0,66.0,66.0,1,66,0.0,66.0,66.0
206119.0,6,3,426,2,280,0.0,214.0,140.0,1,146,0.0,146.0,146.0
90008363.0,17,28,13364,28,13364,3333643.074074074,501.0,477.2857142857143,0,0,0.0,0.0,0.0
90097570.0,6,11,1644,4,816,30031764.0,204.0,204.0,7,828,15015884.5,188.0,118.28571428571428
206029.0,6,3,426,2,280,0.0,214.0,140.0,1,146,0.0,146.0,146.0
0.0,17,1,44,1,44,0.0,44.0,44.0,0,0,0.0,0.0,0.0
16074.000000000002,6,10,2032,5,524,3795.75,252.0,104.8,5,1508,3600.5,1236.0,301.6
120214628.0,6,18,1341,9,691,14999920.125,95.0,76.77777777777777,9,650,14999913.875,95.0,72.22222222222223
22439.0,6,13,1386,7,789,2992.333333333333,253.0,112.71428571428572,6,597,4161.6,259.0,99.5
206114.0,6,3,426,2,280,0.0,214.0,140.0,1,146,0.0,146.0,146.0
3211.0,17,2,363,1,79,0.0,79.0,79.0,1,284,0.0,284.0,284.0
4712.0,17,2,614,1,72,0.0,72.0,72.0,1,542,0.0,542.0,542.0
233959.0,6,3,337,2,214,0.0,160.0,107.0,1,123,0.0,123.0,123.0
50867.0,17,2,180,1,90,0.0,90.0,90.0,1,90,0.0,90.0,90.0
97056246.0,17,14,1126,7,563,16166825.333333334,174.0,80.42857142857143,7,563,16167273.166666666,174.0,80.42857142857143
21071216.0,17,3,1034,2,684,0.0,342.0,342.0,1,350,0.0,350.0,350.0
233430.0,6,3,337,2,214,0.0,160.0,107.0,1,123,0.0,123.0,123.0
135137535.0,17,6,1146,6,1146,27027507.0,191.0,191.0,0,0,0.0,0.0,0.0
25517.0,6,10,2032,5,524,6150.75,252.0,104.8,5,1508,5565.75,1236.0,301.6
153629.0,17,2,180,1,90,0.0,90.0,90.0,1,90,0.0,90.0,90.0
3742992.0,6,5,336,2,134,0.0,68.0,67.0,3,202,1530062.5,70.0,67.33333333333333
1182196.0,6,11,1134,6,558,236439.2,220.0,93.0,5,576,291303.25,304.0,115.2
108119411.0,17,5,1005,5,1005,27029852.75,201.0,201.0,0,0,0.0,0.0,0.0
240674.0,6,3,373,2,238,0.0,172.0,119.0,1,135,0.0,135.0,135.0
90042.0,6,12,1320,7,789,15007.0,253.0,112.71428571428572,5,531,17162.75,259.0,106.2
120102550.0,6,230,26068,115,7886,1047227.1228070176,140.0,68.57391304347826,115,18182,1050148.7631578948,284.0,158.10434782608695
11596.0,6,10,2032,5,524,2592.0,252.0,104.8,5,1508,2230.0,1236.0,301.6
351.0,17,2,160,1,80,0.0,80.0,80.0,1,80,0.0,80.0,80.0
5629002.0,6,5,336,2,134,0.0,68.0,67.0,3,202,1527678.0,70.0,67.33333333333333
1763641.0,6,2,132,1,66,0.0,66.0,66.0,1,66,0.0,66.0,66.0
801.0,17,4,438,2,148,0.0,74.0,74.0,2,290,0.0,147.0,145.0
2407.0,17,4,344,2,150,0.0,75.0,75.0,2,194,0.0,103.0,97.0
503657.0,6,5,336,2,134,0.0,68.0,67.0,3,202,196572.0,70.0,67.33333333333333
729735.0,6,10,1221,6,636,145947.0,298.0,106.0,4,585,241701.66666666663,379.0,146.25
211436.0,17,2,180,1,90,0.0,90.0,90.0,1,90,0.0,90.0,90.0
31148.0,6,14,4740,7,653,5076.666666666667,249.0,93.28571428571428,7,4087,4978.5,1514.0,583.8571428571429
305236.0,6,3,202,2,128,0.0,74.0,64.0,1,74,0.0,74.0,74.0
3010662.0,6,15,1443,8,764,429839.5714285714,262.0,95.5,7,679,501634.8333333333,259.0,97.0
109863.0,17,4,1400,4,1400,36621.0,350.0,350.0,0,0,0.0,0.0,0.0
324.0,17,2,174,1,79,0.0,79.0,79.0,1,95,0.0,95.0,95.0
90668521.0,6,25,1924,11,840,9042851.9,95.0,76.36363636363636,14,1084,6958746.846153846,95.0,77.42857142857143
108104964.0,17,5,955,5,955,27026241.0,191.0,191.0,0,0,0.0,0.0,0.0
10863035.0,6,8,544,4,272,3575418.6666666665,74.0,68.0,4,272,3575323.0,74.0,68.0
107177.0,17,2,286,2,286,0.0,143.0,143.0,0,0,0.0,0.0,0.0
438582.0,6,10,967,5,390,73628.75,162.0,78.0,5,577,73573.25,349.0,115.4
218607.0,6,10,1221,6,636,43721.4,298.0,106.0,4,585,71686.66666666667,379.0,146.25
135136041.0,17,6,1146,6,1146,27027208.2,191.0,191.0,0,0,0.0,0.0,0.0
25641.0,6,14,4740,7,653,3580.0,249.0,93.28571428571428,7,4087,4105.833333333333,1514.0,583.8571428571429
90367888.0,6,11,1644,7,828,15061314.666666666,188.0,118.28571428571428,4,816,20112285.666666668,204.0,204.0
90062732.0,17,28,13364,28,13364,3335656.7407407407,501.0,477.2857142857143,0,0,0.0,0.0,0.0
351354.0,6,4,508,2,238,0.0,172.0,119.0,2,270,0.0,135.0,135.0
130705.0,6,3,337,2,214,0.0,160.0,107.0,1,123,0.0,123.0,123.0
110119591.0,6,852,170916,421,28378,262168.1523809524,214.0,67.40617577197149,431,142538,256043.2186046512,1514.0,330.7146171693735
38345.0,6,12,1320,6,723,6208.4,253.0,120.5,6,597,6665.8,259.0,99.5
108106917.0,17,5,955,5,955,27026729.25,191.0,191.0,0,0,0.0,0.0,0.0
5632690.0,6,4,270,2,134,0.0,68.0,67.0,2,136,0.0,70.0,68.0
26287.0,6,14,4740,7,653,4260.833333333333,249.0,93.28571428571428,7,4087,4090.3333333333335,1514.0,583.8571428571429
3624.0,17,4,344,2,150,0.0,75.0,75.0,2,194,0.0,103.0,97.0
218918.0,6,3,426,2,280,0.0,214.0,140.0,1,146,0.0,146.0,146.0
100255247.0,17,12,516,6,258,20000222.4,43.0,43.0,6,258,20001047.4,43.0,43.0
14928.0,17,2,180,1,90,0.0,90.0,90.0,1,90,0.0,90.0,90.0
15744.999999999998,17,2,180,1,90,0.0,90.0,90.0,1,90,0.0,90.0,90.0
90052451.0,17,28,13364,28,13364,3335275.962962963,501.0,477.2857142857143,0,0,0.0,0.0,0.0
114488797.0,6,296,34760,148,24696,777370.4013605443,284.0,166.86486486486487,148,10064,777370.5034013606,140.0,68.0
123739599.0,6,49,3234,24,1584,4945317.0,66.0,66.0,25,1650,5155803.791666667,66.0,66.0
1296235.0,6,7,499,3,198,614833.5,66.0,66.0,4,301,408085.3333333333,103.0,75.25
30882.0,6,14,4740,7,653,4746.833333333333,249.0,93.28571428571428,7,4087,4345.833333333333,1514.0,583.8571428571429
153453.0,17,2,180,1,90,0.0,90.0,90.0,1,90,0.0,90.0,90.0
2056.0,17,4,344,2,150,0.0,75.0,75.0,2,194,0.0,103.0,97.0
93109836.0,6,38,2508,19,1254,5155430.611111111,66.0,66.0,19,1254,5155425.333333333,66.0,66.0
6609.0,17,2,582,1,83,0.0,83.0,83.0,1,499,0.0,499.0,499.0
120429589.0,6,239,26910,120,18834,1012013.3529411764,284.0,156.95,119,8076,973472.9152542372,140.0,67.8655462184874
52949.0,6,14,4740,7,653,8558.333333333334,249.0,93.28571428571428,7,4087,8444.833333333334,1514.0,583.8571428571429
146176.0,6,3,337,2,214,0.0,160.0,107.0,1,123,0.0,123.0,123.0
30017.0,6,2,145,2,145,0.0,91.0,72.5,0,0,0.0,0.0,0.0
59299.0,6,14,4740,7,653,9720.833333333334,249.0,93.28571428571428,7,4087,9596.666666666666,1514.0,583.8571428571429
142941.0,17,2,176,1,80,0.0,80.0,80.0,1,96,0.0,96.0,96.0
17127.0,17,2,571,1,86,0.0,86.0,86.0,1,485,0.0,485.0,485.0
0.0,17,1,342,1,342,0.0,342.0,342.0,0,0,0.0,0.0,0.0
1310079.0,6,4,264,2,132,0.0,66.0,66.0,2,132,0.0,66.0,66.0
171699.0,17,2,180,1,90,0.0,90.0,90.0,1,90,0.0,90.0,90.0
228206.0,17,2,180,1,90,0.0,90.0,90.0,1,90,0.0,90.0,90.0
231084.0,17,2,180,1,90,0.0,90.0,90.0,1,90,0.0,90.0,90.0
2373.0,17,4,344,2,150,0.0,75.0,75.0,2,194,0.0,103.0,97.0
40073.0,6,13,1386,7,789,6678.833333333333,253.0,112.71428571428572,6,597,6430.4,259.0,99.5
38667.0,6,10,2032,5,524,8180.5,252.0,104.8,5,1508,9348.5,1236.0,301.6
1320822.0,6,4,264,2,132,0.0,66.0,66.0,2,132,0.0,66.0,66.0
135128847.0,17,6,1146,6,1146,27025769.4,191.0,191.0,0,0,0.0,0.0,0.0
232855.0,6,3,337,2,214,0.0,160.0,107.0,1,123,0.0,123.0,123.0
12568.0,6,10,2032,5,524,2891.5,252.0,104.8,5,1508,1719.75,1236.0,301.6
48639.0,6,14,4740,7,653,6672.833333333333,249.0,93.28571428571428,7,4087,7457.0,1514.0,583.8571428571429
197727.0,17,2,180,1,90,0.0,90.0,90.0,1,90,0.0,90.0,90.0
69918.0,17,2,626,1,72,0.0,72.0,72.0,1,554,0.0,554.0,554.0
2377.0,17,4,344,2,150,0.0,75.0,75.0,2,194,0.0,103.0,97.0
349335.0,6,10,1221,6,636,69867.0,298.0,106.0,4,585,110007.33333333331,379.0,146.25
171643.0,17,2,180,1,90,0.0,90.0,90.0,1,90,0.0,90.0,90.0
116006655.0,6,34,2466,17,1272,7236929.125,123.0,74.82352941176471,17,1194,7236927.25,123.0,70.23529411764706
90038711.0,17,28,13364,28,13364,3334767.074074074,501.0,477.2857142857143,0,0,0.0,0.0,0.0
125001265.0,17,14,864,8,475,17857323.57142857,174.0,59.375,6,389,20995382.4,174.0,64.83333333333333
293.0,17,2,168,1,76,0.0,76.0,76.0,1,92,0.0,92.0,92.0
218538.0,6,3,426,2,280,0.0,214.0,140.0,1,146,0.0,146.0,146.0
530.0,17,2,508,2,508,0.0,257.0,254.0,0,0,0.0,0.0,0.0
30952.0,6,10,2032,5,524,7498.0,252.0,104.8,5,1508,7057.25,1236.0,301.6
321129.0,17,4,704,2,148,0.0,74.0,74.0,2,556,0.0,280.0,278.0
37580.0,6,14,4740,7,653,6053.0,249.0,93.28571428571428,7,4087,5907.5,1514.0,583.8571428571429
0.0,6,1,66,1,66,0.0,66.0,66.0,0,0,0.0,0.0,0.0
108102370.0,17,5,1005,5,1005,27025592.5,201.0,201.0,0,0,0.0,0.0,0.0
300569.0,6,6,412,4,272,100189.66666666669,74.0,68.0,2,140,0.0,74.0,70.0
115504.0,6,2,132,1,66,0.0,66.0,66.0,1,66,0.0,66.0,66.0
65153.0,6,14,4740,7,653,10665.333333333334,249.0,93.28571428571428,7,4087,10509.666666666666,1514.0,583.8571428571429
153469.0,17,2,180,1,90,0.0,90.0,90.0,1,90,0.0,90.0,90.0
1112.0,17,2,762,2,762,0.0,381.0,381.0,0,0,0.0,0.0,0.0
511100.0,6,5,336,2,134,0.0,68.0,67.0,3,202,191941.0,70.0,67.33333333333333
146323.0,6,3,337,2,214,0.0,160.0,107.0,1,123,0.0,123.0,123.0
19627.0,6,10,2032,5,524,4687.0,252.0,104.8,5,1508,4328.25,1236.0,301.6
90281994.0,6,17,1287,9,691,11279961.75,95.0,76.77777777777777,8,596,12830364.57142857,95.0,74.5
108392157.0,17,14,864,7,432,18000169.5,174.0,61.71428571428572,7,432,18000910.833333332,174.0,61.71428571428572
30740101.0,6,31,9412,17,3897,143946.625,1514.0,229.23529411764707,14,5515,2348863.6923076925,1514.0,393.9285714285714
205995.0,6,3,426,2,280,0.0,214.0,140.0,1,146,0.0,146.0,146.0
878227.0,6,10,1335,6,798,175645.4,460.0,133.0,4,537,201879.3333333333,331.0,134.25
875.0,17,4,438,2,148,0.0,74.0,74.0,2,290,0.0,147.0,145.0
33004.0,6,14,4740,7,653,5252.333333333333,249.0,93.28571428571428,7,4087,5174.333333333333,1514.0,583.8571428571429
2046.0,17,4,344,2,150,0.0,75.0,75.0,2,194,0.0,103.0,97.0
369.0,17,2,160,1,80,0.0,80.0,80.0,1,80,0.0,80.0,80.0
5627835.0,6,4,270,2,134,0.0,68.0,67.0,2,136,0.0,70.0,68.0
99123563.0,6,193,21714,97,6624,1032537.1145833334,140.0,68.28865979381443,96,15090,1037221.347368421,284.0,157.1875
42034.0,6,14,4740,7,653,6836.333333333333,249.0,93.28571428571428,7,4087,6716.333333333333,1514.0,583.8571428571429
449.0,17,2,508,2,508,0.0,257.0,254.0,0,0,0.0,0.0,0.0
1396371.0,17,16,1120,16,1120,93091.4,70.0,70.0,0,0,0.0,0.0,0.0
116454.0,6,11,2098,6,590,23226.0,252.0,98.33333333333331,5,1508,27561.25,1236.0,301.6
113746940.0,6,46,3036,23,1518,5156342.863636363,66.0,66.0,23,1518,5155854.636363637,66.0,66.0
64163.0,6,14,4740,7,653,10271.333333333334,249.0,93.28571428571428,7,4087,8369.166666666666,1514.0,583.8571428571429
44391488.0,6,8,745,8,745,6341641.142857143,97.0,93.125,0,0,0.0,0.0,0.0
5627802.0,6,4,270,2,134,0.0,68.0,67.0,2,136,0.0,70.0,68.0
2356.0,17,4,344,2,150,0.0,75.0,75.0,2,194,0.0,103.0,97.0
135116081.0,17,6,1146,6,1146,27023216.2,191.0,191.0,0,0,0.0,0.0,0.0
120042500.0,6,21,1585,11,840,11999111.0,95.0,76.36363636363636,10,745,13332319.888888888,95.0,74.5
50941.0,6,14,4740,7,653,8363.666666666666,249.0,93.28571428571428,7,4087,7806.666666666667,1514.0,583.8571428571429
108103179.0,17,5,955,5,955,27025794.75,191.0,191.0,0,0,0.0,0.0,0.0
10466587.0,6,7,478,4,272,3443438.0,74.0,68.0,3,206,5165089.0,74.0,68.66666666666667
236449.0,6,3,337,2,214,0.0,160.0,107.0,1,123,0.0,123.0,123.0
9737.0,17,2,539,1,86,0.0,86.0,86.0,1,453,0.0,453.0,453.0
21577.0,6,14,4740,7,653,3452.1666666666665,249.0,93.28571428571428,7,4087,3264.5,1514.0,583.8571428571429
294079.0,6,10,1221,6,636,58815.8,298.0,106.0,4,585,91869.66666666669,379.0,146.25
2942680.0,6,11,2106,6,598,588272.8,252.0,99.66666666666669,5,1508,3289.75,1236.0,301.6
108318651.0,6,29,2052,15,1089,7721618.285714285,123.0,72.6,14,963,8315454.230769231,123.0,68.78571428571429
75091169.0,6,9,842,9,842,9386396.125,97.0,93.55555555555556,0,0,0.0,0.0,0.0
10470081.0,6,7,478,4,272,3444576.333333333,74.0,68.0,3,206,5166754.5,74.0,68.66666666666667
211690.0,17,4,6056,4,6056,70563.33333333333,1514.0,1514.0,0,0,0.0,0.0,0.0
249483.0,6,3,373,2,238,0.0,172.0,119.0,1,135,0.0,135.0,135.0
23143292.0,17,3,1034,2,684,0.0,342.0,342.0,1,350,0.0,350.0,350.0
1166909.0,6,13,3010,8,2382,166701.2857142857,1514.0,297.75,5,628,223528.25,331.0,125.6
146897.0,6,3,373,2,238,0.0,172.0,119.0,1,135,0.0,135.0,135.0
205773.0,17,2,180,1,90,0.0,90.0,90.0,1,90,0.0,90.0,90.0
106944.0,17,2,700,2,700,0.0,350.0,350.0,0,0,0.0,0.0,0.0
130533.0,6,3,337,2,214,0.0,160.0,107.0,1,123,0.0,123.0,123.0
90276631.0,6,14,2102,8,1016,12896661.57142857,188.0,127.0,6,1086,18018988.6,204.0,181.0
108664302.0,6,34,2482,17,1288,6777950.9375,139.0,75.76470588235294,17,1194,6777533.125,123.0,70.23529411764706
301395.0,17,2,180,1,90,0.0,90.0,90.0,1,90,0.0,90.0,90.0
104956.0,17,2,286,2,286,0.0,143.0,143.0,0,0,0.0,0.0,0.0
147917.0,17,2,180,1,90,0.0,90.0,90.0,1,90,0.0,90.0,90.0
90258030.0,6,12,1832,8,1016,12894004.285714284,188.0,127.0,4,816,30031600.666666668,204.0,204.0
301501.0,6,6,412,4,272,100500.33333333331,74.0,68.0,2,140,0.0,74.0,70.0
304494.0,6,6,412,4,272,101498.0,74.0,68.0,2,140,0.0,74.0,70.0
243513.0,6,3,337,2,214,0.0,160.0,107.0,1,123,0.0,123.0,123.0
28223.0,6,13,4416,6,409,5504.6,127.0,68.16666666666667,7,4007,4398.166666666667,1514.0,572.4285714285714
136389.0,6,2,132,1,66,0.0,66.0,66.0,1,66,0.0,66.0,66.0
209483.0,17,2,180,1,90,0.0,90.0,90.0,1,90,0.0,90.0,90.0
113731865.0,6,46,3036,23,1518,5155438.590909091,66.0,66.0,23,1518,5155441.727272728,66.0,66.0
135134819.0,17,6,1206,6,1206,27026963.8,201.0,201.0,0,0,0.0,0.0,0.0
312984.0,17,2,238,1,74,0.0,74.0,74.0,1,164,0.0,164.0,164.0
120122363.0,6,14,2240,6,1224,24024472.6,204.0,204.0,8,1016,17136888.42857143,188.0,127.0
46241.0,6,14,4740,7,653,7438.5,249.0,93.28571428571428,7,4087,6893.0,1514.0,583.8571428571429
105389.0,17,2,762,2,762,0.0,381.0,381.0,0,0,0.0,0.0,0.0
135131480.0,17,6,1206,6,1206,27026296.0,201.0,201.0,0,0,0.0,0.0,0.0
153522.0,17,2,180,1,90,0.0,90.0,90.0,1,90,0.0,90.0,90.0
6002844.0,17,3,1143,3,1143,3001422.0,381.0,381.0,0,0,0.0,0.0,0.0
302387.0,6,6,412,4,272,100795.66666666669,74.0,68.0,2,140,0.0,74.0,70.0
153421.0,17,2,180,1,90,0.0,90.0,90.0,1,90,0.0,90.0,90.0
119785995.0,6,24,1829,11,840,11978599.5,95.0,76.36363636363636,13,989,9961660.416666666,95.0,76.07692307692308
417068.0,6,3,1604,2,851,0.0,785.0,425.5,1,753,0.0,753.0,753.0
269401.0,6,10,1221,6,636,53880.2,298.0,106.0,4,585,84072.0,379.0,146.25
16592.0,6,14,4740,7,653,2609.0,249.0,93.28571428571428,7,4087,2497.6666666666665,1514.0,583.8571428571429
149671.0,17,2,180,1,90,0.0,90.0,90.0,1,90,0.0,90.0,90.0
196968.0,17,2,180,1,90,0.0,90.0,90.0,1,90,0.0,90.0,90.0
58775.0,6,14,4740,7,653,9250.0,249.0,93.28571428571428,7,4087,9581.5,1514.0,583.8571428571429
108099584.0,17,5,955,5,955,27024896.0,191.0,191.0,0,0,0.0,0.0,0.0
1991.0,17,4,344,2,150,0.0,75.0,75.0,2,194,0.0,103.0,97.0
90257636.0,6,13,2036,8,1016,12893948.0,188.0,127.0,5,1020,22522736.5,204.0,204.0
120084114.0,17,28,13364,28,13364,4447559.777777778,501.0,477.2857142857143,0,0,0.0,0.0,0.0
2364791.0,6,49,23728,25,19797,98532.95833333331,1514.0,791.88,24,3931,92891.73913043478,1514.0,163.79166666666666
307402.0,6,6,412,4,272,102467.33333333331,74.0,68.0,2,140,0.0,74.0,70.0
494948.0,6,2,145,2,145,0.0,91.0,72.5,0,0,0.0,0.0,0.0
105078149.0,6,77,26328,38,13018,2839917.972972973,1514.0,342.57894736842104,39,13310,2765164.052631579,1514.0,341.28205128205127
207231.0,6,3,426,2,280,0.0,214.0,140.0,1,146,0.0,146.0,146.0
191245.0,17,2,180,1,90,0.0,90.0,90.0,1,90,0.0,90.0,90.0
2089065.0,6,23,7478,12,2450,189915.0,1034.0,204.16666666666663,11,5028,177888.6,1510.0,457.09090909090907
216779.0,6,3,426,2,280,0.0,214.0,140.0,1,146,0.0,146.0,146.0
307223.0,6,6,412,4,272,102407.66666666669,74.0,68.0,2,140,0.0,74.0,70.0
30446.0,6,14,4740,7,653,4947.666666666667,249.0,93.28571428571428,7,4087,4450.5,1514.0,583.8571428571429
279651.0,17,4,571,2,148,0.0,74.0,74.0,2,423,0.0,276.0,211.5
2346.0,17,4,344,2,150,0.0,75.0,75.0,2,194,0.0,103.0,97.0
315768.0,17,4,1400,4,1400,105256.0,350.0,350.0,0,0,0.0,0.0,0.0
2388.0,17,4,344,2,150,0.0,75.0,75.0,2,194,0.0,103.0,97.0
312578.0,17,4,1400,4,1400,104192.66666666669,350.0,350.0,0,0,0.0,0.0,0.0
59905.0,6,14,4740,7,653,9814.833333333334,249.0,93.28571428571428,7,4087,9839.166666666666,1514.0,583.8571428571429
9400.0,17,2,582,1,83,0.0,83.0,83.0,1,499,0.0,499.0,499.0
880195.0,6,10,1335,6,798,176039.0,460.0,133.0,4,537,201545.3333333333,331.0,134.25
90212449.0,6,19,1436,9,691,11246633.875,95.0,76.77777777777777,10,745,10000795.444444444,95.0,74.5
17227.0,6,14,4740,7,653,2758.6666666666665,249.0,93.28571428571428,7,4087,2521.5,1514.0,583.8571428571429
120568308.0,6,415,53224,208,39340,582455.5942028986,352.0,189.1346153846154,207,13884,580816.5533980583,140.0,67.07246376811594
225950.0,6,12,1373,7,714,37658.333333333336,298.0,102.0,5,659,55439.5,379.0,131.8
51792.0,6,14,4740,7,653,7856.5,249.0,93.28571428571428,7,4087,8390.833333333334,1514.0,583.8571428571429
90258523.0,6,13,2036,8,1016,12894074.714285716,188.0,127.0,5,1020,22523461.75,204.0,204.0
120009396.0,6,30,2317,17,1328,7499987.75,95.0,78.11764705882354,13,989,10000345.416666666,95.0,76.07692307692308
228156.0,17,2,180,1,90,0.0,90.0,90.0,1,90,0.0,90.0,90.0
15138.0,17,2,180,1,90,0.0,90.0,90.0,1,90,0.0,90.0,90.0
321404.0,6,6,412,4,272,107134.66666666669,74.0,68.0,2,140,0.0,74.0,70.0
1220609.0,17,7,490,7,490,203434.8333333333,70.0,70.0,0,0,0.0,0.0,0.0
103802.0,17,2,286,2,286,0.0,143.0,143.0,0,0,0.0,0.0,0.0
1380769.0,6,4,276,2,128,0.0,74.0,64.0,2,148,0.0,74.0,74.0
119857216.0,6,13,1898,9,1082,14982152.0,188.0,120.22222222222224,4,816,30031005.0,204.0,204.0
303283.0,17,2,238,1,74,0.0,74.0,74.0,1,164,0.0,164.0,164.0
120398092.0,6,225,25520,113,17832,1074982.9642857143,336.0,157.8053097345133,112,7688,1066098.009009009,140.0,68.64285714285714
43844.0,6,13,1479,7,882,7307.333333333333,291.0,126.0,6,597,6436.4,259.0,99.5
90089239.0,6,11,1644,7,828,15014873.166666666,188.0,118.28571428571428,4,816,20020065.33333333,204.0,204.0
2352389.0,6,3,1604,2,851,0.0,785.0,425.5,1,753,0.0,753.0,753.0
120050643.0,6,643,83328,322,61920,373989.5420560748,554.0,192.2981366459628,321,21408,373940.540625,140.0,66.69158878504673
120474737.0,6,295,34694,148,24770,819556.0340136054,284.0,167.36486486486487,147,9924,818106.9178082192,140.0,67.51020408163265
206517.0,6,3,426,2,280,0.0,214.0,140.0,1,146,0.0,146.0,146.0
31564.0,6,14,4740,7,653,4289.666666666667,249.0,93.28571428571428,7,4087,5118.666666666667,1514.0,583.8571428571429
213649.0,17,2,180,1,90,0.0,90.0,90.0,1,90,0.0,90.0,90.0
134088.0,17,6,1230,3,234,66852.5,78.0,78.0,3,996,66839.5,332.0,332.0
120126543.0,6,13,2020,9,1204,15015817.875,188.0,133.77777777777777,4,816,30032898.0,204.0,204.0
31034.0,6,14,4740,7,653,3423.333333333333,249.0,93.28571428571428,7,4087,4963.666666666667,1514.0,583.8571428571429
119339190.0,6,20,1490,10,745,13259910.0,95.0,74.5,10,745,13232097.111111112,95.0,74.5
306557.0,6,6,412,4,272,102185.66666666669,74.0,68.0,2,140,0.0,74.0,70.0
20091.0,6,14,4740,7,653,2866.833333333333,249.0,93.28571428571428,7,4087,3122.833333333333,1514.0,583.8571428571429
9672.0,17,4,823,2,163,0.0,89.0,81.5,2,660,0.0,443.0,330.0
113419618.0,6,45,2970,23,1518,5155437.181818182,66.0,66.0,22,1452,4918956.952380952,66.0,66.0
106704.0,17,2,286,2,286,0.0,143.0,143.0,0,0,0.0,0.0,0.0
90023535.0,17,28,13364,28,13364,3334205.0,501.0,477.2857142857143,0,0,0.0,0.0,0.0
216430.0,6,10,1221,6,636,43286.0,298.0,106.0,4,585,70454.0,379.0,146.25
41578.0,6,14,4740,7,653,6716.0,249.0,93.28571428571428,7,4087,6652.833333333333,1514.0,583.8571428571429
54267.0,6,10,2032,5,524,13237.25,252.0,104.8,5,1508,11008.5,1236.0,301.6
118201844.0,6,47,3102,24,1584,5139194.826086956,66.0,66.0,23,1518,5159998.954545454,66.0,66.0
1306951.0,6,4,264,2,132,0.0,66.0,66.0,2,132,0.0,66.0,66.0
307261.0,6,6,412,4,272,102420.33333333331,74.0,68.0,2,140,0.0,74.0,70.0
249051.0,6,3,337,2,214,0.0,160.0,107.0,1,123,0.0,123.0,123.0
136568.0,6,13,1386,7,789,22761.33333333333,253.0,112.71428571428572,6,597,24414.8,259.0,99.5
323.0,17,2,174,1,79,0.0,79.0,79.0,1,95,0.0,95.0,95.0
2308.0,17,4,344,2,150,0.0,75.0,75.0,2,194,0.0,103.0,97.0
108100832.0,17,5,1005,5,1005,27025208.0,201.0,201.0,0,0,0.0,0.0,0.0
219521.0,6,3,426,2,280,0.0,214.0,140.0,1,146,0.0,146.0,146.0
232662.0,17,4,1400,4,1400,77554.0,350.0,350.0,0,0,0.0,0.0,0.0
178769.0,17,2,180,1,90,0.0,90.0,90.0,1,90,0.0,90.0,90.0
236679.0,6,12,1373,7,714,39446.5,298.0,102.0,5,659,58423.25,379.0,131.8
1321456.0,6,4,264,2,132,0.0,66.0,66.0,2,132,0.0,66.0,66.0
143918.0,17,2,180,1,90,0.0,90.0,90.0,1,90,0.0,90.0,90.0
358827.0,6,10,1221,6,636,71765.4,298.0,106.0,4,585,118230.33333333331,379.0,146.25
108105720.0,17,5,1005,5,1005,27026430.0,201.0,201.0,0,0,0.0,0.0,0.0
207414.0,6,3,426,2,280,0.0,214.0,140.0,1,146,0.0,146.0,146.0
343.0,17,2,250,1,93,0.0,93.0,93.0,1,157,0.0,157.0,157.0
103236605.0,6,188,21310,94,14884,1107864.6666666667,374.0,158.3404255319149,94,6426,1107864.677419355,140.0,68.36170212765957
207251.0,6,3,426,2,280,0.0,214.0,140.0,1,146,0.0,146.0,146.0
237616.0,17,2,180,1,90,0.0,90.0,90.0,1,90,0.0,90.0,90.0
2408.0,17,4,344,2,150,0.0,75.0,75.0,2,194,0.0,103.0,97.0
135135155.0,17,6,1146,6,1146,27027031.0,191.0,191.0,0,0,0.0,0.0,0.0
90261776.0,6,13,2036,8,1016,12894539.42857143,188.0,127.0,5,1020,22524862.5,204.0,204.0
147949.0,17,2,180,1,90,0.0,90.0,90.0,1,90,0.0,90.0,90.0
242684.0,6,3,373,2,238,0.0,172.0,119.0,1,135,0.0,135.0,135.0
111040586.0,6,34,2482,17,1288,6926536.3125,139.0,75.76470588235294,17,1194,6926534.4375,123.0,70.23529411764706
205797.0,17,2,180,1,90,0.0,90.0,90.0,1,90,0.0,90.0,90.0
1391322.0,6,7,499,4,301,434746.3333333333,103.0,75.25,3,198,613740.5,66.0,66.0
101168.0,17,2,762,2,762,0.0,381.0,381.0,0,0,0.0,0.0,0.0
14629148.0,6,20,1607,10,975,1592669.0,315.0,97.5,10,632,1592645.5555555555,78.0,63.2
68560.0,6,10,2032,5,524,16891.0,252.0,104.8,5,1508,14914.75,1236.0,301.6
106187039.0,6,44,2904,22,1452,5056525.666666667,66.0,66.0,22,1452,5041650.619047619,66.0,66.0
102811.0,17,2,286,2,286,0.0,143.0,143.0,0,0,0.0,0.0,0.0
143952.0,17,2,180,1,90,0.0,90.0,90.0,1,90,0.0,90.0,90.0
404310.0,6,4,508,2,238,0.0,172.0,119.0,2,270,0.0,135.0,135.0
5900.0,17,2,180,1,90,0.0,90.0,90.0,1,90,0.0,90.0,90.0
3214405.0,6,3,1777,2,951,0.0,885.0,475.5,1,826,0.0,826.0,826.0
2352.0,17,4,344,2,150,0.0,75.0,75.0,2,194,0.0,103.0,97.0
492872.0,17,2,876,2,876,0.0,438.0,438.0,0,0,0.0,0.0,0.0
153433.0,17,2,180,1,90,0.0,90.0,90.0,1,90,0.0,90.0,90.0
119398877.0,6,311,35892,156,10518,770315.3354838709,140.0,67.42307692307692,155,25374,768577.4675324676,374.0,163.70322580645163
106595982.0,6,28,1860,14,966,8183087.307692308,123.0,69.0,14,894,8183090.230769231,123.0,63.85714285714285
302.0,17,2,164,1,82,0.0,82.0,82.0,1,82,0.0,82.0,82.0
321.0,17,2,164,1,82,0.0,82.0,82.0,1,82,0.0,82.0,82.0
10460887.0,6,7,478,4,272,3441606.6666666665,74.0,68.0,3,206,5162331.5,74.0,68.66666666666667
104549.0,17,2,286,2,286,0.0,143.0,143.0,0,0,0.0,0.0,0.0
192976.0,17,2,180,1,90,0.0,90.0,90.0,1,90,0.0,90.0,90.0
10484385.0,6,6,412,3,206,5171678.5,74.0,68.66666666666667,3,206,5171557.5,74.0,68.66666666666667
165808.0,17,2,414,1,88,0.0,88.0,88.0,1,326,0.0,326.0,326.0
302543.0,6,2,132,1,66,0.0,66.0,66.0,1,66,0.0,66.0,66.0
535948.0,17,6,2100,6,2100,107189.6,350.0,350.0,0,0,0.0,0.0,0.0
90254467.0,6,13,2036,8,1016,12893495.285714284,188.0,127.0,5,1020,22522894.25,204.0,204.0
206209.0,6,3,426,2,280,0.0,214.0,140.0,1,146,0.0,146.0,146.0
314.0,17,2,166,1,75,0.0,75.0,75.0,1,91,0.0,91.0,91.0
93202612.0,17,14,1126,7,563,15500127.666666666,174.0,80.42857142857143,7,563,15500772.666666666,174.0,80.42857142857143
90255418.0,6,14,2240,8,1016,12893631.142857144,188.0,127.0,6,1224,18018202.4,204.0,204.0
272815.0,6,4,492,2,280,0.0,214.0,140.0,2,212,0.0,146.0,106.0
102820270.0,17,14,1126,7,563,17109883.666666668,174.0,80.42857142857143,7,563,17018514.5,174.0,80.42857142857143
2868604.0,6,3,204,1,68,0.0,68.0,68.0,2,136,0.0,70.0,68.0
9993671.0,6,7,499,4,301,2690067.0,103.0,75.25,3,198,4103772.5,66.0,66.0
42960.0,6,14,4740,7,653,7036.166666666667,249.0,93.28571428571428,7,4087,6585.333333333333,1514.0,583.8571428571429
206054.0,6,3,426,2,280,0.0,214.0,140.0,1,146,0.0,146.0,146.0
90047491.0,17,28,13364,28,13364,3335092.25925926,501.0,477.2857142857143,0,0,0.0,0.0,0.0
1052770.0,6,11,1134,6,558,210554.0,220.0,93.0,5,576,260643.75,304.0,115.2
120028924.0,6,240,27066,120,8216,1001794.6302521008,140.0,68.46666666666667,120,18850,1002781.0168067229,284.0,157.08333333333334
119539465.0,6,219,24600,110,7482,1096692.3394495412,140.0,68.01818181818182,109,17118,1097209.8796296297,284.0,157.045871559633
26586.0,6,14,4740,7,653,3813.8333333333335,249.0,93.28571428571428,7,4087,4274.666666666667,1514.0,583.8571428571429
46789206.0,6,8,1940,3,887,22352030.5,753.0,295.6666666666667,5,1053,11260258.25,785.0,210.6
102289754.0,17,14,864,7,432,17001112.0,174.0,61.71428571428572,7,432,17000172.833333332,174.0,61.71428571428572
325.0,17,2,156,1,78,0.0,78.0,78.0,1,78,0.0,78.0,78.0
1471966.0,17,16,1120,16,1120,98131.06666666668,70.0,70.0,0,0,0.0,0.0,0.0
58808.0,6,14,4740,7,653,9333.333333333334,249.0,93.28571428571428,7,4087,8930.333333333334,1514.0,583.8571428571429
231855.0,6,3,337,2,214,0.0,160.0,107.0,1,123,0.0,123.0,123.0
351.0,17,2,248,1,84,0.0,84.0,84.0,1,164,0.0,164.0,164.0
2253482.0,6,49,23728,25,19797,93895.08333333331,1514.0,791.88,24,3931,88761.47826086957,1514.0,163.79166666666666
63704.0,6,14,4740,7,653,10391.666666666666,249.0,93.28571428571428,7,4087,10208.666666666666,1514.0,583.8571428571429
104061880.0,6,44,2904,22,1452,4955327.619047619,66.0,66.0,22,1452,4939673.571428572,66.0,66.0
153404.0,17,2,180,1,90,0.0,90.0,90.0,1,90,0.0,90.0,90.0
71754.0,6,14,4740,7,653,11787.833333333334,249.0,93.28571428571428,7,4087,11697.5,1514.0,583.8571428571429
98593.0,17,2,762,2,762,0.0,381.0,381.0,0,0,0.0,0.0,0.0
1163202.0,6,13,3008,8,2380,166171.7142857143,1514.0,297.5,5,628,222656.25,331.0,125.6
10521565.0,6,7,478,4,272,3460204.333333333,74.0,68.0,3,206,5190036.5,74.0,68.66666666666667
421402.0,17,2,363,1,75,0.0,75.0,75.0,1,288,0.0,288.0,288.0
89935.0,6,15,4806,8,719,12603.714285714286,249.0,89.875,7,4087,14628.5,1514.0,583.8571428571429
255201.0,6,3,337,2,214,0.0,160.0,107.0,1,123,0.0,123.0,123.0
0.0,17,1,55,1,55,0.0,55.0,55.0,0,0,0.0,0.0,0.0
1989.0,17,2,932,1,590,0.0,590.0,590.0,1,342,0.0,342.0,342.0
119354020.0,6,275,32654,138,23316,871197.2262773722,284.0,168.95652173913044,137,9338,870006.7132352941,140.0,68.16058394160584
2211.0,17,2,664,1,322,0.0,322.0,322.0,1,342,0.0,342.0,342.0
1302528.0,6,4,264,2,132,0.0,66.0,66.0,2,132,0.0,66.0,66.0
6397.0,17,4,823,2,163,0.0,89.0,81.5,2,660,0.0,443.0,330.0
0.0,17,1,72,1,72,0.0,72.0,72.0,0,0,0.0,0.0,0.0
308397.0,6,6,412,4,272,102799.0,74.0,68.0,2,140,0.0,74.0,70.0
298100.0,6,6,412,4,272,99366.66666666669,74.0,68.0,2,140,0.0,74.0,70.0
316743.0,17,4,1400,4,1400,105581.0,350.0,350.0,0,0,0.0,0.0,0.0
108104844.0,17,5,1005,5,1005,27026211.0,201.0,201.0,0,0,0.0,0.0,0.0
20429.0,17,2,582,1,83,0.0,83.0,83.0,1,499,0.0,499.0,499.0
106282457.0,6,196,22092,98,15402,1093584.9587628867,284.0,157.16326530612244,98,6690,1093585.4226804124,140.0,68.26530612244898
38818.0,6,14,4740,7,653,6143.666666666667,249.0,93.28571428571428,7,4087,6028.666666666667,1514.0,583.8571428571429
37954.0,6,14,4740,7,653,6208.0,249.0,93.28571428571428,7,4087,6105.0,1514.0,583.8571428571429
228363.0,17,2,180,1,90,0.0,90.0,90.0,1,90,0.0,90.0,90.0
98506006.0,17,12,778,6,389,19669004.2,174.0,64.83333333333333,6,389,19564385.0,174.0,64.83333333333333
49999.0,6,14,4740,7,653,8071.0,249.0,93.28571428571428,7,4087,7942.333333333333,1514.0,583.8571428571429
135133063.0,17,6,1146,6,1146,27026612.6,191.0,191.0,0,0,0.0,0.0,0.0
13186.0,6,11,1133,6,602,2403.6,264.0,100.33333333333331,5,531,2840.75,259.0,106.2
147624.0,6,2,132,1,66,0.0,66.0,66.0,1,66,0.0,66.0,66.0
319768.0,6,6,412,4,272,106589.33333333331,74.0,68.0,2,140,0.0,74.0,70.0
36654.0,6,14,4740,7,653,5613.666666666667,249.0,93.28571428571428,7,4087,4644.833333333333,1514.0,583.8571428571429
213848.0,6,10,1221,6,636,42769.6,298.0,106.0,4,585,69663.0,379.0,146.25
121915.0,6,3,373,2,238,0.0,172.0,119.0,1,135,0.0,135.0,135.0
964312.0,6,12,2710,7,742,160718.66666666666,338.0,106.0,5,1968,172201.0,1514.0,393.6
216544.0,6,3,426,2,280,0.0,214.0,140.0,1,146,0.0,146.0,146.0
112464309.0,6,46,3036,23,1518,5112001.818181818,66.0,66.0,23,1518,5112000.136363637,66.0,66.0
151993.0,17,2,414,1,88,0.0,88.0,88.0,1,326,0.0,326.0,326.0
215246.0,17,2,180,1,90,0.0,90.0,90.0,1,90,0.0,90.0,90.0
197755.0,17,2,180,1,90,0.0,90.0,90.0,1,90,0.0,90.0,90.0
25426.0,6,10,2032,5,524,6084.0,252.0,104.8,5,1508,5766.75,1236.0,301.6
27001.0,6,10,2032,5,524,6405.75,252.0,104.8,5,1508,6285.25,1236.0,301.6
25427.0,6,14,4740,7,653,3857.6666666666665,249.0,93.28571428571428,7,4087,3794.8333333333335,1514.0,583.8571428571429
9074.0,17,2,582,1,83,0.0,83.0,83.0,1,499,0.0,499.0,499.0
405.0,17,2,508,2,508,0.0,257.0,254.0,0,0,0.0,0.0,0.0
5828185.0,6,5,336,2,134,0.0,68.0,67.0,3,202,1527586.5,70.0,67.33333333333333
289.0,17,2,156,1,78,0.0,78.0,78.0,1,78,0.0,78.0,78.0
153431.0,17,2,180,1,90,0.0,90.0,90.0,1,90,0.0,90.0,90.0
34914.0,6,11,2098,6,590,6872.8,252.0,98.33333333333331,5,1508,7125.75,1236.0,301.6
68753.0,6,14,4740,7,653,10910.666666666666,249.0,93.28571428571428,7,4087,8911.833333333334,1514.0,583.8571428571429
199779.0,17,4,6056,4,6056,66593.0,1514.0,1514.0,0,0,0.0,0.0,0.0
21241.0,6,14,4740,7,653,2952.1666666666665,249.0,93.28571428571428,7,4087,2979.5,1514.0,583.8571428571429
103395849.0,6,182,20538,91,14236,1147262.8111111112,284.0,156.43956043956044,91,6302,1146452.3666666667,140.0,69.25274725274726
1992084.0,17,2,876,2,876,0.0,438.0,438.0,0,0,0.0,0.0,0.0
153393.0,17,2,414,1,88,0.0,88.0,88.0,1,326,0.0,326.0,326.0
36586.0,6,14,4740,7,653,5585.5,249.0,93.28571428571428,7,4087,5412.166666666667,1514.0,583.8571428571429
350.0,17,2,267,1,83,0.0,83.0,83.0,1,184,0.0,184.0,184.0
301440.0,6,7,478,4,272,100480.0,74.0,68.0,3,206,75206.0,74.0,68.66666666666667
104351.0,17,2,700,2,700,0.0,350.0,350.0,0,0,0.0,0.0,0.0
17137.0,6,10,2032,5,524,3516.75,252.0,104.8,5,1508,4037.5,1236.0,301.6
303629.0,6,6,412,4,272,101209.66666666669,74.0,68.0,2,140,0.0,74.0,70.0
404824.0,6,4,508,2,238,0.0,172.0,119.0,2,270,0.0,135.0,135.0
28137.0,6,14,4740,7,653,3357.6666666666665,249.0,93.28571428571428,7,4087,4558.333333333333,1514.0,583.8571428571429
112979716.0,6,45,2970,23,1518,5135441.636363637,66.0,66.0,22,1452,5149652.095238095,66.0,66.0
162296.0,17,2,180,1,90,0.0,90.0,90.0,1,90,0.0,90.0,90.0
1303493.0,6,4,264,2,132,0.0,66.0,66.0,2,132,0.0,66.0,66.0
27215003.0,17,5,1718,4,1368,1767112.0,342.0,342.0,1,350,0.0,350.0,350.0
308880.0,6,6,412,4,272,102960.0,74.0,68.0,2,140,0.0,74.0,70.0
176104.0,17,4,1400,4,1400,58701.333333333336,350.0,350.0,0,0,0.0,0.0,0.0
360469.0,6,3,204,2,136,0.0,70.0,68.0,1,68,0.0,68.0,68.0
135137219.0,17,6,1206,6,1206,27027443.8,201.0,201.0,0,0,0.0,0.0,0.0
90287300.0,6,16,1192,8,596,12891342.857142856,95.0,74.5,8,596,12896738.142857144,95.0,74.5
117232487.0,6,229,25912,115,7886,1028355.149122807,140.0,68.57391304347826,114,18026,1027993.1238938052,284.0,158.12280701754386
1178293.0,6,13,3010,8,2382,168327.57142857142,1514.0,297.75,5,628,225649.0,331.0,125.6
120319745.0,6,243,27466,122,19184,994378.0578512396,284.0,157.24590163934425,121,8282,994990.6,140.0,68.44628099173553
318657.0,6,6,412,4,272,106219.0,74.0,68.0,2,140,0.0,74.0,70.0
196992.0,17,2,180,1,90,0.0,90.0,90.0,1,90,0.0,90.0,90.0
32158.0,6,14,4740,7,653,5237.333333333333,249.0,93.28571428571428,7,4087,5185.5,1514.0,583.8571428571429
301033.0,6,6,412,4,272,100344.33333333331,74.0,68.0,2,140,0.0,74.0,70.0
319.0,17,2,174,1,79,0.0,79.0,79.0,1,95,0.0,95.0,95.0
73390.0,6,14,4740,7,653,11315.0,249.0,93.28571428571428,7,4087,11987.5,1514.0,583.8571428571429
1683860.0,17,18,1260,18,1260,99050.58823529413,70.0,70.0,0,0,0.0,0.0,0.0
1298951.0,6,4,264,2,132,0.0,66.0,66.0,2,132,0.0,66.0,66.0
299449.0,6,6,412,4,272,99816.33333333331,74.0,68.0,2,140,0.0,74.0,70.0
98401.0,17,2,762,2,762,0.0,381.0,381.0,0,0,0.0,0.0,0.0
143924.0,17,2,180,1,90,0.0,90.0,90.0,1,90,0.0,90.0,90.0
257600.0,6,3,337,2,214,0.0,160.0,107.0,1,123,0.0,123.0,123.0
2082121.0,17,2,876,2,876,0.0,438.0,438.0,0,0,0.0,0.0,0.0
108093645.0,17,5,1005,5,1005,27023411.25,201.0,201.0,0,0,0.0,0.0,0.0
104441494.0,6,44,2904,22,1452,4973404.476190476,66.0,66.0,22,1452,4958926.952380952,66.0,66.0
298453.0,17,2,604,1,75,0.0,75.0,75.0,1,529,0.0,529.0,529.0
302263.0,6,6,412,4,272,100754.33333333331,74.0,68.0,2,140,0.0,74.0,70.0
88493.0,6,13,1479,7,882,14748.833333333334,291.0,126.0,6,597,17051.6,259.0,99.5
63480.99999999999,6,14,4740,7,653,10457.833333333334,249.0,93.28571428571428,7,4087,8180.333333333333,1514.0,583.8571428571429
108751517.0,6,34,2482,17,1288,6796969.8125,139.0,75.76470588235294,17,1194,6784145.375,123.0,70.23529411764706
54662.0,6,12,1447,6,816,10190.8,291.0,136.0,6,631,8692.6,293.0,105.16666666666669
1956044.0,6,20,7599,11,1469,195604.4,583.0,133.54545454545453,9,6130,212938.5,1484.0,681.1111111111111
47608823.0,6,7,1874,3,887,22664759.5,753.0,295.6666666666667,4,987,15013446.0,785.0,246.75
171561.0,17,2,180,1,90,0.0,90.0,90.0,1,90,0.0,90.0,90.0
217753.0,6,3,426,2,280,0.0,214.0,140.0,1,146,0.0,146.0,146.0
27767.0,6,10,1067,5,536,6748.0,264.0,107.2,5,531,5226.25,259.0,106.2
2303.0,17,4,344,2,150,0.0,75.0,75.0,2,194,0.0,103.0,97.0
144027.0,17,2,180,1,90,0.0,90.0,90.0,1,90,0.0,90.0,90.0
143952.0,17,2,180,1,90,0.0,90.0,90.0,1,90,0.0,90.0,90.0
5623673.0,6,4,270,2,134,0.0,68.0,67.0,2,136,0.0,70.0,68.0
2819116.0,6,2,132,1,66,0.0,66.0,66.0,1,66,0.0,66.0,66.0
300125.0,6,6,412,4,272,100041.66666666669,74.0,68.0,2,140,0.0,74.0,70.0
936124.0,6,12,1427,6,796,185579.0,271.0,132.66666666666666,6,631,186284.0,293.0,105.16666666666669
328114.0,17,4,704,2,148,0.0,74.0,74.0,2,556,0.0,280.0,278.0
103997058.0,6,28,1860,14,966,7983169.461538462,123.0,69.0,14,894,7983154.692307692,123.0,63.85714285714285
39462.0,6,14,4740,7,653,6444.666666666667,249.0,93.28571428571428,7,4087,5867.333333333333,1514.0,583.8571428571429
90258048.0,6,13,2036,8,1016,12894006.857142856,188.0,127.0,5,1020,22523242.25,204.0,204.0
43888.0,6,10,2032,5,524,10642.25,252.0,104.8,5,1508,10615.75,1236.0,301.6
213637.0,17,2,180,1,90,0.0,90.0,90.0,1,90,0.0,90.0,90.0
13844.0,6,10,1067,5,536,2611.25,264.0,107.2,5,531,2597.5,259.0,106.2
354367.0,6,4,508,2,238,0.0,172.0,119.0,2,270,0.0,135.0,135.0
20505.0,6,14,4740,7,653,3244.5,249.0,93.28571428571428,7,4087,2962.333333333333,1514.0,583.8571428571429
90251552.0,6,12,1832,8,1016,12893078.857142856,188.0,127.0,4,816,30029424.0,204.0,204.0
64372.0,6,14,4740,7,653,10408.5,249.0,93.28571428571428,7,4087,10554.833333333334,1514.0,583.8571428571429
30756.0,6,13,4416,6,409,6007.4,127.0,68.16666666666667,7,4007,4750.833333333333,1514.0,572.4285714285714
18707.0,6,20,7606,11,978,1870.7,310.0,88.9090909090909,9,6628,2123.25,1514.0,736.4444444444445
41808.0,6,14,4740,7,653,6724.166666666667,249.0,93.28571428571428,7,4087,5847.833333333333,1514.0,583.8571428571429
90303449.0,6,19,1436,10,745,10028527.555555556,95.0,74.5,9,691,11286573.875,95.0,76.77777777777777
0.0,17,1,55,1,55,0.0,55.0,55.0,0,0,0.0,0.0,0.0
90053382.0,17,27,12943,27,12943,3463591.6153846155,501.0,479.3703703703704,0,0,0.0,0.0,0.0
6031586.0,17,6,2100,6,2100,1206317.2,350.0,350.0,0,0,0.0,0.0,0.0
120573140.0,6,271,30664,136,21458,893134.3703703703,284.0,157.77941176470588,135,9206,892015.8805970149,140.0,68.19259259259259
100557073.0,6,27,1816,14,894,7735159.461538462,123.0,63.85714285714285,13,922,7530634.166666667,139.0,70.92307692307692
3898313.0,6,185,152671,107,143220,36776.53773584906,1510.0,1338.5046728971963,78,9451,46667.8051948052,1510.0,121.16666666666669
78518.0,6,14,4740,7,653,12924.166666666666,249.0,93.28571428571428,7,4087,11547.333333333334,1514.0,583.8571428571429
507062.0,6,5,336,2,134,0.0,68.0,67.0,3,202,190272.5,70.0,67.33333333333333
120020356.0,17,29,13785,29,13785,4286441.285714285,501.0,475.3448275862069,0,0,0.0,0.0,0.0
2977218.0,6,3,204,2,134,0.0,68.0,67.0,1,70,0.0,70.0,70.0
135138492.0,17,6,1206,6,1206,27027698.4,201.0,201.0,0,0,0.0,0.0,0.0
299791.0,17,2,246,1,76,0.0,76.0,76.0,1,170,0.0,170.0,170.0
2293.0,17,4,344,2,150,0.0,75.0,75.0,2,194,0.0,103.0,97.0
511508.0,6,5,336,2,134,0.0,68.0,67.0,3,202,196548.5,70.0,67.33333333333333
303622.0,6,2,132,1,66,0.0,66.0,66.0,1,66,0.0,66.0,66.0
33034.0,6,14,4740,7,653,5374.666666666667,249.0,93.28571428571428,7,4087,5366.166666666667,1514.0,583.8571428571429
133084.0,6,3,337,2,214,0.0,160.0,107.0,1,123,0.0,123.0,123.0
197022.0,17,2,180,1,90,0.0,90.0,90.0,1,90,0.0,90.0,90.0
110492989.0,6,34,2334,17,1209,6892334.4375,123.0,71.11764705882354,17,1125,6892335.4375,123.0,66.17647058823529
125769088.0,17,14,864,7,432,17666827.0,174.0,61.71428571428572,7,432,19985463.83333333,174.0,61.71428571428572
4589.0,17,2,762,2,762,0.0,381.0,381.0,0,0,0.0,0.0,0.0
113641980.0,6,48,3168,24,1584,4940955.652173913,66.0,66.0,24,1584,4931561.739130435,66.0,66.0
143958.0,17,2,180,1,90,0.0,90.0,90.0,1,90,0.0,90.0,90.0
299337.0,6,6,412,4,272,99779.0,74.0,68.0,2,140,0.0,74.0,70.0
32819.0,6,14,4740,7,653,4599.5,249.0,93.28571428571428,7,4087,5330.833333333333,1514.0,583.8571428571429
407298.0,17,4,820,2,156,0.0,78.0,78.0,2,664,0.0,332.0,332.0
1033.0,17,5,550,5,550,258.25,110.0,110.0,0,0,0.0,0.0,0.0
233158.0,6,3,373,2,238,0.0,172.0,119.0,1,135,0.0,135.0,135.0
108112503.0,17,5,1005,5,1005,27028125.75,201.0,201.0,0,0,0.0,0.0,0.0
206271.0,6,3,426,2,280,0.0,214.0,140.0,1,146,0.0,146.0,146.0
90539398.0,6,15,2444,8,1016,12934199.714285716,188.0,127.0,7,1428,15059773.833333334,204.0,204.0
119574834.0,6,20,1490,10,745,13286092.666666666,95.0,74.5,10,745,13257400.888888888,95.0,74.5
35995.0,6,14,4740,7,653,5876.166666666667,249.0,93.28571428571428,7,4087,5859.333333333333,1514.0,583.8571428571429
232708.0,6,3,337,2,214,0.0,160.0,107.0,1,123,0.0,123.0,123.0
1734081.0,6,23,6509,12,1529,157643.72727272726,357.0,127.41666666666669,11,4980,142859.4,1510.0,452.7272727272728
299561.0,6,6,412,4,272,99853.66666666669,74.0,68.0,2,140,0.0,74.0,70.0
90298965.0,6,17,1287,9,691,11281727.5,95.0,76.77777777777777,8,596,12899406.857142856,95.0,74.5
121652110.0,6,55,4681,30,2572,4194900.344827586,139.0,85.73333333333333,25,2109,4866206.5,123.0,84.36
108102910.0,17,5,955,5,955,27025727.5,191.0,191.0,0,0,0.0,0.0,0.0
2409.0,17,4,344,2,150,0.0,75.0,75.0,2,194,0.0,103.0,97.0
106203.0,17,2,700,2,700,0.0,350.0,350.0,0,0,0.0,0.0,0.0
13497.0,6,11,1131,6,600,2372.8,262.0,100.0,5,531,3163.5,259.0,106.2
205766.0,6,3,426,2,280,0.0,214.0,140.0,1,146,0.0,146.0,146.0
120121479.0,6,14,2224,9,1204,15015184.875,188.0,133.77777777777777,5,1020,22523089.5,204.0,204.0
74597461.0,6,9,842,9,842,9324682.625,97.0,93.55555555555556,0,0,0.0,0.0,0.0
237308.0,17,2,180,1,90,0.0,90.0,90.0,1,90,0.0,90.0,90.0
190956.0,17,2,180,1,90,0.0,90.0,90.0,1,90,0.0,90.0,90.0
151756.0,17,4,1400,4,1400,50585.333333333336,350.0,350.0,0,0,0.0,0.0,0.0
9472.0,17,2,582,1,83,0.0,83.0,83.0,1,499,0.0,499.0,499.0
69974.0,6,14,4740,7,653,11533.0,249.0,93.28571428571428,7,4087,11176.0,1514.0,583.8571428571429
36821.0,6,14,4740,7,653,6007.0,249.0,93.28571428571428,7,4087,5643.5,1514.0,583.8571428571429
0.0,17,1,350,1,350,0.0,350.0,350.0,0,0,0.0,0.0,0.0
145728.0,6,3,373,2,238,0.0,172.0,119.0,1,135,0.0,135.0,135.0
3007726.0,6,11,2106,6,598,601355.4,252.0,99.66666666666669,5,1508,1731.25,1236.0,301.6
400.0,17,2,410,1,78,0.0,78.0,78.0,1,332,0.0,332.0,332.0
876777.0,6,10,1333,6,796,175355.4,458.0,132.66666666666666,4,537,201371.3333333333,331.0,134.25
206019.0,17,2,180,1,90,0.0,90.0,90.0,1,90,0.0,90.0,90.0
201183.0,17,4,6056,4,6056,67061.0,1514.0,1514.0,0,0,0.0,0.0,0.0
90533376.0,6,15,2444,8,1016,12933339.42857143,188.0,127.0,7,1428,15060792.5,204.0,204.0
103153.0,17,2,286,2,286,0.0,143.0,143.0,0,0,0.0,0.0,0.0
3532948.0,6,199,167820,116,158040,29867.191304347827,1510.0,1362.4137931034484,83,9780,39281.39024390244,1510.0,117.8313253012048
113310144.0,6,45,2970,23,1518,5150461.090909091,66.0,66.0,22,1452,5025325.714285715,66.0,66.0
90256503.0,6,13,2036,8,1016,12893786.142857144,188.0,127.0,5,1020,22523628.5,204.0,204.0
114703410.0,6,48,3168,24,1584,4987104.782608695,66.0,66.0,24,1584,4977701.652173913,66.0,66.0
14931.0,6,10,2032,5,524,3312.5,252.0,104.8,5,1508,3500.75,1236.0,301.6
0.0,6,1,54,0,0,0.0,0.0,0.0,1,54,0.0,54.0,54.0
109560657.0,17,14,864,7,432,18167583.33333333,174.0,61.71428571428572,7,432,18166843.33333333,174.0,61.71428571428572
101145.0,17,2,762,2,762,0.0,381.0,381.0,0,0,0.0,0.0,0.0
319752.0,6,6,412,4,272,106584.0,74.0,68.0,2,140,0.0,74.0,70.0
319199.0,6,6,412,4,272,106399.66666666669,74.0,68.0,2,140,0.0,74.0,70.0
241966.0,6,3,373,2,238,0.0,172.0,119.0,1,135,0.0,135.0,135.0
2276.0,17,4,344,2,150,0.0,75.0,75.0,2,194,0.0,103.0,97.0
35835.0,6,12,1320,6,723,5737.0,253.0,120.5,6,597,6118.2,259.0,99.5
18145.0,6,10,2032,5,524,3682.25,252.0,104.8,5,1508,4284.0,1236.0,301.6
530304.0,17,6,2100,6,2100,106060.8,350.0,350.0,0,0,0.0,0.0,0.0
50655.0,6,14,4740,7,653,8232.5,249.0,93.28571428571428,7,4087,6999.166666666667,1514.0,583.8571428571429
39634.0,6,10,2032,5,524,8624.5,252.0,104.8,5,1508,7036.0,1236.0,301.6
66959.0,6,14,4740,7,653,10943.5,249.0,93.28571428571428,7,4087,11014.166666666666,1514.0,583.8571428571429
236852.0,6,13,1386,7,789,39475.333333333336,253.0,112.71428571428572,6,597,45383.8,259.0,99.5
2332.0,17,4,344,2,150,0.0,75.0,75.0,2,194,0.0,103.0,97.0
48642.0,6,14,4740,7,653,7976.166666666667,249.0,93.28571428571428,7,4087,7967.333333333333,1514.0,583.8571428571429
106391228.0,6,217,25126,103,7190,1021150.0490196078,140.0,69.80582524271844,114,17936,935092.0442477876,284.0,157.33333333333334
58281336.0,6,19,1375,9,681,7283930.625,95.0,75.66666666666667,10,694,6441256.111111111,95.0,69.4
56416.0,6,10,2032,5,524,13717.5,252.0,104.8,5,1508,13063.0,1236.0,301.6
217692.0,6,10,1221,6,636,43538.4,298.0,106.0,4,585,71019.0,379.0,146.25
2225.0,17,4,344,2,150,0.0,75.0,75.0,2,194,0.0,103.0,97.0
120125036.0,6,14,2224,9,1204,15015629.5,188.0,133.77777777777777,5,1020,22523611.25,204.0,204.0
9897.0,17,2,571,1,86,0.0,86.0,86.0,1,485,0.0,485.0,485.0
23307.0,6,14,4740,7,653,3441.5,249.0,93.28571428571428,7,4087,3580.333333333333,1514.0,583.8571428571429
95948548.0,17,14,4796,13,4446,6249643.083333333,342.0,342.0,1,350,0.0,350.0,350.0
11314.0,17,2,461,1,86,0.0,86.0,86.0,1,375,0.0,375.0,375.0
304264.0,6,6,412,4,272,101421.33333333331,74.0,68.0,2,140,0.0,74.0,70.0
11587709.0,6,5,1736,2,819,0.0,753.0,409.5,3,917,5726011.0,785.0,305.6666666666667
15205.0,6,11,1131,6,600,2837.2,262.0,100.0,5,531,3471.0,259.0,106.2
20051.0,17,2,582,1,83,0.0,83.0,83.0,1,499,0.0,499.0,499.0
120541214.0,6,287,33726,144,23992,842945.5524475524,300.0,166.61111111111111,143,9734,841622.352112676,140.0,68.06993006993007
303712.0,6,6,412,4,272,101237.33333333331,74.0,68.0,2,140,0.0,74.0,70.0
5618392.0,6,4,270,2,134,0.0,68.0,67.0,2,136,0.0,70.0,68.0
90299124.0,6,16,1192,8,596,12893599.714285716,95.0,74.5,8,596,12898811.57142857,95.0,74.5
33040.0,6,14,4740,7,653,5317.0,249.0,93.28571428571428,7,4087,4499.333333333333,1514.0,583.8571428571429
289.0,17,2,156,1,78,0.0,78.0,78.0,1,78,0.0,78.0,78.0
35912.0,6,10,2032,5,524,8746.25,252.0,104.8,5,1508,8333.5,1236.0,301.6
90046681.0,17,28,13364,28,13364,3335062.25925926,501.0,477.2857142857143,0,0,0.0,0.0,0.0
1752601.0,6,2,132,1,66,0.0,66.0,66.0,1,66,0.0,66.0,66.0
108109031.0,17,5,1005,5,1005,27027257.75,201.0,201.0,0,0,0.0,0.0,0.0
222809.0,6,10,1221,6,636,44561.8,298.0,106.0,4,585,73243.66666666667,379.0,146.25
27033848.0,17,5,1710,5,1710,6758462.0,342.0,342.0,0,0,0.0,0.0,0.0
209513.0,17,2,180,1,90,0.0,90.0,90.0,1,90,0.0,90.0,90.0
143883.0,17,2,180,1,90,0.0,90.0,90.0,1,90,0.0,90.0,90.0
90044331.0,17,28,13364,28,13364,3334975.222222222,501.0,477.2857142857143,0,0,0.0,0.0,0.0
228275.0,17,2,180,1,90,0.0,90.0,90.0,1,90,0.0,90.0,90.0
51690.0,6,14,4740,7,653,8441.833333333334,249.0,93.28571428571428,7,4087,6885.0,1514.0,583.8571428571429
418616.0,6,3,204,2,136,0.0,70.0,68.0,1,68,0.0,68.0,68.0
5005658.0,17,4,849,2,166,0.0,83.0,83.0,2,683,0.0,499.0,341.5
0.0,17,1,453,1,453,0.0,453.0,453.0,0,0,0.0,0.0,0.0
119309561.0,6,35,2542,18,1348,7005501.235294118,139.0,74.88888888888889,17,1194,7443340.5,123.0,70.23529411764706
120210535.0,6,229,25928,115,18182,1054478.3771929825,284.0,158.10434782608695,114,7746,1056206.8849557522,140.0,67.94736842105263
18778906.0,6,24,8675,13,1719,1564908.8333333333,408.0,132.23076923076923,11,6956,1477173.8,1514.0,632.3636363636364
90093634.0,6,11,1644,4,816,30030433.33333333,204.0,204.0,7,828,15015215.666666666,188.0,118.28571428571428
9151.0,6,10,1067,5,536,2120.0,264.0,107.2,5,531,2089.25,259.0,106.2
299657.0,6,6,412,4,272,99885.66666666669,74.0,68.0,2,140,0.0,74.0,70.0
90738283.0,6,19,1436,10,745,10077375.333333334,95.0,74.5,9,691,11341200.625,95.0,76.77777777777777
2411.0,17,4,344,2,150,0.0,75.0,75.0,2,194,0.0,103.0,97.0
90012182.0,6,15,1097,8,596,12858883.142857144,95.0,74.5,7,501,14951960.333333334,95.0,71.57142857142857
120318999.0,6,227,25594,114,17914,1064769.9026548672,284.0,157.140350877193,113,7680,1065008.6785714286,140.0,67.96460176991151
120122053.0,6,15,2444,7,1428,20020342.166666668,204.0,204.0,8,1016,17136883.0,188.0,127.0
50183.0,6,14,4740,7,653,6448.333333333333,249.0,93.28571428571428,7,4087,8054.333333333333,1514.0,583.8571428571429
29150.0,6,14,4740,7,653,4675.333333333333,249.0,93.28571428571428,7,4087,4639.166666666667,1514.0,583.8571428571429
1791860.0,6,23,6509,12,1529,159748.0,357.0,127.41666666666669,11,4980,147869.8,1510.0,452.7272727272728
69360.0,6,14,4740,7,653,10991.833333333334,249.0,93.28571428571428,7,4087,11349.166666666666,1514.0,583.8571428571429
108999.0,17,2,286,2,286,0.0,143.0,143.0,0,0,0.0,0.0,0.0
107222812.0,17,14,864,7,432,17834964.333333332,174.0,61.71428571428572,7,432,17833496.166666668,174.0,61.71428571428572
2598372.0,6,2,132,1,66,0.0,66.0,66.0,1,66,0.0,66.0,66.0
317.0,17,2,174,1,79,0.0,79.0,79.0,1,95,0.0,95.0,95.0
309576.0,6,12,1373,7,714,51596.0,298.0,102.0,5,659,72757.25,379.0,131.8
38660.0,6,14,4740,7,653,6281.333333333333,249.0,93.28571428571428,7,4087,6129.166666666667,1514.0,583.8571428571429
106320.0,17,2,286,2,286,0.0,143.0,143.0,0,0,0.0,0.0,0.0
1775243.0,6,2,132,1,66,0.0,66.0,66.0,1,66,0.0,66.0,66.0
1046927.0,6,11,1134,6,558,209385.4,220.0,93.0,5,576,258258.0,304.0,115.2
173395.0,17,4,1524,4,1524,57798.333333333336,381.0,381.0,0,0,0.0,0.0,0.0
65674.0,6,14,4740,7,653,10704.0,249.0,93.28571428571428,7,4087,9992.166666666666,1514.0,583.8571428571429
2269.0,17,4,344,2,150,0.0,75.0,75.0,2,194,0.0,103.0,97.0
1038112.0,6,11,1134,6,558,207622.4,220.0,93.0,5,576,256624.5,304.0,115.2
97688.0,17,2,286,2,286,0.0,143.0,143.0,0,0,0.0,0.0,0.0
293556.0,6,10,1221,6,636,58711.2,298.0,106.0,4,585,91863.66666666669,379.0,146.25
1483753.0,17,16,1120,16,1120,98916.86666666668,70.0,70.0,0,0,0.0,0.0,0.0
342.0,17,2,160,1,80,0.0,80.0,80.0,1,80,0.0,80.0,80.0
236936.0,6,3,373,2,238,0.0,172.0,119.0,1,135,0.0,135.0,135.0
207849.0,6,10,1221,6,636,41569.8,298.0,106.0,4,585,67906.66666666667,379.0,146.25
309210.0,6,6,412,4,272,103070.0,74.0,68.0,2,140,0.0,74.0,70.0
51728493.0,6,8,2113,3,960,24536940.5,826.0,320.0,5,1153,12237159.75,885.0,230.6
745.0,17,4,438,2,148,0.0,74.0,74.0,2,290,0.0,147.0,145.0
863855.0,6,9,1270,6,799,172771.0,461.0,133.16666666666666,3,471,293988.5,331.0,157.0
2819.0,17,4,438,2,148,0.0,74.0,74.0,2,290,0.0,147.0,145.0
90036034.0,17,27,12943,27,12943,3462924.3846153845,501.0,479.3703703703704,0,0,0.0,0.0,0.0
332.0,17,2,250,1,93,0.0,93.0,93.0,1,157,0.0,157.0,157.0
105754.0,17,2,286,2,286,0.0,143.0,143.0,0,0,0.0,0.0,0.0
143864.0,17,2,180,1,90,0.0,90.0,90.0,1,90,0.0,90.0,90.0
146064.0,6,3,337,2,214,0.0,160.0,107.0,1,123,0.0,123.0,123.0
197004.0,17,2,180,1,90,0.0,90.0,90.0,1,90,0.0,90.0,90.0
10492.0,17,4,823,2,163,0.0,89.0,81.5,2,660,0.0,443.0,330.0
92710305.0,6,38,2508,19,1254,5135442.777777778,66.0,66.0,19,1254,5135450.0,66.0,66.0
26893717.0,17,5,1718,4,1368,1049087.6666666667,342.0,342.0,1,350,0.0,350.0,350.0
152577.0,17,2,414,1,88,0.0,88.0,88.0,1,326,0.0,326.0,326.0
148047.0,17,2,180,1,90,0.0,90.0,90.0,1,90,0.0,90.0,90.0
41904.0,6,14,4740,7,653,6876.0,249.0,93.28571428571428,7,4087,6846.166666666667,1514.0,583.8571428571429
352.0,17,2,267,1,83,0.0,83.0,83.0,1,184,0.0,184.0,184.0
90751226.0,6,169,19050,85,5832,1080371.738095238,140.0,68.61176470588235,84,13218,1080882.8192771084,284.0,157.35714285714286
217671.0,6,3,426,2,280,0.0,214.0,140.0,1,146,0.0,146.0,146.0
6326.0,17,4,344,2,150,0.0,75.0,75.0,2,194,0.0,103.0,97.0
313717.0,17,4,1400,4,1400,104572.33333333331,350.0,350.0,0,0,0.0,0.0,0.0
110198.0,17,2,700,2,700,0.0,350.0,350.0,0,0,0.0,0.0,0.0
138770.0,17,4,1524,4,1524,46256.66666666666,381.0,381.0,0,0,0.0,0.0,0.0
117526556.0,6,280,32524,140,23062,843966.381294964,300.0,164.72857142857143,140,9462,843966.1151079136,140.0,67.58571428571429
106279220.0,17,14,864,7,432,17666860.333333332,174.0,61.71428571428572,7,432,17667388.666666668,174.0,61.71428571428572
113234162.0,6,215,24570,108,7350,1058263.1962616823,140.0,68.05555555555556,107,17220,1058419.547169811,374.0,160.93457943925233
810.0,17,5,550,5,550,202.5,110.0,110.0,0,0,0.0,0.0,0.0
41463.0,6,14,4740,7,653,6492.333333333333,249.0,93.28571428571428,7,4087,6205.0,1514.0,583.8571428571429
116152070.0,6,38,2710,19,1408,6440902.555555556,139.0,74.10526315789474,19,1302,6440900.444444444,123.0,68.52631578947368
2451.0,17,4,344,2,150,0.0,75.0,75.0,2,194,0.0,103.0,97.0
17560.0,17,4,823,2,163,0.0,89.0,81.5,2,660,0.0,443.0,330.0
304207.0,17,2,180,1,90,0.0,90.0,90.0,1,90,0.0,90.0,90.0
197628.0,17,2,180,1,90,0.0,90.0,90.0,1,90,0.0,90.0,90.0
303816.0,6,6,412,4,272,101272.0,74.0,68.0,2,140,0.0,74.0,70.0
101960.0,17,2,762,2,762,0.0,381.0,381.0,0,0,0.0,0.0,0.0
299901.0,6,6,412,4,272,99967.0,74.0,68.0,2,140,0.0,74.0,70.0
5623108.0,6,4,270,2,134,0.0,68.0,67.0,2,136,0.0,70.0,68.0
146.0,17,2,700,2,700,0.0,350.0,350.0,0,0,0.0,0.0,0.0
307890.0,17,4,1400,4,1400,102630.0,350.0,350.0,0,0,0.0,0.0,0.0
105243384.0,6,181,20394,91,6240,1169370.933333333,140.0,68.57142857142857,90,14154,1170924.0112359552,284.0,157.26666666666668
108834.0,17,2,286,2,286,0.0,143.0,143.0,0,0,0.0,0.0,0.0
109114.0,17,2,286,2,286,0.0,143.0,143.0,0,0,0.0,0.0,0.0
78216.0,6,14,4740,7,653,12464.166666666666,249.0,93.28571428571428,7,4087,9567.333333333334,1514.0,583.8571428571429
10456481.0,6,6,412,3,206,5160587.5,74.0,68.66666666666667,3,206,5160493.5,74.0,68.66666666666667
105702512.0,6,484,63076,242,46882,437701.7883817427,464.0,193.72727272727272,242,16194,437698.8257261411,140.0,66.91735537190083
146333.0,6,3,337,2,214,0.0,160.0,107.0,1,123,0.0,123.0,123.0
103398.0,17,2,286,2,286,0.0,143.0,143.0,0,0,0.0,0.0,0.0
130737.0,6,3,337,2,214,0.0,160.0,107.0,1,123,0.0,123.0,123.0
3120635.0,6,18,1495,9,921,352347.25,315.0,102.33333333333331,9,574,352326.875,78.0,63.77777777777778
5812761.0,6,5,336,2,134,0.0,68.0,67.0,3,202,1523987.0,70.0,67.33333333333333
216449.0,17,2,180,1,90,0.0,90.0,90.0,1,90,0.0,90.0,90.0
102960.0,6,13,1479,7,882,17160.0,291.0,126.0,6,597,16079.6,259.0,99.5
55213.0,6,10,2032,5,524,12347.0,252.0,104.8,5,1508,11301.0,1236.0,301.6
207193.0,6,3,426,2,280,0.0,214.0,140.0,1,146,0.0,146.0,146.0
93530.0,6,13,1386,7,789,15588.333333333334,253.0,112.71428571428572,6,597,16917.4,259.0,99.5
298934.0,6,6,412,4,272,99644.66666666669,74.0,68.0,2,140,0.0,74.0,70.0
435544.0,6,4,508,2,238,0.0,172.0,119.0,2,270,0.0,135.0,135.0
1487866.0,17,16,1120,16,1120,99191.06666666668,70.0,70.0,0,0,0.0,0.0,0.0
135126991.0,17,6,1206,6,1206,27025398.2,201.0,201.0,0,0,0.0,0.0,0.0
107388.0,17,2,286,2,286,0.0,143.0,143.0,0,0,0.0,0.0,0.0
160916.0,17,2,180,1,90,0.0,90.0,90.0,1,90,0.0,90.0,90.0
50557.0,6,14,4740,7,653,8229.833333333334,249.0,93.28571428571428,7,4087,6391.666666666667,1514.0,583.8571428571429
5005578.0,17,4,849,2,166,0.0,83.0,83.0,2,683,0.0,499.0,341.5
244690.0,6,3,337,2,214,0.0,160.0,107.0,1,123,0.0,123.0,123.0
40617.0,6,10,2032,5,524,9789.0,252.0,104.8,5,1508,9713.75,1236.0,301.6
132012485.0,17,15,907,8,475,18858926.42857143,174.0,59.375,7,432,18666816.166666668,174.0,61.71428571428572
93956.0,6,15,4806,8,719,13085.42857142857,249.0,89.875,7,4087,15234.0,1514.0,583.8571428571429
119632094.0,17,35,16705,35,16705,3518591.0,501.0,477.2857142857143,0,0,0.0,0.0,0.0
32633.000000000004,6,14,4740,7,653,5270.333333333333,249.0,93.28571428571428,7,4087,4869.5,1514.0,583.8571428571429
1208421.0,6,13,3007,8,2379,172631.57142857142,1514.0,297.375,5,628,233095.5,331.0,125.6
91011222.0,6,176,19978,88,13948,1043627.0114942528,374.0,158.5,88,6030,1043625.8505747126,140.0,68.52272727272727
13054.0,6,14,4740,7,653,1981.3333333333333,249.0,93.28571428571428,7,4087,2037.3333333333333,1514.0,583.8571428571429
314381.0,6,3,202,2,128,0.0,74.0,64.0,1,74,0.0,74.0,74.0
147789.0,17,4,704,2,148,0.0,74.0,74.0,2,556,0.0,280.0,278.0
33283.0,6,14,4740,7,653,4901.0,249.0,93.28571428571428,7,4087,5321.333333333333,1514.0,583.8571428571429
96538684.0,6,71,14160,35,7405,2839373.0588235296,1514.0,211.57142857142856,36,6755,2751148.685714286,1514.0,187.63888888888889
217689.0,6,3,426,2,280,0.0,214.0,140.0,1,146,0.0,146.0,146.0
197560.0,17,2,180,1,90,0.0,90.0,90.0,1,90,0.0,90.0,90.0
311.0,17,2,174,1,79,0.0,79.0,79.0,1,95,0.0,95.0,95.0
303680.0,6,2,132,1,66,0.0,66.0,66.0,1,66,0.0,66.0,66.0
310.0,17,2,156,1,78,0.0,78.0,78.0,1,78,0.0,78.0,78.0
1028427.0,6,11,1134,6,558,205685.4,220.0,93.0,5,576,255730.0,304.0,115.2
216900.0,6,3,426,2,280,0.0,214.0,140.0,1,146,0.0,146.0,146.0
3426706.0,6,7,923,4,753,1070086.3333333333,571.0,188.25,3,170,1605699.5,62.0,56.66666666666666
120000080.0,6,17,1287,9,691,15000010.0,95.0,76.77777777777777,8,596,17040416.85714286,95.0,74.5
2301.0,17,4,344,2,150,0.0,75.0,75.0,2,194,0.0,103.0,97.0
2047.0,17,4,344,2,150,0.0,75.0,75.0,2,194,0.0,103.0,97.0
49572.0,6,10,2032,5,524,12098.5,252.0,104.8,5,1508,10206.25,1236.0,301.6
48259.0,6,14,4740,7,653,7078.5,249.0,93.28571428571428,7,4087,6831.5,1514.0,583.8571428571429
14643820.0,6,19,1553,9,921,1791792.625,315.0,102.33333333333331,10,632,1592673.5555555555,78.0,63.2
102007.0,17,2,762,2,762,0.0,381.0,381.0,0,0,0.0,0.0,0.0
90033997.0,17,28,13364,28,13364,3334592.4814814813,501.0,477.2857142857143,0,0,0.0,0.0,0.0
348.0,17,2,174,1,79,0.0,79.0,79.0,1,95,0.0,95.0,95.0
2689.0,17,2,762,2,762,0.0,381.0,381.0,0,0,0.0,0.0,0.0
7583665.0,17,4,1376,3,1026,80329.0,342.0,342.0,1,350,0.0,350.0,350.0
233445.0,6,3,337,2,214,0.0,160.0,107.0,1,123,0.0,123.0,123.0
5394.0,17,4,344,2,150,0.0,75.0,75.0,2,194,0.0,103.0,97.0
82965647.0,17,12,4112,11,3762,7474391.9,342.0,342.0,1,350,0.0,350.0,350.0
121577.0,6,3,337,2,214,0.0,160.0,107.0,1,123,0.0,123.0,123.0
49375.0,6,14,4740,7,653,8061.0,249.0,93.28571428571428,7,4087,8056.166666666667,1514.0,583.8571428571429
117985562.0,6,222,24962,111,7622,1065132.981818182,140.0,68.66666666666667,111,17340,1067850.1363636365,284.0,156.21621621621622
116531290.0,6,220,24958,110,17402,1067120.2201834864,284.0,158.2,110,7556,1067120.2201834864,140.0,68.69090909090909
738.0,17,4,438,2,148,0.0,74.0,74.0,2,290,0.0,147.0,145.0
306971.0,6,6,412,4,272,102323.66666666669,74.0,68.0,2,140,0.0,74.0,70.0
1715922.0,6,23,6508,12,1529,155992.9090909091,357.0,127.41666666666669,11,4979,140728.0,1510.0,452.6363636363636
2430.0,17,4,344,2,150,0.0,75.0,75.0,2,194,0.0,103.0,97.0
120050527.0,17,28,13364,28,13364,4446315.814814814,501.0,477.2857142857143,0,0,0.0,0.0,0.0
116304354.0,6,199,22482,100,15714,1174791.4545454546,284.0,157.14,99,6768,1166949.7142857143,140.0,68.36363636363636
120125128.0,6,13,2036,5,1020,30031282.0,204.0,204.0,8,1016,17137395.285714287,188.0,127.0
108099202.0,17,5,1005,5,1005,27024800.5,201.0,201.0,0,0,0.0,0.0,0.0
300260.0,6,6,412,4,272,100086.66666666669,74.0,68.0,2,140,0.0,74.0,70.0
90307906.0,6,22,1639,12,894,8205425.545454546,95.0,74.5,10,745,10032491.333333334,95.0,74.5
103644733.0,17,18,2103,9,804,12876181.25,250.0,89.33333333333333,9,1299,12875126.375,394.0,144.33333333333334
1416001.0,17,7,490,7,490,236000.16666666663,70.0,70.0,0,0,0.0,0.0,0.0
121926.0,6,3,337,2,214,0.0,160.0,107.0,1,123,0.0,123.0,123.0
213192.0,17,2,180,1,90,0.0,90.0,90.0,1,90,0.0,90.0,90.0
135133599.0,17,6,1206,6,1206,27026719.8,201.0,201.0,0,0,0.0,0.0,0.0
505837.0,6,3,1604,2,851,0.0,785.0,425.5,1,753,0.0,753.0,753.0
205770.0,17,2,180,1,90,0.0,90.0,90.0,1,90,0.0,90.0,90.0
33583.0,6,14,4740,7,653,5369.5,249.0,93.28571428571428,7,4087,4815.833333333333,1514.0,583.8571428571429
310147.0,6,6,412,4,272,103382.33333333331,74.0,68.0,2,140,0.0,74.0,70.0
94141233.0,6,186,20982,93,14622,1020934.7717391304,284.0,157.2258064516129,93,6360,1020934.945652174,140.0,68.38709677419355
297936.0,6,6,412,4,272,99312.0,74.0,68.0,2,140,0.0,74.0,70.0
66624.0,6,14,4740,7,653,10546.0,249.0,93.28571428571428,7,4087,10957.5,1514.0,583.8571428571429
103575254.0,6,44,2904,22,1452,4923897.619047619,66.0,66.0,22,1452,4930134.857142857,66.0,66.0
741454.0,6,11,1131,6,600,147967.8,262.0,100.0,5,531,184477.5,259.0,106.2
311300.0,17,4,704,2,148,0.0,74.0,74.0,2,556,0.0,280.0,278.0
352.0,17,2,174,1,79,0.0,79.0,79.0,1,95,0.0,95.0,95.0
51869.0,6,14,4740,7,653,8130.333333333333,249.0,93.28571428571428,7,4087,8387.0,1514.0,583.8571428571429
153553.0,17,2,180,1,90,0.0,90.0,90.0,1,90,0.0,90.0,90.0
228350.0,17,2,180,1,90,0.0,90.0,90.0,1,90,0.0,90.0,90.0
120191258.0,6,236,26750,118,18740,1025437.3846153846,284.0,158.8135593220339,118,8010,1025437.4957264956,140.0,67.88135593220339
3301964.0,6,3,1777,2,951,0.0,885.0,475.5,1,826,0.0,826.0,826.0
216714.0,6,3,426,2,280,0.0,214.0,140.0,1,146,0.0,146.0,146.0
108105365.0,17,5,955,5,955,27026341.25,191.0,191.0,0,0,0.0,0.0,0.0
68836.0,6,20,7606,11,978,6883.6,310.0,88.9090909090909,9,6628,8352.125,1514.0,736.4444444444445
55802.0,17,2,231,1,78,0.0,78.0,78.0,1,153,0.0,153.0,153.0
27108.0,6,14,4740,7,653,3527.1666666666665,249.0,93.28571428571428,7,4087,4310.333333333333,1514.0,583.8571428571429
52337.0,6,10,2032,5,524,11425.25,252.0,104.8,5,1508,12234.5,1236.0,301.6
18868.0,6,10,2032,5,524,4404.25,252.0,104.8,5,1508,4466.75,1236.0,301.6
135136163.0,17,6,1206,6,1206,27027232.6,201.0,201.0,0,0,0.0,0.0,0.0
79040.0,6,14,4740,7,653,12577.0,249.0,93.28571428571428,7,4087,8128.666666666667,1514.0,583.8571428571429
25126.0,6,10,2032,5,524,5835.5,252.0,104.8,5,1508,5932.5,1236.0,301.6
138243.0,6,2,132,1,66,0.0,66.0,66.0,1,66,0.0,66.0,66.0
30349.0,6,14,4740,7,653,4789.833333333333,249.0,93.28571428571428,7,4087,4913.333333333333,1514.0,583.8571428571429
3050392.0,6,3,204,2,136,0.0,70.0,68.0,1,68,0.0,68.0,68.0
129443.0,6,2,132,1,66,0.0,66.0,66.0,1,66,0.0,66.0,66.0
108112728.0,17,5,955,5,955,27028182.0,191.0,191.0,0,0,0.0,0.0,0.0
330.0,17,2,174,1,79,0.0,79.0,79.0,1,95,0.0,95.0,95.0
20539.0,6,4,301,2,132,0.0,66.0,66.0,2,169,0.0,103.0,84.5
209289.0,6,10,1221,6,636,41857.8,298.0,106.0,4,585,68452.0,379.0,146.25
228399.0,17,2,180,1,90,0.0,90.0,90.0,1,90,0.0,90.0,90.0
143095.0,6,2,132,1,66,0.0,66.0,66.0,1,66,0.0,66.0,66.0
204754.0,17,2,762,2,762,0.0,381.0,381.0,0,0,0.0,0.0,0.0
16784364.0,6,20,1611,9,921,2060628.75,315.0,102.33333333333331,11,690,1648479.5,78.0,62.72727272727273
120297841.0,6,217,24468,109,17044,1113868.898148148,284.0,156.36697247706422,108,7424,1114631.5327102805,140.0,68.74074074074075
2382.0,17,2,762,2,762,0.0,381.0,381.0,0,0,0.0,0.0,0.0
769.0,17,4,438,2,148,0.0,74.0,74.0,2,290,0.0,147.0,145.0
228677.0,17,2,180,1,90,0.0,90.0,90.0,1,90,0.0,90.0,90.0
150.0,17,2,700,2,700,0.0,350.0,350.0,0,0,0.0,0.0,0.0
142378.0,17,4,704,2,148,0.0,74.0,74.0,2,556,0.0,280.0,278.0
354.0,17,2,166,1,75,0.0,75.0,75.0,1,91,0.0,91.0,91.0
122192.0,6,3,373,2,238,0.0,172.0,119.0,1,135,0.0,135.0,135.0
318379.0,17,4,1400,4,1400,106126.33333333331,350.0,350.0,0,0,0.0,0.0,0.0
1789278.0,6,22,6443,11,1463,178927.8,357.0,133.0,11,4980,146260.9,1510.0,452.7272727272728
301.0,17,2,174,1,79,0.0,79.0,79.0,1,95,0.0,95.0,95.0
108106428.0,17,5,1005,5,1005,27026607.0,201.0,201.0,0,0,0.0,0.0,0.0
120213781.0,6,26,1978,12,935,10908941.545454543,95.0,77.91666666666667,14,1043,9230639.692307692,95.0,74.5
329472.0,6,6,412,4,272,109824.0,74.0,68.0,2,140,0.0,74.0,70.0
286906.0,17,2,363,1,79,0.0,79.0,79.0,1,284,0.0,284.0,284.0
77365.0,6,14,4740,7,653,12772.5,249.0,93.28571428571428,7,4087,10959.666666666666,1514.0,583.8571428571429
10963.0,6,10,2032,5,524,2249.25,252.0,104.8,5,1508,2391.25,1236.0,301.6
321917.0,17,4,1400,4,1400,107305.66666666669,350.0,350.0,0,0,0.0,0.0,0.0
10465384.0,6,7,478,4,272,3442957.333333333,74.0,68.0,3,206,5164265.5,74.0,68.66666666666667
36264.0,6,10,2032,5,524,6647.5,252.0,104.8,5,1508,8543.75,1236.0,301.6
55131.0,6,14,4740,7,653,9060.833333333334,249.0,93.28571428571428,7,4087,8726.666666666666,1514.0,583.8571428571429
90051700.0,17,28,13364,28,13364,3335248.1481481483,501.0,477.2857142857143,0,0,0.0,0.0,0.0
13784.0,6,13,1459,7,862,2257.333333333333,271.0,123.14285714285714,6,597,2588.4,259.0,99.5
20200.0,6,14,4740,7,653,2629.5,249.0,93.28571428571428,7,4087,3135.0,1514.0,583.8571428571429
36272.0,6,14,4740,7,653,5916.166666666667,249.0,93.28571428571428,7,4087,5747.333333333333,1514.0,583.8571428571429
3220348.0,6,15,2359,8,1068,460049.7142857143,580.0,133.5,7,1291,500250.3333333333,732.0,184.42857142857144
37343.0,6,14,4740,7,653,6040.333333333333,249.0,93.28571428571428,7,4087,4498.5,1514.0,583.8571428571429
7623.0,17,2,582,1,83,0.0,83.0,83.0,1,499,0.0,499.0,499.0
92030580.0,17,14,1126,7,563,15334176.666666666,174.0,80.42857142857143,7,563,15333494.166666666,174.0,80.42857142857143
1302928.0,6,7,499,3,198,614617.0,66.0,66.0,4,301,420378.6666666667,103.0,75.25
90309093.0,6,16,1192,8,596,12892810.0,95.0,74.5,8,596,12899505.0,95.0,74.5
144357.0,17,2,180,1,90,0.0,90.0,90.0,1,90,0.0,90.0,90.0
53797.0,6,14,4740,7,653,8839.333333333334,249.0,93.28571428571428,7,4087,8359.166666666666,1514.0,583.8571428571429
31747.0,6,10,2032,5,524,5423.25,252.0,104.8,5,1508,6936.5,1236.0,301.6
146711.0,6,3,337,2,214,0.0,160.0,107.0,1,123,0.0,123.0,123.0
258142.0,6,3,337,2,214,0.0,160.0,107.0,1,123,0.0,123.0,123.0
291954.0,17,2,180,1,90,0.0,90.0,90.0,1,90,0.0,90.0,90.0
225705.0,6,3,426,2,280,0.0,214.0,140.0,1,146,0.0,146.0,146.0
2379.0,17,2,762,2,762,0.0,381.0,381.0,0,0,0.0,0.0,0.0
238257.0,6,3,337,2,214,0.0,160.0,107.0,1,123,0.0,123.0,123.0
90254768.0,6,13,2036,8,1016,12893538.285714284,188.0,127.0,5,1020,22522702.25,204.0,204.0
2873724.0,6,4,270,2,134,0.0,68.0,67.0,2,136,0.0,70.0,68.0
0.0,17,1,55,1,55,0.0,55.0,55.0,0,0,0.0,0.0,0.0
1004223.0,6,12,1354,6,723,199732.6,253.0,120.5,6,631,200307.0,293.0,105.16666666666669
306.0,17,2,174,1,79,0.0,79.0,79.0,1,95,0.0,95.0,95.0
1306867.0,6,4,264,2,132,0.0,66.0,66.0,2,132,0.0,66.0,66.0
1199.0,17,4,438,2,148,0.0,74.0,74.0,2,290,0.0,147.0,145.0
308945.0,6,3,202,2,128,0.0,74.0,64.0,1,74,0.0,74.0,74.0
256854.00000000003,6,10,1221,6,636,51370.8,298.0,106.0,4,585,80246.33333333333,379.0,146.25
22418.0,17,2,582,1,83,0.0,83.0,83.0,1,499,0.0,499.0,499.0
107332.0,17,2,286,2,286,0.0,143.0,143.0,0,0,0.0,0.0,0.0
204471.0,17,2,762,2,762,0.0,381.0,381.0,0,0,0.0,0.0,0.0
16697351.000000002,6,21,1952,10,1262,1820577.0,447.0,126.2,11,690,1638494.8,78.0,62.72727272727273
120000028.0,6,38,3840,21,2048,6000001.4,425.0,97.52380952380952,17,1792,7426536.375,358.0,105.41176470588236
244723.0,6,3,373,2,238,0.0,172.0,119.0,1,135,0.0,135.0,135.0
143883.0,17,2,180,1,90,0.0,90.0,90.0,1,90,0.0,90.0,90.0
137029.0,6,2,132,1,66,0.0,66.0,66.0,1,66,0.0,66.0,66.0
297932.0,6,6,412,4,272,99310.66666666669,74.0,68.0,2,140,0.0,74.0,70.0
508712.00000000006,6,5,336,2,134,0.0,68.0,67.0,3,202,195974.0,70.0,67.33333333333333
300444.0,6,6,412,4,272,100148.0,74.0,68.0,2,140,0.0,74.0,70.0
217779.0,6,3,426,2,280,0.0,214.0,140.0,1,146,0.0,146.0,146.0
16825.0,17,2,180,1,90,0.0,90.0,90.0,1,90,0.0,90.0,90.0
1175793.0,6,13,3009,8,2381,167970.42857142858,1514.0,297.625,5,628,224970.25,331.0,125.6
105541239.0,6,34,2541,16,1209,7036082.6,123.0,75.5625,18,1332,6195584.05882353,123.0,74.0
217668.0,6,3,426,2,280,0.0,214.0,140.0,1,146,0.0,146.0,146.0
207559.0,17,2,180,1,90,0.0,90.0,90.0,1,90,0.0,90.0,90.0
274520.0,17,2,180,1,90,0.0,90.0,90.0,1,90,0.0,90.0,90.0
43461.0,6,14,4740,7,653,7118.666666666667,249.0,93.28571428571428,7,4087,6447.5,1514.0,583.8571428571429
119856411.0,6,14,2102,5,1020,29963837.75,204.0,204.0,9,1082,14981904.375,188.0,120.22222222222224
5624037.0,6,5,336,2,134,0.0,68.0,67.0,3,202,1425640.0,70.0,67.33333333333333
116654976.0,6,214,24308,107,16950,1098488.7735849055,284.0,158.41121495327104,107,7358,1098488.5283018867,140.0,68.76635514018692
71040.0,17,2,630,1,82,0.0,82.0,82.0,1,548,0.0,548.0,548.0
41538.0,6,14,4740,7,653,5973.166666666667,249.0,93.28571428571428,7,4087,6167.5,1514.0,583.8571428571429
122511.0,6,3,337,2,214,0.0,160.0,107.0,1,123,0.0,123.0,123.0
144012.0,17,4,704,2,148,0.0,74.0,74.0,2,556,0.0,280.0,278.0
61429.0,6,14,4740,7,653,7741.0,249.0,93.28571428571428,7,4087,10089.166666666666,1514.0,583.8571428571429
5005609.0,17,4,352,2,176,0.0,88.0,88.0,2,176,0.0,88.0,88.0
313687.0,6,6,412,4,272,104562.33333333331,74.0,68.0,2,140,0.0,74.0,70.0
50421.0,6,14,4740,7,653,8286.833333333334,249.0,93.28571428571428,7,4087,7753.666666666667,1514.0,583.8571428571429
90056996.0,17,27,12943,27,12943,3463730.6153846155,501.0,479.3703703703704,0,0,0.0,0.0,0.0
90307375.0,6,16,1192,8,596,12893146.142857144,95.0,74.5,8,596,12900595.0,95.0,74.5
120127976.0,6,15,2428,9,1204,15015997.0,188.0,133.77777777777777,6,1224,18018700.6,204.0,204.0
245369.0,6,3,337,2,214,0.0,160.0,107.0,1,123,0.0,123.0,123.0
90009458.0,17,28,13364,28,13364,3333683.6296296297,501.0,477.2857142857143,0,0,0.0,0.0,0.0
18780.0,17,3,1026,3,1026,9390.0,342.0,342.0,0,0,0.0,0.0,0.0
2347.0,17,4,344,2,150,0.0,75.0,75.0,2,194,0.0,103.0,97.0
92880227.0,6,189,21604,95,6418,988087.5212765958,140.0,67.5578947368421,94,15186,932016.3118279568,300.0,161.5531914893617
36356.0,6,14,4740,7,653,5913.0,249.0,93.28571428571428,7,4087,5096.166666666667,1514.0,583.8571428571429
128609490.0,6,37,2656,18,1248,6977969.352941177,123.0,69.33333333333333,19,1408,6590284.388888889,139.0,74.10526315789474
135143295.0,17,6,1146,6,1146,27028659.0,191.0,191.0,0,0,0.0,0.0,0.0
895643.0,6,13,1394,7,797,149273.83333333334,253.0,113.85714285714286,6,597,177634.0,259.0,99.5
321524.0,17,4,1400,4,1400,107174.66666666669,350.0,350.0,0,0,0.0,0.0,0.0
135130868.0,17,6,1206,6,1206,27026173.6,201.0,201.0,0,0,0.0,0.0,0.0
228241.0,17,2,180,1,90,0.0,90.0,90.0,1,90,0.0,90.0,90.0
50681.0,6,14,4740,7,653,8214.666666666666,249.0,93.28571428571428,7,4087,8311.333333333334,1514.0,583.8571428571429
134006809.0,17,17,1255,9,649,16750851.125,174.0,72.11111111111111,8,606,16261447.714285716,174.0,75.75
108107704.0,17,5,1005,5,1005,27026926.0,201.0,201.0,0,0,0.0,0.0,0.0
154.0,17,2,700,2,700,0.0,350.0,350.0,0,0,0.0,0.0,0.0
7589294.0,17,4,1376,3,1026,81329.5,342.0,342.0,1,350,0.0,350.0,350.0
120151567.0,6,316,35846,158,10724,753529.3248407643,140.0,67.87341772151899,158,25122,760064.0318471338,284.0,159.0
135134520.0,17,6,1146,6,1146,27026904.0,191.0,191.0,0,0,0.0,0.0,0.0
309.0,17,2,174,1,79,0.0,79.0,79.0,1,95,0.0,95.0,95.0
302960.0,6,6,412,4,272,100986.66666666669,74.0,68.0,2,140,0.0,74.0,70.0
228298.0,17,2,180,1,90,0.0,90.0,90.0,1,90,0.0,90.0,90.0
108107950.0,17,5,1005,5,1005,27026987.5,201.0,201.0,0,0,0.0,0.0,0.0
35494.0,6,10,2032,5,524,8056.25,252.0,104.8,5,1508,8051.25,1236.0,301.6
108106798.0,17,5,955,5,955,27026699.5,191.0,191.0,0,0,0.0,0.0,0.0
300850.0,6,3,202,2,128,0.0,74.0,64.0,1,74,0.0,74.0,74.0
0.0,6,1,66,1,66,0.0,66.0,66.0,0,0,0.0,0.0,0.0
3426.0,17,4,344,2,150,0.0,75.0,75.0,2,194,0.0,103.0,97.0
1152110.0,6,13,3017,8,2389,164587.14285714287,1514.0,298.625,5,628,219886.5,331.0,125.6
2889118.0,6,11,2106,6,598,577526.0,252.0,99.66666666666669,5,1508,2238.25,1236.0,301.6
120122875.0,6,14,2224,9,1204,15015359.375,188.0,133.77777777777777,5,1020,22522976.75,204.0,204.0
113000935.0,17,13,821,7,432,18833489.166666668,174.0,61.71428571428572,6,389,18600831.2,174.0,64.83333333333333
2306.0,17,4,344,2,150,0.0,75.0,75.0,2,194,0.0,103.0,97.0
316656.0,17,4,1400,4,1400,105552.0,350.0,350.0,0,0,0.0,0.0,0.0
90013739.0,17,28,13364,28,13364,3333842.185185185,501.0,477.2857142857143,0,0,0.0,0.0,0.0
43008488.0,6,4,1843,3,1017,21504244.0,885.0,339.0,1,826,0.0,826.0,826.0
196821.0,17,2,180,1,90,0.0,90.0,90.0,1,90,0.0,90.0,90.0
135135244.0,17,6,1146,6,1146,27027048.8,191.0,191.0,0,0,0.0,0.0,0.0
153446.0,17,2,180,1,90,0.0,90.0,90.0,1,90,0.0,90.0,90.0
54584.0,6,14,4740,7,653,8976.833333333334,249.0,93.28571428571428,7,4087,7855.333333333333,1514.0,583.8571428571429
308617.0,6,6,412,4,272,102872.33333333331,74.0,68.0,2,140,0.0,74.0,70.0
28747.0,6,10,2032,5,524,6483.25,252.0,104.8,5,1508,6241.25,1236.0,301.6
303106.0,6,2,132,1,66,0.0,66.0,66.0,1,66,0.0,66.0,66.0
108106380.0,17,5,955,5,955,27026595.0,191.0,191.0,0,0,0.0,0.0,0.0
10890064.0,6,8,544,4,272,3584803.6666666665,74.0,68.0,4,272,3584747.333333333,74.0,68.0
90065889.0,17,28,13364,28,13364,3335773.6666666665,501.0,477.2857142857143,0,0,0.0,0.0,0.0
26867.0,6,14,4740,7,653,3437.5,249.0,93.28571428571428,7,4087,4333.5,1514.0,583.8571428571429
15165.0,6,10,2032,5,524,3575.0,252.0,104.8,5,1508,3384.0,1236.0,301.6
104866.0,17,2,700,2,700,0.0,350.0,350.0,0,0,0.0,0.0,0.0
27314.0,6,10,2032,5,524,5866.25,252.0,104.8,5,1508,6546.25,1236.0,301.6
10600457.0,6,7,478,4,272,3472903.0,74.0,68.0,3,206,5209226.5,74.0,68.66666666666667
158992.0,6,3,337,2,214,0.0,160.0,107.0,1,123,0.0,123.0,123.0
115489457.0,6,326,37550,163,26570,711550.0679012346,284.0,163.00613496932516,163,10980,711568.4320987654,140.0,67.36196319018404
120000231.0,6,26,2019,15,1179,8571445.07142857,95.0,78.6,11,840,9047340.0,95.0,76.36363636363636
135125876.0,17,6,1146,6,1146,27025175.2,191.0,191.0,0,0,0.0,0.0,0.0
232886.0,6,3,337,2,214,0.0,160.0,107.0,1,123,0.0,123.0,123.0
217139.0,6,3,426,2,280,0.0,214.0,140.0,1,146,0.0,146.0,146.0
50893.0,17,2,180,1,90,0.0,90.0,90.0,1,90,0.0,90.0,90.0
3744.0,17,2,401,1,88,0.0,88.0,88.0,1,313,0.0,313.0,313.0
92113803.0,6,38,2508,19,1254,5105436.333333333,66.0,66.0,19,1254,5105436.222222222,66.0,66.0
21934.0,6,14,4740,7,653,2954.1666666666665,249.0,93.28571428571428,7,4087,3517.333333333333,1514.0,583.8571428571429
0.0,17,1,55,1,55,0.0,55.0,55.0,0,0,0.0,0.0,0.0
9569.0,6,10,1067,5,536,2220.25,264.0,107.2,5,531,2116.25,259.0,106.2
120002.0,17,2,180,1,70,0.0,70.0,70.0,1,110,0.0,110.0,110.0
90278697.0,6,16,1192,8,596,12890841.857142856,95.0,74.5,8,596,12896785.142857144,95.0,74.5
130571.0,6,2,132,1,66,0.0,66.0,66.0,1,66,0.0,66.0,66.0
29662.0,6,11,2098,6,590,5932.4,252.0,98.33333333333331,5,1508,6359.0,1236.0,301.6
0.0,17,1,381,1,381,0.0,381.0,381.0,0,0,0.0,0.0,0.0
20841.0,17,2,582,1,83,0.0,83.0,83.0,1,499,0.0,499.0,499.0
205914.0,17,2,180,1,90,0.0,90.0,90.0,1,90,0.0,90.0,90.0
1300314.0,6,4,264,2,132,0.0,66.0,66.0,2,132,0.0,66.0,66.0
43814.0,6,14,4740,7,653,7146.0,249.0,93.28571428571428,7,4087,5385.833333333333,1514.0,583.8571428571429
26015.0,6,14,4740,7,653,4168.333333333333,249.0,93.28571428571428,7,4087,3943.3333333333335,1514.0,583.8571428571429
226373.0,6,10,1221,6,636,45274.6,298.0,106.0,4,585,73986.0,379.0,146.25
367246.0,17,2,363,1,75,0.0,75.0,75.0,1,288,0.0,288.0,288.0
101257961.0,6,198,22420,99,15664,1031047.7551020408,374.0,158.22222222222223,99,6756,1031042.2551020408,140.0,68.24242424242425
44098.0,6,14,4740,7,653,7226.166666666667,249.0,93.28571428571428,7,4087,6585.5,1514.0,583.8571428571429
104705077.0,17,14,4788,14,4788,8054236.692307692,342.0,342.0,0,0,0.0,0.0,0.0
21489.0,6,14,4740,7,653,3471.5,249.0,93.28571428571428,7,4087,3443.5,1514.0,583.8571428571429
108099840.0,17,5,1005,5,1005,27024960.0,201.0,201.0,0,0,0.0,0.0,0.0
122964597.0,6,31,2034,16,1086,8197639.8,123.0,67.875,15,948,8054466.214285715,123.0,63.2
135136287.0,17,6,1206,6,1206,27027257.4,201.0,201.0,0,0,0.0,0.0,0.0
44028.0,6,14,4740,7,653,7171.0,249.0,93.28571428571428,7,4087,6028.5,1514.0,583.8571428571429
73729.0,6,14,4740,7,653,11658.666666666666,249.0,93.28571428571428,7,4087,7957.0,1514.0,583.8571428571429
120063790.0,17,28,13364,28,13364,4446807.037037037,501.0,477.2857142857143,0,0,0.0,0.0,0.0
159125.0,6,2,128,1,74,0.0,74.0,74.0,1,54,0.0,54.0,54.0
90256807.0,6,12,1832,8,1016,12893829.57142857,188.0,127.0,4,816,30031594.0,204.0,204.0
108085595.0,17,5,955,5,955,27021398.75,191.0,191.0,0,0,0.0,0.0,0.0
304215.0,6,6,412,4,272,101405.0,74.0,68.0,2,140,0.0,74.0,70.0
300107.0,6,6,412,4,272,100035.66666666669,74.0,68.0,2,140,0.0,74.0,70.0
38046.0,6,14,4740,7,653,6223.833333333333,249.0,93.28571428571428,7,4087,6201.666666666667,1514.0,583.8571428571429
146346.0,6,3,337,2,214,0.0,160.0,107.0,1,123,0.0,123.0,123.0
53267.0,17,2,180,1,90,0.0,90.0,90.0,1,90,0.0,90.0,90.0
120125077.0,6,14,2224,9,1204,15015634.625,188.0,133.77777777777777,5,1020,22522567.5,204.0,204.0
51066.0,6,14,4740,7,653,7704.166666666667,249.0,93.28571428571428,7,4087,7681.166666666667,1514.0,583.8571428571429
120012169.0,6,16,1192,8,596,17144595.57142857,95.0,74.5,8,596,17108165.285714287,95.0,74.5
204938.0,17,4,6056,4,6056,68312.66666666667,1514.0,1514.0,0,0,0.0,0.0,0.0
102916.0,17,2,286,2,286,0.0,143.0,143.0,0,0,0.0,0.0,0.0
2781543.0,6,2,132,1,66,0.0,66.0,66.0,1,66,0.0,66.0,66.0
90298006.0,6,15,1097,8,596,12899715.142857144,95.0,74.5,7,501,14998733.5,95.0,71.57142857142857
2303.0,17,4,344,2,150,0.0,75.0,75.0,2,194,0.0,103.0,97.0
43695.0,6,12,1413,7,882,7282.5,291.0,126.0,5,531,10209.25,259.0,106.2
411.0,17,2,410,1,78,0.0,78.0,78.0,1,332,0.0,332.0,332.0
119779852.0,6,24,1788,13,989,9981654.333333334,95.0,76.07692307692308,11,799,11952729.1,95.0,72.63636363636364
143889.0,17,2,180,1,90,0.0,90.0,90.0,1,90,0.0,90.0,90.0
153442.0,17,2,180,1,90,0.0,90.0,90.0,1,90,0.0,90.0,90.0
31087.0,6,14,4740,7,653,4032.3333333333335,249.0,93.28571428571428,7,4087,4675.5,1514.0,583.8571428571429
90036742.0,17,27,12943,27,12943,3462951.6153846155,501.0,479.3703703703704,0,0,0.0,0.0,0.0
49010.0,6,14,4740,7,653,7520.666666666667,249.0,93.28571428571428,7,4087,7948.666666666667,1514.0,583.8571428571429
284546.0,17,2,363,1,79,0.0,79.0,79.0,1,284,0.0,284.0,284.0
34824.0,6,14,4740,7,653,5626.833333333333,249.0,93.28571428571428,7,4087,5540.166666666667,1514.0,583.8571428571429
169239.0,17,2,414,1,88,0.0,88.0,88.0,1,326,0.0,326.0,326.0
625.0,17,2,762,2,762,0.0,381.0,381.0,0,0,0.0,0.0,0.0
212337.0,6,3,426,2,280,0.0,214.0,140.0,1,146,0.0,146.0,146.0
80625.0,17,2,762,2,762,0.0,381.0,381.0,0,0,0.0,0.0,0.0
207230.0,6,3,426,2,280,0.0,214.0,140.0,1,146,0.0,146.0,146.0
90291876.0,6,15,1097,8,596,12898839.42857143,95.0,74.5,7,501,14999902.166666666,95.0,71.57142857142857
13521.0,6,13,1459,7,862,1932.1666666666667,271.0,123.14285714285714,6,597,2543.8,259.0,99.5
217022.0,6,10,1221,6,636,43404.4,298.0,106.0,4,585,71239.0,379.0,146.25
24272.0,6,10,2032,5,524,5849.5,252.0,104.8,5,1508,5665.25,1236.0,301.6
1471224.0,6,20,7599,11,1469,147122.4,583.0,133.54545454545453,9,6130,151597.125,1484.0,681.1111111111111
6744.0,17,2,582,1,83,0.0,83.0,83.0,1,499,0.0,499.0,499.0
244319.0,6,3,337,2,214,0.0,160.0,107.0,1,123,0.0,123.0,123.0
38770.0,6,14,4740,7,653,6354.666666666667,249.0,93.28571428571428,7,4087,5712.666666666667,1514.0,583.8571428571429
120743645.0,6,30,2037,15,948,8075676.0,123.0,63.2,15,1089,7911178.928571428,123.0,72.6
37010.0,6,10,2032,5,524,8407.0,252.0,104.8,5,1508,8791.0,1236.0,301.6
105838107.0,6,44,2904,22,1452,5039909.857142857,66.0,66.0,22,1452,5029614.238095238,66.0,66.0
603377.0,6,4,508,2,238,0.0,172.0,119.0,2,270,0.0,135.0,135.0
120123969.0,6,16,2356,9,1204,15015496.125,188.0,133.77777777777777,7,1152,15008900.5,204.0,164.57142857142858
90669666.0,6,15,2302,9,1204,11316242.875,188.0,133.77777777777777,6,1098,18100976.8,204.0,183.0
319140.0,6,3,202,2,128,0.0,74.0,64.0,1,74,0.0,74.0,74.0
71264.0,6,14,4740,7,653,11748.666666666666,249.0,93.28571428571428,7,4087,10736.0,1514.0,583.8571428571429
21740.0,17,2,582,1,83,0.0,83.0,83.0,1,499,0.0,499.0,499.0
82.0,17,2,700,2,700,0.0,350.0,350.0,0,0,0.0,0.0,0.0
62869.99999999999,6,14,4740,7,653,7800.666666666667,249.0,93.28571428571428,7,4087,10340.166666666666,1514.0,583.8571428571429
64960.00000000001,6,14,4740,7,653,10335.333333333334,249.0,93.28571428571428,7,4087,10411.833333333334,1514.0,583.8571428571429
90048326.0,17,28,13364,28,13364,3335123.185185185,501.0,477.2857142857143,0,0,0.0,0.0,0.0
1311128.0,6,4,264,2,132,0.0,66.0,66.0,2,132,0.0,66.0,66.0
135129105.0,17,6,1206,6,1206,27025821.0,201.0,201.0,0,0,0.0,0.0,0.0
90220948.0,6,24,1829,11,840,8997871.2,95.0,76.36363636363636,13,989,7501294.5,95.0,76.07692307692308
103318174.0,6,42,2772,21,1386,5150442.35,66.0,66.0,21,1386,5150445.95,66.0,66.0
11080.0,6,10,1066,5,490,2504.5,218.0,98.0,5,576,2362.75,304.0,115.2
302192.0,6,6,412,4,272,100730.66666666669,74.0,68.0,2,140,0.0,74.0,70.0
40682.0,6,14,4740,7,653,5312.0,249.0,93.28571428571428,7,4087,6644.0,1514.0,583.8571428571429
235996.0,6,3,337,2,214,0.0,160.0,107.0,1,123,0.0,123.0,123.0
108417108.0,6,28,1860,14,966,8323186.615384615,123.0,69.0,14,894,8323185.076923077,123.0,63.85714285714285
90035120.0,17,28,13364,28,13364,3334634.074074074,501.0,477.2857142857143,0,0,0.0,0.0,0.0
45108776.0,17,9,3086,8,2736,5108250.857142857,342.0,342.0,1,350,0.0,350.0,350.0
233095.0,6,3,337,2,214,0.0,160.0,107.0,1,123,0.0,123.0,123.0
142441.0,6,2,132,1,66,0.0,66.0,66.0,1,66,0.0,66.0,66.0
146136.0,6,4,439,2,238,0.0,172.0,119.0,2,201,0.0,135.0,100.5
304145.0,6,3,202,2,128,0.0,74.0,64.0,1,74,0.0,74.0,74.0
208770.0,6,3,426,2,280,0.0,214.0,140.0,1,146,0.0,146.0,146.0
149681.0,17,4,6056,4,6056,49893.66666666666,1514.0,1514.0,0,0,0.0,0.0,0.0
485373.0,6,5,336,2,134,0.0,68.0,67.0,3,202,195306.0,70.0,67.33333333333333
340579.0,6,3,1604,2,851,0.0,785.0,425.5,1,753,0.0,753.0,753.0
298860.0,6,6,412,4,272,99620.0,74.0,68.0,2,140,0.0,74.0,70.0
57355.0,6,14,4740,7,653,9190.666666666666,249.0,93.28571428571428,7,4087,9421.333333333334,1514.0,583.8571428571429
38703.0,6,14,4740,7,653,6230.333333333333,249.0,93.28571428571428,7,4087,5892.666666666667,1514.0,583.8571428571429
242248.0,6,3,373,2,238,0.0,172.0,119.0,1,135,0.0,135.0,135.0
102433352.0,6,40,2640,20,1320,4991170.0,66.0,66.0,20,1320,5273321.47368421,66.0,66.0
2795670.0,6,2,132,1,66,0.0,66.0,66.0,1,66,0.0,66.0,66.0
50469.0,6,14,4740,7,653,8200.0,249.0,93.28571428571428,7,4087,7236.833333333333,1514.0,583.8571428571429
1204254.0,17,7,490,7,490,200709.0,70.0,70.0,0,0,0.0,0.0,0.0
0.0,6,1,66,1,66,0.0,66.0,66.0,0,0,0.0,0.0,0.0
90279778.0,6,16,1192,8,596,12890779.857142856,95.0,74.5,8,596,12896009.0,95.0,74.5
168279.0,6,3,337,2,214,0.0,160.0,107.0,1,123,0.0,123.0,123.0
10430518.0,6,6,412,3,206,5147450.5,74.0,68.66666666666667,3,206,5147351.5,74.0,68.66666666666667
9205.0,17,2,582,1,83,0.0,83.0,83.0,1,499,0.0,499.0,499.0
90296878.0,6,21,1585,11,840,9025356.5,95.0,76.36363636363636,10,745,9950881.111111112,95.0,74.5
2335.0,17,4,344,2,150,0.0,75.0,75.0,2,194,0.0,103.0,97.0
214007.0,6,10,1221,6,636,42801.4,298.0,106.0,4,585,70020.33333333333,379.0,146.25
69257.0,17,2,604,1,75,0.0,75.0,75.0,1,529,0.0,529.0,529.0
108105269.0,17,5,955,5,955,27026317.25,191.0,191.0,0,0,0.0,0.0,0.0
1810.0,17,4,438,2,148,0.0,74.0,74.0,2,290,0.0,147.0,145.0
284515.0,17,2,363,1,79,0.0,79.0,79.0,1,284,0.0,284.0,284.0
46398.0,6,14,4740,7,653,7201.333333333333,249.0,93.28571428571428,7,4087,7140.666666666667,1514.0,583.8571428571429
6671.0,17,2,582,1,83,0.0,83.0,83.0,1,499,0.0,499.0,499.0
90506900.0,17,12,778,6,389,18101380.0,174.0,64.83333333333333,6,389,17898624.8,174.0,64.83333333333333
3339883.0,6,132,122600,88,115394,38389.45977011494,1510.0,1311.2954545454545,44,7206,70501.11627906977,1510.0,163.77272727272728
97761160.0,17,12,778,6,389,19400201.8,174.0,64.83333333333333,6,389,19400805.0,174.0,64.83333333333333
228178.0,17,2,180,1,90,0.0,90.0,90.0,1,90,0.0,90.0,90.0
314289.0,6,6,412,4,272,104763.0,74.0,68.0,2,140,0.0,74.0,70.0
298563.0,6,6,412,4,272,99521.0,74.0,68.0,2,140,0.0,74.0,70.0
13917.0,6,11,1133,6,602,2783.4,264.0,100.33333333333331,5,531,2956.25,259.0,106.2
16065024.999999998,17,6,2052,6,2052,3213005.0,342.0,342.0,0,0,0.0,0.0,0.0
10239.0,6,10,2032,5,524,2316.0,252.0,104.8,5,1508,2328.75,1236.0,301.6
90059640.0,17,27,12943,27,12943,3463832.3076923075,501.0,479.3703703703704,0,0,0.0,0.0,0.0
128385586.0,17,15,907,7,432,18166828.0,174.0,61.71428571428572,8,475,18286749.0,174.0,59.375
1933.0,17,4,344,2,150,0.0,75.0,75.0,2,194,0.0,103.0,97.0
76616.0,6,14,4740,7,653,12582.666666666666,249.0,93.28571428571428,7,4087,12627.0,1514.0,583.8571428571429
135085.0,6,3,337,2,214,0.0,160.0,107.0,1,123,0.0,123.0,123.0
45448.0,6,10,2032,5,524,9020.25,252.0,104.8,5,1508,9604.25,1236.0,301.6
1479342.0,6,2,132,1,66,0.0,66.0,66.0,1,66,0.0,66.0,66.0
100127148.0,6,192,21776,96,15218,1051702.9052631578,284.0,158.52083333333334,96,6558,1051703.4210526317,140.0,68.3125
232490.0,6,3,337,2,214,0.0,160.0,107.0,1,123,0.0,123.0,123.0
123250553.0,6,49,3234,25,1650,5135439.708333333,66.0,66.0,24,1584,5190755.565217392,66.0,66.0
1301245.0,6,4,264,2,132,0.0,66.0,66.0,2,132,0.0,66.0,66.0
90039733.0,17,27,12943,27,12943,3463066.653846154,501.0,479.3703703703704,0,0,0.0,0.0,0.0
789.0,17,4,438,2,148,0.0,74.0,74.0,2,290,0.0,147.0,145.0
46817.0,6,14,4740,7,653,7053.166666666667,249.0,93.28571428571428,7,4087,6140.333333333333,1514.0,583.8571428571429
91149379.0,6,22,1680,10,745,10127708.777777778,95.0,74.5,12,935,8262977.454545454,95.0,77.91666666666667
90728344.0,6,20,1694,11,1044,9072834.4,258.0,94.9090909090909,9,650,11304604.625,95.0,72.22222222222223
0.0,17,1,72,1,72,0.0,72.0,72.0,0,0,0.0,0.0,0.0
305258.0,6,6,412,4,272,101752.66666666669,74.0,68.0,2,140,0.0,74.0,70.0
237869.0,6,3,373,2,238,0.0,172.0,119.0,1,135,0.0,135.0,135.0
228352.0,17,2,180,1,90,0.0,90.0,90.0,1,90,0.0,90.0,90.0
90059369.0,17,28,13364,28,13364,3335532.185185185,501.0,477.2857142857143,0,0,0.0,0.0,0.0
108092.0,17,2,286,2,286,0.0,143.0,143.0,0,0,0.0,0.0,0.0
90021541.0,17,28,13364,28,13364,3334131.1481481483,501.0,477.2857142857143,0,0,0.0,0.0,0.0
314910.0,17,4,1400,4,1400,104970.0,350.0,350.0,0,0,0.0,0.0,0.0
99238977.0,6,46,3822,25,2067,4134957.375,123.0,82.68,21,1755,4951131.0,123.0,83.57142857142857
3348.0,17,4,344,2,150,0.0,75.0,75.0,2,194,0.0,103.0,97.0
155266.0,6,3,337,2,214,0.0,160.0,107.0,1,123,0.0,123.0,123.0
312796.0,6,3,202,2,128,0.0,74.0,64.0,1,74,0.0,74.0,74.0
107240.0,17,2,286,2,286,0.0,143.0,143.0,0,0,0.0,0.0,0.0
233091.0,6,3,337,2,214,0.0,160.0,107.0,1,123,0.0,123.0,123.0
119396942.0,6,270,30990,135,9132,890353.7313432836,140.0,67.64444444444445,135,21858,885002.567164179,284.0,161.9111111111111
95912.0,6,14,4740,7,653,14786.0,249.0,93.28571428571428,7,4087,12878.166666666666,1514.0,583.8571428571429
331.0,17,2,166,1,75,0.0,75.0,75.0,1,91,0.0,91.0,91.0
315314.0,17,4,1400,4,1400,105104.66666666669,350.0,350.0,0,0,0.0,0.0,0.0
47469.0,6,14,4740,7,653,6888.333333333333,249.0,93.28571428571428,7,4087,7183.166666666667,1514.0,583.8571428571429
5699.0,17,4,344,2,150,0.0,75.0,75.0,2,194,0.0,103.0,97.0
93551226.0,17,14,1126,7,563,15501231.666666666,174.0,80.42857142857143,7,563,15500138.166666666,174.0,80.42857142857143
42081.0,6,14,4740,7,653,6446.666666666667,249.0,93.28571428571428,7,4087,6477.833333333333,1514.0,583.8571428571429
16938.0,6,10,1067,5,536,4070.5,264.0,107.2,5,531,3604.75,259.0,106.2
281444.0,17,2,363,1,79,0.0,79.0,79.0,1,284,0.0,284.0,284.0
120070119.0,6,35,2473,18,1348,7062948.176470588,139.0,74.88888888888889,17,1125,7415890.0625,123.0,66.17647058823529
106593455.0,6,28,1860,14,966,8182891.384615385,123.0,69.0,14,894,8182893.153846154,123.0,63.85714285714285
153547.0,17,2,180,1,90,0.0,90.0,90.0,1,90,0.0,90.0,90.0
162383.0,17,2,180,1,90,0.0,90.0,90.0,1,90,0.0,90.0,90.0
26790337.0,17,5,1710,5,1710,6697584.25,342.0,342.0,0,0,0.0,0.0,0.0
120124556.0,6,15,2428,9,1204,15015569.5,188.0,133.77777777777777,6,1224,18019655.6,204.0,204.0
1168802.0,6,13,3006,8,2378,166971.7142857143,1514.0,297.25,5,628,223207.0,331.0,125.6
26363.0,6,10,2032,5,524,5939.75,252.0,104.8,5,1508,4991.5,1236.0,301.6
323.0,17,2,174,1,79,0.0,79.0,79.0,1,95,0.0,95.0,95.0
383037.0,17,2,363,1,75,0.0,75.0,75.0,1,288,0.0,288.0,288.0
31076.0,6,10,2032,5,524,7495.75,252.0,104.8,5,1508,7336.25,1236.0,301.6
230976.0,6,10,1221,6,636,46195.2,298.0,106.0,4,585,75415.0,379.0,146.25
59677.0,6,10,2032,5,524,14688.75,252.0,104.8,5,1508,13435.75,1236.0,301.6
146698.0,6,3,337,2,214,0.0,160.0,107.0,1,123,0.0,123.0,123.0
57871.0,6,14,4740,7,653,9021.333333333334,249.0,93.28571428571428,7,4087,8956.666666666666,1514.0,583.8571428571429
127001213.0,17,15,907,8,475,18143030.42857143,174.0,59.375,7,432,17835639.833333332,174.0,61.71428571428572
1708.0,17,2,762,2,762,0.0,381.0,381.0,0,0,0.0,0.0,0.0
108110815.0,17,5,1005,5,1005,27027703.75,201.0,201.0,0,0,0.0,0.0,0.0
33664.0,6,2,145,2,145,0.0,91.0,72.5,0,0,0.0,0.0,0.0
203199.0,6,12,1373,7,714,33866.5,298.0,102.0,5,659,50034.5,379.0,131.8
97100408.0,6,176,19872,88,13842,1113621.91954023,284.0,157.29545454545453,88,6030,1113618.0,140.0,68.52272727272727
121295004.0,6,31,2050,16,1102,8086333.6,139.0,68.875,15,948,7935248.357142857,123.0,63.2
153415.0,17,2,180,1,90,0.0,90.0,90.0,1,90,0.0,90.0,90.0
1306176.0,6,4,264,2,132,0.0,66.0,66.0,2,132,0.0,66.0,66.0
23014520.0,17,3,1034,2,684,0.0,342.0,342.0,1,350,0.0,350.0,350.0
1031575.0,6,11,1134,6,558,206315.00000000003,220.0,93.0,5,576,256946.0,304.0,115.2
90540803.0,6,28,2008,14,1045,6948084.692307692,139.0,74.64285714285714,14,963,6948085.0,123.0,68.78571428571429
1822146.0,6,7,499,4,301,536405.3333333334,103.0,75.25,3,198,818731.0,66.0,66.0
2913437.0,6,2,132,1,66,0.0,66.0,66.0,1,66,0.0,66.0,66.0
135132418.0,17,6,1146,6,1146,27026483.6,191.0,191.0,0,0,0.0,0.0,0.0
108102585.0,17,5,955,5,955,27025646.25,191.0,191.0,0,0,0.0,0.0,0.0
2139.0,17,2,762,2,762,0.0,381.0,381.0,0,0,0.0,0.0,0.0
332862.0,6,3,204,2,136,0.0,70.0,68.0,1,68,0.0,68.0,68.0
91908274.0,6,24,1829,13,989,7658553.0,95.0,76.07692307692308,11,840,9190320.8,95.0,76.36363636363636
90270613.0,6,13,2036,8,1016,12895801.857142856,188.0,127.0,5,1020,22526395.25,204.0,204.0
30699.0,6,14,4740,7,653,4891.0,249.0,93.28571428571428,7,4087,4874.5,1514.0,583.8571428571429
108102759.0,17,5,955,5,955,27025689.75,191.0,191.0,0,0,0.0,0.0,0.0
52697.0,6,14,4740,7,653,6844.166666666667,249.0,93.28571428571428,7,4087,7225.833333333333,1514.0,583.8571428571429
30185.0,6,14,4740,7,653,4805.166666666667,249.0,93.28571428571428,7,4087,4867.0,1514.0,583.8571428571429
135138293.0,17,6,1206,6,1206,27027658.6,201.0,201.0,0,0,0.0,0.0,0.0
107620.0,17,2,286,2,286,0.0,143.0,143.0,0,0,0.0,0.0,0.0
120484.0,17,2,180,1,70,0.0,70.0,70.0,1,110,0.0,110.0,110.0
96366255.0,17,12,778,6,389,19200754.8,174.0,64.83333333333333,6,389,19200190.6,174.0,64.83333333333333
208480.0,6,3,426,2,280,0.0,214.0,140.0,1,146,0.0,146.0,146.0
209610.0,17,2,180,1,90,0.0,90.0,90.0,1,90,0.0,90.0,90.0
3153001.0,6,3,1777,2,951,0.0,885.0,475.5,1,826,0.0,826.0,826.0
120033718.0,17,29,13785,29,13785,4286918.5,501.0,475.3448275862069,0,0,0.0,0.0,0.0
122001153.0,17,15,907,8,475,17428736.14285714,174.0,59.375,7,432,17000929.0,174.0,61.71428571428572
228164.0,17,2,180,1,90,0.0,90.0,90.0,1,90,0.0,90.0,90.0
661.0,17,2,762,2,762,0.0,381.0,381.0,0,0,0.0,0.0,0.0
2003.0,17,4,344,2,150,0.0,75.0,75.0,2,194,0.0,103.0,97.0
322.0,17,2,174,1,79,0.0,79.0,79.0,1,95,0.0,95.0,95.0
7032.0,17,2,582,1,83,0.0,83.0,83.0,1,499,0.0,499.0,499.0
27479077.0,17,5,1710,5,1710,6869769.25,342.0,342.0,0,0,0.0,0.0,0.0
45528.0,6,14,4740,7,653,7468.666666666667,249.0,93.28571428571428,7,4087,7449.166666666667,1514.0,583.8571428571429
135134513.0,17,6,1206,6,1206,27026902.6,201.0,201.0,0,0,0.0,0.0,0.0
17621.0,6,10,2032,5,524,4110.0,252.0,104.8,5,1508,3863.0,1236.0,301.6
197147.0,17,2,180,1,90,0.0,90.0,90.0,1,90,0.0,90.0,90.0
27727.0,6,14,4740,7,653,4290.0,249.0,93.28571428571428,7,4087,4420.5,1514.0,583.8571428571429
101001013.0,17,13,821,7,432,16833502.166666668,174.0,61.71428571428572,6,389,16400553.4,174.0,64.83333333333333
113733915.0,6,46,3036,23,1518,5155441.863636363,66.0,66.0,23,1518,5155448.318181818,66.0,66.0
14316.0,6,10,1065,5,534,3375.25,262.0,106.8,5,531,2974.75,259.0,106.2
35577.0,6,14,4740,7,653,5795.0,249.0,93.28571428571428,7,4087,4094.6666666666665,1514.0,583.8571428571429
119494095.0,17,35,16705,35,16705,3514532.205882353,501.0,477.2857142857143,0,0,0.0,0.0,0.0
320241.0,17,2,180,1,90,0.0,90.0,90.0,1,90,0.0,90.0,90.0
20163.0,17,2,582,1,83,0.0,83.0,83.0,1,499,0.0,499.0,499.0
4481.0,17,2,614,1,72,0.0,72.0,72.0,1,542,0.0,542.0,542.0
115013957.0,6,35,2473,18,1348,6765526.882352941,139.0,74.88888888888889,17,1125,7030280.25,123.0,66.17647058823529
90099463.0,6,12,1710,5,882,22524506.25,204.0,176.4,7,828,15011015.833333334,188.0,118.28571428571428
22884.0,6,14,4740,7,653,3565.333333333333,249.0,93.28571428571428,7,4087,3673.5,1514.0,583.8571428571429
79.0,17,2,762,2,762,0.0,381.0,381.0,0,0,0.0,0.0,0.0
104278.0,17,2,700,2,700,0.0,350.0,350.0,0,0,0.0,0.0,0.0
1031.0,17,2,508,2,508,0.0,257.0,254.0,0,0,0.0,0.0,0.0
51599.0,6,13,1479,7,882,8599.833333333334,291.0,126.0,6,597,8553.6,259.0,99.5
300049.0,6,6,412,4,272,100016.33333333331,74.0,68.0,2,140,0.0,74.0,70.0
1156894.0,6,13,3010,8,2382,165270.57142857142,1514.0,297.75,5,628,221063.0,331.0,125.6
90052342.0,17,28,13364,28,13364,3335271.925925926,501.0,477.2857142857143,0,0,0.0,0.0,0.0
303071.0,6,6,412,4,272,101023.66666666669,74.0,68.0,2,140,0.0,74.0,70.0
301910.0,6,6,412,4,272,100636.66666666669,74.0,68.0,2,140,0.0,74.0,70.0
307261.0,6,6,412,4,272,102420.33333333331,74.0,68.0,2,140,0.0,74.0,70.0
32649.0,6,14,4740,7,653,4962.333333333333,249.0,93.28571428571428,7,4087,4422.166666666667,1514.0,583.8571428571429
153476.0,17,2,180,1,90,0.0,90.0,90.0,1,90,0.0,90.0,90.0
90055404.0,17,28,13364,28,13364,3335385.333333333,501.0,477.2857142857143,0,0,0.0,0.0,0.0
321.0,17,2,174,1,79,0.0,79.0,79.0,1,95,0.0,95.0,95.0
120546684.0,6,21,1822,10,1023,11847128.222222222,336.0,102.3,11,799,12029996.4,95.0,72.63636363636364
119335047.0,6,25,1883,14,1043,9176925.538461538,95.0,74.5,11,840,11932802.4,95.0,76.36363636363636
6709.0,17,2,582,1,83,0.0,83.0,83.0,1,499,0.0,499.0,499.0
2594243.0,6,2,132,1,66,0.0,66.0,66.0,1,66,0.0,66.0,66.0
2599235.0,6,2,132,1,66,0.0,66.0,66.0,1,66,0.0,66.0,66.0
99790.0,6,14,4740,7,653,14047.666666666666,249.0,93.28571428571428,7,4087,16124.833333333334,1514.0,583.8571428571429
120057523.0,17,28,13364,28,13364,4446574.925925926,501.0,477.2857142857143,0,0,0.0,0.0,0.0
197312.0,17,2,180,1,90,0.0,90.0,90.0,1,90,0.0,90.0,90.0
39348.0,6,14,4740,7,653,6432.333333333333,249.0,93.28571428571428,7,4087,5901.333333333333,1514.0,583.8571428571429
311845.0,17,4,1400,4,1400,103948.33333333331,350.0,350.0,0,0,0.0,0.0,0.0
153379.0,17,2,180,1,90,0.0,90.0,90.0,1,90,0.0,90.0,90.0
107789.0,17,2,286,2,286,0.0,143.0,143.0,0,0,0.0,0.0,0.0
96617316.0,17,12,778,6,389,19201064.8,174.0,64.83333333333333,6,389,19200192.8,174.0,64.83333333333333
117043801.0,6,329,39622,165,11186,713681.7134146341,140.0,67.7939393939394,164,28436,716699.5582822086,284.0,173.390243902439
1842803.0,17,2,896,2,896,0.0,453.0,448.0,0,0,0.0,0.0,0.0
364.0,17,2,202,1,87,0.0,87.0,87.0,1,115,0.0,115.0,115.0
135139937.0,17,6,1206,6,1206,27027987.4,201.0,201.0,0,0,0.0,0.0,0.0
317826.0,6,3,202,2,128,0.0,74.0,64.0,1,74,0.0,74.0,74.0
107965.0,17,2,286,2,286,0.0,143.0,143.0,0,0,0.0,0.0,0.0
12327.0,6,10,1949,5,441,2754.25,169.0,88.2,5,1508,2824.25,1236.0,301.6
55434.0,6,10,2032,5,524,13538.75,252.0,104.8,5,1508,9166.25,1236.0,301.6
2430473.0,6,3,1602,2,850,0.0,784.0,425.0,1,752,0.0,752.0,752.0
2028.0,17,2,684,1,342,0.0,342.0,342.0,1,342,0.0,342.0,342.0
20821.0,6,14,4740,7,653,3273.1666666666665,249.0,93.28571428571428,7,4087,3328.0,1514.0,583.8571428571429
4269.0,17,2,598,1,72,0.0,72.0,72.0,1,526,0.0,526.0,526.0
9549.0,6,10,1067,5,536,2123.5,264.0,107.2,5,531,1946.5,259.0,106.2
92572700.0,6,53,15230,28,4527,3428618.5185185187,486.0,161.67857142857142,25,10703,3850465.2083333335,1514.0,428.12
24326.0,6,14,4740,7,653,3767.8333333333335,249.0,93.28571428571428,7,4087,3921.0,1514.0,583.8571428571429
55954.0,6,14,4740,7,653,9112.166666666666,249.0,93.28571428571428,7,4087,8148.833333333333,1514.0,583.8571428571429
119896416.0,17,35,16705,35,16705,3526365.1764705884,501.0,477.2857142857143,0,0,0.0,0.0,0.0
108105350.0,17,5,955,5,955,27026337.5,191.0,191.0,0,0,0.0,0.0,0.0
90044517.0,17,28,13364,28,13364,3334982.111111111,501.0,477.2857142857143,0,0,0.0,0.0,0.0
14103399.0,17,6,2052,6,2052,2820679.8,342.0,342.0,0,0,0.0,0.0,0.0
107372.0,17,2,286,2,286,0.0,143.0,143.0,0,0,0.0,0.0,0.0
231912.0,17,2,180,1,90,0.0,90.0,90.0,1,90,0.0,90.0,90.0
149664264.0,17,36,17126,36,17126,4276121.828571429,501.0,475.72222222222223,0,0,0.0,0.0,0.0
410775.0,17,2,180,1,90,0.0,90.0,90.0,1,90,0.0,90.0,90.0
14554.0,6,14,4740,7,653,2173.5,249.0,93.28571428571428,7,4087,2267.6666666666665,1514.0,583.8571428571429
232870.0,6,3,337,2,214,0.0,160.0,107.0,1,123,0.0,123.0,123.0
2449.0,17,4,344,2,150,0.0,75.0,75.0,2,194,0.0,103.0,97.0
326.0,17,2,174,1,79,0.0,79.0,79.0,1,95,0.0,95.0,95.0
106854069.0,6,44,2904,22,1452,5088289.0,66.0,66.0,22,1452,5073395.714285715,66.0,66.0
14619.0,6,10,1067,5,536,3488.25,264.0,107.2,5,531,2905.5,259.0,106.2
108104328.0,17,5,1005,5,1005,27026082.0,201.0,201.0,0,0,0.0,0.0,0.0
69381.0,17,2,626,1,72,0.0,72.0,72.0,1,554,0.0,554.0,554.0
108105128.0,17,5,1005,5,1005,27026282.0,201.0,201.0,0,0,0.0,0.0,0.0
316160.0,17,4,704,2,148,0.0,74.0,74.0,2,556,0.0,280.0,278.0
90265009.0,6,12,1832,8,1016,12895001.285714284,188.0,127.0,4,816,30033483.666666668,204.0,204.0
298574.0,6,6,412,4,272,99524.66666666669,74.0,68.0,2,140,0.0,74.0,70.0
1873.0,17,2,691,1,349,0.0,349.0,349.0,1,342,0.0,342.0,342.0
218197.0,6,3,426,2,280,0.0,214.0,140.0,1,146,0.0,146.0,146.0
489.0,17,2,508,2,508,0.0,257.0,254.0,0,0,0.0,0.0,0.0
90014752.0,17,28,13364,28,13364,3333879.703703704,501.0,477.2857142857143,0,0,0.0,0.0,0.0
143890.0,17,2,180,1,90,0.0,90.0,90.0,1,90,0.0,90.0,90.0
127085455.0,6,30,1990,15,948,8364337.785714285,123.0,63.2,15,1042,8364341.928571428,139.0,69.46666666666667
36365.0,6,13,1459,7,862,5976.5,271.0,123.14285714285714,6,597,7119.2,259.0,99.5
4068.0,17,4,571,2,148,0.0,74.0,74.0,2,423,0.0,276.0,211.5
217574.0,6,3,426,2,280,0.0,214.0,140.0,1,146,0.0,146.0,146.0
78205.0,6,14,4740,7,653,12503.166666666666,249.0,93.28571428571428,7,4087,12612.333333333334,1514.0,583.8571428571429
197933.0,17,2,180,1,90,0.0,90.0,90.0,1,90,0.0,90.0,90.0
34158.0,6,14,4740,7,653,5316.666666666667,249.0,93.28571428571428,7,4087,5243.0,1514.0,583.8571428571429
9005036.0,17,4,300,4,300,3001678.6666666665,75.0,75.0,0,0,0.0,0.0,0.0
111354169.0,6,36,2734,19,1471,6174358.611111111,139.0,77.42105263157895,17,1263,6946155.25,123.0,74.29411764705883
201193.0,17,2,180,1,90,0.0,90.0,90.0,1,90,0.0,90.0,90.0
12636.0,6,10,1065,5,534,2603.0,262.0,106.8,5,531,2942.75,259.0,106.2
53568.0,6,14,4740,7,653,8361.833333333334,249.0,93.28571428571428,7,4087,8531.666666666666,1514.0,583.8571428571429
2796806.0,6,2,132,1,66,0.0,66.0,66.0,1,66,0.0,66.0,66.0
27634.0,6,10,2032,5,524,6615.25,252.0,104.8,5,1508,6462.5,1236.0,301.6
40576.0,6,14,4740,7,653,5672.333333333333,249.0,93.28571428571428,7,4087,6279.833333333333,1514.0,583.8571428571429
49357.0,6,10,2032,5,524,11248.0,252.0,104.8,5,1508,11918.0,1236.0,301.6
74251.0,6,14,4740,7,653,11790.833333333334,249.0,93.28571428571428,7,4087,12143.166666666666,1514.0,583.8571428571429
294631.0,6,4,492,2,280,0.0,214.0,140.0,2,212,0.0,146.0,106.0
9527.0,17,2,582,1,83,0.0,83.0,83.0,1,499,0.0,499.0,499.0
167448.0,17,2,180,1,90,0.0,90.0,90.0,1,90,0.0,90.0,90.0
117503.0,6,14,4740,7,653,19410.5,249.0,93.28571428571428,7,4087,19404.166666666668,1514.0,583.8571428571429
153477.0,17,2,180,1,90,0.0,90.0,90.0,1,90,0.0,90.0,90.0
16679.0,6,11,2098,6,590,3043.2,252.0,98.33333333333331,5,1508,3831.0,1236.0,301.6
493064.0,6,5,336,2,134,0.0,68.0,67.0,3,202,195924.5,70.0,67.33333333333333
43865.0,6,14,4740,7,653,5312.5,249.0,93.28571428571428,7,4087,6770.166666666667,1514.0,583.8571428571429
2370.0,17,4,344,2,150,0.0,75.0,75.0,2,194,0.0,103.0,97.0
217707.0,17,4,6056,4,6056,72569.0,1514.0,1514.0,0,0,0.0,0.0,0.0
333131.0,6,6,412,4,272,111043.66666666669,74.0,68.0,2,140,0.0,74.0,70.0
108680384.0,6,32,2220,16,1149,7245358.933333334,123.0,71.8125,16,1071,7230949.4,123.0,66.9375
5621473.0,6,4,270,2,134,0.0,68.0,67.0,2,136,0.0,70.0,68.0
108108300.0,17,5,955,5,955,27027075.0,191.0,191.0,0,0,0.0,0.0,0.0
95943103.0,6,185,20842,93,6360,1042859.8152173914,140.0,68.38709677419355,92,14482,1042992.3846153846,284.0,157.41304347826087
34052385.0,6,27,8801,15,1827,2432313.214285714,408.0,121.8,12,6974,2725475.090909091,1514.0,581.1666666666666
330.0,17,2,166,1,75,0.0,75.0,75.0,1,91,0.0,91.0,91.0
216684.0,6,3,426,2,280,0.0,214.0,140.0,1,146,0.0,146.0,146.0
206228.0,6,3,426,2,280,0.0,214.0,140.0,1,146,0.0,146.0,146.0
137300.0,6,2,132,1,66,0.0,66.0,66.0,1,66,0.0,66.0,66.0
301.0,17,2,156,1,78,0.0,78.0,78.0,1,78,0.0,78.0,78.0
65200.99999999999,6,14,4740,7,653,10420.166666666666,249.0,93.28571428571428,7,4087,9425.0,1514.0,583.8571428571429
121409832.0,6,266,30578,133,9074,886982.3106060605,140.0,68.22556390977444,133,21504,913459.5,300.0,161.68421052631578
239762.0,6,3,337,2,214,0.0,160.0,107.0,1,123,0.0,123.0,123.0
2569493.0,6,3,204,2,136,0.0,70.0,68.0,1,68,0.0,68.0,68.0
67985.0,6,14,4740,7,653,7748.833333333333,249.0,93.28571428571428,7,4087,10362.666666666666,1514.0,583.8571428571429
120081360.0,17,28,13364,28,13364,4447457.777777778,501.0,477.2857142857143,0,0,0.0,0.0,0.0
108112568.0,17,5,1005,5,1005,27028142.0,201.0,201.0,0,0,0.0,0.0,0.0
92016308.0,6,38,2508,19,1254,5112002.166666667,66.0,66.0,19,1254,5112003.222222222,66.0,66.0
118768.0,17,2,286,2,286,0.0,143.0,143.0,0,0,0.0,0.0,0.0
146646.0,6,3,373,2,238,0.0,172.0,119.0,1,135,0.0,135.0,135.0
106315.0,17,2,700,2,700,0.0,350.0,350.0,0,0,0.0,0.0,0.0
32183788.0,6,9,754,5,482,8005972.0,210.0,96.4,4,272,10674592.333333334,74.0,68.0
99779.0,17,2,762,2,762,0.0,381.0,381.0,0,0,0.0,0.0,0.0
106038445.0,6,493,62358,247,16524,431050.5894308943,140.0,66.89878542510121,246,45834,428586.4285714286,464.0,186.3170731707317
108093627.0,17,5,955,5,955,27023406.75,191.0,191.0,0,0,0.0,0.0,0.0
2477365.0,6,3,1604,2,851,0.0,785.0,425.5,1,753,0.0,753.0,753.0
3660526.0,6,5,336,2,134,0.0,68.0,67.0,3,202,1425729.0,70.0,67.33333333333333
205738.0,17,2,762,2,762,0.0,381.0,381.0,0,0,0.0,0.0,0.0
520.0,17,2,508,2,508,0.0,257.0,254.0,0,0,0.0,0.0,0.0
121910.0,6,3,337,2,214,0.0,160.0,107.0,1,123,0.0,123.0,123.0
23059639.0,17,3,1034,2,684,0.0,342.0,342.0,1,350,0.0,350.0,350.0
44086.0,6,14,4740,7,653,7222.5,249.0,93.28571428571428,7,4087,6821.833333333333,1514.0,583.8571428571429
135133468.0,17,6,1206,6,1206,27026693.6,201.0,201.0,0,0,0.0,0.0,0.0
148037.0,17,2,180,1,90,0.0,90.0,90.0,1,90,0.0,90.0,90.0
12749.0,6,12,1393,6,796,2299.4,271.0,132.66666666666666,6,597,2376.6,259.0,99.5
205966.0,17,2,180,1,90,0.0,90.0,90.0,1,90,0.0,90.0,90.0
102001109.0,17,13,821,7,432,17000184.833333332,174.0,61.71428571428572,6,389,16400755.4,174.0,64.83333333333333
233472.0,6,3,373,2,238,0.0,172.0,119.0,1,135,0.0,135.0,135.0
135933.0,6,2,132,1,66,0.0,66.0,66.0,1,66,0.0,66.0,66.0
232871.0,6,3,337,2,214,0.0,160.0,107.0,1,123,0.0,123.0,123.0
306158.0,6,6,412,4,272,102052.66666666669,74.0,68.0,2,140,0.0,74.0,70.0
106114.0,17,2,762,2,762,0.0,381.0,381.0,0,0,0.0,0.0,0.0
402907.0,6,4,508,2,238,0.0,172.0,119.0,2,270,0.0,135.0,135.0
0.0,17,1,55,1,55,0.0,55.0,55.0,0,0,0.0,0.0,0.0
90768861.0,6,19,1436,10,745,10080702.0,95.0,74.5,9,691,11345568.75,95.0,76.77777777777777
300351.0,6,6,412,4,272,100117.0,74.0,68.0,2,140,0.0,74.0,70.0
23131885.0,17,3,1034,2,684,0.0,342.0,342.0,1,350,0.0,350.0,350.0
301996.0,6,6,412,4,272,100665.33333333331,74.0,68.0,2,140,0.0,74.0,70.0
303130.0,6,2,132,1,66,0.0,66.0,66.0,1,66,0.0,66.0,66.0
44616.0,6,14,4740,7,653,7261.333333333333,249.0,93.28571428571428,7,4087,7047.5,1514.0,583.8571428571429
205633.0,17,2,180,1,90,0.0,90.0,90.0,1,90,0.0,90.0,90.0
4601832.0,6,5,336,2,134,0.0,68.0,67.0,3,202,1422351.0,70.0,67.33333333333333
90047559.0,17,27,12943,27,12943,3463367.653846154,501.0,479.3703703703704,0,0,0.0,0.0,0.0
579113.0,6,4,508,2,238,0.0,172.0,119.0,2,270,0.0,135.0,135.0
90028378.0,17,28,13364,28,13364,3334384.3703703703,501.0,477.2857142857143,0,0,0.0,0.0,0.0
43105.0,6,14,4740,7,653,7037.666666666667,249.0,93.28571428571428,7,4087,5930.833333333333,1514.0,583.8571428571429
120174835.0,6,23,1775,10,745,10052777.444444444,95.0,74.5,13,1030,10000004.666666666,95.0,79.23076923076923
0.0,17,1,350,1,350,0.0,350.0,350.0,0,0,0.0,0.0,0.0
90093671.0,6,11,1766,7,950,15015611.833333334,188.0,135.71428571428572,4,816,20114151.0,204.0,204.0
930700.0,6,12,2710,7,743,155116.66666666666,339.0,106.14285714285714,5,1967,162861.75,1514.0,393.4
104995068.0,17,15,5130,15,5130,7499647.714285715,342.0,342.0,0,0,0.0,0.0,0.0
146471.0,6,3,337,2,214,0.0,160.0,107.0,1,123,0.0,123.0,123.0
128918.0,6,2,132,1,66,0.0,66.0,66.0,1,66,0.0,66.0,66.0
298311.0,6,6,412,4,272,99437.0,74.0,68.0,2,140,0.0,74.0,70.0
202354.0,6,10,1221,6,636,40470.8,298.0,106.0,4,585,66213.0,379.0,146.25
205957.0,17,2,180,1,90,0.0,90.0,90.0,1,90,0.0,90.0,90.0
103922.0,17,2,700,2,700,0.0,350.0,350.0,0,0,0.0,0.0,0.0
314117.0,17,4,1400,4,1400,104705.66666666669,350.0,350.0,0,0,0.0,0.0,0.0
209585.0,17,2,180,1,90,0.0,90.0,90.0,1,90,0.0,90.0,90.0
90293693.0,6,16,1192,8,596,12891721.57142857,95.0,74.5,8,596,12898335.714285716,95.0,74.5
2386.0,17,4,344,2,150,0.0,75.0,75.0,2,194,0.0,103.0,97.0
155154.0,6,3,337,2,214,0.0,160.0,107.0,1,123,0.0,123.0,123.0
778229.0,6,11,1131,6,600,153922.4,262.0,100.0,5,531,193593.25,259.0,106.2
113255268.0,6,46,3036,23,1518,5135443.318181818,66.0,66.0,23,1518,5135453.7727272725,66.0,66.0
107472.0,17,2,286,2,286,0.0,143.0,143.0,0,0,0.0,0.0,0.0
29549.0,6,10,2032,5,524,6243.75,252.0,104.8,5,1508,7139.25,1236.0,301.6
50045.0,6,14,4740,7,653,8215.333333333334,249.0,93.28571428571428,7,4087,7411.333333333333,1514.0,583.8571428571429
297.0,17,2,164,1,82,0.0,82.0,82.0,1,82,0.0,82.0,82.0
57037.0,6,14,4740,7,653,9293.166666666666,249.0,93.28571428571428,7,4087,8729.333333333334,1514.0,583.8571428571429
25038.0,6,14,4740,7,653,3581.333333333333,249.0,93.28571428571428,7,4087,3875.8333333333335,1514.0,583.8571428571429
153470.0,17,2,180,1,90,0.0,90.0,90.0,1,90,0.0,90.0,90.0
96193699.0,6,206,23472,103,16452,940861.7352941176,284.0,159.72815533980582,103,7020,940859.8039215688,140.0,68.15533980582525
219920.0,6,3,426,2,280,0.0,214.0,140.0,1,146,0.0,146.0,146.0
90257510.0,6,13,2036,8,1016,12893930.0,188.0,127.0,5,1020,22523079.5,204.0,204.0
91913923.0,17,12,778,6,389,18350999.2,174.0,64.83333333333333,6,389,18278251.2,174.0,64.83333333333333
20415.0,17,2,582,1,83,0.0,83.0,83.0,1,499,0.0,499.0,499.0
96733789.0,6,68,16203,35,6816,2845111.4411764704,1514.0,194.7428571428572,33,9387,3015009.9375,1514.0,284.45454545454544
338.0,17,2,267,1,83,0.0,83.0,83.0,1,184,0.0,184.0,184.0
377.0,17,2,166,1,75,0.0,75.0,75.0,1,91,0.0,91.0,91.0
8977.0,17,2,582,1,83,0.0,83.0,83.0,1,499,0.0,499.0,499.0
90216203.0,6,17,1287,8,596,12854067.857142856,95.0,74.5,9,691,11251307.25,95.0,76.77777777777777
121521.0,6,3,337,2,214,0.0,160.0,107.0,1,123,0.0,123.0,123.0
3331.0,17,2,414,1,88,0.0,88.0,88.0,1,326,0.0,326.0,326.0
90022619.0,17,28,13364,28,13364,3334171.074074074,501.0,477.2857142857143,0,0,0.0,0.0,0.0
96337641.0,17,12,778,6,389,19200171.2,174.0,64.83333333333333,6,389,19200914.4,174.0,64.83333333333333
19420.0,6,10,1067,5,536,4115.0,264.0,107.2,5,531,3682.0,259.0,106.2
1174516.0,6,13,3010,8,2382,167788.0,1514.0,297.75,5,628,224748.75,331.0,125.6
90030670.0,17,28,13364,28,13364,3334469.25925926,501.0,477.2857142857143,0,0,0.0,0.0,0.0
1627803.0,6,4,492,2,280,0.0,214.0,140.0,2,212,0.0,146.0,106.0
233989.0,6,3,337,2,214,0.0,160.0,107.0,1,123,0.0,123.0,123.0
50555.0,6,14,4740,7,653,7097.0,249.0,93.28571428571428,7,4087,5896.166666666667,1514.0,583.8571428571429
26755358.0,6,5,1736,2,819,0.0,753.0,409.5,3,917,13308172.0,785.0,305.6666666666667
119578152.0,6,20,1490,10,745,13286461.333333334,95.0,74.5,10,745,13258545.444444444,95.0,74.5
90264790.0,6,14,2114,9,1094,11283098.75,188.0,121.55555555555556,5,1020,22483497.25,204.0,204.0
4237.0,17,2,598,1,72,0.0,72.0,72.0,1,526,0.0,526.0,526.0
144877.0,17,4,1400,4,1400,48292.333333333336,350.0,350.0,0,0,0.0,0.0,0.0
42475.0,6,14,4740,7,653,6694.666666666667,249.0,93.28571428571428,7,4087,6539.666666666667,1514.0,583.8571428571429
309950.0,6,6,412,4,272,103316.66666666669,74.0,68.0,2,140,0.0,74.0,70.0
111116032.0,6,32,2236,16,1165,7407735.466666667,139.0,72.8125,16,1071,7393326.066666666,123.0,66.9375
90003357.0,17,28,13364,28,13364,3333457.6666666665,501.0,477.2857142857143,0,0,0.0,0.0,0.0
113720756.0,6,48,3168,24,1584,4944380.695652174,66.0,66.0,24,1584,4935650.739130435,66.0,66.0
63425.99999999999,17,4,571,2,148,0.0,74.0,74.0,2,423,0.0,280.0,211.5
109000913.0,17,13,821,7,432,18166818.83333333,174.0,61.71428571428572,6,389,17801140.8,174.0,64.83333333333333
34197.0,6,14,4740,7,653,5457.5,249.0,93.28571428571428,7,4087,5296.166666666667,1514.0,583.8571428571429
107837420.0,6,28,1860,14,966,8279437.769230769,123.0,69.0,14,894,8279455.230769231,123.0,63.85714285714285
103911035.0,6,28,1860,14,966,7976567.615384615,123.0,69.0,14,894,7976566.846153846,123.0,63.85714285714285
301583.0,6,2,1711,1,826,0.0,826.0,826.0,1,885,0.0,885.0,885.0
308387.0,6,6,412,4,272,102795.66666666669,74.0,68.0,2,140,0.0,74.0,70.0
228281.0,17,2,180,1,90,0.0,90.0,90.0,1,90,0.0,90.0,90.0
114481092.0,6,48,3168,24,1584,4977438.782608695,66.0,66.0,24,1584,4964019.869565218,66.0,66.0
30214.0,6,14,4740,7,653,4718.5,249.0,93.28571428571428,7,4087,4897.333333333333,1514.0,583.8571428571429
135165845.0,17,6,1146,6,1146,27033169.0,191.0,191.0,0,0,0.0,0.0,0.0
80944.0,6,10,2032,5,524,20024.75,252.0,104.8,5,1508,18577.5,1236.0,301.6
113619097.0,6,46,3036,23,1518,5150446.136363637,66.0,66.0,23,1518,5150447.318181818,66.0,66.0
300.0,17,2,174,1,79,0.0,79.0,79.0,1,95,0.0,95.0,95.0
11602.0,6,12,1393,6,796,2135.0,271.0,132.66666666666666,6,597,2169.0,259.0,99.5
90548556.0,6,14,2240,8,1016,12935508.0,188.0,127.0,6,1224,18076545.2,204.0,204.0
216700.0,6,4,492,2,280,0.0,214.0,140.0,2,212,0.0,146.0,106.0
806.0,17,4,438,2,148,0.0,74.0,74.0,2,290,0.0,147.0,145.0
15040.0,6,14,4740,7,653,2391.333333333333,249.0,93.28571428571428,7,4087,2371.5,1514.0,583.8571428571429
122687983.0,6,49,3234,25,1650,5111999.291666667,66.0,66.0,24,1584,5084672.695652174,66.0,66.0
118847632.0,6,38,2710,19,1408,6590660.666666667,139.0,74.10526315789474,19,1302,6590656.722222222,123.0,68.52631578947368
119487859.0,6,222,25090,111,17468,1084285.4272727272,284.0,157.36936936936937,111,7622,1084285.4090909092,140.0,68.66666666666667
96855964.0,6,177,19938,89,6096,1100635.9545454546,140.0,68.49438202247191,88,13842,1101386.3793103448,284.0,157.29545454545453
135135209.0,17,6,1206,6,1206,27027041.8,201.0,201.0,0,0,0.0,0.0,0.0
113626.0,6,11,1132,6,556,21557.0,218.0,92.66666666666669,5,576,25365.25,304.0,115.2
293310.0,17,2,180,1,90,0.0,90.0,90.0,1,90,0.0,90.0,90.0
246210.0,6,3,337,2,214,0.0,160.0,107.0,1,123,0.0,123.0,123.0
90052474.0,17,28,13364,28,13364,3335276.814814815,501.0,477.2857142857143,0,0,0.0,0.0,0.0
27863.0,6,10,2032,5,524,6423.5,252.0,104.8,5,1508,6696.75,1236.0,301.6
98348931.0,17,12,778,6,389,19600164.2,174.0,64.83333333333333,6,389,19600843.0,174.0,64.83333333333333
75362.0,6,14,4740,7,653,11577.166666666666,249.0,93.28571428571428,7,4087,12135.666666666666,1514.0,583.8571428571429
44491.0,6,14,4740,7,653,7304.0,249.0,93.28571428571428,7,4087,7004.333333333333,1514.0,583.8571428571429
220684.0,17,2,180,1,90,0.0,90.0,90.0,1,90,0.0,90.0,90.0
2848480.0,6,3,204,2,136,0.0,70.0,68.0,1,68,0.0,68.0,68.0
360.0,17,2,267,1,83,0.0,83.0,83.0,1,184,0.0,184.0,184.0
5629076.0,6,5,336,2,134,0.0,68.0,67.0,3,202,1527021.5,70.0,67.33333333333333
9645.0,17,2,582,1,83,0.0,83.0,83.0,1,499,0.0,499.0,499.0
307649.0,6,6,412,4,272,102549.66666666669,74.0,68.0,2,140,0.0,74.0,70.0
135129470.0,17,6,1146,6,1146,27025894.0,191.0,191.0,0,0,0.0,0.0,0.0
33445.0,6,14,4740,7,653,4981.5,249.0,93.28571428571428,7,4087,3605.0,1514.0,583.8571428571429
363424.0,6,11,1021,6,444,48885.2,162.0,74.0,5,577,61008.5,349.0,115.4
206267.0,6,3,426,2,280,0.0,214.0,140.0,1,146,0.0,146.0,146.0
1763367.0,6,4,276,2,128,0.0,74.0,64.0,2,148,0.0,74.0,74.0
105981.0,17,2,286,2,286,0.0,143.0,143.0,0,0,0.0,0.0,0.0
320581.0,17,4,1400,4,1400,106860.33333333331,350.0,350.0,0,0,0.0,0.0,0.0
211255.0,17,2,180,1,90,0.0,90.0,90.0,1,90,0.0,90.0,90.0
5831840.0,6,4,270,2,134,0.0,68.0,67.0,2,136,0.0,70.0,68.0
115129.0,17,2,286,2,286,0.0,143.0,143.0,0,0,0.0,0.0,0.0
354.0,17,2,267,1,83,0.0,83.0,83.0,1,184,0.0,184.0,184.0
210532.0,17,2,180,1,90,0.0,90.0,90.0,1,90,0.0,90.0,90.0
306964.0,6,6,412,4,272,102321.33333333331,74.0,68.0,2,140,0.0,74.0,70.0
143895.0,17,2,180,1,90,0.0,90.0,90.0,1,90,0.0,90.0,90.0
342234.0,6,6,412,4,272,114078.0,74.0,68.0,2,140,0.0,74.0,70.0
2304.0,17,4,344,2,150,0.0,75.0,75.0,2,194,0.0,103.0,97.0
119699011.0,6,226,25550,113,17796,1066819.1875,284.0,157.4867256637168,113,7754,1066818.5535714286,140.0,68.61946902654867
108721.0,17,2,286,2,286,0.0,143.0,143.0,0,0,0.0,0.0,0.0
287130.0,17,2,180,1,90,0.0,90.0,90.0,1,90,0.0,90.0,90.0
307266.0,6,6,412,4,272,102422.0,74.0,68.0,2,140,0.0,74.0,70.0
2084827.0,6,25,7610,13,2516,173735.58333333334,1034.0,193.53846153846155,12,5094,161731.81818181818,1510.0,424.5
108104182.0,17,5,1005,5,1005,27026045.5,201.0,201.0,0,0,0.0,0.0,0.0
232186.0,6,10,1221,6,636,46437.2,298.0,106.0,4,585,76523.66666666667,379.0,146.25
21143.0,6,10,2032,5,524,5041.5,252.0,104.8,5,1508,4715.75,1236.0,301.6
14631418.0,6,20,1607,10,975,1592798.2222222222,315.0,97.5,10,632,1592769.5555555555,78.0,63.2
135134989.0,17,6,1206,6,1206,27026997.8,201.0,201.0,0,0,0.0,0.0,0.0
144047.0,6,2,132,1,66,0.0,66.0,66.0,1,66,0.0,66.0,66.0
39141.0,6,10,2032,5,524,9497.5,252.0,104.8,5,1508,9530.75,1236.0,301.6
10520808.0,6,7,478,4,272,3461224.333333333,74.0,68.0,3,206,5171337.5,74.0,68.66666666666667
39163.0,6,10,1065,5,534,9138.75,262.0,106.8,5,531,8368.5,259.0,106.2
300533.0,6,6,412,4,272,100177.66666666669,74.0,68.0,2,140,0.0,74.0,70.0
216438.0,6,10,1221,6,636,43287.6,298.0,106.0,4,585,70927.0,379.0,146.25
2348.0,17,4,344,2,150,0.0,75.0,75.0,2,194,0.0,103.0,97.0
3037777.0,6,11,2106,6,598,607246.8,252.0,99.66666666666669,5,1508,7188.25,1236.0,301.6
116893356.0,6,48,3168,24,1584,5082319.826086956,66.0,66.0,24,1584,5069236.608695652,66.0,66.0
118542408.0,6,34,2334,17,1209,7396021.5,123.0,71.11764705882354,17,1125,7395855.75,123.0,66.17647058823529
46480.0,6,14,4740,7,653,6947.5,249.0,93.28571428571428,7,4087,6332.166666666667,1514.0,583.8571428571429
209128.0,6,3,426,2,280,0.0,214.0,140.0,1,146,0.0,146.0,146.0
304735.0,17,4,704,2,148,0.0,74.0,74.0,2,556,0.0,280.0,278.0
207632.0,6,3,426,2,280,0.0,214.0,140.0,1,146,0.0,146.0,146.0
2310.0,17,4,344,2,150,0.0,75.0,75.0,2,194,0.0,103.0,97.0
308948.0,6,6,412,4,272,102982.66666666669,74.0,68.0,2,140,0.0,74.0,70.0
358.0,17,2,188,1,86,0.0,86.0,86.0,1,102,0.0,102.0,102.0
11741.0,6,11,1132,6,556,2207.0,218.0,92.66666666666669,5,576,2561.5,304.0,115.2
38434.0,6,14,4740,7,653,6153.833333333333,249.0,93.28571428571428,7,4087,5269.333333333333,1514.0,583.8571428571429
3531.0,17,2,414,1,88,0.0,88.0,88.0,1,326,0.0,326.0,326.0
1026357.0,6,11,1134,6,558,205271.4,220.0,93.0,5,576,255406.25,304.0,115.2
846163.0,17,6,1230,3,234,422890.0,78.0,78.0,3,996,422878.0,332.0,332.0
299794.0,6,6,412,4,272,99931.33333333331,74.0,68.0,2,140,0.0,74.0,70.0
371.0,17,2,300,1,80,0.0,80.0,80.0,1,220,0.0,220.0,220.0
108099905.0,17,5,955,5,955,27024976.25,191.0,191.0,0,0,0.0,0.0,0.0
21188011.0,6,26,7627,14,3735,180439.6923076923,1514.0,266.7857142857143,12,3892,1907457.9090909087,1514.0,324.3333333333333
108098196.0,17,5,1005,5,1005,27024549.0,201.0,201.0,0,0,0.0,0.0,0.0
171651.0,17,2,180,1,90,0.0,90.0,90.0,1,90,0.0,90.0,90.0
309.0,17,2,168,1,76,0.0,76.0,76.0,1,92,0.0,92.0,92.0
148380.0,17,2,414,1,88,0.0,88.0,88.0,1,326,0.0,326.0,326.0
0.0,17,1,44,1,44,0.0,44.0,44.0,0,0,0.0,0.0,0.0
144005.0,17,2,180,1,90,0.0,90.0,90.0,1,90,0.0,90.0,90.0
34148.0,6,14,4740,7,653,5101.5,249.0,93.28571428571428,7,4087,5394.5,1514.0,583.8571428571429
123239207.0,17,14,1257,8,737,17605601.0,174.0,92.125,6,520,16514477.6,174.0,86.66666666666667
100764583.0,6,29,2068,15,1105,7181973.857142857,139.0,73.66666666666667,14,963,7734518.0,123.0,68.78571428571429
328.0,17,2,166,1,75,0.0,75.0,75.0,1,91,0.0,91.0,91.0
104684841.0,17,15,5130,15,5130,7477488.642857143,342.0,342.0,0,0,0.0,0.0,0.0
33839.0,6,14,4740,7,653,4904.166666666667,249.0,93.28571428571428,7,4087,5504.833333333333,1514.0,583.8571428571429
14431828.0,17,6,2052,6,2052,2886365.6,342.0,342.0,0,0,0.0,0.0,0.0
121184755.0,17,15,907,7,432,17000163.666666668,174.0,61.71428571428572,8,475,17286126.85714286,174.0,59.375
309527.0,17,4,704,2,148,0.0,74.0,74.0,2,556,0.0,280.0,278.0
232701.0,6,3,337,2,214,0.0,160.0,107.0,1,123,0.0,123.0,123.0
120190451.0,6,33,2290,17,1125,7511903.1875,123.0,66.17647058823529,16,1165,7332598.133333334,139.0,72.8125
303084.0,6,6,412,4,272,101028.0,74.0,68.0,2,140,0.0,74.0,70.0
9183.0,17,2,614,1,72,0.0,72.0,72.0,1,542,0.0,542.0,542.0
108108931.0,17,5,1005,5,1005,27027232.75,201.0,201.0,0,0,0.0,0.0,0.0
258264.0,6,3,337,2,214,0.0,160.0,107.0,1,123,0.0,123.0,123.0
644427.0,6,4,508,2,238,0.0,172.0,119.0,2,270,0.0,135.0,135.0
111816.0,17,2,286,2,286,0.0,143.0,143.0,0,0,0.0,0.0,0.0
231724.0,6,3,337,2,214,0.0,160.0,107.0,1,123,0.0,123.0,123.0
201725.0,17,2,180,1,90,0.0,90.0,90.0,1,90,0.0,90.0,90.0
108109870.0,17,5,1005,5,1005,27027467.5,201.0,201.0,0,0,0.0,0.0,0.0
11171651.0,17,4,1368,4,1368,3723883.6666666665,342.0,342.0,0,0,0.0,0.0,0.0
2421.0,17,4,344,2,150,0.0,75.0,75.0,2,194,0.0,103.0,97.0
10522482.0,6,7,478,4,272,3461937.6666666665,74.0,68.0,3,206,5192827.0,74.0,68.66666666666667
143891.0,17,2,180,1,90,0.0,90.0,90.0,1,90,0.0,90.0,90.0
5620851.0,6,4,270,2,134,0.0,68.0,67.0,2,136,0.0,70.0,68.0
297309.0,17,2,180,1,90,0.0,90.0,90.0,1,90,0.0,90.0,90.0
0.0,6,1,54,0,0,0.0,0.0,0.0,1,54,0.0,54.0,54.0
48554702.0,6,13,2473,6,1172,9710657.2,826.0,195.3333333333333,7,1301,7628352.5,885.0,185.8571428571429
90259783.0,6,12,1832,8,1016,12894254.714285716,188.0,127.0,4,816,30032049.666666668,204.0,204.0
21983.0,17,2,180,1,90,0.0,90.0,90.0,1,90,0.0,90.0,90.0
120048084.0,17,28,13364,28,13364,4446225.333333333,501.0,477.2857142857143,0,0,0.0,0.0,0.0
502.0,17,2,508,2,508,0.0,257.0,254.0,0,0,0.0,0.0,0.0
127862.0,6,12,1320,7,789,21310.33333333333,253.0,112.71428571428572,5,531,26782.25,259.0,106.2
90015710.0,6,20,1490,11,840,9001571.0,95.0,76.36363636363636,9,650,11213489.0,95.0,72.22222222222223
121256886.0,6,30,2037,15,948,8417697.5,123.0,63.2,15,1089,7947833.0,123.0,72.6
46051.0,6,14,4740,7,653,7557.5,249.0,93.28571428571428,7,4087,7034.666666666667,1514.0,583.8571428571429
273007.0,6,3,337,2,214,0.0,160.0,107.0,1,123,0.0,123.0,123.0
748.0,17,2,762,2,762,0.0,381.0,381.0,0,0,0.0,0.0,0.0
281112.0,17,2,363,1,79,0.0,79.0,79.0,1,284,0.0,284.0,284.0
217115.0,6,3,426,2,280,0.0,214.0,140.0,1,146,0.0,146.0,146.0
3342.0,17,2,414,1,88,0.0,88.0,88.0,1,326,0.0,326.0,326.0
90020721.0,17,28,13364,28,13364,3334100.777777778,501.0,477.2857142857143,0,0,0.0,0.0,0.0
2385.0,17,4,344,2,150,0.0,75.0,75.0,2,194,0.0,103.0,97.0
162500.0,17,2,180,1,90,0.0,90.0,90.0,1,90,0.0,90.0,90.0
303708.0,6,2,132,1,66,0.0,66.0,66.0,1,66,0.0,66.0,66.0
216805.0,6,3,426,2,280,0.0,214.0,140.0,1,146,0.0,146.0,146.0
29992.0,6,14,4740,7,653,3706.5,249.0,93.28571428571428,7,4087,4832.166666666667,1514.0,583.8571428571429
114958112.0,6,48,3168,24,1584,4998178.782608695,66.0,66.0,24,1584,4984965.608695652,66.0,66.0
90134320.0,6,12,1710,5,882,22533154.25,204.0,176.4,7,828,15021987.166666666,188.0,118.28571428571428
135136877.0,17,6,1206,6,1206,27027375.4,201.0,201.0,0,0,0.0,0.0,0.0
42860.0,6,14,4740,7,653,6820.0,249.0,93.28571428571428,7,4087,6960.0,1514.0,583.8571428571429
6669.0,17,4,823,2,163,0.0,89.0,81.5,2,660,0.0,443.0,330.0
159961.0,6,2,128,1,74,0.0,74.0,74.0,1,54,0.0,54.0,54.0
35741.0,6,14,4740,7,653,5591.666666666667,249.0,93.28571428571428,7,4087,5245.0,1514.0,583.8571428571429
126013834.0,17,14,864,8,475,18001976.285714287,174.0,59.375,6,389,17400148.4,174.0,64.83333333333333
155987.0,17,2,180,1,90,0.0,90.0,90.0,1,90,0.0,90.0,90.0
303134.0,6,2,132,1,66,0.0,66.0,66.0,1,66,0.0,66.0,66.0
3314777.0,6,7,923,4,753,1036388.0,571.0,188.25,3,170,1555038.5,62.0,56.66666666666666
104800861.0,6,44,2904,22,1452,4990517.19047619,66.0,66.0,22,1452,4977392.476190476,66.0,66.0
100252723.0,17,12,778,6,389,20000954.0,174.0,64.83333333333333,6,389,20018761.6,174.0,64.83333333333333
317741.0,17,4,1400,4,1400,105913.66666666669,350.0,350.0,0,0,0.0,0.0,0.0
96132937.0,6,58,12226,29,6431,3433319.1785714286,1514.0,221.7586206896552,29,5795,3423989.1785714286,1514.0,199.8275862068965
2799994.0,6,2,132,1,66,0.0,66.0,66.0,1,66,0.0,66.0,66.0
1678437.0,6,23,6509,12,1529,152585.18181818182,357.0,127.41666666666669,11,4980,136797.5,1510.0,452.7272727272728
147977.0,17,2,180,1,90,0.0,90.0,90.0,1,90,0.0,90.0,90.0
119863993.0,6,14,2102,5,1020,29962044.25,204.0,204.0,9,1082,14982852.375,188.0,120.22222222222224
3278543.0,6,3,1604,2,851,0.0,785.0,425.5,1,753,0.0,753.0,753.0
0.0,6,1,66,1,66,0.0,66.0,66.0,0,0,0.0,0.0,0.0
362317.0,6,11,1021,6,444,48625.4,162.0,74.0,5,577,60698.5,349.0,115.4
120022638.0,17,28,13364,28,13364,4445282.888888889,501.0,477.2857142857143,0,0,0.0,0.0,0.0
122224117.0,6,31,2034,16,1086,8148274.466666667,123.0,67.875,15,948,8001573.928571428,123.0,63.2
92592142.0,6,38,2508,19,1254,5143993.833333333,66.0,66.0,19,1254,5143993.111111111,66.0,66.0
2405.0,17,4,344,2,150,0.0,75.0,75.0,2,194,0.0,103.0,97.0
5004945.0,17,4,849,2,166,0.0,83.0,83.0,2,683,0.0,499.0,341.5
105487.0,17,2,286,2,286,0.0,143.0,143.0,0,0,0.0,0.0,0.0
307836.0,6,6,412,4,272,102612.0,74.0,68.0,2,140,0.0,74.0,70.0
24891.0,6,10,2032,5,524,3949.0,252.0,104.8,5,1508,5763.5,1236.0,301.6
108105729.0,17,5,1005,5,1005,27026432.25,201.0,201.0,0,0,0.0,0.0,0.0
67044.0,6,14,4740,7,653,9494.0,249.0,93.28571428571428,7,4087,11031.333333333334,1514.0,583.8571428571429
801.0,17,4,438,2,148,0.0,74.0,74.0,2,290,0.0,147.0,145.0
314658.0,6,3,202,2,128,0.0,74.0,64.0,1,74,0.0,74.0,74.0
74470.0,6,10,2032,5,524,16584.0,252.0,104.8,5,1508,17334.75,1236.0,301.6
277193.0,17,2,346,1,78,0.0,78.0,78.0,1,268,0.0,268.0,268.0
149020.0,6,3,373,2,238,0.0,172.0,119.0,1,135,0.0,135.0,135.0
2036.0,17,4,344,2,150,0.0,75.0,75.0,2,194,0.0,103.0,97.0
233693.0,6,3,373,2,238,0.0,172.0,119.0,1,135,0.0,135.0,135.0
311589.0,17,4,1400,4,1400,103863.0,350.0,350.0,0,0,0.0,0.0,0.0
115925319.0,6,36,2856,20,1578,6101332.578947368,123.0,78.9,16,1278,7713945.866666666,123.0,79.875
2258628.0,6,3,1604,1,753,0.0,753.0,753.0,2,851,0.0,785.0,425.5
144860.0,17,2,180,1,70,0.0,70.0,70.0,1,110,0.0,110.0,110.0
105097.0,17,2,700,2,700,0.0,350.0,350.0,0,0,0.0,0.0,0.0
123840023.0,6,49,3234,25,1650,5160000.958333333,66.0,66.0,24,1584,5079314.434782608,66.0,66.0
2018.0,17,4,344,2,150,0.0,75.0,75.0,2,194,0.0,103.0,97.0
24516.0,6,14,4740,7,653,3288.333333333333,249.0,93.28571428571428,7,4087,3915.0,1514.0,583.8571428571429
147913.0,17,2,180,1,90,0.0,90.0,90.0,1,90,0.0,90.0,90.0
12034845.0,17,5,2265,5,2265,3008711.25,453.0,453.0,0,0,0.0,0.0,0.0
144006.0,17,2,180,1,90,0.0,90.0,90.0,1,90,0.0,90.0,90.0
120005597.0,6,17,1287,9,691,15000699.625,95.0,76.77777777777777,8,596,12859366.285714284,95.0,74.5
97022324.0,6,185,21124,93,14818,1054590.4782608696,374.0,159.33333333333334,92,6306,1044619.2747252748,140.0,68.54347826086956
146199.0,6,3,337,2,214,0.0,160.0,107.0,1,123,0.0,123.0,123.0
12291.0,6,12,1393,6,796,2319.4,271.0,132.66666666666666,6,597,2241.6,259.0,99.5
120001411.0,6,16,1192,8,596,17143058.714285713,95.0,74.5,8,596,17104996.85714286,95.0,74.5
181473.0,17,4,1524,4,1524,60491.0,381.0,381.0,0,0,0.0,0.0,0.0
105215649.0,6,43,2838,22,1452,4995306.761904762,66.0,66.0,21,1386,5155448.3,66.0,66.0
107993762.0,6,32,2374,17,1288,6736126.5,139.0,75.76470588235294,15,1086,7697745.357142857,123.0,72.4
895.0,17,4,438,2,148,0.0,74.0,74.0,2,290,0.0,147.0,145.0
98473446.0,6,31,2314,16,1228,6564896.4,139.0,76.75,15,1086,7018353.142857143,123.0,72.4
57030.0,6,14,4740,7,653,9078.666666666666,249.0,93.28571428571428,7,4087,8914.833333333334,1514.0,583.8571428571429
4156.0,17,2,614,1,72,0.0,72.0,72.0,1,542,0.0,542.0,542.0
6702.0,17,2,582,1,83,0.0,83.0,83.0,1,499,0.0,499.0,499.0
2337.0,17,4,344,2,150,0.0,75.0,75.0,2,194,0.0,103.0,97.0
1476380.0,17,16,1120,16,1120,98425.33333333331,70.0,70.0,0,0,0.0,0.0,0.0
33123301.0,6,7,1874,3,887,16491527.5,753.0,295.6666666666667,4,987,10998322.333333334,785.0,246.75
22407.0,6,10,2032,5,524,5427.75,252.0,104.8,5,1508,4967.0,1236.0,301.6
316.0,17,2,174,1,79,0.0,79.0,79.0,1,95,0.0,95.0,95.0
4201.0,17,2,610,1,72,0.0,72.0,72.0,1,538,0.0,538.0,538.0
237634.0,17,2,180,1,90,0.0,90.0,90.0,1,90,0.0,90.0,90.0
90212974.0,6,21,1585,10,745,9997306.555555556,95.0,74.5,11,840,9000762.7,95.0,76.36363636363636
1302093.0,6,4,264,2,132,0.0,66.0,66.0,2,132,0.0,66.0,66.0
3581369.0,6,23,6506,12,1529,325579.0,357.0,127.41666666666669,11,4977,322241.3,1510.0,452.45454545454544
46554.0,6,10,2032,5,524,10852.75,252.0,104.8,5,1508,11173.0,1236.0,301.6
5002947.0,17,4,849,2,166,0.0,83.0,83.0,2,683,0.0,499.0,341.5
90017027.0,17,28,13364,28,13364,3333963.962962963,501.0,477.2857142857143,0,0,0.0,0.0,0.0
13748447.0,17,6,2052,6,2052,2749689.4,342.0,342.0,0,0,0.0,0.0,0.0
887810.0,6,12,2711,7,743,147968.33333333334,339.0,106.14285714285714,5,1968,153085.25,1514.0,393.6
215500.0,17,2,180,1,90,0.0,90.0,90.0,1,90,0.0,90.0,90.0
61160.0,6,11,2098,6,590,11965.4,252.0,98.33333333333331,5,1508,14830.75,1236.0,301.6
2104.0,17,4,344,2,150,0.0,75.0,75.0,2,194,0.0,103.0,97.0
122688030.0,6,49,3234,25,1650,5112001.25,66.0,66.0,24,1584,4900591.608695652,66.0,66.0
40970.0,6,14,4740,7,653,6707.666666666667,249.0,93.28571428571428,7,4087,6013.333333333333,1514.0,583.8571428571429
508660.0,6,5,336,2,134,0.0,68.0,67.0,3,202,197502.0,70.0,67.33333333333333
90455.0,17,2,762,2,762,0.0,381.0,381.0,0,0,0.0,0.0,0.0
8486.0,6,11,2098,6,590,1619.6,252.0,98.33333333333331,5,1508,1786.5,1236.0,301.6
115603809.0,6,48,3168,24,1584,5026252.565217392,66.0,66.0,24,1584,5012672.782608695,66.0,66.0
108093524.0,17,5,1005,5,1005,27023381.0,201.0,201.0,0,0,0.0,0.0,0.0
5389.0,17,2,762,2,762,0.0,381.0,381.0,0,0,0.0,0.0,0.0
196931.0,17,2,180,1,90,0.0,90.0,90.0,1,90,0.0,90.0,90.0
21021376.0,17,3,1034,2,684,0.0,342.0,342.0,1,350,0.0,350.0,350.0
120433467.0,6,233,26372,117,18420,1038219.5431034482,284.0,157.43589743589743,116,7952,1038173.2608695652,140.0,68.55172413793103
120020247.0,17,28,13364,28,13364,4445194.333333333,501.0,477.2857142857143,0,0,0.0,0.0,0.0
90042893.0,17,27,12943,27,12943,3463188.1923076925,501.0,479.3703703703704,0,0,0.0,0.0,0.0
56525.0,6,10,2032,5,524,13914.0,252.0,104.8,5,1508,12181.25,1236.0,301.6
2801160.0,6,2,132,1,66,0.0,66.0,66.0,1,66,0.0,66.0,66.0
330923.0,6,6,412,4,272,110307.66666666669,74.0,68.0,2,140,0.0,74.0,70.0
25715.0,6,14,4740,7,653,3980.1666666666665,249.0,93.28571428571428,7,4087,4154.5,1514.0,583.8571428571429
90055609.0,17,28,13364,28,13364,3335392.925925926,501.0,477.2857142857143,0,0,0.0,0.0,0.0
304530.0,6,2,1538,1,753,0.0,753.0,753.0,1,785,0.0,785.0,785.0
432.0,17,2,410,1,78,0.0,78.0,78.0,1,332,0.0,332.0,332.0
6629.0,17,4,823,2,163,0.0,89.0,81.5,2,660,0.0,443.0,330.0
73167.0,6,14,4740,7,653,10532.5,249.0,93.28571428571428,7,4087,12026.0,1514.0,583.8571428571429
2345.0,17,4,344,2,150,0.0,75.0,75.0,2,194,0.0,103.0,97.0
108105404.0,17,5,1005,5,1005,27026351.0,201.0,201.0,0,0,0.0,0.0,0.0
121283048.0,17,14,1126,7,563,17166822.166666668,174.0,80.42857142857143,7,563,17372521.166666668,174.0,80.42857142857143
120124039.0,6,15,2152,9,1204,15015504.875,188.0,133.77777777777777,6,948,18018608.2,204.0,158.0
32217.000000000004,6,10,2032,5,524,7830.0,252.0,104.8,5,1508,7483.0,1236.0,301.6
17583.0,6,14,4740,7,653,2176.5,249.0,93.28571428571428,7,4087,2788.333333333333,1514.0,583.8571428571429
228205.0,17,2,180,1,90,0.0,90.0,90.0,1,90,0.0,90.0,90.0
169186.0,17,2,414,1,88,0.0,88.0,88.0,1,326,0.0,326.0,326.0
90255661.0,6,12,1832,8,1016,12893665.857142856,188.0,127.0,4,816,30030417.0,204.0,204.0
206544.0,17,2,180,1,90,0.0,90.0,90.0,1,90,0.0,90.0,90.0
508592.00000000006,6,5,336,2,134,0.0,68.0,67.0,3,202,194623.0,70.0,67.33333333333333
122975134.0,6,48,3168,24,1584,5122124.173913044,66.0,66.0,24,1584,5144965.608695652,66.0,66.0
32596.0,6,14,4740,7,653,3167.5,249.0,93.28571428571428,7,4087,4995.166666666667,1514.0,583.8571428571429
316664.0,17,4,1400,4,1400,105554.66666666669,350.0,350.0,0,0,0.0,0.0,0.0
107828134.0,6,28,1860,14,966,8294471.846153846,123.0,69.0,14,894,8277846.230769231,123.0,63.85714285714285
16362.999999999998,6,14,4740,7,653,2491.0,249.0,93.28571428571428,7,4087,2590.833333333333,1514.0,583.8571428571429
294525.0,17,2,180,1,90,0.0,90.0,90.0,1,90,0.0,90.0,90.0
2337.0,17,4,344,2,150,0.0,75.0,75.0,2,194,0.0,103.0,97.0
61118.0,6,14,4740,7,653,6857.666666666667,249.0,93.28571428571428,7,4087,9641.833333333334,1514.0,583.8571428571429
104430322.0,6,27,1800,14,894,8033101.692307692,123.0,63.85714285714285,13,906,8309442.083333333,123.0,69.6923076923077
217252.0,6,3,426,2,280,0.0,214.0,140.0,1,146,0.0,146.0,146.0
5624152.0,6,5,336,2,134,0.0,68.0,67.0,3,202,1419941.5,70.0,67.33333333333333
33764.0,6,14,4740,7,653,5396.166666666667,249.0,93.28571428571428,7,4087,4925.333333333333,1514.0,583.8571428571429
41127.0,6,14,4740,7,653,6547.166666666667,249.0,93.28571428571428,7,4087,6722.833333333333,1514.0,583.8571428571429
121502.0,6,3,337,2,214,0.0,160.0,107.0,1,123,0.0,123.0,123.0
218211.0,6,3,426,2,280,0.0,214.0,140.0,1,146,0.0,146.0,146.0
891614.0,6,10,1334,6,797,178322.8,459.0,132.83333333333334,4,537,205184.0,331.0,134.25
144163.0,17,2,180,1,90,0.0,90.0,90.0,1,90,0.0,90.0,90.0
9003891.0,17,4,300,4,300,3001297.0,75.0,75.0,0,0,0.0,0.0,0.0
109001030.0,17,13,821,7,432,18166838.33333333,174.0,61.71428571428572,6,389,19911388.4,174.0,64.83333333333333
20102.0,6,2,145,2,145,0.0,91.0,72.5,0,0,0.0,0.0,0.0
307058.0,6,6,412,4,272,102352.66666666669,74.0,68.0,2,140,0.0,74.0,70.0
31827.0,6,10,2032,5,524,6613.0,252.0,104.8,5,1508,5889.25,1236.0,301.6
116336173.0,6,48,3168,24,1584,5058094.478260869,66.0,66.0,24,1584,5044636.869565218,66.0,66.0
107540573.0,6,30,2106,15,1089,7666049.071428572,123.0,72.6,15,1017,7666054.285714285,123.0,67.8
16096.0,6,10,2032,5,524,3803.75,252.0,104.8,5,1508,3805.75,1236.0,301.6
15029.0,17,2,180,1,90,0.0,90.0,90.0,1,90,0.0,90.0,90.0
14742529.0,6,19,1553,9,921,1804379.0,315.0,102.33333333333331,10,632,1603863.0,78.0,63.2
114114105.0,6,36,2649,18,1317,6712567.0,123.0,73.16666666666667,18,1332,6712518.588235294,123.0,74.0
116125201.0,6,32,2220,16,1149,7741680.066666666,123.0,71.8125,16,1071,7727257.0,123.0,66.9375
90201802.0,6,16,1192,8,596,12849140.0,95.0,74.5,8,596,12853561.0,95.0,74.5
103320.0,17,2,286,2,286,0.0,143.0,143.0,0,0,0.0,0.0,0.0
5763947.0,17,6,989,3,238,2881825.0,89.0,79.33333333333333,3,751,2878475.5,443.0,250.3333333333333
308999.0,6,6,412,4,272,102999.66666666669,74.0,68.0,2,140,0.0,74.0,70.0
2590893.0,6,2,132,1,66,0.0,66.0,66.0,1,66,0.0,66.0,66.0
316282.0,17,4,1400,4,1400,105427.33333333331,350.0,350.0,0,0,0.0,0.0,0.0
14328181.0,6,20,1648,10,1016,1558989.5555555555,315.0,101.6,10,632,1558963.7777777778,78.0,63.2
400917.0,6,3,204,2,136,0.0,70.0,68.0,1,68,0.0,68.0,68.0
241410.0,6,3,337,2,214,0.0,160.0,107.0,1,123,0.0,123.0,123.0
103773431.0,6,190,21426,95,6492,1095238.9787234042,140.0,68.33684210526316,95,14934,1095088.4042553192,284.0,157.2
29935.0,17,2,762,2,762,0.0,381.0,381.0,0,0,0.0,0.0,0.0
56160.0,6,14,4740,7,653,9197.166666666666,249.0,93.28571428571428,7,4087,8643.833333333334,1514.0,583.8571428571429
2436.0,17,4,344,2,150,0.0,75.0,75.0,2,194,0.0,103.0,97.0
93100667.0,6,26,2019,15,1179,6647070.785714285,95.0,78.6,11,840,9233331.5,95.0,76.36363636363636
5623039.0,6,5,336,2,134,0.0,68.0,67.0,3,202,1420384.5,70.0,67.33333333333333
135131404.0,17,6,1206,6,1206,27026280.8,201.0,201.0,0,0,0.0,0.0,0.0
48092.0,6,14,4740,7,653,7590.333333333333,249.0,93.28571428571428,7,4087,6962.833333333333,1514.0,583.8571428571429
33425.0,6,10,2032,5,524,8033.75,252.0,104.8,5,1508,7166.0,1236.0,301.6
2135.0,17,4,344,2,150,0.0,75.0,75.0,2,194,0.0,103.0,97.0
299550.0,6,6,412,4,272,99850.0,74.0,68.0,2,140,0.0,74.0,70.0
836.0,17,4,438,2,148,0.0,74.0,74.0,2,290,0.0,147.0,145.0
9226.0,17,2,539,1,86,0.0,86.0,86.0,1,453,0.0,453.0,453.0
54873.0,6,13,1386,7,789,9118.0,253.0,112.71428571428572,6,597,10283.2,259.0,99.5
116662304.0,6,34,2334,17,1209,7277914.125,123.0,71.11764705882354,17,1125,7277915.125,123.0,66.17647058823529
121248.0,6,3,337,2,214,0.0,160.0,107.0,1,123,0.0,123.0,123.0
44367.0,6,14,4740,7,653,7266.5,249.0,93.28571428571428,7,4087,6764.5,1514.0,583.8571428571429
90091777.0,6,10,1440,7,828,15015296.166666666,188.0,118.28571428571428,3,612,30030570.5,204.0,204.0
3573969.0,6,5,336,2,134,0.0,68.0,67.0,3,202,1524654.5,70.0,67.33333333333333
2290.0,17,4,344,2,150,0.0,75.0,75.0,2,194,0.0,103.0,97.0
3037871.0,6,3,1604,2,851,0.0,785.0,425.5,1,753,0.0,753.0,753.0
102728.0,17,2,286,2,286,0.0,143.0,143.0,0,0,0.0,0.0,0.0
108101308.0,17,5,955,5,955,27025327.0,191.0,191.0,0,0,0.0,0.0,0.0
120078393.0,17,28,13364,28,13364,4447347.888888889,501.0,477.2857142857143,0,0,0.0,0.0,0.0
98671.0,17,2,762,2,762,0.0,381.0,381.0,0,0,0.0,0.0,0.0
2344.0,17,4,344,2,150,0.0,75.0,75.0,2,194,0.0,103.0,97.0
234051.0,6,3,337,2,214,0.0,160.0,107.0,1,123,0.0,123.0,123.0
135137263.0,17,6,1146,6,1146,27027452.6,191.0,191.0,0,0,0.0,0.0,0.0
216356.0,17,2,180,1,90,0.0,90.0,90.0,1,90,0.0,90.0,90.0
107201.0,17,2,286,2,286,0.0,143.0,143.0,0,0,0.0,0.0,0.0
28040.0,6,14,4740,7,653,4553.333333333333,249.0,93.28571428571428,7,4087,4532.833333333333,1514.0,583.8571428571429
23976.0,6,14,4740,7,653,3832.3333333333335,249.0,93.28571428571428,7,4087,3581.0,1514.0,583.8571428571429
23665.0,6,10,2032,5,524,5565.75,252.0,104.8,5,1508,5467.5,1236.0,301.6
41842.0,6,12,1328,7,797,6973.666666666667,253.0,113.85714285714286,5,531,9227.25,259.0,106.2
135150544.0,17,6,1206,6,1206,27030108.8,201.0,201.0,0,0,0.0,0.0,0.0
45496.0,6,14,4740,7,653,7315.5,249.0,93.28571428571428,7,4087,6461.333333333333,1514.0,583.8571428571429
147937.0,17,2,180,1,90,0.0,90.0,90.0,1,90,0.0,90.0,90.0
44618.0,6,14,4740,7,653,4300.333333333333,249.0,93.28571428571428,7,4087,7247.166666666667,1514.0,583.8571428571429
3365341.0,6,7,923,4,753,1049209.6666666667,571.0,188.25,3,170,1574434.0,62.0,56.66666666666666
324145.0,6,6,412,4,272,108048.33333333331,74.0,68.0,2,140,0.0,74.0,70.0
1796306.0,6,20,7599,11,1469,179630.6,583.0,133.54545454545453,9,6130,192282.75,1484.0,681.1111111111111
2340.0,17,4,344,2,150,0.0,75.0,75.0,2,194,0.0,103.0,97.0
307081.0,6,6,412,4,272,102360.33333333331,74.0,68.0,2,140,0.0,74.0,70.0
844.0,17,5,550,5,550,211.0,110.0,110.0,0,0,0.0,0.0,0.0
1165310.0,6,13,3000,8,2372,166472.85714285713,1514.0,296.5,5,628,222413.5,331.0,125.6
1774933.0,6,2,132,1,66,0.0,66.0,66.0,1,66,0.0,66.0,66.0
143858.0,17,2,180,1,90,0.0,90.0,90.0,1,90,0.0,90.0,90.0
10424334.0,6,7,478,4,272,3429336.333333333,74.0,68.0,3,206,5143897.0,74.0,68.66666666666667
207644.0,6,3,426,2,280,0.0,214.0,140.0,1,146,0.0,146.0,146.0
207184.0,6,3,426,2,280,0.0,214.0,140.0,1,146,0.0,146.0,146.0
40702.0,6,10,2032,5,524,8937.25,252.0,104.8,5,1508,9824.25,1236.0,301.6
90028999.0,17,28,13364,28,13364,3334407.3703703703,501.0,477.2857142857143,0,0,0.0,0.0,0.0
121831.0,6,3,337,2,214,0.0,160.0,107.0,1,123,0.0,123.0,123.0
178704.0,17,2,180,1,90,0.0,90.0,90.0,1,90,0.0,90.0,90.0
27232.0,6,10,2032,5,524,5679.25,252.0,104.8,5,1508,6492.5,1236.0,301.6
15033444.0,17,6,2718,6,2718,3006688.8,453.0,453.0,0,0,0.0,0.0,0.0
103230.0,17,2,286,2,286,0.0,143.0,143.0,0,0,0.0,0.0,0.0
306886.0,6,6,412,4,272,102295.33333333331,74.0,68.0,2,140,0.0,74.0,70.0
154287.0,6,10,1066,5,490,37756.5,218.0,98.0,5,576,38363.5,304.0,115.2
116274934.0,6,32,2220,16,1149,7737247.8,123.0,71.8125,16,1071,7737276.4,123.0,66.9375
125326219.0,17,15,1169,7,563,17567883.166666668,174.0,80.42857142857143,8,606,17880871.42857143,174.0,75.75
229834.0,6,12,1373,7,714,38305.66666666666,298.0,102.0,5,659,56608.75,379.0,131.8
94652311.0,6,40,2640,20,1320,4981700.578947368,66.0,66.0,20,1320,4965636.736842105,66.0,66.0
510309.0,6,2,145,2,145,0.0,91.0,72.5,0,0,0.0,0.0,0.0
2576838.0,6,2,132,1,66,0.0,66.0,66.0,1,66,0.0,66.0,66.0
108102294.0,17,5,1005,5,1005,27025573.5,201.0,201.0,0,0,0.0,0.0,0.0
36590.0,6,14,4740,7,653,5673.333333333333,249.0,93.28571428571428,7,4087,5773.666666666667,1514.0,583.8571428571429
107446.0,17,2,286,2,286,0.0,143.0,143.0,0,0,0.0,0.0,0.0
99189.0,17,2,762,2,762,0.0,381.0,381.0,0,0,0.0,0.0,0.0
108107376.0,17,5,955,5,955,27026844.0,191.0,191.0,0,0,0.0,0.0,0.0
217736.0,6,3,426,2,280,0.0,214.0,140.0,1,146,0.0,146.0,146.0
10521535.0,6,7,478,4,272,3461563.0,74.0,68.0,3,206,5192246.5,74.0,68.66666666666667
2136839.0,6,37,15535,19,10912,118713.27777777778,1514.0,574.3157894736842,18,4623,112004.9411764706,1514.0,256.8333333333333
165052.0,17,2,414,1,88,0.0,88.0,88.0,1,326,0.0,326.0,326.0
109669712.0,6,31,2182,16,1165,7296919.066666666,139.0,72.8125,15,1017,7818135.214285715,123.0,67.8
245705.0,6,3,337,2,214,0.0,160.0,107.0,1,123,0.0,123.0,123.0
170275.0,6,11,1131,6,600,34055.0,262.0,100.0,5,531,2866.25,259.0,106.2
2588345.0,6,25,7573,14,3735,199103.4615384616,1514.0,266.7857142857143,11,3838,234181.4,1514.0,348.90909090909093
219171.0,6,3,426,2,280,0.0,214.0,140.0,1,146,0.0,146.0,146.0
121250.0,6,3,337,2,214,0.0,160.0,107.0,1,123,0.0,123.0,123.0
478527.0,6,3,204,2,136,0.0,70.0,68.0,1,68,0.0,68.0,68.0
3003680.0,6,12,2172,7,664,500465.5,252.0,94.85714285714286,5,1508,1921.5,1236.0,301.6
90254280.0,6,13,2036,8,1016,12893468.57142857,188.0,127.0,5,1020,22522355.5,204.0,204.0
135125379.0,17,6,1146,6,1146,27025075.8,191.0,191.0,0,0,0.0,0.0,0.0
218919.0,6,3,426,2,280,0.0,214.0,140.0,1,146,0.0,146.0,146.0
108106277.0,17,5,955,5,955,27026569.25,191.0,191.0,0,0,0.0,0.0,0.0
1303433.0,6,4,264,2,132,0.0,66.0,66.0,2,132,0.0,66.0,66.0
90031191.0,17,28,13364,28,13364,3334488.5555555555,501.0,477.2857142857143,0,0,0.0,0.0,0.0
222744.0,6,12,1373,7,714,37124.0,298.0,102.0,5,659,54738.0,379.0,131.8
782.0,17,4,438,2,148,0.0,74.0,74.0,2,290,0.0,147.0,145.0
15613.0,6,14,4740,7,653,2454.833333333333,249.0,93.28571428571428,7,4087,2468.833333333333,1514.0,583.8571428571429
1301640.0,6,4,264,2,132,0.0,66.0,66.0,2,132,0.0,66.0,66.0
302429.0,6,6,412,4,272,100809.66666666669,74.0,68.0,2,140,0.0,74.0,70.0
316949.0,6,12,1373,7,714,52824.833333333336,298.0,102.0,5,659,74566.75,379.0,131.8
216505.0,17,2,180,1,90,0.0,90.0,90.0,1,90,0.0,90.0,90.0
809941.0,6,6,758,3,410,399717.0,172.0,136.66666666666666,3,348,287502.0,135.0,116.0
36522.0,6,10,2032,5,524,7791.25,252.0,104.8,5,1508,8352.5,1236.0,301.6
39129.0,6,14,4740,7,653,5131.0,249.0,93.28571428571428,7,4087,6297.333333333333,1514.0,583.8571428571429
107576.0,17,2,700,2,700,0.0,350.0,350.0,0,0,0.0,0.0,0.0
10507199.0,6,7,478,4,272,3456824.0,74.0,68.0,3,206,5185153.5,74.0,68.66666666666667
2465.0,17,4,344,2,150,0.0,75.0,75.0,2,194,0.0,103.0,97.0
103081.0,17,2,286,2,286,0.0,143.0,143.0,0,0,0.0,0.0,0.0
108100577.0,17,5,1005,5,1005,27025144.25,201.0,201.0,0,0,0.0,0.0,0.0
44248.0,6,10,1065,5,534,10511.0,262.0,106.8,5,531,10003.75,259.0,106.2
364.0,17,2,267,1,83,0.0,83.0,83.0,1,184,0.0,184.0,184.0
9539.0,17,2,582,1,83,0.0,83.0,83.0,1,499,0.0,499.0,499.0
1315502.0,6,4,264,2,132,0.0,66.0,66.0,2,132,0.0,66.0,66.0
90035119.0,17,28,13364,28,13364,3334634.037037037,501.0,477.2857142857143,0,0,0.0,0.0,0.0
120058588.0,17,29,13785,29,13785,4287806.714285715,501.0,475.3448275862069,0,0,0.0,0.0,0.0
90043525.0,17,27,12943,27,12943,3463212.5,501.0,479.3703703703704,0,0,0.0,0.0,0.0
0.0,17,1,350,1,350,0.0,350.0,350.0,0,0,0.0,0.0,0.0
101308977.0,6,23,1862,11,968,10109347.5,223.0,88.0,12,894,9190314.545454543,95.0,74.5
102149216.0,17,14,864,7,432,17000976.833333332,174.0,61.71428571428572,7,432,17000159.666666668,174.0,61.71428571428572
120116158.0,6,34,2419,17,1194,7507259.875,123.0,70.23529411764706,17,1225,7493685.875,139.0,72.05882352941177
108107845.0,17,5,1005,5,1005,27026961.25,201.0,201.0,0,0,0.0,0.0,0.0
121398848.0,6,221,25040,111,17558,1103625.8909090909,284.0,158.18018018018017,110,7482,1086683.8256880734,140.0,68.01818181818182
115139089.0,6,48,3168,24,1584,5006047.347826087,66.0,66.0,24,1584,4992374.782608695,66.0,66.0
40424.0,6,10,2032,5,524,9666.0,252.0,104.8,5,1508,9841.25,1236.0,301.6
120205942.0,6,473,81264,234,15826,512435.034334764,214.0,67.63247863247864,239,65438,502058.03361344535,1514.0,273.7991631799163
368044.0,6,3,204,1,68,0.0,68.0,68.0,2,136,0.0,70.0,68.0
25663.0,6,10,2032,5,524,6197.75,252.0,104.8,5,1508,6079.25,1236.0,301.6
153.0,17,2,700,2,700,0.0,350.0,350.0,0,0,0.0,0.0,0.0
57730112.0,17,9,3086,8,2736,5107720.285714285,342.0,342.0,1,350,0.0,350.0,350.0
153399.0,17,2,180,1,90,0.0,90.0,90.0,1,90,0.0,90.0,90.0
106367.0,17,2,286,2,286,0.0,143.0,143.0,0,0,0.0,0.0,0.0
2321.0,17,4,344,2,150,0.0,75.0,75.0,2,194,0.0,103.0,97.0
135131979.0,17,6,1206,6,1206,27026395.8,201.0,201.0,0,0,0.0,0.0,0.0
153508.0,17,2,180,1,90,0.0,90.0,90.0,1,90,0.0,90.0,90.0
39466935.0,6,8,745,8,745,5638133.571428572,97.0,93.125,0,0,0.0,0.0,0.0
606972.0,6,4,508,2,238,0.0,172.0,119.0,2,270,0.0,135.0,135.0
121530.0,6,3,337,2,214,0.0,160.0,107.0,1,123,0.0,123.0,123.0
295.0,17,2,156,1,78,0.0,78.0,78.0,1,78,0.0,78.0,78.0
0.0,6,1,66,1,66,0.0,66.0,66.0,0,0,0.0,0.0,0.0
114650624.0,6,32,2220,16,1149,7628970.933333334,123.0,71.8125,16,1071,7628974.6,123.0,66.9375
90076207.0,17,28,13364,28,13364,3336155.814814815,501.0,477.2857142857143,0,0,0.0,0.0,0.0
128549.0,17,2,762,2,762,0.0,381.0,381.0,0,0,0.0,0.0,0.0
167405.0,6,3,337,2,214,0.0,160.0,107.0,1,123,0.0,123.0,123.0
135132755.0,17,6,1206,6,1206,27026551.0,201.0,201.0,0,0,0.0,0.0,0.0
106725261.0,6,539,70428,270,52452,396748.1821561338,390.0,194.26666666666668,269,17976,397325.82835820894,140.0,66.82527881040892
98598795.0,6,30,2122,15,1105,7042771.071428572,139.0,73.66666666666667,15,1017,7028096.5,123.0,67.8
13690.0,6,10,1975,5,467,3215.25,195.0,93.4,5,1508,1820.25,1236.0,301.6
90252776.0,6,13,2036,8,1016,12893253.714285716,188.0,127.0,5,1020,22521995.25,204.0,204.0
39144.0,6,4,301,2,132,0.0,66.0,66.0,2,169,0.0,103.0,84.5
542584.0,6,2,132,1,66,0.0,66.0,66.0,1,66,0.0,66.0,66.0
90038691.0,17,28,13364,28,13364,3334766.333333333,501.0,477.2857142857143,0,0,0.0,0.0,0.0
0.0,6,1,54,0,0,0.0,0.0,0.0,1,54,0.0,54.0,54.0
214193.0,17,2,414,1,88,0.0,88.0,88.0,1,326,0.0,326.0,326.0
153409.0,17,2,180,1,90,0.0,90.0,90.0,1,90,0.0,90.0,90.0
90063033.0,17,28,13364,28,13364,3335667.888888889,501.0,477.2857142857143,0,0,0.0,0.0,0.0
34498.0,6,10,2032,5,524,8351.0,252.0,104.8,5,1508,5668.75,1236.0,301.6
2303.0,17,4,344,2,150,0.0,75.0,75.0,2,194,0.0,103.0,97.0
120106894.0,6,228,25718,114,7820,1055611.4867256638,140.0,68.59649122807018,114,17898,1055745.831858407,284.0,157.0
99727110.0,17,19,5758,8,1128,14224024.142857144,506.0,141.0,11,4630,9941914.4,1214.0,420.9090909090909
1314761.0,6,4,264,2,132,0.0,66.0,66.0,2,132,0.0,66.0,66.0
53523.0,6,14,4740,7,653,8700.833333333334,249.0,93.28571428571428,7,4087,7780.0,1514.0,583.8571428571429
90529140.0,6,14,2240,8,1016,12932734.285714284,188.0,127.0,6,1224,18072825.0,204.0,204.0
307144.0,6,3,202,2,128,0.0,74.0,64.0,1,74,0.0,74.0,74.0
120016517.0,17,28,13364,28,13364,4445056.185185186,501.0,477.2857142857143,0,0,0.0,0.0,0.0
10145.0,17,4,344,2,150,0.0,75.0,75.0,2,194,0.0,103.0,97.0
10442305.0,6,7,478,4,272,3435585.0,74.0,68.0,3,206,5153272.5,74.0,68.66666666666667
135137892.0,17,6,1206,6,1206,27027578.4,201.0,201.0,0,0,0.0,0.0,0.0
5003908.0,17,4,849,2,166,0.0,83.0,83.0,2,683,0.0,499.0,341.5
90022767.0,17,27,12943,27,12943,3462414.1153846155,501.0,479.3703703703704,0,0,0.0,0.0,0.0
108105651.0,17,5,955,5,955,27026412.75,191.0,191.0,0,0,0.0,0.0,0.0
10452970.0,6,7,478,4,272,3438835.0,74.0,68.0,3,206,5158141.0,74.0,68.66666666666667
120149615.0,6,236,26840,118,8084,1019973.94017094,140.0,68.50847457627118,118,18756,1024832.4017094016,374.0,158.94915254237287
5830277.0,6,5,336,2,134,0.0,68.0,67.0,3,202,1523948.5,70.0,67.33333333333333
356672.0,17,6,2100,6,2100,71334.4,350.0,350.0,0,0,0.0,0.0,0.0
511866.00000000006,6,5,336,2,134,0.0,68.0,67.0,3,202,197050.5,70.0,67.33333333333333
87508.0,6,14,4740,7,653,14184.0,249.0,93.28571428571428,7,4087,11105.666666666666,1514.0,583.8571428571429
9200.0,17,2,498,1,80,0.0,80.0,80.0,1,418,0.0,418.0,418.0
4624812.0,6,5,1736,2,819,0.0,753.0,409.5,3,917,2243933.0,785.0,305.6666666666667
139612.0,6,2,132,1,66,0.0,66.0,66.0,1,66,0.0,66.0,66.0
118073601.0,6,210,23646,105,7226,1127521.0096153845,140.0,68.81904761904762,105,16420,1127369.0288461538,284.0,156.38095238095238
19058.0,6,10,2032,5,524,4580.0,252.0,104.8,5,1508,4336.25,1236.0,301.6
298363.0,6,6,412,4,272,99454.33333333331,74.0,68.0,2,140,0.0,74.0,70.0
119958027.0,6,13,2036,8,1016,17136861.0,188.0,127.0,5,1020,15082124.5,204.0,204.0
108107872.0,17,5,1005,5,1005,27026968.0,201.0,201.0,0,0,0.0,0.0,0.0
26972266.0,17,5,1710,5,1710,6743066.5,342.0,342.0,0,0,0.0,0.0,0.0
135133336.0,17,6,1206,6,1206,27026667.2,201.0,201.0,0,0,0.0,0.0,0.0
104000959.0,17,13,1083,7,563,17333493.166666668,174.0,80.42857142857143,6,520,16801200.2,174.0,86.66666666666667
264920.0,6,10,1221,6,636,52984.0,298.0,106.0,4,585,82395.0,379.0,146.25
108114811.0,17,5,955,5,955,27028702.75,191.0,191.0,0,0,0.0,0.0,0.0
18491.0,6,10,2032,5,524,3489.75,252.0,104.8,5,1508,4130.0,1236.0,301.6
59724.0,6,10,2032,5,524,14232.75,252.0,104.8,5,1508,14610.0,1236.0,301.6
303823.0,6,6,412,4,272,101274.33333333331,74.0,68.0,2,140,0.0,74.0,70.0
116673495.0,6,222,25106,111,17484,1058712.3909090909,284.0,157.51351351351352,111,7622,1058893.0636363635,140.0,68.66666666666667
108101740.0,17,5,955,5,955,27025435.0,191.0,191.0,0,0,0.0,0.0,0.0
12478.0,6,11,2098,6,590,2310.6,252.0,98.33333333333331,5,1508,2551.25,1236.0,301.6
1486.0,17,2,762,2,762,0.0,381.0,381.0,0,0,0.0,0.0,0.0
118822360.0,6,30,1974,15,1026,8471892.0,123.0,68.4,15,948,8471897.214285715,123.0,63.2
308015.0,17,4,1400,4,1400,102671.66666666669,350.0,350.0,0,0,0.0,0.0,0.0
3794.0,17,2,414,1,88,0.0,88.0,88.0,1,326,0.0,326.0,326.0
196975.0,17,2,180,1,90,0.0,90.0,90.0,1,90,0.0,90.0,90.0
135126948.0,17,6,1146,6,1146,27025389.6,191.0,191.0,0,0,0.0,0.0,0.0
236486.0,6,3,373,2,238,0.0,172.0,119.0,1,135,0.0,135.0,135.0
5627373.0,6,5,336,2,134,0.0,68.0,67.0,3,202,1523118.5,70.0,67.33333333333333
2510.0,17,4,344,2,150,0.0,75.0,75.0,2,194,0.0,103.0,97.0
90044464.0,17,28,13364,28,13364,3334980.1481481483,501.0,477.2857142857143,0,0,0.0,0.0,0.0
91827190.0,6,27,2073,15,1138,6558657.5,95.0,75.86666666666666,12,935,8347553.272727272,95.0,77.91666666666667
2802869.0,6,2,132,1,66,0.0,66.0,66.0,1,66,0.0,66.0,66.0
369.0,17,2,267,1,83,0.0,83.0,83.0,1,184,0.0,184.0,184.0
606.0,17,2,508,2,508,0.0,257.0,254.0,0,0,0.0,0.0,0.0
298387.0,6,6,412,4,272,99462.33333333331,74.0,68.0,2,140,0.0,74.0,70.0
103775.0,17,2,286,2,286,0.0,143.0,143.0,0,0,0.0,0.0,0.0
1112217.0,6,13,1394,7,797,185369.5,253.0,113.85714285714286,6,597,219376.8,259.0,99.5
2425.0,17,4,344,2,150,0.0,75.0,75.0,2,194,0.0,103.0,97.0
90215042.0,6,16,1192,8,596,12853344.57142857,95.0,74.5,8,596,12858499.714285716,95.0,74.5
1449751.0,6,7,499,4,301,422189.0,103.0,75.25,3,198,717154.0,66.0,66.0
143939.0,17,2,180,1,90,0.0,90.0,90.0,1,90,0.0,90.0,90.0
108127241.0,17,5,955,5,955,27031810.25,191.0,191.0,0,0,0.0,0.0,0.0
359.0,17,2,267,1,83,0.0,83.0,83.0,1,184,0.0,184.0,184.0
90255388.0,6,12,1832,8,1016,12893626.857142856,188.0,127.0,4,816,30029049.33333333,204.0,204.0
298352.0,6,6,412,4,272,99450.66666666669,74.0,68.0,2,140,0.0,74.0,70.0
144097.0,17,2,180,1,90,0.0,90.0,90.0,1,90,0.0,90.0,90.0
108099782.0,17,5,955,5,955,27024945.5,191.0,191.0,0,0,0.0,0.0,0.0
879.0,17,5,550,5,550,219.75,110.0,110.0,0,0,0.0,0.0,0.0
1310110.0,6,4,264,2,132,0.0,66.0,66.0,2,132,0.0,66.0,66.0
108108771.0,17,5,955,5,955,27027192.75,191.0,191.0,0,0,0.0,0.0,0.0
153477.0,17,2,180,1,90,0.0,90.0,90.0,1,90,0.0,90.0,90.0
144872.0,17,2,180,1,70,0.0,70.0,70.0,1,110,0.0,110.0,110.0
201661.0,17,4,6056,4,6056,67220.33333333333,1514.0,1514.0,0,0,0.0,0.0,0.0
40829.0,6,14,4740,7,653,5310.166666666667,249.0,93.28571428571428,7,4087,6209.666666666667,1514.0,583.8571428571429
294415.0,6,10,1221,6,636,58883.0,298.0,106.0,4,585,88840.0,379.0,146.25
101344213.0,17,14,1126,7,563,16836994.166666668,174.0,80.42857142857143,7,563,16833532.5,174.0,80.42857142857143
148364.0,17,2,414,1,88,0.0,88.0,88.0,1,326,0.0,326.0,326.0
33697.0,6,10,2032,5,524,7665.75,252.0,104.8,5,1508,6610.75,1236.0,301.6
2937.0,17,2,239,1,82,0.0,82.0,82.0,1,157,0.0,157.0,157.0
2343.0,17,4,344,2,150,0.0,75.0,75.0,2,194,0.0,103.0,97.0
357613.0,6,5,336,2,134,0.0,68.0,67.0,3,202,159334.5,70.0,67.33333333333333
309863.0,6,6,412,4,272,103287.66666666669,74.0,68.0,2,140,0.0,74.0,70.0
14305.0,6,11,1133,6,602,2861.0,264.0,100.33333333333331,5,531,2745.25,259.0,106.2
14359701.0,6,24,7242,14,1785,1104592.3846153845,408.0,127.5,10,5457,1024698.4444444444,1514.0,545.7
218363.0,6,3,426,2,280,0.0,214.0,140.0,1,146,0.0,146.0,146.0
166938.0,17,4,704,2,148,0.0,74.0,74.0,2,556,0.0,280.0,278.0
0.0,17,1,55,1,55,0.0,55.0,55.0,0,0,0.0,0.0,0.0
10607836.0,6,7,478,4,272,3475541.6666666665,74.0,68.0,3,206,5212886.0,74.0,68.66666666666667
8601.0,17,4,823,2,163,0.0,89.0,81.5,2,660,0.0,443.0,330.0
76229.0,6,10,2032,5,524,17975.0,252.0,104.8,5,1508,14449.0,1236.0,301.6
2643.0,17,2,762,2,762,0.0,381.0,381.0,0,0,0.0,0.0,0.0
210112.0,17,2,180,1,90,0.0,90.0,90.0,1,90,0.0,90.0,90.0
90042522.0,17,28,13364,28,13364,3334908.222222222,501.0,477.2857142857143,0,0,0.0,0.0,0.0
216886.0,17,2,180,1,90,0.0,90.0,90.0,1,90,0.0,90.0,90.0
90221896.0,6,20,1531,9,691,11246814.625,95.0,76.77777777777777,11,840,9000643.1,95.0,76.36363636363636
14921.0,17,2,180,1,90,0.0,90.0,90.0,1,90,0.0,90.0,90.0
11741776.0,17,4,1368,4,1368,3913925.3333333335,342.0,342.0,0,0,0.0,0.0,0.0
277062.0,6,10,1221,6,636,55412.4,298.0,106.0,4,585,86887.33333333333,379.0,146.25
868130.0,6,9,1196,6,725,173626.0,387.0,120.83333333333331,3,471,296206.5,331.0,157.0
19964.0,17,2,582,1,83,0.0,83.0,83.0,1,499,0.0,499.0,499.0
113516374.0,6,46,3036,23,1518,5159823.045454546,66.0,66.0,23,1518,5159822.590909091,66.0,66.0
23062791.0,17,3,1034,2,684,0.0,342.0,342.0,1,350,0.0,350.0,350.0
37718.0,6,14,4740,7,653,6164.166666666667,249.0,93.28571428571428,7,4087,5420.666666666667,1514.0,583.8571428571429
39350.0,6,14,4740,7,653,6088.833333333333,249.0,93.28571428571428,7,4087,6327.333333333333,1514.0,583.8571428571429
300.0,17,2,174,1,79,0.0,79.0,79.0,1,95,0.0,95.0,95.0
772.0,17,4,438,2,148,0.0,74.0,74.0,2,290,0.0,147.0,145.0
15119.0,6,14,4740,7,653,2362.0,249.0,93.28571428571428,7,4087,2079.333333333333,1514.0,583.8571428571429
307728.0,6,6,412,4,272,102576.0,74.0,68.0,2,140,0.0,74.0,70.0
87958.0,6,14,4740,7,653,13575.666666666666,249.0,93.28571428571428,7,4087,14476.166666666666,1514.0,583.8571428571429
90283530.0,6,35,3640,18,1845,5308394.0,426.0,102.5,17,1795,5625696.875,360.0,105.58823529411764
23466467.0,6,5,1736,2,819,0.0,753.0,409.5,3,917,11662946.5,785.0,305.6666666666667
6510.0,17,4,823,2,163,0.0,89.0,81.5,2,660,0.0,443.0,330.0
91108781.0,6,166,18762,83,13062,1108455.0731707318,284.0,157.3734939759036,83,5700,1108458.3170731708,140.0,68.67469879518072
207047.0,6,3,426,2,280,0.0,214.0,140.0,1,146,0.0,146.0,146.0
108105767.0,17,5,1005,5,1005,27026441.75,201.0,201.0,0,0,0.0,0.0,0.0
306924.0,6,6,412,4,272,102308.0,74.0,68.0,2,140,0.0,74.0,70.0
319.0,17,2,174,1,79,0.0,79.0,79.0,1,95,0.0,95.0,95.0
105229024.0,6,28,1860,14,966,8077947.461538462,123.0,69.0,14,894,8077945.846153846,123.0,63.85714285714285
32972.0,6,10,2032,5,524,8016.0,252.0,104.8,5,1508,7096.5,1236.0,301.6
1315599.0,6,4,264,2,132,0.0,66.0,66.0,2,132,0.0,66.0,66.0
1098831.0,6,13,1386,7,789,183138.5,253.0,112.71428571428572,6,597,218807.6,259.0,99.5
2009.0,17,4,344,2,150,0.0,75.0,75.0,2,194,0.0,103.0,97.0
0.0,6,1,66,1,66,0.0,66.0,66.0,0,0,0.0,0.0,0.0
182835.0,17,4,1400,4,1400,60945.0,350.0,350.0,0,0,0.0,0.0,0.0
90259791.0,6,16,2368,9,1204,11282473.875,188.0,133.77777777777777,7,1164,15015705.666666666,204.0,166.28571428571428
292.0,17,2,174,1,79,0.0,79.0,79.0,1,95,0.0,95.0,95.0
119677210.0,6,47,3102,23,1518,5143998.454545454,66.0,66.0,24,1584,5203344.956521739,66.0,66.0
213563.0,6,10,1221,6,636,42712.6,298.0,106.0,4,585,70228.66666666667,379.0,146.25
225714.0,6,3,426,2,280,0.0,214.0,140.0,1,146,0.0,146.0,146.0
47608396.0,6,7,1874,3,887,22610557.0,753.0,295.6666666666667,4,987,15014185.333333334,785.0,246.75
204244.0,17,2,762,2,762,0.0,381.0,381.0,0,0,0.0,0.0,0.0
228650.0,17,2,180,1,90,0.0,90.0,90.0,1,90,0.0,90.0,90.0
1300216.0,6,4,264,2,132,0.0,66.0,66.0,2,132,0.0,66.0,66.0
14645870.0,6,20,1607,10,975,1593567.4444444445,315.0,97.5,10,632,1593544.888888889,78.0,63.2
446204.0,6,11,1021,6,444,60522.8,162.0,74.0,5,577,75454.5,349.0,115.4
25207664.0,6,140,31127,72,23842,355037.5211267606,566.0,331.1388888888889,68,7285,371958.8059701492,898.0,107.13235294117646
52172.0,6,13,1386,7,789,7953.0,253.0,112.71428571428572,6,597,8775.8,259.0,99.5
10298.0,17,2,582,1,83,0.0,83.0,83.0,1,499,0.0,499.0,499.0
51724067.0,6,8,2113,3,960,24536722.5,826.0,320.0,5,1153,12237056.75,885.0,230.6
1039405.0,6,13,1386,7,789,173234.16666666666,253.0,112.71428571428572,6,597,204457.8,259.0,99.5
143943.0,17,2,180,1,90,0.0,90.0,90.0,1,90,0.0,90.0,90.0
28983.0,6,10,2032,5,524,6097.5,252.0,104.8,5,1508,5564.5,1236.0,301.6
15028.0,6,10,1975,5,467,1692.75,195.0,93.4,5,1508,3459.25,1236.0,301.6
884277.0,6,10,1332,6,795,176855.4,457.0,132.5,4,537,203928.0,331.0,134.25
20690.0,6,2,145,2,145,0.0,91.0,72.5,0,0,0.0,0.0,0.0
234014.0,6,3,337,2,214,0.0,160.0,107.0,1,123,0.0,123.0,123.0
153490.0,17,2,180,1,90,0.0,90.0,90.0,1,90,0.0,90.0,90.0
629196.0,17,6,1230,3,234,314421.0,78.0,78.0,3,996,314381.5,332.0,332.0
123176973.0,6,214,24202,107,7358,1126076.6698113207,140.0,68.76635514018692,107,16844,1154210.5566037735,284.0,157.42056074766356
84.0,17,2,762,2,762,0.0,381.0,381.0,0,0,0.0,0.0,0.0
71653.0,6,14,4740,7,653,11833.333333333334,249.0,93.28571428571428,7,4087,10513.0,1514.0,583.8571428571429
28071.0,6,11,2098,6,590,5156.6,252.0,98.33333333333331,5,1508,6751.0,1236.0,301.6
108106290.0,17,5,1005,5,1005,27026572.5,201.0,201.0,0,0,0.0,0.0,0.0
120125371.0,6,15,2444,7,1428,20020895.166666668,204.0,204.0,8,1016,17096923.42857143,188.0,127.0
405986.0,6,3,1604,2,851,0.0,785.0,425.5,1,753,0.0,753.0,753.0
244882.0,17,4,1400,4,1400,81627.33333333333,350.0,350.0,0,0,0.0,0.0,0.0
98177372.0,17,12,778,6,389,19600182.4,174.0,64.83333333333333,6,389,19600742.8,174.0,64.83333333333333
217068.0,6,10,1221,6,636,43413.6,298.0,106.0,4,585,70924.0,379.0,146.25
209404.0,17,2,180,1,90,0.0,90.0,90.0,1,90,0.0,90.0,90.0
37490.0,6,14,4740,7,653,5640.0,249.0,93.28571428571428,7,4087,6108.333333333333,1514.0,583.8571428571429
6530.0,17,2,447,1,84,0.0,84.0,84.0,1,363,0.0,363.0,363.0
90040966.0,17,28,13364,28,13364,3334850.592592593,501.0,477.2857142857143,0,0,0.0,0.0,0.0
2648830.0,6,25,7573,14,3735,203756.15384615384,1514.0,266.7857142857143,11,3838,239091.8,1514.0,348.90909090909093
144062.0,17,2,180,1,90,0.0,90.0,90.0,1,90,0.0,90.0,90.0
38132.0,6,10,2032,5,524,9015.5,252.0,104.8,5,1508,8571.5,1236.0,301.6
90044259.0,17,28,13364,28,13364,3334972.5555555555,501.0,477.2857142857143,0,0,0.0,0.0,0.0
42954.0,6,13,1479,7,882,7159.0,291.0,126.0,6,597,7041.8,259.0,99.5
2052.0,17,4,344,2,150,0.0,75.0,75.0,2,194,0.0,103.0,97.0
90022575.0,17,28,13364,28,13364,3334169.4444444445,501.0,477.2857142857143,0,0,0.0,0.0,0.0
90765742.0,6,25,2807,13,1410,7563811.833333333,426.0,108.46153846153848,12,1397,8232158.727272727,359.0,116.41666666666669
115145949.0,17,14,864,7,432,19166821.666666668,174.0,61.71428571428572,7,432,19167772.83333333,174.0,61.71428571428572
0.0,17,1,453,1,453,0.0,453.0,453.0,0,0,0.0,0.0,0.0
236124.0,6,3,373,2,238,0.0,172.0,119.0,1,135,0.0,135.0,135.0
102018656.0,6,317,38284,159,27634,645687.6962025317,336.0,173.7987421383648,158,10650,648319.4585987261,140.0,67.40506329113924
17043.0,6,14,4740,7,653,2718.0,249.0,93.28571428571428,7,4087,2699.1666666666665,1514.0,583.8571428571429
1302901.0,6,4,264,2,132,0.0,66.0,66.0,2,132,0.0,66.0,66.0
90742717.0,6,22,1680,12,935,8245265.363636363,95.0,77.91666666666667,10,745,10051453.555555556,95.0,74.5
37096.0,6,14,4740,7,653,5854.333333333333,249.0,93.28571428571428,7,4087,5994.5,1514.0,583.8571428571429
118022639.0,6,30,1974,15,1026,8414815.285714285,123.0,68.4,15,948,8414333.0,123.0,63.2
451280.0,6,3,1604,2,851,0.0,785.0,425.5,1,753,0.0,753.0,753.0
2372529.0,6,3,204,2,136,0.0,70.0,68.0,1,68,0.0,68.0,68.0
118192910.0,6,222,25270,111,7622,1066958.1363636365,140.0,68.66666666666667,111,17648,1066934.3909090909,284.0,158.99099099099098
121388.0,6,3,337,2,214,0.0,160.0,107.0,1,123,0.0,123.0,123.0
980991.0,6,4,264,2,132,0.0,66.0,66.0,2,132,0.0,66.0,66.0
209482.0,17,2,180,1,90,0.0,90.0,90.0,1,90,0.0,90.0,90.0
108107295.0,17,5,1005,5,1005,27026823.75,201.0,201.0,0,0,0.0,0.0,0.0
394.0,17,2,410,1,78,0.0,78.0,78.0,1,332,0.0,332.0,332.0
90256282.0,6,14,1964,8,1016,12893754.57142857,188.0,127.0,6,948,18018230.6,204.0,158.0
108104977.0,17,5,1005,5,1005,27026244.25,201.0,201.0,0,0,0.0,0.0,0.0
242258.0,6,3,337,2,214,0.0,160.0,107.0,1,123,0.0,123.0,123.0
139006.0,6,2,132,1,66,0.0,66.0,66.0,1,66,0.0,66.0,66.0
255474.0,6,3,337,2,214,0.0,160.0,107.0,1,123,0.0,123.0,123.0
10923182.0,6,8,544,4,272,3593972.6666666665,74.0,68.0,4,272,3593899.0,74.0,68.0
108085713.0,17,5,955,5,955,27021428.25,191.0,191.0,0,0,0.0,0.0,0.0
3412726.0,6,7,923,4,753,1068772.0,571.0,188.25,3,170,1603728.0,62.0,56.66666666666666
108103470.0,17,5,1005,5,1005,27025867.5,201.0,201.0,0,0,0.0,0.0,0.0
116052887.0,17,14,864,7,432,19334928.166666668,174.0,61.71428571428572,7,432,19333498.666666668,174.0,61.71428571428572
111149981.0,6,253,29094,127,8678,882142.7063492064,140.0,68.33070866141732,126,20416,872682.664,554.0,162.03174603174602
134425.0,6,2,132,1,66,0.0,66.0,66.0,1,66,0.0,66.0,66.0
308303.0,6,6,412,4,272,102767.66666666669,74.0,68.0,2,140,0.0,74.0,70.0
20396.0,6,14,4740,7,653,3004.6666666666665,249.0,93.28571428571428,7,4087,3264.0,1514.0,583.8571428571429
48086.0,6,14,4740,7,653,7859.833333333333,249.0,93.28571428571428,7,4087,6755.0,1514.0,583.8571428571429
90255684.0,6,13,2036,8,1016,12893669.142857144,188.0,127.0,5,1020,22522970.75,204.0,204.0
90258823.0,6,13,2036,8,1016,12894117.57142857,188.0,127.0,5,1020,22522666.25,204.0,204.0
25985.0,6,14,4740,7,653,4206.833333333333,249.0,93.28571428571428,7,4087,4130.0,1514.0,583.8571428571429
216877.0,6,3,426,2,280,0.0,214.0,140.0,1,146,0.0,146.0,146.0
120022060.0,6,20,1490,11,840,11997854.1,95.0,76.36363636363636,9,650,14997146.125,95.0,72.22222222222223
49478.0,6,14,4740,7,653,7074.166666666667,249.0,93.28571428571428,7,4087,8090.833333333333,1514.0,583.8571428571429
326.0,17,2,174,1,79,0.0,79.0,79.0,1,95,0.0,95.0,95.0
4168.0,17,2,582,1,83,0.0,83.0,83.0,1,499,0.0,499.0,499.0
153420.0,17,2,180,1,90,0.0,90.0,90.0,1,90,0.0,90.0,90.0
298559.0,6,6,412,4,272,99519.66666666669,74.0,68.0,2,140,0.0,74.0,70.0
1313622.0,6,4,264,2,132,0.0,66.0,66.0,2,132,0.0,66.0,66.0
245387.0,6,3,337,2,214,0.0,160.0,107.0,1,123,0.0,123.0,123.0
2084316.0,6,25,7609,13,2516,173693.0,1034.0,193.53846153846155,12,5093,161890.45454545456,1510.0,424.4166666666667
27629.0,6,14,4740,7,653,4408.333333333333,249.0,93.28571428571428,7,4087,4467.5,1514.0,583.8571428571429
510088.0,6,5,336,2,134,0.0,68.0,67.0,3,202,196606.5,70.0,67.33333333333333
20776.0,6,14,4740,7,653,3079.5,249.0,93.28571428571428,7,4087,3192.5,1514.0,583.8571428571429
297802.0,6,6,412,4,272,99267.33333333331,74.0,68.0,2,140,0.0,74.0,70.0
135129281.0,17,6,1146,6,1146,27025856.2,191.0,191.0,0,0,0.0,0.0,0.0
1231142.0,17,7,490,7,490,205190.3333333333,70.0,70.0,0,0,0.0,0.0,0.0
148177.0,17,2,180,1,90,0.0,90.0,90.0,1,90,0.0,90.0,90.0
90532073.0,6,14,2240,8,1016,12933153.285714284,188.0,127.0,6,1224,18072940.6,204.0,204.0
90294548.0,6,16,1192,8,596,12892140.42857143,95.0,74.5,8,596,12898420.285714284,95.0,74.5
90034037.0,17,28,13364,28,13364,3334593.962962963,501.0,477.2857142857143,0,0,0.0,0.0,0.0
3453.0,17,4,344,2,150,0.0,75.0,75.0,2,194,0.0,103.0,97.0
313309.0,17,4,1400,4,1400,104436.33333333331,350.0,350.0,0,0,0.0,0.0,0.0
118339887.0,6,303,35016,152,24754,783707.8609271523,300.0,162.85526315789474,151,10262,782086.4,140.0,67.96026490066225
54861.0,6,12,1328,6,731,9105.6,253.0,121.83333333333331,6,597,9189.6,259.0,99.5
90991626.0,17,11,735,6,389,18001683.0,174.0,64.83333333333333,5,346,17750172.0,174.0,69.2
292649.0,17,4,1524,4,1524,97549.66666666669,381.0,381.0,0,0,0.0,0.0,0.0
100317.0,17,2,286,2,286,0.0,143.0,143.0,0,0,0.0,0.0,0.0
8977.0,17,2,166,1,75,0.0,75.0,75.0,1,91,0.0,91.0,91.0
606230.0,17,2,346,1,78,0.0,78.0,78.0,1,268,0.0,268.0,268.0
204880.0,6,10,1221,6,636,40976.0,298.0,106.0,4,585,66533.33333333333,379.0,146.25
58656.0,6,14,4740,7,653,9119.833333333334,249.0,93.28571428571428,7,4087,7688.5,1514.0,583.8571428571429
10470727.0,6,7,478,4,272,3444550.6666666665,74.0,68.0,3,206,5166649.0,74.0,68.66666666666667
120012792.0,6,21,1585,11,840,11999994.8,95.0,76.36363636363636,10,745,13333971.444444444,95.0,74.5
90304026.0,6,19,1436,10,745,10028672.111111112,95.0,74.5,9,691,11286959.375,95.0,76.77777777777777
90031207.0,17,28,13364,28,13364,3334489.1481481483,501.0,477.2857142857143,0,0,0.0,0.0,0.0
35434.0,6,10,2032,5,524,8146.75,252.0,104.8,5,1508,8607.5,1236.0,301.6
32994.0,6,14,4740,7,653,5274.833333333333,249.0,93.28571428571428,7,4087,4542.0,1514.0,583.8571428571429
237647.0,6,3,426,2,280,0.0,214.0,140.0,1,146,0.0,146.0,146.0
144026.0,17,2,180,1,90,0.0,90.0,90.0,1,90,0.0,90.0,90.0
90038687.0,17,28,13364,28,13364,3334766.185185185,501.0,477.2857142857143,0,0,0.0,0.0,0.0
91430107.0,6,24,1829,13,989,7618664.25,95.0,76.07692307692308,11,840,9142245.3,95.0,76.36363636363636
40011.0,6,14,4740,7,653,6544.833333333333,249.0,93.28571428571428,7,4087,6509.666666666667,1514.0,583.8571428571429
1832180.0,6,20,7599,11,1469,183218.0,583.0,133.54545454545453,9,6130,196862.0,1484.0,681.1111111111111
46893.0,6,10,2032,5,524,11457.5,252.0,104.8,5,1508,11481.75,1236.0,301.6
92940389.0,6,177,20028,89,6096,1056140.7840909092,140.0,68.49438202247191,88,13932,1056261.264367816,284.0,158.3181818181818
135346145.0,17,8,1713,7,1407,22557690.83333333,201.0,201.0,1,306,0.0,306.0,306.0
300287.0,6,6,412,4,272,100095.66666666669,74.0,68.0,2,140,0.0,74.0,70.0
234033.0,6,3,373,2,238,0.0,172.0,119.0,1,135,0.0,135.0,135.0
216624.0,6,3,426,2,280,0.0,214.0,140.0,1,146,0.0,146.0,146.0
304123.0,6,6,412,4,272,101374.33333333331,74.0,68.0,2,140,0.0,74.0,70.0
82962299.0,17,14,4796,13,4446,6234428.916666667,342.0,342.0,1,350,0.0,350.0,350.0
3371.0,17,2,414,1,88,0.0,88.0,88.0,1,326,0.0,326.0,326.0
79829.0,6,14,4740,7,653,13175.833333333334,249.0,93.28571428571428,7,4087,12413.5,1514.0,583.8571428571429
16680.0,6,10,2032,5,524,3935.0,252.0,104.8,5,1508,3517.25,1236.0,301.6
120066616.0,6,213,24422,106,17064,1137390.1333333333,374.0,160.9811320754717,107,7358,1130673.7358490566,140.0,68.76635514018692
26287.0,6,20,7606,11,978,2628.7,310.0,88.9090909090909,9,6628,3048.5,1514.0,736.4444444444445
95953969.0,6,189,21286,95,6492,1020786.9042553192,140.0,68.33684210526316,94,14794,1020568.1612903224,284.0,157.38297872340425
90526619.0,6,16,2372,8,1016,12932374.142857144,188.0,127.0,8,1356,12903439.714285716,204.0,169.5
93231931.0,17,11,735,6,389,18614606.8,174.0,64.83333333333333,5,346,18353095.5,174.0,69.2
90298431.0,6,16,1192,8,596,12893112.857142856,95.0,74.5,8,596,12897955.285714284,95.0,74.5
184838.0,17,2,180,1,90,0.0,90.0,90.0,1,90,0.0,90.0,90.0
216517.0,17,2,180,1,90,0.0,90.0,90.0,1,90,0.0,90.0,90.0
5602455.0,17,4,692,2,156,0.0,78.0,78.0,2,536,0.0,268.0,268.0
275258.0,17,2,180,1,90,0.0,90.0,90.0,1,90,0.0,90.0,90.0
146170.0,6,3,337,2,214,0.0,160.0,107.0,1,123,0.0,123.0,123.0
38344.0,6,11,2098,6,590,7176.6,252.0,98.33333333333331,5,1508,9110.25,1236.0,301.6
41895.0,6,10,2032,5,524,10178.0,252.0,104.8,5,1508,9388.0,1236.0,301.6
5825778.0,6,4,270,2,134,0.0,68.0,67.0,2,136,0.0,70.0,68.0
10425019.0,6,7,478,4,272,3429641.333333333,74.0,68.0,3,206,5144324.5,74.0,68.66666666666667
75014.0,6,14,4740,7,653,12378.833333333334,249.0,93.28571428571428,7,4087,10859.0,1514.0,583.8571428571429
2192155.0,6,19,6869,10,1501,243572.7777777777,408.0,150.1,9,5368,231677.25,1514.0,596.4444444444445
110555524.0,6,40,3210,21,1701,5527776.2,123.0,81.0,19,1509,6129617.611111111,123.0,79.42105263157895
146144.0,6,3,337,2,214,0.0,160.0,107.0,1,123,0.0,123.0,123.0
143893.0,17,2,180,1,90,0.0,90.0,90.0,1,90,0.0,90.0,90.0
301446.0,6,6,412,4,272,100482.0,74.0,68.0,2,140,0.0,74.0,70.0
90252681.0,6,13,2036,8,1016,12893240.142857144,188.0,127.0,5,1020,22522252.75,204.0,204.0
36876.0,6,14,4740,7,653,5587.166666666667,249.0,93.28571428571428,7,4087,4579.333333333333,1514.0,583.8571428571429
587.0,17,2,508,2,508,0.0,257.0,254.0,0,0,0.0,0.0,0.0
228822.0,6,3,426,2,280,0.0,214.0,140.0,1,146,0.0,146.0,146.0
37291.0,6,14,4740,7,653,6053.833333333333,249.0,93.28571428571428,7,4087,6069.166666666667,1514.0,583.8571428571429
21433.0,6,10,2032,5,524,4490.25,252.0,104.8,5,1508,4210.75,1236.0,301.6
32682101.000000004,6,5,336,2,134,0.0,68.0,67.0,3,202,15051945.0,70.0,67.33333333333333
120121845.0,6,13,2036,8,1016,17137188.285714287,188.0,127.0,5,1020,22523493.75,204.0,204.0
121553.0,6,3,337,2,214,0.0,160.0,107.0,1,123,0.0,123.0,123.0
2870.0,17,2,224,1,76,0.0,76.0,76.0,1,148,0.0,148.0,148.0
317.0,17,2,160,1,80,0.0,80.0,80.0,1,80,0.0,80.0,80.0
119056433.0,6,48,3168,24,1584,5176366.652173913,66.0,66.0,24,1584,5164388.521739131,66.0,66.0
10523763.0,6,7,478,4,272,3460666.333333333,74.0,68.0,3,206,5190889.0,74.0,68.66666666666667
92437872.0,6,37,2442,19,1254,5135437.333333333,66.0,66.0,18,1188,5013603.117647059,66.0,66.0
1149276.0,6,13,3001,8,2373,164182.2857142857,1514.0,296.625,5,628,219149.5,331.0,125.6
254382.0,6,3,337,2,214,0.0,160.0,107.0,1,123,0.0,123.0,123.0
153424.0,17,2,180,1,90,0.0,90.0,90.0,1,90,0.0,90.0,90.0
120116927.0,6,12,1832,8,1016,17136754.57142857,188.0,127.0,4,816,30031001.666666668,204.0,204.0
28083.0,6,14,4740,7,653,4480.0,249.0,93.28571428571428,7,4087,4187.166666666667,1514.0,583.8571428571429
90738102.0,6,20,1531,11,840,9069829.4,95.0,76.36363636363636,9,691,11341732.125,95.0,76.77777777777777
4239510.0,6,5,336,2,134,0.0,68.0,67.0,3,202,733113.5,70.0,67.33333333333333
323796.0,6,3,202,2,128,0.0,74.0,64.0,1,74,0.0,74.0,74.0
209053.0,6,3,426,2,280,0.0,214.0,140.0,1,146,0.0,146.0,146.0
53628.0,6,14,4740,7,653,5910.833333333333,249.0,93.28571428571428,7,4087,8647.166666666666,1514.0,583.8571428571429
90295658.0,6,19,1436,10,745,10028073.444444444,95.0,74.5,9,691,11286498.625,95.0,76.77777777777777
38925.0,6,10,2032,5,524,8813.75,252.0,104.8,5,1508,7832.0,1236.0,301.6
135135238.0,17,6,1146,6,1146,27027047.6,191.0,191.0,0,0,0.0,0.0,0.0
90257599.0,6,14,2102,8,1016,12893942.714285716,188.0,127.0,6,1086,18018750.4,204.0,181.0
317348.0,17,4,1400,4,1400,105782.66666666669,350.0,350.0,0,0,0.0,0.0,0.0
1670167.0,6,2,132,1,66,0.0,66.0,66.0,1,66,0.0,66.0,66.0
14362.0,17,4,344,2,150,0.0,75.0,75.0,2,194,0.0,103.0,97.0
217930.0,6,3,426,2,280,0.0,214.0,140.0,1,146,0.0,146.0,146.0
146760.0,6,3,337,2,214,0.0,160.0,107.0,1,123,0.0,123.0,123.0
10431275.0,6,6,412,3,206,5147773.5,74.0,68.66666666666667,3,206,5147664.5,74.0,68.66666666666667
144897.0,17,2,180,1,70,0.0,70.0,70.0,1,110,0.0,110.0,110.0
30735.0,6,14,4740,7,653,4823.333333333333,249.0,93.28571428571428,7,4087,4988.833333333333,1514.0,583.8571428571429
107452.0,17,2,286,2,286,0.0,143.0,143.0,0,0,0.0,0.0,0.0
301005.0,6,6,412,4,272,100335.0,74.0,68.0,2,140,0.0,74.0,70.0
232377.0,6,3,337,2,214,0.0,160.0,107.0,1,123,0.0,123.0,123.0
96564130.0,17,12,778,6,389,19200910.4,174.0,64.83333333333333,6,389,19200205.8,174.0,64.83333333333333
264683.0,6,3,337,2,214,0.0,160.0,107.0,1,123,0.0,123.0,123.0
123006428.0,17,15,907,8,475,17572346.85714286,174.0,59.375,7,432,17166873.5,174.0,61.71428571428572
2790197.0,6,2,132,1,66,0.0,66.0,66.0,1,66,0.0,66.0,66.0
68836.0,6,10,2032,5,524,14396.25,252.0,104.8,5,1508,16775.25,1236.0,301.6
56913.0,6,14,4740,7,653,9334.166666666666,249.0,93.28571428571428,7,4087,8221.166666666666,1514.0,583.8571428571429
1322.0,17,4,438,2,148,0.0,74.0,74.0,2,290,0.0,147.0,145.0
120160142.0,6,13,1898,5,882,30040035.5,204.0,176.4,8,1016,17136989.285714287,188.0,127.0
49328.0,6,14,4740,7,653,8096.333333333333,249.0,93.28571428571428,7,4087,7395.666666666667,1514.0,583.8571428571429
206494.0,6,3,426,2,280,0.0,214.0,140.0,1,146,0.0,146.0,146.0
93469110.0,6,40,2640,20,1320,4919426.842105263,66.0,66.0,20,1320,4903390.684210527,66.0,66.0
308012.0,6,6,412,4,272,102670.66666666669,74.0,68.0,2,140,0.0,74.0,70.0
1311124.0,6,4,264,2,132,0.0,66.0,66.0,2,132,0.0,66.0,66.0
146692.0,6,3,337,2,214,0.0,160.0,107.0,1,123,0.0,123.0,123.0
110267770.0,6,209,23602,105,7226,1060267.0192307692,140.0,68.81904761904762,104,16376,1060488.7281553398,284.0,157.46153846153845
217296.0,6,3,426,2,280,0.0,214.0,140.0,1,146,0.0,146.0,146.0
206335.0,6,3,426,2,280,0.0,214.0,140.0,1,146,0.0,146.0,146.0
312655.0,17,4,1400,4,1400,104218.33333333331,350.0,350.0,0,0,0.0,0.0,0.0
284572.0,17,2,363,1,79,0.0,79.0,79.0,1,284,0.0,284.0,284.0
2441.0,17,4,344,2,150,0.0,75.0,75.0,2,194,0.0,103.0,97.0
108114075.0,17,5,1005,5,1005,27028518.75,201.0,201.0,0,0,0.0,0.0,0.0
20027.0,6,2,145,2,145,0.0,91.0,72.5,0,0,0.0,0.0,0.0
120017.0,17,2,180,1,70,0.0,70.0,70.0,1,110,0.0,110.0,110.0
759200.0,6,10,1065,5,534,189254.5,262.0,106.8,5,531,188868.0,259.0,106.2
302513.0,6,6,412,4,272,100837.66666666669,74.0,68.0,2,140,0.0,74.0,70.0
10428.0,6,11,2098,6,590,1999.4,252.0,98.33333333333331,5,1508,1967.25,1236.0,301.6
0.0,6,1,160,1,160,0.0,160.0,160.0,0,0,0.0,0.0,0.0
10009.0,6,10,1066,5,490,2335.75,218.0,98.0,5,576,2161.0,304.0,115.2
246214.0,17,2,180,1,90,0.0,90.0,90.0,1,90,0.0,90.0,90.0
41652.0,6,10,2032,5,524,10167.25,252.0,104.8,5,1508,10086.75,1236.0,301.6
210314.0,6,3,426,2,280,0.0,214.0,140.0,1,146,0.0,146.0,146.0
143919.0,17,2,180,1,90,0.0,90.0,90.0,1,90,0.0,90.0,90.0
8402.0,17,2,582,1,83,0.0,83.0,83.0,1,499,0.0,499.0,499.0
114284851.0,6,33,2428,17,1288,7142803.1875,139.0,75.76470588235294,16,1140,7604574.8,123.0,71.25
120054599.0,17,28,13364,28,13364,4446466.62962963,501.0,477.2857142857143,0,0,0.0,0.0,0.0
16021.0,6,14,4740,7,653,2517.333333333333,249.0,93.28571428571428,7,4087,2514.1666666666665,1514.0,583.8571428571429
171537.0,17,2,180,1,90,0.0,90.0,90.0,1,90,0.0,90.0,90.0
108090196.0,17,5,1005,5,1005,27022549.0,201.0,201.0,0,0,0.0,0.0,0.0
39189.0,6,10,2032,5,524,9545.5,252.0,104.8,5,1508,9526.25,1236.0,301.6
319249.0,17,4,1400,4,1400,106416.33333333331,350.0,350.0,0,0,0.0,0.0,0.0
24414.0,6,14,4740,7,653,3877.1666666666665,249.0,93.28571428571428,7,4087,3927.5,1514.0,583.8571428571429
5004940.0,17,4,849,2,166,0.0,83.0,83.0,2,683,0.0,499.0,341.5
90290856.0,6,16,1192,8,596,12892586.42857143,95.0,74.5,8,596,12897759.42857143,95.0,74.5
2430.0,17,4,344,2,150,0.0,75.0,75.0,2,194,0.0,103.0,97.0
90091679.0,6,11,1644,4,816,30030192.0,204.0,204.0,7,828,15015096.0,188.0,118.28571428571428
101859.0,17,2,700,2,700,0.0,350.0,350.0,0,0,0.0,0.0,0.0
120055050.0,17,29,13785,29,13785,4287680.357142857,501.0,475.3448275862069,0,0,0.0,0.0,0.0
2820997.0,6,11,2106,6,598,564030.2,252.0,99.66666666666669,5,1508,2072.0,1236.0,301.6
104266759.0,6,202,22742,101,15780,1040515.89,284.0,156.23762376237624,101,6962,1040515.87,140.0,68.93069306930693
233955.0,6,3,337,2,214,0.0,160.0,107.0,1,123,0.0,123.0,123.0
24119.0,6,14,4740,7,653,3909.6666666666665,249.0,93.28571428571428,7,4087,3799.1666666666665,1514.0,583.8571428571429
28042.0,6,14,4740,7,653,4193.0,249.0,93.28571428571428,7,4087,4035.3333333333335,1514.0,583.8571428571429
2400.0,17,4,344,2,150,0.0,75.0,75.0,2,194,0.0,103.0,97.0
1479853.0,17,16,1120,16,1120,98656.86666666668,70.0,70.0,0,0,0.0,0.0,0.0
110471520.0,6,32,2305,16,1140,7364768.0,123.0,71.25,16,1165,7351013.333333333,139.0,72.8125
246620.0,6,3,337,2,214,0.0,160.0,107.0,1,123,0.0,123.0,123.0
54853.0,6,10,2032,5,524,13455.5,252.0,104.8,5,1508,13199.5,1236.0,301.6
331803.0,17,4,704,2,148,0.0,74.0,74.0,2,556,0.0,280.0,278.0
129011071.0,17,15,907,8,475,18430153.0,174.0,59.375,7,432,18166827.666666668,174.0,61.71428571428572
122470.0,6,14,4740,7,653,20161.5,249.0,93.28571428571428,7,4087,19853.33333333333,1514.0,583.8571428571429
301.0,17,2,156,1,78,0.0,78.0,78.0,1,78,0.0,78.0,78.0
1687499.0,6,23,6509,12,1529,153409.0,357.0,127.41666666666669,11,4980,138302.6,1510.0,452.7272727272728
15062.0,6,10,2032,5,524,3238.75,252.0,104.8,5,1508,3528.25,1236.0,301.6
1795743.0,6,7,499,3,198,818664.0,66.0,66.0,4,301,527498.6666666666,103.0,75.25
33288501.0,6,5,336,2,134,0.0,68.0,67.0,3,202,16577624.5,70.0,67.33333333333333
1430988.0,17,16,1120,16,1120,95399.2,70.0,70.0,0,0,0.0,0.0,0.0
113649838.0,6,34,2350,17,1225,7089601.0625,139.0,72.05882352941177,17,1125,7089611.9375,123.0,66.17647058823529
228293.0,17,2,180,1,90,0.0,90.0,90.0,1,90,0.0,90.0,90.0
304151.0,6,6,412,4,272,101383.66666666669,74.0,68.0,2,140,0.0,74.0,70.0
40512.0,6,12,1320,6,723,6732.8,253.0,120.5,6,597,5596.8,259.0,99.5
57845.0,6,14,4740,7,653,9507.333333333334,249.0,93.28571428571428,7,4087,8950.5,1514.0,583.8571428571429
308562.0,6,6,412,4,272,102854.0,74.0,68.0,2,140,0.0,74.0,70.0
217802.0,6,3,426,2,280,0.0,214.0,140.0,1,146,0.0,146.0,146.0
327.0,17,2,160,1,80,0.0,80.0,80.0,1,80,0.0,80.0,80.0
90019995.0,17,28,13364,28,13364,3334073.888888889,501.0,477.2857142857143,0,0,0.0,0.0,0.0
266788.0,17,4,1400,4,1400,88929.33333333333,350.0,350.0,0,0,0.0,0.0,0.0
301023.0,6,6,412,4,272,100341.0,74.0,68.0,2,140,0.0,74.0,70.0
120471667.0,6,24,1870,14,1125,9267051.307692308,95.0,80.35714285714286,10,745,10052998.555555556,95.0,74.5
306930.0,6,6,412,4,272,102310.0,74.0,68.0,2,140,0.0,74.0,70.0
21406.0,6,10,2032,5,524,5124.5,252.0,104.8,5,1508,4191.0,1236.0,301.6
118491677.0,17,16,1212,8,606,16857313.14285714,174.0,75.75,8,606,16858528.14285714,174.0,75.75
135132399.0,17,6,1146,6,1146,27026479.8,191.0,191.0,0,0,0.0,0.0,0.0
308161.0,6,6,412,4,272,102720.33333333331,74.0,68.0,2,140,0.0,74.0,70.0
20605.0,6,10,1067,5,536,4823.75,264.0,107.2,5,531,4346.75,259.0,106.2
206941.0,6,12,1373,7,714,34490.166666666664,298.0,102.0,5,659,50673.0,379.0,131.8
31314.0,6,20,7606,11,978,3131.4,310.0,88.9090909090909,9,6628,3636.875,1514.0,736.4444444444445
13691024.0,6,18,1495,9,921,1672752.25,315.0,102.33333333333331,9,574,1672720.125,78.0,63.77777777777778
2041.0,17,4,344,2,150,0.0,75.0,75.0,2,194,0.0,103.0,97.0
1180905.0,6,13,3010,8,2382,168700.7142857143,1514.0,297.75,5,628,226329.0,331.0,125.6
204716.0,17,3,1143,3,1143,102358.0,381.0,381.0,0,0,0.0,0.0,0.0
146282.0,6,3,373,2,238,0.0,172.0,119.0,1,135,0.0,135.0,135.0
56798.0,6,14,4740,7,653,9230.166666666666,249.0,93.28571428571428,7,4087,8846.833333333334,1514.0,583.8571428571429
26819.0,6,10,2032,5,524,5684.75,252.0,104.8,5,1508,6120.0,1236.0,301.6
2452.0,17,4,344,2,150,0.0,75.0,75.0,2,194,0.0,103.0,97.0
320.0,17,2,168,1,76,0.0,76.0,76.0,1,92,0.0,92.0,92.0
2583.0,17,4,344,2,150,0.0,75.0,75.0,2,194,0.0,103.0,97.0
107389.0,17,2,286,2,286,0.0,143.0,143.0,0,0,0.0,0.0,0.0
79762.0,6,14,4740,7,653,12748.5,249.0,93.28571428571428,7,4087,12699.5,1514.0,583.8571428571429
106441660.0,6,340,40364,170,28922,628496.4082840236,554.0,170.12941176470588,170,11442,628496.4201183432,140.0,67.30588235294118
24212637.0,17,5,1718,4,1368,696476.6666666666,342.0,342.0,1,350,0.0,350.0,350.0
1372413.0,6,4,492,2,280,0.0,214.0,140.0,2,212,0.0,146.0,106.0
302055.0,6,6,412,4,272,100685.0,74.0,68.0,2,140,0.0,74.0,70.0
476.0,17,2,508,2,508,0.0,257.0,254.0,0,0,0.0,0.0,0.0
1314521.0,6,4,264,2,132,0.0,66.0,66.0,2,132,0.0,66.0,66.0
41525.0,6,10,2032,5,524,9930.75,252.0,104.8,5,1508,9902.5,1236.0,301.6
120004723.0,6,20,1490,10,745,13333858.111111112,95.0,74.5,10,745,13305517.888888888,95.0,74.5
904.0,17,4,438,2,148,0.0,74.0,74.0,2,290,0.0,147.0,145.0
1773946.0,6,4,276,2,128,0.0,74.0,64.0,2,148,0.0,74.0,74.0
105274160.0,17,14,864,7,432,17500161.666666668,174.0,61.71428571428572,7,432,17500949.5,174.0,61.71428571428572
35353.0,6,10,2032,5,524,7548.0,252.0,104.8,5,1508,6420.25,1236.0,301.6
44062.0,6,14,4740,7,653,6598.166666666667,249.0,93.28571428571428,7,4087,5825.666666666667,1514.0,583.8571428571429
302432.0,6,2,132,1,66,0.0,66.0,66.0,1,66,0.0,66.0,66.0
33706658.0,6,5,336,2,134,0.0,68.0,67.0,3,202,16781260.0,70.0,67.33333333333333
111438213.0,6,47,3882,26,2127,4448885.4,123.0,81.8076923076923,21,1755,5561088.6,123.0,83.57142857142857
147129.0,6,3,337,2,214,0.0,160.0,107.0,1,123,0.0,123.0,123.0
2722664.0,6,3,1602,1,752,0.0,752.0,752.0,2,850,0.0,784.0,425.0
727348.0,6,14,4740,7,653,120963.33333333331,249.0,93.28571428571428,7,4087,120667.66666666669,1514.0,583.8571428571429
120125942.0,6,12,1832,8,1016,17136941.285714287,188.0,127.0,4,816,30032736.33333333,204.0,204.0
107237.0,17,2,700,2,700,0.0,350.0,350.0,0,0,0.0,0.0,0.0
38828.0,6,14,4740,7,653,6287.5,249.0,93.28571428571428,7,4087,5977.833333333333,1514.0,583.8571428571429
118039485.0,6,30,1974,15,1026,8415985.642857144,123.0,68.4,15,948,8415983.142857144,123.0,63.2
379086.0,6,10,1221,6,636,75817.2,298.0,106.0,4,585,122926.33333333331,379.0,146.25
257253.0,6,10,1221,6,636,51450.6,298.0,106.0,4,585,80017.33333333333,379.0,146.25
234963.0,6,3,373,2,238,0.0,172.0,119.0,1,135,0.0,135.0,135.0
397553.0,6,10,1221,6,636,79510.6,298.0,106.0,4,585,130999.0,379.0,146.25
90332158.0,6,20,1490,10,704,10031283.444444444,95.0,70.4,10,786,10036023.666666666,95.0,78.6
56424.0,6,14,4740,7,653,9285.333333333334,249.0,93.28571428571428,7,4087,8750.166666666666,1514.0,583.8571428571429
322120.0,6,6,412,4,272,107373.33333333331,74.0,68.0,2,140,0.0,74.0,70.0
121864.0,6,3,337,2,214,0.0,160.0,107.0,1,123,0.0,123.0,123.0
5725951.0,6,5,336,2,134,0.0,68.0,67.0,3,202,1524910.5,70.0,67.33333333333333
92879227.0,6,189,21334,95,6492,988076.8829787234,140.0,68.33684210526316,94,14842,987686.1720430108,300.0,157.89361702127658
299951.0,6,6,412,4,272,99983.66666666669,74.0,68.0,2,140,0.0,74.0,70.0
38391.0,6,14,4740,7,653,6272.166666666667,249.0,93.28571428571428,7,4087,6159.333333333333,1514.0,583.8571428571429
119890495.0,17,34,16284,34,16284,3633045.303030303,501.0,478.9411764705882,0,0,0.0,0.0,0.0
120354010.0,6,235,26594,118,18650,1028666.752136752,284.0,158.05084745762713,117,7944,1028591.525862069,140.0,67.8974358974359
40099.0,6,14,4740,7,653,6573.0,249.0,93.28571428571428,7,4087,6455.0,1514.0,583.8571428571429
108105377.0,17,5,955,5,955,27026344.25,191.0,191.0,0,0,0.0,0.0,0.0
4488.0,17,2,614,1,72,0.0,72.0,72.0,1,542,0.0,542.0,542.0
98281734.0,17,12,778,6,389,19624561.4,174.0,64.83333333333333,6,389,19595504.2,174.0,64.83333333333333
120420384.0,6,217,24596,109,17246,1115003.5555555555,284.0,158.22018348623854,108,7350,1115707.308411215,140.0,68.05555555555556
368130.0,6,3,204,1,68,0.0,68.0,68.0,2,136,0.0,70.0,68.0
53333.0,6,14,4740,7,653,8535.166666666666,249.0,93.28571428571428,7,4087,8250.0,1514.0,583.8571428571429
2719457.0,6,23,6506,12,1529,247223.36363636365,357.0,127.41666666666669,11,4977,241056.0,1510.0,452.45454545454544
404.0,17,2,762,2,762,0.0,381.0,381.0,0,0,0.0,0.0,0.0
90018283.0,17,28,13364,28,13364,3334010.4814814813,501.0,477.2857142857143,0,0,0.0,0.0,0.0
103530.0,17,2,286,2,286,0.0,143.0,143.0,0,0,0.0,0.0,0.0
29288409.0,6,26,7627,14,3735,203100.92307692303,1514.0,266.7857142857143,12,3892,2643952.090909091,1514.0,324.3333333333333
90262268.0,6,13,2036,8,1016,12894609.714285716,188.0,127.0,5,1020,22521446.0,204.0,204.0
12273.0,6,13,1459,7,862,1874.1666666666667,271.0,123.14285714285714,6,597,2302.0,259.0,99.5
317801.0,17,4,1400,4,1400,105933.66666666669,350.0,350.0,0,0,0.0,0.0,0.0
220751.0,17,2,180,1,90,0.0,90.0,90.0,1,90,0.0,90.0,90.0
113168189.0,6,46,3036,23,1518,5143997.090909091,66.0,66.0,23,1518,5143994.727272728,66.0,66.0
2327.0,17,4,344,2,150,0.0,75.0,75.0,2,194,0.0,103.0,97.0
228177.0,17,2,180,1,90,0.0,90.0,90.0,1,90,0.0,90.0,90.0
50360.0,6,14,4740,7,653,7957.5,249.0,93.28571428571428,7,4087,7763.5,1514.0,583.8571428571429
231855.0,17,6,1230,3,234,115739.0,78.0,78.0,3,996,115694.0,332.0,332.0
120111845.0,6,32,2226,17,1209,7506990.3125,123.0,71.11764705882354,15,1017,7851360.357142857,123.0,67.8
90257139.0,6,13,2036,8,1016,12893877.0,188.0,127.0,5,1020,22523444.25,204.0,204.0
120262526.0,6,289,33504,145,23778,835156.4305555555,284.0,163.98620689655172,144,9726,836181.013986014,140.0,67.54166666666667
108107556.0,17,5,1005,5,1005,27026889.0,201.0,201.0,0,0,0.0,0.0,0.0
118948765.0,6,34,2334,17,1209,7420797.375,123.0,71.11764705882354,17,1125,7420797.3125,123.0,66.17647058823529
44101.0,6,14,4740,7,653,7189.166666666667,249.0,93.28571428571428,7,4087,6644.666666666667,1514.0,583.8571428571429
6578.0,17,2,582,1,83,0.0,83.0,83.0,1,499,0.0,499.0,499.0
90257398.0,6,13,2036,8,1016,12893914.0,188.0,127.0,5,1020,22522868.25,204.0,204.0
4441.0,17,2,614,1,72,0.0,72.0,72.0,1,542,0.0,542.0,542.0
90300979.0,6,14,1043,7,542,15050163.166666666,95.0,77.42857142857143,7,501,14999313.833333334,95.0,71.57142857142857
2569.0,17,2,664,1,322,0.0,322.0,322.0,1,342,0.0,342.0,342.0
113469376.0,6,48,3168,24,1584,4933451.130434782,66.0,66.0,24,1584,4921466.478260869,66.0,66.0
323201.0,17,4,1400,4,1400,107733.66666666669,350.0,350.0,0,0,0.0,0.0,0.0
110474406.0,6,30,1990,15,1042,7875587.428571428,139.0,69.46666666666667,15,948,7875612.357142857,123.0,63.2
217943.0,6,4,492,2,280,0.0,214.0,140.0,2,212,0.0,146.0,106.0
94890343.0,6,181,20382,91,6228,1054337.1444444444,140.0,68.43956043956044,90,14154,1058427.2134831462,284.0,157.26666666666668
108105551.0,17,5,955,5,955,27026387.75,191.0,191.0,0,0,0.0,0.0,0.0
312184.0,6,6,412,4,272,104061.33333333331,74.0,68.0,2,140,0.0,74.0,70.0
4833.0,17,2,762,2,762,0.0,381.0,381.0,0,0,0.0,0.0,0.0
120115976.0,6,13,2020,9,1204,15014497.0,188.0,133.77777777777777,4,816,30029306.33333333,204.0,204.0
228172.0,17,2,180,1,90,0.0,90.0,90.0,1,90,0.0,90.0,90.0
12763.0,6,2,132,1,66,0.0,66.0,66.0,1,66,0.0,66.0,66.0
350.0,17,2,267,1,83,0.0,83.0,83.0,1,184,0.0,184.0,184.0
317126.0,17,4,1400,4,1400,105708.66666666669,350.0,350.0,0,0,0.0,0.0,0.0
1157438.0,6,13,3005,8,2377,165348.2857142857,1514.0,297.125,5,628,221042.75,331.0,125.6
928.0,17,4,438,2,148,0.0,74.0,74.0,2,290,0.0,147.0,145.0
42987.0,6,14,4740,7,653,6104.666666666667,249.0,93.28571428571428,7,4087,6093.5,1514.0,583.8571428571429
94.0,17,2,762,2,762,0.0,381.0,381.0,0,0,0.0,0.0,0.0
153483.0,17,2,180,1,90,0.0,90.0,90.0,1,90,0.0,90.0,90.0
158310.0,6,3,337,2,214,0.0,160.0,107.0,1,123,0.0,123.0,123.0
25360.0,6,14,4740,7,653,3704.6666666666665,249.0,93.28571428571428,7,4087,3927.6666666666665,1514.0,583.8571428571429
90091775.0,6,11,1644,7,828,15015295.833333334,188.0,118.28571428571428,4,816,20020742.0,204.0,204.0
110992734.0,6,32,2220,16,1149,7385125.666666667,123.0,71.8125,16,1071,7385122.8,123.0,66.9375
298688.0,6,6,412,4,272,99562.66666666669,74.0,68.0,2,140,0.0,74.0,70.0
90012882.0,17,28,13364,28,13364,3333810.4444444445,501.0,477.2857142857143,0,0,0.0,0.0,0.0
1450140.0,6,7,499,3,198,716319.0,66.0,66.0,4,301,456484.6666666667,103.0,75.25
61366.0,6,10,1066,5,490,13642.75,218.0,98.0,5,576,14433.0,304.0,115.2
2050.0,17,4,344,2,150,0.0,75.0,75.0,2,194,0.0,103.0,97.0
28328.0,6,10,2032,5,524,6858.25,252.0,104.8,5,1508,6777.25,1236.0,301.6
5933.0,17,2,180,1,90,0.0,90.0,90.0,1,90,0.0,90.0,90.0
135144142.0,17,6,1146,6,1146,27028828.4,191.0,191.0,0,0,0.0,0.0,0.0
107624961.0,6,202,22832,101,15870,1076249.61,284.0,157.12871287128712,101,6962,1073923.3,140.0,68.93069306930693
107865.0,17,2,286,2,286,0.0,143.0,143.0,0,0,0.0,0.0,0.0
103385.0,17,2,286,2,286,0.0,143.0,143.0,0,0,0.0,0.0,0.0
219996.0,6,3,426,2,280,0.0,214.0,140.0,1,146,0.0,146.0,146.0
120337528.0,17,14,864,7,432,19958170.166666668,174.0,61.71428571428572,7,432,20029766.0,174.0,61.71428571428572
57480.0,6,14,4740,7,653,9378.833333333334,249.0,93.28571428571428,7,4087,8714.5,1514.0,583.8571428571429
102873.0,17,2,286,2,286,0.0,143.0,143.0,0,0,0.0,0.0,0.0
301475.0,6,6,412,4,272,100491.66666666669,74.0,68.0,2,140,0.0,74.0,70.0
39891.0,6,14,4740,7,653,6073.0,249.0,93.28571428571428,7,4087,6513.166666666667,1514.0,583.8571428571429
46482.0,6,14,4740,7,653,6454.0,249.0,93.28571428571428,7,4087,6854.0,1514.0,583.8571428571429
90047374.0,17,28,13364,28,13364,3335087.925925926,501.0,477.2857142857143,0,0,0.0,0.0,0.0
112950982.0,6,32,2220,16,1149,7516439.466666667,123.0,71.8125,16,1071,7516437.533333333,123.0,66.9375
299790.0,6,6,412,4,272,99930.0,74.0,68.0,2,140,0.0,74.0,70.0
87746.0,6,14,4740,7,653,14369.833333333334,249.0,93.28571428571428,7,4087,14498.0,1514.0,583.8571428571429
315121.0,17,4,1400,4,1400,105040.33333333331,350.0,350.0,0,0,0.0,0.0,0.0
19124.0,6,14,4740,7,653,3022.333333333333,249.0,93.28571428571428,7,4087,3054.6666666666665,1514.0,583.8571428571429
50552.0,6,14,4740,7,653,8151.666666666667,249.0,93.28571428571428,7,4087,7897.0,1514.0,583.8571428571429
1574974.0,6,2,132,1,66,0.0,66.0,66.0,1,66,0.0,66.0,66.0
2073.0,17,4,344,2,150,0.0,75.0,75.0,2,194,0.0,103.0,97.0
67052.0,6,10,2032,5,524,16087.75,252.0,104.8,5,1508,16516.0,1236.0,301.6
319142.0,17,4,704,2,148,0.0,74.0,74.0,2,556,0.0,280.0,278.0
18483.0,6,14,4740,7,653,2971.6666666666665,249.0,93.28571428571428,7,4087,2943.5,1514.0,583.8571428571429
359.0,17,2,267,1,83,0.0,83.0,83.0,1,184,0.0,184.0,184.0
1026289.0,6,11,1134,6,558,205257.8,220.0,93.0,5,576,255805.0,304.0,115.2
2710745.0,6,20,6655,11,1672,271074.5,505.0,152.0,9,4983,290431.5,1510.0,553.6666666666666
20914.0,6,14,4740,7,653,3328.333333333333,249.0,93.28571428571428,7,4087,2979.0,1514.0,583.8571428571429
202568.0,17,2,180,1,90,0.0,90.0,90.0,1,90,0.0,90.0,90.0
31793.0,6,14,4740,7,653,5074.0,249.0,93.28571428571428,7,4087,5002.666666666667,1514.0,583.8571428571429
2002995.0,17,4,525,2,150,0.0,75.0,75.0,2,375,0.0,284.0,187.5
25979.0,6,14,4740,7,653,3775.3333333333335,249.0,93.28571428571428,7,4087,4152.333333333333,1514.0,583.8571428571429
125247230.0,6,35,2479,17,1194,7203827.0625,123.0,70.23529411764706,18,1285,7367395.176470588,139.0,71.38888888888889
1054330.0,6,11,1134,6,558,210866.0,220.0,93.0,5,576,260527.0,304.0,115.2
121953.0,6,3,337,2,214,0.0,160.0,107.0,1,123,0.0,123.0,123.0
90261730.0,6,14,1964,8,1016,12894532.857142856,188.0,127.0,6,948,18019675.6,204.0,158.0
90024004.0,17,28,13364,28,13364,3334222.3703703703,501.0,477.2857142857143,0,0,0.0,0.0,0.0
50516.0,6,10,2032,5,524,12314.5,252.0,104.8,5,1508,12240.5,1236.0,301.6
318.0,17,2,208,1,72,0.0,72.0,72.0,1,136,0.0,136.0,136.0
2500.0,17,2,762,2,762,0.0,381.0,381.0,0,0,0.0,0.0,0.0
300209.0,6,6,412,4,272,100069.66666666669,74.0,68.0,2,140,0.0,74.0,70.0
103872313.0,6,28,1860,14,966,7973574.153846154,123.0,69.0,14,894,7973563.0,123.0,63.85714285714285
1062008.0,6,3,1604,2,851,0.0,785.0,425.5,1,753,0.0,753.0,753.0
107001275.0,17,13,821,7,432,17833545.833333332,174.0,61.71428571428572,6,389,17401475.4,174.0,64.83333333333333
40427.0,6,10,2032,5,524,9871.5,252.0,104.8,5,1508,8801.75,1236.0,301.6
103867.0,17,2,286,2,286,0.0,143.0,143.0,0,0,0.0,0.0,0.0
55387.0,6,10,2032,5,524,13614.5,252.0,104.8,5,1508,11938.75,1236.0,301.6
315081.0,17,4,1400,4,1400,105027.0,350.0,350.0,0,0,0.0,0.0,0.0
108109082.0,17,5,955,5,955,27027270.5,191.0,191.0,0,0,0.0,0.0,0.0
47742.0,6,14,4740,7,653,7348.666666666667,249.0,93.28571428571428,7,4087,7678.833333333333,1514.0,583.8571428571429
54872.0,6,14,4740,7,653,8606.833333333334,249.0,93.28571428571428,7,4087,8908.5,1514.0,583.8571428571429
1036038.0,6,11,1134,6,558,207207.6,220.0,93.0,5,576,257838.5,304.0,115.2
135135745.0,17,6,1206,6,1206,27027149.0,201.0,201.0,0,0,0.0,0.0,0.0
121006496.0,17,15,907,8,475,17286642.285714287,174.0,59.375,7,432,16833495.0,174.0,61.71428571428572
108123319.0,17,5,955,5,955,27030829.75,191.0,191.0,0,0,0.0,0.0,0.0
281557.0,17,2,363,1,79,0.0,79.0,79.0,1,284,0.0,284.0,284.0
1379452.0,17,6,1230,3,234,689548.0,78.0,78.0,3,996,689517.5,332.0,332.0
23726.0,6,14,4740,7,653,3784.5,249.0,93.28571428571428,7,4087,3252.1666666666665,1514.0,583.8571428571429
29303.0,6,20,7606,11,978,2930.3,310.0,88.9090909090909,9,6628,3401.125,1514.0,736.4444444444445
26688.0,6,14,4740,7,653,3507.0,249.0,93.28571428571428,7,4087,4312.166666666667,1514.0,583.8571428571429
2459.0,17,2,762,2,762,0.0,381.0,381.0,0,0,0.0,0.0,0.0
56397.0,6,14,4740,7,653,8518.0,249.0,93.28571428571428,7,4087,8153.333333333333,1514.0,583.8571428571429
24300.0,6,11,2098,6,590,4860.0,252.0,98.33333333333331,5,1508,5284.25,1236.0,301.6
49067.0,6,14,4740,7,653,6911.833333333333,249.0,93.28571428571428,7,4087,7936.333333333333,1514.0,583.8571428571429
114353171.0,6,32,2220,16,1149,7609144.2,123.0,71.8125,16,1071,7609143.333333333,123.0,66.9375
90017688.0,17,28,13364,28,13364,3333988.4444444445,501.0,477.2857142857143,0,0,0.0,0.0,0.0
2374.0,17,4,344,2,150,0.0,75.0,75.0,2,194,0.0,103.0,97.0
96565178.0,17,14,1126,7,563,16000129.333333334,174.0,80.42857142857143,7,563,16002618.666666666,174.0,80.42857142857143
31958.0,6,10,2032,5,524,4436.5,252.0,104.8,5,1508,7666.75,1236.0,301.6
38059.0,6,14,4740,7,653,4393.833333333333,249.0,93.28571428571428,7,4087,5889.833333333333,1514.0,583.8571428571429
0.0,17,1,381,1,381,0.0,381.0,381.0,0,0,0.0,0.0,0.0
2205.0,17,4,344,2,150,0.0,75.0,75.0,2,194,0.0,103.0,97.0
438128.0,6,10,1221,6,636,87625.6,298.0,106.0,4,585,140648.33333333334,379.0,146.25
1170964.0,6,13,3003,8,2375,167280.57142857142,1514.0,296.875,5,628,223820.0,331.0,125.6
1156425.0,6,13,3011,8,2383,165203.57142857142,1514.0,297.875,5,628,220945.0,331.0,125.6
15599.0,6,11,1133,6,602,2243.8,264.0,100.33333333333331,5,531,3628.25,259.0,106.2
2796421.0,6,2,132,1,66,0.0,66.0,66.0,1,66,0.0,66.0,66.0
119.0,17,2,220,2,220,0.0,128.0,110.0,0,0,0.0,0.0,0.0
316963.0,17,4,1400,4,1400,105654.33333333331,350.0,350.0,0,0,0.0,0.0,0.0
120070340.0,17,29,13785,29,13785,4288226.428571428,501.0,475.3448275862069,0,0,0.0,0.0,0.0
111000951.0,17,14,864,7,432,18500158.5,174.0,61.71428571428572,7,432,18168400.83333333,174.0,61.71428571428572
502753.0,6,5,336,2,134,0.0,68.0,67.0,3,202,196980.0,70.0,67.33333333333333
90734449.0,6,30,2260,16,1228,6034578.8,139.0,76.75,14,1032,6962971.846153846,123.0,73.71428571428571
2490.0,17,4,344,2,150,0.0,75.0,75.0,2,194,0.0,103.0,97.0
206372.0,6,3,426,2,280,0.0,214.0,140.0,1,146,0.0,146.0,146.0
135134766.0,17,6,1146,6,1146,27026953.2,191.0,191.0,0,0,0.0,0.0,0.0
92841375.0,6,171,19288,86,5898,1092251.4705882352,140.0,68.5813953488372,85,13390,1092784.0833333333,284.0,157.52941176470588
90300967.0,6,16,1192,8,596,12893611.57142857,95.0,74.5,8,596,12899495.285714284,95.0,74.5
286818.0,17,2,359,1,75,0.0,75.0,75.0,1,284,0.0,284.0,284.0
221150.0,6,3,426,2,280,0.0,214.0,140.0,1,146,0.0,146.0,146.0
120000057.0,6,17,1287,9,691,15000007.125,95.0,76.77777777777777,8,596,12893668.57142857,95.0,74.5
22711.0,6,14,4740,7,653,3673.3333333333335,249.0,93.28571428571428,7,4087,3646.8333333333335,1514.0,583.8571428571429
16727.0,6,10,1949,5,441,3971.25,169.0,88.2,5,1508,3890.75,1236.0,301.6
153445.0,17,2,180,1,90,0.0,90.0,90.0,1,90,0.0,90.0,90.0
135126095.0,17,6,1206,6,1206,27025219.0,201.0,201.0,0,0,0.0,0.0,0.0
49217.0,6,14,4740,7,653,8028.0,249.0,93.28571428571428,7,4087,7773.5,1514.0,583.8571428571429
113804803.0,6,47,3102,24,1584,4936046.739130435,66.0,66.0,23,1518,5135469.318181818,66.0,66.0
114460269.0,17,14,864,7,432,19000870.5,174.0,61.71428571428572,7,432,19000157.83333333,174.0,61.71428571428572
19519.0,6,20,7606,11,978,1951.9,310.0,88.9090909090909,9,6628,1689.375,1514.0,736.4444444444445
2318.0,17,4,344,2,150,0.0,75.0,75.0,2,194,0.0,103.0,97.0
323.0,17,2,174,1,79,0.0,79.0,79.0,1,95,0.0,95.0,95.0
217738.0,6,3,426,2,280,0.0,214.0,140.0,1,146,0.0,146.0,146.0
9643.0,17,2,571,1,86,0.0,86.0,86.0,1,485,0.0,485.0,485.0
99293578.0,6,192,21712,96,15154,1042917.8315789474,300.0,157.85416666666666,96,6558,1042917.7789473684,140.0,68.3125
36441.0,6,14,4740,7,653,5368.5,249.0,93.28571428571428,7,4087,5907.333333333333,1514.0,583.8571428571429
328759.0,6,7,478,4,272,109586.33333333331,74.0,68.0,3,206,86255.5,74.0,68.66666666666667
118899486.0,6,35,2542,18,1348,6994087.411764706,139.0,74.88888888888889,17,1194,7417701.125,123.0,70.23529411764706
10911866.0,6,8,544,4,272,3592177.333333333,74.0,68.0,4,272,3592125.333333333,74.0,68.0
108108595.0,17,5,955,5,955,27027148.75,191.0,191.0,0,0,0.0,0.0,0.0
90293474.0,6,20,1531,11,840,9024253.8,95.0,76.36363636363636,9,691,11227580.125,95.0,76.77777777777777
3104691.0,17,4,1368,4,1368,1034897.0,342.0,342.0,0,0,0.0,0.0,0.0
116027.0,17,4,1400,4,1400,38675.66666666666,350.0,350.0,0,0,0.0,0.0,0.0
36771.0,6,14,4740,7,653,4117.833333333333,249.0,93.28571428571428,7,4087,5555.666666666667,1514.0,583.8571428571429
16081.000000000002,6,11,1132,6,556,3166.4,218.0,92.66666666666669,5,576,2948.0,304.0,115.2
345090.0,17,4,704,2,148,0.0,74.0,74.0,2,556,0.0,280.0,278.0
19560.0,6,11,2098,6,590,3801.8,252.0,98.33333333333331,5,1508,4659.75,1236.0,301.6
55977.0,6,14,4740,7,653,9155.5,249.0,93.28571428571428,7,4087,7370.5,1514.0,583.8571428571429
1348.0,17,5,550,5,550,337.0,110.0,110.0,0,0,0.0,0.0,0.0
127224076.0,17,14,864,7,432,18000207.333333332,174.0,61.71428571428572,7,432,19913419.5,174.0,61.71428571428572
103825.0,17,2,286,2,286,0.0,143.0,143.0,0,0,0.0,0.0,0.0
108553019.0,6,43,2838,22,1452,5169170.333333333,66.0,66.0,21,1386,5160012.6,66.0,66.0
107519.0,17,2,286,2,286,0.0,143.0,143.0,0,0,0.0,0.0,0.0
255345.0,6,3,337,2,214,0.0,160.0,107.0,1,123,0.0,123.0,123.0
120122023.0,6,14,2224,9,1204,15015252.875,188.0,133.77777777777777,5,1020,22531055.5,204.0,204.0
108098287.0,17,5,955,5,955,27024571.75,191.0,191.0,0,0,0.0,0.0,0.0
50899.0,17,2,180,1,90,0.0,90.0,90.0,1,90,0.0,90.0,90.0
208567.0,6,3,426,2,280,0.0,214.0,140.0,1,146,0.0,146.0,146.0
119646015.0,6,224,25324,112,17624,1075953.054054054,284.0,157.35714285714286,112,7700,1075953.2882882883,140.0,68.75
113222887.0,6,189,21286,95,6492,1204498.7978723403,140.0,68.33684210526316,94,14794,1206421.5161290322,284.0,157.38297872340425
313110.0,6,6,412,4,272,104370.0,74.0,68.0,2,140,0.0,74.0,70.0
3006464.0,6,11,2106,6,598,600632.6,252.0,99.66666666666669,5,1508,2642.0,1236.0,301.6
499640.0,6,5,336,2,134,0.0,68.0,67.0,3,202,186938.5,70.0,67.33333333333333
44137.0,6,10,2032,5,524,9902.0,252.0,104.8,5,1508,10170.0,1236.0,301.6
90281642.0,6,16,1192,8,596,12890379.57142857,95.0,74.5,8,596,12896386.142857144,95.0,74.5
320.0,17,2,174,1,79,0.0,79.0,79.0,1,95,0.0,95.0,95.0
114772155.0,6,48,3168,24,1584,4990093.695652174,66.0,66.0,24,1584,4976665.347826087,66.0,66.0
145900.0,17,2,363,1,75,0.0,75.0,75.0,1,288,0.0,288.0,288.0
107984.0,17,2,286,2,286,0.0,143.0,143.0,0,0,0.0,0.0,0.0
281684.0,17,2,363,1,79,0.0,79.0,79.0,1,284,0.0,284.0,284.0
107963.0,17,2,286,2,286,0.0,143.0,143.0,0,0,0.0,0.0,0.0
234051.0,6,3,337,2,214,0.0,160.0,107.0,1,123,0.0,123.0,123.0
36401.0,6,14,4740,7,653,5409.5,249.0,93.28571428571428,7,4087,5842.666666666667,1514.0,583.8571428571429
205807.0,17,2,180,1,90,0.0,90.0,90.0,1,90,0.0,90.0,90.0
17444937.0,6,25,8741,14,1785,1341918.2307692308,408.0,127.5,11,6956,1336186.7,1514.0,632.3636363636364
8741383.0,6,5,1736,2,819,0.0,753.0,409.5,3,917,4304218.5,785.0,305.6666666666667
27017296.0,17,5,1710,5,1710,6754324.0,342.0,342.0,0,0,0.0,0.0,0.0
1970.0,17,2,180,1,90,0.0,90.0,90.0,1,90,0.0,90.0,90.0
47609989.0,6,8,1940,3,887,22562942.0,753.0,295.6666666666667,5,1053,11206950.75,785.0,210.6
2115.0,17,4,344,2,150,0.0,75.0,75.0,2,194,0.0,103.0,97.0
4431.0,17,2,626,1,72,0.0,72.0,72.0,1,554,0.0,554.0,554.0
315109.0,17,4,1400,4,1400,105036.33333333331,350.0,350.0,0,0,0.0,0.0,0.0
869.0,17,2,508,2,508,0.0,257.0,254.0,0,0,0.0,0.0,0.0
50764.0,17,2,180,1,90,0.0,90.0,90.0,1,90,0.0,90.0,90.0
250108.0,17,4,6056,4,6056,83369.33333333333,1514.0,1514.0,0,0,0.0,0.0,0.0
5005321.0,17,4,849,2,166,0.0,83.0,83.0,2,683,0.0,499.0,341.5
2788344.0,6,2,132,1,66,0.0,66.0,66.0,1,66,0.0,66.0,66.0
441403.0,17,2,363,1,79,0.0,79.0,79.0,1,284,0.0,284.0,284.0
41120.0,6,14,4740,7,653,6434.666666666667,249.0,93.28571428571428,7,4087,6504.666666666667,1514.0,583.8571428571429
90527267.0,6,13,2036,8,1016,12932466.714285716,188.0,127.0,5,1020,22591344.25,204.0,204.0
108105993.0,17,5,955,5,955,27026498.25,191.0,191.0,0,0,0.0,0.0,0.0
41448.0,6,10,2032,5,524,9814.5,252.0,104.8,5,1508,7895.5,1236.0,301.6
321636.0,6,6,412,4,272,107212.0,74.0,68.0,2,140,0.0,74.0,70.0
119263268.0,17,34,16284,34,16284,3614038.424242424,501.0,478.9411764705882,0,0,0.0,0.0,0.0
5846803.0,6,4,270,2,134,0.0,68.0,67.0,2,136,0.0,70.0,68.0
34459.0,6,10,2032,5,524,8395.0,252.0,104.8,5,1508,8191.25,1236.0,301.6
207215.0,6,3,426,2,280,0.0,214.0,140.0,1,146,0.0,146.0,146.0
255100.0,6,3,337,2,214,0.0,160.0,107.0,1,123,0.0,123.0,123.0
284805.0,17,2,363,1,79,0.0,79.0,79.0,1,284,0.0,284.0,284.0
41795.0,6,14,4740,7,653,6387.666666666667,249.0,93.28571428571428,7,4087,5634.833333333333,1514.0,583.8571428571429
301843.0,6,6,412,4,272,100614.33333333331,74.0,68.0,2,140,0.0,74.0,70.0
1751704.0,6,19,7533,10,1403,194633.7777777777,583.0,140.3,9,6130,187541.25,1484.0,681.1111111111111
177088.0,6,10,2032,5,524,42756.75,252.0,104.8,5,1508,43648.25,1236.0,301.6
106005362.0,17,13,821,7,432,17667560.333333332,174.0,61.71428571428572,6,389,17200165.6,174.0,64.83333333333333
109107794.0,6,430,57692,215,14486,509759.2990654206,140.0,67.37674418604651,215,43206,506539.42990654206,570.0,200.9581395348837
91296475.0,6,880,228916,454,199912,201537.472406181,1514.0,440.3348017621145,426,29004,214278.5247058824,214.0,68.08450704225352
44929.0,6,10,2032,5,524,10988.0,252.0,104.8,5,1508,10261.25,1236.0,301.6
124710.0,6,12,1320,7,789,20785.0,253.0,112.71428571428572,5,531,29107.5,259.0,106.2
115720218.0,6,48,3168,24,1584,5031313.826086956,66.0,66.0,24,1584,5019318.304347826,66.0,66.0
108108979.0,17,5,955,5,955,27027244.75,191.0,191.0,0,0,0.0,0.0,0.0
206265.0,17,2,762,2,762,0.0,381.0,381.0,0,0,0.0,0.0,0.0
142850.0,6,2,132,1,66,0.0,66.0,66.0,1,66,0.0,66.0,66.0
245869.0,6,3,373,2,238,0.0,172.0,119.0,1,135,0.0,135.0,135.0
209466.0,6,3,426,2,280,0.0,214.0,140.0,1,146,0.0,146.0,146.0
110959401.0,6,32,2236,16,1165,7382891.466666667,139.0,72.8125,16,1071,7382893.066666666,123.0,66.9375
276894.0,6,10,1221,6,636,55378.8,298.0,106.0,4,585,86422.66666666667,379.0,146.25
90007539.0,17,28,13364,28,13364,3333612.5555555555,501.0,477.2857142857143,0,0,0.0,0.0,0.0
209474.0,17,2,180,1,90,0.0,90.0,90.0,1,90,0.0,90.0,90.0
135134864.0,17,6,1146,6,1146,27026972.8,191.0,191.0,0,0,0.0,0.0,0.0
1180542.0,6,13,3010,8,2382,168648.85714285713,1514.0,297.75,5,628,226200.25,331.0,125.6
33950.0,6,14,4740,7,653,5531.333333333333,249.0,93.28571428571428,7,4087,5145.0,1514.0,583.8571428571429
970092.0,17,10,3744,10,3744,107788.0,390.0,374.4,0,0,0.0,0.0,0.0
118244090.0,17,14,864,7,432,19667598.666666668,174.0,61.71428571428572,7,432,19666823.0,174.0,61.71428571428572
338026.0,17,2,180,1,90,0.0,90.0,90.0,1,90,0.0,90.0,90.0
323000.0,17,4,1400,4,1400,107666.66666666669,350.0,350.0,0,0,0.0,0.0,0.0
254268.0,17,4,6056,4,6056,84755.99999999999,1514.0,1514.0,0,0,0.0,0.0,0.0
135128194.0,17,6,1146,6,1146,27025638.8,191.0,191.0,0,0,0.0,0.0,0.0
331.0,17,2,174,1,79,0.0,79.0,79.0,1,95,0.0,95.0,95.0
100380.0,6,14,4740,7,653,16027.333333333334,249.0,93.28571428571428,7,4087,15686.666666666666,1514.0,583.8571428571429
237407.0,17,2,180,1,90,0.0,90.0,90.0,1,90,0.0,90.0,90.0
153430.0,17,2,180,1,90,0.0,90.0,90.0,1,90,0.0,90.0,90.0
153519.0,17,2,180,1,90,0.0,90.0,90.0,1,90,0.0,90.0,90.0
90303198.0,6,21,1585,11,840,9024319.6,95.0,76.36363636363636,10,745,10002380.888888888,95.0,74.5
309961.0,6,6,412,4,272,103320.33333333331,74.0,68.0,2,140,0.0,74.0,70.0
1778657.0,6,23,6507,12,1529,159577.81818181818,357.0,127.41666666666669,11,4978,146857.8,1510.0,452.54545454545456
301738.0,6,6,412,4,272,100579.33333333331,74.0,68.0,2,140,0.0,74.0,70.0
889.0,17,5,550,5,550,222.25,110.0,110.0,0,0,0.0,0.0,0.0
72882.0,6,10,2032,5,524,17825.5,252.0,104.8,5,1508,16066.0,1236.0,301.6
148347.0,17,2,414,1,88,0.0,88.0,88.0,1,326,0.0,326.0,326.0
11647.0,6,13,1459,7,862,1831.6666666666667,271.0,123.14285714285714,6,597,2064.8,259.0,99.5
45903.0,6,14,4740,7,653,7522.5,249.0,93.28571428571428,7,4087,7461.333333333333,1514.0,583.8571428571429
90025651.0,17,28,13364,28,13364,3334283.3703703703,501.0,477.2857142857143,0,0,0.0,0.0,0.0
345309.0,6,6,412,4,272,115103.0,74.0,68.0,2,140,0.0,74.0,70.0
108108725.0,17,5,1005,5,1005,27027181.25,201.0,201.0,0,0,0.0,0.0,0.0
147072.0,6,3,373,2,238,0.0,172.0,119.0,1,135,0.0,135.0,135.0
2462183.0,6,25,7573,14,3735,189398.6923076923,1514.0,266.7857142857143,11,3838,217978.9,1514.0,348.90909090909093
24236.0,17,4,823,2,163,0.0,89.0,81.5,2,660,0.0,443.0,330.0
120025527.0,17,29,13785,29,13785,4286625.964285715,501.0,475.3448275862069,0,0,0.0,0.0,0.0
3012842.0,6,11,2106,6,598,602385.6,252.0,99.66666666666669,5,1508,4596.5,1236.0,301.6
127661294.0,17,16,1343,8,606,17000166.85714286,174.0,75.75,8,737,15388971.42857143,174.0,92.125
29472.0,6,14,4740,7,653,4788.666666666667,249.0,93.28571428571428,7,4087,4771.833333333333,1514.0,583.8571428571429
90596732.0,6,14,2240,8,1016,12942390.285714284,188.0,127.0,6,1224,18073068.0,204.0,204.0
22811.0,6,14,4740,7,653,3630.1666666666665,249.0,93.28571428571428,7,4087,3574.333333333333,1514.0,583.8571428571429
93824.0,17,4,1400,4,1400,31274.666666666668,350.0,350.0,0,0,0.0,0.0,0.0
90040654.0,17,28,13364,28,13364,3334839.037037037,501.0,477.2857142857143,0,0,0.0,0.0,0.0
10490434.0,6,7,478,4,272,3451471.333333333,74.0,68.0,3,206,5177067.0,74.0,68.66666666666667
41725.0,6,14,4740,7,653,6252.0,249.0,93.28571428571428,7,4087,6283.5,1514.0,583.8571428571429
245523.0,6,3,337,2,214,0.0,160.0,107.0,1,123,0.0,123.0,123.0
108095464.0,17,5,955,5,955,27023866.0,191.0,191.0,0,0,0.0,0.0,0.0
100598045.0,6,31,2245,16,1140,6706536.333333333,123.0,71.25,15,1105,7170063.571428572,139.0,73.66666666666667
146232.0,6,3,337,2,214,0.0,160.0,107.0,1,123,0.0,123.0,123.0
105837557.0,6,44,2904,22,1452,5039883.666666667,66.0,66.0,22,1452,5024917.142857143,66.0,66.0
108097169.0,17,5,1005,5,1005,27024292.25,201.0,201.0,0,0,0.0,0.0,0.0
119934499.0,17,35,16705,35,16705,3527485.2647058824,501.0,477.2857142857143,0,0,0.0,0.0,0.0
207662.0,6,3,426,2,280,0.0,214.0,140.0,1,146,0.0,146.0,146.0
33604781.0,6,5,336,2,134,0.0,68.0,67.0,3,202,15462066.5,70.0,67.33333333333333
206320.0,6,3,426,2,280,0.0,214.0,140.0,1,146,0.0,146.0,146.0
69961.0,6,12,1320,7,789,11660.166666666666,253.0,112.71428571428572,5,531,14915.0,259.0,106.2
207878.0,6,10,1221,6,636,41575.6,298.0,106.0,4,585,68430.66666666667,379.0,146.25
17576.0,6,10,2032,5,524,3926.5,252.0,104.8,5,1508,3913.0,1236.0,301.6
2370.0,17,4,344,2,150,0.0,75.0,75.0,2,194,0.0,103.0,97.0
2591913.0,6,2,132,1,66,0.0,66.0,66.0,1,66,0.0,66.0,66.0
50968.0,17,2,180,1,90,0.0,90.0,90.0,1,90,0.0,90.0,90.0
1712848.0,6,22,6443,12,1529,155713.45454545456,357.0,127.41666666666669,10,4914,156258.66666666666,1510.0,491.4
263626.0,6,10,1221,6,636,52725.2,298.0,106.0,4,585,81877.66666666667,379.0,146.25
96552695.0,17,14,1126,7,563,15834175.5,174.0,80.42857142857143,7,563,16000141.0,174.0,80.42857142857143
272633.0,6,3,337,2,214,0.0,160.0,107.0,1,123,0.0,123.0,123.0
201931.0,17,2,762,2,762,0.0,381.0,381.0,0,0,0.0,0.0,0.0
0.0,17,1,381,1,381,0.0,381.0,381.0,0,0,0.0,0.0,0.0
346.0,17,2,267,1,83,0.0,83.0,83.0,1,184,0.0,184.0,184.0
90023446.0,17,27,12943,27,12943,3462440.230769231,501.0,479.3703703703704,0,0,0.0,0.0,0.0
153387.0,17,2,180,1,90,0.0,90.0,90.0,1,90,0.0,90.0,90.0
325.0,17,2,160,1,80,0.0,80.0,80.0,1,80,0.0,80.0,80.0
217746.0,6,3,426,2,280,0.0,214.0,140.0,1,146,0.0,146.0,146.0
146229.0,6,3,337,2,214,0.0,160.0,107.0,1,123,0.0,123.0,123.0
300145.0,6,6,412,4,272,100048.33333333331,74.0,68.0,2,140,0.0,74.0,70.0
2296.0,17,4,344,2,150,0.0,75.0,75.0,2,194,0.0,103.0,97.0
10505207.0,6,7,478,4,272,3456379.0,74.0,68.0,3,206,5184447.0,74.0,68.66666666666667
5622805.0,6,4,270,2,134,0.0,68.0,67.0,2,136,0.0,70.0,68.0
25512.0,6,10,2032,5,524,5709.25,252.0,104.8,5,1508,6040.75,1236.0,301.6
16953.0,6,20,7606,11,978,1695.3,310.0,88.9090909090909,9,6628,1832.5,1514.0,736.4444444444445
2349.0,17,4,344,2,150,0.0,75.0,75.0,2,194,0.0,103.0,97.0
90257578.0,6,12,1832,8,1016,12893939.714285716,188.0,127.0,4,816,30031592.0,204.0,204.0
284499.0,17,4,704,2,148,0.0,74.0,74.0,2,556,0.0,280.0,278.0
110752696.0,6,219,24818,110,7556,1016079.7798165138,140.0,68.69090909090909,109,17262,1022197.3148148148,284.0,158.36697247706422
107205.0,17,2,286,2,286,0.0,143.0,143.0,0,0,0.0,0.0,0.0
10485579.0,6,7,478,4,272,3449694.6666666665,74.0,68.0,3,206,5174448.5,74.0,68.66666666666667
111760535.0,6,842,177672,429,149748,261122.7453271028,1514.0,349.06293706293707,413,27924,270963.8883495146,214.0,67.61259079903148
147422.0,6,3,337,2,214,0.0,160.0,107.0,1,123,0.0,123.0,123.0
153442.0,17,2,180,1,90,0.0,90.0,90.0,1,90,0.0,90.0,90.0
137063.0,17,4,344,2,150,0.0,75.0,75.0,2,194,0.0,103.0,97.0
250416.00000000003,6,3,337,2,214,0.0,160.0,107.0,1,123,0.0,123.0,123.0
228258.0,17,2,180,1,90,0.0,90.0,90.0,1,90,0.0,90.0,90.0
51697.0,6,10,2032,5,524,12678.5,252.0,104.8,5,1508,12607.0,1236.0,301.6
148293.0,17,2,414,1,88,0.0,88.0,88.0,1,326,0.0,326.0,326.0
763.0,17,4,438,2,148,0.0,74.0,74.0,2,290,0.0,147.0,145.0
207104.0,6,3,426,2,280,0.0,214.0,140.0,1,146,0.0,146.0,146.0
491.0,17,2,508,2,508,0.0,257.0,254.0,0,0,0.0,0.0,0.0
156282.0,6,3,337,2,214,0.0,160.0,107.0,1,123,0.0,123.0,123.0
16657682.000000002,6,8,602,5,404,3210628.0,103.0,80.8,3,198,2057711.0,66.0,66.0
2089.0,17,4,344,2,150,0.0,75.0,75.0,2,194,0.0,103.0,97.0
90260964.0,6,15,2444,8,1016,12894423.42857143,188.0,127.0,7,1428,15013877.833333334,204.0,204.0
210622.0,6,3,426,2,280,0.0,214.0,140.0,1,146,0.0,146.0,146.0
123475875.0,6,48,3168,24,1584,5064618.826086956,66.0,66.0,24,1584,5244945.173913044,66.0,66.0
48947532.0,6,7,2047,5,1153,12236883.0,885.0,230.6,2,894,0.0,826.0,447.0
322.0,17,2,174,1,79,0.0,79.0,79.0,1,95,0.0,95.0,95.0
8391.0,6,10,2032,5,524,1760.5,252.0,104.8,5,1508,1846.5,1236.0,301.6
117146040.0,6,48,3168,24,1584,5093306.0869565215,66.0,66.0,24,1584,5083904.478260869,66.0,66.0
8589.0,17,2,582,1,83,0.0,83.0,83.0,1,499,0.0,499.0,499.0
1242959.0,6,7,499,4,301,393550.0,103.0,75.25,3,198,613899.5,66.0,66.0
301708.0,6,6,412,4,272,100569.33333333331,74.0,68.0,2,140,0.0,74.0,70.0
0.0,17,1,72,1,72,0.0,72.0,72.0,0,0,0.0,0.0,0.0
110015691.0,6,32,2236,16,1165,7319988.266666667,139.0,72.8125,16,1071,7319989.733333333,123.0,66.9375
120118211.0,6,234,26438,117,7944,1029527.2068965518,140.0,67.8974358974359,117,18494,1028423.1724137932,284.0,158.06837606837607
316.0,17,2,174,1,79,0.0,79.0,79.0,1,95,0.0,95.0,95.0
327394.0,17,4,1400,4,1400,109131.33333333331,350.0,350.0,0,0,0.0,0.0,0.0
10441970.0,6,6,412,3,206,5153124.0,74.0,68.66666666666667,3,206,5153007.5,74.0,68.66666666666667
36827.0,6,13,1386,7,789,6028.833333333333,253.0,112.71428571428572,6,597,5099.6,259.0,99.5
111728950.0,6,27,2953,14,1502,8593355.23076923,425.0,107.28571428571428,13,1451,9272629.583333334,335.0,111.6153846153846
438873.0,6,11,1021,6,444,59025.8,162.0,74.0,5,577,73657.75,349.0,115.4
47611181.0,6,8,1940,3,887,22788571.5,753.0,295.6666666666667,5,1053,11259823.75,785.0,210.6
303.0,17,2,164,1,82,0.0,82.0,82.0,1,82,0.0,82.0,82.0
218222.0,6,3,426,2,280,0.0,214.0,140.0,1,146,0.0,146.0,146.0
107628.0,17,2,286,2,286,0.0,143.0,143.0,0,0,0.0,0.0,0.0
90206397.0,6,19,1436,9,691,11244112.625,95.0,76.77777777777777,10,745,9998824.0,95.0,74.5
10427489.0,6,7,478,4,272,3430418.333333333,74.0,68.0,3,206,5145529.0,74.0,68.66666666666667
2337.0,17,4,344,2,150,0.0,75.0,75.0,2,194,0.0,103.0,97.0
1314373.0,6,4,264,2,132,0.0,66.0,66.0,2,132,0.0,66.0,66.0
100006179.0,17,12,778,6,389,20001235.8,174.0,64.83333333333333,6,389,16000126.4,174.0,64.83333333333333
35230.0,6,10,2032,5,524,7407.25,252.0,104.8,5,1508,8063.25,1236.0,301.6
105211.0,17,2,286,2,286,0.0,143.0,143.0,0,0,0.0,0.0,0.0
307103.0,6,6,412,4,272,102367.66666666669,74.0,68.0,2,140,0.0,74.0,70.0
31467.000000000004,6,14,4740,7,653,4508.833333333333,249.0,93.28571428571428,7,4087,4991.5,1514.0,583.8571428571429
101685.0,17,2,286,2,286,0.0,143.0,143.0,0,0,0.0,0.0,0.0
0.0,17,1,55,1,55,0.0,55.0,55.0,0,0,0.0,0.0,0.0
90294750.0,6,21,1746,11,1001,9024851.9,256.0,91.0,10,745,10031603.555555556,95.0,74.5
36950.0,6,10,2032,5,524,8981.75,252.0,104.8,5,1508,8729.25,1236.0,301.6
213642.0,17,2,180,1,90,0.0,90.0,90.0,1,90,0.0,90.0,90.0
303181.0,6,2,132,1,66,0.0,66.0,66.0,1,66,0.0,66.0,66.0
9353.0,17,2,582,1,83,0.0,83.0,83.0,1,499,0.0,499.0,499.0
5686265.0,6,104,102681,31,2212,189542.16666666663,212.0,71.35483870967742,73,100469,78791.94444444444,1514.0,1376.2876712328766
119581142.0,17,35,16705,35,16705,3517092.411764706,501.0,477.2857142857143,0,0,0.0,0.0,0.0
76800.0,6,11,2098,6,590,15281.6,252.0,98.33333333333331,5,1508,18678.5,1236.0,301.6
1566098.0,6,2,132,1,66,0.0,66.0,66.0,1,66,0.0,66.0,66.0
113520404.0,6,46,3036,23,1518,5160006.681818182,66.0,66.0,23,1518,5160007.136363637,66.0,66.0
14505.0,6,10,1066,5,490,2677.75,218.0,98.0,5,576,3279.0,304.0,115.2
196869.0,17,2,180,1,90,0.0,90.0,90.0,1,90,0.0,90.0,90.0
27200521.0,17,5,1710,5,1710,6800130.25,342.0,342.0,0,0,0.0,0.0,0.0
2498.0,17,2,180,1,90,0.0,90.0,90.0,1,90,0.0,90.0,90.0
90280004.0,6,13,2036,8,1016,12897143.42857143,188.0,127.0,5,1020,22529799.0,204.0,204.0
206255.0,17,2,762,2,762,0.0,381.0,381.0,0,0,0.0,0.0,0.0
2044.0,17,2,664,1,322,0.0,322.0,322.0,1,342,0.0,342.0,342.0
1104029.0,6,13,1386,7,789,184004.8333333333,253.0,112.71428571428572,6,597,219175.2,259.0,99.5
153461.0,17,2,180,1,90,0.0,90.0,90.0,1,90,0.0,90.0,90.0
4509.0,17,2,626,1,72,0.0,72.0,72.0,1,554,0.0,554.0,554.0
135129469.0,17,6,1146,6,1146,27025893.8,191.0,191.0,0,0,0.0,0.0,0.0
321073.0,6,6,412,4,272,107024.33333333331,74.0,68.0,2,140,0.0,74.0,70.0
436290.0,6,11,1021,6,444,58542.6,162.0,74.0,5,577,73010.75,349.0,115.4
2369.0,17,4,344,2,150,0.0,75.0,75.0,2,194,0.0,103.0,97.0
117821905.0,6,33,2280,17,1209,7350367.0625,123.0,71.11764705882354,16,1071,7840391.466666667,123.0,66.9375
149101694.0,6,22,1767,12,894,13554699.454545457,95.0,74.5,10,873,13262648.555555556,223.0,87.3
50891.0,17,2,180,1,90,0.0,90.0,90.0,1,90,0.0,90.0,90.0
47713054.0,6,7,1872,3,886,22792832.0,752.0,295.3333333333333,4,986,15015913.0,784.0,246.5
39441.0,6,14,4740,7,653,6021.166666666667,249.0,93.28571428571428,7,4087,6441.5,1514.0,583.8571428571429
44833672.0,6,6,1808,4,987,14944557.333333334,785.0,246.75,2,821,0.0,753.0,410.5
104068973.0,17,14,864,7,432,17167555.333333332,174.0,61.71428571428572,7,432,17333492.5,174.0,61.71428571428572
2406.0,17,4,344,2,150,0.0,75.0,75.0,2,194,0.0,103.0,97.0
430.0,17,2,166,1,75,0.0,75.0,75.0,1,91,0.0,91.0,91.0
5831599.0,6,5,336,2,134,0.0,68.0,67.0,3,202,1524964.0,70.0,67.33333333333333
120014255.0,6,19,1436,10,786,13333331.666666666,95.0,78.6,9,650,14881319.125,95.0,72.22222222222223
207618.0,6,3,426,2,280,0.0,214.0,140.0,1,146,0.0,146.0,146.0
468.0,17,2,160,1,80,0.0,80.0,80.0,1,80,0.0,80.0,80.0
110537435.0,6,32,2220,16,1149,7369162.333333333,123.0,71.8125,16,1071,7354742.066666666,123.0,66.9375
400995.0,17,2,876,2,876,0.0,438.0,438.0,0,0,0.0,0.0,0.0
90017079.0,17,27,12943,27,12943,3462195.346153846,501.0,479.3703703703704,0,0,0.0,0.0,0.0
120068903.0,17,28,13364,28,13364,4446996.407407408,501.0,477.2857142857143,0,0,0.0,0.0,0.0
24908.0,6,10,2032,5,524,6013.25,252.0,104.8,5,1508,5408.75,1236.0,301.6
4604.0,17,2,180,1,90,0.0,90.0,90.0,1,90,0.0,90.0,90.0
2661865.0,6,25,7573,14,3735,204758.84615384616,1514.0,266.7857142857143,11,3838,239870.7,1514.0,348.90909090909093
228231.0,17,2,180,1,90,0.0,90.0,90.0,1,90,0.0,90.0,90.0
542.0,17,2,508,2,508,0.0,257.0,254.0,0,0,0.0,0.0,0.0
105863.0,17,2,700,2,700,0.0,350.0,350.0,0,0,0.0,0.0,0.0
3547.0,17,4,344,2,150,0.0,75.0,75.0,2,194,0.0,103.0,97.0
14461.0,6,11,1132,6,556,2733.2,218.0,92.66666666666669,5,576,2828.25,304.0,115.2
16313.000000000002,6,10,2032,5,524,3725.5,252.0,104.8,5,1508,3817.0,1236.0,301.6
90669008.0,6,22,1680,10,745,10047878.222222222,95.0,74.5,12,935,8224046.272727272,95.0,77.91666666666667
103619.0,17,2,286,2,286,0.0,143.0,143.0,0,0,0.0,0.0,0.0
90257281.0,6,15,2444,8,1016,12893897.285714284,188.0,127.0,7,1428,15015485.166666666,204.0,204.0
90256161.0,6,12,1832,8,1016,12893737.285714284,188.0,127.0,4,816,30029908.33333333,204.0,204.0
1175736.0,6,11,1134,6,558,235147.2,220.0,93.0,5,576,292660.75,304.0,115.2
335.0,17,2,267,1,83,0.0,83.0,83.0,1,184,0.0,184.0,184.0
181570.0,17,2,180,1,90,0.0,90.0,90.0,1,90,0.0,90.0,90.0
98057578.0,6,40,2640,20,1320,5160925.157894737,66.0,66.0,20,1320,5146435.315789473,66.0,66.0
554112.0,6,10,1065,5,534,138266.25,262.0,106.8,5,531,137732.5,259.0,106.2
40052.0,6,14,4740,7,653,6567.166666666667,249.0,93.28571428571428,7,4087,6095.333333333333,1514.0,583.8571428571429
108106919.0,17,5,955,5,955,27026729.75,191.0,191.0,0,0,0.0,0.0,0.0
90099043.0,6,14,1976,8,1016,12871291.857142856,188.0,127.0,6,960,12012563.2,204.0,160.0
37685.0,6,14,4740,7,653,6113.5,249.0,93.28571428571428,7,4087,6068.666666666667,1514.0,583.8571428571429
151525.0,17,2,414,1,88,0.0,88.0,88.0,1,326,0.0,326.0,326.0
116641969.0,6,221,24950,111,7622,1060381.5363636364,140.0,68.66666666666667,110,17328,1060716.9449541285,284.0,157.52727272727273
5724914.0,6,4,270,2,134,0.0,68.0,67.0,2,136,0.0,70.0,68.0
80216.0,6,14,4740,7,653,12129.833333333334,249.0,93.28571428571428,7,4087,13075.666666666666,1514.0,583.8571428571429
61569.0,6,10,2032,5,524,13168.25,252.0,104.8,5,1508,13204.75,1236.0,301.6
116596024.0,6,32,2374,17,1288,7273750.625,139.0,75.76470588235294,15,1086,8312850.0,123.0,72.4
118635767.0,6,48,3168,24,1584,5158076.826086956,66.0,66.0,24,1584,5144414.391304348,66.0,66.0
303483.0,6,6,412,4,272,101161.0,74.0,68.0,2,140,0.0,74.0,70.0
325266.0,6,6,412,4,272,108422.0,74.0,68.0,2,140,0.0,74.0,70.0
290317.0,17,2,180,1,90,0.0,90.0,90.0,1,90,0.0,90.0,90.0
53248.0,6,10,2032,5,524,13039.75,252.0,104.8,5,1508,11402.0,1236.0,301.6
120091768.0,6,226,25730,113,7680,1055799.8839285714,140.0,67.96460176991151,113,18050,1065031.7589285714,284.0,159.73451327433628
2594177.0,6,2,132,1,66,0.0,66.0,66.0,1,66,0.0,66.0,66.0
135135885.0,17,6,1146,6,1146,27027177.0,191.0,191.0,0,0,0.0,0.0,0.0
100267.0,17,2,762,2,762,0.0,381.0,381.0,0,0,0.0,0.0,0.0
38622452.0,6,5,336,2,134,0.0,68.0,67.0,3,202,19240422.0,70.0,67.33333333333333
2600935.0,6,2,132,1,66,0.0,66.0,66.0,1,66,0.0,66.0,66.0
49573.0,6,14,4740,7,653,7266.666666666667,249.0,93.28571428571428,7,4087,7726.833333333333,1514.0,583.8571428571429
53960.0,6,10,2032,5,524,13185.25,252.0,104.8,5,1508,11780.0,1236.0,301.6
153389.0,17,2,180,1,90,0.0,90.0,90.0,1,90,0.0,90.0,90.0
6851082.0,6,4,270,2,134,0.0,68.0,67.0,2,136,0.0,70.0,68.0
322783.0,17,4,1400,4,1400,107594.33333333331,350.0,350.0,0,0,0.0,0.0,0.0
0.0,6,1,54,0,0,0.0,0.0,0.0,1,54,0.0,54.0,54.0
14196183.0,17,6,2052,6,2052,2839236.6,342.0,342.0,0,0,0.0,0.0,0.0
29192.0,6,10,2032,5,524,6649.0,252.0,104.8,5,1508,6741.75,1236.0,301.6
104874497.0,6,43,2838,22,1452,4979069.666666667,66.0,66.0,21,1386,5155441.1,66.0,66.0
108103504.0,17,5,1005,5,1005,27025876.0,201.0,201.0,0,0,0.0,0.0,0.0
135133982.0,17,6,1206,6,1206,27026796.4,201.0,201.0,0,0,0.0,0.0,0.0
2575808.0,6,2,132,1,66,0.0,66.0,66.0,1,66,0.0,66.0,66.0
0.0,17,1,381,1,381,0.0,381.0,381.0,0,0,0.0,0.0,0.0
861.0,17,4,438,2,148,0.0,74.0,74.0,2,290,0.0,147.0,145.0
757065.0,17,2,346,1,78,0.0,78.0,78.0,1,268,0.0,268.0,268.0
23101.0,6,14,4740,7,653,3648.0,249.0,93.28571428571428,7,4087,2756.0,1514.0,583.8571428571429
2151.0,17,2,762,2,762,0.0,381.0,381.0,0,0,0.0,0.0,0.0
126901285.0,17,14,864,7,432,19921745.83333333,174.0,61.71428571428572,7,432,17904759.0,174.0,61.71428571428572
209498.0,17,2,180,1,90,0.0,90.0,90.0,1,90,0.0,90.0,90.0
153468.0,17,2,180,1,90,0.0,90.0,90.0,1,90,0.0,90.0,90.0
42380.0,6,14,4740,7,653,6596.333333333333,249.0,93.28571428571428,7,4087,6920.0,1514.0,583.8571428571429
232779.0,6,3,337,2,214,0.0,160.0,107.0,1,123,0.0,123.0,123.0
217957.0,6,3,426,2,280,0.0,214.0,140.0,1,146,0.0,146.0,146.0
90008355.0,17,27,12943,27,12943,3461859.8076923075,501.0,479.3703703703704,0,0,0.0,0.0,0.0
40725.0,6,10,2032,5,524,9759.25,252.0,104.8,5,1508,9173.0,1236.0,301.6
1132393.0,6,20,6434,12,1921,102944.81818181818,620.0,160.08333333333334,8,4513,132990.14285714287,1514.0,564.125
235722.0,6,3,373,2,238,0.0,172.0,119.0,1,135,0.0,135.0,135.0
442719.0,6,11,1021,6,444,59756.8,162.0,74.0,5,577,74512.25,349.0,115.4
181375.0,17,2,180,1,90,0.0,90.0,90.0,1,90,0.0,90.0,90.0
40315.0,6,14,4740,7,653,6598.666666666667,249.0,93.28571428571428,7,4087,6060.166666666667,1514.0,583.8571428571429
301781.0,6,6,412,4,272,100593.66666666669,74.0,68.0,2,140,0.0,74.0,70.0
207250.0,6,3,426,2,280,0.0,214.0,140.0,1,146,0.0,146.0,146.0
63157.00000000001,6,14,4740,7,653,10304.5,249.0,93.28571428571428,7,4087,9751.5,1514.0,583.8571428571429
51096.0,17,2,180,1,90,0.0,90.0,90.0,1,90,0.0,90.0,90.0
144005.0,17,2,180,1,90,0.0,90.0,90.0,1,90,0.0,90.0,90.0
208384.0,17,2,180,1,90,0.0,90.0,90.0,1,90,0.0,90.0,90.0
258460.00000000003,6,10,1221,6,636,51692.0,298.0,106.0,4,585,80710.0,379.0,146.25
107619.0,17,4,1400,4,1400,35873.0,350.0,350.0,0,0,0.0,0.0,0.0
144792.0,17,2,180,1,70,0.0,70.0,70.0,1,110,0.0,110.0,110.0
120196267.0,6,236,26644,118,8084,1020357.6153846154,140.0,68.50847457627118,118,18560,1020250.153846154,284.0,157.28813559322035
319.0,17,2,166,1,75,0.0,75.0,75.0,1,91,0.0,91.0,91.0
110462.0,17,2,286,2,286,0.0,143.0,143.0,0,0,0.0,0.0,0.0
2345.0,17,4,344,2,150,0.0,75.0,75.0,2,194,0.0,103.0,97.0
69447.0,6,14,4740,7,653,11467.5,249.0,93.28571428571428,7,4087,9645.166666666666,1514.0,583.8571428571429
363331.0,6,11,1021,6,444,48882.4,162.0,74.0,5,577,60924.0,349.0,115.4
118429483.0,17,14,864,7,432,19667692.0,174.0,61.71428571428572,7,432,19666857.83333333,174.0,61.71428571428572
143901.0,17,2,180,1,90,0.0,90.0,90.0,1,90,0.0,90.0,90.0
90259381.0,6,16,2368,9,1204,11282422.625,188.0,133.77777777777777,7,1164,15015403.333333334,204.0,166.28571428571428
48235.0,6,14,4740,7,653,7801.166666666667,249.0,93.28571428571428,7,4087,7878.0,1514.0,583.8571428571429
232376.0,6,3,337,2,214,0.0,160.0,107.0,1,123,0.0,123.0,123.0
448.0,17,2,168,1,76,0.0,76.0,76.0,1,92,0.0,92.0,92.0
424663.0,6,3,204,2,136,0.0,70.0,68.0,1,68,0.0,68.0,68.0
24383.0,17,2,582,1,83,0.0,83.0,83.0,1,499,0.0,499.0,499.0
48314.0,6,14,4740,7,653,7325.666666666667,249.0,93.28571428571428,7,4087,7135.5,1514.0,583.8571428571429
2151135.0,17,5,961,3,234,1075318.5,78.0,78.0,2,727,0.0,395.0,363.5
5005196.0,17,4,849,2,166,0.0,83.0,83.0,2,683,0.0,499.0,341.5
315877.0,17,4,1400,4,1400,105292.33333333331,350.0,350.0,0,0,0.0,0.0,0.0
547.0,17,2,508,2,508,0.0,257.0,254.0,0,0,0.0,0.0,0.0
214356.0,6,3,426,2,280,0.0,214.0,140.0,1,146,0.0,146.0,146.0
278033.0,17,2,180,1,90,0.0,90.0,90.0,1,90,0.0,90.0,90.0
143852.0,17,2,180,1,90,0.0,90.0,90.0,1,90,0.0,90.0,90.0
147979.0,17,2,180,1,90,0.0,90.0,90.0,1,90,0.0,90.0,90.0
117869595.0,6,48,3168,24,1584,5124765.0,66.0,66.0,24,1584,5111302.695652174,66.0,66.0
6090419.0,6,5,336,2,134,0.0,68.0,67.0,3,202,1525851.5,70.0,67.33333333333333
2551314.0,6,3,1604,1,753,0.0,753.0,753.0,2,851,0.0,785.0,425.5
247198.0,17,2,180,1,90,0.0,90.0,90.0,1,90,0.0,90.0,90.0
206983.0,17,2,762,2,762,0.0,381.0,381.0,0,0,0.0,0.0,0.0
840228.0,6,9,1118,6,586,168045.6,248.0,97.66666666666669,3,532,282294.5,392.0,177.33333333333334
11538.0,6,10,2032,5,524,2581.0,252.0,104.8,5,1508,2116.5,1236.0,301.6
123840006.0,6,49,3234,25,1650,5160000.25,66.0,66.0,24,1584,5129132.521739131,66.0,66.0
36501.0,6,14,4740,7,653,5470.666666666667,249.0,93.28571428571428,7,4087,5875.333333333333,1514.0,583.8571428571429
13612540.0,6,20,1607,10,975,1479023.4444444445,315.0,97.5,10,632,1478996.3333333333,78.0,63.2
306336.0,6,6,412,4,272,102112.0,74.0,68.0,2,140,0.0,74.0,70.0
108111286.0,17,5,955,5,955,27027821.5,191.0,191.0,0,0,0.0,0.0,0.0
9799.0,17,2,571,1,86,0.0,86.0,86.0,1,485,0.0,485.0,485.0
335.0,17,2,166,1,75,0.0,75.0,75.0,1,91,0.0,91.0,91.0
314.0,17,2,174,1,79,0.0,79.0,79.0,1,95,0.0,95.0,95.0
201184.0,17,2,180,1,90,0.0,90.0,90.0,1,90,0.0,90.0,90.0
347.0,17,2,174,1,79,0.0,79.0,79.0,1,95,0.0,95.0,95.0
209639.0,17,2,180,1,90,0.0,90.0,90.0,1,90,0.0,90.0,90.0
114321098.0,6,48,3168,24,1584,4970482.521739131,66.0,66.0,24,1584,4956901.695652174,66.0,66.0
120156727.0,6,228,25772,115,18092,1054006.3771929825,284.0,157.3217391304348,113,7680,1066317.4285714286,140.0,67.96460176991151
228496.0,17,2,180,1,90,0.0,90.0,90.0,1,90,0.0,90.0,90.0
90256000.0,6,15,2444,8,1016,12893714.285714284,188.0,127.0,7,1428,15013512.833333334,204.0,204.0
284140.0,17,2,363,1,79,0.0,79.0,79.0,1,284,0.0,284.0,284.0
90461285.0,6,21,1585,12,935,8223753.181818182,95.0,77.91666666666667,9,650,11271175.375,95.0,72.22222222222223
167676.0,17,2,414,1,88,0.0,88.0,88.0,1,326,0.0,326.0,326.0
123456422.0,6,49,3234,25,1650,5144017.583333333,66.0,66.0,24,1584,4960460.826086956,66.0,66.0
99082433.0,6,167,18840,84,5778,1193764.253012048,140.0,68.78571428571429,83,13062,1195644.6951219512,284.0,157.3734939759036
141576.0,17,4,571,2,148,0.0,74.0,74.0,2,423,0.0,276.0,211.5
1244879.0,6,7,499,4,301,406313.0,103.0,75.25,3,198,613830.5,66.0,66.0
42630.0,6,10,1066,5,490,3308.75,218.0,98.0,5,576,10439.0,304.0,115.2
218964.0,6,3,426,2,280,0.0,214.0,140.0,1,146,0.0,146.0,146.0
114289177.0,17,14,864,7,432,19000195.5,174.0,61.71428571428572,7,432,19001231.5,174.0,61.71428571428572
10538025.0,6,7,478,4,272,3467437.6666666665,74.0,68.0,3,206,5201077.0,74.0,68.66666666666667
2043.0,17,4,344,2,150,0.0,75.0,75.0,2,194,0.0,103.0,97.0
2044218.0,17,2,876,2,876,0.0,438.0,438.0,0,0,0.0,0.0,0.0
108106147.0,17,5,1005,5,1005,27026536.75,201.0,201.0,0,0,0.0,0.0,0.0
158458.0,6,3,337,2,214,0.0,160.0,107.0,1,123,0.0,123.0,123.0
129007700.0,17,15,907,8,475,18429671.42857143,174.0,59.375,7,432,18166828.666666668,174.0,61.71428571428572
90255094.0,6,12,1832,8,1016,12893584.857142856,188.0,127.0,4,816,30030995.0,204.0,204.0
351275.0,6,10,1221,6,636,70255.0,298.0,106.0,4,585,111721.0,379.0,146.25
302412.0,6,2,132,1,66,0.0,66.0,66.0,1,66,0.0,66.0,66.0
748.0,17,4,438,2,148,0.0,74.0,74.0,2,290,0.0,147.0,145.0
90027982.0,17,28,13364,28,13364,3334369.703703704,501.0,477.2857142857143,0,0,0.0,0.0,0.0
242939.0,6,3,337,2,214,0.0,160.0,107.0,1,123,0.0,123.0,123.0
83.0,17,2,762,2,762,0.0,381.0,381.0,0,0,0.0,0.0,0.0
3087861.0,6,3,204,2,134,0.0,68.0,67.0,1,70,0.0,70.0,70.0
37313.0,6,10,2032,5,524,9089.5,252.0,104.8,5,1508,9045.0,1236.0,301.6
1161366.0,6,13,3010,8,2382,165909.42857142858,1514.0,297.75,5,628,221422.75,331.0,125.6
1020086.0,6,11,1134,6,558,204017.2,220.0,93.0,5,576,254299.0,304.0,115.2
57666.0,6,14,4740,7,653,9443.666666666666,249.0,93.28571428571428,7,4087,9413.5,1514.0,583.8571428571429
299016.0,6,6,412,4,272,99672.0,74.0,68.0,2,140,0.0,74.0,70.0
135129234.0,17,6,1146,6,1146,27025846.8,191.0,191.0,0,0,0.0,0.0,0.0
111003831.0,6,32,2236,16,1165,7385873.866666666,139.0,72.8125,16,1071,7385874.466666667,123.0,66.9375
307985.0,6,6,412,4,272,102661.66666666669,74.0,68.0,2,140,0.0,74.0,70.0
104096.0,6,10,2032,5,524,18596.5,252.0,104.8,5,1508,20443.75,1236.0,301.6
108358.0,17,2,286,2,286,0.0,143.0,143.0,0,0,0.0,0.0,0.0
114601542.0,6,218,24534,109,17118,1059133.1666666667,284.0,157.045871559633,109,7416,1059132.5277777778,140.0,68.03669724770643
43025.0,6,2,132,1,66,0.0,66.0,66.0,1,66,0.0,66.0,66.0
90336157.0,6,21,1585,11,840,9025436.3,95.0,76.36363636363636,10,745,9952043.111111112,95.0,74.5
2796680.0,6,12,2172,7,664,465908.5,252.0,94.85714285714286,5,1508,2306.75,1236.0,301.6
1302488.0,6,4,264,2,132,0.0,66.0,66.0,2,132,0.0,66.0,66.0
0.0,17,1,453,1,453,0.0,453.0,453.0,0,0,0.0,0.0,0.0
213594.0,17,2,180,1,90,0.0,90.0,90.0,1,90,0.0,90.0,90.0
36221.0,6,14,4740,7,653,5100.5,249.0,93.28571428571428,7,4087,5566.0,1514.0,583.8571428571429
303814.0,6,6,412,4,272,101271.33333333331,74.0,68.0,2,140,0.0,74.0,70.0
113329246.0,6,35,2542,18,1348,6666426.235294118,139.0,74.88888888888889,17,1194,7070257.3125,123.0,70.23529411764706
105326921.0,17,14,864,7,432,17501480.833333332,174.0,61.71428571428572,7,432,17500177.0,174.0,61.71428571428572
90028336.0,17,28,13364,28,13364,3334382.814814815,501.0,477.2857142857143,0,0,0.0,0.0,0.0
323.0,17,2,174,1,79,0.0,79.0,79.0,1,95,0.0,95.0,95.0
155082.0,6,3,337,2,214,0.0,160.0,107.0,1,123,0.0,123.0,123.0
14346692.0,17,6,2052,6,2052,2869338.4,342.0,342.0,0,0,0.0,0.0,0.0
203138.0,17,2,762,2,762,0.0,381.0,381.0,0,0,0.0,0.0,0.0
143934.0,17,2,180,1,90,0.0,90.0,90.0,1,90,0.0,90.0,90.0
299422.0,6,6,412,4,272,99807.33333333331,74.0,68.0,2,140,0.0,74.0,70.0
31877.000000000004,6,14,4740,7,653,5184.166666666667,249.0,93.28571428571428,7,4087,4639.0,1514.0,583.8571428571429
854796.0,6,9,1196,6,725,170959.2,387.0,120.83333333333331,3,471,289605.0,331.0,157.0
111016151.0,6,33,2428,17,1288,6925017.5625,139.0,75.76470588235294,16,1140,7386686.6,123.0,71.25
58573.0,6,10,2032,5,524,13018.25,252.0,104.8,5,1508,13501.75,1236.0,301.6
110906783.0,17,13,821,7,432,18484463.83333333,174.0,61.71428571428572,6,389,18200501.2,174.0,64.83333333333333
27460900.0,17,5,1710,5,1710,6865225.0,342.0,342.0,0,0,0.0,0.0,0.0
90950337.0,6,21,1585,11,840,9093916.5,95.0,76.36363636363636,10,745,10104232.222222222,95.0,74.5
0.0,6,1,66,1,66,0.0,66.0,66.0,0,0,0.0,0.0,0.0
447.0,17,2,508,2,508,0.0,257.0,254.0,0,0,0.0,0.0,0.0
56774.0,6,10,2032,5,524,13909.5,252.0,104.8,5,1508,13838.0,1236.0,301.6
10249.0,17,4,643,2,172,0.0,86.0,86.0,2,471,0.0,305.0,235.5
3285059.0,6,205,161682,111,151176,29864.17272727273,1510.0,1361.945945945946,94,10506,31991.989247311827,1510.0,111.76595744680851
315656.0,17,4,1400,4,1400,105218.66666666669,350.0,350.0,0,0,0.0,0.0,0.0
102983766.0,6,42,2772,21,1386,5135428.45,66.0,66.0,21,1386,5135424.85,66.0,66.0
90602801.0,6,15,2302,9,1204,11310862.0,188.0,133.77777777777777,6,1098,18087118.6,204.0,183.0
308672.0,6,3,202,2,128,0.0,74.0,64.0,1,74,0.0,74.0,74.0
58973.0,6,14,4740,7,653,9558.5,249.0,93.28571428571428,7,4087,9622.0,1514.0,583.8571428571429
354.0,17,2,267,1,83,0.0,83.0,83.0,1,184,0.0,184.0,184.0
120057494.0,6,216,24312,108,7424,1115422.2990654206,140.0,68.74074074074075,108,16888,1114382.5046728973,284.0,156.37037037037038
1476139.0,17,16,1120,16,1120,98409.26666666666,70.0,70.0,0,0,0.0,0.0,0.0
157838.0,17,2,180,1,90,0.0,90.0,90.0,1,90,0.0,90.0,90.0
90256731.0,6,14,1964,8,1016,12893818.714285716,188.0,127.0,6,948,18011562.0,204.0,158.0
3187.0,17,4,344,2,150,0.0,75.0,75.0,2,194,0.0,103.0,97.0
305672.0,6,6,412,4,272,101890.66666666669,74.0,68.0,2,140,0.0,74.0,70.0
217708.0,6,3,426,2,280,0.0,214.0,140.0,1,146,0.0,146.0,146.0
153474.0,17,2,180,1,90,0.0,90.0,90.0,1,90,0.0,90.0,90.0
27580.0,6,14,4740,7,653,4239.333333333333,249.0,93.28571428571428,7,4087,4458.166666666667,1514.0,583.8571428571429
26355.0,6,14,4740,7,653,3664.0,249.0,93.28571428571428,7,4087,4255.833333333333,1514.0,583.8571428571429
299452.0,6,6,412,4,272,99817.33333333331,74.0,68.0,2,140,0.0,74.0,70.0
251514.00000000003,6,3,337,2,214,0.0,160.0,107.0,1,123,0.0,123.0,123.0
16232954.0,17,6,2052,6,2052,3246590.8,342.0,342.0,0,0,0.0,0.0,0.0
50968.0,6,14,4740,7,653,8036.5,249.0,93.28571428571428,7,4087,8295.666666666666,1514.0,583.8571428571429
108690672.0,6,32,2236,16,1165,7246044.8,139.0,72.8125,16,1071,7231626.533333333,123.0,66.9375
287638.0,17,2,363,1,79,0.0,79.0,79.0,1,284,0.0,284.0,284.0
320.0,17,2,174,1,79,0.0,79.0,79.0,1,95,0.0,95.0,95.0
109098990.0,17,14,864,7,432,18166834.166666668,174.0,61.71428571428572,7,432,18168664.666666668,174.0,61.71428571428572
0.0,17,1,161,1,161,0.0,161.0,161.0,0,0,0.0,0.0,0.0
234077.0,6,3,373,2,238,0.0,172.0,119.0,1,135,0.0,135.0,135.0
120173580.0,6,445,59328,223,44380,541322.4324324324,336.0,199.0134529147982,222,14948,539079.0180995475,140.0,67.33333333333333
108103741.0,17,5,1005,5,1005,27025935.25,201.0,201.0,0,0,0.0,0.0,0.0
90259014.0,6,14,2102,8,1016,12894144.857142856,188.0,127.0,6,1086,18019263.6,204.0,181.0
68744.0,6,14,4740,7,653,11325.333333333334,249.0,93.28571428571428,7,4087,10985.166666666666,1514.0,583.8571428571429
1434.0,6,2,177,1,123,0.0,123.0,123.0,1,54,0.0,54.0,54.0
542881.0,6,2,132,1,66,0.0,66.0,66.0,1,66,0.0,66.0,66.0
2097650.0,6,19,6869,11,1567,209765.0,408.0,142.45454545454547,8,5302,236926.4285714285,1514.0,662.75
28276.0,6,10,2032,5,524,6895.0,252.0,104.8,5,1508,6354.0,1236.0,301.6
102559.0,17,2,762,2,762,0.0,381.0,381.0,0,0,0.0,0.0,0.0
90036061.0,17,28,13364,28,13364,3334668.925925926,501.0,477.2857142857143,0,0,0.0,0.0,0.0
294387.0,6,6,412,4,272,98129.0,74.0,68.0,2,140,0.0,74.0,70.0
207776.0,6,3,426,2,280,0.0,214.0,140.0,1,146,0.0,146.0,146.0
30211.0,6,14,4740,7,653,4917.666666666667,249.0,93.28571428571428,7,4087,4633.0,1514.0,583.8571428571429
1346.0,17,2,762,2,762,0.0,381.0,381.0,0,0,0.0,0.0,0.0
1312075.0,17,7,490,7,490,218679.16666666663,70.0,70.0,0,0,0.0,0.0,0.0
1302513.0,6,4,264,2,132,0.0,66.0,66.0,2,132,0.0,66.0,66.0
319.0,17,2,174,1,79,0.0,79.0,79.0,1,95,0.0,95.0,95.0
1314776.0,6,4,264,2,132,0.0,66.0,66.0,2,132,0.0,66.0,66.0
204476.0,17,2,762,2,762,0.0,381.0,381.0,0,0,0.0,0.0,0.0
306916.0,6,6,412,4,272,102305.33333333331,74.0,68.0,2,140,0.0,74.0,70.0
2561.0,17,2,180,1,90,0.0,90.0,90.0,1,90,0.0,90.0,90.0
742.0,17,4,438,2,148,0.0,74.0,74.0,2,290,0.0,147.0,145.0
806.0,17,4,438,2,148,0.0,74.0,74.0,2,290,0.0,147.0,145.0
2805924.0,6,2,132,1,66,0.0,66.0,66.0,1,66,0.0,66.0,66.0
7688111.0,6,5,1736,2,819,0.0,753.0,409.5,3,917,2552307.0,785.0,305.6666666666667
146953.0,6,3,373,2,238,0.0,172.0,119.0,1,135,0.0,135.0,135.0
1034375.0,6,11,1134,6,558,206875.0,220.0,93.0,5,576,257760.5,304.0,115.2
32360.0,6,14,4740,7,653,5026.666666666667,249.0,93.28571428571428,7,4087,5258.166666666667,1514.0,583.8571428571429
285183.0,17,2,363,1,79,0.0,79.0,79.0,1,284,0.0,284.0,284.0
205755.0,17,2,315,1,75,0.0,75.0,75.0,1,240,0.0,240.0,240.0
119865312.0,6,14,2102,5,1020,29965734.0,204.0,204.0,9,1082,14982959.75,188.0,120.22222222222224
205881.0,17,2,180,1,90,0.0,90.0,90.0,1,90,0.0,90.0,90.0
104860623.0,17,14,864,7,432,17476770.5,174.0,61.71428571428572,7,432,17333021.0,174.0,61.71428571428572
298931.0,6,6,412,4,272,99643.66666666669,74.0,68.0,2,140,0.0,74.0,70.0
4790.0,17,2,614,1,72,0.0,72.0,72.0,1,542,0.0,542.0,542.0
186764.0,17,2,180,1,90,0.0,90.0,90.0,1,90,0.0,90.0,90.0
92880022.0,6,37,2442,19,1254,5160001.222222222,66.0,66.0,18,1188,5340953.176470588,66.0,66.0
109035.0,17,2,286,2,286,0.0,143.0,143.0,0,0,0.0,0.0,0.0
2272.0,17,4,344,2,150,0.0,75.0,75.0,2,194,0.0,103.0,97.0
15809.0,6,14,4740,7,653,2415.6666666666665,249.0,93.28571428571428,7,4087,2504.5,1514.0,583.8571428571429
103001235.0,17,13,821,7,432,17166872.5,174.0,61.71428571428572,6,389,16601279.4,174.0,64.83333333333333
346.0,17,2,267,1,83,0.0,83.0,83.0,1,184,0.0,184.0,184.0
103163.0,17,2,286,2,286,0.0,143.0,143.0,0,0,0.0,0.0,0.0
90494692.0,6,16,1192,9,650,11306266.75,95.0,72.22222222222223,7,542,10117667.5,95.0,77.42857142857143
108104016.0,17,5,955,5,955,27026004.0,191.0,191.0,0,0,0.0,0.0,0.0
32037.000000000004,6,14,4740,7,653,5212.333333333333,249.0,93.28571428571428,7,4087,4661.833333333333,1514.0,583.8571428571429
90257821.0,6,15,2444,8,1016,12893974.42857143,188.0,127.0,7,1428,15015488.166666666,204.0,204.0
97131040.0,17,12,778,6,389,19401433.4,174.0,64.83333333333333,6,389,19200163.4,174.0,64.83333333333333
257683.0,6,3,337,2,214,0.0,160.0,107.0,1,123,0.0,123.0,123.0
104468235.0,6,221,24822,111,7548,949711.2272727272,140.0,68.0,110,17274,950077.3486238532,284.0,157.03636363636363
153546.0,17,2,180,1,90,0.0,90.0,90.0,1,90,0.0,90.0,90.0
108103262.0,17,5,955,5,955,27025815.5,191.0,191.0,0,0,0.0,0.0,0.0
308001.0,6,6,412,4,272,102667.0,74.0,68.0,2,140,0.0,74.0,70.0
281358.0,17,2,363,1,79,0.0,79.0,79.0,1,284,0.0,284.0,284.0
307189.0,6,6,412,4,272,102396.33333333331,74.0,68.0,2,140,0.0,74.0,70.0
285835.0,17,4,1524,4,1524,95278.33333333331,381.0,381.0,0,0,0.0,0.0,0.0
3330815.0,6,191,158267,109,148553,30840.87962962963,1510.0,1362.8715596330276,82,9714,37216.07407407407,1510.0,118.46341463414636
408357.0,6,3,1777,1,826,0.0,826.0,826.0,2,951,0.0,885.0,475.5
4279.0,17,2,626,1,72,0.0,72.0,72.0,1,554,0.0,554.0,554.0
19655.0,6,14,4740,7,653,3104.5,249.0,93.28571428571428,7,4087,3133.833333333333,1514.0,583.8571428571429
0.0,17,1,44,1,44,0.0,44.0,44.0,0,0,0.0,0.0,0.0
1634436.0,6,20,6434,12,1921,148585.0909090909,620.0,160.08333333333334,8,4513,189436.8571428572,1514.0,564.125
1300983.0,6,4,264,2,132,0.0,66.0,66.0,2,132,0.0,66.0,66.0
20308.0,6,2,145,2,145,0.0,91.0,72.5,0,0,0.0,0.0,0.0
34993.0,6,14,4740,7,653,5719.0,249.0,93.28571428571428,7,4087,5079.0,1514.0,583.8571428571429
9270.0,17,2,582,1,83,0.0,83.0,83.0,1,499,0.0,499.0,499.0
72725.0,6,14,4740,7,653,11702.666666666666,249.0,93.28571428571428,7,4087,11981.166666666666,1514.0,583.8571428571429
5624951.0,6,5,336,2,134,0.0,68.0,67.0,3,202,1526110.0,70.0,67.33333333333333
120131082.0,6,240,27104,120,8216,1002660.3445378152,140.0,68.46666666666667,120,18888,1003357.7731092436,284.0,157.4
3230.0,17,2,363,1,75,0.0,75.0,75.0,1,288,0.0,288.0,288.0
113633733.0,6,33,2406,17,1194,7102081.1875,123.0,70.23529411764706,16,1212,7062991.4,123.0,75.75
144934.0,17,2,180,1,70,0.0,70.0,70.0,1,110,0.0,110.0,110.0
2357.0,17,4,344,2,150,0.0,75.0,75.0,2,194,0.0,103.0,97.0
120148473.0,6,240,27088,120,8216,993946.2773109244,140.0,68.46666666666667,120,18872,1002825.3949579832,284.0,157.26666666666668
833.0,17,4,438,2,148,0.0,74.0,74.0,2,290,0.0,147.0,145.0
207461.0,17,4,6056,4,6056,69153.66666666667,1514.0,1514.0,0,0,0.0,0.0,0.0
48502.0,6,14,4740,7,653,7577.833333333333,249.0,93.28571428571428,7,4087,7911.666666666667,1514.0,583.8571428571429
0.0,6,1,54,0,0,0.0,0.0,0.0,1,54,0.0,54.0,54.0
108097093.0,17,5,955,5,955,27024273.25,191.0,191.0,0,0,0.0,0.0,0.0
43338.0,6,14,4740,7,653,6934.666666666667,249.0,93.28571428571428,7,4087,6832.166666666667,1514.0,583.8571428571429
119818350.0,6,26,1978,15,1138,8554963.92857143,95.0,75.86666666666666,11,840,11981031.0,95.0,76.36363636363636
2373.0,17,4,344,2,150,0.0,75.0,75.0,2,194,0.0,103.0,97.0
148400.0,6,3,373,2,238,0.0,172.0,119.0,1,135,0.0,135.0,135.0
658719.0,6,4,508,2,238,0.0,172.0,119.0,2,270,0.0,135.0,135.0
117818141.0,6,34,2350,17,1225,7350141.9375,139.0,72.05882352941177,17,1125,7350142.125,123.0,66.17647058823529
170518.0,6,11,1132,6,556,33736.6,218.0,92.66666666666669,5,576,39657.0,304.0,115.2
32144.0,6,14,4740,7,653,4172.0,249.0,93.28571428571428,7,4087,5201.333333333333,1514.0,583.8571428571429
6956.0,17,2,582,1,83,0.0,83.0,83.0,1,499,0.0,499.0,499.0
135129962.0,17,6,1206,6,1206,27025992.4,201.0,201.0,0,0,0.0,0.0,0.0
2067.0,17,4,344,2,150,0.0,75.0,75.0,2,194,0.0,103.0,97.0
144887.0,17,2,180,1,70,0.0,70.0,70.0,1,110,0.0,110.0,110.0
42331.0,6,14,4740,7,653,6520.666666666667,249.0,93.28571428571428,7,4087,6472.666666666667,1514.0,583.8571428571429
397731.0,6,4,508,2,238,0.0,172.0,119.0,2,270,0.0,135.0,135.0
106385138.0,6,32,2236,16,1165,7092342.533333333,139.0,72.8125,16,1071,7077924.0,123.0,66.9375
108112475.0,17,5,1005,5,1005,27028118.75,201.0,201.0,0,0,0.0,0.0,0.0
90008781.0,17,28,13364,28,13364,3333658.5555555555,501.0,477.2857142857143,0,0,0.0,0.0,0.0
114037922.0,6,31,2166,16,1149,7588146.533333333,123.0,71.8125,15,1017,8130158.714285715,123.0,67.8
86131.0,6,14,4740,7,653,13970.333333333334,249.0,93.28571428571428,7,4087,11360.833333333334,1514.0,583.8571428571429
90258889.0,6,14,2240,8,1016,12894127.0,188.0,127.0,6,1224,18018705.6,204.0,204.0
3002910.0,6,11,2106,6,598,600407.0,252.0,99.66666666666669,5,1508,1767.75,1236.0,301.6
119769936.0,6,23,1693,12,894,10888176.0,95.0,74.5,11,799,11951289.4,95.0,72.63636363636364
10847704.0,6,8,544,4,272,3570284.0,74.0,68.0,4,272,3570197.0,74.0,68.0
212032.0,17,2,180,1,90,0.0,90.0,90.0,1,90,0.0,90.0,90.0
0.0,17,1,453,1,453,0.0,453.0,453.0,0,0,0.0,0.0,0.0
120124113.0,6,13,2020,9,1204,15015514.125,188.0,133.77777777777777,4,816,30031212.33333333,204.0,204.0
135135657.0,17,6,1146,6,1146,27027131.4,191.0,191.0,0,0,0.0,0.0,0.0
310912.0,6,3,204,2,136,0.0,70.0,68.0,1,68,0.0,68.0,68.0
149595.0,17,2,180,1,90,0.0,90.0,90.0,1,90,0.0,90.0,90.0
10885149.0,6,8,544,4,272,3581736.6666666665,74.0,68.0,4,272,3581630.333333333,74.0,68.0
108098692.0,17,5,1005,5,1005,27024673.0,201.0,201.0,0,0,0.0,0.0,0.0
120028008.0,17,28,13364,28,13364,4445481.777777778,501.0,477.2857142857143,0,0,0.0,0.0,0.0
109734668.0,6,32,2305,16,1140,7315644.533333333,123.0,71.25,16,1165,7301094.733333333,139.0,72.8125
113618861.0,6,46,3036,23,1518,5150438.7727272725,66.0,66.0,23,1518,5150433.409090909,66.0,66.0
311942.0,17,4,1400,4,1400,103980.66666666669,350.0,350.0,0,0,0.0,0.0,0.0
111776755.0,6,35,2542,18,1348,6562406.764705882,139.0,74.88888888888889,17,1194,6972553.9375,123.0,70.23529411764706
221865.0,17,4,1524,4,1524,73955.0,381.0,381.0,0,0,0.0,0.0,0.0
10532245.0,6,7,478,4,272,3464072.6666666665,74.0,68.0,3,206,5195987.0,74.0,68.66666666666667
676.0,17,4,438,2,148,0.0,74.0,74.0,2,290,0.0,147.0,145.0
1287875.0,17,7,490,7,490,214645.8333333333,70.0,70.0,0,0,0.0,0.0,0.0
307639.0,6,6,412,4,272,102546.33333333331,74.0,68.0,2,140,0.0,74.0,70.0
90249284.0,6,14,2240,8,1016,12892754.857142856,188.0,127.0,6,1224,18017232.0,204.0,204.0
135131543.0,17,6,1206,6,1206,27026308.6,201.0,201.0,0,0,0.0,0.0,0.0
1768.0,17,6,1230,3,234,582.0,78.0,78.0,3,996,677.5,332.0,332.0
59067.0,6,12,1320,7,789,9844.5,253.0,112.71428571428572,5,531,12804.75,259.0,106.2
108106199.0,17,5,1005,5,1005,27026549.75,201.0,201.0,0,0,0.0,0.0,0.0
135136525.0,17,6,1206,6,1206,27027305.0,201.0,201.0,0,0,0.0,0.0,0.0
120007521.0,6,30,3574,16,2066,7999999.2,426.0,129.125,14,1508,9194444.461538462,360.0,107.71428571428572
297969.0,6,6,412,4,272,99323.0,74.0,68.0,2,140,0.0,74.0,70.0
317697.0,6,6,412,4,272,105899.0,74.0,68.0,2,140,0.0,74.0,70.0
213777.0,17,4,6056,4,6056,71259.0,1514.0,1514.0,0,0,0.0,0.0,0.0
317602.0,17,4,1400,4,1400,105867.33333333331,350.0,350.0,0,0,0.0,0.0,0.0
35745482.0,6,5,336,3,202,17805266.0,70.0,67.33333333333333,2,134,0.0,68.0,67.0
298136.0,6,6,412,4,272,99378.66666666669,74.0,68.0,2,140,0.0,74.0,70.0
18119.0,6,10,2032,5,524,4234.25,252.0,104.8,5,1508,4074.5,1236.0,301.6
135121178.0,17,6,1146,6,1146,27024235.6,191.0,191.0,0,0,0.0,0.0,0.0
98568556.0,17,14,1126,7,563,16337929.333333334,174.0,80.42857142857143,7,563,16333466.666666666,174.0,80.42857142857143
41431.0,6,14,4740,7,653,6481.666666666667,249.0,93.28571428571428,7,4087,6720.5,1514.0,583.8571428571429
312227.0,6,6,412,4,272,104075.66666666669,74.0,68.0,2,140,0.0,74.0,70.0
40049.0,6,14,4740,7,653,6469.0,249.0,93.28571428571428,7,4087,6084.5,1514.0,583.8571428571429
2419117.0,6,25,7573,14,3735,186085.92307692303,1514.0,266.7857142857143,11,3838,215182.3,1514.0,348.90909090909093
23810.0,6,10,2032,5,524,5341.75,252.0,104.8,5,1508,5620.25,1236.0,301.6
118253411.0,6,217,24378,109,7416,1094938.990740741,140.0,68.03669724770643,108,16962,1095431.1495327102,284.0,157.05555555555554
122530345.0,6,49,3234,25,1650,5105431.041666667,66.0,66.0,24,1584,4890931.608695652,66.0,66.0
124112.0,6,3,373,2,238,0.0,172.0,119.0,1,135,0.0,135.0,135.0
15033951.0,6,5,370,5,370,3758487.75,74.0,74.0,0,0,0.0,0.0,0.0
2627715.0,17,4,1752,4,1752,875905.0,438.0,438.0,0,0,0.0,0.0,0.0
234667.0,6,3,337,2,214,0.0,160.0,107.0,1,123,0.0,123.0,123.0
269241.0,6,3,337,2,214,0.0,160.0,107.0,1,123,0.0,123.0,123.0
306682.0,6,6,412,4,272,102227.33333333331,74.0,68.0,2,140,0.0,74.0,70.0
1059.0,17,4,438,2,148,0.0,74.0,74.0,2,290,0.0,147.0,145.0
1321912.0,6,4,264,2,132,0.0,66.0,66.0,2,132,0.0,66.0,66.0
318746.0,17,4,1400,4,1400,106248.66666666669,350.0,350.0,0,0,0.0,0.0,0.0
422203.0,6,3,204,1,68,0.0,68.0,68.0,2,136,0.0,70.0,68.0
507643.0,6,5,336,2,134,0.0,68.0,67.0,3,202,191874.0,70.0,67.33333333333333
2708.0,17,2,762,2,762,0.0,381.0,381.0,0,0,0.0,0.0,0.0
101113.0,17,4,1400,4,1400,33704.333333333336,350.0,350.0,0,0,0.0,0.0,0.0
45212.0,6,14,4740,7,653,7004.666666666667,249.0,93.28571428571428,7,4087,6147.166666666667,1514.0,583.8571428571429
308067.0,6,6,412,4,272,102689.0,74.0,68.0,2,140,0.0,74.0,70.0
153411.0,17,2,180,1,90,0.0,90.0,90.0,1,90,0.0,90.0,90.0
220164.0,6,3,426,2,280,0.0,214.0,140.0,1,146,0.0,146.0,146.0
20346.0,6,10,2032,5,524,4523.5,252.0,104.8,5,1508,4717.25,1236.0,301.6
16823.0,17,2,180,1,90,0.0,90.0,90.0,1,90,0.0,90.0,90.0
69816.0,6,10,2032,5,524,17247.25,252.0,104.8,5,1508,14787.25,1236.0,301.6
123647843.0,6,48,3168,24,1584,4969456.565217392,66.0,66.0,24,1584,5320004.130434782,66.0,66.0
3117517.0,6,3,1604,2,851,0.0,785.0,425.5,1,753,0.0,753.0,753.0
5841.0,17,2,231,1,78,0.0,78.0,78.0,1,153,0.0,153.0,153.0
217640.0,17,2,414,1,88,0.0,88.0,88.0,1,326,0.0,326.0,326.0
99954009.0,6,24,1500,12,783,9067080.909090908,123.0,65.25,12,717,9067106.090909092,123.0,59.75
1443506.0,6,20,7599,11,1469,144350.6,583.0,133.54545454545453,9,6130,148118.125,1484.0,681.1111111111111
239631.0,6,3,337,2,214,0.0,160.0,107.0,1,123,0.0,123.0,123.0
55904.0,6,14,4740,7,653,9184.5,249.0,93.28571428571428,7,4087,9074.333333333334,1514.0,583.8571428571429
120000056.0,6,27,2954,14,1506,9230773.538461538,426.0,107.57142857142856,13,1448,9455692.75,334.0,111.3846153846154
33960.0,6,2,145,2,145,0.0,91.0,72.5,0,0,0.0,0.0,0.0
217199.0,6,10,1221,6,636,43439.8,298.0,106.0,4,585,71251.33333333333,379.0,146.25
103325.0,17,2,286,2,286,0.0,143.0,143.0,0,0,0.0,0.0,0.0
860119.0,6,9,1096,6,625,172023.8,287.0,104.16666666666669,3,471,293645.5,331.0,157.0
39761.0,6,14,4740,7,653,5436.666666666667,249.0,93.28571428571428,7,4087,5818.166666666667,1514.0,583.8571428571429
90293307.0,6,16,1192,8,596,12892981.142857144,95.0,74.5,8,596,12897228.0,95.0,74.5
298118.0,17,2,180,1,90,0.0,90.0,90.0,1,90,0.0,90.0,90.0
91421822.0,6,861,197536,420,28386,218133.70644391407,214.0,67.58571428571429,441,169150,207735.4863636364,1514.0,383.56009070294783
307532.0,6,6,412,4,272,102510.66666666669,74.0,68.0,2,140,0.0,74.0,70.0
302473.0,6,6,412,4,272,100824.33333333331,74.0,68.0,2,140,0.0,74.0,70.0
9478.0,17,2,582,1,83,0.0,83.0,83.0,1,499,0.0,499.0,499.0
119494864.0,6,232,26072,116,18120,1037214.2869565216,284.0,156.20689655172413,116,7952,1037214.1913043478,140.0,68.55172413793103
108106671.0,17,5,1005,5,1005,27026667.75,201.0,201.0,0,0,0.0,0.0,0.0
135125589.0,17,6,1206,6,1206,27025117.8,201.0,201.0,0,0,0.0,0.0,0.0
149869863.0,17,36,17126,36,17126,4281996.085714285,501.0,475.72222222222223,0,0,0.0,0.0,0.0
134813.0,6,2,132,1,66,0.0,66.0,66.0,1,66,0.0,66.0,66.0
21653.0,6,13,1459,7,862,3307.0,271.0,123.14285714285714,6,597,4144.6,259.0,99.5
143891.0,17,2,180,1,90,0.0,90.0,90.0,1,90,0.0,90.0,90.0
20282.0,6,14,4740,7,653,3191.5,249.0,93.28571428571428,7,4087,3243.5,1514.0,583.8571428571429
383.0,17,2,762,2,762,0.0,381.0,381.0,0,0,0.0,0.0,0.0
315150.0,17,4,1400,4,1400,105050.0,350.0,350.0,0,0,0.0,0.0,0.0
114938368.0,6,34,2334,17,1209,7170870.9375,123.0,71.11764705882354,17,1125,7170872.0,123.0,66.17647058823529
120241549.0,6,254,29124,127,8604,947780.1666666666,140.0,67.74803149606299,127,20520,947769.0873015872,284.0,161.5748031496063
108116915.0,17,5,1005,5,1005,27029228.75,201.0,201.0,0,0,0.0,0.0,0.0
2383.0,17,4,344,2,150,0.0,75.0,75.0,2,194,0.0,103.0,97.0
35135.0,6,14,4740,7,653,5735.5,249.0,93.28571428571428,7,4087,5174.166666666667,1514.0,583.8571428571429
15559.0,6,10,1975,5,467,2998.5,195.0,93.4,5,1508,2273.0,1236.0,301.6
12552.0,6,13,1459,7,862,1944.0,271.0,123.14285714285714,6,597,2356.8,259.0,99.5
2624655.0,6,25,7573,14,3735,201896.53846153847,1514.0,266.7857142857143,11,3838,234954.5,1514.0,348.90909090909093
108113604.0,17,5,1005,5,1005,27028401.0,201.0,201.0,0,0,0.0,0.0,0.0
120063019.0,17,28,13364,28,13364,4446778.481481481,501.0,477.2857142857143,0,0,0.0,0.0,0.0
307832.0,6,6,412,4,272,102610.66666666669,74.0,68.0,2,140,0.0,74.0,70.0
2085.0,17,4,344,2,150,0.0,75.0,75.0,2,194,0.0,103.0,97.0
102015476.0,17,12,778,6,389,20403095.2,174.0,64.83333333333333,6,389,16200192.6,174.0,64.83333333333333
89971.0,6,2,132,1,66,0.0,66.0,66.0,1,66,0.0,66.0,66.0
118852357.0,6,37,2656,19,1408,6602908.722222222,139.0,74.10526315789474,18,1248,6977972.588235294,123.0,69.33333333333333
149716816.0,6,16,2356,6,1086,23977034.4,204.0,181.0,10,1270,16635050.666666666,188.0,127.0
21764.0,6,10,2032,5,524,5211.5,252.0,104.8,5,1508,4764.0,1236.0,301.6
44734.0,6,14,4740,7,653,7332.5,249.0,93.28571428571428,7,4087,6755.0,1514.0,583.8571428571429
5829760.0,6,5,336,2,134,0.0,68.0,67.0,3,202,1522376.0,70.0,67.33333333333333
362.0,17,2,166,1,75,0.0,75.0,75.0,1,91,0.0,91.0,91.0
42212.0,6,14,4740,7,653,6501.5,249.0,93.28571428571428,7,4087,6353.166666666667,1514.0,583.8571428571429
218259.0,6,4,504,3,358,109129.5,214.0,119.33333333333331,1,146,0.0,146.0,146.0
114025956.0,17,14,864,7,432,19000390.33333333,174.0,61.71428571428572,7,432,19000175.166666668,174.0,61.71428571428572
120355241.0,6,203,22914,102,16026,1191636.0495049504,284.0,157.11764705882354,101,6888,1193171.13,140.0,68.1980198019802
762.0,17,2,684,2,684,0.0,342.0,342.0,0,0,0.0,0.0,0.0
120540827.0,6,261,29766,131,20964,927237.1307692308,284.0,160.03053435114504,130,8802,922004.3875968992,140.0,67.70769230769231
2968576.0,6,12,2172,7,664,494578.0,252.0,94.85714285714286,5,1508,2768.25,1236.0,301.6
50832.0,17,2,180,1,90,0.0,90.0,90.0,1,90,0.0,90.0,90.0
2593280.0,6,2,132,1,66,0.0,66.0,66.0,1,66,0.0,66.0,66.0
153537.0,17,2,180,1,90,0.0,90.0,90.0,1,90,0.0,90.0,90.0
2058.0,17,4,344,2,150,0.0,75.0,75.0,2,194,0.0,103.0,97.0
47567.0,6,10,2032,5,524,11145.5,252.0,104.8,5,1508,10929.25,1236.0,301.6
4514.0,17,2,614,1,72,0.0,72.0,72.0,1,542,0.0,542.0,542.0
302065.0,6,6,412,4,272,100688.33333333331,74.0,68.0,2,140,0.0,74.0,70.0
434.0,17,2,166,1,75,0.0,75.0,75.0,1,91,0.0,91.0,91.0
67226.0,6,14,4740,7,653,11066.166666666666,249.0,93.28571428571428,7,4087,11016.0,1514.0,583.8571428571429
190959.0,17,2,180,1,90,0.0,90.0,90.0,1,90,0.0,90.0,90.0
1113178.0,6,7,498,3,214,308787.5,78.0,71.33333333333333,4,284,371059.3333333333,78.0,71.0
90258133.0,6,13,2036,8,1016,12894019.0,188.0,127.0,5,1020,22521335.5,204.0,204.0
100212620.0,17,14,1126,7,563,16667889.333333334,174.0,80.42857142857143,7,563,16666836.166666666,174.0,80.42857142857143
2325.0,17,4,344,2,150,0.0,75.0,75.0,2,194,0.0,103.0,97.0
147948.0,17,2,180,1,90,0.0,90.0,90.0,1,90,0.0,90.0,90.0
345.0,17,2,160,1,80,0.0,80.0,80.0,1,80,0.0,80.0,80.0
2466.0,17,4,344,2,150,0.0,75.0,75.0,2,194,0.0,103.0,97.0
103646407.0,6,29,3104,15,1560,7402600.428571428,426.0,104.0,14,1544,7972605.461538462,334.0,110.28571428571428
90255655.0,6,14,2240,8,1016,12893665.0,188.0,127.0,6,1224,18018747.4,204.0,204.0
107192.0,17,2,286,2,286,0.0,143.0,143.0,0,0,0.0,0.0,0.0
10740.0,6,10,1067,5,536,2497.75,264.0,107.2,5,531,2198.25,259.0,106.2
74870.0,6,14,4740,7,653,11161.166666666666,249.0,93.28571428571428,7,4087,11469.166666666666,1514.0,583.8571428571429
2796221.0,6,2,132,1,66,0.0,66.0,66.0,1,66,0.0,66.0,66.0
64700.99999999999,6,11,2098,6,590,9530.6,252.0,98.33333333333331,5,1508,13453.75,1236.0,301.6
120035177.0,6,25,2447,13,989,9999431.5,95.0,76.07692307692308,12,1458,10866828.909090908,377.0,121.5
152580.0,17,4,6056,4,6056,50860.0,1514.0,1514.0,0,0,0.0,0.0,0.0
3293620.0,6,3,1604,2,851,0.0,785.0,425.5,1,753,0.0,753.0,753.0
5013985.0,17,4,849,2,166,0.0,83.0,83.0,2,683,0.0,499.0,341.5
108640265.0,6,28,1876,14,982,8340339.384615385,139.0,70.14285714285714,14,894,8340307.384615385,123.0,63.85714285714285
120007168.0,6,16,1192,8,596,17143881.14285714,95.0,74.5,8,596,17108667.0,95.0,74.5
120065718.0,17,29,13785,29,13785,4288061.357142857,501.0,475.3448275862069,0,0,0.0,0.0,0.0
90024175.0,17,28,13364,28,13364,3334228.703703704,501.0,477.2857142857143,0,0,0.0,0.0,0.0
207368.0,6,3,426,2,280,0.0,214.0,140.0,1,146,0.0,146.0,146.0
135132129.0,17,6,1146,6,1146,27026425.8,191.0,191.0,0,0,0.0,0.0,0.0
46947.0,6,14,4740,7,653,7582.833333333333,249.0,93.28571428571428,7,4087,6976.666666666667,1514.0,583.8571428571429
103237.0,17,2,286,2,286,0.0,143.0,143.0,0,0,0.0,0.0,0.0
334.0,17,2,166,1,75,0.0,75.0,75.0,1,91,0.0,91.0,91.0
18156.0,6,10,2032,5,524,4121.75,252.0,104.8,5,1508,4231.75,1236.0,301.6
312979.0,17,4,1400,4,1400,104326.33333333331,350.0,350.0,0,0,0.0,0.0,0.0
300535.0,6,6,412,4,272,100178.33333333331,74.0,68.0,2,140,0.0,74.0,70.0
90252559.0,6,12,1832,8,1016,12893222.714285716,188.0,127.0,4,816,30029722.0,204.0,204.0
93187.0,6,12,1413,7,882,15531.166666666666,291.0,126.0,5,531,21450.5,259.0,106.2
15246.0,6,10,2032,5,524,3634.75,252.0,104.8,5,1508,3285.0,1236.0,301.6
120127913.0,6,250,28532,125,8546,965991.0483870968,140.0,68.368,125,19986,953771.6532258064,300.0,159.888
22612.0,6,14,4740,7,653,3623.5,249.0,93.28571428571428,7,4087,3630.8333333333335,1514.0,583.8571428571429
103063345.0,6,189,21270,95,6492,1096418.5638297873,140.0,68.33684210526316,94,14778,1041742.2688172044,284.0,157.2127659574468
302.0,17,2,208,1,72,0.0,72.0,72.0,1,136,0.0,136.0,136.0
232452.0,6,3,337,2,214,0.0,160.0,107.0,1,123,0.0,123.0,123.0
32282.0,6,14,4740,7,653,4960.333333333333,249.0,93.28571428571428,7,4087,5159.333333333333,1514.0,583.8571428571429
12372.0,6,14,4740,7,653,1849.1666666666667,249.0,93.28571428571428,7,4087,1926.1666666666667,1514.0,583.8571428571429
113334688.0,6,209,23506,105,7152,1089756.6153846155,140.0,68.11428571428571,104,16354,1081295.9708737864,284.0,157.25
316.0,17,2,174,1,79,0.0,79.0,79.0,1,95,0.0,95.0,95.0
120000047.0,6,20,1531,11,840,12000004.7,95.0,76.36363636363636,9,691,11284956.625,95.0,76.77777777777777
302761.0,6,6,412,4,272,100920.33333333331,74.0,68.0,2,140,0.0,74.0,70.0
146052.0,6,3,337,2,214,0.0,160.0,107.0,1,123,0.0,123.0,123.0
246519.0,6,3,337,2,214,0.0,160.0,107.0,1,123,0.0,123.0,123.0
727403.0,6,2,132,1,66,0.0,66.0,66.0,1,66,0.0,66.0,66.0
108110409.0,17,5,955,5,955,27027602.25,191.0,191.0,0,0,0.0,0.0,0.0
8045.999999999999,17,2,180,1,90,0.0,90.0,90.0,1,90,0.0,90.0,90.0
308211.0,6,3,202,2,128,0.0,74.0,64.0,1,74,0.0,74.0,74.0
117308184.0,6,33,2280,17,1209,7318275.9375,123.0,71.11764705882354,16,1071,7806156.333333333,123.0,66.9375
315.0,17,2,174,1,79,0.0,79.0,79.0,1,95,0.0,95.0,95.0
104093.0,17,2,286,2,286,0.0,143.0,143.0,0,0,0.0,0.0,0.0
320486.0,17,4,1400,4,1400,106828.66666666669,350.0,350.0,0,0,0.0,0.0,0.0
3260.0,17,2,359,1,75,0.0,75.0,75.0,1,284,0.0,284.0,284.0
51782.0,6,10,2032,5,524,12601.75,252.0,104.8,5,1508,11480.5,1236.0,301.6
16954.0,17,2,180,1,90,0.0,90.0,90.0,1,90,0.0,90.0,90.0
43124.0,6,10,2032,5,524,10083.25,252.0,104.8,5,1508,10502.75,1236.0,301.6
1307022.0,6,4,264,2,132,0.0,66.0,66.0,2,132,0.0,66.0,66.0
91298671.0,6,430,90516,210,14304,436835.74641148327,214.0,68.11428571428571,220,76212,412203.5433789954,1514.0,346.41818181818184
110844086.0,6,31,2176,16,1071,7389574.4,123.0,66.9375,15,1105,7204067.071428572,139.0,73.66666666666667
14170470.0,17,6,2052,6,2052,2834094.0,342.0,342.0,0,0,0.0,0.0,0.0
144008.0,17,2,180,1,90,0.0,90.0,90.0,1,90,0.0,90.0,90.0
258399.0,6,3,337,2,214,0.0,160.0,107.0,1,123,0.0,123.0,123.0
120035942.0,17,28,13364,28,13364,4445775.62962963,501.0,477.2857142857143,0,0,0.0,0.0,0.0
108778821.0,6,206,23346,103,16326,1064347.2647058824,284.0,158.50485436893203,103,7020,1064231.950980392,140.0,68.15533980582525
241396.0,17,2,180,1,90,0.0,90.0,90.0,1,90,0.0,90.0,90.0
21230.0,6,14,4740,7,653,3341.833333333333,249.0,93.28571428571428,7,4087,3274.5,1514.0,583.8571428571429
14370800.0,17,6,2052,6,2052,2874160.0,342.0,342.0,0,0,0.0,0.0,0.0
103832.0,17,2,700,2,700,0.0,350.0,350.0,0,0,0.0,0.0,0.0
14202.0,6,14,4740,7,653,2078.0,249.0,93.28571428571428,7,4087,2229.833333333333,1514.0,583.8571428571429
353.0,17,2,267,1,83,0.0,83.0,83.0,1,184,0.0,184.0,184.0
314270.0,6,6,412,4,272,104756.66666666669,74.0,68.0,2,140,0.0,74.0,70.0
108745.0,17,2,286,2,286,0.0,143.0,143.0,0,0,0.0,0.0,0.0
120026354.0,17,28,13364,28,13364,4445420.518518519,501.0,477.2857142857143,0,0,0.0,0.0,0.0
108121902.0,17,5,1005,5,1005,27030475.5,201.0,201.0,0,0,0.0,0.0,0.0
38906.0,6,10,2032,5,524,8229.0,252.0,104.8,5,1508,7781.5,1236.0,301.6
108101086.0,17,5,955,5,955,27025271.5,191.0,191.0,0,0,0.0,0.0,0.0
25999.0,6,20,7606,11,978,2599.9,310.0,88.9090909090909,9,6628,2713.75,1514.0,736.4444444444445
33971.0,6,14,4740,7,653,5430.5,249.0,93.28571428571428,7,4087,4887.833333333333,1514.0,583.8571428571429
123455537.0,6,49,3234,25,1650,5143980.708333333,66.0,66.0,24,1584,4934258.826086956,66.0,66.0
135129457.0,17,6,1146,6,1146,27025891.4,191.0,191.0,0,0,0.0,0.0,0.0
90226110.0,6,19,1436,9,691,11246677.625,95.0,76.77777777777777,10,745,10001176.666666666,95.0,74.5
91417809.0,6,22,1680,12,935,8310266.363636363,95.0,77.91666666666667,10,745,10157002.0,95.0,74.5
161218.0,6,3,337,2,214,0.0,160.0,107.0,1,123,0.0,123.0,123.0
120050303.0,17,28,13364,28,13364,4446307.518518519,501.0,477.2857142857143,0,0,0.0,0.0,0.0
146038.0,6,3,337,2,214,0.0,160.0,107.0,1,123,0.0,123.0,123.0
886253.0,6,10,1334,6,797,177250.6,459.0,132.83333333333334,4,537,203593.0,331.0,134.25
232904.0,6,3,337,2,214,0.0,160.0,107.0,1,123,0.0,123.0,123.0
216947.0,6,3,426,2,280,0.0,214.0,140.0,1,146,0.0,146.0,146.0
90954814.0,6,21,1585,11,840,9094467.6,95.0,76.36363636363636,10,745,10105054.888888888,95.0,74.5
96900117.0,6,40,2640,20,1320,5100006.157894737,66.0,66.0,20,1320,5085651.105263158,66.0,66.0
52818.0,6,14,4740,7,653,6732.5,249.0,93.28571428571428,7,4087,8625.333333333334,1514.0,583.8571428571429
10488341.0,6,7,478,4,272,3450751.0,74.0,68.0,3,206,5175997.0,74.0,68.66666666666667
108002372.0,6,32,2236,16,1165,7200158.133333334,139.0,72.8125,16,1071,7185726.6,123.0,66.9375
2855149.0,6,3,1604,2,851,0.0,785.0,425.5,1,753,0.0,753.0,753.0
334.0,17,2,160,1,80,0.0,80.0,80.0,1,80,0.0,80.0,80.0
135134676.0,17,6,1146,6,1146,27026935.2,191.0,191.0,0,0,0.0,0.0,0.0
90000455.0,17,28,13364,28,13364,3333350.185185185,501.0,477.2857142857143,0,0,0.0,0.0,0.0
1610040.0,6,45,29965,23,1693,73183.63636363637,233.0,73.6086956521739,22,28272,76012.71428571429,1514.0,1285.090909090909
2794103.0,6,2,132,1,66,0.0,66.0,66.0,1,66,0.0,66.0,66.0
13083.0,6,10,2032,5,524,2906.25,252.0,104.8,5,1508,2367.75,1236.0,301.6
1178928.0,6,13,3010,8,2382,168418.2857142857,1514.0,297.75,5,628,226541.75,331.0,125.6
232904.0,6,3,337,2,214,0.0,160.0,107.0,1,123,0.0,123.0,123.0
51241.0,6,14,4740,7,653,7523.666666666667,249.0,93.28571428571428,7,4087,8416.833333333334,1514.0,583.8571428571429
246997.0,17,2,180,1,90,0.0,90.0,90.0,1,90,0.0,90.0,90.0
99075952.0,6,40,2640,20,1320,5214523.7894736845,66.0,66.0,20,1320,5197974.736842105,66.0,66.0
13707.0,6,11,1131,6,600,2542.8,262.0,100.0,5,531,3092.5,259.0,106.2
5513761.0,6,5,336,2,134,0.0,68.0,67.0,3,202,1421976.5,70.0,67.33333333333333
303134.0,6,6,412,4,272,101044.66666666669,74.0,68.0,2,140,0.0,74.0,70.0
249302.0,17,4,6056,4,6056,83100.66666666667,1514.0,1514.0,0,0,0.0,0.0,0.0
322810.0,17,4,1400,4,1400,107603.33333333331,350.0,350.0,0,0,0.0,0.0,0.0
67943.0,6,14,4740,7,653,10188.666666666666,249.0,93.28571428571428,7,4087,10869.5,1514.0,583.8571428571429
7445.0,17,2,582,1,83,0.0,83.0,83.0,1,499,0.0,499.0,499.0
313762.0,6,6,412,4,272,104587.33333333331,74.0,68.0,2,140,0.0,74.0,70.0
147637.0,6,3,337,2,214,0.0,160.0,107.0,1,123,0.0,123.0,123.0
143573.0,6,2,132,1,66,0.0,66.0,66.0,1,66,0.0,66.0,66.0
90301877.0,6,16,1192,8,596,12893635.285714284,95.0,74.5,8,596,12899932.0,95.0,74.5
204581.0,17,2,762,2,762,0.0,381.0,381.0,0,0,0.0,0.0,0.0
21508.0,6,10,2032,5,524,5148.75,252.0,104.8,5,1508,4918.25,1236.0,301.6
1776276.0,6,2,132,1,66,0.0,66.0,66.0,1,66,0.0,66.0,66.0
328976.0,6,10,1221,6,636,65795.2,298.0,106.0,4,585,104265.0,379.0,146.25
303061.0,6,6,412,4,272,101020.33333333331,74.0,68.0,2,140,0.0,74.0,70.0
501619.00000000006,6,4,270,2,134,0.0,68.0,67.0,2,136,0.0,70.0,68.0
2505.0,17,4,344,2,150,0.0,75.0,75.0,2,194,0.0,103.0,97.0
3079632.0,6,3,204,2,134,0.0,68.0,67.0,1,70,0.0,70.0,70.0
357.0,17,2,208,1,72,0.0,72.0,72.0,1,136,0.0,136.0,136.0
21171.0,6,14,4740,7,653,3289.333333333333,249.0,93.28571428571428,7,4087,3397.333333333333,1514.0,583.8571428571429
55025.0,6,14,4740,7,653,8488.166666666666,249.0,93.28571428571428,7,4087,8778.166666666666,1514.0,583.8571428571429
54552.0,6,14,4740,7,653,7854.166666666667,249.0,93.28571428571428,7,4087,7068.833333333333,1514.0,583.8571428571429
146278.0,6,3,337,2,214,0.0,160.0,107.0,1,123,0.0,123.0,123.0
0.0,17,1,55,1,55,0.0,55.0,55.0,0,0,0.0,0.0,0.0
35804.0,6,14,4740,7,653,4741.333333333333,249.0,93.28571428571428,7,4087,5264.0,1514.0,583.8571428571429
212060.0,6,10,1221,6,636,42412.0,298.0,106.0,4,585,69167.66666666667,379.0,146.25
118915934.0,6,36,2596,18,1348,6982358.294117647,139.0,74.88888888888889,18,1248,6982356.05882353,123.0,69.33333333333333
225478.0,6,10,1221,6,636,45095.6,298.0,106.0,4,585,74142.0,379.0,146.25
210668.0,6,10,1221,6,636,42133.6,298.0,106.0,4,585,69152.66666666667,379.0,146.25
216967.0,17,2,180,1,90,0.0,90.0,90.0,1,90,0.0,90.0,90.0
48670.0,6,13,1386,7,789,8111.666666666667,253.0,112.71428571428572,6,597,8854.6,259.0,99.5
2329.0,17,4,344,2,150,0.0,75.0,75.0,2,194,0.0,103.0,97.0
2329.0,17,4,344,2,150,0.0,75.0,75.0,2,194,0.0,103.0,97.0
97192.0,17,2,762,2,762,0.0,381.0,381.0,0,0,0.0,0.0,0.0
1101045.0,6,11,1134,6,558,220209.0,220.0,93.0,5,576,274142.75,304.0,115.2
207560.0,6,3,426,2,280,0.0,214.0,140.0,1,146,0.0,146.0,146.0
41294.0,6,14,4740,7,653,5982.833333333333,249.0,93.28571428571428,7,4087,6661.333333333333,1514.0,583.8571428571429
207152.0,6,3,426,2,280,0.0,214.0,140.0,1,146,0.0,146.0,146.0
137552.0,17,4,344,2,150,0.0,75.0,75.0,2,194,0.0,103.0,97.0
153446.0,17,2,180,1,90,0.0,90.0,90.0,1,90,0.0,90.0,90.0
106743.0,17,2,286,2,286,0.0,143.0,143.0,0,0,0.0,0.0,0.0
302620.0,6,6,412,4,272,100873.33333333331,74.0,68.0,2,140,0.0,74.0,70.0
311796.0,17,4,1400,4,1400,103932.0,350.0,350.0,0,0,0.0,0.0,0.0
153425.0,17,2,180,1,90,0.0,90.0,90.0,1,90,0.0,90.0,90.0
60423020.0,6,17,1287,8,596,8597138.285714285,95.0,74.5,9,691,7530005.875,95.0,76.77777777777777
6114.0,17,2,447,1,84,0.0,84.0,84.0,1,363,0.0,363.0,363.0
32556.0,6,11,2098,6,590,5665.8,252.0,98.33333333333331,5,1508,7180.0,1236.0,301.6
55269.0,6,14,4740,7,653,9070.0,249.0,93.28571428571428,7,4087,8207.166666666666,1514.0,583.8571428571429
511735.00000000006,6,5,336,2,134,0.0,68.0,67.0,3,202,191939.0,70.0,67.33333333333333
72054.0,6,10,1065,5,534,15908.5,262.0,106.8,5,531,17529.0,259.0,106.2
301491.0,6,6,412,4,272,100497.0,74.0,68.0,2,140,0.0,74.0,70.0
99271.0,17,2,762,2,762,0.0,381.0,381.0,0,0,0.0,0.0,0.0
108100041.0,17,5,1005,5,1005,27025010.25,201.0,201.0,0,0,0.0,0.0,0.0
135131048.0,17,6,1146,6,1146,27026209.6,191.0,191.0,0,0,0.0,0.0,0.0
103600923.0,17,14,864,7,432,17167519.833333332,174.0,61.71428571428572,7,432,17166825.5,174.0,61.71428571428572
203759.0,17,4,6056,4,6056,67919.66666666667,1514.0,1514.0,0,0,0.0,0.0,0.0
106000952.0,17,13,821,7,432,17666825.333333332,174.0,61.71428571428572,6,389,20037806.2,174.0,64.83333333333333
100271462.0,6,38,3118,21,1717,5013573.1,139.0,81.76190476190476,17,1401,6254163.875,123.0,82.41176470588235
153570.0,17,2,180,1,90,0.0,90.0,90.0,1,90,0.0,90.0,90.0
135139576.0,17,6,1206,6,1206,27027915.2,201.0,201.0,0,0,0.0,0.0,0.0
857058.0,6,9,1118,6,586,171411.6,248.0,97.66666666666669,3,532,290603.0,392.0,177.33333333333334
322.0,17,2,174,1,79,0.0,79.0,79.0,1,95,0.0,95.0,95.0
123712010.0,6,49,3234,25,1650,5154667.083333333,66.0,66.0,24,1584,5009659.869565218,66.0,66.0
283833.0,17,2,363,1,79,0.0,79.0,79.0,1,284,0.0,284.0,284.0
105238833.0,6,188,21204,94,14778,1129286.494623656,284.0,157.2127659574468,94,6426,1129286.440860215,140.0,68.36170212765957
261648.0,6,10,1221,6,636,52329.6,298.0,106.0,4,585,81845.33333333333,379.0,146.25
104594.0,17,2,286,2,286,0.0,143.0,143.0,0,0,0.0,0.0,0.0
120057523.0,17,28,13364,28,13364,4446574.925925926,501.0,477.2857142857143,0,0,0.0,0.0,0.0
1176032.0,6,13,3010,8,2382,168004.57142857142,1514.0,297.75,5,628,225095.25,331.0,125.6
28034.0,6,10,2032,5,524,6033.75,252.0,104.8,5,1508,6503.25,1236.0,301.6
33074.0,6,14,4740,7,653,5378.5,249.0,93.28571428571428,7,4087,4425.0,1514.0,583.8571428571429
308967.0,6,6,412,4,272,102989.0,74.0,68.0,2,140,0.0,74.0,70.0
18656.0,6,14,4740,7,653,2910.5,249.0,93.28571428571428,7,4087,2975.833333333333,1514.0,583.8571428571429
747326.0,6,2,132,1,66,0.0,66.0,66.0,1,66,0.0,66.0,66.0
144949.0,17,2,180,1,70,0.0,70.0,70.0,1,110,0.0,110.0,110.0
103368.0,17,2,762,2,762,0.0,381.0,381.0,0,0,0.0,0.0,0.0
24093.0,6,10,2032,5,524,5715.5,252.0,104.8,5,1508,5287.25,1236.0,301.6
1196204.0,6,13,3010,8,2382,170886.2857142857,1514.0,297.75,5,628,230097.5,331.0,125.6
100431717.0,17,12,778,6,389,20086343.4,174.0,64.83333333333333,6,389,19952193.4,174.0,64.83333333333333
5624717.0,6,5,336,2,134,0.0,68.0,67.0,3,202,1423608.0,70.0,67.33333333333333
205765.0,17,2,180,1,90,0.0,90.0,90.0,1,90,0.0,90.0,90.0
255395.0,6,10,1221,6,636,51079.0,298.0,106.0,4,585,79773.66666666667,379.0,146.25
0.0,17,1,178,1,178,0.0,178.0,178.0,0,0,0.0,0.0,0.0
113775076.0,17,16,1212,8,606,16000997.857142856,174.0,75.75,8,606,16000147.714285716,174.0,75.75
241414.0,6,3,373,2,238,0.0,172.0,119.0,1,135,0.0,135.0,135.0
1182830.0,6,13,3012,8,2384,168975.7142857143,1514.0,298.0,5,628,226780.75,331.0,125.6
18763.0,6,10,2032,5,524,3729.25,252.0,104.8,5,1508,4346.5,1236.0,301.6
135137042.0,17,6,1206,6,1206,27027408.4,201.0,201.0,0,0,0.0,0.0,0.0
228238.0,17,2,180,1,90,0.0,90.0,90.0,1,90,0.0,90.0,90.0
23445.0,6,14,4740,7,653,2487.833333333333,249.0,93.28571428571428,7,4087,3684.0,1514.0,583.8571428571429
