flow_duration,protocol,TotPackets,TotBytes,tot_fwd_pkts,totlen_fwd_pkts,fwd_iat_mean,fwd_pkt_len_max,fwd_pkt_len_mean,tot_bwd_pkts,totlen_bwd_pkts,bwd_iat_mean,bwd_pkt_len_max,bwd_pkt_len_mean
314521.0,17,4,1400,4,1400,104840.33333333331,350.0,350.0,0,0,0.0,0.0,0.0
112813314.0,6,48,3168,24,1584,4904926.695652174,66.0,66.0,24,1584,4895529.782608695,66.0,66.0
889936.0,6,13,1428,7,797,148052.16666666666,253.0,113.85714285714286,6,631,177416.0,293.0,105.16666666666669
90519994.0,6,14,2240,8,1016,12931427.714285716,188.0,127.0,6,1224,18071787.6,204.0,204.0
35246.0,6,14,4740,7,653,5497.5,249.0,93.28571428571428,7,4087,5616.333333333333,1514.0,583.8571428571429
1170688.0,6,13,3010,8,2382,167241.14285714287,1514.0,297.75,5,628,223709.25,331.0,125.6
248274.0,6,4,439,2,238,0.0,172.0,119.0,2,201,0.0,135.0,100.5
346.0,17,2,267,1,83,0.0,83.0,83.0,1,184,0.0,184.0,184.0
15720.000000000002,6,20,7606,11,978,1572.0,310.0,88.9090909090909,9,6628,1671.125,1514.0,736.4444444444445
407261.0,6,3,1604,1,753,0.0,753.0,753.0,2,851,0.0,785.0,425.5
3437300.0,6,7,923,4,753,1077379.0,571.0,188.25,3,170,1615869.5,62.0,56.66666666666666
6237534.0,6,127,126044,36,2536,178215.25714285715,206.0,70.44444444444444,91,123508,69219.12222222223,1514.0,1357.2307692307693
143971.0,17,2,180,1,90,0.0,90.0,90.0,1,90,0.0,90.0,90.0
32677.0,6,14,4740,7,653,5337.5,249.0,93.28571428571428,7,4087,5229.5,1514.0,583.8571428571429
59394.0,17,2,762,2,762,0.0,381.0,381.0,0,0,0.0,0.0,0.0
135135972.0,17,6,1146,6,1146,27027194.4,191.0,191.0,0,0,0.0,0.0,0.0
29792.0,6,10,2032,5,524,6392.5,252.0,104.8,5,1508,6882.5,1236.0,301.6
871685.0,6,9,1269,6,798,174337.0,460.0,133.0,3,471,297425.0,331.0,157.0
120015270.0,6,283,33182,142,9594,851172.1276595745,140.0,67.56338028169014,141,23588,850288.1571428571,284.0,167.29078014184398
102615757.0,17,14,864,7,432,17000721.833333332,174.0,61.71428571428572,7,432,17000161.5,174.0,61.71428571428572
314.0,17,2,160,1,80,0.0,80.0,80.0,1,80,0.0,80.0,80.0
265583.0,6,3,337,2,214,0.0,160.0,107.0,1,123,0.0,123.0,123.0
31808731.0,17,5,1718,4,1368,841411.3333333334,342.0,342.0,1,350,0.0,350.0,350.0
2204958.0,6,18,6803,10,1501,244995.3333333333,408.0,150.1,8,5302,252365.0,1514.0,662.75
1310911.0,6,4,264,2,132,0.0,66.0,66.0,2,132,0.0,66.0,66.0
51680.0,6,14,4740,7,653,8153.166666666667,249.0,93.28571428571428,7,4087,8317.833333333334,1514.0,583.8571428571429
56262.0,6,10,2032,5,524,12168.25,252.0,104.8,5,1508,13667.0,1236.0,301.6
103137.0,17,2,286,2,286,0.0,143.0,143.0,0,0,0.0,0.0,0.0
8992.0,6,10,1066,5,490,1919.0,218.0,98.0,5,576,2017.5,304.0,115.2
108109039.0,17,5,955,5,955,27027259.75,191.0,191.0,0,0,0.0,0.0,0.0
121207.0,6,3,337,2,214,0.0,160.0,107.0,1,123,0.0,123.0,123.0
26913.0,6,14,4740,7,653,3827.3333333333335,249.0,93.28571428571428,7,4087,4254.333333333333,1514.0,583.8571428571429
310085.0,17,4,1400,4,1400,103361.66666666669,350.0,350.0,0,0,0.0,0.0,0.0
240129.0,6,3,337,2,214,0.0,160.0,107.0,1,123,0.0,123.0,123.0
633.0,17,5,550,5,550,158.25,110.0,110.0,0,0,0.0,0.0,0.0
22170.0,6,14,4740,7,653,3377.5,249.0,93.28571428571428,7,4087,3483.5,1514.0,583.8571428571429
1326160.0,6,4,492,2,280,0.0,214.0,140.0,2,212,0.0,146.0,106.0
150.0,17,2,700,2,700,0.0,350.0,350.0,0,0,0.0,0.0,0.0
2005063.0,17,4,525,2,150,0.0,75.0,75.0,2,375,0.0,284.0,187.5
2423.0,17,4,344,2,150,0.0,75.0,75.0,2,194,0.0,103.0,97.0
200503.0,17,4,6056,4,6056,66834.33333333333,1514.0,1514.0,0,0,0.0,0.0,0.0
298447.0,6,6,412,4,272,99482.33333333331,74.0,68.0,2,140,0.0,74.0,70.0
103577.0,17,2,700,2,700,0.0,350.0,350.0,0,0,0.0,0.0,0.0
184709.0,17,2,180,1,90,0.0,90.0,90.0,1,90,0.0,90.0,90.0
145095.0,17,2,180,1,70,0.0,70.0,70.0,1,110,0.0,110.0,110.0
207365.0,6,3,426,2,280,0.0,214.0,140.0,1,146,0.0,146.0,146.0
707.0,17,4,438,2,148,0.0,74.0,74.0,2,290,0.0,147.0,145.0
2516.0,17,4,344,2,150,0.0,75.0,75.0,2,194,0.0,103.0,97.0
734.0,17,2,684,2,684,0.0,342.0,342.0,0,0,0.0,0.0,0.0
52413.0,6,14,4740,7,653,8579.833333333334,249.0,93.28571428571428,7,4087,7687.5,1514.0,583.8571428571429
82.0,17,2,762,2,762,0.0,381.0,381.0,0,0,0.0,0.0,0.0
62507.99999999999,17,4,823,2,163,0.0,89.0,81.5,2,660,0.0,443.0,330.0
233134.0,6,3,337,2,214,0.0,160.0,107.0,1,123,0.0,123.0,123.0
3334941.0,6,193,163060,114,153545,29512.75221238938,1510.0,1346.8859649122808,79,9515,38735.10256410256,1510.0,120.44303797468356
90008395.0,17,28,13364,28,13364,3333644.25925926,501.0,477.2857142857143,0,0,0.0,0.0,0.0
26729.0,6,14,4740,7,653,4334.333333333333,249.0,93.28571428571428,7,4087,4024.8333333333335,1514.0,583.8571428571429
90028260.0,17,28,13364,28,13364,3334380.0,501.0,477.2857142857143,0,0,0.0,0.0,0.0
153491.0,17,2,180,1,90,0.0,90.0,90.0,1,90,0.0,90.0,90.0
237585.0,17,2,180,1,90,0.0,90.0,90.0,1,90,0.0,90.0,90.0
5616401.0,6,5,336,2,134,0.0,68.0,67.0,3,202,1523567.5,70.0,67.33333333333333
120123427.0,6,17,2572,8,1368,17160489.57142857,204.0,171.0,9,1204,14995108.75,188.0,133.77777777777777
216953.0,17,2,180,1,90,0.0,90.0,90.0,1,90,0.0,90.0,90.0
108105313.0,17,5,1005,5,1005,27026328.25,201.0,201.0,0,0,0.0,0.0,0.0
10920.0,6,10,1067,5,536,2013.25,264.0,107.2,5,531,2525.0,259.0,106.2
47303.0,6,14,4740,7,653,7760.166666666667,249.0,93.28571428571428,7,4087,7576.5,1514.0,583.8571428571429
218183.0,6,3,426,2,280,0.0,214.0,140.0,1,146,0.0,146.0,146.0
180136.0,6,14,4740,7,653,28140.166666666668,249.0,93.28571428571428,7,4087,28687.166666666668,1514.0,583.8571428571429
22422.0,6,14,4740,7,653,3614.8333333333335,249.0,93.28571428571428,7,4087,3289.0,1514.0,583.8571428571429
363030.0,6,11,1021,6,444,48765.6,162.0,74.0,5,577,60879.75,349.0,115.4
58726.0,6,14,4740,7,653,8309.166666666666,249.0,93.28571428571428,7,4087,9645.666666666666,1514.0,583.8571428571429
241350.0,6,3,337,2,214,0.0,160.0,107.0,1,123,0.0,123.0,123.0
207834.0,6,3,426,2,280,0.0,214.0,140.0,1,146,0.0,146.0,146.0
222842.0,6,3,426,2,280,0.0,214.0,140.0,1,146,0.0,146.0,146.0
146284.0,6,3,337,2,214,0.0,160.0,107.0,1,123,0.0,123.0,123.0
26854.0,6,14,4740,7,653,4205.333333333333,249.0,93.28571428571428,7,4087,2438.833333333333,1514.0,583.8571428571429
90018801.0,17,28,13364,28,13364,3334029.6666666665,501.0,477.2857142857143,0,0,0.0,0.0,0.0
2944357.0,6,115,87514,62,80171,43114.0,1510.0,1293.0806451612902,53,7343,50572.730769230766,1510.0,138.54716981132074
153479.0,17,2,180,1,90,0.0,90.0,90.0,1,90,0.0,90.0,90.0
302517.0,6,6,412,4,272,100839.0,74.0,68.0,2,140,0.0,74.0,70.0
108106015.0,17,5,955,5,955,27026503.75,191.0,191.0,0,0,0.0,0.0,0.0
315408.0,6,10,1221,6,636,63081.6,298.0,106.0,4,585,99416.0,379.0,146.25
83993.0,6,14,4740,7,653,13767.833333333334,249.0,93.28571428571428,7,4087,13849.5,1514.0,583.8571428571429
3007935.0,6,12,2172,7,664,501101.5,252.0,94.85714285714286,5,1508,2217.25,1236.0,301.6
250437.00000000003,17,4,6056,4,6056,83478.99999999999,1514.0,1514.0,0,0,0.0,0.0,0.0
148565.0,17,2,414,1,88,0.0,88.0,88.0,1,326,0.0,326.0,326.0
234189.0,6,10,1221,6,636,46837.8,298.0,106.0,4,585,70925.33333333333,379.0,146.25
120000078.0,6,17,1287,9,691,15000009.75,95.0,76.77777777777777,8,596,12898045.57142857,95.0,74.5
120124334.0,6,13,2036,5,1020,30031083.5,204.0,204.0,8,1016,17137193.57142857,188.0,127.0
37512.0,6,14,4740,7,653,5638.166666666667,249.0,93.28571428571428,7,4087,5955.666666666667,1514.0,583.8571428571429
25170.0,6,14,4740,7,653,4049.6666666666665,249.0,93.28571428571428,7,4087,3418.0,1514.0,583.8571428571429
120013424.0,17,28,13364,28,13364,4444941.62962963,501.0,477.2857142857143,0,0,0.0,0.0,0.0
65845.0,6,14,4740,7,653,10723.5,249.0,93.28571428571428,7,4087,6443.5,1514.0,583.8571428571429
2013.0,17,4,344,2,150,0.0,75.0,75.0,2,194,0.0,103.0,97.0
16896.0,17,2,180,1,90,0.0,90.0,90.0,1,90,0.0,90.0,90.0
119757454.0,17,35,16705,35,16705,3522278.0588235296,501.0,477.2857142857143,0,0,0.0,0.0,0.0
27655034.0,17,5,1710,5,1710,6913758.5,342.0,342.0,0,0,0.0,0.0,0.0
777.0,17,4,438,2,148,0.0,74.0,74.0,2,290,0.0,147.0,145.0
880989.0,6,10,1333,6,796,176197.8,458.0,132.66666666666666,4,537,202857.3333333333,331.0,134.25
3184886.0,6,18,1536,9,962,359067.125,315.0,106.88888888888889,9,574,359045.75,78.0,63.77777777777778
45928.0,6,14,4740,7,653,7394.333333333333,249.0,93.28571428571428,7,4087,6820.166666666667,1514.0,583.8571428571429
108035.0,17,2,286,2,286,0.0,143.0,143.0,0,0,0.0,0.0,0.0
860.0,17,4,438,2,148,0.0,74.0,74.0,2,290,0.0,147.0,145.0
120000505.0,6,16,1192,8,596,17142929.285714287,95.0,74.5,8,596,17107853.42857143,95.0,74.5
38991.0,6,10,2032,5,524,9518.25,252.0,104.8,5,1508,9414.75,1236.0,301.6
275407.0,17,2,238,1,74,0.0,74.0,74.0,1,164,0.0,164.0,164.0
123839802.0,6,48,3168,24,1584,5031587.565217392,66.0,66.0,24,1584,5270466.826086956,66.0,66.0
119682379.0,6,232,26306,116,18354,1038503.4869565218,374.0,158.22413793103448,116,7952,1038844.1565217392,140.0,68.55172413793103
216718.0,6,3,426,2,280,0.0,214.0,140.0,1,146,0.0,146.0,146.0
108093108.0,17,5,1005,5,1005,27023277.0,201.0,201.0,0,0,0.0,0.0,0.0
95725766.0,6,39,2574,20,1320,5038184.52631579,66.0,66.0,19,1254,5159977.722222222,66.0,66.0
457.0,17,2,508,2,508,0.0,257.0,254.0,0,0,0.0,0.0,0.0
107382401.0,6,31,2176,16,1071,7158826.733333333,123.0,66.9375,15,1105,6941597.071428572,139.0,73.66666666666667
120120225.0,6,14,2224,9,1204,15015028.125,188.0,133.77777777777777,5,1020,22523241.5,204.0,204.0
307552.0,6,6,412,4,272,102517.33333333331,74.0,68.0,2,140,0.0,74.0,70.0
117074072.0,6,240,28268,120,8216,976807.4957983192,140.0,68.46666666666667,120,20052,976895.2689075632,300.0,167.1
207023.0,6,3,426,2,280,0.0,214.0,140.0,1,146,0.0,146.0,146.0
9202.0,6,11,1132,6,556,1788.6,218.0,92.66666666666669,5,576,2058.5,304.0,115.2
120007322.0,6,31,3254,16,1654,7999991.266666667,426.0,103.375,15,1600,8571446.714285715,337.0,106.66666666666669
217942.0,6,3,426,2,280,0.0,214.0,140.0,1,146,0.0,146.0,146.0
147841.0,6,3,337,2,214,0.0,160.0,107.0,1,123,0.0,123.0,123.0
24129.0,6,14,4740,7,653,3891.8333333333335,249.0,93.28571428571428,7,4087,3195.833333333333,1514.0,583.8571428571429
205806.0,17,2,180,1,90,0.0,90.0,90.0,1,90,0.0,90.0,90.0
2592237.0,6,2,132,1,66,0.0,66.0,66.0,1,66,0.0,66.0,66.0
137016.0,6,14,4740,7,653,22713.0,249.0,93.28571428571428,7,4087,22256.0,1514.0,583.8571428571429
318710.0,17,4,1400,4,1400,106236.66666666669,350.0,350.0,0,0,0.0,0.0,0.0
118483081.0,6,371,43644,186,12572,640449.0864864865,140.0,67.59139784946237,185,31072,638291.3423913043,374.0,167.95675675675676
102918.0,17,2,286,2,286,0.0,143.0,143.0,0,0,0.0,0.0,0.0
3081.0,17,2,224,1,76,0.0,76.0,76.0,1,148,0.0,148.0,148.0
152224.0,6,3,337,2,214,0.0,160.0,107.0,1,123,0.0,123.0,123.0
192451.0,17,2,180,1,90,0.0,90.0,90.0,1,90,0.0,90.0,90.0
63359.0,6,10,2032,5,524,15603.0,252.0,104.8,5,1508,15006.25,1236.0,301.6
120008342.0,17,28,13364,28,13364,4444753.407407408,501.0,477.2857142857143,0,0,0.0,0.0,0.0
102684.0,17,2,286,2,286,0.0,143.0,143.0,0,0,0.0,0.0,0.0
196843.0,17,2,180,1,90,0.0,90.0,90.0,1,90,0.0,90.0,90.0
99022546.0,6,40,2640,20,1320,5211712.947368421,66.0,66.0,20,1320,5194438.631578947,66.0,66.0
293465.0,17,2,224,1,76,0.0,76.0,76.0,1,148,0.0,148.0,148.0
108109329.0,17,5,955,5,955,27027332.25,191.0,191.0,0,0,0.0,0.0,0.0
120038399.0,17,28,13364,28,13364,4445866.62962963,501.0,477.2857142857143,0,0,0.0,0.0,0.0
105917702.0,17,14,864,7,432,17501094.166666668,174.0,61.71428571428572,7,432,17500161.0,174.0,61.71428571428572
75595.0,6,14,4740,7,653,12473.5,249.0,93.28571428571428,7,4087,12337.666666666666,1514.0,583.8571428571429
277075.0,17,2,363,1,79,0.0,79.0,79.0,1,284,0.0,284.0,284.0
1162254.0,6,13,3000,8,2372,166036.2857142857,1514.0,296.5,5,628,221629.5,331.0,125.6
248568.0,6,3,337,2,214,0.0,160.0,107.0,1,123,0.0,123.0,123.0
334.0,17,2,166,1,75,0.0,75.0,75.0,1,91,0.0,91.0,91.0
320.0,17,2,174,1,79,0.0,79.0,79.0,1,95,0.0,95.0,95.0
3707.0,17,4,571,2,148,0.0,74.0,74.0,2,423,0.0,280.0,211.5
107827898.0,6,28,1860,14,966,8294453.692307692,123.0,69.0,14,894,8277831.0,123.0,63.85714285714285
122379881.0,17,14,864,7,432,17164027.5,174.0,61.71428571428572,7,432,17168102.166666668,174.0,61.71428571428572
52135.0,6,10,2032,5,524,11887.25,252.0,104.8,5,1508,10647.75,1236.0,301.6
1726829.0,6,23,6509,12,1529,156984.45454545456,357.0,127.41666666666669,11,4980,142155.2,1510.0,452.7272727272728
97627367.0,6,26,1746,13,906,8135613.916666667,123.0,69.6923076923077,13,840,8117588.333333333,123.0,64.61538461538461
107694.0,17,2,286,2,286,0.0,143.0,143.0,0,0,0.0,0.0,0.0
259668.0,6,12,1373,7,714,43278.0,298.0,102.0,5,659,60624.5,379.0,131.8
317672.0,6,3,202,2,128,0.0,74.0,64.0,1,74,0.0,74.0,74.0
228197.0,17,2,180,1,90,0.0,90.0,90.0,1,90,0.0,90.0,90.0
108096833.0,17,5,1005,5,1005,27024208.25,201.0,201.0,0,0,0.0,0.0,0.0
438212.0,6,11,1021,6,444,58803.4,162.0,74.0,5,577,73423.5,349.0,115.4
107763.0,17,2,286,2,286,0.0,143.0,143.0,0,0,0.0,0.0,0.0
226096.0,6,12,1373,7,714,37682.66666666666,298.0,102.0,5,659,55710.25,379.0,131.8
38848.0,6,14,4740,7,653,5903.333333333333,249.0,93.28571428571428,7,4087,6018.166666666667,1514.0,583.8571428571429
106416118.0,17,14,864,7,432,17666823.166666668,174.0,61.71428571428572,7,432,17667432.5,174.0,61.71428571428572
334.0,17,2,267,1,83,0.0,83.0,83.0,1,184,0.0,184.0,184.0
285.0,17,2,174,1,79,0.0,79.0,79.0,1,95,0.0,95.0,95.0
15883.999999999998,6,14,4740,7,653,2480.1666666666665,249.0,93.28571428571428,7,4087,2507.1666666666665,1514.0,583.8571428571429
98872.0,17,2,762,2,762,0.0,381.0,381.0,0,0,0.0,0.0,0.0
232869.0,6,3,337,2,214,0.0,160.0,107.0,1,123,0.0,123.0,123.0
882774.0,6,12,2717,7,742,147129.0,338.0,106.0,5,1975,152544.5,1514.0,395.0
49090.0,6,10,2032,5,524,12007.0,252.0,104.8,5,1508,11892.25,1236.0,301.6
113122867.0,6,34,2350,17,1225,7070179.1875,139.0,72.05882352941177,17,1125,7056702.5625,123.0,66.17647058823529
111234325.0,6,408,64202,204,13760,547870.0197044335,214.0,67.45098039215686,204,50442,543893.0295566502,1514.0,247.26470588235293
26502.0,6,10,2032,5,524,6396.0,252.0,104.8,5,1508,6017.25,1236.0,301.6
25521.0,6,14,4740,7,653,4124.166666666667,249.0,93.28571428571428,7,4087,4089.5,1514.0,583.8571428571429
10439537.0,6,7,478,4,272,3434474.6666666665,74.0,68.0,3,206,5151612.0,74.0,68.66666666666667
196919.0,17,2,180,1,90,0.0,90.0,90.0,1,90,0.0,90.0,90.0
90300413.0,6,24,1829,13,989,7521246.833333333,95.0,76.07692307692308,11,840,9001274.6,95.0,76.36363636363636
102980921.0,6,42,2772,21,1386,5135438.1,66.0,66.0,21,1386,5135441.8,66.0,66.0
465178.0,17,6,2100,6,2100,93035.6,350.0,350.0,0,0,0.0,0.0,0.0
48283.0,6,14,4740,7,653,7212.5,249.0,93.28571428571428,7,4087,7778.166666666667,1514.0,583.8571428571429
2059.0,17,4,344,2,150,0.0,75.0,75.0,2,194,0.0,103.0,97.0
36329.0,6,14,4740,7,653,5938.333333333333,249.0,93.28571428571428,7,4087,5734.166666666667,1514.0,583.8571428571429
37971.0,6,10,2032,5,524,9228.0,252.0,104.8,5,1508,9084.25,1236.0,301.6
29567.0,6,10,2032,5,524,6909.75,252.0,104.8,5,1508,7103.25,1236.0,301.6
216569.0,17,2,180,1,90,0.0,90.0,90.0,1,90,0.0,90.0,90.0
230168.0,17,2,180,1,90,0.0,90.0,90.0,1,90,0.0,90.0,90.0
1284151.0,6,4,492,2,280,0.0,214.0,140.0,2,212,0.0,146.0,106.0
26421.0,6,14,4740,7,653,4248.666666666667,249.0,93.28571428571428,7,4087,3905.1666666666665,1514.0,583.8571428571429
3537.0,17,2,414,1,88,0.0,88.0,88.0,1,326,0.0,326.0,326.0
316300.0,6,6,412,4,272,105433.33333333331,74.0,68.0,2,140,0.0,74.0,70.0
809.0,17,4,438,2,148,0.0,74.0,74.0,2,290,0.0,147.0,145.0
1993.0,17,4,344,2,150,0.0,75.0,75.0,2,194,0.0,103.0,97.0
17896.0,6,10,2032,5,524,4262.25,252.0,104.8,5,1508,4208.75,1236.0,301.6
323.0,17,2,166,1,75,0.0,75.0,75.0,1,91,0.0,91.0,91.0
104362548.0,17,14,864,7,432,17333976.5,174.0,61.71428571428572,7,432,17333489.666666668,174.0,61.71428571428572
120121821.0,6,14,2240,6,1224,24024364.2,204.0,204.0,8,1016,17136676.0,188.0,127.0
108100223.0,17,5,955,5,955,27025055.75,191.0,191.0,0,0,0.0,0.0,0.0
114194734.0,6,48,3168,24,1584,4964988.434782608,66.0,66.0,24,1584,4951321.304347826,66.0,66.0
0.0,6,1,60,1,60,0.0,60.0,60.0,0,0,0.0,0.0,0.0
534985.0,6,3,1604,2,851,0.0,785.0,425.5,1,753,0.0,753.0,753.0
135127837.0,17,6,1146,6,1146,27025567.4,191.0,191.0,0,0,0.0,0.0,0.0
120122302.0,6,18,2760,10,1392,13346922.444444444,188.0,139.2,8,1368,12907483.714285716,204.0,171.0
91125477.0,6,263,30670,132,8934,695614.3282442748,140.0,67.68181818181819,131,21736,690902.6307692308,300.0,165.9236641221374
355.0,17,2,248,1,84,0.0,84.0,84.0,1,164,0.0,164.0,164.0
119148964.0,17,16,1474,8,737,16998576.85714286,174.0,92.125,8,737,16998577.285714287,174.0,92.125
90290623.0,6,16,1192,8,596,12892530.714285716,95.0,74.5,8,596,12896545.285714284,95.0,74.5
90034654.0,17,28,13364,28,13364,3334616.814814815,501.0,477.2857142857143,0,0,0.0,0.0,0.0
228251.0,17,2,180,1,90,0.0,90.0,90.0,1,90,0.0,90.0,90.0
216850.0,6,3,426,2,280,0.0,214.0,140.0,1,146,0.0,146.0,146.0
108108462.0,17,5,955,5,955,27027115.5,191.0,191.0,0,0,0.0,0.0,0.0
216527.0,17,2,180,1,90,0.0,90.0,90.0,1,90,0.0,90.0,90.0
83339.0,6,14,4740,7,653,13764.833333333334,249.0,93.28571428571428,7,4087,12803.666666666666,1514.0,583.8571428571429
143953.0,17,2,180,1,90,0.0,90.0,90.0,1,90,0.0,90.0,90.0
0.0,17,1,136,1,136,0.0,136.0,136.0,0,0,0.0,0.0,0.0
6626.0,17,4,823,2,163,0.0,89.0,81.5,2,660,0.0,443.0,330.0
30320.0,6,10,2032,5,524,6913.25,252.0,104.8,5,1508,7304.5,1236.0,301.6
280053.0,6,10,1221,6,636,56010.6,298.0,106.0,4,585,87560.66666666667,379.0,146.25
91690307.0,6,23,1775,13,1030,7637237.166666667,95.0,79.23076923076923,10,745,10155446.111111112,95.0,74.5
118995738.0,6,47,3102,24,1584,5160690.478260869,66.0,66.0,23,1518,5150434.454545454,66.0,66.0
43085.0,6,14,4740,7,653,6807.833333333333,249.0,93.28571428571428,7,4087,7043.0,1514.0,583.8571428571429
284677.0,17,4,704,2,148,0.0,74.0,74.0,2,556,0.0,280.0,278.0
68982.0,6,10,2032,5,524,16948.0,252.0,104.8,5,1508,16723.0,1236.0,301.6
2847.0,17,2,224,1,76,0.0,76.0,76.0,1,148,0.0,148.0,148.0
380.0,17,2,267,1,83,0.0,83.0,83.0,1,184,0.0,184.0,184.0
209620.0,17,2,180,1,90,0.0,90.0,90.0,1,90,0.0,90.0,90.0
952596.0,6,4,492,2,280,0.0,214.0,140.0,2,212,0.0,146.0,106.0
123660502.0,6,49,3234,25,1650,5152520.916666667,66.0,66.0,24,1584,5157193.130434782,66.0,66.0
3293.0,17,2,508,2,508,0.0,257.0,254.0,0,0,0.0,0.0,0.0
101977.0,17,2,762,2,762,0.0,381.0,381.0,0,0,0.0,0.0,0.0
302994.0,6,6,412,4,272,100998.0,74.0,68.0,2,140,0.0,74.0,70.0
30980.0,6,14,4740,7,653,4776.166666666667,249.0,93.28571428571428,7,4087,4338.0,1514.0,583.8571428571429
43916.0,6,10,2032,5,524,9608.5,252.0,104.8,5,1508,9896.25,1236.0,301.6
4237.0,17,4,344,2,150,0.0,75.0,75.0,2,194,0.0,103.0,97.0
3977131.0,17,3,1341,3,1341,1988565.5,453.0,447.0,0,0,0.0,0.0,0.0
1812.0,17,2,939,1,590,0.0,590.0,590.0,1,349,0.0,349.0,349.0
161103.0,6,2,128,1,74,0.0,74.0,74.0,1,54,0.0,54.0,54.0
0.0,17,1,445,1,445,0.0,445.0,445.0,0,0,0.0,0.0,0.0
1451597.0,6,7,499,3,198,716851.5,66.0,66.0,4,301,411721.6666666667,103.0,75.25
70612.0,6,14,4740,7,653,10907.333333333334,249.0,93.28571428571428,7,4087,11537.5,1514.0,583.8571428571429
127408225.0,6,36,2517,18,1248,6907216.470588235,123.0,69.33333333333333,18,1269,7494511.764705882,123.0,70.5
19714.0,6,10,2032,5,524,4664.5,252.0,104.8,5,1508,4668.25,1236.0,301.6
2064.0,17,4,344,2,150,0.0,75.0,75.0,2,194,0.0,103.0,97.0
0.0,17,1,381,1,381,0.0,381.0,381.0,0,0,0.0,0.0,0.0
90250311.0,6,16,1192,8,596,12853839.142857144,95.0,74.5,8,596,12861162.0,95.0,74.5
9759.0,17,2,582,1,83,0.0,83.0,83.0,1,499,0.0,499.0,499.0
120128739.0,6,400,51318,200,37896,602630.0351758794,480.0,189.48,200,13422,602630.08040201,140.0,67.11
90095461.0,6,11,1644,4,816,30031022.33333333,204.0,204.0,7,828,15015518.666666666,188.0,118.28571428571428
108114123.0,17,5,1005,5,1005,27028530.75,201.0,201.0,0,0,0.0,0.0,0.0
2323.0,17,4,344,2,150,0.0,75.0,75.0,2,194,0.0,103.0,97.0
302389.0,6,2,132,1,66,0.0,66.0,66.0,1,66,0.0,66.0,66.0
46663.0,6,14,4740,7,653,7651.833333333333,249.0,93.28571428571428,7,4087,6677.5,1514.0,583.8571428571429
196999.0,17,2,180,1,90,0.0,90.0,90.0,1,90,0.0,90.0,90.0
10427469.0,6,6,412,3,206,5145698.5,74.0,68.66666666666667,3,206,5145546.0,74.0,68.66666666666667
10434646.0,6,7,478,4,272,3432473.333333333,74.0,68.0,3,206,5148616.0,74.0,68.66666666666667
310587.0,17,4,622,4,622,103529.0,163.0,155.5,0,0,0.0,0.0,0.0
315232.0,17,4,1400,4,1400,105077.33333333331,350.0,350.0,0,0,0.0,0.0,0.0
20106825.0,6,6,1981,4,1087,6702275.0,885.0,271.75,2,894,0.0,826.0,447.0
115882147.0,6,436,55318,218,40634,533071.3870967742,336.0,186.39449541284404,218,14684,533073.2073732719,140.0,67.35779816513761
284351.0,17,2,363,1,79,0.0,79.0,79.0,1,284,0.0,284.0,284.0
103008636.0,17,13,821,7,432,17168106.0,174.0,61.71428571428572,6,389,16600160.8,174.0,64.83333333333333
135132450.0,17,6,1206,6,1206,27026490.0,201.0,201.0,0,0,0.0,0.0,0.0
135132381.0,17,6,1206,6,1206,27026476.2,201.0,201.0,0,0,0.0,0.0,0.0
209569.0,17,2,180,1,90,0.0,90.0,90.0,1,90,0.0,90.0,90.0
64673.99999999999,6,14,4740,7,653,10432.833333333334,249.0,93.28571428571428,7,4087,10014.666666666666,1514.0,583.8571428571429
33411.0,6,14,4740,7,653,5443.5,249.0,93.28571428571428,7,4087,5434.333333333333,1514.0,583.8571428571429
135136583.0,17,6,1146,6,1146,27027316.6,191.0,191.0,0,0,0.0,0.0,0.0
311438.0,17,4,622,4,622,103812.66666666669,163.0,155.5,0,0,0.0,0.0,0.0
365381.0,6,10,1221,6,636,73076.2,298.0,106.0,4,585,120589.66666666669,379.0,146.25
308.0,17,2,168,1,76,0.0,76.0,76.0,1,92,0.0,92.0,92.0
108111583.0,17,5,955,5,955,27027895.75,191.0,191.0,0,0,0.0,0.0,0.0
19711.0,6,11,1133,6,602,3439.4,264.0,100.33333333333331,5,531,4363.5,259.0,106.2
336.0,17,2,166,1,75,0.0,75.0,75.0,1,91,0.0,91.0,91.0
56625.0,6,14,4740,7,653,9238.833333333334,249.0,93.28571428571428,7,4087,8883.5,1514.0,583.8571428571429
153421.0,17,2,180,1,90,0.0,90.0,90.0,1,90,0.0,90.0,90.0
206005.0,6,3,426,2,280,0.0,214.0,140.0,1,146,0.0,146.0,146.0
32881.0,6,14,4740,7,653,3922.1666666666665,249.0,93.28571428571428,7,4087,5047.666666666667,1514.0,583.8571428571429
310705.0,17,4,1400,4,1400,103568.33333333331,350.0,350.0,0,0,0.0,0.0,0.0
32320.0,6,10,2032,5,524,7291.75,252.0,104.8,5,1508,5926.0,1236.0,301.6
108099043.0,17,5,1005,5,1005,27024760.75,201.0,201.0,0,0,0.0,0.0,0.0
252765.00000000003,6,3,337,2,214,0.0,160.0,107.0,1,123,0.0,123.0,123.0
103436.0,17,2,286,2,286,0.0,143.0,143.0,0,0,0.0,0.0,0.0
108112790.0,17,5,1005,5,1005,27028197.5,201.0,201.0,0,0,0.0,0.0,0.0
4410.0,17,2,602,1,72,0.0,72.0,72.0,1,530,0.0,530.0,530.0
106928.0,17,2,700,2,700,0.0,350.0,350.0,0,0,0.0,0.0,0.0
112464321.0,6,46,3036,23,1518,5112001.227272728,66.0,66.0,23,1518,5112003.181818182,66.0,66.0
153426.0,17,2,180,1,90,0.0,90.0,90.0,1,90,0.0,90.0,90.0
108101421.0,17,5,1005,5,1005,27025355.25,201.0,201.0,0,0,0.0,0.0,0.0
9660.0,17,2,582,1,83,0.0,83.0,83.0,1,499,0.0,499.0,499.0
302.0,17,2,164,1,82,0.0,82.0,82.0,1,82,0.0,82.0,82.0
135127165.0,17,6,1146,6,1146,27025433.0,191.0,191.0,0,0,0.0,0.0,0.0
247030.0,17,2,180,1,90,0.0,90.0,90.0,1,90,0.0,90.0,90.0
322169.0,17,4,1400,4,1400,107389.66666666669,350.0,350.0,0,0,0.0,0.0,0.0
34464.0,6,10,2032,5,524,7896.25,252.0,104.8,5,1508,8318.5,1236.0,301.6
116292921.0,6,235,26488,118,8084,993956.5897435896,140.0,68.50847457627118,117,18404,993772.1810344828,284.0,157.2991452991453
10440803.0,6,7,478,4,272,3434880.6666666665,74.0,68.0,3,206,5152197.0,74.0,68.66666666666667
97118414.0,6,26,1746,13,906,8075213.416666667,123.0,69.6923076923077,13,840,8075216.583333333,123.0,64.61538461538461
120175064.0,6,238,26866,119,8150,1011509.1186440678,140.0,68.4873949579832,119,18716,1011397.254237288,284.0,157.27731092436974
107551.0,17,2,286,2,286,0.0,143.0,143.0,0,0,0.0,0.0,0.0
10068.0,17,2,684,2,684,0.0,342.0,342.0,0,0,0.0,0.0,0.0
22990.0,6,14,4740,7,653,3372.833333333333,249.0,93.28571428571428,7,4087,3695.3333333333335,1514.0,583.8571428571429
21071378.0,6,6,1981,4,1087,7023792.666666667,885.0,271.75,2,894,0.0,826.0,447.0
127067086.0,6,31,2097,16,1149,8471139.066666666,123.0,71.8125,15,948,8511596.214285715,123.0,63.2
100232300.0,17,13,821,7,432,16666813.166666666,174.0,61.71428571428572,6,389,20001182.0,174.0,64.83333333333333
17582.0,6,14,4740,7,653,2764.1666666666665,249.0,93.28571428571428,7,4087,2682.0,1514.0,583.8571428571429
16063.999999999998,6,14,4740,7,653,2366.6666666666665,249.0,93.28571428571428,7,4087,2483.0,1514.0,583.8571428571429
32055.0,6,10,2032,5,524,7149.25,252.0,104.8,5,1508,7746.5,1236.0,301.6
43950.0,6,14,4740,7,653,6451.5,249.0,93.28571428571428,7,4087,5725.333333333333,1514.0,583.8571428571429
120122539.0,6,16,2356,9,1204,15015317.375,188.0,133.77777777777777,7,1152,15061643.5,204.0,164.57142857142858
17608.0,6,13,1459,7,862,2893.1666666666665,271.0,123.14285714285714,6,597,3336.4,259.0,99.5
24937.0,6,10,2032,5,524,6013.5,252.0,104.8,5,1508,5676.25,1236.0,301.6
108107673.0,17,5,1005,5,1005,27026918.25,201.0,201.0,0,0,0.0,0.0,0.0
90854984.0,6,201,22580,101,15758,908549.84,284.0,156.01980198019805,100,6822,906745.696969697,140.0,68.22
298216.0,6,6,412,4,272,99405.33333333331,74.0,68.0,2,140,0.0,74.0,70.0
261315.00000000003,6,10,1221,6,636,52263.0,298.0,106.0,4,585,81373.0,379.0,146.25
146133.0,6,3,337,2,214,0.0,160.0,107.0,1,123,0.0,123.0,123.0
28742.0,6,10,2032,5,524,6963.25,252.0,104.8,5,1508,6882.0,1236.0,301.6
280595.0,17,2,363,1,79,0.0,79.0,79.0,1,284,0.0,284.0,284.0
213599.0,17,2,180,1,90,0.0,90.0,90.0,1,90,0.0,90.0,90.0
228339.0,17,2,180,1,90,0.0,90.0,90.0,1,90,0.0,90.0,90.0
108107325.0,17,5,1005,5,1005,27026831.25,201.0,201.0,0,0,0.0,0.0,0.0
247793.0,6,3,337,2,214,0.0,160.0,107.0,1,123,0.0,123.0,123.0
90262175.0,6,13,2036,8,1016,12894596.42857143,188.0,127.0,5,1020,22524689.25,204.0,204.0
241644.0,6,3,337,2,214,0.0,160.0,107.0,1,123,0.0,123.0,123.0
532833.0,17,6,1230,3,234,266229.5,78.0,78.0,3,996,266208.0,332.0,332.0
202400.0,17,4,6056,4,6056,67466.66666666667,1514.0,1514.0,0,0,0.0,0.0,0.0
90282934.0,6,16,1192,8,596,12891181.285714284,95.0,74.5,8,596,12896198.42857143,95.0,74.5
90019402.0,17,28,13364,28,13364,3334051.925925926,501.0,477.2857142857143,0,0,0.0,0.0,0.0
83.0,17,2,762,2,762,0.0,381.0,381.0,0,0,0.0,0.0,0.0
36076.0,6,14,4740,7,653,5559.0,249.0,93.28571428571428,7,4087,5823.666666666667,1514.0,583.8571428571429
90047464.0,17,28,13364,28,13364,3335091.25925926,501.0,477.2857142857143,0,0,0.0,0.0,0.0
2034066.0,6,25,7031,13,1999,169505.5,483.0,153.76923076923077,12,5032,156393.72727272726,1510.0,419.3333333333333
39408.0,6,14,4740,7,653,6379.166666666667,249.0,93.28571428571428,7,4087,6339.833333333333,1514.0,583.8571428571429
120000028.0,6,20,1692,11,1042,12000002.8,256.0,94.72727272727272,9,650,14753862.25,95.0,72.22222222222223
56305.0,6,14,4740,7,653,8284.666666666666,249.0,93.28571428571428,7,4087,9094.5,1514.0,583.8571428571429
124722273.0,6,33,2164,17,1162,7795142.0625,139.0,68.3529411764706,16,1002,7635520.466666667,123.0,62.625
18711.0,6,10,2032,5,524,4161.75,252.0,104.8,5,1508,4396.0,1236.0,301.6
108107039.0,17,5,955,5,955,27026759.75,191.0,191.0,0,0,0.0,0.0,0.0
110001143.0,17,13,821,7,432,18333523.83333333,174.0,61.71428571428572,6,389,18000903.2,174.0,64.83333333333333
99719163.0,6,25,1623,13,840,8309930.25,123.0,64.61538461538461,12,783,9045527.818181818,123.0,65.25
216591.0,17,2,180,1,90,0.0,90.0,90.0,1,90,0.0,90.0,90.0
90255399.0,6,14,2240,8,1016,12893628.42857143,188.0,127.0,6,1224,18018091.2,204.0,204.0
119071053.0,6,223,25028,112,7688,1072712.189189189,140.0,68.64285714285714,111,17340,1072955.7545454546,284.0,156.21621621621622
108117150.0,17,5,955,5,955,27029287.5,191.0,191.0,0,0,0.0,0.0,0.0
232233.0,17,2,620,1,75,0.0,75.0,75.0,1,545,0.0,545.0,545.0
303141.0,6,6,412,4,272,101047.0,74.0,68.0,2,140,0.0,74.0,70.0
30279.0,6,10,2032,5,524,7331.5,252.0,104.8,5,1508,7326.5,1236.0,301.6
153478.0,17,2,180,1,90,0.0,90.0,90.0,1,90,0.0,90.0,90.0
171643.0,17,2,180,1,90,0.0,90.0,90.0,1,90,0.0,90.0,90.0
815.0,17,4,438,2,148,0.0,74.0,74.0,2,290,0.0,147.0,145.0
108097135.0,17,5,1005,5,1005,27024283.75,201.0,201.0,0,0,0.0,0.0,0.0
10480693.0,6,7,478,4,272,3446347.6666666665,74.0,68.0,3,206,5169404.0,74.0,68.66666666666667
228167.0,17,2,180,1,90,0.0,90.0,90.0,1,90,0.0,90.0,90.0
45080.0,6,10,2032,5,524,11028.0,252.0,104.8,5,1508,10307.0,1236.0,301.6
13254.0,6,10,2032,5,524,3071.75,252.0,104.8,5,1508,3075.25,1236.0,301.6
2793848.0,6,2,132,1,66,0.0,66.0,66.0,1,66,0.0,66.0,66.0
153420.0,17,2,180,1,90,0.0,90.0,90.0,1,90,0.0,90.0,90.0
122001145.0,17,15,907,8,475,17428735.0,174.0,59.375,7,432,16954994.333333332,174.0,61.71428571428572
21932.0,6,10,2032,5,524,4218.25,252.0,104.8,5,1508,5027.25,1236.0,301.6
20309.0,17,2,582,1,83,0.0,83.0,83.0,1,499,0.0,499.0,499.0
115602297.0,6,31,2182,16,1165,7691848.466666667,139.0,72.8125,15,1017,8241657.142857143,123.0,67.8
4590976.0,6,5,336,2,134,0.0,68.0,67.0,3,202,1525541.5,70.0,67.33333333333333
40783.0,6,10,2032,5,524,9842.25,252.0,104.8,5,1508,9401.0,1236.0,301.6
558.0,17,2,508,2,508,0.0,257.0,254.0,0,0,0.0,0.0,0.0
90305180.0,6,16,1192,8,596,12892119.142857144,95.0,74.5,8,596,12900228.42857143,95.0,74.5
49943.0,6,14,4740,7,653,5521.5,249.0,93.28571428571428,7,4087,8186.666666666667,1514.0,583.8571428571429
36863.0,6,10,2032,5,524,6240.75,252.0,104.8,5,1508,8537.5,1236.0,301.6
148033.0,17,2,180,1,90,0.0,90.0,90.0,1,90,0.0,90.0,90.0
102576.0,17,4,6056,4,6056,34192.0,1514.0,1514.0,0,0,0.0,0.0,0.0
440239.0,17,2,363,1,75,0.0,75.0,75.0,1,288,0.0,288.0,288.0
148031.0,17,2,180,1,90,0.0,90.0,90.0,1,90,0.0,90.0,90.0
310.0,17,2,174,1,79,0.0,79.0,79.0,1,95,0.0,95.0,95.0
2167819.0,6,30,8593,15,4712,154844.2142857143,1514.0,314.1333333333333,15,3881,132777.7142857143,1514.0,258.7333333333333
115867436.0,6,48,3168,24,1584,5037714.608695652,66.0,66.0,24,1584,5028315.260869565,66.0,66.0
108103752.0,17,5,955,5,955,27025938.0,191.0,191.0,0,0,0.0,0.0,0.0
2420.0,17,4,344,2,150,0.0,75.0,75.0,2,194,0.0,103.0,97.0
4215.0,17,2,582,1,83,0.0,83.0,83.0,1,499,0.0,499.0,499.0
92836823.0,6,40,2640,20,1320,4886148.578947368,66.0,66.0,20,1320,4873262.263157895,66.0,66.0
2780972.0,6,2,132,1,66,0.0,66.0,66.0,1,66,0.0,66.0,66.0
0.0,6,1,66,1,66,0.0,66.0,66.0,0,0,0.0,0.0,0.0
119858.0,17,2,180,1,70,0.0,70.0,70.0,1,110,0.0,110.0,110.0
103552.0,17,2,286,2,286,0.0,143.0,143.0,0,0,0.0,0.0,0.0
205880.0,6,3,426,2,280,0.0,214.0,140.0,1,146,0.0,146.0,146.0
309736.0,6,6,412,4,272,103245.33333333331,74.0,68.0,2,140,0.0,74.0,70.0
11593.0,6,10,1067,5,536,2723.25,264.0,107.2,5,531,2011.5,259.0,106.2
317727.0,17,4,1400,4,1400,105909.0,350.0,350.0,0,0,0.0,0.0,0.0
0.0,17,1,90,1,90,0.0,90.0,90.0,0,0,0.0,0.0,0.0
310791.0,17,4,1400,4,1400,103597.0,350.0,350.0,0,0,0.0,0.0,0.0
10481740.0,6,7,478,4,272,3448640.0,74.0,68.0,3,206,5172864.0,74.0,68.66666666666667
144917.0,17,2,180,1,70,0.0,70.0,70.0,1,110,0.0,110.0,110.0
90906151.0,6,19,1436,9,691,11363268.875,95.0,76.77777777777777,10,745,10073328.888888888,95.0,74.5
158900.0,6,2,132,1,66,0.0,66.0,66.0,1,66,0.0,66.0,66.0
40136.0,6,14,4740,7,653,6510.333333333333,249.0,93.28571428571428,7,4087,6116.833333333333,1514.0,583.8571428571429
113232.0,6,14,4740,7,653,16741.5,249.0,93.28571428571428,7,4087,16792.166666666668,1514.0,583.8571428571429
306916.0,6,6,412,4,272,102305.33333333331,74.0,68.0,2,140,0.0,74.0,70.0
3237096.0,6,3,1777,2,951,0.0,885.0,475.5,1,826,0.0,826.0,826.0
30512.0,6,14,4740,7,653,4849.833333333333,249.0,93.28571428571428,7,4087,4462.5,1514.0,583.8571428571429
297820.0,6,6,412,4,272,99273.33333333331,74.0,68.0,2,140,0.0,74.0,70.0
40363.0,6,14,4740,7,653,6116.0,249.0,93.28571428571428,7,4087,6321.0,1514.0,583.8571428571429
108101680.0,17,5,955,5,955,27025420.0,191.0,191.0,0,0,0.0,0.0,0.0
1349471.0,17,16,1120,16,1120,89964.73333333334,70.0,70.0,0,0,0.0,0.0,0.0
118064486.0,6,214,24180,107,7358,1106094.424528302,140.0,68.76635514018692,107,16822,1106012.9811320754,374.0,157.21495327102804
14643645.0,6,20,1607,10,975,1592745.6666666667,315.0,97.5,10,632,1592713.6666666667,78.0,63.2
27571.0,6,14,4740,7,653,4249.833333333333,249.0,93.28571428571428,7,4087,3819.3333333333335,1514.0,583.8571428571429
54226.0,6,11,2041,6,533,10715.8,195.0,88.83333333333333,5,1508,8101.25,1236.0,301.6
4379.0,17,2,626,1,72,0.0,72.0,72.0,1,554,0.0,554.0,554.0
90948403.0,6,21,1585,11,840,9094582.3,95.0,76.36363636363636,10,745,10102414.0,95.0,74.5
5829807.0,6,4,270,2,134,0.0,68.0,67.0,2,136,0.0,70.0,68.0
108096771.0,17,5,1005,5,1005,27024192.75,201.0,201.0,0,0,0.0,0.0,0.0
14641253.0,6,20,1607,10,975,1592833.5555555555,315.0,97.5,10,632,1592807.4444444445,78.0,63.2
456653.0,6,10,1221,6,636,91330.6,298.0,106.0,4,585,151106.33333333334,379.0,146.25
108105941.0,17,5,955,5,955,27026485.25,191.0,191.0,0,0,0.0,0.0,0.0
603585.0,17,2,346,1,78,0.0,78.0,78.0,1,268,0.0,268.0,268.0
67895.0,6,11,2098,6,590,12809.6,252.0,98.33333333333331,5,1508,16805.0,1236.0,301.6
120082733.0,17,29,13785,29,13785,4288669.035714285,501.0,475.3448275862069,0,0,0.0,0.0,0.0
77111.0,6,12,1320,7,789,12851.833333333334,253.0,112.71428571428572,5,531,15692.75,259.0,106.2
216677.0,6,3,426,2,280,0.0,214.0,140.0,1,146,0.0,146.0,146.0
316680.0,17,4,1400,4,1400,105560.0,350.0,350.0,0,0,0.0,0.0,0.0
104768110.0,6,44,2904,22,1452,4988957.619047619,66.0,66.0,22,1452,4974613.952380952,66.0,66.0
143918.0,17,2,180,1,90,0.0,90.0,90.0,1,90,0.0,90.0,90.0
35234.0,6,14,4740,7,653,5312.833333333333,249.0,93.28571428571428,7,4087,5589.333333333333,1514.0,583.8571428571429
108110725.0,17,5,1005,5,1005,27027681.25,201.0,201.0,0,0,0.0,0.0,0.0
307125.0,6,6,412,4,272,102375.0,74.0,68.0,2,140,0.0,74.0,70.0
35500.0,6,14,4740,7,653,5537.666666666667,249.0,93.28571428571428,7,4087,5533.333333333333,1514.0,583.8571428571429
450.0,17,2,176,1,88,0.0,88.0,88.0,1,88,0.0,88.0,88.0
209481.0,17,2,180,1,90,0.0,90.0,90.0,1,90,0.0,90.0,90.0
112831406.0,6,35,2542,18,1348,6637141.529411765,139.0,74.88888888888889,17,1194,7038454.0625,123.0,70.23529411764706
37937.0,6,14,4740,7,653,6026.166666666667,249.0,93.28571428571428,7,4087,5943.833333333333,1514.0,583.8571428571429
120115161.0,6,12,1832,8,1016,17136082.0,188.0,127.0,4,816,30031537.0,204.0,204.0
283048.0,17,4,1400,4,1400,94349.33333333331,350.0,350.0,0,0,0.0,0.0,0.0
205591.0,17,2,180,1,90,0.0,90.0,90.0,1,90,0.0,90.0,90.0
783.0,17,4,438,2,148,0.0,74.0,74.0,2,290,0.0,147.0,145.0
27288.0,6,14,4740,7,653,3858.1666666666665,249.0,93.28571428571428,7,4087,4232.0,1514.0,583.8571428571429
197206.0,17,2,180,1,90,0.0,90.0,90.0,1,90,0.0,90.0,90.0
233237.0,6,3,337,2,214,0.0,160.0,107.0,1,123,0.0,123.0,123.0
299279.0,6,6,412,4,272,99759.66666666669,74.0,68.0,2,140,0.0,74.0,70.0
868883.0,6,12,2710,7,743,144813.83333333334,339.0,106.14285714285714,5,1967,149041.25,1514.0,393.4
146143.0,6,3,337,2,214,0.0,160.0,107.0,1,123,0.0,123.0,123.0
301982.0,6,6,412,4,272,100660.66666666669,74.0,68.0,2,140,0.0,74.0,70.0
271719.0,6,10,1221,6,636,54343.8,298.0,106.0,4,585,84625.33333333333,379.0,146.25
47957.0,6,12,1320,6,723,8509.8,253.0,120.5,6,597,8994.6,259.0,99.5
23939.0,6,14,4740,7,653,3319.5,249.0,93.28571428571428,7,4087,3846.0,1514.0,583.8571428571429
102672.0,17,2,286,2,286,0.0,143.0,143.0,0,0,0.0,0.0,0.0
1425524.0,17,16,1120,16,1120,95034.93333333332,70.0,70.0,0,0,0.0,0.0,0.0
20346.0,17,2,582,1,83,0.0,83.0,83.0,1,499,0.0,499.0,499.0
2019.0,17,4,344,2,150,0.0,75.0,75.0,2,194,0.0,103.0,97.0
123980062.0,17,14,864,7,432,17268290.5,174.0,61.71428571428572,7,432,17334112.666666668,174.0,61.71428571428572
1172733.0,6,13,3010,8,2382,167533.2857142857,1514.0,297.75,5,628,224415.5,331.0,125.6
1453097.0,6,7,499,4,301,417248.6666666667,103.0,75.25,3,198,716054.0,66.0,66.0
37316.0,6,14,4740,7,653,6092.166666666667,249.0,93.28571428571428,7,4087,5031.666666666667,1514.0,583.8571428571429
22404.0,6,14,4740,7,653,3627.1666666666665,249.0,93.28571428571428,7,4087,3601.1666666666665,1514.0,583.8571428571429
90047458.0,17,27,12943,27,12943,3463363.769230769,501.0,479.3703703703704,0,0,0.0,0.0,0.0
151763.0,17,2,414,1,88,0.0,88.0,88.0,1,326,0.0,326.0,326.0
121481009.0,17,15,1169,7,563,17001365.0,174.0,80.42857142857143,8,606,17285871.42857143,174.0,75.75
245973.0,6,3,337,2,214,0.0,160.0,107.0,1,123,0.0,123.0,123.0
9810.0,17,2,582,1,83,0.0,83.0,83.0,1,499,0.0,499.0,499.0
121949.0,6,3,373,2,238,0.0,172.0,119.0,1,135,0.0,135.0,135.0
245227.0,6,3,337,2,214,0.0,160.0,107.0,1,123,0.0,123.0,123.0
327.0,17,2,208,1,72,0.0,72.0,72.0,1,136,0.0,136.0,136.0
2055.0,17,4,344,2,150,0.0,75.0,75.0,2,194,0.0,103.0,97.0
498827.0,6,5,336,2,134,0.0,68.0,67.0,3,202,195968.0,70.0,67.33333333333333
90067957.0,17,28,13364,28,13364,3335850.25925926,501.0,477.2857142857143,0,0,0.0,0.0,0.0
112640815.0,6,32,2236,16,1165,7494997.466666667,139.0,72.8125,16,1071,7494986.466666667,123.0,66.9375
524681.0,17,6,2100,6,2100,104936.2,350.0,350.0,0,0,0.0,0.0,0.0
120284.0,6,14,4740,7,653,17989.333333333332,249.0,93.28571428571428,7,4087,19504.666666666668,1514.0,583.8571428571429
143900.0,17,2,180,1,90,0.0,90.0,90.0,1,90,0.0,90.0,90.0
107743.0,17,2,286,2,286,0.0,143.0,143.0,0,0,0.0,0.0,0.0
1733822.0,6,22,6443,12,1529,157620.18181818182,357.0,127.41666666666669,10,4914,158346.44444444444,1510.0,491.4
90524133.0,6,14,2240,8,1016,12932019.0,188.0,127.0,6,1224,18070159.4,204.0,204.0
616926.0,17,4,629,3,234,85481.5,78.0,78.0,1,395,0.0,395.0,395.0
104541.0,17,2,286,2,286,0.0,143.0,143.0,0,0,0.0,0.0,0.0
332.0,17,2,166,1,75,0.0,75.0,75.0,1,91,0.0,91.0,91.0
120126840.0,6,280,33000,140,9462,858439.0935251799,140.0,67.58571428571429,140,23538,858313.8705035971,374.0,168.12857142857143
228578.0,17,2,180,1,90,0.0,90.0,90.0,1,90,0.0,90.0,90.0
300139.0,6,6,412,4,272,100046.33333333331,74.0,68.0,2,140,0.0,74.0,70.0
2947227.0,6,11,2106,6,598,589185.2,252.0,99.66666666666669,5,1508,1872.5,1236.0,301.6
228429.0,17,2,180,1,90,0.0,90.0,90.0,1,90,0.0,90.0,90.0
125824755.0,6,59,12531,31,6671,3222875.6666666665,1514.0,215.1935483870968,28,5860,4652199.333333333,1514.0,209.28571428571428
205597.0,6,3,426,2,280,0.0,214.0,140.0,1,146,0.0,146.0,146.0
32005.0,6,14,4740,7,653,5111.166666666667,249.0,93.28571428571428,7,4087,4594.0,1514.0,583.8571428571429
90297991.0,6,16,1192,8,596,12892694.714285716,95.0,74.5,8,596,12898417.857142856,95.0,74.5
92772452.0,6,31,2314,16,1228,6184830.133333334,139.0,76.75,15,1086,6611118.785714285,123.0,72.4
5625440.0,6,5,336,2,134,0.0,68.0,67.0,3,202,1526794.5,70.0,67.33333333333333
121276572.0,6,222,25196,111,7548,1077422.681818182,140.0,68.0,111,17648,1095185.9,284.0,158.99099099099098
121444.0,6,3,337,2,214,0.0,160.0,107.0,1,123,0.0,123.0,123.0
5631833.0,6,5,336,2,134,0.0,68.0,67.0,3,202,1525005.5,70.0,67.33333333333333
205842.0,17,2,180,1,90,0.0,90.0,90.0,1,90,0.0,90.0,90.0
128001093.0,17,15,907,8,475,18285870.42857143,174.0,59.375,7,432,18000131.166666668,174.0,61.71428571428572
3735.0,17,2,414,1,88,0.0,88.0,88.0,1,326,0.0,326.0,326.0
17962.0,6,14,4740,7,653,2872.6666666666665,249.0,93.28571428571428,7,4087,2858.833333333333,1514.0,583.8571428571429
10463871.0,6,7,478,4,272,3442558.333333333,74.0,68.0,3,206,5163729.0,74.0,68.66666666666667
347.0,17,2,267,1,83,0.0,83.0,83.0,1,184,0.0,184.0,184.0
65511.0,6,10,2032,5,524,15912.75,252.0,104.8,5,1508,13186.75,1236.0,301.6
331.0,17,2,166,1,75,0.0,75.0,75.0,1,91,0.0,91.0,91.0
976577.0,6,12,1362,6,731,193045.4,253.0,121.83333333333331,6,631,194471.8,293.0,105.16666666666669
1823871.0,6,50,32456,25,1819,75994.625,215.0,72.76,25,30637,75669.58333333333,1514.0,1225.48
299381.0,17,2,604,1,75,0.0,75.0,75.0,1,529,0.0,529.0,529.0
104371.0,17,2,700,2,700,0.0,350.0,350.0,0,0,0.0,0.0,0.0
287.0,17,2,164,1,82,0.0,82.0,82.0,1,82,0.0,82.0,82.0
121276.0,6,3,337,2,214,0.0,160.0,107.0,1,123,0.0,123.0,123.0
146274.0,6,3,337,2,214,0.0,160.0,107.0,1,123,0.0,123.0,123.0
111395414.0,17,14,1126,7,563,18565902.33333333,174.0,80.42857142857143,7,563,18465285.5,174.0,80.42857142857143
123250444.0,6,49,3234,25,1650,5135435.166666667,66.0,66.0,24,1584,5080032.0869565215,66.0,66.0
206640.0,17,2,180,1,90,0.0,90.0,90.0,1,90,0.0,90.0,90.0
40189.0,6,2,132,1,66,0.0,66.0,66.0,1,66,0.0,66.0,66.0
108106509.0,17,5,955,5,955,27026627.25,191.0,191.0,0,0,0.0,0.0,0.0
138482.0,6,2,132,1,66,0.0,66.0,66.0,1,66,0.0,66.0,66.0
320783.0,17,4,1400,4,1400,106927.66666666669,350.0,350.0,0,0,0.0,0.0,0.0
25023.0,6,14,4740,7,653,4045.6666666666665,249.0,93.28571428571428,7,4087,4034.1666666666665,1514.0,583.8571428571429
382184.0,6,4,508,2,238,0.0,172.0,119.0,2,270,0.0,135.0,135.0
323095.0,17,4,1400,4,1400,107698.33333333331,350.0,350.0,0,0,0.0,0.0,0.0
9008.0,17,2,498,1,80,0.0,80.0,80.0,1,418,0.0,418.0,418.0
2309.0,17,4,344,2,150,0.0,75.0,75.0,2,194,0.0,103.0,97.0
211277.0,17,2,180,1,90,0.0,90.0,90.0,1,90,0.0,90.0,90.0
90202862.0,6,27,2073,12,935,8178763.454545454,95.0,77.91666666666667,15,1138,6428434.857142857,95.0,75.86666666666666
198533.0,6,14,4740,7,653,22794.666666666668,249.0,93.28571428571428,7,4087,30162.166666666668,1514.0,583.8571428571429
2051336.0,6,18,6803,10,1501,227926.22222222225,408.0,150.1,8,5302,222498.57142857145,1514.0,662.75
5005294.0,17,4,849,2,166,0.0,83.0,83.0,2,683,0.0,499.0,341.5
24023697.0,17,3,1026,3,1026,12011848.5,342.0,342.0,0,0,0.0,0.0,0.0
407198.0,6,3,1604,1,753,0.0,753.0,753.0,2,851,0.0,785.0,425.5
26474.0,6,14,4740,7,653,3851.0,249.0,93.28571428571428,7,4087,4271.666666666667,1514.0,583.8571428571429
5008190.0,17,4,534,2,166,0.0,83.0,83.0,2,368,0.0,184.0,184.0
90030802.0,17,27,12943,27,12943,3462723.153846154,501.0,479.3703703703704,0,0,0.0,0.0,0.0
104358091.0,6,28,1860,14,966,8010941.384615385,123.0,69.0,14,894,8010942.076923077,123.0,63.85714285714285
234008.0,6,3,337,2,214,0.0,160.0,107.0,1,123,0.0,123.0,123.0
120774.0,6,3,337,2,214,0.0,160.0,107.0,1,123,0.0,123.0,123.0
217706.0,6,3,426,2,280,0.0,214.0,140.0,1,146,0.0,146.0,146.0
976333.0,6,12,1447,6,816,194098.8,291.0,136.0,6,631,194164.4,293.0,105.16666666666669
90015332.0,17,28,13364,28,13364,3333901.185185185,501.0,477.2857142857143,0,0,0.0,0.0,0.0
118011550.0,17,14,864,7,432,19667955.666666668,174.0,61.71428571428572,7,432,19666846.83333333,174.0,61.71428571428572
103880953.0,6,30,2244,16,1212,6910994.266666667,123.0,75.75,14,1032,7974241.384615385,123.0,73.71428571428571
44240.0,6,14,4740,7,653,7253.0,249.0,93.28571428571428,7,4087,7062.833333333333,1514.0,583.8571428571429
330.0,17,2,166,1,75,0.0,75.0,75.0,1,91,0.0,91.0,91.0
119596556.0,17,34,16284,34,16284,3624138.060606061,501.0,478.9411764705882,0,0,0.0,0.0,0.0
114510335.0,6,220,25042,110,17560,1048578.4220183487,374.0,159.63636363636363,110,7482,1048578.1467889908,140.0,68.01818181818182
39219.0,6,11,2098,6,590,7843.8,252.0,98.33333333333331,5,1508,8669.5,1236.0,301.6
38012.0,6,10,2032,5,524,8150.5,252.0,104.8,5,1508,9242.25,1236.0,301.6
1402.0,17,2,762,2,762,0.0,381.0,381.0,0,0,0.0,0.0,0.0
142483.0,6,2,132,1,66,0.0,66.0,66.0,1,66,0.0,66.0,66.0
885199.0,6,10,1333,6,796,177039.8,458.0,132.66666666666666,4,537,203165.66666666663,331.0,134.25
90049316.0,17,27,12943,27,12943,3463435.230769231,501.0,479.3703703703704,0,0,0.0,0.0,0.0
10478.0,17,4,823,2,163,0.0,89.0,81.5,2,660,0.0,443.0,330.0
153363.0,17,2,180,1,90,0.0,90.0,90.0,1,90,0.0,90.0,90.0
108108858.0,17,5,955,5,955,27027214.5,191.0,191.0,0,0,0.0,0.0,0.0
21318.0,6,10,2032,5,524,4336.0,252.0,104.8,5,1508,5064.0,1236.0,301.6
116801.0,17,2,876,2,876,0.0,438.0,438.0,0,0,0.0,0.0,0.0
1726.0,17,2,664,1,322,0.0,322.0,322.0,1,342,0.0,342.0,342.0
284709.0,17,2,363,1,79,0.0,79.0,79.0,1,284,0.0,284.0,284.0
3296978.0,6,201,164421,114,154376,29176.796460177,1510.0,1354.1754385964912,87,10045,34687.56976744186,1510.0,115.45977011494251
106667616.0,17,14,864,7,432,17667983.5,174.0,61.71428571428572,7,432,17666852.666666668,174.0,61.71428571428572
103261.0,17,2,286,2,286,0.0,143.0,143.0,0,0,0.0,0.0,0.0
50637.0,6,14,4740,7,653,7362.333333333333,249.0,93.28571428571428,7,4087,8195.5,1514.0,583.8571428571429
120263034.0,6,224,25402,112,7688,1076031.036036036,140.0,68.64285714285714,112,17714,1076045.0900900902,284.0,158.16071428571428
2637059.0,6,25,7573,14,3735,202850.6923076923,1514.0,266.7857142857143,11,3838,237511.5,1514.0,348.90909090909093
310954.0,17,4,1400,4,1400,103651.33333333331,350.0,350.0,0,0,0.0,0.0,0.0
143959.0,17,2,180,1,90,0.0,90.0,90.0,1,90,0.0,90.0,90.0
10119.0,17,2,582,1,83,0.0,83.0,83.0,1,499,0.0,499.0,499.0
834.0,17,4,438,2,148,0.0,74.0,74.0,2,290,0.0,147.0,145.0
99682.0,17,4,1400,4,1400,33227.333333333336,350.0,350.0,0,0,0.0,0.0,0.0
30338.0,6,14,4740,7,653,4773.166666666667,249.0,93.28571428571428,7,4087,4918.333333333333,1514.0,583.8571428571429
102231354.0,6,30,2106,15,1089,7287637.357142857,123.0,72.6,15,1017,7287637.928571428,123.0,67.8
317.0,17,2,174,1,79,0.0,79.0,79.0,1,95,0.0,95.0,95.0
10470998.0,6,7,478,4,272,3444665.6666666665,74.0,68.0,3,206,5166892.0,74.0,68.66666666666667
306.0,17,2,174,1,79,0.0,79.0,79.0,1,95,0.0,95.0,95.0
90055315.0,17,28,13364,28,13364,3335382.037037037,501.0,477.2857142857143,0,0,0.0,0.0,0.0
1320491.0,6,4,264,2,132,0.0,66.0,66.0,2,132,0.0,66.0,66.0
178136.0,17,2,180,1,90,0.0,90.0,90.0,1,90,0.0,90.0,90.0
135128109.0,17,6,1146,6,1146,27025621.8,191.0,191.0,0,0,0.0,0.0,0.0
121737355.0,6,226,25814,114,7820,1077321.725663717,140.0,68.59649122807018,112,17994,1065189.774774775,300.0,160.66071428571428
25622.0,6,10,2032,5,524,5944.0,252.0,104.8,5,1508,5752.5,1236.0,301.6
95147844.0,6,198,22404,99,6756,969604.9285714284,140.0,68.24242424242425,99,15648,951723.1734693878,284.0,158.06060606060606
37640.0,6,14,4740,7,653,6161.833333333333,249.0,93.28571428571428,7,4087,6131.0,1514.0,583.8571428571429
303151.0,6,2,132,1,66,0.0,66.0,66.0,1,66,0.0,66.0,66.0
1173934.0,6,13,3000,8,2372,167704.85714285713,1514.0,296.5,5,628,224517.0,331.0,125.6
146137.0,6,3,337,2,214,0.0,160.0,107.0,1,123,0.0,123.0,123.0
14759.0,6,13,1459,7,862,2338.1666666666665,271.0,123.14285714285714,6,597,2665.6,259.0,99.5
249439.0,6,10,1221,6,636,49887.8,298.0,106.0,4,585,77823.33333333333,379.0,146.25
113254818.0,6,46,3036,23,1518,5135436.7727272725,66.0,66.0,23,1518,5135439.636363637,66.0,66.0
415.0,17,2,166,1,75,0.0,75.0,75.0,1,91,0.0,91.0,91.0
298.0,17,2,156,1,78,0.0,78.0,78.0,1,78,0.0,78.0,78.0
120382023.0,6,262,30012,131,8868,919692.0846153846,140.0,67.69465648854961,131,21144,919742.1076923076,284.0,161.40458015267177
90765057.0,6,16,1192,8,596,12966436.714285716,95.0,74.5,8,596,12924258.42857143,95.0,74.5
118004149.0,6,30,1974,15,1026,8413492.285714285,123.0,68.4,15,948,8413496.357142856,123.0,63.2
120240710.0,6,19,1436,9,691,14999097.0,95.0,76.77777777777777,10,745,13332222.111111112,95.0,74.5
146215.0,6,3,337,2,214,0.0,160.0,107.0,1,123,0.0,123.0,123.0
90043292.0,17,28,13364,28,13364,3334936.7407407407,501.0,477.2857142857143,0,0,0.0,0.0,0.0
120142145.0,6,14,2240,6,1224,24028429.0,204.0,204.0,8,1016,17137450.57142857,188.0,127.0
2801552.0,6,2,132,1,66,0.0,66.0,66.0,1,66,0.0,66.0,66.0
33707120.0,6,5,336,2,134,0.0,68.0,67.0,3,202,15463372.5,70.0,67.33333333333333
144658.0,17,2,180,1,70,0.0,70.0,70.0,1,110,0.0,110.0,110.0
2592993.0,6,2,132,1,66,0.0,66.0,66.0,1,66,0.0,66.0,66.0
109100425.0,17,14,864,7,432,18167316.83333333,174.0,61.71428571428572,7,432,18166830.33333333,174.0,61.71428571428572
354.0,17,2,166,1,75,0.0,75.0,75.0,1,91,0.0,91.0,91.0
90363649.0,6,13,2052,6,1224,18072386.6,204.0,204.0,7,828,15014412.666666666,188.0,118.28571428571428
222409.0,17,2,180,1,90,0.0,90.0,90.0,1,90,0.0,90.0,90.0
86897.0,6,14,4740,7,653,13443.333333333334,249.0,93.28571428571428,7,4087,13302.333333333334,1514.0,583.8571428571429
1355885.0,17,16,1120,16,1120,90392.33333333331,70.0,70.0,0,0,0.0,0.0,0.0
26770.0,6,14,4740,7,653,3985.1666666666665,249.0,93.28571428571428,7,4087,4317.666666666667,1514.0,583.8571428571429
122241666.0,6,202,22886,102,7028,1210313.524752475,140.0,68.90196078431373,100,15858,1164911.8585858585,284.0,158.58
31726.0,6,10,2032,5,524,7504.5,252.0,104.8,5,1508,4867.5,1236.0,301.6
13925.0,6,11,1133,6,602,2340.2,264.0,100.33333333333331,5,531,3120.75,259.0,106.2
308680.0,6,6,412,4,272,102893.33333333331,74.0,68.0,2,140,0.0,74.0,70.0
69602.0,6,14,4740,7,653,11382.5,249.0,93.28571428571428,7,4087,10319.5,1514.0,583.8571428571429
135132346.0,17,6,1146,6,1146,27026469.2,191.0,191.0,0,0,0.0,0.0,0.0
17603.0,6,14,4740,7,653,2787.6666666666665,249.0,93.28571428571428,7,4087,2799.333333333333,1514.0,583.8571428571429
47561.0,6,10,2032,5,524,11510.25,252.0,104.8,5,1508,9802.0,1236.0,301.6
106031.0,17,2,700,2,700,0.0,350.0,350.0,0,0,0.0,0.0,0.0
1329505.0,17,6,1230,3,234,664569.5,78.0,78.0,3,996,664546.0,332.0,332.0
41100.0,6,14,4740,7,653,6418.666666666667,249.0,93.28571428571428,7,4087,6473.833333333333,1514.0,583.8571428571429
37335.0,6,14,4740,7,653,6094.333333333333,249.0,93.28571428571428,7,4087,6030.833333333333,1514.0,583.8571428571429
108110018.0,17,5,1005,5,1005,27027504.5,201.0,201.0,0,0,0.0,0.0,0.0
108098654.0,17,5,1005,5,1005,27024663.5,201.0,201.0,0,0,0.0,0.0,0.0
90736732.0,6,21,1626,12,935,8244456.454545454,95.0,77.91666666666667,9,691,11279479.0,95.0,76.77777777777777
120208020.0,6,238,26972,119,8150,1011742.559322034,140.0,68.4873949579832,119,18822,1011818.0423728812,374.0,158.16806722689077
53725.0,6,14,4740,7,653,8834.666666666666,249.0,93.28571428571428,7,4087,8483.666666666666,1514.0,583.8571428571429
53620.0,6,10,2032,5,524,13148.25,252.0,104.8,5,1508,10306.75,1236.0,301.6
115024669.0,6,32,2236,16,1071,7668311.266666667,123.0,66.9375,16,1165,6988220.0,139.0,72.8125
10512663.0,6,7,478,4,272,3458862.6666666665,74.0,68.0,3,206,5188176.5,74.0,68.66666666666667
876157.0,6,9,1268,6,797,175231.4,459.0,132.83333333333334,3,471,300107.5,331.0,157.0
113618105.0,6,46,3036,23,1518,5150438.090909091,66.0,66.0,23,1518,5150436.045454546,66.0,66.0
84749.0,6,14,4740,7,653,13842.5,249.0,93.28571428571428,7,4087,13953.666666666666,1514.0,583.8571428571429
54218.0,6,14,4740,7,653,8581.5,249.0,93.28571428571428,7,4087,7281.5,1514.0,583.8571428571429
1302410.0,6,4,264,2,132,0.0,66.0,66.0,2,132,0.0,66.0,66.0
2577755.0,6,2,132,1,66,0.0,66.0,66.0,1,66,0.0,66.0,66.0
146688.0,6,3,337,2,214,0.0,160.0,107.0,1,123,0.0,123.0,123.0
73891.0,6,14,4740,7,653,12158.333333333334,249.0,93.28571428571428,7,4087,11453.666666666666,1514.0,583.8571428571429
114330432.0,6,48,3168,24,1584,4970888.347826087,66.0,66.0,24,1584,4957220.565217392,66.0,66.0
2387548.0,6,3,1604,1,753,0.0,753.0,753.0,2,851,0.0,785.0,425.5
10469170.0,6,7,478,4,272,3442589.0,74.0,68.0,3,206,5163784.5,74.0,68.66666666666667
90095913.0,6,11,1644,7,828,15015985.5,188.0,118.28571428571428,4,816,20113457.666666668,204.0,204.0
29623.0,6,14,4740,7,653,4787.333333333333,249.0,93.28571428571428,7,4087,3450.0,1514.0,583.8571428571429
2093508.0,6,18,6803,10,1501,232612.0,408.0,150.1,8,5302,236589.8571428572,1514.0,662.75
220666.0,6,3,426,2,280,0.0,214.0,140.0,1,146,0.0,146.0,146.0
25948.0,6,14,4740,7,653,2821.5,249.0,93.28571428571428,7,4087,4190.0,1514.0,583.8571428571429
15692.999999999998,6,14,4740,7,653,2337.1666666666665,249.0,93.28571428571428,7,4087,2475.0,1514.0,583.8571428571429
90533121.0,6,13,2036,8,1016,12933303.0,188.0,127.0,5,1020,22592179.0,204.0,204.0
124011142.0,17,15,907,8,475,17715877.42857143,174.0,59.375,7,432,17333501.5,174.0,61.71428571428572
209641.0,17,2,180,1,90,0.0,90.0,90.0,1,90,0.0,90.0,90.0
196939.0,17,2,180,1,90,0.0,90.0,90.0,1,90,0.0,90.0,90.0
132969.0,6,3,337,2,214,0.0,160.0,107.0,1,123,0.0,123.0,123.0
10227.0,6,10,2032,5,524,2318.5,252.0,104.8,5,1508,1941.5,1236.0,301.6
23863.0,6,10,2032,5,524,5635.75,252.0,104.8,5,1508,5345.0,1236.0,301.6
2755487.0,6,2,134,1,68,0.0,68.0,68.0,1,66,0.0,66.0,66.0
17971.0,6,12,1320,6,723,2917.6,253.0,120.5,6,597,3018.2,259.0,99.5
119007379.0,17,13,821,7,432,19834563.166666668,174.0,61.71428571428572,6,389,19800170.8,174.0,64.83333333333333
23104100.0,17,3,1034,2,684,0.0,342.0,342.0,1,350,0.0,350.0,350.0
39122.0,6,14,4740,7,653,5801.333333333333,249.0,93.28571428571428,7,4087,6311.333333333333,1514.0,583.8571428571429
90258177.0,6,13,2036,8,1016,12894025.285714284,188.0,127.0,5,1020,22523599.5,204.0,204.0
737.0,17,4,360,2,172,0.0,86.0,86.0,2,188,0.0,102.0,94.0
90256816.0,6,12,1832,8,1016,12893830.857142856,188.0,127.0,4,816,30031146.0,204.0,204.0
103011564.0,17,14,864,7,432,17166819.166666668,174.0,61.71428571428572,7,432,17167668.0,174.0,61.71428571428572
120208166.0,6,464,60190,232,15608,516871.0216450216,140.0,67.27586206896552,232,44582,516822.1645021645,480.0,192.16379310344828
120053645.0,17,28,13364,28,13364,4446431.296296297,501.0,477.2857142857143,0,0,0.0,0.0,0.0
40210.0,6,14,4740,7,653,6576.333333333333,249.0,93.28571428571428,7,4087,6525.166666666667,1514.0,583.8571428571429
108105021.0,17,5,955,5,955,27026255.25,191.0,191.0,0,0,0.0,0.0,0.0
691723.0,6,5,1742,3,921,345861.5,785.0,307.0,2,821,0.0,753.0,410.5
137.0,17,2,762,2,762,0.0,381.0,381.0,0,0,0.0,0.0,0.0
310059.0,6,6,412,4,272,103353.0,74.0,68.0,2,140,0.0,74.0,70.0
46497.0,6,14,4740,7,653,7272.833333333333,249.0,93.28571428571428,7,4087,7475.833333333333,1514.0,583.8571428571429
120785816.0,17,14,995,8,606,17255116.57142857,174.0,75.75,6,389,19985341.0,174.0,64.83333333333333
90046693.0,17,27,12943,27,12943,3463334.346153846,501.0,479.3703703703704,0,0,0.0,0.0,0.0
53969.0,6,14,4740,7,653,8869.666666666666,249.0,93.28571428571428,7,4087,8487.666666666666,1514.0,583.8571428571429
236147.0,6,3,337,2,214,0.0,160.0,107.0,1,123,0.0,123.0,123.0
146154.0,6,3,337,2,214,0.0,160.0,107.0,1,123,0.0,123.0,123.0
177598.0,6,10,1065,5,534,43967.75,262.0,106.8,5,531,2666.5,259.0,106.2
147904.0,17,2,180,1,90,0.0,90.0,90.0,1,90,0.0,90.0,90.0
0.0,17,1,72,1,72,0.0,72.0,72.0,0,0,0.0,0.0,0.0
123631229.0,6,33,2280,17,1209,7726951.8125,123.0,71.11764705882354,16,1071,7562012.4,123.0,66.9375
144126.0,17,2,180,1,90,0.0,90.0,90.0,1,90,0.0,90.0,90.0
316905.0,17,4,1400,4,1400,105635.0,350.0,350.0,0,0,0.0,0.0,0.0
1568876.0,6,2,132,1,66,0.0,66.0,66.0,1,66,0.0,66.0,66.0
135123400.0,17,6,1206,6,1206,27024680.0,201.0,201.0,0,0,0.0,0.0,0.0
51166838.0,6,8,1307,8,1307,7309548.285714285,172.0,163.375,0,0,0.0,0.0,0.0
162251.0,17,2,180,1,90,0.0,90.0,90.0,1,90,0.0,90.0,90.0
90531479.0,6,14,2240,8,1016,12933068.42857143,188.0,127.0,6,1224,18073836.6,204.0,204.0
149233.0,17,4,6056,4,6056,49744.333333333336,1514.0,1514.0,0,0,0.0,0.0,0.0
315.0,17,2,166,1,75,0.0,75.0,75.0,1,91,0.0,91.0,91.0
9739259.0,6,5,1734,2,818,0.0,752.0,409.0,3,916,3466092.0,784.0,305.3333333333333
352.0,17,2,160,1,80,0.0,80.0,80.0,1,80,0.0,80.0,80.0
299773.0,6,6,412,4,272,99924.33333333331,74.0,68.0,2,140,0.0,74.0,70.0
72570.0,6,14,4740,7,653,11645.666666666666,249.0,93.28571428571428,7,4087,11951.166666666666,1514.0,583.8571428571429
9447.0,17,2,582,1,83,0.0,83.0,83.0,1,499,0.0,499.0,499.0
305545.0,6,6,412,4,272,101848.33333333331,74.0,68.0,2,140,0.0,74.0,70.0
197224.0,17,2,180,1,90,0.0,90.0,90.0,1,90,0.0,90.0,90.0
316242.0,17,4,1400,4,1400,105414.0,350.0,350.0,0,0,0.0,0.0,0.0
2428.0,17,4,344,2,150,0.0,75.0,75.0,2,194,0.0,103.0,97.0
90054450.0,17,28,13364,28,13364,3335350.0,501.0,477.2857142857143,0,0,0.0,0.0,0.0
59700.0,6,13,1513,7,882,9950.0,291.0,126.0,6,631,9536.4,293.0,105.16666666666669
251168.0,6,3,337,2,214,0.0,160.0,107.0,1,123,0.0,123.0,123.0
97444.0,17,2,762,2,762,0.0,381.0,381.0,0,0,0.0,0.0,0.0
22020.0,6,14,4740,7,653,3374.6666666666665,249.0,93.28571428571428,7,4087,3498.333333333333,1514.0,583.8571428571429
101805.0,17,2,762,2,762,0.0,381.0,381.0,0,0,0.0,0.0,0.0
120065290.0,17,29,13785,29,13785,4288046.071428572,501.0,475.3448275862069,0,0,0.0,0.0,0.0
21747.0,6,14,4740,7,653,3310.6666666666665,249.0,93.28571428571428,7,4087,3204.0,1514.0,583.8571428571429
2468.0,17,4,344,2,150,0.0,75.0,75.0,2,194,0.0,103.0,97.0
120125951.0,6,13,2020,9,1204,15015743.875,188.0,133.77777777777777,4,816,30024622.33333333,204.0,204.0
135133104.0,17,6,1206,6,1206,27026620.8,201.0,201.0,0,0,0.0,0.0,0.0
48427.0,6,10,2032,5,524,11759.0,252.0,104.8,5,1508,11835.0,1236.0,301.6
142070.0,6,2,132,1,66,0.0,66.0,66.0,1,66,0.0,66.0,66.0
90091247.0,6,10,1440,7,828,15015207.833333334,188.0,118.28571428571428,3,612,30030049.0,204.0,204.0
2378.0,17,4,344,2,150,0.0,75.0,75.0,2,194,0.0,103.0,97.0
5602608.0,6,5,336,2,134,0.0,68.0,67.0,3,202,1423593.5,70.0,67.33333333333333
130905.0,6,3,337,2,214,0.0,160.0,107.0,1,123,0.0,123.0,123.0
50725.0,6,14,4740,7,653,8182.166666666667,249.0,93.28571428571428,7,4087,7701.5,1514.0,583.8571428571429
2359.0,17,4,344,2,150,0.0,75.0,75.0,2,194,0.0,103.0,97.0
135137162.0,17,6,1206,6,1206,27027432.4,201.0,201.0,0,0,0.0,0.0,0.0
233893.0,6,3,337,2,214,0.0,160.0,107.0,1,123,0.0,123.0,123.0
321905.0,17,4,1400,4,1400,107301.66666666669,350.0,350.0,0,0,0.0,0.0,0.0
102746527.0,6,30,2122,15,1105,7324426.928571428,139.0,73.66666666666667,15,1017,7324434.357142857,123.0,67.8
31919.000000000004,6,14,4740,7,653,5176.666666666667,249.0,93.28571428571428,7,4087,5031.666666666667,1514.0,583.8571428571429
118533.0,6,14,4740,7,653,19518.666666666668,249.0,93.28571428571428,7,4087,18466.166666666668,1514.0,583.8571428571429
228434.0,17,2,180,1,90,0.0,90.0,90.0,1,90,0.0,90.0,90.0
115490021.0,6,256,29420,128,20676,907675.9842519684,284.0,161.53125,128,8744,907675.7401574804,140.0,68.3125
5005498.0,17,4,849,2,166,0.0,83.0,83.0,2,683,0.0,499.0,341.5
101125.0,17,2,762,2,762,0.0,381.0,381.0,0,0,0.0,0.0,0.0
3828768.0,6,5,336,2,134,0.0,68.0,67.0,3,202,1525909.5,70.0,67.33333333333333
814.0,17,4,438,2,148,0.0,74.0,74.0,2,290,0.0,147.0,145.0
90253089.0,6,14,2240,8,1016,12893298.42857143,188.0,127.0,6,1224,18017597.4,204.0,204.0
99947434.0,6,177,19954,89,6096,1135766.2954545454,140.0,68.49438202247191,88,13858,1125097.7701149425,284.0,157.47727272727272
756.0,17,4,438,2,148,0.0,74.0,74.0,2,290,0.0,147.0,145.0
0.0,17,1,342,1,342,0.0,342.0,342.0,0,0,0.0,0.0,0.0
13973.0,6,10,2032,5,524,2902.25,252.0,104.8,5,1508,3121.25,1236.0,301.6
148400.0,17,2,414,1,88,0.0,88.0,88.0,1,326,0.0,326.0,326.0
404.0,17,2,410,1,78,0.0,78.0,78.0,1,332,0.0,332.0,332.0
137013.0,6,2,132,1,66,0.0,66.0,66.0,1,66,0.0,66.0,66.0
311434.0,17,4,1400,4,1400,103811.33333333331,350.0,350.0,0,0,0.0,0.0,0.0
5623535.0,6,5,336,2,134,0.0,68.0,67.0,3,202,1420134.5,70.0,67.33333333333333
90364404.0,6,11,1644,7,828,15060734.0,188.0,118.28571428571428,4,816,20110491.33333333,204.0,204.0
308804.0,6,6,412,4,272,102934.66666666669,74.0,68.0,2,140,0.0,74.0,70.0
120243784.0,6,21,1585,11,840,12024378.4,95.0,76.36363636363636,10,745,13331719.777777778,95.0,74.5
2295.0,17,4,344,2,150,0.0,75.0,75.0,2,194,0.0,103.0,97.0
2610.0,17,4,344,2,150,0.0,75.0,75.0,2,194,0.0,103.0,97.0
298688.0,6,6,412,4,272,99562.66666666669,74.0,68.0,2,140,0.0,74.0,70.0
1181431.0,6,13,3010,8,2382,168775.85714285713,1514.0,297.75,5,628,226431.5,331.0,125.6
309.0,17,2,174,1,79,0.0,79.0,79.0,1,95,0.0,95.0,95.0
244932.0,6,3,337,2,214,0.0,160.0,107.0,1,123,0.0,123.0,123.0
128021673.0,6,31,2034,16,1086,8534778.2,123.0,67.875,15,948,8415779.357142856,123.0,63.2
277267.0,17,2,363,1,79,0.0,79.0,79.0,1,284,0.0,284.0,284.0
228273.0,17,2,180,1,90,0.0,90.0,90.0,1,90,0.0,90.0,90.0
15071.0,6,14,4740,7,653,2289.5,249.0,93.28571428571428,7,4087,2373.333333333333,1514.0,583.8571428571429
307087.0,6,6,412,4,272,102362.33333333331,74.0,68.0,2,140,0.0,74.0,70.0
438.0,17,2,267,1,83,0.0,83.0,83.0,1,184,0.0,184.0,184.0
2801503.0,6,2,132,1,66,0.0,66.0,66.0,1,66,0.0,66.0,66.0
298665.0,6,2,132,1,66,0.0,66.0,66.0,1,66,0.0,66.0,66.0
213095.0,6,3,426,2,280,0.0,214.0,140.0,1,146,0.0,146.0,146.0
10497.0,17,2,174,1,79,0.0,79.0,79.0,1,95,0.0,95.0,95.0
90293174.0,6,19,1436,10,745,10028010.444444444,95.0,74.5,9,691,11282274.375,95.0,76.77777777777777
242924.0,6,3,337,2,214,0.0,160.0,107.0,1,123,0.0,123.0,123.0
153400.0,17,2,180,1,90,0.0,90.0,90.0,1,90,0.0,90.0,90.0
779777.0,6,10,1065,5,534,194229.0,262.0,106.8,5,531,194312.5,259.0,106.2
680.0,17,4,438,2,148,0.0,74.0,74.0,2,290,0.0,147.0,145.0
317430.0,17,4,1400,4,1400,105810.0,350.0,350.0,0,0,0.0,0.0,0.0
329.0,17,2,174,1,79,0.0,79.0,79.0,1,95,0.0,95.0,95.0
120120112.0,6,14,2240,6,1224,24024022.4,204.0,204.0,8,1016,17136273.57142857,188.0,127.0
120473261.0,6,227,25690,114,17936,1066135.0530973452,284.0,157.33333333333334,113,7754,1066436.4375,140.0,68.61946902654867
35976.0,6,10,2032,5,524,8753.5,252.0,104.8,5,1508,8748.75,1236.0,301.6
2434.0,17,4,344,2,150,0.0,75.0,75.0,2,194,0.0,103.0,97.0
3059311.0,6,3,204,2,136,0.0,70.0,68.0,1,68,0.0,68.0,68.0
74702.0,6,14,4740,7,653,11978.166666666666,249.0,93.28571428571428,7,4087,12306.666666666666,1514.0,583.8571428571429
519143.0,17,6,2100,6,2100,103828.6,350.0,350.0,0,0,0.0,0.0,0.0
252100.0,6,3,373,2,238,0.0,172.0,119.0,1,135,0.0,135.0,135.0
228170.0,6,13,1394,7,797,38028.333333333336,253.0,113.85714285714286,6,597,44452.4,259.0,99.5
90932965.0,6,21,1585,11,840,9092326.6,95.0,76.36363636363636,10,745,10103301.111111112,95.0,74.5
108108660.0,17,5,955,5,955,27027165.0,191.0,191.0,0,0,0.0,0.0,0.0
26881.0,6,10,2032,5,524,6119.25,252.0,104.8,5,1508,6211.75,1236.0,301.6
1045.0,17,2,762,2,762,0.0,381.0,381.0,0,0,0.0,0.0,0.0
120120939.0,6,12,1832,8,1016,17137298.0,188.0,127.0,4,816,30030844.666666668,204.0,204.0
36138.0,6,10,2032,5,524,8812.25,252.0,104.8,5,1508,7575.5,1236.0,301.6
356.0,17,2,267,1,83,0.0,83.0,83.0,1,184,0.0,184.0,184.0
498950.0,6,5,336,2,134,0.0,68.0,67.0,3,202,195595.5,70.0,67.33333333333333
90010822.0,17,28,13364,28,13364,3333734.1481481483,501.0,477.2857142857143,0,0,0.0,0.0,0.0
233118.0,6,3,337,2,214,0.0,160.0,107.0,1,123,0.0,123.0,123.0
5262271.0,6,155,134181,94,125853,56577.94623655914,1510.0,1338.8617021276596,61,8328,81199.56666666667,1510.0,136.52459016393442
1018592.0,6,11,1134,6,558,203718.4,220.0,93.0,5,576,253986.75,304.0,115.2
206096.0,6,3,426,2,280,0.0,214.0,140.0,1,146,0.0,146.0,146.0
302891.0,6,6,412,4,272,100963.66666666669,74.0,68.0,2,140,0.0,74.0,70.0
31014.0,6,14,4740,7,653,4935.333333333333,249.0,93.28571428571428,7,4087,4044.1666666666665,1514.0,583.8571428571429
153434.0,17,2,180,1,90,0.0,90.0,90.0,1,90,0.0,90.0,90.0
228312.0,17,2,180,1,90,0.0,90.0,90.0,1,90,0.0,90.0,90.0
104488.0,17,2,700,2,700,0.0,350.0,350.0,0,0,0.0,0.0,0.0
0.0,6,1,172,1,172,0.0,172.0,172.0,0,0,0.0,0.0,0.0
2031.0,17,4,344,2,150,0.0,75.0,75.0,2,194,0.0,103.0,97.0
120015788.0,6,33,2359,17,1288,7488208.8125,139.0,75.76470588235294,16,1071,7987276.2,123.0,66.9375
104095882.0,17,14,1126,7,563,17332650.166666668,174.0,80.42857142857143,7,563,17333469.166666668,174.0,80.42857142857143
316569.0,6,6,412,4,272,105523.0,74.0,68.0,2,140,0.0,74.0,70.0
42526.0,6,13,1394,7,797,7087.666666666667,253.0,113.85714285714286,6,597,6720.0,259.0,99.5
9620.0,17,2,582,1,83,0.0,83.0,83.0,1,499,0.0,499.0,499.0
120355105.0,6,231,26166,116,18354,1046566.1304347826,284.0,158.22413793103448,115,7812,1046645.850877193,140.0,67.9304347826087
4513.0,17,2,180,1,90,0.0,90.0,90.0,1,90,0.0,90.0,90.0
148159.0,17,2,180,1,90,0.0,90.0,90.0,1,90,0.0,90.0,90.0
236887.0,6,3,426,2,280,0.0,214.0,140.0,1,146,0.0,146.0,146.0
103121.0,17,2,286,2,286,0.0,143.0,143.0,0,0,0.0,0.0,0.0
146161.0,6,3,337,2,214,0.0,160.0,107.0,1,123,0.0,123.0,123.0
135134989.0,17,6,1206,6,1206,27026997.8,201.0,201.0,0,0,0.0,0.0,0.0
345759.0,6,3,1604,2,851,0.0,785.0,425.5,1,753,0.0,753.0,753.0
228114.0,17,2,180,1,90,0.0,90.0,90.0,1,90,0.0,90.0,90.0
25174.0,6,14,4740,7,653,4070.6666666666665,249.0,93.28571428571428,7,4087,4059.5,1514.0,583.8571428571429
10900.0,6,10,1067,5,536,2463.25,264.0,107.2,5,531,2194.5,259.0,106.2
105384403.0,17,14,1126,7,563,17441017.333333332,174.0,80.42857142857143,7,563,17537239.333333332,174.0,80.42857142857143
120384999.0,6,216,24424,108,7424,1107762.0654205608,140.0,68.74074074074075,108,17000,1113936.4112149533,284.0,157.40740740740742
16908.0,6,10,2032,5,524,3945.0,252.0,104.8,5,1508,3872.75,1236.0,301.6
136014.0,6,2,132,1,66,0.0,66.0,66.0,1,66,0.0,66.0,66.0
14217.0,6,10,2032,5,524,3248.75,252.0,104.8,5,1508,2722.75,1236.0,301.6
843374.0,6,9,1196,6,725,168674.8,387.0,120.83333333333331,3,471,285230.0,331.0,157.0
71826.0,6,14,4740,7,653,11842.333333333334,249.0,93.28571428571428,7,4087,11413.5,1514.0,583.8571428571429
863761.0,6,9,1269,6,798,172752.2,460.0,133.0,3,471,295592.0,331.0,157.0
360508.0,17,4,820,2,156,0.0,78.0,78.0,2,664,0.0,332.0,332.0
106875889.0,6,29,2052,15,1089,7618574.071428572,123.0,72.6,14,963,8204618.076923077,123.0,68.78571428571429
2272.0,17,4,344,2,150,0.0,75.0,75.0,2,194,0.0,103.0,97.0
148925.0,6,3,373,2,238,0.0,172.0,119.0,1,135,0.0,135.0,135.0
120352185.0,6,197,22392,99,15702,1228083.5204081633,284.0,158.6060606060606,98,6690,1229756.9278350514,140.0,68.26530612244898
2018.0,17,4,344,2,150,0.0,75.0,75.0,2,194,0.0,103.0,97.0
90289213.0,6,16,1192,8,596,12891332.57142857,95.0,74.5,8,596,12896676.0,95.0,74.5
240744.0,6,3,337,2,214,0.0,160.0,107.0,1,123,0.0,123.0,123.0
12545.0,17,2,582,1,83,0.0,83.0,83.0,1,499,0.0,499.0,499.0
143906.0,17,2,180,1,90,0.0,90.0,90.0,1,90,0.0,90.0,90.0
146330.0,6,3,337,2,214,0.0,160.0,107.0,1,123,0.0,123.0,123.0
292863.0,17,2,180,1,90,0.0,90.0,90.0,1,90,0.0,90.0,90.0
1306882.0,6,4,264,2,132,0.0,66.0,66.0,2,132,0.0,66.0,66.0
118916982.0,6,35,2526,18,1332,6995116.588235294,123.0,74.0,17,1194,7418780.9375,123.0,70.23529411764706
2403.0,17,4,344,2,150,0.0,75.0,75.0,2,194,0.0,103.0,97.0
107609.0,17,2,286,2,286,0.0,143.0,143.0,0,0,0.0,0.0,0.0
90291269.0,6,16,1192,8,596,12891495.142857144,95.0,74.5,8,596,12897355.714285716,95.0,74.5
246439.0,6,3,337,2,214,0.0,160.0,107.0,1,123,0.0,123.0,123.0
317850.0,17,4,1400,4,1400,105950.0,350.0,350.0,0,0,0.0,0.0,0.0
45076.0,6,14,4740,7,653,6946.0,249.0,93.28571428571428,7,4087,7266.5,1514.0,583.8571428571429
94261409.0,6,26,2860,13,1407,7854291.5,425.0,108.23076923076924,13,1453,7854214.166666667,358.0,111.76923076923076
27207.0,6,14,4740,7,653,2233.833333333333,249.0,93.28571428571428,7,4087,4318.166666666667,1514.0,583.8571428571429
17106.0,6,11,1131,6,600,3100.8,262.0,100.0,5,531,4056.5,259.0,106.2
129388757.0,6,39,2770,20,1468,6809934.578947368,139.0,73.4,19,1302,6621553.277777778,123.0,68.52631578947368
206000.0,6,3,426,2,280,0.0,214.0,140.0,1,146,0.0,146.0,146.0
24570.0,6,10,2032,5,524,4930.5,252.0,104.8,5,1508,5788.0,1236.0,301.6
5621078.0,6,4,270,2,134,0.0,68.0,67.0,2,136,0.0,70.0,68.0
108121502.0,17,5,1005,5,1005,27030375.5,201.0,201.0,0,0,0.0,0.0,0.0
371324.0,6,12,1373,7,714,61887.333333333336,298.0,102.0,5,659,90961.5,379.0,131.8
10424753.0,6,7,478,4,272,3429450.333333333,74.0,68.0,3,206,5144080.5,74.0,68.66666666666667
10514644.0,6,7,478,4,272,3457733.0,74.0,68.0,3,206,5186495.5,74.0,68.66666666666667
105263887.0,17,14,864,7,432,17502191.333333332,174.0,61.71428571428572,7,432,17500141.833333332,174.0,61.71428571428572
12070.0,6,10,1066,5,490,2801.25,218.0,98.0,5,576,2703.75,304.0,115.2
286256.0,17,2,180,1,90,0.0,90.0,90.0,1,90,0.0,90.0,90.0
300730.0,6,6,412,4,272,100243.33333333331,74.0,68.0,2,140,0.0,74.0,70.0
48720.0,6,10,2032,5,524,11944.0,252.0,104.8,5,1508,10411.5,1236.0,301.6
1082395.0,6,13,1386,7,789,180399.16666666663,253.0,112.71428571428572,6,597,215558.0,259.0,99.5
99926796.0,17,12,778,6,389,19898728.0,174.0,64.83333333333333,6,389,19953399.6,174.0,64.83333333333333
113254849.0,6,46,3036,23,1518,5135435.909090909,66.0,66.0,23,1518,5135432.590909091,66.0,66.0
119116601.0,6,35,2473,18,1248,7006858.882352941,123.0,69.33333333333333,17,1225,7429073.3125,139.0,72.05882352941177
11602.0,6,10,2032,5,524,2578.5,252.0,104.8,5,1508,2590.25,1236.0,301.6
299414.0,6,6,412,4,272,99804.66666666669,74.0,68.0,2,140,0.0,74.0,70.0
1159323.0,6,13,1386,7,789,193220.5,253.0,112.71428571428572,6,597,230252.8,259.0,99.5
81.0,17,2,762,2,762,0.0,381.0,381.0,0,0,0.0,0.0,0.0
228184.0,17,2,180,1,90,0.0,90.0,90.0,1,90,0.0,90.0,90.0
303135.0,6,2,132,1,66,0.0,66.0,66.0,1,66,0.0,66.0,66.0
107290.0,17,2,700,2,700,0.0,350.0,350.0,0,0,0.0,0.0,0.0
135130172.0,17,6,1206,6,1206,27026034.4,201.0,201.0,0,0,0.0,0.0,0.0
301.0,17,2,174,1,79,0.0,79.0,79.0,1,95,0.0,95.0,95.0
98010891.0,17,14,1126,7,563,16334030.333333334,174.0,80.42857142857143,7,563,16333493.5,174.0,80.42857142857143
5003642.0,17,4,629,2,156,0.0,78.0,78.0,2,473,0.0,268.0,236.5
51326.0,6,14,4740,7,653,8109.166666666667,249.0,93.28571428571428,7,4087,6862.166666666667,1514.0,583.8571428571429
122687798.0,6,48,3168,24,1584,5037676.173913044,66.0,66.0,24,1584,5170651.913043479,66.0,66.0
5827216.0,6,5,336,2,134,0.0,68.0,67.0,3,202,1525976.0,70.0,67.33333333333333
0.0,17,1,55,1,55,0.0,55.0,55.0,0,0,0.0,0.0,0.0
312136.0,17,4,1400,4,1400,104045.33333333331,350.0,350.0,0,0,0.0,0.0,0.0
155061.0,6,3,337,2,214,0.0,160.0,107.0,1,123,0.0,123.0,123.0
886324.0,6,10,1333,6,796,177264.8,458.0,132.66666666666666,4,537,204448.3333333333,331.0,134.25
128685063.0,6,35,2526,17,1194,7418760.125,123.0,70.23529411764706,18,1332,6982361.411764706,123.0,74.0
299.0,17,2,164,1,82,0.0,82.0,82.0,1,82,0.0,82.0,82.0
114319167.0,6,34,2334,17,1209,7131447.0,123.0,71.11764705882354,17,1125,7131445.8125,123.0,66.17647058823529
143984.0,17,2,180,1,90,0.0,90.0,90.0,1,90,0.0,90.0,90.0
51348.0,6,14,4740,7,653,7892.333333333333,249.0,93.28571428571428,7,4087,8221.666666666666,1514.0,583.8571428571429
106631569.0,17,15,1169,8,606,15001397.285714284,174.0,75.75,7,563,17500174.666666668,174.0,80.42857142857143
324237.0,6,6,412,4,272,108079.0,74.0,68.0,2,140,0.0,74.0,70.0
10766.0,6,10,1065,5,534,2520.75,262.0,106.8,5,531,2376.5,259.0,106.2
110967695.0,6,30,1974,15,1026,7910843.071428572,123.0,68.4,15,948,7910846.214285715,123.0,63.2
0.0,6,1,214,1,214,0.0,214.0,214.0,0,0,0.0,0.0,0.0
108104115.0,17,5,1005,5,1005,27026028.75,201.0,201.0,0,0,0.0,0.0,0.0
33962.0,17,2,582,1,83,0.0,83.0,83.0,1,499,0.0,499.0,499.0
48137.0,6,10,2032,5,524,11169.5,252.0,104.8,5,1508,11683.0,1236.0,301.6
320937.0,17,4,1400,4,1400,106979.0,350.0,350.0,0,0,0.0,0.0,0.0
173923.0,6,4,391,2,214,0.0,160.0,107.0,2,177,0.0,123.0,88.5
35883.0,6,14,4740,7,653,5849.666666666667,249.0,93.28571428571428,7,4087,5782.5,1514.0,583.8571428571429
200609.0,17,2,180,1,90,0.0,90.0,90.0,1,90,0.0,90.0,90.0
143852.0,17,2,180,1,90,0.0,90.0,90.0,1,90,0.0,90.0,90.0
17139.0,6,2,145,2,145,0.0,91.0,72.5,0,0,0.0,0.0,0.0
90262368.0,6,13,2036,8,1016,12894624.0,188.0,127.0,5,1020,22523410.0,204.0,204.0
90300095.0,6,21,1585,11,840,9025050.4,95.0,76.36363636363636,10,745,9949340.666666666,95.0,74.5
304663.0,6,6,412,4,272,101554.33333333331,74.0,68.0,2,140,0.0,74.0,70.0
91650281.0,17,16,5472,16,5472,6110018.733333333,342.0,342.0,0,0,0.0,0.0,0.0
1005837.0,6,9,1118,6,586,201167.4,248.0,97.66666666666669,3,532,365122.0,392.0,177.33333333333334
28736.0,6,14,4740,7,653,4672.166666666667,249.0,93.28571428571428,7,4087,4370.5,1514.0,583.8571428571429
120510117.0,6,31,2097,16,1149,8034007.8,123.0,71.8125,15,948,8043244.5,123.0,63.2
2066592.0,6,25,7610,13,2516,172216.0,1034.0,193.53846153846155,12,5094,160196.18181818182,1510.0,424.5
46590.0,6,14,4740,7,653,7562.666666666667,249.0,93.28571428571428,7,4087,7351.666666666667,1514.0,583.8571428571429
243290.0,6,3,337,2,214,0.0,160.0,107.0,1,123,0.0,123.0,123.0
120116919.0,6,15,2428,9,1204,15014614.875,188.0,133.77777777777777,6,1224,18017455.4,204.0,204.0
1079531.0,6,13,1386,7,789,179921.83333333334,253.0,112.71428571428572,6,597,215047.6,259.0,99.5
13058.0,6,10,1067,5,536,2784.25,264.0,107.2,5,531,2656.75,259.0,106.2
98674699.0,6,26,1746,13,906,8204908.333333333,123.0,69.6923076923077,13,840,8204908.416666667,123.0,64.61538461538461
143924.0,17,2,180,1,90,0.0,90.0,90.0,1,90,0.0,90.0,90.0
233562.0,6,3,337,2,214,0.0,160.0,107.0,1,123,0.0,123.0,123.0
108110782.0,17,5,1005,5,1005,27027695.5,201.0,201.0,0,0,0.0,0.0,0.0
118667526.0,6,48,3168,24,1584,5159457.652173913,66.0,66.0,24,1584,5146357.130434782,66.0,66.0
90315400.0,6,16,1192,8,596,12895767.714285716,95.0,74.5,8,596,12901625.42857143,95.0,74.5
88764.0,6,14,4740,7,653,14673.333333333334,249.0,93.28571428571428,7,4087,8570.333333333334,1514.0,583.8571428571429
19930.0,17,2,582,1,83,0.0,83.0,83.0,1,499,0.0,499.0,499.0
312883.0,6,3,202,2,128,0.0,74.0,64.0,1,74,0.0,74.0,74.0
207152.0,6,3,426,2,280,0.0,214.0,140.0,1,146,0.0,146.0,146.0
3976509.0,6,155,121252,86,112388,46782.45882352941,1510.0,1306.8372093023256,69,8864,53888.26470588235,1510.0,128.46376811594203
1391117.0,17,16,1120,16,1120,92741.13333333332,70.0,70.0,0,0,0.0,0.0,0.0
1310245.0,6,4,264,2,132,0.0,66.0,66.0,2,132,0.0,66.0,66.0
111651514.0,6,38,2964,20,1578,5876395.47368421,123.0,78.9,18,1386,6555015.647058823,123.0,77.0
107410.0,17,2,286,2,286,0.0,143.0,143.0,0,0,0.0,0.0,0.0
255194.0,6,10,1221,6,636,51038.8,298.0,106.0,4,585,79285.33333333333,379.0,146.25
57020793.0,6,21,1524,11,789,5702079.3,95.0,71.72727272727273,10,735,6310554.888888889,95.0,73.5
247116.0,17,2,180,1,90,0.0,90.0,90.0,1,90,0.0,90.0,90.0
314163.0,6,3,202,2,128,0.0,74.0,64.0,1,74,0.0,74.0,74.0
55909.0,6,14,4740,7,653,9192.333333333334,249.0,93.28571428571428,7,4087,8782.0,1514.0,583.8571428571429
2354.0,17,4,344,2,150,0.0,75.0,75.0,2,194,0.0,103.0,97.0
190924.0,17,2,180,1,90,0.0,90.0,90.0,1,90,0.0,90.0,90.0
108109741.0,17,5,955,5,955,27027435.25,191.0,191.0,0,0,0.0,0.0,0.0
2485.0,17,2,762,2,762,0.0,381.0,381.0,0,0,0.0,0.0,0.0
233153.0,6,3,373,2,238,0.0,172.0,119.0,1,135,0.0,135.0,135.0
300187.0,6,6,412,4,272,100062.33333333331,74.0,68.0,2,140,0.0,74.0,70.0
2332.0,17,4,344,2,150,0.0,75.0,75.0,2,194,0.0,103.0,97.0
108105097.0,17,5,1005,5,1005,27026274.25,201.0,201.0,0,0,0.0,0.0,0.0
14599.0,6,10,2032,5,524,2979.5,252.0,104.8,5,1508,3235.25,1236.0,301.6
9296.0,6,10,1975,5,467,2087.0,195.0,93.4,5,1508,2025.75,1236.0,301.6
5001288.0,6,5,336,2,134,0.0,68.0,67.0,3,202,1525899.0,70.0,67.33333333333333
108109669.0,17,5,955,5,955,27027417.25,191.0,191.0,0,0,0.0,0.0,0.0
215192.0,17,2,762,2,762,0.0,381.0,381.0,0,0,0.0,0.0,0.0
9559.0,17,2,539,1,86,0.0,86.0,86.0,1,453,0.0,453.0,453.0
105103153.0,6,44,2904,22,1452,5004912.047619048,66.0,66.0,22,1452,4994618.19047619,66.0,66.0
90261811.0,6,19,1436,10,745,10023339.666666666,95.0,74.5,9,691,11282205.25,95.0,76.77777777777777
293766.0,17,4,1524,4,1524,97922.0,381.0,381.0,0,0,0.0,0.0,0.0
133804.0,6,3,337,2,214,0.0,160.0,107.0,1,123,0.0,123.0,123.0
207134.0,6,3,426,2,280,0.0,214.0,140.0,1,146,0.0,146.0,146.0
1712.0,17,2,664,1,322,0.0,322.0,322.0,1,342,0.0,342.0,342.0
300.0,17,2,168,1,76,0.0,76.0,76.0,1,92,0.0,92.0,92.0
127780864.0,17,14,864,7,432,18000181.166666668,174.0,61.71428571428572,7,432,18001424.166666668,174.0,61.71428571428572
9890.0,17,2,582,1,83,0.0,83.0,83.0,1,499,0.0,499.0,499.0
252785.0,6,10,1221,6,636,50557.0,298.0,106.0,4,585,78525.66666666667,379.0,146.25
201967.0,17,4,1400,4,1400,67322.33333333333,350.0,350.0,0,0,0.0,0.0,0.0
11882.0,6,10,1067,5,536,2264.5,264.0,107.2,5,531,2546.25,259.0,106.2
90276032.0,6,14,1043,7,542,15046005.333333334,95.0,77.42857142857143,7,501,14998717.0,95.0,71.57142857142857
0.0,17,1,90,1,90,0.0,90.0,90.0,0,0,0.0,0.0,0.0
289516.0,17,4,1400,4,1400,96505.33333333331,350.0,350.0,0,0,0.0,0.0,0.0
1311091.0,6,4,264,2,132,0.0,66.0,66.0,2,132,0.0,66.0,66.0
23578.0,6,10,2032,5,524,4730.0,252.0,104.8,5,1508,5613.0,1236.0,301.6
221404.0,6,3,426,2,280,0.0,214.0,140.0,1,146,0.0,146.0,146.0
308525.0,6,3,202,2,128,0.0,74.0,64.0,1,74,0.0,74.0,74.0
52119.0,6,14,4740,7,653,8567.666666666666,249.0,93.28571428571428,7,4087,7885.5,1514.0,583.8571428571429
143935.0,17,2,180,1,90,0.0,90.0,90.0,1,90,0.0,90.0,90.0
103460.0,17,2,286,2,286,0.0,143.0,143.0,0,0,0.0,0.0,0.0
417164.0,6,15,4806,8,719,59324.857142857145,249.0,89.875,7,4087,67897.5,1514.0,583.8571428571429
879.0,17,4,438,2,148,0.0,74.0,74.0,2,290,0.0,147.0,145.0
2315.0,17,4,344,2,150,0.0,75.0,75.0,2,194,0.0,103.0,97.0
2615222.0,6,2,132,1,66,0.0,66.0,66.0,1,66,0.0,66.0,66.0
144000.0,17,2,180,1,90,0.0,90.0,90.0,1,90,0.0,90.0,90.0
776.0,17,4,438,2,148,0.0,74.0,74.0,2,290,0.0,147.0,145.0
91671094.0,17,12,778,6,389,18334218.8,174.0,64.83333333333333,6,389,18197049.2,174.0,64.83333333333333
10520832.0,6,7,478,4,272,3461808.0,74.0,68.0,3,206,5192627.0,74.0,68.66666666666667
45802.0,6,14,4740,7,653,7509.0,249.0,93.28571428571428,7,4087,7449.0,1514.0,583.8571428571429
32316.0,6,14,4740,7,653,5164.333333333333,249.0,93.28571428571428,7,4087,5221.5,1514.0,583.8571428571429
21476.0,6,11,1131,6,600,4009.4,262.0,100.0,5,531,5154.0,259.0,106.2
304000.0,6,6,412,4,272,101333.33333333331,74.0,68.0,2,140,0.0,74.0,70.0
280665.0,17,2,363,1,79,0.0,79.0,79.0,1,284,0.0,284.0,284.0
20452.0,6,2,145,2,145,0.0,91.0,72.5,0,0,0.0,0.0,0.0
298519.0,6,6,412,4,272,99506.33333333331,74.0,68.0,2,140,0.0,74.0,70.0
102705.0,17,2,286,2,286,0.0,143.0,143.0,0,0,0.0,0.0,0.0
1781463.0,6,2,132,1,66,0.0,66.0,66.0,1,66,0.0,66.0,66.0
206171.0,6,3,426,2,280,0.0,214.0,140.0,1,146,0.0,146.0,146.0
120079606.0,17,29,13785,29,13785,4288557.357142857,501.0,475.3448275862069,0,0,0.0,0.0,0.0
1238.0,17,2,762,2,762,0.0,381.0,381.0,0,0,0.0,0.0,0.0
237710.0,17,2,180,1,90,0.0,90.0,90.0,1,90,0.0,90.0,90.0
118336324.0,6,50,3300,23,1518,5378923.818181818,66.0,66.0,27,1782,4535609.961538462,66.0,66.0
228257.0,17,2,180,1,90,0.0,90.0,90.0,1,90,0.0,90.0,90.0
128312.0,6,2,132,1,66,0.0,66.0,66.0,1,66,0.0,66.0,66.0
107711.0,17,2,286,2,286,0.0,143.0,143.0,0,0,0.0,0.0,0.0
208205.0,17,2,762,2,762,0.0,381.0,381.0,0,0,0.0,0.0,0.0
2596037.0,6,2,132,1,66,0.0,66.0,66.0,1,66,0.0,66.0,66.0
301486.0,6,6,412,4,272,100495.33333333331,74.0,68.0,2,140,0.0,74.0,70.0
357.0,17,2,214,1,75,0.0,75.0,75.0,1,139,0.0,139.0,139.0
24160.0,6,14,4740,7,653,3324.833333333333,249.0,93.28571428571428,7,4087,3891.0,1514.0,583.8571428571429
107883.0,17,2,286,2,286,0.0,143.0,143.0,0,0,0.0,0.0,0.0
2806545.0,6,2,132,1,66,0.0,66.0,66.0,1,66,0.0,66.0,66.0
218336.0,6,3,426,2,280,0.0,214.0,140.0,1,146,0.0,146.0,146.0
17726881.0,6,5,1736,2,819,0.0,753.0,409.5,3,917,7465755.5,785.0,305.6666666666667
115148.0,17,4,1400,4,1400,38382.66666666666,350.0,350.0,0,0,0.0,0.0,0.0
108505.0,6,2,132,1,66,0.0,66.0,66.0,1,66,0.0,66.0,66.0
26576.0,6,14,4740,7,653,4268.5,249.0,93.28571428571428,7,4087,4164.666666666667,1514.0,583.8571428571429
120542402.0,6,219,24814,110,17312,1105893.5963302753,284.0,157.38181818181818,109,7502,1106656.990740741,140.0,68.8256880733945
1561.0,17,2,762,2,762,0.0,381.0,381.0,0,0,0.0,0.0,0.0
121755897.0,6,442,56144,221,14882,537764.0136363637,140.0,67.3393665158371,221,41262,553354.7909090909,336.0,186.7058823529412
387609.0,6,3,204,1,68,0.0,68.0,68.0,2,136,0.0,70.0,68.0
307898.0,6,6,412,4,272,102632.66666666669,74.0,68.0,2,140,0.0,74.0,70.0
9508.0,17,2,539,1,86,0.0,86.0,86.0,1,453,0.0,453.0,453.0
117614411.0,6,48,3168,24,1584,5113670.043478261,66.0,66.0,24,1584,5101689.043478261,66.0,66.0
104111148.0,17,14,864,7,432,17334253.5,174.0,61.71428571428572,7,432,17166831.666666668,174.0,61.71428571428572
103074.0,17,2,286,2,286,0.0,143.0,143.0,0,0,0.0,0.0,0.0
320805.0,17,4,1400,4,1400,106935.0,350.0,350.0,0,0,0.0,0.0,0.0
693.0,17,4,438,2,148,0.0,74.0,74.0,2,290,0.0,147.0,145.0
228400.0,17,2,180,1,90,0.0,90.0,90.0,1,90,0.0,90.0,90.0
197028.0,17,2,180,1,90,0.0,90.0,90.0,1,90,0.0,90.0,90.0
287296.0,17,2,180,1,90,0.0,90.0,90.0,1,90,0.0,90.0,90.0
18724.0,6,20,7606,11,978,1872.4,310.0,88.9090909090909,9,6628,1805.75,1514.0,736.4444444444445
100363865.0,17,12,778,6,389,20000191.8,174.0,64.83333333333333,6,389,20001106.6,174.0,64.83333333333333
1175534.0,17,6,1230,3,234,587583.0,78.0,78.0,3,996,587566.0,332.0,332.0
120374255.0,6,214,24308,107,7284,1127572.4056603771,140.0,68.07476635514018,107,17024,1127878.3867924528,284.0,159.10280373831776
111343948.0,17,14,864,7,432,18500928.166666668,174.0,61.71428571428572,7,432,18500172.33333333,174.0,61.71428571428572
17749.0,6,12,1393,6,796,3282.4,271.0,132.66666666666666,6,597,3144.0,259.0,99.5
90027691.0,17,28,13364,28,13364,3334358.925925926,501.0,477.2857142857143,0,0,0.0,0.0,0.0
3741.0,17,2,762,2,762,0.0,381.0,381.0,0,0,0.0,0.0,0.0
182172.0,17,4,6056,4,6056,60724.0,1514.0,1514.0,0,0,0.0,0.0,0.0
876838.0,6,10,1333,6,796,175367.6,458.0,132.66666666666666,4,537,200541.0,331.0,134.25
94088426.0,17,12,778,6,389,18801052.8,174.0,64.83333333333333,6,389,18800195.6,174.0,64.83333333333333
107160.0,17,2,286,2,286,0.0,143.0,143.0,0,0,0.0,0.0,0.0
307228.0,6,6,412,4,272,102409.33333333331,74.0,68.0,2,140,0.0,74.0,70.0
0.0,17,1,381,1,381,0.0,381.0,381.0,0,0,0.0,0.0,0.0
217896.0,6,3,426,2,280,0.0,214.0,140.0,1,146,0.0,146.0,146.0
2795365.0,6,2,132,1,66,0.0,66.0,66.0,1,66,0.0,66.0,66.0
103818906.0,6,28,1860,14,966,7969473.846153846,123.0,69.0,14,894,7969480.461538462,123.0,63.85714285714285
109583497.0,17,14,864,7,432,18168195.166666668,174.0,61.71428571428572,7,432,18166935.83333333,174.0,61.71428571428572
298933.0,6,10,1221,6,636,59786.6,298.0,106.0,4,585,93876.0,379.0,146.25
120122018.0,6,16,2368,9,1204,14994753.75,188.0,133.77777777777777,7,1164,15015624.5,204.0,166.28571428571428
118902119.0,6,34,2350,17,1225,7431382.4375,139.0,72.05882352941177,17,1125,7417869.4375,123.0,66.17647058823529
45602.0,6,10,1065,5,534,10336.0,262.0,106.8,5,531,8426.25,259.0,106.2
2389754.0,6,25,7573,14,3735,183827.2307692308,1514.0,266.7857142857143,11,3838,212473.4,1514.0,348.90909090909093
2324.0,17,4,344,2,150,0.0,75.0,75.0,2,194,0.0,103.0,97.0
162208.0,17,2,180,1,90,0.0,90.0,90.0,1,90,0.0,90.0,90.0
25595.0,6,10,2032,5,524,4864.25,252.0,104.8,5,1508,6152.75,1236.0,301.6
302377.0,6,2,132,1,66,0.0,66.0,66.0,1,66,0.0,66.0,66.0
3168912.0,6,18,1495,9,921,358422.25,315.0,102.33333333333331,9,574,358411.125,78.0,63.77777777777778
0.0,17,1,453,1,453,0.0,453.0,453.0,0,0,0.0,0.0,0.0
135129919.0,17,6,1146,6,1146,27025983.8,191.0,191.0,0,0,0.0,0.0,0.0
2192948.0,6,24,7544,13,2516,182745.66666666663,1034.0,193.53846153846155,11,5028,185399.5,1510.0,457.09090909090907
108104377.0,17,5,955,5,955,27026094.25,191.0,191.0,0,0,0.0,0.0,0.0
36127.0,6,14,4740,7,653,5430.333333333333,249.0,93.28571428571428,7,4087,4753.833333333333,1514.0,583.8571428571429
1028630.0,6,11,1134,6,558,205726.0,220.0,93.0,5,576,256433.75,304.0,115.2
3326897.0,6,147,125684,90,117620,37380.86516853933,1510.0,1306.888888888889,57,8064,53836.30357142857,1510.0,141.47368421052633
338.0,17,2,216,1,84,0.0,84.0,84.0,1,132,0.0,132.0,132.0
668887.0,6,2,132,1,66,0.0,66.0,66.0,1,66,0.0,66.0,66.0
113981965.0,6,48,3168,24,1584,4955737.608695652,66.0,66.0,24,1584,4942299.347826087,66.0,66.0
153604.0,17,2,180,1,90,0.0,90.0,90.0,1,90,0.0,90.0,90.0
47536.0,6,14,4740,7,653,7492.833333333333,249.0,93.28571428571428,7,4087,7670.666666666667,1514.0,583.8571428571429
936300.0,6,2,132,1,66,0.0,66.0,66.0,1,66,0.0,66.0,66.0
135128454.0,17,6,1146,6,1146,27025690.8,191.0,191.0,0,0,0.0,0.0,0.0
10458192.0,6,7,478,4,272,3440686.0,74.0,68.0,3,206,5160910.0,74.0,68.66666666666667
12198.0,6,10,1066,5,490,2695.75,218.0,98.0,5,576,2769.75,304.0,115.2
319836.0,17,4,1400,4,1400,106612.0,350.0,350.0,0,0,0.0,0.0,0.0
43147.0,6,14,4740,7,653,7036.666666666667,249.0,93.28571428571428,7,4087,6253.666666666667,1514.0,583.8571428571429
10516788.0,6,7,478,4,272,3459961.333333333,74.0,68.0,3,206,5189835.5,74.0,68.66666666666667
246013.0,6,3,373,2,238,0.0,172.0,119.0,1,135,0.0,135.0,135.0
102992.0,17,2,286,2,286,0.0,143.0,143.0,0,0,0.0,0.0,0.0
108107642.0,17,5,1005,5,1005,27026910.5,201.0,201.0,0,0,0.0,0.0,0.0
108098710.0,17,5,1005,5,1005,27024677.5,201.0,201.0,0,0,0.0,0.0,0.0
10472764.0,6,7,478,4,272,3445348.6666666665,74.0,68.0,3,206,5167915.0,74.0,68.66666666666667
103866944.0,17,13,821,7,432,17284470.0,174.0,61.71428571428572,6,389,16825871.2,174.0,64.83333333333333
90258644.0,6,14,2240,8,1016,12894092.0,188.0,127.0,6,1224,18018509.6,204.0,204.0
300323.0,6,6,412,4,272,100107.66666666669,74.0,68.0,2,140,0.0,74.0,70.0
112201484.0,17,14,864,7,432,18666837.0,174.0,61.71428571428572,7,432,18667415.33333333,174.0,61.71428571428572
5827951.0,6,4,270,2,136,0.0,70.0,68.0,2,134,0.0,68.0,67.0
211379.0,17,2,180,1,90,0.0,90.0,90.0,1,90,0.0,90.0,90.0
209193.0,6,3,426,2,280,0.0,214.0,140.0,1,146,0.0,146.0,146.0
298406.0,6,6,412,4,272,99468.66666666669,74.0,68.0,2,140,0.0,74.0,70.0
123610467.0,6,49,3234,25,1650,5150436.125,66.0,66.0,24,1584,5008823.652173913,66.0,66.0
298971.0,6,6,412,4,272,99657.0,74.0,68.0,2,140,0.0,74.0,70.0
120063107.0,17,29,13785,29,13785,4287968.107142857,501.0,475.3448275862069,0,0,0.0,0.0,0.0
302273.0,6,6,412,4,272,100757.66666666669,74.0,68.0,2,140,0.0,74.0,70.0
2046039.0,6,18,6803,10,1501,227337.66666666663,408.0,150.1,8,5302,230331.2857142857,1514.0,662.75
304474.0,6,6,412,4,272,101491.33333333331,74.0,68.0,2,140,0.0,74.0,70.0
316218.0,17,4,1400,4,1400,105406.0,350.0,350.0,0,0,0.0,0.0,0.0
764831.0,6,14,4740,7,653,126851.66666666669,249.0,93.28571428571428,7,4087,127090.5,1514.0,583.8571428571429
9674.0,17,2,582,1,83,0.0,83.0,83.0,1,499,0.0,499.0,499.0
90753903.0,6,24,1829,13,989,7559430.833333333,95.0,76.07692307692308,11,840,9046425.3,95.0,76.36363636363636
264249.0,6,10,1221,6,636,52849.8,298.0,106.0,4,585,82563.33333333333,379.0,146.25
207164.0,6,3,426,2,280,0.0,214.0,140.0,1,146,0.0,146.0,146.0
13888.0,6,14,4740,7,653,2003.8333333333333,249.0,93.28571428571428,7,4087,2109.0,1514.0,583.8571428571429
286437.0,17,2,363,1,79,0.0,79.0,79.0,1,284,0.0,284.0,284.0
10872858.0,6,8,544,4,272,3579059.333333333,74.0,68.0,4,272,3578975.6666666665,74.0,68.0
251605.00000000003,17,4,6056,4,6056,83868.33333333333,1514.0,1514.0,0,0,0.0,0.0,0.0
2500.0,17,4,344,2,150,0.0,75.0,75.0,2,194,0.0,103.0,97.0
364.0,17,2,762,2,762,0.0,381.0,381.0,0,0,0.0,0.0,0.0
198477.0,17,4,6056,4,6056,66159.0,1514.0,1514.0,0,0,0.0,0.0,0.0
510634.00000000006,6,5,336,2,134,0.0,68.0,67.0,3,202,192631.5,70.0,67.33333333333333
2351.0,17,4,344,2,150,0.0,75.0,75.0,2,194,0.0,103.0,97.0
12680.0,6,10,1065,5,534,2832.5,262.0,106.8,5,531,2426.5,259.0,106.2
541948.0,17,6,2100,6,2100,108389.6,350.0,350.0,0,0,0.0,0.0,0.0
3172426.0,6,18,1495,9,921,358344.875,315.0,102.33333333333331,9,574,358312.5,78.0,63.77777777777778
3503.0,17,2,363,1,79,0.0,79.0,79.0,1,284,0.0,284.0,284.0
19792.0,6,10,2032,5,524,4762.75,252.0,104.8,5,1508,4204.25,1236.0,301.6
90035983.0,17,28,13364,28,13364,3334666.037037037,501.0,477.2857142857143,0,0,0.0,0.0,0.0
319554.0,17,4,704,2,148,0.0,74.0,74.0,2,556,0.0,280.0,278.0
40206.0,6,14,4740,7,653,5899.833333333333,249.0,93.28571428571428,7,4087,5250.666666666667,1514.0,583.8571428571429
43070.0,6,10,2032,5,524,10530.25,252.0,104.8,5,1508,10491.5,1236.0,301.6
108094203.0,17,5,955,5,955,27023550.75,191.0,191.0,0,0,0.0,0.0,0.0
143899.0,17,2,180,1,90,0.0,90.0,90.0,1,90,0.0,90.0,90.0
233005.0,6,3,337,2,214,0.0,160.0,107.0,1,123,0.0,123.0,123.0
210135.0,6,10,1221,6,636,42027.0,298.0,106.0,4,585,69159.0,379.0,146.25
224603.0,17,2,414,1,88,0.0,88.0,88.0,1,326,0.0,326.0,326.0
120085603.0,17,29,13785,29,13785,4288771.535714285,501.0,475.3448275862069,0,0,0.0,0.0,0.0
146167.0,6,3,337,2,214,0.0,160.0,107.0,1,123,0.0,123.0,123.0
124518.0,17,2,180,1,70,0.0,70.0,70.0,1,110,0.0,110.0,110.0
121293.0,6,3,337,2,214,0.0,160.0,107.0,1,123,0.0,123.0,123.0
108107947.0,17,5,955,5,955,27026986.75,191.0,191.0,0,0,0.0,0.0,0.0
206479.0,17,2,180,1,90,0.0,90.0,90.0,1,90,0.0,90.0,90.0
232905.0,6,3,337,2,214,0.0,160.0,107.0,1,123,0.0,123.0,123.0
1776266.0,6,23,6509,12,1529,161478.72727272726,357.0,127.41666666666669,11,4980,146122.4,1510.0,452.7272727272728
90020867.0,17,28,13364,28,13364,3334106.185185185,501.0,477.2857142857143,0,0,0.0,0.0,0.0
213717.0,6,10,1221,6,636,42743.4,298.0,106.0,4,585,69473.66666666667,379.0,146.25
310709.0,17,4,1400,4,1400,103569.66666666669,350.0,350.0,0,0,0.0,0.0,0.0
16001.999999999998,6,10,2032,5,524,3386.0,252.0,104.8,5,1508,3730.75,1236.0,301.6
115122460.0,6,1095,272864,532,36074,216749.7796610169,214.0,67.80827067669173,563,236790,204832.462633452,1514.0,420.5861456483126
840961.0,6,9,1118,6,586,168192.2,248.0,97.66666666666669,3,532,282700.5,392.0,177.33333333333334
113255047.0,6,46,3036,23,1518,5135437.227272728,66.0,66.0,23,1518,5135421.590909091,66.0,66.0
217299.0,6,3,426,2,280,0.0,214.0,140.0,1,146,0.0,146.0,146.0
120125179.0,6,14,2240,6,1224,24025035.8,204.0,204.0,8,1016,17137028.57142857,188.0,127.0
147056.0,6,3,373,2,238,0.0,172.0,119.0,1,135,0.0,135.0,135.0
512201.0,6,5,336,2,134,0.0,68.0,67.0,3,202,192437.5,70.0,67.33333333333333
228361.0,17,2,180,1,90,0.0,90.0,90.0,1,90,0.0,90.0,90.0
30756.0,6,14,4740,7,653,5005.166666666667,249.0,93.28571428571428,7,4087,4855.166666666667,1514.0,583.8571428571429
216487.0,17,2,180,1,90,0.0,90.0,90.0,1,90,0.0,90.0,90.0
1321826.0,6,4,264,2,132,0.0,66.0,66.0,2,132,0.0,66.0,66.0
304035.0,6,6,412,4,272,101345.0,74.0,68.0,2,140,0.0,74.0,70.0
119692095.0,6,12,1832,8,1016,17098870.714285713,188.0,127.0,4,816,20021214.33333333,204.0,204.0
53189.0,17,2,180,1,90,0.0,90.0,90.0,1,90,0.0,90.0,90.0
31063.0,6,14,4740,7,653,5045.833333333333,249.0,93.28571428571428,7,4087,4808.333333333333,1514.0,583.8571428571429
232266.0,6,3,337,2,214,0.0,160.0,107.0,1,123,0.0,123.0,123.0
232175.0,6,3,337,2,214,0.0,160.0,107.0,1,123,0.0,123.0,123.0
2895187.0,6,2,132,1,66,0.0,66.0,66.0,1,66,0.0,66.0,66.0
67923.0,6,14,4740,7,653,11134.0,249.0,93.28571428571428,7,4087,11092.666666666666,1514.0,583.8571428571429
61426.0,6,14,4740,7,653,9766.0,249.0,93.28571428571428,7,4087,8937.333333333334,1514.0,583.8571428571429
248191.0,6,3,337,2,214,0.0,160.0,107.0,1,123,0.0,123.0,123.0
36392.0,6,14,4740,7,653,5944.833333333333,249.0,93.28571428571428,7,4087,5925.0,1514.0,583.8571428571429
2829302.0,6,2,132,1,66,0.0,66.0,66.0,1,66,0.0,66.0,66.0
24926.0,6,10,2032,5,524,5898.75,252.0,104.8,5,1508,5670.5,1236.0,301.6
55471.0,6,14,4740,7,653,9032.5,249.0,93.28571428571428,7,4087,7779.166666666667,1514.0,583.8571428571429
10474370.0,6,7,478,4,272,3445880.333333333,74.0,68.0,3,206,5168696.5,74.0,68.66666666666667
26066.0,6,14,4740,7,653,4052.1666666666665,249.0,93.28571428571428,7,4087,3882.8333333333335,1514.0,583.8571428571429
42950.0,6,14,4740,7,653,6699.333333333333,249.0,93.28571428571428,7,4087,7014.333333333333,1514.0,583.8571428571429
120121810.0,6,13,2020,9,1204,15015226.25,188.0,133.77777777777777,4,816,30030195.666666668,204.0,204.0
700318.0,6,11,1021,6,444,93985.0,162.0,74.0,5,577,117405.75,349.0,115.4
209530.0,17,2,180,1,90,0.0,90.0,90.0,1,90,0.0,90.0,90.0
305851.0,17,4,704,2,148,0.0,74.0,74.0,2,556,0.0,280.0,278.0
103342.0,17,2,286,2,286,0.0,143.0,143.0,0,0,0.0,0.0,0.0
90731631.0,6,19,1436,10,745,10076962.888888888,95.0,74.5,9,691,11341107.0,95.0,76.77777777777777
120126809.0,17,28,13364,28,13364,4449141.074074074,501.0,477.2857142857143,0,0,0.0,0.0,0.0
65062.99999999999,6,14,4740,7,653,10732.833333333334,249.0,93.28571428571428,7,4087,10184.5,1514.0,583.8571428571429
34098.0,6,2,145,2,145,0.0,91.0,72.5,0,0,0.0,0.0,0.0
120278394.0,6,18,1382,9,691,14999987.125,95.0,76.77777777777777,9,691,15034421.0,95.0,76.77777777777777
10512.0,17,2,684,2,684,0.0,342.0,342.0,0,0,0.0,0.0,0.0
108396.0,17,2,286,2,286,0.0,143.0,143.0,0,0,0.0,0.0,0.0
0.0,6,1,66,1,66,0.0,66.0,66.0,0,0,0.0,0.0,0.0
17244.0,6,14,4740,7,653,2143.333333333333,249.0,93.28571428571428,7,4087,2736.333333333333,1514.0,583.8571428571429
335.0,17,2,267,1,83,0.0,83.0,83.0,1,184,0.0,184.0,184.0
123542.0,6,11,1132,6,556,23822.6,218.0,92.66666666666669,5,576,30682.25,304.0,115.2
56229.0,6,14,4740,7,653,9025.0,249.0,93.28571428571428,7,4087,9118.166666666666,1514.0,583.8571428571429
271814.0,6,10,1221,6,636,54362.8,298.0,106.0,4,585,85161.0,379.0,146.25
324.0,17,2,174,1,79,0.0,79.0,79.0,1,95,0.0,95.0,95.0
879594.0,6,9,1196,6,725,175918.8,387.0,120.83333333333331,3,471,303491.5,331.0,157.0
107308549.0,6,28,1876,14,982,8237889.0,139.0,70.14285714285714,14,894,8237888.153846154,123.0,63.85714285714285
48249.0,6,14,4740,7,653,7816.0,249.0,93.28571428571428,7,4087,7899.833333333333,1514.0,583.8571428571429
126317315.0,6,39,2770,20,1468,6648279.736842105,139.0,73.4,19,1302,6450811.777777778,123.0,68.52631578947368
121211.0,6,3,337,2,214,0.0,160.0,107.0,1,123,0.0,123.0,123.0
108110526.0,17,5,955,5,955,27027631.5,191.0,191.0,0,0,0.0,0.0,0.0
27623349.0,17,5,1710,5,1710,6905837.25,342.0,342.0,0,0,0.0,0.0,0.0
16974.0,6,14,4740,7,653,2676.0,249.0,93.28571428571428,7,4087,2660.333333333333,1514.0,583.8571428571429
33365.0,6,14,4740,7,653,4705.5,249.0,93.28571428571428,7,4087,5374.666666666667,1514.0,583.8571428571429
18578.0,6,10,2032,5,524,4384.75,252.0,104.8,5,1508,4253.75,1236.0,301.6
255600.0,6,3,337,2,214,0.0,160.0,107.0,1,123,0.0,123.0,123.0
34524.0,6,10,2032,5,524,8329.25,252.0,104.8,5,1508,8149.25,1236.0,301.6
90045218.0,17,28,13364,28,13364,3335008.074074074,501.0,477.2857142857143,0,0,0.0,0.0,0.0
298458.0,6,6,412,4,272,99486.0,74.0,68.0,2,140,0.0,74.0,70.0
2892973.0,6,3,204,2,136,0.0,70.0,68.0,1,68,0.0,68.0,68.0
206328.0,17,2,180,1,90,0.0,90.0,90.0,1,90,0.0,90.0,90.0
304755.0,6,6,412,4,272,101585.0,74.0,68.0,2,140,0.0,74.0,70.0
2522.0,17,4,344,2,150,0.0,75.0,75.0,2,194,0.0,103.0,97.0
120049516.0,17,28,13364,28,13364,4446278.37037037,501.0,477.2857142857143,0,0,0.0,0.0,0.0
120576162.0,6,237,26918,119,18822,1021831.8813559322,390.0,158.16806722689077,118,8096,1021705.1623931624,140.0,68.61016949152543
26185973.0,17,5,1718,4,1368,1747327.6666666667,342.0,342.0,1,350,0.0,350.0,350.0
102695.0,17,2,286,2,286,0.0,143.0,143.0,0,0,0.0,0.0,0.0
2502.0,17,4,344,2,150,0.0,75.0,75.0,2,194,0.0,103.0,97.0
120518979.0,6,217,24694,109,17184,1115916.4722222222,374.0,157.651376146789,108,7510,1116424.168224299,140.0,69.53703703703704
1543756.0,17,5,961,3,234,771695.5,78.0,78.0,2,727,0.0,395.0,363.5
312675.0,17,4,1400,4,1400,104225.0,350.0,350.0,0,0,0.0,0.0,0.0
31537.000000000004,6,10,2032,5,524,7378.5,252.0,104.8,5,1508,7609.75,1236.0,301.6
206394.0,6,3,426,2,280,0.0,214.0,140.0,1,146,0.0,146.0,146.0
32850.0,6,14,4740,7,653,5002.5,249.0,93.28571428571428,7,4087,4755.0,1514.0,583.8571428571429
120125064.0,6,13,2020,9,1204,15015633.0,188.0,133.77777777777777,4,816,30030719.33333333,204.0,204.0
208734.0,6,3,426,2,280,0.0,214.0,140.0,1,146,0.0,146.0,146.0
29057.0,6,14,4740,7,653,3956.3333333333335,249.0,93.28571428571428,7,4087,4612.0,1514.0,583.8571428571429
120125168.0,17,13,821,7,432,20020861.33333333,174.0,61.71428571428572,6,389,20099823.8,174.0,64.83333333333333
2216350.0,6,25,7610,13,2516,182994.0833333333,1034.0,193.53846153846155,12,5094,173261.36363636365,1510.0,424.5
207993.0,6,3,426,2,280,0.0,214.0,140.0,1,146,0.0,146.0,146.0
90054807.0,17,28,13364,28,13364,3335363.222222222,501.0,477.2857142857143,0,0,0.0,0.0,0.0
58474.0,6,10,2032,5,524,14266.25,252.0,104.8,5,1508,14130.75,1236.0,301.6
90040022.0,17,28,13364,28,13364,3334815.6296296297,501.0,477.2857142857143,0,0,0.0,0.0,0.0
53229.0,6,10,2032,5,524,11935.5,252.0,104.8,5,1508,9967.25,1236.0,301.6
1171798.0,6,13,3010,8,2382,167399.7142857143,1514.0,297.75,5,628,224015.5,331.0,125.6
144954.0,17,2,180,1,70,0.0,70.0,70.0,1,110,0.0,110.0,110.0
108105494.0,17,5,955,5,955,27026373.5,191.0,191.0,0,0,0.0,0.0,0.0
33586.0,6,10,2032,5,524,8063.0,252.0,104.8,5,1508,7923.25,1236.0,301.6
1306918.0,6,4,264,2,132,0.0,66.0,66.0,2,132,0.0,66.0,66.0
56680.0,6,10,2032,5,524,13776.25,252.0,104.8,5,1508,12715.75,1236.0,301.6
144653.0,6,2,132,1,66,0.0,66.0,66.0,1,66,0.0,66.0,66.0
320213.0,6,6,412,4,272,106737.66666666669,74.0,68.0,2,140,0.0,74.0,70.0
70106.0,6,14,4740,7,653,11035.166666666666,249.0,93.28571428571428,7,4087,7522.666666666667,1514.0,583.8571428571429
3436.0,17,2,359,1,75,0.0,75.0,75.0,1,284,0.0,284.0,284.0
115536695.0,6,34,2350,17,1225,7207551.1875,139.0,72.05882352941177,17,1125,7207552.625,123.0,66.17647058823529
299.0,17,2,164,1,82,0.0,82.0,82.0,1,82,0.0,82.0,82.0
370127.0,6,11,1021,6,444,51116.4,162.0,74.0,5,577,62474.25,349.0,115.4
90282914.0,6,16,1192,8,596,12890243.285714284,95.0,74.5,8,596,12896961.857142856,95.0,74.5
43931.0,6,14,4740,7,653,7196.833333333333,249.0,93.28571428571428,7,4087,5989.5,1514.0,583.8571428571429
103325.0,17,2,286,2,286,0.0,143.0,143.0,0,0,0.0,0.0,0.0
10426443.0,6,6,412,3,206,5145223.5,74.0,68.66666666666667,3,206,5145111.0,74.0,68.66666666666667
5629576.0,6,5,336,2,134,0.0,68.0,67.0,3,202,1524676.0,70.0,67.33333333333333
56988.0,6,10,2032,5,524,14023.0,252.0,104.8,5,1508,13829.75,1236.0,301.6
108132697.0,17,5,1005,5,1005,27033174.25,201.0,201.0,0,0,0.0,0.0,0.0
104050097.0,6,32,2374,17,1288,6489650.3125,139.0,75.76470588235294,15,1086,7416747.071428572,123.0,72.4
93759530.0,6,28,2008,14,1045,7195655.384615385,139.0,74.64285714285714,14,963,7195668.230769231,123.0,68.78571428571429
110285550.0,6,32,2236,16,1165,7337976.866666666,139.0,72.8125,16,1071,7337979.333333333,123.0,66.9375
240740.0,6,10,1221,6,636,48148.0,298.0,106.0,4,585,79246.33333333333,379.0,146.25
148488.0,17,2,414,1,88,0.0,88.0,88.0,1,326,0.0,326.0,326.0
53184.0,6,10,2032,5,524,13049.5,252.0,104.8,5,1508,12522.25,1236.0,301.6
26705.0,6,14,4740,7,653,4181.333333333333,249.0,93.28571428571428,7,4087,3887.6666666666665,1514.0,583.8571428571429
274563.0,6,10,1221,6,636,54912.6,298.0,106.0,4,585,85222.66666666667,379.0,146.25
301396.0,6,6,412,4,272,100465.33333333331,74.0,68.0,2,140,0.0,74.0,70.0
117434932.0,6,386,46550,193,33516,610519.4427083334,464.0,173.6580310880829,193,13034,610519.3333333334,140.0,67.53367875647669
9310.0,17,4,823,2,163,0.0,89.0,81.5,2,660,0.0,443.0,330.0
347.0,17,2,267,1,83,0.0,83.0,83.0,1,184,0.0,184.0,184.0
108108638.0,17,5,955,5,955,27027159.5,191.0,191.0,0,0,0.0,0.0,0.0
1028153.0,6,11,1134,6,558,205630.6,220.0,93.0,5,576,255150.5,304.0,115.2
36108.0,6,12,1328,6,731,6747.0,253.0,121.83333333333331,6,597,6715.6,259.0,99.5
90532353.0,6,15,2168,8,1016,12933193.285714284,188.0,127.0,7,1152,15055343.5,204.0,164.57142857142858
21074914.0,17,3,1034,2,684,0.0,342.0,342.0,1,350,0.0,350.0,350.0
142571.0,6,2,132,1,66,0.0,66.0,66.0,1,66,0.0,66.0,66.0
90776649.0,6,18,1341,9,691,11347081.125,95.0,76.77777777777777,9,650,11315608.75,95.0,72.22222222222223
228253.0,17,2,180,1,90,0.0,90.0,90.0,1,90,0.0,90.0,90.0
206812.0,6,3,426,2,280,0.0,214.0,140.0,1,146,0.0,146.0,146.0
504841.0,6,5,336,2,134,0.0,68.0,67.0,3,202,193190.0,70.0,67.33333333333333
4714.0,17,2,180,1,90,0.0,90.0,90.0,1,90,0.0,90.0,90.0
93449697.0,6,187,21138,94,6426,1004835.4516129032,140.0,68.36170212765957,93,14712,1004529.554347826,284.0,158.19354838709677
4356.0,17,2,614,1,72,0.0,72.0,72.0,1,542,0.0,542.0,542.0
108106218.0,17,5,1005,5,1005,27026554.5,201.0,201.0,0,0,0.0,0.0,0.0
47139.0,6,10,2032,5,524,11551.5,252.0,104.8,5,1508,11426.5,1236.0,301.6
219770.0,6,10,1221,6,636,43954.0,298.0,106.0,4,585,68023.33333333333,379.0,146.25
1027862.0,6,11,1134,6,558,205572.4,220.0,93.0,5,576,255832.5,304.0,115.2
4350.0,17,2,602,1,72,0.0,72.0,72.0,1,530,0.0,530.0,530.0
299004.0,6,6,412,4,272,99668.0,74.0,68.0,2,140,0.0,74.0,70.0
65994.0,6,14,4740,7,653,10428.166666666666,249.0,93.28571428571428,7,4087,10853.166666666666,1514.0,583.8571428571429
125828674.0,6,33,2296,17,1225,7864292.125,139.0,72.05882352941177,16,1071,7708495.2,123.0,66.9375
310021.0,17,4,1400,4,1400,103340.33333333331,350.0,350.0,0,0,0.0,0.0,0.0
135139151.0,17,6,1146,6,1146,27027830.2,191.0,191.0,0,0,0.0,0.0,0.0
104445810.0,6,31,2176,16,1071,6963023.333333333,123.0,66.9375,15,1105,6747100.857142857,139.0,73.66666666666667
39438.0,6,13,1386,7,789,6007.666666666667,253.0,112.71428571428572,6,597,7222.2,259.0,99.5
90472532.0,6,20,1490,11,840,9042571.3,95.0,76.36363636363636,9,650,11302707.5,95.0,72.22222222222223
2037.0,17,4,344,2,150,0.0,75.0,75.0,2,194,0.0,103.0,97.0
8569217.0,17,3,1034,2,684,0.0,342.0,342.0,1,350,0.0,350.0,350.0
39850708.0,6,5,336,2,134,0.0,68.0,67.0,3,202,19852694.5,70.0,67.33333333333333
107589381.0,6,45,3768,25,2067,4482890.875,123.0,82.68,20,1701,5651222.210526316,123.0,85.05
32880.0,6,14,4740,7,653,5325.5,249.0,93.28571428571428,7,4087,5339.333333333333,1514.0,583.8571428571429
892.0,17,4,438,2,148,0.0,74.0,74.0,2,290,0.0,147.0,145.0
102977.0,17,2,286,2,286,0.0,143.0,143.0,0,0,0.0,0.0,0.0
13029.0,6,11,1132,6,556,2605.8,218.0,92.66666666666669,5,576,2794.5,304.0,115.2
311339.0,17,4,1400,4,1400,103779.66666666669,350.0,350.0,0,0,0.0,0.0,0.0
2798589.0,6,2,132,1,66,0.0,66.0,66.0,1,66,0.0,66.0,66.0
153308.0,17,2,180,1,90,0.0,90.0,90.0,1,90,0.0,90.0,90.0
207489.0,6,3,426,2,280,0.0,214.0,140.0,1,146,0.0,146.0,146.0
16950.0,17,2,180,1,90,0.0,90.0,90.0,1,90,0.0,90.0,90.0
2800386.0,6,2,132,1,66,0.0,66.0,66.0,1,66,0.0,66.0,66.0
308668.0,6,6,412,4,272,102889.33333333331,74.0,68.0,2,140,0.0,74.0,70.0
90255573.0,6,13,2036,8,1016,12893653.285714284,188.0,127.0,5,1020,22522893.0,204.0,204.0
45884.0,6,2,132,1,66,0.0,66.0,66.0,1,66,0.0,66.0,66.0
311.0,17,2,164,1,82,0.0,82.0,82.0,1,82,0.0,82.0,82.0
135130484.0,17,6,1206,6,1206,27026096.8,201.0,201.0,0,0,0.0,0.0,0.0
103011.0,17,2,286,2,286,0.0,143.0,143.0,0,0,0.0,0.0,0.0
108102275.0,17,5,955,5,955,27025568.75,191.0,191.0,0,0,0.0,0.0,0.0
228469.0,17,2,180,1,90,0.0,90.0,90.0,1,90,0.0,90.0,90.0
90096435.0,6,11,1644,4,816,30031358.33333333,204.0,204.0,7,828,15015899.0,188.0,118.28571428571428
308611.0,6,6,412,4,272,102870.33333333331,74.0,68.0,2,140,0.0,74.0,70.0
217885.0,6,3,426,2,280,0.0,214.0,140.0,1,146,0.0,146.0,146.0
311353.0,17,4,1400,4,1400,103784.33333333331,350.0,350.0,0,0,0.0,0.0,0.0
3863044.0,6,69,60759,26,1878,154521.76,208.0,72.23076923076923,43,58881,91829.92857142857,1514.0,1369.3255813953488
233295.0,6,3,373,2,238,0.0,172.0,119.0,1,135,0.0,135.0,135.0
90016927.0,17,28,13364,28,13364,3333960.25925926,501.0,477.2857142857143,0,0,0.0,0.0,0.0
215862.0,17,2,180,1,90,0.0,90.0,90.0,1,90,0.0,90.0,90.0
206292.0,6,3,426,2,280,0.0,214.0,140.0,1,146,0.0,146.0,146.0
14745.0,6,14,4740,7,653,2313.333333333333,249.0,93.28571428571428,7,4087,2321.333333333333,1514.0,583.8571428571429
2011.0,17,4,344,2,150,0.0,75.0,75.0,2,194,0.0,103.0,97.0
2795512.0,6,2,132,1,66,0.0,66.0,66.0,1,66,0.0,66.0,66.0
1155649.0,6,13,3009,8,2381,165092.7142857143,1514.0,297.625,5,628,220759.25,331.0,125.6
100044523.0,6,29,2052,15,1089,7130613.357142857,123.0,72.6,14,963,7679130.615384615,123.0,68.78571428571429
120007646.0,6,29,3146,14,1545,9230740.23076923,425.0,110.35714285714286,15,1601,8571176.714285715,336.0,106.73333333333332
733546.0,6,11,1021,6,444,98250.2,162.0,74.0,5,577,122726.25,349.0,115.4
104117.0,17,2,286,2,286,0.0,143.0,143.0,0,0,0.0,0.0,0.0
304328.0,17,4,704,2,148,0.0,74.0,74.0,2,556,0.0,280.0,278.0
13738331.0,6,26,7627,14,3735,200362.38461538465,1514.0,266.7857142857143,12,3892,1230251.0,1514.0,324.3333333333333
28334.0,6,14,4740,7,653,4144.0,249.0,93.28571428571428,7,4087,4581.166666666667,1514.0,583.8571428571429
109934034.0,6,31,2166,16,1149,7314545.133333334,123.0,71.8125,15,1017,7837015.642857143,123.0,67.8
51098.0,17,2,180,1,90,0.0,90.0,90.0,1,90,0.0,90.0,90.0
16646.0,6,11,1132,6,556,3103.6,218.0,92.66666666666669,5,576,3117.25,304.0,115.2
28447.0,6,14,4740,7,653,4441.0,249.0,93.28571428571428,7,4087,4271.666666666667,1514.0,583.8571428571429
88221.0,6,10,1065,5,534,20120.75,262.0,106.8,5,531,21521.5,259.0,106.2
114326107.0,6,47,3102,24,1584,4957049.652173913,66.0,66.0,23,1518,5155437.454545454,66.0,66.0
848770.0,6,9,1096,6,625,169754.0,287.0,104.16666666666669,3,471,286390.5,331.0,157.0
90267937.0,6,12,1832,8,1016,12895419.57142857,188.0,127.0,4,816,30033869.33333333,204.0,204.0
28948.0,6,14,4740,7,653,4275.166666666667,249.0,93.28571428571428,7,4087,4687.5,1514.0,583.8571428571429
90294850.0,6,16,1192,8,596,12892770.857142856,95.0,74.5,8,596,12897418.57142857,95.0,74.5
2316.0,17,2,684,1,342,0.0,342.0,342.0,1,342,0.0,342.0,342.0
122688033.0,6,49,3234,25,1650,5112001.375,66.0,66.0,24,1584,4947751.956521739,66.0,66.0
297179.0,6,6,412,4,272,99059.66666666669,74.0,68.0,2,140,0.0,74.0,70.0
43112.0,6,14,4740,7,653,7078.166666666667,249.0,93.28571428571428,7,4087,7024.0,1514.0,583.8571428571429
108111970.0,17,5,1005,5,1005,27027992.5,201.0,201.0,0,0,0.0,0.0,0.0
90032053.0,6,18,1382,9,691,7531625.875,95.0,76.77777777777777,9,691,11213694.75,95.0,76.77777777777777
14063541.0,17,6,2052,6,2052,2812708.2,342.0,342.0,0,0,0.0,0.0,0.0
107306.0,17,2,286,2,286,0.0,143.0,143.0,0,0,0.0,0.0,0.0
457490.0,6,12,1373,7,714,76248.33333333333,298.0,102.0,5,659,110257.25,379.0,131.8
921754.0,6,12,1354,6,723,183307.6,253.0,120.5,6,631,184037.6,293.0,105.16666666666669
98335204.0,17,12,778,6,389,19600970.4,174.0,64.83333333333333,6,389,19600190.4,174.0,64.83333333333333
24500.0,17,2,582,1,83,0.0,83.0,83.0,1,499,0.0,499.0,499.0
113254943.0,6,46,3036,23,1518,5135438.727272728,66.0,66.0,23,1518,5135426.954545454,66.0,66.0
42724.0,6,14,4740,7,653,6870.0,249.0,93.28571428571428,7,4087,6881.333333333333,1514.0,583.8571428571429
90037205.0,17,27,12943,27,12943,3462969.423076923,501.0,479.3703703703704,0,0,0.0,0.0,0.0
281315.0,17,2,414,1,88,0.0,88.0,88.0,1,326,0.0,326.0,326.0
92710099.0,6,38,2508,19,1254,5135439.111111111,66.0,66.0,19,1254,5135445.5,66.0,66.0
5005765.0,17,4,534,2,166,0.0,83.0,83.0,2,368,0.0,184.0,184.0
146092.0,6,3,337,2,214,0.0,160.0,107.0,1,123,0.0,123.0,123.0
2009153.0,17,4,525,2,150,0.0,75.0,75.0,2,375,0.0,284.0,187.5
113168402.0,6,46,3036,23,1518,5144006.590909091,66.0,66.0,23,1518,5144005.454545454,66.0,66.0
90063765.0,17,27,12943,27,12943,3463990.961538461,501.0,479.3703703703704,0,0,0.0,0.0,0.0
11845.0,6,11,2098,6,590,1884.0,252.0,98.33333333333331,5,1508,2702.5,1236.0,301.6
44686.0,6,10,1066,5,490,10985.5,218.0,98.0,5,576,10478.5,304.0,115.2
451414.0,6,10,1221,6,636,90282.8,298.0,106.0,4,585,141448.33333333334,379.0,146.25
318.0,17,2,164,1,82,0.0,82.0,82.0,1,82,0.0,82.0,82.0
107588.0,17,2,286,2,286,0.0,143.0,143.0,0,0,0.0,0.0,0.0
135134163.0,17,6,1146,6,1146,27026832.6,191.0,191.0,0,0,0.0,0.0,0.0
55523.0,6,10,2032,5,524,13344.0,252.0,104.8,5,1508,13553.5,1236.0,301.6
499509.0,6,5,336,2,134,0.0,68.0,67.0,3,202,195853.5,70.0,67.33333333333333
13626524.0,6,20,1648,10,1016,1478448.111111111,315.0,101.6,10,632,1477758.0,78.0,63.2
123610479.0,6,49,3234,25,1650,5150436.625,66.0,66.0,24,1584,4978260.0869565215,66.0,66.0
90219228.0,6,16,1192,8,596,12854252.0,95.0,74.5,8,596,12859007.0,95.0,74.5
59129.0,6,14,4740,7,653,9069.166666666666,249.0,93.28571428571428,7,4087,9663.5,1514.0,583.8571428571429
196937.0,17,2,180,1,90,0.0,90.0,90.0,1,90,0.0,90.0,90.0
351.0,17,2,267,1,83,0.0,83.0,83.0,1,184,0.0,184.0,184.0
14457636.0,6,11,738,5,342,3612894.75,95.0,68.4,6,396,2891028.2,95.0,66.0
90257983.0,6,12,1832,8,1016,12893997.57142857,188.0,127.0,4,816,30029164.0,204.0,204.0
2418597.0,6,3,1604,1,753,0.0,753.0,753.0,2,851,0.0,785.0,425.5
90281286.0,6,16,1192,8,596,12891364.714285716,95.0,74.5,8,596,12895500.714285716,95.0,74.5
257326.0,6,3,337,2,214,0.0,160.0,107.0,1,123,0.0,123.0,123.0
58181.0,6,10,2032,5,524,14069.0,252.0,104.8,5,1508,13705.5,1236.0,301.6
1111329.0,6,10,1221,6,636,222265.8,298.0,106.0,4,585,364798.6666666667,379.0,146.25
2427205.0,6,41,15787,21,11032,121360.25,1514.0,525.3333333333334,20,4755,116250.47368421052,1514.0,237.75
90041079.0,17,28,13364,28,13364,3334854.777777778,501.0,477.2857142857143,0,0,0.0,0.0,0.0
120051677.0,17,29,13785,29,13785,4287559.892857143,501.0,475.3448275862069,0,0,0.0,0.0,0.0
283926.0,17,2,363,1,79,0.0,79.0,79.0,1,284,0.0,284.0,284.0
90766905.0,6,24,1829,13,989,7560491.583333333,95.0,76.07692307692308,11,840,8999335.1,95.0,76.36363636363636
34942.0,6,14,4740,7,653,5646.833333333333,249.0,93.28571428571428,7,4087,4731.333333333333,1514.0,583.8571428571429
2290.0,17,4,344,2,150,0.0,75.0,75.0,2,194,0.0,103.0,97.0
72100949.0,6,9,842,9,842,9012618.625,97.0,93.55555555555556,0,0,0.0,0.0,0.0
65315.0,6,14,4740,7,653,10239.333333333334,249.0,93.28571428571428,7,4087,9842.833333333334,1514.0,583.8571428571429
206627.0,17,2,180,1,90,0.0,90.0,90.0,1,90,0.0,90.0,90.0
90267862.0,6,13,2036,8,1016,12895408.857142856,188.0,127.0,5,1020,22525485.25,204.0,204.0
10492594.0,6,6,412,3,206,5178450.0,74.0,68.66666666666667,3,206,5178356.0,74.0,68.66666666666667
19277.0,6,13,4519,6,512,3669.6,230.0,85.33333333333333,7,4007,3010.1666666666665,1514.0,572.4285714285714
90293635.0,6,16,1192,8,596,12892649.714285716,95.0,74.5,8,596,12897884.0,95.0,74.5
139001434.0,17,17,1255,9,649,17375179.25,174.0,72.11111111111111,8,606,17000845.0,174.0,75.75
39959.0,6,11,2098,6,590,7858.6,252.0,98.33333333333331,5,1508,7898.0,1236.0,301.6
3095504.0,6,154,124829,89,116237,35176.181818181816,1510.0,1306.0337078651685,65,8592,43458.84375,1510.0,132.1846153846154
5859124.0,6,22,6440,11,1463,585912.4,357.0,133.0,11,4977,555283.8,1510.0,452.45454545454544
202107.0,17,4,6056,4,6056,67369.0,1514.0,1514.0,0,0,0.0,0.0,0.0
211033.0,6,10,1221,6,636,42206.6,298.0,106.0,4,585,68846.0,379.0,146.25
238851.0,6,3,426,2,280,0.0,214.0,140.0,1,146,0.0,146.0,146.0
206132.0,6,3,426,2,280,0.0,214.0,140.0,1,146,0.0,146.0,146.0
27484.0,6,14,4740,7,653,4469.5,249.0,93.28571428571428,7,4087,4443.0,1514.0,583.8571428571429
120447321.0,6,23,1775,10,745,10151551.111111112,95.0,74.5,13,1030,10017499.083333334,95.0,79.23076923076923
309959.0,17,4,622,4,622,103319.66666666669,163.0,155.5,0,0,0.0,0.0,0.0
35877.0,6,14,4740,7,653,4347.166666666667,249.0,93.28571428571428,7,4087,5838.666666666667,1514.0,583.8571428571429
34730.0,6,14,4740,7,653,5574.333333333333,249.0,93.28571428571428,7,4087,5648.833333333333,1514.0,583.8571428571429
209529.0,17,2,180,1,90,0.0,90.0,90.0,1,90,0.0,90.0,90.0
160142.0,17,2,180,1,90,0.0,90.0,90.0,1,90,0.0,90.0,90.0
2803852.0,6,2,132,1,66,0.0,66.0,66.0,1,66,0.0,66.0,66.0
3266491.0,6,3,1604,2,851,0.0,785.0,425.5,1,753,0.0,753.0,753.0
328912.0,6,10,1221,6,636,65782.4,298.0,106.0,4,585,103871.66666666669,379.0,146.25
299210.0,6,6,412,4,272,99736.66666666669,74.0,68.0,2,140,0.0,74.0,70.0
835305.0,17,2,473,1,78,0.0,78.0,78.0,1,395,0.0,395.0,395.0
3004425.0,6,11,2106,6,598,600701.4,252.0,99.66666666666669,5,1508,1677.0,1236.0,301.6
124648337.0,17,14,864,7,432,17500150.333333332,174.0,61.71428571428572,7,432,17501264.333333332,174.0,61.71428571428572
135130695.0,17,6,1146,6,1146,27026139.0,191.0,191.0,0,0,0.0,0.0,0.0
734.0,17,4,438,2,148,0.0,74.0,74.0,2,290,0.0,147.0,145.0
100607826.0,6,27,1800,14,894,7739063.538461538,123.0,63.85714285714285,13,906,7534756.75,123.0,69.6923076923077
91000856.0,17,11,735,6,389,18200171.2,174.0,64.83333333333333,5,346,17751187.75,174.0,69.2
64296.00000000001,6,10,2032,5,524,14821.0,252.0,104.8,5,1508,15053.25,1236.0,301.6
181291.0,17,2,180,1,90,0.0,90.0,90.0,1,90,0.0,90.0,90.0
99263539.0,17,12,778,6,389,19800189.6,174.0,64.83333333333333,6,389,19800924.2,174.0,64.83333333333333
64710.0,6,14,4740,7,653,10477.666666666666,249.0,93.28571428571428,7,4087,10165.5,1514.0,583.8571428571429
63764.0,6,14,4740,7,653,10170.0,249.0,93.28571428571428,7,4087,10383.0,1514.0,583.8571428571429
120000029.0,6,17,1287,9,691,15000003.625,95.0,76.77777777777777,8,596,12896765.714285716,95.0,74.5
57697.0,6,14,4740,7,653,9489.5,249.0,93.28571428571428,7,4087,8510.0,1514.0,583.8571428571429
153521.0,17,2,180,1,90,0.0,90.0,90.0,1,90,0.0,90.0,90.0
0.0,17,1,90,1,90,0.0,90.0,90.0,0,0,0.0,0.0,0.0
2317.0,17,4,344,2,150,0.0,75.0,75.0,2,194,0.0,103.0,97.0
105939.0,17,3,1143,3,1143,52969.5,381.0,381.0,0,0,0.0,0.0,0.0
32160.0,6,14,4740,7,653,5195.0,249.0,93.28571428571428,7,4087,4973.666666666667,1514.0,583.8571428571429
172004.0,17,2,180,1,90,0.0,90.0,90.0,1,90,0.0,90.0,90.0
145571.0,17,2,180,1,90,0.0,90.0,90.0,1,90,0.0,90.0,90.0
120985029.0,6,35,2473,18,1348,7116766.411764706,139.0,74.88888888888889,17,1125,7447350.25,123.0,66.17647058823529
912.0,17,4,438,2,148,0.0,74.0,74.0,2,290,0.0,147.0,145.0
90310294.0,6,16,1192,8,596,12894591.142857144,95.0,74.5,8,596,12900002.57142857,95.0,74.5
211713.0,17,2,762,2,762,0.0,381.0,381.0,0,0,0.0,0.0,0.0
207252.0,6,3,426,2,280,0.0,214.0,140.0,1,146,0.0,146.0,146.0
3237821.0,6,8,1156,3,494,1588030.0,214.0,164.66666666666666,5,662,755344.75,146.0,132.4
14637820.0,6,20,1607,10,975,1592261.111111111,315.0,97.5,10,632,1592231.4444444445,78.0,63.2
92446.0,6,2,134,1,68,0.0,68.0,68.0,1,66,0.0,66.0,66.0
135129764.0,17,6,1206,6,1206,27025952.8,201.0,201.0,0,0,0.0,0.0,0.0
110765.0,17,2,286,2,286,0.0,143.0,143.0,0,0,0.0,0.0,0.0
25701.0,6,14,4740,7,653,3647.0,249.0,93.28571428571428,7,4087,4054.3333333333335,1514.0,583.8571428571429
145019.0,17,4,820,2,156,0.0,78.0,78.0,2,664,0.0,332.0,332.0
90660690.0,6,15,2302,9,1204,11316160.625,188.0,133.77777777777777,6,1098,18100035.6,204.0,183.0
143894.0,17,2,180,1,90,0.0,90.0,90.0,1,90,0.0,90.0,90.0
2351.0,17,4,344,2,150,0.0,75.0,75.0,2,194,0.0,103.0,97.0
144782.0,17,2,180,1,70,0.0,70.0,70.0,1,110,0.0,110.0,110.0
120189878.0,6,236,26644,118,8084,1020303.9743589744,140.0,68.50847457627118,118,18560,1011327.5897435896,284.0,157.28813559322035
1602.0,17,4,820,2,156,0.0,78.0,78.0,2,664,0.0,332.0,332.0
600724.0,17,3,551,2,156,0.0,78.0,78.0,1,395,0.0,395.0,395.0
309916.0,6,3,202,2,128,0.0,74.0,64.0,1,74,0.0,74.0,74.0
215349.0,17,2,180,1,90,0.0,90.0,90.0,1,90,0.0,90.0,90.0
459091.0,6,3,1604,1,753,0.0,753.0,753.0,2,851,0.0,785.0,425.5
5623473.0,6,5,336,2,134,0.0,68.0,67.0,3,202,1423213.5,70.0,67.33333333333333
5070.0,17,4,344,2,150,0.0,75.0,75.0,2,194,0.0,103.0,97.0
102981047.0,6,44,2904,22,1452,4901614.047619048,66.0,66.0,22,1452,4901060.142857143,66.0,66.0
510980.0,6,5,336,2,134,0.0,68.0,67.0,3,202,193275.5,70.0,67.33333333333333
2260.0,17,4,344,2,150,0.0,75.0,75.0,2,194,0.0,103.0,97.0
318925.0,17,4,1400,4,1400,106308.33333333331,350.0,350.0,0,0,0.0,0.0,0.0
117923538.0,6,34,2350,17,1225,7356716.3125,139.0,72.05882352941177,17,1125,7356718.6875,123.0,66.17647058823529
18679.0,6,14,4740,7,653,2814.0,249.0,93.28571428571428,7,4087,2884.833333333333,1514.0,583.8571428571429
925702.0,17,6,1230,3,234,462663.0,78.0,78.0,3,996,462646.0,332.0,332.0
135181908.0,17,6,1146,6,1146,27036381.6,191.0,191.0,0,0,0.0,0.0,0.0
106850.0,17,2,286,2,286,0.0,143.0,143.0,0,0,0.0,0.0,0.0
162315.0,17,2,180,1,90,0.0,90.0,90.0,1,90,0.0,90.0,90.0
90302576.0,6,16,1192,8,596,12893903.285714284,95.0,74.5,8,596,12899906.285714284,95.0,74.5
120008567.0,6,17,1287,9,691,15001070.875,95.0,76.77777777777777,8,596,12858733.57142857,95.0,74.5
307841.0,6,10,1221,6,636,61568.2,298.0,106.0,4,585,97249.33333333331,379.0,146.25
18727.0,6,10,1067,5,536,4129.0,264.0,107.2,5,531,4135.0,259.0,106.2
743.0,17,2,762,2,762,0.0,381.0,381.0,0,0,0.0,0.0,0.0
247235.0,17,2,180,1,90,0.0,90.0,90.0,1,90,0.0,90.0,90.0
113520160.0,6,46,3036,23,1518,5159995.863636363,66.0,66.0,23,1518,5159995.545454546,66.0,66.0
2382.0,17,4,344,2,150,0.0,75.0,75.0,2,194,0.0,103.0,97.0
25375.0,6,10,2032,5,524,5165.0,252.0,104.8,5,1508,6177.0,1236.0,301.6
3052192.0,6,3,204,1,68,0.0,68.0,68.0,2,136,0.0,70.0,68.0
2370663.0,6,25,7573,14,3735,182358.6923076923,1514.0,266.7857142857143,11,3838,210569.7,1514.0,348.90909090909093
90570414.0,6,14,2240,8,1016,12938630.57142857,188.0,127.0,6,1224,18075494.0,204.0,204.0
120418198.0,6,209,23798,105,16638,1157867.2884615385,374.0,158.45714285714286,104,7160,1158976.1067961166,140.0,68.84615384615384
2967235.0,6,12,2172,7,664,494449.5,252.0,94.85714285714286,5,1508,2689.5,1236.0,301.6
90310389.0,6,16,1192,8,596,12894190.0,95.0,74.5,8,596,12900390.57142857,95.0,74.5
105516611.0,6,44,2904,22,1452,5024600.523809524,66.0,66.0,22,1452,5009605.857142857,66.0,66.0
107409501.0,17,16,1212,8,606,15321396.857142856,174.0,75.75,8,606,15339209.142857144,174.0,75.75
228301.0,17,2,180,1,90,0.0,90.0,90.0,1,90,0.0,90.0,90.0
90049405.0,17,28,13364,28,13364,3335163.1481481483,501.0,477.2857142857143,0,0,0.0,0.0,0.0
90032134.0,17,28,13364,28,13364,3334523.4814814813,501.0,477.2857142857143,0,0,0.0,0.0,0.0
90203342.0,6,16,1192,8,596,12852417.857142856,95.0,74.5,8,596,12856918.285714284,95.0,74.5
3149137.0,6,3,1604,2,851,0.0,785.0,425.5,1,753,0.0,753.0,753.0
33346.0,6,10,2032,5,524,8003.0,252.0,104.8,5,1508,6809.75,1236.0,301.6
90047932.0,17,28,13364,28,13364,3335108.592592593,501.0,477.2857142857143,0,0,0.0,0.0,0.0
45865.0,6,12,1328,7,797,7644.166666666667,253.0,113.85714285714286,5,531,9966.25,259.0,106.2
526.0,17,2,508,2,508,0.0,257.0,254.0,0,0,0.0,0.0,0.0
119592484.0,6,669,138340,339,115968,353823.91715976334,1514.0,342.08849557522126,330,22372,362809.2218844985,214.0,67.7939393939394
282065.0,17,2,363,1,79,0.0,79.0,79.0,1,284,0.0,284.0,284.0
114047976.0,6,48,3168,24,1584,4958607.652173913,66.0,66.0,24,1584,4949208.434782608,66.0,66.0
47172.0,17,2,582,1,83,0.0,83.0,83.0,1,499,0.0,499.0,499.0
240840.0,6,12,1373,7,714,40140.0,298.0,102.0,5,659,58788.25,379.0,131.8
113520261.0,6,46,3036,23,1518,5159999.181818182,66.0,66.0,23,1518,5159997.090909091,66.0,66.0
21946.0,6,14,4740,7,653,3515.1666666666665,249.0,93.28571428571428,7,4087,2673.833333333333,1514.0,583.8571428571429
2368493.0,17,4,1368,4,1368,789497.6666666666,342.0,342.0,0,0,0.0,0.0,0.0
324.0,17,2,164,1,82,0.0,82.0,82.0,1,82,0.0,82.0,82.0
90032270.0,17,28,13364,28,13364,3334528.5185185187,501.0,477.2857142857143,0,0,0.0,0.0,0.0
35171.0,6,11,2098,6,590,5366.4,252.0,98.33333333333331,5,1508,6845.0,1236.0,301.6
2419.0,17,4,344,2,150,0.0,75.0,75.0,2,194,0.0,103.0,97.0
90255723.0,6,13,2036,8,1016,12893674.714285716,188.0,127.0,5,1020,22522433.25,204.0,204.0
37488.0,6,14,4740,7,653,6060.833333333333,249.0,93.28571428571428,7,4087,6109.5,1514.0,583.8571428571429
108128003.0,17,5,1005,5,1005,27032000.75,201.0,201.0,0,0,0.0,0.0,0.0
107142.0,17,2,286,2,286,0.0,143.0,143.0,0,0,0.0,0.0,0.0
108106906.0,17,5,1005,5,1005,27026726.5,201.0,201.0,0,0,0.0,0.0,0.0
297564.0,6,6,412,4,272,99188.0,74.0,68.0,2,140,0.0,74.0,70.0
408441.0,6,3,1604,2,851,0.0,785.0,425.5,1,753,0.0,753.0,753.0
5626549.0,6,5,336,2,134,0.0,68.0,67.0,3,202,1418353.5,70.0,67.33333333333333
362.0,17,2,267,1,83,0.0,83.0,83.0,1,184,0.0,184.0,184.0
362950.0,6,12,1373,7,714,60491.66666666666,298.0,102.0,5,659,89636.0,379.0,131.8
311401.0,17,4,622,4,622,103800.33333333331,163.0,155.5,0,0,0.0,0.0,0.0
53205.0,6,14,4740,7,653,8742.166666666666,249.0,93.28571428571428,7,4087,6718.333333333333,1514.0,583.8571428571429
4281.0,17,2,626,1,72,0.0,72.0,72.0,1,554,0.0,554.0,554.0
120190575.0,6,314,37462,157,10658,768810.8974358974,140.0,67.88535031847134,157,26804,765131.9423076923,374.0,170.7261146496815
3036876.0,6,3,204,2,136,0.0,70.0,68.0,1,68,0.0,68.0,68.0
90027931.0,17,28,13364,28,13364,3334367.814814815,501.0,477.2857142857143,0,0,0.0,0.0,0.0
113533092.0,6,46,3036,23,1518,5160583.681818182,66.0,66.0,23,1518,5160583.681818182,66.0,66.0
42255.0,6,14,4740,7,653,5518.833333333333,249.0,93.28571428571428,7,4087,6323.5,1514.0,583.8571428571429
205782.0,17,2,180,1,90,0.0,90.0,90.0,1,90,0.0,90.0,90.0
284063.0,17,2,363,1,79,0.0,79.0,79.0,1,284,0.0,284.0,284.0
146483.0,6,3,337,2,214,0.0,160.0,107.0,1,123,0.0,123.0,123.0
21805747.0,6,6,1981,4,1087,7268582.333333333,885.0,271.75,2,894,0.0,826.0,447.0
354.0,17,2,248,1,84,0.0,84.0,84.0,1,164,0.0,164.0,164.0
228239.0,17,2,180,1,90,0.0,90.0,90.0,1,90,0.0,90.0,90.0
39257.0,6,14,4740,7,653,6425.333333333333,249.0,93.28571428571428,7,4087,6410.0,1514.0,583.8571428571429
2411508.0,6,3,204,2,136,0.0,70.0,68.0,1,68,0.0,68.0,68.0
307603.0,6,6,412,4,272,102534.33333333331,74.0,68.0,2,140,0.0,74.0,70.0
256885.0,6,3,337,2,214,0.0,160.0,107.0,1,123,0.0,123.0,123.0
206198.0,6,3,426,2,280,0.0,214.0,140.0,1,146,0.0,146.0,146.0
838538.0,6,9,1118,6,586,167707.6,248.0,97.66666666666669,3,532,281408.0,392.0,177.33333333333334
219645.0,6,3,426,2,280,0.0,214.0,140.0,1,146,0.0,146.0,146.0
0.0,6,1,66,1,66,0.0,66.0,66.0,0,0,0.0,0.0,0.0
10429700.0,6,6,412,3,206,5146231.5,74.0,68.66666666666667,3,206,5146139.0,74.0,68.66666666666667
107150657.0,17,14,1126,7,563,17831960.166666668,174.0,80.42857142857143,7,563,17831955.166666668,174.0,80.42857142857143
307282.0,6,6,412,4,272,102427.33333333331,74.0,68.0,2,140,0.0,74.0,70.0
91515027.0,6,28,1992,14,1029,7039617.461538462,123.0,73.5,14,963,7022966.923076923,123.0,68.78571428571429
326584.0,17,4,1400,4,1400,108861.33333333331,350.0,350.0,0,0,0.0,0.0,0.0
31381.0,6,14,4740,7,653,5057.833333333333,249.0,93.28571428571428,7,4087,5039.833333333333,1514.0,583.8571428571429
97096930.0,6,595,95296,298,75324,326925.6902356902,1514.0,252.7651006711409,297,19972,327240.4425675676,214.0,67.24579124579125
10583.0,6,10,1949,5,441,2426.75,169.0,88.2,5,1508,2371.25,1236.0,301.6
107013.0,17,2,286,2,286,0.0,143.0,143.0,0,0,0.0,0.0,0.0
108112508.0,17,5,1005,5,1005,27028127.0,201.0,201.0,0,0,0.0,0.0,0.0
116889872.0,6,48,3168,24,1584,5082168.347826087,66.0,66.0,24,1584,5068751.304347826,66.0,66.0
98467628.0,6,25,1692,13,906,8205635.666666667,123.0,69.6923076923077,12,786,8024160.090909091,123.0,65.5
49264.0,6,14,4740,7,653,7878.333333333333,249.0,93.28571428571428,7,4087,8076.166666666667,1514.0,583.8571428571429
5625802.0,6,5,336,2,134,0.0,68.0,67.0,3,202,1422370.5,70.0,67.33333333333333
113309594.0,6,45,2970,23,1518,5150436.090909091,66.0,66.0,22,1452,4945626.0,66.0,66.0
120015512.0,6,3819,3197454,1445,97516,83113.23545706371,214.0,67.48512110726644,2374,3099938,50547.53603034134,1514.0,1305.786857624263
185630.0,6,10,1066,5,490,44197.0,218.0,98.0,5,576,46194.0,304.0,115.2
15193.0,17,2,180,1,90,0.0,90.0,90.0,1,90,0.0,90.0,90.0
12204.0,6,13,1459,7,862,1953.0,271.0,123.14285714285714,6,597,2233.0,259.0,99.5
148613.0,17,2,414,1,88,0.0,88.0,88.0,1,326,0.0,326.0,326.0
90254984.0,6,13,2036,8,1016,12893569.142857144,188.0,127.0,5,1020,22522567.0,204.0,204.0
108108687.0,17,5,955,5,955,27027171.75,191.0,191.0,0,0,0.0,0.0,0.0
5003888.0,17,4,849,2,166,0.0,83.0,83.0,2,683,0.0,499.0,341.5
18997363.0,6,6,1981,4,1087,6332454.333333333,885.0,271.75,2,894,0.0,826.0,447.0
100882771.0,17,11,604,6,389,20176554.2,174.0,64.83333333333333,5,215,20001188.0,43.0,43.0
120010870.0,6,18,1341,9,691,14999999.375,95.0,76.77777777777777,9,650,14999839.125,95.0,72.22222222222223
38026.0,6,10,2032,5,524,9083.0,252.0,104.8,5,1508,7265.75,1236.0,301.6
90291821.0,6,15,1097,8,596,12898831.57142857,95.0,74.5,7,501,14998558.833333334,95.0,71.57142857142857
4612.0,17,2,762,2,762,0.0,381.0,381.0,0,0,0.0,0.0,0.0
307083.0,6,6,412,4,272,102361.0,74.0,68.0,2,140,0.0,74.0,70.0
285305.0,17,2,363,1,79,0.0,79.0,79.0,1,284,0.0,284.0,284.0
135537.0,6,2,132,1,66,0.0,66.0,66.0,1,66,0.0,66.0,66.0
78435.0,6,14,4740,7,653,12558.0,249.0,93.28571428571428,7,4087,11108.666666666666,1514.0,583.8571428571429
307182.0,6,6,412,4,272,102394.0,74.0,68.0,2,140,0.0,74.0,70.0
1711.0,17,2,762,2,762,0.0,381.0,381.0,0,0,0.0,0.0,0.0
109214166.0,6,197,22286,99,6756,1114430.2653061224,140.0,68.24242424242425,98,15530,1115235.969072165,284.0,158.46938775510205
353522.0,6,3,204,2,136,0.0,70.0,68.0,1,68,0.0,68.0,68.0
2346.0,17,4,344,2,150,0.0,75.0,75.0,2,194,0.0,103.0,97.0
51718.0,6,10,2032,5,524,12688.0,252.0,104.8,5,1508,12437.5,1236.0,301.6
121259.0,6,3,337,2,214,0.0,160.0,107.0,1,123,0.0,123.0,123.0
17737.0,6,10,2032,5,524,4187.25,252.0,104.8,5,1508,3872.5,1236.0,301.6
141766.0,6,2,132,1,66,0.0,66.0,66.0,1,66,0.0,66.0,66.0
105699068.0,6,27,1737,14,894,8130697.538461538,123.0,63.85714285714285,13,843,8790080.083333334,123.0,64.84615384615384
0.0,6,1,54,0,0,0.0,0.0,0.0,1,54,0.0,54.0,54.0
2592115.0,6,2,132,1,66,0.0,66.0,66.0,1,66,0.0,66.0,66.0
226175.0,6,3,426,2,280,0.0,214.0,140.0,1,146,0.0,146.0,146.0
2773820.0,6,2,132,1,66,0.0,66.0,66.0,1,66,0.0,66.0,66.0
254573.0,6,3,337,2,214,0.0,160.0,107.0,1,123,0.0,123.0,123.0
123610518.0,6,49,3234,25,1650,5150438.25,66.0,66.0,24,1584,4937964.608695652,66.0,66.0
153432.0,17,2,180,1,90,0.0,90.0,90.0,1,90,0.0,90.0,90.0
90958522.0,6,21,1585,11,840,9095059.6,95.0,76.36363636363636,10,745,10105088.777777778,95.0,74.5
112145.0,17,2,286,2,286,0.0,143.0,143.0,0,0,0.0,0.0,0.0
135127175.0,17,6,1146,6,1146,27025435.0,191.0,191.0,0,0,0.0,0.0,0.0
121007703.0,17,15,907,8,475,17286814.714285713,174.0,59.375,7,432,16833503.0,174.0,61.71428571428572
2994989.0,6,3,1604,1,753,0.0,753.0,753.0,2,851,0.0,785.0,425.5
69154.0,6,14,4740,7,653,10858.0,249.0,93.28571428571428,7,4087,9611.5,1514.0,583.8571428571429
32472.0,6,14,4740,7,653,4924.166666666667,249.0,93.28571428571428,7,4087,4895.166666666667,1514.0,583.8571428571429
511417.0,6,5,336,2,134,0.0,68.0,67.0,3,202,195852.5,70.0,67.33333333333333
31074.0,6,14,4740,7,653,3627.6666666666665,249.0,93.28571428571428,7,4087,4980.0,1514.0,583.8571428571429
3006514.0,6,11,2106,6,598,601127.8,252.0,99.66666666666669,5,1508,1802.25,1236.0,301.6
415927.0,6,4,508,2,238,0.0,172.0,119.0,2,270,0.0,135.0,135.0
302456.0,6,6,412,4,272,100818.66666666669,74.0,68.0,2,140,0.0,74.0,70.0
2023.0,17,4,344,2,150,0.0,75.0,75.0,2,194,0.0,103.0,97.0
6544.0,17,2,231,1,78,0.0,78.0,78.0,1,153,0.0,153.0,153.0
310544.0,17,2,180,1,90,0.0,90.0,90.0,1,90,0.0,90.0,90.0
248332.0,17,4,1524,4,1524,82777.33333333333,381.0,381.0,0,0,0.0,0.0,0.0
103000979.0,17,13,821,7,432,17166829.833333332,174.0,61.71428571428572,6,389,16599868.6,174.0,64.83333333333333
115114.0,6,14,4740,7,653,19008.166666666668,249.0,93.28571428571428,7,4087,18793.166666666668,1514.0,583.8571428571429
855561.0,6,9,1268,6,797,171112.2,459.0,132.83333333333334,3,471,290147.0,331.0,157.0
25027.0,6,14,4740,7,653,3881.1666666666665,249.0,93.28571428571428,7,4087,3861.6666666666665,1514.0,583.8571428571429
53861.0,6,14,4740,7,653,7872.0,249.0,93.28571428571428,7,4087,8836.333333333334,1514.0,583.8571428571429
5618291.0,6,5,336,2,134,0.0,68.0,67.0,3,202,1519917.0,70.0,67.33333333333333
20842386.0,6,6,1981,4,1087,6947462.0,885.0,271.75,2,894,0.0,826.0,447.0
135128629.0,17,6,1146,6,1146,27025725.8,191.0,191.0,0,0,0.0,0.0,0.0
31859.0,6,2,145,2,145,0.0,91.0,72.5,0,0,0.0,0.0,0.0
138613.0,6,2,132,1,66,0.0,66.0,66.0,1,66,0.0,66.0,66.0
90071981.0,17,27,12943,27,12943,3464306.961538461,501.0,479.3703703703704,0,0,0.0,0.0,0.0
49678.0,6,14,4740,7,653,7883.333333333333,249.0,93.28571428571428,7,4087,6819.0,1514.0,583.8571428571429
413.0,17,2,410,1,78,0.0,78.0,78.0,1,332,0.0,332.0,332.0
3174433.0,6,18,1536,9,962,358361.25,315.0,106.88888888888889,9,574,358329.25,78.0,63.77777777777778
409.0,17,2,508,2,508,0.0,257.0,254.0,0,0,0.0,0.0,0.0
90095095.0,6,12,1848,5,1020,22523178.5,204.0,204.0,7,828,15015456.833333334,188.0,118.28571428571428
300419.0,6,6,412,4,272,100139.66666666669,74.0,68.0,2,140,0.0,74.0,70.0
362705.0,6,11,1021,6,444,48718.4,162.0,74.0,5,577,60708.0,349.0,115.4
107267.0,17,2,286,2,286,0.0,143.0,143.0,0,0,0.0,0.0,0.0
10517334.0,6,7,478,4,272,3460263.6666666665,74.0,68.0,3,206,5190274.5,74.0,68.66666666666667
135134117.0,17,6,1206,6,1206,27026823.4,201.0,201.0,0,0,0.0,0.0,0.0
1301666.0,6,4,264,2,132,0.0,66.0,66.0,2,132,0.0,66.0,66.0
3375983.0,17,3,1026,3,1026,1687991.5,342.0,342.0,0,0,0.0,0.0,0.0
115000961.0,17,13,821,7,432,19166826.83333333,174.0,61.71428571428572,6,389,19002760.8,174.0,64.83333333333333
384665.0,6,10,1221,6,636,76933.0,298.0,106.0,4,585,127267.0,379.0,146.25
233451.0,6,3,337,2,214,0.0,160.0,107.0,1,123,0.0,123.0,123.0
5664.0,17,4,344,2,150,0.0,75.0,75.0,2,194,0.0,103.0,97.0
3441792.0,6,146,130727,94,122993,37008.51612903226,1510.0,1308.436170212766,52,7734,61355.52941176471,1510.0,148.73076923076923
321.0,17,2,166,1,75,0.0,75.0,75.0,1,91,0.0,91.0,91.0
144408.0,6,2,132,1,66,0.0,66.0,66.0,1,66,0.0,66.0,66.0
116697835.0,6,236,26644,118,18560,995578.4786324786,284.0,157.28813559322035,118,8084,995578.3504273504,140.0,68.50847457627118
897.0,17,5,550,5,550,224.25,110.0,110.0,0,0,0.0,0.0,0.0
252436.0,17,4,6056,4,6056,84145.33333333333,1514.0,1514.0,0,0,0.0,0.0,0.0
313308.0,6,6,412,4,272,104436.0,74.0,68.0,2,140,0.0,74.0,70.0
207431.0,6,3,426,2,280,0.0,214.0,140.0,1,146,0.0,146.0,146.0
1302335.0,6,4,264,2,132,0.0,66.0,66.0,2,132,0.0,66.0,66.0
14635976.0,6,20,1607,10,975,1592494.7777777778,315.0,97.5,10,632,1592438.2222222222,78.0,63.2
3428.0,17,2,346,1,78,0.0,78.0,78.0,1,268,0.0,268.0,268.0
37670.0,6,12,1320,6,723,6825.6,253.0,120.5,6,597,6555.2,259.0,99.5
23341959.0,6,32,9479,19,4065,1296775.5,1514.0,213.94736842105263,13,5414,1924438.6666666667,1514.0,416.46153846153845
156128.0,6,3,337,2,214,0.0,160.0,107.0,1,123,0.0,123.0,123.0
90050829.0,17,27,12943,27,12943,3463493.423076923,501.0,479.3703703703704,0,0,0.0,0.0,0.0
228220.0,17,2,180,1,90,0.0,90.0,90.0,1,90,0.0,90.0,90.0
104062901.0,17,14,1126,7,563,17168080.333333332,174.0,80.42857142857143,7,563,17333490.0,174.0,80.42857142857143
14641827.0,6,20,1607,10,975,1592359.888888889,315.0,97.5,10,632,1592331.4444444445,78.0,63.2
204958.0,17,3,1143,3,1143,102479.0,381.0,381.0,0,0,0.0,0.0,0.0
120400630.0,6,223,25548,112,17926,1084690.3603603605,374.0,160.05357142857142,111,7622,1085132.7818181815,140.0,68.66666666666667
442542.0,6,10,967,5,390,74565.0,162.0,78.0,5,577,74498.5,349.0,115.4
102306815.0,6,43,2838,21,1386,5112000.15,66.0,66.0,22,1452,4871739.238095238,66.0,66.0
103511394.0,17,14,864,7,432,17167740.833333332,174.0,61.71428571428572,7,432,17166868.666666668,174.0,61.71428571428572
108112371.0,17,5,1005,5,1005,27028092.75,201.0,201.0,0,0,0.0,0.0,0.0
2794632.0,6,2,132,1,66,0.0,66.0,66.0,1,66,0.0,66.0,66.0
253171.0,6,3,337,2,214,0.0,160.0,107.0,1,123,0.0,123.0,123.0
205744.0,17,4,6056,4,6056,68581.33333333333,1514.0,1514.0,0,0,0.0,0.0,0.0
138424.0,6,2,132,1,66,0.0,66.0,66.0,1,66,0.0,66.0,66.0
2074.0,17,4,344,2,150,0.0,75.0,75.0,2,194,0.0,103.0,97.0
235493.0,6,12,1373,7,714,39248.833333333336,298.0,102.0,5,659,55139.0,379.0,131.8
3779249.0,6,5,336,2,134,0.0,68.0,67.0,3,202,1513326.0,70.0,67.33333333333333
15652.0,17,4,1024,2,163,0.0,89.0,81.5,2,861,0.0,443.0,430.5
2795083.0,6,2,132,1,66,0.0,66.0,66.0,1,66,0.0,66.0,66.0
92106558.0,17,15,5130,15,5130,6579039.857142857,342.0,342.0,0,0,0.0,0.0,0.0
49238.0,6,14,4740,7,653,6098.166666666667,249.0,93.28571428571428,7,4087,7750.0,1514.0,583.8571428571429
305099.0,17,2,180,1,90,0.0,90.0,90.0,1,90,0.0,90.0,90.0
0.0,17,1,72,1,72,0.0,72.0,72.0,0,0,0.0,0.0,0.0
6505.0,17,2,363,1,79,0.0,79.0,79.0,1,284,0.0,284.0,284.0
18312.0,6,14,4740,7,653,2661.5,249.0,93.28571428571428,7,4087,2640.1666666666665,1514.0,583.8571428571429
120117577.0,6,12,1832,8,1016,17136819.42857143,188.0,127.0,4,816,30031408.666666668,204.0,204.0
308932.0,6,3,202,2,128,0.0,74.0,64.0,1,74,0.0,74.0,74.0
99641094.0,6,26,1762,13,922,8285424.083333333,139.0,70.92307692307692,13,840,8285423.166666667,123.0,64.61538461538461
33811.0,6,14,4740,7,653,5514.333333333333,249.0,93.28571428571428,7,4087,4808.666666666667,1514.0,583.8571428571429
207054.0,6,3,426,2,280,0.0,214.0,140.0,1,146,0.0,146.0,146.0
108107710.0,17,5,1005,5,1005,27026927.5,201.0,201.0,0,0,0.0,0.0,0.0
105914.0,17,2,700,2,700,0.0,350.0,350.0,0,0,0.0,0.0,0.0
18176.0,6,14,4740,7,653,2827.5,249.0,93.28571428571428,7,4087,2891.333333333333,1514.0,583.8571428571429
18399.0,6,10,2032,5,524,4304.75,252.0,104.8,5,1508,4189.25,1236.0,301.6
228475.0,17,2,180,1,90,0.0,90.0,90.0,1,90,0.0,90.0,90.0
90010541.0,17,28,13364,28,13364,3333723.7407407407,501.0,477.2857142857143,0,0,0.0,0.0,0.0
302229.0,6,6,412,4,272,100743.0,74.0,68.0,2,140,0.0,74.0,70.0
82879.0,6,14,4740,7,653,13363.5,249.0,93.28571428571428,7,4087,13090.333333333334,1514.0,583.8571428571429
143904.0,17,2,180,1,90,0.0,90.0,90.0,1,90,0.0,90.0,90.0
1629622.0,6,4,276,2,128,0.0,74.0,64.0,2,148,0.0,74.0,74.0
209870.0,6,3,426,2,280,0.0,214.0,140.0,1,146,0.0,146.0,146.0
33172.0,6,14,4740,7,653,5409.5,249.0,93.28571428571428,7,4087,5337.5,1514.0,583.8571428571429
116957265.0,6,34,2350,17,1225,7296327.25,139.0,72.05882352941177,17,1125,7296325.875,123.0,66.17647058823529
2350.0,17,4,344,2,150,0.0,75.0,75.0,2,194,0.0,103.0,97.0
90755873.0,6,18,1382,10,786,10078416.666666666,95.0,78.6,8,596,12897630.142857144,95.0,74.5
216588.0,6,3,426,2,280,0.0,214.0,140.0,1,146,0.0,146.0,146.0
42258.0,6,14,4740,7,653,5578.5,249.0,93.28571428571428,7,4087,6559.333333333333,1514.0,583.8571428571429
90757372.0,6,19,1436,10,745,10079660.111111112,95.0,74.5,9,691,11344251.5,95.0,76.77777777777777
7046.0,17,4,823,2,163,0.0,89.0,81.5,2,660,0.0,443.0,330.0
23215.0,6,10,2032,5,524,5494.0,252.0,104.8,5,1508,5085.25,1236.0,301.6
10507919.0,6,7,478,4,272,3457419.0,74.0,68.0,3,206,5186036.0,74.0,68.66666666666667
1024594.0,6,11,1134,6,558,204918.8,220.0,93.0,5,576,254054.25,304.0,115.2
106047425.0,6,34,2350,17,1225,6614471.5625,139.0,72.05882352941177,17,1125,6614471.9375,123.0,66.17647058823529
314972.0,17,4,1400,4,1400,104990.66666666669,350.0,350.0,0,0,0.0,0.0,0.0
102546.0,6,14,4740,7,653,16958.666666666668,249.0,93.28571428571428,7,4087,16454.5,1514.0,583.8571428571429
28111.0,6,14,4740,7,653,4399.333333333333,249.0,93.28571428571428,7,4087,4051.0,1514.0,583.8571428571429
439506.0,6,10,1221,6,636,87901.2,298.0,106.0,4,585,141040.33333333334,379.0,146.25
608660.0,17,2,346,1,78,0.0,78.0,78.0,1,268,0.0,268.0,268.0
362454.0,6,10,967,5,390,60791.25,162.0,78.0,5,577,60725.5,349.0,115.4
5036006.0,17,4,849,2,166,0.0,83.0,83.0,2,683,0.0,499.0,341.5
120121425.0,6,232,26216,116,7878,1029495.3130434784,140.0,67.91379310344827,116,18338,1037431.6695652172,284.0,158.08620689655172
122409518.0,17,14,995,7,432,17500191.0,174.0,61.71428571428572,7,563,19678154.666666668,174.0,80.42857142857143
10862.0,17,2,224,1,76,0.0,76.0,76.0,1,148,0.0,148.0,148.0
113255037.0,6,46,3036,23,1518,5135440.090909091,66.0,66.0,23,1518,5135441.545454546,66.0,66.0
91410964.0,6,24,1829,13,989,7617045.5,95.0,76.07692307692308,11,840,9140178.7,95.0,76.36363636363636
3531.0,17,4,344,2,150,0.0,75.0,75.0,2,194,0.0,103.0,97.0
316351.0,17,4,1400,4,1400,105450.33333333331,350.0,350.0,0,0,0.0,0.0,0.0
103257.0,17,2,286,2,286,0.0,143.0,143.0,0,0,0.0,0.0,0.0
249856.0,17,4,6056,4,6056,83285.33333333333,1514.0,1514.0,0,0,0.0,0.0,0.0
69681.0,17,4,842,2,154,0.0,77.0,77.0,2,688,0.0,547.0,344.0
10462523.0,6,7,478,4,272,3441872.6666666665,74.0,68.0,3,206,5162678.0,74.0,68.66666666666667
103673.0,17,2,286,2,286,0.0,143.0,143.0,0,0,0.0,0.0,0.0
2342.0,17,2,762,2,762,0.0,381.0,381.0,0,0,0.0,0.0,0.0
94939374.0,6,40,2640,20,1320,4996809.157894737,66.0,66.0,20,1320,4980552.315789473,66.0,66.0
1486.0,17,2,180,1,90,0.0,90.0,90.0,1,90,0.0,90.0,90.0
44327.0,6,14,4740,7,653,7174.833333333333,249.0,93.28571428571428,7,4087,7198.0,1514.0,583.8571428571429
120047237.0,17,28,13364,28,13364,4446193.962962963,501.0,477.2857142857143,0,0,0.0,0.0,0.0
108112398.0,17,5,955,5,955,27028099.5,191.0,191.0,0,0,0.0,0.0,0.0
31300.0,6,14,4740,7,653,4843.333333333333,249.0,93.28571428571428,7,4087,4036.6666666666665,1514.0,583.8571428571429
299826.0,6,6,412,4,272,99942.0,74.0,68.0,2,140,0.0,74.0,70.0
37654.0,6,10,2032,5,524,9180.25,252.0,104.8,5,1508,9181.25,1236.0,301.6
74861.0,6,10,1065,5,534,16631.75,262.0,106.8,5,531,17347.5,259.0,106.2
18401.0,6,10,2032,5,524,4383.75,252.0,104.8,5,1508,4060.25,1236.0,301.6
214277.0,6,3,426,2,280,0.0,214.0,140.0,1,146,0.0,146.0,146.0
2380.0,17,4,344,2,150,0.0,75.0,75.0,2,194,0.0,103.0,97.0
90709076.0,6,24,1829,11,840,9070907.6,95.0,76.36363636363636,13,989,7536250.0,95.0,76.07692307692308
172108.0,17,2,180,1,90,0.0,90.0,90.0,1,90,0.0,90.0,90.0
120287849.0,6,226,25406,113,7754,1067652.1339285714,140.0,68.61946902654867,113,17652,1066459.1160714286,284.0,156.21238938053096
764.0,17,2,762,2,762,0.0,381.0,381.0,0,0,0.0,0.0,0.0
2408.0,17,4,344,2,150,0.0,75.0,75.0,2,194,0.0,103.0,97.0
2358.0,17,4,344,2,150,0.0,75.0,75.0,2,194,0.0,103.0,97.0
9445.0,17,2,582,1,83,0.0,83.0,83.0,1,499,0.0,499.0,499.0
119562079.0,6,33,2412,16,1140,7970805.266666667,123.0,71.25,17,1272,6834979.1875,123.0,74.82352941176471
247366.0,17,4,6056,4,6056,82455.33333333333,1514.0,1514.0,0,0,0.0,0.0,0.0
43545.0,6,14,4740,7,653,6946.0,249.0,93.28571428571428,7,4087,6439.0,1514.0,583.8571428571429
5615666.0,6,4,270,2,134,0.0,68.0,67.0,2,136,0.0,70.0,68.0
114332167.0,6,872,150350,431,28964,265877.8558139535,214.0,67.20185614849188,441,121386,259816.03863636364,1514.0,275.2517006802721
108091937.0,17,5,1005,5,1005,27022984.25,201.0,201.0,0,0,0.0,0.0,0.0
146791.0,6,3,337,2,214,0.0,160.0,107.0,1,123,0.0,123.0,123.0
0.0,17,1,44,1,44,0.0,44.0,44.0,0,0,0.0,0.0,0.0
297446.0,6,6,412,4,272,99148.66666666669,74.0,68.0,2,140,0.0,74.0,70.0
1549.0,17,2,192,1,88,0.0,88.0,88.0,1,104,0.0,104.0,104.0
59417.0,6,14,4740,7,653,9779.5,249.0,93.28571428571428,7,4087,8427.166666666666,1514.0,583.8571428571429
40883.0,6,14,4740,7,653,6694.0,249.0,93.28571428571428,7,4087,6201.0,1514.0,583.8571428571429
25197.0,6,10,2032,5,524,5679.25,252.0,104.8,5,1508,5723.25,1236.0,301.6
115306517.0,6,40,3147,19,1509,6405893.611111111,123.0,79.42105263157895,21,1638,5765302.5,123.0,78.0
2308.0,17,4,344,2,150,0.0,75.0,75.0,2,194,0.0,103.0,97.0
40172.0,6,14,4740,7,653,6266.333333333333,249.0,93.28571428571428,7,4087,6048.0,1514.0,583.8571428571429
90257750.0,6,13,2036,8,1016,12893964.285714284,188.0,127.0,5,1020,22523381.0,204.0,204.0
135133930.0,17,6,1146,6,1146,27026786.0,191.0,191.0,0,0,0.0,0.0,0.0
327126.0,6,6,412,4,272,109042.0,74.0,68.0,2,140,0.0,74.0,70.0
137648.0,6,2,132,1,66,0.0,66.0,66.0,1,66,0.0,66.0,66.0
38431.0,6,14,4740,7,653,6085.0,249.0,93.28571428571428,7,4087,6266.5,1514.0,583.8571428571429
90038089.0,17,27,12943,27,12943,3463003.423076923,501.0,479.3703703703704,0,0,0.0,0.0,0.0
2418.0,17,4,344,2,150,0.0,75.0,75.0,2,194,0.0,103.0,97.0
2795147.0,6,2,132,1,66,0.0,66.0,66.0,1,66,0.0,66.0,66.0
215344.0,17,2,180,1,90,0.0,90.0,90.0,1,90,0.0,90.0,90.0
90069332.0,6,11,1644,4,816,30021725.33333333,204.0,204.0,7,828,15011115.166666666,188.0,118.28571428571428
10016539.0,17,3,270,3,270,5008269.5,90.0,90.0,0,0,0.0,0.0,0.0
120001185.0,6,25,1924,14,1084,9230860.384615384,95.0,77.42857142857143,11,840,9140994.4,95.0,76.36363636363636
196876.0,17,2,180,1,90,0.0,90.0,90.0,1,90,0.0,90.0,90.0
213726.0,17,2,180,1,90,0.0,90.0,90.0,1,90,0.0,90.0,90.0
46975.0,6,14,4740,7,653,7269.833333333333,249.0,93.28571428571428,7,4087,7544.0,1514.0,583.8571428571429
6880.0,17,2,582,1,83,0.0,83.0,83.0,1,499,0.0,499.0,499.0
16045.0,6,10,2032,5,524,3781.75,252.0,104.8,5,1508,3205.5,1236.0,301.6
2014.0,17,4,344,2,150,0.0,75.0,75.0,2,194,0.0,103.0,97.0
14637639.0,6,20,1648,10,1016,1592484.111111111,315.0,101.6,10,632,1592458.111111111,78.0,63.2
263326.0,6,10,1221,6,636,52665.2,298.0,106.0,4,585,82043.0,379.0,146.25
25332.0,6,14,4740,7,653,4095.8333333333335,249.0,93.28571428571428,7,4087,3550.1666666666665,1514.0,583.8571428571429
133000.0,6,3,337,2,214,0.0,160.0,107.0,1,123,0.0,123.0,123.0
23591797.0,6,25,8756,14,1785,1814753.6153846155,408.0,127.5,11,6971,1946963.7,1514.0,633.7272727272727
18940.0,6,14,4740,7,653,2903.6666666666665,249.0,93.28571428571428,7,4087,2444.1666666666665,1514.0,583.8571428571429
9860.0,17,2,571,1,86,0.0,86.0,86.0,1,485,0.0,485.0,485.0
10920146.0,6,8,544,4,272,3593090.333333333,74.0,68.0,4,272,3593017.6666666665,74.0,68.0
311125.0,6,3,202,2,128,0.0,74.0,64.0,1,74,0.0,74.0,74.0
9128.0,17,2,582,1,83,0.0,83.0,83.0,1,499,0.0,499.0,499.0
205861.0,17,2,180,1,90,0.0,90.0,90.0,1,90,0.0,90.0,90.0
48950536.0,6,7,2047,5,1153,12237634.0,885.0,230.6,2,894,0.0,826.0,447.0
242038.0,6,3,337,2,214,0.0,160.0,107.0,1,123,0.0,123.0,123.0
26991.0,6,14,4740,7,653,4358.0,249.0,93.28571428571428,7,4087,4194.5,1514.0,583.8571428571429
120105464.0,6,13,2036,5,1020,30026366.0,204.0,204.0,8,1016,17134683.42857143,188.0,127.0
343635.0,6,6,412,4,272,114545.0,74.0,68.0,2,140,0.0,74.0,70.0
303140.0,6,2,132,1,66,0.0,66.0,66.0,1,66,0.0,66.0,66.0
306803.0,6,6,412,4,272,102267.66666666669,74.0,68.0,2,140,0.0,74.0,70.0
307508.0,6,6,412,4,272,102502.66666666669,74.0,68.0,2,140,0.0,74.0,70.0
90486970.0,6,19,1436,10,786,10048731.666666666,95.0,78.6,9,650,11305411.375,95.0,72.22222222222223
200546.0,17,4,6056,4,6056,66848.66666666667,1514.0,1514.0,0,0,0.0,0.0,0.0
118891334.0,6,39,2902,20,1531,6257438.631578947,139.0,76.55,19,1371,6593057.555555556,123.0,72.15789473684211
98616217.0,6,598,111382,302,91402,327628.62790697673,1514.0,302.65562913907286,296,19980,333472.7762711864,214.0,67.5
109000957.0,17,13,821,7,432,18166826.166666668,174.0,61.71428571428572,6,389,17800761.6,174.0,64.83333333333333
209497.0,17,2,180,1,90,0.0,90.0,90.0,1,90,0.0,90.0,90.0
38302.0,6,14,4740,7,653,6261.5,249.0,93.28571428571428,7,4087,6185.0,1514.0,583.8571428571429
38090.0,6,10,2032,5,524,8814.5,252.0,104.8,5,1508,5503.0,1236.0,301.6
128325329.0,6,35,2394,18,1269,7548548.764705882,123.0,70.5,17,1125,7382725.0625,123.0,66.17647058823529
153426.0,17,2,180,1,90,0.0,90.0,90.0,1,90,0.0,90.0,90.0
153422.0,17,2,180,1,90,0.0,90.0,90.0,1,90,0.0,90.0,90.0
121315.0,6,3,337,2,214,0.0,160.0,107.0,1,123,0.0,123.0,123.0
143871.0,17,2,180,1,90,0.0,90.0,90.0,1,90,0.0,90.0,90.0
46522.0,6,10,2032,5,524,11377.5,252.0,104.8,5,1508,10826.5,1236.0,301.6
34509.0,6,14,4740,7,653,5017.166666666667,249.0,93.28571428571428,7,4087,5366.5,1514.0,583.8571428571429
75683.0,6,14,4740,7,653,12175.5,249.0,93.28571428571428,7,4087,12104.166666666666,1514.0,583.8571428571429
218410.0,6,4,492,2,280,0.0,214.0,140.0,2,212,0.0,146.0,106.0
54375.0,6,14,4740,7,653,8938.333333333334,249.0,93.28571428571428,7,4087,8215.5,1514.0,583.8571428571429
216557.0,6,3,426,2,280,0.0,214.0,140.0,1,146,0.0,146.0,146.0
120124508.0,6,14,2224,9,1204,15015563.5,188.0,133.77777777777777,5,1020,22591832.25,204.0,204.0
20361.0,6,10,2032,5,524,4137.75,252.0,104.8,5,1508,4731.5,1236.0,301.6
143909.0,17,2,180,1,90,0.0,90.0,90.0,1,90,0.0,90.0,90.0
5617767.0,6,4,270,2,134,0.0,68.0,67.0,2,136,0.0,70.0,68.0
95890298.0,6,195,21952,98,6690,988559.7731958764,140.0,68.26530612244898,97,15262,989186.03125,284.0,157.340206185567
153427.0,17,2,180,1,90,0.0,90.0,90.0,1,90,0.0,90.0,90.0
1314533.0,6,4,264,2,132,0.0,66.0,66.0,2,132,0.0,66.0,66.0
322.0,17,2,174,1,79,0.0,79.0,79.0,1,95,0.0,95.0,95.0
2259.0,17,2,684,1,342,0.0,342.0,342.0,1,342,0.0,342.0,342.0
143919.0,17,2,180,1,90,0.0,90.0,90.0,1,90,0.0,90.0,90.0
101803.0,17,2,762,2,762,0.0,381.0,381.0,0,0,0.0,0.0,0.0
109764745.0,6,23,1914,11,1061,10976474.5,220.0,96.45454545454544,12,853,9951272.0,95.0,71.08333333333333
147149.0,6,3,337,2,214,0.0,160.0,107.0,1,123,0.0,123.0,123.0
108109327.0,17,5,1005,5,1005,27027331.75,201.0,201.0,0,0,0.0,0.0,0.0
120009568.0,6,19,1436,9,691,15001196.0,95.0,76.77777777777777,10,745,13305569.333333334,95.0,74.5
41384.0,6,14,4740,7,653,6720.333333333333,249.0,93.28571428571428,7,4087,6724.833333333333,1514.0,583.8571428571429
2803192.0,6,2,132,1,66,0.0,66.0,66.0,1,66,0.0,66.0,66.0
43090.0,6,14,4740,7,653,7057.5,249.0,93.28571428571428,7,4087,6441.666666666667,1514.0,583.8571428571429
206455.0,17,2,180,1,90,0.0,90.0,90.0,1,90,0.0,90.0,90.0
120028276.0,17,29,13785,29,13785,4286724.142857143,501.0,475.3448275862069,0,0,0.0,0.0,0.0
0.0,17,1,381,1,381,0.0,381.0,381.0,0,0,0.0,0.0,0.0
10630.0,17,2,582,1,83,0.0,83.0,83.0,1,499,0.0,499.0,499.0
65337.99999999999,6,14,4740,7,653,10156.833333333334,249.0,93.28571428571428,7,4087,10426.5,1514.0,583.8571428571429
316668.0,17,4,1400,4,1400,105556.0,350.0,350.0,0,0,0.0,0.0,0.0
90096568.0,6,11,1644,7,828,15016094.666666666,188.0,118.28571428571428,4,816,20022034.33333333,204.0,204.0
2643731.0,6,12,2172,7,664,440547.5,252.0,94.85714285714286,5,1508,2180.25,1236.0,301.6
1321433.0,6,4,264,2,132,0.0,66.0,66.0,2,132,0.0,66.0,66.0
59341.0,6,14,4740,7,653,8852.333333333334,249.0,93.28571428571428,7,4087,9578.666666666666,1514.0,583.8571428571429
44098.0,6,14,4740,7,653,6980.833333333333,249.0,93.28571428571428,7,4087,6852.0,1514.0,583.8571428571429
141564.0,6,2,132,1,66,0.0,66.0,66.0,1,66,0.0,66.0,66.0
155282.0,6,3,337,2,214,0.0,160.0,107.0,1,123,0.0,123.0,123.0
6121.0,17,2,239,1,82,0.0,82.0,82.0,1,157,0.0,157.0,157.0
12335.0,6,10,2032,5,524,2542.5,252.0,104.8,5,1508,2665.5,1236.0,301.6
90802642.0,6,26,2903,13,1450,7562604.416666667,426.0,111.53846153846152,13,1453,7566629.5,335.0,111.76923076923076
120122101.0,6,16,2368,9,1204,14994848.625,188.0,133.77777777777777,7,1164,15015628.166666666,204.0,166.28571428571428
106231.0,17,2,286,2,286,0.0,143.0,143.0,0,0,0.0,0.0,0.0
98582140.0,6,29,2046,15,1017,7041549.285714285,123.0,67.8,14,1029,6815120.153846154,123.0,73.5
308712.0,6,6,412,4,272,102904.0,74.0,68.0,2,140,0.0,74.0,70.0
135134778.0,17,6,1146,6,1146,27026955.6,191.0,191.0,0,0,0.0,0.0,0.0
156289.0,6,3,337,2,214,0.0,160.0,107.0,1,123,0.0,123.0,123.0
16607.0,6,14,4740,7,653,2567.333333333333,249.0,93.28571428571428,7,4087,2581.833333333333,1514.0,583.8571428571429
308149.0,6,6,412,4,272,102716.33333333331,74.0,68.0,2,140,0.0,74.0,70.0
117340356.0,6,279,32198,140,9462,844175.2230215827,140.0,67.58571428571429,139,22736,842745.463768116,284.0,163.568345323741
213643.0,17,2,180,1,90,0.0,90.0,90.0,1,90,0.0,90.0,90.0
103826.0,17,2,286,2,286,0.0,143.0,143.0,0,0,0.0,0.0,0.0
135135341.0,17,6,1206,6,1206,27027068.2,201.0,201.0,0,0,0.0,0.0,0.0
77989.0,6,10,2032,5,524,18472.75,252.0,104.8,5,1508,15820.75,1236.0,301.6
284722.0,17,2,620,1,75,0.0,75.0,75.0,1,545,0.0,545.0,545.0
145132.0,6,2,132,1,66,0.0,66.0,66.0,1,66,0.0,66.0,66.0
119268428.0,6,235,26822,118,8084,1019388.2735042736,140.0,68.50847457627118,117,18738,1018996.8534482758,300.0,160.15384615384616
2347.0,17,4,344,2,150,0.0,75.0,75.0,2,194,0.0,103.0,97.0
103188558.0,17,14,864,7,432,17169284.5,174.0,61.71428571428572,7,432,17166824.333333332,174.0,61.71428571428572
120448680.0,6,21,1585,11,840,9040714.6,95.0,76.36363636363636,10,745,13376807.888888888,95.0,74.5
323820.0,17,4,1400,4,1400,107940.0,350.0,350.0,0,0,0.0,0.0,0.0
90903878.0,17,17,5814,17,5814,5681492.375,342.0,342.0,0,0,0.0,0.0,0.0
54948.0,6,13,4515,6,512,10851.4,230.0,85.33333333333333,7,4003,5825.833333333333,1514.0,571.8571428571429
305647.0,6,6,412,4,272,101882.33333333331,74.0,68.0,2,140,0.0,74.0,70.0
233421.0,17,4,1524,4,1524,77807.0,381.0,381.0,0,0,0.0,0.0,0.0
100179614.0,17,14,1126,7,563,16670115.0,174.0,80.42857142857143,7,563,16670116.166666666,174.0,80.42857142857143
122283.0,6,3,373,2,238,0.0,172.0,119.0,1,135,0.0,135.0,135.0
299891.0,6,6,412,4,272,99963.66666666669,74.0,68.0,2,140,0.0,74.0,70.0
322.0,17,2,174,1,79,0.0,79.0,79.0,1,95,0.0,95.0,95.0
98063866.0,6,397,49880,199,13356,495272.0505050505,140.0,67.11557788944724,198,36524,496589.345177665,464.0,184.46464646464648
46653.0,6,14,4740,7,653,6877.333333333333,249.0,93.28571428571428,7,4087,7631.333333333333,1514.0,583.8571428571429
52996.0,6,14,4740,7,653,8610.5,249.0,93.28571428571428,7,4087,7968.833333333333,1514.0,583.8571428571429
9325.0,17,2,498,1,80,0.0,80.0,80.0,1,418,0.0,418.0,418.0
2576687.0,6,2,132,1,66,0.0,66.0,66.0,1,66,0.0,66.0,66.0
135132731.0,17,6,1146,6,1146,27026546.2,191.0,191.0,0,0,0.0,0.0,0.0
1306051.0,6,4,264,2,132,0.0,66.0,66.0,2,132,0.0,66.0,66.0
248367.0,6,3,373,2,238,0.0,172.0,119.0,1,135,0.0,135.0,135.0
14354.0,17,2,614,1,72,0.0,72.0,72.0,1,542,0.0,542.0,542.0
1164209.0,6,13,3010,8,2382,166315.57142857142,1514.0,297.75,5,628,222925.0,331.0,125.6
2298.0,17,4,344,2,150,0.0,75.0,75.0,2,194,0.0,103.0,97.0
105626508.0,17,14,864,7,432,17501048.166666668,174.0,61.71428571428572,7,432,17500200.666666668,174.0,61.71428571428572
309003.0,6,6,412,4,272,103001.0,74.0,68.0,2,140,0.0,74.0,70.0
90938686.0,6,21,1585,11,840,9093147.9,95.0,76.36363636363636,10,745,10103352.666666666,95.0,74.5
2407.0,17,4,344,2,150,0.0,75.0,75.0,2,194,0.0,103.0,97.0
2392.0,17,4,344,2,150,0.0,75.0,75.0,2,194,0.0,103.0,97.0
98279257.0,6,31,2308,16,1140,6551921.8,123.0,71.25,15,1168,6471224.0,139.0,77.86666666666666
2055.0,17,4,344,2,150,0.0,75.0,75.0,2,194,0.0,103.0,97.0
104386.0,17,2,286,2,286,0.0,143.0,143.0,0,0,0.0,0.0,0.0
234659.0,6,3,373,2,238,0.0,172.0,119.0,1,135,0.0,135.0,135.0
17495.0,6,14,4740,7,653,2658.0,249.0,93.28571428571428,7,4087,2778.5,1514.0,583.8571428571429
2405.0,17,4,344,2,150,0.0,75.0,75.0,2,194,0.0,103.0,97.0
1227834.0,17,7,490,7,490,204639.0,70.0,70.0,0,0,0.0,0.0,0.0
44974.0,6,10,2032,5,524,9422.5,252.0,104.8,5,1508,10519.5,1236.0,301.6
109443.0,17,2,700,2,700,0.0,350.0,350.0,0,0,0.0,0.0,0.0
145913.0,17,2,363,1,75,0.0,75.0,75.0,1,288,0.0,288.0,288.0
232301.0,6,3,337,2,214,0.0,160.0,107.0,1,123,0.0,123.0,123.0
217858.0,6,12,1373,7,714,36309.66666666666,298.0,102.0,5,659,53363.75,379.0,131.8
100547830.0,17,12,778,6,389,20109566.0,174.0,64.83333333333333,6,389,19954269.2,174.0,64.83333333333333
328.0,17,2,160,1,80,0.0,80.0,80.0,1,80,0.0,80.0,80.0
309792.0,6,6,412,4,272,103264.0,74.0,68.0,2,140,0.0,74.0,70.0
11130.0,6,10,2032,5,524,2527.75,252.0,104.8,5,1508,2100.25,1236.0,301.6
2351.0,17,4,344,2,150,0.0,75.0,75.0,2,194,0.0,103.0,97.0
90029201.0,17,28,13364,28,13364,3334414.851851852,501.0,477.2857142857143,0,0,0.0,0.0,0.0
90529792.0,6,13,2036,8,1016,12932827.42857143,188.0,127.0,5,1020,22591144.0,204.0,204.0
2288.0,17,4,344,2,150,0.0,75.0,75.0,2,194,0.0,103.0,97.0
90028061.0,17,28,13364,28,13364,3334372.6296296297,501.0,477.2857142857143,0,0,0.0,0.0,0.0
113360200.0,6,207,23268,104,7086,1100584.4660194174,140.0,68.13461538461539,103,16182,1101190.2352941176,284.0,157.10679611650485
50320.0,6,13,1479,7,882,8197.333333333334,291.0,126.0,6,597,9152.6,259.0,99.5
2628046.0,6,25,7573,14,3735,202157.38461538465,1514.0,266.7857142857143,11,3838,237182.0,1514.0,348.90909090909093
232178.0,6,3,337,2,214,0.0,160.0,107.0,1,123,0.0,123.0,123.0
308586.0,6,6,412,4,272,102862.0,74.0,68.0,2,140,0.0,74.0,70.0
95494340.0,17,14,1126,7,563,15885803.0,174.0,80.42857142857143,7,563,15869836.666666666,174.0,80.42857142857143
34603.0,6,14,4740,7,653,5492.333333333333,249.0,93.28571428571428,7,4087,5472.0,1514.0,583.8571428571429
237399.0,17,2,180,1,90,0.0,90.0,90.0,1,90,0.0,90.0,90.0
254090.0,6,3,337,2,214,0.0,160.0,107.0,1,123,0.0,123.0,123.0
135135853.0,17,6,1206,6,1206,27027170.6,201.0,201.0,0,0,0.0,0.0,0.0
120002623.0,6,17,1287,9,691,15000327.875,95.0,76.77777777777777,8,596,12897801.0,95.0,74.5
40852.0,6,10,2032,5,524,9962.0,252.0,104.8,5,1508,9175.75,1236.0,301.6
303781.0,6,6,412,4,272,101260.33333333331,74.0,68.0,2,140,0.0,74.0,70.0
525320.0,6,5,336,2,134,0.0,68.0,67.0,3,202,203002.0,70.0,67.33333333333333
90536842.0,6,14,2240,8,1016,12933834.57142857,188.0,127.0,6,1224,18072782.8,204.0,204.0
37636.0,6,10,2032,5,524,9181.0,252.0,104.8,5,1508,9105.5,1236.0,301.6
120006109.0,17,14,995,7,563,20001018.166666668,174.0,80.42857142857143,7,432,16760477.0,174.0,61.71428571428572
110008729.0,17,13,821,7,432,18334788.166666668,174.0,61.71428571428572,6,389,18000169.0,174.0,64.83333333333333
119850641.0,17,16,1212,8,606,17121520.14285714,174.0,75.75,8,606,17012593.57142857,174.0,75.75
2023.0,17,4,344,2,150,0.0,75.0,75.0,2,194,0.0,103.0,97.0
325.0,17,2,174,1,79,0.0,79.0,79.0,1,95,0.0,95.0,95.0
158110.0,6,3,337,2,214,0.0,160.0,107.0,1,123,0.0,123.0,123.0
90223168.0,6,25,1924,11,840,8997493.0,95.0,76.36363636363636,14,1084,6923685.153846154,95.0,77.42857142857143
102869.0,17,2,286,2,286,0.0,143.0,143.0,0,0,0.0,0.0,0.0
144142.0,17,2,180,1,90,0.0,90.0,90.0,1,90,0.0,90.0,90.0
303281.0,6,6,412,4,272,101093.66666666669,74.0,68.0,2,140,0.0,74.0,70.0
108108437.0,17,5,1005,5,1005,27027109.25,201.0,201.0,0,0,0.0,0.0,0.0
362657.0,17,2,180,1,90,0.0,90.0,90.0,1,90,0.0,90.0,90.0
23022180.0,17,3,1034,2,684,0.0,342.0,342.0,1,350,0.0,350.0,350.0
49033.0,6,12,1413,7,882,8172.166666666667,291.0,126.0,5,531,9410.0,259.0,106.2
303064.0,6,2,132,1,66,0.0,66.0,66.0,1,66,0.0,66.0,66.0
262221.0,6,3,337,2,214,0.0,160.0,107.0,1,123,0.0,123.0,123.0
220293.0,6,3,426,2,280,0.0,214.0,140.0,1,146,0.0,146.0,146.0
16927.0,6,10,2032,5,524,4022.25,252.0,104.8,5,1508,3972.25,1236.0,301.6
90260115.0,6,12,1832,8,1016,12894302.142857144,188.0,127.0,4,816,30031618.666666668,204.0,204.0
1036.0,17,5,550,5,550,259.0,110.0,110.0,0,0,0.0,0.0,0.0
120052972.0,17,29,13785,29,13785,4287606.142857143,501.0,475.3448275862069,0,0,0.0,0.0,0.0
135488.0,6,2,132,1,66,0.0,66.0,66.0,1,66,0.0,66.0,66.0
1314566.0,6,4,264,2,132,0.0,66.0,66.0,2,132,0.0,66.0,66.0
115481739.0,6,47,3102,24,1584,5020932.956521739,66.0,66.0,23,1518,5159997.954545454,66.0,66.0
210908.0,17,3,1143,3,1143,105454.0,381.0,381.0,0,0,0.0,0.0,0.0
237036.0,6,3,337,2,214,0.0,160.0,107.0,1,123,0.0,123.0,123.0
43036.0,6,14,4740,7,653,7002.666666666667,249.0,93.28571428571428,7,4087,6351.333333333333,1514.0,583.8571428571429
9455.0,17,2,582,1,83,0.0,83.0,83.0,1,499,0.0,499.0,499.0
14985.0,17,2,180,1,90,0.0,90.0,90.0,1,90,0.0,90.0,90.0
42800.0,6,14,4740,7,653,6986.0,249.0,93.28571428571428,7,4087,6792.0,1514.0,583.8571428571429
13018.0,6,13,1459,7,862,1979.8333333333333,271.0,123.14285714285714,6,597,2126.6,259.0,99.5
40440.0,6,10,2032,5,524,9839.0,252.0,104.8,5,1508,8800.25,1236.0,301.6
41828.0,6,14,4740,7,653,6704.833333333333,249.0,93.28571428571428,7,4087,6752.5,1514.0,583.8571428571429
10945930.0,6,8,544,4,272,3603090.6666666665,74.0,68.0,4,272,3603025.3333333335,74.0,68.0
105511.0,17,2,286,2,286,0.0,143.0,143.0,0,0,0.0,0.0,0.0
120590.0,6,3,337,2,214,0.0,160.0,107.0,1,123,0.0,123.0,123.0
78112881.0,17,30,10500,30,10500,2693547.620689655,350.0,350.0,0,0,0.0,0.0,0.0
1167305.0,6,13,3010,8,2382,166757.85714285713,1514.0,297.75,5,628,222882.0,331.0,125.6
45830.0,6,14,4740,7,653,7518.0,249.0,93.28571428571428,7,4087,7017.666666666667,1514.0,583.8571428571429
120029178.0,17,29,13785,29,13785,4286756.357142857,501.0,475.3448275862069,0,0,0.0,0.0,0.0
117009823.0,6,30,1974,15,1026,8342430.071428572,123.0,68.4,15,948,8342426.928571428,123.0,63.2
111028062.0,6,30,1974,15,1026,7915139.0,123.0,68.4,15,948,7915143.0,123.0,63.2
139319.0,6,2,132,1,66,0.0,66.0,66.0,1,66,0.0,66.0,66.0
0.0,6,1,172,1,172,0.0,172.0,172.0,0,0,0.0,0.0,0.0
90060078.0,17,28,13364,28,13364,3335558.4444444445,501.0,477.2857142857143,0,0,0.0,0.0,0.0
108104461.0,17,5,1005,5,1005,27026115.25,201.0,201.0,0,0,0.0,0.0,0.0
219922.0,6,12,1373,7,714,36653.66666666666,298.0,102.0,5,659,53973.5,379.0,131.8
120311249.0,6,16,1233,8,637,17187321.285714287,95.0,79.625,8,596,17106269.42857143,95.0,74.5
135126135.0,17,6,1206,6,1206,27025227.0,201.0,201.0,0,0,0.0,0.0,0.0
106983090.0,6,24,11278,12,1734,7480987.181818182,408.0,144.5,12,9544,9423869.545454543,1514.0,795.3333333333334
312679.0,17,4,1400,4,1400,104226.33333333331,350.0,350.0,0,0,0.0,0.0,0.0
153369.0,17,2,180,1,90,0.0,90.0,90.0,1,90,0.0,90.0,90.0
302395.0,6,2,132,1,66,0.0,66.0,66.0,1,66,0.0,66.0,66.0
135140135.0,17,6,1146,6,1146,27028027.0,191.0,191.0,0,0,0.0,0.0,0.0
52961.0,6,14,4740,7,653,8421.0,249.0,93.28571428571428,7,4087,8635.833333333334,1514.0,583.8571428571429
317.0,17,2,174,1,79,0.0,79.0,79.0,1,95,0.0,95.0,95.0
956245.0,6,13,1428,7,797,159105.16666666666,253.0,113.85714285714286,6,631,190729.4,293.0,105.16666666666669
107782.0,17,2,700,2,700,0.0,350.0,350.0,0,0,0.0,0.0,0.0
28250.0,6,14,4740,7,653,4273.666666666667,249.0,93.28571428571428,7,4087,4146.166666666667,1514.0,583.8571428571429
102569.0,17,2,286,2,286,0.0,143.0,143.0,0,0,0.0,0.0,0.0
27203.0,6,14,4740,7,653,4249.333333333333,249.0,93.28571428571428,7,4087,3228.6666666666665,1514.0,583.8571428571429
322764.0,17,4,1400,4,1400,107588.0,350.0,350.0,0,0,0.0,0.0,0.0
120222972.0,6,18,1341,9,691,14997091.0,95.0,76.77777777777777,9,650,14996246.25,95.0,72.22222222222223
19118.0,6,14,4740,7,653,2874.333333333333,249.0,93.28571428571428,7,4087,2597.6666666666665,1514.0,583.8571428571429
121285867.0,6,223,25246,112,17624,1092665.4684684684,284.0,157.35714285714286,111,7622,1084863.0727272728,140.0,68.66666666666667
45567.0,6,14,4740,7,653,7410.5,249.0,93.28571428571428,7,4087,6509.166666666667,1514.0,583.8571428571429
1211753.0,17,7,490,7,490,201958.8333333333,70.0,70.0,0,0,0.0,0.0,0.0
28485.0,6,14,4740,7,653,4418.666666666667,249.0,93.28571428571428,7,4087,4611.0,1514.0,583.8571428571429
209479.0,17,2,180,1,90,0.0,90.0,90.0,1,90,0.0,90.0,90.0
302430.0,6,2,132,1,66,0.0,66.0,66.0,1,66,0.0,66.0,66.0
624399.0,17,2,762,2,762,0.0,381.0,381.0,0,0,0.0,0.0,0.0
119637632.0,6,224,25328,112,17714,1075877.8468468469,284.0,158.16071428571428,112,7614,1075877.5135135136,140.0,67.98214285714286
35848064.0,6,26,7627,14,3735,195375.3076923077,1514.0,266.7857142857143,12,3892,3239215.090909091,1514.0,324.3333333333333
147987.0,17,2,180,1,90,0.0,90.0,90.0,1,90,0.0,90.0,90.0
736360.0,6,6,758,3,410,328256.0,172.0,136.66666666666666,3,348,241820.5,135.0,116.0
734.0,17,4,438,2,148,0.0,74.0,74.0,2,290,0.0,147.0,145.0
150024.0,6,3,337,2,214,0.0,160.0,107.0,1,123,0.0,123.0,123.0
120021722.0,17,28,13364,28,13364,4445248.962962963,501.0,477.2857142857143,0,0,0.0,0.0,0.0
205677.0,17,2,180,1,90,0.0,90.0,90.0,1,90,0.0,90.0,90.0
100510639.0,17,12,778,6,389,20000944.2,174.0,64.83333333333333,6,389,20000162.4,174.0,64.83333333333333
90259110.0,6,14,2240,8,1016,12894158.57142857,188.0,127.0,6,1224,18019144.8,204.0,204.0
10513.0,6,10,1067,5,536,2466.0,264.0,107.2,5,531,2202.5,259.0,106.2
1299525.0,6,4,264,2,132,0.0,66.0,66.0,2,132,0.0,66.0,66.0
90280468.0,6,16,1192,8,596,12891485.0,95.0,74.5,8,596,12895353.142857144,95.0,74.5
90272700.0,6,27,1954,14,1045,6927417.615384615,139.0,74.64285714285714,13,909,7504736.833333333,123.0,69.92307692307692
108117141.0,17,5,1005,5,1005,27029285.25,201.0,201.0,0,0,0.0,0.0,0.0
16060.000000000002,6,13,1459,7,862,2460.1666666666665,271.0,123.14285714285714,6,597,2930.8,259.0,99.5
276722.0,6,10,1221,6,636,55344.4,298.0,106.0,4,585,86877.0,379.0,146.25
135132932.0,17,6,1146,6,1146,27026586.4,191.0,191.0,0,0,0.0,0.0,0.0
319171.0,17,4,1400,4,1400,106390.33333333331,350.0,350.0,0,0,0.0,0.0,0.0
306966.0,6,6,412,4,272,102322.0,74.0,68.0,2,140,0.0,74.0,70.0
14644392.0,6,20,1607,10,975,1592456.5555555555,315.0,97.5,10,632,1592440.5555555555,78.0,63.2
90270277.0,6,13,2036,8,1016,12895753.857142856,188.0,127.0,5,1020,22525362.0,204.0,204.0
120000003.0,6,17,1287,9,691,15000000.375,95.0,76.77777777777777,8,596,12896689.857142856,95.0,74.5
90042370.0,17,28,13364,28,13364,3334902.592592593,501.0,477.2857142857143,0,0,0.0,0.0,0.0
4604.0,17,2,180,1,90,0.0,90.0,90.0,1,90,0.0,90.0,90.0
147876.0,17,2,180,1,90,0.0,90.0,90.0,1,90,0.0,90.0,90.0
321.0,17,2,174,1,79,0.0,79.0,79.0,1,95,0.0,95.0,95.0
121379405.0,6,217,24596,108,7350,1117155.1214953272,140.0,68.05555555555556,109,17246,1116212.148148148,284.0,158.22018348623854
2066.0,17,4,344,2,150,0.0,75.0,75.0,2,194,0.0,103.0,97.0
1302689.0,6,4,264,2,132,0.0,66.0,66.0,2,132,0.0,66.0,66.0
90011887.0,6,17,1406,9,851,11251485.875,255.0,94.55555555555556,8,555,12816661.57142857,95.0,69.375
209627.0,6,3,426,2,280,0.0,214.0,140.0,1,146,0.0,146.0,146.0
302362.0,6,6,412,4,272,100787.33333333331,74.0,68.0,2,140,0.0,74.0,70.0
457.0,17,2,410,1,78,0.0,78.0,78.0,1,332,0.0,332.0,332.0
17664.0,6,13,1459,7,862,2727.333333333333,271.0,123.14285714285714,6,597,3210.0,259.0,99.5
121005821.0,17,15,1169,8,606,17286545.85714286,174.0,75.75,7,563,16833489.333333332,174.0,80.42857142857143
2406.0,17,4,344,2,150,0.0,75.0,75.0,2,194,0.0,103.0,97.0
751059.0,6,2,132,1,66,0.0,66.0,66.0,1,66,0.0,66.0,66.0
90257791.0,6,13,2036,8,1016,12893970.142857144,188.0,127.0,5,1020,22519130.75,204.0,204.0
90053909.0,17,28,13364,28,13364,3335329.962962963,501.0,477.2857142857143,0,0,0.0,0.0,0.0
90301241.0,6,15,1097,8,596,12900177.285714284,95.0,74.5,7,501,15001211.0,95.0,71.57142857142857
41405.0,6,14,4740,7,653,6442.833333333333,249.0,93.28571428571428,7,4087,6581.166666666667,1514.0,583.8571428571429
3992832.0,6,158,121988,86,112935,46974.49411764706,1510.0,1313.1976744186047,72,9053,51899.47887323944,1510.0,125.73611111111111
103738.0,17,2,700,2,700,0.0,350.0,350.0,0,0,0.0,0.0,0.0
120367.0,17,2,180,1,70,0.0,70.0,70.0,1,110,0.0,110.0,110.0
2796036.0,6,2,132,1,66,0.0,66.0,66.0,1,66,0.0,66.0,66.0
14284.0,17,2,180,1,90,0.0,90.0,90.0,1,90,0.0,90.0,90.0
0.0,17,1,453,1,453,0.0,453.0,453.0,0,0,0.0,0.0,0.0
103416867.0,6,44,2904,22,1452,4924612.714285715,66.0,66.0,22,1452,4911486.80952381,66.0,66.0
228279.0,17,2,180,1,90,0.0,90.0,90.0,1,90,0.0,90.0,90.0
308805.0,6,6,412,4,272,102935.0,74.0,68.0,2,140,0.0,74.0,70.0
304051.0,6,6,412,4,272,101350.33333333331,74.0,68.0,2,140,0.0,74.0,70.0
301.0,17,2,168,1,76,0.0,76.0,76.0,1,92,0.0,92.0,92.0
6723.0,17,4,438,2,148,0.0,74.0,74.0,2,290,0.0,147.0,145.0
39979.0,6,14,4740,7,653,6537.5,249.0,93.28571428571428,7,4087,6264.5,1514.0,583.8571428571429
153394.0,17,2,180,1,90,0.0,90.0,90.0,1,90,0.0,90.0,90.0
299882.0,6,3,202,2,128,0.0,74.0,64.0,1,74,0.0,74.0,74.0
300720.0,17,2,586,1,81,0.0,81.0,81.0,1,505,0.0,505.0,505.0
103221.0,17,2,286,2,286,0.0,143.0,143.0,0,0,0.0,0.0,0.0
153444.0,17,2,180,1,90,0.0,90.0,90.0,1,90,0.0,90.0,90.0
36743.0,6,14,4740,7,653,5612.5,249.0,93.28571428571428,7,4087,5024.666666666667,1514.0,583.8571428571429
853684.0,6,9,1096,6,625,170736.8,287.0,104.16666666666669,3,471,289207.5,331.0,157.0
92042386.0,17,12,778,6,389,18400181.2,174.0,64.83333333333333,6,389,18401679.0,174.0,64.83333333333333
14646618.0,6,20,1607,10,975,1593213.5555555555,315.0,97.5,10,632,1593188.5555555555,78.0,63.2
120322240.0,6,223,25150,112,17602,1083984.144144144,284.0,157.16071428571428,111,7548,1084464.518181818,140.0,68.0
311204.0,17,4,1400,4,1400,103734.66666666669,350.0,350.0,0,0,0.0,0.0,0.0
1181853.0,6,13,3010,8,2382,168836.14285714287,1514.0,297.75,5,628,227297.25,331.0,125.6
216534.0,17,2,180,1,90,0.0,90.0,90.0,1,90,0.0,90.0,90.0
2000.0,17,4,344,2,150,0.0,75.0,75.0,2,194,0.0,103.0,97.0
110546284.0,6,32,2220,16,1149,7355375.266666667,123.0,71.8125,16,1071,7355372.4,123.0,66.9375
133013158.0,17,15,907,8,475,19001879.71428572,174.0,59.375,7,432,19000164.0,174.0,61.71428571428572
275481.0,6,10,1221,6,636,55096.2,298.0,106.0,4,585,85583.33333333333,379.0,146.25
108103867.0,17,5,955,5,955,27025966.75,191.0,191.0,0,0,0.0,0.0,0.0
302035.0,6,6,412,4,272,100678.33333333331,74.0,68.0,2,140,0.0,74.0,70.0
209455.0,17,2,180,1,90,0.0,90.0,90.0,1,90,0.0,90.0,90.0
1322.0,17,2,684,2,684,0.0,342.0,342.0,0,0,0.0,0.0,0.0
20166.0,17,2,582,1,83,0.0,83.0,83.0,1,499,0.0,499.0,499.0
104362161.0,6,32,2236,16,1165,6943087.866666666,139.0,72.8125,16,1071,6943091.4,123.0,66.9375
142112.0,6,2,132,1,66,0.0,66.0,66.0,1,66,0.0,66.0,66.0
51728575.0,6,8,2113,3,960,24519135.0,826.0,320.0,5,1153,12236939.5,885.0,230.6
148056.0,17,2,180,1,90,0.0,90.0,90.0,1,90,0.0,90.0,90.0
146577.0,6,3,337,2,214,0.0,160.0,107.0,1,123,0.0,123.0,123.0
146768.0,6,3,337,2,214,0.0,160.0,107.0,1,123,0.0,123.0,123.0
206379.0,6,3,426,2,280,0.0,214.0,140.0,1,146,0.0,146.0,146.0
300291.0,6,6,412,4,272,100097.0,74.0,68.0,2,140,0.0,74.0,70.0
3343562.0,6,7,923,4,753,1046033.0,571.0,188.25,3,170,1569354.5,62.0,56.66666666666666
4146.0,17,2,598,1,72,0.0,72.0,72.0,1,526,0.0,526.0,526.0
302534.0,6,10,1221,6,636,60506.8,298.0,106.0,4,585,95069.0,379.0,146.25
109677.0,17,4,1400,4,1400,36559.0,350.0,350.0,0,0,0.0,0.0,0.0
5004825.0,17,4,849,2,166,0.0,83.0,83.0,2,683,0.0,499.0,341.5
1052756.0,6,2,132,1,66,0.0,66.0,66.0,1,66,0.0,66.0,66.0
149454.0,6,3,337,2,214,0.0,160.0,107.0,1,123,0.0,123.0,123.0
214247.0,6,10,1221,6,636,42849.4,298.0,106.0,4,585,70039.66666666667,379.0,146.25
233215.0,6,3,373,2,238,0.0,172.0,119.0,1,135,0.0,135.0,135.0
28865.0,6,14,4740,7,653,4560.166666666667,249.0,93.28571428571428,7,4087,4632.833333333333,1514.0,583.8571428571429
90261692.0,6,13,2036,8,1016,12894527.42857143,188.0,127.0,5,1020,22525073.0,204.0,204.0
146288.0,6,3,337,2,214,0.0,160.0,107.0,1,123,0.0,123.0,123.0
811.0,17,4,438,2,148,0.0,74.0,74.0,2,290,0.0,147.0,145.0
228604.0,17,2,180,1,90,0.0,90.0,90.0,1,90,0.0,90.0,90.0
29402.0,6,14,4740,7,653,4690.5,249.0,93.28571428571428,7,4087,4770.333333333333,1514.0,583.8571428571429
93386292.0,6,40,2640,20,1320,4915068.0,66.0,66.0,20,1320,4897925.105263158,66.0,66.0
2274.0,17,4,344,2,150,0.0,75.0,75.0,2,194,0.0,103.0,97.0
2475663.0,6,25,7573,14,3735,190435.6153846153,1514.0,266.7857142857143,11,3838,222809.8,1514.0,348.90909090909093
509320.0,6,4,270,2,134,0.0,68.0,67.0,2,136,0.0,70.0,68.0
5623187.0,6,5,336,2,134,0.0,68.0,67.0,3,202,1422468.5,70.0,67.33333333333333
108109883.0,17,5,1005,5,1005,27027470.75,201.0,201.0,0,0,0.0,0.0,0.0
47615478.0,6,8,2113,3,960,22461669.5,826.0,320.0,5,1153,11208486.0,885.0,230.6
217858.0,6,3,426,2,280,0.0,214.0,140.0,1,146,0.0,146.0,146.0
1516726.0,6,20,6434,12,1921,137884.18181818182,620.0,160.08333333333334,8,4513,178333.14285714287,1514.0,564.125
21724.0,6,10,2032,5,524,5064.0,252.0,104.8,5,1508,5050.25,1236.0,301.6
5624782.0,6,4,270,2,134,0.0,68.0,67.0,2,136,0.0,70.0,68.0
2362.0,17,4,344,2,150,0.0,75.0,75.0,2,194,0.0,103.0,97.0
118281711.0,6,48,3168,24,1584,5142683.0869565215,66.0,66.0,24,1584,5129264.956521739,66.0,66.0
2795256.0,6,2,132,1,66,0.0,66.0,66.0,1,66,0.0,66.0,66.0
116963810.0,6,29,3102,15,1559,8354030.0,427.0,103.93333333333334,14,1543,8996733.153846154,333.0,110.21428571428572
135148403.0,17,6,1206,6,1206,27029680.6,201.0,201.0,0,0,0.0,0.0,0.0
13594.0,6,11,2098,6,590,2647.4,252.0,98.33333333333331,5,1508,2786.0,1236.0,301.6
79424.0,6,14,4740,7,653,11339.833333333334,249.0,93.28571428571428,7,4087,13097.833333333334,1514.0,583.8571428571429
103377.0,17,2,286,2,286,0.0,143.0,143.0,0,0,0.0,0.0,0.0
90297261.0,6,16,1192,8,596,12892298.57142857,95.0,74.5,8,596,12899076.142857144,95.0,74.5
90264755.0,6,13,2036,8,1016,12894965.0,188.0,127.0,5,1020,22524924.0,204.0,204.0
90596815.0,6,27,1954,14,1045,6952391.769230769,139.0,74.64285714285714,13,909,7531756.333333333,123.0,69.92307692307692
118288496.0,6,219,24818,110,7482,1085215.5596330275,140.0,68.01818181818182,109,17336,1085742.638888889,284.0,159.045871559633
103225.0,17,2,286,2,286,0.0,143.0,143.0,0,0,0.0,0.0,0.0
90073470.0,17,28,13364,28,13364,3336054.4444444445,501.0,477.2857142857143,0,0,0.0,0.0,0.0
96907855.0,6,189,21286,95,6492,1030934.6276595744,140.0,68.33684210526316,94,14794,1030686.0967741936,284.0,157.38297872340425
113855335.0,6,47,3102,24,1584,4940846.173913044,66.0,66.0,23,1518,5105434.863636363,66.0,66.0
216570.0,6,3,426,2,280,0.0,214.0,140.0,1,146,0.0,146.0,146.0
143986.0,17,2,180,1,90,0.0,90.0,90.0,1,90,0.0,90.0,90.0
41985984.0,6,4,1670,3,917,20992992.0,785.0,305.6666666666667,1,753,0.0,753.0,753.0
52682.0,6,10,1066,5,490,10684.0,218.0,98.0,5,576,12494.0,304.0,115.2
108103546.0,17,5,1005,5,1005,27025886.5,201.0,201.0,0,0,0.0,0.0,0.0
55892.0,6,14,4740,7,653,9133.0,249.0,93.28571428571428,7,4087,8856.166666666666,1514.0,583.8571428571429
462.0,17,2,166,1,75,0.0,75.0,75.0,1,91,0.0,91.0,91.0
310026.0,17,4,1400,4,1400,103342.0,350.0,350.0,0,0,0.0,0.0,0.0
311590.0,17,4,1400,4,1400,103863.33333333331,350.0,350.0,0,0,0.0,0.0,0.0
146087.0,6,3,337,2,214,0.0,160.0,107.0,1,123,0.0,123.0,123.0
318230.0,17,4,1400,4,1400,106076.66666666669,350.0,350.0,0,0,0.0,0.0,0.0
106331.0,17,4,1400,4,1400,35443.666666666664,350.0,350.0,0,0,0.0,0.0,0.0
2316.0,17,4,344,2,150,0.0,75.0,75.0,2,194,0.0,103.0,97.0
206131.0,6,3,426,2,280,0.0,214.0,140.0,1,146,0.0,146.0,146.0
233795.0,6,3,337,2,214,0.0,160.0,107.0,1,123,0.0,123.0,123.0
153467.0,17,2,180,1,90,0.0,90.0,90.0,1,90,0.0,90.0,90.0
15046.0,17,2,180,1,90,0.0,90.0,90.0,1,90,0.0,90.0,90.0
111007729.0,6,32,2236,16,1165,7386119.266666667,139.0,72.8125,16,1071,7386132.066666666,123.0,66.9375
2952766.0,6,3,1777,2,951,0.0,885.0,475.5,1,826,0.0,826.0,826.0
176740.0,6,11,1132,6,556,34914.8,218.0,92.66666666666669,5,576,43895.5,304.0,115.2
507054.0,6,5,336,2,134,0.0,68.0,67.0,3,202,196706.5,70.0,67.33333333333333
2429.0,17,4,344,2,150,0.0,75.0,75.0,2,194,0.0,103.0,97.0
17535.0,6,10,2032,5,524,4160.25,252.0,104.8,5,1508,3824.75,1236.0,301.6
206758.0,6,3,426,2,280,0.0,214.0,140.0,1,146,0.0,146.0,146.0
120153976.0,17,14,864,7,432,19931033.5,174.0,61.71428571428572,7,432,19998982.5,174.0,61.71428571428572
119095371.0,6,30,1974,15,1026,8492168.285714285,123.0,68.4,15,948,8492165.92857143,123.0,63.2
10483180.0,6,7,478,4,272,3448153.0,74.0,68.0,3,206,5172144.0,74.0,68.66666666666667
153618.0,17,2,180,1,90,0.0,90.0,90.0,1,90,0.0,90.0,90.0
19734.0,6,14,4740,7,653,3124.6666666666665,249.0,93.28571428571428,7,4087,3148.6666666666665,1514.0,583.8571428571429
198132.0,17,2,180,1,90,0.0,90.0,90.0,1,90,0.0,90.0,90.0
111843256.0,6,32,2220,16,1149,7441820.133333334,123.0,71.8125,16,1071,7441829.2,123.0,66.9375
114323295.0,6,48,3168,24,1584,4970578.043478261,66.0,66.0,24,1584,4956976.652173913,66.0,66.0
307022.0,17,4,704,2,148,0.0,74.0,74.0,2,556,0.0,280.0,278.0
5384.0,17,2,614,1,72,0.0,72.0,72.0,1,542,0.0,542.0,542.0
233220.0,6,3,337,2,214,0.0,160.0,107.0,1,123,0.0,123.0,123.0
5003568.0,17,4,629,2,156,0.0,78.0,78.0,2,473,0.0,268.0,236.5
52978.0,6,14,4740,7,653,8445.5,249.0,93.28571428571428,7,4087,8486.833333333334,1514.0,583.8571428571429
109059335.0,6,32,2236,16,1165,7256231.066666666,139.0,72.8125,16,1071,7256230.866666666,123.0,66.9375
103219.0,17,2,286,2,286,0.0,143.0,143.0,0,0,0.0,0.0,0.0
120979041.0,6,33,2280,17,1209,7561190.0625,123.0,71.11764705882354,16,1071,7385158.533333333,123.0,66.9375
90280234.0,6,14,1043,7,542,15046705.666666666,95.0,77.42857142857143,7,501,14998246.166666666,95.0,71.57142857142857
90045757.0,17,27,12943,27,12943,3463298.346153846,501.0,479.3703703703704,0,0,0.0,0.0,0.0
109699.0,17,4,1400,4,1400,36566.333333333336,350.0,350.0,0,0,0.0,0.0,0.0
34354.0,6,14,4740,7,653,5561.666666666667,249.0,93.28571428571428,7,4087,5585.666666666667,1514.0,583.8571428571429
318201.0,17,4,1400,4,1400,106067.0,350.0,350.0,0,0,0.0,0.0,0.0
193399.0,17,2,180,1,90,0.0,90.0,90.0,1,90,0.0,90.0,90.0
312116.0,6,6,412,4,272,104038.66666666669,74.0,68.0,2,140,0.0,74.0,70.0
108108014.0,17,5,955,5,955,27027003.5,191.0,191.0,0,0,0.0,0.0,0.0
90283703.0,6,17,1287,9,691,11280316.75,95.0,76.77777777777777,8,596,12896130.714285716,95.0,74.5
311396.0,17,4,1400,4,1400,103798.66666666669,350.0,350.0,0,0,0.0,0.0,0.0
218641.0,6,3,426,2,280,0.0,214.0,140.0,1,146,0.0,146.0,146.0
90011732.0,17,27,12943,27,12943,3461989.6923076925,501.0,479.3703703703704,0,0,0.0,0.0,0.0
30712.0,6,10,2032,5,524,7148.0,252.0,104.8,5,1508,7311.0,1236.0,301.6
148142.0,6,3,337,2,214,0.0,160.0,107.0,1,123,0.0,123.0,123.0
2391.0,17,4,344,2,150,0.0,75.0,75.0,2,194,0.0,103.0,97.0
90056645.0,17,28,13364,28,13364,3335431.296296296,501.0,477.2857142857143,0,0,0.0,0.0,0.0
2568725.0,6,2,132,1,66,0.0,66.0,66.0,1,66,0.0,66.0,66.0
17527.0,17,2,582,1,83,0.0,83.0,83.0,1,499,0.0,499.0,499.0
47177.0,6,12,1320,6,723,8429.0,253.0,120.5,6,597,8928.2,259.0,99.5
39642.0,6,10,2032,5,524,9657.5,252.0,104.8,5,1508,9201.0,1236.0,301.6
171658.0,17,2,180,1,90,0.0,90.0,90.0,1,90,0.0,90.0,90.0
3433.0,17,2,363,1,79,0.0,79.0,79.0,1,284,0.0,284.0,284.0
45345.0,6,12,1320,6,723,8451.2,253.0,120.5,6,597,7602.6,259.0,99.5
22108.0,6,10,2032,5,524,3950.5,252.0,104.8,5,1508,5168.0,1236.0,301.6
298880.0,6,6,412,4,272,99626.66666666669,74.0,68.0,2,140,0.0,74.0,70.0
115369908.0,6,39,2896,20,1425,6072100.421052632,123.0,71.25,19,1471,5842690.166666667,139.0,77.42105263157895
1518012.0,6,8,602,5,404,355063.75,103.0,80.8,3,198,204791.0,66.0,66.0
3046037.0,6,3,204,2,136,0.0,70.0,68.0,1,68,0.0,68.0,68.0
46810.0,6,13,1386,7,789,6761.5,253.0,112.71428571428572,6,597,8740.2,259.0,99.5
206882.0,6,3,426,2,280,0.0,214.0,140.0,1,146,0.0,146.0,146.0
90607219.0,6,26,1746,13,906,7532600.083333333,123.0,69.6923076923077,13,840,7532601.416666667,123.0,64.61538461538461
153399.0,17,2,180,1,90,0.0,90.0,90.0,1,90,0.0,90.0,90.0
156772.0,6,3,337,2,214,0.0,160.0,107.0,1,123,0.0,123.0,123.0
90257483.0,6,13,2036,8,1016,12893926.142857144,188.0,127.0,5,1020,22522207.75,204.0,204.0
31219.0,6,14,4740,7,653,5044.833333333333,249.0,93.28571428571428,7,4087,4554.333333333333,1514.0,583.8571428571429
45041.0,6,10,2032,5,524,10748.5,252.0,104.8,5,1508,10455.75,1236.0,301.6
218366.0,6,12,1373,7,714,36394.333333333336,298.0,102.0,5,659,53906.0,379.0,131.8
9001.0,17,2,582,1,83,0.0,83.0,83.0,1,499,0.0,499.0,499.0
197645.0,17,2,180,1,90,0.0,90.0,90.0,1,90,0.0,90.0,90.0
310151.0,17,4,704,2,148,0.0,74.0,74.0,2,556,0.0,280.0,278.0
135140700.0,17,6,1206,6,1206,27028140.0,201.0,201.0,0,0,0.0,0.0,0.0
5609207.0,6,5,336,2,134,0.0,68.0,67.0,3,202,1526540.0,70.0,67.33333333333333
113520242.0,6,46,3036,23,1518,5159998.681818182,66.0,66.0,23,1518,5159995.863636363,66.0,66.0
40317.0,6,14,4740,7,653,6482.5,249.0,93.28571428571428,7,4087,6176.333333333333,1514.0,583.8571428571429
114699.0,6,2,145,2,145,0.0,91.0,72.5,0,0,0.0,0.0,0.0
348.0,17,2,267,1,83,0.0,83.0,83.0,1,184,0.0,184.0,184.0
323.0,17,2,174,1,79,0.0,79.0,79.0,1,95,0.0,95.0,95.0
149494.0,17,2,414,1,88,0.0,88.0,88.0,1,326,0.0,326.0,326.0
108106870.0,17,5,955,5,955,27026717.5,191.0,191.0,0,0,0.0,0.0,0.0
2947670.0,6,159,118887,84,109635,35514.096385542165,1510.0,1305.178571428571,75,9252,35672.86486486487,1510.0,123.36
336.0,17,2,160,1,80,0.0,80.0,80.0,1,80,0.0,80.0,80.0
341525.0,6,2,132,1,66,0.0,66.0,66.0,1,66,0.0,66.0,66.0
315.0,17,2,174,1,79,0.0,79.0,79.0,1,95,0.0,95.0,95.0
305051.0,6,6,412,4,272,101683.66666666669,74.0,68.0,2,140,0.0,74.0,70.0
204426.0,17,2,762,2,762,0.0,381.0,381.0,0,0,0.0,0.0,0.0
121215.0,6,3,337,2,214,0.0,160.0,107.0,1,123,0.0,123.0,123.0
148969.0,17,2,414,1,88,0.0,88.0,88.0,1,326,0.0,326.0,326.0
111858.0,17,2,286,2,286,0.0,143.0,143.0,0,0,0.0,0.0,0.0
62402454.0,17,12,2250,6,469,12480426.4,89.0,78.16666666666667,6,1781,12478509.4,443.0,296.8333333333333
539661.0,17,6,2100,6,2100,107932.2,350.0,350.0,0,0,0.0,0.0,0.0
319.0,17,2,156,1,78,0.0,78.0,78.0,1,78,0.0,78.0,78.0
317256.0,6,6,412,4,272,105752.0,74.0,68.0,2,140,0.0,74.0,70.0
1313610.0,6,4,264,2,132,0.0,66.0,66.0,2,132,0.0,66.0,66.0
90031536.0,17,28,13364,28,13364,3334501.333333333,501.0,477.2857142857143,0,0,0.0,0.0,0.0
119999584.0,17,34,16284,34,16284,3636351.0303030303,501.0,478.9411764705882,0,0,0.0,0.0,0.0
120310729.0,6,224,25328,112,7614,1070631.9189189188,140.0,67.98214285714286,112,17714,1076579.990990991,284.0,158.16071428571428
47336.0,6,14,4740,7,653,7738.333333333333,249.0,93.28571428571428,7,4087,7720.333333333333,1514.0,583.8571428571429
9850.0,17,2,571,1,86,0.0,86.0,86.0,1,485,0.0,485.0,485.0
90258339.0,6,13,2036,8,1016,12894048.42857143,188.0,127.0,5,1020,22523325.5,204.0,204.0
119185952.0,6,33,2296,17,1225,7449122.0,139.0,72.05882352941177,16,1071,7265644.266666667,123.0,66.9375
103249.0,17,2,286,2,286,0.0,143.0,143.0,0,0,0.0,0.0,0.0
96408045.0,17,14,1126,7,563,16001142.666666666,174.0,80.42857142857143,7,563,16000129.666666666,174.0,80.42857142857143
90040955.0,17,28,13364,28,13364,3334850.185185185,501.0,477.2857142857143,0,0,0.0,0.0,0.0
2061.0,17,4,344,2,150,0.0,75.0,75.0,2,194,0.0,103.0,97.0
2259.0,17,4,344,2,150,0.0,75.0,75.0,2,194,0.0,103.0,97.0
1303539.0,6,4,264,2,132,0.0,66.0,66.0,2,132,0.0,66.0,66.0
5831143.0,6,5,336,2,134,0.0,68.0,67.0,3,202,1525401.5,70.0,67.33333333333333
107503905.0,6,34,2350,17,1225,6706159.875,139.0,72.05882352941177,17,1125,6706208.125,123.0,66.17647058823529
108108741.0,17,5,955,5,955,27027185.25,191.0,191.0,0,0,0.0,0.0,0.0
501039.0,6,5,336,2,134,0.0,68.0,67.0,3,202,194038.5,70.0,67.33333333333333
2296.0,17,4,344,2,150,0.0,75.0,75.0,2,194,0.0,103.0,97.0
285322.0,17,2,363,1,79,0.0,79.0,79.0,1,284,0.0,284.0,284.0
42399.0,6,14,4740,7,653,6755.666666666667,249.0,93.28571428571428,7,4087,5057.833333333333,1514.0,583.8571428571429
4110.0,17,4,344,2,150,0.0,75.0,75.0,2,194,0.0,103.0,97.0
108848736.0,6,30,1974,15,1026,7759480.857142857,123.0,68.4,15,948,7759479.428571428,123.0,63.2
302410.0,6,2,132,1,66,0.0,66.0,66.0,1,66,0.0,66.0,66.0
117922.0,17,4,1400,4,1400,39307.333333333336,350.0,350.0,0,0,0.0,0.0,0.0
35730.0,6,14,4740,7,653,5784.833333333333,249.0,93.28571428571428,7,4087,5797.833333333333,1514.0,583.8571428571429
2848.0,17,2,762,2,762,0.0,381.0,381.0,0,0,0.0,0.0,0.0
350391.0,17,4,622,4,622,116797.0,163.0,155.5,0,0,0.0,0.0,0.0
90013821.0,17,28,13364,28,13364,3333845.222222222,501.0,477.2857142857143,0,0,0.0,0.0,0.0
120071888.0,17,29,13785,29,13785,4288281.714285715,501.0,475.3448275862069,0,0,0.0,0.0,0.0
85.0,17,2,762,2,762,0.0,381.0,381.0,0,0,0.0,0.0,0.0
90093315.0,6,11,1644,4,816,30030323.33333333,204.0,204.0,7,828,15015145.0,188.0,118.28571428571428
25294.0,6,11,2098,6,590,4207.8,252.0,98.33333333333331,5,1508,5889.0,1236.0,301.6
144094.0,17,2,180,1,90,0.0,90.0,90.0,1,90,0.0,90.0,90.0
91816963.0,6,179,20176,90,6162,1031651.2696629212,140.0,68.46666666666667,89,14014,1019788.375,284.0,157.46067415730337
830427.0,6,9,1118,6,586,166085.4,248.0,97.66666666666669,3,532,278903.0,392.0,177.33333333333334
107790804.0,6,33,2428,17,1288,6724099.3125,139.0,75.76470588235294,16,1140,7172378.8,123.0,71.25
116161666.0,6,248,27864,124,8406,938701.1219512196,140.0,67.79032258064517,124,19458,937570.4146341464,284.0,156.9193548387097
37459.0,6,14,4740,7,653,5483.333333333333,249.0,93.28571428571428,7,4087,5340.666666666667,1514.0,583.8571428571429
1049365.0,6,2,132,1,66,0.0,66.0,66.0,1,66,0.0,66.0,66.0
96284848.0,6,25,1702,13,840,8023737.333333333,123.0,64.61538461538461,12,862,7825783.909090909,139.0,71.83333333333333
123455976.0,6,49,3234,25,1650,5143999.0,66.0,66.0,24,1584,5175143.434782608,66.0,66.0
1581811.0,6,2,132,1,66,0.0,66.0,66.0,1,66,0.0,66.0,66.0
90329409.0,6,13,1898,8,1016,12904201.285714284,188.0,127.0,5,882,22541515.25,204.0,176.4
262168.0,17,4,1524,4,1524,87389.33333333333,381.0,381.0,0,0,0.0,0.0,0.0
111024194.0,6,32,2236,16,1165,7387210.133333334,139.0,72.8125,16,1071,7387204.066666666,123.0,66.9375
153423.0,17,2,180,1,90,0.0,90.0,90.0,1,90,0.0,90.0,90.0
498713.0,6,5,336,2,134,0.0,68.0,67.0,3,202,193332.0,70.0,67.33333333333333
13438.0,6,13,1459,7,862,2154.6666666666665,271.0,123.14285714285714,6,597,2403.0,259.0,99.5
90267243.0,6,18,1341,9,691,11283405.375,95.0,76.77777777777777,9,650,11248329.25,95.0,72.22222222222223
108105092.0,17,5,1005,5,1005,27026273.0,201.0,201.0,0,0,0.0,0.0,0.0
31438.0,6,10,2032,5,524,7626.0,252.0,104.8,5,1508,6600.25,1236.0,301.6
142653.0,17,4,344,2,150,0.0,75.0,75.0,2,194,0.0,103.0,97.0
108670426.0,6,31,2176,16,1071,7244695.066666666,123.0,66.9375,15,1105,7700288.071428572,139.0,73.66666666666667
14632548.0,6,20,1607,10,975,1591889.0,315.0,97.5,10,632,1591908.6666666667,78.0,63.2
95591265.0,17,15,5138,14,4788,5732054.076923077,342.0,342.0,1,350,0.0,350.0,350.0
32569.0,6,2,145,2,145,0.0,91.0,72.5,0,0,0.0,0.0,0.0
319.0,17,2,174,1,79,0.0,79.0,79.0,1,95,0.0,95.0,95.0
68617.0,6,14,4740,7,653,9673.166666666666,249.0,93.28571428571428,7,4087,10064.833333333334,1514.0,583.8571428571429
90287078.0,6,16,1192,8,596,12891878.857142856,95.0,74.5,8,596,12896550.0,95.0,74.5
320527.0,6,6,412,4,272,106842.33333333331,74.0,68.0,2,140,0.0,74.0,70.0
19012.0,6,10,2032,5,524,4325.75,252.0,104.8,5,1508,4586.25,1236.0,301.6
18907.0,17,2,582,1,83,0.0,83.0,83.0,1,499,0.0,499.0,499.0
1172631.0,6,13,3005,8,2377,167518.7142857143,1514.0,297.125,5,628,224231.75,331.0,125.6
103578.0,17,2,286,2,286,0.0,143.0,143.0,0,0,0.0,0.0,0.0
17077.0,6,14,4740,7,653,2562.833333333333,249.0,93.28571428571428,7,4087,2709.333333333333,1514.0,583.8571428571429
183775.0,17,2,762,2,762,0.0,381.0,381.0,0,0,0.0,0.0,0.0
10485093.0,6,7,478,4,272,3449434.333333333,74.0,68.0,3,206,5174026.5,74.0,68.66666666666667
7550.0,17,4,823,2,163,0.0,89.0,81.5,2,660,0.0,443.0,330.0
2369.0,17,4,344,2,150,0.0,75.0,75.0,2,194,0.0,103.0,97.0
15026.0,17,2,180,1,90,0.0,90.0,90.0,1,90,0.0,90.0,90.0
196986.0,17,2,180,1,90,0.0,90.0,90.0,1,90,0.0,90.0,90.0
246211.0,6,3,337,2,214,0.0,160.0,107.0,1,123,0.0,123.0,123.0
45388.0,6,14,4740,7,653,7285.333333333333,249.0,93.28571428571428,7,4087,6754.0,1514.0,583.8571428571429
27038.0,6,10,2032,5,524,6180.75,252.0,104.8,5,1508,6458.75,1236.0,301.6
157772.0,17,2,180,1,90,0.0,90.0,90.0,1,90,0.0,90.0,90.0
162322.0,17,2,180,1,90,0.0,90.0,90.0,1,90,0.0,90.0,90.0
108001161.0,17,13,821,7,432,18000193.5,174.0,61.71428571428572,6,389,17601036.0,174.0,64.83333333333333
108104610.0,17,5,1005,5,1005,27026152.5,201.0,201.0,0,0,0.0,0.0,0.0
24445863.0,17,5,1718,4,1368,847241.6666666666,342.0,342.0,1,350,0.0,350.0,350.0
2325.0,17,4,344,2,150,0.0,75.0,75.0,2,194,0.0,103.0,97.0
90349647.0,6,25,1686,13,840,7529137.25,123.0,64.61538461538461,12,846,7286192.090909091,123.0,70.5
223601.0,17,2,180,1,90,0.0,90.0,90.0,1,90,0.0,90.0,90.0
300309.0,6,6,412,4,272,100103.0,74.0,68.0,2,140,0.0,74.0,70.0
101952.0,17,2,762,2,762,0.0,381.0,381.0,0,0,0.0,0.0,0.0
100650781.0,6,30,2106,15,1089,7173924.785714285,123.0,72.6,15,1017,7173902.785714285,123.0,67.8
5626285.0,6,5,336,2,134,0.0,68.0,67.0,3,202,1417693.0,70.0,67.33333333333333
107551.0,17,2,762,2,762,0.0,381.0,381.0,0,0,0.0,0.0,0.0
329592.0,6,6,412,4,272,109864.0,74.0,68.0,2,140,0.0,74.0,70.0
316253.0,17,4,704,2,148,0.0,74.0,74.0,2,556,0.0,280.0,278.0
25075.0,6,10,2032,5,524,6052.75,252.0,104.8,5,1508,6015.75,1236.0,301.6
101849.0,6,12,1413,6,816,18304.0,291.0,136.0,6,597,18868.2,259.0,99.5
39883.0,6,14,4740,7,653,6255.5,249.0,93.28571428571428,7,4087,6437.666666666667,1514.0,583.8571428571429
30525.0,6,14,4740,7,653,4965.333333333333,249.0,93.28571428571428,7,4087,4797.5,1514.0,583.8571428571429
353.0,17,2,166,1,75,0.0,75.0,75.0,1,91,0.0,91.0,91.0
44255.0,6,14,4740,7,653,6810.666666666667,249.0,93.28571428571428,7,4087,7237.5,1514.0,583.8571428571429
24037.0,6,13,1459,7,862,3555.0,271.0,123.14285714285714,6,597,4002.2,259.0,99.5
135124776.0,17,6,1146,6,1146,27024955.2,191.0,191.0,0,0,0.0,0.0,0.0
192458.0,17,2,180,1,90,0.0,90.0,90.0,1,90,0.0,90.0,90.0
8525256.0,6,6,433,2,132,0.0,66.0,66.0,4,301,2841752.0,103.0,75.25
2360.0,17,4,344,2,150,0.0,75.0,75.0,2,194,0.0,103.0,97.0
1308547.0,6,4,264,2,132,0.0,66.0,66.0,2,132,0.0,66.0,66.0
108100629.0,17,5,1005,5,1005,27025157.25,201.0,201.0,0,0,0.0,0.0,0.0
904133.0,6,12,2710,7,743,150688.83333333334,339.0,106.14285714285714,5,1967,157220.5,1514.0,393.4
891411.0,6,12,2709,7,742,148568.5,338.0,106.0,5,1967,154054.0,1514.0,393.4
124236.0,17,4,1524,4,1524,41412.0,381.0,381.0,0,0,0.0,0.0,0.0
14653.0,17,2,180,1,90,0.0,90.0,90.0,1,90,0.0,90.0,90.0
1244377.0,6,7,499,4,301,395099.6666666667,103.0,75.25,3,198,613411.0,66.0,66.0
463.0,17,2,508,2,508,0.0,257.0,254.0,0,0,0.0,0.0,0.0
307461.0,6,6,412,4,272,102487.0,74.0,68.0,2,140,0.0,74.0,70.0
345.0,17,2,267,1,83,0.0,83.0,83.0,1,184,0.0,184.0,184.0
98931809.0,17,11,735,6,389,19754579.2,174.0,64.83333333333333,5,346,19748894.75,174.0,69.2
127500156.0,17,14,864,7,432,18002221.333333332,174.0,61.71428571428572,7,432,18000209.0,174.0,61.71428571428572
118988426.0,17,21,9513,21,9513,5949421.3,453.0,453.0,0,0,0.0,0.0,0.0
57298.0,6,10,2032,5,524,14095.75,252.0,104.8,5,1508,14062.25,1236.0,301.6
302374.0,6,2,132,1,66,0.0,66.0,66.0,1,66,0.0,66.0,66.0
2330.0,17,4,344,2,150,0.0,75.0,75.0,2,194,0.0,103.0,97.0
1306930.0,6,4,264,2,132,0.0,66.0,66.0,2,132,0.0,66.0,66.0
337002.0,6,6,412,4,272,112334.0,74.0,68.0,2,140,0.0,74.0,70.0
313068.0,17,4,1400,4,1400,104356.0,350.0,350.0,0,0,0.0,0.0,0.0
49914.0,6,14,4740,7,653,7815.666666666667,249.0,93.28571428571428,7,4087,7448.5,1514.0,583.8571428571429
49140.0,6,14,4740,7,653,8064.5,249.0,93.28571428571428,7,4087,7744.833333333333,1514.0,583.8571428571429
103342.0,17,2,286,2,286,0.0,143.0,143.0,0,0,0.0,0.0,0.0
90290095.0,6,12,1832,8,1016,12898585.0,188.0,127.0,4,816,30041611.666666668,204.0,204.0
317601.0,6,6,412,4,272,105867.0,74.0,68.0,2,140,0.0,74.0,70.0
35953.0,6,14,4740,7,653,5871.5,249.0,93.28571428571428,7,4087,5554.166666666667,1514.0,583.8571428571429
138440.0,6,10,1065,5,534,34075.75,262.0,106.8,5,531,31231.75,259.0,106.2
315624.0,17,4,1400,4,1400,105208.0,350.0,350.0,0,0,0.0,0.0,0.0
102902.0,17,2,286,2,286,0.0,143.0,143.0,0,0,0.0,0.0,0.0
860114.0,6,9,1118,6,586,172022.8,248.0,97.66666666666669,3,532,292253.5,392.0,177.33333333333334
37554.0,6,14,4740,7,653,5785.833333333333,249.0,93.28571428571428,7,4087,5851.166666666667,1514.0,583.8571428571429
120076663.0,17,28,13364,28,13364,4447283.814814814,501.0,477.2857142857143,0,0,0.0,0.0,0.0
10620974.0,6,6,412,3,206,5219564.5,74.0,68.66666666666667,3,206,5219428.0,74.0,68.66666666666667
90667492.0,6,24,1829,11,840,9042305.6,95.0,76.36363636363636,13,989,7538558.0,95.0,76.07692307692308
125826405.0,6,59,12341,29,6451,3433090.035714286,1514.0,222.44827586206893,30,5890,4331408.655172414,1514.0,196.3333333333333
135132133.0,17,6,1146,6,1146,27026426.6,191.0,191.0,0,0,0.0,0.0,0.0
101888518.0,6,28,1860,14,966,7820956.615384615,123.0,69.0,14,894,7820933.230769231,123.0,63.85714285714285
90579783.0,6,15,2444,8,1016,12939969.0,188.0,127.0,7,1428,15060229.5,204.0,204.0
2084496.0,6,20,6935,11,1567,208449.6,408.0,142.45454545454547,9,5368,216862.625,1514.0,596.4444444444445
28768.0,6,10,2032,5,524,6980.5,252.0,104.8,5,1508,6650.5,1236.0,301.6
36878.0,6,14,4740,7,653,5654.833333333333,249.0,93.28571428571428,7,4087,5641.166666666667,1514.0,583.8571428571429
2940880.0,6,3,1602,1,752,0.0,752.0,752.0,2,850,0.0,784.0,425.0
30702.0,6,10,2032,5,524,6624.25,252.0,104.8,5,1508,7065.75,1236.0,301.6
2436.0,17,4,344,2,150,0.0,75.0,75.0,2,194,0.0,103.0,97.0
10476123.0,6,7,478,4,272,3446592.0,74.0,68.0,3,206,5169767.5,74.0,68.66666666666667
90046600.0,17,28,13364,28,13364,3335059.25925926,501.0,477.2857142857143,0,0,0.0,0.0,0.0
2327.0,17,4,344,2,150,0.0,75.0,75.0,2,194,0.0,103.0,97.0
479533.0,6,3,1604,2,851,0.0,785.0,425.5,1,753,0.0,753.0,753.0
120051146.0,17,29,13785,29,13785,4287540.928571428,501.0,475.3448275862069,0,0,0.0,0.0,0.0
35936.0,6,14,4740,7,653,5862.666666666667,249.0,93.28571428571428,7,4087,5556.5,1514.0,583.8571428571429
228162.0,17,2,180,1,90,0.0,90.0,90.0,1,90,0.0,90.0,90.0
301126.0,6,6,412,4,272,100375.33333333331,74.0,68.0,2,140,0.0,74.0,70.0
1487.0,17,2,762,2,762,0.0,381.0,381.0,0,0,0.0,0.0,0.0
90023435.0,17,28,13364,28,13364,3334201.296296296,501.0,477.2857142857143,0,0,0.0,0.0,0.0
143895.0,17,2,180,1,90,0.0,90.0,90.0,1,90,0.0,90.0,90.0
17619.0,17,4,823,2,163,0.0,89.0,81.5,2,660,0.0,443.0,330.0
120056583.0,17,29,13785,29,13785,4287735.107142857,501.0,475.3448275862069,0,0,0.0,0.0,0.0
297927.0,6,6,412,4,272,99309.0,74.0,68.0,2,140,0.0,74.0,70.0
85764.0,6,14,4740,7,653,12540.0,249.0,93.28571428571428,7,4087,13170.666666666666,1514.0,583.8571428571429
804616.0,17,4,883,2,156,0.0,78.0,78.0,2,727,0.0,395.0,363.5
232955.0,6,3,373,2,238,0.0,172.0,119.0,1,135,0.0,135.0,135.0
103087.0,17,2,286,2,286,0.0,143.0,143.0,0,0,0.0,0.0,0.0
21632.0,6,14,4740,7,653,3447.1666666666665,249.0,93.28571428571428,7,4087,3370.1666666666665,1514.0,583.8571428571429
196748.0,17,2,180,1,90,0.0,90.0,90.0,1,90,0.0,90.0,90.0
114743205.0,6,48,3168,24,1584,4988835.0,66.0,66.0,24,1584,4975515.478260869,66.0,66.0
728208.0,6,10,1065,5,534,181411.0,262.0,106.8,5,531,181440.25,259.0,106.2
299.0,17,2,164,1,82,0.0,82.0,82.0,1,82,0.0,82.0,82.0
35332.0,6,14,4740,7,653,5100.666666666667,249.0,93.28571428571428,7,4087,5752.333333333333,1514.0,583.8571428571429
206052.0,17,2,762,2,762,0.0,381.0,381.0,0,0,0.0,0.0,0.0
298874.0,6,6,412,4,272,99624.66666666669,74.0,68.0,2,140,0.0,74.0,70.0
124011846.0,17,15,907,8,475,17715978.0,174.0,59.375,7,432,17333502.166666668,174.0,61.71428571428572
120012698.0,6,22,1680,12,935,10909082.545454543,95.0,77.91666666666667,10,745,13333368.0,95.0,74.5
60182.0,6,10,2032,5,524,14425.0,252.0,104.8,5,1508,13551.0,1236.0,301.6
197676.0,17,2,180,1,90,0.0,90.0,90.0,1,90,0.0,90.0,90.0
315370.0,17,4,1400,4,1400,105123.33333333331,350.0,350.0,0,0,0.0,0.0,0.0
17504944.0,6,8,472,2,124,0.0,62.0,62.0,6,348,3439398.2,58.0,58.0
308315.0,6,6,412,4,272,102771.66666666669,74.0,68.0,2,140,0.0,74.0,70.0
10611003.0,6,7,478,4,272,3476369.333333333,74.0,68.0,3,206,5214455.0,74.0,68.66666666666667
120038618.0,6,25,2045,12,894,10912601.636363637,95.0,74.5,13,1151,9982684.583333334,257.0,88.53846153846153
1220223.0,6,11,1134,6,558,244044.6,220.0,93.0,5,576,302879.5,304.0,115.2
553513.0,6,10,1221,6,636,110702.6,298.0,106.0,4,585,183533.0,379.0,146.25
1319.0,17,2,508,2,508,0.0,257.0,254.0,0,0,0.0,0.0,0.0
380058.0,6,10,1221,6,636,76011.6,298.0,106.0,4,585,124319.0,379.0,146.25
135122359.0,17,6,1206,6,1206,27024471.8,201.0,201.0,0,0,0.0,0.0,0.0
5524679.0,6,4,270,2,134,0.0,68.0,67.0,2,136,0.0,70.0,68.0
0.0,17,1,453,1,453,0.0,453.0,453.0,0,0,0.0,0.0,0.0
234514.0,6,3,373,2,238,0.0,172.0,119.0,1,135,0.0,135.0,135.0
108105416.0,17,5,1005,5,1005,27026354.0,201.0,201.0,0,0,0.0,0.0,0.0
101254281.0,6,32,2220,16,1149,6750285.4,123.0,71.8125,16,1071,6735880.0,123.0,66.9375
119922121.0,6,34,2488,18,1348,7041549.05882353,139.0,74.88888888888889,16,1140,7980396.866666666,123.0,71.25
308437.0,6,6,412,4,272,102812.33333333331,74.0,68.0,2,140,0.0,74.0,70.0
205827.0,17,2,180,1,90,0.0,90.0,90.0,1,90,0.0,90.0,90.0
120129030.0,6,17,2556,10,1392,13347670.0,188.0,139.2,7,1164,15014903.833333334,204.0,166.28571428571428
1053566.0,6,3,1604,1,753,0.0,753.0,753.0,2,851,0.0,785.0,425.5
1826.0,17,2,176,1,80,0.0,80.0,80.0,1,96,0.0,96.0,96.0
171660.0,17,2,180,1,90,0.0,90.0,90.0,1,90,0.0,90.0,90.0
309793.0,17,4,622,4,622,103264.33333333331,163.0,155.5,0,0,0.0,0.0,0.0
1491.0,17,2,762,2,762,0.0,381.0,381.0,0,0,0.0,0.0,0.0
66069.0,6,14,4740,7,653,10891.5,249.0,93.28571428571428,7,4087,10794.833333333334,1514.0,583.8571428571429
2788.0,17,5,550,5,550,697.0,110.0,110.0,0,0,0.0,0.0,0.0
122944929.0,6,33,2296,16,1071,7530660.2,123.0,66.9375,17,1225,7059997.0,139.0,72.05882352941177
320497.0,17,4,1400,4,1400,106832.33333333331,350.0,350.0,0,0,0.0,0.0,0.0
78888.0,6,14,4740,7,653,12988.5,249.0,93.28571428571428,7,4087,12418.5,1514.0,583.8571428571429
328.0,17,2,174,1,79,0.0,79.0,79.0,1,95,0.0,95.0,95.0
835534.0,6,9,1118,6,586,167106.8,248.0,97.66666666666669,3,532,281449.0,392.0,177.33333333333334
31675.0,6,14,4740,7,653,4975.333333333333,249.0,93.28571428571428,7,4087,5144.333333333333,1514.0,583.8571428571429
38826.0,6,10,2032,5,524,9476.25,252.0,104.8,5,1508,9357.25,1236.0,301.6
325212.0,17,2,166,1,75,0.0,75.0,75.0,1,91,0.0,91.0,91.0
22446.0,6,14,4740,7,653,3624.0,249.0,93.28571428571428,7,4087,3458.1666666666665,1514.0,583.8571428571429
135952.0,6,2,132,1,66,0.0,66.0,66.0,1,66,0.0,66.0,66.0
2433.0,17,4,344,2,150,0.0,75.0,75.0,2,194,0.0,103.0,97.0
227664.0,6,3,426,2,280,0.0,214.0,140.0,1,146,0.0,146.0,146.0
100430865.0,17,12,778,6,389,19991690.2,174.0,64.83333333333333,6,389,20053981.6,174.0,64.83333333333333
22672372.0,6,26,7627,14,3735,180530.7692307692,1514.0,266.7857142857143,12,3892,2041550.7272727275,1514.0,324.3333333333333
216233.0,17,2,180,1,90,0.0,90.0,90.0,1,90,0.0,90.0,90.0
2257.0,17,2,664,1,322,0.0,322.0,322.0,1,342,0.0,342.0,342.0
90044853.0,17,28,13364,28,13364,3334994.5555555555,501.0,477.2857142857143,0,0,0.0,0.0,0.0
90754891.0,6,22,1680,12,935,8246270.545454546,95.0,77.91666666666667,10,745,10051784.0,95.0,74.5
201752.0,17,2,180,1,90,0.0,90.0,90.0,1,90,0.0,90.0,90.0
60313.0,6,14,4740,7,653,9931.5,249.0,93.28571428571428,7,4087,9023.666666666666,1514.0,583.8571428571429
314157.0,17,4,1400,4,1400,104719.0,350.0,350.0,0,0,0.0,0.0,0.0
148080.0,17,2,180,1,90,0.0,90.0,90.0,1,90,0.0,90.0,90.0
8097.999999999999,17,2,538,1,81,0.0,81.0,81.0,1,457,0.0,457.0,457.0
0.0,17,1,179,1,179,0.0,179.0,179.0,0,0,0.0,0.0,0.0
830418.0,6,9,1118,6,586,166083.6,248.0,97.66666666666669,3,532,278997.5,392.0,177.33333333333334
51408586.0,17,4,360,2,180,0.0,90.0,90.0,2,180,0.0,90.0,90.0
103000990.0,17,14,864,7,432,17166831.666666668,174.0,61.71428571428572,7,432,17000888.666666668,174.0,61.71428571428572
166814.0,6,13,1386,7,789,27802.33333333333,253.0,112.71428571428572,6,597,30894.4,259.0,99.5
317280.0,17,4,1400,4,1400,105760.0,350.0,350.0,0,0,0.0,0.0,0.0
113352451.0,6,37,2788,19,1471,6297358.388888889,139.0,77.42105263157895,18,1317,6655069.0,123.0,73.16666666666667
90047077.0,17,28,13364,28,13364,3335076.925925926,501.0,477.2857142857143,0,0,0.0,0.0,0.0
28332.0,6,14,4740,7,653,3905.6666666666665,249.0,93.28571428571428,7,4087,3971.6666666666665,1514.0,583.8571428571429
106783.0,17,2,700,2,700,0.0,350.0,350.0,0,0,0.0,0.0,0.0
200819.0,17,4,6056,4,6056,66939.66666666667,1514.0,1514.0,0,0,0.0,0.0,0.0
108107896.0,17,5,955,5,955,27026974.0,191.0,191.0,0,0,0.0,0.0,0.0
301181.0,6,6,412,4,272,100393.66666666669,74.0,68.0,2,140,0.0,74.0,70.0
91584521.0,17,16,5472,16,5472,6105634.733333333,342.0,342.0,0,0,0.0,0.0,0.0
147948.0,17,2,180,1,90,0.0,90.0,90.0,1,90,0.0,90.0,90.0
40701.0,6,14,4740,7,653,6239.5,249.0,93.28571428571428,7,4087,6470.666666666667,1514.0,583.8571428571429
1303042.0,6,4,264,2,132,0.0,66.0,66.0,2,132,0.0,66.0,66.0
132571.0,6,2,132,1,66,0.0,66.0,66.0,1,66,0.0,66.0,66.0
197262.0,17,2,180,1,90,0.0,90.0,90.0,1,90,0.0,90.0,90.0
217846.0,6,3,426,2,280,0.0,214.0,140.0,1,146,0.0,146.0,146.0
298888.0,6,6,412,4,272,99629.33333333331,74.0,68.0,2,140,0.0,74.0,70.0
147974.0,17,2,180,1,90,0.0,90.0,90.0,1,90,0.0,90.0,90.0
4280.0,17,2,620,1,75,0.0,75.0,75.0,1,545,0.0,545.0,545.0
250437.00000000003,6,3,337,2,214,0.0,160.0,107.0,1,123,0.0,123.0,123.0
301186.0,6,6,412,4,272,100395.33333333331,74.0,68.0,2,140,0.0,74.0,70.0
1816.0,17,2,664,1,322,0.0,322.0,322.0,1,342,0.0,342.0,342.0
108109197.0,17,5,955,5,955,27027299.25,191.0,191.0,0,0,0.0,0.0,0.0
307890.0,6,3,202,2,128,0.0,74.0,64.0,1,74,0.0,74.0,74.0
120123092.0,6,13,2036,8,1016,17137009.714285713,188.0,127.0,5,1020,22514474.0,204.0,204.0
229565.0,17,2,359,1,75,0.0,75.0,75.0,1,284,0.0,284.0,284.0
2422.0,17,4,344,2,150,0.0,75.0,75.0,2,194,0.0,103.0,97.0
14940.0,6,10,1066,5,490,3563.0,218.0,98.0,5,576,3459.5,304.0,115.2
15883.000000000002,6,10,2032,5,524,3754.0,252.0,104.8,5,1508,3693.5,1236.0,301.6
357.0,17,2,267,1,83,0.0,83.0,83.0,1,184,0.0,184.0,184.0
24748.0,6,14,4740,7,653,3925.1666666666665,249.0,93.28571428571428,7,4087,3505.833333333333,1514.0,583.8571428571429
92438640.0,6,35,2950,20,1657,4853833.7894736845,139.0,82.85,15,1293,6587344.428571428,123.0,86.2
1276646.0,17,7,490,7,490,212774.3333333333,70.0,70.0,0,0,0.0,0.0,0.0
108102986.0,17,5,1005,5,1005,27025746.5,201.0,201.0,0,0,0.0,0.0,0.0
212518.0,6,10,1221,6,636,42503.6,298.0,106.0,4,585,69489.0,379.0,146.25
104769295.0,6,44,2904,22,1452,4989014.047619048,66.0,66.0,22,1452,4974361.476190476,66.0,66.0
90029659.0,17,28,13364,28,13364,3334431.814814815,501.0,477.2857142857143,0,0,0.0,0.0,0.0
193051.0,17,2,180,1,90,0.0,90.0,90.0,1,90,0.0,90.0,90.0
371650.0,6,11,1021,6,444,51323.2,162.0,74.0,5,577,63000.75,349.0,115.4
26010.0,6,10,1066,5,490,4850.5,218.0,98.0,5,576,6168.5,304.0,115.2
10597.0,17,2,398,1,88,0.0,88.0,88.0,1,310,0.0,310.0,310.0
24291.0,6,14,4740,7,653,3842.3333333333335,249.0,93.28571428571428,7,4087,3894.3333333333335,1514.0,583.8571428571429
50860.0,17,2,180,1,90,0.0,90.0,90.0,1,90,0.0,90.0,90.0
15288.0,17,2,180,1,90,0.0,90.0,90.0,1,90,0.0,90.0,90.0
90949404.0,6,21,1585,11,840,9093951.8,95.0,76.36363636363636,10,745,10104358.333333334,95.0,74.5
2344.0,17,4,344,2,150,0.0,75.0,75.0,2,194,0.0,103.0,97.0
1305589.0,6,4,264,2,132,0.0,66.0,66.0,2,132,0.0,66.0,66.0
865044.0,6,9,1096,6,625,173008.8,287.0,104.16666666666669,3,471,294796.5,331.0,157.0
107268.0,17,2,286,2,286,0.0,143.0,143.0,0,0,0.0,0.0,0.0
510705.0,6,5,336,2,134,0.0,68.0,67.0,3,202,195901.0,70.0,67.33333333333333
1028803.0,6,11,1134,6,558,205760.6,220.0,93.0,5,576,256318.75,304.0,115.2
27582.0,6,10,2032,5,524,4463.75,252.0,104.8,5,1508,6610.25,1236.0,301.6
93617.0,6,14,4740,7,653,14586.333333333334,249.0,93.28571428571428,7,4087,15411.0,1514.0,583.8571428571429
90013496.0,17,27,12943,27,12943,3462057.5384615385,501.0,479.3703703703704,0,0,0.0,0.0,0.0
321547.0,17,4,1400,4,1400,107182.33333333331,350.0,350.0,0,0,0.0,0.0,0.0
135119620.0,17,6,1146,6,1146,27023924.0,191.0,191.0,0,0,0.0,0.0,0.0
60265.0,6,14,4740,7,653,9691.5,249.0,93.28571428571428,7,4087,9598.666666666666,1514.0,583.8571428571429
24249.0,6,10,2032,5,524,5812.75,252.0,104.8,5,1508,5727.75,1236.0,301.6
118483784.0,6,252,29066,126,20528,946147.528,284.0,162.9206349206349,126,8538,946138.336,140.0,67.76190476190476
2127.0,17,4,344,2,150,0.0,75.0,75.0,2,194,0.0,103.0,97.0
0.0,6,1,54,0,0,0.0,0.0,0.0,1,54,0.0,54.0,54.0
110966423.0,6,34,2482,17,1288,6921882.75,139.0,75.76470588235294,17,1194,6921907.4375,123.0,70.23529411764706
120131903.0,6,238,26930,119,8150,1011025.254237288,140.0,68.4873949579832,119,18780,1012236.6440677966,300.0,157.81512605042016
135123876.0,17,6,1146,6,1146,27024775.2,191.0,191.0,0,0,0.0,0.0,0.0
142851.0,17,4,820,2,156,0.0,78.0,78.0,2,664,0.0,332.0,332.0
102994.0,17,2,286,2,286,0.0,143.0,143.0,0,0,0.0,0.0,0.0
2484.0,17,4,344,2,150,0.0,75.0,75.0,2,194,0.0,103.0,97.0
846034.0,6,9,1118,6,586,169206.8,248.0,97.66666666666669,3,532,285194.0,392.0,177.33333333333334
27560.0,6,13,4519,6,512,5369.2,230.0,85.33333333333333,7,4007,4332.666666666667,1514.0,572.4285714285714
165741.0,17,2,414,1,88,0.0,88.0,88.0,1,326,0.0,326.0,326.0
135129281.0,17,6,1206,6,1206,27025856.2,201.0,201.0,0,0,0.0,0.0,0.0
1314518.0,6,4,264,2,132,0.0,66.0,66.0,2,132,0.0,66.0,66.0
247914.0,6,3,337,2,214,0.0,160.0,107.0,1,123,0.0,123.0,123.0
2793544.0,6,2,132,1,66,0.0,66.0,66.0,1,66,0.0,66.0,66.0
567287.0,17,2,397,1,75,0.0,75.0,75.0,1,322,0.0,322.0,322.0
146253.0,6,3,337,2,214,0.0,160.0,107.0,1,123,0.0,123.0,123.0
30199.0,6,13,1479,7,882,5033.166666666667,291.0,126.0,6,597,5423.0,259.0,99.5
10903638.0,6,8,544,4,272,3589002.6666666665,74.0,68.0,4,272,3588923.333333333,74.0,68.0
97469791.0,17,12,778,6,389,19400584.0,174.0,64.83333333333333,6,389,19400154.8,174.0,64.83333333333333
120336728.0,6,225,25484,113,17796,1074435.0714285714,284.0,157.4867256637168,112,7688,1074694.1081081082,140.0,68.64285714285714
197110.0,17,2,180,1,90,0.0,90.0,90.0,1,90,0.0,90.0,90.0
153445.0,17,2,180,1,90,0.0,90.0,90.0,1,90,0.0,90.0,90.0
115623539.0,6,35,2526,18,1332,6787963.176470588,123.0,74.0,17,1194,7212685.3125,123.0,70.23529411764706
234255.0,6,3,373,2,238,0.0,172.0,119.0,1,135,0.0,135.0,135.0
1178009.0,6,13,3010,8,2382,168287.0,1514.0,297.75,5,628,225455.25,331.0,125.6
2469.0,17,4,344,2,150,0.0,75.0,75.0,2,194,0.0,103.0,97.0
308659.0,6,6,412,4,272,102886.33333333331,74.0,68.0,2,140,0.0,74.0,70.0
309755.0,6,6,412,4,272,103251.66666666669,74.0,68.0,2,140,0.0,74.0,70.0
12957.0,17,4,823,2,163,0.0,89.0,81.5,2,660,0.0,443.0,330.0
234485.0,6,3,373,2,238,0.0,172.0,119.0,1,135,0.0,135.0,135.0
297560.0,6,6,412,4,272,99186.66666666669,74.0,68.0,2,140,0.0,74.0,70.0
44313.0,6,14,4740,7,653,5980.333333333333,249.0,93.28571428571428,7,4087,7132.833333333333,1514.0,583.8571428571429
137435.0,17,2,176,1,80,0.0,80.0,80.0,1,96,0.0,96.0,96.0
90223369.0,6,16,1192,8,596,12853943.142857144,95.0,74.5,8,596,12858277.285714284,95.0,74.5
103947955.0,17,14,1126,7,563,17324659.166666668,174.0,80.42857142857143,7,563,17194214.833333332,174.0,80.42857142857143
90315559.0,6,16,1192,8,596,12894720.142857144,95.0,74.5,8,596,12899999.0,95.0,74.5
2347.0,17,4,344,2,150,0.0,75.0,75.0,2,194,0.0,103.0,97.0
302363.0,6,2,132,1,66,0.0,66.0,66.0,1,66,0.0,66.0,66.0
2308.0,17,4,344,2,150,0.0,75.0,75.0,2,194,0.0,103.0,97.0
46077.0,6,14,4740,7,653,6922.0,249.0,93.28571428571428,7,4087,6894.666666666667,1514.0,583.8571428571429
90219538.0,6,16,1192,8,596,12852153.714285716,95.0,74.5,8,596,12857611.0,95.0,74.5
114805040.0,6,48,3168,24,1584,4991523.478260869,66.0,66.0,24,1584,4982126.565217392,66.0,66.0
502377.0,6,5,336,2,134,0.0,68.0,67.0,3,202,193192.0,70.0,67.33333333333333
232262.0,6,3,337,2,214,0.0,160.0,107.0,1,123,0.0,123.0,123.0
108104848.0,17,5,955,5,955,27026212.0,191.0,191.0,0,0,0.0,0.0,0.0
308782.0,6,6,412,4,272,102927.33333333331,74.0,68.0,2,140,0.0,74.0,70.0
239155.0,17,2,180,1,70,0.0,70.0,70.0,1,110,0.0,110.0,110.0
516149.0,6,5,336,2,134,0.0,68.0,67.0,3,202,194528.0,70.0,67.33333333333333
147107.0,6,3,373,2,238,0.0,172.0,119.0,1,135,0.0,135.0,135.0
19071.0,6,2,145,2,145,0.0,91.0,72.5,0,0,0.0,0.0,0.0
308111.0,6,6,412,4,272,102703.66666666669,74.0,68.0,2,140,0.0,74.0,70.0
90654245.0,6,15,2302,9,1204,11316014.875,188.0,133.77777777777777,6,1098,18098301.0,204.0,183.0
153585.0,17,2,180,1,90,0.0,90.0,90.0,1,90,0.0,90.0,90.0
818.0,17,4,438,2,148,0.0,74.0,74.0,2,290,0.0,147.0,145.0
105261779.0,17,14,864,7,432,17503761.833333332,174.0,61.71428571428572,7,432,17500149.0,174.0,61.71428571428572
22545734.0,6,29,9249,16,3843,161597.13333333333,1514.0,240.1875,13,5406,1861754.1666666667,1514.0,415.84615384615387
344208.0,6,3,1604,2,851,0.0,785.0,425.5,1,753,0.0,753.0,753.0
6776.0,17,2,582,1,83,0.0,83.0,83.0,1,499,0.0,499.0,499.0
3203.0,17,2,224,1,76,0.0,76.0,76.0,1,148,0.0,148.0,148.0
319087.0,17,4,1400,4,1400,106362.33333333331,350.0,350.0,0,0,0.0,0.0,0.0
90710500.0,6,21,1585,10,745,10078944.444444444,95.0,74.5,11,840,9044771.6,95.0,76.36363636363636
343960.0,6,10,1221,6,636,68792.0,298.0,106.0,4,585,108250.33333333331,379.0,146.25
123416485.0,6,48,3168,24,1584,5177048.0,66.0,66.0,24,1584,5124526.130434782,66.0,66.0
216602.0,6,12,1373,7,714,36100.333333333336,298.0,102.0,5,659,53032.25,379.0,131.8
98865113.0,17,14,1126,7,563,16334388.0,174.0,80.42857142857143,7,563,16333473.666666666,174.0,80.42857142857143
143894.0,17,2,180,1,90,0.0,90.0,90.0,1,90,0.0,90.0,90.0
129597200.0,6,35,2463,17,1194,7475786.5625,123.0,70.23529411764706,18,1269,7623235.05882353,123.0,70.5
29845.0,6,14,4740,7,653,4185.333333333333,249.0,93.28571428571428,7,4087,4833.5,1514.0,583.8571428571429
135121003.0,17,6,1206,6,1206,27024200.6,201.0,201.0,0,0,0.0,0.0,0.0
2724958.0,6,3,1604,1,753,0.0,753.0,753.0,2,851,0.0,785.0,425.5
149600.0,17,2,180,1,90,0.0,90.0,90.0,1,90,0.0,90.0,90.0
103675.0,17,2,286,2,286,0.0,143.0,143.0,0,0,0.0,0.0,0.0
98539.0,17,2,762,2,762,0.0,381.0,381.0,0,0,0.0,0.0,0.0
84342.0,6,14,4740,7,653,11883.833333333334,249.0,93.28571428571428,7,4087,12056.666666666666,1514.0,583.8571428571429
209513.0,17,2,180,1,90,0.0,90.0,90.0,1,90,0.0,90.0,90.0
145323.0,17,2,180,1,90,0.0,90.0,90.0,1,90,0.0,90.0,90.0
90238238.0,6,16,1192,8,596,12856141.0,95.0,74.5,8,596,12861815.285714284,95.0,74.5
319.0,17,2,174,1,79,0.0,79.0,79.0,1,95,0.0,95.0,95.0
2382.0,17,4,344,2,150,0.0,75.0,75.0,2,194,0.0,103.0,97.0
90261802.0,6,14,1964,8,1016,12894543.142857144,188.0,127.0,6,948,18018691.0,204.0,158.0
120122407.0,6,13,2020,9,1204,15015300.875,188.0,133.77777777777777,4,816,30030893.33333333,204.0,204.0
135135176.0,17,6,1146,6,1146,27027035.2,191.0,191.0,0,0,0.0,0.0,0.0
107402.0,17,2,286,2,286,0.0,143.0,143.0,0,0,0.0,0.0,0.0
111475.0,17,4,1400,4,1400,37158.333333333336,350.0,350.0,0,0,0.0,0.0,0.0
497818.0,6,5,336,2,134,0.0,68.0,67.0,3,202,195359.0,70.0,67.33333333333333
301.0,17,2,156,1,78,0.0,78.0,78.0,1,78,0.0,78.0,78.0
209874.0,6,10,1221,6,636,41974.8,298.0,106.0,4,585,68806.33333333333,379.0,146.25
0.0,6,1,66,1,66,0.0,66.0,66.0,0,0,0.0,0.0,0.0
108673816.0,6,35,2542,18,1348,6379884.94117647,139.0,74.88888888888889,17,1194,6778621.5625,123.0,70.23529411764706
90041428.0,17,28,13364,28,13364,3334867.703703704,501.0,477.2857142857143,0,0,0.0,0.0,0.0
120546593.0,6,223,25262,112,17714,1086005.3423423425,284.0,158.16071428571428,111,7548,1086421.2363636363,140.0,68.0
125617.0,6,14,4740,7,653,12953.0,249.0,93.28571428571428,7,4087,17521.333333333332,1514.0,583.8571428571429
97356.0,17,2,762,2,762,0.0,381.0,381.0,0,0,0.0,0.0,0.0
14672398.0,6,22,1713,10,973,1596182.6666666667,315.0,97.3,12,740,1305951.4545454546,78.0,61.66666666666666
27672.0,6,10,1066,5,490,6494.25,218.0,98.0,5,576,6710.25,304.0,115.2
14328550.0,6,20,1607,10,975,1558580.111111111,315.0,97.5,10,632,1558554.2222222222,78.0,63.2
102894827.0,6,184,20872,92,6368,1127617.2197802195,140.0,69.21739130434783,92,14504,1121607.197802198,284.0,157.65217391304347
108767523.0,6,33,2428,17,1288,6797970.1875,139.0,75.76470588235294,16,1140,7236735.133333334,123.0,71.25
108525918.0,6,35,2536,18,1248,6383851.470588235,123.0,69.33333333333333,17,1288,6158818.375,139.0,75.76470588235294
108102544.0,17,5,1005,5,1005,27025636.0,201.0,201.0,0,0,0.0,0.0,0.0
108101949.0,17,5,955,5,955,27025487.25,191.0,191.0,0,0,0.0,0.0,0.0
498453.0,6,5,336,2,134,0.0,68.0,67.0,3,202,191774.0,70.0,67.33333333333333
209589.0,17,2,180,1,90,0.0,90.0,90.0,1,90,0.0,90.0,90.0
216763.0,6,3,426,2,280,0.0,214.0,140.0,1,146,0.0,146.0,146.0
301957.0,6,6,412,4,272,100652.33333333331,74.0,68.0,2,140,0.0,74.0,70.0
8995824.0,17,4,300,4,300,2998608.0,75.0,75.0,0,0,0.0,0.0,0.0
135133744.0,17,6,1206,6,1206,27026748.8,201.0,201.0,0,0,0.0,0.0,0.0
15862.999999999998,6,20,7606,11,978,1586.3,310.0,88.9090909090909,9,6628,1682.5,1514.0,736.4444444444445
112535452.0,6,46,3036,23,1518,5105435.7727272725,66.0,66.0,23,1518,5105438.818181818,66.0,66.0
135137658.0,17,6,1146,6,1146,27027531.6,191.0,191.0,0,0,0.0,0.0,0.0
99936627.0,6,24,1500,12,783,9065525.909090908,123.0,65.25,12,717,9065521.909090908,123.0,59.75
103423.0,17,2,286,2,286,0.0,143.0,143.0,0,0,0.0,0.0,0.0
90054998.0,17,28,13364,28,13364,3335370.296296296,501.0,477.2857142857143,0,0,0.0,0.0,0.0
36603.0,6,14,4740,7,653,5979.5,249.0,93.28571428571428,7,4087,5398.0,1514.0,583.8571428571429
207211.0,6,3,426,2,280,0.0,214.0,140.0,1,146,0.0,146.0,146.0
295205.0,17,4,1524,4,1524,98401.66666666669,381.0,381.0,0,0,0.0,0.0,0.0
10029556.0,6,32,8682,17,4821,626847.25,1514.0,283.5882352941176,15,3861,640665.7857142857,1514.0,257.4
209535.0,17,2,180,1,90,0.0,90.0,90.0,1,90,0.0,90.0,90.0
1826566.0,17,2,180,1,90,0.0,90.0,90.0,1,90,0.0,90.0,90.0
503086.00000000006,6,4,270,2,134,0.0,68.0,67.0,2,136,0.0,70.0,68.0
108543.0,6,14,4740,7,653,17487.5,249.0,93.28571428571428,7,4087,16972.333333333332,1514.0,583.8571428571429
67837.0,6,14,4740,7,653,10210.0,249.0,93.28571428571428,7,4087,11147.833333333334,1514.0,583.8571428571429
107619925.0,6,27,1800,14,894,8278455.769230769,123.0,63.85714285714285,13,906,8118279.166666667,123.0,69.6923076923077
4177.0,17,2,762,2,762,0.0,381.0,381.0,0,0,0.0,0.0,0.0
252613.0,17,2,180,1,90,0.0,90.0,90.0,1,90,0.0,90.0,90.0
209538.0,17,2,180,1,90,0.0,90.0,90.0,1,90,0.0,90.0,90.0
125855065.0,6,59,12397,29,6510,3433975.214285714,1514.0,224.48275862068965,30,5887,4332280.551724138,1514.0,196.2333333333333
352960.0,6,4,508,2,238,0.0,172.0,119.0,2,270,0.0,135.0,135.0
3167353.0,6,18,1495,9,921,358364.5,315.0,102.33333333333331,9,574,358339.875,78.0,63.77777777777778
90527051.0,6,13,2036,8,1016,12932435.857142856,188.0,127.0,5,1020,22591501.0,204.0,204.0
119767061.0,6,22,1598,11,799,11953134.0,95.0,72.63636363636364,11,799,11972995.4,95.0,72.63636363636364
218301.0,6,10,1221,6,636,43660.2,298.0,106.0,4,585,71407.0,379.0,146.25
266180.0,17,2,180,1,90,0.0,90.0,90.0,1,90,0.0,90.0,90.0
1048033.0,6,11,1134,6,558,209606.6,220.0,93.0,5,576,257755.0,304.0,115.2
200939.0,17,4,6056,4,6056,66979.66666666667,1514.0,1514.0,0,0,0.0,0.0,0.0
313522.0,17,4,1400,4,1400,104507.33333333331,350.0,350.0,0,0,0.0,0.0,0.0
196880.0,17,2,180,1,90,0.0,90.0,90.0,1,90,0.0,90.0,90.0
119926.0,17,2,180,1,70,0.0,70.0,70.0,1,110,0.0,110.0,110.0
43941.0,6,14,4740,7,653,6484.166666666667,249.0,93.28571428571428,7,4087,7190.166666666667,1514.0,583.8571428571429
121227.0,6,3,337,2,214,0.0,160.0,107.0,1,123,0.0,123.0,123.0
81043.0,6,14,4740,7,653,12966.666666666666,249.0,93.28571428571428,7,4087,12011.833333333334,1514.0,583.8571428571429
6836.0,17,2,582,1,83,0.0,83.0,83.0,1,499,0.0,499.0,499.0
121366.0,6,3,337,2,214,0.0,160.0,107.0,1,123,0.0,123.0,123.0
146901.0,6,3,373,2,238,0.0,172.0,119.0,1,135,0.0,135.0,135.0
102349.0,6,2,132,1,66,0.0,66.0,66.0,1,66,0.0,66.0,66.0
120115980.0,6,14,2240,6,1224,24023196.0,204.0,204.0,8,1016,17097624.0,188.0,127.0
10479929.0,6,7,478,4,272,3447819.6666666665,74.0,68.0,3,206,5171606.0,74.0,68.66666666666667
120264591.0,6,278,32688,139,9396,865490.6666666666,140.0,67.59712230215827,139,23292,865555.1521739131,284.0,167.568345323741
1655849.0,6,7,499,3,198,818739.0,66.0,66.0,4,301,487529.3333333333,103.0,75.25
2331.0,17,2,762,2,762,0.0,381.0,381.0,0,0,0.0,0.0,0.0
204837.0,17,2,762,2,762,0.0,381.0,381.0,0,0,0.0,0.0,0.0
101997308.0,6,28,1860,14,966,7829329.461538462,123.0,69.0,14,894,7829331.307692308,123.0,63.85714285714285
135136410.0,17,6,1146,6,1146,27027282.0,191.0,191.0,0,0,0.0,0.0,0.0
135133838.0,17,6,1146,6,1146,27026767.6,191.0,191.0,0,0,0.0,0.0,0.0
299863.0,17,2,246,1,76,0.0,76.0,76.0,1,170,0.0,170.0,170.0
104710.0,17,2,700,2,700,0.0,350.0,350.0,0,0,0.0,0.0,0.0
499.0,17,2,191,1,73,0.0,73.0,73.0,1,118,0.0,118.0,118.0
73051334.0,6,9,842,9,842,9131416.75,97.0,93.55555555555556,0,0,0.0,0.0,0.0
14649778.0,6,20,1607,10,975,1592798.0,315.0,97.5,10,632,1592787.7777777778,78.0,63.2
233039.0,6,3,337,2,214,0.0,160.0,107.0,1,123,0.0,123.0,123.0
10515300.0,6,7,478,4,272,3459247.0,74.0,68.0,3,206,5188752.0,74.0,68.66666666666667
10426328.0,6,7,478,4,272,3429717.0,74.0,68.0,3,206,5144537.0,74.0,68.66666666666667
128010325.0,17,15,907,8,475,18287189.285714287,174.0,59.375,7,432,18000158.5,174.0,61.71428571428572
207564.0,17,2,762,2,762,0.0,381.0,381.0,0,0,0.0,0.0,0.0
2365.0,17,4,344,2,150,0.0,75.0,75.0,2,194,0.0,103.0,97.0
209379.0,17,2,180,1,90,0.0,90.0,90.0,1,90,0.0,90.0,90.0
29165.0,6,10,2032,5,524,6641.5,252.0,104.8,5,1508,6550.0,1236.0,301.6
215648.0,17,2,180,1,90,0.0,90.0,90.0,1,90,0.0,90.0,90.0
247122.0,6,3,373,2,238,0.0,172.0,119.0,1,135,0.0,135.0,135.0
472.0,17,2,166,1,75,0.0,75.0,75.0,1,91,0.0,91.0,91.0
55848.0,17,2,239,1,82,0.0,82.0,82.0,1,157,0.0,157.0,157.0
112421.0,17,4,1400,4,1400,37473.66666666666,350.0,350.0,0,0,0.0,0.0,0.0
7476.0,6,2,132,1,66,0.0,66.0,66.0,1,66,0.0,66.0,66.0
590118.0,6,4,508,2,238,0.0,172.0,119.0,2,270,0.0,135.0,135.0
49675.0,6,14,4740,7,653,7610.833333333333,249.0,93.28571428571428,7,4087,8134.0,1514.0,583.8571428571429
97801.0,17,2,762,2,762,0.0,381.0,381.0,0,0,0.0,0.0,0.0
28664.0,6,14,4740,7,653,4514.5,249.0,93.28571428571428,7,4087,4299.0,1514.0,583.8571428571429
191227.0,17,2,180,1,90,0.0,90.0,90.0,1,90,0.0,90.0,90.0
108095247.0,17,5,955,5,955,27023811.75,191.0,191.0,0,0,0.0,0.0,0.0
99008797.0,6,23,1894,12,1095,8999783.363636363,255.0,91.25,11,799,9899883.1,95.0,72.63636363636364
2271.0,17,4,344,2,150,0.0,75.0,75.0,2,194,0.0,103.0,97.0
102063.0,17,2,286,2,286,0.0,143.0,143.0,0,0,0.0,0.0,0.0
147981.0,17,2,180,1,90,0.0,90.0,90.0,1,90,0.0,90.0,90.0
116778194.0,6,211,23836,106,7304,1112173.2761904765,140.0,68.90566037735849,105,16532,1112942.048076923,284.0,157.44761904761904
237101.0,6,3,337,2,214,0.0,160.0,107.0,1,123,0.0,123.0,123.0
22086.0,6,2,145,2,145,0.0,91.0,72.5,0,0,0.0,0.0,0.0
156314.0,17,2,180,1,90,0.0,90.0,90.0,1,90,0.0,90.0,90.0
2409.0,17,4,344,2,150,0.0,75.0,75.0,2,194,0.0,103.0,97.0
90053966.0,17,27,12943,27,12943,3463614.076923077,501.0,479.3703703703704,0,0,0.0,0.0,0.0
107819.0,17,2,286,2,286,0.0,143.0,143.0,0,0,0.0,0.0,0.0
120046187.0,17,28,13364,28,13364,4446155.074074074,501.0,477.2857142857143,0,0,0.0,0.0,0.0
33392.0,6,14,4740,7,653,5445.166666666667,249.0,93.28571428571428,7,4087,5424.666666666667,1514.0,583.8571428571429
2800250.0,6,2,132,1,66,0.0,66.0,66.0,1,66,0.0,66.0,66.0
302219.0,6,6,412,4,272,100739.66666666669,74.0,68.0,2,140,0.0,74.0,70.0
2331.0,17,2,762,2,762,0.0,381.0,381.0,0,0,0.0,0.0,0.0
99906039.0,17,12,778,6,389,19981207.8,174.0,64.83333333333333,6,389,19938292.2,174.0,64.83333333333333
96698415.0,6,40,2640,20,1320,5089390.263157895,66.0,66.0,20,1320,5072946.578947368,66.0,66.0
4249.0,17,4,704,2,148,0.0,74.0,74.0,2,556,0.0,280.0,278.0
29214.0,6,10,2032,5,524,7065.0,252.0,104.8,5,1508,6321.5,1236.0,301.6
1309615.0,6,4,264,2,132,0.0,66.0,66.0,2,132,0.0,66.0,66.0
113420912.0,6,45,2970,23,1518,5155496.0,66.0,66.0,22,1452,5120709.476190476,66.0,66.0
22057.0,6,10,2032,5,524,5220.75,252.0,104.8,5,1508,5253.5,1236.0,301.6
259203.00000000003,6,3,373,2,238,0.0,172.0,119.0,1,135,0.0,135.0,135.0
97636817.0,6,26,1746,13,906,8118400.0,123.0,69.6923076923077,13,840,8118382.166666667,123.0,64.61538461538461
60367.0,6,14,4740,7,653,9568.0,249.0,93.28571428571428,7,4087,9543.166666666666,1514.0,583.8571428571429
136273.0,6,2,132,1,66,0.0,66.0,66.0,1,66,0.0,66.0,66.0
502103.0,6,5,336,2,134,0.0,68.0,67.0,3,202,192432.0,70.0,67.33333333333333
121478.0,6,3,337,2,214,0.0,160.0,107.0,1,123,0.0,123.0,123.0
90525420.0,6,15,2444,8,1016,12932202.857142856,188.0,127.0,7,1428,15060226.166666666,204.0,204.0
32101.0,6,10,1066,5,490,7600.0,218.0,98.0,5,576,7730.5,304.0,115.2
376.0,17,2,267,1,83,0.0,83.0,83.0,1,184,0.0,184.0,184.0
2745366.0,6,2,134,1,68,0.0,68.0,68.0,1,66,0.0,66.0,66.0
54298.0,6,14,4740,7,653,8773.666666666666,249.0,93.28571428571428,7,4087,8914.0,1514.0,583.8571428571429
212064.0,6,3,426,2,280,0.0,214.0,140.0,1,146,0.0,146.0,146.0
207107.0,17,2,762,2,762,0.0,381.0,381.0,0,0,0.0,0.0,0.0
106371.0,17,2,286,2,286,0.0,143.0,143.0,0,0,0.0,0.0,0.0
135132983.0,17,6,1146,6,1146,27026596.6,191.0,191.0,0,0,0.0,0.0,0.0
305563.0,6,6,412,4,272,101854.33333333331,74.0,68.0,2,140,0.0,74.0,70.0
100329674.0,6,40,2640,20,1320,5280509.157894737,66.0,66.0,20,1320,5264452.368421053,66.0,66.0
2326946.0,6,3,1777,2,951,0.0,885.0,475.5,1,826,0.0,826.0,826.0
95656730.0,6,40,2640,20,1320,5034564.736842105,66.0,66.0,20,1320,5018313.263157895,66.0,66.0
19352.0,6,14,4740,7,653,3109.0,249.0,93.28571428571428,7,4087,3044.0,1514.0,583.8571428571429
143955.0,6,2,132,1,66,0.0,66.0,66.0,1,66,0.0,66.0,66.0
50504.0,6,14,4740,7,653,8035.0,249.0,93.28571428571428,7,4087,7923.333333333333,1514.0,583.8571428571429
135132178.0,17,6,1146,6,1146,27026435.6,191.0,191.0,0,0,0.0,0.0,0.0
112535418.0,6,46,3036,23,1518,5105433.045454546,66.0,66.0,23,1518,5105432.7727272725,66.0,66.0
240751.0,17,2,180,1,90,0.0,90.0,90.0,1,90,0.0,90.0,90.0
9146.0,17,2,498,1,80,0.0,80.0,80.0,1,418,0.0,418.0,418.0
162319.0,17,2,762,2,762,0.0,381.0,381.0,0,0,0.0,0.0,0.0
143061.0,17,2,192,1,88,0.0,88.0,88.0,1,104,0.0,104.0,104.0
2604729.0,6,25,7573,14,3735,200363.7692307692,1514.0,266.7857142857143,11,3838,235500.2,1514.0,348.90909090909093
108103832.0,17,5,1005,5,1005,27025958.0,201.0,201.0,0,0,0.0,0.0,0.0
164844.0,17,2,414,1,88,0.0,88.0,88.0,1,326,0.0,326.0,326.0
103425.0,17,2,286,2,286,0.0,143.0,143.0,0,0,0.0,0.0,0.0
18271.0,6,2,145,2,145,0.0,91.0,72.5,0,0,0.0,0.0,0.0
146920.0,6,3,337,2,214,0.0,160.0,107.0,1,123,0.0,123.0,123.0
20303.0,17,2,180,1,90,0.0,90.0,90.0,1,90,0.0,90.0,90.0
50934.0,17,2,180,1,90,0.0,90.0,90.0,1,90,0.0,90.0,90.0
6460.0,17,4,823,2,163,0.0,89.0,81.5,2,660,0.0,443.0,330.0
28065.0,6,10,2032,5,524,5476.25,252.0,104.8,5,1508,4786.75,1236.0,301.6
1032850.0,6,11,1134,6,558,206570.0,220.0,93.0,5,576,257710.0,304.0,115.2
233740.0,17,2,180,1,70,0.0,70.0,70.0,1,110,0.0,110.0,110.0
83390.0,6,14,4740,7,653,13757.166666666666,249.0,93.28571428571428,7,4087,13723.5,1514.0,583.8571428571429
3007954.0,6,12,2172,7,664,501116.1666666667,252.0,94.85714285714286,5,1508,2268.75,1236.0,301.6
228316.0,17,2,180,1,90,0.0,90.0,90.0,1,90,0.0,90.0,90.0
99374.0,17,2,286,2,286,0.0,143.0,143.0,0,0,0.0,0.0,0.0
10903279.0,6,7,478,3,206,5383992.5,74.0,68.66666666666667,4,272,3589259.333333333,74.0,68.0
141557.0,17,4,1524,4,1524,47185.66666666666,381.0,381.0,0,0,0.0,0.0,0.0
298313.0,6,6,412,4,272,99437.66666666669,74.0,68.0,2,140,0.0,74.0,70.0
24059099.0,17,3,1034,2,684,0.0,342.0,342.0,1,350,0.0,350.0,350.0
135123178.0,17,6,1146,6,1146,27024635.6,191.0,191.0,0,0,0.0,0.0,0.0
50803.0,6,13,1479,7,882,8191.0,291.0,126.0,6,597,8366.4,259.0,99.5
19944381.0,17,3,1034,2,684,0.0,342.0,342.0,1,350,0.0,350.0,350.0
120132846.0,6,228,25846,114,7820,1055868.407079646,140.0,68.59649122807018,114,18026,1056750.796460177,284.0,158.12280701754386
128183.0,6,2,132,1,66,0.0,66.0,66.0,1,66,0.0,66.0,66.0
90028441.0,17,28,13364,28,13364,3334386.703703704,501.0,477.2857142857143,0,0,0.0,0.0,0.0
108105548.0,17,5,955,5,955,27026387.0,191.0,191.0,0,0,0.0,0.0,0.0
120064560.0,6,386,46602,193,12960,620993.640625,140.0,67.15025906735751,193,33642,621614.5520833334,284.0,174.31088082901553
96174341.0,6,56,11709,28,5968,3562012.6296296297,1514.0,213.1428571428572,28,5741,3552372.5555555555,1514.0,205.03571428571428
109171711.0,6,43,2838,22,1452,5198638.80952381,66.0,66.0,21,1386,5160002.75,66.0,66.0
8489.0,6,10,2032,5,524,1825.5,252.0,104.8,5,1508,1818.75,1236.0,301.6
105442.0,17,2,286,2,286,0.0,143.0,143.0,0,0,0.0,0.0,0.0
1020073.0,6,11,1134,6,558,204014.6,220.0,93.0,5,576,254161.5,304.0,115.2
0.0,17,1,342,1,342,0.0,342.0,342.0,0,0,0.0,0.0,0.0
302829.0,6,6,412,4,272,100943.0,74.0,68.0,2,140,0.0,74.0,70.0
11314.0,6,10,2032,5,524,2527.75,252.0,104.8,5,1508,2459.75,1236.0,301.6
198803.0,17,2,180,1,90,0.0,90.0,90.0,1,90,0.0,90.0,90.0
408466.0,17,2,176,1,80,0.0,80.0,80.0,1,96,0.0,96.0,96.0
50141.0,6,14,4740,7,653,6986.333333333333,249.0,93.28571428571428,7,4087,8189.166666666667,1514.0,583.8571428571429
108101143.0,17,5,955,5,955,27025285.75,191.0,191.0,0,0,0.0,0.0,0.0
0.0,17,1,453,1,453,0.0,453.0,453.0,0,0,0.0,0.0,0.0
10830.0,6,10,1067,5,536,2515.0,264.0,107.2,5,531,2159.25,259.0,106.2
90307521.0,6,16,1192,8,596,12894398.57142857,95.0,74.5,8,596,12900334.57142857,95.0,74.5
2195.0,17,4,438,2,148,0.0,74.0,74.0,2,290,0.0,147.0,145.0
833282.0,6,9,1118,6,586,166656.4,248.0,97.66666666666669,3,532,280347.5,392.0,177.33333333333334
90228391.0,6,16,1192,8,596,12854173.42857143,95.0,74.5,8,596,12858922.0,95.0,74.5
304120.0,6,6,412,4,272,101373.33333333331,74.0,68.0,2,140,0.0,74.0,70.0
2413.0,17,4,344,2,150,0.0,75.0,75.0,2,194,0.0,103.0,97.0
321.0,17,2,174,1,79,0.0,79.0,79.0,1,95,0.0,95.0,95.0
39536.0,6,10,1065,5,534,9521.5,262.0,106.8,5,531,8115.75,259.0,106.2
27858.0,6,10,2032,5,524,6218.0,252.0,104.8,5,1508,6597.5,1236.0,301.6
328.0,17,2,166,1,75,0.0,75.0,75.0,1,91,0.0,91.0,91.0
1301521.0,6,4,264,2,132,0.0,66.0,66.0,2,132,0.0,66.0,66.0
325.0,17,2,208,1,72,0.0,72.0,72.0,1,136,0.0,136.0,136.0
120077337.0,17,28,13364,28,13364,4447308.777777778,501.0,477.2857142857143,0,0,0.0,0.0,0.0
2875.0,17,2,224,1,76,0.0,76.0,76.0,1,148,0.0,148.0,148.0
70330.0,17,2,604,1,75,0.0,75.0,75.0,1,529,0.0,529.0,529.0
1191921.0,6,13,3011,8,2383,170274.42857142858,1514.0,297.875,5,628,229144.25,331.0,125.6
10476001.0,6,6,412,3,206,5170054.5,74.0,68.66666666666667,3,206,5169948.5,74.0,68.66666666666667
44279.0,6,14,4740,7,653,7176.333333333333,249.0,93.28571428571428,7,4087,6855.833333333333,1514.0,583.8571428571429
0.0,6,1,172,1,172,0.0,172.0,172.0,0,0,0.0,0.0,0.0
5260677.0,17,4,1368,4,1368,1753559.0,342.0,342.0,0,0,0.0,0.0,0.0
302366.0,6,2,132,1,66,0.0,66.0,66.0,1,66,0.0,66.0,66.0
360752.0,6,11,1021,6,444,48475.8,162.0,74.0,5,577,60391.5,349.0,115.4
10470987.0,6,7,478,4,272,3444874.6666666665,74.0,68.0,3,206,5167204.0,74.0,68.66666666666667
240266.0,6,3,373,2,238,0.0,172.0,119.0,1,135,0.0,135.0,135.0
303120.0,6,2,132,1,66,0.0,66.0,66.0,1,66,0.0,66.0,66.0
113613572.0,6,46,3036,23,1518,5150453.181818182,66.0,66.0,23,1518,5150454.727272728,66.0,66.0
108389708.0,17,14,864,7,432,18001015.833333332,174.0,61.71428571428572,7,432,18000160.666666668,174.0,61.71428571428572
281619.0,17,2,414,1,88,0.0,88.0,88.0,1,326,0.0,326.0,326.0
135137412.0,17,6,1146,6,1146,27027482.4,191.0,191.0,0,0,0.0,0.0,0.0
206026.0,6,3,426,2,280,0.0,214.0,140.0,1,146,0.0,146.0,146.0
141467.0,17,4,1400,4,1400,47155.66666666666,350.0,350.0,0,0,0.0,0.0,0.0
9382.0,17,2,539,1,86,0.0,86.0,86.0,1,453,0.0,453.0,453.0
28310.0,6,10,2032,5,524,6845.25,252.0,104.8,5,1508,6397.0,1236.0,301.6
120010192.0,6,25,2808,12,1356,10910017.454545457,426.0,113.0,13,1452,9978218.916666666,334.0,111.6923076923077
240911.0,6,3,337,2,214,0.0,160.0,107.0,1,123,0.0,123.0,123.0
37466.0,6,10,2032,5,524,9128.25,252.0,104.8,5,1508,7881.0,1236.0,301.6
2908068.0,6,11,2106,6,598,581435.0,252.0,99.66666666666669,5,1508,2373.25,1236.0,301.6
114358176.0,6,30,1974,15,1026,8153839.642857143,123.0,68.4,15,948,8153784.5,123.0,63.2
839.0,17,4,438,2,148,0.0,74.0,74.0,2,290,0.0,147.0,145.0
107581167.0,6,32,2374,17,1288,6711041.3125,139.0,75.76470588235294,15,1086,7669764.642857143,123.0,72.4
102077700.0,17,14,864,7,432,17000179.666666668,174.0,61.71428571428572,7,432,17001430.666666668,174.0,61.71428571428572
0.0,6,1,172,1,172,0.0,172.0,172.0,0,0,0.0,0.0,0.0
49178.0,6,14,4740,7,653,8072.666666666667,249.0,93.28571428571428,7,4087,6449.666666666667,1514.0,583.8571428571429
120123905.0,6,15,2428,9,1204,15015488.125,188.0,133.77777777777777,6,1224,18018697.0,204.0,204.0
197030.0,17,2,180,1,90,0.0,90.0,90.0,1,90,0.0,90.0,90.0
113254731.0,6,46,3036,23,1518,5135438.636363637,66.0,66.0,23,1518,5135436.136363637,66.0,66.0
101578.0,6,15,4806,8,719,12873.0,249.0,89.875,7,4087,16063.0,1514.0,583.8571428571429
207914.0,6,3,426,2,280,0.0,214.0,140.0,1,146,0.0,146.0,146.0
196927.0,17,2,180,1,90,0.0,90.0,90.0,1,90,0.0,90.0,90.0
1475827.0,17,16,1120,16,1120,98388.46666666666,70.0,70.0,0,0,0.0,0.0,0.0
2398.0,17,4,344,2,150,0.0,75.0,75.0,2,194,0.0,103.0,97.0
83751.0,6,14,4740,7,653,11537.5,249.0,93.28571428571428,7,4087,13748.166666666666,1514.0,583.8571428571429
16441.0,6,20,7606,11,978,1644.1,310.0,88.9090909090909,9,6628,1810.375,1514.0,736.4444444444445
72.0,17,2,700,2,700,0.0,350.0,350.0,0,0,0.0,0.0,0.0
2309491.0,6,4,492,2,280,0.0,214.0,140.0,2,212,0.0,146.0,106.0
1627104.0,6,7,499,4,301,465445.0,103.0,75.25,3,198,729269.0,66.0,66.0
2592970.0,6,32,10926,18,3951,152527.64705882352,1514.0,219.5,14,6975,179875.23076923078,1514.0,498.2142857142857
145504.0,6,3,337,2,214,0.0,160.0,107.0,1,123,0.0,123.0,123.0
10544174.0,6,7,478,4,272,3469141.0,74.0,68.0,3,206,5203620.5,74.0,68.66666666666667
100440896.0,17,12,778,6,389,20088179.2,174.0,64.83333333333333,6,389,19989420.0,174.0,64.83333333333333
239422.0,6,3,337,2,214,0.0,160.0,107.0,1,123,0.0,123.0,123.0
37233.0,6,14,4740,7,653,3955.1666666666665,249.0,93.28571428571428,7,4087,5834.0,1514.0,583.8571428571429
16303849.0,17,5,1710,5,1710,4075962.25,342.0,342.0,0,0,0.0,0.0,0.0
13786.0,6,13,1459,7,862,2061.0,271.0,123.14285714285714,6,597,2585.2,259.0,99.5
1183537.0,6,13,3010,8,2382,169076.7142857143,1514.0,297.75,5,628,226885.5,331.0,125.6
2225902.0,6,25,7610,13,2516,185491.8333333333,1034.0,193.53846153846155,12,5094,174558.36363636365,1510.0,424.5
33709982.0,6,5,336,2,134,0.0,68.0,67.0,3,202,15464407.5,70.0,67.33333333333333
2902.0,17,2,224,1,76,0.0,76.0,76.0,1,148,0.0,148.0,148.0
297506.0,6,6,412,4,272,99168.66666666669,74.0,68.0,2,140,0.0,74.0,70.0
2286.0,17,4,344,2,150,0.0,75.0,75.0,2,194,0.0,103.0,97.0
116062.0,17,4,1400,4,1400,38687.333333333336,350.0,350.0,0,0,0.0,0.0,0.0
221545.0,6,3,426,2,280,0.0,214.0,140.0,1,146,0.0,146.0,146.0
38766.0,6,14,4740,7,653,4875.5,249.0,93.28571428571428,7,4087,6323.5,1514.0,583.8571428571429
331.0,17,2,160,1,80,0.0,80.0,80.0,1,80,0.0,80.0,80.0
3135.0,17,2,335,1,88,0.0,88.0,88.0,1,247,0.0,247.0,247.0
217034.0,6,3,426,2,280,0.0,214.0,140.0,1,146,0.0,146.0,146.0
1768977.0,6,7,499,3,198,817633.0,66.0,66.0,4,301,577021.0,103.0,75.25
2420.0,17,4,344,2,150,0.0,75.0,75.0,2,194,0.0,103.0,97.0
120027278.0,17,28,13364,28,13364,4445454.740740741,501.0,477.2857142857143,0,0,0.0,0.0,0.0
108108170.0,17,5,955,5,955,27027042.5,191.0,191.0,0,0,0.0,0.0,0.0
82824378.0,17,14,4796,13,4446,6228941.833333333,342.0,342.0,1,350,0.0,350.0,350.0
90044227.0,17,28,13364,28,13364,3334971.3703703703,501.0,477.2857142857143,0,0,0.0,0.0,0.0
58880879.0,17,9,3086,8,2736,5110203.285714285,342.0,342.0,1,350,0.0,350.0,350.0
15858.0,6,10,1067,5,536,3719.0,264.0,107.2,5,531,3027.75,259.0,106.2
496815.0,6,5,336,2,134,0.0,68.0,67.0,3,202,193482.0,70.0,67.33333333333333
311.0,17,2,164,1,82,0.0,82.0,82.0,1,82,0.0,82.0,82.0
108099356.0,17,5,955,5,955,27024839.0,191.0,191.0,0,0,0.0,0.0,0.0
90015554.0,17,28,13364,28,13364,3333909.407407407,501.0,477.2857142857143,0,0,0.0,0.0,0.0
27041828.0,17,5,1710,5,1710,6760457.0,342.0,342.0,0,0,0.0,0.0,0.0
323.0,17,2,174,1,79,0.0,79.0,79.0,1,95,0.0,95.0,95.0
293.0,17,2,156,1,78,0.0,78.0,78.0,1,78,0.0,78.0,78.0
192336.0,6,14,4740,7,653,31049.83333333333,249.0,93.28571428571428,7,4087,31632.666666666668,1514.0,583.8571428571429
143957.0,17,2,180,1,90,0.0,90.0,90.0,1,90,0.0,90.0,90.0
46841.0,6,10,2032,5,524,11422.5,252.0,104.8,5,1508,9483.5,1236.0,301.6
100756.0,17,2,762,2,762,0.0,381.0,381.0,0,0,0.0,0.0,0.0
505441.00000000006,6,4,270,2,134,0.0,68.0,67.0,2,136,0.0,70.0,68.0
112951685.0,6,48,3168,24,1584,4910942.826086956,66.0,66.0,24,1584,4901542.913043479,66.0,66.0
14909.0,17,4,820,2,156,0.0,78.0,78.0,2,664,0.0,332.0,332.0
90255356.0,6,12,1832,8,1016,12893622.285714284,188.0,127.0,4,816,30029871.33333333,204.0,204.0
38585.0,6,14,4740,7,653,6256.5,249.0,93.28571428571428,7,4087,5489.666666666667,1514.0,583.8571428571429
317770.0,17,4,1400,4,1400,105923.33333333331,350.0,350.0,0,0,0.0,0.0,0.0
2797524.0,6,2,132,1,66,0.0,66.0,66.0,1,66,0.0,66.0,66.0
495.0,17,2,762,2,762,0.0,381.0,381.0,0,0,0.0,0.0,0.0
90258585.0,6,12,1832,8,1016,12894083.57142857,188.0,127.0,4,816,30031062.666666668,204.0,204.0
2698493.0,6,2,132,1,66,0.0,66.0,66.0,1,66,0.0,66.0,66.0
95302380.0,17,14,1126,7,563,15833469.833333334,174.0,80.42857142857143,7,563,15834554.166666666,174.0,80.42857142857143
308499.0,6,6,412,4,272,102833.0,74.0,68.0,2,140,0.0,74.0,70.0
105643.0,17,2,286,2,286,0.0,143.0,143.0,0,0,0.0,0.0,0.0
246888.0,6,3,373,2,238,0.0,172.0,119.0,1,135,0.0,135.0,135.0
118300110.0,6,209,23618,105,7152,1137501.0576923075,140.0,68.11428571428571,104,16466,1139054.0291262136,284.0,158.32692307692307
95110271.0,6,39,2574,20,1320,5005790.842105263,66.0,66.0,19,1254,5160010.5,66.0,66.0
87945.0,6,13,1479,7,882,14236.166666666666,291.0,126.0,6,597,14836.2,259.0,99.5
5626137.0,6,5,336,2,134,0.0,68.0,67.0,3,202,1526022.0,70.0,67.33333333333333
27165332.0,17,5,1710,5,1710,6791333.0,342.0,342.0,0,0,0.0,0.0,0.0
135136342.0,17,6,1146,6,1146,27027268.4,191.0,191.0,0,0,0.0,0.0,0.0
2293.0,17,4,344,2,150,0.0,75.0,75.0,2,194,0.0,103.0,97.0
144286.0,17,2,180,1,90,0.0,90.0,90.0,1,90,0.0,90.0,90.0
32477.0,6,13,1386,7,789,4798.0,253.0,112.71428571428572,6,597,4764.8,259.0,99.5
2328.0,17,4,344,2,150,0.0,75.0,75.0,2,194,0.0,103.0,97.0
301851.0,6,6,412,4,272,100617.0,74.0,68.0,2,140,0.0,74.0,70.0
303549.0,6,6,412,4,272,101183.0,74.0,68.0,2,140,0.0,74.0,70.0
38618.0,6,10,2032,5,524,9420.75,252.0,104.8,5,1508,9233.75,1236.0,301.6
902375.0,6,12,2710,7,743,150395.83333333334,339.0,106.14285714285714,5,1967,156680.75,1514.0,393.4
108107720.0,17,5,1005,5,1005,27026930.0,201.0,201.0,0,0,0.0,0.0,0.0
5623195.0,6,4,270,2,134,0.0,68.0,67.0,2,136,0.0,70.0,68.0
35491.0,6,10,2032,5,524,7323.0,252.0,104.8,5,1508,8611.5,1236.0,301.6
309.0,17,2,174,1,79,0.0,79.0,79.0,1,95,0.0,95.0,95.0
153491.0,17,2,180,1,90,0.0,90.0,90.0,1,90,0.0,90.0,90.0
6344.0,17,2,180,1,90,0.0,90.0,90.0,1,90,0.0,90.0,90.0
106246.0,6,14,4740,7,653,17581.0,249.0,93.28571428571428,7,4087,16588.166666666668,1514.0,583.8571428571429
119294754.0,6,26,2062,14,1043,9176519.538461538,95.0,74.5,12,1019,10825208.272727272,220.0,84.91666666666667
60481.0,6,14,4740,7,653,9854.5,249.0,93.28571428571428,7,4087,9556.5,1514.0,583.8571428571429
355.0,17,2,267,1,83,0.0,83.0,83.0,1,184,0.0,184.0,184.0
316288.0,17,4,1400,4,1400,105429.33333333331,350.0,350.0,0,0,0.0,0.0,0.0
119599425.0,6,22,1696,11,799,11954956.1,95.0,72.63636363636364,11,897,11955195.2,156.0,81.54545454545455
325678.0,6,3,204,2,136,0.0,70.0,68.0,1,68,0.0,68.0,68.0
233469.0,6,3,337,2,214,0.0,160.0,107.0,1,123,0.0,123.0,123.0
14205.0,17,4,823,2,163,0.0,89.0,81.5,2,660,0.0,443.0,330.0
135120899.0,17,6,1146,6,1146,27024179.8,191.0,191.0,0,0,0.0,0.0,0.0
166946.0,17,2,180,1,90,0.0,90.0,90.0,1,90,0.0,90.0,90.0
748135.0,6,2,132,1,66,0.0,66.0,66.0,1,66,0.0,66.0,66.0
255510.00000000003,6,3,337,2,214,0.0,160.0,107.0,1,123,0.0,123.0,123.0
108103472.0,17,5,1005,5,1005,27025868.0,201.0,201.0,0,0,0.0,0.0,0.0
11028.0,6,10,1067,5,536,2184.0,264.0,107.2,5,531,2562.25,259.0,106.2
160100.0,17,2,180,1,90,0.0,90.0,90.0,1,90,0.0,90.0,90.0
2801841.0,6,2,132,1,66,0.0,66.0,66.0,1,66,0.0,66.0,66.0
24907.0,6,14,4740,7,653,3944.0,249.0,93.28571428571428,7,4087,3896.3333333333335,1514.0,583.8571428571429
1296811.0,6,4,264,2,132,0.0,66.0,66.0,2,132,0.0,66.0,66.0
42278.0,6,14,4740,7,653,6881.666666666667,249.0,93.28571428571428,7,4087,6824.666666666667,1514.0,583.8571428571429
2043.0,17,4,344,2,150,0.0,75.0,75.0,2,194,0.0,103.0,97.0
90014140.0,17,27,12943,27,12943,3462082.3076923075,501.0,479.3703703703704,0,0,0.0,0.0,0.0
90539675.0,6,14,2240,8,1016,12934239.285714284,188.0,127.0,6,1224,18074247.2,204.0,204.0
143900.0,17,2,180,1,90,0.0,90.0,90.0,1,90,0.0,90.0,90.0
0.0,17,1,55,1,55,0.0,55.0,55.0,0,0,0.0,0.0,0.0
103422984.0,6,44,2904,22,1452,4909942.476190476,66.0,66.0,22,1452,4909946.428571428,66.0,66.0
297371.0,6,6,412,4,272,99123.66666666669,74.0,68.0,2,140,0.0,74.0,70.0
42459.0,6,14,4740,7,653,6945.333333333333,249.0,93.28571428571428,7,4087,6207.5,1514.0,583.8571428571429
105774891.0,6,31,2182,16,1165,7037259.933333334,139.0,72.8125,15,1017,7539920.428571428,123.0,67.8
765.0,17,5,550,5,550,191.25,110.0,110.0,0,0,0.0,0.0,0.0
120138777.0,6,17,2572,8,1368,17162682.42857143,204.0,171.0,9,1204,14966134.125,188.0,133.77777777777777
2311.0,17,4,344,2,150,0.0,75.0,75.0,2,194,0.0,103.0,97.0
92253103.0,17,16,5472,16,5472,6150206.866666666,342.0,342.0,0,0,0.0,0.0,0.0
114184655.0,6,47,3102,24,1584,4964531.434782608,66.0,66.0,23,1518,5144002.045454546,66.0,66.0
3192616.0,6,3,1604,1,753,0.0,753.0,753.0,2,851,0.0,785.0,425.5
0.0,17,1,381,1,381,0.0,381.0,381.0,0,0,0.0,0.0,0.0
5626091.0,6,5,336,2,134,0.0,68.0,67.0,3,202,1522303.0,70.0,67.33333333333333
2426.0,17,4,344,2,150,0.0,75.0,75.0,2,194,0.0,103.0,97.0
10445412.0,6,7,478,4,272,3436012.0,74.0,68.0,3,206,5153851.0,74.0,68.66666666666667
333.0,17,2,164,1,82,0.0,82.0,82.0,1,82,0.0,82.0,82.0
5621589.0,6,4,270,2,134,0.0,68.0,67.0,2,136,0.0,70.0,68.0
2030.0,17,4,344,2,150,0.0,75.0,75.0,2,194,0.0,103.0,97.0
25327.0,6,11,1132,6,556,5065.4,218.0,92.66666666666669,5,576,5938.75,304.0,115.2
122687954.0,6,49,3234,25,1650,5111998.083333333,66.0,66.0,24,1584,5166886.0869565215,66.0,66.0
246354.0,6,3,337,2,214,0.0,160.0,107.0,1,123,0.0,123.0,123.0
207402.0,6,3,426,2,280,0.0,214.0,140.0,1,146,0.0,146.0,146.0
38208.0,6,14,4740,7,653,5925.833333333333,249.0,93.28571428571428,7,4087,6221.833333333333,1514.0,583.8571428571429
15310.0,6,19,7540,11,978,1531.0,310.0,88.9090909090909,8,6562,1870.2857142857144,1514.0,820.25
232937.0,6,3,337,2,214,0.0,160.0,107.0,1,123,0.0,123.0,123.0
90529174.0,6,13,2036,8,1016,12932739.142857144,188.0,127.0,5,1020,22591293.0,204.0,204.0
298121.0,6,6,412,4,272,99373.66666666669,74.0,68.0,2,140,0.0,74.0,70.0
215558.0,17,2,180,1,90,0.0,90.0,90.0,1,90,0.0,90.0,90.0
29988.0,6,14,4740,7,653,4853.166666666667,249.0,93.28571428571428,7,4087,4463.666666666667,1514.0,583.8571428571429
312.0,17,2,168,1,76,0.0,76.0,76.0,1,92,0.0,92.0,92.0
79037177.0,6,9,842,9,842,9879647.125,97.0,93.55555555555556,0,0,0.0,0.0,0.0
160212.0,17,2,180,1,90,0.0,90.0,90.0,1,90,0.0,90.0,90.0
29031.0,6,14,4740,7,653,4260.0,249.0,93.28571428571428,7,4087,4694.333333333333,1514.0,583.8571428571429
108106007.0,17,5,955,5,955,27026501.75,191.0,191.0,0,0,0.0,0.0,0.0
810894.0,6,6,758,3,410,401438.0,172.0,136.66666666666666,3,348,285261.5,135.0,116.0
307914.0,6,6,412,4,272,102638.0,74.0,68.0,2,140,0.0,74.0,70.0
104302.0,17,2,700,2,700,0.0,350.0,350.0,0,0,0.0,0.0,0.0
5622714.0,6,5,336,2,134,0.0,68.0,67.0,3,202,1514396.5,70.0,67.33333333333333
504268.00000000006,6,5,336,2,134,0.0,68.0,67.0,3,202,193969.5,70.0,67.33333333333333
26117.0,6,10,2032,5,524,6305.0,252.0,104.8,5,1508,6267.0,1236.0,301.6
105699500.0,6,30,2238,15,1086,7549934.285714285,123.0,72.4,15,1152,7000728.142857143,123.0,76.8
9319.0,6,10,1067,5,536,2144.25,264.0,107.2,5,531,2050.25,259.0,106.2
319825.0,17,4,1400,4,1400,106608.33333333331,350.0,350.0,0,0,0.0,0.0,0.0
461.0,17,2,166,1,75,0.0,75.0,75.0,1,91,0.0,91.0,91.0
90045773.0,17,28,13364,28,13364,3335028.6296296297,501.0,477.2857142857143,0,0,0.0,0.0,0.0
945671.0,6,12,1354,6,723,187969.8,253.0,120.5,6,631,187668.4,293.0,105.16666666666669
56899.0,6,13,1394,7,797,9401.166666666666,253.0,113.85714285714286,6,597,10893.2,259.0,99.5
120000033.0,6,22,1680,12,935,10909093.909090908,95.0,77.91666666666667,10,745,10000621.0,95.0,74.5
37328.0,6,14,4740,7,653,5052.833333333333,249.0,93.28571428571428,7,4087,5869.833333333333,1514.0,583.8571428571429
153364.0,17,2,180,1,90,0.0,90.0,90.0,1,90,0.0,90.0,90.0
547.0,17,2,762,2,762,0.0,381.0,381.0,0,0,0.0,0.0,0.0
108072956.0,17,5,955,5,955,27018239.0,191.0,191.0,0,0,0.0,0.0,0.0
1419.0,17,2,762,2,762,0.0,381.0,381.0,0,0,0.0,0.0,0.0
125156.0,6,15,4806,8,719,17637.285714285714,249.0,89.875,7,4087,20595.666666666668,1514.0,583.8571428571429
2466.0,17,4,344,2,150,0.0,75.0,75.0,2,194,0.0,103.0,97.0
46676.0,6,14,4740,7,653,7578.333333333333,249.0,93.28571428571428,7,4087,6325.166666666667,1514.0,583.8571428571429
17690.0,6,2,145,2,145,0.0,91.0,72.5,0,0,0.0,0.0,0.0
2973.0,17,2,224,1,76,0.0,76.0,76.0,1,148,0.0,148.0,148.0
128630.0,6,2,132,1,66,0.0,66.0,66.0,1,66,0.0,66.0,66.0
1163819.0,6,13,3010,8,2382,166259.85714285713,1514.0,297.75,5,628,222775.25,331.0,125.6
211710.0,17,2,180,1,90,0.0,90.0,90.0,1,90,0.0,90.0,90.0
228223.0,17,2,180,1,90,0.0,90.0,90.0,1,90,0.0,90.0,90.0
39948.0,6,14,4740,7,653,6447.666666666667,249.0,93.28571428571428,7,4087,6514.666666666667,1514.0,583.8571428571429
750.0,17,4,438,2,148,0.0,74.0,74.0,2,290,0.0,147.0,145.0
107838367.0,6,28,1860,14,966,8278668.461538462,123.0,69.0,14,894,8278669.692307692,123.0,63.85714285714285
5621435.0,6,5,336,2,134,0.0,68.0,67.0,3,202,1525960.0,70.0,67.33333333333333
2493.0,17,4,344,2,150,0.0,75.0,75.0,2,194,0.0,103.0,97.0
90013973.0,17,28,13364,28,13364,3333850.851851852,501.0,477.2857142857143,0,0,0.0,0.0,0.0
122383.0,6,3,373,2,238,0.0,172.0,119.0,1,135,0.0,135.0,135.0
147659.0,17,4,1400,4,1400,49219.66666666666,350.0,350.0,0,0,0.0,0.0,0.0
509645.0,6,5,336,2,134,0.0,68.0,67.0,3,202,192062.5,70.0,67.33333333333333
320435.0,17,4,1400,4,1400,106811.66666666669,350.0,350.0,0,0,0.0,0.0,0.0
107427.0,17,2,286,2,286,0.0,143.0,143.0,0,0,0.0,0.0,0.0
215744.0,6,10,1221,6,636,43148.8,298.0,106.0,4,585,71016.33333333333,379.0,146.25
27931.0,6,10,2032,5,524,5914.75,252.0,104.8,5,1508,6464.25,1236.0,301.6
8329.0,17,4,823,2,163,0.0,89.0,81.5,2,660,0.0,443.0,330.0
47195.0,6,14,4740,7,653,6095.5,249.0,93.28571428571428,7,4087,7689.333333333333,1514.0,583.8571428571429
77263.0,6,14,4740,7,653,11982.0,249.0,93.28571428571428,7,4087,12653.5,1514.0,583.8571428571429
0.0,17,1,90,1,90,0.0,90.0,90.0,0,0,0.0,0.0,0.0
120366543.0,6,227,25578,114,17824,1065190.646017699,284.0,156.35087719298247,113,7754,1065410.892857143,140.0,68.61946902654867
36166.0,6,10,2032,5,524,8824.5,252.0,104.8,5,1508,7815.25,1236.0,301.6
298636.0,6,6,412,4,272,99545.33333333331,74.0,68.0,2,140,0.0,74.0,70.0
116470874.0,6,48,3168,24,1584,5063951.043478261,66.0,66.0,24,1584,5050283.217391305,66.0,66.0
123260542.0,6,49,3234,25,1650,5135855.916666667,66.0,66.0,24,1584,5127334.956521739,66.0,66.0
104024.0,17,2,286,2,286,0.0,143.0,143.0,0,0,0.0,0.0,0.0
90284843.0,6,15,1097,8,596,12897834.714285716,95.0,74.5,7,501,14999275.333333334,95.0,71.57142857142857
2385178.0,6,2,132,1,66,0.0,66.0,66.0,1,66,0.0,66.0,66.0
103455.0,17,2,286,2,286,0.0,143.0,143.0,0,0,0.0,0.0,0.0
506581.0,6,4,270,2,134,0.0,68.0,67.0,2,136,0.0,70.0,68.0
120062492.0,6,218,24662,109,7416,1105195.1574074074,140.0,68.03669724770643,109,17246,1104224.787037037,284.0,158.22018348623854
218571.0,6,3,426,2,280,0.0,214.0,140.0,1,146,0.0,146.0,146.0
108083524.0,17,5,1005,5,1005,27020881.0,201.0,201.0,0,0,0.0,0.0,0.0
106067716.0,6,185,20932,93,6434,1152909.956521739,140.0,69.18279569892474,92,14498,1154271.7032967033,300.0,157.58695652173913
35148.0,6,14,4740,7,653,5412.666666666667,249.0,93.28571428571428,7,4087,5713.333333333333,1514.0,583.8571428571429
120294502.0,6,222,25106,111,7548,1086147.7545454546,140.0,68.0,111,17558,1086141.9,284.0,158.18018018018017
106498.0,17,2,286,2,286,0.0,143.0,143.0,0,0,0.0,0.0,0.0
816.0,17,4,438,2,148,0.0,74.0,74.0,2,290,0.0,147.0,145.0
853.0,17,2,762,2,762,0.0,381.0,381.0,0,0,0.0,0.0,0.0
326238.0,17,4,1400,4,1400,108746.0,350.0,350.0,0,0,0.0,0.0,0.0
2316.0,17,4,344,2,150,0.0,75.0,75.0,2,194,0.0,103.0,97.0
153355.0,17,2,180,1,90,0.0,90.0,90.0,1,90,0.0,90.0,90.0
45867.0,6,14,4740,7,653,7512.333333333333,249.0,93.28571428571428,7,4087,6759.833333333333,1514.0,583.8571428571429
5006214.0,17,4,629,2,156,0.0,78.0,78.0,2,473,0.0,268.0,236.5
472625.0,6,4,508,2,238,0.0,172.0,119.0,2,270,0.0,135.0,135.0
253108.0,6,3,337,2,214,0.0,160.0,107.0,1,123,0.0,123.0,123.0
135133979.0,17,6,1146,6,1146,27026795.8,191.0,191.0,0,0,0.0,0.0,0.0
108467521.0,6,192,21648,96,15090,1139459.8421052631,284.0,157.1875,96,6558,1139467.852631579,140.0,68.3125
29917.0,6,14,4740,7,653,4864.333333333333,249.0,93.28571428571428,7,4087,4611.0,1514.0,583.8571428571429
561.0,17,2,508,2,508,0.0,257.0,254.0,0,0,0.0,0.0,0.0
108111768.0,17,5,955,5,955,27027942.0,191.0,191.0,0,0,0.0,0.0,0.0
505852.0,6,5,336,2,134,0.0,68.0,67.0,3,202,196756.0,70.0,67.33333333333333
10441621.0,6,7,478,4,272,3435222.333333333,74.0,68.0,3,206,5152720.0,74.0,68.66666666666667
197076.0,17,2,180,1,90,0.0,90.0,90.0,1,90,0.0,90.0,90.0
90286040.0,6,17,1287,9,691,11279671.5,95.0,76.77777777777777,8,596,12832296.714285716,95.0,74.5
60469.0,6,14,4740,7,653,9954.166666666666,249.0,93.28571428571428,7,4087,8307.0,1514.0,583.8571428571429
105286843.0,6,31,2314,16,1228,7004733.866666666,139.0,76.75,15,1086,7505015.857142857,123.0,72.4
120123279.0,6,12,1832,8,1016,17136944.57142857,188.0,127.0,4,816,30031561.0,204.0,204.0
120034.0,17,2,180,1,70,0.0,70.0,70.0,1,110,0.0,110.0,110.0
964.0,17,4,438,2,148,0.0,74.0,74.0,2,290,0.0,147.0,145.0
119900616.0,17,35,16705,35,16705,3526488.705882353,501.0,477.2857142857143,0,0,0.0,0.0,0.0
277393.0,17,2,363,1,79,0.0,79.0,79.0,1,284,0.0,284.0,284.0
100380315.0,17,12,778,6,389,20076063.0,174.0,64.83333333333333,6,389,19969919.8,174.0,64.83333333333333
120066485.0,17,29,13785,29,13785,4288088.75,501.0,475.3448275862069,0,0,0.0,0.0,0.0
0.0,17,1,90,1,90,0.0,90.0,90.0,0,0,0.0,0.0,0.0
1531260.0,6,7,499,4,301,452440.6666666667,103.0,75.25,3,198,716662.0,66.0,66.0
211360.0,17,2,180,1,90,0.0,90.0,90.0,1,90,0.0,90.0,90.0
120186171.0,6,364,43028,182,12308,659531.6464088397,140.0,67.62637362637362,182,30720,659464.906077348,374.0,168.7912087912088
70127.0,6,14,4740,7,653,10784.833333333334,249.0,93.28571428571428,7,4087,11500.666666666666,1514.0,583.8571428571429
103385040.0,6,41,3292,23,1837,4689509.909090909,139.0,79.8695652173913,18,1455,6068775.411764706,123.0,80.83333333333333
120340197.0,6,231,26224,116,18338,1046436.495652174,284.0,158.08620689655172,115,7886,1046406.9824561405,140.0,68.57391304347826
135126856.0,17,6,1206,6,1206,27025371.2,201.0,201.0,0,0,0.0,0.0,0.0
26178.0,6,10,2032,5,524,6292.0,252.0,104.8,5,1508,6272.0,1236.0,301.6
34677.0,6,14,4740,7,653,5654.333333333333,249.0,93.28571428571428,7,4087,5639.0,1514.0,583.8571428571429
8556.0,17,4,344,2,150,0.0,75.0,75.0,2,194,0.0,103.0,97.0
41219.0,6,10,2032,5,524,10092.0,252.0,104.8,5,1508,8892.0,1236.0,301.6
232259.0,6,3,337,2,214,0.0,160.0,107.0,1,123,0.0,123.0,123.0
1983.0,17,4,344,2,150,0.0,75.0,75.0,2,194,0.0,103.0,97.0
3050440.0,6,5,336,3,202,1525220.0,70.0,67.33333333333333,2,134,0.0,68.0,67.0
90708653.0,6,21,1585,10,745,10078739.222222222,95.0,74.5,11,840,9044612.4,95.0,76.36363636363636
103821.0,17,2,286,2,286,0.0,143.0,143.0,0,0,0.0,0.0,0.0
90289331.0,6,17,1287,9,691,11280387.5,95.0,76.77777777777777,8,596,12834199.714285716,95.0,74.5
10487983.0,6,7,478,4,272,3450331.333333333,74.0,68.0,3,206,5175390.0,74.0,68.66666666666667
321582.0,6,6,412,4,272,107194.0,74.0,68.0,2,140,0.0,74.0,70.0
257880.0,6,10,1221,6,636,51576.0,298.0,106.0,4,585,80211.0,379.0,146.25
284372.0,17,4,571,2,148,0.0,74.0,74.0,2,423,0.0,280.0,211.5
120006577.0,17,13,559,7,301,20001096.166666668,43.0,43.0,6,258,20000169.6,43.0,43.0
2298.0,17,4,344,2,150,0.0,75.0,75.0,2,194,0.0,103.0,97.0
1352317.0,17,5,961,3,234,675929.5,78.0,78.0,2,727,0.0,395.0,363.5
341211.0,17,2,180,1,90,0.0,90.0,90.0,1,90,0.0,90.0,90.0
675.0,17,5,550,5,550,168.75,110.0,110.0,0,0,0.0,0.0,0.0
120002443.0,6,17,1287,9,691,15000305.375,95.0,76.77777777777777,8,596,12858182.285714284,95.0,74.5
120102557.0,6,17,2836,9,1204,15012819.625,188.0,133.77777777777777,8,1632,12904084.857142856,204.0,204.0
42500.0,6,10,2032,5,524,10412.0,252.0,104.8,5,1508,10358.25,1236.0,301.6
401991.0,6,4,508,2,238,0.0,172.0,119.0,2,270,0.0,135.0,135.0
233594.0,6,3,337,2,214,0.0,160.0,107.0,1,123,0.0,123.0,123.0
1027862.0,6,11,1134,6,558,205572.4,220.0,93.0,5,576,255085.0,304.0,115.2
104968.0,17,2,286,2,286,0.0,143.0,143.0,0,0,0.0,0.0,0.0
90538845.0,6,17,2572,9,1204,11317355.625,188.0,133.77777777777777,8,1368,12910883.857142856,204.0,171.0
44201.0,6,14,4740,7,653,6814.666666666667,249.0,93.28571428571428,7,4087,7022.833333333333,1514.0,583.8571428571429
326.0,17,2,174,1,79,0.0,79.0,79.0,1,95,0.0,95.0,95.0
245566.0,6,3,337,2,214,0.0,160.0,107.0,1,123,0.0,123.0,123.0
2543263.0,6,3,204,2,136,0.0,70.0,68.0,1,68,0.0,68.0,68.0
734892.0,6,11,1021,6,444,98400.8,162.0,74.0,5,577,122814.0,349.0,115.4
1818415.0,6,7,499,4,301,547380.6666666666,103.0,75.25,3,198,819619.5,66.0,66.0
247088.0,6,10,1221,6,636,49417.6,298.0,106.0,4,585,81181.0,379.0,146.25
363420.0,6,11,1021,6,444,48815.0,162.0,74.0,5,577,60944.75,349.0,115.4
228251.0,17,2,180,1,90,0.0,90.0,90.0,1,90,0.0,90.0,90.0
127001007.0,17,15,907,8,475,18143001.0,174.0,59.375,7,432,17832524.333333332,174.0,61.71428571428572
90933021.0,6,21,1585,11,840,9091976.3,95.0,76.36363636363636,10,745,10102422.111111112,95.0,74.5
179918.0,17,2,180,1,90,0.0,90.0,90.0,1,90,0.0,90.0,90.0
16444.0,6,11,2098,6,590,3036.0,252.0,98.33333333333331,5,1508,3839.25,1236.0,301.6
2401.0,17,4,344,2,150,0.0,75.0,75.0,2,194,0.0,103.0,97.0
2694672.0,6,3,1604,1,753,0.0,753.0,753.0,2,851,0.0,785.0,425.5
15038816.0,17,6,2718,6,2718,3007763.2,453.0,453.0,0,0,0.0,0.0,0.0
5501077.0,6,5,336,2,134,0.0,68.0,67.0,3,202,1357916.0,70.0,67.33333333333333
237750.0,17,2,180,1,90,0.0,90.0,90.0,1,90,0.0,90.0,90.0
332.0,17,2,166,1,75,0.0,75.0,75.0,1,91,0.0,91.0,91.0
41602.0,6,10,2032,5,524,10096.75,252.0,104.8,5,1508,9393.75,1236.0,301.6
90296797.0,6,16,1192,8,596,12893190.285714284,95.0,74.5,8,596,12897650.285714284,95.0,74.5
317.0,17,2,174,1,79,0.0,79.0,79.0,1,95,0.0,95.0,95.0
2598.0,17,2,664,1,322,0.0,322.0,322.0,1,342,0.0,342.0,342.0
1302539.0,6,4,264,2,132,0.0,66.0,66.0,2,132,0.0,66.0,66.0
127602478.0,17,14,864,7,432,18001105.0,174.0,61.71428571428572,7,432,18000161.0,174.0,61.71428571428572
148574.0,17,2,414,1,88,0.0,88.0,88.0,1,326,0.0,326.0,326.0
121285.0,6,3,337,2,214,0.0,160.0,107.0,1,123,0.0,123.0,123.0
196957.0,17,2,180,1,90,0.0,90.0,90.0,1,90,0.0,90.0,90.0
147874.0,17,2,180,1,90,0.0,90.0,90.0,1,90,0.0,90.0,90.0
298876.0,6,6,412,4,272,99625.33333333331,74.0,68.0,2,140,0.0,74.0,70.0
94477.0,6,14,4740,7,653,14966.166666666666,249.0,93.28571428571428,7,4087,15431.333333333334,1514.0,583.8571428571429
90067101.0,17,28,13364,28,13364,3335818.5555555555,501.0,477.2857142857143,0,0,0.0,0.0,0.0
115744.0,17,4,1400,4,1400,38581.333333333336,350.0,350.0,0,0,0.0,0.0,0.0
198327.0,17,4,6056,4,6056,66109.0,1514.0,1514.0,0,0,0.0,0.0,0.0
228178.0,17,2,180,1,90,0.0,90.0,90.0,1,90,0.0,90.0,90.0
2589566.0,6,2,132,1,66,0.0,66.0,66.0,1,66,0.0,66.0,66.0
103224.0,17,2,286,2,286,0.0,143.0,143.0,0,0,0.0,0.0,0.0
147395.0,6,3,373,2,238,0.0,172.0,119.0,1,135,0.0,135.0,135.0
1321602.0,6,4,264,2,132,0.0,66.0,66.0,2,132,0.0,66.0,66.0
46912.0,6,14,4740,7,653,7695.333333333333,249.0,93.28571428571428,7,4087,6721.5,1514.0,583.8571428571429
120124891.0,6,15,2428,9,1204,15015611.375,188.0,133.77777777777777,6,1224,18072874.2,204.0,204.0
22349.0,6,14,4740,7,653,3571.5,249.0,93.28571428571428,7,4087,2852.333333333333,1514.0,583.8571428571429
39641.0,6,14,4740,7,653,6295.0,249.0,93.28571428571428,7,4087,6280.833333333333,1514.0,583.8571428571429
3056413.0,6,3,1604,2,851,0.0,785.0,425.5,1,753,0.0,753.0,753.0
98719.0,17,2,700,2,700,0.0,350.0,350.0,0,0,0.0,0.0,0.0
26592.0,6,14,4740,7,653,3858.6666666666665,249.0,93.28571428571428,7,4087,4231.5,1514.0,583.8571428571429
120151271.0,6,408,48182,204,13760,587896.4630541872,140.0,67.45098039215686,204,34422,587950.1280788177,284.0,168.73529411764707
90523952.0,6,17,2572,9,1204,11315494.0,188.0,133.77777777777777,8,1368,12908669.285714284,204.0,171.0
46114.0,6,14,4740,7,653,7473.833333333333,249.0,93.28571428571428,7,4087,7541.166666666667,1514.0,583.8571428571429
120122663.0,6,15,2428,9,1204,15015332.875,188.0,133.77777777777777,6,1224,18072861.2,204.0,204.0
43010287.0,6,4,1843,3,1017,21505143.5,885.0,339.0,1,826,0.0,826.0,826.0
31332.0,6,14,4740,7,653,4508.333333333333,249.0,93.28571428571428,7,4087,4962.666666666667,1514.0,583.8571428571429
190776.0,17,2,180,1,90,0.0,90.0,90.0,1,90,0.0,90.0,90.0
2312.0,17,4,344,2,150,0.0,75.0,75.0,2,194,0.0,103.0,97.0
90257386.0,6,12,1832,8,1016,12893912.285714284,188.0,127.0,4,816,30031169.33333333,204.0,204.0
317946.0,17,4,1400,4,1400,105982.0,350.0,350.0,0,0,0.0,0.0,0.0
27270041.0,17,5,1710,5,1710,6817510.25,342.0,342.0,0,0,0.0,0.0,0.0
72638.0,6,14,4740,7,653,11968.333333333334,249.0,93.28571428571428,7,4087,10116.333333333334,1514.0,583.8571428571429
149738154.0,17,36,17126,36,17126,4278232.971428571,501.0,475.72222222222223,0,0,0.0,0.0,0.0
334.0,17,2,166,1,75,0.0,75.0,75.0,1,91,0.0,91.0,91.0
90287317.0,6,16,1192,8,596,12892070.0,95.0,74.5,8,596,12897194.857142856,95.0,74.5
247928.0,6,3,337,2,214,0.0,160.0,107.0,1,123,0.0,123.0,123.0
602191.0,6,4,508,2,238,0.0,172.0,119.0,2,270,0.0,135.0,135.0
2600391.0,6,2,132,1,66,0.0,66.0,66.0,1,66,0.0,66.0,66.0
216407.0,6,3,426,2,280,0.0,214.0,140.0,1,146,0.0,146.0,146.0
96868337.0,17,11,735,6,389,19373667.4,174.0,64.83333333333333,5,346,19260678.0,174.0,69.2
364.0,17,2,204,1,88,0.0,88.0,88.0,1,116,0.0,116.0,116.0
54552.0,6,10,2032,5,524,13394.75,252.0,104.8,5,1508,13162.75,1236.0,301.6
5624234.0,6,4,270,2,134,0.0,68.0,67.0,2,136,0.0,70.0,68.0
135126755.0,17,6,1146,6,1146,27025351.0,191.0,191.0,0,0,0.0,0.0,0.0
171601.0,17,2,180,1,90,0.0,90.0,90.0,1,90,0.0,90.0,90.0
150065.0,6,4,439,2,238,0.0,172.0,119.0,2,201,0.0,135.0,100.5
312110.0,17,4,1400,4,1400,104036.66666666669,350.0,350.0,0,0,0.0,0.0,0.0
74293.0,6,10,2032,5,524,18332.0,252.0,104.8,5,1508,16153.0,1236.0,301.6
26685.0,6,14,4740,7,653,4311.666666666667,249.0,93.28571428571428,7,4087,4308.0,1514.0,583.8571428571429
119256407.0,6,297,34990,149,24926,805786.5337837838,284.0,167.28859060402684,148,10064,805047.0476190476,140.0,68.0
14261.0,6,10,2032,5,524,2820.75,252.0,104.8,5,1508,3272.25,1236.0,301.6
26551.0,6,10,2032,5,524,6414.25,252.0,104.8,5,1508,5020.0,1236.0,301.6
57891.0,6,10,2032,5,524,14212.5,252.0,104.8,5,1508,13911.0,1236.0,301.6
126542944.0,6,36,2602,19,1408,7030163.555555556,139.0,74.10526315789474,17,1194,7271338.6875,123.0,70.23529411764706
7861.999999999999,17,4,823,2,163,0.0,89.0,81.5,2,660,0.0,443.0,330.0
186795.0,17,2,180,1,90,0.0,90.0,90.0,1,90,0.0,90.0,90.0
212367.0,17,2,762,2,762,0.0,381.0,381.0,0,0,0.0,0.0,0.0
103178895.0,6,189,21398,95,6566,1097647.819148936,140.0,69.11578947368422,94,14832,1104906.569892473,284.0,157.7872340425532
0.0,17,1,136,1,136,0.0,136.0,136.0,0,0,0.0,0.0,0.0
2478.0,17,4,344,2,150,0.0,75.0,75.0,2,194,0.0,103.0,97.0
2283.0,17,4,344,2,150,0.0,75.0,75.0,2,194,0.0,103.0,97.0
171732.0,17,2,180,1,90,0.0,90.0,90.0,1,90,0.0,90.0,90.0
1306955.0,6,4,264,2,132,0.0,66.0,66.0,2,132,0.0,66.0,66.0
14913.0,17,2,180,1,90,0.0,90.0,90.0,1,90,0.0,90.0,90.0
209507.0,17,2,180,1,90,0.0,90.0,90.0,1,90,0.0,90.0,90.0
123250508.0,6,49,3234,25,1650,5135437.833333333,66.0,66.0,24,1584,5179035.652173913,66.0,66.0
28622.0,6,14,4740,7,653,2377.6666666666665,249.0,93.28571428571428,7,4087,4630.166666666667,1514.0,583.8571428571429
104778878.0,6,43,2838,22,1452,4979196.523809524,66.0,66.0,21,1386,5105433.1,66.0,66.0
90033557.0,17,28,13364,28,13364,3334576.185185185,501.0,477.2857142857143,0,0,0.0,0.0,0.0
41881.0,6,10,2032,5,524,10148.0,252.0,104.8,5,1508,10175.25,1236.0,301.6
15019.0,17,2,180,1,90,0.0,90.0,90.0,1,90,0.0,90.0,90.0
1312063.0,6,4,264,2,132,0.0,66.0,66.0,2,132,0.0,66.0,66.0
117595161.0,6,48,3168,24,1584,5112833.0869565215,66.0,66.0,24,1584,5099161.217391305,66.0,66.0
135128185.0,17,6,1206,6,1206,27025637.0,201.0,201.0,0,0,0.0,0.0,0.0
10519047.0,6,7,478,4,272,3459556.0,74.0,68.0,3,206,5189216.5,74.0,68.66666666666667
228185.0,17,2,180,1,90,0.0,90.0,90.0,1,90,0.0,90.0,90.0
362770.0,17,2,363,1,75,0.0,75.0,75.0,1,288,0.0,288.0,288.0
135138503.0,17,6,1146,6,1146,27027700.6,191.0,191.0,0,0,0.0,0.0,0.0
116791790.0,6,48,3168,24,1584,5077903.913043479,66.0,66.0,24,1584,5065933.304347826,66.0,66.0
113049.0,6,14,4740,7,653,18718.33333333333,249.0,93.28571428571428,7,4087,18458.0,1514.0,583.8571428571429
318476.0,17,4,704,2,148,0.0,74.0,74.0,2,556,0.0,280.0,278.0
120290152.0,6,247,27894,124,8554,971293.243902439,140.0,68.98387096774194,123,19340,979278.9098360656,284.0,157.2357723577236
437395.0,6,11,1021,6,444,58641.6,162.0,74.0,5,577,73226.0,349.0,115.4
46282.0,6,14,4740,7,653,6291.333333333333,249.0,93.28571428571428,7,4087,7217.166666666667,1514.0,583.8571428571429
10515793.0,6,7,478,4,272,3458492.333333333,74.0,68.0,3,206,5187639.0,74.0,68.66666666666667
107860534.0,6,28,1860,14,966,8280347.538461538,123.0,69.0,14,894,8280360.0,123.0,63.85714285714285
102884.0,17,2,286,2,286,0.0,143.0,143.0,0,0,0.0,0.0,0.0
103347.0,17,2,286,2,286,0.0,143.0,143.0,0,0,0.0,0.0,0.0
2522232.0,6,3,1602,1,752,0.0,752.0,752.0,2,850,0.0,784.0,425.0
97648892.0,6,192,21680,97,15262,1017175.9583333334,284.0,157.340206185567,95,6418,1020195.914893617,140.0,67.5578947368421
44127.0,6,10,2032,5,524,9878.0,252.0,104.8,5,1508,10539.75,1236.0,301.6
205722.0,17,2,180,1,90,0.0,90.0,90.0,1,90,0.0,90.0,90.0
13445.0,6,11,2098,6,590,2046.8,252.0,98.33333333333331,5,1508,3117.5,1236.0,301.6
153461.0,17,2,180,1,90,0.0,90.0,90.0,1,90,0.0,90.0,90.0
118000880.0,17,13,821,7,432,19666813.33333333,174.0,61.71428571428572,6,389,19600677.2,174.0,64.83333333333333
120009024.0,6,262,29916,132,21114,916099.4198473282,300.0,159.95454545454547,130,8802,925405.4651162792,140.0,67.70769230769231
112298422.0,6,204,23124,103,16236,1100964.9215686277,284.0,157.63106796116506,101,6888,1102425.97,140.0,68.1980198019802
198570.0,17,2,180,1,90,0.0,90.0,90.0,1,90,0.0,90.0,90.0
224800.0,17,4,1524,4,1524,74933.33333333333,381.0,381.0,0,0,0.0,0.0,0.0
108104175.0,17,5,955,5,955,27026043.75,191.0,191.0,0,0,0.0,0.0,0.0
153419.0,17,2,180,1,90,0.0,90.0,90.0,1,90,0.0,90.0,90.0
153466.0,17,2,180,1,90,0.0,90.0,90.0,1,90,0.0,90.0,90.0
90298991.0,6,16,1192,8,596,12893130.285714284,95.0,74.5,8,596,12898247.42857143,95.0,74.5
0.0,17,1,55,1,55,0.0,55.0,55.0,0,0,0.0,0.0,0.0
1311706.0,17,7,490,7,490,218617.66666666663,70.0,70.0,0,0,0.0,0.0,0.0
5617677.0,6,4,270,2,134,0.0,68.0,67.0,2,136,0.0,70.0,68.0
40027.0,6,10,2032,5,524,9585.5,252.0,104.8,5,1508,9423.25,1236.0,301.6
301389.0,6,6,412,4,272,100463.0,74.0,68.0,2,140,0.0,74.0,70.0
18625.0,6,14,4740,7,653,2806.833333333333,249.0,93.28571428571428,7,4087,2605.5,1514.0,583.8571428571429
119457092.0,17,34,16284,34,16284,3619911.878787879,501.0,478.9411764705882,0,0,0.0,0.0,0.0
2500.0,17,4,344,2,150,0.0,75.0,75.0,2,194,0.0,103.0,97.0
24691.0,6,14,4740,7,653,3235.333333333333,249.0,93.28571428571428,7,4087,3933.1666666666665,1514.0,583.8571428571429
197030.0,17,2,180,1,90,0.0,90.0,90.0,1,90,0.0,90.0,90.0
298696.0,6,3,202,2,128,0.0,74.0,64.0,1,74,0.0,74.0,74.0
143350.0,6,2,132,1,66,0.0,66.0,66.0,1,66,0.0,66.0,66.0
1307001.0,6,4,264,2,132,0.0,66.0,66.0,2,132,0.0,66.0,66.0
11231.0,6,10,1066,5,490,2517.75,218.0,98.0,5,576,2605.0,304.0,115.2
1830012.0,17,6,1039,4,312,609880.0,78.0,78.0,2,727,0.0,395.0,363.5
120034688.0,17,29,13785,29,13785,4286953.142857143,501.0,475.3448275862069,0,0,0.0,0.0,0.0
103509.0,17,2,286,2,286,0.0,143.0,143.0,0,0,0.0,0.0,0.0
309948.0,6,6,412,4,272,103316.0,74.0,68.0,2,140,0.0,74.0,70.0
102984824.0,6,42,2772,21,1386,5135435.45,66.0,66.0,21,1386,5135468.45,66.0,66.0
2332.0,17,4,344,2,150,0.0,75.0,75.0,2,194,0.0,103.0,97.0
120124974.0,6,14,2224,9,1204,15015621.75,188.0,133.77777777777777,5,1020,22592426.0,204.0,204.0
865577.0,6,9,1266,6,795,173115.4,457.0,132.5,3,471,296527.5,331.0,157.0
115827254.0,6,537,74840,269,17976,432191.2462686568,140.0,66.82527881040892,268,56864,432938.5805243446,300.0,212.179104477612
45205.0,6,14,4740,7,653,7325.833333333333,249.0,93.28571428571428,7,4087,7377.833333333333,1514.0,583.8571428571429
439843.0,6,11,1021,6,444,59242.2,162.0,74.0,5,577,73901.25,349.0,115.4
153405.0,17,2,180,1,90,0.0,90.0,90.0,1,90,0.0,90.0,90.0
135134862.0,17,6,1146,6,1146,27026972.4,191.0,191.0,0,0,0.0,0.0,0.0
55550.0,6,10,2032,5,524,13627.25,252.0,104.8,5,1508,13064.0,1236.0,301.6
1407997.0,17,7,490,7,490,234666.16666666663,70.0,70.0,0,0,0.0,0.0,0.0
50096.0,6,13,1479,7,882,8349.333333333334,291.0,126.0,6,597,8983.2,259.0,99.5
24538.0,6,10,2032,5,524,5672.5,252.0,104.8,5,1508,5850.0,1236.0,301.6
110303333.0,6,30,1974,15,1026,7863379.5,123.0,68.4,15,948,7863381.5,123.0,63.2
302427.0,6,2,132,1,66,0.0,66.0,66.0,1,66,0.0,66.0,66.0
10428897.0,6,6,412,3,206,5144621.5,74.0,68.66666666666667,3,206,5144422.5,74.0,68.66666666666667
2060.0,17,4,344,2,150,0.0,75.0,75.0,2,194,0.0,103.0,97.0
90287407.0,6,24,1829,13,989,7520488.0,95.0,76.07692307692308,11,840,9001001.9,95.0,76.36363636363636
211584.0,17,2,180,1,90,0.0,90.0,90.0,1,90,0.0,90.0,90.0
2886.0,17,2,224,1,76,0.0,76.0,76.0,1,148,0.0,148.0,148.0
112319603.0,6,45,2970,23,1518,5105436.5,66.0,66.0,22,1452,4910390.571428572,66.0,66.0
51733212.0,6,8,2113,3,960,24538227.0,826.0,320.0,5,1153,12238364.25,885.0,230.6
95487102.0,17,13,4454,12,4104,6771819.727272728,342.0,342.0,1,350,0.0,350.0,350.0
2417.0,17,4,344,2,150,0.0,75.0,75.0,2,194,0.0,103.0,97.0
138343.0,6,2,132,1,66,0.0,66.0,66.0,1,66,0.0,66.0,66.0
123690687.0,6,31,2097,16,1149,8246045.8,123.0,71.8125,15,948,8270685.5,123.0,63.2
277873.0,17,2,180,1,90,0.0,90.0,90.0,1,90,0.0,90.0,90.0
45808.0,6,14,4740,7,653,7416.333333333333,249.0,93.28571428571428,7,4087,7270.166666666667,1514.0,583.8571428571429
233413.0,6,3,337,2,214,0.0,160.0,107.0,1,123,0.0,123.0,123.0
560545.0,6,11,1287,6,636,112109.0,298.0,106.0,5,651,127386.0,379.0,130.2
120027168.0,17,28,13364,28,13364,4445450.666666667,501.0,477.2857142857143,0,0,0.0,0.0,0.0
155998.0,6,3,337,2,214,0.0,160.0,107.0,1,123,0.0,123.0,123.0
241209.0,6,3,337,2,214,0.0,160.0,107.0,1,123,0.0,123.0,123.0
100253663.0,6,39,3426,22,1887,4773983.952380952,123.0,85.77272727272727,17,1539,6252256.0,123.0,90.52941176470588
2343.0,17,4,344,2,150,0.0,75.0,75.0,2,194,0.0,103.0,97.0
306184.0,6,3,202,2,128,0.0,74.0,64.0,1,74,0.0,74.0,74.0
36606.0,6,14,4740,7,653,5621.0,249.0,93.28571428571428,7,4087,5554.666666666667,1514.0,583.8571428571429
146198.0,6,3,337,2,214,0.0,160.0,107.0,1,123,0.0,123.0,123.0
110220291.0,6,34,2488,18,1348,6470853.235294118,139.0,74.88888888888889,16,1140,7333635.066666666,123.0,71.25
120133823.0,6,14,2224,9,1204,15016727.875,188.0,133.77777777777777,5,1020,22526066.0,204.0,204.0
109322.0,17,4,344,2,150,0.0,75.0,75.0,2,194,0.0,103.0,97.0
9514.0,17,2,539,1,86,0.0,86.0,86.0,1,453,0.0,453.0,453.0
33946.0,6,14,4740,7,653,5069.333333333333,249.0,93.28571428571428,7,4087,5510.166666666667,1514.0,583.8571428571429
108110233.0,17,5,955,5,955,27027558.25,191.0,191.0,0,0,0.0,0.0,0.0
38054.0,6,14,4740,7,653,6215.166666666667,249.0,93.28571428571428,7,4087,6199.5,1514.0,583.8571428571429
2055083.0,6,4,270,2,134,0.0,68.0,67.0,2,136,0.0,70.0,68.0
106027.0,17,2,286,2,286,0.0,143.0,143.0,0,0,0.0,0.0,0.0
496.0,17,2,508,2,508,0.0,257.0,254.0,0,0,0.0,0.0,0.0
51691.0,6,11,2098,6,590,8875.8,252.0,98.33333333333331,5,1508,10825.5,1236.0,301.6
38294.0,6,11,2098,6,590,7165.0,252.0,98.33333333333331,5,1508,9315.0,1236.0,301.6
103844.0,17,2,762,2,762,0.0,381.0,381.0,0,0,0.0,0.0,0.0
13686498.0,6,6,433,4,301,4562166.0,103.0,75.25,2,132,0.0,66.0,66.0
24921.0,6,10,2032,5,524,5444.75,252.0,104.8,5,1508,5309.0,1236.0,301.6
65739.0,6,14,4740,7,653,10783.0,249.0,93.28571428571428,7,4087,10633.166666666666,1514.0,583.8571428571429
0.0,17,1,80,1,80,0.0,80.0,80.0,0,0,0.0,0.0,0.0
108094044.0,17,5,955,5,955,27023511.0,191.0,191.0,0,0,0.0,0.0,0.0
284000.0,17,2,363,1,79,0.0,79.0,79.0,1,284,0.0,284.0,284.0
16991.0,17,2,180,1,90,0.0,90.0,90.0,1,90,0.0,90.0,90.0
53694.0,6,14,4740,7,653,8765.0,249.0,93.28571428571428,7,4087,8808.0,1514.0,583.8571428571429
9468.0,17,2,582,1,83,0.0,83.0,83.0,1,499,0.0,499.0,499.0
197059.0,17,2,180,1,90,0.0,90.0,90.0,1,90,0.0,90.0,90.0
126271132.0,6,32,2289,17,1272,7891945.75,123.0,74.82352941176471,15,1017,8458477.0,123.0,67.8
197048.0,17,2,180,1,90,0.0,90.0,90.0,1,90,0.0,90.0,90.0
32663.0,17,2,507,1,86,0.0,86.0,86.0,1,421,0.0,421.0,421.0
90227335.0,6,21,1585,10,745,9997971.0,95.0,74.5,11,840,9001193.7,95.0,76.36363636363636
873948.0,6,9,1196,6,725,174789.6,387.0,120.83333333333331,3,471,299120.0,331.0,157.0
462622.0,6,3,1604,2,851,0.0,785.0,425.5,1,753,0.0,753.0,753.0
5630673.0,6,5,336,2,134,0.0,68.0,67.0,3,202,1426511.0,70.0,67.33333333333333
44478.0,6,14,4740,7,653,7169.166666666667,249.0,93.28571428571428,7,4087,6952.5,1514.0,583.8571428571429
118894793.0,6,31,2182,16,1165,7911928.933333334,139.0,72.8125,15,1017,8477072.142857144,123.0,67.8
2327.0,17,4,344,2,150,0.0,75.0,75.0,2,194,0.0,103.0,97.0
209988.0,17,2,762,2,762,0.0,381.0,381.0,0,0,0.0,0.0,0.0
93891690.0,6,40,2640,20,1320,4941667.894736842,66.0,66.0,20,1320,4925127.210526316,66.0,66.0
120000177.0,6,26,2019,15,1179,8571441.214285715,95.0,78.6,11,840,9046515.5,95.0,76.36363636363636
261520.0,6,3,337,2,214,0.0,160.0,107.0,1,123,0.0,123.0,123.0
100264224.0,17,14,864,7,432,16666805.666666666,174.0,61.71428571428572,7,432,16667534.833333334,174.0,61.71428571428572
90011168.0,17,28,13364,28,13364,3333746.962962963,501.0,477.2857142857143,0,0,0.0,0.0,0.0
449.0,17,2,166,1,75,0.0,75.0,75.0,1,91,0.0,91.0,91.0
0.0,17,1,55,1,55,0.0,55.0,55.0,0,0,0.0,0.0,0.0
876.0,17,4,438,2,148,0.0,74.0,74.0,2,290,0.0,147.0,145.0
171008.0,17,2,1500,1,994,0.0,994.0,994.0,1,506,0.0,506.0,506.0
250523.0,6,3,373,2,238,0.0,172.0,119.0,1,135,0.0,135.0,135.0
125829933.0,6,57,12307,30,6543,3314753.172413793,1514.0,218.1,27,5764,4831745.576923077,1514.0,213.4814814814815
207552.0,6,3,426,2,280,0.0,214.0,140.0,1,146,0.0,146.0,146.0
2070.0,17,4,344,2,150,0.0,75.0,75.0,2,194,0.0,103.0,97.0
120122152.0,6,280,33418,140,9536,862622.3525179856,140.0,68.11428571428571,140,23882,858264.45323741,464.0,170.5857142857143
60773.0,6,10,2032,5,524,14958.5,252.0,104.8,5,1508,14914.75,1236.0,301.6
135136607.0,17,6,1206,6,1206,27027321.4,201.0,201.0,0,0,0.0,0.0,0.0
1944745.0,6,23,6507,12,1529,176795.0,357.0,127.41666666666669,11,4978,162553.3,1510.0,452.54545454545456
90261396.0,6,12,1832,8,1016,12894485.142857144,188.0,127.0,4,816,30031956.33333333,204.0,204.0
2730120.0,6,3,204,2,136,0.0,70.0,68.0,1,68,0.0,68.0,68.0
26082.0,6,14,4740,7,653,4239.5,249.0,93.28571428571428,7,4087,3559.0,1514.0,583.8571428571429
316434.0,17,4,1400,4,1400,105478.0,350.0,350.0,0,0,0.0,0.0,0.0
49678.0,6,14,4740,7,653,7740.0,249.0,93.28571428571428,7,4087,7166.5,1514.0,583.8571428571429
210945.0,17,2,180,1,90,0.0,90.0,90.0,1,90,0.0,90.0,90.0
1028626.0,6,11,1134,6,558,205725.2,220.0,93.0,5,576,255533.75,304.0,115.2
113254889.0,6,46,3036,23,1518,5135437.227272728,66.0,66.0,23,1518,5135431.409090909,66.0,66.0
108108753.0,17,5,1005,5,1005,27027188.25,201.0,201.0,0,0,0.0,0.0,0.0
2593088.0,6,2,132,1,66,0.0,66.0,66.0,1,66,0.0,66.0,66.0
120003763.0,6,18,1382,9,691,14978739.5,95.0,76.77777777777777,9,691,14970012.125,95.0,76.77777777777777
120166226.0,6,198,22426,99,6830,1219025.530612245,140.0,68.98989898989899,99,15596,1218928.469387755,284.0,157.53535353535352
303117.0,17,2,180,1,90,0.0,90.0,90.0,1,90,0.0,90.0,90.0
108685337.0,6,32,2236,16,1165,7231311.733333333,139.0,72.8125,16,1071,7231298.2,123.0,66.9375
248663.0,6,3,337,2,214,0.0,160.0,107.0,1,123,0.0,123.0,123.0
135132617.0,17,6,1146,6,1146,27026523.4,191.0,191.0,0,0,0.0,0.0,0.0
369.0,17,2,174,1,79,0.0,79.0,79.0,1,95,0.0,95.0,95.0
146241.0,6,3,337,2,214,0.0,160.0,107.0,1,123,0.0,123.0,123.0
216434.0,17,2,180,1,90,0.0,90.0,90.0,1,90,0.0,90.0,90.0
38037.0,6,14,4740,7,653,6218.833333333333,249.0,93.28571428571428,7,4087,6053.5,1514.0,583.8571428571429
120062590.0,17,29,13785,29,13785,4287949.642857143,501.0,475.3448275862069,0,0,0.0,0.0,0.0
31276.0,6,14,4740,7,653,5040.0,249.0,93.28571428571428,7,4087,4986.5,1514.0,583.8571428571429
90051267.0,17,28,13364,28,13364,3335232.111111111,501.0,477.2857142857143,0,0,0.0,0.0,0.0
22928.0,6,14,4740,7,653,3658.1666666666665,249.0,93.28571428571428,7,4087,3678.5,1514.0,583.8571428571429
136520.0,17,4,1400,4,1400,45506.66666666666,350.0,350.0,0,0,0.0,0.0,0.0
302421.0,6,2,132,1,66,0.0,66.0,66.0,1,66,0.0,66.0,66.0
1580297.0,6,2,132,1,66,0.0,66.0,66.0,1,66,0.0,66.0,66.0
41605.0,6,14,4740,7,653,6714.5,249.0,93.28571428571428,7,4087,4085.1666666666665,1514.0,583.8571428571429
22085.0,6,10,2032,5,524,4033.75,252.0,104.8,5,1508,5270.5,1236.0,301.6
315410.0,6,6,412,4,272,105136.66666666669,74.0,68.0,2,140,0.0,74.0,70.0
102381.0,17,2,762,2,762,0.0,381.0,381.0,0,0,0.0,0.0,0.0
42715.0,6,10,2032,5,524,10429.75,252.0,104.8,5,1508,7217.25,1236.0,301.6
143385.0,17,2,762,2,762,0.0,381.0,381.0,0,0,0.0,0.0,0.0
120123986.0,6,13,2020,9,1204,15015498.25,188.0,133.77777777777777,4,816,30034296.33333333,204.0,204.0
795.0,17,4,438,2,148,0.0,74.0,74.0,2,290,0.0,147.0,145.0
1017461.0,6,12,1362,6,731,201404.0,253.0,121.83333333333331,6,631,202953.6,293.0,105.16666666666669
2003651.0,17,4,525,2,150,0.0,75.0,75.0,2,375,0.0,284.0,187.5
42710.0,6,14,4740,7,653,6735.0,249.0,93.28571428571428,7,4087,6932.166666666667,1514.0,583.8571428571429
323195.0,17,4,1400,4,1400,107731.66666666669,350.0,350.0,0,0,0.0,0.0,0.0
107258553.0,6,43,2838,22,1452,5092860.857142857,66.0,66.0,21,1386,5150446.05,66.0,66.0
54928525.0,6,8,1307,8,1307,7846932.142857143,172.0,163.375,0,0,0.0,0.0,0.0
47161.0,6,2,145,2,145,0.0,91.0,72.5,0,0,0.0,0.0,0.0
311128.0,17,4,1400,4,1400,103709.33333333331,350.0,350.0,0,0,0.0,0.0,0.0
233251.0,6,3,337,2,214,0.0,160.0,107.0,1,123,0.0,123.0,123.0
108104702.0,17,5,955,5,955,27026175.5,191.0,191.0,0,0,0.0,0.0,0.0
509600.00000000006,6,5,336,2,134,0.0,68.0,67.0,3,202,191509.5,70.0,67.33333333333333
197057.0,17,2,180,1,90,0.0,90.0,90.0,1,90,0.0,90.0,90.0
206498.0,6,3,426,2,280,0.0,214.0,140.0,1,146,0.0,146.0,146.0
13128.0,6,10,1067,5,536,2902.5,264.0,107.2,5,531,3059.5,259.0,106.2
120048613.0,17,28,13364,28,13364,4446244.925925926,501.0,477.2857142857143,0,0,0.0,0.0,0.0
205914.0,17,2,180,1,90,0.0,90.0,90.0,1,90,0.0,90.0,90.0
196928.0,17,2,180,1,90,0.0,90.0,90.0,1,90,0.0,90.0,90.0
1494.0,17,2,762,2,762,0.0,381.0,381.0,0,0,0.0,0.0,0.0
39651.0,6,14,4740,7,653,6320.5,249.0,93.28571428571428,7,4087,6428.833333333333,1514.0,583.8571428571429
2357.0,17,4,344,2,150,0.0,75.0,75.0,2,194,0.0,103.0,97.0
12610.0,6,10,1065,5,534,2853.25,262.0,106.8,5,531,2775.5,259.0,106.2
35861.0,6,10,2032,5,524,8687.25,252.0,104.8,5,1508,8657.5,1236.0,301.6
143887.0,17,2,180,1,90,0.0,90.0,90.0,1,90,0.0,90.0,90.0
90680651.0,6,21,1585,10,745,10075627.888888888,95.0,74.5,11,840,9043161.7,95.0,76.36363636363636
297434.0,6,6,412,4,272,99144.66666666669,74.0,68.0,2,140,0.0,74.0,70.0
135125511.0,17,6,1206,6,1206,27025102.2,201.0,201.0,0,0,0.0,0.0,0.0
29531.0,6,10,2032,5,524,7152.5,252.0,104.8,5,1508,4906.75,1236.0,301.6
2458.0,17,4,344,2,150,0.0,75.0,75.0,2,194,0.0,103.0,97.0
205844.0,17,2,180,1,90,0.0,90.0,90.0,1,90,0.0,90.0,90.0
196975.0,17,2,180,1,90,0.0,90.0,90.0,1,90,0.0,90.0,90.0
65280.00000000001,6,10,2032,5,524,15603.5,252.0,104.8,5,1508,15787.5,1236.0,301.6
29961.0,6,11,2098,6,590,5518.0,252.0,98.33333333333331,5,1508,7260.0,1236.0,301.6
453.0,17,2,508,2,508,0.0,257.0,254.0,0,0,0.0,0.0,0.0
146670.0,6,3,337,2,214,0.0,160.0,107.0,1,123,0.0,123.0,123.0
223714.0,6,3,426,2,280,0.0,214.0,140.0,1,146,0.0,146.0,146.0
3155.0,17,2,363,1,79,0.0,79.0,79.0,1,284,0.0,284.0,284.0
59656.0,6,10,2032,5,524,14629.0,252.0,104.8,5,1508,13219.0,1236.0,301.6
1302582.0,6,4,264,2,132,0.0,66.0,66.0,2,132,0.0,66.0,66.0
147850.0,17,2,180,1,90,0.0,90.0,90.0,1,90,0.0,90.0,90.0
352696.0,6,4,508,2,238,0.0,172.0,119.0,2,270,0.0,135.0,135.0
135133005.0,17,6,1146,6,1146,27026601.0,191.0,191.0,0,0,0.0,0.0,0.0
122992561.0,17,17,1779,9,911,15374070.125,174.0,101.22222222222224,8,868,14717139.285714284,174.0,108.5
198041.0,17,2,906,2,906,0.0,453.0,453.0,0,0,0.0,0.0,0.0
310823.0,17,4,1400,4,1400,103607.66666666669,350.0,350.0,0,0,0.0,0.0,0.0
90740246.0,6,19,1436,10,745,10076989.555555556,95.0,74.5,9,691,11342018.875,95.0,76.77777777777777
46249.0,6,14,4740,7,653,7141.166666666667,249.0,93.28571428571428,7,4087,7222.333333333333,1514.0,583.8571428571429
817.0,17,5,550,5,550,204.25,110.0,110.0,0,0,0.0,0.0,0.0
2337.0,17,4,344,2,150,0.0,75.0,75.0,2,194,0.0,103.0,97.0
88467.0,6,14,4740,7,653,13168.166666666666,249.0,93.28571428571428,7,4087,13858.0,1514.0,583.8571428571429
108105215.0,17,5,955,5,955,27026303.75,191.0,191.0,0,0,0.0,0.0,0.0
207234.0,6,3,426,2,280,0.0,214.0,140.0,1,146,0.0,146.0,146.0
108101909.0,17,5,955,5,955,27025477.25,191.0,191.0,0,0,0.0,0.0,0.0
55716.0,6,10,2032,5,524,11664.25,252.0,104.8,5,1508,13531.75,1236.0,301.6
90277703.0,6,16,1192,8,596,12890766.0,95.0,74.5,8,596,12895441.285714284,95.0,74.5
327.0,17,2,166,1,75,0.0,75.0,75.0,1,91,0.0,91.0,91.0
16870.0,17,2,180,1,90,0.0,90.0,90.0,1,90,0.0,90.0,90.0
1307052.0,6,4,264,2,132,0.0,66.0,66.0,2,132,0.0,66.0,66.0
2876740.0,6,11,2106,6,598,575167.4,252.0,99.66666666666669,5,1508,1751.5,1236.0,301.6
38906.0,6,10,2032,5,524,8947.5,252.0,104.8,5,1508,8920.75,1236.0,301.6
292178.0,6,12,1362,6,731,57702.2,253.0,121.83333333333331,6,631,56694.6,293.0,105.16666666666669
110437658.0,17,14,864,7,432,18334896.0,174.0,61.71428571428572,7,432,18333550.5,174.0,61.71428571428572
3007819.0,6,11,2106,6,598,601378.4,252.0,99.66666666666669,5,1508,1811.5,1236.0,301.6
120389531.0,6,233,26372,117,18420,1037840.7844827586,284.0,157.43589743589743,116,7952,1037843.0695652174,140.0,68.55172413793103
246138.0,6,3,337,2,214,0.0,160.0,107.0,1,123,0.0,123.0,123.0
838329.0,6,9,1118,6,586,167665.8,248.0,97.66666666666669,3,532,281293.0,392.0,177.33333333333334
105988797.0,6,28,1876,14,982,8136351.384615385,139.0,70.14285714285714,14,894,8136353.846153846,123.0,63.85714285714285
92740686.0,6,40,2640,20,1320,4881088.736842105,66.0,66.0,20,1320,4873268.368421053,66.0,66.0
236506.0,6,3,373,2,238,0.0,172.0,119.0,1,135,0.0,135.0,135.0
2878800.0,6,5,336,2,134,0.0,68.0,67.0,3,202,154192.0,70.0,67.33333333333333
135132790.0,17,6,1146,6,1146,27026558.0,191.0,191.0,0,0,0.0,0.0,0.0
50960.0,17,2,180,1,90,0.0,90.0,90.0,1,90,0.0,90.0,90.0
297067.0,6,6,412,4,272,99022.33333333331,74.0,68.0,2,140,0.0,74.0,70.0
90091981.0,6,12,1848,5,1020,22522707.0,204.0,204.0,7,828,15015089.833333334,188.0,118.28571428571428
95903337.0,6,40,2640,20,1320,5047544.052631579,66.0,66.0,20,1320,5031688.52631579,66.0,66.0
5819925.0,6,5,336,2,134,0.0,68.0,67.0,3,202,1520698.5,70.0,67.33333333333333
5800.0,17,2,180,1,90,0.0,90.0,90.0,1,90,0.0,90.0,90.0
90097543.0,6,11,1644,4,816,30031756.33333333,204.0,204.0,7,828,15015873.5,188.0,118.28571428571428
93405236.0,6,40,2640,20,1320,4916065.052631579,66.0,66.0,20,1320,4899519.842105263,66.0,66.0
19573755.0,6,5,1736,2,819,0.0,753.0,409.5,3,917,9718374.5,785.0,305.6666666666667
314235.0,6,3,202,2,128,0.0,74.0,64.0,1,74,0.0,74.0,74.0
1138495.0,6,11,1134,6,558,227699.0,220.0,93.0,5,576,282306.0,304.0,115.2
147313.0,6,3,373,2,238,0.0,172.0,119.0,1,135,0.0,135.0,135.0
5096.0,17,2,762,2,762,0.0,381.0,381.0,0,0,0.0,0.0,0.0
120481570.0,6,21,1585,11,840,9046729.4,95.0,76.36363636363636,10,745,13382409.111111112,95.0,74.5
120224762.0,6,220,24884,110,7556,1095469.733944954,140.0,68.69090909090909,110,17328,1095415.2110091744,284.0,157.52727272727273
238159.0,6,3,337,2,214,0.0,160.0,107.0,1,123,0.0,123.0,123.0
135133536.0,17,6,1146,6,1146,27026707.2,191.0,191.0,0,0,0.0,0.0,0.0
31907.0,6,14,4740,7,653,5202.166666666667,249.0,93.28571428571428,7,4087,4595.333333333333,1514.0,583.8571428571429
120236588.0,6,434,55044,217,14618,552872.925925926,140.0,67.36405529953917,217,40426,556606.1435185185,336.0,186.29493087557603
308117.0,6,6,412,4,272,102705.66666666669,74.0,68.0,2,140,0.0,74.0,70.0
90257867.0,6,15,2444,8,1016,12893981.0,188.0,127.0,7,1428,15015578.666666666,204.0,204.0
15620.0,6,14,4740,7,653,2348.333333333333,249.0,93.28571428571428,7,4087,2469.833333333333,1514.0,583.8571428571429
53885.0,6,14,4740,7,653,8865.166666666666,249.0,93.28571428571428,7,4087,8513.833333333334,1514.0,583.8571428571429
7313.0,17,2,582,1,83,0.0,83.0,83.0,1,499,0.0,499.0,499.0
45750.0,6,10,2032,5,524,11108.25,252.0,104.8,5,1508,10444.75,1236.0,301.6
108094157.0,17,5,1005,5,1005,27023539.25,201.0,201.0,0,0,0.0,0.0,0.0
19855.0,6,10,2032,5,524,4725.25,252.0,104.8,5,1508,4381.5,1236.0,301.6
232143.0,6,3,337,2,214,0.0,160.0,107.0,1,123,0.0,123.0,123.0
440719.0,6,11,1021,6,444,59438.4,162.0,74.0,5,577,74129.25,349.0,115.4
17673.0,6,10,2032,5,524,4142.5,252.0,104.8,5,1508,4040.0,1236.0,301.6
90048885.0,17,28,13364,28,13364,3335143.888888889,501.0,477.2857142857143,0,0,0.0,0.0,0.0
108766.0,17,2,286,2,286,0.0,143.0,143.0,0,0,0.0,0.0,0.0
108105590.0,17,5,955,5,955,27026397.5,191.0,191.0,0,0,0.0,0.0,0.0
120126266.0,6,14,2224,9,1204,15015783.25,188.0,133.77777777777777,5,1020,22522658.25,204.0,204.0
47581.0,6,14,4740,7,653,7042.166666666667,249.0,93.28571428571428,7,4087,7514.0,1514.0,583.8571428571429
217678.0,6,3,426,2,280,0.0,214.0,140.0,1,146,0.0,146.0,146.0
14109661.0,17,6,2052,6,2052,2821932.2,342.0,342.0,0,0,0.0,0.0,0.0
833.0,17,4,438,2,148,0.0,74.0,74.0,2,290,0.0,147.0,145.0
34997063.0,6,26,7627,14,3735,183215.15384615384,1514.0,266.7857142857143,12,3892,3162845.4545454546,1514.0,324.3333333333333
216600.0,6,3,426,2,280,0.0,214.0,140.0,1,146,0.0,146.0,146.0
2295.0,17,4,344,2,150,0.0,75.0,75.0,2,194,0.0,103.0,97.0
0.0,6,1,785,0,0,0.0,0.0,0.0,1,785,0.0,785.0,785.0
120298705.0,6,18,1382,9,691,14999989.5,95.0,76.77777777777777,9,691,15036690.25,95.0,76.77777777777777
0.0,17,1,342,1,342,0.0,342.0,342.0,0,0,0.0,0.0,0.0
11902.0,6,10,1067,5,536,2752.75,264.0,107.2,5,531,2382.0,259.0,106.2
23808.0,6,14,4740,7,653,3186.5,249.0,93.28571428571428,7,4087,3747.5,1514.0,583.8571428571429
30638.0,6,10,2032,5,524,6937.0,252.0,104.8,5,1508,6150.5,1236.0,301.6
136385.0,6,3,337,2,214,0.0,160.0,107.0,1,123,0.0,123.0,123.0
541437.0,17,6,2100,6,2100,108287.4,350.0,350.0,0,0,0.0,0.0,0.0
99219.0,17,2,762,2,762,0.0,381.0,381.0,0,0,0.0,0.0,0.0
90289187.0,6,16,1192,8,596,12891713.285714284,95.0,74.5,8,596,12897217.57142857,95.0,74.5
2579972.0,6,2,132,1,66,0.0,66.0,66.0,1,66,0.0,66.0,66.0
1302467.0,6,4,264,2,132,0.0,66.0,66.0,2,132,0.0,66.0,66.0
307196.0,6,6,412,4,272,102398.66666666669,74.0,68.0,2,140,0.0,74.0,70.0
108111487.0,17,5,955,5,955,27027871.75,191.0,191.0,0,0,0.0,0.0,0.0
90257669.0,6,12,1832,8,1016,12893952.714285716,188.0,127.0,4,816,30030998.666666668,204.0,204.0
303692.0,6,2,132,1,66,0.0,66.0,66.0,1,66,0.0,66.0,66.0
220336.0,6,3,426,2,280,0.0,214.0,140.0,1,146,0.0,146.0,146.0
298010.0,6,6,412,4,272,99336.66666666669,74.0,68.0,2,140,0.0,74.0,70.0
389.0,17,2,267,1,83,0.0,83.0,83.0,1,184,0.0,184.0,184.0
39867.0,6,14,4740,7,653,6454.333333333333,249.0,93.28571428571428,7,4087,6054.166666666667,1514.0,583.8571428571429
136760277.0,17,15,1038,8,606,19537182.42857143,174.0,75.75,7,432,19666818.666666668,174.0,61.71428571428572
122355.0,6,3,337,2,214,0.0,160.0,107.0,1,123,0.0,123.0,123.0
43010.0,6,14,4740,7,653,7036.333333333333,249.0,93.28571428571428,7,4087,6191.666666666667,1514.0,583.8571428571429
309606.0,17,4,1400,4,1400,103202.0,350.0,350.0,0,0,0.0,0.0,0.0
90228537.0,6,16,1192,8,596,12853436.285714284,95.0,74.5,8,596,12858950.142857144,95.0,74.5
141513.0,17,4,704,2,148,0.0,74.0,74.0,2,556,0.0,280.0,278.0
147989.0,17,2,180,1,90,0.0,90.0,90.0,1,90,0.0,90.0,90.0
210707.0,17,2,359,1,75,0.0,75.0,75.0,1,284,0.0,284.0,284.0
2753.0,17,5,550,5,550,688.25,110.0,110.0,0,0,0.0,0.0,0.0
295337.0,6,6,412,4,272,98445.66666666669,74.0,68.0,2,140,0.0,74.0,70.0
16873.0,17,2,180,1,90,0.0,90.0,90.0,1,90,0.0,90.0,90.0
233160.0,6,3,337,2,214,0.0,160.0,107.0,1,123,0.0,123.0,123.0
104467957.0,6,44,2904,22,1452,4974664.619047619,66.0,66.0,22,1452,4960195.761904762,66.0,66.0
143912.0,17,2,180,1,90,0.0,90.0,90.0,1,90,0.0,90.0,90.0
52797.0,6,14,4740,7,653,8275.166666666666,249.0,93.28571428571428,7,4087,7662.333333333333,1514.0,583.8571428571429
129011996.0,17,15,907,8,475,18430285.14285714,174.0,59.375,7,432,18166821.33333333,174.0,61.71428571428572
27197.0,6,14,4740,7,653,4407.666666666667,249.0,93.28571428571428,7,4087,4278.333333333333,1514.0,583.8571428571429
112256381.0,6,211,23856,106,7218,1069108.3904761905,140.0,68.09433962264151,105,16638,1069393.0961538462,284.0,158.45714285714286
28017.0,6,14,4740,7,653,4559.333333333333,249.0,93.28571428571428,7,4087,3530.6666666666665,1514.0,583.8571428571429
232929.0,6,3,337,2,214,0.0,160.0,107.0,1,123,0.0,123.0,123.0
37801665.0,6,5,336,2,134,0.0,68.0,67.0,3,202,18832586.0,70.0,67.33333333333333
90026992.0,17,28,13364,28,13364,3334333.037037037,501.0,477.2857142857143,0,0,0.0,0.0,0.0
307706.0,6,6,412,4,272,102568.66666666669,74.0,68.0,2,140,0.0,74.0,70.0
120020309.0,17,29,13785,29,13785,4286439.607142857,501.0,475.3448275862069,0,0,0.0,0.0,0.0
58608.0,6,10,2032,5,524,13582.25,252.0,104.8,5,1508,14492.0,1236.0,301.6
90223895.0,6,21,1585,10,745,9996892.888888888,95.0,74.5,11,840,9000840.6,95.0,76.36363636363636
90012851.0,17,28,13364,28,13364,3333809.296296296,501.0,477.2857142857143,0,0,0.0,0.0,0.0
108028.0,17,2,286,2,286,0.0,143.0,143.0,0,0,0.0,0.0,0.0
102630.0,17,2,286,2,286,0.0,143.0,143.0,0,0,0.0,0.0,0.0
23181.0,6,10,2032,5,524,5518.75,252.0,104.8,5,1508,5231.25,1236.0,301.6
311321.0,6,6,412,4,272,103773.66666666669,74.0,68.0,2,140,0.0,74.0,70.0
70757.0,6,14,4740,7,653,11610.833333333334,249.0,93.28571428571428,7,4087,9722.833333333334,1514.0,583.8571428571429
290043.0,17,2,363,1,79,0.0,79.0,79.0,1,284,0.0,284.0,284.0
103906834.0,17,14,864,7,432,17167488.333333332,174.0,61.71428571428572,7,432,17166828.333333332,174.0,61.71428571428572
87292.0,6,14,4740,7,653,13520.333333333334,249.0,93.28571428571428,7,4087,14416.166666666666,1514.0,583.8571428571429
108106168.0,17,5,955,5,955,27026542.0,191.0,191.0,0,0,0.0,0.0,0.0
18853.0,6,14,4740,7,653,2778.5,249.0,93.28571428571428,7,4087,2899.5,1514.0,583.8571428571429
23015.0,6,10,2032,5,524,4500.75,252.0,104.8,5,1508,5375.5,1236.0,301.6
103534.0,17,2,286,2,286,0.0,143.0,143.0,0,0,0.0,0.0,0.0
21856.0,6,14,4740,7,653,3534.0,249.0,93.28571428571428,7,4087,3153.833333333333,1514.0,583.8571428571429
5002733.0,17,4,849,2,166,0.0,83.0,83.0,2,683,0.0,499.0,341.5
320187.0,17,4,1400,4,1400,106729.0,350.0,350.0,0,0,0.0,0.0,0.0
206036.0,17,2,180,1,90,0.0,90.0,90.0,1,90,0.0,90.0,90.0
196918.0,17,2,180,1,90,0.0,90.0,90.0,1,90,0.0,90.0,90.0
228358.0,17,2,180,1,90,0.0,90.0,90.0,1,90,0.0,90.0,90.0
237421.0,17,2,180,1,90,0.0,90.0,90.0,1,90,0.0,90.0,90.0
2315.0,17,4,344,2,150,0.0,75.0,75.0,2,194,0.0,103.0,97.0
218054.0,6,3,426,2,280,0.0,214.0,140.0,1,146,0.0,146.0,146.0
166526.0,17,2,180,1,90,0.0,90.0,90.0,1,90,0.0,90.0,90.0
109568.0,17,2,286,2,286,0.0,143.0,143.0,0,0,0.0,0.0,0.0
216051.0,6,10,1221,6,636,43210.2,298.0,106.0,4,585,70740.66666666667,379.0,146.25
829631.0,6,9,1118,6,586,165926.2,248.0,97.66666666666669,3,532,278461.0,392.0,177.33333333333334
310756.0,6,3,202,2,128,0.0,74.0,64.0,1,74,0.0,74.0,74.0
234429.0,17,2,180,1,90,0.0,90.0,90.0,1,90,0.0,90.0,90.0
237244.0,17,2,180,1,90,0.0,90.0,90.0,1,90,0.0,90.0,90.0
218916.0,17,2,180,1,90,0.0,90.0,90.0,1,90,0.0,90.0,90.0
119997653.0,17,35,16705,35,16705,3529342.7352941176,501.0,477.2857142857143,0,0,0.0,0.0,0.0
605498.0,6,10,1221,6,636,121099.6,298.0,106.0,4,585,194701.0,379.0,146.25
24193.0,6,14,4740,7,653,3623.0,249.0,93.28571428571428,7,4087,3768.8333333333335,1514.0,583.8571428571429
3172473.0,6,19,1549,9,921,358137.875,315.0,102.33333333333331,10,628,318312.1111111111,78.0,62.8
301549.0,6,6,412,4,272,100516.33333333331,74.0,68.0,2,140,0.0,74.0,70.0
119576825.0,6,236,26660,118,18576,1020185.05982906,284.0,157.42372881355934,118,8084,1020184.1623931624,140.0,68.50847457627118
23338.0,17,4,823,2,163,0.0,89.0,81.5,2,660,0.0,443.0,330.0
298148.0,17,4,1524,4,1524,99382.66666666669,381.0,381.0,0,0,0.0,0.0,0.0
35611.0,6,2,145,2,145,0.0,91.0,72.5,0,0,0.0,0.0,0.0
59345.0,6,13,1479,7,882,9890.833333333334,291.0,126.0,6,597,10116.4,259.0,99.5
10513758.0,6,7,478,4,272,3458931.6666666665,74.0,68.0,3,206,5188302.5,74.0,68.66666666666667
228411.0,17,2,180,1,90,0.0,90.0,90.0,1,90,0.0,90.0,90.0
3036.0,17,2,224,1,76,0.0,76.0,76.0,1,148,0.0,148.0,148.0
50866.0,17,2,180,1,90,0.0,90.0,90.0,1,90,0.0,90.0,90.0
35172648.0,6,7,1874,3,887,17513124.0,753.0,295.6666666666667,4,987,11677824.333333334,785.0,246.75
113596168.0,6,48,3168,24,1584,4938963.826086956,66.0,66.0,24,1584,4929568.956521739,66.0,66.0
875.0,17,4,438,2,148,0.0,74.0,74.0,2,290,0.0,147.0,145.0
2021956.0,17,4,525,2,150,0.0,75.0,75.0,2,375,0.0,284.0,187.5
135132523.0,17,6,1206,6,1206,27026504.6,201.0,201.0,0,0,0.0,0.0,0.0
90198080.0,6,16,1192,8,596,12851849.57142857,95.0,74.5,8,596,12856206.142857144,95.0,74.5
385681.0,6,3,204,2,136,0.0,70.0,68.0,1,68,0.0,68.0,68.0
120031709.0,17,28,13364,28,13364,4445618.851851852,501.0,477.2857142857143,0,0,0.0,0.0,0.0
204202.0,17,2,762,2,762,0.0,381.0,381.0,0,0,0.0,0.0,0.0
354.0,17,2,267,1,83,0.0,83.0,83.0,1,184,0.0,184.0,184.0
2273.0,17,4,344,2,150,0.0,75.0,75.0,2,194,0.0,103.0,97.0
1311567.0,17,7,490,7,490,218594.5,70.0,70.0,0,0,0.0,0.0,0.0
38939.0,6,14,4740,7,653,6222.666666666667,249.0,93.28571428571428,7,4087,6347.5,1514.0,583.8571428571429
303139.0,6,2,132,1,66,0.0,66.0,66.0,1,66,0.0,66.0,66.0
26762.0,6,14,4740,7,653,3734.8333333333335,249.0,93.28571428571428,7,4087,3919.3333333333335,1514.0,583.8571428571429
32186990.0,6,9,754,5,482,8006794.0,210.0,96.4,4,272,10675652.666666666,74.0,68.0
50879.0,6,14,4740,7,653,8353.333333333334,249.0,93.28571428571428,7,4087,8161.166666666667,1514.0,583.8571428571429
29397.0,6,14,4740,7,653,3493.6666666666665,249.0,93.28571428571428,7,4087,4768.666666666667,1514.0,583.8571428571429
34928.0,6,14,4740,7,653,5698.666666666667,249.0,93.28571428571428,7,4087,5427.833333333333,1514.0,583.8571428571429
2476.0,17,4,344,2,150,0.0,75.0,75.0,2,194,0.0,103.0,97.0
379917.0,6,10,1221,6,636,75983.4,298.0,106.0,4,585,125146.66666666669,379.0,146.25
312296.0,6,3,202,2,128,0.0,74.0,64.0,1,74,0.0,74.0,74.0
216509.0,17,2,180,1,90,0.0,90.0,90.0,1,90,0.0,90.0,90.0
1343501.0,17,16,1120,16,1120,89566.73333333334,70.0,70.0,0,0,0.0,0.0,0.0
147140.0,6,4,439,2,238,0.0,172.0,119.0,2,201,0.0,135.0,100.5
41523.0,6,14,4740,7,653,6477.333333333333,249.0,93.28571428571428,7,4087,6687.333333333333,1514.0,583.8571428571429
313708.0,6,3,202,2,128,0.0,74.0,64.0,1,74,0.0,74.0,74.0
18107.0,6,20,7606,11,978,1810.7,310.0,88.9090909090909,9,6628,1884.75,1514.0,736.4444444444445
196812.0,17,2,180,1,90,0.0,90.0,90.0,1,90,0.0,90.0,90.0
120674859.0,6,47,3102,23,1518,5143984.227272728,66.0,66.0,24,1584,5246718.782608695,66.0,66.0
2091545.0,6,24,6964,13,1999,174295.41666666666,483.0,153.76923076923077,11,4965,177626.4,1510.0,451.3636363636364
90529108.0,6,14,2240,8,1016,12932729.714285716,188.0,127.0,6,1224,18073512.2,204.0,204.0
228224.0,17,2,180,1,90,0.0,90.0,90.0,1,90,0.0,90.0,90.0
144898.0,17,2,180,1,70,0.0,70.0,70.0,1,110,0.0,110.0,110.0
20526.0,17,4,807,2,163,0.0,89.0,81.5,2,644,0.0,427.0,322.0
115663149.0,6,30,1990,15,1042,8246215.285714285,139.0,69.46666666666667,15,948,8246131.785714285,123.0,63.2
117970376.0,6,48,3168,24,1584,5129146.782608695,66.0,66.0,24,1584,5119732.0,66.0,66.0
102918.0,17,2,286,2,286,0.0,143.0,143.0,0,0,0.0,0.0,0.0
0.0,6,1,66,0,0,0.0,0.0,0.0,1,66,0.0,66.0,66.0
2596400.0,6,50,23782,26,19851,103856.0,1514.0,763.5,24,3931,103444.69565217392,1514.0,163.79166666666666
116264.0,17,4,1400,4,1400,38754.66666666666,350.0,350.0,0,0,0.0,0.0,0.0
12742.0,6,13,1459,7,862,2034.3333333333333,271.0,123.14285714285714,6,597,2359.2,259.0,99.5
10423730.0,6,6,412,3,206,5143695.0,74.0,68.66666666666667,3,206,5143613.5,74.0,68.66666666666667
53630.0,6,14,4740,7,653,8005.333333333333,249.0,93.28571428571428,7,4087,8531.166666666666,1514.0,583.8571428571429
247010.0,6,3,373,2,238,0.0,172.0,119.0,1,135,0.0,135.0,135.0
108081964.0,17,5,1005,5,1005,27020491.0,201.0,201.0,0,0,0.0,0.0,0.0
286.0,17,2,156,1,78,0.0,78.0,78.0,1,78,0.0,78.0,78.0
120105250.0,17,28,13364,28,13364,4448342.592592592,501.0,477.2857142857143,0,0,0.0,0.0,0.0
256040.0,6,3,337,2,214,0.0,160.0,107.0,1,123,0.0,123.0,123.0
2043.0,17,4,344,2,150,0.0,75.0,75.0,2,194,0.0,103.0,97.0
55771.0,6,14,4740,7,653,8428.5,249.0,93.28571428571428,7,4087,9105.5,1514.0,583.8571428571429
241959.0,6,3,337,2,214,0.0,160.0,107.0,1,123,0.0,123.0,123.0
145071.0,6,2,132,1,66,0.0,66.0,66.0,1,66,0.0,66.0,66.0
146120.0,6,3,337,2,214,0.0,160.0,107.0,1,123,0.0,123.0,123.0
2744854.0,6,3,1604,2,851,0.0,785.0,425.5,1,753,0.0,753.0,753.0
90111936.0,6,12,1710,5,882,22527665.25,204.0,176.4,7,828,15017947.0,188.0,118.28571428571428
590945.0,17,2,363,1,75,0.0,75.0,75.0,1,288,0.0,288.0,288.0
90091344.0,6,10,1440,7,828,15015224.0,188.0,118.28571428571428,3,612,30030858.0,204.0,204.0
24343.0,6,14,4740,7,653,3774.6666666666665,249.0,93.28571428571428,7,4087,3569.333333333333,1514.0,583.8571428571429
207964.0,6,3,426,2,280,0.0,214.0,140.0,1,146,0.0,146.0,146.0
399.0,17,2,174,1,79,0.0,79.0,79.0,1,95,0.0,95.0,95.0
99210793.0,6,638,106564,317,21218,313958.2056962025,214.0,66.93375394321767,321,85346,309313.578125,1514.0,265.8753894080997
153391.0,17,2,180,1,90,0.0,90.0,90.0,1,90,0.0,90.0,90.0
21245.0,6,14,4740,7,653,2844.833333333333,249.0,93.28571428571428,7,4087,3397.6666666666665,1514.0,583.8571428571429
114297838.0,6,48,3168,24,1584,4969471.217391305,66.0,66.0,24,1584,4956078.304347826,66.0,66.0
120005206.0,6,18,1341,9,691,14999983.625,95.0,76.77777777777777,9,650,14999048.875,95.0,72.22222222222223
91232674.0,6,150,16986,75,11814,1229965.8513513512,284.0,157.52,75,5172,1229966.162162162,140.0,68.96
1310147.0,6,4,264,2,132,0.0,66.0,66.0,2,132,0.0,66.0,66.0
79944.0,6,14,4740,7,653,13013.666666666666,249.0,93.28571428571428,7,4087,13182.833333333334,1514.0,583.8571428571429
48921.0,6,14,4740,7,653,7597.666666666667,249.0,93.28571428571428,7,4087,7198.0,1514.0,583.8571428571429
246358.0,6,3,337,2,214,0.0,160.0,107.0,1,123,0.0,123.0,123.0
37976.0,6,14,4740,7,653,6212.0,249.0,93.28571428571428,7,4087,6192.833333333333,1514.0,583.8571428571429
2371.0,17,4,344,2,150,0.0,75.0,75.0,2,194,0.0,103.0,97.0
403010.0,17,6,1230,3,234,201321.5,78.0,78.0,3,996,201299.5,332.0,332.0
90025912.0,17,27,12943,27,12943,3462535.076923077,501.0,479.3703703703704,0,0,0.0,0.0,0.0
211352.0,17,2,180,1,90,0.0,90.0,90.0,1,90,0.0,90.0,90.0
26485249.0,17,5,1718,4,1368,861113.6666666666,342.0,342.0,1,350,0.0,350.0,350.0
607797.0,17,2,346,1,78,0.0,78.0,78.0,1,268,0.0,268.0,268.0
298586.0,6,6,412,4,272,99528.66666666669,74.0,68.0,2,140,0.0,74.0,70.0
4519.0,17,2,614,1,72,0.0,72.0,72.0,1,542,0.0,542.0,542.0
95000942.0,17,11,735,6,389,19000188.4,174.0,64.83333333333333,5,346,19001038.5,174.0,69.2
1306350.0,6,4,264,2,132,0.0,66.0,66.0,2,132,0.0,66.0,66.0
101355270.0,17,14,1126,7,563,16833491.666666668,174.0,80.42857142857143,7,563,16834110.333333332,174.0,80.42857142857143
3061737.0,6,173,141652,100,132532,30926.636363636364,1510.0,1325.32,73,9120,38177.26388888889,1510.0,124.93150684931508
90618927.0,6,26,1746,13,906,7533560.166666667,123.0,69.6923076923077,13,840,7533560.333333333,123.0,64.61538461538461
0.0,17,1,342,1,342,0.0,342.0,342.0,0,0,0.0,0.0,0.0
90957414.0,6,21,1585,11,840,9094927.7,95.0,76.36363636363636,10,745,10105486.666666666,95.0,74.5
1023938.0,6,11,1134,6,558,204787.60000000003,220.0,93.0,5,576,254634.75,304.0,115.2
309618.0,6,6,412,4,272,103206.0,74.0,68.0,2,140,0.0,74.0,70.0
5623375.0,6,4,270,2,134,0.0,68.0,67.0,2,136,0.0,70.0,68.0
135130703.0,17,6,1206,6,1206,27026140.6,201.0,201.0,0,0,0.0,0.0,0.0
10468264.0,6,7,478,4,272,3444235.6666666665,74.0,68.0,3,206,5166255.5,74.0,68.66666666666667
2180.0,17,4,344,2,150,0.0,75.0,75.0,2,194,0.0,103.0,97.0
205889.0,17,2,180,1,90,0.0,90.0,90.0,1,90,0.0,90.0,90.0
203914.0,17,2,762,2,762,0.0,381.0,381.0,0,0,0.0,0.0,0.0
0.0,6,1,66,1,66,0.0,66.0,66.0,0,0,0.0,0.0,0.0
38431269.0,6,6,1808,4,987,12810423.0,785.0,246.75,2,821,0.0,753.0,410.5
90749062.0,6,16,1192,8,596,12964151.714285716,95.0,74.5,8,596,12921420.57142857,95.0,74.5
907415.0,6,10,1334,6,797,181483.0,459.0,132.83333333333334,4,537,210595.0,331.0,134.25
135131451.0,17,6,1206,6,1206,27026290.2,201.0,201.0,0,0,0.0,0.0,0.0
109227034.0,6,204,22996,102,16042,1079326.0594059406,284.0,157.27450980392155,102,6954,1079326.3465346536,140.0,68.17647058823529
238845.0,17,2,180,1,90,0.0,90.0,90.0,1,90,0.0,90.0,90.0
108105161.0,17,5,955,5,955,27026290.25,191.0,191.0,0,0,0.0,0.0,0.0
366123.0,17,2,363,1,75,0.0,75.0,75.0,1,288,0.0,288.0,288.0
70762.0,17,2,616,1,75,0.0,75.0,75.0,1,541,0.0,541.0,541.0
216307.0,17,2,180,1,90,0.0,90.0,90.0,1,90,0.0,90.0,90.0
11464988.0,6,6,433,4,301,3821662.6666666665,103.0,75.25,2,132,0.0,66.0,66.0
90255175.0,6,12,1832,8,1016,12893596.42857143,188.0,127.0,4,816,30024206.666666668,204.0,204.0
60036.0,6,13,1386,7,789,9590.166666666666,253.0,112.71428571428572,6,597,10256.6,259.0,99.5
2060751.0,6,28,8252,15,4068,147196.5,1514.0,271.2,13,4184,146242.0,1514.0,321.84615384615387
205996.0,6,3,426,2,280,0.0,214.0,140.0,1,146,0.0,146.0,146.0
16836.0,6,14,4740,7,653,2277.333333333333,249.0,93.28571428571428,7,4087,2674.5,1514.0,583.8571428571429
48605.0,6,10,2032,5,524,11854.0,252.0,104.8,5,1508,10719.25,1236.0,301.6
0.0,17,1,90,1,90,0.0,90.0,90.0,0,0,0.0,0.0,0.0
92881872.0,6,2900,580751,1452,502487,64012.31702274294,858.0,346.0654269972452,1448,78264,64062.41672425709,66.0,54.04972375690608
341.0,17,2,214,1,75,0.0,75.0,75.0,1,139,0.0,139.0,139.0
2304.0,17,4,344,2,150,0.0,75.0,75.0,2,194,0.0,103.0,97.0
5623806.0,6,4,270,2,134,0.0,68.0,67.0,2,136,0.0,70.0,68.0
90259060.0,6,13,2036,8,1016,12894151.42857143,188.0,127.0,5,1020,22523436.5,204.0,204.0
6925.0,17,2,582,1,83,0.0,83.0,83.0,1,499,0.0,499.0,499.0
280091.0,6,3,373,2,238,0.0,172.0,119.0,1,135,0.0,135.0,135.0
112399441.0,6,32,2220,16,1149,7478905.2,123.0,71.8125,16,1071,7478904.333333333,123.0,66.9375
315312.0,17,4,1400,4,1400,105104.0,350.0,350.0,0,0,0.0,0.0,0.0
108734612.0,6,44,2904,22,1452,5177838.666666667,66.0,66.0,22,1452,5164861.571428572,66.0,66.0
812.0,17,4,438,2,148,0.0,74.0,74.0,2,290,0.0,147.0,145.0
511926.0,6,5,336,2,134,0.0,68.0,67.0,3,202,192796.5,70.0,67.33333333333333
118578208.0,6,30,2043,15,1017,8469872.0,123.0,67.8,15,1026,8454434.214285715,123.0,68.4
90220006.0,6,17,1287,8,596,12852933.42857143,95.0,74.5,9,691,11250601.625,95.0,76.77777777777777
153472.0,17,2,180,1,90,0.0,90.0,90.0,1,90,0.0,90.0,90.0
769.0,17,4,438,2,148,0.0,74.0,74.0,2,290,0.0,147.0,145.0
103128.0,17,2,286,2,286,0.0,143.0,143.0,0,0,0.0,0.0,0.0
198125.0,17,2,180,1,90,0.0,90.0,90.0,1,90,0.0,90.0,90.0
109398.0,17,2,286,2,286,0.0,143.0,143.0,0,0,0.0,0.0,0.0
863395.0,6,9,1270,6,799,172679.0,461.0,133.16666666666666,3,471,294160.0,331.0,157.0
135133025.0,17,6,1206,6,1206,27026605.0,201.0,201.0,0,0,0.0,0.0,0.0
103957.0,17,2,286,2,286,0.0,143.0,143.0,0,0,0.0,0.0,0.0
23620.0,6,10,2032,5,524,4382.25,252.0,104.8,5,1508,5273.0,1236.0,301.6
28630.0,6,14,4740,7,653,4647.833333333333,249.0,93.28571428571428,7,4087,4529.5,1514.0,583.8571428571429
135139567.0,17,6,1206,6,1206,27027913.4,201.0,201.0,0,0,0.0,0.0,0.0
90260532.0,6,13,2036,8,1016,12894361.714285716,188.0,127.0,5,1020,22523742.75,204.0,204.0
312710.0,17,4,1400,4,1400,104236.66666666669,350.0,350.0,0,0,0.0,0.0,0.0
304756.0,6,6,412,4,272,101585.33333333331,74.0,68.0,2,140,0.0,74.0,70.0
311634.0,17,4,1400,4,1400,103878.0,350.0,350.0,0,0,0.0,0.0,0.0
39435.0,6,10,2032,5,524,9611.0,252.0,104.8,5,1508,8962.25,1236.0,301.6
114593427.0,6,48,3168,24,1584,4982322.913043479,66.0,66.0,24,1584,4970349.608695652,66.0,66.0
65191.0,6,10,2032,5,524,15752.75,252.0,104.8,5,1508,16000.25,1236.0,301.6
52261.0,6,10,2032,5,524,12640.75,252.0,104.8,5,1508,12401.75,1236.0,301.6
743.0,17,2,684,2,684,0.0,342.0,342.0,0,0,0.0,0.0,0.0
99513594.0,6,25,1692,13,906,8274807.75,123.0,69.6923076923077,12,786,9027068.909090908,123.0,65.5
146613.0,6,3,337,2,214,0.0,160.0,107.0,1,123,0.0,123.0,123.0
118059800.0,17,16,1212,8,606,16858022.57142857,174.0,75.75,8,606,16857325.14285714,174.0,75.75
110970903.0,6,33,2428,17,1288,6922137.625,139.0,75.76470588235294,16,1140,7383643.933333334,123.0,71.25
120167413.0,6,220,24884,110,7482,1094614.4587155962,140.0,68.01818181818182,110,17402,1094906.1743119266,284.0,158.2
50281.0,6,14,4740,7,653,7796.833333333333,249.0,93.28571428571428,7,4087,7366.666666666667,1514.0,583.8571428571429
120106015.0,6,230,25866,115,7812,1046320.4912280702,140.0,67.9304347826087,115,18054,1046475.2894736842,284.0,156.9913043478261
61611.0,6,14,4740,7,653,9451.666666666666,249.0,93.28571428571428,7,4087,8717.5,1514.0,583.8571428571429
90526682.0,6,14,2240,8,1016,12932383.142857144,188.0,127.0,6,1224,18072427.0,204.0,204.0
228076.0,17,2,180,1,90,0.0,90.0,90.0,1,90,0.0,90.0,90.0
991939.0,6,12,1362,6,731,197298.2,253.0,121.83333333333331,6,631,198110.2,293.0,105.16666666666669
308.0,17,2,164,1,82,0.0,82.0,82.0,1,82,0.0,82.0,82.0
228380.0,17,2,180,1,90,0.0,90.0,90.0,1,90,0.0,90.0,90.0
108104436.0,17,5,1005,5,1005,27026109.0,201.0,201.0,0,0,0.0,0.0,0.0
339246.0,17,2,335,1,88,0.0,88.0,88.0,1,247,0.0,247.0,247.0
10465675.0,6,7,478,4,272,3441681.6666666665,74.0,68.0,3,206,5162404.5,74.0,68.66666666666667
326167.0,6,6,412,4,272,108722.33333333331,74.0,68.0,2,140,0.0,74.0,70.0
21614575.0,6,5,1736,2,819,0.0,753.0,409.5,3,917,10740305.0,785.0,305.6666666666667
102500816.0,6,32,2236,16,1165,6833387.733333333,139.0,72.8125,16,1071,6819710.866666666,123.0,66.9375
102079.0,6,12,1447,6,816,19567.6,291.0,136.0,6,631,19480.2,293.0,105.16666666666669
16782.0,6,14,4740,7,653,2682.0,249.0,93.28571428571428,7,4087,2660.333333333333,1514.0,583.8571428571429
1772160.0,6,23,6509,12,1529,161105.45454545456,357.0,127.41666666666669,11,4980,145970.7,1510.0,452.7272727272728
120060790.0,17,28,13364,28,13364,4446695.925925926,501.0,477.2857142857143,0,0,0.0,0.0,0.0
210776.0,6,10,1221,6,636,42155.2,298.0,106.0,4,585,67889.0,379.0,146.25
90295386.0,6,16,1192,8,596,12891502.0,95.0,74.5,8,596,12897839.142857144,95.0,74.5
1054593.0,17,2,252,1,79,0.0,79.0,79.0,1,173,0.0,173.0,173.0
47618.0,6,10,2032,5,524,8496.25,252.0,104.8,5,1508,11578.5,1236.0,301.6
90255582.0,6,14,2240,8,1016,12893654.57142857,188.0,127.0,6,1224,18018796.4,204.0,204.0
112610211.0,6,34,2482,17,1194,7038111.4375,123.0,70.23529411764706,17,1288,6414057.125,139.0,75.76470588235294
101252164.0,17,14,864,7,432,16834545.833333332,174.0,61.71428571428572,7,432,16833495.833333332,174.0,61.71428571428572
317.0,17,2,174,1,79,0.0,79.0,79.0,1,95,0.0,95.0,95.0
90527124.0,6,13,2036,8,1016,12932446.285714284,188.0,127.0,5,1020,22590938.0,204.0,204.0
16136.999999999998,6,11,2098,6,590,3227.4,252.0,98.33333333333331,5,1508,3452.5,1236.0,301.6
43313.0,6,14,4740,7,653,7093.333333333333,249.0,93.28571428571428,7,4087,6429.666666666667,1514.0,583.8571428571429
107159209.0,6,213,24384,107,7284,1010935.933962264,140.0,68.07476635514018,106,17100,1010849.7904761904,464.0,161.32075471698113
1986792.0,6,4,492,2,280,0.0,214.0,140.0,2,212,0.0,146.0,106.0
21165.0,6,14,4740,7,653,3416.0,249.0,93.28571428571428,7,4087,2544.5,1514.0,583.8571428571429
32050.000000000004,6,14,4740,7,653,3871.8333333333335,249.0,93.28571428571428,7,4087,5199.833333333333,1514.0,583.8571428571429
1171280.0,6,13,3011,8,2383,167325.7142857143,1514.0,297.875,5,628,223888.25,331.0,125.6
213356.0,6,3,426,2,280,0.0,214.0,140.0,1,146,0.0,146.0,146.0
120124632.0,6,13,2020,9,1204,15015579.0,188.0,133.77777777777777,4,816,30030964.0,204.0,204.0
1061854.0,6,3,1604,2,851,0.0,785.0,425.5,1,753,0.0,753.0,753.0
318009.0,6,6,412,4,272,106003.0,74.0,68.0,2,140,0.0,74.0,70.0
49492.0,6,14,4740,7,653,8083.666666666667,249.0,93.28571428571428,7,4087,6564.5,1514.0,583.8571428571429
122021.0,6,3,337,2,214,0.0,160.0,107.0,1,123,0.0,123.0,123.0
1911792.0,6,8,602,5,404,453051.25,103.0,80.8,3,198,204775.0,66.0,66.0
850869.0,6,9,1096,6,625,170173.8,287.0,104.16666666666669,3,471,287657.0,331.0,157.0
35447.0,6,10,2032,5,524,8574.5,252.0,104.8,5,1508,8454.5,1236.0,301.6
205876.0,17,2,180,1,90,0.0,90.0,90.0,1,90,0.0,90.0,90.0
104777.0,17,2,700,2,700,0.0,350.0,350.0,0,0,0.0,0.0,0.0
227435.0,6,13,1394,7,797,37905.833333333336,253.0,113.85714285714286,6,597,42030.4,259.0,99.5
21174.0,6,10,2032,5,524,3791.5,252.0,104.8,5,1508,5041.25,1236.0,301.6
153470.0,17,2,180,1,90,0.0,90.0,90.0,1,90,0.0,90.0,90.0
31456899.0,6,26,7627,14,3735,206150.0,1514.0,266.7857142857143,12,3892,2840125.4545454546,1514.0,324.3333333333333
135133002.0,17,6,1206,6,1206,27026600.4,201.0,201.0,0,0,0.0,0.0,0.0
106402.0,17,2,700,2,700,0.0,350.0,350.0,0,0,0.0,0.0,0.0
22755692.0,6,26,7627,14,3735,188638.2307692308,1514.0,266.7857142857143,12,3892,2049990.3636363635,1514.0,324.3333333333333
90292494.0,6,18,1577,10,1022,10032499.333333334,335.0,102.2,8,555,12855592.857142856,95.0,69.375
10463462.0,6,7,478,4,272,3441019.6666666665,74.0,68.0,3,206,5161389.5,74.0,68.66666666666667
1865737.0,6,22,6443,12,1529,169612.45454545456,357.0,127.41666666666669,10,4914,170330.33333333334,1510.0,491.4
171737.0,17,2,180,1,90,0.0,90.0,90.0,1,90,0.0,90.0,90.0
112783.0,17,2,286,2,286,0.0,143.0,143.0,0,0,0.0,0.0,0.0
108107933.0,17,5,1005,5,1005,27026983.25,201.0,201.0,0,0,0.0,0.0,0.0
14601.0,17,2,582,1,83,0.0,83.0,83.0,1,499,0.0,499.0,499.0
105290.0,6,2,132,1,66,0.0,66.0,66.0,1,66,0.0,66.0,66.0
108097777.0,17,5,1005,5,1005,27024444.25,201.0,201.0,0,0,0.0,0.0,0.0
24855.0,6,14,4740,7,653,3928.1666666666665,249.0,93.28571428571428,7,4087,3039.5,1514.0,583.8571428571429
51074.0,6,14,4740,7,653,7755.833333333333,249.0,93.28571428571428,7,4087,8356.666666666666,1514.0,583.8571428571429
103199836.0,6,41,2706,21,1386,5159991.8,66.0,66.0,20,1320,5133449.7894736845,66.0,66.0
113068786.0,6,30,1990,15,1042,8060916.714285715,139.0,69.46666666666667,15,948,8060917.214285715,123.0,63.2
22723744.0,6,26,7627,14,3735,197360.15384615384,1514.0,266.7857142857143,12,3892,2046219.9090909087,1514.0,324.3333333333333
108073.0,17,2,700,2,700,0.0,350.0,350.0,0,0,0.0,0.0,0.0
36922.0,6,10,2032,5,524,8640.0,252.0,104.8,5,1508,8752.0,1236.0,301.6
25540.0,6,10,2032,5,524,6000.5,252.0,104.8,5,1508,6073.25,1236.0,301.6
108109670.0,17,5,1005,5,1005,27027417.5,201.0,201.0,0,0,0.0,0.0,0.0
113676900.0,6,31,2166,16,1149,7564067.4,123.0,71.8125,15,1017,8104356.5,123.0,67.8
46552.0,6,10,2032,5,524,11412.0,252.0,104.8,5,1508,11355.5,1236.0,301.6
990225.0,17,6,1230,3,234,494929.5,78.0,78.0,3,996,494905.5,332.0,332.0
339.0,17,2,166,1,75,0.0,75.0,75.0,1,91,0.0,91.0,91.0
287.0,17,2,168,1,76,0.0,76.0,76.0,1,92,0.0,92.0,92.0
146615.0,6,2,132,1,66,0.0,66.0,66.0,1,66,0.0,66.0,66.0
116087464.0,6,47,3102,24,1584,5047270.478260869,66.0,66.0,23,1518,5159996.0,66.0,66.0
225568.0,6,10,1221,6,636,45113.6,298.0,106.0,4,585,72114.66666666667,379.0,146.25
320190.0,17,4,1400,4,1400,106730.0,350.0,350.0,0,0,0.0,0.0,0.0
108087127.0,17,5,955,5,955,27021781.75,191.0,191.0,0,0,0.0,0.0,0.0
90031358.0,17,28,13364,28,13364,3334494.7407407407,501.0,477.2857142857143,0,0,0.0,0.0,0.0
2356.0,17,4,344,2,150,0.0,75.0,75.0,2,194,0.0,103.0,97.0
386.0,17,2,166,1,75,0.0,75.0,75.0,1,91,0.0,91.0,91.0
90742771.0,6,19,1436,10,745,10077754.777777778,95.0,74.5,9,691,11341864.125,95.0,76.77777777777777
15422.0,6,13,1459,7,862,2449.333333333333,271.0,123.14285714285714,6,597,2889.4,259.0,99.5
21409504.0,6,5,1736,2,819,0.0,753.0,409.5,3,917,10637742.5,785.0,305.6666666666667
27626.0,6,14,4740,7,653,4488.333333333333,249.0,93.28571428571428,7,4087,4356.166666666667,1514.0,583.8571428571429
119738444.0,6,218,24550,109,17134,1106696.509259259,284.0,157.19266055045873,109,7416,1106697.1944444445,140.0,68.03669724770643
45359.0,6,14,4740,7,653,7404.833333333333,249.0,93.28571428571428,7,4087,6775.0,1514.0,583.8571428571429
114533720.0,6,48,3168,24,1584,4979726.956521739,66.0,66.0,24,1584,4970331.434782608,66.0,66.0
27216.0,6,14,4740,7,653,4380.5,249.0,93.28571428571428,7,4087,3822.0,1514.0,583.8571428571429
141209.0,6,2,132,1,66,0.0,66.0,66.0,1,66,0.0,66.0,66.0
317765.0,17,4,1400,4,1400,105921.66666666669,350.0,350.0,0,0,0.0,0.0,0.0
13467.0,6,10,1949,5,441,3157.5,169.0,88.2,5,1508,3110.0,1236.0,301.6
376.0,17,2,166,1,75,0.0,75.0,75.0,1,91,0.0,91.0,91.0
305698.0,6,6,412,4,272,101899.33333333331,74.0,68.0,2,140,0.0,74.0,70.0
230952.0,17,2,180,1,90,0.0,90.0,90.0,1,90,0.0,90.0,90.0
113334245.0,6,48,3168,24,1584,4927575.869565218,66.0,66.0,24,1584,4920347.521739131,66.0,66.0
249666.0,17,4,6056,4,6056,83222.0,1514.0,1514.0,0,0,0.0,0.0,0.0
5837211.0,6,5,336,2,134,0.0,68.0,67.0,3,202,1526199.0,70.0,67.33333333333333
105146324.0,6,44,2904,22,1452,5006967.80952381,66.0,66.0,22,1452,4993986.666666667,66.0,66.0
135132543.0,17,6,1206,6,1206,27026508.6,201.0,201.0,0,0,0.0,0.0,0.0
203964.0,17,2,762,2,762,0.0,381.0,381.0,0,0,0.0,0.0,0.0
104352997.0,17,15,5130,15,5130,7453785.5,342.0,342.0,0,0,0.0,0.0,0.0
108113646.0,17,5,1005,5,1005,27028411.5,201.0,201.0,0,0,0.0,0.0,0.0
90956731.0,6,21,1585,11,840,9094836.7,95.0,76.36363636363636,10,745,10105467.111111112,95.0,74.5
120120496.0,6,15,2428,9,1204,15015062.0,188.0,133.77777777777777,6,1224,18024220.6,204.0,204.0
319895.0,17,4,1400,4,1400,106631.66666666669,350.0,350.0,0,0,0.0,0.0,0.0
84943.0,6,12,1328,7,797,14157.166666666666,253.0,113.85714285714286,5,531,19006.0,259.0,106.2
87336400.0,17,12,4112,11,3762,7806136.1,342.0,342.0,1,350,0.0,350.0,350.0
13500813.0,6,4,1843,2,892,0.0,826.0,446.0,2,951,0.0,885.0,475.5
0.0,6,1,66,1,66,0.0,66.0,66.0,0,0,0.0,0.0,0.0
2560126.0,6,3,1602,1,752,0.0,752.0,752.0,2,850,0.0,784.0,425.0
52648.0,6,14,4740,7,653,8009.833333333333,249.0,93.28571428571428,7,4087,7555.166666666667,1514.0,583.8571428571429
198528.0,17,2,180,1,90,0.0,90.0,90.0,1,90,0.0,90.0,90.0
239788.0,6,3,337,2,214,0.0,160.0,107.0,1,123,0.0,123.0,123.0
77013.0,6,14,4740,7,653,12269.5,249.0,93.28571428571428,7,4087,9808.833333333334,1514.0,583.8571428571429
50266.0,6,14,4740,7,653,8205.666666666666,249.0,93.28571428571428,7,4087,6725.5,1514.0,583.8571428571429
118583673.0,6,216,24424,108,17000,1106341.3738317755,284.0,157.40740740740742,108,7424,1106340.8785046728,140.0,68.74074074074075
38152.0,6,14,4740,7,653,5511.0,249.0,93.28571428571428,7,4087,5254.833333333333,1514.0,583.8571428571429
21887.0,6,14,4740,7,653,3277.0,249.0,93.28571428571428,7,4087,3453.833333333333,1514.0,583.8571428571429
4294.0,17,2,582,1,83,0.0,83.0,83.0,1,499,0.0,499.0,499.0
538193.0,17,6,2100,6,2100,107638.6,350.0,350.0,0,0,0.0,0.0,0.0
104086241.0,17,14,864,7,432,17334289.0,174.0,61.71428571428572,7,432,17333490.333333332,174.0,61.71428571428572
90021018.0,17,28,13364,28,13364,3334111.777777778,501.0,477.2857142857143,0,0,0.0,0.0,0.0
120092234.0,6,15,2428,9,1204,15011529.25,188.0,133.77777777777777,6,1224,18067440.4,204.0,204.0
216583.0,6,3,426,2,280,0.0,214.0,140.0,1,146,0.0,146.0,146.0
90041444.0,17,27,12943,27,12943,3463132.461538461,501.0,479.3703703703704,0,0,0.0,0.0,0.0
104276.0,17,2,700,2,700,0.0,350.0,350.0,0,0,0.0,0.0,0.0
105331149.0,6,44,2904,22,1452,5015769.0,66.0,66.0,22,1452,5000800.666666667,66.0,66.0
126276437.0,6,33,2280,17,1209,7892277.3125,123.0,71.11764705882354,16,1071,7739138.866666666,123.0,66.9375
114561933.0,6,47,3102,24,1584,4966709.695652174,66.0,66.0,23,1518,5161408.0,66.0,66.0
90301479.0,6,17,1287,9,691,11279778.0,95.0,76.77777777777777,8,596,12899300.42857143,95.0,74.5
124740472.0,6,32,2236,16,1071,7650321.866666666,123.0,66.9375,16,1165,7650301.4,139.0,72.8125
140253.0,17,4,344,2,150,0.0,75.0,75.0,2,194,0.0,103.0,97.0
135141713.0,17,6,1146,6,1146,27028342.6,191.0,191.0,0,0,0.0,0.0,0.0
120237683.0,6,18,1341,9,691,14999464.625,95.0,76.77777777777777,9,650,14999985.875,95.0,72.22222222222223
104168688.0,17,14,864,7,432,17168167.0,174.0,61.71428571428572,7,432,17166843.666666668,174.0,61.71428571428572
98139043.0,17,12,778,6,389,19600171.8,174.0,64.83333333333333,6,389,19602130.0,174.0,64.83333333333333
399.0,17,2,410,1,78,0.0,78.0,78.0,1,332,0.0,332.0,332.0
120145274.0,6,232,26306,116,7952,1037546.704347826,140.0,68.55172413793103,116,18354,1037513.0695652174,374.0,158.22413793103448
276395.0,17,2,346,1,78,0.0,78.0,78.0,1,268,0.0,268.0,268.0
0.0,17,1,381,1,381,0.0,381.0,381.0,0,0,0.0,0.0,0.0
149632.0,6,3,373,2,238,0.0,172.0,119.0,1,135,0.0,135.0,135.0
23276.0,6,20,7606,11,978,2327.6,310.0,88.9090909090909,9,6628,2567.75,1514.0,736.4444444444445
217606.0,6,3,426,2,280,0.0,214.0,140.0,1,146,0.0,146.0,146.0
298337.0,6,6,412,4,272,99445.66666666669,74.0,68.0,2,140,0.0,74.0,70.0
300.0,17,2,156,1,78,0.0,78.0,78.0,1,78,0.0,78.0,78.0
96363630.0,6,30,2260,16,1228,6409859.866666666,139.0,76.75,14,1032,7395992.0,123.0,73.71428571428571
120239319.0,6,23,1734,11,840,11999561.2,95.0,76.36363636363636,12,894,10909087.363636363,95.0,74.5
90259956.0,6,14,2240,8,1016,12894279.42857143,188.0,127.0,6,1224,18019437.8,204.0,204.0
247910.0,6,3,337,2,214,0.0,160.0,107.0,1,123,0.0,123.0,123.0
511625.0,6,5,336,2,134,0.0,68.0,67.0,3,202,194961.5,70.0,67.33333333333333
104635664.0,6,30,2122,15,1105,7473976.0,139.0,73.66666666666667,15,1017,7458506.785714285,123.0,67.8
103183.0,17,2,286,2,286,0.0,143.0,143.0,0,0,0.0,0.0,0.0
147803.0,6,3,337,2,214,0.0,160.0,107.0,1,123,0.0,123.0,123.0
24181.0,6,14,4740,7,653,3863.8333333333335,249.0,93.28571428571428,7,4087,3453.5,1514.0,583.8571428571429
119358114.0,6,543,74504,272,18248,440435.84501845017,140.0,67.08823529411765,271,56256,438203.1703703704,390.0,207.58671586715863
17639.0,6,14,4740,7,653,2725.333333333333,249.0,93.28571428571428,7,4087,2718.6666666666665,1514.0,583.8571428571429
35488.0,6,14,4740,7,653,4399.666666666667,249.0,93.28571428571428,7,4087,5777.833333333333,1514.0,583.8571428571429
2404680.0,6,25,7573,14,3735,184975.38461538465,1514.0,266.7857142857143,11,3838,214718.0,1514.0,348.90909090909093
90256363.0,6,12,1832,8,1016,12893766.142857144,188.0,127.0,4,816,30030672.0,204.0,204.0
321590.0,17,4,1400,4,1400,107196.66666666669,350.0,350.0,0,0,0.0,0.0,0.0
110339.0,17,2,286,2,286,0.0,143.0,143.0,0,0,0.0,0.0,0.0
18225.0,6,10,2032,5,524,4321.75,252.0,104.8,5,1508,4189.25,1236.0,301.6
53045.0,6,14,4740,7,653,8714.333333333334,249.0,93.28571428571428,7,4087,8033.166666666667,1514.0,583.8571428571429
1890.0,17,2,192,1,88,0.0,88.0,88.0,1,104,0.0,104.0,104.0
92713064.0,6,38,2508,19,1254,5135435.166666667,66.0,66.0,19,1254,5135418.055555556,66.0,66.0
90098036.0,6,12,1710,5,882,22523917.0,204.0,176.4,7,828,15013604.5,188.0,118.28571428571428
90257046.0,6,12,1832,8,1016,12893863.714285716,188.0,127.0,4,816,30030492.33333333,204.0,204.0
147032.0,17,2,180,1,70,0.0,70.0,70.0,1,110,0.0,110.0,110.0
206112.0,17,2,180,1,90,0.0,90.0,90.0,1,90,0.0,90.0,90.0
0.0,6,1,66,0,0,0.0,0.0,0.0,1,66,0.0,66.0,66.0
2068.0,17,4,344,2,150,0.0,75.0,75.0,2,194,0.0,103.0,97.0
153562.0,17,2,180,1,90,0.0,90.0,90.0,1,90,0.0,90.0,90.0
3006114.0,6,11,2106,6,598,601037.0,252.0,99.66666666666669,5,1508,1617.0,1236.0,301.6
206609.0,6,10,1221,6,636,41321.8,298.0,106.0,4,585,67656.33333333333,379.0,146.25
217650.0,6,3,426,2,280,0.0,214.0,140.0,1,146,0.0,146.0,146.0
205570.0,17,2,180,1,90,0.0,90.0,90.0,1,90,0.0,90.0,90.0
147190.0,6,3,373,2,238,0.0,172.0,119.0,1,135,0.0,135.0,135.0
90256509.0,6,13,2036,8,1016,12893787.0,188.0,127.0,5,1020,22523290.0,204.0,204.0
2591700.0,6,2,132,1,66,0.0,66.0,66.0,1,66,0.0,66.0,66.0
143860.0,17,2,180,1,90,0.0,90.0,90.0,1,90,0.0,90.0,90.0
59705008.0,17,9,3086,8,2736,5228236.0,342.0,342.0,1,350,0.0,350.0,350.0
90059819.0,17,28,13364,28,13364,3335548.851851852,501.0,477.2857142857143,0,0,0.0,0.0,0.0
10459796.0,6,7,478,4,272,3441095.0,74.0,68.0,3,206,5161525.0,74.0,68.66666666666667
143928.0,17,2,180,1,90,0.0,90.0,90.0,1,90,0.0,90.0,90.0
17431.0,6,10,1932,5,480,4116.75,252.0,96.0,5,1452,4089.75,1224.0,290.4
133848.0,6,2,132,1,66,0.0,66.0,66.0,1,66,0.0,66.0,66.0
224040.0,6,3,426,2,280,0.0,214.0,140.0,1,146,0.0,146.0,146.0
5099.0,17,4,344,2,150,0.0,75.0,75.0,2,194,0.0,103.0,97.0
148.0,17,2,158,2,158,0.0,79.0,79.0,0,0,0.0,0.0,0.0
91172857.0,6,24,1829,11,840,9117285.7,95.0,76.36363636363636,13,989,7575962.833333333,95.0,76.07692307692308
319065.0,6,6,412,4,272,106355.0,74.0,68.0,2,140,0.0,74.0,70.0
16885.0,6,14,4740,7,653,2547.0,249.0,93.28571428571428,7,4087,2636.0,1514.0,583.8571428571429
316321.0,17,4,1400,4,1400,105440.33333333331,350.0,350.0,0,0,0.0,0.0,0.0
90096714.0,6,12,1848,5,1020,22523591.5,204.0,204.0,7,828,15015730.666666666,188.0,118.28571428571428
115236848.0,6,211,23856,106,7218,1097493.7904761904,140.0,68.09433962264151,105,16638,1098077.3653846155,284.0,158.45714285714286
102029.0,17,2,762,2,762,0.0,381.0,381.0,0,0,0.0,0.0,0.0
182335.0,17,2,180,1,90,0.0,90.0,90.0,1,90,0.0,90.0,90.0
2376.0,17,4,344,2,150,0.0,75.0,75.0,2,194,0.0,103.0,97.0
1415971.0,17,16,1120,16,1120,94398.06666666668,70.0,70.0,0,0,0.0,0.0,0.0
103100.0,17,2,286,2,286,0.0,143.0,143.0,0,0,0.0,0.0,0.0
5005741.0,17,4,849,2,166,0.0,83.0,83.0,2,683,0.0,499.0,341.5
328.0,17,2,166,1,75,0.0,75.0,75.0,1,91,0.0,91.0,91.0
315925.0,17,4,1400,4,1400,105308.33333333331,350.0,350.0,0,0,0.0,0.0,0.0
153517.0,17,2,180,1,90,0.0,90.0,90.0,1,90,0.0,90.0,90.0
2371.0,17,4,344,2,150,0.0,75.0,75.0,2,194,0.0,103.0,97.0
90258243.0,6,13,2036,8,1016,12894034.714285716,188.0,127.0,5,1020,22523123.0,204.0,204.0
206821.0,6,3,426,2,280,0.0,214.0,140.0,1,146,0.0,146.0,146.0
100209655.0,17,12,516,6,258,20000165.6,43.0,43.0,6,258,20001382.6,43.0,43.0
107193313.0,17,14,864,7,432,17834311.0,174.0,61.71428571428572,7,432,17833526.833333332,174.0,61.71428571428572
1108848.0,6,13,1394,7,797,184808.0,253.0,113.85714285714286,6,597,219159.6,259.0,99.5
7300.0,17,2,582,1,83,0.0,83.0,83.0,1,499,0.0,499.0,499.0
233852.0,6,3,337,2,214,0.0,160.0,107.0,1,123,0.0,123.0,123.0
147937.0,17,2,180,1,90,0.0,90.0,90.0,1,90,0.0,90.0,90.0
234944.0,6,3,337,2,214,0.0,160.0,107.0,1,123,0.0,123.0,123.0
207305.0,6,3,426,2,280,0.0,214.0,140.0,1,146,0.0,146.0,146.0
144023.0,17,2,180,1,90,0.0,90.0,90.0,1,90,0.0,90.0,90.0
2098104.0,6,25,7610,13,2516,174842.0,1034.0,193.53846153846155,12,5094,163068.0,1510.0,424.5
147122.0,6,3,373,2,238,0.0,172.0,119.0,1,135,0.0,135.0,135.0
37414.0,6,14,4740,7,653,5929.0,249.0,93.28571428571428,7,4087,5636.0,1514.0,583.8571428571429
216463.0,17,2,180,1,90,0.0,90.0,90.0,1,90,0.0,90.0,90.0
2087148.0,6,25,7610,13,2516,173929.0,1034.0,193.53846153846155,12,5094,161862.54545454544,1510.0,424.5
20898.0,6,10,2032,5,524,4996.0,252.0,104.8,5,1508,4935.5,1236.0,301.6
130283.0,6,3,337,2,214,0.0,160.0,107.0,1,123,0.0,123.0,123.0
0.0,17,1,90,1,90,0.0,90.0,90.0,0,0,0.0,0.0,0.0
2602234.0,6,2,132,1,66,0.0,66.0,66.0,1,66,0.0,66.0,66.0
196730.0,17,2,180,1,90,0.0,90.0,90.0,1,90,0.0,90.0,90.0
121492.0,6,3,337,2,214,0.0,160.0,107.0,1,123,0.0,123.0,123.0
23557.0,6,10,2032,5,524,5648.5,252.0,104.8,5,1508,5439.75,1236.0,301.6
209662.0,17,2,180,1,90,0.0,90.0,90.0,1,90,0.0,90.0,90.0
1175777.0,6,13,3011,8,2383,167968.14285714287,1514.0,297.875,5,628,225012.25,331.0,125.6
15544.0,6,10,2032,5,524,3543.0,252.0,104.8,5,1508,3565.75,1236.0,301.6
2453.0,17,4,344,2,150,0.0,75.0,75.0,2,194,0.0,103.0,97.0
108104688.0,17,5,1005,5,1005,27026172.0,201.0,201.0,0,0,0.0,0.0,0.0
92488.0,6,12,1328,7,797,15414.666666666666,253.0,113.85714285714286,5,531,18974.0,259.0,106.2
90260932.0,6,12,1832,8,1016,12894418.857142856,188.0,127.0,4,816,30024976.0,204.0,204.0
205953.0,6,3,426,2,280,0.0,214.0,140.0,1,146,0.0,146.0,146.0
209272.0,17,2,180,1,90,0.0,90.0,90.0,1,90,0.0,90.0,90.0
10449039.0,6,6,412,3,206,5154032.0,74.0,68.66666666666667,3,206,5153932.5,74.0,68.66666666666667
90062407.0,17,28,13364,28,13364,3335644.703703704,501.0,477.2857142857143,0,0,0.0,0.0,0.0
103571963.0,6,43,2838,22,1452,4917314.714285715,66.0,66.0,21,1386,5150437.85,66.0,66.0
221821.0,17,2,180,1,90,0.0,90.0,90.0,1,90,0.0,90.0,90.0
121272.0,6,3,337,2,214,0.0,160.0,107.0,1,123,0.0,123.0,123.0
313877.0,17,4,1400,4,1400,104625.66666666669,350.0,350.0,0,0,0.0,0.0,0.0
171546.0,6,11,1132,6,556,33962.6,218.0,92.66666666666669,5,576,41793.25,304.0,115.2
89821.0,6,14,4740,7,653,3221.0,249.0,93.28571428571428,7,4087,14833.333333333334,1514.0,583.8571428571429
114397734.0,6,33,2290,17,1125,7149858.375,123.0,66.17647058823529,16,1165,7099500.533333333,139.0,72.8125
41360.0,6,14,4740,7,653,6784.166666666667,249.0,93.28571428571428,7,4087,6119.666666666667,1514.0,583.8571428571429
91532229.0,6,30,2260,16,1228,6087718.2,139.0,76.75,14,1032,7024315.923076923,123.0,73.71428571428571
206251.0,6,3,426,2,280,0.0,214.0,140.0,1,146,0.0,146.0,146.0
23197.0,6,10,2032,5,524,5192.5,252.0,104.8,5,1508,5628.25,1236.0,301.6
624692.0,17,2,346,1,78,0.0,78.0,78.0,1,268,0.0,268.0,268.0
1053621.0,6,3,1604,2,851,0.0,785.0,425.5,1,753,0.0,753.0,753.0
120023861.0,17,28,13364,28,13364,4445328.185185186,501.0,477.2857142857143,0,0,0.0,0.0,0.0
90295687.0,6,21,1585,11,840,9024941.9,95.0,76.36363636363636,10,745,10002277.777777778,95.0,74.5
2021220.0,17,4,525,2,150,0.0,75.0,75.0,2,375,0.0,284.0,187.5
249497.0,6,3,337,2,214,0.0,160.0,107.0,1,123,0.0,123.0,123.0
466.0,17,2,174,1,79,0.0,79.0,79.0,1,95,0.0,95.0,95.0
300156.0,6,6,412,4,272,100052.0,74.0,68.0,2,140,0.0,74.0,70.0
2805484.0,6,2,132,1,66,0.0,66.0,66.0,1,66,0.0,66.0,66.0
17675.0,6,14,4740,7,653,2662.1666666666665,249.0,93.28571428571428,7,4087,2764.1666666666665,1514.0,583.8571428571429
121874.0,6,3,373,2,238,0.0,172.0,119.0,1,135,0.0,135.0,135.0
13785.0,6,10,1065,5,534,3034.5,262.0,106.8,5,531,2542.25,259.0,106.2
118672024.0,6,34,2472,18,1332,6980707.294117647,123.0,74.0,16,1140,7231381.666666667,123.0,71.25
90307569.0,6,17,1287,9,691,11282287.25,95.0,76.77777777777777,8,596,12900755.285714284,95.0,74.5
9784.0,17,2,571,1,86,0.0,86.0,86.0,1,485,0.0,485.0,485.0
324558.0,6,6,412,4,272,108186.0,74.0,68.0,2,140,0.0,74.0,70.0
239062.0,6,13,1394,7,797,39843.66666666666,253.0,113.85714285714286,6,597,46114.2,259.0,99.5
207545.0,6,3,426,2,280,0.0,214.0,140.0,1,146,0.0,146.0,146.0
300297.0,6,6,412,4,272,100099.0,74.0,68.0,2,140,0.0,74.0,70.0
23798.0,6,11,2098,6,590,4512.6,252.0,98.33333333333331,5,1508,5720.5,1236.0,301.6
439832.0,6,11,1021,6,444,59175.8,162.0,74.0,5,577,73766.75,349.0,115.4
5005485.0,17,4,849,2,166,0.0,83.0,83.0,2,683,0.0,499.0,341.5
1326.0,17,2,762,2,762,0.0,381.0,381.0,0,0,0.0,0.0,0.0
336.0,17,2,267,1,83,0.0,83.0,83.0,1,184,0.0,184.0,184.0
114123538.0,6,47,3102,24,1584,4961881.304347826,66.0,66.0,23,1518,5160003.090909091,66.0,66.0
121010326.0,17,15,907,8,475,17287189.42857143,174.0,59.375,7,432,16937274.833333332,174.0,61.71428571428572
153470.0,17,2,180,1,90,0.0,90.0,90.0,1,90,0.0,90.0,90.0
240211.0,17,4,1400,4,1400,80070.33333333333,350.0,350.0,0,0,0.0,0.0,0.0
90057551.0,17,28,13364,28,13364,3335464.851851852,501.0,477.2857142857143,0,0,0.0,0.0,0.0
1993.0,17,4,344,2,150,0.0,75.0,75.0,2,194,0.0,103.0,97.0
119516269.0,6,228,25768,114,17936,1055760.9911504425,284.0,157.33333333333334,114,7832,1055761.371681416,140.0,68.70175438596492
2069038.0,6,24,7543,12,2450,188094.36363636365,1034.0,204.16666666666663,12,5093,160008.27272727274,1510.0,424.4166666666667
1409307.0,17,2,876,2,876,0.0,438.0,438.0,0,0,0.0,0.0,0.0
1302592.0,6,4,264,2,132,0.0,66.0,66.0,2,132,0.0,66.0,66.0
219108.0,6,3,426,2,280,0.0,214.0,140.0,1,146,0.0,146.0,146.0
135123127.0,17,6,1206,6,1206,27024625.4,201.0,201.0,0,0,0.0,0.0,0.0
5631190.0,6,5,336,2,134,0.0,68.0,67.0,3,202,1526645.0,70.0,67.33333333333333
16424992.0,6,27,9227,15,2193,1173213.7142857143,408.0,146.2,12,7034,1117822.4545454546,1514.0,586.1666666666666
20079.0,6,14,4740,7,653,3176.333333333333,249.0,93.28571428571428,7,4087,3080.1666666666665,1514.0,583.8571428571429
120153531.0,6,234,26422,117,8018,1028675.551724138,140.0,68.52991452991454,117,18404,1028715.6637931034,284.0,157.2991452991453
103729201.0,6,43,2838,22,1452,4939472.904761905,66.0,66.0,21,1386,5160784.25,66.0,66.0
645.0,17,2,508,2,508,0.0,257.0,254.0,0,0,0.0,0.0,0.0
60080.0,6,14,4740,7,653,9231.666666666666,249.0,93.28571428571428,7,4087,9774.333333333334,1514.0,583.8571428571429
92447693.0,6,373,50414,187,37916,497030.60752688174,480.0,202.75935828877004,186,12498,498464.8864864865,140.0,67.19354838709677
135145660.0,17,6,1206,6,1206,27029132.0,201.0,201.0,0,0,0.0,0.0,0.0
128688766.0,17,14,864,7,432,18166827.0,174.0,61.71428571428572,7,432,18168422.0,174.0,61.71428571428572
315735.0,17,4,1400,4,1400,105245.0,350.0,350.0,0,0,0.0,0.0,0.0
41872.0,6,14,4740,7,653,6130.166666666667,249.0,93.28571428571428,7,4087,6572.166666666667,1514.0,583.8571428571429
102796602.0,17,14,864,7,432,17001042.333333332,174.0,61.71428571428572,7,432,17000166.166666668,174.0,61.71428571428572
108106999.0,17,5,1005,5,1005,27026749.75,201.0,201.0,0,0,0.0,0.0,0.0
1537936.0,6,4,276,2,128,0.0,74.0,64.0,2,148,0.0,74.0,74.0
153436.0,17,2,180,1,90,0.0,90.0,90.0,1,90,0.0,90.0,90.0
103660.0,17,2,286,2,286,0.0,143.0,143.0,0,0,0.0,0.0,0.0
892.0,17,4,438,2,148,0.0,74.0,74.0,2,290,0.0,147.0,145.0
243322.0,6,3,337,2,214,0.0,160.0,107.0,1,123,0.0,123.0,123.0
2378.0,17,4,344,2,150,0.0,75.0,75.0,2,194,0.0,103.0,97.0
301557.0,6,6,412,4,272,100519.0,74.0,68.0,2,140,0.0,74.0,70.0
117043.0,17,4,1400,4,1400,39014.333333333336,350.0,350.0,0,0,0.0,0.0,0.0
90022407.0,17,28,13364,28,13364,3334163.222222222,501.0,477.2857142857143,0,0,0.0,0.0,0.0
120086425.0,6,30,1990,15,1042,8562172.714285715,139.0,69.46666666666667,15,948,8562172.857142856,123.0,63.2
147468.0,17,4,704,2,148,0.0,74.0,74.0,2,556,0.0,280.0,278.0
135128880.0,17,6,1206,6,1206,27025776.0,201.0,201.0,0,0,0.0,0.0,0.0
154636.0,17,2,180,1,90,0.0,90.0,90.0,1,90,0.0,90.0,90.0
303121.0,6,2,132,1,66,0.0,66.0,66.0,1,66,0.0,66.0,66.0
146115.0,6,3,337,2,214,0.0,160.0,107.0,1,123,0.0,123.0,123.0
218031.0,6,3,426,2,280,0.0,214.0,140.0,1,146,0.0,146.0,146.0
49718.0,6,14,4740,7,653,7650.0,249.0,93.28571428571428,7,4087,7970.666666666667,1514.0,583.8571428571429
228575.0,17,2,180,1,90,0.0,90.0,90.0,1,90,0.0,90.0,90.0
5727.0,17,2,239,1,82,0.0,82.0,82.0,1,157,0.0,157.0,157.0
1193.0,17,2,896,2,896,0.0,453.0,448.0,0,0,0.0,0.0,0.0
1307475.0,6,4,264,2,132,0.0,66.0,66.0,2,132,0.0,66.0,66.0
127590181.0,6,34,2356,18,1285,7505304.764705882,139.0,71.38888888888889,16,1071,7825993.4,123.0,66.9375
135133001.0,17,6,1146,6,1146,27026600.2,191.0,191.0,0,0,0.0,0.0,0.0
15945.0,6,13,1459,7,862,2657.5,271.0,123.14285714285714,6,597,2874.8,259.0,99.5
274611.0,17,4,1524,4,1524,91537.0,381.0,381.0,0,0,0.0,0.0,0.0
32369.000000000004,6,14,4740,7,653,4585.333333333333,249.0,93.28571428571428,7,4087,5255.0,1514.0,583.8571428571429
121238185.0,6,212,23996,106,7218,1138042.0285714285,140.0,68.09433962264151,106,16778,1136862.1142857142,284.0,158.28301886792454
854277.0,6,9,1096,6,625,170855.4,287.0,104.16666666666669,3,471,289362.5,331.0,157.0
37207.0,6,14,4740,7,653,6038.833333333333,249.0,93.28571428571428,7,4087,6009.5,1514.0,583.8571428571429
2053627.0,6,25,7610,13,2516,171135.58333333334,1034.0,193.53846153846155,12,5094,159200.63636363635,1510.0,424.5
298394.0,6,10,1221,6,636,59678.8,298.0,106.0,4,585,94074.0,379.0,146.25
132596847.0,17,14,864,7,432,18834392.0,174.0,61.71428571428572,7,432,18833494.666666668,174.0,61.71428571428572
36867.0,6,10,2032,5,524,8984.25,252.0,104.8,5,1508,8917.0,1236.0,301.6
111147436.0,17,14,1126,7,563,18498086.0,174.0,80.42857142857143,7,563,18498088.5,174.0,80.42857142857143
166826.0,6,13,4515,6,512,32997.4,230.0,85.33333333333333,7,4003,27113.0,1514.0,571.8571428571429
751166.0,6,2,132,1,66,0.0,66.0,66.0,1,66,0.0,66.0,66.0
130692.0,6,2,132,1,66,0.0,66.0,66.0,1,66,0.0,66.0,66.0
232395.0,6,3,337,2,214,0.0,160.0,107.0,1,123,0.0,123.0,123.0
101967.0,17,2,286,2,286,0.0,143.0,143.0,0,0,0.0,0.0,0.0
105277.0,6,13,1394,7,797,17546.166666666668,253.0,113.85714285714286,6,597,20388.4,259.0,99.5
90057447.0,17,28,13364,28,13364,3335461.0,501.0,477.2857142857143,0,0,0.0,0.0,0.0
250258.0,6,3,337,2,214,0.0,160.0,107.0,1,123,0.0,123.0,123.0
143913.0,17,2,180,1,90,0.0,90.0,90.0,1,90,0.0,90.0,90.0
908739.0,6,12,2710,7,742,151456.5,338.0,106.0,5,1968,158392.25,1514.0,393.6
40184.0,6,14,4740,7,653,6564.666666666667,249.0,93.28571428571428,7,4087,6444.833333333333,1514.0,583.8571428571429
319.0,17,2,166,1,75,0.0,75.0,75.0,1,91,0.0,91.0,91.0
1632130.0,6,19,6869,11,1567,163213.0,408.0,142.45454545454547,8,5302,184328.0,1514.0,662.75
90255618.0,6,13,2036,8,1016,12893659.714285716,188.0,127.0,5,1020,22522600.5,204.0,204.0
95912058.0,6,173,19494,87,5964,1115256.488372093,140.0,68.55172413793103,86,13530,1121626.0705882353,284.0,157.32558139534885
1346014.0,17,16,1120,16,1120,89734.26666666666,70.0,70.0,0,0,0.0,0.0,0.0
48905.0,6,14,4740,7,653,7518.333333333333,249.0,93.28571428571428,7,4087,6462.5,1514.0,583.8571428571429
530053.0,17,6,2100,6,2100,106010.6,350.0,350.0,0,0,0.0,0.0,0.0
137662.0,6,2,132,1,66,0.0,66.0,66.0,1,66,0.0,66.0,66.0
103555558.0,17,14,864,7,432,17166871.833333332,174.0,61.71428571428572,7,432,17167456.0,174.0,61.71428571428572
27246908.0,17,5,1710,5,1710,6811727.0,342.0,342.0,0,0,0.0,0.0,0.0
43322.0,6,13,1386,7,789,6770.666666666667,253.0,112.71428571428572,6,597,5744.4,259.0,99.5
135135400.0,17,6,1146,6,1146,27027080.0,191.0,191.0,0,0,0.0,0.0,0.0
10474324.0,6,7,478,4,272,3446250.0,74.0,68.0,3,206,5169261.0,74.0,68.66666666666667
318906.0,6,6,412,4,272,106302.0,74.0,68.0,2,140,0.0,74.0,70.0
196970.0,17,2,180,1,90,0.0,90.0,90.0,1,90,0.0,90.0,90.0
279447.0,6,10,1221,6,636,55889.4,298.0,106.0,4,585,87188.0,379.0,146.25
298274.0,6,6,412,4,272,99424.66666666669,74.0,68.0,2,140,0.0,74.0,70.0
1523635.0,6,20,6434,12,1921,138512.27272727274,620.0,160.08333333333334,8,4513,177889.85714285713,1514.0,564.125
121266027.0,6,214,24218,107,7284,1126567.4433962265,140.0,68.07476635514018,107,16934,1136367.0943396229,284.0,158.26168224299064
2585797.0,6,2,132,1,66,0.0,66.0,66.0,1,66,0.0,66.0,66.0
270162.0,6,12,1373,7,714,45027.0,298.0,102.0,5,659,62638.75,379.0,131.8
120062400.0,6,220,24740,110,7556,1095122.229357798,140.0,68.69090909090909,110,17184,1093997.2018348624,284.0,156.21818181818182
234537.0,6,3,426,2,280,0.0,214.0,140.0,1,146,0.0,146.0,146.0
492072.0,6,5,336,2,134,0.0,68.0,67.0,3,202,193413.5,70.0,67.33333333333333
9343.0,6,10,2032,5,524,2121.75,252.0,104.8,5,1508,2053.5,1236.0,301.6
316170.0,17,4,571,2,148,0.0,74.0,74.0,2,423,0.0,276.0,211.5
1395787.0,17,16,1120,16,1120,93052.46666666666,70.0,70.0,0,0,0.0,0.0,0.0
116831187.0,17,16,1212,8,606,16667179.42857143,174.0,75.75,8,606,16596944.42857143,174.0,75.75
51728569.0,6,8,2113,3,960,24538160.5,826.0,320.0,5,1153,12236984.25,885.0,230.6
2623400.0,6,3,1604,1,753,0.0,753.0,753.0,2,851,0.0,785.0,425.5
111983.0,6,15,4806,8,719,15853.57142857143,249.0,89.875,7,4087,17847.333333333332,1514.0,583.8571428571429
207074.0,6,3,426,2,280,0.0,214.0,140.0,1,146,0.0,146.0,146.0
120111992.0,6,228,25644,114,7820,1046497.0619469028,140.0,68.59649122807018,114,17824,1055723.7876106196,284.0,156.35087719298247
36316.0,6,14,4740,7,653,5303.0,249.0,93.28571428571428,7,4087,5475.166666666667,1514.0,583.8571428571429
303129.0,6,2,132,1,66,0.0,66.0,66.0,1,66,0.0,66.0,66.0
90257691.0,6,12,1832,8,1016,12893955.857142856,188.0,127.0,4,816,30031500.0,204.0,204.0
347.0,17,2,267,1,83,0.0,83.0,83.0,1,184,0.0,184.0,184.0
43533.0,6,14,4740,7,653,7020.166666666667,249.0,93.28571428571428,7,4087,7015.0,1514.0,583.8571428571429
207163.0,6,3,426,2,280,0.0,214.0,140.0,1,146,0.0,146.0,146.0
39444.0,6,10,2032,5,524,9552.25,252.0,104.8,5,1508,8436.0,1236.0,301.6
313238.0,17,4,1400,4,1400,104412.66666666669,350.0,350.0,0,0,0.0,0.0,0.0
171920.0,17,2,180,1,90,0.0,90.0,90.0,1,90,0.0,90.0,90.0
76550431.0,6,9,842,9,842,9568803.875,97.0,93.55555555555556,0,0,0.0,0.0,0.0
120122432.0,6,15,2428,9,1204,15015304.0,188.0,133.77777777777777,6,1224,18073672.8,204.0,204.0
302453.0,6,2,132,1,66,0.0,66.0,66.0,1,66,0.0,66.0,66.0
120227.0,17,2,180,1,70,0.0,70.0,70.0,1,110,0.0,110.0,110.0
206104.0,6,3,426,2,280,0.0,214.0,140.0,1,146,0.0,146.0,146.0
148432.0,17,2,414,1,88,0.0,88.0,88.0,1,326,0.0,326.0,326.0
284694.0,17,2,180,1,90,0.0,90.0,90.0,1,90,0.0,90.0,90.0
30185.0,6,14,4740,7,653,4876.166666666667,249.0,93.28571428571428,7,4087,4888.0,1514.0,583.8571428571429
115691735.0,6,48,3168,24,1584,5030075.434782608,66.0,66.0,24,1584,5016443.913043479,66.0,66.0
244807.0,6,3,373,2,238,0.0,172.0,119.0,1,135,0.0,135.0,135.0
2342.0,17,4,344,2,150,0.0,75.0,75.0,2,194,0.0,103.0,97.0
217865.0,6,3,426,2,280,0.0,214.0,140.0,1,146,0.0,146.0,146.0
108106598.0,17,5,1005,5,1005,27026649.5,201.0,201.0,0,0,0.0,0.0,0.0
147377.0,6,3,373,2,238,0.0,172.0,119.0,1,135,0.0,135.0,135.0
97854964.0,6,32,2506,17,1351,6115935.25,139.0,79.47058823529412,15,1155,6974191.5,123.0,77.0
73542.0,6,14,4740,7,653,12026.166666666666,249.0,93.28571428571428,7,4087,9661.5,1514.0,583.8571428571429
301657.0,6,6,412,4,272,100552.33333333331,74.0,68.0,2,140,0.0,74.0,70.0
296.0,17,2,168,1,76,0.0,76.0,76.0,1,92,0.0,92.0,92.0
1538.0,6,2,177,1,123,0.0,123.0,123.0,1,54,0.0,54.0,54.0
99629488.0,17,14,1126,7,563,16501947.5,174.0,80.42857142857143,7,563,16500137.333333334,174.0,80.42857142857143
1240036.0,17,7,490,7,490,206672.66666666663,70.0,70.0,0,0,0.0,0.0,0.0
13229.0,6,14,4740,7,653,2042.1666666666667,249.0,93.28571428571428,7,4087,2070.1666666666665,1514.0,583.8571428571429
2091.0,17,4,344,2,150,0.0,75.0,75.0,2,194,0.0,103.0,97.0
313830.0,6,6,412,4,272,104610.0,74.0,68.0,2,140,0.0,74.0,70.0
1340836.0,17,16,1120,16,1120,89389.06666666667,70.0,70.0,0,0,0.0,0.0,0.0
59849.0,6,14,4740,7,653,4332.0,249.0,93.28571428571428,7,4087,9838.833333333334,1514.0,583.8571428571429
95013175.0,17,11,735,6,389,19002635.0,174.0,64.83333333333333,5,346,18750220.25,174.0,69.2
300819.0,6,6,412,4,272,100273.0,74.0,68.0,2,140,0.0,74.0,70.0
2345.0,17,4,344,2,150,0.0,75.0,75.0,2,194,0.0,103.0,97.0
102377603.0,17,14,864,7,432,17000170.5,174.0,61.71428571428572,7,432,17001549.166666668,174.0,61.71428571428572
304907.0,6,6,412,4,272,101635.66666666669,74.0,68.0,2,140,0.0,74.0,70.0
117028559.0,6,33,2290,17,1125,7314284.9375,123.0,66.17647058823529,16,1165,7121753.666666667,139.0,72.8125
246261.0,6,3,337,2,214,0.0,160.0,107.0,1,123,0.0,123.0,123.0
6455.0,17,4,823,2,163,0.0,89.0,81.5,2,660,0.0,443.0,330.0
24595.0,6,14,4740,7,653,2970.5,249.0,93.28571428571428,7,4087,3962.0,1514.0,583.8571428571429
306615.0,17,6,2100,6,2100,61323.0,350.0,350.0,0,0,0.0,0.0,0.0
49814.0,6,14,4740,7,653,8165.5,249.0,93.28571428571428,7,4087,7069.0,1514.0,583.8571428571429
0.0,17,1,72,1,72,0.0,72.0,72.0,0,0,0.0,0.0,0.0
120000020.0,6,20,1531,11,840,12000002.0,95.0,76.36363636363636,9,691,11286483.5,95.0,76.77777777777777
107940.0,17,4,1400,4,1400,35980.0,350.0,350.0,0,0,0.0,0.0,0.0
118765105.0,6,33,2290,17,1125,7422819.0625,123.0,66.17647058823529,16,1165,7238149.733333333,139.0,72.8125
0.0,17,1,55,1,55,0.0,55.0,55.0,0,0,0.0,0.0,0.0
117315942.0,6,983,240510,477,32444,246441.83613445377,214.0,68.0167714884696,506,208066,232299.2118811881,1514.0,411.197628458498
36994.0,6,14,4740,7,653,5092.333333333333,249.0,93.28571428571428,7,4087,6030.833333333333,1514.0,583.8571428571429
2799172.0,6,2,132,1,66,0.0,66.0,66.0,1,66,0.0,66.0,66.0
299574.0,6,6,412,4,272,99858.0,74.0,68.0,2,140,0.0,74.0,70.0
2340.0,17,4,344,2,150,0.0,75.0,75.0,2,194,0.0,103.0,97.0
105354135.0,17,14,1126,7,563,17559022.5,174.0,80.42857142857143,7,563,17403486.166666668,174.0,80.42857142857143
110004666.0,17,13,821,7,432,18333499.5,174.0,61.71428571428572,6,389,18000932.8,174.0,64.83333333333333
120227.0,17,2,180,1,70,0.0,70.0,70.0,1,110,0.0,110.0,110.0
3087235.0,6,4,270,2,134,0.0,68.0,67.0,2,136,0.0,70.0,68.0
50982.0,17,2,180,1,90,0.0,90.0,90.0,1,90,0.0,90.0,90.0
41316.0,6,14,4740,7,653,6745.666666666667,249.0,93.28571428571428,7,4087,5163.833333333333,1514.0,583.8571428571429
217693.0,6,3,426,2,280,0.0,214.0,140.0,1,146,0.0,146.0,146.0
2049837.0,17,8,1640,4,312,683143.0,78.0,78.0,4,1328,683140.6666666666,332.0,332.0
225487.0,6,13,1394,7,797,37581.16666666666,253.0,113.85714285714286,6,597,42882.8,259.0,99.5
8282163.000000001,17,4,1376,3,1026,842025.0,342.0,342.0,1,350,0.0,350.0,350.0
2798265.0,6,2,132,1,66,0.0,66.0,66.0,1,66,0.0,66.0,66.0
213635.0,17,2,180,1,90,0.0,90.0,90.0,1,90,0.0,90.0,90.0
99849656.0,6,285,35422,143,9672,703166.5915492958,140.0,67.63636363636364,142,25750,701719.3333333334,300.0,181.33802816901408
0.0,17,1,381,1,381,0.0,381.0,381.0,0,0,0.0,0.0,0.0
103660998.0,17,14,864,7,432,17167859.666666668,174.0,61.71428571428572,7,432,17166833.666666668,174.0,61.71428571428572
144932.0,17,2,180,1,70,0.0,70.0,70.0,1,110,0.0,110.0,110.0
956151.0,6,12,1354,6,723,188716.4,253.0,120.5,6,631,189848.4,293.0,105.16666666666669
62549.99999999999,6,14,4740,7,653,10175.666666666666,249.0,93.28571428571428,7,4087,10224.833333333334,1514.0,583.8571428571429
108109522.0,17,5,1005,5,1005,27027380.5,201.0,201.0,0,0,0.0,0.0,0.0
220290.0,17,2,180,1,90,0.0,90.0,90.0,1,90,0.0,90.0,90.0
33350.0,6,10,2032,5,524,8106.5,252.0,104.8,5,1508,7252.25,1236.0,301.6
56907.0,6,14,4740,7,653,9352.833333333334,249.0,93.28571428571428,7,4087,9200.5,1514.0,583.8571428571429
228280.0,17,2,180,1,90,0.0,90.0,90.0,1,90,0.0,90.0,90.0
1112.0,17,5,550,5,550,278.0,110.0,110.0,0,0,0.0,0.0,0.0
243065.0,6,3,337,2,214,0.0,160.0,107.0,1,123,0.0,123.0,123.0
161137.0,6,2,128,1,74,0.0,74.0,74.0,1,54,0.0,54.0,54.0
120164816.0,6,228,25772,115,7886,1054077.3333333333,140.0,68.57391304347826,113,17886,1057094.1517857143,284.0,158.28318584070797
17461.0,6,14,4740,7,653,2633.833333333333,249.0,93.28571428571428,7,4087,2612.833333333333,1514.0,583.8571428571429
120034632.0,17,29,13785,29,13785,4286951.142857143,501.0,475.3448275862069,0,0,0.0,0.0,0.0
755352.0,6,10,967,5,390,127717.5,162.0,78.0,5,577,126584.5,349.0,115.4
100172567.0,17,12,516,6,258,20000169.2,43.0,43.0,6,258,20003104.0,43.0,43.0
120000004.0,6,26,2019,15,1179,8571428.857142856,95.0,78.6,11,840,9094951.2,95.0,76.36363636363636
18356.0,6,10,2032,5,524,2796.75,252.0,104.8,5,1508,3770.0,1236.0,301.6
10520171.0,6,7,478,4,272,3461555.6666666665,74.0,68.0,3,206,5192231.0,74.0,68.66666666666667
153400.0,17,2,180,1,90,0.0,90.0,90.0,1,90,0.0,90.0,90.0
120124599.0,6,15,2428,9,1204,15015574.875,188.0,133.77777777777777,6,1224,18075167.0,204.0,204.0
2008.0,17,4,344,2,150,0.0,75.0,75.0,2,194,0.0,103.0,97.0
301123.0,6,6,412,4,272,100374.33333333331,74.0,68.0,2,140,0.0,74.0,70.0
26579.0,6,10,2032,5,524,6433.0,252.0,104.8,5,1508,6132.0,1236.0,301.6
120107.0,17,2,180,1,70,0.0,70.0,70.0,1,110,0.0,110.0,110.0
121200309.0,6,346,52818,173,11862,693870.1976744186,214.0,68.56647398843931,173,40956,699981.0581395349,1514.0,236.7398843930636
3616.0,17,2,414,1,88,0.0,88.0,88.0,1,326,0.0,326.0,326.0
110325762.0,6,30,1990,15,1042,7865006.857142857,139.0,69.46666666666667,15,948,7865004.928571428,123.0,63.2
829.0,17,4,438,2,148,0.0,74.0,74.0,2,290,0.0,147.0,145.0
13623510.0,6,21,1743,11,1111,1330887.8,315.0,101.0,10,632,1478762.7777777778,78.0,63.2
2356.0,17,4,344,2,150,0.0,75.0,75.0,2,194,0.0,103.0,97.0
53300.0,6,10,2032,5,524,12969.5,252.0,104.8,5,1508,11151.5,1236.0,301.6
322093.0,6,6,412,4,272,107364.33333333331,74.0,68.0,2,140,0.0,74.0,70.0
96312374.0,6,25,1686,13,840,8025995.75,123.0,64.61538461538461,12,846,7847867.727272727,123.0,70.5
103755.0,17,2,286,2,286,0.0,143.0,143.0,0,0,0.0,0.0,0.0
299134.0,6,6,412,4,272,99711.33333333331,74.0,68.0,2,140,0.0,74.0,70.0
0.0,6,1,54,1,54,0.0,54.0,54.0,0,0,0.0,0.0,0.0
9498.0,17,2,582,1,83,0.0,83.0,83.0,1,499,0.0,499.0,499.0
321507.0,6,3,202,2,128,0.0,74.0,64.0,1,74,0.0,74.0,74.0
312242.0,17,4,1400,4,1400,104080.66666666669,350.0,350.0,0,0,0.0,0.0,0.0
364154.0,6,10,967,5,390,61297.75,162.0,78.0,5,577,61233.5,349.0,115.4
55500.0,6,12,1447,6,816,10668.8,291.0,136.0,6,631,9200.2,293.0,105.16666666666669
317357.0,17,4,1400,4,1400,105785.66666666669,350.0,350.0,0,0,0.0,0.0,0.0
325.0,17,2,174,1,79,0.0,79.0,79.0,1,95,0.0,95.0,95.0
34509.0,6,10,2032,5,524,8397.25,252.0,104.8,5,1508,8236.0,1236.0,301.6
284261.0,6,10,1221,6,636,56852.2,298.0,106.0,4,585,89162.33333333333,379.0,146.25
299220.0,6,6,412,4,272,99740.0,74.0,68.0,2,140,0.0,74.0,70.0
25766.0,6,10,2032,5,524,6204.0,252.0,104.8,5,1508,5039.25,1236.0,301.6
46501.0,6,14,4740,7,653,7076.333333333333,249.0,93.28571428571428,7,4087,7239.5,1514.0,583.8571428571429
218230.0,6,3,426,2,280,0.0,214.0,140.0,1,146,0.0,146.0,146.0
135132493.0,17,6,1146,6,1146,27026498.6,191.0,191.0,0,0,0.0,0.0,0.0
235935.0,17,2,180,1,90,0.0,90.0,90.0,1,90,0.0,90.0,90.0
120088228.0,6,218,24662,109,7490,1095919.3425925926,140.0,68.71559633027523,109,17172,1094799.861111111,284.0,157.54128440366972
5629348.0,6,5,336,2,134,0.0,68.0,67.0,3,202,1419760.5,70.0,67.33333333333333
25984.0,6,14,4740,7,653,4042.1666666666665,249.0,93.28571428571428,7,4087,4153.0,1514.0,583.8571428571429
9420.0,17,2,507,1,86,0.0,86.0,86.0,1,421,0.0,421.0,421.0
1570734.0,6,2,132,1,66,0.0,66.0,66.0,1,66,0.0,66.0,66.0
46581431.0,6,8,1938,3,886,22062749.5,752.0,295.3333333333333,5,1052,11003361.5,784.0,210.4
297788.0,6,6,412,4,272,99262.66666666669,74.0,68.0,2,140,0.0,74.0,70.0
240958.0,6,3,337,2,214,0.0,160.0,107.0,1,123,0.0,123.0,123.0
150840.0,17,2,414,1,88,0.0,88.0,88.0,1,326,0.0,326.0,326.0
4476.0,17,2,618,1,72,0.0,72.0,72.0,1,546,0.0,546.0,546.0
317150.0,17,4,704,2,148,0.0,74.0,74.0,2,556,0.0,280.0,278.0
113618012.0,6,46,3036,23,1518,5150438.7727272725,66.0,66.0,23,1518,5150436.5,66.0,66.0
17159.0,6,10,2032,5,524,3860.25,252.0,104.8,5,1508,3977.5,1236.0,301.6
135130811.0,17,6,1206,6,1206,27026162.2,201.0,201.0,0,0,0.0,0.0,0.0
1168265.0,6,13,3010,8,2382,166895.0,1514.0,297.75,5,628,223184.5,331.0,125.6
108111144.0,6,31,2166,16,1149,7193008.733333333,123.0,71.8125,15,1017,7706795.071428572,123.0,67.8
90219068.0,6,19,1436,9,691,11246459.0,95.0,76.77777777777777,10,745,10000348.222222222,95.0,74.5
92880719.0,17,13,1083,7,563,15480119.833333334,174.0,80.42857142857143,6,520,14666059.8,174.0,86.66666666666667
2594327.0,6,2,132,1,66,0.0,66.0,66.0,1,66,0.0,66.0,66.0
104215.0,17,2,286,2,286,0.0,143.0,143.0,0,0,0.0,0.0,0.0
104047279.0,6,201,22618,101,6888,1040472.79,140.0,68.1980198019802,100,15730,1040613.6161616162,284.0,157.3
5062.0,17,2,180,1,90,0.0,90.0,90.0,1,90,0.0,90.0,90.0
230831.0,17,2,180,1,90,0.0,90.0,90.0,1,90,0.0,90.0,90.0
26549.0,6,14,4740,7,653,4297.833333333333,249.0,93.28571428571428,7,4087,4257.166666666667,1514.0,583.8571428571429
123415851.0,6,48,3168,24,1584,5019219.043478261,66.0,66.0,24,1584,5282326.652173913,66.0,66.0
110414986.0,6,210,23758,105,16532,1059614.2403846155,284.0,157.44761904761904,105,7226,1059613.673076923,140.0,68.81904761904762
43159.0,6,14,4740,7,653,7066.666666666667,249.0,93.28571428571428,7,4087,6647.333333333333,1514.0,583.8571428571429
90063486.0,17,28,13364,28,13364,3335684.6666666665,501.0,477.2857142857143,0,0,0.0,0.0,0.0
0.0,6,1,172,1,172,0.0,172.0,172.0,0,0,0.0,0.0,0.0
122635392.0,6,33,2296,16,1071,7510035.466666667,123.0,66.9375,17,1225,7040654.875,139.0,72.05882352941177
247991.0,6,3,426,2,280,0.0,214.0,140.0,1,146,0.0,146.0,146.0
148048.0,17,2,180,1,90,0.0,90.0,90.0,1,90,0.0,90.0,90.0
2599672.0,6,2,132,1,66,0.0,66.0,66.0,1,66,0.0,66.0,66.0
103583.0,17,2,286,2,286,0.0,143.0,143.0,0,0,0.0,0.0,0.0
46580109.0,6,8,1940,3,887,21818266.0,753.0,295.6666666666667,5,1053,11515169.5,785.0,210.6
171502.0,6,3,337,2,214,0.0,160.0,107.0,1,123,0.0,123.0,123.0
191435.0,17,2,180,1,90,0.0,90.0,90.0,1,90,0.0,90.0,90.0
42463.0,6,14,4740,7,653,6612.666666666667,249.0,93.28571428571428,7,4087,6283.666666666667,1514.0,583.8571428571429
1711584.0,6,19,7533,10,1403,190176.0,583.0,140.3,9,6130,181076.0,1484.0,681.1111111111111
44186.0,6,12,1320,6,723,7922.0,253.0,120.5,6,597,8190.4,259.0,99.5
295.0,17,2,174,1,79,0.0,79.0,79.0,1,95,0.0,95.0,95.0
109342974.0,6,830,148532,411,27644,266387.06341463415,214.0,67.2603406326034,419,120888,261571.1866028708,1514.0,288.51551312649167
240161.0,6,3,337,2,214,0.0,160.0,107.0,1,123,0.0,123.0,123.0
33953.0,6,14,4740,7,653,4524.666666666667,249.0,93.28571428571428,7,4087,3141.0,1514.0,583.8571428571429
2036.0,17,4,344,2,150,0.0,75.0,75.0,2,194,0.0,103.0,97.0
5998592.0,17,3,1359,3,1359,2999296.0,453.0,453.0,0,0,0.0,0.0,0.0
90262168.0,6,14,2240,8,1016,12894595.42857143,188.0,127.0,6,1224,18018653.2,204.0,204.0
1419480.0,17,7,490,7,490,236580.0,70.0,70.0,0,0,0.0,0.0,0.0
102683.0,17,2,286,2,286,0.0,143.0,143.0,0,0,0.0,0.0,0.0
109709376.0,6,211,23786,105,7226,1047123.3557692308,140.0,68.81904761904762,106,16560,1044745.0571428572,284.0,156.2264150943396
90260459.0,6,12,1832,8,1016,12894351.285714284,188.0,127.0,4,816,30030485.33333333,204.0,204.0
206078.0,6,3,426,2,280,0.0,214.0,140.0,1,146,0.0,146.0,146.0
286442.0,6,10,1221,6,636,57288.4,298.0,106.0,4,585,88989.0,379.0,146.25
91998350.0,17,16,5472,16,5472,6133223.333333333,342.0,342.0,0,0,0.0,0.0,0.0
311312.0,6,3,202,2,128,0.0,74.0,64.0,1,74,0.0,74.0,74.0
17236.0,17,4,823,2,163,0.0,89.0,81.5,2,660,0.0,443.0,330.0
0.0,6,1,172,1,172,0.0,172.0,172.0,0,0,0.0,0.0,0.0
2453.0,17,4,344,2,150,0.0,75.0,75.0,2,194,0.0,103.0,97.0
757.0,17,4,438,2,148,0.0,74.0,74.0,2,290,0.0,147.0,145.0
2272.0,17,4,344,2,150,0.0,75.0,75.0,2,194,0.0,103.0,97.0
205892.0,17,2,180,1,90,0.0,90.0,90.0,1,90,0.0,90.0,90.0
83682.0,6,10,2032,5,524,20665.0,252.0,104.8,5,1508,19311.5,1236.0,301.6
239037.0,17,2,180,1,90,0.0,90.0,90.0,1,90,0.0,90.0,90.0
91245059.0,6,26,2019,15,1179,6514602.142857143,95.0,78.6,11,840,9088024.8,95.0,76.36363636363636
38320.0,6,14,4740,7,653,6155.833333333333,249.0,93.28571428571428,7,4087,5914.166666666667,1514.0,583.8571428571429
10474264.0,6,7,478,4,272,3445951.333333333,74.0,68.0,3,206,5168807.0,74.0,68.66666666666667
236774.0,6,3,337,2,214,0.0,160.0,107.0,1,123,0.0,123.0,123.0
40091.0,6,14,4740,7,653,6544.666666666667,249.0,93.28571428571428,7,4087,6364.5,1514.0,583.8571428571429
106779.0,17,2,286,2,286,0.0,143.0,143.0,0,0,0.0,0.0,0.0
113910633.0,6,47,3102,24,1584,4952624.782608695,66.0,66.0,23,1518,5112000.681818182,66.0,66.0
2790696.0,6,2,132,1,66,0.0,66.0,66.0,1,66,0.0,66.0,66.0
206615.0,6,3,426,2,280,0.0,214.0,140.0,1,146,0.0,146.0,146.0
120190370.0,6,234,26422,117,8018,1029075.4568965518,140.0,68.52991452991454,117,18404,1029312.7155172414,284.0,157.2991452991453
331.0,17,2,166,1,75,0.0,75.0,75.0,1,91,0.0,91.0,91.0
27381878.0,17,5,1710,5,1710,6845469.5,342.0,342.0,0,0,0.0,0.0,0.0
234942.0,6,10,1066,5,490,58571.0,218.0,98.0,5,576,58210.5,304.0,115.2
117458641.0,6,229,25980,115,18234,1030338.9561403508,284.0,158.55652173913043,114,7746,1030308.9911504424,140.0,67.94736842105263
108107640.0,17,5,955,5,955,27026910.0,191.0,191.0,0,0,0.0,0.0,0.0
3720.0,17,2,762,2,762,0.0,381.0,381.0,0,0,0.0,0.0,0.0
94555641.0,17,12,778,6,389,18800166.4,174.0,64.83333333333333,6,389,18800996.4,174.0,64.83333333333333
22860.0,6,10,2032,5,524,4375.0,252.0,104.8,5,1508,5135.75,1236.0,301.6
2134.0,17,4,344,2,150,0.0,75.0,75.0,2,194,0.0,103.0,97.0
2480.0,17,4,344,2,150,0.0,75.0,75.0,2,194,0.0,103.0,97.0
302.0,17,2,168,1,76,0.0,76.0,76.0,1,92,0.0,92.0,92.0
102473403.0,6,462,71628,231,56012,444596.75217391306,1514.0,242.47619047619048,231,15616,444601.0565217391,214.0,67.6017316017316
92056084.0,17,12,778,6,389,18401412.6,174.0,64.83333333333333,6,389,18400167.8,174.0,64.83333333333333
103375.0,17,2,286,2,286,0.0,143.0,143.0,0,0,0.0,0.0,0.0
96539768.0,6,185,20826,93,6360,1049345.3043478262,140.0,68.38709677419355,92,14466,1049569.912087912,284.0,157.2391304347826
118970975.0,6,34,2334,17,1209,7422185.375,123.0,71.11764705882354,17,1125,7422183.875,123.0,66.17647058823529
503302.0,6,5,336,2,134,0.0,68.0,67.0,3,202,191770.0,70.0,67.33333333333333
2394.0,17,4,344,2,150,0.0,75.0,75.0,2,194,0.0,103.0,97.0
148819.0,6,15,4806,8,719,20873.14285714286,249.0,89.875,7,4087,24267.166666666668,1514.0,583.8571428571429
840.0,17,4,438,2,148,0.0,74.0,74.0,2,290,0.0,147.0,145.0
205764.0,17,2,180,1,90,0.0,90.0,90.0,1,90,0.0,90.0,90.0
2435.0,17,2,762,2,762,0.0,381.0,381.0,0,0,0.0,0.0,0.0
120024866.0,6,19,1436,10,786,13333330.111111112,95.0,78.6,9,650,14945145.0,95.0,72.22222222222223
204509.0,17,2,762,2,762,0.0,381.0,381.0,0,0,0.0,0.0,0.0
90254873.0,6,12,1832,8,1016,12893553.285714284,188.0,127.0,4,816,30029629.0,204.0,204.0
2800962.0,6,2,132,1,66,0.0,66.0,66.0,1,66,0.0,66.0,66.0
107744.0,17,2,286,2,286,0.0,143.0,143.0,0,0,0.0,0.0,0.0
318.0,17,2,174,1,79,0.0,79.0,79.0,1,95,0.0,95.0,95.0
114902495.0,6,29,1930,15,948,8207321.071428572,123.0,63.2,14,982,8053853.692307692,139.0,70.14285714285714
111005923.0,17,13,821,7,432,18500987.166666668,174.0,61.71428571428572,6,389,18200203.2,174.0,64.83333333333333
2805064.0,6,2,132,1,66,0.0,66.0,66.0,1,66,0.0,66.0,66.0
281392.0,17,2,363,1,79,0.0,79.0,79.0,1,284,0.0,284.0,284.0
1161588.0,6,13,3000,8,2372,165941.14285714287,1514.0,296.5,5,628,222271.25,331.0,125.6
102880150.0,6,42,2772,21,1386,5143994.5,66.0,66.0,21,1386,5143993.9,66.0,66.0
2822889.0,6,11,2106,6,598,563931.8,252.0,99.66666666666669,5,1508,2262.5,1236.0,301.6
23866.0,6,14,4740,7,653,3821.8333333333335,249.0,93.28571428571428,7,4087,3306.0,1514.0,583.8571428571429
2781442.0,6,2,132,1,66,0.0,66.0,66.0,1,66,0.0,66.0,66.0
285729.0,17,2,180,1,90,0.0,90.0,90.0,1,90,0.0,90.0,90.0
157331.0,6,3,337,2,214,0.0,160.0,107.0,1,123,0.0,123.0,123.0
100862.0,17,2,286,2,286,0.0,143.0,143.0,0,0,0.0,0.0,0.0
308056.0,6,6,412,4,272,102685.33333333331,74.0,68.0,2,140,0.0,74.0,70.0
32951.0,6,14,4740,7,653,5311.0,249.0,93.28571428571428,7,4087,5220.833333333333,1514.0,583.8571428571429
135140178.0,17,6,1146,6,1146,27028035.6,191.0,191.0,0,0,0.0,0.0,0.0
101979.0,17,2,762,2,762,0.0,381.0,381.0,0,0,0.0,0.0,0.0
90132511.0,17,12,778,6,389,18000158.6,174.0,64.83333333333333,6,389,18001075.0,174.0,64.83333333333333
2002.0,17,4,344,2,150,0.0,75.0,75.0,2,194,0.0,103.0,97.0
50138.0,6,10,2032,5,524,12301.75,252.0,104.8,5,1508,8553.75,1236.0,301.6
5629498.0,6,5,336,2,134,0.0,68.0,67.0,3,202,1423846.5,70.0,67.33333333333333
320.0,17,2,168,1,76,0.0,76.0,76.0,1,92,0.0,92.0,92.0
219049.0,6,10,1221,6,636,43809.8,298.0,106.0,4,585,70810.0,379.0,146.25
26506329.0,17,5,1718,4,1368,859865.0,342.0,342.0,1,350,0.0,350.0,350.0
206084.0,17,2,762,2,762,0.0,381.0,381.0,0,0,0.0,0.0,0.0
143951.0,17,2,180,1,90,0.0,90.0,90.0,1,90,0.0,90.0,90.0
52044.0,6,14,4740,7,653,8256.5,249.0,93.28571428571428,7,4087,6903.0,1514.0,583.8571428571429
508658.00000000006,6,5,336,2,134,0.0,68.0,67.0,3,202,191574.0,70.0,67.33333333333333
3121087.0,6,3,204,1,68,0.0,68.0,68.0,2,136,0.0,70.0,68.0
90279811.0,6,17,1287,9,691,11279397.25,95.0,76.77777777777777,8,596,12895779.285714284,95.0,74.5
321.0,17,2,174,1,79,0.0,79.0,79.0,1,95,0.0,95.0,95.0
213570.0,17,2,180,1,90,0.0,90.0,90.0,1,90,0.0,90.0,90.0
108106661.0,17,5,1005,5,1005,27026665.25,201.0,201.0,0,0,0.0,0.0,0.0
135134090.0,17,6,1146,6,1146,27026818.0,191.0,191.0,0,0,0.0,0.0,0.0
839.0,17,4,438,2,148,0.0,74.0,74.0,2,290,0.0,147.0,145.0
2295.0,17,4,344,2,150,0.0,75.0,75.0,2,194,0.0,103.0,97.0
143958.0,17,2,180,1,90,0.0,90.0,90.0,1,90,0.0,90.0,90.0
108106488.0,17,5,955,5,955,27026622.0,191.0,191.0,0,0,0.0,0.0,0.0
616.0,17,2,508,2,508,0.0,257.0,254.0,0,0,0.0,0.0,0.0
113932561.0,6,48,3168,24,1584,4953589.608695652,66.0,66.0,24,1584,4939914.913043479,66.0,66.0
24488.0,6,10,1065,5,534,2602.25,262.0,106.8,5,531,5903.75,259.0,106.2
327.0,17,2,166,1,75,0.0,75.0,75.0,1,91,0.0,91.0,91.0
54637.0,6,14,4740,7,653,8696.666666666666,249.0,93.28571428571428,7,4087,8512.166666666666,1514.0,583.8571428571429
900925.0,6,12,1447,6,816,179432.0,291.0,136.0,6,631,179714.2,293.0,105.16666666666669
135131545.0,17,6,1206,6,1206,27026309.0,201.0,201.0,0,0,0.0,0.0,0.0
90051839.0,17,27,12943,27,12943,3463532.269230769,501.0,479.3703703703704,0,0,0.0,0.0,0.0
51829.0,6,11,1133,6,602,10009.8,264.0,100.33333333333331,5,531,9976.0,259.0,106.2
106492.0,17,2,286,2,286,0.0,143.0,143.0,0,0,0.0,0.0,0.0
90581625.0,6,17,2572,9,1204,11322703.125,188.0,133.77777777777777,8,1368,12908769.42857143,204.0,171.0
2348.0,17,4,344,2,150,0.0,75.0,75.0,2,194,0.0,103.0,97.0
205765.0,17,2,180,1,90,0.0,90.0,90.0,1,90,0.0,90.0,90.0
116469310.0,6,196,22236,98,15546,1198494.886597938,284.0,158.6326530612245,98,6690,1198494.5360824745,140.0,68.26530612244898
25175325.0,17,5,1718,4,1368,1809482.0,342.0,342.0,1,350,0.0,350.0,350.0
58870055.0,17,9,3086,8,2736,5107899.0,342.0,342.0,1,350,0.0,350.0,350.0
146161.0,6,3,337,2,214,0.0,160.0,107.0,1,123,0.0,123.0,123.0
100855177.0,6,275,32930,138,23654,736169.1751824818,284.0,171.40579710144928,137,9276,736034.6176470588,140.0,67.7080291970803
199447.0,6,11,1132,6,556,39889.4,218.0,92.66666666666669,5,576,48893.5,304.0,115.2
35754322.0,6,5,336,2,134,0.0,68.0,67.0,3,202,17804344.5,70.0,67.33333333333333
37462.0,6,14,4740,7,653,6114.0,249.0,93.28571428571428,7,4087,5622.0,1514.0,583.8571428571429
120120006.0,6,14,2240,6,1224,24024001.2,204.0,204.0,8,1016,17098189.57142857,188.0,127.0
22470.0,6,14,4740,7,653,3626.3333333333335,249.0,93.28571428571428,7,4087,3612.6666666666665,1514.0,583.8571428571429
146614.0,6,3,373,2,238,0.0,172.0,119.0,1,135,0.0,135.0,135.0
2361.0,17,4,344,2,150,0.0,75.0,75.0,2,194,0.0,103.0,97.0
295.0,17,2,168,1,76,0.0,76.0,76.0,1,92,0.0,92.0,92.0
18852.0,6,10,1067,5,536,3100.0,264.0,107.2,5,531,4043.5,259.0,106.2
108105866.0,17,5,955,5,955,27026466.5,191.0,191.0,0,0,0.0,0.0,0.0
44791.0,6,14,4740,7,653,7338.833333333333,249.0,93.28571428571428,7,4087,5114.333333333333,1514.0,583.8571428571429
16972.0,17,2,180,1,90,0.0,90.0,90.0,1,90,0.0,90.0,90.0
15053296.0,17,6,2718,6,2718,3010659.2,453.0,453.0,0,0,0.0,0.0,0.0
2288.0,17,4,344,2,150,0.0,75.0,75.0,2,194,0.0,103.0,97.0
80055.0,6,10,2032,5,524,18029.75,252.0,104.8,5,1508,7220.0,1236.0,301.6
5624332.0,6,5,336,2,134,0.0,68.0,67.0,3,202,1419044.0,70.0,67.33333333333333
18923.0,6,2,145,2,145,0.0,91.0,72.5,0,0,0.0,0.0,0.0
224870.0,17,2,414,1,88,0.0,88.0,88.0,1,326,0.0,326.0,326.0
203578.0,17,2,762,2,762,0.0,381.0,381.0,0,0,0.0,0.0,0.0
216506.0,17,2,180,1,90,0.0,90.0,90.0,1,90,0.0,90.0,90.0
90299550.0,6,20,1490,11,840,9025216.6,95.0,76.36363636363636,9,650,11286104.75,95.0,72.22222222222223
91006039.0,6,164,18572,82,13012,1120875.1975308645,284.0,158.6829268292683,82,5560,1120874.827160494,140.0,67.8048780487805
200283.0,17,2,180,1,90,0.0,90.0,90.0,1,90,0.0,90.0,90.0
146154.0,6,3,337,2,214,0.0,160.0,107.0,1,123,0.0,123.0,123.0
303870.0,6,6,412,4,272,101290.0,74.0,68.0,2,140,0.0,74.0,70.0
38918.0,6,14,4740,7,653,6356.833333333333,249.0,93.28571428571428,7,4087,5858.5,1514.0,583.8571428571429
307854.0,17,4,1400,4,1400,102618.0,350.0,350.0,0,0,0.0,0.0,0.0
601550.0,6,4,508,2,238,0.0,172.0,119.0,2,270,0.0,135.0,135.0
90259974.0,6,13,2036,8,1016,12894282.0,188.0,127.0,5,1020,22524039.75,204.0,204.0
5881.0,17,2,180,1,90,0.0,90.0,90.0,1,90,0.0,90.0,90.0
154953.0,6,11,1132,6,556,30355.0,218.0,92.66666666666669,5,576,38441.75,304.0,115.2
143875.0,17,2,180,1,90,0.0,90.0,90.0,1,90,0.0,90.0,90.0
2589413.0,6,2,132,1,66,0.0,66.0,66.0,1,66,0.0,66.0,66.0
5004963.0,17,4,629,2,156,0.0,78.0,78.0,2,473,0.0,268.0,236.5
110007174.0,17,13,821,7,432,18334529.0,174.0,61.71428571428572,6,389,18000233.6,174.0,64.83333333333333
19590.0,6,20,7606,11,978,1959.0,310.0,88.9090909090909,9,6628,2118.125,1514.0,736.4444444444445
49866.0,6,14,4740,7,653,7891.833333333333,249.0,93.28571428571428,7,4087,7968.5,1514.0,583.8571428571429
39459.0,6,11,2098,6,590,7891.8,252.0,98.33333333333331,5,1508,6433.5,1236.0,301.6
406308.0,6,4,508,2,238,0.0,172.0,119.0,2,270,0.0,135.0,135.0
2049539.0,17,3,1026,3,1026,1024769.5,342.0,342.0,0,0,0.0,0.0,0.0
111125961.0,6,32,2358,17,1272,6931922.75,123.0,74.82352941176471,15,1086,7922194.928571428,123.0,72.4
10587.0,6,11,2098,6,590,1760.6,252.0,98.33333333333331,5,1508,2332.75,1236.0,301.6
108093185.0,17,5,955,5,955,27023296.25,191.0,191.0,0,0,0.0,0.0,0.0
49283.0,6,10,2032,5,524,11767.75,252.0,104.8,5,1508,11716.25,1236.0,301.6
81332.0,6,14,4740,7,653,13419.666666666666,249.0,93.28571428571428,7,4087,12015.833333333334,1514.0,583.8571428571429
90255520.0,6,12,1832,8,1016,12893645.714285716,188.0,127.0,4,816,30030630.33333333,204.0,204.0
23645.0,6,14,4740,7,653,3593.1666666666665,249.0,93.28571428571428,7,4087,3670.1666666666665,1514.0,583.8571428571429
10470657.0,6,6,412,3,206,5164855.5,74.0,68.66666666666667,3,206,5164701.0,74.0,68.66666666666667
751.0,17,2,762,2,762,0.0,381.0,381.0,0,0,0.0,0.0,0.0
147943.0,17,2,180,1,90,0.0,90.0,90.0,1,90,0.0,90.0,90.0
1733.0,17,6,1230,3,234,566.0,78.0,78.0,3,996,660.5,332.0,332.0
48169.0,6,14,4740,7,653,7701.833333333333,249.0,93.28571428571428,7,4087,7883.833333333333,1514.0,583.8571428571429
90262964.0,6,16,2368,9,1204,11282870.5,188.0,133.77777777777777,7,1164,15016402.333333334,204.0,166.28571428571428
2845697.0,6,2,132,1,66,0.0,66.0,66.0,1,66,0.0,66.0,66.0
2212.0,17,4,344,2,150,0.0,75.0,75.0,2,194,0.0,103.0,97.0
45751.0,6,10,2032,5,524,11208.0,252.0,104.8,5,1508,10680.25,1236.0,301.6
120062196.0,6,437,56592,219,14750,550744.0183486239,140.0,67.35159817351598,218,41842,548471.5391705069,570.0,191.93577981651376
90037803.0,17,28,13364,28,13364,3334733.4444444445,501.0,477.2857142857143,0,0,0.0,0.0,0.0
230845.0,17,2,359,1,75,0.0,75.0,75.0,1,284,0.0,284.0,284.0
58128.0,17,2,762,2,762,0.0,381.0,381.0,0,0,0.0,0.0,0.0
301199.0,6,6,412,4,272,100399.66666666669,74.0,68.0,2,140,0.0,74.0,70.0
10464046.0,6,7,478,4,272,3440993.0,74.0,68.0,3,206,5161375.0,74.0,68.66666666666667
90902285.0,6,19,1436,9,691,11362785.625,95.0,76.77777777777777,10,745,10073538.222222222,95.0,74.5
108104521.0,17,5,955,5,955,27026130.25,191.0,191.0,0,0,0.0,0.0,0.0
35437.0,6,14,4740,7,653,5257.333333333333,249.0,93.28571428571428,7,4087,5493.5,1514.0,583.8571428571429
135133456.0,17,6,1146,6,1146,27026691.2,191.0,191.0,0,0,0.0,0.0,0.0
101206046.0,17,14,864,7,432,16833501.5,174.0,61.71428571428572,7,432,16834303.833333332,174.0,61.71428571428572
122530366.0,6,49,3234,25,1650,5105431.916666667,66.0,66.0,24,1584,4935128.956521739,66.0,66.0
0.0,17,1,72,1,72,0.0,72.0,72.0,0,0,0.0,0.0,0.0
116250667.0,6,42,3330,23,1821,5274032.227272728,123.0,79.17391304347827,19,1509,6446036.277777778,123.0,79.42105263157895
30492.0,6,10,2032,5,524,7207.0,252.0,104.8,5,1508,6884.75,1236.0,301.6
50749.0,6,10,2032,5,524,11486.5,252.0,104.8,5,1508,11524.0,1236.0,301.6
781.0,17,4,438,2,148,0.0,74.0,74.0,2,290,0.0,147.0,145.0
121740.0,6,4,439,2,238,0.0,172.0,119.0,2,201,0.0,135.0,100.5
153431.0,17,2,180,1,90,0.0,90.0,90.0,1,90,0.0,90.0,90.0
153431.0,17,2,180,1,90,0.0,90.0,90.0,1,90,0.0,90.0,90.0
35000.0,6,10,2032,5,524,8040.25,252.0,104.8,5,1508,8060.0,1236.0,301.6
103604.0,17,2,286,2,286,0.0,143.0,143.0,0,0,0.0,0.0,0.0
334.0,17,2,250,1,93,0.0,93.0,93.0,1,157,0.0,157.0,157.0
128010139.0,17,15,907,8,475,18287162.71428572,174.0,59.375,7,432,18000167.5,174.0,61.71428571428572
91777254.0,6,26,1762,13,922,7630130.25,139.0,70.92307692307692,13,840,7630131.25,123.0,64.61538461538461
2019.0,17,4,344,2,150,0.0,75.0,75.0,2,194,0.0,103.0,97.0
27562.0,6,14,4740,7,653,4138.0,249.0,93.28571428571428,7,4087,4008.1666666666665,1514.0,583.8571428571429
108411205.0,6,218,24640,109,17224,1001815.6018518518,374.0,158.0183486238532,109,7416,1001815.7037037036,140.0,68.03669724770643
90256345.0,6,13,2036,8,1016,12893763.57142857,188.0,127.0,5,1020,22522808.0,204.0,204.0
100711042.0,6,28,1876,14,982,7730398.769230769,139.0,70.14285714285714,14,894,7730397.461538462,123.0,63.85714285714285
297681.0,6,6,412,4,272,99227.0,74.0,68.0,2,140,0.0,74.0,70.0
34948.0,6,14,4740,7,653,4605.0,249.0,93.28571428571428,7,4087,5613.0,1514.0,583.8571428571429
46676.0,6,12,1320,6,723,8277.6,253.0,120.5,6,597,8427.8,259.0,99.5
10532971.0,6,7,478,4,272,3463827.333333333,74.0,68.0,3,206,5195637.0,74.0,68.66666666666667
102211.0,17,2,286,2,286,0.0,143.0,143.0,0,0,0.0,0.0,0.0
510196.0,6,5,336,2,134,0.0,68.0,67.0,3,202,194920.5,70.0,67.33333333333333
514346.0,6,3,1604,2,851,0.0,785.0,425.5,1,753,0.0,753.0,753.0
42954.0,6,14,4740,7,653,6347.666666666667,249.0,93.28571428571428,7,4087,6281.833333333333,1514.0,583.8571428571429
139013.0,17,2,176,1,80,0.0,80.0,80.0,1,96,0.0,96.0,96.0
101490099.0,17,14,864,7,432,16832359.333333332,174.0,61.71428571428572,7,432,16833531.666666668,174.0,61.71428571428572
247467.0,6,3,337,2,214,0.0,160.0,107.0,1,123,0.0,123.0,123.0
281959.0,17,2,363,1,79,0.0,79.0,79.0,1,284,0.0,284.0,284.0
27407334.0,17,5,1710,5,1710,6851833.5,342.0,342.0,0,0,0.0,0.0,0.0
443.0,17,2,166,1,75,0.0,75.0,75.0,1,91,0.0,91.0,91.0
120123018.0,6,14,2224,9,1204,15015377.25,188.0,133.77777777777777,5,1020,22591572.75,204.0,204.0
125796096.0,6,54,12073,29,6455,3431539.6785714286,1514.0,222.5862068965517,25,5618,5232949.041666667,1514.0,224.72
77348.0,6,15,4806,8,719,10925.857142857143,249.0,89.875,7,4087,12684.0,1514.0,583.8571428571429
107359182.0,17,14,864,7,432,17866567.833333332,174.0,61.71428571428572,7,432,17783448.666666668,174.0,61.71428571428572
0.0,17,1,289,1,289,0.0,289.0,289.0,0,0,0.0,0.0,0.0
115133727.0,6,48,3168,24,1584,5005814.217391305,66.0,66.0,24,1584,4993823.913043479,66.0,66.0
1003308.0,6,12,1354,6,723,199071.2,253.0,120.5,6,631,198067.6,293.0,105.16666666666669
27108.0,6,11,2098,6,590,4966.8,252.0,98.33333333333331,5,1508,5743.0,1236.0,301.6
90369.0,6,2,132,1,66,0.0,66.0,66.0,1,66,0.0,66.0,66.0
23408.0,6,14,4740,7,653,3776.8333333333335,249.0,93.28571428571428,7,4087,3741.1666666666665,1514.0,583.8571428571429
119871382.0,17,35,16705,35,16705,3525628.882352941,501.0,477.2857142857143,0,0,0.0,0.0,0.0
99988904.0,6,225,26108,113,7754,892758.0714285715,140.0,68.61946902654867,112,18354,898337.2432432432,300.0,163.875
144738.0,17,2,180,1,70,0.0,70.0,70.0,1,110,0.0,110.0,110.0
488839.0,6,3,1777,1,826,0.0,826.0,826.0,2,951,0.0,885.0,475.5
135135644.0,17,6,1206,6,1206,27027128.8,201.0,201.0,0,0,0.0,0.0,0.0
26554.0,6,14,4740,7,653,4301.833333333333,249.0,93.28571428571428,7,4087,4285.0,1514.0,583.8571428571429
322207.0,6,6,412,4,272,107402.33333333331,74.0,68.0,2,140,0.0,74.0,70.0
42627.0,6,14,4740,7,653,6893.5,249.0,93.28571428571428,7,4087,6743.0,1514.0,583.8571428571429
2425.0,17,2,762,2,762,0.0,381.0,381.0,0,0,0.0,0.0,0.0
121459.0,6,3,337,2,214,0.0,160.0,107.0,1,123,0.0,123.0,123.0
46463.0,6,14,4740,7,653,7633.333333333333,249.0,93.28571428571428,7,4087,5537.666666666667,1514.0,583.8571428571429
316.0,17,2,174,1,79,0.0,79.0,79.0,1,95,0.0,95.0,95.0
966563.0,17,2,239,1,82,0.0,82.0,82.0,1,157,0.0,157.0,157.0
27752.0,6,14,4740,7,653,4129.833333333333,249.0,93.28571428571428,7,4087,4401.666666666667,1514.0,583.8571428571429
10476324.0,6,7,478,4,272,3444898.6666666665,74.0,68.0,3,206,5167234.0,74.0,68.66666666666667
324.0,17,2,174,1,79,0.0,79.0,79.0,1,95,0.0,95.0,95.0
90529257.0,6,15,2444,8,1016,12932751.0,188.0,127.0,7,1428,15060614.0,204.0,204.0
309739.0,6,6,412,4,272,103246.33333333331,74.0,68.0,2,140,0.0,74.0,70.0
138088.0,6,2,132,1,66,0.0,66.0,66.0,1,66,0.0,66.0,66.0
63904.0,6,14,4740,7,653,10510.0,249.0,93.28571428571428,7,4087,10493.166666666666,1514.0,583.8571428571429
4461.0,17,4,344,2,150,0.0,75.0,75.0,2,194,0.0,103.0,97.0
62674.99999999999,6,10,2032,5,524,15362.5,252.0,104.8,5,1508,15397.25,1236.0,301.6
280889.0,17,2,363,1,79,0.0,79.0,79.0,1,284,0.0,284.0,284.0
28410.0,6,14,4740,7,653,4434.333333333333,249.0,93.28571428571428,7,4087,4261.5,1514.0,583.8571428571429
30627.0,6,14,4740,7,653,4906.5,249.0,93.28571428571428,7,4087,4862.5,1514.0,583.8571428571429
307830.0,6,6,412,4,272,102610.0,74.0,68.0,2,140,0.0,74.0,70.0
153479.0,17,2,180,1,90,0.0,90.0,90.0,1,90,0.0,90.0,90.0
126856495.0,6,36,2734,17,1263,7304477.8125,123.0,74.29411764705883,19,1471,6492846.0,139.0,77.42105263157895
108671006.0,6,34,2482,17,1288,6778436.5,139.0,75.76470588235294,17,1194,6778436.0,123.0,70.23529411764706
153401.0,17,2,180,1,90,0.0,90.0,90.0,1,90,0.0,90.0,90.0
242077.0,6,3,337,2,214,0.0,160.0,107.0,1,123,0.0,123.0,123.0
2404.0,17,4,344,2,150,0.0,75.0,75.0,2,194,0.0,103.0,97.0
0.0,17,1,55,1,55,0.0,55.0,55.0,0,0,0.0,0.0,0.0
2137357.0,6,20,6935,11,1567,213735.7,408.0,142.45454545454547,9,5368,224184.875,1514.0,596.4444444444445
97035604.0,6,40,2640,20,1320,5107137.052631579,66.0,66.0,20,1320,5090589.421052632,66.0,66.0
2342.0,17,4,344,2,150,0.0,75.0,75.0,2,194,0.0,103.0,97.0
233081.0,6,3,337,2,214,0.0,160.0,107.0,1,123,0.0,123.0,123.0
3019069.0,6,12,2172,7,664,503013.0,252.0,94.85714285714286,5,1508,4407.75,1236.0,301.6
135122384.0,17,6,1206,6,1206,27024476.8,201.0,201.0,0,0,0.0,0.0,0.0
10526207.0,6,7,478,4,272,3461683.6666666665,74.0,68.0,3,206,5192414.0,74.0,68.66666666666667
299794.0,6,3,202,2,128,0.0,74.0,64.0,1,74,0.0,74.0,74.0
5005155.0,17,4,534,2,166,0.0,83.0,83.0,2,368,0.0,184.0,184.0
142757.0,17,4,571,2,148,0.0,74.0,74.0,2,423,0.0,276.0,211.5
34309.0,6,14,4740,7,653,5593.5,249.0,93.28571428571428,7,4087,5044.833333333333,1514.0,583.8571428571429
332.0,17,2,160,1,80,0.0,80.0,80.0,1,80,0.0,80.0,80.0
27428324.0,17,5,1710,5,1710,6857081.0,342.0,342.0,0,0,0.0,0.0,0.0
90016713.0,17,28,13364,28,13364,3333952.333333333,501.0,477.2857142857143,0,0,0.0,0.0,0.0
2320.0,17,4,344,2,150,0.0,75.0,75.0,2,194,0.0,103.0,97.0
262854.0,6,10,1221,6,636,52570.8,298.0,106.0,4,585,82086.0,379.0,146.25
206031.0,17,2,180,1,90,0.0,90.0,90.0,1,90,0.0,90.0,90.0
12363.0,17,4,823,2,163,0.0,89.0,81.5,2,660,0.0,443.0,330.0
312.0,17,2,174,1,79,0.0,79.0,79.0,1,95,0.0,95.0,95.0
232920.0,6,3,337,2,214,0.0,160.0,107.0,1,123,0.0,123.0,123.0
236513.0,6,3,337,2,214,0.0,160.0,107.0,1,123,0.0,123.0,123.0
197219.0,17,2,180,1,90,0.0,90.0,90.0,1,90,0.0,90.0,90.0
314465.0,6,3,202,2,128,0.0,74.0,64.0,1,74,0.0,74.0,74.0
9548.0,17,2,582,1,83,0.0,83.0,83.0,1,499,0.0,499.0,499.0
27959052.0,6,28,7735,15,3789,168455.5,1514.0,252.6,13,3946,2312794.9166666665,1514.0,303.53846153846155
234998.0,6,3,373,2,238,0.0,172.0,119.0,1,135,0.0,135.0,135.0
68334.0,6,14,4740,7,653,10936.333333333334,249.0,93.28571428571428,7,4087,11173.5,1514.0,583.8571428571429
21718.0,6,14,4740,7,653,3145.6666666666665,249.0,93.28571428571428,7,4087,2983.0,1514.0,583.8571428571429
307333.0,6,6,412,4,272,102444.33333333331,74.0,68.0,2,140,0.0,74.0,70.0
62458.0,6,10,1066,5,490,11248.0,218.0,98.0,5,576,15395.25,304.0,115.2
594.0,17,2,508,2,508,0.0,257.0,254.0,0,0,0.0,0.0,0.0
2015.0,17,4,344,2,150,0.0,75.0,75.0,2,194,0.0,103.0,97.0
196894.0,17,2,180,1,90,0.0,90.0,90.0,1,90,0.0,90.0,90.0
120071319.0,17,28,13364,28,13364,4447085.888888889,501.0,477.2857142857143,0,0,0.0,0.0,0.0
146113.0,6,3,337,2,214,0.0,160.0,107.0,1,123,0.0,123.0,123.0
1073572.0,6,13,1386,7,789,178928.66666666666,253.0,112.71428571428572,6,597,209054.8,259.0,99.5
96614.0,17,2,762,2,762,0.0,381.0,381.0,0,0,0.0,0.0,0.0
69818.0,6,14,4740,7,653,11252.0,249.0,93.28571428571428,7,4087,11076.833333333334,1514.0,583.8571428571429
4955.0,17,4,344,2,150,0.0,75.0,75.0,2,194,0.0,103.0,97.0
30304.0,6,14,4740,7,653,4874.833333333333,249.0,93.28571428571428,7,4087,4918.333333333333,1514.0,583.8571428571429
146188.0,6,3,337,2,214,0.0,160.0,107.0,1,123,0.0,123.0,123.0
26601.0,6,11,2098,6,590,5069.6,252.0,98.33333333333331,5,1508,6059.75,1236.0,301.6
1026719.0,6,11,1134,6,558,205343.8,220.0,93.0,5,576,254879.5,304.0,115.2
209924.0,17,2,180,1,90,0.0,90.0,90.0,1,90,0.0,90.0,90.0
97298.0,17,2,762,2,762,0.0,381.0,381.0,0,0,0.0,0.0,0.0
16305.0,6,14,4740,7,653,2607.5,249.0,93.28571428571428,7,4087,2581.333333333333,1514.0,583.8571428571429
440.0,17,2,166,1,75,0.0,75.0,75.0,1,91,0.0,91.0,91.0
10474463.0,6,7,478,4,272,3445989.6666666665,74.0,68.0,3,206,5168704.5,74.0,68.66666666666667
1307690.0,6,4,264,2,132,0.0,66.0,66.0,2,132,0.0,66.0,66.0
121818.0,6,3,337,2,214,0.0,160.0,107.0,1,123,0.0,123.0,123.0
207080.0,6,3,426,2,280,0.0,214.0,140.0,1,146,0.0,146.0,146.0
25027.0,6,10,2032,5,524,6000.5,252.0,104.8,5,1508,5625.75,1236.0,301.6
123455869.0,6,48,3168,24,1584,5076366.0,66.0,66.0,24,1584,5191600.695652174,66.0,66.0
118930570.0,6,35,2526,18,1332,6983218.117647059,123.0,74.0,17,1194,7419671.75,123.0,70.23529411764706
242153.0,6,3,337,2,214,0.0,160.0,107.0,1,123,0.0,123.0,123.0
90286981.0,6,16,1192,8,596,12891718.142857144,95.0,74.5,8,596,12897740.285714284,95.0,74.5
135138310.0,17,6,1206,6,1206,27027662.0,201.0,201.0,0,0,0.0,0.0,0.0
104556.0,17,2,286,2,286,0.0,143.0,143.0,0,0,0.0,0.0,0.0
106295359.0,6,196,22310,98,15546,1093609.649484536,374.0,158.6326530612245,98,6764,1093610.6082474226,140.0,69.0204081632653
3445.0,17,2,762,2,762,0.0,381.0,381.0,0,0,0.0,0.0,0.0
102636.0,17,2,286,2,286,0.0,143.0,143.0,0,0,0.0,0.0,0.0
2875.0,17,2,224,1,76,0.0,76.0,76.0,1,148,0.0,148.0,148.0
92151637.0,6,515,64762,258,17250,358566.68093385216,140.0,66.86046511627907,257,47512,359067.77734375,464.0,184.8715953307393
2039056.0,17,5,961,3,234,1019335.5,78.0,78.0,2,727,0.0,395.0,363.5
1304220.0,6,4,264,2,132,0.0,66.0,66.0,2,132,0.0,66.0,66.0
4943.0,17,4,344,2,150,0.0,75.0,75.0,2,194,0.0,103.0,97.0
41788.0,6,14,4740,7,653,5723.166666666667,249.0,93.28571428571428,7,4087,6726.333333333333,1514.0,583.8571428571429
120989323.0,6,33,2296,17,1225,7561832.6875,139.0,72.05882352941177,16,1071,7385772.866666666,123.0,66.9375
13613465.0,6,20,1607,10,975,1479128.4444444445,315.0,97.5,10,632,1479120.111111111,78.0,63.2
125188178.0,6,30,2037,15,948,8416239.857142856,123.0,63.2,15,1089,8228767.571428572,123.0,72.6
20068.0,6,11,1133,6,602,3829.8,264.0,100.33333333333331,5,531,4294.5,259.0,106.2
108103810.0,17,5,955,5,955,27025952.5,191.0,191.0,0,0,0.0,0.0,0.0
2466.0,17,2,762,2,762,0.0,381.0,381.0,0,0,0.0,0.0,0.0
26904773.0,17,5,1710,5,1710,6726193.25,342.0,342.0,0,0,0.0,0.0,0.0
90268297.0,6,13,2036,8,1016,12895471.0,188.0,127.0,5,1020,22526312.25,204.0,204.0
2391.0,17,4,344,2,150,0.0,75.0,75.0,2,194,0.0,103.0,97.0
49808.0,6,14,4740,7,653,8122.333333333333,249.0,93.28571428571428,7,4087,7414.5,1514.0,583.8571428571429
120671210.0,17,14,864,7,432,16833499.166666668,174.0,61.71428571428572,7,432,16835086.666666668,174.0,61.71428571428572
232997.0,6,3,337,2,214,0.0,160.0,107.0,1,123,0.0,123.0,123.0
20156.0,6,2,145,2,145,0.0,91.0,72.5,0,0,0.0,0.0,0.0
211668.0,17,2,180,1,90,0.0,90.0,90.0,1,90,0.0,90.0,90.0
9354.0,6,10,1067,5,536,2169.25,264.0,107.2,5,531,2063.0,259.0,106.2
19874.0,6,14,4740,7,653,3173.1666666666665,249.0,93.28571428571428,7,4087,3171.833333333333,1514.0,583.8571428571429
112392.0,17,4,1400,4,1400,37464.0,350.0,350.0,0,0,0.0,0.0,0.0
22077.0,6,10,2032,5,524,5223.25,252.0,104.8,5,1508,5239.25,1236.0,301.6
6861.0,17,2,582,1,83,0.0,83.0,83.0,1,499,0.0,499.0,499.0
506734.0,6,5,336,2,134,0.0,68.0,67.0,3,202,192899.5,70.0,67.33333333333333
60172.0,6,14,4740,7,653,8633.0,249.0,93.28571428571428,7,4087,9810.333333333334,1514.0,583.8571428571429
90069725.0,17,28,13364,28,13364,3335915.7407407407,501.0,477.2857142857143,0,0,0.0,0.0,0.0
90257855.0,6,13,2036,8,1016,12893979.285714284,188.0,127.0,5,1020,22522990.5,204.0,204.0
107834394.0,6,28,1860,14,966,8278334.923076923,123.0,69.0,14,894,8278352.461538462,123.0,63.85714285714285
2460.0,17,4,344,2,150,0.0,75.0,75.0,2,194,0.0,103.0,97.0
31677.0,6,10,2032,5,524,7684.5,252.0,104.8,5,1508,7743.25,1236.0,301.6
287.0,17,2,700,2,700,0.0,350.0,350.0,0,0,0.0,0.0,0.0
1315882.0,6,4,264,2,132,0.0,66.0,66.0,2,132,0.0,66.0,66.0
2802871.0,6,2,132,1,66,0.0,66.0,66.0,1,66,0.0,66.0,66.0
153387.0,17,2,180,1,90,0.0,90.0,90.0,1,90,0.0,90.0,90.0
97951912.0,6,171,19272,86,5898,1152375.4352941175,140.0,68.5813953488372,85,13374,1155152.6785714286,284.0,157.34117647058824
159259.0,6,3,337,2,214,0.0,160.0,107.0,1,123,0.0,123.0,123.0
320784.0,6,6,412,4,272,106928.0,74.0,68.0,2,140,0.0,74.0,70.0
4893.0,17,2,180,1,90,0.0,90.0,90.0,1,90,0.0,90.0,90.0
2304.0,17,4,344,2,150,0.0,75.0,75.0,2,194,0.0,103.0,97.0
233370.0,6,3,337,2,214,0.0,160.0,107.0,1,123,0.0,123.0,123.0
16324.000000000002,6,14,4740,7,653,2066.0,249.0,93.28571428571428,7,4087,2585.333333333333,1514.0,583.8571428571429
157072.0,6,3,337,2,214,0.0,160.0,107.0,1,123,0.0,123.0,123.0
11570.0,6,11,2098,6,590,2159.0,252.0,98.33333333333331,5,1508,2649.75,1236.0,301.6
20294.0,6,10,2032,5,524,4722.0,252.0,104.8,5,1508,4449.0,1236.0,301.6
205753.0,17,2,180,1,90,0.0,90.0,90.0,1,90,0.0,90.0,90.0
90051786.0,17,28,13364,28,13364,3335251.333333333,501.0,477.2857142857143,0,0,0.0,0.0,0.0
58627.0,6,14,4740,7,653,9648.0,249.0,93.28571428571428,7,4087,9314.666666666666,1514.0,583.8571428571429
148102.0,17,2,180,1,90,0.0,90.0,90.0,1,90,0.0,90.0,90.0
114256504.0,6,48,3168,24,1584,4967674.0869565215,66.0,66.0,24,1584,4955818.478260869,66.0,66.0
309.0,17,2,164,1,82,0.0,82.0,82.0,1,82,0.0,82.0,82.0
22777.0,6,14,4740,7,653,3361.5,249.0,93.28571428571428,7,4087,3563.1666666666665,1514.0,583.8571428571429
249697.0,17,2,359,1,75,0.0,75.0,75.0,1,284,0.0,284.0,284.0
308667.0,6,6,412,4,272,102889.0,74.0,68.0,2,140,0.0,74.0,70.0
1395.0,17,5,550,5,550,348.75,110.0,110.0,0,0,0.0,0.0,0.0
21618.0,17,2,582,1,83,0.0,83.0,83.0,1,499,0.0,499.0,499.0
245512.0,6,3,337,2,214,0.0,160.0,107.0,1,123,0.0,123.0,123.0
90034107.0,17,28,13364,28,13364,3334596.5555555555,501.0,477.2857142857143,0,0,0.0,0.0,0.0
2357.0,17,4,344,2,150,0.0,75.0,75.0,2,194,0.0,103.0,97.0
135138360.0,17,6,1146,6,1146,27027672.0,191.0,191.0,0,0,0.0,0.0,0.0
228330.0,17,2,180,1,90,0.0,90.0,90.0,1,90,0.0,90.0,90.0
146671.0,6,3,373,2,238,0.0,172.0,119.0,1,135,0.0,135.0,135.0
25418.0,6,11,2098,6,590,4970.0,252.0,98.33333333333331,5,1508,5811.0,1236.0,301.6
47611284.0,6,8,2113,3,960,22439262.5,826.0,320.0,5,1153,11207811.75,885.0,230.6
518.0,17,2,508,2,508,0.0,257.0,254.0,0,0,0.0,0.0,0.0
108099504.0,17,5,1005,5,1005,27024876.0,201.0,201.0,0,0,0.0,0.0,0.0
2444.0,17,4,344,2,150,0.0,75.0,75.0,2,194,0.0,103.0,97.0
69464.0,6,14,4740,7,653,11218.166666666666,249.0,93.28571428571428,7,4087,10228.833333333334,1514.0,583.8571428571429
135132757.0,17,6,1146,6,1146,27026551.4,191.0,191.0,0,0,0.0,0.0,0.0
838928.0,6,9,1118,6,586,167785.6,248.0,97.66666666666669,3,532,283155.5,392.0,177.33333333333334
124384277.0,6,32,2226,17,1209,7774017.3125,123.0,71.11764705882354,15,1017,8155941.571428572,123.0,67.8
72432.0,6,10,2032,5,524,17863.0,252.0,104.8,5,1508,13444.75,1236.0,301.6
117386316.0,17,16,1212,8,606,16714421.714285716,174.0,75.75,8,606,16715431.0,174.0,75.75
395.0,17,2,410,1,78,0.0,78.0,78.0,1,332,0.0,332.0,332.0
90255864.0,6,13,2036,8,1016,12893694.857142856,188.0,127.0,5,1020,22522888.0,204.0,204.0
120122728.0,6,15,2428,9,1204,15015341.0,188.0,133.77777777777777,6,1224,18018436.2,204.0,204.0
90093511.0,6,13,2052,6,1224,18018251.8,204.0,204.0,7,828,14969586.0,188.0,118.28571428571428
24853.0,6,14,4740,7,653,3775.0,249.0,93.28571428571428,7,4087,3770.3333333333335,1514.0,583.8571428571429
883669.0,6,12,2718,7,743,147278.16666666666,339.0,106.14285714285714,5,1975,152044.5,1514.0,395.0
102135767.0,6,879,180198,431,29038,237519.37441860465,214.0,67.37354988399072,448,151160,228465.82997762863,1514.0,337.4107142857143
227954.0,6,3,426,2,280,0.0,214.0,140.0,1,146,0.0,146.0,146.0
90262253.0,6,13,2036,8,1016,12894607.57142857,188.0,127.0,5,1020,22524863.75,204.0,204.0
36983135.0,6,5,336,2,134,0.0,68.0,67.0,3,202,18422634.0,70.0,67.33333333333333
90304452.0,6,16,1192,8,596,12894554.0,95.0,74.5,8,596,12899838.42857143,95.0,74.5
119808462.0,6,23,1734,11,840,11980846.2,95.0,76.36363636363636,12,894,10868544.636363637,95.0,74.5
228241.0,17,2,180,1,90,0.0,90.0,90.0,1,90,0.0,90.0,90.0
116690485.0,6,48,3168,24,1584,5073499.347826087,66.0,66.0,24,1584,5059895.956521739,66.0,66.0
108099790.0,17,5,1005,5,1005,27024947.5,201.0,201.0,0,0,0.0,0.0,0.0
84705.0,6,14,4740,7,653,13997.0,249.0,93.28571428571428,7,4087,13926.5,1514.0,583.8571428571429
15143.0,17,2,180,1,90,0.0,90.0,90.0,1,90,0.0,90.0,90.0
146935.0,6,3,373,2,238,0.0,172.0,119.0,1,135,0.0,135.0,135.0
299547.0,6,6,412,4,272,99849.0,74.0,68.0,2,140,0.0,74.0,70.0
353.0,17,2,214,1,75,0.0,75.0,75.0,1,139,0.0,139.0,139.0
120125632.0,6,14,2240,6,1224,24025126.4,204.0,204.0,8,1016,17137175.714285713,188.0,127.0
2022545.0,6,19,6869,10,1501,224727.22222222225,408.0,150.1,9,5368,206118.5,1514.0,596.4444444444445
44863.0,6,14,4740,7,653,6993.166666666667,249.0,93.28571428571428,7,4087,7338.166666666667,1514.0,583.8571428571429
574491.0,6,4,508,2,238,0.0,172.0,119.0,2,270,0.0,135.0,135.0
10446620.0,6,6,412,3,206,5153376.0,74.0,68.66666666666667,3,206,5153268.5,74.0,68.66666666666667
133881.0,6,2,132,1,66,0.0,66.0,66.0,1,66,0.0,66.0,66.0
125696.0,6,13,1394,7,797,20949.33333333333,253.0,113.85714285714286,6,597,23370.4,259.0,99.5
143950.0,17,2,180,1,90,0.0,90.0,90.0,1,90,0.0,90.0,90.0
10505854.0,6,7,478,4,272,3456311.333333333,74.0,68.0,3,206,5184369.0,74.0,68.66666666666667
114383812.0,6,251,28984,126,8612,915070.496,140.0,68.34920634920636,125,20372,915313.629032258,284.0,162.976
54693.0,6,14,4740,7,653,8141.166666666667,249.0,93.28571428571428,7,4087,7146.0,1514.0,583.8571428571429
845902.0,6,9,1096,6,625,169180.4,287.0,104.16666666666669,3,471,286726.0,331.0,157.0
13172.0,6,11,2098,6,590,2409.4,252.0,98.33333333333331,5,1508,2945.5,1236.0,301.6
118687334.0,6,33,2274,17,1125,7417958.375,123.0,66.17647058823529,16,1149,7232417.666666667,123.0,71.8125
102442377.0,6,30,2106,15,1089,7302705.0,123.0,72.6,15,1017,7302703.642857143,123.0,67.8
90264334.0,6,12,1832,8,1016,12894904.857142856,188.0,127.0,4,816,30030366.666666668,204.0,204.0
158852.0,6,3,337,2,214,0.0,160.0,107.0,1,123,0.0,123.0,123.0
120086483.0,17,29,13785,29,13785,4288802.964285715,501.0,475.3448275862069,0,0,0.0,0.0,0.0
302475.0,6,6,412,4,272,100825.0,74.0,68.0,2,140,0.0,74.0,70.0
5009907.0,17,4,376,2,152,0.0,76.0,76.0,2,224,0.0,148.0,112.0
232389.0,6,3,337,2,214,0.0,160.0,107.0,1,123,0.0,123.0,123.0
241932.0,6,3,337,2,214,0.0,160.0,107.0,1,123,0.0,123.0,123.0
33218.0,6,11,2098,6,590,6518.4,252.0,98.33333333333331,5,1508,7929.75,1236.0,301.6
44576.0,6,14,4740,7,653,7246.333333333333,249.0,93.28571428571428,7,4087,7186.833333333333,1514.0,583.8571428571429
2119.0,17,4,344,2,150,0.0,75.0,75.0,2,194,0.0,103.0,97.0
111002090.0,17,13,821,7,432,18500348.33333333,174.0,61.71428571428572,6,389,18200183.0,174.0,64.83333333333333
543891.0,6,15,4811,7,742,90528.0,230.0,106.0,8,4069,76911.42857142855,1514.0,508.625
92531548.0,6,34,2890,19,1597,5140641.555555556,139.0,84.05263157894737,15,1293,6593854.785714285,123.0,86.2
153402.0,17,2,180,1,90,0.0,90.0,90.0,1,90,0.0,90.0,90.0
5623163.0,6,4,270,2,134,0.0,68.0,67.0,2,136,0.0,70.0,68.0
66132.0,6,14,4740,7,653,10784.666666666666,249.0,93.28571428571428,7,4087,10319.333333333334,1514.0,583.8571428571429
104691.0,17,2,700,2,700,0.0,350.0,350.0,0,0,0.0,0.0,0.0
4524.0,17,2,180,1,90,0.0,90.0,90.0,1,90,0.0,90.0,90.0
11021.0,6,10,2032,5,524,2385.5,252.0,104.8,5,1508,2489.25,1236.0,301.6
1169726.0,6,13,3003,8,2375,167103.7142857143,1514.0,296.875,5,628,223469.5,331.0,125.6
232189.0,6,3,337,2,214,0.0,160.0,107.0,1,123,0.0,123.0,123.0
103262.0,17,2,286,2,286,0.0,143.0,143.0,0,0,0.0,0.0,0.0
206048.0,6,3,426,2,280,0.0,214.0,140.0,1,146,0.0,146.0,146.0
119849318.0,6,13,1898,9,1082,14981164.75,188.0,120.22222222222224,4,816,30021080.33333333,204.0,204.0
722.0,17,4,438,2,148,0.0,74.0,74.0,2,290,0.0,147.0,145.0
0.0,6,1,66,1,66,0.0,66.0,66.0,0,0,0.0,0.0,0.0
120055701.0,17,29,13785,29,13785,4287703.607142857,501.0,475.3448275862069,0,0,0.0,0.0,0.0
300437.0,6,10,1221,6,636,60087.4,298.0,106.0,4,585,94550.33333333331,379.0,146.25
90018108.0,17,28,13364,28,13364,3334004.0,501.0,477.2857142857143,0,0,0.0,0.0,0.0
0.0,6,1,54,1,54,0.0,54.0,54.0,0,0,0.0,0.0,0.0
210084.0,6,3,426,2,280,0.0,214.0,140.0,1,146,0.0,146.0,146.0
22041.0,6,10,1065,5,534,4796.25,262.0,106.8,5,531,5160.5,259.0,106.2
16121.0,6,10,2032,5,524,3237.5,252.0,104.8,5,1508,3707.0,1236.0,301.6
1682389.0,17,2,876,2,876,0.0,438.0,438.0,0,0,0.0,0.0,0.0
300779.0,6,6,412,4,272,100259.66666666669,74.0,68.0,2,140,0.0,74.0,70.0
107161.0,17,2,286,2,286,0.0,143.0,143.0,0,0,0.0,0.0,0.0
90297773.0,6,19,1436,10,745,10028643.222222222,95.0,74.5,9,691,11285563.75,95.0,76.77777777777777
105137498.0,6,44,2904,22,1452,5006547.523809524,66.0,66.0,22,1452,4993416.666666667,66.0,66.0
209550.0,6,10,1221,6,636,41910.0,298.0,106.0,4,585,68650.66666666667,379.0,146.25
31308.000000000004,6,14,4740,7,653,5043.166666666667,249.0,93.28571428571428,7,4087,5055.666666666667,1514.0,583.8571428571429
90030707.0,17,28,13364,28,13364,3334470.6296296297,501.0,477.2857142857143,0,0,0.0,0.0,0.0
90010746.0,17,28,13364,28,13364,3333731.333333333,501.0,477.2857142857143,0,0,0.0,0.0,0.0
32948.0,6,10,2032,5,524,6748.0,252.0,104.8,5,1508,7731.25,1236.0,301.6
303.0,17,2,174,1,79,0.0,79.0,79.0,1,95,0.0,95.0,95.0
314160.0,17,4,1400,4,1400,104720.0,350.0,350.0,0,0,0.0,0.0,0.0
90040859.0,17,28,13364,28,13364,3334846.6296296297,501.0,477.2857142857143,0,0,0.0,0.0,0.0
27268.0,6,14,4740,7,653,4337.833333333333,249.0,93.28571428571428,7,4087,4097.5,1514.0,583.8571428571429
2383.0,17,4,344,2,150,0.0,75.0,75.0,2,194,0.0,103.0,97.0
2425.0,17,4,344,2,150,0.0,75.0,75.0,2,194,0.0,103.0,97.0
277081.0,6,12,1373,7,714,46180.16666666666,298.0,102.0,5,659,65043.25,379.0,131.8
29069.0,6,10,2032,5,524,7059.5,252.0,104.8,5,1508,6115.5,1236.0,301.6
7150.0,17,2,582,1,83,0.0,83.0,83.0,1,499,0.0,499.0,499.0
1276637.0,6,20,6916,11,3099,127663.7,1514.0,281.72727272727275,9,3817,131944.625,1514.0,424.1111111111111
120199209.0,6,24,1829,11,881,11998281.0,95.0,80.0909090909091,13,948,9998571.833333334,95.0,72.92307692307692
2589896.0,6,2,132,1,66,0.0,66.0,66.0,1,66,0.0,66.0,66.0
90260698.0,6,12,1832,8,1016,12894385.42857143,188.0,127.0,4,816,30031832.666666668,204.0,204.0
119174412.0,6,246,28416,123,8340,970107.1803278688,140.0,67.8048780487805,123,20076,970063.6147540984,374.0,163.21951219512195
13610.0,6,11,1133,6,602,2517.0,264.0,100.33333333333331,5,531,2360.5,259.0,106.2
26334.0,6,10,2032,5,524,6296.25,252.0,104.8,5,1508,6086.0,1236.0,301.6
19817.0,6,14,4740,7,653,3196.0,249.0,93.28571428571428,7,4087,3138.0,1514.0,583.8571428571429
103057.0,17,2,286,2,286,0.0,143.0,143.0,0,0,0.0,0.0,0.0
22187.0,6,14,4740,7,653,3586.833333333333,249.0,93.28571428571428,7,4087,3551.1666666666665,1514.0,583.8571428571429
305.0,17,2,156,1,78,0.0,78.0,78.0,1,78,0.0,78.0,78.0
120293427.0,6,254,28838,127,8678,948251.7222222222,140.0,68.33070866141732,127,20160,948137.6349206348,374.0,158.74015748031496
115811423.0,6,48,3168,24,1584,5035279.260869565,66.0,66.0,24,1584,5023308.782608695,66.0,66.0
302.0,17,2,164,1,82,0.0,82.0,82.0,1,82,0.0,82.0,82.0
31651.0,6,10,2032,5,524,6926.75,252.0,104.8,5,1508,5664.5,1236.0,301.6
217885.0,6,3,426,2,280,0.0,214.0,140.0,1,146,0.0,146.0,146.0
99682.0,17,2,762,2,762,0.0,381.0,381.0,0,0,0.0,0.0,0.0
2409376.0,6,3,1604,2,851,0.0,785.0,425.5,1,753,0.0,753.0,753.0
108098100.0,17,5,1005,5,1005,27024525.0,201.0,201.0,0,0,0.0,0.0,0.0
92989958.0,6,28,2168,12,935,8453632.545454545,95.0,77.91666666666667,16,1233,6181945.066666666,95.0,77.0625
10485979.0,6,7,478,4,272,3449900.6666666665,74.0,68.0,3,206,5174721.5,74.0,68.66666666666667
190991.0,17,2,180,1,90,0.0,90.0,90.0,1,90,0.0,90.0,90.0
103612.0,17,2,286,2,286,0.0,143.0,143.0,0,0,0.0,0.0,0.0
14629933.0,6,20,1689,10,1057,1592496.0,315.0,105.7,10,632,1592469.111111111,78.0,63.2
335.0,17,2,166,1,75,0.0,75.0,75.0,1,91,0.0,91.0,91.0
194636.0,17,2,180,1,90,0.0,90.0,90.0,1,90,0.0,90.0,90.0
76132.0,6,14,4740,7,653,12262.666666666666,249.0,93.28571428571428,7,4087,11401.666666666666,1514.0,583.8571428571429
203502.0,6,13,1394,7,797,33917.0,253.0,113.85714285714286,6,597,27165.8,259.0,99.5
66579.0,6,14,4740,7,653,10499.333333333334,249.0,93.28571428571428,7,4087,10442.166666666666,1514.0,583.8571428571429
135132126.0,17,6,1146,6,1146,27026425.2,191.0,191.0,0,0,0.0,0.0,0.0
6475.0,17,2,447,1,84,0.0,84.0,84.0,1,363,0.0,363.0,363.0
113779068.0,6,48,3168,24,1584,4946916.0,66.0,66.0,24,1584,4934942.173913044,66.0,66.0
90019727.0,17,28,13364,28,13364,3334063.962962963,501.0,477.2857142857143,0,0,0.0,0.0,0.0
101119.0,17,2,286,2,286,0.0,143.0,143.0,0,0,0.0,0.0,0.0
90284825.0,6,21,1585,11,840,9023193.7,95.0,76.36363636363636,10,745,10001899.888888888,95.0,74.5
204147.0,17,2,762,2,762,0.0,381.0,381.0,0,0,0.0,0.0,0.0
21632332.0,6,9,589,5,342,5408083.0,95.0,68.4,4,247,7123459.666666667,85.0,61.75
1975.0,17,4,344,2,150,0.0,75.0,75.0,2,194,0.0,103.0,97.0
120033193.0,17,28,13364,28,13364,4445673.814814814,501.0,477.2857142857143,0,0,0.0,0.0,0.0
70673336.0,17,15,6795,15,6795,5048095.428571428,453.0,453.0,0,0,0.0,0.0,0.0
34856.0,6,4,301,2,169,0.0,103.0,84.5,2,132,0.0,66.0,66.0
454071.0,6,10,1221,6,636,90814.2,298.0,106.0,4,585,145473.66666666666,379.0,146.25
57349.0,6,14,4740,7,653,9353.166666666666,249.0,93.28571428571428,7,4087,8761.0,1514.0,583.8571428571429
143899.0,17,2,180,1,90,0.0,90.0,90.0,1,90,0.0,90.0,90.0
206041.0,17,2,180,1,90,0.0,90.0,90.0,1,90,0.0,90.0,90.0
100307530.0,17,12,778,6,389,19927831.6,174.0,64.83333333333333,6,389,20029303.6,174.0,64.83333333333333
108100748.0,17,5,1005,5,1005,27025187.0,201.0,201.0,0,0,0.0,0.0,0.0
14635753.0,6,20,1607,10,975,1592988.6666666667,315.0,97.5,10,632,1592958.6666666667,78.0,63.2
431614.0,6,4,508,2,238,0.0,172.0,119.0,2,270,0.0,135.0,135.0
108106952.0,17,5,1005,5,1005,27026738.0,201.0,201.0,0,0,0.0,0.0,0.0
24240.0,6,10,2032,5,524,5843.25,252.0,104.8,5,1508,5748.5,1236.0,301.6
3243389.0,6,3,1604,1,753,0.0,753.0,753.0,2,851,0.0,785.0,425.5
90064441.0,17,28,13364,28,13364,3335720.037037037,501.0,477.2857142857143,0,0,0.0,0.0,0.0
105936.0,17,2,286,2,286,0.0,143.0,143.0,0,0,0.0,0.0,0.0
37694.0,6,14,4740,7,653,6157.666666666667,249.0,93.28571428571428,7,4087,5842.0,1514.0,583.8571428571429
134274.0,6,2,132,1,66,0.0,66.0,66.0,1,66,0.0,66.0,66.0
51500.0,6,10,2032,5,524,12230.5,252.0,104.8,5,1508,11694.5,1236.0,301.6
27164152.0,17,5,1710,5,1710,6791038.0,342.0,342.0,0,0,0.0,0.0,0.0
2312.0,17,4,344,2,150,0.0,75.0,75.0,2,194,0.0,103.0,97.0
228434.0,17,2,180,1,90,0.0,90.0,90.0,1,90,0.0,90.0,90.0
924.0,17,2,762,2,762,0.0,381.0,381.0,0,0,0.0,0.0,0.0
122265.0,6,3,373,2,238,0.0,172.0,119.0,1,135,0.0,135.0,135.0
10455819.0,6,7,478,4,272,3438392.6666666665,74.0,68.0,3,206,5157496.5,74.0,68.66666666666667
160240.0,17,2,180,1,90,0.0,90.0,90.0,1,90,0.0,90.0,90.0
14629940.0,6,20,1607,10,975,1592051.7777777778,315.0,97.5,10,632,1592019.3333333333,78.0,63.2
100760916.0,6,28,1860,14,966,7734225.0,123.0,69.0,14,894,7734229.769230769,123.0,63.85714285714285
90534007.0,6,14,2240,8,1016,12933429.57142857,188.0,127.0,6,1224,18072961.6,204.0,204.0
4994871.0,17,4,376,2,152,0.0,76.0,76.0,2,224,0.0,148.0,112.0
90253449.0,6,14,2240,8,1016,12893349.857142856,188.0,127.0,6,1224,18018162.0,204.0,204.0
46496.0,6,10,2032,5,524,10676.25,252.0,104.8,5,1508,11104.5,1236.0,301.6
103485.0,17,2,286,2,286,0.0,143.0,143.0,0,0,0.0,0.0,0.0
448.0,17,2,267,1,83,0.0,83.0,83.0,1,184,0.0,184.0,184.0
19997.0,6,14,4740,7,653,3222.6666666666665,249.0,93.28571428571428,7,4087,3195.0,1514.0,583.8571428571429
136412209.0,17,26,6233,15,4881,9743729.214285716,1214.0,325.4,11,1352,11749778.2,522.0,122.9090909090909
274702.0,17,2,180,1,90,0.0,90.0,90.0,1,90,0.0,90.0,90.0
123305622.0,6,48,3168,24,1584,5132001.521739131,66.0,66.0,24,1584,5164750.956521739,66.0,66.0
90366351.0,6,13,2052,6,1224,18073047.0,204.0,204.0,7,828,15015986.0,188.0,118.28571428571428
107272895.0,6,30,2122,15,1105,7662349.642857143,139.0,73.66666666666667,15,1017,7646877.0,123.0,67.8
1776407.0,6,2,132,1,66,0.0,66.0,66.0,1,66,0.0,66.0,66.0
120343783.0,6,225,25484,113,17870,1074498.0625,284.0,158.141592920354,112,7614,1075993.4144144144,140.0,67.98214285714286
104503522.0,17,14,1126,7,563,17333495.666666668,174.0,80.42857142857143,7,563,17334883.666666668,174.0,80.42857142857143
305401.0,6,6,412,4,272,101800.33333333331,74.0,68.0,2,140,0.0,74.0,70.0
126023327.0,17,15,907,7,432,17833482.333333332,174.0,61.71428571428572,8,475,18001197.85714286,174.0,59.375
5052.0,17,4,344,2,150,0.0,75.0,75.0,2,194,0.0,103.0,97.0
203679.0,17,4,6056,4,6056,67893.0,1514.0,1514.0,0,0,0.0,0.0,0.0
90038320.0,17,28,13364,28,13364,3334752.592592593,501.0,477.2857142857143,0,0,0.0,0.0,0.0
85213.0,6,12,1320,7,789,14202.166666666666,253.0,112.71428571428572,5,531,17974.5,259.0,106.2
208995.0,6,3,426,2,280,0.0,214.0,140.0,1,146,0.0,146.0,146.0
3170513.0,6,18,1495,9,921,358431.875,315.0,102.33333333333331,9,574,358392.125,78.0,63.77777777777778
90041542.0,17,28,13364,28,13364,3334871.925925926,501.0,477.2857142857143,0,0,0.0,0.0,0.0
9745.0,17,2,582,1,83,0.0,83.0,83.0,1,499,0.0,499.0,499.0
193217.0,17,2,180,1,90,0.0,90.0,90.0,1,90,0.0,90.0,90.0
41902.0,6,14,4740,7,653,6799.5,249.0,93.28571428571428,7,4087,5698.333333333333,1514.0,583.8571428571429
102951.0,17,2,286,2,286,0.0,143.0,143.0,0,0,0.0,0.0,0.0
108107216.0,17,5,1005,5,1005,27026804.0,201.0,201.0,0,0,0.0,0.0,0.0
304474.0,6,6,412,4,272,101491.33333333331,74.0,68.0,2,140,0.0,74.0,70.0
310.0,17,2,164,1,82,0.0,82.0,82.0,1,82,0.0,82.0,82.0
10454552.0,6,7,478,4,272,3439278.6666666665,74.0,68.0,3,206,5158822.5,74.0,68.66666666666667
93188227.0,17,12,778,6,389,18600194.6,174.0,64.83333333333333,6,389,18601169.0,174.0,64.83333333333333
18334.0,6,10,1065,5,534,4178.75,262.0,106.8,5,531,4245.5,259.0,106.2
205946.0,6,3,426,2,280,0.0,214.0,140.0,1,146,0.0,146.0,146.0
57383.0,6,14,4740,7,653,8666.833333333334,249.0,93.28571428571428,7,4087,9323.0,1514.0,583.8571428571429
5619686.0,6,4,270,2,134,0.0,68.0,67.0,2,136,0.0,70.0,68.0
1292021.0,17,7,490,7,490,215336.8333333333,70.0,70.0,0,0,0.0,0.0,0.0
120000872.0,6,17,1246,9,650,15000109.0,95.0,72.22222222222223,8,596,17106759.57142857,95.0,74.5
90032581.0,17,28,13364,28,13364,3334540.037037037,501.0,477.2857142857143,0,0,0.0,0.0,0.0
108107031.0,17,5,955,5,955,27026757.75,191.0,191.0,0,0,0.0,0.0,0.0
345.0,17,2,267,1,83,0.0,83.0,83.0,1,184,0.0,184.0,184.0
1451.0,17,2,762,2,762,0.0,381.0,381.0,0,0,0.0,0.0,0.0
2322.0,17,4,344,2,150,0.0,75.0,75.0,2,194,0.0,103.0,97.0
309720.0,6,6,412,4,272,103240.0,74.0,68.0,2,140,0.0,74.0,70.0
207571.0,17,2,180,1,90,0.0,90.0,90.0,1,90,0.0,90.0,90.0
34774.0,6,14,4740,7,653,5561.833333333333,249.0,93.28571428571428,7,4087,4631.666666666667,1514.0,583.8571428571429
108177492.0,6,38,2964,20,1578,5693552.210526316,123.0,78.9,18,1386,6350667.235294118,123.0,77.0
120052863.0,17,28,13364,28,13364,4446402.333333333,501.0,477.2857142857143,0,0,0.0,0.0,0.0
91897009.0,17,16,5472,16,5472,6126467.266666667,342.0,342.0,0,0,0.0,0.0,0.0
226422.0,6,3,426,2,280,0.0,214.0,140.0,1,146,0.0,146.0,146.0
990315.0,6,10,1333,6,796,198063.0,458.0,132.66666666666666,4,537,237263.3333333333,331.0,134.25
121372563.0,6,242,28058,121,8294,995965.8,140.0,68.54545454545455,121,19764,1004463.35,374.0,163.3388429752066
68199.0,6,11,2098,6,590,13266.4,252.0,98.33333333333331,5,1508,16544.75,1236.0,301.6
0.0,17,1,381,1,381,0.0,381.0,381.0,0,0,0.0,0.0,0.0
135135745.0,17,6,1206,6,1206,27027149.0,201.0,201.0,0,0,0.0,0.0,0.0
145198.0,17,2,180,1,70,0.0,70.0,70.0,1,110,0.0,110.0,110.0
198547.0,17,2,180,1,90,0.0,90.0,90.0,1,90,0.0,90.0,90.0
55977.0,6,14,4740,7,653,8723.166666666666,249.0,93.28571428571428,7,4087,7913.0,1514.0,583.8571428571429
323002.0,17,4,1400,4,1400,107667.33333333331,350.0,350.0,0,0,0.0,0.0,0.0
5004536.0,17,4,849,2,166,0.0,83.0,83.0,2,683,0.0,499.0,341.5
90297507.0,6,15,1097,8,596,12899643.857142856,95.0,74.5,7,501,14998623.666666666,95.0,71.57142857142857
30919.0,6,14,4740,7,653,4176.0,249.0,93.28571428571428,7,4087,4108.5,1514.0,583.8571428571429
2036.0,17,4,344,2,150,0.0,75.0,75.0,2,194,0.0,103.0,97.0
2391.0,17,4,344,2,150,0.0,75.0,75.0,2,194,0.0,103.0,97.0
10872577.0,6,8,544,4,272,3578570.6666666665,74.0,68.0,4,272,3578497.6666666665,74.0,68.0
220858.0,6,3,426,2,280,0.0,214.0,140.0,1,146,0.0,146.0,146.0
206410.0,6,3,426,2,280,0.0,214.0,140.0,1,146,0.0,146.0,146.0
10467852.0,6,7,499,4,301,3171842.6666666665,103.0,75.25,3,198,4099084.0,66.0,66.0
3006032.0,6,11,2106,6,598,601005.2,252.0,99.66666666666669,5,1508,1830.75,1236.0,301.6
90079367.0,17,27,12943,27,12943,3464591.0384615385,501.0,479.3703703703704,0,0,0.0,0.0,0.0
4328.0,17,2,180,1,90,0.0,90.0,90.0,1,90,0.0,90.0,90.0
45145.0,6,14,4740,7,653,7199.5,249.0,93.28571428571428,7,4087,7319.666666666667,1514.0,583.8571428571429
417.0,17,2,410,1,78,0.0,78.0,78.0,1,332,0.0,332.0,332.0
125969942.0,6,36,2596,18,1248,6822629.235294118,123.0,69.33333333333333,18,1348,6957591.117647059,139.0,74.88888888888889
209654.0,17,2,180,1,90,0.0,90.0,90.0,1,90,0.0,90.0,90.0
406.0,17,2,208,1,72,0.0,72.0,72.0,1,136,0.0,136.0,136.0
148749.0,17,2,414,1,88,0.0,88.0,88.0,1,326,0.0,326.0,326.0
38757.0,6,10,2032,5,524,9395.0,252.0,104.8,5,1508,8990.25,1236.0,301.6
108103754.0,17,5,1005,5,1005,27025938.5,201.0,201.0,0,0,0.0,0.0,0.0
35658.0,6,14,4740,7,653,5820.166666666667,249.0,93.28571428571428,7,4087,5658.833333333333,1514.0,583.8571428571429
102093257.0,6,193,21698,97,6698,1063471.4270833333,140.0,69.05154639175258,96,15000,1063766.0526315789,284.0,156.25
459.0,17,2,508,2,508,0.0,257.0,254.0,0,0,0.0,0.0,0.0
205068.0,17,2,762,2,762,0.0,381.0,381.0,0,0,0.0,0.0,0.0
207305.0,6,3,426,2,280,0.0,214.0,140.0,1,146,0.0,146.0,146.0
46421.0,6,14,4740,7,653,7571.5,249.0,93.28571428571428,7,4087,7385.5,1514.0,583.8571428571429
436.0,17,2,410,1,78,0.0,78.0,78.0,1,332,0.0,332.0,332.0
2342.0,17,4,344,2,150,0.0,75.0,75.0,2,194,0.0,103.0,97.0
153338.0,17,2,180,1,90,0.0,90.0,90.0,1,90,0.0,90.0,90.0
10468945.0,6,7,478,4,272,3444307.333333333,74.0,68.0,3,206,5166339.0,74.0,68.66666666666667
40655.0,6,14,4740,7,653,6652.166666666667,249.0,93.28571428571428,7,4087,6599.666666666667,1514.0,583.8571428571429
19965.0,17,2,582,1,83,0.0,83.0,83.0,1,499,0.0,499.0,499.0
11585.0,6,10,2032,5,524,2431.5,252.0,104.8,5,1508,2233.25,1236.0,301.6
105042399.0,6,201,22602,101,6888,1050423.99,140.0,68.1980198019802,100,15714,1050716.7171717172,284.0,157.14
139211.0,17,4,344,2,150,0.0,75.0,75.0,2,194,0.0,103.0,97.0
135145115.0,17,6,1146,6,1146,27029023.0,191.0,191.0,0,0,0.0,0.0,0.0
5624721.0,6,4,270,2,134,0.0,68.0,67.0,2,136,0.0,70.0,68.0
2392.0,17,4,344,2,150,0.0,75.0,75.0,2,194,0.0,103.0,97.0
2049.0,17,4,344,2,150,0.0,75.0,75.0,2,194,0.0,103.0,97.0
108107315.0,17,5,1005,5,1005,27026828.75,201.0,201.0,0,0,0.0,0.0,0.0
2361.0,17,4,344,2,150,0.0,75.0,75.0,2,194,0.0,103.0,97.0
40130.0,6,14,4740,7,653,6447.5,249.0,93.28571428571428,7,4087,6449.833333333333,1514.0,583.8571428571429
143934.0,17,2,180,1,90,0.0,90.0,90.0,1,90,0.0,90.0,90.0
120118925.0,6,15,2164,9,1204,14994894.25,188.0,133.77777777777777,6,960,18018025.6,204.0,160.0
305.0,17,2,168,1,76,0.0,76.0,76.0,1,92,0.0,92.0,92.0
117533835.0,17,14,864,7,432,19500158.0,174.0,61.71428571428572,7,432,19500967.666666668,174.0,61.71428571428572
217632.0,6,3,426,2,280,0.0,214.0,140.0,1,146,0.0,146.0,146.0
4479.0,17,2,614,1,72,0.0,72.0,72.0,1,542,0.0,542.0,542.0
90256395.0,6,12,1832,8,1016,12893770.714285716,188.0,127.0,4,816,30030849.666666668,204.0,204.0
2520567.0,6,27,7681,14,3735,193889.7692307692,1514.0,266.7857142857143,13,3946,189006.91666666663,1514.0,303.53846153846155
256822.0,6,10,1221,6,636,51364.4,298.0,106.0,4,585,78650.0,379.0,146.25
120115173.0,6,15,2428,9,1204,15014396.625,188.0,133.77777777777777,6,1224,18017049.4,204.0,204.0
135131486.0,17,6,1146,6,1146,27026297.2,191.0,191.0,0,0,0.0,0.0,0.0
113601458.0,6,32,2236,16,1165,7559026.666666667,139.0,72.8125,16,1071,7559026.066666666,123.0,66.9375
117005378.0,17,13,821,7,432,19500896.33333333,174.0,61.71428571428572,6,389,19400153.4,174.0,64.83333333333333
90283021.0,6,17,1287,8,637,12897574.42857143,95.0,79.625,9,650,11249909.375,95.0,72.22222222222223
146188.0,6,3,337,2,214,0.0,160.0,107.0,1,123,0.0,123.0,123.0
119610489.0,6,222,25196,111,17574,1085412.0363636364,374.0,158.32432432432432,111,7622,1085412.5727272728,140.0,68.66666666666667
115754525.0,6,48,3168,24,1584,5032805.434782608,66.0,66.0,24,1584,5019217.913043479,66.0,66.0
150302.0,17,2,180,1,70,0.0,70.0,70.0,1,110,0.0,110.0,110.0
52249.0,6,14,4740,7,653,8587.0,249.0,93.28571428571428,7,4087,7269.0,1514.0,583.8571428571429
308240.0,17,4,622,4,622,102746.66666666669,163.0,155.5,0,0,0.0,0.0,0.0
2072.0,17,4,344,2,150,0.0,75.0,75.0,2,194,0.0,103.0,97.0
90263329.0,6,12,1832,8,1016,12894761.285714284,188.0,127.0,4,816,30033243.0,204.0,204.0
1053249.0,6,13,1386,7,789,175541.5,253.0,112.71428571428572,6,597,207639.2,259.0,99.5
26195.0,6,14,4740,7,653,4192.666666666667,249.0,93.28571428571428,7,4087,4005.8333333333335,1514.0,583.8571428571429
0.0,6,1,66,1,66,0.0,66.0,66.0,0,0,0.0,0.0,0.0
300474.0,6,6,412,4,272,100158.0,74.0,68.0,2,140,0.0,74.0,70.0
43512194.0,6,8,1940,3,887,20507996.0,753.0,295.6666666666667,5,1053,10237068.25,785.0,210.6
90048327.0,17,28,13364,28,13364,3335123.222222222,501.0,477.2857142857143,0,0,0.0,0.0,0.0
327.0,17,2,208,1,72,0.0,72.0,72.0,1,136,0.0,136.0,136.0
313530.0,17,4,1400,4,1400,104510.0,350.0,350.0,0,0,0.0,0.0,0.0
129005873.0,17,15,907,8,475,18429410.42857143,174.0,59.375,7,432,18166845.166666668,174.0,61.71428571428572
40817.0,6,14,4740,7,653,6674.0,249.0,93.28571428571428,7,4087,6347.833333333333,1514.0,583.8571428571429
4472.0,17,2,614,1,72,0.0,72.0,72.0,1,542,0.0,542.0,542.0
106206.0,17,2,286,2,286,0.0,143.0,143.0,0,0,0.0,0.0,0.0
279442.0,17,4,704,2,148,0.0,74.0,74.0,2,556,0.0,280.0,278.0
23932.0,6,10,2032,5,524,5375.75,252.0,104.8,5,1508,5720.25,1236.0,301.6
51192.0,17,2,180,1,90,0.0,90.0,90.0,1,90,0.0,90.0,90.0
93089443.0,6,40,2640,20,1320,4899444.368421053,66.0,66.0,20,1320,4885107.578947368,66.0,66.0
121500.0,6,3,337,2,214,0.0,160.0,107.0,1,123,0.0,123.0,123.0
211535.0,6,10,1221,6,636,42307.0,298.0,106.0,4,585,69328.33333333333,379.0,146.25
297355.0,6,6,412,4,272,99118.33333333331,74.0,68.0,2,140,0.0,74.0,70.0
119876247.0,6,34,2334,17,1209,7478774.8125,123.0,71.11764705882354,17,1125,7478776.75,123.0,66.17647058823529
153519.0,17,2,180,1,90,0.0,90.0,90.0,1,90,0.0,90.0,90.0
232156.0,6,3,337,2,214,0.0,160.0,107.0,1,123,0.0,123.0,123.0
189766.0,17,2,180,1,90,0.0,90.0,90.0,1,90,0.0,90.0,90.0
233050.0,6,3,337,2,214,0.0,160.0,107.0,1,123,0.0,123.0,123.0
120007621.0,17,28,13364,28,13364,4444726.703703703,501.0,477.2857142857143,0,0,0.0,0.0,0.0
108756926.0,6,32,2236,16,1165,7250461.733333333,139.0,72.8125,16,1071,7236767.0,123.0,66.9375
146203.0,6,3,337,2,214,0.0,160.0,107.0,1,123,0.0,123.0,123.0
228450.0,17,2,180,1,90,0.0,90.0,90.0,1,90,0.0,90.0,90.0
108107772.0,17,5,955,5,955,27026943.0,191.0,191.0,0,0,0.0,0.0,0.0
37092.0,6,14,4740,7,653,5302.333333333333,249.0,93.28571428571428,7,4087,5990.5,1514.0,583.8571428571429
35362.0,6,14,4740,7,653,5766.833333333333,249.0,93.28571428571428,7,4087,5407.833333333333,1514.0,583.8571428571429
313237.0,17,4,1400,4,1400,104412.33333333331,350.0,350.0,0,0,0.0,0.0,0.0
108104483.0,17,5,955,5,955,27026120.75,191.0,191.0,0,0,0.0,0.0,0.0
5627718.0,6,5,336,2,134,0.0,68.0,67.0,3,202,1525985.5,70.0,67.33333333333333
82676.0,6,14,4740,7,653,11155.666666666666,249.0,93.28571428571428,7,4087,13645.0,1514.0,583.8571428571429
3009552.0,6,11,2106,6,598,601708.0,252.0,99.66666666666669,5,1508,2339.5,1236.0,301.6
20875.0,6,20,7606,11,978,2087.5,310.0,88.9090909090909,9,6628,2370.5,1514.0,736.4444444444445
370.0,17,2,762,2,762,0.0,381.0,381.0,0,0,0.0,0.0,0.0
103450.0,17,2,286,2,286,0.0,143.0,143.0,0,0,0.0,0.0,0.0
119495843.0,6,217,24452,109,7490,1106442.990740741,140.0,68.71559633027523,108,16962,1087843.018691589,284.0,157.05555555555554
2085191.0,6,19,6869,11,1567,208519.1,408.0,142.45454545454547,8,5302,235001.14285714287,1514.0,662.75
90060424.0,17,28,13364,28,13364,3335571.25925926,501.0,477.2857142857143,0,0,0.0,0.0,0.0
447.0,17,2,410,1,78,0.0,78.0,78.0,1,332,0.0,332.0,332.0
1391495.0,17,16,1120,16,1120,92766.33333333331,70.0,70.0,0,0,0.0,0.0,0.0
120122517.0,6,15,2428,9,1204,15015314.625,188.0,133.77777777777777,6,1224,18018040.4,204.0,204.0
51610.0,6,10,2032,5,524,12689.0,252.0,104.8,5,1508,11156.5,1236.0,301.6
207314.0,6,3,426,2,280,0.0,214.0,140.0,1,146,0.0,146.0,146.0
119966509.0,17,34,16284,34,16284,3635348.757575758,501.0,478.9411764705882,0,0,0.0,0.0,0.0
42305.0,6,14,4740,7,653,6500.666666666667,249.0,93.28571428571428,7,4087,6706.333333333333,1514.0,583.8571428571429
284837.0,17,2,620,1,75,0.0,75.0,75.0,1,545,0.0,545.0,545.0
149037584.0,6,26,1978,13,989,9938646.083333334,95.0,76.07692307692308,13,989,12418903.75,95.0,76.07692307692308
120095703.0,6,15,2444,8,1016,17133713.714285713,188.0,127.0,7,1428,15013144.0,204.0,204.0
2438.0,17,4,344,2,150,0.0,75.0,75.0,2,194,0.0,103.0,97.0
40613.0,6,14,4740,7,653,6347.666666666667,249.0,93.28571428571428,7,4087,5335.666666666667,1514.0,583.8571428571429
90016836.0,17,27,12943,27,12943,3462186.0,501.0,479.3703703703704,0,0,0.0,0.0,0.0
2376.0,17,4,344,2,150,0.0,75.0,75.0,2,194,0.0,103.0,97.0
102431.0,17,2,286,2,286,0.0,143.0,143.0,0,0,0.0,0.0,0.0
90015203.0,6,15,1097,8,596,12859314.714285716,95.0,74.5,7,501,14952011.5,95.0,71.57142857142857
135976.0,17,4,1400,4,1400,45325.333333333336,350.0,350.0,0,0,0.0,0.0,0.0
53663.0,6,14,4740,7,653,8606.833333333334,249.0,93.28571428571428,7,4087,8237.0,1514.0,583.8571428571429
184712.0,17,2,180,1,90,0.0,90.0,90.0,1,90,0.0,90.0,90.0
205660.0,17,2,180,1,90,0.0,90.0,90.0,1,90,0.0,90.0,90.0
103801.0,17,2,286,2,286,0.0,143.0,143.0,0,0,0.0,0.0,0.0
119608211.0,6,183,20716,92,6368,1314375.945054945,140.0,69.21739130434783,91,14348,1317421.0777777778,284.0,157.67032967032966
108099595.0,6,32,2236,16,1165,7206639.666666667,139.0,72.8125,16,1071,7192210.066666666,123.0,66.9375
90264354.0,6,12,1832,8,1016,12894907.714285716,188.0,127.0,4,816,30033960.0,204.0,204.0
349.0,17,2,160,1,80,0.0,80.0,80.0,1,80,0.0,80.0,80.0
99942435.0,17,12,778,6,389,19928128.4,174.0,64.83333333333333,6,389,19956287.8,174.0,64.83333333333333
179904.0,17,2,180,1,90,0.0,90.0,90.0,1,90,0.0,90.0,90.0
90313745.0,6,16,1192,8,596,12891536.857142856,95.0,74.5,8,596,12900102.857142856,95.0,74.5
1751150.0,6,23,6509,12,1529,159195.45454545456,357.0,127.41666666666669,11,4980,144208.0,1510.0,452.7272727272728
32383.000000000004,6,10,2032,5,524,7552.0,252.0,104.8,5,1508,7707.75,1236.0,301.6
10459197.0,6,7,478,4,272,3441028.0,74.0,68.0,3,206,5161389.0,74.0,68.66666666666667
2079118.0,6,18,6803,10,1501,231013.11111111112,408.0,150.1,8,5302,235141.14285714287,1514.0,662.75
106995646.0,6,43,2838,21,1386,5143991.0,66.0,66.0,22,1452,5095018.714285715,66.0,66.0
206403.0,17,2,180,1,90,0.0,90.0,90.0,1,90,0.0,90.0,90.0
108098211.0,17,5,1005,5,1005,27024552.75,201.0,201.0,0,0,0.0,0.0,0.0
310883.0,17,4,1400,4,1400,103627.66666666669,350.0,350.0,0,0,0.0,0.0,0.0
98898.0,17,2,762,2,762,0.0,381.0,381.0,0,0,0.0,0.0,0.0
2463.0,17,2,762,2,762,0.0,381.0,381.0,0,0,0.0,0.0,0.0
228390.0,17,2,180,1,90,0.0,90.0,90.0,1,90,0.0,90.0,90.0
115501059.0,6,32,2236,16,1165,7686326.266666667,139.0,72.8125,16,1071,7686392.866666666,123.0,66.9375
115366840.0,6,47,3102,24,1584,5015938.304347826,66.0,66.0,23,1518,5143999.227272728,66.0,66.0
120320509.0,6,248,28516,124,8480,971542.2276422764,140.0,68.38709677419355,124,20036,971497.5447154472,284.0,161.5806451612903
27648201.0,17,5,1710,5,1710,6912050.25,342.0,342.0,0,0,0.0,0.0,0.0
43062.0,6,14,4740,7,653,6511.666666666667,249.0,93.28571428571428,7,4087,6772.666666666667,1514.0,583.8571428571429
765.0,17,4,438,2,148,0.0,74.0,74.0,2,290,0.0,147.0,145.0
233967.0,6,12,1373,7,714,38994.5,298.0,102.0,5,659,57846.0,379.0,131.8
856949.0,6,9,1267,6,796,171389.8,458.0,132.66666666666666,3,471,292148.0,331.0,157.0
32526.0,6,10,2032,5,524,7267.75,252.0,104.8,5,1508,7915.5,1236.0,301.6
9440.0,17,2,582,1,83,0.0,83.0,83.0,1,499,0.0,499.0,499.0
90309109.0,6,16,1192,8,596,12894158.142857144,95.0,74.5,8,596,12900636.57142857,95.0,74.5
216322.0,17,2,180,1,90,0.0,90.0,90.0,1,90,0.0,90.0,90.0
2065.0,17,4,344,2,150,0.0,75.0,75.0,2,194,0.0,103.0,97.0
2044616.0,17,6,1039,4,312,681418.6666666666,78.0,78.0,2,727,0.0,395.0,363.5
120122825.0,6,15,2152,9,1204,15015353.125,188.0,133.77777777777777,6,948,18018382.4,204.0,158.0
109556.0,17,2,700,2,700,0.0,350.0,350.0,0,0,0.0,0.0,0.0
653.0,17,2,762,2,762,0.0,381.0,381.0,0,0,0.0,0.0,0.0
298051.0,6,6,412,4,272,99350.33333333331,74.0,68.0,2,140,0.0,74.0,70.0
143957.0,17,2,180,1,90,0.0,90.0,90.0,1,90,0.0,90.0,90.0
6771.0,17,2,582,1,83,0.0,83.0,83.0,1,499,0.0,499.0,499.0
106263961.0,6,28,3052,14,1504,8170717.923076923,427.0,107.42857142857144,14,1548,8173841.538461538,359.0,110.57142857142856
35300.0,6,14,4740,7,653,5602.0,249.0,93.28571428571428,7,4087,5718.666666666667,1514.0,583.8571428571429
46852.0,6,14,4740,7,653,7681.166666666667,249.0,93.28571428571428,7,4087,7669.166666666667,1514.0,583.8571428571429
13928403.0,6,20,1648,10,1016,1514360.4444444445,315.0,101.6,10,632,1514337.0,78.0,63.2
143944.0,17,2,180,1,90,0.0,90.0,90.0,1,90,0.0,90.0,90.0
118033057.0,17,13,952,7,563,19672176.166666668,174.0,80.42857142857143,6,389,19687580.8,174.0,64.83333333333333
280.0,17,2,174,1,79,0.0,79.0,79.0,1,95,0.0,95.0,95.0
113239152.0,6,219,24728,110,7482,1038891.3027522936,140.0,68.01818181818182,109,17246,1038876.7129629628,284.0,158.22018348623854
396.0,17,2,410,1,78,0.0,78.0,78.0,1,332,0.0,332.0,332.0
119603385.0,6,20,1490,10,745,13289265.0,95.0,74.5,10,745,13261248.111111112,95.0,74.5
119371494.0,6,19,1395,10,745,13257790.111111112,95.0,74.5,9,650,14919848.5,95.0,72.22222222222223
108100396.0,17,5,1005,5,1005,27025099.0,201.0,201.0,0,0,0.0,0.0,0.0
103200.0,17,2,286,2,286,0.0,143.0,143.0,0,0,0.0,0.0,0.0
29605.0,6,10,1066,5,490,4244.25,218.0,98.0,5,576,7196.75,304.0,115.2
311471.0,17,4,622,4,622,103823.66666666669,163.0,155.5,0,0,0.0,0.0,0.0
228749.0,17,2,180,1,90,0.0,90.0,90.0,1,90,0.0,90.0,90.0
118909333.0,6,34,2334,17,1209,7431833.3125,123.0,71.11764705882354,17,1125,7418314.5,123.0,66.17647058823529
143883.0,17,2,180,1,90,0.0,90.0,90.0,1,90,0.0,90.0,90.0
2139169.0,6,18,6803,10,1501,237685.44444444444,408.0,150.1,8,5302,243165.7142857143,1514.0,662.75
298872.0,6,6,412,4,272,99624.0,74.0,68.0,2,140,0.0,74.0,70.0
197695.0,17,2,180,1,90,0.0,90.0,90.0,1,90,0.0,90.0,90.0
65843.0,17,2,180,1,90,0.0,90.0,90.0,1,90,0.0,90.0,90.0
135134429.0,17,6,1146,6,1146,27026885.8,191.0,191.0,0,0,0.0,0.0,0.0
120122121.0,6,16,2648,8,1632,17160303.0,204.0,204.0,8,1016,17136207.14285714,188.0,127.0
402664.0,17,2,363,1,75,0.0,75.0,75.0,1,288,0.0,288.0,288.0
50377.0,6,10,2032,5,524,12138.0,252.0,104.8,5,1508,11897.5,1236.0,301.6
14681666.0,6,20,1607,10,975,1595016.6666666667,315.0,97.5,10,632,1595226.5555555555,78.0,63.2
27150.0,6,14,4740,7,653,4384.5,249.0,93.28571428571428,7,4087,3825.6666666666665,1514.0,583.8571428571429
135125142.0,17,6,1146,6,1146,27025028.4,191.0,191.0,0,0,0.0,0.0,0.0
120600474.0,6,34,2472,16,1140,7374335.666666667,123.0,71.25,18,1332,6506779.705882353,123.0,74.0
90252400.0,6,12,1832,8,1016,12893200.0,188.0,127.0,4,816,30029493.33333333,204.0,204.0
2261.0,17,4,344,2,150,0.0,75.0,75.0,2,194,0.0,103.0,97.0
5624982.0,6,5,336,2,134,0.0,68.0,67.0,3,202,1525485.0,70.0,67.33333333333333
33874.0,6,10,2032,5,524,8030.0,252.0,104.8,5,1508,7859.25,1236.0,301.6
169277.0,17,4,1524,4,1524,56425.66666666666,381.0,381.0,0,0,0.0,0.0,0.0
302194.0,6,6,412,4,272,100731.33333333331,74.0,68.0,2,140,0.0,74.0,70.0
143449.0,6,2,132,1,66,0.0,66.0,66.0,1,66,0.0,66.0,66.0
1017746.0,6,11,1134,6,558,203549.2,220.0,93.0,5,576,254034.75,304.0,115.2
120096978.0,6,440,56404,220,41662,547404.5159817352,390.0,189.37272727272727,220,14742,547404.4794520548,140.0,67.00909090909092
34988.0,6,14,4740,7,653,5710.166666666667,249.0,93.28571428571428,7,4087,5458.5,1514.0,583.8571428571429
917087.0,6,10,1336,6,799,183417.4,461.0,133.16666666666666,4,537,213832.3333333333,331.0,134.25
1236092.0,17,7,490,7,490,206015.3333333333,70.0,70.0,0,0,0.0,0.0,0.0
21200.0,6,10,1065,5,534,4262.25,262.0,106.8,5,531,4897.0,259.0,106.2
120123762.0,6,12,1832,8,1016,17137411.85714286,188.0,127.0,4,816,30029906.0,204.0,204.0
119319933.0,6,23,1693,12,894,10847266.636363637,95.0,74.5,11,799,11906078.5,95.0,72.63636363636364
1058857.0,6,11,1134,6,558,211771.4,220.0,93.0,5,576,259882.5,304.0,115.2
108105864.0,17,5,955,5,955,27026466.0,191.0,191.0,0,0,0.0,0.0,0.0
113890505.0,6,32,2220,16,1149,7592700.333333333,123.0,71.8125,16,1071,7578283.466666667,123.0,66.9375
173765.0,17,2,604,1,75,0.0,75.0,75.0,1,529,0.0,529.0,529.0
56803.0,6,14,4740,7,653,9339.0,249.0,93.28571428571428,7,4087,8949.666666666666,1514.0,583.8571428571429
68601.0,6,10,2032,5,524,14992.25,252.0,104.8,5,1508,16344.5,1236.0,301.6
14559.0,6,12,1393,6,796,2780.0,271.0,132.66666666666666,6,597,2726.8,259.0,99.5
120123642.0,6,14,2224,9,1204,15015455.25,188.0,133.77777777777777,5,1020,22523024.75,204.0,204.0
90006465.0,17,28,13364,28,13364,3333572.777777778,501.0,477.2857142857143,0,0,0.0,0.0,0.0
102240244.0,6,42,2772,21,1386,5111998.95,66.0,66.0,21,1386,5111998.35,66.0,66.0
216565.0,6,3,426,2,280,0.0,214.0,140.0,1,146,0.0,146.0,146.0
90017050.0,17,28,13364,28,13364,3333964.814814815,501.0,477.2857142857143,0,0,0.0,0.0,0.0
2315.0,17,4,344,2,150,0.0,75.0,75.0,2,194,0.0,103.0,97.0
502689.00000000006,6,5,336,2,134,0.0,68.0,67.0,3,202,183213.0,70.0,67.33333333333333
312161.0,17,4,1400,4,1400,104053.66666666669,350.0,350.0,0,0,0.0,0.0,0.0
104796086.0,17,15,5130,15,5130,7485434.714285715,342.0,342.0,0,0,0.0,0.0,0.0
25926.0,6,14,4740,7,653,4124.666666666667,249.0,93.28571428571428,7,4087,4183.5,1514.0,583.8571428571429
335.0,17,2,166,1,75,0.0,75.0,75.0,1,91,0.0,91.0,91.0
914032.0,6,10,1335,6,798,182806.4,460.0,133.0,4,537,212806.66666666663,331.0,134.25
41772.0,6,14,4740,7,653,6502.833333333333,249.0,93.28571428571428,7,4087,6490.166666666667,1514.0,583.8571428571429
47187.0,6,14,4740,7,653,7651.833333333333,249.0,93.28571428571428,7,4087,7620.5,1514.0,583.8571428571429
206888.0,6,3,426,2,280,0.0,214.0,140.0,1,146,0.0,146.0,146.0
108179.0,17,2,286,2,286,0.0,143.0,143.0,0,0,0.0,0.0,0.0
101855.0,17,2,762,2,762,0.0,381.0,381.0,0,0,0.0,0.0,0.0
1305618.0,6,4,264,2,132,0.0,66.0,66.0,2,132,0.0,66.0,66.0
90210155.0,6,20,1531,9,691,11246235.25,95.0,76.77777777777777,11,840,9000386.7,95.0,76.36363636363636
120386185.0,6,229,25848,115,18102,1056019.1666666667,300.0,157.40869565217392,114,7746,1056184.0796460176,140.0,67.94736842105263
128810454.0,6,36,2596,18,1248,6989678.823529412,123.0,69.33333333333333,18,1348,6989670.176470588,139.0,74.88888888888889
27350851.0,17,5,1710,5,1710,6837712.75,342.0,342.0,0,0,0.0,0.0,0.0
16076.0,6,14,4740,7,653,2108.833333333333,249.0,93.28571428571428,7,4087,2475.0,1514.0,583.8571428571429
90303798.0,6,19,1760,10,1110,10029117.888888888,257.0,111.0,9,650,11287475.0,95.0,72.22222222222223
3959.0,17,2,582,1,83,0.0,83.0,83.0,1,499,0.0,499.0,499.0
29382.0,6,14,4740,7,653,4588.5,249.0,93.28571428571428,7,4087,3347.6666666666665,1514.0,583.8571428571429
110690222.0,6,33,2412,17,1272,6904637.3125,123.0,74.82352941176471,16,1140,7364947.6,123.0,71.25
108103542.0,17,5,1005,5,1005,27025885.5,201.0,201.0,0,0,0.0,0.0,0.0
314590.0,17,4,1400,4,1400,104863.33333333331,350.0,350.0,0,0,0.0,0.0,0.0
37018.0,6,14,4740,7,653,5378.166666666667,249.0,93.28571428571428,7,4087,5963.166666666667,1514.0,583.8571428571429
6670772.0,6,5,1736,3,917,3266208.0,785.0,305.6666666666667,2,819,0.0,753.0,409.5
23961.0,6,14,4740,7,653,3802.8333333333335,249.0,93.28571428571428,7,4087,3480.333333333333,1514.0,583.8571428571429
33232.0,6,10,2032,5,524,7947.5,252.0,104.8,5,1508,7683.25,1236.0,301.6
2051.0,17,4,344,2,150,0.0,75.0,75.0,2,194,0.0,103.0,97.0
89344.0,6,10,2032,5,524,22107.5,252.0,104.8,5,1508,20193.0,1236.0,301.6
110151817.0,6,27,1822,14,982,8456684.538461538,139.0,70.14285714285714,13,840,9158536.583333334,123.0,64.61538461538461
61116.0,6,14,4740,7,653,9601.166666666666,249.0,93.28571428571428,7,4087,9743.5,1514.0,583.8571428571429
427.0,17,2,166,1,75,0.0,75.0,75.0,1,91,0.0,91.0,91.0
34134.0,6,14,4740,7,653,5579.0,249.0,93.28571428571428,7,4087,4259.166666666667,1514.0,583.8571428571429
32796.0,6,10,2032,5,524,6453.75,252.0,104.8,5,1508,7569.75,1236.0,301.6
20682.0,17,2,582,1,83,0.0,83.0,83.0,1,499,0.0,499.0,499.0
135129581.0,17,6,1146,6,1146,27025916.2,191.0,191.0,0,0,0.0,0.0,0.0
10456890.0,6,7,478,4,272,3440329.6666666665,74.0,68.0,3,206,5160404.0,74.0,68.66666666666667
121007241.0,17,15,907,8,475,17286748.714285713,174.0,59.375,7,432,16833522.5,174.0,61.71428571428572
33665.0,6,2,145,2,145,0.0,91.0,72.5,0,0,0.0,0.0,0.0
90051217.0,17,28,13364,28,13364,3335230.25925926,501.0,477.2857142857143,0,0,0.0,0.0,0.0
1983.0,17,4,344,2,150,0.0,75.0,75.0,2,194,0.0,103.0,97.0
308576.0,6,6,412,4,272,102858.66666666669,74.0,68.0,2,140,0.0,74.0,70.0
328.0,17,2,174,1,79,0.0,79.0,79.0,1,95,0.0,95.0,95.0
51562.0,6,10,2032,5,524,12571.25,252.0,104.8,5,1508,9147.75,1236.0,301.6
121492.0,6,4,439,2,238,0.0,172.0,119.0,2,201,0.0,135.0,100.5
135139687.0,17,6,1146,6,1146,27027937.4,191.0,191.0,0,0,0.0,0.0,0.0
1827813.0,6,40,23944,21,1535,91390.65,207.0,73.0952380952381,19,22409,101242.55555555556,1514.0,1179.421052631579
1085095.0,6,13,1386,7,789,180849.16666666663,253.0,112.71428571428572,6,597,216321.0,259.0,99.5
813.0,17,2,762,2,762,0.0,381.0,381.0,0,0,0.0,0.0,0.0
0.0,17,1,55,1,55,0.0,55.0,55.0,0,0,0.0,0.0,0.0
120124681.0,6,15,2428,9,1204,15015585.125,188.0,133.77777777777777,6,1224,18074101.6,204.0,204.0
90049949.0,17,28,13364,28,13364,3335183.296296296,501.0,477.2857142857143,0,0,0.0,0.0,0.0
2304.0,17,4,344,2,150,0.0,75.0,75.0,2,194,0.0,103.0,97.0
823727.0,6,12,1354,6,723,159428.2,253.0,120.5,6,631,164005.2,293.0,105.16666666666669
31875981.0,6,31,9412,17,3897,159413.8125,1514.0,229.23529411764707,14,5515,2435423.923076923,1514.0,393.9285714285714
306025.0,6,6,412,4,272,102008.33333333331,74.0,68.0,2,140,0.0,74.0,70.0
90020795.0,17,28,13364,28,13364,3334103.5185185187,501.0,477.2857142857143,0,0,0.0,0.0,0.0
2066073.0,6,18,6803,10,1501,229563.66666666663,408.0,150.1,8,5302,232825.7142857143,1514.0,662.75
33502201.0,6,5,336,2,134,0.0,68.0,67.0,3,202,15456222.0,70.0,67.33333333333333
104090.0,17,2,700,2,700,0.0,350.0,350.0,0,0,0.0,0.0,0.0
90529198.0,6,13,2036,8,1016,12932742.57142857,188.0,127.0,5,1020,22591866.75,204.0,204.0
90023314.0,17,28,13364,28,13364,3334196.814814815,501.0,477.2857142857143,0,0,0.0,0.0,0.0
2292.0,17,4,344,2,150,0.0,75.0,75.0,2,194,0.0,103.0,97.0
100735308.0,17,13,821,7,432,16667726.5,174.0,61.71428571428572,6,389,20000153.8,174.0,64.83333333333333
197269.0,17,2,180,1,90,0.0,90.0,90.0,1,90,0.0,90.0,90.0
91273.0,6,14,4740,7,653,15079.5,249.0,93.28571428571428,7,4087,14372.833333333334,1514.0,583.8571428571429
103322.0,17,2,286,2,286,0.0,143.0,143.0,0,0,0.0,0.0,0.0
0.0,17,1,381,1,381,0.0,381.0,381.0,0,0,0.0,0.0,0.0
2030213.0,6,24,6999,13,2047,169184.41666666666,575.0,157.46153846153845,11,4952,171710.2,1510.0,450.1818181818182
113288.0,6,14,4740,7,653,15885.833333333334,249.0,93.28571428571428,7,4087,18707.166666666668,1514.0,583.8571428571429
90301205.0,6,19,1436,10,745,10027828.444444444,95.0,74.5,9,691,11287059.5,95.0,76.77777777777777
206005.0,17,2,180,1,90,0.0,90.0,90.0,1,90,0.0,90.0,90.0
97099303.0,6,198,22330,99,15574,988613.6428571428,284.0,157.31313131313132,99,6756,988614.1020408164,140.0,68.24242424242425
1047.0,17,2,508,2,508,0.0,257.0,254.0,0,0,0.0,0.0,0.0
1183350.0,6,13,3010,8,2382,169050.0,1514.0,297.75,5,628,226923.5,331.0,125.6
90053007.0,17,28,13364,28,13364,3335296.5555555555,501.0,477.2857142857143,0,0,0.0,0.0,0.0
177975.0,6,12,1354,6,723,33737.0,253.0,120.5,6,631,34346.8,293.0,105.16666666666669
108104360.0,17,5,1005,5,1005,27026090.0,201.0,201.0,0,0,0.0,0.0,0.0
1016148.0,6,11,1134,6,558,203229.6,220.0,93.0,5,576,253662.5,304.0,115.2
2422372.0,6,3,1604,2,851,0.0,785.0,425.5,1,753,0.0,753.0,753.0
228218.0,17,2,180,1,90,0.0,90.0,90.0,1,90,0.0,90.0,90.0
0.0,17,1,55,1,55,0.0,55.0,55.0,0,0,0.0,0.0,0.0
146130.0,6,3,337,2,214,0.0,160.0,107.0,1,123,0.0,123.0,123.0
2343.0,17,4,344,2,150,0.0,75.0,75.0,2,194,0.0,103.0,97.0
90257811.0,6,12,1832,8,1016,12893973.0,188.0,127.0,4,816,30030982.0,204.0,204.0
5005346.0,17,2,168,2,168,0.0,84.0,84.0,0,0,0.0,0.0,0.0
12556.0,17,4,344,2,150,0.0,75.0,75.0,2,194,0.0,103.0,97.0
383.0,17,2,267,1,83,0.0,83.0,83.0,1,184,0.0,184.0,184.0
108107071.0,17,5,955,5,955,27026767.75,191.0,191.0,0,0,0.0,0.0,0.0
3002109.0,6,12,2172,7,664,500130.1666666667,252.0,94.85714285714286,5,1508,1822.75,1236.0,301.6
162707.0,6,3,337,2,214,0.0,160.0,107.0,1,123,0.0,123.0,123.0
151030.0,6,3,337,2,214,0.0,160.0,107.0,1,123,0.0,123.0,123.0
143890.0,17,2,180,1,90,0.0,90.0,90.0,1,90,0.0,90.0,90.0
120288687.0,6,17,1287,9,691,15036085.875,95.0,76.77777777777777,8,596,17105849.14285714,95.0,74.5
90030308.0,17,28,13364,28,13364,3334455.851851852,501.0,477.2857142857143,0,0,0.0,0.0,0.0
320674.0,17,4,1400,4,1400,106891.33333333331,350.0,350.0,0,0,0.0,0.0,0.0
1994960.0,6,20,7599,11,1469,199496.0,583.0,133.54545454545453,9,6130,217823.75,1484.0,681.1111111111111
380.0,17,2,300,1,80,0.0,80.0,80.0,1,220,0.0,220.0,220.0
105833185.0,6,28,1860,14,966,8124399.461538462,123.0,69.0,14,894,8124411.615384615,123.0,63.85714285714285
323754.0,17,4,1400,4,1400,107918.0,350.0,350.0,0,0,0.0,0.0,0.0
243014.0,6,3,337,2,214,0.0,160.0,107.0,1,123,0.0,123.0,123.0
90050367.0,17,27,12943,27,12943,3463475.653846154,501.0,479.3703703703704,0,0,0.0,0.0,0.0
29042.0,6,14,4740,7,653,3105.333333333333,249.0,93.28571428571428,7,4087,4701.833333333333,1514.0,583.8571428571429
120124773.0,6,16,2490,10,1392,13347197.0,188.0,139.2,6,1098,18105299.0,204.0,183.0
18055349.0,6,29,9249,16,3843,160753.33333333334,1514.0,240.1875,13,5406,1487551.4166666667,1514.0,415.84615384615387
104044.0,17,2,286,2,286,0.0,143.0,143.0,0,0,0.0,0.0,0.0
111004397.0,17,13,821,7,432,18500732.83333333,174.0,61.71428571428572,6,389,18200152.6,174.0,64.83333333333333
196913.0,17,2,180,1,90,0.0,90.0,90.0,1,90,0.0,90.0,90.0
233734.0,6,3,337,2,214,0.0,160.0,107.0,1,123,0.0,123.0,123.0
15664.0,6,10,1067,5,536,3705.75,264.0,107.2,5,531,3234.5,259.0,106.2
1165499.0,6,13,3010,8,2382,166499.85714285713,1514.0,297.75,5,628,222473.25,331.0,125.6
310107.0,17,4,1400,4,1400,103369.0,350.0,350.0,0,0,0.0,0.0,0.0
114878052.0,6,48,3168,24,1584,4994697.913043479,66.0,66.0,24,1584,4982722.652173913,66.0,66.0
315843.0,17,4,1400,4,1400,105281.0,350.0,350.0,0,0,0.0,0.0,0.0
27559604.0,17,5,1710,5,1710,6889901.0,342.0,342.0,0,0,0.0,0.0,0.0
244103.0,6,3,337,2,214,0.0,160.0,107.0,1,123,0.0,123.0,123.0
90564031.0,6,795,187332,388,26274,234003.31782945737,214.0,67.71649484536083,407,161058,221080.16995073893,1514.0,395.7199017199017
33706863.0,6,5,336,2,134,0.0,68.0,67.0,3,202,15463615.0,70.0,67.33333333333333
10421920.0,6,6,412,3,206,5142989.0,74.0,68.66666666666667,3,206,5142882.5,74.0,68.66666666666667
115378600.0,6,48,3168,24,1584,5016460.869565218,66.0,66.0,24,1584,5004488.521739131,66.0,66.0
16810.0,17,2,180,1,90,0.0,90.0,90.0,1,90,0.0,90.0,90.0
135132620.0,17,6,1146,6,1146,27026524.0,191.0,191.0,0,0,0.0,0.0,0.0
108742.0,17,2,286,2,286,0.0,143.0,143.0,0,0,0.0,0.0,0.0
120199976.0,6,33,2359,16,1071,7500739.133333334,123.0,66.9375,17,1288,7470622.6875,139.0,75.76470588235294
0.0,17,1,90,1,90,0.0,90.0,90.0,0,0,0.0,0.0,0.0
313288.0,17,4,1400,4,1400,104429.33333333331,350.0,350.0,0,0,0.0,0.0,0.0
108105795.0,17,5,955,5,955,27026448.75,191.0,191.0,0,0,0.0,0.0,0.0
196862.0,17,2,180,1,90,0.0,90.0,90.0,1,90,0.0,90.0,90.0
107481.0,17,2,286,2,286,0.0,143.0,143.0,0,0,0.0,0.0,0.0
100489216.0,17,13,821,7,432,16666805.666666666,174.0,61.71428571428572,6,389,20001225.2,174.0,64.83333333333333
1187923.0,6,13,3012,8,2384,169703.2857142857,1514.0,298.0,5,628,228198.5,331.0,125.6
34745172.0,6,5,336,2,134,0.0,68.0,67.0,3,202,16988130.0,70.0,67.33333333333333
148049.0,17,2,180,1,90,0.0,90.0,90.0,1,90,0.0,90.0,90.0
315712.0,17,4,1400,4,1400,105237.33333333331,350.0,350.0,0,0,0.0,0.0,0.0
49527.0,6,14,4740,7,653,7275.5,249.0,93.28571428571428,7,4087,8109.0,1514.0,583.8571428571429
90278370.0,6,12,1832,8,1016,12896910.0,188.0,127.0,4,816,30039248.0,204.0,204.0
2182830.0,6,18,6803,10,1501,242536.66666666663,408.0,150.1,8,5302,253558.7142857143,1514.0,662.75
320292.0,17,4,1400,4,1400,106764.0,350.0,350.0,0,0,0.0,0.0,0.0
4358.0,17,2,614,1,72,0.0,72.0,72.0,1,542,0.0,542.0,542.0
122687975.0,6,49,3234,25,1650,5111998.958333333,66.0,66.0,24,1584,5085451.0869565215,66.0,66.0
39594.0,17,2,700,2,700,0.0,350.0,350.0,0,0,0.0,0.0,0.0
120124067.0,6,15,2428,9,1204,15015508.375,188.0,133.77777777777777,6,1224,18072631.0,204.0,204.0
18554.0,6,14,4740,7,653,2884.833333333333,249.0,93.28571428571428,7,4087,2959.5,1514.0,583.8571428571429
2402.0,17,4,344,2,150,0.0,75.0,75.0,2,194,0.0,103.0,97.0
1947.0,17,2,192,1,88,0.0,88.0,88.0,1,104,0.0,104.0,104.0
205476.0,17,2,762,2,762,0.0,381.0,381.0,0,0,0.0,0.0,0.0
381422.0,17,2,363,1,75,0.0,75.0,75.0,1,288,0.0,288.0,288.0
147918.0,6,3,337,2,214,0.0,160.0,107.0,1,123,0.0,123.0,123.0
196811.0,17,2,180,1,90,0.0,90.0,90.0,1,90,0.0,90.0,90.0
13615582.0,6,19,1594,9,962,1663910.0,315.0,106.88888888888889,10,632,1479009.2222222222,78.0,63.2
837.0,17,5,550,5,550,209.25,110.0,110.0,0,0,0.0,0.0,0.0
13996981.0,17,6,2052,6,2052,2799396.2,342.0,342.0,0,0,0.0,0.0,0.0
179029.0,17,2,614,1,72,0.0,72.0,72.0,1,542,0.0,542.0,542.0
128745150.0,17,16,1212,8,606,15524250.142857144,174.0,75.75,8,606,17843361.285714287,174.0,75.75
217927.0,6,11,1132,6,556,43585.4,218.0,92.66666666666669,5,576,53775.25,304.0,115.2
217821.0,6,10,1221,6,636,43564.2,298.0,106.0,4,585,71649.66666666667,379.0,146.25
45806.0,6,10,2032,5,524,11155.75,252.0,104.8,5,1508,11180.5,1236.0,301.6
135557.0,6,2,132,1,66,0.0,66.0,66.0,1,66,0.0,66.0,66.0
21147.0,6,14,4740,7,653,3376.833333333333,249.0,93.28571428571428,7,4087,3347.5,1514.0,583.8571428571429
115445090.0,6,48,3168,24,1584,5019351.739130435,66.0,66.0,24,1584,5006254.043478261,66.0,66.0
148297.0,6,3,337,2,214,0.0,160.0,107.0,1,123,0.0,123.0,123.0
90533896.0,6,14,2114,6,1098,18106779.2,204.0,183.0,8,1016,12910176.57142857,188.0,127.0
207407.0,6,3,426,2,280,0.0,214.0,140.0,1,146,0.0,146.0,146.0
302706.0,6,7,478,4,272,100902.0,74.0,68.0,3,206,75085.0,74.0,68.66666666666667
99958170.0,6,191,21492,96,6558,1052191.2631578948,140.0,68.3125,95,14934,1042454.1170212766,284.0,157.2
142260.0,17,4,571,2,148,0.0,74.0,74.0,2,423,0.0,280.0,211.5
773.0,17,4,438,2,148,0.0,74.0,74.0,2,290,0.0,147.0,145.0
2390.0,17,4,344,2,150,0.0,75.0,75.0,2,194,0.0,103.0,97.0
324662.0,17,2,180,1,90,0.0,90.0,90.0,1,90,0.0,90.0,90.0
107684.0,17,4,1400,4,1400,35894.666666666664,350.0,350.0,0,0,0.0,0.0,0.0
25254768.0,6,26,7627,14,3735,206971.2307692308,1514.0,266.7857142857143,12,3892,2276304.8181818184,1514.0,324.3333333333333
20506.0,6,2,145,2,145,0.0,91.0,72.5,0,0,0.0,0.0,0.0
241987.0,6,3,337,2,214,0.0,160.0,107.0,1,123,0.0,123.0,123.0
25252.0,6,14,4740,7,653,3036.6666666666665,249.0,93.28571428571428,7,4087,3743.6666666666665,1514.0,583.8571428571429
1304543.0,6,4,264,2,132,0.0,66.0,66.0,2,132,0.0,66.0,66.0
2877890.0,17,3,1026,3,1026,1438945.0,342.0,342.0,0,0,0.0,0.0,0.0
216356.0,17,2,180,1,90,0.0,90.0,90.0,1,90,0.0,90.0,90.0
0.0,17,1,55,1,55,0.0,55.0,55.0,0,0,0.0,0.0,0.0
2381712.0,6,32,10926,18,3951,140100.70588235295,1514.0,219.5,14,6975,162822.46153846153,1514.0,498.2142857142857
14637301.0,6,20,1607,10,975,1592850.4444444445,315.0,97.5,10,632,1592815.6666666667,78.0,63.2
26925.0,6,14,4740,7,653,3692.6666666666665,249.0,93.28571428571428,7,4087,4221.5,1514.0,583.8571428571429
5005459.0,17,4,849,2,166,0.0,83.0,83.0,2,683,0.0,499.0,341.5
134583.0,17,4,1524,4,1524,44861.0,381.0,381.0,0,0,0.0,0.0,0.0
108108473.0,17,5,955,5,955,27027118.25,191.0,191.0,0,0,0.0,0.0,0.0
2419.0,17,4,344,2,150,0.0,75.0,75.0,2,194,0.0,103.0,97.0
140642.0,6,2,132,1,66,0.0,66.0,66.0,1,66,0.0,66.0,66.0
120406743.0,6,209,23724,105,16638,1157757.1442307692,284.0,158.45714285714286,104,7086,1158916.2912621358,140.0,68.13461538461539
146029.0,6,3,337,2,214,0.0,160.0,107.0,1,123,0.0,123.0,123.0
44919.0,6,14,4740,7,653,6096.666666666667,249.0,93.28571428571428,7,4087,7206.166666666667,1514.0,583.8571428571429
120246572.0,6,28,3006,14,1543,9230337.692307692,335.0,110.21428571428572,14,1463,9230766.23076923,425.0,104.5
2597189.0,6,2,132,1,66,0.0,66.0,66.0,1,66,0.0,66.0,66.0
138367.0,6,2,132,1,66,0.0,66.0,66.0,1,66,0.0,66.0,66.0
120214.0,17,2,180,1,70,0.0,70.0,70.0,1,110,0.0,110.0,110.0
52436.0,6,14,4740,7,653,8532.666666666666,249.0,93.28571428571428,7,4087,5972.833333333333,1514.0,583.8571428571429
90218124.0,6,16,1192,8,596,12853615.285714284,95.0,74.5,8,596,12859057.714285716,95.0,74.5
178711.0,6,12,1447,6,816,34420.6,291.0,136.0,6,631,34571.6,293.0,105.16666666666669
250447.0,6,3,337,2,214,0.0,160.0,107.0,1,123,0.0,123.0,123.0
368.0,17,2,267,1,83,0.0,83.0,83.0,1,184,0.0,184.0,184.0
90948922.0,6,21,1585,11,840,9093772.3,95.0,76.36363636363636,10,745,10105001.666666666,95.0,74.5
146749.0,6,4,439,2,238,0.0,172.0,119.0,2,201,0.0,135.0,100.5
10475845.0,6,7,478,4,272,3446715.0,74.0,68.0,3,206,5169938.5,74.0,68.66666666666667
13788088.0,6,264,251783,75,5127,186325.51351351352,211.0,68.36,189,246656,73282.12234042553,1514.0,1305.0582010582011
587282.0,6,3,204,1,68,0.0,68.0,68.0,2,136,0.0,70.0,68.0
211151.0,17,2,180,1,90,0.0,90.0,90.0,1,90,0.0,90.0,90.0
61366.0,6,12,1328,7,797,10227.666666666666,253.0,113.85714285714286,5,531,13726.25,259.0,106.2
2403.0,17,4,344,2,150,0.0,75.0,75.0,2,194,0.0,103.0,97.0
1085253.0,6,13,1386,7,789,180875.5,253.0,112.71428571428572,6,597,216299.6,259.0,99.5
758309.0,6,2,132,1,66,0.0,66.0,66.0,1,66,0.0,66.0,66.0
57387.0,6,14,4740,7,653,9441.333333333334,249.0,93.28571428571428,7,4087,8883.833333333334,1514.0,583.8571428571429
1181559.0,6,13,3010,8,2382,168794.14285714287,1514.0,297.75,5,628,226320.0,331.0,125.6
3362667.0,6,7,923,4,753,1052401.6666666667,571.0,188.25,3,170,1578412.0,62.0,56.66666666666666
117316362.0,6,309,37148,155,10526,761794.5584415584,140.0,67.90967741935484,154,26622,760087.385620915,284.0,172.87012987012986
47982.0,6,14,4740,7,653,7656.0,249.0,93.28571428571428,7,4087,6619.5,1514.0,583.8571428571429
93069028.0,6,251,28618,126,8464,744552.224,140.0,67.17460317460318,125,20154,742236.6612903225,284.0,161.232
5006034.0,17,4,849,2,166,0.0,83.0,83.0,2,683,0.0,499.0,341.5
62022.0,6,14,4740,7,653,10210.166666666666,249.0,93.28571428571428,7,4087,9666.333333333334,1514.0,583.8571428571429
49863.0,6,10,2032,5,524,12221.5,252.0,104.8,5,1508,10682.0,1236.0,301.6
146267.0,6,3,337,2,214,0.0,160.0,107.0,1,123,0.0,123.0,123.0
28755.0,6,14,4740,7,653,4634.166666666667,249.0,93.28571428571428,7,4087,4575.0,1514.0,583.8571428571429
240315.0,6,3,337,2,214,0.0,160.0,107.0,1,123,0.0,123.0,123.0
504423.0,6,5,336,2,134,0.0,68.0,67.0,3,202,198003.0,70.0,67.33333333333333
119435496.0,6,227,25472,114,7820,1056951.2920353983,140.0,68.59649122807018,113,17652,1057263.0892857143,284.0,156.21238938053096
2506.0,17,4,344,2,150,0.0,75.0,75.0,2,194,0.0,103.0,97.0
2882018.0,6,4,270,2,134,0.0,68.0,67.0,2,136,0.0,70.0,68.0
13618100.0,6,19,1553,9,921,1663298.875,315.0,102.33333333333331,10,632,1478462.4444444445,78.0,63.2
2122.0,17,5,550,5,550,530.5,110.0,110.0,0,0,0.0,0.0,0.0
99967778.0,6,211,24702,106,7218,952074.0761904762,140.0,68.09433962264151,105,17484,951368.0769230768,336.0,166.5142857142857
128543031.0,17,14,864,7,432,18172479.0,174.0,61.71428571428572,7,432,18166817.5,174.0,61.71428571428572
238424.0,6,3,337,2,214,0.0,160.0,107.0,1,123,0.0,123.0,123.0
94910614.0,6,184,20850,92,14556,1040719.2857142856,284.0,158.2173913043478,92,6294,1040719.043956044,140.0,68.41304347826087
16821.0,17,2,180,1,90,0.0,90.0,90.0,1,90,0.0,90.0,90.0
234456.0,6,10,1221,6,636,46891.2,298.0,106.0,4,585,77263.0,379.0,146.25
32996.0,6,10,2032,5,524,7967.5,252.0,104.8,5,1508,7285.0,1236.0,301.6
120047997.0,17,28,13364,28,13364,4446222.111111111,501.0,477.2857142857143,0,0,0.0,0.0,0.0
90255291.0,6,14,1964,8,1016,12893613.0,188.0,127.0,6,948,18018200.4,204.0,158.0
207179.0,17,2,762,2,762,0.0,381.0,381.0,0,0,0.0,0.0,0.0
387.0,17,2,762,2,762,0.0,381.0,381.0,0,0,0.0,0.0,0.0
1311342.0,6,4,264,2,132,0.0,66.0,66.0,2,132,0.0,66.0,66.0
1167.0,17,2,3028,2,3028,0.0,1514.0,1514.0,0,0,0.0,0.0,0.0
307967.0,6,6,412,4,272,102655.66666666669,74.0,68.0,2,140,0.0,74.0,70.0
2147.0,17,2,180,1,90,0.0,90.0,90.0,1,90,0.0,90.0,90.0
2270.0,17,4,344,2,150,0.0,75.0,75.0,2,194,0.0,103.0,97.0
2019249.0,17,4,525,2,150,0.0,75.0,75.0,2,375,0.0,284.0,187.5
1975.0,17,2,508,2,508,0.0,257.0,254.0,0,0,0.0,0.0,0.0
51865.0,6,14,4740,7,653,8225.5,249.0,93.28571428571428,7,4087,8500.166666666666,1514.0,583.8571428571429
509971.0,6,5,336,2,134,0.0,68.0,67.0,3,202,194672.5,70.0,67.33333333333333
50896.0,6,12,1393,6,796,8315.0,271.0,132.66666666666666,6,597,9073.8,259.0,99.5
106114138.0,6,43,2838,22,1452,5053042.523809524,66.0,66.0,21,1386,5143996.0,66.0,66.0
314.0,17,2,174,1,79,0.0,79.0,79.0,1,95,0.0,95.0,95.0
34435.0,6,14,4740,7,653,5540.166666666667,249.0,93.28571428571428,7,4087,5001.833333333333,1514.0,583.8571428571429
126906000.0,6,38,2716,20,1468,6679263.157894737,139.0,73.4,18,1248,6865063.235294118,123.0,69.33333333333333
146334.0,6,3,337,2,214,0.0,160.0,107.0,1,123,0.0,123.0,123.0
90258855.0,6,12,1832,8,1016,12894122.142857144,188.0,127.0,4,816,30031984.666666668,204.0,204.0
26588.0,6,10,1067,5,536,6282.5,264.0,107.2,5,531,5122.5,259.0,106.2
9731.0,17,2,571,1,86,0.0,86.0,86.0,1,485,0.0,485.0,485.0
255847.0,6,3,337,2,214,0.0,160.0,107.0,1,123,0.0,123.0,123.0
18179.0,6,14,4740,7,653,2835.333333333333,249.0,93.28571428571428,7,4087,2893.1666666666665,1514.0,583.8571428571429
323777.0,17,4,1400,4,1400,107925.66666666669,350.0,350.0,0,0,0.0,0.0,0.0
90269708.0,6,14,2240,8,1016,12895672.57142857,188.0,127.0,6,1224,18021105.4,204.0,204.0
109219.0,17,2,762,2,762,0.0,381.0,381.0,0,0,0.0,0.0,0.0
415169.0,6,3,1604,2,851,0.0,785.0,425.5,1,753,0.0,753.0,753.0
245785.0,6,3,337,2,214,0.0,160.0,107.0,1,123,0.0,123.0,123.0
320097.0,17,4,1400,4,1400,106699.0,350.0,350.0,0,0,0.0,0.0,0.0
106107.0,17,2,286,2,286,0.0,143.0,143.0,0,0,0.0,0.0,0.0
90214675.0,6,17,1287,8,596,12854068.0,95.0,74.5,9,691,11251117.125,95.0,76.77777777777777
91790496.0,6,163,18490,82,12922,1133216.0,284.0,157.58536585365854,81,5568,1134381.0375,140.0,68.74074074074075
239685.0,6,3,337,2,214,0.0,160.0,107.0,1,123,0.0,123.0,123.0
26405.0,6,10,2032,5,524,6335.0,252.0,104.8,5,1508,6345.0,1236.0,301.6
30972.0,6,14,4740,7,653,5018.0,249.0,93.28571428571428,7,4087,4835.333333333333,1514.0,583.8571428571429
2029.0,17,4,344,2,150,0.0,75.0,75.0,2,194,0.0,103.0,97.0
941.0,17,4,438,2,148,0.0,74.0,74.0,2,290,0.0,147.0,145.0
104932113.0,6,30,2106,15,1089,7479742.5,123.0,72.6,15,1017,7479740.857142857,123.0,67.8
142468.0,6,10,2032,5,524,35377.5,252.0,104.8,5,1508,22931.0,1236.0,301.6
228316.0,17,2,180,1,90,0.0,90.0,90.0,1,90,0.0,90.0,90.0
297.0,17,2,156,1,78,0.0,78.0,78.0,1,78,0.0,78.0,78.0
209477.0,17,4,6056,4,6056,69825.66666666667,1514.0,1514.0,0,0,0.0,0.0,0.0
45770.0,6,14,4740,7,653,7371.333333333333,249.0,93.28571428571428,7,4087,7313.0,1514.0,583.8571428571429
46276.0,6,10,2032,5,524,9126.5,252.0,104.8,5,1508,10803.5,1236.0,301.6
182698.0,6,11,1132,6,556,36277.4,218.0,92.66666666666669,5,576,45476.75,304.0,115.2
2424.0,17,4,344,2,150,0.0,75.0,75.0,2,194,0.0,103.0,97.0
308597.0,6,6,412,4,272,102865.66666666669,74.0,68.0,2,140,0.0,74.0,70.0
30471.0,6,11,2098,6,590,5959.2,252.0,98.33333333333331,5,1508,6757.75,1236.0,301.6
42468.0,6,10,2032,5,524,10383.25,252.0,104.8,5,1508,8921.0,1236.0,301.6
57315.0,6,14,4740,7,653,9022.166666666666,249.0,93.28571428571428,7,4087,9384.0,1514.0,583.8571428571429
2508.0,17,4,344,2,150,0.0,75.0,75.0,2,194,0.0,103.0,97.0
0.0,17,1,179,1,179,0.0,179.0,179.0,0,0,0.0,0.0,0.0
103120.0,17,2,762,2,762,0.0,381.0,381.0,0,0,0.0,0.0,0.0
42015.0,6,13,1386,7,789,6676.833333333333,253.0,112.71428571428572,6,597,8089.0,259.0,99.5
197252.0,17,2,180,1,90,0.0,90.0,90.0,1,90,0.0,90.0,90.0
153494.0,17,2,180,1,90,0.0,90.0,90.0,1,90,0.0,90.0,90.0
2296.0,17,4,344,2,150,0.0,75.0,75.0,2,194,0.0,103.0,97.0
106382167.0,6,33,2412,17,1272,6648885.4375,123.0,74.82352941176471,16,1140,7077721.333333333,123.0,71.25
8966.0,17,4,823,2,163,0.0,89.0,81.5,2,660,0.0,443.0,330.0
10362.0,6,10,1066,5,490,2379.5,218.0,98.0,5,576,2188.0,304.0,115.2
0.0,6,1,66,1,66,0.0,66.0,66.0,0,0,0.0,0.0,0.0
872446.0,6,10,1334,6,797,174489.2,459.0,132.83333333333334,4,537,198697.3333333333,331.0,134.25
196850.0,17,2,180,1,90,0.0,90.0,90.0,1,90,0.0,90.0,90.0
90096979.0,6,11,1644,4,816,30031536.0,204.0,204.0,7,828,15015782.333333334,188.0,118.28571428571428
41930.0,6,14,4740,7,653,6843.5,249.0,93.28571428571428,7,4087,6809.0,1514.0,583.8571428571429
102219547.0,6,33,2428,17,1288,6375238.0625,139.0,75.76470588235294,16,1140,6800254.333333333,123.0,71.25
338210.0,6,6,412,4,272,112736.66666666669,74.0,68.0,2,140,0.0,74.0,70.0
90049121.0,17,28,13364,28,13364,3335152.6296296297,501.0,477.2857142857143,0,0,0.0,0.0,0.0
270814.0,17,2,571,1,86,0.0,86.0,86.0,1,485,0.0,485.0,485.0
108105592.0,17,5,955,5,955,27026398.0,191.0,191.0,0,0,0.0,0.0,0.0
90018266.0,6,22,1799,11,799,9001826.6,95.0,72.63636363636364,11,1000,8979609.7,255.0,90.9090909090909
0.0,17,1,55,1,55,0.0,55.0,55.0,0,0,0.0,0.0,0.0
120122750.0,6,14,2224,9,1204,15015343.75,188.0,133.77777777777777,5,1020,22523548.75,204.0,204.0
256297.0,6,3,337,2,214,0.0,160.0,107.0,1,123,0.0,123.0,123.0
270298.0,6,10,1221,6,636,54059.6,298.0,106.0,4,585,84726.66666666667,379.0,146.25
216888.0,6,3,426,2,280,0.0,214.0,140.0,1,146,0.0,146.0,146.0
10478370.0,6,6,412,3,206,5170945.5,74.0,68.66666666666667,3,206,5170829.5,74.0,68.66666666666667
99609.0,17,2,286,2,286,0.0,143.0,143.0,0,0,0.0,0.0,0.0
90227704.0,6,23,1734,11,840,8997333.0,95.0,76.36363636363636,12,894,8182940.181818182,95.0,74.5
100359.0,17,2,762,2,762,0.0,381.0,381.0,0,0,0.0,0.0,0.0
2283.0,17,4,344,2,150,0.0,75.0,75.0,2,194,0.0,103.0,97.0
135148214.0,17,6,1146,6,1146,27029642.8,191.0,191.0,0,0,0.0,0.0,0.0
326532.0,17,2,180,1,90,0.0,90.0,90.0,1,90,0.0,90.0,90.0
108695317.0,6,32,2236,16,1165,7246354.466666667,139.0,72.8125,16,1071,7231932.2,123.0,66.9375
1033298.0,6,11,1134,6,558,206659.6,220.0,93.0,5,576,257081.75,304.0,115.2
16387.0,6,14,4740,7,653,2313.5,249.0,93.28571428571428,7,4087,2595.5,1514.0,583.8571428571429
25466.0,6,15,4782,8,699,3638.0,241.0,87.375,7,4083,3391.833333333333,1514.0,583.2857142857143
90266212.0,6,13,2036,8,1016,12895173.142857144,188.0,127.0,5,1020,22525529.5,204.0,204.0
1378131.0,6,4,492,2,280,0.0,214.0,140.0,2,212,0.0,146.0,106.0
112535727.0,6,46,3036,23,1518,5105439.045454546,66.0,66.0,23,1518,5105447.363636363,66.0,66.0
11486674.0,6,7,499,3,198,4095532.000000001,66.0,66.0,4,301,3506888.0,103.0,75.25
1245930.0,17,7,490,7,490,207655.0,70.0,70.0,0,0,0.0,0.0,0.0
237023.0,6,3,337,2,214,0.0,160.0,107.0,1,123,0.0,123.0,123.0
246180.0,6,3,337,2,214,0.0,160.0,107.0,1,123,0.0,123.0,123.0
0.0,17,1,350,1,350,0.0,350.0,350.0,0,0,0.0,0.0,0.0
2403.0,17,4,344,2,150,0.0,75.0,75.0,2,194,0.0,103.0,97.0
685.0,17,2,762,2,762,0.0,381.0,381.0,0,0,0.0,0.0,0.0
306640.0,6,6,412,4,272,102213.33333333331,74.0,68.0,2,140,0.0,74.0,70.0
317668.0,17,4,1400,4,1400,105889.33333333331,350.0,350.0,0,0,0.0,0.0,0.0
202601.0,17,4,6056,4,6056,67533.66666666667,1514.0,1514.0,0,0,0.0,0.0,0.0
120213287.0,6,19,1436,9,691,14999580.375,95.0,76.77777777777777,10,745,13332973.555555556,95.0,74.5
3409098.0,6,7,923,4,753,1064033.0,571.0,188.25,3,170,1596384.0,62.0,56.66666666666666
107514.0,17,2,286,2,286,0.0,143.0,143.0,0,0,0.0,0.0,0.0
120011554.0,6,24,1829,13,1030,9999994.083333334,95.0,79.23076923076923,11,799,11973492.2,95.0,72.63636363636364
135136280.0,17,6,1206,6,1206,27027256.0,201.0,201.0,0,0,0.0,0.0,0.0
80.0,17,2,762,2,762,0.0,381.0,381.0,0,0,0.0,0.0,0.0
8663691.0,17,3,1034,2,684,0.0,342.0,342.0,1,350,0.0,350.0,350.0
2269.0,17,4,344,2,150,0.0,75.0,75.0,2,194,0.0,103.0,97.0
50489.0,17,2,180,1,90,0.0,90.0,90.0,1,90,0.0,90.0,90.0
878912.0,6,10,1333,6,796,175782.4,458.0,132.66666666666666,4,537,202102.66666666663,331.0,134.25
118655520.0,6,206,23330,103,16236,1161180.303921569,284.0,157.63106796116506,103,7094,1161180.607843137,140.0,68.87378640776699
284793.0,17,2,180,1,90,0.0,90.0,90.0,1,90,0.0,90.0,90.0
96089930.0,6,54,12053,29,6477,3431783.214285714,1514.0,223.3448275862069,25,5576,3993103.6666666665,1514.0,223.04
90257158.0,6,13,2036,8,1016,12893879.714285716,188.0,127.0,5,1020,22523036.75,204.0,204.0
184852.0,17,2,180,1,90,0.0,90.0,90.0,1,90,0.0,90.0,90.0
143923.0,17,2,180,1,90,0.0,90.0,90.0,1,90,0.0,90.0,90.0
108092004.0,17,5,1005,5,1005,27023001.0,201.0,201.0,0,0,0.0,0.0,0.0
24363.0,6,14,4740,7,653,3108.333333333333,249.0,93.28571428571428,7,4087,3920.1666666666665,1514.0,583.8571428571429
31221.0,6,14,4740,7,653,5079.0,249.0,93.28571428571428,7,4087,4874.166666666667,1514.0,583.8571428571429
49925.0,6,14,4740,7,653,8106.5,249.0,93.28571428571428,7,4087,8098.833333333333,1514.0,583.8571428571429
26696.0,6,14,4740,7,653,3909.5,249.0,93.28571428571428,7,4087,4167.166666666667,1514.0,583.8571428571429
102720.0,17,2,286,2,286,0.0,143.0,143.0,0,0,0.0,0.0,0.0
308220.0,6,6,412,4,272,102740.0,74.0,68.0,2,140,0.0,74.0,70.0
37910.0,6,10,2032,5,524,8635.75,252.0,104.8,5,1508,8911.5,1236.0,301.6
207236.0,17,2,762,2,762,0.0,381.0,381.0,0,0,0.0,0.0,0.0
90054307.0,17,27,12943,27,12943,3463627.1923076925,501.0,479.3703703703704,0,0,0.0,0.0,0.0
3842.0,17,4,344,2,150,0.0,75.0,75.0,2,194,0.0,103.0,97.0
14361.0,6,13,1459,7,862,2393.5,271.0,123.14285714285714,6,597,2142.6,259.0,99.5
720.0,17,4,438,2,148,0.0,74.0,74.0,2,290,0.0,147.0,145.0
107941.0,17,2,286,2,286,0.0,143.0,143.0,0,0,0.0,0.0,0.0
414.0,17,2,410,1,78,0.0,78.0,78.0,1,332,0.0,332.0,332.0
3814651.0,6,51,23848,26,19851,152586.04,1514.0,763.5,25,3997,149445.5,1514.0,159.88
743010.0,6,2,132,1,66,0.0,66.0,66.0,1,66,0.0,66.0,66.0
37535.0,6,10,2032,5,524,9144.25,252.0,104.8,5,1508,7655.5,1236.0,301.6
254943.0,6,3,337,2,214,0.0,160.0,107.0,1,123,0.0,123.0,123.0
206280.0,6,3,426,2,280,0.0,214.0,140.0,1,146,0.0,146.0,146.0
10843.0,17,2,582,1,83,0.0,83.0,83.0,1,499,0.0,499.0,499.0
120061723.0,17,28,13364,28,13364,4446730.481481481,501.0,477.2857142857143,0,0,0.0,0.0,0.0
306370.0,6,6,412,4,272,102123.33333333331,74.0,68.0,2,140,0.0,74.0,70.0
935432.0,6,12,2718,7,743,155905.33333333334,339.0,106.14285714285714,5,1975,164972.25,1514.0,395.0
205852.0,17,2,180,1,90,0.0,90.0,90.0,1,90,0.0,90.0,90.0
2382.0,17,4,344,2,150,0.0,75.0,75.0,2,194,0.0,103.0,97.0
10508603.0,6,7,478,4,272,3457047.0,74.0,68.0,3,206,5185451.5,74.0,68.66666666666667
1180984.0,6,13,3012,8,2384,168712.0,1514.0,298.0,5,628,226291.75,331.0,125.6
116923335.0,6,47,3102,23,1518,5160006.7727272725,66.0,66.0,24,1584,5083608.695652174,66.0,66.0
29076.0,6,14,4740,7,653,4692.0,249.0,93.28571428571428,7,4087,3871.6666666666665,1514.0,583.8571428571429
278377.0,6,3,426,2,280,0.0,214.0,140.0,1,146,0.0,146.0,146.0
203315.0,17,4,1524,4,1524,67771.66666666667,381.0,381.0,0,0,0.0,0.0,0.0
4439.0,17,4,797,2,144,0.0,72.0,72.0,2,653,0.0,526.0,326.5
233051.0,6,3,337,2,214,0.0,160.0,107.0,1,123,0.0,123.0,123.0
118896006.0,6,37,2656,19,1408,6605333.666666667,139.0,74.10526315789474,18,1248,6981168.529411765,123.0,69.33333333333333
36907.0,6,10,2032,5,524,8983.0,252.0,104.8,5,1508,8955.5,1236.0,301.6
2800364.0,6,2,132,1,66,0.0,66.0,66.0,1,66,0.0,66.0,66.0
4199.0,17,2,610,1,72,0.0,72.0,72.0,1,538,0.0,538.0,538.0
93580574.0,6,26,1746,13,906,7798381.166666667,123.0,69.6923076923077,13,840,7780336.916666667,123.0,64.61538461538461
146378.0,17,4,704,2,148,0.0,74.0,74.0,2,556,0.0,280.0,278.0
135135869.0,17,6,1146,6,1146,27027173.8,191.0,191.0,0,0,0.0,0.0,0.0
100407863.0,17,13,821,7,432,16734643.833333334,174.0,61.71428571428572,6,389,16233022.2,174.0,64.83333333333333
22765.0,6,14,4740,7,653,3557.6666666666665,249.0,93.28571428571428,7,4087,3616.5,1514.0,583.8571428571429
60176.0,6,14,4740,7,653,9388.833333333334,249.0,93.28571428571428,7,4087,7994.0,1514.0,583.8571428571429
26767.0,6,14,4740,7,653,4268.666666666667,249.0,93.28571428571428,7,4087,4328.333333333333,1514.0,583.8571428571429
305925.0,6,6,412,4,272,101975.0,74.0,68.0,2,140,0.0,74.0,70.0
16947.0,6,11,1133,6,602,3243.4,264.0,100.33333333333331,5,531,3245.75,259.0,106.2
0.0,6,1,66,1,66,0.0,66.0,66.0,0,0,0.0,0.0,0.0
1046004.0,6,11,1134,6,558,209200.8,220.0,93.0,5,576,260735.25,304.0,115.2
2086334.0,6,24,7544,12,2450,189666.7272727273,1034.0,204.16666666666663,12,5094,161592.36363636365,1510.0,424.5
28527.0,6,14,4740,7,653,4629.5,249.0,93.28571428571428,7,4087,4335.0,1514.0,583.8571428571429
45246.0,6,14,4740,7,653,7144.666666666667,249.0,93.28571428571428,7,4087,6746.833333333333,1514.0,583.8571428571429
135135721.0,17,6,1206,6,1206,27027144.2,201.0,201.0,0,0,0.0,0.0,0.0
301715.0,6,6,412,4,272,100571.66666666669,74.0,68.0,2,140,0.0,74.0,70.0
0.0,17,1,44,1,44,0.0,44.0,44.0,0,0,0.0,0.0,0.0
1921.0,17,4,344,2,150,0.0,75.0,75.0,2,194,0.0,103.0,97.0
146448.0,6,3,337,2,214,0.0,160.0,107.0,1,123,0.0,123.0,123.0
2381.0,17,4,344,2,150,0.0,75.0,75.0,2,194,0.0,103.0,97.0
5004811.0,17,4,849,2,166,0.0,83.0,83.0,2,683,0.0,499.0,341.5
90035633.0,17,28,13364,28,13364,3334653.074074074,501.0,477.2857142857143,0,0,0.0,0.0,0.0
143815.0,17,2,180,1,90,0.0,90.0,90.0,1,90,0.0,90.0,90.0
106891260.0,6,32,2220,16,1149,7126084.0,123.0,71.8125,16,1071,7112375.533333333,123.0,66.9375
120124296.0,6,15,2444,7,1428,20020716.0,204.0,204.0,8,1016,17098422.285714287,188.0,127.0
104418908.0,17,15,5130,15,5130,7458493.428571428,342.0,342.0,0,0,0.0,0.0,0.0
196140.0,17,4,6056,4,6056,65380.0,1514.0,1514.0,0,0,0.0,0.0,0.0
200448.0,17,2,180,1,90,0.0,90.0,90.0,1,90,0.0,90.0,90.0
90280734.0,6,16,1192,8,596,12891242.0,95.0,74.5,8,596,12896521.142857144,95.0,74.5
90206995.0,6,16,1192,8,596,12852879.714285716,95.0,74.5,8,596,12857391.714285716,95.0,74.5
209461.0,17,2,180,1,90,0.0,90.0,90.0,1,90,0.0,90.0,90.0
506031.0,6,5,336,2,134,0.0,68.0,67.0,3,202,186291.5,70.0,67.33333333333333
148014.0,17,2,180,1,90,0.0,90.0,90.0,1,90,0.0,90.0,90.0
90770089.0,6,25,1924,14,1084,6978359.538461538,95.0,77.42857142857143,11,840,9048811.7,95.0,76.36363636363636
27452.0,6,14,4740,7,653,4463.166666666667,249.0,93.28571428571428,7,4087,4441.666666666667,1514.0,583.8571428571429
208231.0,17,2,762,2,762,0.0,381.0,381.0,0,0,0.0,0.0,0.0
1028651.0,6,11,1134,6,558,205730.2,220.0,93.0,5,576,256377.5,304.0,115.2
120122425.0,6,15,2152,9,1204,15015303.125,188.0,133.77777777777777,6,948,18011419.2,204.0,158.0
21556.0,17,2,582,1,83,0.0,83.0,83.0,1,499,0.0,499.0,499.0
19186.0,6,10,2032,5,524,4487.0,252.0,104.8,5,1508,4081.5,1236.0,301.6
31953.000000000004,6,14,4740,7,653,4875.666666666667,249.0,93.28571428571428,7,4087,4351.833333333333,1514.0,583.8571428571429
108102885.0,17,5,955,5,955,27025721.25,191.0,191.0,0,0,0.0,0.0,0.0
135132042.0,17,6,1146,6,1146,27026408.4,191.0,191.0,0,0,0.0,0.0,0.0
43290.0,6,10,2032,5,524,10580.0,252.0,104.8,5,1508,9889.75,1236.0,301.6
92734238.0,17,12,778,6,389,18514655.2,174.0,64.83333333333333,6,389,18438896.6,174.0,64.83333333333333
98300.0,17,2,762,2,762,0.0,381.0,381.0,0,0,0.0,0.0,0.0
2069.0,17,4,344,2,150,0.0,75.0,75.0,2,194,0.0,103.0,97.0
1162233.0,6,13,3013,8,2385,166033.2857142857,1514.0,298.125,5,628,221621.25,331.0,125.6
36885.0,6,10,2032,5,524,8974.5,252.0,104.8,5,1508,8982.75,1236.0,301.6
1427834.0,17,16,1120,16,1120,95188.93333333332,70.0,70.0,0,0,0.0,0.0,0.0
10352.0,17,4,1024,2,163,0.0,89.0,81.5,2,861,0.0,443.0,430.5
7077.0,17,4,823,2,163,0.0,89.0,81.5,2,660,0.0,443.0,330.0
1307935.0,6,4,264,2,132,0.0,66.0,66.0,2,132,0.0,66.0,66.0
108101095.0,17,5,1005,5,1005,27025273.75,201.0,201.0,0,0,0.0,0.0,0.0
22758.0,6,10,2032,5,524,4543.25,252.0,104.8,5,1508,4959.5,1236.0,301.6
153425.0,17,2,180,1,90,0.0,90.0,90.0,1,90,0.0,90.0,90.0
218919.0,6,3,426,2,280,0.0,214.0,140.0,1,146,0.0,146.0,146.0
142021.0,6,2,132,1,66,0.0,66.0,66.0,1,66,0.0,66.0,66.0
35978.0,6,14,4740,7,653,5184.0,249.0,93.28571428571428,7,4087,5689.333333333333,1514.0,583.8571428571429
2191.0,17,4,344,2,150,0.0,75.0,75.0,2,194,0.0,103.0,97.0
2449.0,17,4,344,2,150,0.0,75.0,75.0,2,194,0.0,103.0,97.0
161116.0,6,11,1131,6,600,31987.6,262.0,100.0,5,531,3218.75,259.0,106.2
143923.0,17,2,180,1,90,0.0,90.0,90.0,1,90,0.0,90.0,90.0
16768.0,17,2,180,1,90,0.0,90.0,90.0,1,90,0.0,90.0,90.0
2801279.0,6,2,132,1,66,0.0,66.0,66.0,1,66,0.0,66.0,66.0
107394.0,17,2,286,2,286,0.0,143.0,143.0,0,0,0.0,0.0,0.0
203056.0,17,2,180,1,90,0.0,90.0,90.0,1,90,0.0,90.0,90.0
3005982.0,6,12,2172,7,664,500904.6666666667,252.0,94.85714285714286,5,1508,1896.0,1236.0,301.6
67421.0,6,13,1386,7,789,10871.666666666666,253.0,112.71428571428572,6,597,11373.8,259.0,99.5
111072562.0,6,31,2182,16,1165,7390437.066666666,139.0,72.8125,15,1017,7918339.0,123.0,67.8
90040253.0,17,28,13364,28,13364,3334824.185185185,501.0,477.2857142857143,0,0,0.0,0.0,0.0
228193.0,17,2,180,1,90,0.0,90.0,90.0,1,90,0.0,90.0,90.0
233137.0,6,3,337,2,214,0.0,160.0,107.0,1,123,0.0,123.0,123.0
313.0,17,2,174,1,79,0.0,79.0,79.0,1,95,0.0,95.0,95.0
5201.0,6,5,578,3,438,1474.0,298.0,146.0,2,140,0.0,74.0,70.0
47860.0,6,10,2032,5,524,11275.5,252.0,104.8,5,1508,9456.25,1236.0,301.6
10425897.0,6,7,478,4,272,3429797.333333333,74.0,68.0,3,206,5144589.5,74.0,68.66666666666667
121451.0,6,3,337,2,214,0.0,160.0,107.0,1,123,0.0,123.0,123.0
106278575.0,17,14,864,7,432,17501761.833333332,174.0,61.71428571428572,7,432,17500228.166666668,174.0,61.71428571428572
90525856.0,6,13,2036,8,1016,12932265.142857144,188.0,127.0,5,1020,22584127.0,204.0,204.0
26565.0,6,14,4740,7,653,3058.1666666666665,249.0,93.28571428571428,7,4087,4216.166666666667,1514.0,583.8571428571429
99154428.0,6,40,2640,20,1320,5218654.105263158,66.0,66.0,20,1320,5202857.210526316,66.0,66.0
866694.0,6,9,1270,6,799,173338.8,461.0,133.16666666666666,3,471,295244.0,331.0,157.0
4290.0,17,2,598,1,72,0.0,72.0,72.0,1,526,0.0,526.0,526.0
115660539.0,6,32,2236,16,1165,7710702.6,139.0,72.8125,16,1071,7696292.866666666,123.0,66.9375
120119690.0,6,14,2240,8,1016,17136694.57142857,188.0,127.0,6,1224,18018440.0,204.0,204.0
109562909.0,6,35,2542,18,1348,6444877.0,139.0,74.88888888888889,17,1194,6834175.125,123.0,70.23529411764706
27079.0,17,2,582,1,83,0.0,83.0,83.0,1,499,0.0,499.0,499.0
55537.0,17,2,231,1,78,0.0,78.0,78.0,1,153,0.0,153.0,153.0
161304.0,17,2,180,1,90,0.0,90.0,90.0,1,90,0.0,90.0,90.0
111337965.0,6,30,1974,15,1026,7937299.285714285,123.0,68.4,15,948,7937298.071428572,123.0,63.2
302125.0,6,6,412,4,272,100708.33333333331,74.0,68.0,2,140,0.0,74.0,70.0
129008749.0,17,15,907,8,475,18429821.285714287,174.0,59.375,7,432,18018088.0,174.0,61.71428571428572
44995826.0,17,9,3086,8,2736,5107770.571428572,342.0,342.0,1,350,0.0,350.0,350.0
352.0,17,2,267,1,83,0.0,83.0,83.0,1,184,0.0,184.0,184.0
90031667.0,17,28,13364,28,13364,3334506.185185185,501.0,477.2857142857143,0,0,0.0,0.0,0.0
2417.0,17,4,344,2,150,0.0,75.0,75.0,2,194,0.0,103.0,97.0
2299661.0,6,32,10926,18,3951,135274.17647058822,1514.0,219.5,14,6975,156096.53846153847,1514.0,498.2142857142857
9531.0,6,10,1066,5,490,2217.5,218.0,98.0,5,576,2169.25,304.0,115.2
6776.0,17,2,582,1,83,0.0,83.0,83.0,1,499,0.0,499.0,499.0
104274.0,17,2,286,2,286,0.0,143.0,143.0,0,0,0.0,0.0,0.0
352.0,17,2,160,1,80,0.0,80.0,80.0,1,80,0.0,80.0,80.0
102566.0,17,2,286,2,286,0.0,143.0,143.0,0,0,0.0,0.0,0.0
46780517.0,6,8,1940,3,887,22145895.5,753.0,295.6666666666667,5,1053,11002049.75,785.0,210.6
108105932.0,17,5,1005,5,1005,27026483.0,201.0,201.0,0,0,0.0,0.0,0.0
28051.0,6,10,2032,5,524,5436.25,252.0,104.8,5,1508,6671.5,1236.0,301.6
146845.0,6,4,439,2,238,0.0,172.0,119.0,2,201,0.0,135.0,100.5
107516.0,17,2,286,2,286,0.0,143.0,143.0,0,0,0.0,0.0,0.0
104091.0,17,2,286,2,286,0.0,143.0,143.0,0,0,0.0,0.0,0.0
102681.0,17,2,286,2,286,0.0,143.0,143.0,0,0,0.0,0.0,0.0
153317.0,17,2,180,1,90,0.0,90.0,90.0,1,90,0.0,90.0,90.0
219581.0,6,3,426,2,280,0.0,214.0,140.0,1,146,0.0,146.0,146.0
36769.0,6,14,4740,7,653,5279.333333333333,249.0,93.28571428571428,7,4087,5613.0,1514.0,583.8571428571429
50875.0,6,12,1328,7,797,8479.166666666666,253.0,113.85714285714286,5,531,10685.5,259.0,106.2
15399098.0,6,27,9227,15,2193,1099935.5714285714,408.0,146.2,12,7034,1073949.0,1514.0,586.1666666666666
132728.0,6,2,132,1,66,0.0,66.0,66.0,1,66,0.0,66.0,66.0
113857337.0,6,46,3036,23,1518,5160442.181818182,66.0,66.0,23,1518,5160780.590909091,66.0,66.0
90301280.0,6,16,1192,8,596,12892880.57142857,95.0,74.5,8,596,12899558.142857144,95.0,74.5
90011715.0,17,28,13364,28,13364,3333767.222222222,501.0,477.2857142857143,0,0,0.0,0.0,0.0
237216.0,6,3,337,2,214,0.0,160.0,107.0,1,123,0.0,123.0,123.0
1296090.0,17,7,490,7,490,216015.0,70.0,70.0,0,0,0.0,0.0,0.0
25296.0,6,11,1133,6,602,4653.6,264.0,100.33333333333331,5,531,6040.75,259.0,106.2
103290.0,17,2,286,2,286,0.0,143.0,143.0,0,0,0.0,0.0,0.0
108103272.0,17,5,955,5,955,27025818.0,191.0,191.0,0,0,0.0,0.0,0.0
68974.0,17,2,604,1,75,0.0,75.0,75.0,1,529,0.0,529.0,529.0
119323554.0,6,235,26488,118,8084,1019859.435897436,140.0,68.50847457627118,117,18404,1020041.698275862,284.0,157.2991452991453
868733.0,6,9,1096,6,625,173746.6,287.0,104.16666666666669,3,471,296585.5,331.0,157.0
120025298.0,17,28,13364,28,13364,4445381.407407408,501.0,477.2857142857143,0,0,0.0,0.0,0.0
330489.0,17,6,2100,6,2100,66097.8,350.0,350.0,0,0,0.0,0.0,0.0
514915.0,6,5,336,2,134,0.0,68.0,67.0,3,202,194265.5,70.0,67.33333333333333
118674353.0,6,36,2596,18,1248,6980817.647058823,123.0,69.33333333333333,18,1348,6932799.294117647,139.0,74.88888888888889
54627.0,6,14,4740,7,653,8975.666666666666,249.0,93.28571428571428,7,4087,8771.5,1514.0,583.8571428571429
107524.0,17,2,286,2,286,0.0,143.0,143.0,0,0,0.0,0.0,0.0
120000385.0,6,17,1246,9,650,15000048.125,95.0,72.22222222222223,8,596,17107055.285714287,95.0,74.5
120005555.0,6,26,1978,14,1084,9230757.076923076,95.0,77.42857142857143,12,894,10909130.363636363,95.0,74.5
316162.0,17,4,1400,4,1400,105387.33333333331,350.0,350.0,0,0,0.0,0.0,0.0
511684.0,6,3,204,2,136,0.0,70.0,68.0,1,68,0.0,68.0,68.0
73681.0,17,3,1143,3,1143,36840.5,381.0,381.0,0,0,0.0,0.0,0.0
120235567.0,6,230,25994,115,7812,1039391.1666666666,140.0,67.9304347826087,115,18182,1047492.3070175438,284.0,158.10434782608695
306737.0,6,6,412,4,272,102245.66666666669,74.0,68.0,2,140,0.0,74.0,70.0
2800820.0,6,2,132,1,66,0.0,66.0,66.0,1,66,0.0,66.0,66.0
4157.0,17,2,582,1,83,0.0,83.0,83.0,1,499,0.0,499.0,499.0
206070.0,6,4,492,2,280,0.0,214.0,140.0,2,212,0.0,146.0,106.0
6934.0,17,2,582,1,83,0.0,83.0,83.0,1,499,0.0,499.0,499.0
285514.0,17,2,363,1,79,0.0,79.0,79.0,1,284,0.0,284.0,284.0
2653401.0,6,25,7573,14,3735,204107.7692307692,1514.0,266.7857142857143,11,3838,240424.6,1514.0,348.90909090909093
108108951.0,17,5,1005,5,1005,27027237.75,201.0,201.0,0,0,0.0,0.0,0.0
220813.0,6,3,426,2,280,0.0,214.0,140.0,1,146,0.0,146.0,146.0
233648.0,6,10,1221,6,636,46729.6,298.0,106.0,4,585,72472.33333333333,379.0,146.25
298469.0,6,6,412,4,272,99489.66666666669,74.0,68.0,2,140,0.0,74.0,70.0
2709831.0,6,3,1604,2,851,0.0,785.0,425.5,1,753,0.0,753.0,753.0
298559.0,6,6,412,4,272,99519.66666666669,74.0,68.0,2,140,0.0,74.0,70.0
90220511.0,6,18,1382,8,596,12853978.0,95.0,74.5,10,786,10001698.222222222,95.0,78.6
298004.0,6,6,412,4,272,99334.66666666669,74.0,68.0,2,140,0.0,74.0,70.0
90769832.0,6,19,1436,10,745,10080675.222222222,95.0,74.5,9,691,11345355.375,95.0,76.77777777777777
10425720.0,6,6,412,3,206,5144438.0,74.0,68.66666666666667,3,206,5144341.5,74.0,68.66666666666667
301558.0,6,6,412,4,272,100519.33333333331,74.0,68.0,2,140,0.0,74.0,70.0
314178.0,6,6,412,4,272,104726.0,74.0,68.0,2,140,0.0,74.0,70.0
2578.0,17,4,344,2,150,0.0,75.0,75.0,2,194,0.0,103.0,97.0
308366.0,6,6,412,4,272,102788.66666666669,74.0,68.0,2,140,0.0,74.0,70.0
183994.0,17,2,180,1,90,0.0,90.0,90.0,1,90,0.0,90.0,90.0
106719.0,17,2,286,2,286,0.0,143.0,143.0,0,0,0.0,0.0,0.0
39267.0,6,14,4740,7,653,6335.5,249.0,93.28571428571428,7,4087,6011.833333333333,1514.0,583.8571428571429
747965.0,6,2,132,1,66,0.0,66.0,66.0,1,66,0.0,66.0,66.0
322799.0,17,4,1400,4,1400,107599.66666666669,350.0,350.0,0,0,0.0,0.0,0.0
118797387.0,6,477,76806,239,16070,499148.6848739496,214.0,67.23849372384937,238,60736,499789.6666666667,1514.0,255.1932773109244
100537457.0,6,876,178696,446,149872,225926.8696629213,1514.0,336.0358744394619,430,28824,233835.53846153847,214.0,67.03255813953488
120121411.0,6,13,2020,9,1204,15015176.375,188.0,133.77777777777777,4,816,30030372.0,204.0,204.0
2073359.0,6,18,6803,10,1501,230373.22222222225,408.0,150.1,8,5302,238304.14285714287,1514.0,662.75
210624.0,6,10,1221,6,636,42124.8,298.0,106.0,4,585,69031.33333333333,379.0,146.25
90094288.0,6,10,1562,7,950,15015714.666666666,188.0,135.71428571428572,3,612,30031632.5,204.0,204.0
104267500.0,6,184,20744,92,14376,1143432.1758241758,284.0,156.2608695652174,92,6368,1143431.956043956,140.0,69.21739130434783
315554.0,17,4,1400,4,1400,105184.66666666669,350.0,350.0,0,0,0.0,0.0,0.0
30694.0,6,14,4740,7,653,4623.333333333333,249.0,93.28571428571428,7,4087,4878.666666666667,1514.0,583.8571428571429
107531.0,17,2,286,2,286,0.0,143.0,143.0,0,0,0.0,0.0,0.0
50422.0,6,14,4740,7,653,8272.5,249.0,93.28571428571428,7,4087,7868.666666666667,1514.0,583.8571428571429
205862.0,17,2,180,1,90,0.0,90.0,90.0,1,90,0.0,90.0,90.0
113638804.0,6,46,3036,23,1518,5151347.590909091,66.0,66.0,23,1518,5151209.909090909,66.0,66.0
120023.0,17,2,180,1,70,0.0,70.0,70.0,1,110,0.0,110.0,110.0
120122383.0,6,14,2224,9,1204,15015297.875,188.0,133.77777777777777,5,1020,22591700.75,204.0,204.0
153875.0,17,3,1143,3,1143,76937.5,381.0,381.0,0,0,0.0,0.0,0.0
3074.0,17,2,224,1,76,0.0,76.0,76.0,1,148,0.0,148.0,148.0
284932.0,17,2,363,1,79,0.0,79.0,79.0,1,284,0.0,284.0,284.0
948967.0,6,12,1354,6,723,188036.4,253.0,120.5,6,631,188879.6,293.0,105.16666666666669
6849.0,17,2,224,1,76,0.0,76.0,76.0,1,148,0.0,148.0,148.0
146195.0,6,3,337,2,214,0.0,160.0,107.0,1,123,0.0,123.0,123.0
51115.0,6,10,2032,5,524,9370.5,252.0,104.8,5,1508,12005.25,1236.0,301.6
90258103.0,6,12,1832,8,1016,12894014.714285716,188.0,127.0,4,816,30030840.666666668,204.0,204.0
28205.0,6,14,4740,7,653,4125.666666666667,249.0,93.28571428571428,7,4087,4185.5,1514.0,583.8571428571429
122001210.0,17,15,907,8,475,17428744.285714287,174.0,59.375,7,432,17001381.666666668,174.0,61.71428571428572
1181666.0,6,13,3012,8,2384,168809.42857142858,1514.0,298.0,5,628,226496.0,331.0,125.6
79638.0,6,14,4740,7,653,12938.166666666666,249.0,93.28571428571428,7,4087,13058.166666666666,1514.0,583.8571428571429
21979.0,6,10,2032,5,524,5040.25,252.0,104.8,5,1508,4921.0,1236.0,301.6
196958.0,17,2,180,1,90,0.0,90.0,90.0,1,90,0.0,90.0,90.0
14953.0,17,4,823,2,163,0.0,89.0,81.5,2,660,0.0,443.0,330.0
3170375.0,6,18,1495,9,921,358361.625,315.0,102.33333333333331,9,574,358378.625,78.0,63.77777777777778
108106311.0,17,5,955,5,955,27026577.75,191.0,191.0,0,0,0.0,0.0,0.0
301442.0,6,6,412,4,272,100480.66666666669,74.0,68.0,2,140,0.0,74.0,70.0
103953770.0,6,44,2904,22,1452,4950179.523809524,66.0,66.0,22,1452,4935845.666666667,66.0,66.0
442054.0,17,2,363,1,79,0.0,79.0,79.0,1,284,0.0,284.0,284.0
51509.0,17,2,180,1,90,0.0,90.0,90.0,1,90,0.0,90.0,90.0
404350.0,6,3,1604,1,753,0.0,753.0,753.0,2,851,0.0,785.0,425.5
4394.0,17,2,180,1,90,0.0,90.0,90.0,1,90,0.0,90.0,90.0
103527101.0,6,33,2412,17,1272,6456949.5,123.0,74.82352941176471,16,1140,6887415.933333334,123.0,71.25
314.0,17,2,174,1,79,0.0,79.0,79.0,1,95,0.0,95.0,95.0
109694.0,17,2,762,2,762,0.0,381.0,381.0,0,0,0.0,0.0,0.0
90764182.0,6,22,1680,12,935,8247125.818181818,95.0,77.91666666666667,10,745,10052466.0,95.0,74.5
120490073.0,6,33,2365,16,1140,7366982.733333333,123.0,71.25,17,1225,7530541.375,139.0,72.05882352941177
14092.0,6,14,4740,7,653,2085.5,249.0,93.28571428571428,7,4087,2215.0,1514.0,583.8571428571429
75130.0,6,10,2032,5,524,18567.0,252.0,104.8,5,1508,17093.75,1236.0,301.6
410.0,17,2,410,1,78,0.0,78.0,78.0,1,332,0.0,332.0,332.0
332.0,17,2,166,1,75,0.0,75.0,75.0,1,91,0.0,91.0,91.0
10420135.0,6,6,412,3,206,5142125.5,74.0,68.66666666666667,3,206,5142038.5,74.0,68.66666666666667
227567.0,17,2,180,1,90,0.0,90.0,90.0,1,90,0.0,90.0,90.0
120004783.0,6,18,1341,9,691,14999997.25,95.0,76.77777777777777,9,650,14999116.375,95.0,72.22222222222223
436194.0,6,4,508,2,238,0.0,172.0,119.0,2,270,0.0,135.0,135.0
59066.0,6,10,2032,5,524,11895.75,252.0,104.8,5,1508,14506.0,1236.0,301.6
1971.0,17,2,684,1,342,0.0,342.0,342.0,1,342,0.0,342.0,342.0
118138698.0,6,48,3168,24,1584,5136465.130434782,66.0,66.0,24,1584,5124491.391304348,66.0,66.0
205987.0,6,3,426,2,280,0.0,214.0,140.0,1,146,0.0,146.0,146.0
207656.0,17,2,762,2,762,0.0,381.0,381.0,0,0,0.0,0.0,0.0
90092991.0,6,10,1440,7,828,15015498.5,188.0,118.28571428571428,3,612,30030362.0,204.0,204.0
108112675.0,17,5,955,5,955,27028168.75,191.0,191.0,0,0,0.0,0.0,0.0
128872166.0,6,35,2394,18,1269,7580715.647058823,123.0,70.5,17,1125,7416927.5,123.0,66.17647058823529
277885.0,17,2,363,1,79,0.0,79.0,79.0,1,284,0.0,284.0,284.0
118980921.0,17,17,1517,9,780,14872615.125,174.0,86.66666666666667,8,737,16434588.42857143,174.0,92.125
90029154.0,17,28,13364,28,13364,3334413.111111111,501.0,477.2857142857143,0,0,0.0,0.0,0.0
28033.0,6,14,4740,7,653,3733.0,249.0,93.28571428571428,7,4087,4532.833333333333,1514.0,583.8571428571429
153488.0,17,2,180,1,90,0.0,90.0,90.0,1,90,0.0,90.0,90.0
120013236.0,6,18,1341,9,691,14999993.375,95.0,76.77777777777777,9,650,15000370.125,95.0,72.22222222222223
90089993.0,6,15,2180,7,1164,15014828.333333334,204.0,166.28571428571428,8,1016,12869593.57142857,188.0,127.0
58808.0,6,14,4740,7,653,9609.0,249.0,93.28571428571428,7,4087,9254.833333333334,1514.0,583.8571428571429
10540702.0,6,7,478,4,272,3466527.0,74.0,68.0,3,206,5199676.0,74.0,68.66666666666667
304574.0,6,6,412,4,272,101524.66666666669,74.0,68.0,2,140,0.0,74.0,70.0
16602.0,6,10,2032,5,524,3928.5,252.0,104.8,5,1508,3780.5,1236.0,301.6
125216.0,17,4,1524,4,1524,41738.66666666666,381.0,381.0,0,0,0.0,0.0,0.0
57185.0,6,10,2032,5,524,13853.75,252.0,104.8,5,1508,11532.5,1236.0,301.6
120124702.0,6,13,2020,9,1204,15015587.75,188.0,133.77777777777777,4,816,30031058.666666668,204.0,204.0
146749.0,6,3,373,2,238,0.0,172.0,119.0,1,135,0.0,135.0,135.0
105610105.0,17,14,1126,7,563,17601684.166666668,174.0,80.42857142857143,7,563,17447822.833333332,174.0,80.42857142857143
1302508.0,6,4,264,2,132,0.0,66.0,66.0,2,132,0.0,66.0,66.0
37121.0,6,14,4740,7,653,5253.833333333333,249.0,93.28571428571428,7,4087,5521.333333333333,1514.0,583.8571428571429
1026921.0,6,11,1134,6,558,205384.2,220.0,93.0,5,576,255546.25,304.0,115.2
480481.0,6,3,204,2,136,0.0,70.0,68.0,1,68,0.0,68.0,68.0
100788688.0,6,29,2068,15,1105,7183773.071428572,139.0,73.66666666666667,14,963,7736370.769230769,123.0,68.78571428571429
607476.0,6,4,508,2,238,0.0,172.0,119.0,2,270,0.0,135.0,135.0
85992.0,6,14,4740,7,653,14160.833333333334,249.0,93.28571428571428,7,4087,11713.833333333334,1514.0,583.8571428571429
254957.0,6,3,354,2,288,0.0,222.0,144.0,1,66,0.0,66.0,66.0
120299082.0,6,230,25994,115,7886,1048125.9122807018,140.0,68.57391304347826,115,18108,1048038.3596491228,284.0,157.4608695652174
19297.0,6,20,7606,11,978,1929.7,310.0,88.9090909090909,9,6628,2168.875,1514.0,736.4444444444445
48205.0,6,12,1320,6,723,7987.8,253.0,120.5,6,597,9075.4,259.0,99.5
24399.0,6,10,2032,5,524,5581.25,252.0,104.8,5,1508,5654.75,1236.0,301.6
106197043.0,6,419,57648,210,14082,508119.8229665072,140.0,67.05714285714286,209,43566,505640.9038461539,570.0,208.44976076555025
153549.0,17,2,180,1,90,0.0,90.0,90.0,1,90,0.0,90.0,90.0
302.0,17,2,168,1,76,0.0,76.0,76.0,1,92,0.0,92.0,92.0
135134585.0,17,6,1206,6,1206,27026917.0,201.0,201.0,0,0,0.0,0.0,0.0
905.0,17,4,438,2,148,0.0,74.0,74.0,2,290,0.0,147.0,145.0
31803.0,6,13,1479,7,882,5189.333333333333,291.0,126.0,6,597,4693.8,259.0,99.5
0.0,17,1,44,1,44,0.0,44.0,44.0,0,0,0.0,0.0,0.0
211802.0,6,10,1221,6,636,42360.4,298.0,106.0,4,585,69233.66666666667,379.0,146.25
205828.0,6,3,426,2,280,0.0,214.0,140.0,1,146,0.0,146.0,146.0
144929.0,17,2,180,1,70,0.0,70.0,70.0,1,110,0.0,110.0,110.0
108109041.0,17,5,955,5,955,27027260.25,191.0,191.0,0,0,0.0,0.0,0.0
101417438.0,17,14,1126,7,563,16876080.5,174.0,80.42857142857143,7,563,16895185.833333332,174.0,80.42857142857143
15130.0,6,14,4740,7,653,2413.333333333333,249.0,93.28571428571428,7,4087,2339.5,1514.0,583.8571428571429
736.0,17,4,438,2,148,0.0,74.0,74.0,2,290,0.0,147.0,145.0
2298.0,17,4,344,2,150,0.0,75.0,75.0,2,194,0.0,103.0,97.0
108109496.0,17,5,955,5,955,27027374.0,191.0,191.0,0,0,0.0,0.0,0.0
27202678.0,17,5,1710,5,1710,6800669.5,342.0,342.0,0,0,0.0,0.0,0.0
38049.0,6,10,2032,5,524,8414.25,252.0,104.8,5,1508,8928.5,1236.0,301.6
128956277.0,17,14,864,7,432,18087210.166666668,174.0,61.71428571428572,7,432,18167671.0,174.0,61.71428571428572
54936.0,6,14,4740,7,653,9034.0,249.0,93.28571428571428,7,4087,8273.333333333334,1514.0,583.8571428571429
308755.0,6,6,412,4,272,102918.33333333331,74.0,68.0,2,140,0.0,74.0,70.0
232508.0,6,3,337,2,214,0.0,160.0,107.0,1,123,0.0,123.0,123.0
90050804.0,17,28,13364,28,13364,3335214.962962963,501.0,477.2857142857143,0,0,0.0,0.0,0.0
323.0,17,2,174,1,79,0.0,79.0,79.0,1,95,0.0,95.0,95.0
234781.0,6,3,337,2,214,0.0,160.0,107.0,1,123,0.0,123.0,123.0
90582.0,6,13,1386,7,789,14807.5,253.0,112.71428571428572,6,597,16351.6,259.0,99.5
171638.0,17,2,180,1,90,0.0,90.0,90.0,1,90,0.0,90.0,90.0
123287570.0,17,15,907,7,432,17334336.833333332,174.0,61.71428571428572,8,475,17571653.714285713,174.0,59.375
3966.0,17,4,344,2,150,0.0,75.0,75.0,2,194,0.0,103.0,97.0
864045.0,6,9,1267,6,796,172809.0,458.0,132.66666666666666,3,471,294236.5,331.0,157.0
296774.0,17,4,1400,4,1400,98924.66666666669,350.0,350.0,0,0,0.0,0.0,0.0
119795078.0,17,34,16284,34,16284,3630153.878787879,501.0,478.9411764705882,0,0,0.0,0.0,0.0
289108.0,17,2,180,1,90,0.0,90.0,90.0,1,90,0.0,90.0,90.0
90222690.0,6,24,1829,11,840,8997702.2,95.0,76.36363636363636,13,989,7500488.083333333,95.0,76.07692307692308
503576.0,6,4,270,2,134,0.0,68.0,67.0,2,136,0.0,70.0,68.0
17355805.0,6,18,1499,8,867,1755372.714285714,315.0,108.375,10,632,1894227.3333333333,78.0,63.2
90031097.0,17,27,12943,27,12943,3462734.5,501.0,479.3703703703704,0,0,0.0,0.0,0.0
246377.0,6,3,337,2,214,0.0,160.0,107.0,1,123,0.0,123.0,123.0
40751.0,6,10,2032,5,524,9574.25,252.0,104.8,5,1508,8674.75,1236.0,301.6
5632245.0,6,5,336,2,134,0.0,68.0,67.0,3,202,1427485.0,70.0,67.33333333333333
21726.0,6,10,2032,5,524,5183.0,252.0,104.8,5,1508,5181.0,1236.0,301.6
43045.0,6,10,2032,5,524,6824.5,252.0,104.8,5,1508,10299.75,1236.0,301.6
2076605.0,6,23,7479,12,2450,188782.2727272728,1034.0,204.16666666666663,11,5029,177367.7,1510.0,457.1818181818182
70268.0,6,10,1065,5,534,16720.75,262.0,106.8,5,531,14935.5,259.0,106.2
108110384.0,17,5,955,5,955,27027596.0,191.0,191.0,0,0,0.0,0.0,0.0
47850.0,6,14,4740,7,653,7826.5,249.0,93.28571428571428,7,4087,7626.166666666667,1514.0,583.8571428571429
34265.0,6,14,4740,7,653,5408.166666666667,249.0,93.28571428571428,7,4087,5523.833333333333,1514.0,583.8571428571429
120596322.0,6,221,25068,111,17574,1096330.2,284.0,158.32432432432432,110,7494,1096870.376146789,140.0,68.12727272727273
61275.0,6,14,4740,7,653,9562.333333333334,249.0,93.28571428571428,7,4087,7923.833333333333,1514.0,583.8571428571429
9297.0,6,10,1067,5,536,2161.5,264.0,107.2,5,531,2093.5,259.0,106.2
153436.0,17,2,180,1,90,0.0,90.0,90.0,1,90,0.0,90.0,90.0
51190.0,6,14,4740,7,653,8373.666666666666,249.0,93.28571428571428,7,4087,7233.333333333333,1514.0,583.8571428571429
349839.0,6,7,478,4,272,116613.0,74.0,68.0,3,206,96326.0,74.0,68.66666666666667
114402136.0,6,238,27152,119,19076,967685.2118644068,284.0,160.30252100840335,119,8076,967685.0508474576,140.0,67.8655462184874
120357252.0,6,282,33206,141,9528,853864.4785714286,140.0,67.57446808510639,141,23678,853864.5785714285,284.0,167.9290780141844
90216517.0,6,16,1192,8,596,12853260.42857143,95.0,74.5,8,596,12858821.857142856,95.0,74.5
850195.0,6,9,1268,6,797,170039.0,459.0,132.83333333333334,3,471,288797.0,331.0,157.0
203422.0,17,2,180,1,90,0.0,90.0,90.0,1,90,0.0,90.0,90.0
93036567.0,6,240,28326,120,20184,780095.9831932773,336.0,168.2,120,8142,780095.7731092437,140.0,67.85
141635.0,6,2,132,1,66,0.0,66.0,66.0,1,66,0.0,66.0,66.0
281082.0,17,2,363,1,79,0.0,79.0,79.0,1,284,0.0,284.0,284.0
10482650.0,6,7,478,4,272,3448642.0,74.0,68.0,3,206,5172852.5,74.0,68.66666666666667
16179469.999999998,17,6,2052,6,2052,3235894.0,342.0,342.0,0,0,0.0,0.0,0.0
1857484.0,6,23,6509,12,1529,168862.18181818182,357.0,127.41666666666669,11,4980,152552.5,1510.0,452.7272727272728
211343.0,17,2,180,1,90,0.0,90.0,90.0,1,90,0.0,90.0,90.0
208297.0,6,3,426,2,280,0.0,214.0,140.0,1,146,0.0,146.0,146.0
303648.0,6,2,132,1,66,0.0,66.0,66.0,1,66,0.0,66.0,66.0
112503625.0,6,35,2526,18,1332,6605155.294117647,123.0,74.0,17,1194,7017975.4375,123.0,70.23529411764706
2729667.0,6,25,6657,13,1603,227472.25,357.0,123.3076923076923,12,5054,219388.7272727273,1510.0,421.1666666666667
108107957.0,17,5,1005,5,1005,27026989.25,201.0,201.0,0,0,0.0,0.0,0.0
196938.0,17,2,180,1,90,0.0,90.0,90.0,1,90,0.0,90.0,90.0
207014.0,17,2,762,2,762,0.0,381.0,381.0,0,0,0.0,0.0,0.0
30981.0,6,14,4740,7,653,4630.833333333333,249.0,93.28571428571428,7,4087,5029.333333333333,1514.0,583.8571428571429
310054.0,6,6,412,4,272,103351.33333333331,74.0,68.0,2,140,0.0,74.0,70.0
46720.0,6,14,4740,7,653,7272.166666666667,249.0,93.28571428571428,7,4087,7645.666666666667,1514.0,583.8571428571429
505517.0,6,3,204,1,68,0.0,68.0,68.0,2,136,0.0,70.0,68.0
2804242.0,6,2,132,1,66,0.0,66.0,66.0,1,66,0.0,66.0,66.0
147297.0,6,3,337,2,214,0.0,160.0,107.0,1,123,0.0,123.0,123.0
90056160.0,17,28,13364,28,13364,3335413.333333333,501.0,477.2857142857143,0,0,0.0,0.0,0.0
206516.0,6,3,426,2,280,0.0,214.0,140.0,1,146,0.0,146.0,146.0
1581448.0,6,10,2032,5,524,395127.25,252.0,104.8,5,1508,395040.25,1236.0,301.6
108081034.0,17,14,864,7,432,18000158.0,174.0,61.71428571428572,7,432,18001094.833333332,174.0,61.71428571428572
317226.0,17,4,1400,4,1400,105742.0,350.0,350.0,0,0,0.0,0.0,0.0
714.0,17,2,762,2,762,0.0,381.0,381.0,0,0,0.0,0.0,0.0
317.0,17,2,174,1,79,0.0,79.0,79.0,1,95,0.0,95.0,95.0
304317.0,6,6,412,4,272,101439.0,74.0,68.0,2,140,0.0,74.0,70.0
103585.0,17,2,286,2,286,0.0,143.0,143.0,0,0,0.0,0.0,0.0
988.0,17,4,438,2,148,0.0,74.0,74.0,2,290,0.0,147.0,145.0
90289255.0,6,16,1192,8,596,12892336.57142857,95.0,74.5,8,596,12897175.285714284,95.0,74.5
146826.0,6,4,439,2,238,0.0,172.0,119.0,2,201,0.0,135.0,100.5
16379.000000000002,6,10,2032,5,524,3131.5,252.0,104.8,5,1508,3713.75,1236.0,301.6
228403.0,17,2,180,1,90,0.0,90.0,90.0,1,90,0.0,90.0,90.0
120338.0,17,2,180,1,70,0.0,70.0,70.0,1,110,0.0,110.0,110.0
2790974.0,6,2,132,1,66,0.0,66.0,66.0,1,66,0.0,66.0,66.0
223950.0,17,2,180,1,90,0.0,90.0,90.0,1,90,0.0,90.0,90.0
314617.0,17,4,1400,4,1400,104872.33333333331,350.0,350.0,0,0,0.0,0.0,0.0
108105524.0,17,5,1005,5,1005,27026381.0,201.0,201.0,0,0,0.0,0.0,0.0
13922.0,6,10,2032,5,524,3135.75,252.0,104.8,5,1508,3227.0,1236.0,301.6
123199169.0,6,35,2410,18,1285,7247009.94117647,139.0,71.38888888888889,17,1125,7062313.3125,123.0,66.17647058823529
5626730.0,6,5,336,2,134,0.0,68.0,67.0,3,202,1525728.0,70.0,67.33333333333333
12399.0,6,11,1133,6,602,2479.8,264.0,100.33333333333331,5,531,2352.75,259.0,106.2
102639.0,17,2,286,2,286,0.0,143.0,143.0,0,0,0.0,0.0,0.0
23433.0,6,10,2032,5,524,5650.25,252.0,104.8,5,1508,5287.0,1236.0,301.6
97001932.0,6,28,1992,14,1029,7461687.076923077,123.0,73.5,14,963,7445055.307692308,123.0,68.78571428571429
90045670.0,17,28,13364,28,13364,3335024.814814815,501.0,477.2857142857143,0,0,0.0,0.0,0.0
7169.0,17,2,582,1,83,0.0,83.0,83.0,1,499,0.0,499.0,499.0
102258773.0,17,14,864,7,432,17001010.166666668,174.0,61.71428571428572,7,432,17000162.166666668,174.0,61.71428571428572
220690.0,17,2,180,1,90,0.0,90.0,90.0,1,90,0.0,90.0,90.0
135134961.0,17,6,1206,6,1206,27026992.2,201.0,201.0,0,0,0.0,0.0,0.0
0.0,6,1,66,1,66,0.0,66.0,66.0,0,0,0.0,0.0,0.0
232946.0,6,3,337,2,214,0.0,160.0,107.0,1,123,0.0,123.0,123.0
232752.0,6,4,439,2,238,0.0,172.0,119.0,2,201,0.0,135.0,100.5
11515359.0,17,4,1368,4,1368,3838453.0,342.0,342.0,0,0,0.0,0.0,0.0
121270.0,6,3,373,2,238,0.0,172.0,119.0,1,135,0.0,135.0,135.0
36331.0,6,14,4740,7,653,5928.666666666667,249.0,93.28571428571428,7,4087,5796.833333333333,1514.0,583.8571428571429
153384.0,17,2,180,1,90,0.0,90.0,90.0,1,90,0.0,90.0,90.0
10464711.0,6,7,478,4,272,3441232.6666666665,74.0,68.0,3,206,5161743.5,74.0,68.66666666666667
42819.0,6,12,1393,6,796,7473.6,271.0,132.66666666666666,6,597,7697.2,259.0,99.5
298512.0,6,6,412,4,272,99504.0,74.0,68.0,2,140,0.0,74.0,70.0
49467.0,6,14,4740,7,653,8114.333333333333,249.0,93.28571428571428,7,4087,6922.166666666667,1514.0,583.8571428571429
361760.0,6,11,1021,6,444,48576.4,162.0,74.0,5,577,60555.5,349.0,115.4
103358.0,17,2,286,2,286,0.0,143.0,143.0,0,0,0.0,0.0,0.0
153369.0,17,2,180,1,90,0.0,90.0,90.0,1,90,0.0,90.0,90.0
98164215.0,6,194,22246,97,15622,1020302.0520833334,284.0,161.05154639175257,97,6624,1020302.1875,140.0,68.28865979381443
113504166.0,6,30,1974,15,1026,8092845.357142857,123.0,68.4,15,948,8092843.357142857,123.0,63.2
109204622.0,6,289,34298,145,24572,758365.4305555555,284.0,169.46206896551723,144,9726,756488.6083916083,140.0,67.54166666666667
102917.0,17,2,286,2,286,0.0,143.0,143.0,0,0,0.0,0.0,0.0
107355.0,17,2,286,2,286,0.0,143.0,143.0,0,0,0.0,0.0,0.0
236853.0,6,3,337,2,214,0.0,160.0,107.0,1,123,0.0,123.0,123.0
205949.0,6,3,426,2,280,0.0,214.0,140.0,1,146,0.0,146.0,146.0
298738.0,6,6,412,4,272,99579.33333333331,74.0,68.0,2,140,0.0,74.0,70.0
27430848.0,17,5,1710,5,1710,6857712.0,342.0,342.0,0,0,0.0,0.0,0.0
261360.0,6,11,1287,6,636,52272.0,298.0,106.0,5,651,63476.75,379.0,130.2
232238.0,6,3,373,2,238,0.0,172.0,119.0,1,135,0.0,135.0,135.0
216461.0,17,2,180,1,90,0.0,90.0,90.0,1,90,0.0,90.0,90.0
879690.0,6,10,1333,6,796,175938.0,458.0,132.66666666666666,4,537,201394.3333333333,331.0,134.25
27857.0,6,10,2032,5,524,6061.25,252.0,104.8,5,1508,6495.25,1236.0,301.6
118504784.0,6,214,24202,107,16844,1115938.5377358492,284.0,157.42056074766356,107,7358,1115939.2264150945,140.0,68.76635514018692
51586.0,6,14,4740,7,653,8275.666666666666,249.0,93.28571428571428,7,4087,7820.833333333333,1514.0,583.8571428571429
10515518.0,6,7,478,4,272,3459888.333333333,74.0,68.0,3,206,5189767.0,74.0,68.66666666666667
216666.0,17,2,180,1,90,0.0,90.0,90.0,1,90,0.0,90.0,90.0
219761.0,6,10,1221,6,636,43952.2,298.0,106.0,4,585,71772.33333333333,379.0,146.25
133397.0,6,11,1132,6,556,26679.4,218.0,92.66666666666669,5,576,31838.25,304.0,115.2
316.0,17,2,174,1,79,0.0,79.0,79.0,1,95,0.0,95.0,95.0
148003.0,17,2,180,1,90,0.0,90.0,90.0,1,90,0.0,90.0,90.0
39937.0,6,14,4740,7,653,6204.833333333333,249.0,93.28571428571428,7,4087,6469.333333333333,1514.0,583.8571428571429
2796680.0,6,2,132,1,66,0.0,66.0,66.0,1,66,0.0,66.0,66.0
134357.0,6,12,1447,6,816,25954.2,291.0,136.0,6,631,25849.6,293.0,105.16666666666669
103145438.0,6,28,1860,14,966,7917647.846153846,123.0,69.0,14,894,7917649.461538462,123.0,63.85714285714285
120115264.0,6,16,2490,10,1392,13346140.444444444,188.0,139.2,6,1098,18095911.6,204.0,183.0
27202.0,6,14,4740,7,653,4363.833333333333,249.0,93.28571428571428,7,4087,4040.1666666666665,1514.0,583.8571428571429
317766.0,17,4,1400,4,1400,105922.0,350.0,350.0,0,0,0.0,0.0,0.0
90009015.0,17,28,13364,28,13364,3333667.222222222,501.0,477.2857142857143,0,0,0.0,0.0,0.0
228379.0,17,2,180,1,90,0.0,90.0,90.0,1,90,0.0,90.0,90.0
211911.0,17,2,180,1,90,0.0,90.0,90.0,1,90,0.0,90.0,90.0
10865.0,6,10,1067,5,536,2473.25,264.0,107.2,5,531,2137.5,259.0,106.2
25083.0,6,12,1393,6,796,4582.6,271.0,132.66666666666666,6,597,4626.0,259.0,99.5
242173.0,6,3,337,2,214,0.0,160.0,107.0,1,123,0.0,123.0,123.0
6950.0,17,2,582,1,83,0.0,83.0,83.0,1,499,0.0,499.0,499.0
120586440.0,6,284,33878,142,9668,851033.6028368794,140.0,68.08450704225352,142,24210,849410.7659574468,284.0,170.49295774647888
1022925.0,6,11,1134,6,558,204585.00000000003,220.0,93.0,5,576,255032.75,304.0,115.2
2140801.0,6,24,7545,12,2450,194618.2727272728,1034.0,204.16666666666663,12,5095,166209.54545454544,1510.0,424.5833333333333
2171535.0,6,18,6803,10,1501,241281.66666666663,408.0,150.1,8,5302,252232.8571428572,1514.0,662.75
120137195.0,6,230,25978,115,7886,1047631.5789473684,140.0,68.57391304347826,115,18092,1046595.9736842106,284.0,157.3217391304348
5628396.0,6,5,336,2,134,0.0,68.0,67.0,3,202,1526183.0,70.0,67.33333333333333
3107.0,17,2,224,1,76,0.0,76.0,76.0,1,148,0.0,148.0,148.0
707240.0,6,5,336,2,134,0.0,68.0,67.0,3,202,295346.0,70.0,67.33333333333333
839.0,17,5,550,5,550,209.75,110.0,110.0,0,0,0.0,0.0,0.0
517.0,17,2,508,2,508,0.0,257.0,254.0,0,0,0.0,0.0,0.0
5624057.0,6,4,270,2,134,0.0,68.0,67.0,2,136,0.0,70.0,68.0
37909.0,6,10,2032,5,524,8493.5,252.0,104.8,5,1508,8828.5,1236.0,301.6
17438.0,6,14,4740,7,653,2745.6666666666665,249.0,93.28571428571428,7,4087,2593.5,1514.0,583.8571428571429
69834.0,17,2,180,1,90,0.0,90.0,90.0,1,90,0.0,90.0,90.0
228291.0,17,2,180,1,90,0.0,90.0,90.0,1,90,0.0,90.0,90.0
1313672.0,6,4,264,2,132,0.0,66.0,66.0,2,132,0.0,66.0,66.0
90035435.0,17,28,13364,28,13364,3334645.7407407407,501.0,477.2857142857143,0,0,0.0,0.0,0.0
322817.0,6,7,478,4,272,107605.66666666669,74.0,68.0,3,206,74349.0,74.0,68.66666666666667
9009104.0,17,2,160,2,160,0.0,80.0,80.0,0,0,0.0,0.0,0.0
151479.0,17,2,414,1,88,0.0,88.0,88.0,1,326,0.0,326.0,326.0
328.0,17,2,166,1,75,0.0,75.0,75.0,1,91,0.0,91.0,91.0
29844.0,6,10,1067,5,536,7272.0,264.0,107.2,5,531,6136.0,259.0,106.2
181908.0,17,4,571,2,148,0.0,74.0,74.0,2,423,0.0,276.0,211.5
2874522.0,6,11,2106,6,598,574734.0,252.0,99.66666666666669,5,1508,4266.75,1236.0,301.6
250289.0,6,3,337,2,214,0.0,160.0,107.0,1,123,0.0,123.0,123.0
322886.0,17,4,1400,4,1400,107628.66666666669,350.0,350.0,0,0,0.0,0.0,0.0
2698.0,17,2,762,2,762,0.0,381.0,381.0,0,0,0.0,0.0,0.0
318764.0,17,4,1400,4,1400,106254.66666666669,350.0,350.0,0,0,0.0,0.0,0.0
308130.0,6,6,412,4,272,102710.0,74.0,68.0,2,140,0.0,74.0,70.0
322.0,17,2,174,1,79,0.0,79.0,79.0,1,95,0.0,95.0,95.0
109391738.0,6,395,48890,198,13364,555288.0101522843,140.0,67.4949494949495,197,35526,556712.2704081633,336.0,180.33502538071065
313818.0,17,4,1400,4,1400,104606.0,350.0,350.0,0,0,0.0,0.0,0.0
3165739.0,6,18,1495,9,921,358205.375,315.0,102.33333333333331,9,574,358173.125,78.0,63.77777777777778
105355467.0,17,13,821,7,432,17559244.5,174.0,61.71428571428572,6,389,17118479.8,174.0,64.83333333333333
16263.0,6,14,4740,7,653,2601.6666666666665,249.0,93.28571428571428,7,4087,2515.5,1514.0,583.8571428571429
298578.0,6,6,412,4,272,99526.0,74.0,68.0,2,140,0.0,74.0,70.0
65876.0,6,10,2032,5,524,15391.75,252.0,104.8,5,1508,16191.0,1236.0,301.6
206186.0,17,2,180,1,90,0.0,90.0,90.0,1,90,0.0,90.0,90.0
16623415.999999998,6,5,1736,2,819,0.0,753.0,409.5,3,917,8243779.499999999,785.0,305.6666666666667
302126.0,6,6,412,4,272,100708.66666666669,74.0,68.0,2,140,0.0,74.0,70.0
100994.0,17,2,762,2,762,0.0,381.0,381.0,0,0,0.0,0.0,0.0
349693.0,17,8,12112,8,12112,49956.142857142855,1514.0,1514.0,0,0,0.0,0.0,0.0
153417.0,17,2,180,1,90,0.0,90.0,90.0,1,90,0.0,90.0,90.0
217969.0,6,3,426,2,280,0.0,214.0,140.0,1,146,0.0,146.0,146.0
66551.0,6,14,4740,7,653,9435.666666666666,249.0,93.28571428571428,7,4087,10572.166666666666,1514.0,583.8571428571429
120083077.0,6,248,27938,124,8480,970603.5284552844,140.0,68.38709677419355,124,19458,969594.62601626,284.0,156.9193548387097
22171680.0,6,26,7627,14,3735,198218.0,1514.0,266.7857142857143,12,3892,1997000.4545454544,1514.0,324.3333333333333
50906.0,6,14,4740,7,653,8362.333333333334,249.0,93.28571428571428,7,4087,7804.166666666667,1514.0,583.8571428571429
2802205.0,6,2,132,1,66,0.0,66.0,66.0,1,66,0.0,66.0,66.0
2278.0,17,4,344,2,150,0.0,75.0,75.0,2,194,0.0,103.0,97.0
205805.0,17,2,762,2,762,0.0,381.0,381.0,0,0,0.0,0.0,0.0
121260759.0,6,216,24296,108,7424,1107276.8691588785,140.0,68.74074074074075,108,16872,1125632.710280374,284.0,156.22222222222223
204518.0,17,2,762,2,762,0.0,381.0,381.0,0,0,0.0,0.0,0.0
153459.0,17,2,180,1,90,0.0,90.0,90.0,1,90,0.0,90.0,90.0
305528.0,17,4,704,2,148,0.0,74.0,74.0,2,556,0.0,280.0,278.0
5950.0,17,2,231,1,78,0.0,78.0,78.0,1,153,0.0,153.0,153.0
108978.0,17,2,286,2,286,0.0,143.0,143.0,0,0,0.0,0.0,0.0
233082.0,6,3,337,2,214,0.0,160.0,107.0,1,123,0.0,123.0,123.0
57423.0,6,14,4740,7,653,8607.0,249.0,93.28571428571428,7,4087,9148.333333333334,1514.0,583.8571428571429
107276899.0,6,44,2904,22,1452,5108423.761904762,66.0,66.0,22,1452,5093704.285714285,66.0,66.0
92278910.0,17,14,1126,7,563,15334155.333333334,174.0,80.42857142857143,7,563,15333505.0,174.0,80.42857142857143
42104.0,6,14,4740,7,653,6851.5,249.0,93.28571428571428,7,4087,6251.0,1514.0,583.8571428571429
95387.0,17,2,762,2,762,0.0,381.0,381.0,0,0,0.0,0.0,0.0
15748.000000000002,6,10,2032,5,524,3603.5,252.0,104.8,5,1508,2882.75,1236.0,301.6
31728.0,6,10,2032,5,524,7015.25,252.0,104.8,5,1508,7675.0,1236.0,301.6
5829568.0,6,4,270,2,134,0.0,68.0,67.0,2,136,0.0,70.0,68.0
498314.0,6,3,1604,2,851,0.0,785.0,425.5,1,753,0.0,753.0,753.0
36947.0,6,10,2032,5,524,6057.5,252.0,104.8,5,1508,8746.0,1236.0,301.6
3384526.0,6,7,923,4,753,1055884.0,571.0,188.25,3,170,1584048.0,62.0,56.66666666666666
171555.0,17,2,180,1,90,0.0,90.0,90.0,1,90,0.0,90.0,90.0
100355237.0,17,12,778,6,389,20071047.4,174.0,64.83333333333333,6,389,19963106.0,174.0,64.83333333333333
1403914.0,17,16,1120,16,1120,93594.26666666666,70.0,70.0,0,0,0.0,0.0,0.0
99437.0,17,2,762,2,762,0.0,381.0,381.0,0,0,0.0,0.0,0.0
39171.0,6,10,2032,5,524,9501.0,252.0,104.8,5,1508,8811.5,1236.0,301.6
356.0,17,2,267,1,83,0.0,83.0,83.0,1,184,0.0,184.0,184.0
0.0,17,1,381,1,381,0.0,381.0,381.0,0,0,0.0,0.0,0.0
114016468.0,6,48,3168,24,1584,4957237.739130435,66.0,66.0,24,1584,4943816.782608695,66.0,66.0
337.0,17,2,267,1,83,0.0,83.0,83.0,1,184,0.0,184.0,184.0
90252046.0,6,13,2036,8,1016,12893149.42857143,188.0,127.0,5,1020,22522550.75,204.0,204.0
117320444.0,6,369,46148,185,12506,637494.3858695652,140.0,67.6,184,33642,637916.6338797815,336.0,182.83695652173915
414.0,17,2,508,2,508,0.0,257.0,254.0,0,0,0.0,0.0,0.0
2369648.0,6,25,7573,14,3735,182280.6153846153,1514.0,266.7857142857143,11,3838,212370.2,1514.0,348.90909090909093
380899.0,6,4,508,2,238,0.0,172.0,119.0,2,270,0.0,135.0,135.0
146066.0,6,3,337,2,214,0.0,160.0,107.0,1,123,0.0,123.0,123.0
241654.0,17,2,180,1,90,0.0,90.0,90.0,1,90,0.0,90.0,90.0
538633.0,6,5,336,2,134,0.0,68.0,67.0,3,202,207711.0,70.0,67.33333333333333
308773.0,6,6,412,4,272,102924.33333333331,74.0,68.0,2,140,0.0,74.0,70.0
90094599.0,6,12,1871,5,995,22523070.0,199.0,199.0,7,876,15015337.166666666,204.0,125.14285714285714
205798.0,17,2,180,1,90,0.0,90.0,90.0,1,90,0.0,90.0,90.0
35995.0,6,14,4740,7,653,5876.333333333333,249.0,93.28571428571428,7,4087,5700.333333333333,1514.0,583.8571428571429
539241.0,17,6,2100,6,2100,107848.2,350.0,350.0,0,0,0.0,0.0,0.0
825.0,17,4,438,2,148,0.0,74.0,74.0,2,290,0.0,147.0,145.0
1302513.0,6,4,264,2,132,0.0,66.0,66.0,2,132,0.0,66.0,66.0
245384.0,6,3,337,2,214,0.0,160.0,107.0,1,123,0.0,123.0,123.0
228303.0,17,2,180,1,90,0.0,90.0,90.0,1,90,0.0,90.0,90.0
311216.0,6,6,412,4,272,103738.66666666669,74.0,68.0,2,140,0.0,74.0,70.0
310125.0,17,4,1400,4,1400,103375.0,350.0,350.0,0,0,0.0,0.0,0.0
317979.0,17,4,1400,4,1400,105993.0,350.0,350.0,0,0,0.0,0.0,0.0
116327890.0,6,48,3168,24,1584,5057734.347826087,66.0,66.0,24,1584,5044148.782608695,66.0,66.0
121446.0,6,3,337,2,214,0.0,160.0,107.0,1,123,0.0,123.0,123.0
29215361.0,17,5,1718,4,1368,1749018.0,342.0,342.0,1,350,0.0,350.0,350.0
108097892.0,17,5,1005,5,1005,27024473.0,201.0,201.0,0,0,0.0,0.0,0.0
231883.0,6,3,337,2,214,0.0,160.0,107.0,1,123,0.0,123.0,123.0
103674.0,17,2,286,2,286,0.0,143.0,143.0,0,0,0.0,0.0,0.0
90018323.0,17,28,13364,28,13364,3334011.962962963,501.0,477.2857142857143,0,0,0.0,0.0,0.0
46295.0,6,14,4740,7,653,6965.833333333333,249.0,93.28571428571428,7,4087,7243.833333333333,1514.0,583.8571428571429
128006513.0,17,15,907,8,475,18286644.71428572,174.0,59.375,7,432,18000178.666666668,174.0,61.71428571428572
38016985.0,17,10,4530,10,4530,4224109.444444444,453.0,453.0,0,0,0.0,0.0,0.0
135132170.0,17,6,1206,6,1206,27026434.0,201.0,201.0,0,0,0.0,0.0,0.0
330.0,17,2,208,1,72,0.0,72.0,72.0,1,136,0.0,136.0,136.0
39168.0,6,10,2032,5,524,7055.0,252.0,104.8,5,1508,9531.25,1236.0,301.6
321784.0,17,4,1400,4,1400,107261.33333333331,350.0,350.0,0,0,0.0,0.0,0.0
32425.000000000004,6,10,1066,5,490,5592.25,218.0,98.0,5,576,7891.25,304.0,115.2
5834097.0,6,5,336,2,134,0.0,68.0,67.0,3,202,1525005.0,70.0,67.33333333333333
78.0,17,2,762,2,762,0.0,381.0,381.0,0,0,0.0,0.0,0.0
243704.0,6,3,337,2,214,0.0,160.0,107.0,1,123,0.0,123.0,123.0
120225102.0,6,190,21570,95,6492,1270186.4468085107,140.0,68.33684210526316,95,15078,1260357.5319148935,284.0,158.7157894736842
37392.0,6,14,4740,7,653,6033.5,249.0,93.28571428571428,7,4087,6034.0,1514.0,583.8571428571429
221544.0,6,3,426,2,280,0.0,214.0,140.0,1,146,0.0,146.0,146.0
292462.0,17,2,224,1,76,0.0,76.0,76.0,1,148,0.0,148.0,148.0
217830.0,6,3,426,2,280,0.0,214.0,140.0,1,146,0.0,146.0,146.0
190881.0,17,2,180,1,90,0.0,90.0,90.0,1,90,0.0,90.0,90.0
90962472.0,6,21,1585,11,840,9095033.7,95.0,76.36363636363636,10,745,10106137.444444444,95.0,74.5
2990.0,17,2,224,1,76,0.0,76.0,76.0,1,148,0.0,148.0,148.0
120353608.0,6,250,28250,125,8546,963818.379032258,140.0,68.368,125,19704,963989.8548387096,284.0,157.632
100247943.0,17,14,864,7,432,16668093.666666666,174.0,61.71428571428572,7,432,16666836.333333334,174.0,61.71428571428572
855.0,17,4,820,2,156,0.0,78.0,78.0,2,664,0.0,332.0,332.0
3394354.0,6,158,125064,88,116142,39015.5632183908,1510.0,1319.7954545454545,70,8922,44632.02898550725,1510.0,127.45714285714286
211322.0,17,2,180,1,90,0.0,90.0,90.0,1,90,0.0,90.0,90.0
496.0,17,2,762,2,762,0.0,381.0,381.0,0,0,0.0,0.0,0.0
47239.0,6,11,2098,6,590,8310.8,252.0,98.33333333333331,5,1508,11371.5,1236.0,301.6
153539.0,17,2,180,1,90,0.0,90.0,90.0,1,90,0.0,90.0,90.0
3681047.0,6,5,336,2,134,0.0,68.0,67.0,3,202,1424698.5,70.0,67.33333333333333
125001379.0,17,15,907,8,475,17857339.85714286,174.0,59.375,7,432,17501876.666666668,174.0,61.71428571428572
303628.0,6,2,132,1,66,0.0,66.0,66.0,1,66,0.0,66.0,66.0
1302494.0,6,4,264,2,132,0.0,66.0,66.0,2,132,0.0,66.0,66.0
97054647.0,6,180,20332,90,14244,1088084.4606741574,284.0,158.26666666666668,90,6088,1088084.7415730336,140.0,67.64444444444445
575516.0,6,4,508,2,238,0.0,172.0,119.0,2,270,0.0,135.0,135.0
46600.0,6,14,4740,7,653,6828.5,249.0,93.28571428571428,7,4087,7107.0,1514.0,583.8571428571429
549898.0,17,2,346,1,78,0.0,78.0,78.0,1,268,0.0,268.0,268.0
119895.0,17,2,180,1,70,0.0,70.0,70.0,1,110,0.0,110.0,110.0
40103.0,6,14,4740,7,653,6541.5,249.0,93.28571428571428,7,4087,6184.0,1514.0,583.8571428571429
146237.0,6,3,337,2,214,0.0,160.0,107.0,1,123,0.0,123.0,123.0
5616540.0,6,5,336,2,134,0.0,68.0,67.0,3,202,1525841.5,70.0,67.33333333333333
1625587.0,6,4,276,2,128,0.0,74.0,64.0,2,148,0.0,74.0,74.0
178082.0,17,2,180,1,90,0.0,90.0,90.0,1,90,0.0,90.0,90.0
100742.0,17,2,762,2,762,0.0,381.0,381.0,0,0,0.0,0.0,0.0
5005821.0,17,4,849,2,166,0.0,83.0,83.0,2,683,0.0,499.0,341.5
21503.0,6,10,2032,5,524,4911.5,252.0,104.8,5,1508,4474.75,1236.0,301.6
99338010.0,6,308,36594,154,26208,647930.2810457516,374.0,170.1818181818182,154,10386,647929.7973856209,140.0,67.44155844155844
10580.0,17,4,438,2,148,0.0,74.0,74.0,2,290,0.0,147.0,145.0
311.0,17,2,174,1,79,0.0,79.0,79.0,1,95,0.0,95.0,95.0
145554.0,6,3,337,2,214,0.0,160.0,107.0,1,123,0.0,123.0,123.0
38117.0,6,10,2032,5,524,9266.75,252.0,104.8,5,1508,8850.75,1236.0,301.6
90308682.0,6,16,1192,8,596,12894525.857142856,95.0,74.5,8,596,12899584.714285716,95.0,74.5
114289422.0,6,335,38800,168,11310,684367.7964071856,140.0,67.32142857142857,167,27490,682228.5,480.0,164.61077844311376
457149.0,6,3,1604,2,851,0.0,785.0,425.5,1,753,0.0,753.0,753.0
100523868.0,6,27,2957,13,1452,8359940.416666667,357.0,111.6923076923077,14,1505,7716868.769230769,426.0,107.5
364.0,17,2,214,1,75,0.0,75.0,75.0,1,139,0.0,139.0,139.0
545801.0,6,15,4815,7,742,90395.83333333331,230.0,106.0,8,4073,77209.28571428571,1514.0,509.125
42645.0,6,14,4740,7,653,6434.833333333333,249.0,93.28571428571428,7,4087,6889.166666666667,1514.0,583.8571428571429
144846.0,17,2,180,1,70,0.0,70.0,70.0,1,110,0.0,110.0,110.0
509906.0,6,5,336,2,134,0.0,68.0,67.0,3,202,192140.5,70.0,67.33333333333333
4058448.000000001,6,16,1131,8,586,579497.4285714285,95.0,73.25,8,545,536855.1428571428,95.0,68.125
108680115.0,6,32,2220,16,1149,7230950.2,123.0,71.8125,16,1071,7230950.866666666,123.0,66.9375
12272.0,6,11,1132,6,556,2454.4,218.0,92.66666666666669,5,576,2587.25,304.0,115.2
21174539.0,6,23,7156,14,1789,1628810.6923076925,408.0,127.78571428571428,9,5367,1722272.375,1514.0,596.3333333333334
61432.0,6,10,2032,5,524,15134.0,252.0,104.8,5,1508,13443.0,1236.0,301.6
146144.0,6,3,373,2,238,0.0,172.0,119.0,1,135,0.0,135.0,135.0
101106.0,17,2,762,2,762,0.0,381.0,381.0,0,0,0.0,0.0,0.0
108113577.0,17,5,1005,5,1005,27028394.25,201.0,201.0,0,0,0.0,0.0,0.0
218233.0,17,2,180,1,90,0.0,90.0,90.0,1,90,0.0,90.0,90.0
83263.0,6,14,4740,7,653,12335.166666666666,249.0,93.28571428571428,7,4087,13598.166666666666,1514.0,583.8571428571429
300969.0,6,6,412,4,272,100323.0,74.0,68.0,2,140,0.0,74.0,70.0
3005202.0,6,11,2106,6,598,600756.4,252.0,99.66666666666669,5,1508,2018.75,1236.0,301.6
1027218.0,6,11,1134,6,558,205443.6,220.0,93.0,5,576,254695.75,304.0,115.2
172107.0,17,2,180,1,90,0.0,90.0,90.0,1,90,0.0,90.0,90.0
32091.0,6,14,4740,7,653,4764.666666666667,249.0,93.28571428571428,7,4087,5208.333333333333,1514.0,583.8571428571429
310436.0,17,4,1400,4,1400,103478.66666666669,350.0,350.0,0,0,0.0,0.0,0.0
238165.0,6,3,337,2,214,0.0,160.0,107.0,1,123,0.0,123.0,123.0
46592.0,6,14,4740,7,653,7081.833333333333,249.0,93.28571428571428,7,4087,7389.333333333333,1514.0,583.8571428571429
99203.0,17,2,762,2,762,0.0,381.0,381.0,0,0,0.0,0.0,0.0
1808.0,17,4,344,2,150,0.0,75.0,75.0,2,194,0.0,103.0,97.0
21317.0,6,14,4740,7,653,3099.0,249.0,93.28571428571428,7,4087,3318.1666666666665,1514.0,583.8571428571429
53733.0,6,14,4740,7,653,8426.833333333334,249.0,93.28571428571428,7,4087,8604.333333333334,1514.0,583.8571428571429
93724205.0,6,40,2640,20,1320,4932852.894736842,66.0,66.0,20,1320,4916819.631578947,66.0,66.0
197123.0,17,2,180,1,90,0.0,90.0,90.0,1,90,0.0,90.0,90.0
5831734.0,6,5,336,2,134,0.0,68.0,67.0,3,202,1520229.5,70.0,67.33333333333333
3013.0,17,2,224,1,76,0.0,76.0,76.0,1,148,0.0,148.0,148.0
113001389.0,17,15,1169,8,606,16143055.57142857,174.0,75.75,7,563,15501007.166666666,174.0,80.42857142857143
254512.00000000003,6,3,337,2,214,0.0,160.0,107.0,1,123,0.0,123.0,123.0
2547890.0,6,3,204,2,136,0.0,70.0,68.0,1,68,0.0,68.0,68.0
205454.0,6,3,426,2,280,0.0,214.0,140.0,1,146,0.0,146.0,146.0
146118.0,6,3,337,2,214,0.0,160.0,107.0,1,123,0.0,123.0,123.0
216669.0,17,2,180,1,90,0.0,90.0,90.0,1,90,0.0,90.0,90.0
90258480.0,6,12,1832,8,1016,12894068.57142857,188.0,127.0,4,816,30031993.33333333,204.0,204.0
125280800.0,6,35,2394,18,1269,7369458.823529412,123.0,70.5,17,1125,7192488.75,123.0,66.17647058823529
5643876.0,6,5,336,2,134,0.0,68.0,67.0,3,202,1534661.5,70.0,67.33333333333333
118045984.0,17,14,864,7,432,19666825.33333333,174.0,61.71428571428572,7,432,19668342.0,174.0,61.71428571428572
90048338.0,17,28,13364,28,13364,3335123.6296296297,501.0,477.2857142857143,0,0,0.0,0.0,0.0
103631.0,17,2,286,2,286,0.0,143.0,143.0,0,0,0.0,0.0,0.0
99182925.0,17,12,778,6,389,19800943.8,174.0,64.83333333333333,6,389,19800188.8,174.0,64.83333333333333
328.0,17,2,166,1,75,0.0,75.0,75.0,1,91,0.0,91.0,91.0
317288.0,17,4,1400,4,1400,105762.66666666669,350.0,350.0,0,0,0.0,0.0,0.0
233074.0,6,3,337,2,214,0.0,160.0,107.0,1,123,0.0,123.0,123.0
146790.0,6,3,337,2,214,0.0,160.0,107.0,1,123,0.0,123.0,123.0
101167205.0,6,204,23086,102,16132,999523.4752475248,300.0,158.15686274509804,102,6954,999512.1188118812,140.0,68.17647058823529
2049.0,17,4,344,2,150,0.0,75.0,75.0,2,194,0.0,103.0,97.0
26847.0,6,14,4740,7,653,3814.1666666666665,249.0,93.28571428571428,7,4087,4248.166666666667,1514.0,583.8571428571429
45908.0,6,14,4740,7,653,7482.0,249.0,93.28571428571428,7,4087,6344.333333333333,1514.0,583.8571428571429
362461.0,6,11,1021,6,444,48648.6,162.0,74.0,5,577,60734.5,349.0,115.4
90054242.0,17,28,13364,28,13364,3335342.296296296,501.0,477.2857142857143,0,0,0.0,0.0,0.0
135129872.0,17,6,1146,6,1146,27025974.4,191.0,191.0,0,0,0.0,0.0,0.0
44536.0,6,11,2098,6,590,8907.2,252.0,98.33333333333331,5,1508,8361.25,1236.0,301.6
0.0,6,1,172,1,172,0.0,172.0,172.0,0,0,0.0,0.0,0.0
90008524.0,17,28,13364,28,13364,3333649.037037037,501.0,477.2857142857143,0,0,0.0,0.0,0.0
92799029.0,6,179,20250,90,14154,1042685.7191011236,284.0,157.26666666666668,89,6096,1044007.7045454546,140.0,68.49438202247191
108101350.0,17,5,955,5,955,27025337.5,191.0,191.0,0,0,0.0,0.0,0.0
96148720.0,17,12,778,6,389,19202565.0,174.0,64.83333333333333,6,389,19200149.0,174.0,64.83333333333333
211976.0,17,2,620,1,75,0.0,75.0,75.0,1,545,0.0,545.0,545.0
43224.0,6,10,2032,5,524,9227.25,252.0,104.8,5,1508,10507.25,1236.0,301.6
60073.0,6,10,2032,5,524,13542.75,252.0,104.8,5,1508,14494.5,1236.0,301.6
11617.0,6,11,2098,6,590,2235.2,252.0,98.33333333333331,5,1508,2553.25,1236.0,301.6
90211017.0,6,21,1585,10,745,9996500.111111112,95.0,74.5,11,840,9000633.2,95.0,76.36363636363636
16789.0,6,10,2032,5,524,3970.0,252.0,104.8,5,1508,3884.5,1236.0,301.6
5006068.0,17,4,862,2,164,0.0,82.0,82.0,2,698,0.0,552.0,349.0
90223517.0,6,19,1598,9,650,11247815.25,95.0,72.22222222222223,10,948,10001914.111111112,257.0,94.8
103987965.0,6,44,2904,22,1452,4951807.857142857,66.0,66.0,22,1452,4937476.666666667,66.0,66.0
218494.0,17,2,180,1,90,0.0,90.0,90.0,1,90,0.0,90.0,90.0
1165954.0,6,13,3020,8,2392,166564.85714285713,1514.0,299.0,5,628,222600.5,331.0,125.6
141639.0,6,2,132,1,66,0.0,66.0,66.0,1,66,0.0,66.0,66.0
15213.0,6,14,4740,7,653,2215.833333333333,249.0,93.28571428571428,7,4087,2393.333333333333,1514.0,583.8571428571429
218165.0,17,2,180,1,90,0.0,90.0,90.0,1,90,0.0,90.0,90.0
308674.0,6,6,412,4,272,102891.33333333331,74.0,68.0,2,140,0.0,74.0,70.0
299457.0,6,6,412,4,272,99819.0,74.0,68.0,2,140,0.0,74.0,70.0
511747.0,6,5,336,2,134,0.0,68.0,67.0,3,202,194433.0,70.0,67.33333333333333
153467.0,17,2,180,1,90,0.0,90.0,90.0,1,90,0.0,90.0,90.0
322190.0,17,4,1400,4,1400,107396.66666666669,350.0,350.0,0,0,0.0,0.0,0.0
90257223.0,6,12,1832,8,1016,12893889.0,188.0,127.0,4,816,30031571.33333333,204.0,204.0
30014.0,6,14,4740,7,653,4774.0,249.0,93.28571428571428,7,4087,4861.833333333333,1514.0,583.8571428571429
196833.0,17,2,180,1,90,0.0,90.0,90.0,1,90,0.0,90.0,90.0
40285.0,6,14,4740,7,653,6532.333333333333,249.0,93.28571428571428,7,4087,6082.5,1514.0,583.8571428571429
117356597.0,6,251,28536,126,8562,938852.776,140.0,67.95238095238095,125,19974,938186.0725806452,284.0,159.792
115257309.0,6,216,24386,108,16962,1075160.7289719626,284.0,157.05555555555554,108,7424,1075160.7196261685,140.0,68.74074074074075
206880.0,6,3,426,2,280,0.0,214.0,140.0,1,146,0.0,146.0,146.0
121324.0,6,3,337,2,214,0.0,160.0,107.0,1,123,0.0,123.0,123.0
153509.0,17,2,180,1,90,0.0,90.0,90.0,1,90,0.0,90.0,90.0
46872.0,6,14,4740,7,653,7693.0,249.0,93.28571428571428,7,4087,7280.833333333333,1514.0,583.8571428571429
115561792.0,6,306,36304,153,25910,758923.0263157894,336.0,169.34640522875816,153,10394,758923.9802631579,140.0,67.93464052287581
55534.0,6,14,4740,7,653,9127.666666666666,249.0,93.28571428571428,7,4087,8856.166666666666,1514.0,583.8571428571429
999273.0,6,12,1354,6,723,196787.4,253.0,120.5,6,631,199103.0,293.0,105.16666666666669
38428.0,6,14,4740,7,653,6236.666666666667,249.0,93.28571428571428,7,4087,5671.5,1514.0,583.8571428571429
1564598.0,6,2,132,1,66,0.0,66.0,66.0,1,66,0.0,66.0,66.0
197223.0,17,2,180,1,90,0.0,90.0,90.0,1,90,0.0,90.0,90.0
216797.0,17,2,180,1,90,0.0,90.0,90.0,1,90,0.0,90.0,90.0
39875.0,6,14,4740,7,653,5840.666666666667,249.0,93.28571428571428,7,4087,6132.333333333333,1514.0,583.8571428571429
1302523.0,6,4,264,2,132,0.0,66.0,66.0,2,132,0.0,66.0,66.0
108336421.0,17,7,1452,6,1146,21667284.2,191.0,191.0,1,306,0.0,306.0,306.0
108133.0,17,2,286,2,286,0.0,143.0,143.0,0,0,0.0,0.0,0.0
29295.0,6,10,1065,5,534,7140.75,262.0,106.8,5,531,7108.75,259.0,106.2
106058.0,17,2,700,2,700,0.0,350.0,350.0,0,0,0.0,0.0,0.0
135339.0,6,2,132,1,66,0.0,66.0,66.0,1,66,0.0,66.0,66.0
101456503.0,6,27,2201,12,1063,9223318.454545457,223.0,88.58333333333333,15,1138,7228572.785714285,95.0,75.86666666666666
5821072.0,6,5,336,2,134,0.0,68.0,67.0,3,202,1526134.5,70.0,67.33333333333333
103907.0,17,2,286,2,286,0.0,143.0,143.0,0,0,0.0,0.0,0.0
98889664.0,6,203,22824,102,6954,979105.5841584158,140.0,68.17647058823529,101,15870,979605.38,284.0,157.12871287128712
146159.0,6,3,337,2,214,0.0,160.0,107.0,1,123,0.0,123.0,123.0
302078.0,6,6,412,4,272,100692.66666666669,74.0,68.0,2,140,0.0,74.0,70.0
146160.0,6,3,337,2,214,0.0,160.0,107.0,1,123,0.0,123.0,123.0
38789.0,17,2,582,1,83,0.0,83.0,83.0,1,499,0.0,499.0,499.0
47506.0,6,14,4740,7,653,7795.333333333333,249.0,93.28571428571428,7,4087,7516.0,1514.0,583.8571428571429
111378.0,6,15,4806,8,719,15797.42857142857,249.0,89.875,7,4087,18065.666666666668,1514.0,583.8571428571429
321913.0,17,4,1400,4,1400,107304.33333333331,350.0,350.0,0,0,0.0,0.0,0.0
147311.0,17,4,704,2,148,0.0,74.0,74.0,2,556,0.0,280.0,278.0
369215.0,6,10,1221,6,636,73843.0,298.0,106.0,4,585,121878.66666666669,379.0,146.25
135140935.0,17,6,1146,6,1146,27028187.0,191.0,191.0,0,0,0.0,0.0,0.0
4304.0,17,2,359,1,75,0.0,75.0,75.0,1,284,0.0,284.0,284.0
23501716.0,6,6,1981,4,1087,7833905.333333333,885.0,271.75,2,894,0.0,826.0,447.0
117525395.0,6,22,1639,12,894,10680115.272727272,95.0,74.5,10,745,13057591.555555556,95.0,74.5
310677.0,17,4,1400,4,1400,103559.0,350.0,350.0,0,0,0.0,0.0,0.0
2315.0,17,4,344,2,150,0.0,75.0,75.0,2,194,0.0,103.0,97.0
118058854.0,6,30,1974,15,1026,8417358.357142856,123.0,68.4,15,948,8417358.714285715,123.0,63.2
297800.0,6,6,412,4,272,99266.66666666669,74.0,68.0,2,140,0.0,74.0,70.0
92826.0,17,2,286,2,286,0.0,143.0,143.0,0,0,0.0,0.0,0.0
110793368.0,6,29,1914,15,948,7913812.0,123.0,63.2,14,966,7737708.230769231,123.0,69.0
119925021.0,17,35,16705,35,16705,3527206.5,501.0,477.2857142857143,0,0,0.0,0.0,0.0
6940.0,17,2,582,1,83,0.0,83.0,83.0,1,499,0.0,499.0,499.0
31514.0,6,14,4740,7,653,4279.666666666667,249.0,93.28571428571428,7,4087,4708.666666666667,1514.0,583.8571428571429
90297603.0,6,14,1043,7,542,15049600.5,95.0,77.42857142857143,7,501,14999044.166666666,95.0,71.57142857142857
205534.0,17,2,762,2,762,0.0,381.0,381.0,0,0,0.0,0.0,0.0
103221530.0,6,188,21220,94,14794,1107594.7311827955,284.0,157.38297872340425,94,6426,1107595.0752688171,140.0,68.36170212765957
3008852.0,6,11,2106,6,598,601588.0,252.0,99.66666666666669,5,1508,2892.5,1236.0,301.6
120184110.0,6,280,31670,140,9536,858735.0,140.0,68.11428571428571,140,22134,858699.1942446043,284.0,158.1
153435.0,17,2,180,1,90,0.0,90.0,90.0,1,90,0.0,90.0,90.0
120003586.0,6,28,3340,14,1504,9231045.076923076,332.0,107.42857142857144,14,1836,9211475.307692308,425.0,131.14285714285714
90530337.0,6,13,2036,8,1016,12932905.285714284,188.0,127.0,5,1020,22589741.5,204.0,204.0
484.0,17,2,508,2,508,0.0,257.0,254.0,0,0,0.0,0.0,0.0
2439.0,17,4,344,2,150,0.0,75.0,75.0,2,194,0.0,103.0,97.0
324251.0,17,4,1400,4,1400,108083.66666666669,350.0,350.0,0,0,0.0,0.0,0.0
113370875.0,6,48,3168,24,1584,4929168.478260869,66.0,66.0,24,1584,4919770.739130435,66.0,66.0
35733.0,6,12,1320,6,723,6552.4,253.0,120.5,6,597,6175.6,259.0,99.5
2590030.0,6,2,132,1,66,0.0,66.0,66.0,1,66,0.0,66.0,66.0
232295.0,6,3,337,2,214,0.0,160.0,107.0,1,123,0.0,123.0,123.0
108104918.0,17,5,1005,5,1005,27026229.5,201.0,201.0,0,0,0.0,0.0,0.0
232099.0,6,10,1221,6,636,46419.8,298.0,106.0,4,585,76586.66666666667,379.0,146.25
2034.0,17,4,344,2,150,0.0,75.0,75.0,2,194,0.0,103.0,97.0
47011.0,6,14,4740,7,653,7708.166666666667,249.0,93.28571428571428,7,4087,7325.333333333333,1514.0,583.8571428571429
47608072.0,6,7,1874,3,887,22637998.5,753.0,295.6666666666667,4,987,15008368.333333334,785.0,246.75
216946.0,6,3,426,2,280,0.0,214.0,140.0,1,146,0.0,146.0,146.0
526986.0,17,2,363,1,79,0.0,79.0,79.0,1,284,0.0,284.0,284.0
0.0,6,1,172,1,172,0.0,172.0,172.0,0,0,0.0,0.0,0.0
0.0,6,1,66,1,66,0.0,66.0,66.0,0,0,0.0,0.0,0.0
322.0,17,2,174,1,79,0.0,79.0,79.0,1,95,0.0,95.0,95.0
12464294.0,6,27,7650,15,2049,890306.7142857143,408.0,136.6,12,5601,754051.5454545454,1514.0,466.75
135068.0,6,2,132,1,66,0.0,66.0,66.0,1,66,0.0,66.0,66.0
4494.0,17,4,344,2,150,0.0,75.0,75.0,2,194,0.0,103.0,97.0
90097924.0,6,13,2052,6,1224,18019118.8,204.0,204.0,7,828,14970447.166666666,188.0,118.28571428571428
121375.0,6,3,337,2,214,0.0,160.0,107.0,1,123,0.0,123.0,123.0
308404.0,6,6,412,4,272,102801.33333333331,74.0,68.0,2,140,0.0,74.0,70.0
176234.0,6,2,132,1,66,0.0,66.0,66.0,1,66,0.0,66.0,66.0
49652.0,6,14,4740,7,653,7775.666666666667,249.0,93.28571428571428,7,4087,7664.0,1514.0,583.8571428571429
120005938.0,6,23,1734,12,935,10908897.181818182,95.0,77.91666666666667,11,799,11971648.7,95.0,72.63636363636364
101299748.0,6,30,2106,15,1089,7220291.642857143,123.0,72.6,15,1017,7220266.5,123.0,67.8
307918.0,6,6,412,4,272,102639.33333333331,74.0,68.0,2,140,0.0,74.0,70.0
107265963.0,6,198,22362,99,15606,1092353.8673469387,300.0,157.63636363636363,99,6756,1092354.969387755,140.0,68.24242424242425
90037140.0,6,14,1084,7,542,10039948.5,95.0,77.42857142857143,7,542,14926224.833333334,95.0,77.42857142857143
302414.0,6,2,132,1,66,0.0,66.0,66.0,1,66,0.0,66.0,66.0
135131615.0,17,6,1206,6,1206,27026323.0,201.0,201.0,0,0,0.0,0.0,0.0
148513.0,17,4,6056,4,6056,49504.333333333336,1514.0,1514.0,0,0,0.0,0.0,0.0
91860626.0,17,15,5130,15,5130,6561473.285714285,342.0,342.0,0,0,0.0,0.0,0.0
301010.0,6,6,412,4,272,100336.66666666669,74.0,68.0,2,140,0.0,74.0,70.0
245706.0,6,3,337,2,214,0.0,160.0,107.0,1,123,0.0,123.0,123.0
102594.0,17,2,286,2,286,0.0,143.0,143.0,0,0,0.0,0.0,0.0
119618005.0,17,15,1169,8,606,17065584.0,174.0,75.75,7,563,19334314.5,174.0,80.42857142857143
13692.0,6,12,1393,6,796,2402.6,271.0,132.66666666666666,6,597,2495.6,259.0,99.5
527949.0,17,6,2100,6,2100,105589.8,350.0,350.0,0,0,0.0,0.0,0.0
218092.0,6,3,426,2,280,0.0,214.0,140.0,1,146,0.0,146.0,146.0
93942.0,6,14,4740,7,653,15546.5,249.0,93.28571428571428,7,4087,15170.0,1514.0,583.8571428571429
883430.0,6,10,1333,6,796,176686.0,458.0,132.66666666666666,4,537,202501.3333333333,331.0,134.25
53029.0,6,10,2032,5,524,11529.25,252.0,104.8,5,1508,11878.25,1236.0,301.6
196904.0,17,2,180,1,90,0.0,90.0,90.0,1,90,0.0,90.0,90.0
1142.0,17,2,508,2,508,0.0,257.0,254.0,0,0,0.0,0.0,0.0
107839.0,17,2,286,2,286,0.0,143.0,143.0,0,0,0.0,0.0,0.0
40275.0,6,14,4740,7,653,6544.666666666667,249.0,93.28571428571428,7,4087,6576.333333333333,1514.0,583.8571428571429
3006400.0,6,12,2172,7,664,500607.5,252.0,94.85714285714286,5,1508,5450.5,1236.0,301.6
356.0,17,2,160,1,80,0.0,80.0,80.0,1,80,0.0,80.0,80.0
216449.0,17,2,180,1,90,0.0,90.0,90.0,1,90,0.0,90.0,90.0
3176585.0,6,18,1495,9,921,358314.5,315.0,102.33333333333331,9,574,358294.0,78.0,63.77777777777778
120435388.0,6,223,25278,112,17730,1085003.4954954954,284.0,158.30357142857142,111,7548,1085463.027272727,140.0,68.0
63826.99999999999,6,11,2098,6,590,12258.4,252.0,98.33333333333331,5,1508,15227.75,1236.0,301.6
2799945.0,6,2,132,1,66,0.0,66.0,66.0,1,66,0.0,66.0,66.0
14524.0,6,13,1459,7,862,2229.333333333333,271.0,123.14285714285714,6,597,2737.0,259.0,99.5
209696.0,17,2,180,1,90,0.0,90.0,90.0,1,90,0.0,90.0,90.0
237618.0,6,3,426,2,280,0.0,214.0,140.0,1,146,0.0,146.0,146.0
108111667.0,17,5,955,5,955,27027916.75,191.0,191.0,0,0,0.0,0.0,0.0
4307.0,17,2,180,1,90,0.0,90.0,90.0,1,90,0.0,90.0,90.0
15299.0,6,14,4740,7,653,2440.1666666666665,249.0,93.28571428571428,7,4087,2411.333333333333,1514.0,583.8571428571429
100382891.0,17,12,778,6,389,20000944.4,174.0,64.83333333333333,6,389,20000208.6,174.0,64.83333333333333
228357.0,17,2,180,1,90,0.0,90.0,90.0,1,90,0.0,90.0,90.0
121883.0,6,3,373,2,238,0.0,172.0,119.0,1,135,0.0,135.0,135.0
2055.0,17,4,344,2,150,0.0,75.0,75.0,2,194,0.0,103.0,97.0
214590.0,6,14,4740,7,653,19930.33333333333,249.0,93.28571428571428,7,4087,35225.666666666664,1514.0,583.8571428571429
8527.0,17,4,823,2,163,0.0,89.0,81.5,2,660,0.0,443.0,330.0
62808.0,6,14,4740,7,653,9662.0,249.0,93.28571428571428,7,4087,10030.333333333334,1514.0,583.8571428571429
1030020.0,6,13,1394,7,797,171670.0,253.0,113.85714285714286,6,597,204178.4,259.0,99.5
107162.0,17,2,286,2,286,0.0,143.0,143.0,0,0,0.0,0.0,0.0
108105063.0,17,5,955,5,955,27026265.75,191.0,191.0,0,0,0.0,0.0,0.0
242508.0,6,3,337,2,214,0.0,160.0,107.0,1,123,0.0,123.0,123.0
102988.0,17,2,286,2,286,0.0,143.0,143.0,0,0,0.0,0.0,0.0
149563628.0,6,22,1639,11,840,14956362.8,95.0,76.36363636363636,11,799,11973003.5,95.0,72.63636363636364
335.0,17,2,166,1,75,0.0,75.0,75.0,1,91,0.0,91.0,91.0
2356373.0,6,3,1777,2,951,0.0,885.0,475.5,1,826,0.0,826.0,826.0
169165.0,17,2,414,1,88,0.0,88.0,88.0,1,326,0.0,326.0,326.0
2422.0,17,4,344,2,150,0.0,75.0,75.0,2,194,0.0,103.0,97.0
302.0,17,2,174,1,79,0.0,79.0,79.0,1,95,0.0,95.0,95.0
146416.0,6,3,337,2,214,0.0,160.0,107.0,1,123,0.0,123.0,123.0
20199.0,17,2,582,1,83,0.0,83.0,83.0,1,499,0.0,499.0,499.0
119789958.0,6,26,1937,14,1043,9214612.153846154,95.0,74.5,12,894,10844559.727272728,95.0,74.5
291258.0,6,10,1221,6,636,58251.6,298.0,106.0,4,585,91574.33333333331,379.0,146.25
13887.0,6,13,1459,7,862,2168.333333333333,271.0,123.14285714285714,6,597,2504.0,259.0,99.5
128189946.0,6,38,2716,20,1468,6746839.263157895,139.0,73.4,18,1248,6940552.882352941,123.0,69.33333333333333
120247903.0,6,18,1341,9,691,14999931.5,95.0,76.77777777777777,9,650,14999995.75,95.0,72.22222222222223
251579.0,6,3,337,2,214,0.0,160.0,107.0,1,123,0.0,123.0,123.0
15616.0,6,14,4740,7,653,2492.333333333333,249.0,93.28571428571428,7,4087,2053.6666666666665,1514.0,583.8571428571429
1134453.0,6,20,6434,12,1921,103132.09090909093,620.0,160.08333333333334,8,4513,133777.42857142858,1514.0,564.125
13175.0,6,14,4740,7,653,1990.6666666666667,249.0,93.28571428571428,7,4087,2057.6666666666665,1514.0,583.8571428571429
98486861.0,6,32,2368,16,1228,6565790.733333333,139.0,76.75,16,1140,6551368.666666667,123.0,71.25
28353.0,6,10,2032,5,524,6841.5,252.0,104.8,5,1508,6386.75,1236.0,301.6
62928.0,6,14,4740,7,653,10252.333333333334,249.0,93.28571428571428,7,4087,10276.833333333334,1514.0,583.8571428571429
0.0,17,1,381,1,381,0.0,381.0,381.0,0,0,0.0,0.0,0.0
314486.0,17,4,1400,4,1400,104828.66666666669,350.0,350.0,0,0,0.0,0.0,0.0
134652.0,6,2,132,1,66,0.0,66.0,66.0,1,66,0.0,66.0,66.0
2327.0,17,4,344,2,150,0.0,75.0,75.0,2,194,0.0,103.0,97.0
4450.0,17,2,602,1,72,0.0,72.0,72.0,1,530,0.0,530.0,530.0
311396.0,17,4,1400,4,1400,103798.66666666669,350.0,350.0,0,0,0.0,0.0,0.0
105885.0,17,2,286,2,286,0.0,143.0,143.0,0,0,0.0,0.0,0.0
19747.0,6,14,4740,7,653,2431.833333333333,249.0,93.28571428571428,7,4087,3154.1666666666665,1514.0,583.8571428571429
2834656.0,6,3,1604,1,753,0.0,753.0,753.0,2,851,0.0,785.0,425.5
323219.0,17,2,180,1,90,0.0,90.0,90.0,1,90,0.0,90.0,90.0
11966.0,6,11,1133,6,602,2393.2,264.0,100.33333333333331,5,531,2584.75,259.0,106.2
316373.0,17,4,1400,4,1400,105457.66666666669,350.0,350.0,0,0,0.0,0.0,0.0
29491.0,6,10,2032,5,524,6388.0,252.0,104.8,5,1508,5021.0,1236.0,301.6
120110564.0,6,222,25090,111,7622,1084516.690909091,140.0,68.66666666666667,111,17468,1085485.9545454546,284.0,157.36936936936937
14477.0,6,13,1459,7,862,2295.0,271.0,123.14285714285714,6,597,2050.8,259.0,99.5
103370.0,17,2,286,2,286,0.0,143.0,143.0,0,0,0.0,0.0,0.0
135128309.0,17,6,1206,6,1206,27025661.8,201.0,201.0,0,0,0.0,0.0,0.0
20400.0,6,2,145,2,145,0.0,91.0,72.5,0,0,0.0,0.0,0.0
47875.0,6,14,4740,7,653,6599.333333333333,249.0,93.28571428571428,7,4087,7840.833333333333,1514.0,583.8571428571429
126261795.0,6,39,2902,20,1531,6645357.631578947,139.0,76.55,19,1371,6447859.333333333,123.0,72.15789473684211
119322300.0,6,20,1490,10,745,13258033.333333334,95.0,74.5,10,745,13229884.0,95.0,74.5
1307842.0,6,4,264,2,132,0.0,66.0,66.0,2,132,0.0,66.0,66.0
9584.0,17,2,582,1,83,0.0,83.0,83.0,1,499,0.0,499.0,499.0
108108413.0,17,5,955,5,955,27027103.25,191.0,191.0,0,0,0.0,0.0,0.0
90035545.0,17,28,13364,28,13364,3334649.814814815,501.0,477.2857142857143,0,0,0.0,0.0,0.0
2213.0,17,2,664,1,322,0.0,322.0,322.0,1,342,0.0,342.0,342.0
50277.0,6,14,4740,7,653,8219.166666666666,249.0,93.28571428571428,7,4087,7144.833333333333,1514.0,583.8571428571429
2786.0,17,2,224,1,76,0.0,76.0,76.0,1,148,0.0,148.0,148.0
90041791.0,17,28,13364,28,13364,3334881.1481481483,501.0,477.2857142857143,0,0,0.0,0.0,0.0
90034004.0,17,28,13364,28,13364,3334592.7407407407,501.0,477.2857142857143,0,0,0.0,0.0,0.0
78873.0,6,13,1386,7,789,13145.5,253.0,112.71428571428572,6,597,11747.4,259.0,99.5
239353.0,6,3,337,2,214,0.0,160.0,107.0,1,123,0.0,123.0,123.0
120047708.0,6,48,3168,24,1584,5219465.565217392,66.0,66.0,24,1584,5210068.043478261,66.0,66.0
5620818.0,6,5,336,2,134,0.0,68.0,67.0,3,202,1420479.0,70.0,67.33333333333333
0.0,17,1,453,1,453,0.0,453.0,453.0,0,0,0.0,0.0,0.0
114829524.0,6,47,3102,24,1584,4983206.173913044,66.0,66.0,23,1518,5105432.045454546,66.0,66.0
298213.0,6,6,412,4,272,99404.33333333331,74.0,68.0,2,140,0.0,74.0,70.0
2415.0,17,4,344,2,150,0.0,75.0,75.0,2,194,0.0,103.0,97.0
102264109.0,6,198,22330,99,15574,1041425.193877551,284.0,157.31313131313132,99,6756,1041425.5612244898,140.0,68.24242424242425
29375.0,6,14,4740,7,653,4190.666666666667,249.0,93.28571428571428,7,4087,4694.5,1514.0,583.8571428571429
111001256.0,17,13,821,7,432,18500209.33333333,174.0,61.71428571428572,6,389,20025056.4,174.0,64.83333333333333
1171411.0,6,13,3005,8,2377,167344.42857142858,1514.0,297.125,5,628,224694.5,331.0,125.6
90010000.0,6,17,1287,9,691,11251250.0,95.0,76.77777777777777,8,596,12815957.714285716,95.0,74.5
66376.0,6,10,2032,5,524,16290.75,252.0,104.8,5,1508,16291.75,1236.0,301.6
26927.0,6,14,4740,7,653,3981.3333333333335,249.0,93.28571428571428,7,4087,4305.166666666667,1514.0,583.8571428571429
119262513.0,6,233,26372,117,18494,1028125.1120689656,284.0,158.06837606837607,116,7878,1028127.9217391304,140.0,67.91379310344827
1786951.0,6,22,6443,12,1529,162450.0909090909,357.0,127.41666666666669,10,4914,164695.77777777778,1510.0,491.4
16835.0,17,2,180,1,90,0.0,90.0,90.0,1,90,0.0,90.0,90.0
43129.0,6,14,4740,7,653,7010.333333333333,249.0,93.28571428571428,7,4087,6130.166666666667,1514.0,583.8571428571429
1310035.0,6,4,264,2,132,0.0,66.0,66.0,2,132,0.0,66.0,66.0
7458580.0,6,4,1071,2,120,0.0,66.0,60.0,2,951,0.0,885.0,475.5
304428.0,6,6,412,4,272,101476.0,74.0,68.0,2,140,0.0,74.0,70.0
53423122.0,6,8,1307,8,1307,7631874.571428572,172.0,163.375,0,0,0.0,0.0,0.0
303638.0,6,2,132,1,66,0.0,66.0,66.0,1,66,0.0,66.0,66.0
90313469.0,6,24,1829,13,989,7521854.75,95.0,76.07692307692308,11,840,9002970.5,95.0,76.36363636363636
90301832.0,6,16,1192,8,596,12893286.0,95.0,74.5,8,596,12899469.0,95.0,74.5
108111820.0,17,5,955,5,955,27027955.0,191.0,191.0,0,0,0.0,0.0,0.0
2039081.0,6,25,7065,13,2047,169923.41666666666,575.0,157.46153846153845,12,5018,156389.0909090909,1510.0,418.1666666666667
129628635.0,6,30,2986,15,1971,9259188.214285716,337.0,131.4,15,1015,7111872.0,95.0,67.66666666666667
82648912.0,17,13,4454,12,4104,6774665.181818182,342.0,342.0,1,350,0.0,350.0,350.0
93535.0,6,2,132,1,66,0.0,66.0,66.0,1,66,0.0,66.0,66.0
0.0,17,1,381,1,381,0.0,381.0,381.0,0,0,0.0,0.0,0.0
56768.0,6,10,2032,5,524,13359.0,252.0,104.8,5,1508,13203.5,1236.0,301.6
106571480.0,6,29,1999,15,1017,7612248.571428572,123.0,67.8,14,982,8181029.153846154,139.0,70.14285714285714
271847.0,6,10,1221,6,636,54369.4,298.0,106.0,4,585,84870.0,379.0,146.25
27094.0,6,12,1413,7,882,4515.666666666667,291.0,126.0,5,531,5192.25,259.0,106.2
144319.0,17,2,180,1,90,0.0,90.0,90.0,1,90,0.0,90.0,90.0
285067.0,17,2,363,1,79,0.0,79.0,79.0,1,284,0.0,284.0,284.0
120039528.0,6,21,1585,11,840,11999199.6,95.0,76.36363636363636,10,745,13312138.111111112,95.0,74.5
837315.0,6,5,1742,3,921,418657.5,785.0,307.0,2,821,0.0,753.0,410.5
120212871.0,6,218,24608,109,7490,1096896.5555555555,140.0,68.71559633027523,109,17118,1105131.4351851852,284.0,157.045871559633
319.0,17,2,174,1,79,0.0,79.0,79.0,1,95,0.0,95.0,95.0
30630.0,6,10,2032,5,524,7339.5,252.0,104.8,5,1508,7353.75,1236.0,301.6
106528.0,6,12,1427,6,796,19427.2,271.0,132.66666666666666,6,631,19579.0,293.0,105.16666666666669
90297109.0,6,16,1192,8,596,12891853.0,95.0,74.5,8,596,12897394.714285716,95.0,74.5
41232.0,6,10,2032,5,524,9844.0,252.0,104.8,5,1508,9738.5,1236.0,301.6
90258554.0,6,13,1898,8,1016,12894079.142857144,188.0,127.0,5,882,22524029.75,204.0,176.4
19477.0,17,2,582,1,83,0.0,83.0,83.0,1,499,0.0,499.0,499.0
135131260.0,17,6,1206,6,1206,27026252.0,201.0,201.0,0,0,0.0,0.0,0.0
90017211.0,17,28,13364,28,13364,3333970.777777778,501.0,477.2857142857143,0,0,0.0,0.0,0.0
109585845.0,6,28,1860,14,966,8413076.538461538,123.0,69.0,14,894,8413074.384615384,123.0,63.85714285714285
90042095.0,17,28,13364,28,13364,3334892.407407407,501.0,477.2857142857143,0,0,0.0,0.0,0.0
70825.0,6,12,1320,6,723,12727.0,253.0,120.5,6,597,12023.6,259.0,99.5
207034.0,6,3,426,2,280,0.0,214.0,140.0,1,146,0.0,146.0,146.0
702.0,17,2,762,2,762,0.0,381.0,381.0,0,0,0.0,0.0,0.0
47683.0,6,14,4740,7,653,7789.833333333333,249.0,93.28571428571428,7,4087,4401.0,1514.0,583.8571428571429
147004.0,6,3,337,2,214,0.0,160.0,107.0,1,123,0.0,123.0,123.0
119441373.0,6,211,23824,106,7292,1137536.8857142858,140.0,68.79245283018868,105,16532,1138518.5288461538,284.0,157.44761904761904
55185.0,6,14,4740,7,653,9085.0,249.0,93.28571428571428,7,4087,9021.5,1514.0,583.8571428571429
90258527.0,6,15,2168,8,1016,12894075.285714284,188.0,127.0,7,1152,15009634.666666666,204.0,164.57142857142858
23876.0,6,14,4740,7,653,3406.333333333333,249.0,93.28571428571428,7,4087,3843.3333333333335,1514.0,583.8571428571429
107949.0,17,2,762,2,762,0.0,381.0,381.0,0,0,0.0,0.0,0.0
120000917.0,6,22,1680,12,935,10909174.272727272,95.0,77.91666666666667,10,745,10002020.444444444,95.0,74.5
2598566.0,6,2,132,1,66,0.0,66.0,66.0,1,66,0.0,66.0,66.0
216879.0,6,3,426,2,280,0.0,214.0,140.0,1,146,0.0,146.0,146.0
207300.0,6,3,426,2,280,0.0,214.0,140.0,1,146,0.0,146.0,146.0
108109786.0,17,5,955,5,955,27027446.5,191.0,191.0,0,0,0.0,0.0,0.0
100148499.0,6,30,2122,15,1105,7138058.928571428,139.0,73.66666666666667,15,1017,7138057.642857143,123.0,67.8
13589.0,6,10,2032,5,524,3170.25,252.0,104.8,5,1508,2862.0,1236.0,301.6
105040357.0,6,28,1876,14,982,8064310.461538462,139.0,70.14285714285714,14,894,8064307.384615385,123.0,63.85714285714285
13659.0,6,14,4740,7,653,2023.3333333333333,249.0,93.28571428571428,7,4087,2138.6666666666665,1514.0,583.8571428571429
36537.0,6,14,4740,7,653,5972.5,249.0,93.28571428571428,7,4087,5180.5,1514.0,583.8571428571429
71706.0,6,14,4740,7,653,10714.0,249.0,93.28571428571428,7,4087,11816.0,1514.0,583.8571428571429
456.0,17,2,508,2,508,0.0,257.0,254.0,0,0,0.0,0.0,0.0
294876.0,17,2,180,1,90,0.0,90.0,90.0,1,90,0.0,90.0,90.0
334.0,17,2,166,1,75,0.0,75.0,75.0,1,91,0.0,91.0,91.0
324189.0,6,6,412,4,272,108063.0,74.0,68.0,2,140,0.0,74.0,70.0
14656.0,17,4,823,2,163,0.0,89.0,81.5,2,660,0.0,443.0,330.0
94275636.0,17,12,778,6,389,18855127.2,174.0,64.83333333333333,6,389,18811688.0,174.0,64.83333333333333
0.0,17,1,438,1,438,0.0,438.0,438.0,0,0,0.0,0.0,0.0
103715.0,17,2,286,2,286,0.0,143.0,143.0,0,0,0.0,0.0,0.0
862603.0,6,9,1269,6,798,172520.6,460.0,133.0,3,471,293445.5,331.0,157.0
143986.0,17,2,180,1,90,0.0,90.0,90.0,1,90,0.0,90.0,90.0
103136.0,17,2,762,2,762,0.0,381.0,381.0,0,0,0.0,0.0,0.0
143953.0,17,2,180,1,90,0.0,90.0,90.0,1,90,0.0,90.0,90.0
103788364.0,17,14,864,7,432,17167535.333333332,174.0,61.71428571428572,7,432,17166827.5,174.0,61.71428571428572
108109545.0,17,5,955,5,955,27027386.25,191.0,191.0,0,0,0.0,0.0,0.0
217173.0,6,3,426,2,280,0.0,214.0,140.0,1,146,0.0,146.0,146.0
220821.0,6,13,1386,7,789,36803.5,253.0,112.71428571428572,6,597,42456.2,259.0,99.5
147971.0,17,2,180,1,90,0.0,90.0,90.0,1,90,0.0,90.0,90.0
306975.0,6,2,132,1,66,0.0,66.0,66.0,1,66,0.0,66.0,66.0
22809.0,6,10,2032,5,524,4386.25,252.0,104.8,5,1508,4321.5,1236.0,301.6
36023.0,6,14,4740,7,653,5872.666666666667,249.0,93.28571428571428,7,4087,5869.0,1514.0,583.8571428571429
90255071.0,6,13,2036,8,1016,12893581.57142857,188.0,127.0,5,1020,22523280.0,204.0,204.0
356.0,17,2,267,1,83,0.0,83.0,83.0,1,184,0.0,184.0,184.0
98345912.0,17,12,778,6,389,19600151.4,174.0,64.83333333333333,6,389,19601546.8,174.0,64.83333333333333
94623053.0,17,14,1126,7,563,15668262.5,174.0,80.42857142857143,7,563,15666808.0,174.0,80.42857142857143
73683.0,6,10,2032,5,524,16712.5,252.0,104.8,5,1508,17909.75,1236.0,301.6
319.0,17,2,174,1,79,0.0,79.0,79.0,1,95,0.0,95.0,95.0
2066854.0,6,19,6869,11,1567,206685.4,408.0,142.45454545454547,8,5302,232240.7142857143,1514.0,662.75
147256.0,6,3,373,2,238,0.0,172.0,119.0,1,135,0.0,135.0,135.0
4586027.0,6,4,270,2,134,0.0,68.0,67.0,2,136,0.0,70.0,68.0
18926418.0,17,3,1034,2,684,0.0,342.0,342.0,1,350,0.0,350.0,350.0
2016066.0,17,4,525,2,150,0.0,75.0,75.0,2,375,0.0,284.0,187.5
128013.0,6,2,132,1,66,0.0,66.0,66.0,1,66,0.0,66.0,66.0
316081.0,17,4,1400,4,1400,105360.33333333331,350.0,350.0,0,0,0.0,0.0,0.0
2916.0,17,2,180,1,90,0.0,90.0,90.0,1,90,0.0,90.0,90.0
108118657.0,17,5,1005,5,1005,27029664.25,201.0,201.0,0,0,0.0,0.0,0.0
247122.0,17,2,180,1,90,0.0,90.0,90.0,1,90,0.0,90.0,90.0
108100886.0,17,5,955,5,955,27025221.5,191.0,191.0,0,0,0.0,0.0,0.0
2491.0,17,4,344,2,150,0.0,75.0,75.0,2,194,0.0,103.0,97.0
1314619.0,6,4,264,2,132,0.0,66.0,66.0,2,132,0.0,66.0,66.0
226495.0,6,3,426,2,280,0.0,214.0,140.0,1,146,0.0,146.0,146.0
211775.0,6,11,1131,6,600,42307.6,262.0,100.0,5,531,3307.75,259.0,106.2
27073227.0,17,5,1710,5,1710,6768306.75,342.0,342.0,0,0,0.0,0.0,0.0
20389.0,6,11,2098,6,590,3337.6,252.0,98.33333333333331,5,1508,4859.75,1236.0,301.6
60887.0,6,14,4740,7,653,9821.833333333334,249.0,93.28571428571428,7,4087,7625.333333333333,1514.0,583.8571428571429
220455.0,6,3,426,2,280,0.0,214.0,140.0,1,146,0.0,146.0,146.0
298922.0,6,6,412,4,272,99640.66666666669,74.0,68.0,2,140,0.0,74.0,70.0
298216.0,6,6,412,4,272,99405.33333333331,74.0,68.0,2,140,0.0,74.0,70.0
5626365.0,6,5,336,2,134,0.0,68.0,67.0,3,202,1527732.5,70.0,67.33333333333333
112804843.0,6,33,2280,17,1209,7036803.6875,123.0,71.11764705882354,16,1071,7505938.866666666,123.0,66.9375
2047.0,17,4,344,2,150,0.0,75.0,75.0,2,194,0.0,103.0,97.0
331.0,17,2,267,1,83,0.0,83.0,83.0,1,184,0.0,184.0,184.0
238368.0,6,3,426,2,280,0.0,214.0,140.0,1,146,0.0,146.0,146.0
2439.0,17,4,344,2,150,0.0,75.0,75.0,2,194,0.0,103.0,97.0
90096032.0,6,11,1644,4,816,30031534.33333333,204.0,204.0,7,828,15015607.5,188.0,118.28571428571428
90042186.0,17,28,13364,28,13364,3334895.777777778,501.0,477.2857142857143,0,0,0.0,0.0,0.0
300842.0,6,6,412,4,272,100280.66666666669,74.0,68.0,2,140,0.0,74.0,70.0
288295.0,17,2,363,1,79,0.0,79.0,79.0,1,284,0.0,284.0,284.0
1054744.0,6,11,1134,6,558,210948.8,220.0,93.0,5,576,258077.0,304.0,115.2
3301234.0,6,158,125165,89,116309,37514.02272727273,1510.0,1306.8426966292134,69,8856,44018.44117647059,1510.0,128.34782608695653
52532.0,6,14,4740,7,653,8297.5,249.0,93.28571428571428,7,4087,8328.333333333334,1514.0,583.8571428571429
302133.0,6,6,412,4,272,100711.0,74.0,68.0,2,140,0.0,74.0,70.0
2387.0,17,4,344,2,150,0.0,75.0,75.0,2,194,0.0,103.0,97.0
147928.0,17,2,180,1,90,0.0,90.0,90.0,1,90,0.0,90.0,90.0
9636.0,17,2,582,1,83,0.0,83.0,83.0,1,499,0.0,499.0,499.0
233330.0,6,3,337,2,214,0.0,160.0,107.0,1,123,0.0,123.0,123.0
121322970.0,6,216,24324,108,7436,1116502.887850467,140.0,68.85185185185185,108,16888,1126256.925233645,284.0,156.37037037037038
91170290.0,6,164,18588,82,12954,1122887.172839506,300.0,157.97560975609755,82,5634,1122887.4074074074,140.0,68.70731707317073
39767.0,6,14,4740,7,653,5405.666666666667,249.0,93.28571428571428,7,4087,5995.833333333333,1514.0,583.8571428571429
127433.0,6,10,1066,5,490,31327.5,218.0,98.0,5,576,31653.5,304.0,115.2
3535.0,17,2,414,1,88,0.0,88.0,88.0,1,326,0.0,326.0,326.0
41162.0,6,13,4515,6,512,7711.2,230.0,85.33333333333333,7,4003,6699.166666666667,1514.0,571.8571428571429
153548.0,17,2,180,1,90,0.0,90.0,90.0,1,90,0.0,90.0,90.0
48584.0,6,14,4740,7,653,7973.5,249.0,93.28571428571428,7,4087,7258.333333333333,1514.0,583.8571428571429
55081.0,6,11,2098,6,590,10593.6,252.0,98.33333333333331,5,1508,13356.25,1236.0,301.6
318.0,17,2,174,1,79,0.0,79.0,79.0,1,95,0.0,95.0,95.0
13449.0,6,10,2032,5,524,3053.5,252.0,104.8,5,1508,2961.0,1236.0,301.6
235327.0,17,4,1524,4,1524,78442.33333333333,381.0,381.0,0,0,0.0,0.0,0.0
41055.0,6,14,4740,7,653,6176.333333333333,249.0,93.28571428571428,7,4087,6542.333333333333,1514.0,583.8571428571429
333152.0,17,2,608,1,75,0.0,75.0,75.0,1,533,0.0,533.0,533.0
2647706.0,6,3,1777,1,826,0.0,826.0,826.0,2,951,0.0,885.0,475.5
63122.0,6,13,1394,7,797,10072.333333333334,253.0,113.85714285714286,6,597,11978.6,259.0,99.5
34729.0,6,10,2032,5,524,6885.25,252.0,104.8,5,1508,8118.25,1236.0,301.6
315815.0,17,4,1400,4,1400,105271.66666666669,350.0,350.0,0,0,0.0,0.0,0.0
123455973.0,6,49,3234,25,1650,5143998.875,66.0,66.0,24,1584,5094095.173913044,66.0,66.0
121293.0,6,3,337,2,214,0.0,160.0,107.0,1,123,0.0,123.0,123.0
196993.0,17,2,180,1,90,0.0,90.0,90.0,1,90,0.0,90.0,90.0
44534.0,6,12,1328,7,797,7422.333333333333,253.0,113.85714285714286,5,531,9474.5,259.0,106.2
90043684.0,17,28,13364,28,13364,3334951.25925926,501.0,477.2857142857143,0,0,0.0,0.0,0.0
322.0,17,2,174,1,79,0.0,79.0,79.0,1,95,0.0,95.0,95.0
1283907.0,17,7,490,7,490,213984.5,70.0,70.0,0,0,0.0,0.0,0.0
210078.0,6,3,426,2,280,0.0,214.0,140.0,1,146,0.0,146.0,146.0
108107699.0,17,5,1005,5,1005,27026924.75,201.0,201.0,0,0,0.0,0.0,0.0
107275.0,17,2,286,2,286,0.0,143.0,143.0,0,0,0.0,0.0,0.0
27564786.0,17,5,1710,5,1710,6891196.5,342.0,342.0,0,0,0.0,0.0,0.0
228958.0,17,2,180,1,90,0.0,90.0,90.0,1,90,0.0,90.0,90.0
90027912.0,17,28,13364,28,13364,3334367.111111111,501.0,477.2857142857143,0,0,0.0,0.0,0.0
34577.0,6,14,4740,7,653,5454.666666666667,249.0,93.28571428571428,7,4087,5538.0,1514.0,583.8571428571429
281591.0,6,10,1221,6,636,56318.2,298.0,106.0,4,585,88109.66666666667,379.0,146.25
120213822.0,6,23,1734,11,840,11999783.6,95.0,76.36363636363636,12,894,10908893.545454543,95.0,74.5
90304481.0,6,16,1192,8,596,12893592.57142857,95.0,74.5,8,596,12898793.0,95.0,74.5
3265264.0,6,154,130173,92,121779,35882.02197802198,1510.0,1323.6847826086955,62,8394,48622.47540983607,1510.0,135.38709677419354
2563820.0,6,3,204,1,68,0.0,68.0,68.0,2,136,0.0,70.0,68.0
303371.0,17,4,1400,4,1400,101123.66666666669,350.0,350.0,0,0,0.0,0.0,0.0
121319.0,6,3,337,2,214,0.0,160.0,107.0,1,123,0.0,123.0,123.0
3056396.0,17,2,876,2,876,0.0,438.0,438.0,0,0,0.0,0.0,0.0
204451.0,17,2,762,2,762,0.0,381.0,381.0,0,0,0.0,0.0,0.0
628423.0,17,3,551,2,156,0.0,78.0,78.0,1,395,0.0,395.0,395.0
64370.0,6,14,4740,7,653,9045.0,249.0,93.28571428571428,7,4087,10533.833333333334,1514.0,583.8571428571429
306340.0,17,4,1400,4,1400,102113.33333333331,350.0,350.0,0,0,0.0,0.0,0.0
219411.0,6,3,426,2,280,0.0,214.0,140.0,1,146,0.0,146.0,146.0
116812498.0,6,30,1974,15,1026,8328318.642857143,123.0,68.4,15,948,8328323.785714285,123.0,63.2
237424.0,6,3,373,2,238,0.0,172.0,119.0,1,135,0.0,135.0,135.0
21199.0,6,10,1949,5,441,4585.75,169.0,88.2,5,1508,4757.0,1236.0,301.6
70245.0,6,10,1065,5,534,17385.5,262.0,106.8,5,531,14980.0,259.0,106.2
228138.0,17,2,180,1,90,0.0,90.0,90.0,1,90,0.0,90.0,90.0
135136359.0,17,6,1206,6,1206,27027271.8,201.0,201.0,0,0,0.0,0.0,0.0
15756.0,17,2,498,1,80,0.0,80.0,80.0,1,418,0.0,418.0,418.0
143972.0,17,2,180,1,90,0.0,90.0,90.0,1,90,0.0,90.0,90.0
0.0,17,1,55,1,55,0.0,55.0,55.0,0,0,0.0,0.0,0.0
90035477.0,17,28,13364,28,13364,3334647.296296296,501.0,477.2857142857143,0,0,0.0,0.0,0.0
95207802.0,6,412,51288,206,37470,463404.1658536585,464.0,181.89320388349515,206,13818,463427.1463414634,140.0,67.07766990291262
165994.0,17,2,414,1,88,0.0,88.0,88.0,1,326,0.0,326.0,326.0
284256.0,17,2,363,1,79,0.0,79.0,79.0,1,284,0.0,284.0,284.0
795554.0,6,6,758,3,410,393555.5,172.0,136.66666666666666,3,348,282280.0,135.0,116.0
108108751.0,17,5,1005,5,1005,27027187.75,201.0,201.0,0,0,0.0,0.0,0.0
108101631.0,17,5,955,5,955,27025407.75,191.0,191.0,0,0,0.0,0.0,0.0
322.0,17,2,174,1,79,0.0,79.0,79.0,1,95,0.0,95.0,95.0
2357.0,17,4,344,2,150,0.0,75.0,75.0,2,194,0.0,103.0,97.0
431249.0,6,10,1221,6,636,86249.8,298.0,106.0,4,585,142545.0,379.0,146.25
135123868.0,17,6,1206,6,1206,27024773.6,201.0,201.0,0,0,0.0,0.0,0.0
120120093.0,6,16,2648,8,1632,17160013.285714287,204.0,204.0,8,1016,17136532.57142857,188.0,127.0
31135.0,6,10,1949,5,441,7547.25,169.0,88.2,5,1508,7579.0,1236.0,301.6
12570.0,6,10,2032,5,524,2809.25,252.0,104.8,5,1508,2880.5,1236.0,301.6
104516.0,17,2,700,2,700,0.0,350.0,350.0,0,0,0.0,0.0,0.0
126508643.0,6,46,3696,26,2064,5060345.72,123.0,79.38461538461539,20,1632,6121435.0,123.0,81.6
197547.0,17,2,180,1,90,0.0,90.0,90.0,1,90,0.0,90.0,90.0
2997512.0,6,12,2172,7,664,499386.0,252.0,94.85714285714286,5,1508,2155.0,1236.0,301.6
297911.0,6,6,412,4,272,99303.66666666669,74.0,68.0,2,140,0.0,74.0,70.0
105490.0,17,4,1400,4,1400,35163.333333333336,350.0,350.0,0,0,0.0,0.0,0.0
164874.0,17,2,414,1,88,0.0,88.0,88.0,1,326,0.0,326.0,326.0
35153.0,6,12,1320,7,789,5858.833333333333,253.0,112.71428571428572,5,531,7384.25,259.0,106.2
42562.0,6,14,4740,7,653,6891.166666666667,249.0,93.28571428571428,7,4087,6962.333333333333,1514.0,583.8571428571429
2291.0,17,4,344,2,150,0.0,75.0,75.0,2,194,0.0,103.0,97.0
64219.0,6,11,2098,6,590,12576.6,252.0,98.33333333333331,5,1508,14863.0,1236.0,301.6
147069.0,6,3,373,2,238,0.0,172.0,119.0,1,135,0.0,135.0,135.0
147942.0,17,2,180,1,90,0.0,90.0,90.0,1,90,0.0,90.0,90.0
324.0,17,2,174,1,79,0.0,79.0,79.0,1,95,0.0,95.0,95.0
58788023.0,17,9,3086,8,2736,5110247.285714285,342.0,342.0,1,350,0.0,350.0,350.0
228441.0,17,2,180,1,90,0.0,90.0,90.0,1,90,0.0,90.0,90.0
80381.0,6,10,2032,5,524,19262.75,252.0,104.8,5,1508,19816.75,1236.0,301.6
90252408.0,6,17,2572,9,1204,11281551.0,188.0,133.77777777777777,8,1368,12869757.714285716,204.0,171.0
120375467.0,6,235,26594,118,18650,1028850.1452991453,284.0,158.05084745762713,117,7944,1028722.5948275862,140.0,67.8974358974359
90092883.0,6,11,1644,7,828,15015480.5,188.0,118.28571428571428,4,816,20021208.0,204.0,204.0
96543776.0,17,12,778,6,389,19308755.2,174.0,64.83333333333333,6,389,19140120.6,174.0,64.83333333333333
105106923.0,17,14,4788,14,4788,8085147.923076923,342.0,342.0,0,0,0.0,0.0,0.0
112433991.0,6,210,23630,105,16404,1079128.7788461538,284.0,156.22857142857143,105,7226,1079129.2115384615,140.0,68.81904761904762
37857.0,6,10,2032,5,524,9188.75,252.0,104.8,5,1508,8228.75,1236.0,301.6
39248.0,6,14,4740,7,653,4156.833333333333,249.0,93.28571428571428,7,4087,6403.166666666667,1514.0,583.8571428571429
32480.000000000004,6,10,2032,5,524,6886.5,252.0,104.8,5,1508,7564.0,1236.0,301.6
90797193.0,6,19,1557,10,745,10083252.555555556,95.0,74.5,9,812,11348919.625,216.0,90.22222222222224
217791.0,6,3,426,2,280,0.0,214.0,140.0,1,146,0.0,146.0,146.0
349.0,17,2,267,1,83,0.0,83.0,83.0,1,184,0.0,184.0,184.0
105505.0,17,2,700,2,700,0.0,350.0,350.0,0,0,0.0,0.0,0.0
90072303.0,17,28,13364,28,13364,3336011.222222222,501.0,477.2857142857143,0,0,0.0,0.0,0.0
45807.0,6,14,4740,7,653,7272.833333333333,249.0,93.28571428571428,7,4087,6073.666666666667,1514.0,583.8571428571429
197848.0,17,2,180,1,90,0.0,90.0,90.0,1,90,0.0,90.0,90.0
103199149.0,17,14,1126,7,563,17173171.666666668,174.0,80.42857142857143,7,563,17188406.833333332,174.0,80.42857142857143
298884.0,6,6,412,4,272,99628.0,74.0,68.0,2,140,0.0,74.0,70.0
228062.0,17,2,180,1,90,0.0,90.0,90.0,1,90,0.0,90.0,90.0
19364.0,6,14,4740,7,653,2896.5,249.0,93.28571428571428,7,4087,3067.333333333333,1514.0,583.8571428571429
25139.0,6,14,4740,7,653,3132.333333333333,249.0,93.28571428571428,7,4087,4057.6666666666665,1514.0,583.8571428571429
102185.0,17,2,762,2,762,0.0,381.0,381.0,0,0,0.0,0.0,0.0
754387.0,6,11,1021,6,444,100900.0,162.0,74.0,5,577,126289.25,349.0,115.4
124009741.0,17,15,907,8,475,17715677.285714287,174.0,59.375,7,432,17333493.166666668,174.0,61.71428571428572
233350.0,6,3,337,2,214,0.0,160.0,107.0,1,123,0.0,123.0,123.0
300399.0,17,2,246,1,76,0.0,76.0,76.0,1,170,0.0,170.0,170.0
100527.0,6,11,1131,6,600,19744.4,262.0,100.0,5,531,24633.0,259.0,106.2
1984.0,17,2,691,1,349,0.0,349.0,349.0,1,342,0.0,342.0,342.0
121189.0,6,3,337,2,214,0.0,160.0,107.0,1,123,0.0,123.0,123.0
90049316.0,17,28,13364,28,13364,3335159.851851852,501.0,477.2857142857143,0,0,0.0,0.0,0.0
2147.0,17,4,344,2,150,0.0,75.0,75.0,2,194,0.0,103.0,97.0
825.0,17,4,438,2,148,0.0,74.0,74.0,2,290,0.0,147.0,145.0
93.0,17,2,762,2,762,0.0,381.0,381.0,0,0,0.0,0.0,0.0
211639.0,17,2,180,1,90,0.0,90.0,90.0,1,90,0.0,90.0,90.0
90045006.0,17,28,13364,28,13364,3335000.222222222,501.0,477.2857142857143,0,0,0.0,0.0,0.0
120024.0,17,2,180,1,70,0.0,70.0,70.0,1,110,0.0,110.0,110.0
90059111.0,6,9,1374,6,762,17979871.6,188.0,127.0,3,612,30031814.0,204.0,204.0
108112481.0,17,5,955,5,955,27028120.25,191.0,191.0,0,0,0.0,0.0,0.0
10261.0,6,10,1975,5,467,2214.25,195.0,93.4,5,1508,1882.25,1236.0,301.6
91862737.0,6,24,1829,13,989,7654739.25,95.0,76.07692307692308,11,840,9185892.4,95.0,76.36363636363636
43978.0,6,10,2032,5,524,10741.0,252.0,104.8,5,1508,9719.5,1236.0,301.6
113731367.0,6,46,3036,23,1518,5155424.045454546,66.0,66.0,23,1518,5155421.909090909,66.0,66.0
17868.0,6,10,1067,5,536,4122.0,264.0,107.2,5,531,3088.75,259.0,106.2
30124.0,6,14,4740,7,653,4913.666666666667,249.0,93.28571428571428,7,4087,4131.5,1514.0,583.8571428571429
2942648.0,6,131,95353,68,86893,43920.119402985074,1510.0,1277.8382352941176,63,8460,42524.43548387097,1510.0,134.28571428571428
2444.0,17,4,344,2,150,0.0,75.0,75.0,2,194,0.0,103.0,97.0
99038.0,17,2,700,2,700,0.0,350.0,350.0,0,0,0.0,0.0,0.0
143913.0,17,2,180,1,90,0.0,90.0,90.0,1,90,0.0,90.0,90.0
422058.0,6,3,204,2,136,0.0,70.0,68.0,1,68,0.0,68.0,68.0
90318121.0,6,17,1287,9,691,11284420.625,95.0,76.77777777777777,8,596,12901049.57142857,95.0,74.5
112000993.0,17,13,821,7,432,18666832.166666668,174.0,61.71428571428572,6,389,18399058.2,174.0,64.83333333333333
313076.0,6,3,202,2,128,0.0,74.0,64.0,1,74,0.0,74.0,74.0
1165282.0,6,13,3010,8,2382,166468.85714285713,1514.0,297.75,5,628,222418.0,331.0,125.6
108101560.0,17,5,1005,5,1005,27025390.0,201.0,201.0,0,0,0.0,0.0,0.0
107214.0,17,2,286,2,286,0.0,143.0,143.0,0,0,0.0,0.0,0.0
147077.0,6,3,337,2,214,0.0,160.0,107.0,1,123,0.0,123.0,123.0
313278.0,17,4,1400,4,1400,104426.0,350.0,350.0,0,0,0.0,0.0,0.0
3480198.0,17,3,1026,3,1026,1740099.0,342.0,342.0,0,0,0.0,0.0,0.0
341978.0,17,4,704,2,148,0.0,74.0,74.0,2,556,0.0,280.0,278.0
152002.0,17,2,414,1,88,0.0,88.0,88.0,1,326,0.0,326.0,326.0
108531.0,17,2,286,2,286,0.0,143.0,143.0,0,0,0.0,0.0,0.0
119408000.0,6,221,24806,111,7622,1085527.2727272727,140.0,68.66666666666667,110,17184,1087025.119266055,284.0,156.21818181818182
135135682.0,17,6,1146,6,1146,27027136.4,191.0,191.0,0,0,0.0,0.0,0.0
146156.0,6,3,337,2,214,0.0,160.0,107.0,1,123,0.0,123.0,123.0
108683887.0,6,36,2734,19,1471,6037993.722222222,139.0,77.42105263157895,17,1263,6779222.0625,123.0,74.29411764705883
40306.0,6,14,4740,7,653,6555.0,249.0,93.28571428571428,7,4087,6486.333333333333,1514.0,583.8571428571429
103458.0,17,2,286,2,286,0.0,143.0,143.0,0,0,0.0,0.0,0.0
106392889.0,6,44,2904,22,1452,5066328.047619048,66.0,66.0,22,1452,5051804.0,66.0,66.0
11146.0,6,11,1132,6,556,2054.6,218.0,92.66666666666669,5,576,2532.75,304.0,115.2
123242.0,6,3,373,2,238,0.0,172.0,119.0,1,135,0.0,135.0,135.0
120127970.0,6,14,2240,6,1224,24025594.0,204.0,204.0,8,1016,17098995.85714286,188.0,127.0
121641.0,6,3,337,2,214,0.0,160.0,107.0,1,123,0.0,123.0,123.0
303168.0,6,2,132,1,66,0.0,66.0,66.0,1,66,0.0,66.0,66.0
228351.0,17,2,180,1,90,0.0,90.0,90.0,1,90,0.0,90.0,90.0
108548.0,17,2,762,2,762,0.0,381.0,381.0,0,0,0.0,0.0,0.0
60924.0,6,14,4740,7,653,9989.0,249.0,93.28571428571428,7,4087,7565.166666666667,1514.0,583.8571428571429
5362.0,17,4,344,2,150,0.0,75.0,75.0,2,194,0.0,103.0,97.0
9170.0,17,4,823,2,163,0.0,89.0,81.5,2,660,0.0,443.0,330.0
121347.0,6,3,337,2,214,0.0,160.0,107.0,1,123,0.0,123.0,123.0
1302591.0,6,4,264,2,132,0.0,66.0,66.0,2,132,0.0,66.0,66.0
92108612.0,17,15,5130,15,5130,6579186.571428572,342.0,342.0,0,0,0.0,0.0,0.0
122273.0,6,3,373,2,238,0.0,172.0,119.0,1,135,0.0,135.0,135.0
303635.0,6,6,412,4,272,101211.66666666669,74.0,68.0,2,140,0.0,74.0,70.0
53796.0,6,14,4740,7,653,8847.0,249.0,93.28571428571428,7,4087,8654.166666666666,1514.0,583.8571428571429
3221216.0,6,3,1604,1,753,0.0,753.0,753.0,2,851,0.0,785.0,425.5
2380.0,17,4,344,2,150,0.0,75.0,75.0,2,194,0.0,103.0,97.0
235530.0,6,3,337,2,214,0.0,160.0,107.0,1,123,0.0,123.0,123.0
51503.0,17,2,180,1,90,0.0,90.0,90.0,1,90,0.0,90.0,90.0
303194.0,6,2,132,1,66,0.0,66.0,66.0,1,66,0.0,66.0,66.0
145000.0,17,4,571,2,148,0.0,74.0,74.0,2,423,0.0,276.0,211.5
800.0,17,4,438,2,148,0.0,74.0,74.0,2,290,0.0,147.0,145.0
986891.0,6,11,852,6,453,197048.0,107.0,75.5,5,399,3637.5,127.0,79.8
119562813.0,6,218,24646,109,17156,1105069.8796296297,284.0,157.39449541284404,109,7490,1105070.361111111,140.0,68.71559633027523
90041602.0,17,28,13364,28,13364,3334874.1481481483,501.0,477.2857142857143,0,0,0.0,0.0,0.0
0.0,17,1,342,1,342,0.0,342.0,342.0,0,0,0.0,0.0,0.0
578.0,17,2,267,1,83,0.0,83.0,83.0,1,184,0.0,184.0,184.0
168319.0,17,2,414,1,88,0.0,88.0,88.0,1,326,0.0,326.0,326.0
15678888.0,6,5,1734,2,818,0.0,752.0,409.0,3,916,6544469.0,784.0,305.3333333333333
259832.0,6,10,1221,6,636,51966.4,298.0,106.0,4,585,80851.0,379.0,146.25
207264.0,6,3,426,2,280,0.0,214.0,140.0,1,146,0.0,146.0,146.0
113055654.0,6,35,2526,18,1332,6637644.05882353,123.0,74.0,17,1194,7052478.1875,123.0,70.23529411764706
1772064.0,17,6,1230,3,234,885844.0,78.0,78.0,3,996,885824.0,332.0,332.0
4223.0,17,2,598,1,72,0.0,72.0,72.0,1,526,0.0,526.0,526.0
112083724.0,6,219,24706,110,7482,1028291.0458715596,140.0,68.01818181818182,109,17224,1029421.6851851852,374.0,158.0183486238532
90256669.0,6,13,2036,8,1016,12893809.857142856,188.0,127.0,5,1020,22523018.25,204.0,204.0
113610735.0,6,48,3168,24,1584,4929145.260869565,66.0,66.0,24,1584,4938460.304347826,66.0,66.0
246181.0,6,3,337,2,214,0.0,160.0,107.0,1,123,0.0,123.0,123.0
233794.0,6,3,337,2,214,0.0,160.0,107.0,1,123,0.0,123.0,123.0
314.0,17,2,174,1,79,0.0,79.0,79.0,1,95,0.0,95.0,95.0
38016.0,6,10,2032,5,524,8540.75,252.0,104.8,5,1508,7348.75,1236.0,301.6
15014.0,17,2,180,1,90,0.0,90.0,90.0,1,90,0.0,90.0,90.0
131120.0,6,3,337,2,214,0.0,160.0,107.0,1,123,0.0,123.0,123.0
33551.0,6,14,4740,7,653,5033.666666666667,249.0,93.28571428571428,7,4087,5353.666666666667,1514.0,583.8571428571429
306727.0,6,6,412,4,272,102242.33333333331,74.0,68.0,2,140,0.0,74.0,70.0
366.0,17,2,160,1,80,0.0,80.0,80.0,1,80,0.0,80.0,80.0
177266.0,6,10,1066,5,490,43350.5,218.0,98.0,5,576,44117.5,304.0,115.2
1303169.0,6,4,264,2,132,0.0,66.0,66.0,2,132,0.0,66.0,66.0
8658907.0,17,3,1034,2,684,0.0,342.0,342.0,1,350,0.0,350.0,350.0
332.0,17,2,208,1,72,0.0,72.0,72.0,1,136,0.0,136.0,136.0
300.0,17,2,164,1,82,0.0,82.0,82.0,1,82,0.0,82.0,82.0
118908267.0,6,48,3168,24,1584,5169924.652173913,66.0,66.0,24,1584,5158082.826086956,66.0,66.0
113956821.0,6,31,2166,16,1149,7582745.4,123.0,71.8125,15,1017,8124367.714285715,123.0,67.8
207484.0,6,3,426,2,280,0.0,214.0,140.0,1,146,0.0,146.0,146.0
121783.0,6,3,373,2,238,0.0,172.0,119.0,1,135,0.0,135.0,135.0
209351.0,17,2,180,1,90,0.0,90.0,90.0,1,90,0.0,90.0,90.0
524.0,17,2,508,2,508,0.0,257.0,254.0,0,0,0.0,0.0,0.0
115965357.0,6,33,2280,17,1209,7234235.875,123.0,71.11764705882354,16,1071,7716630.733333333,123.0,66.9375
135136528.0,17,6,1206,6,1206,27027305.6,201.0,201.0,0,0,0.0,0.0,0.0
145496.0,6,2,132,1,66,0.0,66.0,66.0,1,66,0.0,66.0,66.0
10128.0,17,2,571,1,86,0.0,86.0,86.0,1,485,0.0,485.0,485.0
37848.0,6,14,4740,7,653,3664.3333333333335,249.0,93.28571428571428,7,4087,6129.166666666667,1514.0,583.8571428571429
2072.0,17,4,344,2,150,0.0,75.0,75.0,2,194,0.0,103.0,97.0
28883.0,6,10,2032,5,524,6974.75,252.0,104.8,5,1508,6241.25,1236.0,301.6
321646.0,17,4,1400,4,1400,107215.33333333331,350.0,350.0,0,0,0.0,0.0,0.0
9312392.0,17,3,1034,2,684,0.0,342.0,342.0,1,350,0.0,350.0,350.0
235510.0,6,3,337,2,214,0.0,160.0,107.0,1,123,0.0,123.0,123.0
39273.0,6,14,4740,7,653,4680.333333333333,249.0,93.28571428571428,7,4087,6119.833333333333,1514.0,583.8571428571429
120120741.0,6,256,29234,128,8744,940149.062992126,140.0,68.3125,128,20490,939160.2913385826,300.0,160.078125
241634.0,6,3,337,2,214,0.0,160.0,107.0,1,123,0.0,123.0,123.0
349477.0,6,4,508,2,238,0.0,172.0,119.0,2,270,0.0,135.0,135.0
34799.0,6,14,4740,7,653,4744.833333333333,249.0,93.28571428571428,7,4087,5665.166666666667,1514.0,583.8571428571429
43479.0,6,10,2032,5,524,10638.25,252.0,104.8,5,1508,10332.5,1236.0,301.6
121272.0,6,3,337,2,214,0.0,160.0,107.0,1,123,0.0,123.0,123.0
1203979.0,17,7,490,7,490,200663.16666666663,70.0,70.0,0,0,0.0,0.0,0.0
102291673.0,17,14,864,7,432,17000162.666666668,174.0,61.71428571428572,7,432,17001334.333333332,174.0,61.71428571428572
109908823.0,6,32,2220,16,1149,7312872.4,123.0,71.8125,16,1071,7312871.533333333,123.0,66.9375
155447.0,6,3,337,2,214,0.0,160.0,107.0,1,123,0.0,123.0,123.0
298114.0,6,6,412,4,272,99371.33333333331,74.0,68.0,2,140,0.0,74.0,70.0
55597.0,6,14,4740,7,653,8736.666666666666,249.0,93.28571428571428,7,4087,8955.0,1514.0,583.8571428571429
11727.0,6,10,2032,5,524,2637.5,252.0,104.8,5,1508,2575.25,1236.0,301.6
301992.0,6,6,412,4,272,100664.0,74.0,68.0,2,140,0.0,74.0,70.0
90264195.0,6,13,1898,8,1016,12894885.0,188.0,127.0,5,882,22525538.75,204.0,176.4
161336.0,17,2,180,1,90,0.0,90.0,90.0,1,90,0.0,90.0,90.0
90260532.0,6,13,2036,8,1016,12894361.714285716,188.0,127.0,5,1020,22523858.0,204.0,204.0
135137009.0,17,6,1146,6,1146,27027401.8,191.0,191.0,0,0,0.0,0.0,0.0
20843.0,6,14,4740,7,653,3359.5,249.0,93.28571428571428,7,4087,3345.0,1514.0,583.8571428571429
106503.0,17,2,286,2,286,0.0,143.0,143.0,0,0,0.0,0.0,0.0
129009138.0,17,15,907,8,475,18429876.85714286,174.0,59.375,7,432,18166835.83333333,174.0,61.71428571428572
120123362.0,6,16,2356,9,1204,15015420.25,188.0,133.77777777777777,7,1152,15015347.666666666,204.0,164.57142857142858
126716.0,17,4,1524,4,1524,42238.66666666666,381.0,381.0,0,0,0.0,0.0,0.0
301307.0,6,2,1711,1,826,0.0,826.0,826.0,1,885,0.0,885.0,885.0
179840.0,17,2,180,1,90,0.0,90.0,90.0,1,90,0.0,90.0,90.0
102773.0,17,2,286,2,286,0.0,143.0,143.0,0,0,0.0,0.0,0.0
108101129.0,17,5,955,5,955,27025282.25,191.0,191.0,0,0,0.0,0.0,0.0
120205990.0,6,18,1341,9,691,14998852.375,95.0,76.77777777777777,9,650,14998848.25,95.0,72.22222222222223
27688470.0,17,5,1710,5,1710,6922117.5,342.0,342.0,0,0,0.0,0.0,0.0
29370.0,6,12,1413,7,882,4895.0,291.0,126.0,5,531,6233.0,259.0,106.2
233265.0,6,3,337,2,214,0.0,160.0,107.0,1,123,0.0,123.0,123.0
54068.0,6,13,1479,7,882,8894.5,291.0,126.0,6,597,10107.6,259.0,99.5
197025.0,17,2,180,1,90,0.0,90.0,90.0,1,90,0.0,90.0,90.0
52072.0,6,14,4740,7,653,8501.833333333334,249.0,93.28571428571428,7,4087,5827.833333333333,1514.0,583.8571428571429
46264.0,6,14,4740,7,653,6126.5,249.0,93.28571428571428,7,4087,7186.833333333333,1514.0,583.8571428571429
208191.0,6,3,426,2,280,0.0,214.0,140.0,1,146,0.0,146.0,146.0
832.0,17,4,438,2,148,0.0,74.0,74.0,2,290,0.0,147.0,145.0
292949.0,17,2,246,1,76,0.0,76.0,76.0,1,170,0.0,170.0,170.0
45702068.0,17,9,3086,8,2736,5108078.571428572,342.0,342.0,1,350,0.0,350.0,350.0
227458.0,6,13,1394,7,797,37909.66666666666,253.0,113.85714285714286,6,597,42704.0,259.0,99.5
90736116.0,6,177,20388,89,6096,1031092.2272727272,140.0,68.49438202247191,88,14292,1030995.264367816,284.0,162.4090909090909
243939.0,6,3,426,2,280,0.0,214.0,140.0,1,146,0.0,146.0,146.0
90295728.0,6,19,1490,9,650,11281226.375,95.0,72.22222222222223,10,840,10032079.222222222,153.0,84.0
298.0,17,2,156,1,78,0.0,78.0,78.0,1,78,0.0,78.0,78.0
90312348.0,6,16,1192,8,596,12894328.714285716,95.0,74.5,8,596,12900918.857142856,95.0,74.5
300423.0,17,4,1400,4,1400,100141.0,350.0,350.0,0,0,0.0,0.0,0.0
100008312.0,17,11,473,6,258,20001662.4,43.0,43.0,5,215,20000170.25,43.0,43.0
90256630.0,6,13,2036,8,1016,12893804.285714284,188.0,127.0,5,1020,22523035.5,204.0,204.0
207145.0,6,3,426,2,280,0.0,214.0,140.0,1,146,0.0,146.0,146.0
308803.0,6,5,337,3,174,154401.5,66.0,58.0,2,163,0.0,97.0,81.5
508039.0,6,5,336,2,134,0.0,68.0,67.0,3,202,193511.0,70.0,67.33333333333333
105152.0,17,2,762,2,762,0.0,381.0,381.0,0,0,0.0,0.0,0.0
198165.0,17,2,180,1,90,0.0,90.0,90.0,1,90,0.0,90.0,90.0
321195.0,17,4,1400,4,1400,107065.0,350.0,350.0,0,0,0.0,0.0,0.0
29010.0,6,14,4740,7,653,4709.833333333333,249.0,93.28571428571428,7,4087,4096.0,1514.0,583.8571428571429
3100.0,17,2,224,1,76,0.0,76.0,76.0,1,148,0.0,148.0,148.0
10477039.0,6,6,412,3,206,5170523.5,74.0,68.66666666666667,3,206,5170407.5,74.0,68.66666666666667
2333.0,17,4,344,2,150,0.0,75.0,75.0,2,194,0.0,103.0,97.0
930925.0,6,12,2710,7,742,155154.16666666666,338.0,106.0,5,1968,164573.75,1514.0,393.6
307919.0,6,6,412,4,272,102639.66666666669,74.0,68.0,2,140,0.0,74.0,70.0
5620272.0,6,5,336,2,134,0.0,68.0,67.0,3,202,1423323.0,70.0,67.33333333333333
2424.0,17,4,344,2,150,0.0,75.0,75.0,2,194,0.0,103.0,97.0
2355.0,17,4,344,2,150,0.0,75.0,75.0,2,194,0.0,103.0,97.0
33819.0,6,10,2032,5,524,7897.0,252.0,104.8,5,1508,8172.75,1236.0,301.6
840616.0,6,9,1096,6,625,168123.2,287.0,104.16666666666669,3,471,283985.0,331.0,157.0
321809.0,17,4,1400,4,1400,107269.66666666669,350.0,350.0,0,0,0.0,0.0,0.0
241930.0,6,3,373,2,238,0.0,172.0,119.0,1,135,0.0,135.0,135.0
604273.0,6,4,508,2,238,0.0,172.0,119.0,2,270,0.0,135.0,135.0
140753.0,6,2,132,1,66,0.0,66.0,66.0,1,66,0.0,66.0,66.0
85657.0,6,14,4740,7,653,13744.833333333334,249.0,93.28571428571428,7,4087,12845.0,1514.0,583.8571428571429
90025379.0,17,28,13364,28,13364,3334273.296296296,501.0,477.2857142857143,0,0,0.0,0.0,0.0
2802556.0,6,2,132,1,66,0.0,66.0,66.0,1,66,0.0,66.0,66.0
313316.0,17,4,1524,4,1524,104438.66666666669,381.0,381.0,0,0,0.0,0.0,0.0
0.0,17,1,55,1,55,0.0,55.0,55.0,0,0,0.0,0.0,0.0
49473.0,6,14,4740,7,653,8081.166666666667,249.0,93.28571428571428,7,4087,7537.0,1514.0,583.8571428571429
2350.0,17,4,344,2,150,0.0,75.0,75.0,2,194,0.0,103.0,97.0
268286.0,17,6,1230,3,234,133953.0,78.0,78.0,3,996,133926.5,332.0,332.0
103264.0,17,2,286,2,286,0.0,143.0,143.0,0,0,0.0,0.0,0.0
108102357.0,17,5,1005,5,1005,27025589.25,201.0,201.0,0,0,0.0,0.0,0.0
440224.0,6,10,967,5,390,73997.75,162.0,78.0,5,577,73939.5,349.0,115.4
4462.0,17,2,614,1,72,0.0,72.0,72.0,1,542,0.0,542.0,542.0
204536.0,17,2,762,2,762,0.0,381.0,381.0,0,0,0.0,0.0,0.0
147948.0,17,2,180,1,90,0.0,90.0,90.0,1,90,0.0,90.0,90.0
23525.0,6,10,2032,5,524,5578.75,252.0,104.8,5,1508,5305.5,1236.0,301.6
7511.0,17,2,180,1,90,0.0,90.0,90.0,1,90,0.0,90.0,90.0
98810605.0,17,12,778,6,389,19600944.4,174.0,64.83333333333333,6,389,19600169.6,174.0,64.83333333333333
135128218.0,17,6,1146,6,1146,27025643.6,191.0,191.0,0,0,0.0,0.0,0.0
294225.0,17,2,246,1,76,0.0,76.0,76.0,1,170,0.0,170.0,170.0
253355.0,6,3,337,2,214,0.0,160.0,107.0,1,123,0.0,123.0,123.0
279257.0,6,10,1221,6,636,55851.4,298.0,106.0,4,585,87525.0,379.0,146.25
207095.0,6,3,426,2,280,0.0,214.0,140.0,1,146,0.0,146.0,146.0
2498.0,17,4,344,2,150,0.0,75.0,75.0,2,194,0.0,103.0,97.0
120159019.0,6,242,27506,121,8282,994116.7,140.0,68.44628099173553,121,19224,994434.6,284.0,158.87603305785123
101172.0,17,2,762,2,762,0.0,381.0,381.0,0,0,0.0,0.0,0.0
56025.0,6,14,4740,7,653,8360.833333333334,249.0,93.28571428571428,7,4087,9070.0,1514.0,583.8571428571429
204777.0,17,2,762,2,762,0.0,381.0,381.0,0,0,0.0,0.0,0.0
98039307.0,17,12,778,6,389,19600150.6,174.0,64.83333333333333,6,389,19601814.0,174.0,64.83333333333333
312414.0,17,4,622,4,622,104138.0,163.0,155.5,0,0,0.0,0.0,0.0
284488.0,17,4,704,2,148,0.0,74.0,74.0,2,556,0.0,280.0,278.0
298560.0,6,6,412,4,272,99520.0,74.0,68.0,2,140,0.0,74.0,70.0
443244.0,6,10,1221,6,636,88648.8,298.0,106.0,4,585,142282.33333333334,379.0,146.25
47593.0,6,14,4740,7,653,7591.833333333333,249.0,93.28571428571428,7,4087,7445.0,1514.0,583.8571428571429
869.0,17,4,438,2,148,0.0,74.0,74.0,2,290,0.0,147.0,145.0
2473.0,17,4,344,2,150,0.0,75.0,75.0,2,194,0.0,103.0,97.0
250553.00000000003,6,3,337,2,214,0.0,160.0,107.0,1,123,0.0,123.0,123.0
51015.0,17,2,180,1,90,0.0,90.0,90.0,1,90,0.0,90.0,90.0
146147.0,6,3,337,2,214,0.0,160.0,107.0,1,123,0.0,123.0,123.0
408.0,17,2,168,1,84,0.0,84.0,84.0,1,84,0.0,84.0,84.0
90006050.0,17,28,13364,28,13364,3333557.407407407,501.0,477.2857142857143,0,0,0.0,0.0,0.0
25045858.0,17,3,1034,2,684,0.0,342.0,342.0,1,350,0.0,350.0,350.0
90035176.0,17,27,12943,27,12943,3462891.3846153845,501.0,479.3703703703704,0,0,0.0,0.0,0.0
209480.0,17,2,180,1,90,0.0,90.0,90.0,1,90,0.0,90.0,90.0
103212.0,6,14,4740,7,653,17025.5,249.0,93.28571428571428,7,4087,14888.5,1514.0,583.8571428571429
109000982.0,17,13,821,7,432,18166830.33333333,174.0,61.71428571428572,6,389,17801032.0,174.0,64.83333333333333
143163.0,6,2,132,1,66,0.0,66.0,66.0,1,66,0.0,66.0,66.0
90019760.0,17,27,12943,27,12943,3462298.461538461,501.0,479.3703703703704,0,0,0.0,0.0,0.0
34809.0,6,10,2032,5,524,8493.5,252.0,104.8,5,1508,8286.0,1236.0,301.6
10495039.0,6,7,478,4,272,3451007.0,74.0,68.0,3,206,5176440.0,74.0,68.66666666666667
26684.0,6,14,4740,7,653,4226.5,249.0,93.28571428571428,7,4087,3956.5,1514.0,583.8571428571429
102552.0,17,2,762,2,762,0.0,381.0,381.0,0,0,0.0,0.0,0.0
321.0,17,2,174,1,79,0.0,79.0,79.0,1,95,0.0,95.0,95.0
1306997.0,6,4,264,2,132,0.0,66.0,66.0,2,132,0.0,66.0,66.0
90257960.0,6,13,2036,8,1016,12893994.285714284,188.0,127.0,5,1020,22523820.75,204.0,204.0
90056191.0,17,28,13364,28,13364,3335414.4814814813,501.0,477.2857142857143,0,0,0.0,0.0,0.0
3379.0,17,2,414,1,88,0.0,88.0,88.0,1,326,0.0,326.0,326.0
306674.0,6,6,412,4,272,102224.66666666669,74.0,68.0,2,140,0.0,74.0,70.0
39870.0,6,14,4740,7,653,6520.5,249.0,93.28571428571428,7,4087,6395.5,1514.0,583.8571428571429
216726.0,6,3,426,2,280,0.0,214.0,140.0,1,146,0.0,146.0,146.0
104306362.0,6,44,2904,22,1452,4966969.619047619,66.0,66.0,22,1452,4952624.238095238,66.0,66.0
90256205.0,6,13,2036,8,1016,12893743.57142857,188.0,127.0,5,1020,22522780.5,204.0,204.0
19224.0,6,14,4740,7,653,2793.6666666666665,249.0,93.28571428571428,7,4087,3066.333333333333,1514.0,583.8571428571429
90043167.0,17,28,13364,28,13364,3334932.111111111,501.0,477.2857142857143,0,0,0.0,0.0,0.0
2361.0,17,4,344,2,150,0.0,75.0,75.0,2,194,0.0,103.0,97.0
27325421.0,17,5,1710,5,1710,6831355.25,342.0,342.0,0,0,0.0,0.0,0.0
2601682.0,6,2,132,1,66,0.0,66.0,66.0,1,66,0.0,66.0,66.0
319878.0,6,6,412,4,272,106626.0,74.0,68.0,2,140,0.0,74.0,70.0
205930.0,17,2,180,1,90,0.0,90.0,90.0,1,90,0.0,90.0,90.0
34223.0,6,10,2032,5,524,8291.25,252.0,104.8,5,1508,6835.5,1236.0,301.6
104546759.0,6,30,2106,15,1089,7467625.642857143,123.0,72.6,15,1017,7452161.785714285,123.0,67.8
43036.0,6,10,2032,5,524,9761.5,252.0,104.8,5,1508,9983.75,1236.0,301.6
1690444.0,6,20,7599,11,1469,169044.4,583.0,133.54545454545453,9,6130,178893.625,1484.0,681.1111111111111
15096.0,6,11,1132,6,556,3019.2,218.0,92.66666666666669,5,576,3131.25,304.0,115.2
120125133.0,6,14,2224,9,1204,15015641.625,188.0,133.77777777777777,5,1020,22598747.0,204.0,204.0
9857.0,17,4,823,2,163,0.0,89.0,81.5,2,660,0.0,443.0,330.0
108101518.0,17,5,955,5,955,27025379.5,191.0,191.0,0,0,0.0,0.0,0.0
16801.0,6,20,7606,11,978,1680.1,310.0,88.9090909090909,9,6628,1887.0,1514.0,736.4444444444445
143969.0,17,2,180,1,90,0.0,90.0,90.0,1,90,0.0,90.0,90.0
20166.0,6,10,2032,5,524,4270.75,252.0,104.8,5,1508,3726.75,1236.0,301.6
20279.0,6,2,145,2,145,0.0,91.0,72.5,0,0,0.0,0.0,0.0
153451.0,17,2,180,1,90,0.0,90.0,90.0,1,90,0.0,90.0,90.0
10512919.0,6,7,478,4,272,3458769.6666666665,74.0,68.0,3,206,5188080.0,74.0,68.66666666666667
119710760.0,17,35,16705,35,16705,3520904.705882353,501.0,477.2857142857143,0,0,0.0,0.0,0.0
98938.0,17,2,762,2,762,0.0,381.0,381.0,0,0,0.0,0.0,0.0
232915.0,6,4,439,2,238,0.0,172.0,119.0,2,201,0.0,135.0,100.5
135134182.0,17,6,1206,6,1206,27026836.4,201.0,201.0,0,0,0.0,0.0,0.0
0.0,6,1,66,1,66,0.0,66.0,66.0,0,0,0.0,0.0,0.0
111540.0,17,4,1400,4,1400,37180.0,350.0,350.0,0,0,0.0,0.0,0.0
20221.0,6,20,7606,11,978,2022.1,310.0,88.9090909090909,9,6628,2218.625,1514.0,736.4444444444445
119658164.0,6,212,23996,106,16778,1137552.980952381,284.0,158.28301886792454,106,7218,1137552.1523809524,140.0,68.09433962264151
53845.0,6,14,4740,7,653,8843.333333333334,249.0,93.28571428571428,7,4087,7663.666666666667,1514.0,583.8571428571429
90011371.0,6,15,1097,8,596,12858767.285714284,95.0,74.5,7,501,14951517.333333334,95.0,71.57142857142857
0.0,17,1,90,1,90,0.0,90.0,90.0,0,0,0.0,0.0,0.0
103288547.0,17,14,864,7,432,17166825.0,174.0,61.71428571428572,7,432,17167575.833333332,174.0,61.71428571428572
475.0,17,2,156,1,78,0.0,78.0,78.0,1,78,0.0,78.0,78.0
64198.00000000001,6,14,4740,7,653,10565.833333333334,249.0,93.28571428571428,7,4087,9877.666666666666,1514.0,583.8571428571429
90290922.0,6,19,1436,10,745,10026776.666666666,95.0,74.5,9,691,11285169.25,95.0,76.77777777777777
120124221.0,6,14,2240,6,1224,24024844.2,204.0,204.0,8,1016,17136856.285714287,188.0,127.0
51728185.0,6,8,2113,3,960,24540839.0,826.0,320.0,5,1153,12236980.25,885.0,230.6
209550.0,6,3,426,2,280,0.0,214.0,140.0,1,146,0.0,146.0,146.0
90091968.0,6,15,2180,7,1164,15014953.166666666,204.0,166.28571428571428,8,1016,12834787.857142856,188.0,127.0
303086.0,6,2,132,1,66,0.0,66.0,66.0,1,66,0.0,66.0,66.0
2377.0,17,4,344,2,150,0.0,75.0,75.0,2,194,0.0,103.0,97.0
46059.0,6,10,2032,5,524,10904.0,252.0,104.8,5,1508,9762.25,1236.0,301.6
205762.0,17,2,180,1,90,0.0,90.0,90.0,1,90,0.0,90.0,90.0
2183559.0,6,18,6803,10,1501,242617.66666666663,408.0,150.1,8,5302,247359.14285714287,1514.0,662.75
209560.0,17,2,180,1,90,0.0,90.0,90.0,1,90,0.0,90.0,90.0
145550.0,6,3,337,2,214,0.0,160.0,107.0,1,123,0.0,123.0,123.0
0.0,6,1,172,1,172,0.0,172.0,172.0,0,0,0.0,0.0,0.0
90530510.0,6,13,2036,8,1016,12932930.0,188.0,127.0,5,1020,22591661.75,204.0,204.0
6796.0,17,2,582,1,83,0.0,83.0,83.0,1,499,0.0,499.0,499.0
90031588.0,17,27,12943,27,12943,3462753.3846153845,501.0,479.3703703703704,0,0,0.0,0.0,0.0
113254781.0,6,46,3036,23,1518,5135433.7727272725,66.0,66.0,23,1518,5135418.863636363,66.0,66.0
298162.0,6,6,412,4,272,99387.33333333331,74.0,68.0,2,140,0.0,74.0,70.0
228339.0,17,2,180,1,90,0.0,90.0,90.0,1,90,0.0,90.0,90.0
63409955.0,17,11,3770,10,3420,4606696.666666667,342.0,342.0,1,350,0.0,350.0,350.0
23619.0,6,10,2032,5,524,5573.75,252.0,104.8,5,1508,5537.0,1236.0,301.6
90251140.0,6,12,1832,8,1016,12893020.0,188.0,127.0,4,816,30028829.666666668,204.0,204.0
232940.0,6,3,337,2,214,0.0,160.0,107.0,1,123,0.0,123.0,123.0
2806815.0,6,2,132,1,66,0.0,66.0,66.0,1,66,0.0,66.0,66.0
146118.0,6,3,337,2,214,0.0,160.0,107.0,1,123,0.0,123.0,123.0
108100791.0,17,5,1005,5,1005,27025197.75,201.0,201.0,0,0,0.0,0.0,0.0
14946.0,17,2,180,1,90,0.0,90.0,90.0,1,90,0.0,90.0,90.0
577886.0,6,4,508,2,238,0.0,172.0,119.0,2,270,0.0,135.0,135.0
503482.0,6,5,336,2,134,0.0,68.0,67.0,3,202,192758.5,70.0,67.33333333333333
108107696.0,17,5,1005,5,1005,27026924.0,201.0,201.0,0,0,0.0,0.0,0.0
90296799.0,6,21,1585,11,840,9024963.2,95.0,76.36363636363636,10,745,9944953.777777778,95.0,74.5
120556.0,17,2,180,1,70,0.0,70.0,70.0,1,110,0.0,110.0,110.0
25504.0,6,10,1067,5,536,6003.75,264.0,107.2,5,531,5081.25,259.0,106.2
119577978.0,6,20,1490,10,745,13286442.0,95.0,74.5,10,745,13259147.111111112,95.0,74.5
0.0,17,1,55,1,55,0.0,55.0,55.0,0,0,0.0,0.0,0.0
180810.0,6,12,1354,6,723,35015.4,253.0,120.5,6,631,35244.4,293.0,105.16666666666669
99715732.0,6,23,1440,12,717,9065066.545454543,123.0,59.75,11,723,8951466.2,123.0,65.72727272727273
31089.0,6,14,4740,7,653,4874.666666666667,249.0,93.28571428571428,7,4087,5044.166666666667,1514.0,583.8571428571429
52466666.0,17,4,360,2,180,0.0,90.0,90.0,2,180,0.0,90.0,90.0
5622356.0,6,4,270,2,134,0.0,68.0,67.0,2,136,0.0,70.0,68.0
19528.0,6,10,2032,5,524,4653.75,252.0,104.8,5,1508,4598.25,1236.0,301.6
300196.0,6,6,412,4,272,100065.33333333331,74.0,68.0,2,140,0.0,74.0,70.0
120121596.0,6,226,25406,113,7754,1065162.5625,140.0,68.61946902654867,113,17652,1065016.25,284.0,156.21238938053096
337072.0,6,3,204,2,136,0.0,70.0,68.0,1,68,0.0,68.0,68.0
41090.0,6,10,2032,5,524,10011.25,252.0,104.8,5,1508,9887.5,1236.0,301.6
0.0,6,1,66,1,66,0.0,66.0,66.0,0,0,0.0,0.0,0.0
837456.0,6,9,1118,6,586,167491.2,248.0,97.66666666666669,3,532,280923.5,392.0,177.33333333333334
277985.0,17,4,1400,4,1400,92661.66666666669,350.0,350.0,0,0,0.0,0.0,0.0
307755.0,6,6,412,4,272,102585.0,74.0,68.0,2,140,0.0,74.0,70.0
309598.0,6,3,202,2,128,0.0,74.0,64.0,1,74,0.0,74.0,74.0
90295891.0,6,16,1192,8,596,12892782.857142856,95.0,74.5,8,596,12899012.0,95.0,74.5
5625089.0,6,5,336,2,134,0.0,68.0,67.0,3,202,1526924.0,70.0,67.33333333333333
2613155.0,6,3,1604,2,851,0.0,785.0,425.5,1,753,0.0,753.0,753.0
234503.0,6,3,337,2,214,0.0,160.0,107.0,1,123,0.0,123.0,123.0
2049972.0,17,4,820,2,156,0.0,78.0,78.0,2,664,0.0,332.0,332.0
135128485.0,17,6,1146,6,1146,27025697.0,191.0,191.0,0,0,0.0,0.0,0.0
92707773.0,6,37,2442,19,1254,5150431.833333333,66.0,66.0,18,1188,4952648.588235294,66.0,66.0
108132502.0,17,5,955,5,955,27033125.5,191.0,191.0,0,0,0.0,0.0,0.0
123730613.0,6,49,3234,25,1650,5155442.208333333,66.0,66.0,24,1584,5174530.739130435,66.0,66.0
47612.0,17,4,344,2,150,0.0,75.0,75.0,2,194,0.0,103.0,97.0
14665699.0,6,20,1607,10,975,1592395.5555555555,315.0,97.5,10,632,1592408.5555555555,78.0,63.2
115153708.0,6,315,36268,158,10724,733463.1082802548,140.0,67.87341772151899,157,25544,736726.5897435897,284.0,162.70063694267515
123363764.0,6,234,26438,117,8018,1017598.2672413794,140.0,68.52991452991454,117,18420,1056446.0,284.0,157.43589743589743
3873.0,17,5,550,5,550,968.25,110.0,110.0,0,0,0.0,0.0,0.0
108110133.0,17,5,1005,5,1005,27027533.25,201.0,201.0,0,0,0.0,0.0,0.0
197159.0,17,2,180,1,90,0.0,90.0,90.0,1,90,0.0,90.0,90.0
123001097.0,17,15,907,8,475,17571585.285714287,174.0,59.375,7,432,17168257.333333332,174.0,61.71428571428572
2020970.0,17,4,525,2,150,0.0,75.0,75.0,2,375,0.0,284.0,187.5
233191.0,6,3,337,2,214,0.0,160.0,107.0,1,123,0.0,123.0,123.0
2154705.0,6,25,7610,13,2516,179558.75,1034.0,193.53846153846155,12,5094,167241.63636363635,1510.0,424.5
18238.0,6,14,4740,7,653,2816.1666666666665,249.0,93.28571428571428,7,4087,2833.1666666666665,1514.0,583.8571428571429
234000.0,17,2,414,1,88,0.0,88.0,88.0,1,326,0.0,326.0,326.0
90255513.0,6,13,2036,8,1016,12893644.714285716,188.0,127.0,5,1020,22522127.0,204.0,204.0
92389540.0,6,32,2644,18,1474,5434678.823529412,139.0,81.88888888888889,14,1170,7090262.769230769,123.0,83.57142857142857
64705.0,6,10,2032,5,524,15951.25,252.0,104.8,5,1508,15706.25,1236.0,301.6
50167.0,6,14,4740,7,653,8013.666666666667,249.0,93.28571428571428,7,4087,7897.333333333333,1514.0,583.8571428571429
0.0,17,1,72,1,72,0.0,72.0,72.0,0,0,0.0,0.0,0.0
385.0,17,2,283,1,78,0.0,78.0,78.0,1,205,0.0,205.0,205.0
233811.0,6,3,373,2,238,0.0,172.0,119.0,1,135,0.0,135.0,135.0
107388547.0,6,232,26486,116,18608,931939.6608695652,284.0,160.41379310344828,116,7878,931940.5565217392,140.0,67.91379310344827
51386.0,6,10,2032,5,524,12493.25,252.0,104.8,5,1508,11917.5,1236.0,301.6
122530491.0,6,49,3234,25,1650,5105437.125,66.0,66.0,24,1584,4891615.173913044,66.0,66.0
5626566.0,6,4,270,2,134,0.0,68.0,67.0,2,136,0.0,70.0,68.0
27656738.0,17,5,1710,5,1710,6914184.5,342.0,342.0,0,0,0.0,0.0,0.0
117361608.0,17,13,952,7,563,19546547.5,174.0,80.42857142857143,6,389,19600966.6,174.0,64.83333333333333
144335.0,17,2,180,1,90,0.0,90.0,90.0,1,90,0.0,90.0,90.0
143857.0,17,2,180,1,90,0.0,90.0,90.0,1,90,0.0,90.0,90.0
297757.0,6,6,412,4,272,99252.33333333331,74.0,68.0,2,140,0.0,74.0,70.0
90258806.0,6,16,2368,9,1204,11282350.75,188.0,133.77777777777777,7,1164,15015832.0,204.0,166.28571428571428
116376264.0,6,287,34562,144,9800,813820.027972028,140.0,68.05555555555556,143,24762,812268.8028169014,336.0,173.16083916083917
135136225.0,17,6,1206,6,1206,27027245.0,201.0,201.0,0,0,0.0,0.0,0.0
684671.0,17,4,883,2,156,0.0,78.0,78.0,2,727,0.0,395.0,363.5
108107092.0,17,5,955,5,955,27026773.0,191.0,191.0,0,0,0.0,0.0,0.0
153569.0,17,2,180,1,90,0.0,90.0,90.0,1,90,0.0,90.0,90.0
119301268.0,6,225,25378,113,7754,1065189.892857143,140.0,68.61946902654867,112,17624,1065394.945945946,284.0,157.35714285714286
18068.0,6,10,2032,5,524,4268.75,252.0,104.8,5,1508,4195.5,1236.0,301.6
75651.0,6,14,4740,7,653,11382.666666666666,249.0,93.28571428571428,7,4087,10411.333333333334,1514.0,583.8571428571429
2088698.0,6,25,7610,13,2516,174058.16666666666,1034.0,193.53846153846155,12,5094,161175.72727272726,1510.0,424.5
299.0,17,2,168,1,76,0.0,76.0,76.0,1,92,0.0,92.0,92.0
5620194.0,6,5,336,2,134,0.0,68.0,67.0,3,202,1521102.0,70.0,67.33333333333333
15064557.0,17,6,2718,6,2718,3012911.4,453.0,453.0,0,0,0.0,0.0,0.0
328.0,17,2,208,1,72,0.0,72.0,72.0,1,136,0.0,136.0,136.0
218582.0,6,3,426,2,280,0.0,214.0,140.0,1,146,0.0,146.0,146.0
19545.0,17,2,447,1,84,0.0,84.0,84.0,1,363,0.0,363.0,363.0
863476.0,6,9,1270,6,799,172695.2,461.0,133.16666666666666,3,471,294152.5,331.0,157.0
108835.0,17,2,286,2,286,0.0,143.0,143.0,0,0,0.0,0.0,0.0
102472738.0,6,33,2428,17,1288,6404546.125,139.0,75.76470588235294,16,1140,6817780.333333333,123.0,71.25
9658.0,17,4,823,2,163,0.0,89.0,81.5,2,660,0.0,443.0,330.0
1189856.0,6,13,1386,7,789,198309.3333333333,253.0,112.71428571428572,6,597,235377.8,259.0,99.5
228166.0,17,2,359,1,75,0.0,75.0,75.0,1,284,0.0,284.0,284.0
12746.0,6,10,1066,5,490,2728.25,218.0,98.0,5,576,2774.0,304.0,115.2
309391.0,6,6,412,4,272,103130.33333333331,74.0,68.0,2,140,0.0,74.0,70.0
18938.0,6,2,145,2,145,0.0,91.0,72.5,0,0,0.0,0.0,0.0
90253171.0,6,12,1832,8,1016,12893310.142857144,188.0,127.0,4,816,30026080.666666668,204.0,204.0
35837.0,6,14,4740,7,653,5522.833333333333,249.0,93.28571428571428,7,4087,5410.666666666667,1514.0,583.8571428571429
306.0,17,2,174,1,79,0.0,79.0,79.0,1,95,0.0,95.0,95.0
4517.0,17,4,834,2,144,0.0,72.0,72.0,2,690,0.0,554.0,345.0
362068.0,6,11,1021,6,444,48609.6,162.0,74.0,5,577,60673.0,349.0,115.4
90294559.0,6,16,1192,8,596,12892310.42857143,95.0,74.5,8,596,12898772.42857143,95.0,74.5
90736164.0,6,24,1829,13,989,7557980.0,95.0,76.07692307692308,11,840,9045235.4,95.0,76.36363636363636
120000389.0,6,17,1246,9,650,15000048.625,95.0,72.22222222222223,8,596,17106125.14285714,95.0,74.5
200742.0,17,4,1524,4,1524,66914.0,381.0,381.0,0,0,0.0,0.0,0.0
196899.0,17,2,180,1,90,0.0,90.0,90.0,1,90,0.0,90.0,90.0
135135819.0,17,6,1206,6,1206,27027163.8,201.0,201.0,0,0,0.0,0.0,0.0
105556925.0,6,29,2068,15,1105,7523923.142857143,139.0,73.66666666666667,14,963,8102687.769230769,123.0,68.78571428571429
90034476.0,17,28,13364,28,13364,3334610.222222222,501.0,477.2857142857143,0,0,0.0,0.0,0.0
106818406.0,6,204,23092,102,7028,1049485.6732673268,140.0,68.90196078431373,102,16064,1049561.099009901,284.0,157.49019607843138
115982803.0,6,48,3168,24,1584,5042730.565217392,66.0,66.0,24,1584,5030752.434782608,66.0,66.0
112983760.0,6,45,2970,23,1518,5135625.454545454,66.0,66.0,22,1452,5219408.666666667,66.0,66.0
209459.0,17,2,180,1,90,0.0,90.0,90.0,1,90,0.0,90.0,90.0
437008.0,6,10,967,5,390,73188.75,162.0,78.0,5,577,73104.5,349.0,115.4
90048339.0,17,28,13364,28,13364,3335123.6666666665,501.0,477.2857142857143,0,0,0.0,0.0,0.0
220399.0,17,2,180,1,90,0.0,90.0,90.0,1,90,0.0,90.0,90.0
303753.0,6,6,412,4,272,101251.0,74.0,68.0,2,140,0.0,74.0,70.0
109649927.0,6,27,1822,14,982,8418010.153846154,139.0,70.14285714285714,13,840,9119513.333333334,123.0,64.61538461538461
805.0,17,4,438,2,148,0.0,74.0,74.0,2,290,0.0,147.0,145.0
318290.0,6,6,412,4,272,106096.66666666669,74.0,68.0,2,140,0.0,74.0,70.0
1164561.0,6,13,3011,8,2383,166365.85714285713,1514.0,297.875,5,628,222984.75,331.0,125.6
103442.0,17,2,286,2,286,0.0,143.0,143.0,0,0,0.0,0.0,0.0
90745401.0,6,22,1680,12,935,8245628.727272727,95.0,77.91666666666667,10,745,10051759.111111112,95.0,74.5
146164.0,6,3,337,2,214,0.0,160.0,107.0,1,123,0.0,123.0,123.0
40719.0,6,14,4740,7,653,6665.5,249.0,93.28571428571428,7,4087,5983.166666666667,1514.0,583.8571428571429
18030.0,6,2,145,2,145,0.0,91.0,72.5,0,0,0.0,0.0,0.0
14641596.0,6,20,1607,10,975,1592698.4444444445,315.0,97.5,10,632,1592653.6666666667,78.0,63.2
108095094.0,17,5,1005,5,1005,27023773.5,201.0,201.0,0,0,0.0,0.0,0.0
32360.0,6,13,1479,7,882,5393.333333333333,291.0,126.0,6,597,5041.8,259.0,99.5
91380831.0,6,22,1680,12,935,8306658.181818182,95.0,77.91666666666667,10,745,10152255.888888888,95.0,74.5
298205.0,6,6,412,4,272,99401.66666666669,74.0,68.0,2,140,0.0,74.0,70.0
135300.0,6,2,132,1,66,0.0,66.0,66.0,1,66,0.0,66.0,66.0
308189.0,6,6,412,4,272,102729.66666666669,74.0,68.0,2,140,0.0,74.0,70.0
322996.0,17,4,1400,4,1400,107665.33333333331,350.0,350.0,0,0,0.0,0.0,0.0
100405.0,17,2,762,2,762,0.0,381.0,381.0,0,0,0.0,0.0,0.0
108128875.0,17,5,1005,5,1005,27032218.75,201.0,201.0,0,0,0.0,0.0,0.0
205508.0,17,2,762,2,762,0.0,381.0,381.0,0,0,0.0,0.0,0.0
153380.0,17,2,180,1,90,0.0,90.0,90.0,1,90,0.0,90.0,90.0
251190.00000000003,6,3,373,2,238,0.0,172.0,119.0,1,135,0.0,135.0,135.0
1595601.0,6,4,492,2,280,0.0,214.0,140.0,2,212,0.0,146.0,106.0
90281415.0,6,16,1192,8,596,12890936.714285716,95.0,74.5,8,596,12896562.857142856,95.0,74.5
143890.0,17,2,180,1,90,0.0,90.0,90.0,1,90,0.0,90.0,90.0
108106490.0,17,5,955,5,955,27026622.5,191.0,191.0,0,0,0.0,0.0,0.0
2590842.0,6,2,132,1,66,0.0,66.0,66.0,1,66,0.0,66.0,66.0
147965.0,17,2,180,1,90,0.0,90.0,90.0,1,90,0.0,90.0,90.0
121347191.0,6,38,2848,18,1317,6550671.647058823,123.0,73.16666666666667,20,1531,5982045.210526316,139.0,76.55
120059988.0,6,208,23440,104,7086,1157596.4660194174,140.0,68.13461538461539,104,16354,1158419.145631068,284.0,157.25
148016.0,17,2,180,1,90,0.0,90.0,90.0,1,90,0.0,90.0,90.0
106377.0,17,2,286,2,286,0.0,143.0,143.0,0,0,0.0,0.0,0.0
120118628.0,6,13,2036,8,1016,17136591.57142857,188.0,127.0,5,1020,22520796.0,204.0,204.0
120466405.0,6,223,25262,112,17640,1085282.9279279278,284.0,157.5,111,7622,1085810.9545454546,140.0,68.66666666666667
59396.0,6,12,1413,6,816,11235.6,291.0,136.0,6,597,9646.0,259.0,99.5
16178.999999999998,6,14,4740,7,653,2402.1666666666665,249.0,93.28571428571428,7,4087,2552.1666666666665,1514.0,583.8571428571429
101606.0,17,2,286,2,286,0.0,143.0,143.0,0,0,0.0,0.0,0.0
9544.0,6,10,1066,5,490,2222.75,218.0,98.0,5,576,2109.0,304.0,115.2
2150856.0,6,18,6803,10,1501,238984.0,408.0,150.1,8,5302,244489.14285714287,1514.0,662.75
119393885.0,17,14,864,7,432,19834290.0,174.0,61.71428571428572,7,432,19833500.83333333,174.0,61.71428571428572
315.0,17,2,174,1,79,0.0,79.0,79.0,1,95,0.0,95.0,95.0
14641166.0,6,20,1607,10,975,1592806.6666666667,315.0,97.5,10,632,1592777.4444444445,78.0,63.2
4288355.0,6,26,5155,14,2631,329873.4615384616,580.0,187.92857142857144,12,2524,371015.0909090909,732.0,210.3333333333333
2937686.0,6,4,264,4,264,979228.6666666666,66.0,66.0,0,0,0.0,0.0,0.0
90793385.0,6,19,1436,10,745,10082281.666666666,95.0,74.5,9,691,11348191.875,95.0,76.77777777777777
3255.0,17,2,346,1,78,0.0,78.0,78.0,1,268,0.0,268.0,268.0
216728.0,17,2,180,1,90,0.0,90.0,90.0,1,90,0.0,90.0,90.0
120261614.0,6,214,24202,107,7358,1126850.8679245282,140.0,68.76635514018692,107,16844,1126821.3867924528,284.0,157.42056074766356
21122.0,6,14,4740,7,653,3316.1666666666665,249.0,93.28571428571428,7,4087,3375.6666666666665,1514.0,583.8571428571429
97256718.0,6,412,55122,206,13818,473789.46341463417,140.0,67.07766990291262,206,41304,474339.3804878049,336.0,200.50485436893203
90258365.0,6,12,1832,8,1016,12894052.142857144,188.0,127.0,4,816,30030694.33333333,204.0,204.0
90028102.0,17,28,13364,28,13364,3334374.1481481483,501.0,477.2857142857143,0,0,0.0,0.0,0.0
306269.0,6,6,412,4,272,102089.66666666669,74.0,68.0,2,140,0.0,74.0,70.0
119676111.0,6,34,2488,18,1348,7027064.764705882,139.0,74.88888888888889,16,1140,7964007.266666667,123.0,71.25
101112536.0,17,14,864,7,432,16834271.0,174.0,61.71428571428572,7,432,16833567.0,174.0,61.71428571428572
24054.0,6,14,4740,7,653,3294.333333333333,249.0,93.28571428571428,7,4087,3696.6666666666665,1514.0,583.8571428571429
301.0,17,2,156,1,78,0.0,78.0,78.0,1,78,0.0,78.0,78.0
207458.0,6,3,426,2,280,0.0,214.0,140.0,1,146,0.0,146.0,146.0
122227.0,6,3,373,2,238,0.0,172.0,119.0,1,135,0.0,135.0,135.0
206353.0,6,3,426,2,280,0.0,214.0,140.0,1,146,0.0,146.0,146.0
10638.0,6,11,2098,6,590,1942.4,252.0,98.33333333333331,5,1508,2262.75,1236.0,301.6
236963.0,17,2,180,1,90,0.0,90.0,90.0,1,90,0.0,90.0,90.0
46545.0,6,14,4740,7,653,7588.0,249.0,93.28571428571428,7,4087,7500.833333333333,1514.0,583.8571428571429
0.0,6,1,66,1,66,0.0,66.0,66.0,0,0,0.0,0.0,0.0
120000917.0,17,13,821,7,432,20000152.83333333,174.0,61.71428571428572,6,389,20001027.8,174.0,64.83333333333333
2075883.0,6,18,6803,10,1501,230653.66666666663,408.0,150.1,8,5302,236374.14285714287,1514.0,662.75
10419472.0,6,6,412,3,206,5141520.0,74.0,68.66666666666667,3,206,5141422.0,74.0,68.66666666666667
104172925.0,6,44,2904,22,1452,4960615.476190476,66.0,66.0,22,1452,4945876.142857143,66.0,66.0
90034374.0,17,27,12943,27,12943,3462860.5384615385,501.0,479.3703703703704,0,0,0.0,0.0,0.0
120315624.0,6,267,30210,134,21210,904628.7518796992,300.0,158.28358208955223,133,9000,903608.1666666666,140.0,67.66917293233082
303681.0,6,2,132,1,66,0.0,66.0,66.0,1,66,0.0,66.0,66.0
27576.0,6,10,2032,5,524,5969.25,252.0,104.8,5,1508,4615.75,1236.0,301.6
284203.0,6,10,1221,6,636,56840.6,298.0,106.0,4,585,89030.0,379.0,146.25
318177.0,17,4,1400,4,1400,106059.0,350.0,350.0,0,0,0.0,0.0,0.0
96387892.0,17,12,778,6,389,19200161.8,174.0,64.83333333333333,6,389,19201179.6,174.0,64.83333333333333
322006.0,17,4,1400,4,1400,107335.33333333331,350.0,350.0,0,0,0.0,0.0,0.0
334.0,17,2,166,1,75,0.0,75.0,75.0,1,91,0.0,91.0,91.0
43377.0,6,14,4740,7,653,6870.0,249.0,93.28571428571428,7,4087,6827.666666666667,1514.0,583.8571428571429
345.0,17,2,250,1,93,0.0,93.0,93.0,1,157,0.0,157.0,157.0
113168325.0,6,46,3036,23,1518,5144003.7727272725,66.0,66.0,23,1518,5143992.954545454,66.0,66.0
263989.0,6,3,337,2,214,0.0,160.0,107.0,1,123,0.0,123.0,123.0
75558.0,6,14,4740,7,653,12462.0,249.0,93.28571428571428,7,4087,6929.333333333333,1514.0,583.8571428571429
135134150.0,17,6,1206,6,1206,27026830.0,201.0,201.0,0,0,0.0,0.0,0.0
66178.0,6,13,1394,7,797,11029.666666666666,253.0,113.85714285714286,6,597,12066.8,259.0,99.5
108105570.0,17,5,955,5,955,27026392.5,191.0,191.0,0,0,0.0,0.0,0.0
178132.0,17,2,180,1,90,0.0,90.0,90.0,1,90,0.0,90.0,90.0
104154757.0,6,44,2904,22,1452,4959750.333333333,66.0,66.0,22,1452,4944998.714285715,66.0,66.0
138552.0,6,2,132,1,66,0.0,66.0,66.0,1,66,0.0,66.0,66.0
1507556.0,6,4,276,2,128,0.0,74.0,64.0,2,148,0.0,74.0,74.0
120941149.0,6,31,2034,16,1086,8062743.266666667,123.0,67.875,15,948,7910065.428571428,123.0,63.2
135139872.0,17,6,1206,6,1206,27027974.4,201.0,201.0,0,0,0.0,0.0,0.0
24594.0,6,14,4740,7,653,3196.6666666666665,249.0,93.28571428571428,7,4087,3717.8333333333335,1514.0,583.8571428571429
108106004.0,17,5,955,5,955,27026501.0,191.0,191.0,0,0,0.0,0.0,0.0
307958.0,6,6,412,4,272,102652.66666666669,74.0,68.0,2,140,0.0,74.0,70.0
24045.0,6,10,2032,5,524,5796.75,252.0,104.8,5,1508,5752.25,1236.0,301.6
280205.0,17,4,1524,4,1524,93401.66666666669,381.0,381.0,0,0,0.0,0.0,0.0
1955335.0,6,19,6869,11,1567,195533.5,408.0,142.45454545454547,8,5302,227358.8571428572,1514.0,662.75
2425.0,17,4,344,2,150,0.0,75.0,75.0,2,194,0.0,103.0,97.0
47161.0,6,10,2032,5,524,11574.0,252.0,104.8,5,1508,10777.75,1236.0,301.6
45072236.0,6,5,370,5,370,11268059.0,74.0,74.0,0,0,0.0,0.0,0.0
90754051.0,6,17,1287,9,691,11336144.875,95.0,76.77777777777777,8,596,12963881.857142856,95.0,74.5
1116539.0,6,13,1386,7,789,186089.8333333333,253.0,112.71428571428572,6,597,221565.2,259.0,99.5
8028537.0,6,29,6810,17,2262,501783.5625,544.0,133.05882352941177,12,4548,718790.2727272727,1514.0,379.0
216914.0,6,3,426,2,280,0.0,214.0,140.0,1,146,0.0,146.0,146.0
208521.0,6,3,426,2,280,0.0,214.0,140.0,1,146,0.0,146.0,146.0
108103587.0,17,5,1005,5,1005,27025896.75,201.0,201.0,0,0,0.0,0.0,0.0
1250204.0,6,10,1184,6,586,250040.8,248.0,97.66666666666669,4,598,325897.6666666667,392.0,149.5
0.0,17,1,90,1,90,0.0,90.0,90.0,0,0,0.0,0.0,0.0
145355.0,6,2,132,1,66,0.0,66.0,66.0,1,66,0.0,66.0,66.0
92555111.0,17,12,778,6,389,18400869.8,174.0,64.83333333333333,6,389,18400158.8,174.0,64.83333333333333
117123662.0,6,30,1990,15,1042,8350556.5,139.0,69.46666666666667,15,948,8350560.5,123.0,63.2
106560560.0,17,13,821,7,432,17760093.333333332,174.0,61.71428571428572,6,389,17389033.8,174.0,64.83333333333333
34855.0,6,14,4740,7,653,4950.333333333333,249.0,93.28571428571428,7,4087,4985.333333333333,1514.0,583.8571428571429
585.0,17,2,762,2,762,0.0,381.0,381.0,0,0,0.0,0.0,0.0
121616406.0,6,49,3234,24,1584,5182283.043478261,66.0,66.0,25,1650,5067339.75,66.0,66.0
1032525.0,6,11,1134,6,558,206505.0,220.0,93.0,5,576,256242.75,304.0,115.2
135143340.0,17,6,1206,6,1206,27028668.0,201.0,201.0,0,0,0.0,0.0,0.0
40808.0,6,14,4740,7,653,6181.333333333333,249.0,93.28571428571428,7,4087,5911.0,1514.0,583.8571428571429
103791.0,17,2,286,2,286,0.0,143.0,143.0,0,0,0.0,0.0,0.0
118430988.0,6,222,25106,111,17484,1074689.3,284.0,157.51351351351352,111,7622,1074688.509090909,140.0,68.66666666666667
90303666.0,6,16,1192,8,596,12893360.714285716,95.0,74.5,8,596,12898980.714285716,95.0,74.5
5410338.0,6,6,509,6,509,1082067.6,91.0,84.83333333333333,0,0,0.0,0.0,0.0
1432294.0,17,16,1120,16,1120,95486.26666666666,70.0,70.0,0,0,0.0,0.0,0.0
201966.0,17,2,762,2,762,0.0,381.0,381.0,0,0,0.0,0.0,0.0
210286.0,17,2,180,1,90,0.0,90.0,90.0,1,90,0.0,90.0,90.0
114090694.0,6,48,3168,24,1584,4960464.956521739,66.0,66.0,24,1584,4951067.0869565215,66.0,66.0
305875.0,17,4,1524,4,1524,101958.33333333331,381.0,381.0,0,0,0.0,0.0,0.0
47426.0,6,14,4740,7,653,7473.666666666667,249.0,93.28571428571428,7,4087,7681.833333333333,1514.0,583.8571428571429
112245356.0,6,36,2718,19,1455,6235853.111111111,123.0,76.57894736842105,17,1263,7001734.1875,123.0,74.29411764705883
90285075.0,6,17,1287,9,691,11279990.375,95.0,76.77777777777777,8,596,12896616.0,95.0,74.5
37610.0,6,14,4740,7,653,6152.166666666667,249.0,93.28571428571428,7,4087,6132.666666666667,1514.0,583.8571428571429
16781.0,17,2,180,1,90,0.0,90.0,90.0,1,90,0.0,90.0,90.0
1956.0,17,2,664,1,322,0.0,322.0,322.0,1,342,0.0,342.0,342.0
146189.0,6,3,337,2,214,0.0,160.0,107.0,1,123,0.0,123.0,123.0
2325.0,17,4,344,2,150,0.0,75.0,75.0,2,194,0.0,103.0,97.0
35040.0,6,14,4740,7,653,5718.833333333333,249.0,93.28571428571428,7,4087,5702.166666666667,1514.0,583.8571428571429
120580025.0,6,280,32700,141,23218,861285.8928571428,300.0,164.66666666666666,139,9482,866297.0652173914,140.0,68.2158273381295
146297.0,6,3,337,2,214,0.0,160.0,107.0,1,123,0.0,123.0,123.0
216747.0,6,3,426,2,280,0.0,214.0,140.0,1,146,0.0,146.0,146.0
71042.0,6,10,2032,5,524,13844.75,252.0,104.8,5,1508,15576.0,1236.0,301.6
105486875.0,6,44,2904,22,1452,5023184.523809524,66.0,66.0,22,1452,5007390.80952381,66.0,66.0
297618.0,6,10,1221,6,636,59523.6,298.0,106.0,4,585,92164.0,379.0,146.25
90254721.0,6,15,2444,8,1016,12893531.57142857,188.0,127.0,7,1428,15015435.333333334,204.0,204.0
209374.0,17,2,180,1,90,0.0,90.0,90.0,1,90,0.0,90.0,90.0
107652746.0,17,21,5844,9,1171,13376475.5,506.0,130.11111111111111,12,4673,9758594.818181818,1214.0,389.4166666666667
92951537.0,6,40,2640,20,1320,4892186.157894737,66.0,66.0,20,1320,4880822.157894737,66.0,66.0
281321.0,17,2,363,1,79,0.0,79.0,79.0,1,284,0.0,284.0,284.0
65904.0,6,14,4740,7,653,8905.5,249.0,93.28571428571428,7,4087,10706.166666666666,1514.0,583.8571428571429
3029866.0,6,12,2172,7,664,502277.1666666667,252.0,94.85714285714286,5,1508,5890.75,1236.0,301.6
33845.0,6,11,2098,6,590,6769.0,252.0,98.33333333333331,5,1508,6827.5,1236.0,301.6
302864.0,6,6,412,4,272,100954.66666666669,74.0,68.0,2,140,0.0,74.0,70.0
69159.0,6,14,4740,7,653,11411.833333333334,249.0,93.28571428571428,7,4087,10989.333333333334,1514.0,583.8571428571429
206342.0,6,3,426,2,280,0.0,214.0,140.0,1,146,0.0,146.0,146.0
208441.0,17,2,180,1,90,0.0,90.0,90.0,1,90,0.0,90.0,90.0
1280033.0,17,7,490,7,490,213338.8333333333,70.0,70.0,0,0,0.0,0.0,0.0
255137.0,6,10,1221,6,636,51027.4,298.0,106.0,4,585,79569.0,379.0,146.25
26489.0,6,14,4740,7,653,4040.0,249.0,93.28571428571428,7,4087,4067.0,1514.0,583.8571428571429
114417680.0,6,48,3168,24,1584,4974681.739130435,66.0,66.0,24,1584,4960207.391304348,66.0,66.0
111107145.0,17,14,864,7,432,18501123.83333333,174.0,61.71428571428572,7,432,18500220.666666668,174.0,61.71428571428572
90245518.0,6,14,2240,8,1016,12892216.857142856,188.0,127.0,6,1224,18016348.2,204.0,204.0
177434.0,17,2,180,1,90,0.0,90.0,90.0,1,90,0.0,90.0,90.0
319.0,17,2,174,1,79,0.0,79.0,79.0,1,95,0.0,95.0,95.0
306289.0,6,6,412,4,272,102096.33333333331,74.0,68.0,2,140,0.0,74.0,70.0
100784823.0,6,29,2068,15,1105,7183509.0,139.0,73.66666666666667,14,963,7736090.846153846,123.0,68.78571428571429
296.0,17,2,156,1,78,0.0,78.0,78.0,1,78,0.0,78.0,78.0
218009.0,6,3,426,2,280,0.0,214.0,140.0,1,146,0.0,146.0,146.0
155458.0,6,3,337,2,214,0.0,160.0,107.0,1,123,0.0,123.0,123.0
113618928.0,6,46,3036,23,1518,5150437.727272728,66.0,66.0,23,1518,5150442.454545454,66.0,66.0
3099849.0,6,157,116428,83,107242,37803.03658536585,1510.0,1292.0722891566263,74,9186,38129.94520547945,1510.0,124.13513513513512
205979.0,17,2,180,1,90,0.0,90.0,90.0,1,90,0.0,90.0,90.0
40815.0,6,14,4740,7,653,6501.833333333333,249.0,93.28571428571428,7,4087,5834.5,1514.0,583.8571428571429
143913.0,17,2,180,1,90,0.0,90.0,90.0,1,90,0.0,90.0,90.0
20697.0,6,12,1393,6,796,3223.8,271.0,132.66666666666666,6,597,3398.8,259.0,99.5
98651808.0,17,12,778,6,389,19600348.4,174.0,64.83333333333333,6,389,19600251.2,174.0,64.83333333333333
107490.0,17,2,286,2,286,0.0,143.0,143.0,0,0,0.0,0.0,0.0
102915.0,17,2,286,2,286,0.0,143.0,143.0,0,0,0.0,0.0,0.0
297689.0,17,4,1524,4,1524,99229.66666666669,381.0,381.0,0,0,0.0,0.0,0.0
135131911.0,17,6,1206,6,1206,27026382.2,201.0,201.0,0,0,0.0,0.0,0.0
144070.0,17,2,180,1,90,0.0,90.0,90.0,1,90,0.0,90.0,90.0
119905141.0,17,35,16705,35,16705,3526621.794117647,501.0,477.2857142857143,0,0,0.0,0.0,0.0
108218.0,17,2,286,2,286,0.0,143.0,143.0,0,0,0.0,0.0,0.0
21060978.0,17,3,1034,2,684,0.0,342.0,342.0,1,350,0.0,350.0,350.0
2406.0,17,4,344,2,150,0.0,75.0,75.0,2,194,0.0,103.0,97.0
1028785.0,6,11,1134,6,558,205757.00000000003,220.0,93.0,5,576,255130.5,304.0,115.2
309797.0,6,6,412,4,272,103265.66666666669,74.0,68.0,2,140,0.0,74.0,70.0
27206.0,6,14,4740,7,653,4426.0,249.0,93.28571428571428,7,4087,3336.5,1514.0,583.8571428571429
2405.0,17,4,344,2,150,0.0,75.0,75.0,2,194,0.0,103.0,97.0
101351930.0,6,29,2131,15,1168,7239423.571428572,139.0,77.86666666666666,14,963,7198326.153846154,123.0,68.78571428571429
323.0,17,2,166,1,75,0.0,75.0,75.0,1,91,0.0,91.0,91.0
305756.0,6,2,1538,1,753,0.0,753.0,753.0,1,785,0.0,785.0,785.0
1313598.0,6,4,264,2,132,0.0,66.0,66.0,2,132,0.0,66.0,66.0
3759700.0,6,5,336,2,134,0.0,68.0,67.0,3,202,1526017.0,70.0,67.33333333333333
26928179.0,17,5,1710,5,1710,6732044.75,342.0,342.0,0,0,0.0,0.0,0.0
306890.0,6,2,132,1,66,0.0,66.0,66.0,1,66,0.0,66.0,66.0
102345.0,17,2,762,2,762,0.0,381.0,381.0,0,0,0.0,0.0,0.0
28437.0,6,10,2032,5,524,6881.75,252.0,104.8,5,1508,6873.25,1236.0,301.6
226263.0,17,2,180,1,90,0.0,90.0,90.0,1,90,0.0,90.0,90.0
90740442.0,6,24,1829,13,989,7558283.083333333,95.0,76.07692307692308,11,840,9044858.7,95.0,76.36363636363636
28136.0,6,10,2032,5,524,6792.0,252.0,104.8,5,1508,6493.25,1236.0,301.6
27286956.0,17,5,1710,5,1710,6821739.0,342.0,342.0,0,0,0.0,0.0,0.0
363784.0,6,10,967,5,390,61132.5,162.0,78.0,5,577,61074.5,349.0,115.4
135136090.0,17,6,1146,6,1146,27027218.0,191.0,191.0,0,0,0.0,0.0,0.0
209586.0,17,2,180,1,90,0.0,90.0,90.0,1,90,0.0,90.0,90.0
246182.0,6,3,337,2,214,0.0,160.0,107.0,1,123,0.0,123.0,123.0
36225.0,6,14,4740,7,653,5862.333333333333,249.0,93.28571428571428,7,4087,5384.333333333333,1514.0,583.8571428571429
9454.0,6,11,2098,6,590,1762.0,252.0,98.33333333333331,5,1508,1787.5,1236.0,301.6
106397264.0,6,31,2182,16,1165,7078741.466666667,139.0,72.8125,15,1017,7584365.928571428,123.0,67.8
19086.0,6,14,4740,7,653,3062.1666666666665,249.0,93.28571428571428,7,4087,3042.0,1514.0,583.8571428571429
14217.0,6,13,1459,7,862,2369.5,271.0,123.14285714285714,6,597,2424.0,259.0,99.5
2982092.0,6,160,126011,90,117089,33506.651685393255,1510.0,1300.9888888888888,70,8922,38827.985507246376,1510.0,127.45714285714286
1345.0,17,2,762,2,762,0.0,381.0,381.0,0,0,0.0,0.0,0.0
112527689.0,6,32,2236,16,1165,7488118.8,139.0,72.8125,16,1071,7488126.0,123.0,66.9375
202965.0,6,10,1221,6,636,40593.0,298.0,106.0,4,585,65900.0,379.0,146.25
26997.0,6,10,2032,5,524,6373.25,252.0,104.8,5,1508,5474.25,1236.0,301.6
1023364.0,6,11,1134,6,558,204672.8,220.0,93.0,5,576,255165.25,304.0,115.2
113264839.0,6,46,3036,23,1518,5135890.409090909,66.0,66.0,23,1518,5135893.090909091,66.0,66.0
228160.0,17,2,180,1,90,0.0,90.0,90.0,1,90,0.0,90.0,90.0
25787.0,6,10,2032,5,524,5524.25,252.0,104.8,5,1508,6190.75,1236.0,301.6
120121755.0,6,13,2036,8,1016,17137241.285714287,188.0,127.0,5,1020,22523597.75,204.0,204.0
13297.0,6,11,1132,6,556,2659.4,218.0,92.66666666666669,5,576,1834.0,304.0,115.2
108106562.0,17,5,1005,5,1005,27026640.5,201.0,201.0,0,0,0.0,0.0,0.0
108103371.0,17,5,955,5,955,27025842.75,191.0,191.0,0,0,0.0,0.0,0.0
101599562.0,6,883,161068,436,29220,233501.82988505744,214.0,67.01834862385321,447,131848,227757.30269058296,1514.0,294.9619686800895
4826.0,17,4,344,2,150,0.0,75.0,75.0,2,194,0.0,103.0,97.0
3280.0,17,2,363,1,75,0.0,75.0,75.0,1,288,0.0,288.0,288.0
2496.0,17,4,344,2,150,0.0,75.0,75.0,2,194,0.0,103.0,97.0
16070.000000000002,6,11,1133,6,602,2900.0,264.0,100.33333333333331,5,531,3767.25,259.0,106.2
90015161.0,17,27,12943,27,12943,3462121.576923077,501.0,479.3703703703704,0,0,0.0,0.0,0.0
67065.0,6,10,2032,5,524,16519.25,252.0,104.8,5,1508,16025.25,1236.0,301.6
222528.0,6,3,426,2,280,0.0,214.0,140.0,1,146,0.0,146.0,146.0
311800.0,6,6,412,4,272,103933.33333333331,74.0,68.0,2,140,0.0,74.0,70.0
2068631.0,6,25,7610,13,2516,172385.91666666666,1034.0,193.53846153846155,12,5094,160511.27272727274,1510.0,424.5
2168.0,17,2,180,1,90,0.0,90.0,90.0,1,90,0.0,90.0,90.0
80914.0,6,14,4740,7,653,12983.166666666666,249.0,93.28571428571428,7,4087,13175.5,1514.0,583.8571428571429
75244.0,6,13,1386,7,789,11953.333333333334,253.0,112.71428571428572,6,597,12895.0,259.0,99.5
300170.0,6,6,412,4,272,100056.66666666669,74.0,68.0,2,140,0.0,74.0,70.0
120126910.0,6,13,2020,9,1204,15015863.75,188.0,133.77777777777777,4,816,30029078.33333333,204.0,204.0
299627.0,6,6,412,4,272,99875.66666666669,74.0,68.0,2,140,0.0,74.0,70.0
221195.0,6,3,426,2,280,0.0,214.0,140.0,1,146,0.0,146.0,146.0
120200954.0,6,200,22680,100,6822,1195495.4747474748,140.0,68.22,100,15858,1196054.2525252523,284.0,158.58
204638.0,17,2,762,2,762,0.0,381.0,381.0,0,0,0.0,0.0,0.0
121429.0,6,3,337,2,214,0.0,160.0,107.0,1,123,0.0,123.0,123.0
108102089.0,17,5,1005,5,1005,27025522.25,201.0,201.0,0,0,0.0,0.0,0.0
121152695.0,6,220,25064,110,7556,1094464.2018348624,140.0,68.69090909090909,110,17508,1103901.9816513762,336.0,159.16363636363636
2339705.0,6,2,132,1,66,0.0,66.0,66.0,1,66,0.0,66.0,66.0
95886944.0,6,167,18918,84,13218,1155264.3855421687,284.0,157.35714285714286,83,5700,1156660.9390243902,140.0,68.67469879518072
92540978.0,6,29,2068,15,1105,6595468.285714285,139.0,73.66666666666667,14,963,7102754.769230769,123.0,68.78571428571429
94520123.0,17,12,778,6,389,18872002.8,174.0,64.83333333333333,6,389,18875420.2,174.0,64.83333333333333
165917.0,17,2,180,1,90,0.0,90.0,90.0,1,90,0.0,90.0,90.0
2981135.0,6,2,132,1,66,0.0,66.0,66.0,1,66,0.0,66.0,66.0
50278.0,6,14,4740,7,653,7387.333333333333,249.0,93.28571428571428,7,4087,8241.166666666666,1514.0,583.8571428571429
482770.0,6,4,270,2,134,0.0,68.0,67.0,2,136,0.0,70.0,68.0
508571.0,6,5,336,2,134,0.0,68.0,67.0,3,202,192553.5,70.0,67.33333333333333
108089516.0,17,5,955,5,955,27022379.0,191.0,191.0,0,0,0.0,0.0,0.0
113309699.0,6,45,2970,23,1518,5150440.863636363,66.0,66.0,22,1452,5243674.476190476,66.0,66.0
0.0,6,1,66,1,66,0.0,66.0,66.0,0,0,0.0,0.0,0.0
196738.0,17,2,180,1,90,0.0,90.0,90.0,1,90,0.0,90.0,90.0
28726.0,6,10,2032,5,524,6271.0,252.0,104.8,5,1508,6463.75,1236.0,301.6
1487942.0,17,16,1120,16,1120,99196.13333333332,70.0,70.0,0,0,0.0,0.0,0.0
144700.0,17,2,180,1,70,0.0,70.0,70.0,1,110,0.0,110.0,110.0
114114573.0,6,30,1974,15,1026,8135606.928571428,123.0,68.4,15,948,8135554.285714285,123.0,63.2
78554.0,6,11,2098,6,590,15500.2,252.0,98.33333333333331,5,1508,19314.0,1236.0,301.6
1884.0,17,4,344,2,150,0.0,75.0,75.0,2,194,0.0,103.0,97.0
9260.0,6,11,2041,6,533,1689.4,195.0,88.83333333333333,5,1508,1753.0,1236.0,301.6
91359612.0,6,22,1680,10,786,10151068.0,95.0,78.6,12,894,8282940.727272727,95.0,74.5
135132529.0,17,6,1206,6,1206,27026505.8,201.0,201.0,0,0,0.0,0.0,0.0
594520.0,6,4,508,2,238,0.0,172.0,119.0,2,270,0.0,135.0,135.0
3882.0,17,4,344,2,150,0.0,75.0,75.0,2,194,0.0,103.0,97.0
2365.0,17,4,344,2,150,0.0,75.0,75.0,2,194,0.0,103.0,97.0
2379.0,17,4,344,2,150,0.0,75.0,75.0,2,194,0.0,103.0,97.0
2699102.0,6,3,1777,2,951,0.0,885.0,475.5,1,826,0.0,826.0,826.0
2575127.0,6,25,7573,14,3735,198086.6923076923,1514.0,266.7857142857143,11,3838,231388.6,1514.0,348.90909090909093
307.0,17,2,164,1,82,0.0,82.0,82.0,1,82,0.0,82.0,82.0
246971.0,6,4,439,2,238,0.0,172.0,119.0,2,201,0.0,135.0,100.5
457.0,17,2,267,1,83,0.0,83.0,83.0,1,184,0.0,184.0,184.0
326.0,17,2,160,1,80,0.0,80.0,80.0,1,80,0.0,80.0,80.0
108101410.0,17,5,1005,5,1005,27025352.5,201.0,201.0,0,0,0.0,0.0,0.0
6511.0,17,2,180,1,90,0.0,90.0,90.0,1,90,0.0,90.0,90.0
5627682.0,6,5,336,2,134,0.0,68.0,67.0,3,202,1528014.5,70.0,67.33333333333333
24126.0,6,11,2098,6,590,4825.2,252.0,98.33333333333331,5,1508,5088.0,1236.0,301.6
86.0,17,2,762,2,762,0.0,381.0,381.0,0,0,0.0,0.0,0.0
232723.0,6,3,337,2,214,0.0,160.0,107.0,1,123,0.0,123.0,123.0
356.0,17,2,250,1,93,0.0,93.0,93.0,1,157,0.0,157.0,157.0
120008045.0,17,29,13785,29,13785,4286001.607142857,501.0,475.3448275862069,0,0,0.0,0.0,0.0
319931.0,17,4,1400,4,1400,106643.66666666669,350.0,350.0,0,0,0.0,0.0,0.0
3391399.0,6,7,923,4,753,1061752.0,571.0,188.25,3,170,1592956.5,62.0,56.66666666666666
19965.0,17,2,539,1,86,0.0,86.0,86.0,1,453,0.0,453.0,453.0
232884.0,6,3,337,2,214,0.0,160.0,107.0,1,123,0.0,123.0,123.0
2271.0,17,4,344,2,150,0.0,75.0,75.0,2,194,0.0,103.0,97.0
218032.0,6,3,426,2,280,0.0,214.0,140.0,1,146,0.0,146.0,146.0
147938.0,17,2,180,1,90,0.0,90.0,90.0,1,90,0.0,90.0,90.0
108106879.0,17,5,955,5,955,27026719.75,191.0,191.0,0,0,0.0,0.0,0.0
153548.0,17,2,180,1,90,0.0,90.0,90.0,1,90,0.0,90.0,90.0
209554.0,17,2,180,1,90,0.0,90.0,90.0,1,90,0.0,90.0,90.0
101998.0,17,2,762,2,762,0.0,381.0,381.0,0,0,0.0,0.0,0.0
106206.0,17,2,286,2,286,0.0,143.0,143.0,0,0,0.0,0.0,0.0
51355.0,6,10,1065,5,534,12108.25,262.0,106.8,5,531,12425.0,259.0,106.2
164666.0,17,2,414,1,88,0.0,88.0,88.0,1,326,0.0,326.0,326.0
90039695.0,17,28,13364,28,13364,3334803.5185185187,501.0,477.2857142857143,0,0,0.0,0.0,0.0
3114.0,17,2,762,2,762,0.0,381.0,381.0,0,0,0.0,0.0,0.0
92482772.0,17,12,778,6,389,18401143.2,174.0,64.83333333333333,6,389,18400347.8,174.0,64.83333333333333
2508.0,17,2,762,2,762,0.0,381.0,381.0,0,0,0.0,0.0,0.0
311124.0,17,4,1400,4,1400,103708.0,350.0,350.0,0,0,0.0,0.0,0.0
121917.0,6,3,337,2,214,0.0,160.0,107.0,1,123,0.0,123.0,123.0
736714.0,6,11,1131,6,600,146480.0,262.0,100.0,5,531,183971.5,259.0,106.2
197320.0,17,2,180,1,90,0.0,90.0,90.0,1,90,0.0,90.0,90.0
102657.0,17,2,762,2,762,0.0,381.0,381.0,0,0,0.0,0.0,0.0
108106796.0,17,5,955,5,955,27026699.0,191.0,191.0,0,0,0.0,0.0,0.0
15619.0,6,13,1459,7,862,1923.1666666666667,271.0,123.14285714285714,6,597,2949.6,259.0,99.5
135131498.0,17,6,1146,6,1146,27026299.6,191.0,191.0,0,0,0.0,0.0,0.0
50372.0,6,14,4740,7,653,7939.333333333333,249.0,93.28571428571428,7,4087,8257.333333333334,1514.0,583.8571428571429
146171.0,6,3,337,2,214,0.0,160.0,107.0,1,123,0.0,123.0,123.0
115346010.0,6,211,23818,106,7218,1098533.4285714286,140.0,68.09433962264151,105,16600,1099128.1442307692,374.0,158.0952380952381
1775224.0,6,4,492,2,280,0.0,214.0,140.0,2,212,0.0,146.0,106.0
139109.0,17,2,192,1,88,0.0,88.0,88.0,1,104,0.0,104.0,104.0
90037194.0,17,27,12943,27,12943,3462969.0,501.0,479.3703703703704,0,0,0.0,0.0,0.0
1302549.0,6,4,264,2,132,0.0,66.0,66.0,2,132,0.0,66.0,66.0
3875.0,17,4,344,2,150,0.0,75.0,75.0,2,194,0.0,103.0,97.0
234767.0,6,3,337,2,214,0.0,160.0,107.0,1,123,0.0,123.0,123.0
222640.0,6,10,1221,6,636,44528.0,298.0,106.0,4,585,73155.0,379.0,146.25
322.0,17,2,174,1,79,0.0,79.0,79.0,1,95,0.0,95.0,95.0
90302710.0,6,19,1436,10,745,10027981.444444444,95.0,74.5,9,691,11283788.375,95.0,76.77777777777777
121165.0,6,3,337,2,214,0.0,160.0,107.0,1,123,0.0,123.0,123.0
105631.0,17,2,286,2,286,0.0,143.0,143.0,0,0,0.0,0.0,0.0
10463.0,6,10,2032,5,524,2404.25,252.0,104.8,5,1508,2324.75,1236.0,301.6
2796216.0,6,2,132,1,66,0.0,66.0,66.0,1,66,0.0,66.0,66.0
119659064.0,6,224,25290,112,17602,1076069.1711711711,300.0,157.16071428571428,112,7688,1076069.8738738738,140.0,68.64285714285714
450.0,17,2,508,2,508,0.0,257.0,254.0,0,0,0.0,0.0,0.0
155082.0,6,3,337,2,214,0.0,160.0,107.0,1,123,0.0,123.0,123.0
142721.0,6,2,132,1,66,0.0,66.0,66.0,1,66,0.0,66.0,66.0
2611249.0,6,13,1386,7,789,435208.1666666667,253.0,112.71428571428572,6,597,517966.6,259.0,99.5
105729.0,17,2,700,2,700,0.0,350.0,350.0,0,0,0.0,0.0,0.0
14231.0,6,14,4740,7,653,2163.1666666666665,249.0,93.28571428571428,7,4087,2234.333333333333,1514.0,583.8571428571429
22802.0,6,10,2032,5,524,4545.0,252.0,104.8,5,1508,5463.5,1236.0,301.6
329436.0,6,6,412,4,272,109812.0,74.0,68.0,2,140,0.0,74.0,70.0
110064982.0,6,34,2482,17,1288,6879061.375,139.0,75.76470588235294,17,1194,6865534.0,123.0,70.23529411764706
26847055.0,17,4,1376,3,1026,1555321.5,342.0,342.0,1,350,0.0,350.0,350.0
896528.0,6,4,270,2,134,0.0,68.0,67.0,2,136,0.0,70.0,68.0
108112413.0,17,5,1005,5,1005,27028103.25,201.0,201.0,0,0,0.0,0.0,0.0
42400.0,6,10,2032,5,524,9727.25,252.0,104.8,5,1508,9855.5,1236.0,301.6
207265.0,6,3,426,2,280,0.0,214.0,140.0,1,146,0.0,146.0,146.0
287.0,17,2,164,1,82,0.0,82.0,82.0,1,82,0.0,82.0,82.0
43119.0,6,12,1320,7,789,7186.5,253.0,112.71428571428572,5,531,9300.25,259.0,106.2
7087.0,17,2,180,1,90,0.0,90.0,90.0,1,90,0.0,90.0,90.0
157113.0,17,4,1400,4,1400,52371.0,350.0,350.0,0,0,0.0,0.0,0.0
91789903.0,6,175,19620,88,5956,1055056.3563218392,140.0,67.68181818181819,87,13664,1055293.7325581396,284.0,157.05747126436782
207191.0,6,3,426,2,280,0.0,214.0,140.0,1,146,0.0,146.0,146.0
234641.0,6,3,337,2,214,0.0,160.0,107.0,1,123,0.0,123.0,123.0
44011.0,6,14,4740,7,653,6456.5,249.0,93.28571428571428,7,4087,7198.166666666667,1514.0,583.8571428571429
143949.0,17,2,180,1,90,0.0,90.0,90.0,1,90,0.0,90.0,90.0
25943.0,6,14,4740,7,653,4195.333333333333,249.0,93.28571428571428,7,4087,4182.5,1514.0,583.8571428571429
391.0,17,2,267,1,83,0.0,83.0,83.0,1,184,0.0,184.0,184.0
135131787.0,17,6,1206,6,1206,27026357.4,201.0,201.0,0,0,0.0,0.0,0.0
109220798.0,17,14,864,7,432,18168064.5,174.0,61.71428571428572,7,432,18166829.666666668,174.0,61.71428571428572
4510.0,17,2,626,1,72,0.0,72.0,72.0,1,554,0.0,554.0,554.0
108692822.0,6,34,2482,17,1288,6793301.375,139.0,75.76470588235294,17,1194,6779819.0625,123.0,70.23529411764706
298133.0,6,6,412,4,272,99377.66666666669,74.0,68.0,2,140,0.0,74.0,70.0
23429.0,6,10,2032,5,524,5525.0,252.0,104.8,5,1508,5560.75,1236.0,301.6
10992.0,6,10,2032,5,524,2487.5,252.0,104.8,5,1508,2452.75,1236.0,301.6
118035093.0,6,32,2236,16,1165,7869006.2,139.0,72.8125,16,1071,7854587.866666666,123.0,66.9375
22289.0,6,10,2032,5,524,5070.25,252.0,104.8,5,1508,4771.0,1236.0,301.6
56611.0,6,14,4740,7,653,8739.166666666666,249.0,93.28571428571428,7,4087,8617.333333333334,1514.0,583.8571428571429
207211.0,6,3,426,2,280,0.0,214.0,140.0,1,146,0.0,146.0,146.0
90271113.0,6,12,1832,8,1016,12895873.285714284,188.0,127.0,4,816,30035013.0,204.0,204.0
2441.0,17,4,344,2,150,0.0,75.0,75.0,2,194,0.0,103.0,97.0
206245.0,6,3,426,2,280,0.0,214.0,140.0,1,146,0.0,146.0,146.0
115405337.0,6,210,23630,105,16404,1107585.4423076925,284.0,156.22857142857143,105,7226,1107585.6634615385,140.0,68.81904761904762
27434400.0,17,5,1710,5,1710,6858600.0,342.0,342.0,0,0,0.0,0.0,0.0
143993.0,17,2,180,1,90,0.0,90.0,90.0,1,90,0.0,90.0,90.0
90094526.0,6,11,1644,4,816,30030745.0,204.0,204.0,7,828,15015598.666666666,188.0,118.28571428571428
23182.0,6,14,4740,7,653,3730.6666666666665,249.0,93.28571428571428,7,4087,3726.8333333333335,1514.0,583.8571428571429
146119.0,6,3,337,2,214,0.0,160.0,107.0,1,123,0.0,123.0,123.0
100523.0,17,2,286,2,286,0.0,143.0,143.0,0,0,0.0,0.0,0.0
305827.0,6,3,202,2,128,0.0,74.0,64.0,1,74,0.0,74.0,74.0
26716770.0,6,5,1736,2,819,0.0,753.0,409.5,3,917,13293387.5,785.0,305.6666666666667
153456.0,17,2,180,1,90,0.0,90.0,90.0,1,90,0.0,90.0,90.0
54583.0,6,10,2032,5,524,13432.0,252.0,104.8,5,1508,10877.25,1236.0,301.6
7062.0,17,2,582,1,83,0.0,83.0,83.0,1,499,0.0,499.0,499.0
1058790.0,6,3,1604,2,851,0.0,785.0,425.5,1,753,0.0,753.0,753.0
339650.0,6,6,412,4,272,113216.66666666669,74.0,68.0,2,140,0.0,74.0,70.0
3050491.0,6,3,204,2,136,0.0,70.0,68.0,1,68,0.0,68.0,68.0
107839751.0,6,28,1860,14,966,8295365.461538462,123.0,69.0,14,894,8278711.615384615,123.0,63.85714285714285
846738.0,6,9,1096,6,625,169347.6,287.0,104.16666666666669,3,471,285506.5,331.0,157.0
205899.0,6,3,426,2,280,0.0,214.0,140.0,1,146,0.0,146.0,146.0
90254371.0,6,13,2036,8,1016,12893481.57142857,188.0,127.0,5,1020,22522870.5,204.0,204.0
717650.0,6,10,1065,5,534,179237.75,262.0,106.8,5,531,178983.5,259.0,106.2
41657.0,6,14,4740,7,653,6785.166666666667,249.0,93.28571428571428,7,4087,6762.333333333333,1514.0,583.8571428571429
262833.0,6,3,337,2,214,0.0,160.0,107.0,1,123,0.0,123.0,123.0
120011504.0,6,25,1924,13,1030,9999998.416666666,95.0,79.23076923076923,12,894,10909202.909090908,95.0,74.5
46657.0,6,14,4740,7,653,7650.166666666667,249.0,93.28571428571428,7,4087,7116.166666666667,1514.0,583.8571428571429
43440.0,6,14,4740,7,653,6623.166666666667,249.0,93.28571428571428,7,4087,6736.666666666667,1514.0,583.8571428571429
90917168.0,6,20,1531,11,840,9091716.8,95.0,76.36363636363636,9,691,11337614.875,95.0,76.77777777777777
270798.0,6,10,1221,6,636,54159.6,298.0,106.0,4,585,83071.66666666667,379.0,146.25
102933.0,17,2,762,2,762,0.0,381.0,381.0,0,0,0.0,0.0,0.0
147681.0,17,2,192,1,88,0.0,88.0,88.0,1,104,0.0,104.0,104.0
2439.0,17,4,344,2,150,0.0,75.0,75.0,2,194,0.0,103.0,97.0
120009924.0,6,18,1341,9,691,14999995.625,95.0,76.77777777777777,9,650,15000553.5,95.0,72.22222222222223
14636485.0,6,20,1607,10,975,1592834.888888889,315.0,97.5,10,632,1592809.2222222222,78.0,63.2
90259609.0,6,12,1832,8,1016,12894229.857142856,188.0,127.0,4,816,30031384.33333333,204.0,204.0
10454149.0,6,7,478,4,272,3439306.333333333,74.0,68.0,3,206,5158848.5,74.0,68.66666666666667
210139.0,6,10,1221,6,636,42027.8,298.0,106.0,4,585,68298.66666666667,379.0,146.25
5624305.0,6,4,270,2,134,0.0,68.0,67.0,2,136,0.0,70.0,68.0
497666.0,6,5,336,2,134,0.0,68.0,67.0,3,202,191636.0,70.0,67.33333333333333
317285.0,6,6,412,4,272,105761.66666666669,74.0,68.0,2,140,0.0,74.0,70.0
100981983.0,6,181,20382,91,6228,1122022.0333333334,140.0,68.43956043956044,90,14154,1124245.5280898877,284.0,157.26666666666668
6185.0,17,2,231,1,78,0.0,78.0,78.0,1,153,0.0,153.0,153.0
2408.0,17,4,344,2,150,0.0,75.0,75.0,2,194,0.0,103.0,97.0
128679211.0,6,33,2359,16,1071,7913224.133333334,123.0,66.9375,17,1288,7418389.25,139.0,75.76470588235294
90759097.0,6,19,1436,10,745,10079591.777777778,95.0,74.5,9,691,11344223.625,95.0,76.77777777777777
203385.0,6,10,1221,6,636,40677.0,298.0,106.0,4,585,66866.33333333333,379.0,146.25
294024.0,17,4,1400,4,1400,98008.0,350.0,350.0,0,0,0.0,0.0,0.0
3016038.0,6,11,2106,6,598,602941.2,252.0,99.66666666666669,5,1508,4660.75,1236.0,301.6
101191.0,17,2,762,2,762,0.0,381.0,381.0,0,0,0.0,0.0,0.0
200108.0,17,2,180,1,90,0.0,90.0,90.0,1,90,0.0,90.0,90.0
11849.0,6,10,1067,5,536,2683.75,264.0,107.2,5,531,2577.0,259.0,106.2
2934584.0,6,12,2172,7,664,488907.1666666667,252.0,94.85714285714286,5,1508,2875.75,1236.0,301.6
205912.0,17,2,180,1,90,0.0,90.0,90.0,1,90,0.0,90.0,90.0
101920.0,17,2,286,2,286,0.0,143.0,143.0,0,0,0.0,0.0,0.0
103606.0,17,2,286,2,286,0.0,143.0,143.0,0,0,0.0,0.0,0.0
13562356.0,6,252,243647,69,4717,199446.41176470587,209.0,68.3623188405797,183,238930,74482.14285714286,1514.0,1305.6284153005463
99013.0,17,2,762,2,762,0.0,381.0,381.0,0,0,0.0,0.0,0.0
298845.0,6,6,412,4,272,99615.0,74.0,68.0,2,140,0.0,74.0,70.0
120472595.0,6,23,1775,13,1030,10039382.916666666,95.0,79.23076923076923,10,745,10105956.777777778,95.0,74.5
118222654.0,6,217,24362,109,7490,1094654.2037037036,140.0,68.71559633027523,108,16872,1096287.523364486,284.0,156.22222222222223
96894543.0,17,14,1126,7,563,16001015.666666666,174.0,80.42857142857143,7,563,16000140.833333334,174.0,80.42857142857143
219700.0,6,10,1221,6,636,43940.0,298.0,106.0,4,585,72096.0,379.0,146.25
107847556.0,6,28,1860,14,966,8279366.153846154,123.0,69.0,14,894,8279361.384615385,123.0,63.85714285714285
2031.0,17,4,344,2,150,0.0,75.0,75.0,2,194,0.0,103.0,97.0
135134464.0,17,6,1146,6,1146,27026892.8,191.0,191.0,0,0,0.0,0.0,0.0
108373.0,17,2,286,2,286,0.0,143.0,143.0,0,0,0.0,0.0,0.0
208087.0,17,2,762,2,762,0.0,381.0,381.0,0,0,0.0,0.0,0.0
3413.0,17,2,346,1,78,0.0,78.0,78.0,1,268,0.0,268.0,268.0
135129099.0,17,6,1206,6,1206,27025819.8,201.0,201.0,0,0,0.0,0.0,0.0
51172.0,17,2,180,1,90,0.0,90.0,90.0,1,90,0.0,90.0,90.0
104745.0,17,2,762,2,762,0.0,381.0,381.0,0,0,0.0,0.0,0.0
1848.0,17,2,939,1,590,0.0,590.0,590.0,1,349,0.0,349.0,349.0
27479174.0,17,5,1710,5,1710,6869793.5,342.0,342.0,0,0,0.0,0.0,0.0
252378.0,6,3,337,2,214,0.0,160.0,107.0,1,123,0.0,123.0,123.0
107878.0,17,2,286,2,286,0.0,143.0,143.0,0,0,0.0,0.0,0.0
10870476.0,6,8,544,4,272,3577002.0,74.0,68.0,4,272,3576919.333333333,74.0,68.0
18325.0,6,14,4740,7,653,2806.833333333333,249.0,93.28571428571428,7,4087,2861.333333333333,1514.0,583.8571428571429
51493.0,6,10,2032,5,524,12654.75,252.0,104.8,5,1508,12701.0,1236.0,301.6
90254155.0,6,13,2036,8,1016,12893450.714285716,188.0,127.0,5,1020,22522750.0,204.0,204.0
206367.0,6,3,426,2,280,0.0,214.0,140.0,1,146,0.0,146.0,146.0
11600.0,6,10,1067,5,536,2607.0,264.0,107.2,5,531,2611.25,259.0,106.2
44193.0,6,14,4740,7,653,6914.5,249.0,93.28571428571428,7,4087,6147.833333333333,1514.0,583.8571428571429
34904.0,6,14,4740,7,653,5591.333333333333,249.0,93.28571428571428,7,4087,5600.0,1514.0,583.8571428571429
1307789.0,6,4,264,2,132,0.0,66.0,66.0,2,132,0.0,66.0,66.0
207852.0,6,3,426,2,280,0.0,214.0,140.0,1,146,0.0,146.0,146.0
737.0,17,4,438,2,148,0.0,74.0,74.0,2,290,0.0,147.0,145.0
236776.0,17,4,1524,4,1524,78925.33333333333,381.0,381.0,0,0,0.0,0.0,0.0
497912.0,6,5,336,2,134,0.0,68.0,67.0,3,202,195686.0,70.0,67.33333333333333
18372.0,6,10,1810,5,358,4331.25,130.0,71.6,5,1452,4006.0,1224.0,290.4
17679.0,6,20,7606,11,978,1767.9,310.0,88.9090909090909,9,6628,1915.875,1514.0,736.4444444444445
121827865.0,6,59,12462,30,6668,4200960.862068965,1514.0,222.26666666666668,29,5794,3424413.4285714286,1514.0,199.79310344827587
502473.0,6,5,336,2,134,0.0,68.0,67.0,3,202,191467.0,70.0,67.33333333333333
38813.0,6,14,4740,7,653,5620.666666666667,249.0,93.28571428571428,7,4087,6329.833333333333,1514.0,583.8571428571429
123301927.0,6,48,3168,24,1584,5022174.347826087,66.0,66.0,24,1584,5274424.043478261,66.0,66.0
18117.0,6,11,2098,6,590,2614.6,252.0,98.33333333333331,5,1508,4005.25,1236.0,301.6
102354370.0,6,44,2904,22,1452,4874017.619047619,66.0,66.0,22,1452,4868573.666666667,66.0,66.0
313672.0,17,4,704,2,148,0.0,74.0,74.0,2,556,0.0,280.0,278.0
123455627.0,6,48,3168,24,1584,5003020.695652174,66.0,66.0,24,1584,5264809.521739131,66.0,66.0
119955952.0,17,35,16705,35,16705,3528116.2352941176,501.0,477.2857142857143,0,0,0.0,0.0,0.0
302384.0,6,6,412,4,272,100794.66666666669,74.0,68.0,2,140,0.0,74.0,70.0
932782.0,6,12,2710,7,742,155463.66666666666,338.0,106.0,5,1968,164224.5,1514.0,393.6
1053415.0,6,3,1604,2,851,0.0,785.0,425.5,1,753,0.0,753.0,753.0
320662.0,6,6,544,3,350,80769.5,210.0,116.66666666666669,3,194,80765.5,74.0,64.66666666666667
138322.0,6,2,132,1,66,0.0,66.0,66.0,1,66,0.0,66.0,66.0
36670.0,6,14,4740,7,653,6004.333333333333,249.0,93.28571428571428,7,4087,5255.166666666667,1514.0,583.8571428571429
200453.0,6,11,1132,6,556,38252.8,218.0,92.66666666666669,5,576,49912.75,304.0,115.2
3780026.0,6,5,336,2,134,0.0,68.0,67.0,3,202,1526170.5,70.0,67.33333333333333
90521320.0,6,14,2240,8,1016,12931617.142857144,188.0,127.0,6,1224,18071558.2,204.0,204.0
120055900.0,17,28,13364,28,13364,4446514.814814814,501.0,477.2857142857143,0,0,0.0,0.0,0.0
9411.0,17,2,582,1,83,0.0,83.0,83.0,1,499,0.0,499.0,499.0
120083903.0,6,272,31170,136,9198,883518.925925926,140.0,67.63235294117646,136,21972,884281.9629629629,300.0,161.55882352941177
228163.0,17,2,180,1,90,0.0,90.0,90.0,1,90,0.0,90.0,90.0
332.0,17,2,166,1,75,0.0,75.0,75.0,1,91,0.0,91.0,91.0
306776.0,6,6,412,4,272,102258.66666666669,74.0,68.0,2,140,0.0,74.0,70.0
232956.0,6,3,337,2,214,0.0,160.0,107.0,1,123,0.0,123.0,123.0
245458.0,6,3,337,2,214,0.0,160.0,107.0,1,123,0.0,123.0,123.0
90300661.0,6,16,1192,8,596,12893001.285714284,95.0,74.5,8,596,12898525.285714284,95.0,74.5
212769.0,6,3,426,2,280,0.0,214.0,140.0,1,146,0.0,146.0,146.0
135132132.0,17,6,1146,6,1146,27026426.4,191.0,191.0,0,0,0.0,0.0,0.0
2957308.0,17,2,876,2,876,0.0,438.0,438.0,0,0,0.0,0.0,0.0
143912.0,17,2,180,1,90,0.0,90.0,90.0,1,90,0.0,90.0,90.0
95902851.0,6,173,19494,87,5964,1115149.4302325582,140.0,68.55172413793103,86,13530,1116007.3411764705,284.0,157.32558139534885
247105.0,6,3,373,2,238,0.0,172.0,119.0,1,135,0.0,135.0,135.0
498.0,17,2,508,2,508,0.0,257.0,254.0,0,0,0.0,0.0,0.0
1981536.0,6,19,6869,11,1567,198153.6,408.0,142.45454545454547,8,5302,224043.57142857145,1514.0,662.75
206442.0,6,3,426,2,280,0.0,214.0,140.0,1,146,0.0,146.0,146.0
228144.0,17,2,180,1,90,0.0,90.0,90.0,1,90,0.0,90.0,90.0
90294613.0,6,14,1043,7,542,15049102.166666666,95.0,77.42857142857143,7,501,14999950.666666666,95.0,71.57142857142857
66785.0,6,14,4740,7,653,10966.5,249.0,93.28571428571428,7,4087,10779.5,1514.0,583.8571428571429
33608.0,6,10,2032,5,524,8165.25,252.0,104.8,5,1508,7223.75,1236.0,301.6
299906.0,17,2,246,1,76,0.0,76.0,76.0,1,170,0.0,170.0,170.0
135136385.0,17,6,1146,6,1146,27027277.0,191.0,191.0,0,0,0.0,0.0,0.0
2288600.0,6,3,1602,2,850,0.0,784.0,425.0,1,752,0.0,752.0,752.0
30553.0,6,14,4740,7,653,4966.666666666667,249.0,93.28571428571428,7,4087,4758.0,1514.0,583.8571428571429
108101552.0,17,5,955,5,955,27025388.0,191.0,191.0,0,0,0.0,0.0,0.0
9071.0,17,2,507,1,86,0.0,86.0,86.0,1,421,0.0,421.0,421.0
152127.0,17,2,414,1,88,0.0,88.0,88.0,1,326,0.0,326.0,326.0
90528098.0,6,13,2036,8,1016,12932585.42857143,188.0,127.0,5,1020,22590928.75,204.0,204.0
120122326.0,6,16,2372,8,1356,17160332.285714287,204.0,169.5,8,1016,17098074.714285713,188.0,127.0
15063553.0,17,6,2718,6,2718,3012710.6,453.0,453.0,0,0,0.0,0.0,0.0
105255842.0,6,31,2314,16,1228,7002666.666666667,139.0,76.75,15,1086,7502855.428571428,123.0,72.4
143952.0,17,2,180,1,90,0.0,90.0,90.0,1,90,0.0,90.0,90.0
95287061.0,6,40,2640,20,1320,5015108.47368421,66.0,66.0,20,1320,5003733.684210527,66.0,66.0
7176.0,17,4,344,2,150,0.0,75.0,75.0,2,194,0.0,103.0,97.0
2099.0,17,4,344,2,150,0.0,75.0,75.0,2,194,0.0,103.0,97.0
143326.0,6,2,132,1,66,0.0,66.0,66.0,1,66,0.0,66.0,66.0
1879.0,17,2,180,1,90,0.0,90.0,90.0,1,90,0.0,90.0,90.0
312929.0,17,4,1400,4,1400,104309.66666666669,350.0,350.0,0,0,0.0,0.0,0.0
58788.0,6,12,1328,7,797,9798.0,253.0,113.85714285714286,5,531,12704.75,259.0,106.2
33716.0,6,14,4740,7,653,5493.666666666667,249.0,93.28571428571428,7,4087,5144.333333333333,1514.0,583.8571428571429
98491268.0,17,12,778,6,389,19600979.8,174.0,64.83333333333333,6,389,19600167.4,174.0,64.83333333333333
219465.0,17,2,180,1,90,0.0,90.0,90.0,1,90,0.0,90.0,90.0
37937.0,6,14,4740,7,653,5775.333333333333,249.0,93.28571428571428,7,4087,5525.333333333333,1514.0,583.8571428571429
49466.0,6,11,2098,6,590,9548.6,252.0,98.33333333333331,5,1508,12113.5,1236.0,301.6
2796896.0,6,2,132,1,66,0.0,66.0,66.0,1,66,0.0,66.0,66.0
37665.0,6,10,2032,5,524,9030.0,252.0,104.8,5,1508,8639.25,1236.0,301.6
74864.0,6,14,4740,7,653,12357.0,249.0,93.28571428571428,7,4087,11957.333333333334,1514.0,583.8571428571429
153593.0,17,2,180,1,90,0.0,90.0,90.0,1,90,0.0,90.0,90.0
100008694.0,6,339,41198,170,11516,591767.4201183432,140.0,67.74117647058823,169,29682,593124.5476190476,336.0,175.63313609467457
228441.0,17,2,180,1,90,0.0,90.0,90.0,1,90,0.0,90.0,90.0
2070.0,17,2,932,1,590,0.0,590.0,590.0,1,342,0.0,342.0,342.0
9207.0,17,2,539,1,86,0.0,86.0,86.0,1,453,0.0,453.0,453.0
70.0,17,2,762,2,762,0.0,381.0,381.0,0,0,0.0,0.0,0.0
281446.0,17,2,363,1,79,0.0,79.0,79.0,1,284,0.0,284.0,284.0
103222794.0,6,40,3094,21,1654,5161139.7,139.0,78.76190476190476,19,1440,5722584.666666667,123.0,75.78947368421052
2051484.0,6,18,6803,10,1501,227942.66666666663,408.0,150.1,8,5302,231251.14285714287,1514.0,662.75
121220804.0,6,36,2665,19,1471,6734489.111111111,139.0,77.42105263157895,17,1194,7418396.6875,123.0,70.23529411764706
90041534.0,17,28,13364,28,13364,3334871.6296296297,501.0,477.2857142857143,0,0,0.0,0.0,0.0
118560956.0,6,48,3168,24,1584,5154824.173913044,66.0,66.0,24,1584,5142838.826086956,66.0,66.0
2279.0,17,4,344,2,150,0.0,75.0,75.0,2,194,0.0,103.0,97.0
0.0,17,1,44,1,44,0.0,44.0,44.0,0,0,0.0,0.0,0.0
90202294.0,6,16,1192,8,596,12851983.0,95.0,74.5,8,596,12856832.0,95.0,74.5
303094.0,6,2,132,1,66,0.0,66.0,66.0,1,66,0.0,66.0,66.0
1978.0,17,2,192,1,88,0.0,88.0,88.0,1,104,0.0,104.0,104.0
320658.0,17,4,1400,4,1400,106886.0,350.0,350.0,0,0,0.0,0.0,0.0
5619278.0,6,5,336,2,134,0.0,68.0,67.0,3,202,1422668.5,70.0,67.33333333333333
204198.0,6,11,1132,6,556,39272.6,218.0,92.66666666666669,5,576,50696.0,304.0,115.2
154370.0,17,2,180,1,90,0.0,90.0,90.0,1,90,0.0,90.0,90.0
216522.0,6,10,1221,6,636,43304.4,298.0,106.0,4,585,71044.0,379.0,146.25
14648449.0,6,20,1607,10,975,1594035.111111111,315.0,97.5,10,632,1594009.4444444445,78.0,63.2
48572.0,6,10,2032,5,524,11855.75,252.0,104.8,5,1508,11035.25,1236.0,301.6
19729.0,6,11,1133,6,602,3292.4,264.0,100.33333333333331,5,531,4152.75,259.0,106.2
191390.0,17,2,906,2,906,0.0,453.0,453.0,0,0,0.0,0.0,0.0
66241.0,6,12,1328,7,797,11040.166666666666,253.0,113.85714285714286,5,531,12298.5,259.0,106.2
114473270.0,6,36,2596,18,1348,6721012.588235294,139.0,74.88888888888889,18,1248,6721015.705882353,123.0,69.33333333333333
122530494.0,6,49,3234,25,1650,5105437.25,66.0,66.0,24,1584,4970777.391304348,66.0,66.0
241696.0,6,3,373,2,238,0.0,172.0,119.0,1,135,0.0,135.0,135.0
120416889.0,6,227,25562,114,17808,1065636.185840708,284.0,156.21052631578948,113,7754,1066009.7142857143,140.0,68.61946902654867
2052.0,17,4,344,2,150,0.0,75.0,75.0,2,194,0.0,103.0,97.0
120032645.0,17,29,13785,29,13785,4286880.178571428,501.0,475.3448275862069,0,0,0.0,0.0,0.0
2092.0,17,4,344,2,150,0.0,75.0,75.0,2,194,0.0,103.0,97.0
114345811.0,6,221,24950,111,7548,1039507.3727272728,140.0,68.0,110,17402,1042657.6330275228,284.0,158.2
45647.0,6,14,4740,7,653,7322.833333333333,249.0,93.28571428571428,7,4087,7102.333333333333,1514.0,583.8571428571429
114428109.0,6,461,63168,231,15468,497513.5173913044,140.0,66.96103896103897,230,47700,498687.34934497817,480.0,207.3913043478261
146118.0,6,3,337,2,214,0.0,160.0,107.0,1,123,0.0,123.0,123.0
2345.0,17,4,344,2,150,0.0,75.0,75.0,2,194,0.0,103.0,97.0
27425.0,6,10,2032,5,524,6644.25,252.0,104.8,5,1508,6121.0,1236.0,301.6
34580.0,6,10,2032,5,524,7324.0,252.0,104.8,5,1508,7794.0,1236.0,301.6
5829784.0,6,4,270,2,134,0.0,68.0,67.0,2,136,0.0,70.0,68.0
207517.0,6,3,426,2,280,0.0,214.0,140.0,1,146,0.0,146.0,146.0
121005601.0,17,15,907,8,475,17286514.42857143,174.0,59.375,7,432,16833500.166666668,174.0,61.71428571428572
1166590.0,6,13,3010,8,2382,166655.7142857143,1514.0,297.75,5,628,223519.25,331.0,125.6
288363.0,17,2,180,1,90,0.0,90.0,90.0,1,90,0.0,90.0,90.0
90009929.0,17,28,13364,28,13364,3333701.074074074,501.0,477.2857142857143,0,0,0.0,0.0,0.0
90031840.0,17,28,13364,28,13364,3334512.592592593,501.0,477.2857142857143,0,0,0.0,0.0,0.0
120117922.0,6,13,2036,8,1016,17136765.42857143,188.0,127.0,5,1020,22522852.25,204.0,204.0
91961213.0,17,16,5472,16,5472,6130747.533333333,342.0,342.0,0,0,0.0,0.0,0.0
119413431.0,6,39,2902,20,1531,6284917.421052632,139.0,76.55,19,1371,6622074.777777778,123.0,72.15789473684211
34589.0,6,14,4740,7,653,5078.833333333333,249.0,93.28571428571428,7,4087,5086.0,1514.0,583.8571428571429
201858.0,17,2,180,1,90,0.0,90.0,90.0,1,90,0.0,90.0,90.0
120209324.0,6,216,24296,108,7424,1115870.1962616823,140.0,68.74074074074075,108,16872,1115787.7757009345,284.0,156.22222222222223
92059764.0,17,10,1065,10,1065,10228862.666666666,170.0,106.5,0,0,0.0,0.0,0.0
1303192.0,6,4,264,2,132,0.0,66.0,66.0,2,132,0.0,66.0,66.0
100381516.0,17,14,1126,7,563,16666816.333333334,174.0,80.42857142857143,7,563,16667637.666666666,174.0,80.42857142857143
108105775.0,17,5,1005,5,1005,27026443.75,201.0,201.0,0,0,0.0,0.0,0.0
120036317.0,6,222,25106,111,7622,1084954.6363636365,140.0,68.66666666666667,111,17484,1083692.181818182,284.0,157.51351351351352
216589.0,17,2,180,1,90,0.0,90.0,90.0,1,90,0.0,90.0,90.0
5621971.0,6,4,270,2,134,0.0,68.0,67.0,2,136,0.0,70.0,68.0
97589615.0,6,31,2176,16,1071,6505974.333333333,123.0,66.9375,15,1105,6910468.142857143,139.0,73.66666666666667
115793646.0,17,14,864,7,432,19167497.33333333,174.0,61.71428571428572,7,432,19166824.166666668,174.0,61.71428571428572
36580.0,6,14,4740,7,653,5798.833333333333,249.0,93.28571428571428,7,4087,5257.0,1514.0,583.8571428571429
103202979.0,6,41,2706,21,1386,5160148.95,66.0,66.0,20,1320,5213465.315789473,66.0,66.0
300547.0,6,6,412,4,272,100182.33333333331,74.0,68.0,2,140,0.0,74.0,70.0
204858.0,17,2,180,1,90,0.0,90.0,90.0,1,90,0.0,90.0,90.0
0.0,6,1,54,0,0,0.0,0.0,0.0,1,54,0.0,54.0,54.0
153445.0,17,2,180,1,90,0.0,90.0,90.0,1,90,0.0,90.0,90.0
2002.0,17,4,344,2,150,0.0,75.0,75.0,2,194,0.0,103.0,97.0
135136739.0,17,6,1146,6,1146,27027347.8,191.0,191.0,0,0,0.0,0.0,0.0
302293.0,6,6,412,4,272,100764.33333333331,74.0,68.0,2,140,0.0,74.0,70.0
2324.0,17,4,344,2,150,0.0,75.0,75.0,2,194,0.0,103.0,97.0
1298312.0,6,4,264,2,132,0.0,66.0,66.0,2,132,0.0,66.0,66.0
14418.0,6,10,2032,5,524,3351.25,252.0,104.8,5,1508,3444.75,1236.0,301.6
16835.0,17,2,180,1,90,0.0,90.0,90.0,1,90,0.0,90.0,90.0
256595.00000000003,6,12,1373,7,714,42765.833333333336,298.0,102.0,5,659,59811.5,379.0,131.8
30635.0,6,10,2032,5,524,5189.0,252.0,104.8,5,1508,6643.75,1236.0,301.6
32063.0,6,10,2032,5,524,7797.25,252.0,104.8,5,1508,7748.0,1236.0,301.6
108103893.0,17,5,955,5,955,27025973.25,191.0,191.0,0,0,0.0,0.0,0.0
120122320.0,6,14,2240,6,1224,24024464.0,204.0,204.0,8,1016,17136130.285714287,188.0,127.0
143936.0,17,2,180,1,90,0.0,90.0,90.0,1,90,0.0,90.0,90.0
204656.0,17,2,762,2,762,0.0,381.0,381.0,0,0,0.0,0.0,0.0
197087.0,17,2,180,1,90,0.0,90.0,90.0,1,90,0.0,90.0,90.0
162356.0,17,2,180,1,90,0.0,90.0,90.0,1,90,0.0,90.0,90.0
494255.0,6,5,336,2,134,0.0,68.0,67.0,3,202,194359.5,70.0,67.33333333333333
135135594.0,17,6,1206,6,1206,27027118.8,201.0,201.0,0,0,0.0,0.0,0.0
90023346.0,17,27,12943,27,12943,3462436.3846153845,501.0,479.3703703703704,0,0,0.0,0.0,0.0
149972967.0,17,36,17126,36,17126,4284941.914285715,501.0,475.72222222222223,0,0,0.0,0.0,0.0
90254871.0,6,12,1832,8,1016,12893553.0,188.0,127.0,4,816,30030989.666666668,204.0,204.0
867.0,17,4,438,2,148,0.0,74.0,74.0,2,290,0.0,147.0,145.0
2399.0,17,4,344,2,150,0.0,75.0,75.0,2,194,0.0,103.0,97.0
108109675.0,17,5,1005,5,1005,27027418.75,201.0,201.0,0,0,0.0,0.0,0.0
17948.0,6,10,2032,5,524,4256.25,252.0,104.8,5,1508,4096.25,1236.0,301.6
3590247.0,6,5,336,2,134,0.0,68.0,67.0,3,202,1429587.5,70.0,67.33333333333333
216528.0,17,2,180,1,90,0.0,90.0,90.0,1,90,0.0,90.0,90.0
10526048.0,6,7,478,4,272,3461443.333333333,74.0,68.0,3,206,5192099.0,74.0,68.66666666666667
153423.0,17,2,180,1,90,0.0,90.0,90.0,1,90,0.0,90.0,90.0
8574.0,17,4,823,2,163,0.0,89.0,81.5,2,660,0.0,443.0,330.0
0.0,17,1,350,1,350,0.0,350.0,350.0,0,0,0.0,0.0,0.0
39133.0,6,14,4740,7,653,6414.833333333333,249.0,93.28571428571428,7,4087,6164.0,1514.0,583.8571428571429
18762.0,17,2,180,1,90,0.0,90.0,90.0,1,90,0.0,90.0,90.0
108105133.0,17,5,955,5,955,27026283.25,191.0,191.0,0,0,0.0,0.0,0.0
7875.999999999999,17,4,823,2,163,0.0,89.0,81.5,2,660,0.0,443.0,330.0
120067298.0,17,29,13785,29,13785,4288117.785714285,501.0,475.3448275862069,0,0,0.0,0.0,0.0
2598570.0,6,2,132,1,66,0.0,66.0,66.0,1,66,0.0,66.0,66.0
171622.0,17,2,180,1,90,0.0,90.0,90.0,1,90,0.0,90.0,90.0
98076.0,17,2,762,2,762,0.0,381.0,381.0,0,0,0.0,0.0,0.0
118943562.0,6,35,2542,18,1348,6996680.117647059,139.0,74.88888888888889,17,1194,7421167.1875,123.0,70.23529411764706
123416451.0,6,48,3168,24,1584,5202201.217391305,66.0,66.0,24,1584,5099373.130434782,66.0,66.0
14637026.0,6,19,1553,9,921,1791794.375,315.0,102.33333333333331,10,632,1592672.3333333333,78.0,63.2
14948.0,17,2,180,1,90,0.0,90.0,90.0,1,90,0.0,90.0,90.0
851492.0,6,9,1268,6,797,170298.4,459.0,132.83333333333334,3,471,288091.5,331.0,157.0
115851774.0,17,16,1212,8,606,16428754.57142857,174.0,75.75,8,606,16429270.714285716,174.0,75.75
2128238.0,6,19,6869,11,1567,212823.8,408.0,142.45454545454547,8,5302,242224.7142857143,1514.0,662.75
113619275.0,6,46,3036,23,1518,5150435.7727272725,66.0,66.0,23,1518,5150452.727272728,66.0,66.0
90092846.0,6,10,1440,7,828,15015474.333333334,188.0,118.28571428571428,3,612,30031047.5,204.0,204.0
2184914.0,6,25,7610,13,2516,182013.5,1034.0,193.53846153846155,12,5094,171010.9090909091,1510.0,424.5
119330889.0,6,227,25472,114,7820,1056025.5663716814,140.0,68.59649122807018,113,17652,1056231.4910714286,284.0,156.21238938053096
103974.0,17,2,762,2,762,0.0,381.0,381.0,0,0,0.0,0.0,0.0
303154.0,6,2,132,1,66,0.0,66.0,66.0,1,66,0.0,66.0,66.0
94683.0,17,3,1050,3,1050,47341.5,350.0,350.0,0,0,0.0,0.0,0.0
228203.0,17,2,180,1,90,0.0,90.0,90.0,1,90,0.0,90.0,90.0
50998.0,6,14,4740,7,653,8179.5,249.0,93.28571428571428,7,4087,8041.833333333333,1514.0,583.8571428571429
14646900.0,6,20,1607,10,975,1592632.4444444445,315.0,97.5,10,632,1592610.4444444445,78.0,63.2
210321.0,17,2,414,1,88,0.0,88.0,88.0,1,326,0.0,326.0,326.0
0.0,6,1,66,1,66,0.0,66.0,66.0,0,0,0.0,0.0,0.0
108110371.0,17,5,955,5,955,27027592.75,191.0,191.0,0,0,0.0,0.0,0.0
248838.0,6,13,1394,7,797,41473.0,253.0,113.85714285714286,6,597,45451.4,259.0,99.5
108125109.0,17,5,955,5,955,27031277.25,191.0,191.0,0,0,0.0,0.0,0.0
25773.0,6,10,2032,5,524,6199.25,252.0,104.8,5,1508,6158.5,1236.0,301.6
90302238.0,6,19,1436,10,745,10028787.666666666,95.0,74.5,9,691,11287489.875,95.0,76.77777777777777
5005721.0,17,2,150,2,150,0.0,75.0,75.0,0,0,0.0,0.0,0.0
47532.0,6,14,4740,7,653,7794.0,249.0,93.28571428571428,7,4087,7684.166666666667,1514.0,583.8571428571429
15025859.0,17,6,2718,6,2718,3005171.8,453.0,453.0,0,0,0.0,0.0,0.0
2630.0,17,4,344,2,150,0.0,75.0,75.0,2,194,0.0,103.0,97.0
222365.0,6,4,492,2,280,0.0,214.0,140.0,2,212,0.0,146.0,106.0
46778467.0,6,8,1940,3,887,22011292.0,753.0,295.6666666666667,5,1053,11004302.75,785.0,210.6
634.0,17,2,762,2,762,0.0,381.0,381.0,0,0,0.0,0.0,0.0
116457630.0,6,33,2296,17,1225,7265113.5625,139.0,72.05882352941177,16,1071,7749456.066666666,123.0,66.9375
795.0,17,4,438,2,148,0.0,74.0,74.0,2,290,0.0,147.0,145.0
26633.0,6,14,4740,7,653,4124.333333333333,249.0,93.28571428571428,7,4087,4215.166666666667,1514.0,583.8571428571429
7072.0,17,4,823,2,163,0.0,89.0,81.5,2,660,0.0,443.0,330.0
35623.0,6,10,1065,5,534,7028.25,262.0,106.8,5,531,7837.5,259.0,106.2
36170.0,6,14,4740,7,653,5898.333333333333,249.0,93.28571428571428,7,4087,4353.333333333333,1514.0,583.8571428571429
25879.0,6,10,2032,5,524,6099.5,252.0,104.8,5,1508,6213.5,1236.0,301.6
14885.0,17,2,180,1,90,0.0,90.0,90.0,1,90,0.0,90.0,90.0
94538.0,17,3,1143,3,1143,47269.0,381.0,381.0,0,0,0.0,0.0,0.0
33706892.0,6,5,336,2,134,0.0,68.0,67.0,3,202,16780901.5,70.0,67.33333333333333
33016.0,6,14,4740,7,653,5331.5,249.0,93.28571428571428,7,4087,4421.666666666667,1514.0,583.8571428571429
120509517.0,6,217,24596,109,17172,1115828.861111111,284.0,157.54128440366972,108,7424,1116394.9439252336,140.0,68.74074074074075
135366.0,6,2,132,1,66,0.0,66.0,66.0,1,66,0.0,66.0,66.0
35519.0,6,10,2032,5,524,8449.0,252.0,104.8,5,1508,7323.0,1236.0,301.6
84604.0,17,2,286,2,286,0.0,143.0,143.0,0,0,0.0,0.0,0.0
15201.0,6,11,1132,6,556,2669.4,218.0,92.66666666666669,5,576,3531.75,304.0,115.2
303142.0,6,2,132,1,66,0.0,66.0,66.0,1,66,0.0,66.0,66.0
106303.0,17,2,700,2,700,0.0,350.0,350.0,0,0,0.0,0.0,0.0
14703.0,17,2,180,1,90,0.0,90.0,90.0,1,90,0.0,90.0,90.0
232965.0,6,3,337,2,214,0.0,160.0,107.0,1,123,0.0,123.0,123.0
94672825.0,17,12,778,6,389,18800849.0,174.0,64.83333333333333,6,389,18800201.2,174.0,64.83333333333333
90258346.0,6,13,1898,8,1016,12894049.42857143,188.0,127.0,5,882,22524267.75,204.0,176.4
10500679.0,6,7,478,4,272,3454784.0,74.0,68.0,3,206,5182074.0,74.0,68.66666666666667
5627931.0,6,5,336,2,134,0.0,68.0,67.0,3,202,1524251.5,70.0,67.33333333333333
35993.0,6,14,4740,7,653,5740.5,249.0,93.28571428571428,7,4087,5026.833333333333,1514.0,583.8571428571429
112801.0,17,2,762,2,762,0.0,381.0,381.0,0,0,0.0,0.0,0.0
10894595.0,6,8,544,4,272,3586158.6666666665,74.0,68.0,4,272,3586102.6666666665,74.0,68.0
90042943.0,17,28,13364,28,13364,3334923.814814815,501.0,477.2857142857143,0,0,0.0,0.0,0.0
108106395.0,17,5,1005,5,1005,27026598.75,201.0,201.0,0,0,0.0,0.0,0.0
300702.0,6,6,412,4,272,100234.0,74.0,68.0,2,140,0.0,74.0,70.0
65945.0,6,14,4740,7,653,10867.333333333334,249.0,93.28571428571428,7,4087,10176.0,1514.0,583.8571428571429
161527.0,6,14,4740,7,653,23558.83333333333,249.0,93.28571428571428,7,4087,21676.666666666668,1514.0,583.8571428571429
15914.999999999998,6,14,4740,7,653,2489.833333333333,249.0,93.28571428571428,7,4087,2506.6666666666665,1514.0,583.8571428571429
102105452.0,6,30,2106,15,1089,7277839.714285715,123.0,72.6,15,1017,7277841.785714285,123.0,67.8
11582974.0,6,5,1736,2,819,0.0,753.0,409.5,3,917,4496887.5,785.0,305.6666666666667
127913926.0,17,14,864,7,432,18000171.333333332,174.0,61.71428571428572,7,432,17998892.666666668,174.0,61.71428571428572
855477.0,6,6,758,3,410,310345.5,172.0,136.66666666666666,3,348,302917.5,135.0,116.0
1306782.0,17,7,490,7,490,217797.0,70.0,70.0,0,0,0.0,0.0,0.0
138473.0,17,2,176,1,80,0.0,80.0,80.0,1,96,0.0,96.0,96.0
2955.0,17,2,180,1,90,0.0,90.0,90.0,1,90,0.0,90.0,90.0
65673.0,6,14,4740,7,653,10408.5,249.0,93.28571428571428,7,4087,10423.333333333334,1514.0,583.8571428571429
120069453.0,17,29,13785,29,13785,4288194.75,501.0,475.3448275862069,0,0,0.0,0.0,0.0
95014896.0,17,12,778,6,389,19000168.6,174.0,64.83333333333333,6,389,19000876.2,174.0,64.83333333333333
120462172.0,6,26,2019,15,1179,8604440.857142856,95.0,78.6,11,840,9138370.6,95.0,76.36363636363636
747255.0,6,2,132,1,66,0.0,66.0,66.0,1,66,0.0,66.0,66.0
36768570.0,6,5,336,3,202,18317059.5,70.0,67.33333333333333,2,134,0.0,68.0,67.0
298392.0,6,6,412,4,272,99464.0,74.0,68.0,2,140,0.0,74.0,70.0
103903052.0,6,20,1727,10,1023,11517196.111111112,336.0,102.3,10,704,11520855.888888888,95.0,70.4
90089465.0,6,12,1572,7,828,15014910.833333334,188.0,118.28571428571428,5,744,15015507.75,204.0,148.8
135130358.0,17,6,1206,6,1206,27026071.6,201.0,201.0,0,0,0.0,0.0,0.0
68809.0,6,14,4740,7,653,11307.333333333334,249.0,93.28571428571428,7,4087,9739.166666666666,1514.0,583.8571428571429
12057.0,6,11,2098,6,590,1997.8,252.0,98.33333333333331,5,1508,2751.25,1236.0,301.6
2559.0,17,2,180,1,90,0.0,90.0,90.0,1,90,0.0,90.0,90.0
111142581.0,17,14,1126,7,563,18497077.5,174.0,80.42857142857143,7,563,18497077.0,174.0,80.42857142857143
119063.0,6,2,132,1,66,0.0,66.0,66.0,1,66,0.0,66.0,66.0
2380.0,17,4,344,2,150,0.0,75.0,75.0,2,194,0.0,103.0,97.0
90255560.0,6,12,1832,8,1016,12893651.42857143,188.0,127.0,4,816,30030218.0,204.0,204.0
122314693.0,6,48,3168,24,1584,5186073.173913044,66.0,66.0,24,1584,5021685.130434782,66.0,66.0
47965.0,6,2,132,1,66,0.0,66.0,66.0,1,66,0.0,66.0,66.0
36305.0,6,13,4412,6,409,7114.4,127.0,68.16666666666667,7,4003,5864.5,1514.0,571.8571428571429
62002.0,6,10,2032,5,524,14688.75,252.0,104.8,5,1508,14806.5,1236.0,301.6
11939.0,6,10,1067,5,536,2717.0,264.0,107.2,5,531,2727.0,259.0,106.2
47703.0,6,10,2032,5,524,11672.75,252.0,104.8,5,1508,11347.5,1236.0,301.6
10471403.0,6,7,478,4,272,3445101.6666666665,74.0,68.0,3,206,5167559.0,74.0,68.66666666666667
113520151.0,6,46,3036,23,1518,5159995.636363637,66.0,66.0,23,1518,5159994.227272728,66.0,66.0
39610.0,6,13,1479,7,882,6601.666666666667,291.0,126.0,6,597,6966.4,259.0,99.5
37211.0,6,14,4740,7,653,6072.166666666667,249.0,93.28571428571428,7,4087,5918.5,1514.0,583.8571428571429
5006312.0,17,4,629,2,156,0.0,78.0,78.0,2,473,0.0,268.0,236.5
982.0,17,4,438,2,148,0.0,74.0,74.0,2,290,0.0,147.0,145.0
4114.0,17,2,762,2,762,0.0,381.0,381.0,0,0,0.0,0.0,0.0
218058.0,6,3,426,2,280,0.0,214.0,140.0,1,146,0.0,146.0,146.0
27937.0,6,14,4740,7,653,4121.166666666667,249.0,93.28571428571428,7,4087,4176.0,1514.0,583.8571428571429
108107138.0,17,5,1005,5,1005,27026784.5,201.0,201.0,0,0,0.0,0.0,0.0
919.0,17,2,248,1,84,0.0,84.0,84.0,1,164,0.0,164.0,164.0
24210.0,6,14,4740,7,653,3721.0,249.0,93.28571428571428,7,4087,3897.5,1514.0,583.8571428571429
47976.0,6,14,4740,7,653,7865.666666666667,249.0,93.28571428571428,7,4087,7802.666666666667,1514.0,583.8571428571429
707110.0,6,10,967,5,390,119229.0,162.0,78.0,5,577,119169.25,349.0,115.4
90038334.0,17,28,13364,28,13364,3334753.111111111,501.0,477.2857142857143,0,0,0.0,0.0,0.0
301.0,17,2,174,1,79,0.0,79.0,79.0,1,95,0.0,95.0,95.0
303619.0,6,2,132,1,66,0.0,66.0,66.0,1,66,0.0,66.0,66.0
205740.0,17,2,180,1,90,0.0,90.0,90.0,1,90,0.0,90.0,90.0
202477.0,17,2,620,1,75,0.0,75.0,75.0,1,545,0.0,545.0,545.0
5624646.0,6,5,336,2,134,0.0,68.0,67.0,3,202,1425695.5,70.0,67.33333333333333
112143191.0,6,283,32536,142,9668,795341.780141844,140.0,68.08450704225352,141,22868,793377.8785714286,284.0,162.18439716312056
209403.0,17,2,180,1,90,0.0,90.0,90.0,1,90,0.0,90.0,90.0
47937.0,6,14,4740,7,653,7832.5,249.0,93.28571428571428,7,4087,6812.0,1514.0,583.8571428571429
10437974.0,6,7,478,4,272,3432565.333333333,74.0,68.0,3,206,5148065.5,74.0,68.66666666666667
14503465.0,17,6,2052,6,2052,2900693.0,342.0,342.0,0,0,0.0,0.0,0.0
143954.0,17,2,180,1,90,0.0,90.0,90.0,1,90,0.0,90.0,90.0
119483743.0,6,211,23930,106,16778,1137940.4095238096,284.0,158.28301886792454,105,7152,1138738.3557692308,140.0,68.11428571428571
131063.0,6,11,1132,6,556,25976.8,218.0,92.66666666666669,5,576,32486.5,304.0,115.2
2366.0,17,4,344,2,150,0.0,75.0,75.0,2,194,0.0,103.0,97.0
317581.0,17,4,1400,4,1400,105860.33333333331,350.0,350.0,0,0,0.0,0.0,0.0
32222.0,6,11,1133,6,602,5815.6,264.0,100.33333333333331,5,531,6523.25,259.0,106.2
55280.0,6,14,4740,7,653,8029.5,249.0,93.28571428571428,7,4087,9031.833333333334,1514.0,583.8571428571429
12709.0,6,14,4740,7,653,1861.0,249.0,93.28571428571428,7,4087,1982.3333333333333,1514.0,583.8571428571429
197198.0,17,2,180,1,90,0.0,90.0,90.0,1,90,0.0,90.0,90.0
0.0,6,1,66,1,66,0.0,66.0,66.0,0,0,0.0,0.0,0.0
1431.0,17,2,762,2,762,0.0,381.0,381.0,0,0,0.0,0.0,0.0
41885.0,6,14,4740,7,653,6850.0,249.0,93.28571428571428,7,4087,6541.166666666667,1514.0,583.8571428571429
108099738.0,17,5,1005,5,1005,27024934.5,201.0,201.0,0,0,0.0,0.0,0.0
364.0,17,2,160,1,80,0.0,80.0,80.0,1,80,0.0,80.0,80.0
311848.0,17,4,1400,4,1400,103949.33333333331,350.0,350.0,0,0,0.0,0.0,0.0
0.0,17,1,381,1,381,0.0,381.0,381.0,0,0,0.0,0.0,0.0
149106.0,17,4,704,2,148,0.0,74.0,74.0,2,556,0.0,280.0,278.0
2616251.0,6,2,132,1,66,0.0,66.0,66.0,1,66,0.0,66.0,66.0
852975.0,6,9,1196,6,725,170595.0,387.0,120.83333333333331,3,471,290267.5,331.0,157.0
173237.0,17,4,704,2,148,0.0,74.0,74.0,2,556,0.0,280.0,278.0
232284.0,6,3,337,2,214,0.0,160.0,107.0,1,123,0.0,123.0,123.0
20494.0,17,2,582,1,83,0.0,83.0,83.0,1,499,0.0,499.0,499.0
14643740.0,6,20,1607,10,975,1592409.888888889,315.0,97.5,10,632,1592416.3333333333,78.0,63.2
108103027.0,17,5,955,5,955,27025756.75,191.0,191.0,0,0,0.0,0.0,0.0
298356.0,6,6,412,4,272,99452.0,74.0,68.0,2,140,0.0,74.0,70.0
404.0,17,2,166,1,75,0.0,75.0,75.0,1,91,0.0,91.0,91.0
90017469.0,17,28,13364,28,13364,3333980.333333333,501.0,477.2857142857143,0,0,0.0,0.0,0.0
103667.0,17,2,286,2,286,0.0,143.0,143.0,0,0,0.0,0.0,0.0
2094.0,17,4,344,2,150,0.0,75.0,75.0,2,194,0.0,103.0,97.0
128170959.0,6,30,1980,16,1086,8544730.6,123.0,67.875,14,894,8306328.230769231,123.0,63.85714285714285
3290511.0,6,7,923,4,753,1028015.3333333334,571.0,188.25,3,170,1542344.5,62.0,56.66666666666666
31043.0,6,10,2032,5,524,5239.5,252.0,104.8,5,1508,7208.25,1236.0,301.6
2323.0,17,4,344,2,150,0.0,75.0,75.0,2,194,0.0,103.0,97.0
320931.0,17,4,1400,4,1400,106977.0,350.0,350.0,0,0,0.0,0.0,0.0
23870.0,6,19,7540,11,978,2387.0,310.0,88.9090909090909,8,6562,2483.5714285714284,1514.0,820.25
283010.0,17,2,363,1,79,0.0,79.0,79.0,1,284,0.0,284.0,284.0
147539.0,6,3,337,2,214,0.0,160.0,107.0,1,123,0.0,123.0,123.0
196840.0,17,2,180,1,90,0.0,90.0,90.0,1,90,0.0,90.0,90.0
1495.0,17,2,762,2,762,0.0,381.0,381.0,0,0,0.0,0.0,0.0
24220.0,17,2,582,1,83,0.0,83.0,83.0,1,499,0.0,499.0,499.0
196862.0,17,2,180,1,90,0.0,90.0,90.0,1,90,0.0,90.0,90.0
993639.0,6,12,2710,7,743,165606.5,339.0,106.14285714285714,5,1967,179409.75,1514.0,393.4
90040619.0,17,28,13364,28,13364,3334837.7407407407,501.0,477.2857142857143,0,0,0.0,0.0,0.0
465057.0,6,11,1021,6,444,64266.8,162.0,74.0,5,577,80089.25,349.0,115.4
218300.0,6,3,426,2,280,0.0,214.0,140.0,1,146,0.0,146.0,146.0
109991116.0,6,400,66214,200,52570,551637.6482412061,1514.0,262.85,200,13644,551638.2060301508,214.0,68.22
90746153.0,6,17,1287,9,691,11337260.0,95.0,76.77777777777777,8,596,12961498.714285716,95.0,74.5
304780.0,6,6,412,4,272,101593.33333333331,74.0,68.0,2,140,0.0,74.0,70.0
299.0,17,2,164,1,82,0.0,82.0,82.0,1,82,0.0,82.0,82.0
10459906.0,6,7,478,4,272,3441120.0,74.0,68.0,3,206,5161557.0,74.0,68.66666666666667
108104799.0,17,5,955,5,955,27026199.75,191.0,191.0,0,0,0.0,0.0,0.0
135131403.0,17,6,1206,6,1206,27026280.6,201.0,201.0,0,0,0.0,0.0,0.0
125994818.0,17,15,907,8,475,17999259.714285713,174.0,59.375,7,432,17500169.666666668,174.0,61.71428571428572
101280674.0,17,14,864,7,432,16833493.166666668,174.0,61.71428571428572,7,432,16834325.0,174.0,61.71428571428572
90031063.0,6,11,840,6,488,18006212.6,95.0,81.33333333333333,5,352,15002522.25,95.0,70.4
308223.0,17,4,1400,4,1400,102741.0,350.0,350.0,0,0,0.0,0.0,0.0
108108587.0,17,5,1005,5,1005,27027146.75,201.0,201.0,0,0,0.0,0.0,0.0
21830.0,6,14,4740,7,653,2885.833333333333,249.0,93.28571428571428,7,4087,3460.6666666666665,1514.0,583.8571428571429
17043.0,17,2,180,1,90,0.0,90.0,90.0,1,90,0.0,90.0,90.0
4354.0,17,2,614,1,72,0.0,72.0,72.0,1,542,0.0,542.0,542.0
143925.0,17,2,180,1,90,0.0,90.0,90.0,1,90,0.0,90.0,90.0
158491.0,6,3,337,2,214,0.0,160.0,107.0,1,123,0.0,123.0,123.0
198531.0,17,2,180,1,90,0.0,90.0,90.0,1,90,0.0,90.0,90.0
115026719.0,6,47,3102,24,1584,5001147.826086956,66.0,66.0,23,1518,5144001.181818182,66.0,66.0
92592466.0,6,38,2508,19,1254,5144006.388888889,66.0,66.0,19,1254,5144010.333333333,66.0,66.0
197781.0,17,2,180,1,90,0.0,90.0,90.0,1,90,0.0,90.0,90.0
34573.0,6,14,4740,7,653,5473.0,249.0,93.28571428571428,7,4087,4235.666666666667,1514.0,583.8571428571429
300751.0,6,6,412,4,272,100250.33333333331,74.0,68.0,2,140,0.0,74.0,70.0
90263803.0,6,15,2444,8,1016,12894829.0,188.0,127.0,7,1428,15016973.833333334,204.0,204.0
15615.0,6,14,4740,7,653,2355.5,249.0,93.28571428571428,7,4087,2412.333333333333,1514.0,583.8571428571429
61997.0,6,14,4740,7,653,10204.333333333334,249.0,93.28571428571428,7,4087,9442.0,1514.0,583.8571428571429
121393.0,6,3,337,2,214,0.0,160.0,107.0,1,123,0.0,123.0,123.0
216101.0,6,11,1132,6,556,43220.2,218.0,92.66666666666669,5,576,52436.5,304.0,115.2
107394.0,17,2,286,2,286,0.0,143.0,143.0,0,0,0.0,0.0,0.0
321.0,17,2,174,1,79,0.0,79.0,79.0,1,95,0.0,95.0,95.0
213668.0,17,2,180,1,90,0.0,90.0,90.0,1,90,0.0,90.0,90.0
183624.0,17,2,180,1,90,0.0,90.0,90.0,1,90,0.0,90.0,90.0
213791.0,17,2,180,1,90,0.0,90.0,90.0,1,90,0.0,90.0,90.0
142799.0,17,4,704,2,148,0.0,74.0,74.0,2,556,0.0,280.0,278.0
153422.0,17,2,180,1,90,0.0,90.0,90.0,1,90,0.0,90.0,90.0
120589.0,6,3,373,2,238,0.0,172.0,119.0,1,135,0.0,135.0,135.0
10598.0,6,2,177,1,123,0.0,123.0,123.0,1,54,0.0,54.0,54.0
101018.0,17,2,286,2,286,0.0,143.0,143.0,0,0,0.0,0.0,0.0
120134153.0,6,468,56850,234,41172,514716.0429184549,390.0,175.94871794871796,234,15678,514716.4248927039,140.0,67.0
63144.00000000001,6,10,1066,5,490,14457.75,218.0,98.0,5,576,15561.0,304.0,115.2
10024277.0,17,3,270,3,270,5012138.5,90.0,90.0,0,0,0.0,0.0,0.0
86278.0,6,15,4806,8,719,11898.57142857143,249.0,89.875,7,4087,13830.166666666666,1514.0,583.8571428571429
214487.0,6,10,1221,6,636,42897.4,298.0,106.0,4,585,70091.0,379.0,146.25
237802.0,6,3,337,2,214,0.0,160.0,107.0,1,123,0.0,123.0,123.0
50844.0,6,14,4740,7,653,8344.333333333334,249.0,93.28571428571428,7,4087,7909.333333333333,1514.0,583.8571428571429
56056.0,6,14,4740,7,653,9162.333333333334,249.0,93.28571428571428,7,4087,9192.666666666666,1514.0,583.8571428571429
3741760.0,6,5,336,2,134,0.0,68.0,67.0,3,202,1423756.0,70.0,67.33333333333333
254599.00000000003,6,3,337,2,214,0.0,160.0,107.0,1,123,0.0,123.0,123.0
303125.0,6,2,132,1,66,0.0,66.0,66.0,1,66,0.0,66.0,66.0
3398273.0,6,174,140246,101,131126,33982.73,1510.0,1298.2772277227723,73,9120,42928.51388888889,1510.0,124.93150684931508
349200.0,6,4,508,2,238,0.0,172.0,119.0,2,270,0.0,135.0,135.0
237871.0,6,3,337,2,214,0.0,160.0,107.0,1,123,0.0,123.0,123.0
21395.0,17,2,582,1,83,0.0,83.0,83.0,1,499,0.0,499.0,499.0
108096500.0,17,5,1005,5,1005,27024125.0,201.0,201.0,0,0,0.0,0.0,0.0
90293103.0,6,16,1192,8,596,12891914.42857143,95.0,74.5,8,596,12898559.0,95.0,74.5
135129.0,6,2,132,1,66,0.0,66.0,66.0,1,66,0.0,66.0,66.0
102111698.0,6,315,49502,158,10798,650392.9808917197,214.0,68.34177215189874,157,38704,649933.5769230769,1514.0,246.52229299363057
19159.0,6,13,1386,7,789,2930.833333333333,253.0,112.71428571428572,6,597,3449.6,259.0,99.5
2800667.0,6,2,132,1,66,0.0,66.0,66.0,1,66,0.0,66.0,66.0
446.0,17,2,166,1,75,0.0,75.0,75.0,1,91,0.0,91.0,91.0
10506953.0,6,7,478,4,272,3456705.6666666665,74.0,68.0,3,206,5184966.0,74.0,68.66666666666667
35729.0,6,14,4740,7,653,5829.333333333333,249.0,93.28571428571428,7,4087,5169.333333333333,1514.0,583.8571428571429
12442.0,17,4,823,2,163,0.0,89.0,81.5,2,660,0.0,443.0,330.0
135129565.0,17,6,1146,6,1146,27025913.0,191.0,191.0,0,0,0.0,0.0,0.0
90255103.0,6,14,2240,8,1016,12893586.142857144,188.0,127.0,6,1224,18018578.0,204.0,204.0
217094.0,6,3,426,2,280,0.0,214.0,140.0,1,146,0.0,146.0,146.0
153529.0,17,2,180,1,90,0.0,90.0,90.0,1,90,0.0,90.0,90.0
1244440.0,6,7,499,3,198,614373.0,66.0,66.0,4,301,401623.6666666667,103.0,75.25
146304.0,6,3,337,2,214,0.0,160.0,107.0,1,123,0.0,123.0,123.0
352.0,17,2,267,1,83,0.0,83.0,83.0,1,184,0.0,184.0,184.0
303788.0,6,6,412,4,272,101262.66666666669,74.0,68.0,2,140,0.0,74.0,70.0
116218964.0,6,48,3168,24,1584,5052998.434782608,66.0,66.0,24,1584,5041014.913043479,66.0,66.0
852079.0,6,9,1096,6,625,170415.8,287.0,104.16666666666669,3,471,288240.5,331.0,157.0
108120062.0,17,5,1005,5,1005,27030015.5,201.0,201.0,0,0,0.0,0.0,0.0
16790.0,6,10,2032,5,524,3906.75,252.0,104.8,5,1508,3269.0,1236.0,301.6
143857.0,17,2,180,1,90,0.0,90.0,90.0,1,90,0.0,90.0,90.0
56143.0,6,11,2098,6,590,10768.6,252.0,98.33333333333331,5,1508,8011.75,1236.0,301.6
153439.0,17,2,180,1,90,0.0,90.0,90.0,1,90,0.0,90.0,90.0
1317100.0,6,4,264,2,132,0.0,66.0,66.0,2,132,0.0,66.0,66.0
3489428.0,6,5,336,2,134,0.0,68.0,67.0,3,202,531114.5,70.0,67.33333333333333
0.0,6,1,66,1,66,0.0,66.0,66.0,0,0,0.0,0.0,0.0
104153334.0,17,14,1388,7,694,17332266.166666668,174.0,99.14285714285714,7,694,17332265.5,174.0,99.14285714285714
103200240.0,6,42,2772,21,1386,5159999.1,66.0,66.0,21,1386,5159994.3,66.0,66.0
284185.0,17,2,363,1,79,0.0,79.0,79.0,1,284,0.0,284.0,284.0
135132849.0,17,6,1206,6,1206,27026569.8,201.0,201.0,0,0,0.0,0.0,0.0
306315.0,17,4,1524,4,1524,102105.0,381.0,381.0,0,0,0.0,0.0,0.0
20589456.0,17,4,1376,3,1026,515553.5,342.0,342.0,1,350,0.0,350.0,350.0
90038846.0,17,28,13364,28,13364,3334772.074074074,501.0,477.2857142857143,0,0,0.0,0.0,0.0
1537242.0,6,20,7599,11,1469,153724.2,583.0,133.54545454545453,9,6130,160168.25,1484.0,681.1111111111111
2581235.0,6,2,132,1,66,0.0,66.0,66.0,1,66,0.0,66.0,66.0
2797795.0,6,2,132,1,66,0.0,66.0,66.0,1,66,0.0,66.0,66.0
14322.0,6,13,1459,7,862,2191.1666666666665,271.0,123.14285714285714,6,597,2711.2,259.0,99.5
116570981.0,6,32,2236,16,1071,7771398.733333333,123.0,66.9375,16,1165,7690024.4,139.0,72.8125
100142033.0,17,12,516,6,258,20000205.2,43.0,43.0,6,258,20000906.6,43.0,43.0
5623214.0,6,4,270,2,134,0.0,68.0,67.0,2,136,0.0,70.0,68.0
10477498.0,6,7,478,4,272,3445265.0,74.0,68.0,3,206,5167794.5,74.0,68.66666666666667
50983.0,17,2,180,1,90,0.0,90.0,90.0,1,90,0.0,90.0,90.0
169634.0,6,14,4740,7,653,22042.0,249.0,93.28571428571428,7,4087,27360.5,1514.0,583.8571428571429
120029480.0,17,28,13364,28,13364,4445536.296296297,501.0,477.2857142857143,0,0,0.0,0.0,0.0
1302092.0,6,4,264,2,132,0.0,66.0,66.0,2,132,0.0,66.0,66.0
24488864.0,17,5,1718,4,1368,788249.3333333334,342.0,342.0,1,350,0.0,350.0,350.0
104230701.0,6,43,2838,22,1452,4948641.0,66.0,66.0,21,1386,5151154.2,66.0,66.0
315251.0,17,4,1400,4,1400,105083.66666666669,350.0,350.0,0,0,0.0,0.0,0.0
53703.0,6,14,4740,7,653,8834.333333333334,249.0,93.28571428571428,7,4087,7823.166666666667,1514.0,583.8571428571429
1987.0,17,4,344,2,150,0.0,75.0,75.0,2,194,0.0,103.0,97.0
261954.00000000003,6,10,1221,6,636,52390.8,298.0,106.0,4,585,81849.66666666667,379.0,146.25
39607620.0,6,19,1375,9,681,4950474.875,95.0,75.66666666666667,10,694,4315814.111111111,95.0,69.4
2457.0,17,4,344,2,150,0.0,75.0,75.0,2,194,0.0,103.0,97.0
114815128.0,6,32,2236,16,1165,7639947.6,139.0,72.8125,16,1071,7639960.2,123.0,66.9375
1022487.0,6,11,1134,6,558,204497.4,220.0,93.0,5,576,255105.5,304.0,115.2
90334622.0,6,16,1192,8,596,12898012.714285716,95.0,74.5,8,596,12903824.285714284,95.0,74.5
407.0,17,2,267,1,83,0.0,83.0,83.0,1,184,0.0,184.0,184.0
117512411.0,6,48,3168,24,1584,5109235.260869565,66.0,66.0,24,1584,5097215.043478261,66.0,66.0
308193.0,6,6,412,4,272,102731.0,74.0,68.0,2,140,0.0,74.0,70.0
15478.0,6,10,2032,5,524,2955.0,252.0,104.8,5,1508,3510.75,1236.0,301.6
122975471.0,6,48,3168,24,1584,5106536.695652174,66.0,66.0,24,1584,5160567.217391305,66.0,66.0
146391.0,6,3,337,2,214,0.0,160.0,107.0,1,123,0.0,123.0,123.0
153507.0,17,2,180,1,90,0.0,90.0,90.0,1,90,0.0,90.0,90.0
45377.0,6,14,4740,7,653,7437.0,249.0,93.28571428571428,7,4087,7422.833333333333,1514.0,583.8571428571429
108104035.0,17,5,1005,5,1005,27026008.75,201.0,201.0,0,0,0.0,0.0,0.0
43868.0,6,14,4740,7,653,6194.333333333333,249.0,93.28571428571428,7,4087,7153.5,1514.0,583.8571428571429
115240998.0,6,47,3102,24,1584,4997223.913043479,66.0,66.0,23,1518,5150447.090909091,66.0,66.0
90098800.0,17,28,13364,28,13364,3336992.592592593,501.0,477.2857142857143,0,0,0.0,0.0,0.0
284.0,17,2,174,1,79,0.0,79.0,79.0,1,95,0.0,95.0,95.0
90515604.0,6,13,1910,8,1016,12909383.285714284,188.0,127.0,5,894,15121825.5,204.0,178.8
90525815.0,6,14,2240,8,1016,12932259.285714284,188.0,127.0,6,1224,18072424.6,204.0,204.0
146168.0,6,3,337,2,214,0.0,160.0,107.0,1,123,0.0,123.0,123.0
120121942.0,6,14,2224,9,1204,15015242.75,188.0,133.77777777777777,5,1020,22591881.0,204.0,204.0
22958.0,6,14,4740,7,653,2857.1666666666665,249.0,93.28571428571428,7,4087,3688.1666666666665,1514.0,583.8571428571429
216405.0,17,2,180,1,90,0.0,90.0,90.0,1,90,0.0,90.0,90.0
146706.0,6,3,337,2,214,0.0,160.0,107.0,1,123,0.0,123.0,123.0
486549.0,17,2,363,1,75,0.0,75.0,75.0,1,288,0.0,288.0,288.0
202866.0,17,2,762,2,762,0.0,381.0,381.0,0,0,0.0,0.0,0.0
354.0,17,2,267,1,83,0.0,83.0,83.0,1,184,0.0,184.0,184.0
232207.0,6,3,337,2,214,0.0,160.0,107.0,1,123,0.0,123.0,123.0
42687.0,6,14,4740,7,653,6227.5,249.0,93.28571428571428,7,4087,6974.833333333333,1514.0,583.8571428571429
90258106.0,6,16,2368,9,1204,11282263.25,188.0,133.77777777777777,7,1164,15015101.0,204.0,166.28571428571428
108105661.0,17,5,1005,5,1005,27026415.25,201.0,201.0,0,0,0.0,0.0,0.0
108162308.0,6,243,28164,122,8274,893903.3719008265,140.0,67.81967213114754,121,19890,892636.4583333334,284.0,164.3801652892562
271463.0,6,10,1221,6,636,54292.6,298.0,106.0,4,585,84702.0,379.0,146.25
6775.0,17,2,582,1,83,0.0,83.0,83.0,1,499,0.0,499.0,499.0
216877.0,6,3,426,2,280,0.0,214.0,140.0,1,146,0.0,146.0,146.0
10478164.0,6,7,478,4,272,3445775.0,74.0,68.0,3,206,5168522.0,74.0,68.66666666666667
366.0,17,2,300,1,80,0.0,80.0,80.0,1,220,0.0,220.0,220.0
217838.0,6,3,426,2,280,0.0,214.0,140.0,1,146,0.0,146.0,146.0
90261435.0,6,13,2036,8,1016,12894490.714285716,188.0,127.0,5,1020,22523477.5,204.0,204.0
10487574.0,6,7,478,4,272,3450292.6666666665,74.0,68.0,3,206,5175331.5,74.0,68.66666666666667
9286.0,6,11,2098,6,590,1633.2,252.0,98.33333333333331,5,1508,1942.75,1236.0,301.6
135133501.0,17,6,1206,6,1206,27026700.2,201.0,201.0,0,0,0.0,0.0,0.0
302495.0,6,6,412,4,272,100831.66666666669,74.0,68.0,2,140,0.0,74.0,70.0
26818814.0,17,5,1710,5,1710,6704703.5,342.0,342.0,0,0,0.0,0.0,0.0
2392.0,17,4,344,2,150,0.0,75.0,75.0,2,194,0.0,103.0,97.0
3073309.0,6,158,123438,88,114516,35325.3908045977,1510.0,1301.3181818181818,70,8922,40029.92753623189,1510.0,127.45714285714286
240161.0,6,3,337,2,214,0.0,160.0,107.0,1,123,0.0,123.0,123.0
208552.0,6,10,1221,6,636,41710.4,298.0,106.0,4,585,68211.33333333333,379.0,146.25
1442.0,17,5,550,5,550,360.5,110.0,110.0,0,0,0.0,0.0,0.0
5005616.0,17,2,168,2,168,0.0,84.0,84.0,0,0,0.0,0.0,0.0
322277.0,17,4,1400,4,1400,107425.66666666669,350.0,350.0,0,0,0.0,0.0,0.0
90056315.0,17,28,13364,28,13364,3335419.074074074,501.0,477.2857142857143,0,0,0.0,0.0,0.0
209657.0,17,2,180,1,90,0.0,90.0,90.0,1,90,0.0,90.0,90.0
8574.0,17,2,180,1,90,0.0,90.0,90.0,1,90,0.0,90.0,90.0
30364.0,6,12,1413,7,882,5060.666666666667,291.0,126.0,5,531,6561.75,259.0,106.2
2435.0,17,4,344,2,150,0.0,75.0,75.0,2,194,0.0,103.0,97.0
139302.0,17,4,344,2,150,0.0,75.0,75.0,2,194,0.0,103.0,97.0
11520.0,6,10,1065,5,534,2388.0,262.0,106.8,5,531,2314.25,259.0,106.2
10475256.0,6,7,478,4,272,3446038.0,74.0,68.0,3,206,5168951.0,74.0,68.66666666666667
117871790.0,6,38,2779,19,1371,6548432.777777778,123.0,72.15789473684211,19,1408,6536373.777777778,139.0,74.10526315789474
0.0,6,1,66,1,66,0.0,66.0,66.0,0,0,0.0,0.0,0.0
2085.0,17,4,344,2,150,0.0,75.0,75.0,2,194,0.0,103.0,97.0
4533.0,17,2,626,1,72,0.0,72.0,72.0,1,554,0.0,554.0,554.0
27536.0,6,14,4740,7,653,3863.1666666666665,249.0,93.28571428571428,7,4087,4304.333333333333,1514.0,583.8571428571429
31267.000000000004,6,14,4740,7,653,4217.0,249.0,93.28571428571428,7,4087,5055.333333333333,1514.0,583.8571428571429
2815.0,17,4,344,2,150,0.0,75.0,75.0,2,194,0.0,103.0,97.0
215919.0,17,2,180,1,90,0.0,90.0,90.0,1,90,0.0,90.0,90.0
90037194.0,17,28,13364,28,13364,3334710.888888889,501.0,477.2857142857143,0,0,0.0,0.0,0.0
206256.0,6,3,426,2,280,0.0,214.0,140.0,1,146,0.0,146.0,146.0
26555.0,6,14,4740,7,653,4118.5,249.0,93.28571428571428,7,4087,4176.333333333333,1514.0,583.8571428571429
204302.0,17,2,762,2,762,0.0,381.0,381.0,0,0,0.0,0.0,0.0
1978.0,17,4,344,2,150,0.0,75.0,75.0,2,194,0.0,103.0,97.0
11947.0,17,4,823,2,163,0.0,89.0,81.5,2,660,0.0,443.0,330.0
117014374.0,17,14,864,7,432,19501495.33333333,174.0,61.71428571428572,7,432,19500160.0,174.0,61.71428571428572
106315092.0,6,32,2236,16,1165,7073275.133333334,139.0,72.8125,16,1071,7073281.533333333,123.0,66.9375
94221741.0,6,39,2574,20,1320,4959020.842105263,66.0,66.0,19,1254,5144003.222222222,66.0,66.0
281776.0,17,2,363,1,79,0.0,79.0,79.0,1,284,0.0,284.0,284.0
310271.0,6,6,412,4,272,103423.66666666669,74.0,68.0,2,140,0.0,74.0,70.0
163243.0,6,3,337,2,214,0.0,160.0,107.0,1,123,0.0,123.0,123.0
120013558.0,17,28,13364,28,13364,4444946.592592592,501.0,477.2857142857143,0,0,0.0,0.0,0.0
29964.0,6,11,1133,6,602,5709.6,264.0,100.33333333333331,5,531,4881.0,259.0,106.2
4184289.0,6,5,336,2,134,0.0,68.0,67.0,3,202,817791.5,70.0,67.33333333333333
233134.0,6,3,337,2,214,0.0,160.0,107.0,1,123,0.0,123.0,123.0
199409.0,17,4,6056,4,6056,66469.66666666667,1514.0,1514.0,0,0,0.0,0.0,0.0
264799.0,17,4,1400,4,1400,88266.33333333333,350.0,350.0,0,0,0.0,0.0,0.0
0.0,17,1,350,1,350,0.0,350.0,350.0,0,0,0.0,0.0,0.0
316458.0,17,4,1400,4,1400,105486.0,350.0,350.0,0,0,0.0,0.0,0.0
90041407.0,17,27,12943,27,12943,3463131.0384615385,501.0,479.3703703703704,0,0,0.0,0.0,0.0
43183.0,6,14,4740,7,653,6678.666666666667,249.0,93.28571428571428,7,4087,6196.166666666667,1514.0,583.8571428571429
135131553.0,17,6,1146,6,1146,27026310.6,191.0,191.0,0,0,0.0,0.0,0.0
30090.0,6,14,4740,7,653,4904.666666666667,249.0,93.28571428571428,7,4087,4705.166666666667,1514.0,583.8571428571429
281284.0,17,2,363,1,79,0.0,79.0,79.0,1,284,0.0,284.0,284.0
58836339.0,17,9,3086,8,2736,5108711.714285715,342.0,342.0,1,350,0.0,350.0,350.0
49405.0,17,2,762,2,762,0.0,381.0,381.0,0,0,0.0,0.0,0.0
843179.0,6,9,1096,6,625,168635.8,287.0,104.16666666666669,3,471,283724.0,331.0,157.0
101695.0,17,2,286,2,286,0.0,143.0,143.0,0,0,0.0,0.0,0.0
119171479.0,6,37,2656,19,1408,6609277.277777778,139.0,74.10526315789474,18,1248,6998049.529411765,123.0,69.33333333333333
90034606.0,6,176,19872,88,13842,1032406.8620689656,284.0,157.29545454545453,88,6030,1032406.8390804598,140.0,68.52272727272727
108140656.0,17,5,955,5,955,27035164.0,191.0,191.0,0,0,0.0,0.0,0.0
90329966.0,6,16,1192,8,596,12897956.142857144,95.0,74.5,8,596,12902835.57142857,95.0,74.5
240392.0,6,3,337,2,214,0.0,160.0,107.0,1,123,0.0,123.0,123.0
90010751.0,17,28,13364,28,13364,3333731.5185185187,501.0,477.2857142857143,0,0,0.0,0.0,0.0
154997.0,6,3,337,2,214,0.0,160.0,107.0,1,123,0.0,123.0,123.0
90259055.0,6,12,1832,8,1016,12894150.714285716,188.0,127.0,4,816,30031388.0,204.0,204.0
104004819.0,17,13,821,7,432,17334136.5,174.0,61.71428571428572,6,389,16800155.6,174.0,64.83333333333333
573527.0,6,4,508,2,238,0.0,172.0,119.0,2,270,0.0,135.0,135.0
2390.0,17,4,344,2,150,0.0,75.0,75.0,2,194,0.0,103.0,97.0
301952.0,6,6,412,4,272,100650.66666666669,74.0,68.0,2,140,0.0,74.0,70.0
108100904.0,17,5,1005,5,1005,27025226.0,201.0,201.0,0,0,0.0,0.0,0.0
217611.0,6,3,426,2,280,0.0,214.0,140.0,1,146,0.0,146.0,146.0
314614.0,17,4,1400,4,1400,104871.33333333331,350.0,350.0,0,0,0.0,0.0,0.0
126296240.0,6,31,2050,16,1102,8419749.333333334,139.0,68.875,15,948,8292424.071428572,123.0,63.2
5616009.0,6,5,336,2,134,0.0,68.0,67.0,3,202,1524144.0,70.0,67.33333333333333
206601.0,6,3,426,2,280,0.0,214.0,140.0,1,146,0.0,146.0,146.0
93210848.0,17,16,5472,16,5472,6214056.533333333,342.0,342.0,0,0,0.0,0.0,0.0
351497.0,6,3,1604,2,851,0.0,785.0,425.5,1,753,0.0,753.0,753.0
47818224.0,6,8,1940,3,887,22870962.0,753.0,295.6666666666667,5,1053,11257248.5,785.0,210.6
498886.0,6,5,336,2,134,0.0,68.0,67.0,3,202,192648.5,70.0,67.33333333333333
22468.0,6,14,4740,7,653,3454.333333333333,249.0,93.28571428571428,7,4087,3610.3333333333335,1514.0,583.8571428571429
50573.0,6,14,4740,7,653,4039.6666666666665,249.0,93.28571428571428,7,4087,8278.0,1514.0,583.8571428571429
40343.0,6,10,2032,5,524,9834.75,252.0,104.8,5,1508,9802.75,1236.0,301.6
94042037.0,6,184,20792,92,14572,1031051.956043956,284.0,158.3913043478261,92,6220,1031052.098901099,140.0,67.6086956521739
147976.0,17,2,180,1,90,0.0,90.0,90.0,1,90,0.0,90.0,90.0
29046.0,6,10,2032,5,524,6042.25,252.0,104.8,5,1508,7016.5,1236.0,301.6
306642.0,6,6,412,4,272,102214.0,74.0,68.0,2,140,0.0,74.0,70.0
120466206.0,6,519,69860,260,52470,465120.4864864865,336.0,201.80769230769232,259,17390,462797.8062015504,140.0,67.14285714285714
10472811.0,6,7,478,4,272,3445610.333333333,74.0,68.0,3,206,5168290.5,74.0,68.66666666666667
36384.0,6,14,4740,7,653,5939.166666666667,249.0,93.28571428571428,7,4087,5821.0,1514.0,583.8571428571429
228236.0,17,2,180,1,90,0.0,90.0,90.0,1,90,0.0,90.0,90.0
143955.0,17,2,180,1,90,0.0,90.0,90.0,1,90,0.0,90.0,90.0
2062.0,17,4,344,2,150,0.0,75.0,75.0,2,194,0.0,103.0,97.0
120373143.0,6,229,25912,114,7820,1058017.8584070797,140.0,68.59649122807018,115,18092,1055873.4210526317,284.0,157.3217391304348
137362.0,6,2,132,1,66,0.0,66.0,66.0,1,66,0.0,66.0,66.0
146322.0,6,3,337,2,214,0.0,160.0,107.0,1,123,0.0,123.0,123.0
135132926.0,17,6,1206,6,1206,27026585.2,201.0,201.0,0,0,0.0,0.0,0.0
35832.0,6,14,4740,7,653,4017.1666666666665,249.0,93.28571428571428,7,4087,5830.833333333333,1514.0,583.8571428571429
14285.0,17,2,180,1,90,0.0,90.0,90.0,1,90,0.0,90.0,90.0
103367.0,17,2,286,2,286,0.0,143.0,143.0,0,0,0.0,0.0,0.0
731068.0,6,10,1065,5,534,182463.5,262.0,106.8,5,531,182232.0,259.0,106.2
106861.0,17,2,286,2,286,0.0,143.0,143.0,0,0,0.0,0.0,0.0
46755.0,6,14,4740,7,653,7667.333333333333,249.0,93.28571428571428,7,4087,7516.5,1514.0,583.8571428571429
68521.0,6,14,4740,7,653,10775.5,249.0,93.28571428571428,7,4087,11210.166666666666,1514.0,583.8571428571429
114829796.0,17,14,864,7,432,19001114.33333333,174.0,61.71428571428572,7,432,19000170.0,174.0,61.71428571428572
36623.0,6,10,2032,5,524,7675.75,252.0,104.8,5,1508,8892.75,1236.0,301.6
121371.0,6,3,337,2,214,0.0,160.0,107.0,1,123,0.0,123.0,123.0
111002.0,17,2,286,2,286,0.0,143.0,143.0,0,0,0.0,0.0,0.0
216740.0,6,3,426,2,280,0.0,214.0,140.0,1,146,0.0,146.0,146.0
108107215.0,17,5,955,5,955,27026803.75,191.0,191.0,0,0,0.0,0.0,0.0
51813.0,6,14,4740,7,653,8401.333333333334,249.0,93.28571428571428,7,4087,7581.666666666667,1514.0,583.8571428571429
108311.0,17,2,286,2,286,0.0,143.0,143.0,0,0,0.0,0.0,0.0
5630946.0,6,5,336,2,134,0.0,68.0,67.0,3,202,1426829.0,70.0,67.33333333333333
338.0,17,2,166,1,75,0.0,75.0,75.0,1,91,0.0,91.0,91.0
2620728.0,17,2,876,2,876,0.0,438.0,438.0,0,0,0.0,0.0,0.0
10539.0,6,11,2098,6,590,1578.6,252.0,98.33333333333331,5,1508,2382.0,1236.0,301.6
363722.0,6,11,1021,6,444,48939.0,162.0,74.0,5,577,61093.0,349.0,115.4
1075468.0,6,4,2389,3,1636,537734.0,785.0,545.3333333333334,1,753,0.0,753.0,753.0
108107479.0,17,5,955,5,955,27026869.75,191.0,191.0,0,0,0.0,0.0,0.0
120044649.0,17,28,13364,28,13364,4446098.111111111,501.0,477.2857142857143,0,0,0.0,0.0,0.0
205898.0,6,3,426,2,280,0.0,214.0,140.0,1,146,0.0,146.0,146.0
32991.0,6,14,4740,7,653,5274.666666666667,249.0,93.28571428571428,7,4087,5249.166666666667,1514.0,583.8571428571429
90308418.0,6,19,1436,10,745,10028609.0,95.0,74.5,9,691,11287111.375,95.0,76.77777777777777
13683113.0,6,18,1495,9,921,1672347.375,315.0,102.33333333333331,9,574,1672312.875,78.0,63.77777777777778
5004823.0,17,4,849,2,166,0.0,83.0,83.0,2,683,0.0,499.0,341.5
13608016.0,6,20,1607,10,975,1478441.0,315.0,97.5,10,632,1478416.5555555555,78.0,63.2
1435.0,17,2,762,2,762,0.0,381.0,381.0,0,0,0.0,0.0,0.0
2602233.0,6,25,7573,14,3735,200171.7692307692,1514.0,266.7857142857143,11,3838,234573.3,1514.0,348.90909090909093
90249378.0,6,22,1680,10,786,9997903.666666666,95.0,78.6,12,894,8182038.636363637,95.0,74.5
90256184.0,6,15,2168,8,1016,12893740.57142857,188.0,127.0,7,1152,15015405.5,204.0,164.57142857142858
205702.0,17,2,180,1,90,0.0,90.0,90.0,1,90,0.0,90.0,90.0
211005.0,17,2,614,1,72,0.0,72.0,72.0,1,542,0.0,542.0,542.0
310353.0,6,3,202,2,128,0.0,74.0,64.0,1,74,0.0,74.0,74.0
135136180.0,17,6,1146,6,1146,27027236.0,191.0,191.0,0,0,0.0,0.0,0.0
0.0,17,1,342,1,342,0.0,342.0,342.0,0,0,0.0,0.0,0.0
305641.0,6,6,412,4,272,101880.33333333331,74.0,68.0,2,140,0.0,74.0,70.0
135132836.0,17,6,1206,6,1206,27026567.2,201.0,201.0,0,0,0.0,0.0,0.0
59028.0,6,10,2032,5,524,14456.0,252.0,104.8,5,1508,14484.5,1236.0,301.6
123129503.0,6,37,2640,19,1392,6840527.944444444,123.0,73.26315789473684,18,1248,6642844.411764706,123.0,69.33333333333333
90276957.0,6,22,1680,12,935,8203027.090909091,95.0,77.91666666666667,10,745,10000435.111111112,95.0,74.5
153392.0,17,2,180,1,90,0.0,90.0,90.0,1,90,0.0,90.0,90.0
11278.0,6,11,1133,6,602,2062.0,264.0,100.33333333333331,5,531,2602.0,259.0,106.2
108106890.0,17,5,1005,5,1005,27026722.5,201.0,201.0,0,0,0.0,0.0,0.0
1307759.0,6,4,264,2,132,0.0,66.0,66.0,2,132,0.0,66.0,66.0
46588935.0,6,8,2113,3,960,22260798.0,826.0,320.0,5,1153,10952295.5,885.0,230.6
120138697.0,6,63,5598,27,2493,4620719.115384615,123.0,92.33333333333331,36,3105,3415893.7714285715,123.0,86.25
2905577.0,6,3,1604,2,851,0.0,785.0,425.5,1,753,0.0,753.0,753.0
108096681.0,17,5,955,5,955,27024170.25,191.0,191.0,0,0,0.0,0.0,0.0
751.0,17,4,438,2,148,0.0,74.0,74.0,2,290,0.0,147.0,145.0
35390.0,6,10,2032,5,524,8630.25,252.0,104.8,5,1508,7821.5,1236.0,301.6
140.0,17,3,1143,3,1143,70.0,381.0,381.0,0,0,0.0,0.0,0.0
135134694.0,17,6,1206,6,1206,27026938.8,201.0,201.0,0,0,0.0,0.0,0.0
2288.0,17,4,344,2,150,0.0,75.0,75.0,2,194,0.0,103.0,97.0
257641.0,17,4,1524,4,1524,85880.33333333333,381.0,381.0,0,0,0.0,0.0,0.0
25972.0,6,10,2032,5,524,6222.75,252.0,104.8,5,1508,6237.5,1236.0,301.6
82694.0,6,2,132,1,66,0.0,66.0,66.0,1,66,0.0,66.0,66.0
107607.0,17,2,286,2,286,0.0,143.0,143.0,0,0,0.0,0.0,0.0
6083.0,17,2,401,1,85,0.0,85.0,85.0,1,316,0.0,316.0,316.0
120057375.0,17,29,13785,29,13785,4287763.392857143,501.0,475.3448275862069,0,0,0.0,0.0,0.0
108106599.0,17,5,955,5,955,27026649.75,191.0,191.0,0,0,0.0,0.0,0.0
2797515.0,6,2,132,1,66,0.0,66.0,66.0,1,66,0.0,66.0,66.0
229729.0,6,4,492,2,280,0.0,214.0,140.0,2,212,0.0,146.0,106.0
0.0,17,1,381,1,381,0.0,381.0,381.0,0,0,0.0,0.0,0.0
90260958.0,6,14,2240,8,1016,12894422.57142857,188.0,127.0,6,1224,18019075.6,204.0,204.0
16358.000000000002,6,14,4740,7,653,2540.6666666666665,249.0,93.28571428571428,7,4087,2592.0,1514.0,583.8571428571429
120107122.0,6,268,31058,134,9140,896962.977443609,140.0,68.2089552238806,134,21918,897776.2255639097,284.0,163.56716417910448
120001001.0,17,14,864,8,475,17143000.14285714,174.0,59.375,6,389,20118022.4,174.0,64.83333333333333
308606.0,6,6,412,4,272,102868.66666666669,74.0,68.0,2,140,0.0,74.0,70.0
12475.0,6,10,1065,5,534,2646.25,262.0,106.8,5,531,2790.75,259.0,106.2
90255826.0,6,12,1832,8,1016,12893689.42857143,188.0,127.0,4,816,30030871.666666668,204.0,204.0
14634205.0,6,20,1607,10,975,1592526.6666666667,315.0,97.5,10,632,1592497.4444444445,78.0,63.2
16882.0,17,2,180,1,90,0.0,90.0,90.0,1,90,0.0,90.0,90.0
108112583.0,17,5,955,5,955,27028145.75,191.0,191.0,0,0,0.0,0.0,0.0
247937.0,6,10,1221,6,636,49587.4,298.0,106.0,4,585,77259.66666666667,379.0,146.25
14327412.0,6,20,1689,10,1057,1557447.6666666667,315.0,105.7,10,632,1557405.0,78.0,63.2
115476.0,17,4,1400,4,1400,38492.0,350.0,350.0,0,0,0.0,0.0,0.0
101549327.0,6,278,33296,139,23900,734304.6376811594,390.0,171.94244604316546,139,9396,734305.2246376812,140.0,67.59712230215827
246281.0,6,3,337,2,214,0.0,160.0,107.0,1,123,0.0,123.0,123.0
0.0,17,1,99,1,99,0.0,99.0,99.0,0,0,0.0,0.0,0.0
2343.0,17,2,684,1,342,0.0,342.0,342.0,1,342,0.0,342.0,342.0
12733.0,6,10,2032,5,524,2854.25,252.0,104.8,5,1508,2955.75,1236.0,301.6
27273469.0,17,5,1710,5,1710,6818367.25,342.0,342.0,0,0,0.0,0.0,0.0
46857.0,6,10,2032,5,524,11504.0,252.0,104.8,5,1508,10221.0,1236.0,301.6
38143.0,6,2,132,1,66,0.0,66.0,66.0,1,66,0.0,66.0,66.0
146276.0,6,3,337,2,214,0.0,160.0,107.0,1,123,0.0,123.0,123.0
2298.0,17,4,344,2,150,0.0,75.0,75.0,2,194,0.0,103.0,97.0
4978.0,17,2,582,1,83,0.0,83.0,83.0,1,499,0.0,499.0,499.0
90297658.0,6,14,2102,8,1016,12899665.42857143,188.0,127.0,6,1086,18026662.0,204.0,181.0
135127846.0,17,6,1206,6,1206,27025569.2,201.0,201.0,0,0,0.0,0.0,0.0
306167.0,6,6,412,4,272,102055.66666666669,74.0,68.0,2,140,0.0,74.0,70.0
217714.0,6,3,426,2,280,0.0,214.0,140.0,1,146,0.0,146.0,146.0
90399072.0,6,15,2460,8,1632,12910412.57142857,204.0,204.0,7,828,15018810.666666666,188.0,118.28571428571428
159976.0,6,2,128,1,74,0.0,74.0,74.0,1,54,0.0,54.0,54.0
1232652.0,17,2,876,2,876,0.0,438.0,438.0,0,0,0.0,0.0,0.0
42346.0,6,10,2032,5,524,10324.75,252.0,104.8,5,1508,8399.5,1236.0,301.6
224292.0,6,10,1221,6,636,44858.4,298.0,106.0,4,585,72340.66666666667,379.0,146.25
108106484.0,17,5,1005,5,1005,27026621.0,201.0,201.0,0,0,0.0,0.0,0.0
589.0,17,2,762,2,762,0.0,381.0,381.0,0,0,0.0,0.0,0.0
41343.0,6,14,4740,7,653,6764.666666666667,249.0,93.28571428571428,7,4087,6058.833333333333,1514.0,583.8571428571429
11982.0,6,11,1131,6,600,2307.8,262.0,100.0,5,531,2661.25,259.0,106.2
34694.0,6,10,2032,5,524,7431.25,252.0,104.8,5,1508,7878.75,1236.0,301.6
184312.0,17,2,180,1,90,0.0,90.0,90.0,1,90,0.0,90.0,90.0
108110012.0,17,5,1005,5,1005,27027503.0,201.0,201.0,0,0,0.0,0.0,0.0
316124.0,17,4,1400,4,1400,105374.66666666669,350.0,350.0,0,0,0.0,0.0,0.0
329362.0,6,6,412,4,272,109787.33333333331,74.0,68.0,2,140,0.0,74.0,70.0
121618.0,6,3,337,2,214,0.0,160.0,107.0,1,123,0.0,123.0,123.0
106997.0,17,2,762,2,762,0.0,381.0,381.0,0,0,0.0,0.0,0.0
148058.0,17,2,180,1,90,0.0,90.0,90.0,1,90,0.0,90.0,90.0
315142.0,6,3,202,2,128,0.0,74.0,64.0,1,74,0.0,74.0,74.0
119513666.0,6,226,25566,113,17886,1065260.294642857,284.0,158.28318584070797,113,7680,1065260.4910714286,140.0,67.96460176991151
48377.0,6,14,4740,7,653,7932.333333333333,249.0,93.28571428571428,7,4087,7584.5,1514.0,583.8571428571429
25647.0,6,14,4740,7,653,3805.0,249.0,93.28571428571428,7,4087,4088.1666666666665,1514.0,583.8571428571429
38881.0,6,14,4740,7,653,5383.5,249.0,93.28571428571428,7,4087,6318.0,1514.0,583.8571428571429
43489.0,6,14,4740,7,653,6868.333333333333,249.0,93.28571428571428,7,4087,6825.333333333333,1514.0,583.8571428571429
132280.0,6,14,4740,7,653,18859.666666666668,249.0,93.28571428571428,7,4087,21873.666666666668,1514.0,583.8571428571429
108110680.0,17,5,955,5,955,27027670.0,191.0,191.0,0,0,0.0,0.0,0.0
138049.0,17,4,344,2,150,0.0,75.0,75.0,2,194,0.0,103.0,97.0
90048916.0,17,27,12943,27,12943,3463419.846153846,501.0,479.3703703703704,0,0,0.0,0.0,0.0
108104424.0,17,5,955,5,955,27026106.0,191.0,191.0,0,0,0.0,0.0,0.0
108104617.0,17,5,955,5,955,27026154.25,191.0,191.0,0,0,0.0,0.0,0.0
822539.0,17,4,820,2,156,0.0,78.0,78.0,2,664,0.0,332.0,332.0
120089490.0,17,28,13364,28,13364,4447758.888888889,501.0,477.2857142857143,0,0,0.0,0.0,0.0
2591429.0,6,2,132,1,66,0.0,66.0,66.0,1,66,0.0,66.0,66.0
153389.0,17,2,180,1,90,0.0,90.0,90.0,1,90,0.0,90.0,90.0
108107425.0,17,5,955,5,955,27026856.25,191.0,191.0,0,0,0.0,0.0,0.0
54648.0,6,14,4740,7,653,8983.666666666666,249.0,93.28571428571428,7,4087,6626.666666666667,1514.0,583.8571428571429
104352.0,6,2,132,1,66,0.0,66.0,66.0,1,66,0.0,66.0,66.0
228351.0,17,2,180,1,90,0.0,90.0,90.0,1,90,0.0,90.0,90.0
994883.0,6,11,1131,6,600,196895.2,262.0,100.0,5,531,248518.75,259.0,106.2
310597.0,17,4,1400,4,1400,103532.33333333331,350.0,350.0,0,0,0.0,0.0,0.0
5826713.0,6,4,270,2,134,0.0,68.0,67.0,2,136,0.0,70.0,68.0
1315506.0,6,4,264,2,132,0.0,66.0,66.0,2,132,0.0,66.0,66.0
1062.0,17,5,550,5,550,265.5,110.0,110.0,0,0,0.0,0.0,0.0
36796.0,6,11,2098,6,590,4451.4,252.0,98.33333333333331,5,1508,8943.5,1236.0,301.6
106078.0,17,2,700,2,700,0.0,350.0,350.0,0,0,0.0,0.0,0.0
209680.0,6,10,1221,6,636,41936.0,298.0,106.0,4,585,68752.0,379.0,146.25
90529439.0,6,13,2036,8,1016,12932777.0,188.0,127.0,5,1020,22591185.75,204.0,204.0
62431.0,6,13,1386,7,789,9444.0,253.0,112.71428571428572,6,597,10886.6,259.0,99.5
47560.0,6,14,4740,7,653,7052.666666666667,249.0,93.28571428571428,7,4087,7646.666666666667,1514.0,583.8571428571429
106023958.0,6,235,26736,118,8084,906187.6752136752,140.0,68.50847457627118,117,18652,905062.6034482758,284.0,159.4188034188034
221411.0,6,4,492,2,280,0.0,214.0,140.0,2,212,0.0,146.0,106.0
1771864.0,6,2,132,1,66,0.0,66.0,66.0,1,66,0.0,66.0,66.0
1025722.0,6,11,1134,6,558,205144.4,220.0,93.0,5,576,255503.25,304.0,115.2
878110.0,6,10,1333,6,796,175622.0,458.0,132.66666666666666,4,537,200829.3333333333,331.0,134.25
21507.0,6,14,4740,7,653,3403.6666666666665,249.0,93.28571428571428,7,4087,2991.833333333333,1514.0,583.8571428571429
837240.0,6,9,1118,6,586,167448.0,248.0,97.66666666666669,3,532,282123.0,392.0,177.33333333333334
5626663.0,6,4,270,2,134,0.0,68.0,67.0,2,136,0.0,70.0,68.0
120044656.0,17,28,13364,28,13364,4446098.37037037,501.0,477.2857142857143,0,0,0.0,0.0,0.0
120012683.0,6,18,1341,9,691,14999988.125,95.0,76.77777777777777,9,650,15000226.125,95.0,72.22222222222223
105344930.0,6,214,24360,107,17076,991791.2075471698,284.0,159.58878504672896,107,7284,991791.141509434,140.0,68.07476635514018
60517.0,6,11,2098,6,590,11868.8,252.0,98.33333333333331,5,1508,14725.25,1236.0,301.6
299587.0,17,2,346,1,78,0.0,78.0,78.0,1,268,0.0,268.0,268.0
117270954.0,6,231,26256,116,7878,1019747.4260869564,140.0,67.91379310344827,115,18378,1011540.9824561405,284.0,159.80869565217392
224213.0,6,12,1373,7,714,37368.833333333336,298.0,102.0,5,659,55042.0,379.0,131.8
1333347.0,6,7,548,4,338,444449.0,103.0,84.5,3,210,410689.5,78.0,70.0
120021149.0,17,29,13785,29,13785,4286469.607142857,501.0,475.3448275862069,0,0,0.0,0.0,0.0
230321.0,17,2,180,1,90,0.0,90.0,90.0,1,90,0.0,90.0,90.0
148758.0,6,3,373,2,238,0.0,172.0,119.0,1,135,0.0,135.0,135.0
23880.0,6,14,4740,7,653,3818.0,249.0,93.28571428571428,7,4087,3799.1666666666665,1514.0,583.8571428571429
114029.0,17,4,1400,4,1400,38009.66666666666,350.0,350.0,0,0,0.0,0.0,0.0
108103297.0,17,5,955,5,955,27025824.25,191.0,191.0,0,0,0.0,0.0,0.0
3013908.0,6,11,2106,6,598,602387.6,252.0,99.66666666666669,5,1508,3596.5,1236.0,301.6
500780.0,6,5,336,2,134,0.0,68.0,67.0,3,202,195845.0,70.0,67.33333333333333
745672.0,6,2,132,1,66,0.0,66.0,66.0,1,66,0.0,66.0,66.0
329.0,17,2,208,1,72,0.0,72.0,72.0,1,136,0.0,136.0,136.0
19114.0,6,10,1067,5,536,4604.25,264.0,107.2,5,531,3496.5,259.0,106.2
37447.0,6,14,4740,7,653,6097.833333333333,249.0,93.28571428571428,7,4087,5017.166666666667,1514.0,583.8571428571429
1244113.0,17,7,490,7,490,207352.16666666663,70.0,70.0,0,0,0.0,0.0,0.0
26928.0,6,10,2032,5,524,5700.0,252.0,104.8,5,1508,6175.75,1236.0,301.6
34173.0,6,14,4740,7,653,5539.333333333333,249.0,93.28571428571428,7,4087,4701.333333333333,1514.0,583.8571428571429
103544.0,17,2,286,2,286,0.0,143.0,143.0,0,0,0.0,0.0,0.0
35187.0,6,10,2032,5,524,8527.25,252.0,104.8,5,1508,7881.0,1236.0,301.6
105164578.0,6,215,24940,108,7350,982846.523364486,140.0,68.05555555555556,107,17590,973788.6981132076,390.0,164.39252336448598
92637129.0,6,27,1948,14,963,7125933.0,123.0,68.78571428571429,13,985,6971822.166666667,139.0,75.76923076923077
321159.0,17,4,1400,4,1400,107053.0,350.0,350.0,0,0,0.0,0.0,0.0
102239752.0,6,41,2706,21,1386,5111987.6,66.0,66.0,20,1320,5282287.894736842,66.0,66.0
114307324.0,6,31,2166,16,1149,7606107.4,123.0,71.8125,15,1017,8149402.642857143,123.0,67.8
17342.0,6,14,4740,7,653,2719.833333333333,249.0,93.28571428571428,7,4087,2590.333333333333,1514.0,583.8571428571429
112686.0,17,2,286,2,286,0.0,143.0,143.0,0,0,0.0,0.0,0.0
2117.0,17,2,762,2,762,0.0,381.0,381.0,0,0,0.0,0.0,0.0
37588.0,6,10,2032,5,524,8738.25,252.0,104.8,5,1508,8446.75,1236.0,301.6
196944.0,17,2,180,1,90,0.0,90.0,90.0,1,90,0.0,90.0,90.0
31979.0,6,14,4740,7,653,5126.5,249.0,93.28571428571428,7,4087,4788.666666666667,1514.0,583.8571428571429
204611.0,17,2,762,2,762,0.0,381.0,381.0,0,0,0.0,0.0,0.0
24444.0,6,14,4740,7,653,3961.3333333333335,249.0,93.28571428571428,7,4087,3425.6666666666665,1514.0,583.8571428571429
284781.0,17,2,363,1,79,0.0,79.0,79.0,1,284,0.0,284.0,284.0
92836168.0,6,189,21540,95,6492,987618.8085106384,140.0,68.33684210526316,94,15048,987181.505376344,284.0,160.08510638297872
108099591.0,17,5,1005,5,1005,27024897.75,201.0,201.0,0,0,0.0,0.0,0.0
123250488.0,6,49,3234,25,1650,5135437.0,66.0,66.0,24,1584,4979731.782608695,66.0,66.0
116007799.0,6,42,3340,22,1777,5513610.380952381,139.0,80.77272727272727,20,1563,6093984.578947368,123.0,78.15
205856.0,17,2,180,1,90,0.0,90.0,90.0,1,90,0.0,90.0,90.0
106135490.0,17,14,864,7,432,17668182.833333332,174.0,61.71428571428572,7,432,17666824.666666668,174.0,61.71428571428572
2802708.0,6,2,132,1,66,0.0,66.0,66.0,1,66,0.0,66.0,66.0
74575885.0,6,9,842,9,842,9321985.625,97.0,93.55555555555556,0,0,0.0,0.0,0.0
46557.0,6,10,2032,5,524,10009.25,252.0,104.8,5,1508,10502.25,1236.0,301.6
0.0,17,1,90,1,90,0.0,90.0,90.0,0,0,0.0,0.0,0.0
4362.0,17,2,614,1,72,0.0,72.0,72.0,1,542,0.0,542.0,542.0
120126844.0,6,14,2240,6,1224,24025368.8,204.0,204.0,8,1016,17098131.85714286,188.0,127.0
15061109.0,17,6,2718,6,2718,3012221.8,453.0,453.0,0,0,0.0,0.0,0.0
862714.0,6,10,1332,6,795,172542.8,457.0,132.5,4,537,196521.0,331.0,134.25
43627.0,6,14,4740,7,653,6839.333333333333,249.0,93.28571428571428,7,4087,6829.166666666667,1514.0,583.8571428571429
843.0,17,4,438,2,148,0.0,74.0,74.0,2,290,0.0,147.0,145.0
5005786.0,17,4,534,2,166,0.0,83.0,83.0,2,368,0.0,184.0,184.0
12077.0,6,10,2032,5,524,2715.25,252.0,104.8,5,1508,2738.5,1236.0,301.6
135135200.0,17,6,1146,6,1146,27027040.0,191.0,191.0,0,0,0.0,0.0,0.0
99780014.0,6,380,49960,190,37198,526796.4074074074,300.0,195.77894736842103,190,12762,526797.9629629629,140.0,67.16842105263157
120229780.0,6,31,3256,16,1652,8015318.666666667,425.0,103.25,15,1604,8530969.142857144,361.0,106.93333333333334
45613.0,6,14,4740,7,653,7260.0,249.0,93.28571428571428,7,4087,6204.0,1514.0,583.8571428571429
2054.0,17,4,344,2,150,0.0,75.0,75.0,2,194,0.0,103.0,97.0
2392.0,17,4,344,2,150,0.0,75.0,75.0,2,194,0.0,103.0,97.0
90051673.0,17,28,13364,28,13364,3335247.1481481483,501.0,477.2857142857143,0,0,0.0,0.0,0.0
20271.0,6,14,4740,7,653,2579.0,249.0,93.28571428571428,7,4087,3233.833333333333,1514.0,583.8571428571429
294150.0,6,6,412,4,272,98050.0,74.0,68.0,2,140,0.0,74.0,70.0
848038.0,6,13,1493,7,862,141002.5,271.0,123.14285714285714,6,631,168067.2,293.0,105.16666666666669
34737313.0,6,5,336,2,134,0.0,68.0,67.0,3,202,16070944.5,70.0,67.33333333333333
34562.0,6,14,4740,7,653,4608.166666666667,249.0,93.28571428571428,7,4087,4585.666666666667,1514.0,583.8571428571429
120078096.0,6,226,25496,113,7754,1064771.5625,140.0,68.61946902654867,113,17742,1065592.982142857,284.0,157.00884955752213
201532.0,17,4,6056,4,6056,67177.33333333333,1514.0,1514.0,0,0,0.0,0.0,0.0
120042360.0,17,28,13364,28,13364,4446013.333333333,501.0,477.2857142857143,0,0,0.0,0.0,0.0
302915.0,6,3,202,2,128,0.0,74.0,64.0,1,74,0.0,74.0,74.0
143933.0,17,2,180,1,90,0.0,90.0,90.0,1,90,0.0,90.0,90.0
90038711.0,17,28,13364,28,13364,3334767.074074074,501.0,477.2857142857143,0,0,0.0,0.0,0.0
118311943.0,6,233,26314,117,8018,1019930.5431034482,140.0,68.52991452991454,116,18296,1019862.9391304348,300.0,157.72413793103448
2355.0,17,4,344,2,150,0.0,75.0,75.0,2,194,0.0,103.0,97.0
23932.0,6,10,2032,5,524,5580.5,252.0,104.8,5,1508,5416.25,1236.0,301.6
121382.0,6,13,1394,7,797,20230.33333333333,253.0,113.85714285714286,6,597,21901.2,259.0,99.5
1307596.0,6,4,264,2,132,0.0,66.0,66.0,2,132,0.0,66.0,66.0
62548.00000000001,6,14,4740,7,653,10247.666666666666,249.0,93.28571428571428,7,4087,10145.166666666666,1514.0,583.8571428571429
763535.0,6,14,4740,7,653,126614.16666666669,249.0,93.28571428571428,7,4087,126916.83333333331,1514.0,583.8571428571429
90996931.0,6,168,18984,84,13218,1093756.4096385543,284.0,157.35714285714286,84,5766,1093755.6506024096,140.0,68.64285714285714
299247.0,6,6,412,4,272,99749.0,74.0,68.0,2,140,0.0,74.0,70.0
122095878.0,6,31,2182,15,1017,8007806.142857143,123.0,67.8,16,1165,7473953.333333333,139.0,72.8125
50719.0,17,2,180,1,90,0.0,90.0,90.0,1,90,0.0,90.0,90.0
123006071.0,17,15,1169,8,606,17572295.85714286,174.0,75.75,7,563,17000154.5,174.0,80.42857142857143
0.0,17,1,453,1,453,0.0,453.0,453.0,0,0,0.0,0.0,0.0
510855.0,6,5,336,2,134,0.0,68.0,67.0,3,202,195735.0,70.0,67.33333333333333
157167.0,6,3,337,2,214,0.0,160.0,107.0,1,123,0.0,123.0,123.0
303671.0,6,2,132,1,66,0.0,66.0,66.0,1,66,0.0,66.0,66.0
103352.0,17,2,286,2,286,0.0,143.0,143.0,0,0,0.0,0.0,0.0
300209.0,6,6,412,4,272,100069.66666666669,74.0,68.0,2,140,0.0,74.0,70.0
99445.0,17,2,762,2,762,0.0,381.0,381.0,0,0,0.0,0.0,0.0
146081.0,6,3,337,2,214,0.0,160.0,107.0,1,123,0.0,123.0,123.0
360.0,17,2,300,1,80,0.0,80.0,80.0,1,220,0.0,220.0,220.0
207245.0,6,3,426,2,280,0.0,214.0,140.0,1,146,0.0,146.0,146.0
220122.0,6,3,426,2,280,0.0,214.0,140.0,1,146,0.0,146.0,146.0
153654.0,17,2,180,1,90,0.0,90.0,90.0,1,90,0.0,90.0,90.0
135105475.0,17,6,1206,6,1206,27021095.0,201.0,201.0,0,0,0.0,0.0,0.0
4926419.0,6,15,4814,8,727,703634.2857142857,249.0,90.875,7,4087,2220.833333333333,1514.0,583.8571428571429
146196.0,6,3,337,2,214,0.0,160.0,107.0,1,123,0.0,123.0,123.0
1184406.0,6,13,3011,8,2383,169200.85714285713,1514.0,297.875,5,628,227135.75,331.0,125.6
108670428.0,6,34,2466,17,1272,6791901.75,123.0,74.82352941176471,17,1194,6778375.0,123.0,70.23529411764706
108109512.0,17,5,1005,5,1005,27027378.0,201.0,201.0,0,0,0.0,0.0,0.0
101148113.0,17,14,1126,7,563,16831390.5,174.0,80.42857142857143,7,563,16831391.166666668,174.0,80.42857142857143
2496.0,17,2,664,1,322,0.0,322.0,322.0,1,342,0.0,342.0,342.0
234477.0,6,3,337,2,214,0.0,160.0,107.0,1,123,0.0,123.0,123.0
46764.0,6,10,2032,5,524,10524.0,252.0,104.8,5,1508,11060.25,1236.0,301.6
119780224.0,6,19,1395,10,745,13282526.555555556,95.0,74.5,9,650,14942504.25,95.0,72.22222222222223
57019.0,6,10,2032,5,524,14025.5,252.0,104.8,5,1508,13370.5,1236.0,301.6
99298.0,17,2,762,2,762,0.0,381.0,381.0,0,0,0.0,0.0,0.0
34165.0,6,14,4740,7,653,5412.333333333333,249.0,93.28571428571428,7,4087,5555.5,1514.0,583.8571428571429
108508445.0,17,14,864,7,432,18003105.666666668,174.0,61.71428571428572,7,432,18000162.5,174.0,61.71428571428572
103294759.0,17,13,821,7,432,17189305.833333332,174.0,61.71428571428572,6,389,16661265.8,174.0,64.83333333333333
350.0,17,2,267,1,83,0.0,83.0,83.0,1,184,0.0,184.0,184.0
317.0,17,2,174,1,79,0.0,79.0,79.0,1,95,0.0,95.0,95.0
29382.0,6,14,4740,7,653,4777.0,249.0,93.28571428571428,7,4087,4714.5,1514.0,583.8571428571429
108827.0,17,2,762,2,762,0.0,381.0,381.0,0,0,0.0,0.0,0.0
118489055.0,6,34,2350,17,1225,7392081.0625,139.0,72.05882352941177,17,1125,7392086.0,123.0,66.17647058823529
1814064.0,17,3,1026,3,1026,907032.0,342.0,342.0,0,0,0.0,0.0,0.0
120079047.0,17,29,13785,29,13785,4288537.392857143,501.0,475.3448275862069,0,0,0.0,0.0,0.0
104736107.0,17,14,864,7,432,17334762.0,174.0,61.71428571428572,7,432,17333507.833333332,174.0,61.71428571428572
102228.0,17,2,286,2,286,0.0,143.0,143.0,0,0,0.0,0.0,0.0
135132047.0,17,6,1146,6,1146,27026409.4,191.0,191.0,0,0,0.0,0.0,0.0
16402.0,6,11,2098,6,590,3280.4,252.0,98.33333333333331,5,1508,3734.25,1236.0,301.6
143998.0,17,2,180,1,90,0.0,90.0,90.0,1,90,0.0,90.0,90.0
207322.0,6,3,426,2,280,0.0,214.0,140.0,1,146,0.0,146.0,146.0
27000333.0,17,5,1710,5,1710,6750083.25,342.0,342.0,0,0,0.0,0.0,0.0
275690.0,6,12,1373,7,714,45948.333333333336,298.0,102.0,5,659,64892.5,379.0,131.8
90339189.0,6,11,1644,7,828,15056531.5,188.0,118.28571428571428,4,816,20112035.33333333,204.0,204.0
90015680.0,17,28,13364,28,13364,3333914.074074074,501.0,477.2857142857143,0,0,0.0,0.0,0.0
103540.0,17,2,286,2,286,0.0,143.0,143.0,0,0,0.0,0.0,0.0
207281.0,6,3,426,2,280,0.0,214.0,140.0,1,146,0.0,146.0,146.0
2286277.0,6,48,23662,25,19797,95261.54166666669,1514.0,791.88,23,3865,94267.04545454546,1514.0,168.04347826086956
0.0,17,1,90,1,90,0.0,90.0,90.0,0,0,0.0,0.0,0.0
108114477.0,17,5,955,5,955,27028619.25,191.0,191.0,0,0,0.0,0.0,0.0
128010292.0,17,15,907,8,475,18287184.57142857,174.0,59.375,7,432,18000169.0,174.0,61.71428571428572
101228.0,17,2,762,2,762,0.0,381.0,381.0,0,0,0.0,0.0,0.0
253309.0,6,10,1221,6,636,50661.8,298.0,106.0,4,585,78421.66666666667,379.0,146.25
126844504.0,17,14,864,7,432,17754017.166666668,174.0,61.71428571428572,7,432,17834426.166666668,174.0,61.71428571428572
121495096.0,17,14,864,7,432,17000850.166666668,174.0,61.71428571428572,7,432,19890676.5,174.0,61.71428571428572
108108720.0,17,5,1005,5,1005,27027180.0,201.0,201.0,0,0,0.0,0.0,0.0
118643800.0,6,31,2044,16,1002,7909586.666666667,123.0,62.625,15,1042,7745941.214285715,139.0,69.46666666666667
308239.0,6,6,412,4,272,102746.33333333331,74.0,68.0,2,140,0.0,74.0,70.0
90100281.0,6,13,2052,6,1224,18019693.8,204.0,204.0,7,828,15014496.333333334,188.0,118.28571428571428
122243.0,6,3,373,2,238,0.0,172.0,119.0,1,135,0.0,135.0,135.0
16915.0,17,2,180,1,90,0.0,90.0,90.0,1,90,0.0,90.0,90.0
1352798.0,17,16,1120,16,1120,90186.53333333334,70.0,70.0,0,0,0.0,0.0,0.0
108097587.0,17,5,955,5,955,27024396.75,191.0,191.0,0,0,0.0,0.0,0.0
12011.0,6,13,1459,7,862,1736.1666666666667,271.0,123.14285714285714,6,597,2242.8,259.0,99.5
2432.0,17,4,344,2,150,0.0,75.0,75.0,2,194,0.0,103.0,97.0
98929006.0,17,12,778,6,389,19753783.2,174.0,64.83333333333333,6,389,19718514.0,174.0,64.83333333333333
2444.0,17,4,344,2,150,0.0,75.0,75.0,2,194,0.0,103.0,97.0
369.0,17,2,267,1,83,0.0,83.0,83.0,1,184,0.0,184.0,184.0
124001365.0,17,15,907,8,475,17714480.714285713,174.0,59.375,7,432,17337733.833333332,174.0,61.71428571428572
5649.0,17,2,691,2,691,0.0,349.0,345.5,0,0,0.0,0.0,0.0
50680.0,6,14,4740,7,653,7670.0,249.0,93.28571428571428,7,4087,8304.166666666666,1514.0,583.8571428571429
442.0,17,2,508,2,508,0.0,257.0,254.0,0,0,0.0,0.0,0.0
143869.0,17,2,180,1,90,0.0,90.0,90.0,1,90,0.0,90.0,90.0
120122613.0,6,13,2036,8,1016,17136982.42857143,188.0,127.0,5,1020,22523296.75,204.0,204.0
4341.0,17,2,618,1,72,0.0,72.0,72.0,1,546,0.0,546.0,546.0
42753.0,6,14,4740,7,653,6192.166666666667,249.0,93.28571428571428,7,4087,6464.666666666667,1514.0,583.8571428571429
135132753.0,17,6,1206,6,1206,27026550.6,201.0,201.0,0,0,0.0,0.0,0.0
102324679.0,6,42,2772,21,1386,5105440.05,66.0,66.0,21,1386,5105441.8,66.0,66.0
2594051.0,6,2,132,1,66,0.0,66.0,66.0,1,66,0.0,66.0,66.0
3324805.0,17,4,324,2,162,0.0,82.0,81.0,2,162,0.0,82.0,81.0
108102393.0,17,5,955,5,955,27025598.25,191.0,191.0,0,0,0.0,0.0,0.0
316584.0,17,4,1400,4,1400,105528.0,350.0,350.0,0,0,0.0,0.0,0.0
1479869.0,6,4,276,2,128,0.0,74.0,64.0,2,148,0.0,74.0,74.0
363.0,17,2,267,1,83,0.0,83.0,83.0,1,184,0.0,184.0,184.0
27283557.0,17,5,1710,5,1710,6820889.25,342.0,342.0,0,0,0.0,0.0,0.0
314370.0,6,6,412,4,272,104790.0,74.0,68.0,2,140,0.0,74.0,70.0
91826082.0,6,157,17840,79,12544,1177257.4615384615,284.0,158.78481012658227,78,5296,1153610.6233766233,140.0,67.8974358974359
237395.0,6,3,337,2,214,0.0,160.0,107.0,1,123,0.0,123.0,123.0
103500.0,17,2,286,2,286,0.0,143.0,143.0,0,0,0.0,0.0,0.0
120322330.0,17,13,821,7,432,20053721.666666668,174.0,61.71428571428572,6,389,20103530.6,174.0,64.83333333333333
43776.0,6,14,4740,7,653,7142.833333333333,249.0,93.28571428571428,7,4087,6061.666666666667,1514.0,583.8571428571429
573286.0,6,4,508,2,238,0.0,172.0,119.0,2,270,0.0,135.0,135.0
103660.0,6,15,4806,8,719,14177.142857142857,249.0,89.875,7,4087,16029.666666666666,1514.0,583.8571428571429
175150.0,17,4,571,2,148,0.0,74.0,74.0,2,423,0.0,276.0,211.5
309501.0,6,6,412,4,272,103167.0,74.0,68.0,2,140,0.0,74.0,70.0
37306.0,6,14,4740,7,653,6096.333333333333,249.0,93.28571428571428,7,4087,6080.666666666667,1514.0,583.8571428571429
2444.0,17,4,344,2,150,0.0,75.0,75.0,2,194,0.0,103.0,97.0
108101645.0,17,5,955,5,955,27025411.25,191.0,191.0,0,0,0.0,0.0,0.0
113150003.0,6,277,33966,139,9396,819927.5579710145,140.0,67.59712230215827,138,24570,819153.4306569343,300.0,178.04347826086956
10511692.0,6,7,478,4,272,3458319.6666666665,74.0,68.0,3,206,5187333.0,74.0,68.66666666666667
24336.0,6,14,4740,7,653,3677.6666666666665,249.0,93.28571428571428,7,4087,2638.6666666666665,1514.0,583.8571428571429
10531370.0,6,7,478,4,272,3465078.6666666665,74.0,68.0,3,206,5197522.5,74.0,68.66666666666667
121367.0,6,3,337,2,214,0.0,160.0,107.0,1,123,0.0,123.0,123.0
117863.0,17,3,1050,3,1050,58931.5,350.0,350.0,0,0,0.0,0.0,0.0
197255.0,17,2,180,1,90,0.0,90.0,90.0,1,90,0.0,90.0,90.0
21248.0,6,10,2032,5,524,2760.0,252.0,104.8,5,1508,4552.0,1236.0,301.6
9377.0,17,2,571,1,86,0.0,86.0,86.0,1,485,0.0,485.0,485.0
90215550.0,6,16,1192,8,596,12852320.142857144,95.0,74.5,8,596,12857064.285714284,95.0,74.5
217093.0,6,3,426,2,280,0.0,214.0,140.0,1,146,0.0,146.0,146.0
99606510.0,6,461,62898,231,15468,433071.7826086957,140.0,66.96103896103897,230,47430,433998.7947598253,300.0,206.2173913043478
146153.0,6,3,337,2,214,0.0,160.0,107.0,1,123,0.0,123.0,123.0
37169.0,6,14,4740,7,653,5594.5,249.0,93.28571428571428,7,4087,6022.166666666667,1514.0,583.8571428571429
120053757.0,17,28,13364,28,13364,4446435.444444444,501.0,477.2857142857143,0,0,0.0,0.0,0.0
108085376.0,17,5,955,5,955,27021344.0,191.0,191.0,0,0,0.0,0.0,0.0
71635.0,6,14,4740,7,653,11723.666666666666,249.0,93.28571428571428,7,4087,9802.5,1514.0,583.8571428571429
245594.0,6,3,337,2,214,0.0,160.0,107.0,1,123,0.0,123.0,123.0
207836.0,6,3,426,2,280,0.0,214.0,140.0,1,146,0.0,146.0,146.0
90028495.0,17,28,13364,28,13364,3334388.703703704,501.0,477.2857142857143,0,0,0.0,0.0,0.0
110010209.0,17,13,821,7,432,18335034.83333333,174.0,61.71428571428572,6,389,18000158.8,174.0,64.83333333333333
298749.0,6,6,412,4,272,99583.0,74.0,68.0,2,140,0.0,74.0,70.0
311443.0,17,4,622,4,622,103814.33333333331,163.0,155.5,0,0,0.0,0.0,0.0
90301093.0,6,22,1680,12,935,8204911.272727272,95.0,77.91666666666667,10,745,10000753.222222222,95.0,74.5
1078978.0,6,13,1479,7,882,179829.66666666666,291.0,126.0,6,597,213718.4,259.0,99.5
90198241.0,6,16,1192,8,596,12851120.857142856,95.0,74.5,8,596,12856249.285714284,95.0,74.5
98930.0,17,2,762,2,762,0.0,381.0,381.0,0,0,0.0,0.0,0.0
54232.0,6,14,4740,7,653,8214.333333333334,249.0,93.28571428571428,7,4087,7578.5,1514.0,583.8571428571429
119538167.0,17,35,16705,35,16705,3515828.4411764704,501.0,477.2857142857143,0,0,0.0,0.0,0.0
148018.0,17,2,180,1,90,0.0,90.0,90.0,1,90,0.0,90.0,90.0
232880.0,6,3,337,2,214,0.0,160.0,107.0,1,123,0.0,123.0,123.0
5627659.0,6,5,336,2,134,0.0,68.0,67.0,3,202,1421464.5,70.0,67.33333333333333
24972.0,6,13,1479,7,882,4162.0,291.0,126.0,6,597,4135.8,259.0,99.5
119429185.0,6,219,24834,110,17418,1095680.5963302753,284.0,158.34545454545454,109,7416,1096215.009259259,140.0,68.03669724770643
90300433.0,6,16,1192,8,596,12892881.0,95.0,74.5,8,596,12898897.857142856,95.0,74.5
323646.0,6,6,412,4,272,107882.0,74.0,68.0,2,140,0.0,74.0,70.0
205594.0,17,2,180,1,90,0.0,90.0,90.0,1,90,0.0,90.0,90.0
103138217.0,17,14,864,7,432,17168030.833333332,174.0,61.71428571428572,7,432,17166837.833333332,174.0,61.71428571428572
1302994.0,6,4,264,2,132,0.0,66.0,66.0,2,132,0.0,66.0,66.0
117379358.0,6,23,1734,12,935,10670850.727272728,95.0,77.91666666666667,11,799,11712192.3,95.0,72.63636363636364
90058274.0,17,27,12943,27,12943,3463779.769230769,501.0,479.3703703703704,0,0,0.0,0.0,0.0
25804.0,6,10,2032,5,524,3261.5,252.0,104.8,5,1508,6198.75,1236.0,301.6
146275.0,6,3,337,2,214,0.0,160.0,107.0,1,123,0.0,123.0,123.0
204542.0,17,2,762,2,762,0.0,381.0,381.0,0,0,0.0,0.0,0.0
1380094.0,6,8,602,5,404,319409.75,103.0,80.8,3,198,204643.5,66.0,66.0
146310.0,6,3,337,2,214,0.0,160.0,107.0,1,123,0.0,123.0,123.0
2600264.0,6,2,132,1,66,0.0,66.0,66.0,1,66,0.0,66.0,66.0
146047.0,6,3,337,2,214,0.0,160.0,107.0,1,123,0.0,123.0,123.0
108104575.0,17,5,1005,5,1005,27026143.75,201.0,201.0,0,0,0.0,0.0,0.0
191384.0,6,26,12978,14,1073,14721.846153846154,207.0,76.64285714285714,12,11905,16695.727272727272,1514.0,992.0833333333334
106749.0,17,2,762,2,762,0.0,381.0,381.0,0,0,0.0,0.0,0.0
35486.0,6,10,2032,5,524,8251.5,252.0,104.8,5,1508,8529.5,1236.0,301.6
155227.0,6,3,337,2,214,0.0,160.0,107.0,1,123,0.0,123.0,123.0
216589.0,17,2,180,1,90,0.0,90.0,90.0,1,90,0.0,90.0,90.0
135136582.0,17,6,1206,6,1206,27027316.4,201.0,201.0,0,0,0.0,0.0,0.0
728.0,17,4,438,2,148,0.0,74.0,74.0,2,290,0.0,147.0,145.0
135135016.0,17,6,1146,6,1146,27027003.2,191.0,191.0,0,0,0.0,0.0,0.0
120397112.0,6,223,25224,112,17676,1084658.6666666667,374.0,157.82142857142858,111,7548,1085231.6090909091,140.0,68.0
249839.0,17,4,6056,4,6056,83279.66666666667,1514.0,1514.0,0,0,0.0,0.0,0.0
204729.0,17,2,762,2,762,0.0,381.0,381.0,0,0,0.0,0.0,0.0
127557773.0,17,14,864,7,432,17923080.833333332,174.0,61.71428571428572,7,432,18000988.166666668,174.0,61.71428571428572
1302402.0,6,4,264,2,132,0.0,66.0,66.0,2,132,0.0,66.0,66.0
90021235.0,17,28,13364,28,13364,3334119.814814815,501.0,477.2857142857143,0,0,0.0,0.0,0.0
2796934.0,6,2,132,1,66,0.0,66.0,66.0,1,66,0.0,66.0,66.0
207120.0,6,3,426,2,280,0.0,214.0,140.0,1,146,0.0,146.0,146.0
259106.0,6,3,337,2,214,0.0,160.0,107.0,1,123,0.0,123.0,123.0
833.0,17,4,438,2,148,0.0,74.0,74.0,2,290,0.0,147.0,145.0
29619.0,6,10,2032,5,524,6624.0,252.0,104.8,5,1508,6845.5,1236.0,301.6
4695.0,17,4,344,2,150,0.0,75.0,75.0,2,194,0.0,103.0,97.0
9261.0,17,2,539,1,86,0.0,86.0,86.0,1,453,0.0,453.0,453.0
143898.0,17,2,180,1,90,0.0,90.0,90.0,1,90,0.0,90.0,90.0
40245.0,6,14,4740,7,653,6518.0,249.0,93.28571428571428,7,4087,6462.166666666667,1514.0,583.8571428571429
0.0,6,1,66,1,66,0.0,66.0,66.0,0,0,0.0,0.0,0.0
303995.0,17,2,180,1,90,0.0,90.0,90.0,1,90,0.0,90.0,90.0
120169219.0,6,220,24740,110,7556,1094985.0366972478,140.0,68.69090909090909,110,17184,1076226.4311926605,284.0,156.21818181818182
90287698.0,6,16,1192,8,596,12891363.857142856,95.0,74.5,8,596,12897056.714285716,95.0,74.5
1434304.0,17,16,1120,16,1120,95620.26666666666,70.0,70.0,0,0,0.0,0.0,0.0
70484.0,6,14,4740,7,653,11561.5,249.0,93.28571428571428,7,4087,10648.666666666666,1514.0,583.8571428571429
237266.0,17,2,180,1,90,0.0,90.0,90.0,1,90,0.0,90.0,90.0
685459.0,17,4,820,2,156,0.0,78.0,78.0,2,664,0.0,332.0,332.0
161156.0,6,2,128,1,74,0.0,74.0,74.0,1,54,0.0,54.0,54.0
0.0,17,1,44,1,44,0.0,44.0,44.0,0,0,0.0,0.0,0.0
90300398.0,6,16,1192,8,596,12893180.285714284,95.0,74.5,8,596,12899034.857142856,95.0,74.5
141471.0,17,4,820,2,156,0.0,78.0,78.0,2,664,0.0,332.0,332.0
1311464.0,6,4,264,2,132,0.0,66.0,66.0,2,132,0.0,66.0,66.0
31378.000000000004,6,14,4740,7,653,5039.666666666667,249.0,93.28571428571428,7,4087,4926.5,1514.0,583.8571428571429
303111.0,6,2,132,1,66,0.0,66.0,66.0,1,66,0.0,66.0,66.0
105538543.0,6,30,2106,15,1089,7523052.5,123.0,72.6,15,1017,7523060.142857143,123.0,67.8
90023331.0,17,28,13364,28,13364,3334197.4444444445,501.0,477.2857142857143,0,0,0.0,0.0,0.0
108112442.0,17,5,1005,5,1005,27028110.5,201.0,201.0,0,0,0.0,0.0,0.0
197859.0,17,2,180,1,90,0.0,90.0,90.0,1,90,0.0,90.0,90.0
599739.0,17,2,346,1,78,0.0,78.0,78.0,1,268,0.0,268.0,268.0
13493.0,6,13,1459,7,862,2139.333333333333,271.0,123.14285714285714,6,597,2223.2,259.0,99.5
93015453.0,6,38,2508,19,1254,5150439.0,66.0,66.0,19,1254,5150439.222222222,66.0,66.0
113615281.0,6,208,23440,104,16354,1100972.5339805826,284.0,157.25,104,7086,1100972.582524272,140.0,68.13461538461539
405315.0,6,4,508,2,238,0.0,172.0,119.0,2,270,0.0,135.0,135.0
90948739.0,6,21,1585,11,840,9094620.7,95.0,76.36363636363636,10,745,10104593.0,95.0,74.5
2485.0,17,4,344,2,150,0.0,75.0,75.0,2,194,0.0,103.0,97.0
153327.0,17,2,180,1,90,0.0,90.0,90.0,1,90,0.0,90.0,90.0
2281.0,17,4,344,2,150,0.0,75.0,75.0,2,194,0.0,103.0,97.0
103047.0,17,2,286,2,286,0.0,143.0,143.0,0,0,0.0,0.0,0.0
90038653.0,17,27,12943,27,12943,3463025.1153846155,501.0,479.3703703703704,0,0,0.0,0.0,0.0
1169644.0,6,13,3019,8,2391,167092.0,1514.0,298.875,5,628,223491.25,331.0,125.6
110245748.0,17,14,864,7,432,18167815.0,174.0,61.71428571428572,7,432,18166857.5,174.0,61.71428571428572
377991.0,6,3,202,2,128,0.0,74.0,64.0,1,74,0.0,74.0,74.0
100116532.0,17,12,516,6,258,20000980.8,43.0,43.0,6,258,20000164.8,43.0,43.0
3754.0,17,2,414,1,88,0.0,88.0,88.0,1,326,0.0,326.0,326.0
2330208.0,6,3,1777,1,826,0.0,826.0,826.0,2,951,0.0,885.0,475.5
0.0,17,1,90,1,90,0.0,90.0,90.0,0,0,0.0,0.0,0.0
10475059.0,6,6,412,3,206,5169244.5,74.0,68.66666666666667,3,206,5169136.5,74.0,68.66666666666667
47023.0,6,14,4740,7,653,7707.5,249.0,93.28571428571428,7,4087,7241.666666666667,1514.0,583.8571428571429
233043.0,6,3,337,2,214,0.0,160.0,107.0,1,123,0.0,123.0,123.0
90283214.0,6,14,1043,7,542,15047202.333333334,95.0,77.42857142857143,7,501,14998251.166666666,95.0,71.57142857142857
228202.0,17,2,180,1,90,0.0,90.0,90.0,1,90,0.0,90.0,90.0
1990.0,17,4,344,2,150,0.0,75.0,75.0,2,194,0.0,103.0,97.0
11477.0,6,10,1065,5,534,2658.5,262.0,106.8,5,531,2472.5,259.0,106.2
90017592.0,17,28,13364,28,13364,3333984.888888889,501.0,477.2857142857143,0,0,0.0,0.0,0.0
31988.000000000004,6,14,4740,7,653,4877.333333333333,249.0,93.28571428571428,7,4087,5193.333333333333,1514.0,583.8571428571429
153441.0,17,2,180,1,90,0.0,90.0,90.0,1,90,0.0,90.0,90.0
111255.0,17,2,286,2,286,0.0,143.0,143.0,0,0,0.0,0.0,0.0
303607.0,6,6,412,4,272,101202.33333333331,74.0,68.0,2,140,0.0,74.0,70.0
229980.0,17,2,180,1,90,0.0,90.0,90.0,1,90,0.0,90.0,90.0
326208.0,6,6,412,4,272,108736.0,74.0,68.0,2,140,0.0,74.0,70.0
120125015.0,6,13,2036,5,1020,30031253.75,204.0,204.0,8,1016,17137410.42857143,188.0,127.0
120085574.0,17,28,13364,28,13364,4447613.851851852,501.0,477.2857142857143,0,0,0.0,0.0,0.0
107683.0,17,2,286,2,286,0.0,143.0,143.0,0,0,0.0,0.0,0.0
0.0,17,1,161,1,161,0.0,161.0,161.0,0,0,0.0,0.0,0.0
46323.0,6,19,7540,10,912,4864.444444444444,310.0,91.2,9,6628,5618.75,1514.0,736.4444444444445
113688640.0,6,209,23490,105,7226,1093027.7211538462,140.0,68.81904761904762,104,16264,1085812.2718446602,284.0,156.3846153846154
1548.0,17,2,192,1,88,0.0,88.0,88.0,1,104,0.0,104.0,104.0
5622757.0,6,4,270,2,136,0.0,70.0,68.0,2,134,0.0,68.0,67.0
1028933.0,6,11,1134,6,558,205786.6,220.0,93.0,5,576,256173.0,304.0,115.2
40876.0,6,14,4740,7,653,6244.666666666667,249.0,93.28571428571428,7,4087,5980.166666666667,1514.0,583.8571428571429
237727.0,17,2,180,1,90,0.0,90.0,90.0,1,90,0.0,90.0,90.0
234067.0,6,3,373,2,238,0.0,172.0,119.0,1,135,0.0,135.0,135.0
1304149.0,6,4,264,2,132,0.0,66.0,66.0,2,132,0.0,66.0,66.0
39248.0,6,10,2032,5,524,7708.75,252.0,104.8,5,1508,9528.25,1236.0,301.6
197024.0,17,2,180,1,90,0.0,90.0,90.0,1,90,0.0,90.0,90.0
822.0,17,4,438,2,148,0.0,74.0,74.0,2,290,0.0,147.0,145.0
56838.0,6,14,4740,7,653,9253.333333333334,249.0,93.28571428571428,7,4087,8989.666666666666,1514.0,583.8571428571429
109479142.0,17,14,864,7,432,18167985.83333333,174.0,61.71428571428572,7,432,18166834.666666668,174.0,61.71428571428572
300596.0,6,6,412,4,272,100198.66666666669,74.0,68.0,2,140,0.0,74.0,70.0
23951.0,6,10,2032,5,524,5740.25,252.0,104.8,5,1508,5286.5,1236.0,301.6
300744.0,6,6,412,4,272,100248.0,74.0,68.0,2,140,0.0,74.0,70.0
108109992.0,17,5,1005,5,1005,27027498.0,201.0,201.0,0,0,0.0,0.0,0.0
1160381.0,6,13,3000,8,2372,165768.7142857143,1514.0,296.5,5,628,221907.0,331.0,125.6
101145797.0,17,14,1126,7,563,16830943.833333332,174.0,80.42857142857143,7,563,16830945.333333332,174.0,80.42857142857143
75980.0,6,14,4740,7,653,12541.5,249.0,93.28571428571428,7,4087,12359.833333333334,1514.0,583.8571428571429
90628255.0,6,30,2106,15,1089,6458042.285714285,123.0,72.6,15,1017,6458043.142857143,123.0,67.8
43080.0,6,14,4740,7,653,6521.0,249.0,93.28571428571428,7,4087,6488.166666666667,1514.0,583.8571428571429
309922.0,6,3,202,2,128,0.0,74.0,64.0,1,74,0.0,74.0,74.0
2364.0,17,4,344,2,150,0.0,75.0,75.0,2,194,0.0,103.0,97.0
351.0,17,2,248,1,84,0.0,84.0,84.0,1,164,0.0,164.0,164.0
24051747.0,17,3,1034,2,684,0.0,342.0,342.0,1,350,0.0,350.0,350.0
135134361.0,17,6,1146,6,1146,27026872.2,191.0,191.0,0,0,0.0,0.0,0.0
3212389.0,6,15,2266,8,1146,458912.7142857143,580.0,143.25,7,1120,499016.0,732.0,160.0
313599.0,17,4,1400,4,1400,104533.0,350.0,350.0,0,0,0.0,0.0,0.0
211783.0,17,4,1400,4,1400,70594.33333333333,350.0,350.0,0,0,0.0,0.0,0.0
90307255.0,6,16,1192,8,596,12893720.714285716,95.0,74.5,8,596,12900500.857142856,95.0,74.5
961888.0,6,13,1420,7,789,159682.83333333334,253.0,112.71428571428572,6,631,191809.2,293.0,105.16666666666669
2412.0,17,4,344,2,150,0.0,75.0,75.0,2,194,0.0,103.0,97.0
117281213.0,6,253,29450,127,8678,930803.2777777778,140.0,68.33070866141732,126,20772,930015.056,300.0,164.85714285714286
746629.0,6,10,1221,6,636,149325.8,298.0,106.0,4,585,247524.66666666663,379.0,146.25
37156.0,6,10,2032,5,524,9033.75,252.0,104.8,5,1508,7537.25,1236.0,301.6
40321.0,6,14,4740,7,653,6598.0,249.0,93.28571428571428,7,4087,6572.333333333333,1514.0,583.8571428571429
301972.0,6,6,412,4,272,100657.33333333331,74.0,68.0,2,140,0.0,74.0,70.0
321017.0,17,4,1400,4,1400,107005.66666666669,350.0,350.0,0,0,0.0,0.0,0.0
99003469.0,17,11,735,6,389,19800693.8,174.0,64.83333333333333,5,346,19750155.5,174.0,69.2
32151.0,6,10,2032,5,524,7794.75,252.0,104.8,5,1508,7635.5,1236.0,301.6
305670.0,6,2,1538,1,753,0.0,753.0,753.0,1,785,0.0,785.0,785.0
18115.0,6,11,1131,6,600,3124.2,262.0,100.0,5,531,4209.5,259.0,106.2
144058.0,17,2,180,1,90,0.0,90.0,90.0,1,90,0.0,90.0,90.0
50855.0,17,2,180,1,90,0.0,90.0,90.0,1,90,0.0,90.0,90.0
1694275.0,6,19,7533,10,1403,188252.7777777777,583.0,140.3,9,6130,178815.125,1484.0,681.1111111111111
312543.0,6,3,202,2,128,0.0,74.0,64.0,1,74,0.0,74.0,74.0
51798.0,6,11,2098,6,590,9002.4,252.0,98.33333333333331,5,1508,11706.75,1236.0,301.6
135129080.0,17,6,1206,6,1206,27025816.0,201.0,201.0,0,0,0.0,0.0,0.0
2377.0,17,4,344,2,150,0.0,75.0,75.0,2,194,0.0,103.0,97.0
120057593.0,17,29,13785,29,13785,4287771.178571428,501.0,475.3448275862069,0,0,0.0,0.0,0.0
246128.0,6,3,337,2,214,0.0,160.0,107.0,1,123,0.0,123.0,123.0
298543.0,6,6,412,4,272,99514.33333333331,74.0,68.0,2,140,0.0,74.0,70.0
239641.0,6,3,373,2,238,0.0,172.0,119.0,1,135,0.0,135.0,135.0
90487513.0,6,19,1436,10,786,10049093.111111112,95.0,78.6,9,650,11305662.0,95.0,72.22222222222223
90004453.0,6,15,1097,8,596,12857779.0,95.0,74.5,7,501,14953129.333333334,95.0,71.57142857142857
121598.0,6,3,337,2,214,0.0,160.0,107.0,1,123,0.0,123.0,123.0
115522393.0,6,34,2482,17,1194,7220123.375,123.0,70.23529411764706,17,1288,6596108.4375,139.0,75.76470588235294
10785.0,6,10,2032,5,524,2400.75,252.0,104.8,5,1508,2437.5,1236.0,301.6
591564.0,6,5,526,3,280,295782.0,160.0,93.33333333333331,2,246,0.0,123.0,123.0
4513.0,17,2,614,1,72,0.0,72.0,72.0,1,542,0.0,542.0,542.0
3038577.0,6,3,204,2,136,0.0,70.0,68.0,1,68,0.0,68.0,68.0
5825844.0,6,4,270,2,134,0.0,68.0,67.0,2,136,0.0,70.0,68.0
108101432.0,17,5,1005,5,1005,27025358.0,201.0,201.0,0,0,0.0,0.0,0.0
5009873.0,17,4,376,2,152,0.0,76.0,76.0,2,224,0.0,148.0,112.0
59524.0,6,14,4740,7,653,9172.833333333334,249.0,93.28571428571428,7,4087,9721.333333333334,1514.0,583.8571428571429
115690.0,6,12,1354,6,723,21419.2,253.0,120.5,6,631,21441.2,293.0,105.16666666666669
16634.0,17,2,180,1,90,0.0,90.0,90.0,1,90,0.0,90.0,90.0
119870.0,17,2,180,1,70,0.0,70.0,70.0,1,110,0.0,110.0,110.0
300446.0,17,4,1400,4,1400,100148.66666666669,350.0,350.0,0,0,0.0,0.0,0.0
197124.0,17,2,180,1,90,0.0,90.0,90.0,1,90,0.0,90.0,90.0
123416552.0,6,48,3168,24,1584,4947828.565217392,66.0,66.0,24,1584,5353750.826086956,66.0,66.0
12588978.0,17,17,6470,17,6470,786811.125,394.0,380.5882352941176,0,0,0.0,0.0,0.0
72873.0,17,3,1143,3,1143,36436.5,381.0,381.0,0,0,0.0,0.0,0.0
144729.0,17,2,180,1,70,0.0,70.0,70.0,1,110,0.0,110.0,110.0
114767.0,17,4,1400,4,1400,38255.66666666666,350.0,350.0,0,0,0.0,0.0,0.0
90311706.0,6,24,1829,13,989,7520967.916666667,95.0,76.07692307692308,11,840,9002797.7,95.0,76.36363636363636
13422.0,6,13,1459,7,862,2083.1666666666665,271.0,123.14285714285714,6,597,2394.8,259.0,99.5
144036.0,17,2,180,1,90,0.0,90.0,90.0,1,90,0.0,90.0,90.0
232286.0,6,3,337,2,214,0.0,160.0,107.0,1,123,0.0,123.0,123.0
321032.0,6,6,412,4,272,107010.66666666669,74.0,68.0,2,140,0.0,74.0,70.0
24066839.0,17,3,1034,2,684,0.0,342.0,342.0,1,350,0.0,350.0,350.0
4065.0,17,2,582,1,83,0.0,83.0,83.0,1,499,0.0,499.0,499.0
120066020.0,17,28,13364,28,13364,4446889.62962963,501.0,477.2857142857143,0,0,0.0,0.0,0.0
202115.0,17,4,1524,4,1524,67371.66666666667,381.0,381.0,0,0,0.0,0.0,0.0
0.0,17,1,381,1,381,0.0,381.0,381.0,0,0,0.0,0.0,0.0
55974.0,6,14,4740,7,653,9041.0,249.0,93.28571428571428,7,4087,7831.333333333333,1514.0,583.8571428571429
2594189.0,6,2,132,1,66,0.0,66.0,66.0,1,66,0.0,66.0,66.0
90056085.0,17,28,13364,28,13364,3335410.5555555555,501.0,477.2857142857143,0,0,0.0,0.0,0.0
153514.0,17,2,180,1,90,0.0,90.0,90.0,1,90,0.0,90.0,90.0
90531357.0,6,13,2036,8,1016,12933051.0,188.0,127.0,5,1020,22591819.5,204.0,204.0
49331.0,6,14,4740,7,653,8091.666666666667,249.0,93.28571428571428,7,4087,6379.833333333333,1514.0,583.8571428571429
105260.0,17,2,762,2,762,0.0,381.0,381.0,0,0,0.0,0.0,0.0
90287915.0,6,17,1287,9,691,11280022.875,95.0,76.77777777777777,8,596,12832533.142857144,95.0,74.5
108105613.0,17,5,1005,5,1005,27026403.25,201.0,201.0,0,0,0.0,0.0,0.0
106039.0,17,2,700,2,700,0.0,350.0,350.0,0,0,0.0,0.0,0.0
736930.0,6,6,758,3,410,285958.5,172.0,136.66666666666666,3,348,253185.5,135.0,116.0
156933.0,6,3,337,2,214,0.0,160.0,107.0,1,123,0.0,123.0,123.0
4384.0,17,2,626,1,72,0.0,72.0,72.0,1,554,0.0,554.0,554.0
241794.0,6,3,337,2,214,0.0,160.0,107.0,1,123,0.0,123.0,123.0
1518580.0,6,4,276,2,128,0.0,74.0,64.0,2,148,0.0,74.0,74.0
90217680.0,6,19,1436,9,691,11247071.5,95.0,76.77777777777777,10,745,10001362.555555556,95.0,74.5
28715.0,6,14,4740,7,653,4362.666666666667,249.0,93.28571428571428,7,4087,3778.8333333333335,1514.0,583.8571428571429
300321.0,6,6,412,4,272,100107.0,74.0,68.0,2,140,0.0,74.0,70.0
30927.0,6,14,4740,7,653,5006.0,249.0,93.28571428571428,7,4087,4208.5,1514.0,583.8571428571429
90256338.0,6,13,2036,8,1016,12893762.57142857,188.0,127.0,5,1020,22523505.25,204.0,204.0
307.0,17,2,164,1,82,0.0,82.0,82.0,1,82,0.0,82.0,82.0
53932.0,6,10,2032,5,524,12488.0,252.0,104.8,5,1508,13272.5,1236.0,301.6
153806.0,17,2,180,1,90,0.0,90.0,90.0,1,90,0.0,90.0,90.0
40136.0,6,10,2032,5,524,8725.75,252.0,104.8,5,1508,9379.0,1236.0,301.6
4161.0,17,4,344,2,150,0.0,75.0,75.0,2,194,0.0,103.0,97.0
153448.0,17,2,180,1,90,0.0,90.0,90.0,1,90,0.0,90.0,90.0
413.0,17,2,267,1,83,0.0,83.0,83.0,1,184,0.0,184.0,184.0
28130.0,6,10,2032,5,524,6704.25,252.0,104.8,5,1508,5348.0,1236.0,301.6
847803.0,6,9,1118,6,586,169560.6,248.0,97.66666666666669,3,532,286088.0,392.0,177.33333333333334
108098914.0,17,5,955,5,955,27024728.5,191.0,191.0,0,0,0.0,0.0,0.0
14645138.0,6,20,1607,10,975,1592270.6666666667,315.0,97.5,10,632,1592246.2222222222,78.0,63.2
209505.0,6,3,426,2,280,0.0,214.0,140.0,1,146,0.0,146.0,146.0
2452624.0,6,25,7573,14,3735,188663.38461538465,1514.0,266.7857142857143,11,3838,219373.9,1514.0,348.90909090909093
282706.0,17,2,180,1,90,0.0,90.0,90.0,1,90,0.0,90.0,90.0
172051.0,17,2,180,1,90,0.0,90.0,90.0,1,90,0.0,90.0,90.0
9821.0,17,2,571,1,86,0.0,86.0,86.0,1,485,0.0,485.0,485.0
314459.0,6,6,412,4,272,104819.66666666669,74.0,68.0,2,140,0.0,74.0,70.0
106766.0,17,4,1400,4,1400,35588.666666666664,350.0,350.0,0,0,0.0,0.0,0.0
1486.0,17,2,180,1,90,0.0,90.0,90.0,1,90,0.0,90.0,90.0
48163.0,6,10,2032,5,524,11647.0,252.0,104.8,5,1508,11219.5,1236.0,301.6
22492.0,17,2,239,1,82,0.0,82.0,82.0,1,157,0.0,157.0,157.0
590403.0,6,6,758,3,410,285086.5,172.0,136.66666666666666,3,348,223097.0,135.0,116.0
10954867.0,6,8,544,4,272,3604502.0,74.0,68.0,4,272,3604388.0,74.0,68.0
53342.0,17,2,180,1,90,0.0,90.0,90.0,1,90,0.0,90.0,90.0
102490.0,17,2,286,2,286,0.0,143.0,143.0,0,0,0.0,0.0,0.0
303893.0,17,2,180,1,90,0.0,90.0,90.0,1,90,0.0,90.0,90.0
1783004.0,6,19,7533,10,1403,198111.5555555556,583.0,140.3,9,6130,189397.75,1484.0,681.1111111111111
76747.0,6,14,4740,7,653,11454.0,249.0,93.28571428571428,7,4087,11999.0,1514.0,583.8571428571429
119588481.0,6,20,1490,10,745,13287609.0,95.0,74.5,10,745,13258981.333333334,95.0,74.5
405122.0,6,4,508,2,238,0.0,172.0,119.0,2,270,0.0,135.0,135.0
224207.0,6,13,1394,7,797,37367.833333333336,253.0,113.85714285714286,6,597,42775.2,259.0,99.5
1168487.0,6,13,3010,8,2382,166926.7142857143,1514.0,297.75,5,628,223984.5,331.0,125.6
36977.0,6,14,4740,7,653,6047.0,249.0,93.28571428571428,7,4087,5458.333333333333,1514.0,583.8571428571429
10438540.0,6,7,478,4,272,3432969.6666666665,74.0,68.0,3,206,5149327.0,74.0,68.66666666666667
108104387.0,17,5,955,5,955,27026096.75,191.0,191.0,0,0,0.0,0.0,0.0
513580.00000000006,6,3,204,2,136,0.0,70.0,68.0,1,68,0.0,68.0,68.0
111000963.0,17,13,821,7,432,18500160.5,174.0,61.71428571428572,6,389,19979273.2,174.0,64.83333333333333
27447.0,6,14,4740,7,653,4115.833333333333,249.0,93.28571428571428,7,4087,4443.5,1514.0,583.8571428571429
108103580.0,17,5,1005,5,1005,27025895.0,201.0,201.0,0,0,0.0,0.0,0.0
329209.0,6,12,1373,7,714,54868.16666666666,298.0,102.0,5,659,77567.25,379.0,131.8
2454.0,17,4,344,2,150,0.0,75.0,75.0,2,194,0.0,103.0,97.0
234484.0,6,3,373,2,238,0.0,172.0,119.0,1,135,0.0,135.0,135.0
302412.0,6,2,132,1,66,0.0,66.0,66.0,1,66,0.0,66.0,66.0
119800248.0,6,20,1490,10,745,13311138.666666666,95.0,74.5,10,745,13282755.111111112,95.0,74.5
811.0,17,4,438,2,148,0.0,74.0,74.0,2,290,0.0,147.0,145.0
101329088.0,17,14,864,7,432,16834284.5,174.0,61.71428571428572,7,432,16833496.833333332,174.0,61.71428571428572
324894.0,17,4,1400,4,1400,108298.0,350.0,350.0,0,0,0.0,0.0,0.0
153505.0,17,2,180,1,90,0.0,90.0,90.0,1,90,0.0,90.0,90.0
247160.0,6,3,373,2,238,0.0,172.0,119.0,1,135,0.0,135.0,135.0
296331.0,6,12,1373,7,714,49388.5,298.0,102.0,5,659,70036.25,379.0,131.8
21556.0,17,2,582,1,83,0.0,83.0,83.0,1,499,0.0,499.0,499.0
60552.0,6,14,4740,7,653,9821.0,249.0,93.28571428571428,7,4087,9944.666666666666,1514.0,583.8571428571429
108631.0,17,2,286,2,286,0.0,143.0,143.0,0,0,0.0,0.0,0.0
90292603.0,6,15,1097,8,596,12898943.285714284,95.0,74.5,7,501,14998247.166666666,95.0,71.57142857142857
228184.0,17,2,180,1,90,0.0,90.0,90.0,1,90,0.0,90.0,90.0
2348.0,17,4,344,2,150,0.0,75.0,75.0,2,194,0.0,103.0,97.0
372.0,17,2,762,2,762,0.0,381.0,381.0,0,0,0.0,0.0,0.0
3004769.0,6,12,2172,7,664,500695.1666666667,252.0,94.85714285714286,5,1508,2085.25,1236.0,301.6
5012808.0,17,4,849,2,166,0.0,83.0,83.0,2,683,0.0,499.0,341.5
3170203.0,6,18,1536,9,962,358397.5,315.0,106.88888888888889,9,574,358360.0,78.0,63.77777777777778
90915001.0,6,164,18540,82,12906,1119750.7777777778,284.0,157.390243902439,82,5634,1119751.1851851852,140.0,68.70731707317073
299149.0,17,2,180,1,90,0.0,90.0,90.0,1,90,0.0,90.0,90.0
6741.0,17,2,582,1,83,0.0,83.0,83.0,1,499,0.0,499.0,499.0
119849132.0,6,14,2102,5,1020,29961694.25,204.0,204.0,9,1082,14981004.75,188.0,120.22222222222224
92238.0,6,14,4740,7,653,15245.5,249.0,93.28571428571428,7,4087,14892.833333333334,1514.0,583.8571428571429
237380.0,6,3,337,2,214,0.0,160.0,107.0,1,123,0.0,123.0,123.0
103572.0,17,2,286,2,286,0.0,143.0,143.0,0,0,0.0,0.0,0.0
120322108.0,6,244,28014,122,8274,987686.5785123968,140.0,67.81967213114754,122,19740,987622.1570247934,284.0,161.8032786885246
5834680.0,6,5,336,3,202,1527291.0,70.0,67.33333333333333,2,134,0.0,68.0,67.0
362670.0,6,10,967,5,390,60878.0,162.0,78.0,5,577,60817.25,349.0,115.4
121514.0,6,3,337,2,214,0.0,160.0,107.0,1,123,0.0,123.0,123.0
205864.0,17,2,180,1,90,0.0,90.0,90.0,1,90,0.0,90.0,90.0
314270.0,6,3,202,2,128,0.0,74.0,64.0,1,74,0.0,74.0,74.0
236543.0,6,3,337,2,214,0.0,160.0,107.0,1,123,0.0,123.0,123.0
301179.0,6,6,412,4,272,100393.0,74.0,68.0,2,140,0.0,74.0,70.0
54043.0,6,14,4740,7,653,8060.0,249.0,93.28571428571428,7,4087,8246.666666666666,1514.0,583.8571428571429
55001.0,6,4,301,2,132,0.0,66.0,66.0,2,169,0.0,103.0,84.5
56855.0,6,13,1479,7,882,9237.5,291.0,126.0,6,597,11032.6,259.0,99.5
123795826.0,17,14,864,7,432,17333574.0,174.0,61.71428571428572,7,432,17334120.5,174.0,61.71428571428572
158120.0,6,3,337,2,214,0.0,160.0,107.0,1,123,0.0,123.0,123.0
97262370.0,17,12,778,6,389,19399369.4,174.0,64.83333333333333,6,389,19400152.4,174.0,64.83333333333333
90043405.0,17,28,13364,28,13364,3334940.925925926,501.0,477.2857142857143,0,0,0.0,0.0,0.0
108111280.0,17,5,955,5,955,27027820.0,191.0,191.0,0,0,0.0,0.0,0.0
2560058.0,6,25,7621,14,3783,196927.53846153847,1514.0,270.2142857142857,11,3838,230564.4,1514.0,348.90909090909093
120085725.0,6,34,2334,17,1209,7491868.625,123.0,71.11764705882354,17,1125,7491872.75,123.0,66.17647058823529
121240.0,6,3,337,2,214,0.0,160.0,107.0,1,123,0.0,123.0,123.0
35399.0,6,14,4740,7,653,5755.5,249.0,93.28571428571428,7,4087,5364.333333333333,1514.0,583.8571428571429
243323.0,6,3,337,2,214,0.0,160.0,107.0,1,123,0.0,123.0,123.0
51159.0,17,2,180,1,90,0.0,90.0,90.0,1,90,0.0,90.0,90.0
20689.0,6,20,7606,11,978,2068.9,310.0,88.9090909090909,9,6628,2318.875,1514.0,736.4444444444445
2348.0,17,4,344,2,150,0.0,75.0,75.0,2,194,0.0,103.0,97.0
205756.0,6,3,426,2,280,0.0,214.0,140.0,1,146,0.0,146.0,146.0
108104363.0,17,5,955,5,955,27026090.75,191.0,191.0,0,0,0.0,0.0,0.0
228196.0,17,2,180,1,90,0.0,90.0,90.0,1,90,0.0,90.0,90.0
49917.0,6,14,4740,7,653,7556.833333333333,249.0,93.28571428571428,7,4087,6999.5,1514.0,583.8571428571429
617447.0,17,2,346,1,78,0.0,78.0,78.0,1,268,0.0,268.0,268.0
108099466.0,17,5,1005,5,1005,27024866.5,201.0,201.0,0,0,0.0,0.0,0.0
90293715.0,6,19,1436,10,745,10026823.111111112,95.0,74.5,9,691,11286549.25,95.0,76.77777777777777
23703.0,6,10,2032,5,524,5711.5,252.0,104.8,5,1508,5601.5,1236.0,301.6
113516309.0,6,46,3036,23,1518,5159819.909090909,66.0,66.0,23,1518,5159820.863636363,66.0,66.0
90051529.0,17,27,12943,27,12943,3463520.346153846,501.0,479.3703703703704,0,0,0.0,0.0,0.0
120196803.0,6,18,1341,9,691,14999019.375,95.0,76.77777777777777,9,650,14999028.625,95.0,72.22222222222223
9787.0,17,2,582,1,83,0.0,83.0,83.0,1,499,0.0,499.0,499.0
1455.0,17,5,550,5,550,363.75,110.0,110.0,0,0,0.0,0.0,0.0
120000205.0,6,18,1382,10,786,13333356.111111112,95.0,78.6,8,596,12897145.714285716,95.0,74.5
20277.0,17,2,582,1,83,0.0,83.0,83.0,1,499,0.0,499.0,499.0
2320.0,17,4,344,2,150,0.0,75.0,75.0,2,194,0.0,103.0,97.0
217534.0,17,2,180,1,90,0.0,90.0,90.0,1,90,0.0,90.0,90.0
118118943.0,6,34,2350,17,1225,7368982.125,139.0,72.05882352941177,17,1125,7368982.5625,123.0,66.17647058823529
72052.0,6,12,1328,6,731,13673.6,253.0,121.83333333333331,6,597,12667.8,259.0,99.5
131041.0,6,3,337,2,214,0.0,160.0,107.0,1,123,0.0,123.0,123.0
210140.0,6,3,426,2,280,0.0,214.0,140.0,1,146,0.0,146.0,146.0
90258986.0,6,13,2036,8,1016,12894140.857142856,188.0,127.0,5,1020,22522600.0,204.0,204.0
107060.0,17,4,1400,4,1400,35686.666666666664,350.0,350.0,0,0,0.0,0.0,0.0
142738.0,17,2,762,2,762,0.0,381.0,381.0,0,0,0.0,0.0,0.0
238752.0,6,3,337,2,214,0.0,160.0,107.0,1,123,0.0,123.0,123.0
111255147.0,17,14,1126,7,563,18516036.166666668,174.0,80.42857142857143,7,563,18516039.0,174.0,80.42857142857143
212763.0,17,2,762,2,762,0.0,381.0,381.0,0,0,0.0,0.0,0.0
120121047.0,6,14,2224,9,1204,15015130.875,188.0,133.77777777777777,5,1020,22522353.5,204.0,204.0
25249.0,6,14,4740,7,653,3125.0,249.0,93.28571428571428,7,4087,4071.1666666666665,1514.0,583.8571428571429
119392013.0,17,35,16705,35,16705,3511529.794117647,501.0,477.2857142857143,0,0,0.0,0.0,0.0
3163578.0,6,18,1495,9,921,358343.875,315.0,102.33333333333331,9,574,358303.0,78.0,63.77777777777778
67570.0,6,10,2032,5,524,16575.5,252.0,104.8,5,1508,16641.75,1236.0,301.6
232973.0,6,3,337,2,214,0.0,160.0,107.0,1,123,0.0,123.0,123.0
2392.0,17,4,344,2,150,0.0,75.0,75.0,2,194,0.0,103.0,97.0
97052996.0,17,14,1126,7,563,15999949.5,174.0,80.42857142857143,7,563,16000147.0,174.0,80.42857142857143
56009.0,6,10,2032,5,524,13700.25,252.0,104.8,5,1508,12031.75,1236.0,301.6
299615.0,17,2,346,1,78,0.0,78.0,78.0,1,268,0.0,268.0,268.0
51333.0,6,10,2032,5,524,12507.75,252.0,104.8,5,1508,12121.25,1236.0,301.6
206044.0,17,2,180,1,90,0.0,90.0,90.0,1,90,0.0,90.0,90.0
90888.0,6,10,2032,5,524,22500.5,252.0,104.8,5,1508,21984.25,1236.0,301.6
59493.0,6,14,4740,7,653,9782.333333333334,249.0,93.28571428571428,7,4087,8540.166666666666,1514.0,583.8571428571429
36993.0,6,10,2032,5,524,8847.75,252.0,104.8,5,1508,8904.75,1236.0,301.6
16244285.000000002,17,6,2052,6,2052,3248857.0,342.0,342.0,0,0,0.0,0.0,0.0
90258731.0,6,13,2036,8,1016,12894104.42857143,188.0,127.0,5,1020,22523327.0,204.0,204.0
143899.0,17,2,180,1,90,0.0,90.0,90.0,1,90,0.0,90.0,90.0
86077.0,6,26,14587,14,1094,6621.307692307692,228.0,78.14285714285714,12,13493,7193.818181818182,1514.0,1124.4166666666667
316299.0,6,3,202,2,128,0.0,74.0,64.0,1,74,0.0,74.0,74.0
237152.0,17,2,180,1,90,0.0,90.0,90.0,1,90,0.0,90.0,90.0
90324476.0,6,16,1192,8,596,12896333.285714284,95.0,74.5,8,596,12902328.42857143,95.0,74.5
108110540.0,17,5,955,5,955,27027635.0,191.0,191.0,0,0,0.0,0.0,0.0
1150023.0,6,13,3010,8,2382,164289.0,1514.0,297.75,5,628,219340.0,331.0,125.6
21725.0,6,14,4740,7,653,3471.0,249.0,93.28571428571428,7,4087,3426.0,1514.0,583.8571428571429
103531.0,17,2,286,2,286,0.0,143.0,143.0,0,0,0.0,0.0,0.0
2094489.0,6,5,367,2,132,0.0,66.0,66.0,3,235,1047244.5,103.0,78.33333333333333
16316.0,6,10,2032,5,524,3855.75,252.0,104.8,5,1508,3797.25,1236.0,301.6
226245.0,6,10,1221,6,636,45249.0,298.0,106.0,4,585,71405.0,379.0,146.25
16459.0,17,2,180,1,90,0.0,90.0,90.0,1,90,0.0,90.0,90.0
108102755.0,17,5,1005,5,1005,27025688.75,201.0,201.0,0,0,0.0,0.0,0.0
90257027.0,6,16,2368,9,1204,11282128.375,188.0,133.77777777777777,7,1164,15015336.5,204.0,166.28571428571428
108317620.0,6,233,26446,116,7952,926713.3478260868,140.0,68.55172413793103,117,18494,933664.551724138,284.0,158.06837606837607
213063.0,6,3,426,2,280,0.0,214.0,140.0,1,146,0.0,146.0,146.0
52850.0,6,14,4740,7,653,8684.333333333334,249.0,93.28571428571428,7,4087,7817.333333333333,1514.0,583.8571428571429
121005402.0,17,15,907,8,475,17286486.0,174.0,59.375,7,432,16833495.0,174.0,61.71428571428572
271301.0,6,12,1373,7,714,45216.833333333336,298.0,102.0,5,659,63746.0,379.0,131.8
210912.0,6,10,1221,6,636,42182.4,298.0,106.0,4,585,69100.0,379.0,146.25
11278.0,17,4,571,2,148,0.0,74.0,74.0,2,423,0.0,280.0,211.5
10460175.0,6,7,478,4,272,3441023.6666666665,74.0,68.0,3,206,5161440.5,74.0,68.66666666666667
305969.0,6,6,412,4,272,101989.66666666669,74.0,68.0,2,140,0.0,74.0,70.0
2518823.0,6,3,1777,1,826,0.0,826.0,826.0,2,951,0.0,885.0,475.5
1759987.0,6,22,6443,11,1463,175998.7,357.0,133.0,11,4980,144597.1,1510.0,452.7272727272728
205539.0,17,2,762,2,762,0.0,381.0,381.0,0,0,0.0,0.0,0.0
161673.0,6,11,1132,6,556,32334.6,218.0,92.66666666666669,5,576,39894.5,304.0,115.2
135132021.0,17,6,1206,6,1206,27026404.2,201.0,201.0,0,0,0.0,0.0,0.0
90204087.0,6,20,1531,9,691,11246190.25,95.0,76.77777777777777,11,840,8999945.9,95.0,76.36363636363636
153430.0,17,2,180,1,90,0.0,90.0,90.0,1,90,0.0,90.0,90.0
322667.0,6,6,412,4,272,107555.66666666669,74.0,68.0,2,140,0.0,74.0,70.0
309295.0,17,4,704,2,148,0.0,74.0,74.0,2,556,0.0,280.0,278.0
23349.0,6,20,7606,11,978,2334.9,310.0,88.9090909090909,9,6628,2170.75,1514.0,736.4444444444445
119781201.0,6,19,1395,10,745,13280815.888888888,95.0,74.5,9,650,14941319.5,95.0,72.22222222222223
296938.0,6,6,412,4,272,98979.33333333331,74.0,68.0,2,140,0.0,74.0,70.0
143854.0,17,2,180,1,90,0.0,90.0,90.0,1,90,0.0,90.0,90.0
48007.0,6,14,4740,7,653,7880.0,249.0,93.28571428571428,7,4087,7352.333333333333,1514.0,583.8571428571429
109846905.0,17,14,864,7,432,18167933.0,174.0,61.71428571428572,7,432,18166824.666666668,174.0,61.71428571428572
116308250.0,6,48,3168,24,1584,5056880.434782608,66.0,66.0,24,1584,5043422.434782608,66.0,66.0
303873.0,6,6,412,4,272,101291.0,74.0,68.0,2,140,0.0,74.0,70.0
90029399.0,17,28,13364,28,13364,3334422.185185185,501.0,477.2857142857143,0,0,0.0,0.0,0.0
214739.0,17,2,906,2,906,0.0,453.0,453.0,0,0,0.0,0.0,0.0
304635.0,6,6,412,4,272,101545.0,74.0,68.0,2,140,0.0,74.0,70.0
208567.0,6,3,426,2,280,0.0,214.0,140.0,1,146,0.0,146.0,146.0
3612.0,17,4,344,2,150,0.0,75.0,75.0,2,194,0.0,103.0,97.0
22410.0,6,14,4740,7,653,3409.833333333333,249.0,93.28571428571428,7,4087,3444.0,1514.0,583.8571428571429
111464052.0,17,14,864,7,432,18500961.666666668,174.0,61.71428571428572,7,432,18500164.0,174.0,61.71428571428572
2327.0,17,4,344,2,150,0.0,75.0,75.0,2,194,0.0,103.0,97.0
408.0,17,2,410,1,78,0.0,78.0,78.0,1,332,0.0,332.0,332.0
2054.0,17,4,344,2,150,0.0,75.0,75.0,2,194,0.0,103.0,97.0
91394660.0,6,24,1829,13,989,7615737.166666667,95.0,76.07692307692308,11,840,9138167.5,95.0,76.36363636363636
40372.0,6,14,4740,7,653,6058.0,249.0,93.28571428571428,7,4087,5489.0,1514.0,583.8571428571429
6291.0,17,4,344,2,150,0.0,75.0,75.0,2,194,0.0,103.0,97.0
121021763.0,6,31,2097,16,1149,8068117.533333333,123.0,71.8125,15,948,8183514.357142857,123.0,63.2
118300739.0,6,47,3102,24,1584,5143499.478260869,66.0,66.0,23,1518,5143999.590909091,66.0,66.0
128024163.0,6,31,2034,16,1086,8534944.2,123.0,67.875,15,948,8415917.785714285,123.0,63.2
1172701.0,6,13,3010,8,2382,167528.7142857143,1514.0,297.75,5,628,224380.5,331.0,125.6
21852.0,17,2,180,1,90,0.0,90.0,90.0,1,90,0.0,90.0,90.0
165683.0,17,2,414,1,88,0.0,88.0,88.0,1,326,0.0,326.0,326.0
93072719.0,6,182,20538,91,14310,1031751.6777777778,284.0,157.25274725274724,91,6228,1031751.5222222222,140.0,68.43956043956044
90249804.0,6,13,2036,8,1016,12892829.142857144,188.0,127.0,5,1020,22521429.25,204.0,204.0
2626.0,17,4,344,2,150,0.0,75.0,75.0,2,194,0.0,103.0,97.0
26505.0,6,10,2032,5,524,6165.75,252.0,104.8,5,1508,6168.0,1236.0,301.6
157827.0,17,2,180,1,90,0.0,90.0,90.0,1,90,0.0,90.0,90.0
279831.0,17,2,180,1,90,0.0,90.0,90.0,1,90,0.0,90.0,90.0
524509.0,6,3,1604,1,753,0.0,753.0,753.0,2,851,0.0,785.0,425.5
103006954.0,17,13,821,7,432,17167825.666666668,174.0,61.71428571428572,6,389,19866822.0,174.0,64.83333333333333
7587.0,17,2,762,2,762,0.0,381.0,381.0,0,0,0.0,0.0,0.0
90525214.0,6,14,2240,8,1016,12932173.42857143,188.0,127.0,6,1224,18072170.0,204.0,204.0
108105495.0,17,5,1005,5,1005,27026373.75,201.0,201.0,0,0,0.0,0.0,0.0
2465.0,17,4,344,2,150,0.0,75.0,75.0,2,194,0.0,103.0,97.0
162345.0,17,2,180,1,90,0.0,90.0,90.0,1,90,0.0,90.0,90.0
520.0,17,2,508,2,508,0.0,257.0,254.0,0,0,0.0,0.0,0.0
216437.0,17,2,180,1,90,0.0,90.0,90.0,1,90,0.0,90.0,90.0
135131032.0,17,6,1206,6,1206,27026206.4,201.0,201.0,0,0,0.0,0.0,0.0
90256970.0,6,14,2240,8,1016,12893852.857142856,188.0,127.0,6,1224,18018683.0,204.0,204.0
118704771.0,6,48,3168,24,1584,5161077.0,66.0,66.0,24,1584,5149096.739130435,66.0,66.0
226475.0,6,10,1221,6,636,45295.0,298.0,106.0,4,585,74480.33333333333,379.0,146.25
146266.0,6,3,337,2,214,0.0,160.0,107.0,1,123,0.0,123.0,123.0
90903556.0,6,21,1585,11,840,9090063.9,95.0,76.36363636363636,10,745,10099749.888888888,95.0,74.5
43474.0,6,14,4740,7,653,6855.333333333333,249.0,93.28571428571428,7,4087,6619.666666666667,1514.0,583.8571428571429
204658.0,17,2,762,2,762,0.0,381.0,381.0,0,0,0.0,0.0,0.0
155172.0,6,3,337,2,214,0.0,160.0,107.0,1,123,0.0,123.0,123.0
3048986.0,6,4,270,3,202,1524493.0,70.0,67.33333333333333,1,68,0.0,68.0,68.0
310193.0,17,2,346,1,78,0.0,78.0,78.0,1,268,0.0,268.0,268.0
31837.0,6,14,4740,7,653,4518.833333333333,249.0,93.28571428571428,7,4087,4724.0,1514.0,583.8571428571429
314358.0,6,6,412,4,272,104786.0,74.0,68.0,2,140,0.0,74.0,70.0
120205007.0,6,18,1341,9,691,14999876.0,95.0,76.77777777777777,9,650,14999867.75,95.0,72.22222222222223
254065.0,17,4,6056,4,6056,84688.33333333333,1514.0,1514.0,0,0,0.0,0.0,0.0
135126699.0,17,6,1146,6,1146,27025339.8,191.0,191.0,0,0,0.0,0.0,0.0
305060.0,6,6,412,4,272,101686.66666666669,74.0,68.0,2,140,0.0,74.0,70.0
120025329.0,17,28,13364,28,13364,4445382.555555556,501.0,477.2857142857143,0,0,0.0,0.0,0.0
1040114.0,6,11,1134,6,558,208022.8,220.0,93.0,5,576,258959.25,304.0,115.2
90029098.0,17,28,13364,28,13364,3334411.037037037,501.0,477.2857142857143,0,0,0.0,0.0,0.0
841208.0,6,5,1742,3,921,420604.0,785.0,307.0,2,821,0.0,753.0,410.5
110942970.0,6,32,2220,16,1149,7381811.466666667,123.0,71.8125,16,1071,7381810.333333333,123.0,66.9375
313220.0,6,11,1287,6,636,62644.0,298.0,106.0,5,651,73225.75,379.0,130.2
120259329.0,6,254,29664,127,8604,945394.7857142856,140.0,67.74803149606299,127,21060,939772.0476190476,464.0,165.82677165354332
302387.0,6,6,412,4,272,100795.66666666669,74.0,68.0,2,140,0.0,74.0,70.0
90327903.0,6,16,1192,8,596,12898119.714285716,95.0,74.5,8,596,12902297.714285716,95.0,74.5
322.0,17,2,208,1,72,0.0,72.0,72.0,1,136,0.0,136.0,136.0
335.0,17,2,166,1,75,0.0,75.0,75.0,1,91,0.0,91.0,91.0
103729668.0,6,44,2904,22,1452,4939508.0,66.0,66.0,22,1452,4923916.952380952,66.0,66.0
0.0,17,1,55,1,55,0.0,55.0,55.0,0,0,0.0,0.0,0.0
119790565.0,6,26,1937,14,1043,9214658.846153846,95.0,74.5,12,894,10844881.090909092,95.0,74.5
329.0,17,2,166,1,75,0.0,75.0,75.0,1,91,0.0,91.0,91.0
303695.0,6,2,132,1,66,0.0,66.0,66.0,1,66,0.0,66.0,66.0
191094.0,17,2,180,1,90,0.0,90.0,90.0,1,90,0.0,90.0,90.0
107126782.0,17,14,864,7,432,17834305.333333332,174.0,61.71428571428572,7,432,17833548.333333332,174.0,61.71428571428572
24036591.0,17,3,1026,3,1026,12018295.5,342.0,342.0,0,0,0.0,0.0,0.0
33968.0,6,10,2032,5,524,7991.75,252.0,104.8,5,1508,7387.0,1236.0,301.6
1216350.0,6,14,3080,9,2452,152043.75,1514.0,272.44444444444446,5,628,235205.25,331.0,125.6
299403.0,6,6,412,4,272,99801.0,74.0,68.0,2,140,0.0,74.0,70.0
216847.0,6,3,426,2,280,0.0,214.0,140.0,1,146,0.0,146.0,146.0
106991997.0,6,223,25134,112,7614,963891.8648648649,140.0,67.98214285714286,111,17520,964344.8,284.0,157.83783783783784
126484543.0,6,31,2034,16,1086,8432302.866666667,123.0,67.875,15,948,8306020.357142857,123.0,63.2
229971.0,17,2,359,1,75,0.0,75.0,75.0,1,284,0.0,284.0,284.0
191125.0,17,2,180,1,90,0.0,90.0,90.0,1,90,0.0,90.0,90.0
91992475.0,17,16,5472,16,5472,6132831.666666667,342.0,342.0,0,0,0.0,0.0,0.0
99991395.0,6,31,2298,16,1212,6666093.0,123.0,75.75,15,1086,7126796.428571428,123.0,72.4
361140.0,6,5,367,3,235,180570.0,103.0,78.33333333333333,2,132,0.0,66.0,66.0
2346.0,17,4,344,2,150,0.0,75.0,75.0,2,194,0.0,103.0,97.0
299527.0,6,6,412,4,272,99842.33333333331,74.0,68.0,2,140,0.0,74.0,70.0
216761.0,17,2,180,1,90,0.0,90.0,90.0,1,90,0.0,90.0,90.0
123839967.0,6,49,3234,25,1650,5159998.625,66.0,66.0,24,1584,4983483.173913044,66.0,66.0
108101725.0,17,5,1005,5,1005,27025431.25,201.0,201.0,0,0,0.0,0.0,0.0
1997.0,17,4,344,2,150,0.0,75.0,75.0,2,194,0.0,103.0,97.0
256312.0,6,10,1221,6,636,51262.4,298.0,106.0,4,585,79923.0,379.0,146.25
143975.0,17,2,180,1,90,0.0,90.0,90.0,1,90,0.0,90.0,90.0
116001000.0,17,13,821,7,432,19333500.0,174.0,61.71428571428572,6,389,19979509.0,174.0,64.83333333333333
45447.0,6,14,4740,7,653,6390.333333333333,249.0,93.28571428571428,7,4087,6724.0,1514.0,583.8571428571429
153474.0,17,2,180,1,90,0.0,90.0,90.0,1,90,0.0,90.0,90.0
101613234.0,17,14,864,7,432,16935539.0,174.0,61.71428571428572,7,432,16854469.166666668,174.0,61.71428571428572
108106226.0,17,5,1005,5,1005,27026556.5,201.0,201.0,0,0,0.0,0.0,0.0
204448.0,17,2,762,2,762,0.0,381.0,381.0,0,0,0.0,0.0,0.0
116047858.0,6,47,3102,24,1584,5032147.565217392,66.0,66.0,23,1518,5150440.181818182,66.0,66.0
4599576.0,6,5,336,2,134,0.0,68.0,67.0,3,202,1419161.5,70.0,67.33333333333333
1302497.0,6,4,264,2,132,0.0,66.0,66.0,2,132,0.0,66.0,66.0
245715.0,6,3,426,2,280,0.0,214.0,140.0,1,146,0.0,146.0,146.0
93215056.0,6,30,3197,16,1652,6214337.066666666,426.0,103.25,14,1545,7133434.615384615,335.0,110.35714285714286
6188420.0,6,11,1167,6,881,1194372.8,571.0,146.83333333333334,5,286,1493136.75,62.0,57.2
108094073.0,17,5,1005,5,1005,27023518.25,201.0,201.0,0,0,0.0,0.0,0.0
309159.0,17,2,246,1,76,0.0,76.0,76.0,1,170,0.0,170.0,170.0
7173.0,17,2,582,1,83,0.0,83.0,83.0,1,499,0.0,499.0,499.0
120186207.0,6,356,44856,178,12044,674378.186440678,140.0,67.66292134831461,178,32812,674260.1412429379,464.0,184.3370786516854
122924.0,6,3,373,2,238,0.0,172.0,119.0,1,135,0.0,135.0,135.0
112319.0,17,4,1400,4,1400,37439.66666666666,350.0,350.0,0,0,0.0,0.0,0.0
36281.0,6,10,2032,5,524,7278.0,252.0,104.8,5,1508,8565.75,1236.0,301.6
90047619.0,17,28,13364,28,13364,3335097.0,501.0,477.2857142857143,0,0,0.0,0.0,0.0
880739.0,6,10,1162,6,625,176147.8,287.0,104.16666666666669,4,537,202672.3333333333,331.0,134.25
207952.0,6,3,426,2,280,0.0,214.0,140.0,1,146,0.0,146.0,146.0
135136737.0,17,6,1146,6,1146,27027347.4,191.0,191.0,0,0,0.0,0.0,0.0
123452940.0,6,49,3234,25,1650,5143872.5,66.0,66.0,24,1584,4982582.0,66.0,66.0
118246576.0,6,33,2434,18,1348,6955680.94117647,139.0,74.88888888888889,15,1086,7718345.571428572,123.0,72.4
14121113.0,6,18,1577,9,1003,1727406.0,315.0,111.44444444444444,9,574,1727378.875,78.0,63.77777777777778
315845.0,6,6,412,4,272,105281.66666666669,74.0,68.0,2,140,0.0,74.0,70.0
41618.0,6,14,4740,7,653,6755.166666666667,249.0,93.28571428571428,7,4087,6251.166666666667,1514.0,583.8571428571429
1066277.0,6,3,204,2,136,0.0,70.0,68.0,1,68,0.0,68.0,68.0
607323.0,6,4,508,2,238,0.0,172.0,119.0,2,270,0.0,135.0,135.0
125799086.0,6,57,11786,28,5953,3558705.5185185187,1514.0,212.6071428571429,29,5833,4485480.25,1514.0,201.1379310344828
0.0,17,1,55,1,55,0.0,55.0,55.0,0,0,0.0,0.0,0.0
123839633.0,6,48,3168,24,1584,4994689.304347826,66.0,66.0,24,1584,5302725.956521739,66.0,66.0
48922.0,6,12,1320,7,789,8153.666666666667,253.0,112.71428571428572,5,531,11498.75,259.0,106.2
220863.0,6,3,426,2,280,0.0,214.0,140.0,1,146,0.0,146.0,146.0
94833584.0,6,193,21714,97,6624,987849.8333333334,140.0,68.28865979381443,96,15090,987275.4105263158,284.0,157.1875
2404.0,17,4,344,2,150,0.0,75.0,75.0,2,194,0.0,103.0,97.0
113520159.0,6,46,3036,23,1518,5159995.954545454,66.0,66.0,23,1518,5159996.090909091,66.0,66.0
107196.0,17,2,286,2,286,0.0,143.0,143.0,0,0,0.0,0.0,0.0
321.0,17,2,174,1,79,0.0,79.0,79.0,1,95,0.0,95.0,95.0
5630078.0,6,5,336,2,134,0.0,68.0,67.0,3,202,1423009.0,70.0,67.33333333333333
120027504.0,17,29,13785,29,13785,4286696.571428572,501.0,475.3448275862069,0,0,0.0,0.0,0.0
228240.0,17,2,180,1,90,0.0,90.0,90.0,1,90,0.0,90.0,90.0
121300.0,6,4,439,2,238,0.0,172.0,119.0,2,201,0.0,135.0,100.5
305686.0,6,6,412,4,272,101895.33333333331,74.0,68.0,2,140,0.0,74.0,70.0
112964806.0,6,32,2236,16,1165,7517273.266666667,139.0,72.8125,16,1071,7517247.666666667,123.0,66.9375
10403.0,6,10,1067,5,536,2361.5,264.0,107.2,5,531,2326.0,259.0,106.2
26811219.0,17,5,1710,5,1710,6702804.75,342.0,342.0,0,0,0.0,0.0,0.0
90017654.0,17,27,12943,27,12943,3462217.461538461,501.0,479.3703703703704,0,0,0.0,0.0,0.0
245738.0,6,3,337,2,214,0.0,160.0,107.0,1,123,0.0,123.0,123.0
135136852.0,17,6,1146,6,1146,27027370.4,191.0,191.0,0,0,0.0,0.0,0.0
112094583.0,6,695,111324,350,88184,320567.70200573065,1514.0,251.9542857142857,345,23140,325230.988372093,214.0,67.07246376811594
8329971.0,17,3,1034,2,684,0.0,342.0,342.0,1,350,0.0,350.0,350.0
32349.000000000004,6,10,1065,5,534,7645.75,262.0,106.8,5,531,7825.75,259.0,106.2
125413.0,6,3,337,2,214,0.0,160.0,107.0,1,123,0.0,123.0,123.0
201504.0,17,4,6056,4,6056,67168.0,1514.0,1514.0,0,0,0.0,0.0,0.0
147227.0,6,3,373,2,238,0.0,172.0,119.0,1,135,0.0,135.0,135.0
10587729.0,6,7,478,4,272,3481979.6666666665,74.0,68.0,3,206,5222866.5,74.0,68.66666666666667
90288509.0,6,16,1192,8,596,12891645.57142857,95.0,74.5,8,596,12897007.57142857,95.0,74.5
99286.0,17,2,762,2,762,0.0,381.0,381.0,0,0,0.0,0.0,0.0
137503.0,6,2,132,1,66,0.0,66.0,66.0,1,66,0.0,66.0,66.0
218059.0,6,3,426,2,280,0.0,214.0,140.0,1,146,0.0,146.0,146.0
25947605.0,6,5,1736,2,819,0.0,753.0,409.5,3,917,12937561.5,785.0,305.6666666666667
1445194.0,6,8,602,3,198,204754.0,66.0,66.0,5,404,336749.0,103.0,80.8
90258446.0,6,12,1832,8,1016,12894063.714285716,188.0,127.0,4,816,30029644.666666668,204.0,204.0
120322944.0,6,221,25024,111,17468,1093844.9454545456,284.0,157.36936936936937,110,7556,1094358.0,140.0,68.69090909090909
97206268.0,6,30,2122,15,1105,6927876.142857143,139.0,73.66666666666667,15,1017,6927875.142857143,123.0,67.8
30128.0,6,10,2032,5,524,7304.25,252.0,104.8,5,1508,7245.0,1236.0,301.6
320934.0,17,4,1400,4,1400,106978.0,350.0,350.0,0,0,0.0,0.0,0.0
37599.0,6,14,4740,7,653,6135.166666666667,249.0,93.28571428571428,7,4087,6128.333333333333,1514.0,583.8571428571429
39249.0,6,13,1386,7,789,6070.166666666667,253.0,112.71428571428572,6,597,6768.8,259.0,99.5
102825.0,17,2,286,2,286,0.0,143.0,143.0,0,0,0.0,0.0,0.0
17265.0,6,2,145,2,145,0.0,91.0,72.5,0,0,0.0,0.0,0.0
2578444.0,6,3,204,1,68,0.0,68.0,68.0,2,136,0.0,70.0,68.0
100416401.0,6,29,2068,15,1105,7157183.714285715,139.0,73.66666666666667,14,963,7707600.461538462,123.0,68.78571428571429
120001254.0,6,20,1531,11,840,12000125.4,95.0,76.36363636363636,9,691,11284459.625,95.0,76.77777777777777
90258368.0,6,14,1964,8,1016,12894052.57142857,188.0,127.0,6,948,18011835.0,204.0,158.0
0.0,6,1,66,1,66,0.0,66.0,66.0,0,0,0.0,0.0,0.0
39355.0,6,14,4740,7,653,6432.666666666667,249.0,93.28571428571428,7,4087,5590.833333333333,1514.0,583.8571428571429
17865.0,17,3,1026,3,1026,8932.5,342.0,342.0,0,0,0.0,0.0,0.0
145649.0,6,3,373,2,238,0.0,172.0,119.0,1,135,0.0,135.0,135.0
1168672.0,6,13,3009,8,2381,166953.14285714287,1514.0,297.625,5,628,224012.5,331.0,125.6
123250425.0,6,49,3234,25,1650,5135434.375,66.0,66.0,24,1584,4979016.0869565215,66.0,66.0
121569604.0,17,14,864,7,432,17000175.333333332,174.0,61.71428571428572,7,432,16999779.333333332,174.0,61.71428571428572
2577015.0,6,2,132,1,66,0.0,66.0,66.0,1,66,0.0,66.0,66.0
90292580.0,6,19,1436,10,745,10027560.666666666,95.0,74.5,9,691,11285081.375,95.0,76.77777777777777
319295.0,6,6,412,4,272,106431.66666666669,74.0,68.0,2,140,0.0,74.0,70.0
105187.0,17,2,700,2,700,0.0,350.0,350.0,0,0,0.0,0.0,0.0
38132.0,6,14,4740,7,653,6190.0,249.0,93.28571428571428,7,4087,5953.166666666667,1514.0,583.8571428571429
343.0,17,2,160,1,80,0.0,80.0,80.0,1,80,0.0,80.0,80.0
205965.0,6,3,426,2,280,0.0,214.0,140.0,1,146,0.0,146.0,146.0
5246.0,17,4,344,2,150,0.0,75.0,75.0,2,194,0.0,103.0,97.0
1509.0,6,2,177,1,123,0.0,123.0,123.0,1,54,0.0,54.0,54.0
103316120.0,6,233,26154,117,18276,888790.7327586206,284.0,156.2051282051282,116,7878,895837.5130434782,140.0,67.91379310344827
209411.0,17,2,180,1,90,0.0,90.0,90.0,1,90,0.0,90.0,90.0
232625.0,6,3,337,2,214,0.0,160.0,107.0,1,123,0.0,123.0,123.0
112464280.0,6,46,3036,23,1518,5112001.227272728,66.0,66.0,23,1518,5112000.909090909,66.0,66.0
66744.0,6,14,4740,7,653,10298.5,249.0,93.28571428571428,7,4087,10968.0,1514.0,583.8571428571429
117254731.0,6,213,23950,107,7284,1106176.70754717,140.0,68.07476635514018,106,16666,1106875.2571428572,284.0,157.2264150943396
31066.0,6,14,4740,7,653,4941.5,249.0,93.28571428571428,7,4087,4571.333333333333,1514.0,583.8571428571429
102406.0,17,2,286,2,286,0.0,143.0,143.0,0,0,0.0,0.0,0.0
29493.0,6,12,1413,7,882,4915.5,291.0,126.0,5,531,6197.25,259.0,106.2
806.0,17,4,438,2,148,0.0,74.0,74.0,2,290,0.0,147.0,145.0
107407.0,17,2,286,2,286,0.0,143.0,143.0,0,0,0.0,0.0,0.0
44995.0,6,14,4740,7,653,7367.0,249.0,93.28571428571428,7,4087,7073.166666666667,1514.0,583.8571428571429
34095.0,6,14,4740,7,653,5254.0,249.0,93.28571428571428,7,4087,5545.833333333333,1514.0,583.8571428571429
83097.0,6,14,4740,7,653,12424.5,249.0,93.28571428571428,7,4087,11210.5,1514.0,583.8571428571429
107237.0,17,2,286,2,286,0.0,143.0,143.0,0,0,0.0,0.0,0.0
1339093.0,17,6,1230,3,234,669347.5,78.0,78.0,3,996,669342.5,332.0,332.0
90297176.0,6,16,1192,8,596,12893375.714285716,95.0,74.5,8,596,12897835.285714284,95.0,74.5
17595.0,6,10,2032,5,524,4115.5,252.0,104.8,5,1508,3836.25,1236.0,301.6
313440.0,17,4,1400,4,1400,104480.0,350.0,350.0,0,0,0.0,0.0,0.0
8445051.0,17,3,1034,2,684,0.0,342.0,342.0,1,350,0.0,350.0,350.0
502987.0,6,5,336,2,134,0.0,68.0,67.0,3,202,196102.0,70.0,67.33333333333333
232821.0,6,3,337,2,214,0.0,160.0,107.0,1,123,0.0,123.0,123.0
41382.0,6,14,4740,7,653,6786.666666666667,249.0,93.28571428571428,7,4087,6750.666666666667,1514.0,583.8571428571429
168134.0,17,2,414,1,88,0.0,88.0,88.0,1,326,0.0,326.0,326.0
44187.0,6,10,2032,5,524,10737.75,252.0,104.8,5,1508,10714.25,1236.0,301.6
10467306.0,6,7,478,4,272,3443675.6666666665,74.0,68.0,3,206,5165398.5,74.0,68.66666666666667
528424.0,17,4,601,2,146,0.0,73.0,73.0,2,455,0.0,301.0,227.5
117035459.0,6,48,3168,24,1584,5088498.217391305,66.0,66.0,24,1584,5075401.304347826,66.0,66.0
322.0,17,2,174,1,79,0.0,79.0,79.0,1,95,0.0,95.0,95.0
539.0,17,2,508,2,508,0.0,257.0,254.0,0,0,0.0,0.0,0.0
92016253.0,6,38,2508,19,1254,5111999.111111111,66.0,66.0,19,1254,5112000.333333333,66.0,66.0
50945.0,17,2,180,1,90,0.0,90.0,90.0,1,90,0.0,90.0,90.0
304009.0,6,6,412,4,272,101336.33333333331,74.0,68.0,2,140,0.0,74.0,70.0
19362.0,6,14,4740,7,653,3079.6666666666665,249.0,93.28571428571428,7,4087,3007.0,1514.0,583.8571428571429
121334246.0,17,14,864,7,432,17166899.0,174.0,61.71428571428572,7,432,17001549.333333332,174.0,61.71428571428572
166868.0,17,2,239,1,82,0.0,82.0,82.0,1,157,0.0,157.0,157.0
2799351.0,6,2,132,1,66,0.0,66.0,66.0,1,66,0.0,66.0,66.0
312.0,17,2,164,1,82,0.0,82.0,82.0,1,82,0.0,82.0,82.0
108105429.0,17,5,955,5,955,27026357.25,191.0,191.0,0,0,0.0,0.0,0.0
103428.0,17,2,286,2,286,0.0,143.0,143.0,0,0,0.0,0.0,0.0
90258458.0,6,12,1832,8,1016,12894065.42857143,188.0,127.0,4,816,30030849.0,204.0,204.0
23933.0,6,10,2032,5,524,4551.25,252.0,104.8,5,1508,5417.0,1236.0,301.6
2999206.0,6,11,2106,6,598,599521.0,252.0,99.66666666666669,5,1508,1999.25,1236.0,301.6
135126832.0,17,6,1146,6,1146,27025366.4,191.0,191.0,0,0,0.0,0.0,0.0
135126345.0,17,6,1206,6,1206,27025269.0,201.0,201.0,0,0,0.0,0.0,0.0
41532.0,6,14,4740,7,653,5552.5,249.0,93.28571428571428,7,4087,6750.5,1514.0,583.8571428571429
118596297.0,6,230,26010,115,18198,1038523.6403508772,284.0,158.24347826086955,115,7812,1038523.9824561405,140.0,67.9304347826087
228869.0,6,10,1221,6,636,45773.8,298.0,106.0,4,585,74665.33333333333,379.0,146.25
5205.0,17,2,762,2,762,0.0,381.0,381.0,0,0,0.0,0.0,0.0
5617860.0,6,5,336,2,134,0.0,68.0,67.0,3,202,1421413.0,70.0,67.33333333333333
873742.0,6,10,1336,6,799,174748.4,461.0,133.16666666666666,4,537,199359.66666666663,331.0,134.25
43227.0,6,14,4740,7,653,7010.333333333333,249.0,93.28571428571428,7,4087,7062.666666666667,1514.0,583.8571428571429
135943.0,17,4,1524,4,1524,45314.333333333336,381.0,381.0,0,0,0.0,0.0,0.0
306589.0,6,6,412,4,272,102196.33333333331,74.0,68.0,2,140,0.0,74.0,70.0
3749.0,17,2,762,2,762,0.0,381.0,381.0,0,0,0.0,0.0,0.0
204657.0,17,2,762,2,762,0.0,381.0,381.0,0,0,0.0,0.0,0.0
90303855.0,6,16,1192,8,596,12893861.857142856,95.0,74.5,8,596,12899905.285714284,95.0,74.5
101478544.0,17,14,864,7,432,16834830.666666668,174.0,61.71428571428572,7,432,16833487.333333332,174.0,61.71428571428572
44706.0,6,12,1320,7,789,7451.0,253.0,112.71428571428572,5,531,8116.5,259.0,106.2
19606.0,6,14,4740,7,653,3066.6666666666665,249.0,93.28571428571428,7,4087,2595.833333333333,1514.0,583.8571428571429
120038264.0,17,28,13364,28,13364,4445861.62962963,501.0,477.2857142857143,0,0,0.0,0.0,0.0
303600.0,6,2,132,1,66,0.0,66.0,66.0,1,66,0.0,66.0,66.0
206402.0,6,3,426,2,280,0.0,214.0,140.0,1,146,0.0,146.0,146.0
34316.0,6,14,4740,7,653,5590.666666666667,249.0,93.28571428571428,7,4087,5578.333333333333,1514.0,583.8571428571429
12052069.0,17,5,2265,5,2265,3013017.25,453.0,453.0,0,0,0.0,0.0,0.0
121370.0,6,3,337,2,214,0.0,160.0,107.0,1,123,0.0,123.0,123.0
234699.0,6,3,337,2,214,0.0,160.0,107.0,1,123,0.0,123.0,123.0
2593694.0,6,2,132,1,66,0.0,66.0,66.0,1,66,0.0,66.0,66.0
90256141.0,6,12,1832,8,1016,12893734.42857143,188.0,127.0,4,816,30025506.666666668,204.0,204.0
35406.0,6,10,2032,5,524,7550.5,252.0,104.8,5,1508,8527.0,1236.0,301.6
2394.0,17,4,344,2,150,0.0,75.0,75.0,2,194,0.0,103.0,97.0
196797.0,17,2,180,1,90,0.0,90.0,90.0,1,90,0.0,90.0,90.0
106001054.0,17,12,1040,8,606,15143007.714285716,174.0,75.75,4,434,15131268.0,174.0,108.5
1306993.0,6,4,264,2,132,0.0,66.0,66.0,2,132,0.0,66.0,66.0
9421.0,17,2,582,1,83,0.0,83.0,83.0,1,499,0.0,499.0,499.0
2553165.0,6,25,7573,14,3735,196397.3076923077,1514.0,266.7857142857143,11,3838,229512.3,1514.0,348.90909090909093
55207.0,6,14,4740,7,653,9055.166666666666,249.0,93.28571428571428,7,4087,8541.666666666666,1514.0,583.8571428571429
121391093.0,6,247,29070,123,20590,978205.106557377,300.0,167.39837398373984,124,8480,985159.9674796748,140.0,68.38709677419355
124939627.0,6,33,2359,16,1071,7816541.333333333,123.0,66.9375,17,1288,7184543.1875,139.0,75.76470588235294
107087102.0,6,30,2106,15,1089,7649078.714285715,123.0,72.6,15,1017,7633612.5,123.0,67.8
116393327.0,17,15,1169,8,606,16627618.142857144,174.0,75.75,7,563,16272054.0,174.0,80.42857142857143
29001.0,6,14,4740,7,653,4719.833333333333,249.0,93.28571428571428,7,4087,3655.1666666666665,1514.0,583.8571428571429
123306939.0,6,48,3168,24,1584,5100987.956521739,66.0,66.0,24,1584,5193042.304347826,66.0,66.0
307133.0,6,6,412,4,272,102377.66666666669,74.0,68.0,2,140,0.0,74.0,70.0
107578.0,17,2,286,2,286,0.0,143.0,143.0,0,0,0.0,0.0,0.0
5000229.0,17,4,849,2,166,0.0,83.0,83.0,2,683,0.0,499.0,341.5
373.0,17,2,300,1,80,0.0,80.0,80.0,1,220,0.0,220.0,220.0
100434904.0,17,12,516,6,258,20002666.8,43.0,43.0,6,258,20000164.6,43.0,43.0
59426.0,6,10,2032,5,524,14359.25,252.0,104.8,5,1508,14537.25,1236.0,301.6
99453000.0,17,12,778,6,389,19800986.6,174.0,64.83333333333333,6,389,19800160.2,174.0,64.83333333333333
1429022.0,17,16,1120,16,1120,95268.13333333332,70.0,70.0,0,0,0.0,0.0,0.0
108098626.0,17,5,955,5,955,27024656.5,191.0,191.0,0,0,0.0,0.0,0.0
197196.0,17,2,180,1,90,0.0,90.0,90.0,1,90,0.0,90.0,90.0
106534.0,17,2,700,2,700,0.0,350.0,350.0,0,0,0.0,0.0,0.0
1028944.0,6,11,1134,6,558,205788.8,220.0,93.0,5,576,255626.25,304.0,115.2
120143741.0,6,226,25534,113,7754,1057169.8482142857,140.0,68.61946902654867,113,17780,1056048.3392857143,284.0,157.34513274336285
5624617.0,6,5,336,2,134,0.0,68.0,67.0,3,202,1423144.0,70.0,67.33333333333333
5633586.0,6,21,1663,11,1027,532309.5,315.0,93.36363636363636,10,636,591463.1111111111,78.0,63.6
2806078.0,6,2,132,1,66,0.0,66.0,66.0,1,66,0.0,66.0,66.0
18314941.0,6,23,8609,13,1719,1526245.0833333333,408.0,132.23076923076923,10,6890,1576774.6666666667,1514.0,689.0
26120294.0,17,5,1718,4,1368,1685944.6666666667,342.0,342.0,1,350,0.0,350.0,350.0
246288.0,6,3,337,2,214,0.0,160.0,107.0,1,123,0.0,123.0,123.0
3050417.0,6,3,204,1,68,0.0,68.0,68.0,2,136,0.0,70.0,68.0
18650.0,6,10,2032,5,524,4380.5,252.0,104.8,5,1508,4220.0,1236.0,301.6
42986.0,6,14,4740,7,653,7043.5,249.0,93.28571428571428,7,4087,6831.666666666667,1514.0,583.8571428571429
42260.0,6,2,132,1,66,0.0,66.0,66.0,1,66,0.0,66.0,66.0
5823426.0,6,5,336,2,134,0.0,68.0,67.0,3,202,1525582.0,70.0,67.33333333333333
234086.0,6,3,337,2,214,0.0,160.0,107.0,1,123,0.0,123.0,123.0
103373.0,17,2,286,2,286,0.0,143.0,143.0,0,0,0.0,0.0,0.0
60699.0,6,10,2032,5,524,14940.0,252.0,104.8,5,1508,14433.5,1236.0,301.6
204114.0,17,2,180,1,90,0.0,90.0,90.0,1,90,0.0,90.0,90.0
90289488.0,6,16,1192,8,596,12892653.857142856,95.0,74.5,8,596,12897918.857142856,95.0,74.5
32410.0,6,10,2032,5,524,5768.0,252.0,104.8,5,1508,7179.5,1236.0,301.6
2741099.0,6,2,132,1,66,0.0,66.0,66.0,1,66,0.0,66.0,66.0
90043984.0,17,27,12943,27,12943,3463230.153846154,501.0,479.3703703703704,0,0,0.0,0.0,0.0
317296.0,6,10,1221,6,636,63459.2,298.0,106.0,4,585,100192.66666666669,379.0,146.25
326015.0,6,3,1604,2,851,0.0,785.0,425.5,1,753,0.0,753.0,753.0
9249.0,17,2,582,1,83,0.0,83.0,83.0,1,499,0.0,499.0,499.0
310308.0,6,3,202,2,128,0.0,74.0,64.0,1,74,0.0,74.0,74.0
197063.0,17,2,180,1,90,0.0,90.0,90.0,1,90,0.0,90.0,90.0
10463082.0,6,6,412,3,206,5163162.0,74.0,68.66666666666667,3,206,5163120.5,74.0,68.66666666666667
201273.0,17,2,762,2,762,0.0,381.0,381.0,0,0,0.0,0.0,0.0
2233.0,17,2,932,1,590,0.0,590.0,590.0,1,342,0.0,342.0,342.0
416.0,17,2,166,1,75,0.0,75.0,75.0,1,91,0.0,91.0,91.0
96373.0,17,2,762,2,762,0.0,381.0,381.0,0,0,0.0,0.0,0.0
719.0,17,2,762,2,762,0.0,381.0,381.0,0,0,0.0,0.0,0.0
875570.0,6,12,1354,6,723,174333.0,253.0,120.5,6,631,174116.0,293.0,105.16666666666669
90260634.0,6,16,2368,9,1204,11282579.25,188.0,133.77777777777777,7,1164,15015928.5,204.0,166.28571428571428
316899.0,17,4,1400,4,1400,105633.0,350.0,350.0,0,0,0.0,0.0,0.0
120530.0,6,11,2098,6,590,22161.2,252.0,98.33333333333331,5,1508,29067.0,1236.0,301.6
30751.0,6,10,2032,5,524,5946.75,252.0,104.8,5,1508,6665.5,1236.0,301.6
70194.0,6,10,1066,5,490,17140.0,218.0,98.0,5,576,17180.5,304.0,115.2
134465.0,6,3,337,2,214,0.0,160.0,107.0,1,123,0.0,123.0,123.0
120306604.0,6,287,32974,144,23314,841304.9230769231,284.0,161.90277777777777,143,9660,839995.1267605633,140.0,67.55244755244755
37091.0,6,10,2032,5,524,8854.5,252.0,104.8,5,1508,8745.25,1236.0,301.6
58114.0,6,14,4740,7,653,8253.5,249.0,93.28571428571428,7,4087,9485.666666666666,1514.0,583.8571428571429
120007166.0,6,24,1829,13,1030,9999996.083333334,95.0,79.23076923076923,11,799,11972579.4,95.0,72.63636363636364
23017626.0,17,3,1034,2,684,0.0,342.0,342.0,1,350,0.0,350.0,350.0
15478.0,6,12,1393,6,796,2829.2,271.0,132.66666666666666,6,597,2865.2,259.0,99.5
1315522.0,6,4,264,2,132,0.0,66.0,66.0,2,132,0.0,66.0,66.0
522509.0,17,6,2100,6,2100,104501.8,350.0,350.0,0,0,0.0,0.0,0.0
119962836.0,6,13,2036,5,1020,22523294.0,204.0,204.0,8,1016,17137381.714285713,188.0,127.0
44379.0,6,14,4740,7,653,7275.5,249.0,93.28571428571428,7,4087,5630.833333333333,1514.0,583.8571428571429
752552.0,6,2,132,1,66,0.0,66.0,66.0,1,66,0.0,66.0,66.0
308379.0,6,6,412,4,272,102793.0,74.0,68.0,2,140,0.0,74.0,70.0
90680582.0,6,21,1585,10,745,10075620.222222222,95.0,74.5,11,840,9043127.9,95.0,76.36363636363636
13805839.0,17,6,2052,6,2052,2761167.8,342.0,342.0,0,0,0.0,0.0,0.0
315.0,17,2,174,1,79,0.0,79.0,79.0,1,95,0.0,95.0,95.0
102478.0,17,2,286,2,286,0.0,143.0,143.0,0,0,0.0,0.0,0.0
0.0,6,1,66,1,66,0.0,66.0,66.0,0,0,0.0,0.0,0.0
147928.0,17,2,180,1,90,0.0,90.0,90.0,1,90,0.0,90.0,90.0
156228.0,6,3,337,2,214,0.0,160.0,107.0,1,123,0.0,123.0,123.0
1308082.0,17,7,490,7,490,218013.66666666663,70.0,70.0,0,0,0.0,0.0,0.0
139715.0,6,2,132,1,66,0.0,66.0,66.0,1,66,0.0,66.0,66.0
120071864.0,17,29,13785,29,13785,4288280.857142857,501.0,475.3448275862069,0,0,0.0,0.0,0.0
307757.0,6,6,412,4,272,102585.66666666669,74.0,68.0,2,140,0.0,74.0,70.0
104468882.0,6,44,2904,22,1452,4974708.666666667,66.0,66.0,22,1452,4961724.333333333,66.0,66.0
146309.0,6,3,337,2,214,0.0,160.0,107.0,1,123,0.0,123.0,123.0
90040423.0,17,28,13364,28,13364,3334830.4814814813,501.0,477.2857142857143,0,0,0.0,0.0,0.0
27888.0,6,2,132,1,66,0.0,66.0,66.0,1,66,0.0,66.0,66.0
108113210.0,17,5,1005,5,1005,27028302.5,201.0,201.0,0,0,0.0,0.0,0.0
65853.0,6,14,4740,7,653,10751.833333333334,249.0,93.28571428571428,7,4087,5513.333333333333,1514.0,583.8571428571429
2122342.0,6,24,7544,13,2516,176861.83333333334,1034.0,193.53846153846155,11,5028,181671.3,1510.0,457.09090909090907
64168.0,6,10,2032,5,524,15718.5,252.0,104.8,5,1508,11477.75,1236.0,301.6
32283.0,6,14,4740,7,653,5160.666666666667,249.0,93.28571428571428,7,4087,4476.0,1514.0,583.8571428571429
90040927.0,17,28,13364,28,13364,3334849.1481481483,501.0,477.2857142857143,0,0,0.0,0.0,0.0
245263.0,6,3,337,2,214,0.0,160.0,107.0,1,123,0.0,123.0,123.0
90213442.0,6,16,1192,8,596,12853526.285714284,95.0,74.5,8,596,12858385.42857143,95.0,74.5
2631.0,17,4,344,2,150,0.0,75.0,75.0,2,194,0.0,103.0,97.0
607693.0,6,4,508,2,238,0.0,172.0,119.0,2,270,0.0,135.0,135.0
143934.0,17,2,180,1,90,0.0,90.0,90.0,1,90,0.0,90.0,90.0
271264.0,17,2,180,1,90,0.0,90.0,90.0,1,90,0.0,90.0,90.0
35134.0,6,14,4740,7,653,4975.0,249.0,93.28571428571428,7,4087,5672.166666666667,1514.0,583.8571428571429
234944.0,6,3,337,2,214,0.0,160.0,107.0,1,123,0.0,123.0,123.0
231331.0,6,3,426,2,280,0.0,214.0,140.0,1,146,0.0,146.0,146.0
80504.0,6,14,4740,7,653,12940.0,249.0,93.28571428571428,7,4087,13208.333333333334,1514.0,583.8571428571429
338769.0,6,10,1221,6,636,67753.8,298.0,106.0,4,585,107190.66666666669,379.0,146.25
103716.0,17,2,286,2,286,0.0,143.0,143.0,0,0,0.0,0.0,0.0
8105713.0,17,5,1710,5,1710,2026428.25,342.0,342.0,0,0,0.0,0.0,0.0
39092.0,6,14,4740,7,653,6207.333333333333,249.0,93.28571428571428,7,4087,6086.0,1514.0,583.8571428571429
5811249.0,6,5,336,2,134,0.0,68.0,67.0,3,202,1532881.5,70.0,67.33333333333333
149571.0,17,2,180,1,90,0.0,90.0,90.0,1,90,0.0,90.0,90.0
318381.0,17,4,1400,4,1400,106127.0,350.0,350.0,0,0,0.0,0.0,0.0
302168.0,6,6,412,4,272,100722.66666666669,74.0,68.0,2,140,0.0,74.0,70.0
216487.0,17,2,180,1,90,0.0,90.0,90.0,1,90,0.0,90.0,90.0
108099683.0,17,5,955,5,955,27024920.75,191.0,191.0,0,0,0.0,0.0,0.0
1779119.0,6,2,132,1,66,0.0,66.0,66.0,1,66,0.0,66.0,66.0
1801.0,17,2,176,1,80,0.0,80.0,80.0,1,96,0.0,96.0,96.0
143575.0,6,2,132,1,66,0.0,66.0,66.0,1,66,0.0,66.0,66.0
108106509.0,17,5,955,5,955,27026627.25,191.0,191.0,0,0,0.0,0.0,0.0
28490.0,6,14,4740,7,653,4627.166666666667,249.0,93.28571428571428,7,4087,4559.166666666667,1514.0,583.8571428571429
114449192.0,17,14,1126,7,563,19074865.33333333,174.0,80.42857142857143,7,563,19044060.0,174.0,80.42857142857143
242343.0,6,3,337,2,214,0.0,160.0,107.0,1,123,0.0,123.0,123.0
146162.0,6,3,337,2,214,0.0,160.0,107.0,1,123,0.0,123.0,123.0
120626359.0,6,263,30252,132,21384,920811.9007633588,300.0,162.0,131,8868,919968.676923077,140.0,67.69465648854961
108105525.0,17,5,1005,5,1005,27026381.25,201.0,201.0,0,0,0.0,0.0,0.0
90526693.0,6,13,2036,8,1016,12932384.714285716,188.0,127.0,5,1020,22591068.5,204.0,204.0
2049537.0,17,8,1640,4,312,683051.0,78.0,78.0,4,1328,683039.6666666666,332.0,332.0
121413.0,6,3,337,2,214,0.0,160.0,107.0,1,123,0.0,123.0,123.0
153425.0,17,2,180,1,90,0.0,90.0,90.0,1,90,0.0,90.0,90.0
138695.0,6,2,132,1,66,0.0,66.0,66.0,1,66,0.0,66.0,66.0
209603.0,17,2,180,1,90,0.0,90.0,90.0,1,90,0.0,90.0,90.0
205799.0,17,2,180,1,90,0.0,90.0,90.0,1,90,0.0,90.0,90.0
39592439.0,6,4,270,2,134,0.0,68.0,67.0,2,136,0.0,70.0,68.0
529574.0,17,6,2100,6,2100,105914.8,350.0,350.0,0,0,0.0,0.0,0.0
308718.0,6,6,412,4,272,102906.0,74.0,68.0,2,140,0.0,74.0,70.0
771681.0,6,19,5075,10,1098,85742.33333333333,288.0,109.8,9,3977,74769.875,1514.0,441.8888888888889
90021373.0,17,28,13364,28,13364,3334124.925925926,501.0,477.2857142857143,0,0,0.0,0.0,0.0
101411.0,17,2,762,2,762,0.0,381.0,381.0,0,0,0.0,0.0,0.0
9108.0,17,2,582,1,83,0.0,83.0,83.0,1,499,0.0,499.0,499.0
24923.0,6,14,4740,7,653,4045.1666666666665,249.0,93.28571428571428,7,4087,3470.833333333333,1514.0,583.8571428571429
162435.0,17,2,180,1,90,0.0,90.0,90.0,1,90,0.0,90.0,90.0
3263.0,17,2,224,1,76,0.0,76.0,76.0,1,148,0.0,148.0,148.0
15847.0,17,2,180,1,90,0.0,90.0,90.0,1,90,0.0,90.0,90.0
879473.0,6,10,1336,6,799,175894.6,461.0,133.16666666666666,4,537,201261.0,331.0,134.25
2038.0,17,4,344,2,150,0.0,75.0,75.0,2,194,0.0,103.0,97.0
6724.0,17,2,582,1,83,0.0,83.0,83.0,1,499,0.0,499.0,499.0
2032.0,17,4,344,2,150,0.0,75.0,75.0,2,194,0.0,103.0,97.0
207180.0,6,3,426,2,280,0.0,214.0,140.0,1,146,0.0,146.0,146.0
16219.0,6,11,2098,6,590,2636.2,252.0,98.33333333333331,5,1508,3642.25,1236.0,301.6
74641594.0,6,9,842,9,842,9330199.25,97.0,93.55555555555556,0,0,0.0,0.0,0.0
104390207.0,6,43,2838,22,1452,4970949.904761905,66.0,66.0,21,1386,5151994.2,66.0,66.0
11535.0,17,4,823,2,163,0.0,89.0,81.5,2,660,0.0,443.0,330.0
107719.0,17,2,286,2,286,0.0,143.0,143.0,0,0,0.0,0.0,0.0
53060.0,6,13,1386,7,789,8843.333333333334,253.0,112.71428571428572,6,597,9697.0,259.0,99.5
153483.0,17,2,180,1,90,0.0,90.0,90.0,1,90,0.0,90.0,90.0
120000062.0,6,17,1287,9,691,15000007.75,95.0,76.77777777777777,8,596,12896552.42857143,95.0,74.5
506902.0,6,5,336,2,134,0.0,68.0,67.0,3,202,193607.5,70.0,67.33333333333333
33762.0,6,14,4740,7,653,5500.0,249.0,93.28571428571428,7,4087,5488.333333333333,1514.0,583.8571428571429
2101.0,17,4,344,2,150,0.0,75.0,75.0,2,194,0.0,103.0,97.0
10449622.0,6,7,478,4,272,3437730.0,74.0,68.0,3,206,5156485.0,74.0,68.66666666666667
120125695.0,6,12,1832,8,1016,17137540.0,188.0,127.0,4,816,30031117.0,204.0,204.0
283804.0,17,2,363,1,79,0.0,79.0,79.0,1,284,0.0,284.0,284.0
135130922.0,17,6,1206,6,1206,27026184.4,201.0,201.0,0,0,0.0,0.0,0.0
10496361.0,6,7,478,4,272,3453583.6666666665,74.0,68.0,3,206,5180277.5,74.0,68.66666666666667
2402.0,17,4,344,2,150,0.0,75.0,75.0,2,194,0.0,103.0,97.0
135138639.0,17,6,1206,6,1206,27027727.8,201.0,201.0,0,0,0.0,0.0,0.0
1062052.0,6,3,1604,1,753,0.0,753.0,753.0,2,851,0.0,785.0,425.5
1996.0,17,4,344,2,150,0.0,75.0,75.0,2,194,0.0,103.0,97.0
33260.0,6,13,1386,7,789,5063.666666666667,253.0,112.71428571428572,6,597,4822.6,259.0,99.5
135114668.0,17,6,1146,6,1146,27022933.6,191.0,191.0,0,0,0.0,0.0,0.0
3962.000000000001,17,2,582,1,83,0.0,83.0,83.0,1,499,0.0,499.0,499.0
111878.0,17,2,286,2,286,0.0,143.0,143.0,0,0,0.0,0.0,0.0
10768410.0,6,5,1736,2,819,0.0,753.0,409.5,3,917,5311070.5,785.0,305.6666666666667
226252.0,17,2,180,1,90,0.0,90.0,90.0,1,90,0.0,90.0,90.0
78825.0,6,10,2032,5,524,19469.5,252.0,104.8,5,1508,19351.25,1236.0,301.6
120339478.0,6,231,26224,116,18338,1046430.2434782608,284.0,158.08620689655172,115,7886,1046547.5087719298,140.0,68.57391304347826
360052.0,6,3,1777,1,826,0.0,826.0,826.0,2,951,0.0,885.0,475.5
108106157.0,17,5,955,5,955,27026539.25,191.0,191.0,0,0,0.0,0.0,0.0
40751.0,6,14,4740,7,653,5993.5,249.0,93.28571428571428,7,4087,6645.0,1514.0,583.8571428571429
2399.0,17,4,344,2,150,0.0,75.0,75.0,2,194,0.0,103.0,97.0
108105209.0,17,5,1005,5,1005,27026302.25,201.0,201.0,0,0,0.0,0.0,0.0
33591599.0,6,5,336,2,134,0.0,68.0,67.0,3,202,16679061.0,70.0,67.33333333333333
15774.0,6,14,4740,7,653,2008.5,249.0,93.28571428571428,7,4087,2486.833333333333,1514.0,583.8571428571429
322342.0,17,2,180,1,90,0.0,90.0,90.0,1,90,0.0,90.0,90.0
48907.0,6,14,4740,7,653,7559.166666666667,249.0,93.28571428571428,7,4087,8011.833333333333,1514.0,583.8571428571429
20291.0,17,2,582,1,83,0.0,83.0,83.0,1,499,0.0,499.0,499.0
135132333.0,17,6,1146,6,1146,27026466.6,191.0,191.0,0,0,0.0,0.0,0.0
41086.0,6,13,1479,7,882,6541.666666666667,291.0,126.0,6,597,7531.6,259.0,99.5
1774.0,17,4,344,2,150,0.0,75.0,75.0,2,194,0.0,103.0,97.0
90092549.0,6,11,1644,4,816,30030008.0,204.0,204.0,7,828,15015034.833333334,188.0,118.28571428571428
1297702.0,17,7,490,7,490,216283.66666666663,70.0,70.0,0,0,0.0,0.0,0.0
108106495.0,17,5,955,5,955,27026623.75,191.0,191.0,0,0,0.0,0.0,0.0
319.0,17,2,166,1,75,0.0,75.0,75.0,1,91,0.0,91.0,91.0
208792.0,6,3,426,2,280,0.0,214.0,140.0,1,146,0.0,146.0,146.0
10422704.0,6,6,412,3,206,5143471.5,74.0,68.66666666666667,3,206,5143400.0,74.0,68.66666666666667
120123155.0,6,14,2224,9,1204,15015394.375,188.0,133.77777777777777,5,1020,22516164.0,204.0,204.0
119912672.0,17,35,16705,35,16705,3526843.294117647,501.0,477.2857142857143,0,0,0.0,0.0,0.0
542058.0,6,2,132,1,66,0.0,66.0,66.0,1,66,0.0,66.0,66.0
120358488.0,6,47,3102,23,1518,5135440.909090909,66.0,66.0,24,1584,5221142.913043479,66.0,66.0
39335.0,6,14,4740,7,653,6434.166666666667,249.0,93.28571428571428,7,4087,5896.833333333333,1514.0,583.8571428571429
61811.0,6,14,4740,7,653,9932.166666666666,249.0,93.28571428571428,7,4087,10072.166666666666,1514.0,583.8571428571429
17400.0,6,10,2032,5,524,4121.75,252.0,104.8,5,1508,3990.5,1236.0,301.6
308.0,17,2,174,1,79,0.0,79.0,79.0,1,95,0.0,95.0,95.0
118109083.0,6,220,24868,110,7556,1076096.0,140.0,68.69090909090909,110,17312,1076060.2201834864,284.0,157.38181818181818
90058729.0,17,28,13364,28,13364,3335508.4814814813,501.0,477.2857142857143,0,0,0.0,0.0,0.0
106402.0,17,2,286,2,286,0.0,143.0,143.0,0,0,0.0,0.0,0.0
521397.0,6,5,336,2,134,0.0,68.0,67.0,3,202,184056.5,70.0,67.33333333333333
90737129.0,6,17,1287,8,637,12962447.0,95.0,79.625,9,650,11306244.875,95.0,72.22222222222223
90049776.0,17,28,13364,28,13364,3335176.888888889,501.0,477.2857142857143,0,0,0.0,0.0,0.0
2533476.0,6,2,134,1,68,0.0,68.0,68.0,1,66,0.0,66.0,66.0
322624.0,17,4,1400,4,1400,107541.33333333331,350.0,350.0,0,0,0.0,0.0,0.0
66213.0,6,10,2032,5,524,15734.25,252.0,104.8,5,1508,15548.0,1236.0,301.6
526.0,17,2,508,2,508,0.0,257.0,254.0,0,0,0.0,0.0,0.0
1419191.0,17,16,1120,16,1120,94612.73333333334,70.0,70.0,0,0,0.0,0.0,0.0
110596.0,6,10,2032,5,524,26507.75,252.0,104.8,5,1508,26923.5,1236.0,301.6
217287.0,6,3,426,2,280,0.0,214.0,140.0,1,146,0.0,146.0,146.0
2600618.0,6,2,132,1,66,0.0,66.0,66.0,1,66,0.0,66.0,66.0
3162119.0,6,18,1495,9,921,358344.0,315.0,102.33333333333331,9,574,358313.0,78.0,63.77777777777778
20167.0,17,2,582,1,83,0.0,83.0,83.0,1,499,0.0,499.0,499.0
196683.0,17,4,6056,4,6056,65561.0,1514.0,1514.0,0,0,0.0,0.0,0.0
2429.0,17,4,344,2,150,0.0,75.0,75.0,2,194,0.0,103.0,97.0
15052.0,17,2,180,1,90,0.0,90.0,90.0,1,90,0.0,90.0,90.0
43465.0,6,2,132,1,66,0.0,66.0,66.0,1,66,0.0,66.0,66.0
408.0,17,2,410,1,78,0.0,78.0,78.0,1,332,0.0,332.0,332.0
0.0,17,1,72,1,72,0.0,72.0,72.0,0,0,0.0,0.0,0.0
90743291.0,6,20,1531,11,840,9070009.1,95.0,76.36363636363636,9,691,11342457.625,95.0,76.77777777777777
90264942.0,6,12,1832,8,1016,12894991.714285716,188.0,127.0,4,816,30034306.33333333,204.0,204.0
179126.0,6,3,337,2,214,0.0,160.0,107.0,1,123,0.0,123.0,123.0
120124109.0,6,16,2632,9,1204,15015513.625,188.0,133.77777777777777,7,1428,15012984.333333334,204.0,204.0
297770.0,6,6,412,4,272,99256.66666666669,74.0,68.0,2,140,0.0,74.0,70.0
2020.0,17,4,344,2,150,0.0,75.0,75.0,2,194,0.0,103.0,97.0
848970.0,6,9,1268,6,797,169794.0,459.0,132.83333333333334,3,471,286822.5,331.0,157.0
12512.0,6,10,2032,5,524,2735.5,252.0,104.8,5,1508,2339.25,1236.0,301.6
237445.0,17,2,180,1,90,0.0,90.0,90.0,1,90,0.0,90.0,90.0
217141.0,6,3,426,2,280,0.0,214.0,140.0,1,146,0.0,146.0,146.0
312661.0,17,4,1400,4,1400,104220.33333333331,350.0,350.0,0,0,0.0,0.0,0.0
242458.0,6,3,337,2,214,0.0,160.0,107.0,1,123,0.0,123.0,123.0
56330.0,6,14,4740,7,653,8354.166666666666,249.0,93.28571428571428,7,4087,7071.0,1514.0,583.8571428571429
4414204.0,6,5,367,2,132,0.0,66.0,66.0,3,235,2207102.0,103.0,78.33333333333333
4993060.0,17,4,849,2,166,0.0,83.0,83.0,2,683,0.0,499.0,341.5
228446.0,17,2,180,1,90,0.0,90.0,90.0,1,90,0.0,90.0,90.0
90297178.0,6,21,1585,11,840,9024749.6,95.0,76.36363636363636,10,745,10002103.444444444,95.0,74.5
3825.0,17,4,344,2,150,0.0,75.0,75.0,2,194,0.0,103.0,97.0
254757.0,6,3,337,2,214,0.0,160.0,107.0,1,123,0.0,123.0,123.0
228207.0,17,2,180,1,90,0.0,90.0,90.0,1,90,0.0,90.0,90.0
298428.0,6,6,412,4,272,99476.0,74.0,68.0,2,140,0.0,74.0,70.0
255206.0,17,4,6056,4,6056,85068.66666666666,1514.0,1514.0,0,0,0.0,0.0,0.0
106136.0,17,4,1400,4,1400,35378.666666666664,350.0,350.0,0,0,0.0,0.0,0.0
135145937.0,17,6,1206,6,1206,27029187.4,201.0,201.0,0,0,0.0,0.0,0.0
204714.0,6,10,1949,5,441,50954.25,169.0,88.2,5,1508,8223.5,1236.0,301.6
326008.0,6,6,412,4,272,108669.33333333331,74.0,68.0,2,140,0.0,74.0,70.0
120721641.0,6,17,1328,8,637,17245948.714285713,95.0,79.625,9,691,14969197.0,95.0,76.77777777777777
4050.0,17,2,582,1,83,0.0,83.0,83.0,1,499,0.0,499.0,499.0
733004.0,6,5,1736,2,819,0.0,753.0,409.5,3,917,295358.0,785.0,305.6666666666667
246138.0,6,3,373,2,238,0.0,172.0,119.0,1,135,0.0,135.0,135.0
4276.0,17,2,614,1,72,0.0,72.0,72.0,1,542,0.0,542.0,542.0
93877180.0,6,27,1954,14,1045,7221321.538461538,139.0,74.64285714285714,13,909,7805064.666666667,123.0,69.92307692307692
56052.0,6,14,4740,7,653,9188.0,249.0,93.28571428571428,7,4087,4579.833333333333,1514.0,583.8571428571429
113980487.0,6,48,3168,24,1584,4955673.347826087,66.0,66.0,24,1584,4942459.173913044,66.0,66.0
2332.0,17,4,344,2,150,0.0,75.0,75.0,2,194,0.0,103.0,97.0
214532.0,6,12,1373,7,714,35755.333333333336,298.0,102.0,5,659,52649.75,379.0,131.8
105434.0,17,2,762,2,762,0.0,381.0,381.0,0,0,0.0,0.0,0.0
319073.0,17,4,571,2,148,0.0,74.0,74.0,2,423,0.0,276.0,211.5
48815.0,6,2,132,1,66,0.0,66.0,66.0,1,66,0.0,66.0,66.0
108110350.0,17,5,1005,5,1005,27027587.5,201.0,201.0,0,0,0.0,0.0,0.0
18763.0,6,14,4740,7,653,2663.6666666666665,249.0,93.28571428571428,7,4087,2959.333333333333,1514.0,583.8571428571429
2774930.0,6,2,132,1,66,0.0,66.0,66.0,1,66,0.0,66.0,66.0
122530315.0,6,49,3234,25,1650,5105429.791666667,66.0,66.0,24,1584,5072235.565217392,66.0,66.0
2434.0,17,4,344,2,150,0.0,75.0,75.0,2,194,0.0,103.0,97.0
39686.0,6,14,4740,7,653,5878.5,249.0,93.28571428571428,7,4087,4165.5,1514.0,583.8571428571429
237669.0,17,2,180,1,90,0.0,90.0,90.0,1,90,0.0,90.0,90.0
218135.0,6,3,426,2,280,0.0,214.0,140.0,1,146,0.0,146.0,146.0
13543.0,6,13,1459,7,862,2103.833333333333,271.0,123.14285714285714,6,597,2504.6,259.0,99.5
147943.0,17,2,180,1,90,0.0,90.0,90.0,1,90,0.0,90.0,90.0
25665.0,6,10,2032,5,524,6173.75,252.0,104.8,5,1508,5551.5,1236.0,301.6
224393.0,6,3,426,2,280,0.0,214.0,140.0,1,146,0.0,146.0,146.0
120115728.0,6,338,39406,169,11450,710047.8035714285,140.0,67.75147928994083,169,27956,710710.4047619047,284.0,165.42011834319527
121511.0,6,3,337,2,214,0.0,160.0,107.0,1,123,0.0,123.0,123.0
36404.0,6,14,4740,7,653,5946.0,249.0,93.28571428571428,7,4087,5556.333333333333,1514.0,583.8571428571429
122007741.0,17,15,907,8,475,17429677.285714287,174.0,59.375,7,432,17000177.5,174.0,61.71428571428572
120041742.0,6,22,1639,12,894,10908727.363636363,95.0,74.5,10,745,13332864.333333334,95.0,74.5
147930.0,17,2,180,1,90,0.0,90.0,90.0,1,90,0.0,90.0,90.0
105826.0,17,2,286,2,286,0.0,143.0,143.0,0,0,0.0,0.0,0.0
251533.0,6,3,337,2,214,0.0,160.0,107.0,1,123,0.0,123.0,123.0
120122204.0,6,13,2020,9,1204,15015275.5,188.0,133.77777777777777,4,816,30030609.0,204.0,204.0
1111648.0,6,13,1386,7,789,185274.66666666663,253.0,112.71428571428572,6,597,221301.2,259.0,99.5
412.0,17,2,410,1,78,0.0,78.0,78.0,1,332,0.0,332.0,332.0
300073.0,6,6,412,4,272,100024.33333333331,74.0,68.0,2,140,0.0,74.0,70.0
206082.0,6,3,426,2,280,0.0,214.0,140.0,1,146,0.0,146.0,146.0
90532383.0,6,14,2240,8,1016,12933197.57142857,188.0,127.0,6,1224,18073231.2,204.0,204.0
16173.0,6,10,2032,5,524,3809.0,252.0,104.8,5,1508,3309.75,1236.0,301.6
108387.0,17,2,286,2,286,0.0,143.0,143.0,0,0,0.0,0.0,0.0
4385.0,17,2,598,1,72,0.0,72.0,72.0,1,526,0.0,526.0,526.0
90260176.0,6,12,1832,8,1016,12894310.857142856,188.0,127.0,4,816,30030935.666666668,204.0,204.0
228296.0,17,2,180,1,90,0.0,90.0,90.0,1,90,0.0,90.0,90.0
90286356.0,6,24,1829,13,989,7520179.583333333,95.0,76.07692307692308,11,840,9001048.6,95.0,76.36363636363636
91239201.0,6,18,1382,10,786,10132351.111111112,95.0,78.6,8,596,13032637.714285716,95.0,74.5
303340.0,6,6,412,4,272,101113.33333333331,74.0,68.0,2,140,0.0,74.0,70.0
220633.0,17,2,180,1,90,0.0,90.0,90.0,1,90,0.0,90.0,90.0
108104191.0,17,5,955,5,955,27026047.75,191.0,191.0,0,0,0.0,0.0,0.0
120379026.0,6,34,2673,19,1518,6687723.666666667,123.0,79.89473684210526,15,1155,8166335.0,123.0,77.0
147926.0,17,2,180,1,90,0.0,90.0,90.0,1,90,0.0,90.0,90.0
53769600.0,6,8,2113,3,960,25544066.5,826.0,320.0,5,1153,12749238.75,885.0,230.6
35352.0,6,10,2032,5,524,6623.75,252.0,104.8,5,1508,7901.25,1236.0,301.6
264065.0,6,10,1221,6,636,52813.0,298.0,106.0,4,585,82247.66666666667,379.0,146.25
11457.0,6,10,1067,5,536,2502.0,264.0,107.2,5,531,2502.5,259.0,106.2
213624.0,17,2,180,1,90,0.0,90.0,90.0,1,90,0.0,90.0,90.0
108107778.0,17,5,1005,5,1005,27026944.5,201.0,201.0,0,0,0.0,0.0,0.0
5823579.0,6,5,336,2,134,0.0,68.0,67.0,3,202,1526544.5,70.0,67.33333333333333
2399.0,17,4,344,2,150,0.0,75.0,75.0,2,194,0.0,103.0,97.0
2794087.0,6,2,132,1,66,0.0,66.0,66.0,1,66,0.0,66.0,66.0
359.0,17,2,267,1,83,0.0,83.0,83.0,1,184,0.0,184.0,184.0
40669.0,6,14,4740,7,653,5175.0,249.0,93.28571428571428,7,4087,6417.0,1514.0,583.8571428571429
43653.0,6,14,4740,7,653,7079.333333333333,249.0,93.28571428571428,7,4087,7043.5,1514.0,583.8571428571429
316695.0,17,4,1400,4,1400,105565.0,350.0,350.0,0,0,0.0,0.0,0.0
201542.0,17,2,180,1,90,0.0,90.0,90.0,1,90,0.0,90.0,90.0
48501.0,6,14,4740,7,653,7305.666666666667,249.0,93.28571428571428,7,4087,7938.166666666667,1514.0,583.8571428571429
108102505.0,17,5,1005,5,1005,27025626.25,201.0,201.0,0,0,0.0,0.0,0.0
305822.0,6,6,412,4,272,101940.66666666669,74.0,68.0,2,140,0.0,74.0,70.0
215541.0,17,2,762,2,762,0.0,381.0,381.0,0,0,0.0,0.0,0.0
5625009.0,6,5,336,2,134,0.0,68.0,67.0,3,202,1423711.5,70.0,67.33333333333333
218600.0,6,3,426,2,280,0.0,214.0,140.0,1,146,0.0,146.0,146.0
108105011.0,17,5,955,5,955,27026252.75,191.0,191.0,0,0,0.0,0.0,0.0
16837.0,17,2,180,1,90,0.0,90.0,90.0,1,90,0.0,90.0,90.0
31038.0,6,14,4740,7,653,5052.833333333333,249.0,93.28571428571428,7,4087,5040.666666666667,1514.0,583.8571428571429
216763.0,17,2,180,1,90,0.0,90.0,90.0,1,90,0.0,90.0,90.0
851238.0,6,9,1196,6,725,170247.6,387.0,120.83333333333331,3,471,287759.5,331.0,157.0
1168343.0,6,13,3000,8,2372,166906.14285714287,1514.0,296.5,5,628,223148.25,331.0,125.6
90681976.0,6,21,1585,10,745,10075775.111111112,95.0,74.5,11,840,9043454.3,95.0,76.36363636363636
33470.0,6,14,4740,7,653,5453.333333333333,249.0,93.28571428571428,7,4087,4766.833333333333,1514.0,583.8571428571429
102071731.0,17,14,864,7,432,17000890.333333332,174.0,61.71428571428572,7,432,17000166.5,174.0,61.71428571428572
90295642.0,6,20,2017,11,1367,9024891.6,257.0,124.27272727272728,9,650,11285459.125,95.0,72.22222222222223
107821423.0,6,28,1860,14,966,8277328.0,123.0,69.0,14,894,8277337.923076923,123.0,63.85714285714285
105009501.0,17,13,821,7,432,17501583.5,174.0,61.71428571428572,6,389,17000162.4,174.0,64.83333333333333
147941.0,17,2,180,1,90,0.0,90.0,90.0,1,90,0.0,90.0,90.0
108222.0,17,2,286,2,286,0.0,143.0,143.0,0,0,0.0,0.0,0.0
108109343.0,17,5,1005,5,1005,27027335.75,201.0,201.0,0,0,0.0,0.0,0.0
38519.0,6,14,4740,7,653,6253.833333333333,249.0,93.28571428571428,7,4087,5912.666666666667,1514.0,583.8571428571429
1057576.0,6,3,204,2,136,0.0,70.0,68.0,1,68,0.0,68.0,68.0
47822471.0,6,908,844607,251,16739,191289.884,207.0,66.68924302788845,657,827868,72894.9893292683,1514.0,1260.073059360731
206634.0,6,4,492,2,280,0.0,214.0,140.0,2,212,0.0,146.0,106.0
4324.0,17,2,614,1,72,0.0,72.0,72.0,1,542,0.0,542.0,542.0
49563.0,6,14,4740,7,653,7596.666666666667,249.0,93.28571428571428,7,4087,6374.5,1514.0,583.8571428571429
78197.0,6,10,2032,5,524,19212.75,252.0,104.8,5,1508,18496.5,1236.0,301.6
988888.0,17,8,1640,4,312,329502.3333333333,78.0,78.0,4,1328,329492.0,332.0,332.0
100008356.0,17,11,473,6,258,20001671.2,43.0,43.0,5,215,20000197.25,43.0,43.0
153673.0,17,2,180,1,90,0.0,90.0,90.0,1,90,0.0,90.0,90.0
90294807.0,6,14,2102,8,1016,12899258.142857144,188.0,127.0,6,1086,18021531.4,204.0,181.0
3123755.0,6,3,204,2,136,0.0,70.0,68.0,1,68,0.0,68.0,68.0
2574075.0,6,2,132,1,66,0.0,66.0,66.0,1,66,0.0,66.0,66.0
92238078.0,17,12,778,6,389,18400723.8,174.0,64.83333333333333,6,389,18400156.4,174.0,64.83333333333333
90258696.0,6,12,1832,8,1016,12894099.42857143,188.0,127.0,4,816,30031152.666666668,204.0,204.0
101392.0,17,2,762,2,762,0.0,381.0,381.0,0,0,0.0,0.0,0.0
182118.0,17,4,1524,4,1524,60706.0,381.0,381.0,0,0,0.0,0.0,0.0
63650.0,6,14,4740,7,653,9868.0,249.0,93.28571428571428,7,4087,10368.333333333334,1514.0,583.8571428571429
108105315.0,17,5,1005,5,1005,27026328.75,201.0,201.0,0,0,0.0,0.0,0.0
120018597.0,17,29,13785,29,13785,4286378.464285715,501.0,475.3448275862069,0,0,0.0,0.0,0.0
2394.0,17,4,344,2,150,0.0,75.0,75.0,2,194,0.0,103.0,97.0
298129.0,6,6,412,4,272,99376.33333333331,74.0,68.0,2,140,0.0,74.0,70.0
120062457.0,17,29,13785,29,13785,4287944.892857143,501.0,475.3448275862069,0,0,0.0,0.0,0.0
836.0,17,4,438,2,148,0.0,74.0,74.0,2,290,0.0,147.0,145.0
66948.0,6,14,4740,7,653,9514.0,249.0,93.28571428571428,7,4087,11002.0,1514.0,583.8571428571429
245096.0,6,3,337,2,214,0.0,160.0,107.0,1,123,0.0,123.0,123.0
44859.0,6,10,2032,5,524,10974.5,252.0,104.8,5,1508,10450.5,1236.0,301.6
176911.0,17,4,1524,4,1524,58970.333333333336,381.0,381.0,0,0,0.0,0.0,0.0
90056668.0,17,27,12943,27,12943,3463718.0,501.0,479.3703703703704,0,0,0.0,0.0,0.0
92275835.0,17,15,5130,15,5130,6591131.071428572,342.0,342.0,0,0,0.0,0.0,0.0
299856.0,6,6,412,4,272,99952.0,74.0,68.0,2,140,0.0,74.0,70.0
332.0,17,2,166,1,75,0.0,75.0,75.0,1,91,0.0,91.0,91.0
219110.0,6,3,426,2,280,0.0,214.0,140.0,1,146,0.0,146.0,146.0
38489.0,6,14,4740,7,653,5821.666666666667,249.0,93.28571428571428,7,4087,4146.0,1514.0,583.8571428571429
233014.0,6,3,337,2,214,0.0,160.0,107.0,1,123,0.0,123.0,123.0
214023.0,17,2,180,1,90,0.0,90.0,90.0,1,90,0.0,90.0,90.0
9034.0,17,2,507,1,86,0.0,86.0,86.0,1,421,0.0,421.0,421.0
237429.0,17,2,180,1,90,0.0,90.0,90.0,1,90,0.0,90.0,90.0
207153.0,6,3,426,2,280,0.0,214.0,140.0,1,146,0.0,146.0,146.0
3077.0,17,2,224,1,76,0.0,76.0,76.0,1,148,0.0,148.0,148.0
216338.0,17,2,180,1,90,0.0,90.0,90.0,1,90,0.0,90.0,90.0
10483408.0,6,7,478,4,272,3447582.0,74.0,68.0,3,206,5171256.0,74.0,68.66666666666667
92233153.0,17,14,1126,7,563,15333471.5,174.0,80.42857142857143,7,563,15334275.166666666,174.0,80.42857142857143
2150.0,17,4,344,2,150,0.0,75.0,75.0,2,194,0.0,103.0,97.0
335.0,17,2,208,1,72,0.0,72.0,72.0,1,136,0.0,136.0,136.0
63399.0,6,14,4740,7,653,10159.666666666666,249.0,93.28571428571428,7,4087,8333.166666666666,1514.0,583.8571428571429
104080.0,17,2,286,2,286,0.0,143.0,143.0,0,0,0.0,0.0,0.0
2308.0,17,4,344,2,150,0.0,75.0,75.0,2,194,0.0,103.0,97.0
135140634.0,17,6,1206,6,1206,27028126.8,201.0,201.0,0,0,0.0,0.0,0.0
57872.0,6,14,4740,7,653,9499.166666666666,249.0,93.28571428571428,7,4087,8691.166666666666,1514.0,583.8571428571429
213190.0,6,10,1221,6,636,42638.0,298.0,106.0,4,585,69879.0,379.0,146.25
4223.0,17,4,571,2,148,0.0,74.0,74.0,2,423,0.0,276.0,211.5
207023.0,6,3,426,2,280,0.0,214.0,140.0,1,146,0.0,146.0,146.0
967860.0,6,13,1420,7,789,159649.66666666666,253.0,112.71428571428572,6,631,192987.2,293.0,105.16666666666669
304110.0,6,6,412,4,272,101370.0,74.0,68.0,2,140,0.0,74.0,70.0
4355871.0,6,128,97975,71,89913,62226.72857142857,1510.0,1266.380281690141,57,8062,72168.03571428571,1510.0,141.43859649122808
302097.0,6,6,412,4,272,100699.0,74.0,68.0,2,140,0.0,74.0,70.0
108108441.0,17,5,1005,5,1005,27027110.25,201.0,201.0,0,0,0.0,0.0,0.0
16842.0,17,2,180,1,90,0.0,90.0,90.0,1,90,0.0,90.0,90.0
5624507.0,6,5,336,2,134,0.0,68.0,67.0,3,202,1423921.0,70.0,67.33333333333333
969.0,17,4,438,2,148,0.0,74.0,74.0,2,290,0.0,147.0,145.0
109780890.0,6,30,1974,15,1026,7826062.071428572,123.0,68.4,15,948,7826052.428571428,123.0,63.2
117316517.0,6,47,3102,24,1584,5100706.434782608,66.0,66.0,23,1518,5160722.0,66.0,66.0
135134542.0,17,6,1146,6,1146,27026908.4,191.0,191.0,0,0,0.0,0.0,0.0
120435416.0,6,209,23564,105,16404,1158032.8461538462,284.0,156.22857142857143,104,7160,1159053.4854368933,140.0,68.84615384615384
217889.0,6,3,426,2,280,0.0,214.0,140.0,1,146,0.0,146.0,146.0
154481.0,6,13,1386,7,789,25746.83333333333,253.0,112.71428571428572,6,597,29736.0,259.0,99.5
45743.0,6,14,4740,7,653,7504.333333333333,249.0,93.28571428571428,7,4087,7117.666666666667,1514.0,583.8571428571429
104673.0,17,3,1143,3,1143,52336.5,381.0,381.0,0,0,0.0,0.0,0.0
135130260.0,17,6,1146,6,1146,27026052.0,191.0,191.0,0,0,0.0,0.0,0.0
2866797.0,6,12,2172,7,664,477676.1666666667,252.0,94.85714285714286,5,1508,6082.75,1236.0,301.6
90258112.0,6,14,1964,8,1016,12894016.0,188.0,127.0,6,948,18011374.6,204.0,158.0
2015471.0,17,4,525,2,150,0.0,75.0,75.0,2,375,0.0,284.0,187.5
302133.0,6,6,412,4,272,100711.0,74.0,68.0,2,140,0.0,74.0,70.0
3316.0,17,2,414,1,88,0.0,88.0,88.0,1,326,0.0,326.0,326.0
317.0,17,2,174,1,79,0.0,79.0,79.0,1,95,0.0,95.0,95.0
23525.0,6,11,2098,6,590,4705.0,252.0,98.33333333333331,5,1508,5636.75,1236.0,301.6
14158574.0,17,6,2052,6,2052,2831714.8,342.0,342.0,0,0,0.0,0.0,0.0
16256.0,6,13,1459,7,862,2560.1666666666665,271.0,123.14285714285714,6,597,3094.4,259.0,99.5
3165758.0,6,18,1495,9,921,357812.75,315.0,102.33333333333331,9,574,357782.5,78.0,63.77777777777778
108105186.0,17,5,955,5,955,27026296.5,191.0,191.0,0,0,0.0,0.0,0.0
17443.0,6,10,1810,5,358,3864.0,130.0,71.6,5,1452,3960.75,1224.0,290.4
1001048.0,6,12,1447,6,816,198784.8,291.0,136.0,6,631,198441.6,293.0,105.16666666666669
90365244.0,6,12,1848,5,1020,22590997.25,204.0,204.0,7,828,15060460.833333334,188.0,118.28571428571428
321427.0,6,6,412,4,272,107142.33333333331,74.0,68.0,2,140,0.0,74.0,70.0
135155505.0,17,6,1146,6,1146,27031101.0,191.0,191.0,0,0,0.0,0.0,0.0
240872.0,6,3,337,2,214,0.0,160.0,107.0,1,123,0.0,123.0,123.0
121547.0,17,2,762,2,762,0.0,381.0,381.0,0,0,0.0,0.0,0.0
223217.0,6,3,426,2,280,0.0,214.0,140.0,1,146,0.0,146.0,146.0
108638.0,17,4,1400,4,1400,36212.66666666666,350.0,350.0,0,0,0.0,0.0,0.0
103937.0,17,2,286,2,286,0.0,143.0,143.0,0,0,0.0,0.0,0.0
101188.0,17,2,762,2,762,0.0,381.0,381.0,0,0,0.0,0.0,0.0
209776.0,6,3,426,2,280,0.0,214.0,140.0,1,146,0.0,146.0,146.0
229432.0,6,10,1221,6,636,45886.4,298.0,106.0,4,585,75164.33333333333,379.0,146.25
0.0,6,1,66,1,66,0.0,66.0,66.0,0,0,0.0,0.0,0.0
5629854.0,6,5,336,2,134,0.0,68.0,67.0,3,202,1528797.0,70.0,67.33333333333333
307222.0,6,6,412,4,272,102407.33333333331,74.0,68.0,2,140,0.0,74.0,70.0
120000002.0,6,17,1287,9,691,15000000.25,95.0,76.77777777777777,8,596,12899410.714285716,95.0,74.5
65620.0,6,14,4740,7,653,10515.0,249.0,93.28571428571428,7,4087,10758.333333333334,1514.0,583.8571428571429
310311.0,6,6,412,4,272,103437.0,74.0,68.0,2,140,0.0,74.0,70.0
313163.0,6,3,1604,1,753,0.0,753.0,753.0,2,851,0.0,785.0,425.5
4554.0,17,2,614,1,72,0.0,72.0,72.0,1,542,0.0,542.0,542.0
115962169.0,6,47,3102,24,1584,5041817.478260869,66.0,66.0,23,1518,5160766.818181818,66.0,66.0
307.0,17,2,174,1,79,0.0,79.0,79.0,1,95,0.0,95.0,95.0
232625.0,6,3,337,2,214,0.0,160.0,107.0,1,123,0.0,123.0,123.0
146220.0,6,3,337,2,214,0.0,160.0,107.0,1,123,0.0,123.0,123.0
90254177.0,6,12,1832,8,1016,12893453.857142856,188.0,127.0,4,816,30029191.666666668,204.0,204.0
90527493.0,6,15,2444,8,1016,12932499.0,188.0,127.0,7,1428,15054944.666666666,204.0,204.0
72783.0,6,14,4740,7,653,11666.5,249.0,93.28571428571428,7,4087,11970.333333333334,1514.0,583.8571428571429
108106726.0,17,5,955,5,955,27026681.5,191.0,191.0,0,0,0.0,0.0,0.0
3549464.0,6,174,142749,99,133497,36219.02040816326,1510.0,1348.4545454545455,75,9252,43877.54054054054,1510.0,123.36
90255862.0,6,12,1832,8,1016,12893694.57142857,188.0,127.0,4,816,30030617.666666668,204.0,204.0
10496872.0,6,6,412,3,206,5180076.5,74.0,68.66666666666667,3,206,5179982.0,74.0,68.66666666666667
108098470.0,17,5,1005,5,1005,27024617.5,201.0,201.0,0,0,0.0,0.0,0.0
213661.0,17,2,180,1,90,0.0,90.0,90.0,1,90,0.0,90.0,90.0
43152.0,6,10,2032,5,524,10399.0,252.0,104.8,5,1508,8323.25,1236.0,301.6
21743.0,17,2,582,1,83,0.0,83.0,83.0,1,499,0.0,499.0,499.0
133350.0,6,13,1394,7,797,22225.0,253.0,113.85714285714286,6,597,24982.6,259.0,99.5
121218885.0,6,33,2280,17,1209,7576180.3125,123.0,71.11764705882354,16,1071,7401954.466666667,123.0,66.9375
120335030.0,6,241,27340,121,19198,1002791.9166666666,300.0,158.6611570247934,120,8142,1002612.9411764706,140.0,67.85
313.0,17,2,174,1,79,0.0,79.0,79.0,1,95,0.0,95.0,95.0
108109220.0,17,5,1005,5,1005,27027305.0,201.0,201.0,0,0,0.0,0.0,0.0
90535978.0,6,15,2168,8,1016,12933711.142857144,188.0,127.0,7,1152,15060299.0,204.0,164.57142857142858
281589.0,17,2,363,1,79,0.0,79.0,79.0,1,284,0.0,284.0,284.0
138955.0,6,12,1447,6,816,25722.8,291.0,136.0,6,631,26649.8,293.0,105.16666666666669
317277.0,17,4,1400,4,1400,105759.0,350.0,350.0,0,0,0.0,0.0,0.0
48009.0,6,14,4740,7,653,7842.0,249.0,93.28571428571428,7,4087,7572.666666666667,1514.0,583.8571428571429
65366.99999999999,6,11,2098,6,590,12722.2,252.0,98.33333333333331,5,1508,15741.0,1236.0,301.6
863329.0,6,9,1196,6,725,172665.8,387.0,120.83333333333331,3,471,293943.5,331.0,157.0
101689792.0,17,14,864,7,432,16948298.666666668,174.0,61.71428571428572,7,432,16834152.0,174.0,61.71428571428572
2434.0,17,4,344,2,150,0.0,75.0,75.0,2,194,0.0,103.0,97.0
328.0,17,2,174,1,79,0.0,79.0,79.0,1,95,0.0,95.0,95.0
14371.0,6,10,1065,5,534,3259.5,262.0,106.8,5,531,3261.75,259.0,106.2
36687.0,6,14,4740,7,653,5989.333333333333,249.0,93.28571428571428,7,4087,5662.833333333333,1514.0,583.8571428571429
335.0,17,2,160,1,80,0.0,80.0,80.0,1,80,0.0,80.0,80.0
275416.0,17,2,238,1,74,0.0,74.0,74.0,1,164,0.0,164.0,164.0
123302254.0,6,48,3168,24,1584,4986179.739130435,66.0,66.0,24,1584,5310430.391304348,66.0,66.0
61350.0,6,14,4740,7,653,10116.333333333334,249.0,93.28571428571428,7,4087,8271.833333333334,1514.0,583.8571428571429
205801.0,17,2,180,1,90,0.0,90.0,90.0,1,90,0.0,90.0,90.0
73740.0,6,14,4740,7,653,11178.333333333334,249.0,93.28571428571428,7,4087,12068.166666666666,1514.0,583.8571428571429
135140315.0,17,6,1206,6,1206,27028063.0,201.0,201.0,0,0,0.0,0.0,0.0
2019669.0,17,4,525,2,150,0.0,75.0,75.0,2,375,0.0,284.0,187.5
171041.0,17,2,414,1,88,0.0,88.0,88.0,1,326,0.0,326.0,326.0
138475.0,17,4,1524,4,1524,46158.333333333336,381.0,381.0,0,0,0.0,0.0,0.0
113406345.0,6,35,2542,18,1348,6658265.294117647,139.0,74.88888888888889,17,1194,7074408.3125,123.0,70.23529411764706
48628.0,6,14,4740,7,653,7977.166666666667,249.0,93.28571428571428,7,4087,6558.166666666667,1514.0,583.8571428571429
1302465.0,6,4,264,2,132,0.0,66.0,66.0,2,132,0.0,66.0,66.0
307034.0,6,6,412,4,272,102344.66666666669,74.0,68.0,2,140,0.0,74.0,70.0
96004095.0,17,13,1083,7,563,16000682.5,174.0,80.42857142857143,6,520,15200176.0,174.0,86.66666666666667
0.0,6,1,172,1,172,0.0,172.0,172.0,0,0,0.0,0.0,0.0
130547.0,6,2,132,1,66,0.0,66.0,66.0,1,66,0.0,66.0,66.0
119394357.0,6,235,26578,118,18560,1020464.5897435896,284.0,157.28813559322035,117,8018,1020444.5775862068,140.0,68.52991452991454
2453.0,17,4,344,2,150,0.0,75.0,75.0,2,194,0.0,103.0,97.0
117403814.0,6,219,24712,110,7556,1077099.2110091744,140.0,68.69090909090909,109,17156,1077559.9074074074,284.0,157.39449541284404
93.0,17,2,762,2,762,0.0,381.0,381.0,0,0,0.0,0.0,0.0
246088.0,6,3,337,2,214,0.0,160.0,107.0,1,123,0.0,123.0,123.0
301469.0,6,6,412,4,272,100489.66666666669,74.0,68.0,2,140,0.0,74.0,70.0
119887621.0,6,237,26710,119,8150,1015996.7881355932,140.0,68.4873949579832,118,18560,1017692.4102564104,284.0,157.28813559322035
51348.0,6,14,4740,7,653,8380.666666666666,249.0,93.28571428571428,7,4087,8185.833333333333,1514.0,583.8571428571429
46232.0,6,10,2032,5,524,11084.0,252.0,104.8,5,1508,10920.75,1236.0,301.6
241300.0,17,2,180,1,90,0.0,90.0,90.0,1,90,0.0,90.0,90.0
108103114.0,17,5,955,5,955,27025778.5,191.0,191.0,0,0,0.0,0.0,0.0
0.0,17,1,55,1,55,0.0,55.0,55.0,0,0,0.0,0.0,0.0
219751.0,6,3,426,2,280,0.0,214.0,140.0,1,146,0.0,146.0,146.0
90539134.0,6,13,2036,8,1016,12934162.0,188.0,127.0,5,1020,22591775.5,204.0,204.0
121486.0,6,3,337,2,214,0.0,160.0,107.0,1,123,0.0,123.0,123.0
202531.0,17,2,762,2,762,0.0,381.0,381.0,0,0,0.0,0.0,0.0
2402.0,17,4,344,2,150,0.0,75.0,75.0,2,194,0.0,103.0,97.0
442247.0,17,2,363,1,79,0.0,79.0,79.0,1,284,0.0,284.0,284.0
309269.0,6,6,412,4,272,103089.66666666669,74.0,68.0,2,140,0.0,74.0,70.0
248742.0,17,2,180,1,90,0.0,90.0,90.0,1,90,0.0,90.0,90.0
3806183.0,6,5,1909,3,1017,1450213.5,885.0,339.0,2,892,0.0,826.0,446.0
148832025.0,6,22,1680,10,745,13234864.666666666,95.0,74.5,12,935,13511502.909090908,95.0,77.91666666666667
310829.0,6,6,412,4,272,103609.66666666669,74.0,68.0,2,140,0.0,74.0,70.0
14201.0,6,10,1067,5,536,3385.0,264.0,107.2,5,531,2305.75,259.0,106.2
163308.0,17,4,1524,4,1524,54436.0,381.0,381.0,0,0,0.0,0.0,0.0
233210.0,6,3,373,2,238,0.0,172.0,119.0,1,135,0.0,135.0,135.0
96562490.0,6,27,1932,14,963,7427848.769230769,123.0,68.78571428571429,13,969,7406175.75,123.0,74.53846153846153
303140.0,6,2,132,1,66,0.0,66.0,66.0,1,66,0.0,66.0,66.0
10461453.0,6,7,478,4,272,3441708.6666666665,74.0,68.0,3,206,5162434.0,74.0,68.66666666666667
60129.0,6,14,4740,7,653,9373.666666666666,249.0,93.28571428571428,7,4087,6737.5,1514.0,583.8571428571429
321.0,17,2,174,1,79,0.0,79.0,79.0,1,95,0.0,95.0,95.0
108105925.0,17,5,1005,5,1005,27026481.25,201.0,201.0,0,0,0.0,0.0,0.0
314.0,17,2,174,1,79,0.0,79.0,79.0,1,95,0.0,95.0,95.0
25037.0,6,14,4740,7,653,3359.0,249.0,93.28571428571428,7,4087,3778.8333333333335,1514.0,583.8571428571429
165891.0,17,2,414,1,88,0.0,88.0,88.0,1,326,0.0,326.0,326.0
95886980.0,6,26,1746,13,906,7972599.5,123.0,69.6923076923077,13,840,7972600.75,123.0,64.61538461538461
5012233.0,17,4,1164,2,166,0.0,83.0,83.0,2,998,0.0,499.0,499.0
196779.0,17,2,180,1,90,0.0,90.0,90.0,1,90,0.0,90.0,90.0
90036698.0,17,28,13364,28,13364,3334692.5185185187,501.0,477.2857142857143,0,0,0.0,0.0,0.0
108009682.0,17,13,821,7,432,18001613.666666668,174.0,61.71428571428572,6,389,17539128.2,174.0,64.83333333333333
233560.0,6,3,337,2,214,0.0,160.0,107.0,1,123,0.0,123.0,123.0
321507.0,17,4,1400,4,1400,107169.0,350.0,350.0,0,0,0.0,0.0,0.0
15771141.0,17,12,5004,12,5004,1433740.0909090908,453.0,417.0,0,0,0.0,0.0,0.0
102135.0,17,2,762,2,762,0.0,381.0,381.0,0,0,0.0,0.0,0.0
236807.0,6,3,337,2,214,0.0,160.0,107.0,1,123,0.0,123.0,123.0
27158.0,6,11,2098,6,590,5421.2,252.0,98.33333333333331,5,1508,6089.75,1236.0,301.6
12886.0,17,2,571,1,86,0.0,86.0,86.0,1,485,0.0,485.0,485.0
218012.0,6,3,426,2,280,0.0,214.0,140.0,1,146,0.0,146.0,146.0
111022282.0,6,34,2350,17,1225,6925392.5625,139.0,72.05882352941177,17,1125,6925390.375,123.0,66.17647058823529
206713.0,6,3,426,2,280,0.0,214.0,140.0,1,146,0.0,146.0,146.0
233508.0,6,3,337,2,214,0.0,160.0,107.0,1,123,0.0,123.0,123.0
16709.0,6,14,4740,7,653,2616.5,249.0,93.28571428571428,7,4087,2650.833333333333,1514.0,583.8571428571429
137776.0,6,13,1386,7,789,22962.666666666668,253.0,112.71428571428572,6,597,26091.6,259.0,99.5
302475.0,6,6,412,4,272,100825.0,74.0,68.0,2,140,0.0,74.0,70.0
131140.0,6,2,132,1,66,0.0,66.0,66.0,1,66,0.0,66.0,66.0
5522041.0,6,5,336,2,134,0.0,68.0,67.0,3,202,1418436.5,70.0,67.33333333333333
358.0,17,2,160,1,80,0.0,80.0,80.0,1,80,0.0,80.0,80.0
120006538.0,17,15,1169,8,606,17143791.14285714,174.0,75.75,7,563,16666825.333333334,174.0,80.42857142857143
105431.0,17,2,286,2,286,0.0,143.0,143.0,0,0,0.0,0.0,0.0
205771.0,17,2,180,1,90,0.0,90.0,90.0,1,90,0.0,90.0,90.0
2595704.0,6,2,132,1,66,0.0,66.0,66.0,1,66,0.0,66.0,66.0
60453.0,6,11,2098,6,590,10494.0,252.0,98.33333333333331,5,1508,13490.0,1236.0,301.6
2403.0,17,4,344,2,150,0.0,75.0,75.0,2,194,0.0,103.0,97.0
34102.0,6,14,4740,7,653,5511.166666666667,249.0,93.28571428571428,7,4087,5318.166666666667,1514.0,583.8571428571429
228183.0,17,2,180,1,90,0.0,90.0,90.0,1,90,0.0,90.0,90.0
387.0,17,2,166,1,75,0.0,75.0,75.0,1,91,0.0,91.0,91.0
844235.0,6,9,1118,6,586,168847.0,248.0,97.66666666666669,3,532,284307.5,392.0,177.33333333333334
729.0,17,4,438,2,148,0.0,74.0,74.0,2,290,0.0,147.0,145.0
504.0,17,2,508,2,508,0.0,257.0,254.0,0,0,0.0,0.0,0.0
93626.0,17,2,762,2,762,0.0,381.0,381.0,0,0,0.0,0.0,0.0
90283920.0,6,12,1832,8,1016,12897702.857142856,188.0,127.0,4,816,30039930.33333333,204.0,204.0
0.0,17,1,381,1,381,0.0,381.0,381.0,0,0,0.0,0.0,0.0
90254483.0,6,16,2368,9,1204,11281810.375,188.0,133.77777777777777,7,1164,15014120.0,204.0,166.28571428571428
43909.0,6,14,4740,7,653,7210.166666666667,249.0,93.28571428571428,7,4087,5827.666666666667,1514.0,583.8571428571429
362.0,17,2,762,2,762,0.0,381.0,381.0,0,0,0.0,0.0,0.0
320.0,17,2,160,1,80,0.0,80.0,80.0,1,80,0.0,80.0,80.0
90085539.0,6,15,2180,7,1164,15014089.833333334,204.0,166.28571428571428,8,1016,12869036.857142856,188.0,127.0
216485.0,17,2,180,1,90,0.0,90.0,90.0,1,90,0.0,90.0,90.0
70377.0,6,14,4740,7,653,11600.833333333334,249.0,93.28571428571428,7,4087,10774.0,1514.0,583.8571428571429
107007.0,17,2,286,2,286,0.0,143.0,143.0,0,0,0.0,0.0,0.0
57025.0,6,14,4740,7,653,8353.0,249.0,93.28571428571428,7,4087,9224.666666666666,1514.0,583.8571428571429
108100985.0,17,5,955,5,955,27025246.25,191.0,191.0,0,0,0.0,0.0,0.0
254864.0,17,4,6056,4,6056,84954.66666666667,1514.0,1514.0,0,0,0.0,0.0,0.0
105452.0,17,2,700,2,700,0.0,350.0,350.0,0,0,0.0,0.0,0.0
18948.0,6,10,2032,5,524,4016.25,252.0,104.8,5,1508,4478.75,1236.0,301.6
753.0,17,4,438,2,148,0.0,74.0,74.0,2,290,0.0,147.0,145.0
997018.0,6,12,1354,6,723,198490.4,253.0,120.5,6,631,198466.4,293.0,105.16666666666669
258915.0,6,3,337,2,214,0.0,160.0,107.0,1,123,0.0,123.0,123.0
10903144.0,6,8,544,4,272,3588885.333333333,74.0,68.0,4,272,3588831.0,74.0,68.0
135140034.0,17,6,1146,6,1146,27028006.8,191.0,191.0,0,0,0.0,0.0,0.0
2336.0,17,4,344,2,150,0.0,75.0,75.0,2,194,0.0,103.0,97.0
48431.0,6,14,4740,7,653,7195.5,249.0,93.28571428571428,7,4087,7639.833333333333,1514.0,583.8571428571429
2293.0,17,4,344,2,150,0.0,75.0,75.0,2,194,0.0,103.0,97.0
299774.0,6,6,412,4,272,99924.66666666669,74.0,68.0,2,140,0.0,74.0,70.0
90049805.0,17,28,13364,28,13364,3335177.962962963,501.0,477.2857142857143,0,0,0.0,0.0,0.0
91367842.0,6,22,1680,12,935,8305527.818181818,95.0,77.91666666666667,10,745,10151418.0,95.0,74.5
138.0,17,2,700,2,700,0.0,350.0,350.0,0,0,0.0,0.0,0.0
108105462.0,17,5,1005,5,1005,27026365.5,201.0,201.0,0,0,0.0,0.0,0.0
298676.0,6,6,412,4,272,99558.66666666669,74.0,68.0,2,140,0.0,74.0,70.0
120212953.0,6,19,1436,9,691,14999607.75,95.0,76.77777777777777,10,745,13332985.222222222,95.0,74.5
307404.0,6,6,412,4,272,102468.0,74.0,68.0,2,140,0.0,74.0,70.0
108087883.0,17,5,1005,5,1005,27021970.75,201.0,201.0,0,0,0.0,0.0,0.0
1324720.0,6,4,264,2,132,0.0,66.0,66.0,2,132,0.0,66.0,66.0
315.0,17,2,174,1,79,0.0,79.0,79.0,1,95,0.0,95.0,95.0
112683585.0,17,14,864,7,432,18666876.33333333,174.0,61.71428571428572,7,432,18667765.5,174.0,61.71428571428572
108108007.0,17,5,1005,5,1005,27027001.75,201.0,201.0,0,0,0.0,0.0,0.0
135131825.0,17,6,1206,6,1206,27026365.0,201.0,201.0,0,0,0.0,0.0,0.0
108111781.0,17,5,955,5,955,27027945.25,191.0,191.0,0,0,0.0,0.0,0.0
28712.0,6,14,4740,7,653,4597.666666666667,249.0,93.28571428571428,7,4087,4332.833333333333,1514.0,583.8571428571429
153491.0,17,2,180,1,90,0.0,90.0,90.0,1,90,0.0,90.0,90.0
242576.0,17,4,1524,4,1524,80858.66666666667,381.0,381.0,0,0,0.0,0.0,0.0
2337.0,17,4,344,2,150,0.0,75.0,75.0,2,194,0.0,103.0,97.0
3172957.0,6,18,1495,9,921,358137.25,315.0,102.33333333333331,9,574,358108.75,78.0,63.77777777777778
1316031.0,6,4,264,2,132,0.0,66.0,66.0,2,132,0.0,66.0,66.0
105114659.0,6,253,29132,127,8604,834243.3253968254,140.0,67.74803149606299,126,20528,832661.96,284.0,162.9206349206349
10900325.0,6,8,544,4,272,3586373.6666666665,74.0,68.0,4,272,3586311.6666666665,74.0,68.0
90044327.0,17,28,13364,28,13364,3334975.074074074,501.0,477.2857142857143,0,0,0.0,0.0,0.0
20116.0,6,11,1132,6,556,2882.6,218.0,92.66666666666669,5,576,3626.75,304.0,115.2
36401.0,6,10,2032,5,524,8763.75,252.0,104.8,5,1508,8436.0,1236.0,301.6
5615888.0,6,4,270,2,134,0.0,68.0,67.0,2,136,0.0,70.0,68.0
98901372.0,6,201,22708,101,15886,989013.72,284.0,157.2871287128713,100,6822,988530.3737373736,140.0,68.22
315586.0,6,6,412,4,272,105195.33333333331,74.0,68.0,2,140,0.0,74.0,70.0
107108725.0,17,14,864,7,432,17834418.666666668,174.0,61.71428571428572,7,432,17833491.333333332,174.0,61.71428571428572
331855.0,6,5,336,2,134,0.0,68.0,67.0,3,202,154447.5,70.0,67.33333333333333
135125807.0,17,6,1146,6,1146,27025161.4,191.0,191.0,0,0,0.0,0.0,0.0
4573.0,17,4,344,2,150,0.0,75.0,75.0,2,194,0.0,103.0,97.0
3359378.0,6,165,142069,100,133478,33933.11111111111,1510.0,1334.78,65,8591,47672.09375,1510.0,132.16923076923078
103234178.0,17,14,864,7,432,17167412.0,174.0,61.71428571428572,7,432,17166875.666666668,174.0,61.71428571428572
2590759.0,6,2,132,1,66,0.0,66.0,66.0,1,66,0.0,66.0,66.0
85969.0,6,11,1131,6,600,17001.2,262.0,100.0,5,531,3125.0,259.0,106.2
213659.0,17,2,180,1,90,0.0,90.0,90.0,1,90,0.0,90.0,90.0
363.0,17,2,160,1,80,0.0,80.0,80.0,1,80,0.0,80.0,80.0
43172.0,6,10,2032,5,524,9714.5,252.0,104.8,5,1508,9868.75,1236.0,301.6
108105167.0,17,5,1005,5,1005,27026291.75,201.0,201.0,0,0,0.0,0.0,0.0
216727.0,6,10,1221,6,636,43345.4,298.0,106.0,4,585,71333.66666666667,379.0,146.25
133710.0,6,2,132,1,66,0.0,66.0,66.0,1,66,0.0,66.0,66.0
318612.0,17,4,1400,4,1400,106204.0,350.0,350.0,0,0,0.0,0.0,0.0
324118.0,17,4,1400,4,1400,108039.33333333331,350.0,350.0,0,0,0.0,0.0,0.0
242040.0,6,3,337,2,214,0.0,160.0,107.0,1,123,0.0,123.0,123.0
108088197.0,17,5,1005,5,1005,27022049.25,201.0,201.0,0,0,0.0,0.0,0.0
305425.0,17,2,180,1,90,0.0,90.0,90.0,1,90,0.0,90.0,90.0
147966.0,17,2,180,1,90,0.0,90.0,90.0,1,90,0.0,90.0,90.0
15980.000000000002,6,11,1132,6,556,2374.4,218.0,92.66666666666669,5,576,3768.0,304.0,115.2
2337.0,17,2,939,1,590,0.0,590.0,590.0,1,349,0.0,349.0,349.0
1056451.0,6,3,1604,1,753,0.0,753.0,753.0,2,851,0.0,785.0,425.5
2062.0,17,4,344,2,150,0.0,75.0,75.0,2,194,0.0,103.0,97.0
14653657.0,6,20,1607,10,975,1592923.3333333333,315.0,97.5,10,632,1592997.7777777778,78.0,63.2
92427221.0,17,12,778,6,389,18400823.4,174.0,64.83333333333333,6,389,18400170.0,174.0,64.83333333333333
103874501.0,6,28,1860,14,966,7974615.923076923,123.0,69.0,14,894,7974616.846153846,123.0,63.85714285714285
51094.0,17,2,180,1,90,0.0,90.0,90.0,1,90,0.0,90.0,90.0
144974.0,17,2,180,1,90,0.0,90.0,90.0,1,90,0.0,90.0,90.0
3906437.0,17,9,3022,9,3022,488304.625,382.0,335.77777777777777,0,0,0.0,0.0,0.0
3369.0,17,2,414,1,88,0.0,88.0,88.0,1,326,0.0,326.0,326.0
1036698.0,6,11,1134,6,558,207339.6,220.0,93.0,5,576,257851.0,304.0,115.2
21975.0,6,10,1067,5,536,5320.25,264.0,107.2,5,531,4499.0,259.0,106.2
297275.0,6,6,412,4,272,99091.66666666669,74.0,68.0,2,140,0.0,74.0,70.0
906989.0,6,12,2710,7,743,151164.83333333334,339.0,106.14285714285714,5,1967,158588.75,1514.0,393.4
300.0,17,2,168,1,76,0.0,76.0,76.0,1,92,0.0,92.0,92.0
67155.0,6,14,4740,7,653,10400.833333333334,249.0,93.28571428571428,7,4087,9445.333333333334,1514.0,583.8571428571429
135378.0,6,2,132,1,66,0.0,66.0,66.0,1,66,0.0,66.0,66.0
122530593.0,6,49,3234,25,1650,5105441.375,66.0,66.0,24,1584,4991559.217391305,66.0,66.0
303316.0,6,6,412,4,272,101105.33333333331,74.0,68.0,2,140,0.0,74.0,70.0
90260757.0,6,14,2240,8,1016,12894393.857142856,188.0,127.0,6,1224,18019369.8,204.0,204.0
108105530.0,17,5,1005,5,1005,27026382.5,201.0,201.0,0,0,0.0,0.0,0.0
222566.0,6,3,426,2,280,0.0,214.0,140.0,1,146,0.0,146.0,146.0
314557.0,6,11,1287,6,636,62911.4,298.0,106.0,5,651,78020.25,379.0,130.2
3016312.0,6,188,149486,103,139574,29571.686274509804,1510.0,1355.0873786407767,85,9912,32165.571428571428,1510.0,116.61176470588236
254397.0,6,10,1221,6,636,50879.4,298.0,106.0,4,585,78963.33333333333,379.0,146.25
45377.0,6,14,4740,7,653,6507.333333333333,249.0,93.28571428571428,7,4087,7047.5,1514.0,583.8571428571429
43348.0,6,14,4740,7,653,7104.166666666667,249.0,93.28571428571428,7,4087,7084.666666666667,1514.0,583.8571428571429
98000833.0,17,11,735,6,389,19600166.6,174.0,64.83333333333333,5,346,19888597.5,174.0,69.2
218033.0,6,3,426,2,280,0.0,214.0,140.0,1,146,0.0,146.0,146.0
1299806.0,6,4,264,2,132,0.0,66.0,66.0,2,132,0.0,66.0,66.0
2018.0,17,4,344,2,150,0.0,75.0,75.0,2,194,0.0,103.0,97.0
107346.0,17,2,286,2,286,0.0,143.0,143.0,0,0,0.0,0.0,0.0
90039603.0,17,28,13364,28,13364,3334800.111111111,501.0,477.2857142857143,0,0,0.0,0.0,0.0
90257292.0,6,12,1832,8,1016,12893898.857142856,188.0,127.0,4,816,30031161.33333333,204.0,204.0
282471.0,17,2,180,1,90,0.0,90.0,90.0,1,90,0.0,90.0,90.0
314919.0,17,4,622,4,622,104973.0,163.0,155.5,0,0,0.0,0.0,0.0
183944.0,17,4,1400,4,1400,61314.66666666666,350.0,350.0,0,0,0.0,0.0,0.0
205857.0,17,2,180,1,90,0.0,90.0,90.0,1,90,0.0,90.0,90.0
243231.0,6,3,337,2,214,0.0,160.0,107.0,1,123,0.0,123.0,123.0
898121.0,6,10,1333,6,796,179624.2,458.0,132.66666666666666,4,537,207584.3333333333,331.0,134.25
114501131.0,6,48,3168,24,1584,4978310.043478261,66.0,66.0,24,1584,4964638.391304348,66.0,66.0
31511.0,6,10,1065,5,534,7501.75,262.0,106.8,5,531,7506.75,259.0,106.2
206198.0,6,3,426,2,280,0.0,214.0,140.0,1,146,0.0,146.0,146.0
406202.0,6,3,1604,2,851,0.0,785.0,425.5,1,753,0.0,753.0,753.0
228396.0,6,10,1221,6,636,45679.2,298.0,106.0,4,585,74930.33333333333,379.0,146.25
246701.0,6,3,337,2,214,0.0,160.0,107.0,1,123,0.0,123.0,123.0
108109460.0,17,5,955,5,955,27027365.0,191.0,191.0,0,0,0.0,0.0,0.0
103316412.0,6,42,2772,21,1386,5150440.75,66.0,66.0,21,1386,5150448.7,66.0,66.0
216723.0,6,3,426,2,280,0.0,214.0,140.0,1,146,0.0,146.0,146.0
111973855.0,6,35,2542,18,1348,6573989.647058823,139.0,74.88888888888889,17,1194,6984863.9375,123.0,70.23529411764706
119093321.0,6,251,29476,126,21004,952746.568,352.0,166.6984126984127,125,8472,954749.991935484,140.0,67.776
90223337.0,6,16,1192,8,596,12853723.857142856,95.0,74.5,8,596,12858261.57142857,95.0,74.5
2410.0,17,4,344,2,150,0.0,75.0,75.0,2,194,0.0,103.0,97.0
153443.0,17,2,180,1,90,0.0,90.0,90.0,1,90,0.0,90.0,90.0
10530878.0,6,7,478,4,272,3464730.6666666665,74.0,68.0,3,206,5197011.5,74.0,68.66666666666667
148023.0,17,2,180,1,90,0.0,90.0,90.0,1,90,0.0,90.0,90.0
79598.0,6,14,4740,7,653,13111.833333333334,249.0,93.28571428571428,7,4087,12916.333333333334,1514.0,583.8571428571429
23121347.0,17,3,1034,2,684,0.0,342.0,342.0,1,350,0.0,350.0,350.0
99184.0,17,2,762,2,762,0.0,381.0,381.0,0,0,0.0,0.0,0.0
2571836.0,6,2,132,1,66,0.0,66.0,66.0,1,66,0.0,66.0,66.0
23136.0,6,10,2032,5,524,5531.75,252.0,104.8,5,1508,4957.25,1236.0,301.6
90297239.0,6,24,1829,13,989,7521272.166666667,95.0,76.07692307692308,11,840,9001765.8,95.0,76.36363636363636
123005527.0,17,14,864,7,432,17315280.833333332,174.0,61.71428571428572,7,432,17334457.166666668,174.0,61.71428571428572
2386.0,17,4,344,2,150,0.0,75.0,75.0,2,194,0.0,103.0,97.0
108005578.0,17,13,821,7,432,18000929.666666668,174.0,61.71428571428572,6,389,17600157.8,174.0,64.83333333333333
94992978.0,17,11,735,6,389,18998595.6,174.0,64.83333333333333,5,346,18796355.25,174.0,69.2
2545235.0,6,25,7573,14,3735,195787.3076923077,1514.0,266.7857142857143,11,3838,228071.6,1514.0,348.90909090909093
90097163.0,17,12,778,6,389,17987485.0,174.0,64.83333333333333,6,389,17915693.0,174.0,64.83333333333333
209516.0,17,2,180,1,90,0.0,90.0,90.0,1,90,0.0,90.0,90.0
171620.0,17,2,180,1,90,0.0,90.0,90.0,1,90,0.0,90.0,90.0
122248.0,6,14,4740,7,653,20253.166666666668,249.0,93.28571428571428,7,4087,19613.83333333333,1514.0,583.8571428571429
119999994.0,6,17,1246,9,650,14999999.25,95.0,72.22222222222223,8,596,12853322.142857144,95.0,74.5
2095022.0,6,19,6869,11,1567,209502.2,408.0,142.45454545454547,8,5302,236877.7142857143,1514.0,662.75
50827.0,6,10,2032,5,524,12141.5,252.0,104.8,5,1508,9489.0,1236.0,301.6
125875430.0,6,40,3147,22,1761,5994068.095238095,123.0,80.04545454545455,18,1386,6920957.705882353,123.0,77.0
30519.0,6,10,2032,5,524,5113.0,252.0,104.8,5,1508,7200.75,1236.0,301.6
90934298.0,6,21,1585,11,840,9092424.7,95.0,76.36363636363636,10,745,10102952.333333334,95.0,74.5
10431786.0,6,7,478,4,272,3431791.333333333,74.0,68.0,3,206,5147573.5,74.0,68.66666666666667
430922.0,6,5,367,2,132,0.0,66.0,66.0,3,235,215461.0,103.0,78.33333333333333
103230.0,17,2,286,2,286,0.0,143.0,143.0,0,0,0.0,0.0,0.0
5648284.0,6,5,336,2,134,0.0,68.0,67.0,3,202,1537629.5,70.0,67.33333333333333
5620781.0,6,5,336,2,134,0.0,68.0,67.0,3,202,1523029.5,70.0,67.33333333333333
2797359.0,6,2,132,1,66,0.0,66.0,66.0,1,66,0.0,66.0,66.0
90529753.0,6,15,2444,8,1016,12932821.857142856,188.0,127.0,7,1428,15061330.333333334,204.0,204.0
10483983.0,6,7,478,4,272,3449314.6666666665,74.0,68.0,3,206,5173805.0,74.0,68.66666666666667
135131491.0,17,6,1146,6,1146,27026298.2,191.0,191.0,0,0,0.0,0.0,0.0
279735.0,17,2,363,1,79,0.0,79.0,79.0,1,284,0.0,284.0,284.0
27570417.0,17,5,1710,5,1710,6892604.25,342.0,342.0,0,0,0.0,0.0,0.0
5822.0,17,4,438,2,148,0.0,74.0,74.0,2,290,0.0,147.0,145.0
274755.0,6,10,1221,6,636,54951.0,298.0,106.0,4,585,90540.66666666669,379.0,146.25
1424077.0,17,7,490,7,490,237346.16666666663,70.0,70.0,0,0,0.0,0.0,0.0
13006.0,17,2,582,1,83,0.0,83.0,83.0,1,499,0.0,499.0,499.0
205820.0,17,2,180,1,90,0.0,90.0,90.0,1,90,0.0,90.0,90.0
0.0,6,1,54,0,0,0.0,0.0,0.0,1,54,0.0,54.0,54.0
225884.0,6,10,1221,6,636,45176.8,298.0,106.0,4,585,71798.66666666667,379.0,146.25
108107112.0,17,5,955,5,955,27026778.0,191.0,191.0,0,0,0.0,0.0,0.0
22626.0,6,10,2032,5,524,5115.75,252.0,104.8,5,1508,4904.25,1236.0,301.6
3488512.0,17,3,1026,3,1026,1744256.0,342.0,342.0,0,0,0.0,0.0,0.0
1300081.0,6,4,264,2,132,0.0,66.0,66.0,2,132,0.0,66.0,66.0
146157.0,6,3,337,2,214,0.0,160.0,107.0,1,123,0.0,123.0,123.0
305931.0,6,6,412,4,272,101977.0,74.0,68.0,2,140,0.0,74.0,70.0
21048494.0,17,3,1034,2,684,0.0,342.0,342.0,1,350,0.0,350.0,350.0
30460.0,6,14,4740,7,653,4550.833333333333,249.0,93.28571428571428,7,4087,4313.166666666667,1514.0,583.8571428571429
90064779.0,17,28,13364,28,13364,3335732.5555555555,501.0,477.2857142857143,0,0,0.0,0.0,0.0
120309469.0,6,233,26228,117,18276,1037150.5948275862,284.0,156.2051282051282,116,7952,1038220.9739130436,140.0,68.55172413793103
5620416.0,6,5,336,2,134,0.0,68.0,67.0,3,202,1522725.0,70.0,67.33333333333333
99831094.0,6,40,2640,20,1320,5254268.105263158,66.0,66.0,20,1320,5236864.47368421,66.0,66.0
100804107.0,17,12,516,6,258,20001582.4,43.0,43.0,6,258,20000148.6,43.0,43.0
123839755.0,6,48,3168,24,1584,5169651.478260869,66.0,66.0,24,1584,5127785.956521739,66.0,66.0
21169.0,6,14,4740,7,653,3190.333333333333,249.0,93.28571428571428,7,4087,3391.5,1514.0,583.8571428571429
2414.0,17,4,344,2,150,0.0,75.0,75.0,2,194,0.0,103.0,97.0
14261554.0,17,5,1710,5,1710,3565388.5,342.0,342.0,0,0,0.0,0.0,0.0
29273.0,6,14,4740,7,653,2953.333333333333,249.0,93.28571428571428,7,4087,4687.833333333333,1514.0,583.8571428571429
97702.0,6,11,1133,6,602,16679.2,264.0,100.33333333333331,5,531,19958.75,259.0,106.2
120303265.0,6,34,2403,18,1332,7076662.647058823,123.0,74.0,16,1071,7493438.933333334,123.0,66.9375
45953.0,6,14,4740,7,653,6991.833333333333,249.0,93.28571428571428,7,4087,7136.666666666667,1514.0,583.8571428571429
2408.0,17,4,344,2,150,0.0,75.0,75.0,2,194,0.0,103.0,97.0
311499.0,6,6,412,4,272,103833.0,74.0,68.0,2,140,0.0,74.0,70.0
263936.0,6,10,1221,6,636,52787.2,298.0,106.0,4,585,82204.66666666667,379.0,146.25
232990.0,6,3,337,2,214,0.0,160.0,107.0,1,123,0.0,123.0,123.0
1114168.0,6,20,6434,12,1921,101288.0,620.0,160.08333333333334,8,4513,131403.14285714287,1514.0,564.125
55602.0,6,13,1386,7,789,9094.666666666666,253.0,112.71428571428572,6,597,9309.8,259.0,99.5
135127884.0,17,6,1206,6,1206,27025576.8,201.0,201.0,0,0,0.0,0.0,0.0
77849.0,6,14,4740,7,653,12702.333333333334,249.0,93.28571428571428,7,4087,12269.5,1514.0,583.8571428571429
0.0,17,1,161,1,161,0.0,161.0,161.0,0,0,0.0,0.0,0.0
10469473.0,6,6,412,3,206,5166592.5,74.0,68.66666666666667,3,206,5166521.5,74.0,68.66666666666667
146296.0,6,3,337,2,214,0.0,160.0,107.0,1,123,0.0,123.0,123.0
99893318.0,6,197,22142,99,6830,1019319.5714285716,140.0,68.98989898989899,98,15312,1024660.1546391752,284.0,156.24489795918367
120209683.0,6,2447,2137874,749,49470,160708.13235294115,78.0,66.04806408544727,1698,2088404,70574.97937536829,1514.0,1229.919905771496
493.0,17,2,508,2,508,0.0,257.0,254.0,0,0,0.0,0.0,0.0
118066276.0,6,30,1974,15,1026,8417881.0,123.0,68.4,15,948,8417887.357142856,123.0,63.2
83113.0,6,14,4740,7,653,12872.5,249.0,93.28571428571428,7,4087,11875.833333333334,1514.0,583.8571428571429
301673.0,6,6,412,4,272,100557.66666666669,74.0,68.0,2,140,0.0,74.0,70.0
32475.0,6,14,4740,7,653,4883.166666666667,249.0,93.28571428571428,7,4087,5124.5,1514.0,583.8571428571429
90020768.0,17,28,13364,28,13364,3334102.5185185187,501.0,477.2857142857143,0,0,0.0,0.0,0.0
17976.0,6,10,1065,5,534,4317.25,262.0,106.8,5,531,2500.75,259.0,106.2
1321465.0,6,4,264,2,132,0.0,66.0,66.0,2,132,0.0,66.0,66.0
90529702.0,6,15,2168,8,1016,12932814.57142857,188.0,127.0,7,1152,15055336.5,204.0,164.57142857142858
310204.0,17,4,622,4,622,103401.33333333331,163.0,155.5,0,0,0.0,0.0,0.0
119484554.0,6,48,3168,24,1584,5194980.608695652,66.0,66.0,24,1584,5181557.739130435,66.0,66.0
2374.0,17,4,344,2,150,0.0,75.0,75.0,2,194,0.0,103.0,97.0
218609.0,6,12,1373,7,714,36434.833333333336,298.0,102.0,5,659,53260.5,379.0,131.8
153478.0,17,2,180,1,90,0.0,90.0,90.0,1,90,0.0,90.0,90.0
146408.0,6,2,132,1,66,0.0,66.0,66.0,1,66,0.0,66.0,66.0
4230.0,17,2,602,1,72,0.0,72.0,72.0,1,530,0.0,530.0,530.0
3142087.0,6,18,1536,9,962,354195.125,315.0,106.88888888888889,9,574,354168.0,78.0,63.77777777777778
255029.0,6,3,337,2,214,0.0,160.0,107.0,1,123,0.0,123.0,123.0
90011670.0,17,27,12943,27,12943,3461987.3076923075,501.0,479.3703703703704,0,0,0.0,0.0,0.0
144008.0,17,2,180,1,90,0.0,90.0,90.0,1,90,0.0,90.0,90.0
70432.0,6,14,4740,7,653,11582.833333333334,249.0,93.28571428571428,7,4087,11556.333333333334,1514.0,583.8571428571429
196976.0,17,2,180,1,90,0.0,90.0,90.0,1,90,0.0,90.0,90.0
5824.0,17,4,344,2,150,0.0,75.0,75.0,2,194,0.0,103.0,97.0
19544.0,6,10,2032,5,524,4641.25,252.0,104.8,5,1508,4651.75,1236.0,301.6
340.0,17,2,160,1,80,0.0,80.0,80.0,1,80,0.0,80.0,80.0
236313.0,6,10,1221,6,636,47262.6,298.0,106.0,4,585,77899.0,379.0,146.25
107292.0,17,2,286,2,286,0.0,143.0,143.0,0,0,0.0,0.0,0.0
110054445.0,6,213,24078,107,7284,1038249.4811320754,140.0,68.07476635514018,106,16794,1039425.2285714286,284.0,158.43396226415095
135132426.0,17,6,1206,6,1206,27026485.2,201.0,201.0,0,0,0.0,0.0,0.0
48429.0,6,14,4740,7,653,7626.833333333333,249.0,93.28571428571428,7,4087,7844.833333333333,1514.0,583.8571428571429
38225.0,6,14,4740,7,653,5674.666666666667,249.0,93.28571428571428,7,4087,5636.333333333333,1514.0,583.8571428571429
0.0,6,1,66,1,66,0.0,66.0,66.0,0,0,0.0,0.0,0.0
90257510.0,6,12,1832,8,1016,12893930.0,188.0,127.0,4,816,30030277.0,204.0,204.0
2797126.0,6,2,132,1,66,0.0,66.0,66.0,1,66,0.0,66.0,66.0
198792.0,17,4,6056,4,6056,66264.0,1514.0,1514.0,0,0,0.0,0.0,0.0
10458322.0,6,7,478,4,272,3440867.0,74.0,68.0,3,206,5161223.0,74.0,68.66666666666667
119799954.0,6,20,1490,10,745,13311106.0,95.0,74.5,10,745,13282957.555555556,95.0,74.5
2407.0,17,4,344,2,150,0.0,75.0,75.0,2,194,0.0,103.0,97.0
122975322.0,6,48,3168,24,1584,4957099.260869565,66.0,66.0,24,1584,5309995.565217392,66.0,66.0
294.0,17,2,156,1,78,0.0,78.0,78.0,1,78,0.0,78.0,78.0
30599.0,17,2,539,1,86,0.0,86.0,86.0,1,453,0.0,453.0,453.0
90023185.0,17,28,13364,28,13364,3334192.037037037,501.0,477.2857142857143,0,0,0.0,0.0,0.0
108107859.0,17,5,955,5,955,27026964.75,191.0,191.0,0,0,0.0,0.0,0.0
90256903.0,6,13,2036,8,1016,12893843.285714284,188.0,127.0,5,1020,22523266.0,204.0,204.0
99113365.0,6,33,2428,17,1288,6181093.6875,139.0,75.76470588235294,16,1140,6593160.266666667,123.0,71.25
115184051.0,6,209,23576,105,16416,1107538.951923077,284.0,156.34285714285716,104,7160,1109364.1262135922,140.0,68.84615384615384
100740869.0,17,13,821,7,432,16763324.0,174.0,61.71428571428572,6,389,19972169.0,174.0,64.83333333333333
321.0,17,2,174,1,79,0.0,79.0,79.0,1,95,0.0,95.0,95.0
121423.0,6,3,337,2,214,0.0,160.0,107.0,1,123,0.0,123.0,123.0
9393.0,17,2,582,1,83,0.0,83.0,83.0,1,499,0.0,499.0,499.0
118420617.0,6,23,1734,13,989,9863932.666666666,95.0,76.07692307692308,10,745,13132202.888888888,95.0,74.5
43998208.0,6,7,1872,5,1052,10999552.0,784.0,210.4,2,820,0.0,752.0,410.0
2054.0,17,4,344,2,150,0.0,75.0,75.0,2,194,0.0,103.0,97.0
110847030.0,6,31,2182,16,1165,7376140.6,139.0,72.8125,15,1017,7903006.214285715,123.0,67.8
153466.0,17,2,180,1,90,0.0,90.0,90.0,1,90,0.0,90.0,90.0
123384.0,17,4,1400,4,1400,41128.0,350.0,350.0,0,0,0.0,0.0,0.0
216957.0,17,2,180,1,90,0.0,90.0,90.0,1,90,0.0,90.0,90.0
92339.0,6,14,4740,7,653,15279.5,249.0,93.28571428571428,7,4087,14414.0,1514.0,583.8571428571429
55407.0,6,14,4740,7,653,9055.833333333334,249.0,93.28571428571428,7,4087,8960.333333333334,1514.0,583.8571428571429
90050180.0,17,27,12943,27,12943,3463468.461538461,501.0,479.3703703703704,0,0,0.0,0.0,0.0
20118.0,6,14,4740,7,653,2977.5,249.0,93.28571428571428,7,4087,3216.6666666666665,1514.0,583.8571428571429
217717.0,6,3,426,2,280,0.0,214.0,140.0,1,146,0.0,146.0,146.0
321.0,17,2,174,1,79,0.0,79.0,79.0,1,95,0.0,95.0,95.0
3680.0,17,2,398,1,88,0.0,88.0,88.0,1,310,0.0,310.0,310.0
1154628.0,6,13,3011,8,2383,164946.85714285713,1514.0,297.875,5,628,220544.75,331.0,125.6
114005935.0,17,13,821,7,432,19000989.166666668,174.0,61.71428571428572,6,389,18801126.0,174.0,64.83333333333333
196953.0,17,2,180,1,90,0.0,90.0,90.0,1,90,0.0,90.0,90.0
10506911.0,6,6,412,3,206,5185168.5,74.0,68.66666666666667,3,206,5183115.5,74.0,68.66666666666667
120460696.0,6,217,24676,109,17314,1115376.8148148148,336.0,158.8440366972477,108,7362,1116062.9626168224,140.0,68.16666666666667
10474780.0,6,7,478,4,272,3444155.0,74.0,68.0,3,206,5166142.0,74.0,68.66666666666667
106567.0,17,2,762,2,762,0.0,381.0,381.0,0,0,0.0,0.0,0.0
146245.0,17,2,363,1,75,0.0,75.0,75.0,1,288,0.0,288.0,288.0
207185.0,6,3,426,2,280,0.0,214.0,140.0,1,146,0.0,146.0,146.0
107938.0,17,2,286,2,286,0.0,143.0,143.0,0,0,0.0,0.0,0.0
27177.0,6,10,2032,5,524,6142.0,252.0,104.8,5,1508,6356.5,1236.0,301.6
1021349.0,6,11,1134,6,558,204269.8,220.0,93.0,5,576,254953.5,304.0,115.2
143946.0,17,2,180,1,90,0.0,90.0,90.0,1,90,0.0,90.0,90.0
90026859.0,17,28,13364,28,13364,3334328.111111111,501.0,477.2857142857143,0,0,0.0,0.0,0.0
207869.0,6,3,426,2,280,0.0,214.0,140.0,1,146,0.0,146.0,146.0
5829414.0,6,5,336,3,202,1526549.5,70.0,67.33333333333333,2,134,0.0,68.0,67.0
14970.0,17,2,180,1,90,0.0,90.0,90.0,1,90,0.0,90.0,90.0
8012.0,17,4,823,2,163,0.0,89.0,81.5,2,660,0.0,443.0,330.0
102412.0,17,2,286,2,286,0.0,143.0,143.0,0,0,0.0,0.0,0.0
339793.0,17,4,704,2,148,0.0,74.0,74.0,2,556,0.0,280.0,278.0
108121720.0,17,5,955,5,955,27030430.0,191.0,191.0,0,0,0.0,0.0,0.0
311075.0,6,6,412,4,272,103691.66666666669,74.0,68.0,2,140,0.0,74.0,70.0
298017.0,6,6,412,4,272,99339.0,74.0,68.0,2,140,0.0,74.0,70.0
32760.0,6,10,2032,5,524,7897.0,252.0,104.8,5,1508,7846.25,1236.0,301.6
141263.0,6,2,132,1,66,0.0,66.0,66.0,1,66,0.0,66.0,66.0
119923112.0,6,17,2434,10,1270,13324790.222222222,188.0,127.0,7,1164,19981491.666666668,204.0,166.28571428571428
108108019.0,17,5,1005,5,1005,27027004.75,201.0,201.0,0,0,0.0,0.0,0.0
286734.0,17,4,1524,4,1524,95578.0,381.0,381.0,0,0,0.0,0.0,0.0
120123801.0,6,14,2224,9,1204,15015475.125,188.0,133.77777777777777,5,1020,22591662.25,204.0,204.0
103140.0,17,4,1400,4,1400,34380.0,350.0,350.0,0,0,0.0,0.0,0.0
32646.0,6,14,4740,7,653,5019.333333333333,249.0,93.28571428571428,7,4087,4790.333333333333,1514.0,583.8571428571429
44592.0,6,14,4740,7,653,7222.833333333333,249.0,93.28571428571428,7,4087,6797.0,1514.0,583.8571428571429
324.0,17,2,166,1,75,0.0,75.0,75.0,1,91,0.0,91.0,91.0
284572.0,17,2,363,1,79,0.0,79.0,79.0,1,284,0.0,284.0,284.0
93990262.0,6,165,18712,83,5626,1146222.7073170731,140.0,67.78313253012048,82,13086,1147581.8395061728,284.0,159.58536585365854
10903.0,17,2,762,2,762,0.0,381.0,381.0,0,0,0.0,0.0,0.0
104235439.0,17,14,864,7,432,17333504.833333332,174.0,61.71428571428572,7,432,17334914.333333332,174.0,61.71428571428572
6859.0,17,2,180,1,90,0.0,90.0,90.0,1,90,0.0,90.0,90.0
2490.0,17,4,344,2,150,0.0,75.0,75.0,2,194,0.0,103.0,97.0
233988.0,6,3,337,2,214,0.0,160.0,107.0,1,123,0.0,123.0,123.0
318717.0,17,4,1400,4,1400,106239.0,350.0,350.0,0,0,0.0,0.0,0.0
139532.0,6,2,132,1,66,0.0,66.0,66.0,1,66,0.0,66.0,66.0
62922.00000000001,6,12,1320,6,723,11889.2,253.0,120.5,6,597,11969.4,259.0,99.5
5808726.0,6,5,336,2,134,0.0,68.0,67.0,3,202,1523707.0,70.0,67.33333333333333
106632913.0,6,30,2106,15,1089,7601405.357142857,123.0,72.6,15,1017,7601424.357142857,123.0,67.8
11145288.0,17,4,1368,4,1368,3715096.0,342.0,342.0,0,0,0.0,0.0,0.0
218442.0,6,3,426,2,280,0.0,214.0,140.0,1,146,0.0,146.0,146.0
2022.0,17,4,344,2,150,0.0,75.0,75.0,2,194,0.0,103.0,97.0
502147.0,6,5,336,2,134,0.0,68.0,67.0,3,202,192828.5,70.0,67.33333333333333
299081.0,6,6,412,4,272,99693.66666666669,74.0,68.0,2,140,0.0,74.0,70.0
301523.0,6,6,412,4,272,100507.66666666669,74.0,68.0,2,140,0.0,74.0,70.0
47416.0,6,14,4740,7,653,6874.333333333333,249.0,93.28571428571428,7,4087,5622.0,1514.0,583.8571428571429
207206.0,6,3,426,2,280,0.0,214.0,140.0,1,146,0.0,146.0,146.0
3230.0,17,2,359,1,75,0.0,75.0,75.0,1,284,0.0,284.0,284.0
24333.0,6,10,2032,5,524,5868.0,252.0,104.8,5,1508,5574.0,1236.0,301.6
5823915.0,6,5,336,2,134,0.0,68.0,67.0,3,202,1525487.0,70.0,67.33333333333333
17170.0,17,2,180,1,90,0.0,90.0,90.0,1,90,0.0,90.0,90.0
17849.0,17,4,823,2,163,0.0,89.0,81.5,2,660,0.0,443.0,330.0
197260.0,17,2,180,1,90,0.0,90.0,90.0,1,90,0.0,90.0,90.0
114189378.0,17,16,1474,8,737,16289897.0,174.0,92.125,8,737,16289894.42857143,174.0,92.125
11090.0,6,10,1065,5,534,2539.5,262.0,106.8,5,531,2558.25,259.0,106.2
822.0,17,4,438,2,148,0.0,74.0,74.0,2,290,0.0,147.0,145.0
156170.0,6,3,337,2,214,0.0,160.0,107.0,1,123,0.0,123.0,123.0
284520.0,17,2,363,1,79,0.0,79.0,79.0,1,284,0.0,284.0,284.0
20283.0,17,2,582,1,83,0.0,83.0,83.0,1,499,0.0,499.0,499.0
78065.0,6,10,2032,5,524,16785.75,252.0,104.8,5,1508,19075.25,1236.0,301.6
97000050.0,6,183,20620,92,6294,1065934.6153846155,140.0,68.41304347826087,91,14326,1066267.5,284.0,157.42857142857142
0.0,17,1,90,1,90,0.0,90.0,90.0,0,0,0.0,0.0,0.0
254432.0,6,12,1354,6,723,49831.6,253.0,120.5,6,631,50103.6,293.0,105.16666666666669
255006.0,6,3,337,2,214,0.0,160.0,107.0,1,123,0.0,123.0,123.0
108203768.0,6,43,2838,22,1452,5142280.095238095,66.0,66.0,21,1386,5105438.45,66.0,66.0
5005368.0,17,4,849,2,166,0.0,83.0,83.0,2,683,0.0,499.0,341.5
11382.0,17,4,823,2,163,0.0,89.0,81.5,2,660,0.0,443.0,330.0
144037.0,17,2,180,1,90,0.0,90.0,90.0,1,90,0.0,90.0,90.0
77580.0,6,10,2032,5,524,18123.5,252.0,104.8,5,1508,18725.5,1236.0,301.6
120010686.0,17,28,13364,28,13364,4444840.222222222,501.0,477.2857142857143,0,0,0.0,0.0,0.0
315685.0,6,6,412,4,272,105228.33333333331,74.0,68.0,2,140,0.0,74.0,70.0
120190344.0,6,326,39260,163,11054,736853.1358024691,140.0,67.8159509202454,163,28206,737649.1666666666,464.0,173.04294478527606
0.0,17,1,381,1,381,0.0,381.0,381.0,0,0,0.0,0.0,0.0
102108784.0,6,41,2706,21,1386,5105439.2,66.0,66.0,20,1320,5100471.263157895,66.0,66.0
90051232.0,17,27,12943,27,12943,3463508.923076923,501.0,479.3703703703704,0,0,0.0,0.0,0.0
178951.0,17,2,180,1,90,0.0,90.0,90.0,1,90,0.0,90.0,90.0
217088.0,6,3,426,2,280,0.0,214.0,140.0,1,146,0.0,146.0,146.0
237367.0,17,2,180,1,90,0.0,90.0,90.0,1,90,0.0,90.0,90.0
893681.0,6,10,1333,6,796,178736.2,458.0,132.66666666666666,4,537,206015.66666666663,331.0,134.25
247094.0,6,3,337,2,214,0.0,160.0,107.0,1,123,0.0,123.0,123.0
102689098.0,6,44,2904,22,1452,4889957.047619048,66.0,66.0,22,1452,4879664.047619048,66.0,66.0
5617665.0,6,5,336,2,134,0.0,68.0,67.0,3,202,1524847.0,70.0,67.33333333333333
120004301.0,6,15,2168,6,1086,23999961.0,204.0,181.0,9,1082,15000182.5,188.0,120.22222222222224
162537.0,17,2,180,1,90,0.0,90.0,90.0,1,90,0.0,90.0,90.0
4390.0,17,2,614,1,72,0.0,72.0,72.0,1,542,0.0,542.0,542.0
117436002.0,6,47,3102,24,1584,5105901.782608695,66.0,66.0,23,1518,5143989.363636363,66.0,66.0
33737.0,6,10,2032,5,524,8183.75,252.0,104.8,5,1508,8087.0,1236.0,301.6
18845.0,6,13,1459,7,862,2948.833333333333,271.0,123.14285714285714,6,597,3558.4,259.0,99.5
16587.0,6,14,4740,7,653,2583.6666666666665,249.0,93.28571428571428,7,4087,2626.0,1514.0,583.8571428571429
951519.0,17,5,961,3,234,475569.5,78.0,78.0,2,727,0.0,395.0,363.5
108129858.0,17,5,1005,5,1005,27032464.5,201.0,201.0,0,0,0.0,0.0,0.0
314738.0,17,4,1400,4,1400,104912.66666666669,350.0,350.0,0,0,0.0,0.0,0.0
2806253.0,6,2,132,1,66,0.0,66.0,66.0,1,66,0.0,66.0,66.0
90893709.0,6,378,46164,189,12696,483430.3617021277,140.0,67.17460317460318,189,33468,483348.7819148936,336.0,177.0793650793651
2637.0,17,4,344,2,150,0.0,75.0,75.0,2,194,0.0,103.0,97.0
297562.0,17,2,180,1,90,0.0,90.0,90.0,1,90,0.0,90.0,90.0
119368339.0,6,331,38600,166,27414,723444.4787878788,374.0,165.14457831325302,165,11186,722952.5365853659,140.0,67.7939393939394
135137676.0,17,6,1206,6,1206,27027535.2,201.0,201.0,0,0,0.0,0.0,0.0
2345.0,17,4,344,2,150,0.0,75.0,75.0,2,194,0.0,103.0,97.0
3209.0,17,4,344,2,150,0.0,75.0,75.0,2,194,0.0,103.0,97.0
50325.0,6,14,4740,7,653,7774.666666666667,249.0,93.28571428571428,7,4087,7595.666666666667,1514.0,583.8571428571429
2002.0,17,4,344,2,150,0.0,75.0,75.0,2,194,0.0,103.0,97.0
90031933.0,17,28,13364,28,13364,3334516.037037037,501.0,477.2857142857143,0,0,0.0,0.0,0.0
106599.0,17,2,286,2,286,0.0,143.0,143.0,0,0,0.0,0.0,0.0
107824881.0,6,28,1860,14,966,8294221.615384615,123.0,69.0,14,894,8277588.384615385,123.0,63.85714285714285
35519.0,6,14,4740,7,653,5136.833333333333,249.0,93.28571428571428,7,4087,5784.666666666667,1514.0,583.8571428571429
61523.0,6,14,4740,7,653,9708.166666666666,249.0,93.28571428571428,7,4087,9810.0,1514.0,583.8571428571429
15240.0,6,14,4740,7,653,2389.833333333333,249.0,93.28571428571428,7,4087,2315.1666666666665,1514.0,583.8571428571429
146658.0,6,3,337,2,214,0.0,160.0,107.0,1,123,0.0,123.0,123.0
216138.0,17,2,180,1,90,0.0,90.0,90.0,1,90,0.0,90.0,90.0
103171.0,17,2,762,2,762,0.0,381.0,381.0,0,0,0.0,0.0,0.0
1756302.0,6,27,8386,14,4004,135100.15384615384,1514.0,286.0,13,4382,120670.25,1514.0,337.0769230769231
108104334.0,17,5,955,5,955,27026083.5,191.0,191.0,0,0,0.0,0.0,0.0
23072.0,6,10,1066,5,490,5499.0,218.0,98.0,5,576,3178.25,304.0,115.2
1845.0,17,2,192,1,88,0.0,88.0,88.0,1,104,0.0,104.0,104.0
135124677.0,17,6,1146,6,1146,27024935.4,191.0,191.0,0,0,0.0,0.0,0.0
151995.0,17,2,414,1,88,0.0,88.0,88.0,1,326,0.0,326.0,326.0
27057.0,6,10,2032,5,524,6517.0,252.0,104.8,5,1508,6508.75,1236.0,301.6
267872.0,6,10,1221,6,636,53574.4,298.0,106.0,4,585,83501.0,379.0,146.25
224224.0,6,10,1221,6,636,44844.8,298.0,106.0,4,585,72249.33333333333,379.0,146.25
107836937.0,6,28,1860,14,966,8295149.0,123.0,69.0,14,894,8278500.230769231,123.0,63.85714285714285
135130343.0,17,6,1206,6,1206,27026068.6,201.0,201.0,0,0,0.0,0.0,0.0
3148655.0,6,4,270,2,134,0.0,68.0,67.0,2,136,0.0,70.0,68.0
801.0,17,5,550,5,550,200.25,110.0,110.0,0,0,0.0,0.0,0.0
446.0,17,2,166,1,75,0.0,75.0,75.0,1,91,0.0,91.0,91.0
21206.0,6,14,4740,7,653,3174.0,249.0,93.28571428571428,7,4087,3343.833333333333,1514.0,583.8571428571429
108285.0,17,2,286,2,286,0.0,143.0,143.0,0,0,0.0,0.0,0.0
327.0,17,2,208,1,72,0.0,72.0,72.0,1,136,0.0,136.0,136.0
146165.0,6,3,337,2,214,0.0,160.0,107.0,1,123,0.0,123.0,123.0
320.0,17,2,174,1,79,0.0,79.0,79.0,1,95,0.0,95.0,95.0
130180.0,6,3,337,2,214,0.0,160.0,107.0,1,123,0.0,123.0,123.0
2423.0,17,4,344,2,150,0.0,75.0,75.0,2,194,0.0,103.0,97.0
120067326.0,17,28,13364,28,13364,4446938.0,501.0,477.2857142857143,0,0,0.0,0.0,0.0
111140390.0,6,32,2220,16,1149,7394978.133333334,123.0,71.8125,16,1071,7394979.266666667,123.0,66.9375
158931.0,6,12,1447,6,816,30489.6,291.0,136.0,6,631,31284.4,293.0,105.16666666666669
355.0,17,2,762,2,762,0.0,381.0,381.0,0,0,0.0,0.0,0.0
120016435.0,6,21,1585,11,840,11999997.4,95.0,76.36363636363636,10,745,13334143.666666666,95.0,74.5
313.0,17,2,152,1,76,0.0,76.0,76.0,1,76,0.0,76.0,76.0
108112346.0,17,5,1005,5,1005,27028086.5,201.0,201.0,0,0,0.0,0.0,0.0
4271.0,17,2,626,1,72,0.0,72.0,72.0,1,554,0.0,554.0,554.0
125197303.0,6,33,2280,17,1209,7824831.4375,123.0,71.11764705882354,16,1071,7666314.133333334,123.0,66.9375
117386046.0,6,30,1974,15,1026,8369340.285714285,123.0,68.4,15,948,8369342.857142857,123.0,63.2
4035.000000000001,17,4,704,2,148,0.0,74.0,74.0,2,556,0.0,280.0,278.0
153440.0,17,2,180,1,90,0.0,90.0,90.0,1,90,0.0,90.0,90.0
315970.0,17,4,1400,4,1400,105323.33333333331,350.0,350.0,0,0,0.0,0.0,0.0
53839.0,6,14,4740,7,653,8863.0,249.0,93.28571428571428,7,4087,8427.666666666666,1514.0,583.8571428571429
58628.0,6,10,1065,5,534,14384.0,262.0,106.8,5,531,11002.0,259.0,106.2
120056724.0,17,28,13364,28,13364,4446545.333333333,501.0,477.2857142857143,0,0,0.0,0.0,0.0
116871456.0,6,31,2160,16,1071,7791430.4,123.0,66.9375,15,1089,7619317.571428572,123.0,72.6
207080.0,6,3,426,2,280,0.0,214.0,140.0,1,146,0.0,146.0,146.0
271357.0,6,12,1373,7,714,45226.16666666666,298.0,102.0,5,659,63791.0,379.0,131.8
96130811.0,6,56,12164,28,6426,3560400.407407407,1514.0,229.5,28,5738,3550567.962962963,1514.0,204.92857142857144
44174935.0,6,857,789472,238,15870,186392.13080168777,208.0,66.68067226890756,619,773602,71460.09385113268,1514.0,1249.7609046849757
135121530.0,17,6,1206,6,1206,27024306.0,201.0,201.0,0,0,0.0,0.0,0.0
33107.0,17,4,344,2,150,0.0,75.0,75.0,2,194,0.0,103.0,97.0
902538.0,6,12,2718,7,743,150423.0,339.0,106.14285714285714,5,1975,156703.5,1514.0,395.0
311424.0,6,6,412,4,272,103808.0,74.0,68.0,2,140,0.0,74.0,70.0
242662.0,6,3,337,2,214,0.0,160.0,107.0,1,123,0.0,123.0,123.0
349.0,17,2,160,1,80,0.0,80.0,80.0,1,80,0.0,80.0,80.0
2414884.0,6,3,1777,2,951,0.0,885.0,475.5,1,826,0.0,826.0,826.0
104822954.0,17,15,5130,15,5130,7487353.857142857,342.0,342.0,0,0,0.0,0.0,0.0
243110.0,6,3,337,2,214,0.0,160.0,107.0,1,123,0.0,123.0,123.0
45619127.0,6,7,1874,3,887,21508718.5,753.0,295.6666666666667,4,987,14337864.0,785.0,246.75
146607.0,6,3,373,2,238,0.0,172.0,119.0,1,135,0.0,135.0,135.0
2289.0,17,4,344,2,150,0.0,75.0,75.0,2,194,0.0,103.0,97.0
112619584.0,17,14,864,7,432,18666843.33333333,174.0,61.71428571428572,7,432,18667951.0,174.0,61.71428571428572
107858197.0,6,28,1860,14,966,8296784.384615385,123.0,69.0,14,894,8280145.923076923,123.0,63.85714285714285
17997.0,6,14,4740,7,653,2670.0,249.0,93.28571428571428,7,4087,2820.5,1514.0,583.8571428571429
45423.0,6,14,4740,7,653,7438.833333333333,249.0,93.28571428571428,7,4087,6626.5,1514.0,583.8571428571429
146161.0,6,3,337,2,214,0.0,160.0,107.0,1,123,0.0,123.0,123.0
104719.0,17,2,286,2,286,0.0,143.0,143.0,0,0,0.0,0.0,0.0
9204.0,17,2,539,1,86,0.0,86.0,86.0,1,453,0.0,453.0,453.0
118905539.0,6,36,2580,18,1332,6994443.470588235,123.0,74.0,18,1248,6981715.529411765,123.0,69.33333333333333
306178.0,6,6,412,4,272,102059.33333333331,74.0,68.0,2,140,0.0,74.0,70.0
122843560.0,6,32,2157,16,1071,7523943.666666667,123.0,66.9375,16,1086,8189485.6,123.0,67.875
19527.0,6,14,4740,7,653,3055.1666666666665,249.0,93.28571428571428,7,4087,2771.0,1514.0,583.8571428571429
2406.0,17,4,344,2,150,0.0,75.0,75.0,2,194,0.0,103.0,97.0
17932.0,6,11,1131,6,600,3427.4,262.0,100.0,5,531,4147.25,259.0,106.2
108094152.0,17,5,1005,5,1005,27023538.0,201.0,201.0,0,0,0.0,0.0,0.0
104662843.0,17,13,821,7,432,17417123.5,174.0,61.71428571428572,6,389,16994001.2,174.0,64.83333333333333
2705665.0,6,3,1777,2,951,0.0,885.0,475.5,1,826,0.0,826.0,826.0
135133549.0,17,6,1146,6,1146,27026709.8,191.0,191.0,0,0,0.0,0.0,0.0
228229.0,17,2,180,1,90,0.0,90.0,90.0,1,90,0.0,90.0,90.0
218000.0,6,3,426,2,280,0.0,214.0,140.0,1,146,0.0,146.0,146.0
206652.0,6,3,426,2,280,0.0,214.0,140.0,1,146,0.0,146.0,146.0
207205.0,6,3,426,2,280,0.0,214.0,140.0,1,146,0.0,146.0,146.0
0.0,6,1,54,0,0,0.0,0.0,0.0,1,54,0.0,54.0,54.0
112535473.0,6,46,3036,23,1518,5105434.318181818,66.0,66.0,23,1518,5105435.2727272725,66.0,66.0
120000016.0,6,21,1626,12,935,10909092.363636363,95.0,77.91666666666667,9,691,11229361.5,95.0,76.77777777777777
50702.0,6,10,2032,5,524,12343.75,252.0,104.8,5,1508,10520.5,1236.0,301.6
90526474.0,6,14,2240,8,1016,12932353.42857143,188.0,127.0,6,1224,18072848.0,204.0,204.0
302.0,17,2,164,1,82,0.0,82.0,82.0,1,82,0.0,82.0,82.0
102001008.0,17,13,1083,7,563,17000168.0,174.0,80.42857142857143,6,520,16867442.2,174.0,86.66666666666667
102378.0,17,2,286,2,286,0.0,143.0,143.0,0,0,0.0,0.0,0.0
296.0,17,2,156,1,78,0.0,78.0,78.0,1,78,0.0,78.0,78.0
118000971.0,17,15,1169,8,606,16857281.57142857,174.0,75.75,7,563,16334422.5,174.0,80.42857142857143
357.0,17,2,208,1,72,0.0,72.0,72.0,1,136,0.0,136.0,136.0
113520257.0,6,46,3036,23,1518,5160000.227272728,66.0,66.0,23,1518,5159999.818181818,66.0,66.0
888967.0,6,12,2709,7,742,148161.16666666666,338.0,106.0,5,1967,153320.0,1514.0,393.4
100478441.0,17,14,1126,7,563,16666660.0,174.0,80.42857142857143,7,563,16666767.833333334,174.0,80.42857142857143
29275.0,6,14,4740,7,653,4126.833333333333,249.0,93.28571428571428,7,4087,4742.333333333333,1514.0,583.8571428571429
113254859.0,6,48,3168,24,1584,4923240.304347826,66.0,66.0,24,1584,4921251.130434782,66.0,66.0
111715691.0,6,39,3162,22,1761,5309515.380952381,123.0,80.04545454545455,17,1401,6968594.25,123.0,82.41176470588235
102652.0,17,2,286,2,286,0.0,143.0,143.0,0,0,0.0,0.0,0.0
228243.0,17,2,180,1,90,0.0,90.0,90.0,1,90,0.0,90.0,90.0
1862.0,17,2,192,1,88,0.0,88.0,88.0,1,104,0.0,104.0,104.0
117633277.0,6,212,24024,106,16794,1118266.8857142858,284.0,158.43396226415095,106,7230,1118267.0761904763,140.0,68.20754716981132
103901.0,17,2,286,2,286,0.0,143.0,143.0,0,0,0.0,0.0,0.0
92370898.0,6,40,2640,20,1320,4861626.210526316,66.0,66.0,20,1320,4850251.315789473,66.0,66.0
34724385.0,6,5,336,2,134,0.0,68.0,67.0,3,202,16576277.0,70.0,67.33333333333333
2335.0,17,4,344,2,150,0.0,75.0,75.0,2,194,0.0,103.0,97.0
2671956.0,6,25,7589,14,3751,205535.0769230769,1514.0,267.92857142857144,11,3838,239862.5,1514.0,348.90909090909093
114035923.0,6,30,2106,15,1017,8145423.071428572,123.0,67.8,15,1089,7416803.428571428,123.0,72.6
2979414.0,6,3,1777,2,951,0.0,885.0,475.5,1,826,0.0,826.0,826.0
120396189.0,6,221,24896,111,17340,1094510.809090909,284.0,156.21621621621622,110,7556,1094978.5504587155,140.0,68.69090909090909
321340.0,17,4,1400,4,1400,107113.33333333331,350.0,350.0,0,0,0.0,0.0,0.0
15836.0,6,10,2032,5,524,3719.0,252.0,104.8,5,1508,3433.0,1236.0,301.6
112699300.0,6,48,3168,24,1584,4899969.565217392,66.0,66.0,24,1584,4890571.956521739,66.0,66.0
242038.0,6,3,373,2,238,0.0,172.0,119.0,1,135,0.0,135.0,135.0
134767.0,6,2,132,1,66,0.0,66.0,66.0,1,66,0.0,66.0,66.0
417.0,17,2,508,2,508,0.0,257.0,254.0,0,0,0.0,0.0,0.0
72982.0,6,11,1132,6,556,14168.0,218.0,92.66666666666669,5,576,17805.5,304.0,115.2
147863.0,17,2,180,1,90,0.0,90.0,90.0,1,90,0.0,90.0,90.0
317530.0,17,4,1400,4,1400,105843.33333333331,350.0,350.0,0,0,0.0,0.0,0.0
90707672.0,6,21,1585,10,745,10078630.222222222,95.0,74.5,11,840,9044757.1,95.0,76.36363636363636
96813.0,17,2,762,2,762,0.0,381.0,381.0,0,0,0.0,0.0,0.0
97624113.0,6,39,2574,20,1320,5138097.0,66.0,66.0,19,1254,5112002.111111111,66.0,66.0
120306271.0,6,228,25772,114,7820,1048353.8938053098,140.0,68.59649122807018,114,17952,1057394.5663716814,284.0,157.47368421052633
308.0,17,2,174,1,79,0.0,79.0,79.0,1,95,0.0,95.0,95.0
29737.0,6,10,2032,5,524,4205.5,252.0,104.8,5,1508,7173.25,1236.0,301.6
27721.0,6,11,1133,6,602,5326.0,264.0,100.33333333333331,5,531,4743.75,259.0,106.2
5168.0,17,4,344,2,150,0.0,75.0,75.0,2,194,0.0,103.0,97.0
0.0,6,1,66,1,66,0.0,66.0,66.0,0,0,0.0,0.0,0.0
135134765.0,17,6,1146,6,1146,27026953.0,191.0,191.0,0,0,0.0,0.0,0.0
70954.0,6,10,1065,5,534,17057.5,262.0,106.8,5,531,15414.25,259.0,106.2
361804.0,6,11,1021,6,444,48597.2,162.0,74.0,5,577,60616.25,349.0,115.4
16875.0,6,10,1066,5,490,3269.5,218.0,98.0,5,576,4013.0,304.0,115.2
44394.0,6,14,4740,7,653,7272.333333333333,249.0,93.28571428571428,7,4087,6185.333333333333,1514.0,583.8571428571429
135133284.0,17,6,1206,6,1206,27026656.8,201.0,201.0,0,0,0.0,0.0,0.0
29366.0,6,14,4740,7,653,4723.666666666667,249.0,93.28571428571428,7,4087,4097.0,1514.0,583.8571428571429
107435384.0,6,474,60134,237,44196,454321.1228813559,464.0,186.48101265822783,237,15938,454864.4830508475,140.0,67.24894514767932
301830.0,6,6,412,4,272,100610.0,74.0,68.0,2,140,0.0,74.0,70.0
205582.0,6,13,1386,7,789,34263.666666666664,253.0,112.71428571428572,6,597,40037.6,259.0,99.5
120061303.0,17,28,13364,28,13364,4446714.925925926,501.0,477.2857142857143,0,0,0.0,0.0,0.0
121083289.0,6,218,24534,109,7416,1104977.888888889,140.0,68.03669724770643,109,17118,1113531.259259259,284.0,157.045871559633
90256118.0,6,12,1832,8,1016,12893731.142857144,188.0,127.0,4,816,30030325.33333333,204.0,204.0
1490.0,17,2,762,2,762,0.0,381.0,381.0,0,0,0.0,0.0,0.0
284902.0,17,2,363,1,79,0.0,79.0,79.0,1,284,0.0,284.0,284.0
121829.0,6,3,337,2,214,0.0,160.0,107.0,1,123,0.0,123.0,123.0
109759644.0,6,33,2428,17,1288,6846487.875,139.0,75.76470588235294,16,1140,7302921.266666667,123.0,71.25
246464.0,6,3,337,2,214,0.0,160.0,107.0,1,123,0.0,123.0,123.0
117800008.0,6,48,3168,24,1584,5121739.478260869,66.0,66.0,24,1584,5107280.130434782,66.0,66.0
123839832.0,6,48,3168,24,1584,5157129.695652174,66.0,66.0,24,1584,5140348.565217392,66.0,66.0
242721.0,6,3,337,2,214,0.0,160.0,107.0,1,123,0.0,123.0,123.0
90261262.0,6,13,2036,8,1016,12894466.0,188.0,127.0,5,1020,22523560.25,204.0,204.0
113344197.0,6,46,3036,23,1518,5151996.954545454,66.0,66.0,23,1518,5151997.727272728,66.0,66.0
7780.0,6,10,2032,5,524,1715.25,252.0,104.8,5,1508,1706.75,1236.0,301.6
294.0,17,2,164,1,82,0.0,82.0,82.0,1,82,0.0,82.0,82.0
88859.0,6,14,4740,7,653,12015.833333333334,249.0,93.28571428571428,7,4087,14654.166666666666,1514.0,583.8571428571429
38621.0,6,14,4740,7,653,6313.0,249.0,93.28571428571428,7,4087,6143.0,1514.0,583.8571428571429
97201660.0,6,40,2640,20,1320,5115876.842105263,66.0,66.0,20,1320,5101522.684210527,66.0,66.0
121423.0,6,3,337,2,214,0.0,160.0,107.0,1,123,0.0,123.0,123.0
41257.0,6,14,4740,7,653,6449.833333333333,249.0,93.28571428571428,7,4087,6540.333333333333,1514.0,583.8571428571429
316014.0,6,10,1221,6,636,63202.8,298.0,106.0,4,585,99932.33333333331,379.0,146.25
107415919.0,6,34,2482,17,1194,6713467.1875,123.0,70.23529411764706,17,1288,6089489.5625,139.0,75.76470588235294
1307640.0,6,4,264,2,132,0.0,66.0,66.0,2,132,0.0,66.0,66.0
1164365.0,6,13,3020,8,2392,166337.85714285713,1514.0,299.0,5,628,222907.5,331.0,125.6
90072166.0,17,27,12943,27,12943,3464314.076923077,501.0,479.3703703703704,0,0,0.0,0.0,0.0
854254.0,6,9,1196,6,725,170850.8,387.0,120.83333333333331,3,471,289267.5,331.0,157.0
104190.0,17,2,762,2,762,0.0,381.0,381.0,0,0,0.0,0.0,0.0
108108789.0,17,5,955,5,955,27027197.25,191.0,191.0,0,0,0.0,0.0,0.0
31505.0,6,14,4740,7,653,5122.5,249.0,93.28571428571428,7,4087,5073.833333333333,1514.0,583.8571428571429
143935.0,17,2,176,1,80,0.0,80.0,80.0,1,96,0.0,96.0,96.0
204714.0,17,2,762,2,762,0.0,381.0,381.0,0,0,0.0,0.0,0.0
130336.0,6,3,337,2,214,0.0,160.0,107.0,1,123,0.0,123.0,123.0
2897104.0,6,2,132,1,66,0.0,66.0,66.0,1,66,0.0,66.0,66.0
3043082.0,6,3,1604,1,753,0.0,753.0,753.0,2,851,0.0,785.0,425.5
789865.0,17,11,4122,11,4122,78986.5,390.0,374.7272727272728,0,0,0.0,0.0,0.0
2327.0,17,4,344,2,150,0.0,75.0,75.0,2,194,0.0,103.0,97.0
318269.0,17,4,1400,4,1400,106089.66666666669,350.0,350.0,0,0,0.0,0.0,0.0
303127.0,6,2,132,1,66,0.0,66.0,66.0,1,66,0.0,66.0,66.0
90273759.0,6,13,2036,8,1016,12896251.285714284,188.0,127.0,5,1020,22526848.0,204.0,204.0
328167.0,6,6,412,4,272,109389.0,74.0,68.0,2,140,0.0,74.0,70.0
45759935.0,6,8,1940,3,887,21885150.5,753.0,295.6666666666667,5,1053,10824197.75,785.0,210.6
93760016.0,6,179,20266,90,14244,1053483.3258426967,284.0,158.26666666666668,89,6022,1043642.4886363636,140.0,67.66292134831461
324.0,17,2,160,1,80,0.0,80.0,80.0,1,80,0.0,80.0,80.0
120107730.0,6,14,2224,9,1204,15013466.25,188.0,133.77777777777777,5,1020,22511817.25,204.0,204.0
108434073.0,6,32,2220,16,1149,7214544.933333334,123.0,71.8125,16,1071,7214548.466666667,123.0,66.9375
116574518.0,6,202,22992,101,16104,1163590.51,374.0,159.44554455445544,101,6888,1163592.04,140.0,68.1980198019802
232104.0,6,3,337,2,214,0.0,160.0,107.0,1,123,0.0,123.0,123.0
311422.0,6,6,412,4,272,103807.33333333331,74.0,68.0,2,140,0.0,74.0,70.0
137043.0,6,2,132,1,66,0.0,66.0,66.0,1,66,0.0,66.0,66.0
39902.0,6,14,4740,7,653,5183.666666666667,249.0,93.28571428571428,7,4087,6464.0,1514.0,583.8571428571429
149730.0,17,4,1524,4,1524,49910.0,381.0,381.0,0,0,0.0,0.0,0.0
122120.0,6,3,373,2,238,0.0,172.0,119.0,1,135,0.0,135.0,135.0
108087400.0,17,5,955,5,955,27021850.0,191.0,191.0,0,0,0.0,0.0,0.0
56142.0,6,12,1328,7,797,9357.0,253.0,113.85714285714286,5,531,10289.5,259.0,106.2
47929.0,6,4,301,2,132,0.0,66.0,66.0,2,169,0.0,103.0,84.5
2478.0,17,4,344,2,150,0.0,75.0,75.0,2,194,0.0,103.0,97.0
78022.0,6,14,4740,7,653,12783.5,249.0,93.28571428571428,7,4087,11762.666666666666,1514.0,583.8571428571429
108105185.0,17,5,1005,5,1005,27026296.25,201.0,201.0,0,0,0.0,0.0,0.0
56067.0,6,14,4740,7,653,9214.5,249.0,93.28571428571428,7,4087,8784.0,1514.0,583.8571428571429
102695.0,6,14,4740,7,653,16336.166666666666,249.0,93.28571428571428,7,4087,16776.5,1514.0,583.8571428571429
33659.0,6,14,4740,7,653,5152.166666666667,249.0,93.28571428571428,7,4087,5403.166666666667,1514.0,583.8571428571429
1305971.0,6,4,264,2,132,0.0,66.0,66.0,2,132,0.0,66.0,66.0
15156.0,6,13,1459,7,862,2294.5,271.0,123.14285714285714,6,597,2438.4,259.0,99.5
316577.0,17,4,1400,4,1400,105525.66666666669,350.0,350.0,0,0,0.0,0.0,0.0
30561.0,6,10,2032,5,524,7412.75,252.0,104.8,5,1508,5905.5,1236.0,301.6
135124712.0,17,6,1146,6,1146,27024942.4,191.0,191.0,0,0,0.0,0.0,0.0
97815637.0,17,14,4796,13,4446,6227637.666666667,342.0,342.0,1,350,0.0,350.0,350.0
216383.0,17,2,180,1,90,0.0,90.0,90.0,1,90,0.0,90.0,90.0
90289675.0,6,20,1531,10,786,10026707.222222222,95.0,78.6,10,745,9936113.111111112,95.0,74.5
2170479.0,6,25,7610,13,2516,179135.83333333334,1034.0,193.53846153846155,12,5094,169197.81818181818,1510.0,424.5
2428.0,17,4,344,2,150,0.0,75.0,75.0,2,194,0.0,103.0,97.0
93865858.0,6,181,20382,91,6228,1042953.9777777778,140.0,68.43956043956044,90,14154,1042998.6292134832,284.0,157.26666666666668
112530.0,17,4,1400,4,1400,37510.0,350.0,350.0,0,0,0.0,0.0,0.0
115806451.0,6,48,3168,24,1584,5035063.0869565215,66.0,66.0,24,1584,5025671.652173913,66.0,66.0
44769.0,6,14,4740,7,653,7192.666666666667,249.0,93.28571428571428,7,4087,7223.5,1514.0,583.8571428571429
254212.0,6,3,337,2,214,0.0,160.0,107.0,1,123,0.0,123.0,123.0
100277693.0,17,12,778,6,389,20055538.6,174.0,64.83333333333333,6,389,19939175.0,174.0,64.83333333333333
90258794.0,6,12,1832,8,1016,12894113.42857143,188.0,127.0,4,816,30031323.33333333,204.0,204.0
475.0,17,2,508,2,508,0.0,257.0,254.0,0,0,0.0,0.0,0.0
849766.0,6,9,1096,6,625,169953.2,287.0,104.16666666666669,3,471,287362.5,331.0,157.0
2372.0,17,4,344,2,150,0.0,75.0,75.0,2,194,0.0,103.0,97.0
91392076.0,6,24,1829,13,989,7614596.583333333,95.0,76.07692307692308,11,840,9138029.7,95.0,76.36363636363636
70298.0,6,14,4740,7,653,10412.5,249.0,93.28571428571428,7,4087,11562.0,1514.0,583.8571428571429
136444.0,6,2,132,1,66,0.0,66.0,66.0,1,66,0.0,66.0,66.0
81725.0,6,14,4740,7,653,13431.666666666666,249.0,93.28571428571428,7,4087,13433.666666666666,1514.0,583.8571428571429
235001.0,6,10,1221,6,636,47000.2,298.0,106.0,4,585,74699.0,379.0,146.25
25693.0,6,10,2032,5,524,5814.75,252.0,104.8,5,1508,6047.0,1236.0,301.6
23226.0,6,10,2032,5,524,5108.0,252.0,104.8,5,1508,5503.75,1236.0,301.6
111618929.0,17,15,1431,8,737,15945561.285714284,174.0,92.125,7,694,16153860.333333334,174.0,99.14285714285714
92300.0,6,15,4806,8,719,12883.42857142857,249.0,89.875,7,4087,14894.0,1514.0,583.8571428571429
126001431.0,17,15,907,8,475,18000204.42857143,174.0,59.375,7,432,17667411.0,174.0,61.71428571428572
256215.00000000003,6,3,337,2,214,0.0,160.0,107.0,1,123,0.0,123.0,123.0
97830639.0,6,40,2640,20,1320,5148981.0,66.0,66.0,20,1320,5132536.842105263,66.0,66.0
90526457.0,6,14,2240,8,1016,12932351.0,188.0,127.0,6,1224,18062951.0,204.0,204.0
102205.0,17,2,286,2,286,0.0,143.0,143.0,0,0,0.0,0.0,0.0
233230.0,6,3,337,2,214,0.0,160.0,107.0,1,123,0.0,123.0,123.0
115188204.0,6,215,24246,108,7350,1076525.2710280374,140.0,68.05555555555556,107,16896,1076943.1981132077,284.0,157.90654205607476
87796.0,6,10,2032,5,524,8437.5,252.0,104.8,5,1508,21507.5,1236.0,301.6
147942.0,6,3,373,2,238,0.0,172.0,119.0,1,135,0.0,135.0,135.0
49512.0,6,10,2032,5,524,10192.25,252.0,104.8,5,1508,10629.75,1236.0,301.6
110985318.0,6,31,2182,16,1165,7384640.8,139.0,72.8125,15,1017,7912115.214285715,123.0,67.8
2387.0,17,4,344,2,150,0.0,75.0,75.0,2,194,0.0,103.0,97.0
5009925.0,17,4,849,2,166,0.0,83.0,83.0,2,683,0.0,499.0,341.5
153502.0,17,2,180,1,90,0.0,90.0,90.0,1,90,0.0,90.0,90.0
90689282.0,6,15,2302,9,1204,11316356.375,188.0,133.77777777777777,6,1098,18105286.4,204.0,183.0
36139.0,6,14,4740,7,653,5860.833333333333,249.0,93.28571428571428,7,4087,4906.333333333333,1514.0,583.8571428571429
353.0,17,2,250,1,93,0.0,93.0,93.0,1,157,0.0,157.0,157.0
107445.0,17,2,700,2,700,0.0,350.0,350.0,0,0,0.0,0.0,0.0
228670.0,17,2,180,1,90,0.0,90.0,90.0,1,90,0.0,90.0,90.0
137735.0,6,2,132,1,66,0.0,66.0,66.0,1,66,0.0,66.0,66.0
146043.0,6,3,337,2,214,0.0,160.0,107.0,1,123,0.0,123.0,123.0
143842.0,17,2,180,1,90,0.0,90.0,90.0,1,90,0.0,90.0,90.0
218051.0,17,2,180,1,90,0.0,90.0,90.0,1,90,0.0,90.0,90.0
242331.0,6,3,337,2,214,0.0,160.0,107.0,1,123,0.0,123.0,123.0
277984.0,17,4,1524,4,1524,92661.33333333331,381.0,381.0,0,0,0.0,0.0,0.0
11125.0,6,11,1132,6,556,1681.8,218.0,92.66666666666669,5,576,2502.75,304.0,115.2
91393348.0,6,24,1829,13,989,7613864.083333333,95.0,76.07692307692308,11,840,9138347.9,95.0,76.36363636363636
119554282.0,6,228,25644,114,17824,1056098.610619469,284.0,156.35087719298247,114,7820,1056098.4867256638,140.0,68.59649122807018
469159.0,17,6,1230,3,234,234395.0,78.0,78.0,3,996,234374.5,332.0,332.0
207677.0,6,3,426,2,280,0.0,214.0,140.0,1,146,0.0,146.0,146.0
52905.0,6,14,4740,7,653,7135.333333333333,249.0,93.28571428571428,7,4087,7505.833333333333,1514.0,583.8571428571429
120119769.0,6,16,2368,7,1164,20019961.5,204.0,166.28571428571428,9,1204,14994683.625,188.0,133.77777777777777
303.0,17,2,174,1,79,0.0,79.0,79.0,1,95,0.0,95.0,95.0
314481.0,6,6,412,4,272,104827.0,74.0,68.0,2,140,0.0,74.0,70.0
2859.0,17,2,762,2,762,0.0,381.0,381.0,0,0,0.0,0.0,0.0
19169654.0,6,9,589,4,288,6383885.0,95.0,72.0,5,301,4790720.75,85.0,60.2
103267.0,17,2,286,2,286,0.0,143.0,143.0,0,0,0.0,0.0,0.0
105714.0,17,2,700,2,700,0.0,350.0,350.0,0,0,0.0,0.0,0.0
299749.0,6,6,412,4,272,99916.33333333331,74.0,68.0,2,140,0.0,74.0,70.0
298830.0,17,2,238,1,74,0.0,74.0,74.0,1,164,0.0,164.0,164.0
127656.0,6,2,132,1,66,0.0,66.0,66.0,1,66,0.0,66.0,66.0
90289541.0,6,30,3197,15,1595,6446085.285714285,425.0,106.33333333333331,15,1602,6429448.928571428,359.0,106.8
35119.0,6,2,145,2,145,0.0,91.0,72.5,0,0,0.0,0.0,0.0
65045.00000000001,6,14,4740,7,653,10649.166666666666,249.0,93.28571428571428,7,4087,10451.166666666666,1514.0,583.8571428571429
362356.0,6,11,1021,6,444,48672.6,162.0,74.0,5,577,60661.75,349.0,115.4
306948.0,6,6,412,4,272,102316.0,74.0,68.0,2,140,0.0,74.0,70.0
320125.0,6,6,412,4,272,106708.33333333331,74.0,68.0,2,140,0.0,74.0,70.0
120006408.0,17,15,907,8,475,17143772.57142857,174.0,59.375,7,432,16666846.833333334,174.0,61.71428571428572
2618.0,17,4,344,2,150,0.0,75.0,75.0,2,194,0.0,103.0,97.0
10081.0,17,4,823,2,163,0.0,89.0,81.5,2,660,0.0,443.0,330.0
211095.0,6,12,1373,7,714,35182.5,298.0,102.0,5,659,51771.25,379.0,131.8
115841930.0,6,48,3168,24,1584,5036605.652173913,66.0,66.0,24,1584,5024767.434782608,66.0,66.0
105799.0,17,2,700,2,700,0.0,350.0,350.0,0,0,0.0,0.0,0.0
34925.0,6,10,2032,5,524,8348.75,252.0,104.8,5,1508,7975.25,1236.0,301.6
7226.0,17,2,582,1,83,0.0,83.0,83.0,1,499,0.0,499.0,499.0
103119.0,17,2,286,2,286,0.0,143.0,143.0,0,0,0.0,0.0,0.0
993088.0,17,4,820,2,156,0.0,78.0,78.0,2,664,0.0,332.0,332.0
53793.0,6,10,2032,5,524,13197.0,252.0,104.8,5,1508,12246.0,1236.0,301.6
10455779.0,6,6,412,3,206,5160003.5,74.0,68.66666666666667,3,206,5159663.5,74.0,68.66666666666667
2192114.0,6,25,7610,13,2516,182676.16666666663,1034.0,193.53846153846155,12,5094,170400.18181818182,1510.0,424.5
300153.0,6,6,412,4,272,100051.0,74.0,68.0,2,140,0.0,74.0,70.0
2100549.0,17,2,876,2,876,0.0,438.0,438.0,0,0,0.0,0.0,0.0
137635.0,6,2,132,1,66,0.0,66.0,66.0,1,66,0.0,66.0,66.0
138614.0,17,4,344,2,150,0.0,75.0,75.0,2,194,0.0,103.0,97.0
120049491.0,17,29,13785,29,13785,4287481.821428572,501.0,475.3448275862069,0,0,0.0,0.0,0.0
108107032.0,17,5,955,5,955,27026758.0,191.0,191.0,0,0,0.0,0.0,0.0
92134.0,6,10,2032,5,524,22530.5,252.0,104.8,5,1508,22477.0,1236.0,301.6
153591.0,17,2,180,1,90,0.0,90.0,90.0,1,90,0.0,90.0,90.0
120070760.0,17,28,13364,28,13364,4447065.185185186,501.0,477.2857142857143,0,0,0.0,0.0,0.0
204456.0,17,2,762,2,762,0.0,381.0,381.0,0,0,0.0,0.0,0.0
108107892.0,17,5,955,5,955,27026973.0,191.0,191.0,0,0,0.0,0.0,0.0
266292.0,17,2,180,1,90,0.0,90.0,90.0,1,90,0.0,90.0,90.0
136511.0,6,2,132,1,66,0.0,66.0,66.0,1,66,0.0,66.0,66.0
115481104.0,6,219,24728,110,7482,1059459.6697247706,140.0,68.01818181818182,109,17246,1059615.2037037036,284.0,158.22018348623854
32681848.000000004,6,5,336,2,134,0.0,68.0,67.0,3,202,15053027.5,70.0,67.33333333333333
120179930.0,6,216,24424,108,7424,1115475.9719626168,140.0,68.74074074074075,108,17000,1115542.3457943923,284.0,157.40740740740742
86.0,17,2,762,2,762,0.0,381.0,381.0,0,0,0.0,0.0,0.0
303110.0,6,2,132,1,66,0.0,66.0,66.0,1,66,0.0,66.0,66.0
40540.0,6,14,4740,7,653,6520.5,249.0,93.28571428571428,7,4087,6379.666666666667,1514.0,583.8571428571429
37226.0,6,10,2032,5,524,8258.25,252.0,104.8,5,1508,8031.75,1236.0,301.6
4340.0,17,2,598,1,72,0.0,72.0,72.0,1,526,0.0,526.0,526.0
1872.0,17,2,192,1,88,0.0,88.0,88.0,1,104,0.0,104.0,104.0
41083.0,6,14,4740,7,653,6410.166666666667,249.0,93.28571428571428,7,4087,5679.666666666667,1514.0,583.8571428571429
42796.0,6,14,4740,7,653,6867.5,249.0,93.28571428571428,7,4087,6047.666666666667,1514.0,583.8571428571429
0.0,17,1,381,1,381,0.0,381.0,381.0,0,0,0.0,0.0,0.0
134172106.0,17,15,1038,7,432,19833709.83333333,174.0,61.71428571428572,8,606,19126477.57142857,174.0,75.75
200278.0,17,4,6056,4,6056,66759.33333333333,1514.0,1514.0,0,0,0.0,0.0,0.0
257543.00000000003,6,10,1221,6,636,51508.6,298.0,106.0,4,585,80428.33333333333,379.0,146.25
3253092.0,6,3,1604,2,851,0.0,785.0,425.5,1,753,0.0,753.0,753.0
110056824.0,6,254,28668,127,20064,871750.1587301587,300.0,157.98425196850394,127,8604,871748.4444444445,140.0,67.74803149606299
153668.0,17,2,180,1,90,0.0,90.0,90.0,1,90,0.0,90.0,90.0
108100449.0,17,5,955,5,955,27025112.25,191.0,191.0,0,0,0.0,0.0,0.0
115505016.0,6,862,170454,429,28918,269871.5327102804,214.0,67.4079254079254,433,141536,265514.78935185185,1514.0,326.8729792147806
90238403.0,6,14,2240,8,1016,12891200.42857143,188.0,127.0,6,1224,18014779.6,204.0,204.0
143971.0,17,2,180,1,90,0.0,90.0,90.0,1,90,0.0,90.0,90.0
90330077.0,6,16,1192,8,596,12892236.57142857,95.0,74.5,8,596,12903797.857142856,95.0,74.5
228234.0,17,2,180,1,90,0.0,90.0,90.0,1,90,0.0,90.0,90.0
42349.0,6,10,2032,5,524,10250.25,252.0,104.8,5,1508,10296.25,1236.0,301.6
0.0,6,1,66,1,66,0.0,66.0,66.0,0,0,0.0,0.0,0.0
135132106.0,17,6,1146,6,1146,27026421.2,191.0,191.0,0,0,0.0,0.0,0.0
26245.0,6,14,4740,7,653,4253.666666666667,249.0,93.28571428571428,7,4087,4239.5,1514.0,583.8571428571429
15090.0,6,10,2032,5,524,3610.0,252.0,104.8,5,1508,3445.0,1236.0,301.6
16066.0,6,11,1131,6,600,3213.2,262.0,100.0,5,531,3685.5,259.0,106.2
119752.0,17,2,180,1,70,0.0,70.0,70.0,1,110,0.0,110.0,110.0
1314619.0,6,4,264,2,132,0.0,66.0,66.0,2,132,0.0,66.0,66.0
104916209.0,6,28,1876,14,982,8053755.076923077,139.0,70.14285714285714,14,894,8053815.153846154,123.0,63.85714285714285
309256.0,6,3,202,2,128,0.0,74.0,64.0,1,74,0.0,74.0,74.0
90257401.0,6,12,1832,8,1016,12893914.42857143,188.0,127.0,4,816,30031103.666666668,204.0,204.0
304182.0,6,6,412,4,272,101394.0,74.0,68.0,2,140,0.0,74.0,70.0
2952.0,17,4,344,2,150,0.0,75.0,75.0,2,194,0.0,103.0,97.0
13131.0,6,13,1459,7,862,2188.5,271.0,123.14285714285714,6,597,1982.2,259.0,99.5
2604578.0,6,28,9195,16,3843,173638.53333333333,1514.0,240.1875,12,5352,213762.7272727273,1514.0,446.0
2010616.0,17,4,525,2,150,0.0,75.0,75.0,2,375,0.0,284.0,187.5
228147.0,17,2,180,1,90,0.0,90.0,90.0,1,90,0.0,90.0,90.0
108109265.0,17,5,1005,5,1005,27027316.25,201.0,201.0,0,0,0.0,0.0,0.0
2312494.0,6,47,23596,24,19731,100543.21739130437,1514.0,822.125,23,3865,95446.63636363635,1514.0,168.04347826086956
65337.99999999999,6,10,2032,5,524,15881.0,252.0,104.8,5,1508,10805.75,1236.0,301.6
3280.0,17,2,224,1,76,0.0,76.0,76.0,1,148,0.0,148.0,148.0
41741.0,6,10,2032,5,524,10020.5,252.0,104.8,5,1508,10177.0,1236.0,301.6
2797921.0,6,2,132,1,66,0.0,66.0,66.0,1,66,0.0,66.0,66.0
5621114.0,6,5,336,2,134,0.0,68.0,67.0,3,202,1526346.0,70.0,67.33333333333333
5628197.0,6,5,336,2,134,0.0,68.0,67.0,3,202,1527831.5,70.0,67.33333333333333
107468.0,17,2,286,2,286,0.0,143.0,143.0,0,0,0.0,0.0,0.0
304945.0,6,3,202,2,128,0.0,74.0,64.0,1,74,0.0,74.0,74.0
41811.0,6,10,2032,5,524,9020.75,252.0,104.8,5,1508,9873.5,1236.0,301.6
372.0,17,2,267,1,83,0.0,83.0,83.0,1,184,0.0,184.0,184.0
59254385.0,17,9,3086,8,2736,5178556.571428572,342.0,342.0,1,350,0.0,350.0,350.0
207397.0,6,3,426,2,280,0.0,214.0,140.0,1,146,0.0,146.0,146.0
92312236.0,17,12,778,6,389,18400153.6,174.0,64.83333333333333,6,389,18400869.6,174.0,64.83333333333333
42576.0,6,14,4740,7,653,6971.0,249.0,93.28571428571428,7,4087,6477.666666666667,1514.0,583.8571428571429
4378.0,17,2,614,1,72,0.0,72.0,72.0,1,542,0.0,542.0,542.0
228180.0,17,2,180,1,90,0.0,90.0,90.0,1,90,0.0,90.0,90.0
93215163.0,6,27,2073,15,1138,6657844.714285715,95.0,75.86666666666666,12,935,8473614.636363637,95.0,77.91666666666667
32762.0,6,10,2032,5,524,7990.75,252.0,104.8,5,1508,7562.75,1236.0,301.6
10559064.0,6,7,478,4,272,3473985.0,74.0,68.0,3,206,5210893.0,74.0,68.66666666666667
108112926.0,17,5,1005,5,1005,27028231.5,201.0,201.0,0,0,0.0,0.0,0.0
6556.0,17,4,823,2,163,0.0,89.0,81.5,2,660,0.0,443.0,330.0
26958.0,6,14,4740,7,653,3830.8333333333335,249.0,93.28571428571428,7,4087,4348.333333333333,1514.0,583.8571428571429
303231.0,6,2,132,1,66,0.0,66.0,66.0,1,66,0.0,66.0,66.0
236063.0,6,3,337,2,214,0.0,160.0,107.0,1,123,0.0,123.0,123.0
318468.0,17,4,1400,4,1400,106156.0,350.0,350.0,0,0,0.0,0.0,0.0
251111.0,6,3,337,2,214,0.0,160.0,107.0,1,123,0.0,123.0,123.0
3054663.0,6,3,204,2,136,0.0,70.0,68.0,1,68,0.0,68.0,68.0
119213.0,17,4,1400,4,1400,39737.66666666666,350.0,350.0,0,0,0.0,0.0,0.0
119552684.0,6,225,25484,112,7688,1069604.3963963964,140.0,68.64285714285714,113,17796,1067403.3214285714,284.0,157.4867256637168
76456.0,17,2,762,2,762,0.0,381.0,381.0,0,0,0.0,0.0,0.0
51152.0,17,2,180,1,90,0.0,90.0,90.0,1,90,0.0,90.0,90.0
14283.0,6,10,1065,5,534,3263.0,262.0,106.8,5,531,2888.75,259.0,106.2
23855.0,17,2,582,1,83,0.0,83.0,83.0,1,499,0.0,499.0,499.0
15049.0,6,14,4740,7,653,2364.0,249.0,93.28571428571428,7,4087,2369.5,1514.0,583.8571428571429
120002778.0,6,18,1341,9,691,14999989.625,95.0,76.77777777777777,9,650,14998677.125,95.0,72.22222222222223
1320900.0,6,4,264,2,132,0.0,66.0,66.0,2,132,0.0,66.0,66.0
161055.0,17,2,180,1,90,0.0,90.0,90.0,1,90,0.0,90.0,90.0
90014797.0,17,28,13364,28,13364,3333881.3703703703,501.0,477.2857142857143,0,0,0.0,0.0,0.0
205835.0,17,2,180,1,90,0.0,90.0,90.0,1,90,0.0,90.0,90.0
90074068.0,17,28,13364,28,13364,3336076.592592593,501.0,477.2857142857143,0,0,0.0,0.0,0.0
215768.0,6,3,426,2,280,0.0,214.0,140.0,1,146,0.0,146.0,146.0
18124.0,17,2,180,1,90,0.0,90.0,90.0,1,90,0.0,90.0,90.0
2849189.0,6,3,204,2,136,0.0,70.0,68.0,1,68,0.0,68.0,68.0
254842.0,6,10,1221,6,636,50968.4,298.0,106.0,4,585,79589.33333333333,379.0,146.25
275430.0,6,12,1373,7,714,45905.0,298.0,102.0,5,659,64809.0,379.0,131.8
2492.0,17,4,344,2,150,0.0,75.0,75.0,2,194,0.0,103.0,97.0
47731.0,6,14,4740,7,653,6197.0,249.0,93.28571428571428,7,4087,7372.5,1514.0,583.8571428571429
233174.0,6,3,373,2,238,0.0,172.0,119.0,1,135,0.0,135.0,135.0
0.0,17,1,381,1,381,0.0,381.0,381.0,0,0,0.0,0.0,0.0
10467458.0,6,7,478,4,272,3441911.6666666665,74.0,68.0,3,206,5162781.0,74.0,68.66666666666667
6402.0,17,4,344,2,150,0.0,75.0,75.0,2,194,0.0,103.0,97.0
107412571.0,6,24,2151,13,1352,8950084.5,256.0,104.0,11,799,10740242.1,95.0,72.63636363636364
323.0,17,2,174,1,79,0.0,79.0,79.0,1,95,0.0,95.0,95.0
135125220.0,17,6,1146,6,1146,27025044.0,191.0,191.0,0,0,0.0,0.0,0.0
302246.0,6,6,412,4,272,100748.66666666669,74.0,68.0,2,140,0.0,74.0,70.0
143925.0,17,2,180,1,90,0.0,90.0,90.0,1,90,0.0,90.0,90.0
1851.0,17,2,176,1,80,0.0,80.0,80.0,1,96,0.0,96.0,96.0
257809.0,6,3,373,2,238,0.0,172.0,119.0,1,135,0.0,135.0,135.0
104017.0,17,2,286,2,286,0.0,143.0,143.0,0,0,0.0,0.0,0.0
2331.0,17,4,344,2,150,0.0,75.0,75.0,2,194,0.0,103.0,97.0
2420.0,17,4,344,2,150,0.0,75.0,75.0,2,194,0.0,103.0,97.0
128013469.0,6,31,2034,16,1086,8534231.266666668,123.0,67.875,15,948,8415230.07142857,123.0,63.2
90012538.0,17,28,13364,28,13364,3333797.703703704,501.0,477.2857142857143,0,0,0.0,0.0,0.0
105006839.0,17,13,821,7,432,17501139.833333332,174.0,61.71428571428572,6,389,17000164.2,174.0,64.83333333333333
2407.0,17,4,344,2,150,0.0,75.0,75.0,2,194,0.0,103.0,97.0
95028764.0,6,664,119494,330,22224,288841.22796352586,214.0,67.34545454545454,334,97270,282271.3423423424,1514.0,291.22754491017963
120117318.0,6,16,2368,7,1164,20019553.0,204.0,166.28571428571428,9,1204,14994510.625,188.0,133.77777777777777
2793397.0,6,2,132,1,66,0.0,66.0,66.0,1,66,0.0,66.0,66.0
2019.0,17,4,344,2,150,0.0,75.0,75.0,2,194,0.0,103.0,97.0
0.0,17,1,55,1,55,0.0,55.0,55.0,0,0,0.0,0.0,0.0
90253783.0,6,12,1832,8,1016,12893397.57142857,188.0,127.0,4,816,30030625.0,204.0,204.0
2965827.0,6,3,1602,2,850,0.0,784.0,425.0,1,752,0.0,752.0,752.0
148447.0,6,3,337,2,214,0.0,160.0,107.0,1,123,0.0,123.0,123.0
119008005.0,17,13,821,7,432,19834667.5,174.0,61.71428571428572,6,389,19629212.2,174.0,64.83333333333333
160286.0,6,2,128,1,74,0.0,74.0,74.0,1,54,0.0,54.0,54.0
10484894.0,6,6,412,3,206,5173934.5,74.0,68.66666666666667,3,206,5173806.0,74.0,68.66666666666667
890.0,17,4,438,2,148,0.0,74.0,74.0,2,290,0.0,147.0,145.0
108113438.0,17,5,1005,5,1005,27028359.5,201.0,201.0,0,0,0.0,0.0,0.0
108103597.0,17,5,1005,5,1005,27025899.25,201.0,201.0,0,0,0.0,0.0,0.0
113617982.0,6,48,3168,24,1584,4935782.521739131,66.0,66.0,24,1584,4939792.869565218,66.0,66.0
47826.0,6,14,4740,7,653,7825.666666666667,249.0,93.28571428571428,7,4087,7234.0,1514.0,583.8571428571429
2359.0,17,4,344,2,150,0.0,75.0,75.0,2,194,0.0,103.0,97.0
108113799.0,17,5,1005,5,1005,27028449.75,201.0,201.0,0,0,0.0,0.0,0.0
203492.0,17,4,1524,4,1524,67830.66666666667,381.0,381.0,0,0,0.0,0.0,0.0
300140.0,6,6,412,4,272,100046.66666666669,74.0,68.0,2,140,0.0,74.0,70.0
135123281.0,17,6,1206,6,1206,27024656.2,201.0,201.0,0,0,0.0,0.0,0.0
0.0,17,1,55,1,55,0.0,55.0,55.0,0,0,0.0,0.0,0.0
100866697.0,6,25,1692,13,906,8387575.833333333,123.0,69.6923076923077,12,786,9149959.909090908,123.0,65.5
24032.0,6,11,1133,6,602,4218.4,264.0,100.33333333333331,5,531,4865.25,259.0,106.2
196951.0,17,2,180,1,90,0.0,90.0,90.0,1,90,0.0,90.0,90.0
107706.0,17,2,286,2,286,0.0,143.0,143.0,0,0,0.0,0.0,0.0
110193.0,17,2,286,2,286,0.0,143.0,143.0,0,0,0.0,0.0,0.0
100175003.0,17,13,821,7,432,16695833.833333334,174.0,61.71428571428572,6,389,19940897.0,174.0,64.83333333333333
1095548.0,6,13,1386,7,789,182591.3333333333,253.0,112.71428571428572,6,597,218194.2,259.0,99.5
20264.0,17,2,582,1,83,0.0,83.0,83.0,1,499,0.0,499.0,499.0
216788.0,6,3,426,2,280,0.0,214.0,140.0,1,146,0.0,146.0,146.0
90024363.0,17,28,13364,28,13364,3334235.6666666665,501.0,477.2857142857143,0,0,0.0,0.0,0.0
31489.000000000004,6,14,4740,7,653,3191.1666666666665,249.0,93.28571428571428,7,4087,5026.0,1514.0,583.8571428571429
135131320.0,17,6,1206,6,1206,27026264.0,201.0,201.0,0,0,0.0,0.0,0.0
206477.0,17,2,180,1,90,0.0,90.0,90.0,1,90,0.0,90.0,90.0
48279.0,6,10,2032,5,524,11793.5,252.0,104.8,5,1508,10950.75,1236.0,301.6
90032211.0,17,28,13364,28,13364,3334526.333333333,501.0,477.2857142857143,0,0,0.0,0.0,0.0
303143.0,6,2,132,1,66,0.0,66.0,66.0,1,66,0.0,66.0,66.0
116251612.0,6,31,2166,16,1149,7735721.4,123.0,71.8125,15,1017,8288275.0,123.0,67.8
90029738.0,17,27,12943,27,12943,3462682.230769231,501.0,479.3703703703704,0,0,0.0,0.0,0.0
120050512.0,17,29,13785,29,13785,4287518.285714285,501.0,475.3448275862069,0,0,0.0,0.0,0.0
302562.0,6,6,412,4,272,100854.0,74.0,68.0,2,140,0.0,74.0,70.0
54931.0,6,10,2032,5,524,13069.0,252.0,104.8,5,1508,9713.0,1236.0,301.6
120531545.0,17,14,864,7,432,16833492.0,174.0,61.71428571428572,7,432,16834856.5,174.0,61.71428571428572
90044287.0,17,27,12943,27,12943,3463241.8076923075,501.0,479.3703703703704,0,0,0.0,0.0,0.0
17602.0,6,10,2032,5,524,4159.75,252.0,104.8,5,1508,4088.25,1236.0,301.6
252197.0,6,3,373,2,238,0.0,172.0,119.0,1,135,0.0,135.0,135.0
62747137.0,6,8,1307,8,1307,8963876.714285715,172.0,163.375,0,0,0.0,0.0,0.0
108109881.0,17,5,1005,5,1005,27027470.25,201.0,201.0,0,0,0.0,0.0,0.0
143920.0,17,2,180,1,90,0.0,90.0,90.0,1,90,0.0,90.0,90.0
22362.0,6,14,4740,7,653,3478.5,249.0,93.28571428571428,7,4087,3294.6666666666665,1514.0,583.8571428571429
204673.0,6,10,1221,6,636,40934.6,298.0,106.0,4,585,66936.66666666667,379.0,146.25
10954.0,6,10,1067,5,536,2570.25,264.0,107.2,5,531,2283.0,259.0,106.2
118028548.0,6,30,1974,15,1026,8415180.642857144,123.0,68.4,15,948,8415186.714285715,123.0,63.2
3560227.0,6,183,151119,106,141735,33906.92380952381,1510.0,1337.122641509434,77,9384,42798.19736842105,1510.0,121.87012987012989
110118107.0,6,30,2106,15,1017,7865579.071428572,123.0,67.8,15,1089,7303157.142857143,123.0,72.6
4045667.0,17,12,3235,12,3235,367787.9090909091,382.0,269.5833333333333,0,0,0.0,0.0,0.0
39408.0,6,14,4740,7,653,6447.333333333333,249.0,93.28571428571428,7,4087,5376.666666666667,1514.0,583.8571428571429
90034156.0,17,28,13364,28,13364,3334598.3703703703,501.0,477.2857142857143,0,0,0.0,0.0,0.0
88255.0,6,14,4740,7,653,14590.0,249.0,93.28571428571428,7,4087,13365.333333333334,1514.0,583.8571428571429
90264714.0,6,12,1832,8,1016,12894959.142857144,188.0,127.0,4,816,30024072.666666668,204.0,204.0
107497.0,17,2,762,2,762,0.0,381.0,381.0,0,0,0.0,0.0,0.0
110531.0,17,2,286,2,286,0.0,143.0,143.0,0,0,0.0,0.0,0.0
24217.0,6,14,4740,7,653,3076.6666666666665,249.0,93.28571428571428,7,4087,3904.6666666666665,1514.0,583.8571428571429
108579.0,17,4,6056,4,6056,36193.0,1514.0,1514.0,0,0,0.0,0.0,0.0
2594530.0,6,2,132,1,66,0.0,66.0,66.0,1,66,0.0,66.0,66.0
3249563.0,6,7,923,4,753,1014677.6666666666,571.0,188.25,3,170,1522191.0,62.0,56.66666666666666
231103.0,6,3,426,2,280,0.0,214.0,140.0,1,146,0.0,146.0,146.0
15537.0,6,11,1133,6,602,2896.0,264.0,100.33333333333331,5,531,3161.25,259.0,106.2
58310.0,6,10,2032,5,524,14344.5,252.0,104.8,5,1508,13519.75,1236.0,301.6
492.00000000000006,17,2,508,2,508,0.0,257.0,254.0,0,0,0.0,0.0,0.0
17802.0,17,4,823,2,163,0.0,89.0,81.5,2,660,0.0,443.0,330.0
305006.0,6,6,412,4,272,101668.66666666669,74.0,68.0,2,140,0.0,74.0,70.0
5626044.0,6,5,336,2,134,0.0,68.0,67.0,3,202,1521885.0,70.0,67.33333333333333
27071699.0,6,27,11887,13,2073,2255974.9166666665,408.0,159.46153846153845,14,9814,1814671.6153846155,1514.0,701.0
249357.0,6,3,337,2,214,0.0,160.0,107.0,1,123,0.0,123.0,123.0
330655.0,17,4,1400,4,1400,110218.33333333331,350.0,350.0,0,0,0.0,0.0,0.0
108813.0,17,4,1400,4,1400,36271.0,350.0,350.0,0,0,0.0,0.0,0.0
300665.0,6,6,412,4,272,100221.66666666669,74.0,68.0,2,140,0.0,74.0,70.0
30454.0,6,14,4740,7,653,4618.0,249.0,93.28571428571428,7,4087,4934.333333333333,1514.0,583.8571428571429
839954.0,6,9,1118,6,586,167990.8,248.0,97.66666666666669,3,532,283730.0,392.0,177.33333333333334
90290987.0,6,16,1192,8,596,12892039.857142856,95.0,74.5,8,596,12897888.714285716,95.0,74.5
107000.0,17,2,286,2,286,0.0,143.0,143.0,0,0,0.0,0.0,0.0
40473.0,6,10,2032,5,524,9852.25,252.0,104.8,5,1508,8777.75,1236.0,301.6
35430.0,6,14,4740,7,653,5635.666666666667,249.0,93.28571428571428,7,4087,5234.5,1514.0,583.8571428571429
729.0,17,4,438,2,148,0.0,74.0,74.0,2,290,0.0,147.0,145.0
27664474.0,17,5,1710,5,1710,6916118.5,342.0,342.0,0,0,0.0,0.0,0.0
301930.0,6,6,412,4,272,100643.33333333331,74.0,68.0,2,140,0.0,74.0,70.0
36416.0,6,10,2032,5,524,8873.75,252.0,104.8,5,1508,8777.5,1236.0,301.6
123551984.0,6,48,3168,24,1584,4936989.0869565215,66.0,66.0,24,1584,5371814.565217392,66.0,66.0
204410.0,17,2,762,2,762,0.0,381.0,381.0,0,0,0.0,0.0,0.0
97959.0,17,2,762,2,762,0.0,381.0,381.0,0,0,0.0,0.0,0.0
37459.0,6,10,2032,5,524,9022.0,252.0,104.8,5,1508,8456.0,1236.0,301.6
120398778.0,6,249,28020,125,19614,970957.8870967742,284.0,156.912,124,8406,970541.024390244,140.0,67.79032258064517
711182.0,6,10,1065,5,534,177304.0,262.0,106.8,5,531,177503.0,259.0,106.2
6822.0,17,2,180,1,90,0.0,90.0,90.0,1,90,0.0,90.0,90.0
205607.0,17,2,762,2,762,0.0,381.0,381.0,0,0,0.0,0.0,0.0
106094694.0,6,32,2236,16,1165,7058579.066666666,139.0,72.8125,16,1071,7058573.333333333,123.0,66.9375
389235.0,17,2,363,1,75,0.0,75.0,75.0,1,288,0.0,288.0,288.0
228099.0,17,2,180,1,90,0.0,90.0,90.0,1,90,0.0,90.0,90.0
90033193.0,17,28,13364,28,13364,3334562.703703704,501.0,477.2857142857143,0,0,0.0,0.0,0.0
315713.0,6,6,412,4,272,105237.66666666669,74.0,68.0,2,140,0.0,74.0,70.0
0.0,6,1,66,1,66,0.0,66.0,66.0,0,0,0.0,0.0,0.0
3025015.0,6,12,2172,7,664,504077.3333333333,252.0,94.85714285714286,5,1508,2378.5,1236.0,301.6
57949.0,6,14,4740,7,653,7917.333333333333,249.0,93.28571428571428,7,4087,9525.833333333334,1514.0,583.8571428571429
1826.0,17,2,192,1,88,0.0,88.0,88.0,1,104,0.0,104.0,104.0
0.0,17,1,342,1,342,0.0,342.0,342.0,0,0,0.0,0.0,0.0
5829460.0,6,5,336,2,134,0.0,68.0,67.0,3,202,1524567.0,70.0,67.33333333333333
4489.0,17,2,626,1,72,0.0,72.0,72.0,1,554,0.0,554.0,554.0
206362.0,6,3,426,2,280,0.0,214.0,140.0,1,146,0.0,146.0,146.0
120047985.0,6,250,28118,125,8546,961523.6854838708,140.0,68.368,125,19572,961343.1612903224,300.0,156.576
1241318.0,6,7,499,3,198,613791.0,66.0,66.0,4,301,386208.3333333333,103.0,75.25
71178.0,6,14,4740,7,653,11706.333333333334,249.0,93.28571428571428,7,4087,11673.833333333334,1514.0,583.8571428571429
105558.0,17,2,286,2,286,0.0,143.0,143.0,0,0,0.0,0.0,0.0
108117270.0,17,5,1005,5,1005,27029317.5,201.0,201.0,0,0,0.0,0.0,0.0
305611.0,6,6,412,4,272,101870.33333333331,74.0,68.0,2,140,0.0,74.0,70.0
307317.0,6,6,412,4,272,102439.0,74.0,68.0,2,140,0.0,74.0,70.0
120035916.0,17,28,13364,28,13364,4445774.666666667,501.0,477.2857142857143,0,0,0.0,0.0,0.0
37979.0,6,10,2032,5,524,9246.25,252.0,104.8,5,1508,8853.5,1236.0,301.6
27809.0,6,14,4740,7,653,4173.166666666667,249.0,93.28571428571428,7,4087,4493.833333333333,1514.0,583.8571428571429
362757.0,6,11,1021,6,444,49043.4,162.0,74.0,5,577,60778.0,349.0,115.4
228167.0,17,2,180,1,90,0.0,90.0,90.0,1,90,0.0,90.0,90.0
134023247.0,17,15,1169,7,563,18991827.5,174.0,80.42857142857143,8,606,19123476.14285714,174.0,75.75
306595.0,6,6,412,4,272,102198.33333333331,74.0,68.0,2,140,0.0,74.0,70.0
114172.0,17,2,286,2,286,0.0,143.0,143.0,0,0,0.0,0.0,0.0
5624953.0,6,4,270,2,134,0.0,68.0,67.0,2,136,0.0,70.0,68.0
135136099.0,17,6,1146,6,1146,27027219.8,191.0,191.0,0,0,0.0,0.0,0.0
57531.0,6,14,4740,7,653,9322.0,249.0,93.28571428571428,7,4087,8511.666666666666,1514.0,583.8571428571429
106710.0,17,2,700,2,700,0.0,350.0,350.0,0,0,0.0,0.0,0.0
2795668.0,6,2,132,1,66,0.0,66.0,66.0,1,66,0.0,66.0,66.0
120068582.0,17,28,13364,28,13364,4446984.518518519,501.0,477.2857142857143,0,0,0.0,0.0,0.0
217100.0,17,2,180,1,90,0.0,90.0,90.0,1,90,0.0,90.0,90.0
143908.0,17,2,180,1,90,0.0,90.0,90.0,1,90,0.0,90.0,90.0
246143.0,6,3,337,2,214,0.0,160.0,107.0,1,123,0.0,123.0,123.0
27459206.0,17,5,1710,5,1710,6864801.5,342.0,342.0,0,0,0.0,0.0,0.0
321151.0,17,4,1400,4,1400,107050.33333333331,350.0,350.0,0,0,0.0,0.0,0.0
74649428.0,6,9,842,9,842,9331178.5,97.0,93.55555555555556,0,0,0.0,0.0,0.0
3012483.0,6,13,1467,7,870,501543.8333333333,271.0,124.28571428571428,6,597,2873.2,259.0,99.5
1242470.0,6,7,499,3,198,613984.5,66.0,66.0,4,301,407858.3333333333,103.0,75.25
14089.0,6,2,132,1,66,0.0,66.0,66.0,1,66,0.0,66.0,66.0
144050.0,17,2,180,1,90,0.0,90.0,90.0,1,90,0.0,90.0,90.0
11341820.0,17,4,1368,4,1368,3780606.6666666665,342.0,342.0,0,0,0.0,0.0,0.0
39098.0,6,14,4740,7,653,6004.5,249.0,93.28571428571428,7,4087,6255.5,1514.0,583.8571428571429
90286982.0,6,19,1436,10,745,10027009.333333334,95.0,74.5,9,691,11285523.25,95.0,76.77777777777777
44209.0,6,14,4740,7,653,6507.833333333333,249.0,93.28571428571428,7,4087,7087.333333333333,1514.0,583.8571428571429
16194.0,17,2,180,1,90,0.0,90.0,90.0,1,90,0.0,90.0,90.0
12794.0,6,10,1067,5,536,3003.75,264.0,107.2,5,531,2812.0,259.0,106.2
1617643.0,17,6,1230,3,234,808637.5,78.0,78.0,3,996,808625.5,332.0,332.0
49954.0,6,14,4740,7,653,7676.666666666667,249.0,93.28571428571428,7,4087,7904.166666666667,1514.0,583.8571428571429
106757.0,17,2,286,2,286,0.0,143.0,143.0,0,0,0.0,0.0,0.0
43520.0,6,10,2032,5,524,10645.0,252.0,104.8,5,1508,9037.0,1236.0,301.6
43385.0,6,10,2032,5,524,8920.5,252.0,104.8,5,1508,8457.75,1236.0,301.6
205870.0,17,2,180,1,90,0.0,90.0,90.0,1,90,0.0,90.0,90.0
37005.0,6,10,2032,5,524,8738.25,252.0,104.8,5,1508,6944.25,1236.0,301.6
90042625.0,17,28,13364,28,13364,3334912.037037037,501.0,477.2857142857143,0,0,0.0,0.0,0.0
107520.0,17,2,286,2,286,0.0,143.0,143.0,0,0,0.0,0.0,0.0
112189583.0,6,44,2904,22,1452,5342361.095238095,66.0,66.0,22,1452,5329375.857142857,66.0,66.0
2265.0,17,4,344,2,150,0.0,75.0,75.0,2,194,0.0,103.0,97.0
108105539.0,17,5,1005,5,1005,27026384.75,201.0,201.0,0,0,0.0,0.0,0.0
155558.0,6,3,337,2,214,0.0,160.0,107.0,1,123,0.0,123.0,123.0
60791.0,6,14,4740,7,653,10005.333333333334,249.0,93.28571428571428,7,4087,9232.666666666666,1514.0,583.8571428571429
2786798.0,6,2,132,1,66,0.0,66.0,66.0,1,66,0.0,66.0,66.0
10475604.0,6,7,478,4,272,3445076.0,74.0,68.0,3,206,5167495.5,74.0,68.66666666666667
241939.0,6,3,337,2,214,0.0,160.0,107.0,1,123,0.0,123.0,123.0
13493.0,6,10,2032,5,524,2551.0,252.0,104.8,5,1508,3128.0,1236.0,301.6
117144078.0,17,14,864,7,432,19500189.33333333,174.0,61.71428571428572,7,432,19501465.5,174.0,61.71428571428572
111349.0,17,4,1400,4,1400,37116.333333333336,350.0,350.0,0,0,0.0,0.0,0.0
135131368.0,17,6,1146,6,1146,27026273.6,191.0,191.0,0,0,0.0,0.0,0.0
317032.0,17,4,1400,4,1400,105677.33333333331,350.0,350.0,0,0,0.0,0.0,0.0
474.0,17,2,166,1,75,0.0,75.0,75.0,1,91,0.0,91.0,91.0
352422.0,6,3,202,2,128,0.0,74.0,64.0,1,74,0.0,74.0,74.0
3808.0,17,4,344,2,150,0.0,75.0,75.0,2,194,0.0,103.0,97.0
9278.0,6,10,1067,5,536,2058.25,264.0,107.2,5,531,1958.75,259.0,106.2
237727.0,17,2,180,1,90,0.0,90.0,90.0,1,90,0.0,90.0,90.0
29740.0,6,10,2032,5,524,7199.25,252.0,104.8,5,1508,7109.75,1236.0,301.6
108100436.0,17,5,1005,5,1005,27025109.0,201.0,201.0,0,0,0.0,0.0,0.0
283771.0,17,2,363,1,79,0.0,79.0,79.0,1,284,0.0,284.0,284.0
16744.0,6,10,1932,5,480,3777.5,252.0,96.0,5,1452,3770.0,1224.0,290.4
39542.0,6,10,2032,5,524,9240.0,252.0,104.8,5,1508,9377.75,1236.0,301.6
118279.0,17,4,1400,4,1400,39426.333333333336,350.0,350.0,0,0,0.0,0.0,0.0
5241.0,17,2,762,2,762,0.0,381.0,381.0,0,0,0.0,0.0,0.0
303407.0,6,6,412,4,272,101135.66666666669,74.0,68.0,2,140,0.0,74.0,70.0
305.0,17,2,174,1,79,0.0,79.0,79.0,1,95,0.0,95.0,95.0
56010.0,6,14,4740,7,653,7079.833333333333,249.0,93.28571428571428,7,4087,8462.166666666666,1514.0,583.8571428571429
959.0,17,2,508,2,508,0.0,257.0,254.0,0,0,0.0,0.0,0.0
1282870.0,17,7,490,7,490,213811.66666666663,70.0,70.0,0,0,0.0,0.0,0.0
18394.0,6,10,2032,5,524,4362.75,252.0,104.8,5,1508,4293.5,1236.0,301.6
146321.0,6,3,337,2,214,0.0,160.0,107.0,1,123,0.0,123.0,123.0
48824.0,6,14,4740,7,653,7974.666666666667,249.0,93.28571428571428,7,4087,7770.166666666667,1514.0,583.8571428571429
213440.0,6,10,1221,6,636,42688.0,298.0,106.0,4,585,70039.66666666667,379.0,146.25
120002813.0,6,18,1341,9,650,15000351.625,95.0,72.22222222222223,9,691,14967566.125,95.0,76.77777777777777
146092.0,6,3,337,2,214,0.0,160.0,107.0,1,123,0.0,123.0,123.0
90015727.0,17,28,13364,28,13364,3333915.814814815,501.0,477.2857142857143,0,0,0.0,0.0,0.0
45690.0,6,14,4740,7,653,7482.666666666667,249.0,93.28571428571428,7,4087,6055.833333333333,1514.0,583.8571428571429
2079.0,17,4,344,2,150,0.0,75.0,75.0,2,194,0.0,103.0,97.0
204659.0,6,10,1221,6,636,40931.8,298.0,106.0,4,585,66909.33333333333,379.0,146.25
53747.0,6,10,2032,5,524,7649.25,252.0,104.8,5,1508,13158.75,1236.0,301.6
10464596.0,6,7,478,4,272,3440862.6666666665,74.0,68.0,3,206,5161212.0,74.0,68.66666666666667
111587220.0,6,32,2236,16,1165,7439148.0,139.0,72.8125,16,1071,7424729.866666666,123.0,66.9375
90031864.0,17,28,13364,28,13364,3334513.4814814813,501.0,477.2857142857143,0,0,0.0,0.0,0.0
108191217.0,6,44,2904,22,1452,5151962.714285715,66.0,66.0,22,1452,5137263.666666667,66.0,66.0
90287993.0,6,16,1192,8,596,12891294.42857143,95.0,74.5,8,596,12897894.714285716,95.0,74.5
127346372.0,6,34,2350,17,1125,7478536.0,123.0,66.17647058823529,17,1225,7959028.0,139.0,72.05882352941177
5005373.0,17,4,629,2,156,0.0,78.0,78.0,2,473,0.0,268.0,236.5
120001382.0,6,17,1287,9,691,15000172.75,95.0,76.77777777777777,8,596,12857153.857142856,95.0,74.5
41666.0,6,14,4740,7,653,3897.3333333333335,249.0,93.28571428571428,7,4087,6602.166666666667,1514.0,583.8571428571429
43830.0,6,14,4740,7,653,6715.833333333333,249.0,93.28571428571428,7,4087,6683.666666666667,1514.0,583.8571428571429
10434935.0,6,6,412,3,206,5149229.0,74.0,68.66666666666667,3,206,5149108.5,74.0,68.66666666666667
113520066.0,6,46,3036,23,1518,5159991.227272728,66.0,66.0,23,1518,5159991.5,66.0,66.0
303667.0,6,2,132,1,66,0.0,66.0,66.0,1,66,0.0,66.0,66.0
104480404.0,6,32,2220,16,1149,6950970.666666667,123.0,71.8125,16,1071,6950972.0,123.0,66.9375
12964.0,6,13,1459,7,862,2160.6666666666665,271.0,123.14285714285714,6,597,2070.8,259.0,99.5
26982.0,6,14,4740,7,653,3586.6666666666665,249.0,93.28571428571428,7,4087,4265.0,1514.0,583.8571428571429
328.0,17,2,160,1,80,0.0,80.0,80.0,1,80,0.0,80.0,80.0
96663258.0,6,186,20982,93,6360,1041835.8152173914,140.0,68.38709677419355,93,14622,1041706.75,284.0,157.2258064516129
90035838.0,17,28,13364,28,13364,3334660.6666666665,501.0,477.2857142857143,0,0,0.0,0.0,0.0
34727779.0,6,5,336,2,134,0.0,68.0,67.0,3,202,17292281.5,70.0,67.33333333333333
2357.0,17,4,344,2,150,0.0,75.0,75.0,2,194,0.0,103.0,97.0
305037.0,6,6,412,4,272,101679.0,74.0,68.0,2,140,0.0,74.0,70.0
135142591.0,17,6,1146,6,1146,27028518.2,191.0,191.0,0,0,0.0,0.0,0.0
120127350.0,6,14,2224,9,1204,15015918.75,188.0,133.77777777777777,5,1020,22523961.25,204.0,204.0
2411.0,17,4,344,2,150,0.0,75.0,75.0,2,194,0.0,103.0,97.0
55465797.0,17,11,10934,11,10934,5546579.7,994.0,994.0,0,0,0.0,0.0,0.0
2906583.0,6,155,123334,87,114544,33797.476744186046,1510.0,1316.5977011494251,68,8790,38898.07462686567,1510.0,129.26470588235293
225007.0,6,10,1221,6,636,45001.4,298.0,106.0,4,585,73768.66666666667,379.0,146.25
2798560.0,6,2,132,1,66,0.0,66.0,66.0,1,66,0.0,66.0,66.0
216494.0,17,2,180,1,90,0.0,90.0,90.0,1,90,0.0,90.0,90.0
90392820.0,6,25,1686,13,840,7532735.0,123.0,64.61538461538461,12,846,7289976.181818182,123.0,70.5
2669892.0,6,25,7573,14,3735,205376.3076923077,1514.0,266.7857142857143,11,3838,241150.6,1514.0,348.90909090909093
10465493.0,6,7,478,4,272,3443004.6666666665,74.0,68.0,3,206,5164386.0,74.0,68.66666666666667
90948928.0,6,23,1734,13,989,7575296.166666667,95.0,76.07692307692308,10,745,10099783.555555556,95.0,74.5
146214.0,6,3,337,2,214,0.0,160.0,107.0,1,123,0.0,123.0,123.0
147956.0,17,2,180,1,90,0.0,90.0,90.0,1,90,0.0,90.0,90.0
2049486.0,17,6,1230,3,234,1024558.5,78.0,78.0,3,996,1024534.0,332.0,332.0
31859.0,6,14,4740,7,653,5177.0,249.0,93.28571428571428,7,4087,5115.0,1514.0,583.8571428571429
62077.0,6,14,4740,7,653,10165.666666666666,249.0,93.28571428571428,7,4087,9981.333333333334,1514.0,583.8571428571429
17484.0,6,11,1133,6,602,3392.4,264.0,100.33333333333331,5,531,4015.75,259.0,106.2
321.0,17,2,174,1,79,0.0,79.0,79.0,1,95,0.0,95.0,95.0
28441.0,6,10,2032,5,524,6653.0,252.0,104.8,5,1508,6710.0,1236.0,301.6
90095207.0,6,10,1440,7,828,15015867.833333334,188.0,118.28571428571428,3,612,30025638.0,204.0,204.0
2983.0,17,2,224,1,76,0.0,76.0,76.0,1,148,0.0,148.0,148.0
13163.0,6,11,1132,6,556,2431.0,218.0,92.66666666666669,5,576,2673.5,304.0,115.2
120121277.0,6,16,2368,9,1204,14994701.875,188.0,133.77777777777777,7,1164,15012830.0,204.0,166.28571428571428
103003.0,17,2,762,2,762,0.0,381.0,381.0,0,0,0.0,0.0,0.0
90717.0,6,2,132,1,66,0.0,66.0,66.0,1,66,0.0,66.0,66.0
153501.0,17,2,180,1,90,0.0,90.0,90.0,1,90,0.0,90.0,90.0
108109754.0,17,5,955,5,955,27027438.5,191.0,191.0,0,0,0.0,0.0,0.0
127713243.0,6,32,2157,16,1071,7848525.866666666,123.0,66.9375,16,1086,8514091.733333332,123.0,67.875
33670.0,6,11,2098,6,590,6387.2,252.0,98.33333333333331,5,1508,7553.25,1236.0,301.6
154524.0,17,2,432,1,86,0.0,86.0,86.0,1,346,0.0,346.0,346.0
105165404.0,17,14,864,7,432,17500621.333333332,174.0,61.71428571428572,7,432,17500162.833333332,174.0,61.71428571428572
115067981.0,6,32,2220,16,1149,7656812.533333333,123.0,71.8125,16,1071,7656809.533333333,123.0,66.9375
90090613.0,6,11,1644,7,828,15015102.166666666,188.0,118.28571428571428,4,816,20021092.666666668,204.0,204.0
14645818.0,6,20,1607,10,975,1592753.6666666667,315.0,97.5,10,632,1592780.4444444445,78.0,63.2
41513.0,6,14,4740,7,653,6557.5,249.0,93.28571428571428,7,4087,6673.5,1514.0,583.8571428571429
111677568.0,6,44,2904,22,1452,5317979.428571428,66.0,66.0,22,1452,5302138.571428572,66.0,66.0
111749.0,17,2,286,2,286,0.0,143.0,143.0,0,0,0.0,0.0,0.0
90288552.0,6,16,1192,8,596,12892153.714285716,95.0,74.5,8,596,12896516.857142856,95.0,74.5
90020313.0,17,28,13364,28,13364,3334085.6666666665,501.0,477.2857142857143,0,0,0.0,0.0,0.0
44413.0,6,2,132,1,66,0.0,66.0,66.0,1,66,0.0,66.0,66.0
9305.0,17,2,582,1,83,0.0,83.0,83.0,1,499,0.0,499.0,499.0
124860749.0,17,14,995,8,606,17837249.85714286,174.0,75.75,6,389,20076009.2,174.0,64.83333333333333
90024129.0,17,28,13364,28,13364,3334227.0,501.0,477.2857142857143,0,0,0.0,0.0,0.0
25436.0,6,14,4740,7,653,4089.6666666666665,249.0,93.28571428571428,7,4087,4099.0,1514.0,583.8571428571429
456731.0,6,3,1604,2,851,0.0,785.0,425.5,1,753,0.0,753.0,753.0
2295.0,17,4,344,2,150,0.0,75.0,75.0,2,194,0.0,103.0,97.0
142236.0,17,4,704,2,148,0.0,74.0,74.0,2,556,0.0,280.0,278.0
19949.0,17,2,582,1,83,0.0,83.0,83.0,1,499,0.0,499.0,499.0
128676.0,17,4,1400,4,1400,42892.0,350.0,350.0,0,0,0.0,0.0,0.0
128721704.0,17,14,864,7,432,18167378.166666668,174.0,61.71428571428572,7,432,18166826.666666668,174.0,61.71428571428572
102678431.0,17,14,864,7,432,17001672.5,174.0,61.71428571428572,7,432,17000161.666666668,174.0,61.71428571428572
154890.0,6,3,337,2,214,0.0,160.0,107.0,1,123,0.0,123.0,123.0
108092605.0,17,5,1005,5,1005,27023151.25,201.0,201.0,0,0,0.0,0.0,0.0
826.0,17,4,438,2,148,0.0,74.0,74.0,2,290,0.0,147.0,145.0
209415.0,17,2,180,1,90,0.0,90.0,90.0,1,90,0.0,90.0,90.0
879.0,17,4,438,2,148,0.0,74.0,74.0,2,290,0.0,147.0,145.0
218009.0,6,3,426,2,280,0.0,214.0,140.0,1,146,0.0,146.0,146.0
99054.0,6,12,1328,7,797,16509.0,253.0,113.85714285714286,5,531,23038.25,259.0,106.2
41848.0,6,10,2032,5,524,10266.75,252.0,104.8,5,1508,2913.5,1236.0,301.6
109138.0,17,2,286,2,286,0.0,143.0,143.0,0,0,0.0,0.0,0.0
90228562.0,6,24,1829,11,840,8997640.2,95.0,76.36363636363636,13,989,7501054.25,95.0,76.07692307692308
322505.0,6,6,412,4,272,107501.66666666669,74.0,68.0,2,140,0.0,74.0,70.0
38729.0,6,10,2032,5,524,9449.75,252.0,104.8,5,1508,8479.75,1236.0,301.6
15680.0,6,10,2032,5,524,3653.75,252.0,104.8,5,1508,3467.25,1236.0,301.6
218037.0,6,3,426,2,280,0.0,214.0,140.0,1,146,0.0,146.0,146.0
349.0,17,2,267,1,83,0.0,83.0,83.0,1,184,0.0,184.0,184.0
250302.00000000003,6,3,337,2,214,0.0,160.0,107.0,1,123,0.0,123.0,123.0
204605.0,17,2,762,2,762,0.0,381.0,381.0,0,0,0.0,0.0,0.0
228258.0,17,2,180,1,90,0.0,90.0,90.0,1,90,0.0,90.0,90.0
108106179.0,17,5,1005,5,1005,27026544.75,201.0,201.0,0,0,0.0,0.0,0.0
104968.0,17,2,286,2,286,0.0,143.0,143.0,0,0,0.0,0.0,0.0
103504.0,17,2,286,2,286,0.0,143.0,143.0,0,0,0.0,0.0,0.0
117336747.0,6,273,32268,137,9264,862770.1985294118,140.0,67.62043795620438,136,23004,861595.925925926,284.0,169.14705882352942
25220.0,17,4,823,2,163,0.0,89.0,81.5,2,660,0.0,443.0,330.0
90050849.0,17,28,13364,28,13364,3335216.6296296297,501.0,477.2857142857143,0,0,0.0,0.0,0.0
29925.0,6,14,4740,7,653,4870.833333333333,249.0,93.28571428571428,7,4087,3996.0,1514.0,583.8571428571429
232894.0,6,3,337,2,214,0.0,160.0,107.0,1,123,0.0,123.0,123.0
120378578.0,6,231,26166,116,18354,1046770.2434782608,284.0,158.22413793103448,115,7812,1047868.903508772,140.0,67.9304347826087
34473.0,6,13,1479,7,882,5745.5,291.0,126.0,6,597,6377.8,259.0,99.5
10514807.0,6,7,478,4,272,3458084.6666666665,74.0,68.0,3,206,5187017.5,74.0,68.66666666666667
1303919.0,6,4,264,2,132,0.0,66.0,66.0,2,132,0.0,66.0,66.0
1186238.0,6,13,3003,8,2375,169462.57142857142,1514.0,296.875,5,628,227617.75,331.0,125.6
6475.0,17,4,823,2,163,0.0,89.0,81.5,2,660,0.0,443.0,330.0
10816.0,17,2,684,2,684,0.0,342.0,342.0,0,0,0.0,0.0,0.0
2411.0,17,4,344,2,150,0.0,75.0,75.0,2,194,0.0,103.0,97.0
944929.0,6,12,1354,6,723,188048.2,253.0,120.5,6,631,187743.4,293.0,105.16666666666669
197016.0,17,2,180,1,90,0.0,90.0,90.0,1,90,0.0,90.0,90.0
501715.0,6,5,336,2,134,0.0,68.0,67.0,3,202,191804.0,70.0,67.33333333333333
319.0,17,2,174,1,79,0.0,79.0,79.0,1,95,0.0,95.0,95.0
2415.0,17,4,344,2,150,0.0,75.0,75.0,2,194,0.0,103.0,97.0
146278.0,6,3,337,2,214,0.0,160.0,107.0,1,123,0.0,123.0,123.0
90304066.0,6,16,1192,8,596,12893537.42857143,95.0,74.5,8,596,12899279.285714284,95.0,74.5
2314.0,17,4,344,2,150,0.0,75.0,75.0,2,194,0.0,103.0,97.0
24646.0,6,20,7606,11,978,2464.6,310.0,88.9090909090909,9,6628,2882.25,1514.0,736.4444444444445
3004055.0,6,11,2106,6,598,600608.6,252.0,99.66666666666669,5,1508,1856.25,1236.0,301.6
12014752.0,17,3,1026,3,1026,6007376.0,342.0,342.0,0,0,0.0,0.0,0.0
120124027.0,6,13,2020,9,1204,15015503.375,188.0,133.77777777777777,4,816,30030472.0,204.0,204.0
107579.0,17,2,286,2,286,0.0,143.0,143.0,0,0,0.0,0.0,0.0
120050756.0,17,28,13364,28,13364,4446324.296296297,501.0,477.2857142857143,0,0,0.0,0.0,0.0
94488177.0,17,12,778,6,389,18801645.8,174.0,64.83333333333333,6,389,18800154.4,174.0,64.83333333333333
23359.0,6,11,2098,6,590,4560.2,252.0,98.33333333333331,5,1508,5530.75,1236.0,301.6
108105354.0,17,5,1005,5,1005,27026338.5,201.0,201.0,0,0,0.0,0.0,0.0
158073.0,6,3,337,2,214,0.0,160.0,107.0,1,123,0.0,123.0,123.0
222147.0,17,2,180,1,90,0.0,90.0,90.0,1,90,0.0,90.0,90.0
113964825.0,6,48,3168,24,1584,4954992.391304348,66.0,66.0,24,1584,4941514.565217392,66.0,66.0
188160.0,6,11,1131,6,600,37353.6,262.0,100.0,5,531,2594.75,259.0,106.2
228605.0,17,2,180,1,90,0.0,90.0,90.0,1,90,0.0,90.0,90.0
135129729.0,17,6,1146,6,1146,27025945.8,191.0,191.0,0,0,0.0,0.0,0.0
213614.0,17,2,180,1,90,0.0,90.0,90.0,1,90,0.0,90.0,90.0
1490225.0,17,16,1120,16,1120,99348.33333333331,70.0,70.0,0,0,0.0,0.0,0.0
2305.0,17,4,344,2,150,0.0,75.0,75.0,2,194,0.0,103.0,97.0
307358.0,6,6,412,4,272,102452.66666666669,74.0,68.0,2,140,0.0,74.0,70.0
281745.0,17,2,363,1,79,0.0,79.0,79.0,1,284,0.0,284.0,284.0
443438.0,17,2,240,1,88,0.0,88.0,88.0,1,152,0.0,152.0,152.0
2348.0,17,4,344,2,150,0.0,75.0,75.0,2,194,0.0,103.0,97.0
102940.0,17,2,286,2,286,0.0,143.0,143.0,0,0,0.0,0.0,0.0
2290.0,17,4,344,2,150,0.0,75.0,75.0,2,194,0.0,103.0,97.0
207459.0,6,3,426,2,280,0.0,214.0,140.0,1,146,0.0,146.0,146.0
108702376.0,6,32,2220,16,1149,7246825.066666666,123.0,71.8125,16,1071,7232385.0,123.0,66.9375
27489.0,6,14,4740,7,653,4432.333333333333,249.0,93.28571428571428,7,4087,4443.5,1514.0,583.8571428571429
218072.0,6,3,426,2,280,0.0,214.0,140.0,1,146,0.0,146.0,146.0
281285.0,17,2,363,1,79,0.0,79.0,79.0,1,284,0.0,284.0,284.0
90090497.0,6,10,1440,7,828,15015082.833333334,188.0,118.28571428571428,3,612,30028914.5,204.0,204.0
18131.0,6,10,2032,5,524,4196.25,252.0,104.8,5,1508,4327.5,1236.0,301.6
99006165.0,17,11,735,6,389,19801233.0,174.0,64.83333333333333,5,346,19750154.0,174.0,69.2
305089.0,6,10,1221,6,636,61017.8,298.0,106.0,4,585,95857.33333333331,379.0,146.25
120124910.0,6,13,2036,5,1020,30031227.5,204.0,204.0,8,1016,17137197.285714287,188.0,127.0
1171909.0,6,13,3000,8,2372,167415.57142857142,1514.0,296.5,5,628,224063.75,331.0,125.6
105073673.0,6,44,2904,22,1452,5003508.238095238,66.0,66.0,22,1452,4988985.714285715,66.0,66.0
303097.0,6,2,132,1,66,0.0,66.0,66.0,1,66,0.0,66.0,66.0
103908588.0,6,44,2904,22,1452,4948028.0,66.0,66.0,22,1452,4935057.0,66.0,66.0
91306058.0,6,23,1775,12,935,8296859.909090909,95.0,77.91666666666667,11,840,9129965.0,95.0,76.36363636363636
153469.0,17,2,180,1,90,0.0,90.0,90.0,1,90,0.0,90.0,90.0
26271.0,6,10,2032,5,524,6329.25,252.0,104.8,5,1508,5846.5,1236.0,301.6
2395530.0,6,3,1604,2,851,0.0,785.0,425.5,1,753,0.0,753.0,753.0
90038624.0,17,28,13364,28,13364,3334763.851851852,501.0,477.2857142857143,0,0,0.0,0.0,0.0
10534043.0,6,7,478,4,272,3464205.333333333,74.0,68.0,3,206,5196210.5,74.0,68.66666666666667
119365222.0,17,35,16705,35,16705,3510741.823529412,501.0,477.2857142857143,0,0,0.0,0.0,0.0
122418.0,6,3,373,2,238,0.0,172.0,119.0,1,135,0.0,135.0,135.0
312303.0,17,4,1400,4,1400,104101.0,350.0,350.0,0,0,0.0,0.0,0.0
45135.0,6,14,4740,7,653,7299.0,249.0,93.28571428571428,7,4087,7380.166666666667,1514.0,583.8571428571429
108102948.0,17,5,1005,5,1005,27025737.0,201.0,201.0,0,0,0.0,0.0,0.0
10093.0,17,2,582,1,83,0.0,83.0,83.0,1,499,0.0,499.0,499.0
30350.0,6,10,2032,5,524,7226.75,252.0,104.8,5,1508,6035.75,1236.0,301.6
18692387.0,6,23,7554,13,1707,1557698.9166666667,408.0,131.30769230769232,10,5847,1850105.6666666667,1514.0,584.7
307793.0,6,6,412,4,272,102597.66666666669,74.0,68.0,2,140,0.0,74.0,70.0
116283010.0,6,32,2220,16,1149,7737799.133333334,123.0,71.8125,16,1071,7737801.666666667,123.0,66.9375
5620772.0,6,5,336,2,134,0.0,68.0,67.0,3,202,1421209.5,70.0,67.33333333333333
307916.0,6,6,412,4,272,102638.66666666669,74.0,68.0,2,140,0.0,74.0,70.0
29093.0,6,14,4740,7,653,4723.5,249.0,93.28571428571428,7,4087,4472.0,1514.0,583.8571428571429
383.0,17,2,166,1,75,0.0,75.0,75.0,1,91,0.0,91.0,91.0
26283.0,6,14,4740,7,653,3857.5,249.0,93.28571428571428,7,4087,4160.333333333333,1514.0,583.8571428571429
235099.0,6,3,337,2,214,0.0,160.0,107.0,1,123,0.0,123.0,123.0
93202073.0,6,160,18202,80,12700,1177047.164556962,374.0,158.75,80,5502,1177047.7721518988,140.0,68.775
90032516.0,17,28,13364,28,13364,3334537.6296296297,501.0,477.2857142857143,0,0,0.0,0.0,0.0
109085819.0,6,215,24140,108,7424,1019493.6355140188,140.0,68.74074074074075,107,16716,1020395.3113207548,284.0,156.22429906542055
243637.0,17,4,1524,4,1524,81212.33333333333,381.0,381.0,0,0,0.0,0.0,0.0
5623539.0,6,5,336,2,134,0.0,68.0,67.0,3,202,1521620.5,70.0,67.33333333333333
45394.0,6,14,4740,7,653,7404.666666666667,249.0,93.28571428571428,7,4087,7270.333333333333,1514.0,583.8571428571429
109597908.0,6,30,2122,15,1105,7813006.428571428,139.0,73.66666666666667,15,1017,7813001.357142857,123.0,67.8
16869.0,17,2,180,1,90,0.0,90.0,90.0,1,90,0.0,90.0,90.0
30860.0,6,13,1386,7,789,4938.666666666667,253.0,112.71428571428572,6,597,4809.0,259.0,99.5
120118861.0,6,14,2240,8,1016,17136667.85714286,188.0,127.0,6,1224,18017931.8,204.0,204.0
115668651.0,6,262,29546,131,8942,889720.4769230769,140.0,68.25954198473282,131,20604,883442.4384615384,284.0,157.2824427480916
178197.0,17,2,180,1,90,0.0,90.0,90.0,1,90,0.0,90.0,90.0
42412.0,6,14,4740,7,653,6769.333333333333,249.0,93.28571428571428,7,4087,6544.166666666667,1514.0,583.8571428571429
10470304.0,6,7,478,4,272,3443471.6666666665,74.0,68.0,3,206,5165099.5,74.0,68.66666666666667
63433.0,6,14,4740,7,653,9728.0,249.0,93.28571428571428,7,4087,10017.166666666666,1514.0,583.8571428571429
17720.0,6,14,4740,7,653,2827.333333333333,249.0,93.28571428571428,7,4087,2777.1666666666665,1514.0,583.8571428571429
30113.0,6,10,2032,5,524,7246.25,252.0,104.8,5,1508,6690.25,1236.0,301.6
107827784.0,6,31,2182,16,1165,7174130.466666667,139.0,72.8125,15,1017,7686558.214285715,123.0,67.8
1440.0,17,2,762,2,762,0.0,381.0,381.0,0,0,0.0,0.0,0.0
20572.0,6,10,2032,5,524,4917.0,252.0,104.8,5,1508,4898.5,1236.0,301.6
107065854.0,6,32,2220,16,1149,7123322.266666667,123.0,71.8125,16,1071,7123323.6,123.0,66.9375
109246941.0,6,207,23358,104,16264,1060649.912621359,284.0,156.3846153846154,103,7094,1060882.196078431,140.0,68.87378640776699
2805573.0,6,2,132,1,66,0.0,66.0,66.0,1,66,0.0,66.0,66.0
345576.0,6,10,1221,6,636,69115.2,298.0,106.0,4,585,114199.0,379.0,146.25
90255453.0,6,16,2368,9,1204,11281931.625,188.0,133.77777777777777,7,1164,15015443.5,204.0,166.28571428571428
1501.0,17,5,550,5,550,375.25,110.0,110.0,0,0,0.0,0.0,0.0
21464.0,17,2,582,1,83,0.0,83.0,83.0,1,499,0.0,499.0,499.0
166760.0,17,2,180,1,90,0.0,90.0,90.0,1,90,0.0,90.0,90.0
96990256.0,6,179,20250,90,14154,1089778.1573033708,284.0,157.26666666666668,89,6096,1090270.2840909092,140.0,68.49438202247191
12655.0,6,13,1459,7,862,2024.6666666666667,271.0,123.14285714285714,6,597,2358.4,259.0,99.5
121664.0,6,3,337,2,214,0.0,160.0,107.0,1,123,0.0,123.0,123.0
0.0,17,1,55,1,55,0.0,55.0,55.0,0,0,0.0,0.0,0.0
99884715.0,17,10,561,5,346,20122904.0,174.0,69.2,5,215,20002047.75,43.0,43.0
89.0,17,2,762,2,762,0.0,381.0,381.0,0,0,0.0,0.0,0.0
90260260.0,6,13,2036,8,1016,12894322.857142856,188.0,127.0,5,1020,22524200.0,204.0,204.0
304976.0,17,4,1524,4,1524,101658.66666666669,381.0,381.0,0,0,0.0,0.0,0.0
119732908.0,17,17,1517,9,780,14966613.5,174.0,86.66666666666667,8,737,16575855.0,174.0,92.125
3864.0,17,4,344,2,150,0.0,75.0,75.0,2,194,0.0,103.0,97.0
106520.0,17,2,286,2,286,0.0,143.0,143.0,0,0,0.0,0.0,0.0
236726.0,6,3,337,2,214,0.0,160.0,107.0,1,123,0.0,123.0,123.0
488443.0,6,3,204,2,136,0.0,70.0,68.0,1,68,0.0,68.0,68.0
110700876.0,6,30,1990,15,1042,7891800.571428572,139.0,69.46666666666667,15,948,7891799.642857143,123.0,63.2
33682.0,6,13,4416,6,409,6580.2,127.0,68.16666666666667,7,4007,5451.666666666667,1514.0,572.4285714285714
38199.0,6,14,4740,7,653,5511.333333333333,249.0,93.28571428571428,7,4087,6231.833333333333,1514.0,583.8571428571429
208282.0,6,3,426,2,280,0.0,214.0,140.0,1,146,0.0,146.0,146.0
107019270.0,6,198,22330,99,6756,1083489.1224489796,140.0,68.24242424242425,99,15574,1083942.387755102,284.0,157.31313131313132
44100.0,6,14,4740,7,653,7106.833333333333,249.0,93.28571428571428,7,4087,7214.166666666667,1514.0,583.8571428571429
19558.0,6,14,4740,7,653,3101.0,249.0,93.28571428571428,7,4087,2862.0,1514.0,583.8571428571429
107253.0,17,2,286,2,286,0.0,143.0,143.0,0,0,0.0,0.0,0.0
57362.0,6,14,4740,7,653,8354.333333333334,249.0,93.28571428571428,7,4087,8988.833333333334,1514.0,583.8571428571429
5005798.0,17,4,629,2,156,0.0,78.0,78.0,2,473,0.0,268.0,236.5
5003.0,17,2,762,2,762,0.0,381.0,381.0,0,0,0.0,0.0,0.0
299435.0,6,6,412,4,272,99811.66666666669,74.0,68.0,2,140,0.0,74.0,70.0
59065.0,6,14,4740,7,653,9178.833333333334,249.0,93.28571428571428,7,4087,9706.333333333334,1514.0,583.8571428571429
4603526.0,6,5,336,2,134,0.0,68.0,67.0,3,202,1522065.5,70.0,67.33333333333333
146181.0,6,3,337,2,214,0.0,160.0,107.0,1,123,0.0,123.0,123.0
131536.0,6,3,337,2,214,0.0,160.0,107.0,1,123,0.0,123.0,123.0
27626982.0,17,5,1710,5,1710,6906745.5,342.0,342.0,0,0,0.0,0.0,0.0
2072.0,17,4,344,2,150,0.0,75.0,75.0,2,194,0.0,103.0,97.0
112522624.0,17,14,864,7,432,18666841.166666668,174.0,61.71428571428572,7,432,18668003.33333333,174.0,61.71428571428572
309.0,17,2,174,1,79,0.0,79.0,79.0,1,95,0.0,95.0,95.0
120181929.0,6,223,25028,112,7688,1082720.0810810812,140.0,68.64285714285714,111,17340,1085783.9181818182,284.0,156.21621621621622
32964.0,6,14,4740,7,653,5317.833333333333,249.0,93.28571428571428,7,4087,5284.5,1514.0,583.8571428571429
207590.0,6,10,1221,6,636,41518.0,298.0,106.0,4,585,68132.33333333333,379.0,146.25
205865.0,17,2,762,2,762,0.0,381.0,381.0,0,0,0.0,0.0,0.0
0.0,6,1,66,1,66,0.0,66.0,66.0,0,0,0.0,0.0,0.0
90256077.0,6,12,1832,8,1016,12893725.285714284,188.0,127.0,4,816,30029891.0,204.0,204.0
99148.0,6,13,1386,7,789,16524.666666666668,253.0,112.71428571428572,6,597,17323.0,259.0,99.5
168471.0,17,2,414,1,88,0.0,88.0,88.0,1,326,0.0,326.0,326.0
126011396.0,17,15,907,8,475,18001628.0,174.0,59.375,7,432,17666836.666666668,174.0,61.71428571428572
149050.0,6,3,337,2,214,0.0,160.0,107.0,1,123,0.0,123.0,123.0
131715.0,6,2,132,1,66,0.0,66.0,66.0,1,66,0.0,66.0,66.0
90256452.0,6,14,2240,8,1016,12893778.857142856,188.0,127.0,6,1224,18018727.0,204.0,204.0
115005600.0,17,13,821,7,432,19167600.0,174.0,61.71428571428572,6,389,19000175.0,174.0,64.83333333333333
2593396.0,6,2,132,1,66,0.0,66.0,66.0,1,66,0.0,66.0,66.0
205726.0,17,2,180,1,90,0.0,90.0,90.0,1,90,0.0,90.0,90.0
21521.0,17,2,582,1,83,0.0,83.0,83.0,1,499,0.0,499.0,499.0
104699558.0,6,44,2904,22,1452,4985693.238095238,66.0,66.0,22,1452,4970724.19047619,66.0,66.0
310535.0,17,4,1400,4,1400,103511.66666666669,350.0,350.0,0,0,0.0,0.0,0.0
228460.0,17,2,180,1,90,0.0,90.0,90.0,1,90,0.0,90.0,90.0
90368352.0,6,12,1848,5,1020,22591352.25,204.0,204.0,7,828,15060908.0,188.0,118.28571428571428
10453371.0,6,7,478,4,272,3438842.6666666665,74.0,68.0,3,206,5158175.5,74.0,68.66666666666667
5618648.0,6,5,336,2,134,0.0,68.0,67.0,3,202,1524053.0,70.0,67.33333333333333
2026.0,17,4,344,2,150,0.0,75.0,75.0,2,194,0.0,103.0,97.0
37318.0,6,10,2032,5,524,9122.5,252.0,104.8,5,1508,9107.0,1236.0,301.6
324356.0,6,6,412,4,272,108118.66666666669,74.0,68.0,2,140,0.0,74.0,70.0
120074331.0,17,28,13364,28,13364,4447197.444444444,501.0,477.2857142857143,0,0,0.0,0.0,0.0
299.0,17,2,164,1,82,0.0,82.0,82.0,1,82,0.0,82.0,82.0
123418526.0,6,48,3168,24,1584,4951370.260869565,66.0,66.0,24,1584,5350991.956521739,66.0,66.0
856361.0,6,9,1268,6,797,171272.2,459.0,132.83333333333334,3,471,290582.0,331.0,157.0
5720458.0,6,5,336,2,134,0.0,68.0,67.0,3,202,1525096.5,70.0,67.33333333333333
31131.0,6,14,4740,7,653,4892.0,249.0,93.28571428571428,7,4087,5056.166666666667,1514.0,583.8571428571429
224392.0,6,3,426,2,280,0.0,214.0,140.0,1,146,0.0,146.0,146.0
93541715.0,6,22,1798,10,904,10393523.888888888,213.0,90.4,12,894,8476356.454545455,95.0,74.5
236930.0,17,2,180,1,90,0.0,90.0,90.0,1,90,0.0,90.0,90.0
108451461.0,17,14,864,7,432,18001759.0,174.0,61.71428571428572,7,432,18000167.333333332,174.0,61.71428571428572
153382.0,17,2,180,1,90,0.0,90.0,90.0,1,90,0.0,90.0,90.0
103399.0,17,2,286,2,286,0.0,143.0,143.0,0,0,0.0,0.0,0.0
341258.0,6,10,1102,5,570,85030.0,298.0,114.0,5,532,84973.5,260.0,106.4
1669306.0,6,7,499,3,198,818769.5,66.0,66.0,4,301,497955.0,103.0,75.25
45396.0,6,14,4740,7,653,7268.833333333333,249.0,93.28571428571428,7,4087,6975.5,1514.0,583.8571428571429
120631.0,6,3,337,2,214,0.0,160.0,107.0,1,123,0.0,123.0,123.0
93825293.0,6,168,18996,84,5778,1120635.2771084337,140.0,68.78571428571429,84,13218,1108163.7951807228,284.0,157.35714285714286
24156.0,6,10,2032,5,524,5824.5,252.0,104.8,5,1508,5310.25,1236.0,301.6
3239403.0,6,178,143321,100,133871,32721.242424242424,1510.0,1338.71,78,9450,38047.81818181818,1510.0,121.15384615384616
1479.0,17,2,762,2,762,0.0,381.0,381.0,0,0,0.0,0.0,0.0
117843421.0,6,44,3714,25,2067,4910142.541666667,123.0,82.68,19,1647,6535363.277777778,123.0,86.6842105263158
144861.0,17,2,180,1,70,0.0,70.0,70.0,1,110,0.0,110.0,110.0
538819.0,17,6,2100,6,2100,107763.8,350.0,350.0,0,0,0.0,0.0,0.0
104160256.0,6,44,2904,22,1452,4960012.19047619,66.0,66.0,22,1452,4945044.619047619,66.0,66.0
108111206.0,17,5,1005,5,1005,27027801.5,201.0,201.0,0,0,0.0,0.0,0.0
209563.0,17,2,180,1,90,0.0,90.0,90.0,1,90,0.0,90.0,90.0
56401.0,6,10,2032,5,524,13872.0,252.0,104.8,5,1508,12886.75,1236.0,301.6
111307691.0,6,206,23250,103,16230,1089141.862745098,300.0,157.5728155339806,103,7020,1089142.0098039217,140.0,68.15533980582525
148350.0,17,2,414,1,88,0.0,88.0,88.0,1,326,0.0,326.0,326.0
829.0,17,4,438,2,148,0.0,74.0,74.0,2,290,0.0,147.0,145.0
216899.0,6,3,426,2,280,0.0,214.0,140.0,1,146,0.0,146.0,146.0
1162864.0,6,13,3010,8,2382,166123.42857142858,1514.0,297.75,5,628,221711.5,331.0,125.6
10194.0,17,4,823,2,163,0.0,89.0,81.5,2,660,0.0,443.0,330.0
844.0,17,4,438,2,148,0.0,74.0,74.0,2,290,0.0,147.0,145.0
48625864.0,6,8,1940,3,887,22915323.5,753.0,295.6666666666667,5,1053,11513053.25,785.0,210.6
120000142.0,6,25,1924,14,1084,9230780.153846154,95.0,77.42857142857143,11,840,9047171.5,95.0,76.36363636363636
54909.0,6,10,2032,5,524,13396.75,252.0,104.8,5,1508,10543.25,1236.0,301.6
135128797.0,17,6,1206,6,1206,27025759.4,201.0,201.0,0,0,0.0,0.0,0.0
95544981.0,17,12,778,6,389,19076982.4,174.0,64.83333333333333,6,389,19082678.4,174.0,64.83333333333333
108110915.0,17,5,1005,5,1005,27027728.75,201.0,201.0,0,0,0.0,0.0,0.0
299739.0,6,6,412,4,272,99913.0,74.0,68.0,2,140,0.0,74.0,70.0
10978.0,17,4,344,2,150,0.0,75.0,75.0,2,194,0.0,103.0,97.0
108106612.0,17,5,1005,5,1005,27026653.0,201.0,201.0,0,0,0.0,0.0,0.0
253081.0,6,14,4740,7,653,42056.16666666666,249.0,93.28571428571428,7,4087,41994.0,1514.0,583.8571428571429
1303976.0,17,7,490,7,490,217329.3333333333,70.0,70.0,0,0,0.0,0.0,0.0
303426.0,6,3,202,2,128,0.0,74.0,64.0,1,74,0.0,74.0,74.0
120136618.0,6,14,2224,9,1204,15017077.25,188.0,133.77777777777777,5,1020,22590836.25,204.0,204.0
37859.0,6,10,2032,5,524,9238.75,252.0,104.8,5,1508,8750.25,1236.0,301.6
120592.0,6,3,337,2,214,0.0,160.0,107.0,1,123,0.0,123.0,123.0
114616348.0,6,48,3168,24,1584,4983319.478260869,66.0,66.0,24,1584,4971471.347826087,66.0,66.0
2800949.0,6,2,132,1,66,0.0,66.0,66.0,1,66,0.0,66.0,66.0
237849.0,6,3,373,2,238,0.0,172.0,119.0,1,135,0.0,135.0,135.0
59482.0,6,14,4740,7,653,9790.5,249.0,93.28571428571428,7,4087,9430.5,1514.0,583.8571428571429
770.0,17,4,438,2,148,0.0,74.0,74.0,2,290,0.0,147.0,145.0
13927425.0,6,20,1607,10,975,1512810.2222222222,315.0,97.5,10,632,1512777.0,78.0,63.2
131889.0,6,2,132,1,66,0.0,66.0,66.0,1,66,0.0,66.0,66.0
300467.0,6,6,412,4,272,100155.66666666669,74.0,68.0,2,140,0.0,74.0,70.0
244166.0,17,4,1524,4,1524,81388.66666666667,381.0,381.0,0,0,0.0,0.0,0.0
177401.0,17,4,344,2,150,0.0,75.0,75.0,2,194,0.0,103.0,97.0
165970.0,17,2,180,1,90,0.0,90.0,90.0,1,90,0.0,90.0,90.0
249988.0,17,2,180,1,90,0.0,90.0,90.0,1,90,0.0,90.0,90.0
28867.0,6,14,4740,7,653,4675.333333333333,249.0,93.28571428571428,7,4087,4679.0,1514.0,583.8571428571429
44886693.0,17,9,3086,8,2736,5108866.428571428,342.0,342.0,1,350,0.0,350.0,350.0
2328.0,17,4,344,2,150,0.0,75.0,75.0,2,194,0.0,103.0,97.0
357.0,17,2,300,1,80,0.0,80.0,80.0,1,220,0.0,220.0,220.0
48621.0,6,14,4740,7,653,7984.333333333333,249.0,93.28571428571428,7,4087,5416.5,1514.0,583.8571428571429
309159.0,6,3,202,2,128,0.0,74.0,64.0,1,74,0.0,74.0,74.0
376.0,17,2,160,1,80,0.0,80.0,80.0,1,80,0.0,80.0,80.0
5961.0,17,2,239,1,82,0.0,82.0,82.0,1,157,0.0,157.0,157.0
15802750.0,6,24,8675,13,1719,1316895.8333333333,408.0,132.23076923076923,11,6956,1175839.4,1514.0,632.3636363636364
318764.0,6,10,1221,6,636,63752.8,298.0,106.0,4,585,105379.66666666669,379.0,146.25
98814.0,17,2,762,2,762,0.0,381.0,381.0,0,0,0.0,0.0,0.0
23837.0,6,10,2032,5,524,5640.75,252.0,104.8,5,1508,3910.0,1236.0,301.6
204966.0,17,2,762,2,762,0.0,381.0,381.0,0,0,0.0,0.0,0.0
306721.0,17,2,180,1,90,0.0,90.0,90.0,1,90,0.0,90.0,90.0
146103.0,6,3,337,2,214,0.0,160.0,107.0,1,123,0.0,123.0,123.0
2555262.0,6,5,367,2,132,0.0,66.0,66.0,3,235,1277631.0,103.0,78.33333333333333
113265118.0,6,46,3036,23,1518,5135895.545454546,66.0,66.0,23,1518,5135865.818181818,66.0,66.0
15178.0,6,13,1459,7,862,2529.6666666666665,271.0,123.14285714285714,6,597,2563.8,259.0,99.5
121152653.0,6,218,24646,109,7490,1104678.9444444445,140.0,68.71559633027523,109,17156,1115211.5648148148,284.0,157.39449541284404
34102.0,6,10,2032,5,524,8282.5,252.0,104.8,5,1508,8251.5,1236.0,301.6
171976.0,17,2,180,1,90,0.0,90.0,90.0,1,90,0.0,90.0,90.0
354.0,17,2,166,1,75,0.0,75.0,75.0,1,91,0.0,91.0,91.0
157874.0,17,2,180,1,90,0.0,90.0,90.0,1,90,0.0,90.0,90.0
279658.0,6,12,1373,7,714,46609.66666666666,298.0,102.0,5,659,65555.5,379.0,131.8
119678569.0,6,380,46588,190,33752,632075.2116402116,464.0,177.6421052631579,190,12836,632081.4232804233,140.0,67.5578947368421
120054765.0,17,29,13785,29,13785,4287670.178571428,501.0,475.3448275862069,0,0,0.0,0.0,0.0
495395.0,6,5,336,2,134,0.0,68.0,67.0,3,202,193392.0,70.0,67.33333333333333
23039220.0,17,3,1034,2,684,0.0,342.0,342.0,1,350,0.0,350.0,350.0
1321476.0,6,4,264,2,132,0.0,66.0,66.0,2,132,0.0,66.0,66.0
243697.0,6,3,337,2,214,0.0,160.0,107.0,1,123,0.0,123.0,123.0
1302664.0,6,4,264,2,132,0.0,66.0,66.0,2,132,0.0,66.0,66.0
26096.0,6,14,4740,7,653,4193.333333333333,249.0,93.28571428571428,7,4087,4106.0,1514.0,583.8571428571429
31238.0,6,10,2032,5,524,6402.25,252.0,104.8,5,1508,7423.5,1236.0,301.6
228151.0,17,2,180,1,90,0.0,90.0,90.0,1,90,0.0,90.0,90.0
206422.0,17,2,180,1,90,0.0,90.0,90.0,1,90,0.0,90.0,90.0
108106431.0,17,5,1005,5,1005,27026607.75,201.0,201.0,0,0,0.0,0.0,0.0
319846.0,17,4,1400,4,1400,106615.33333333331,350.0,350.0,0,0,0.0,0.0,0.0
106209355.0,6,32,2236,16,1165,7065525.2,139.0,72.8125,16,1071,7065529.0,123.0,66.9375
11816.0,6,10,2032,5,524,2736.5,252.0,104.8,5,1508,2675.75,1236.0,301.6
298.0,17,2,164,1,82,0.0,82.0,82.0,1,82,0.0,82.0,82.0
5620406.0,6,4,270,2,134,0.0,68.0,67.0,2,136,0.0,70.0,68.0
298523.0,6,6,412,4,272,99507.66666666669,74.0,68.0,2,140,0.0,74.0,70.0
304071.0,6,6,412,4,272,101357.0,74.0,68.0,2,140,0.0,74.0,70.0
10004.0,6,10,1975,5,467,2239.0,195.0,93.4,5,1508,2230.75,1236.0,301.6
206948.0,6,3,426,2,280,0.0,214.0,140.0,1,146,0.0,146.0,146.0
408.0,17,2,410,1,78,0.0,78.0,78.0,1,332,0.0,332.0,332.0
108105852.0,17,5,1005,5,1005,27026463.0,201.0,201.0,0,0,0.0,0.0,0.0
109055794.0,6,32,2220,16,1149,7255991.6,123.0,71.8125,16,1071,7255995.733333333,123.0,66.9375
149906450.0,17,36,17126,36,17126,4283041.428571428,501.0,475.72222222222223,0,0,0.0,0.0,0.0
117553027.0,6,48,3168,24,1584,5111001.173913044,66.0,66.0,24,1584,5099024.826086956,66.0,66.0
287.0,17,2,168,1,76,0.0,76.0,76.0,1,92,0.0,92.0,92.0
148041.0,17,2,180,1,90,0.0,90.0,90.0,1,90,0.0,90.0,90.0
322160.0,17,4,1400,4,1400,107386.66666666669,350.0,350.0,0,0,0.0,0.0,0.0
97674055.0,17,13,4454,12,4104,6798063.0,342.0,342.0,1,350,0.0,350.0,350.0
994837.0,6,12,1447,6,816,198208.0,291.0,136.0,6,631,197828.4,293.0,105.16666666666669
1299986.0,17,7,490,7,490,216664.3333333333,70.0,70.0,0,0,0.0,0.0,0.0
459197.0,6,3,204,1,68,0.0,68.0,68.0,2,136,0.0,70.0,68.0
135129370.0,17,6,1146,6,1146,27025874.0,191.0,191.0,0,0,0.0,0.0,0.0
107946.0,17,2,700,2,700,0.0,350.0,350.0,0,0,0.0,0.0,0.0
5624776.0,6,4,270,2,134,0.0,68.0,67.0,2,136,0.0,70.0,68.0
18896605.0,17,3,1034,2,684,0.0,342.0,342.0,1,350,0.0,350.0,350.0
1151.0,17,2,202,1,87,0.0,87.0,87.0,1,115,0.0,115.0,115.0
1886958.0,6,4,492,2,280,0.0,214.0,140.0,2,212,0.0,146.0,106.0
135129942.0,17,6,1146,6,1146,27025988.4,191.0,191.0,0,0,0.0,0.0,0.0
103992.0,17,2,286,2,286,0.0,143.0,143.0,0,0,0.0,0.0,0.0
233120.0,6,3,337,2,214,0.0,160.0,107.0,1,123,0.0,123.0,123.0
1054855.0,6,13,1513,7,882,175644.33333333334,291.0,126.0,6,631,210601.6,293.0,105.16666666666669
329.0,17,2,208,1,72,0.0,72.0,72.0,1,136,0.0,136.0,136.0
31825.0,6,14,4740,7,653,4130.5,249.0,93.28571428571428,7,4087,4966.666666666667,1514.0,583.8571428571429
1199255.0,17,7,490,7,490,199875.8333333333,70.0,70.0,0,0,0.0,0.0,0.0
50902.0,17,2,180,1,90,0.0,90.0,90.0,1,90,0.0,90.0,90.0
209408.0,6,3,426,2,280,0.0,214.0,140.0,1,146,0.0,146.0,146.0
153515.0,17,2,180,1,90,0.0,90.0,90.0,1,90,0.0,90.0,90.0
1314573.0,6,4,264,2,132,0.0,66.0,66.0,2,132,0.0,66.0,66.0
37058.0,6,14,4740,7,653,5352.833333333333,249.0,93.28571428571428,7,4087,5948.0,1514.0,583.8571428571429
59979.0,6,14,4740,7,653,9218.0,249.0,93.28571428571428,7,4087,9176.833333333334,1514.0,583.8571428571429
127007773.0,17,15,907,8,475,18143967.57142857,174.0,59.375,7,432,17833509.5,174.0,61.71428571428572
120057919.0,17,28,13364,28,13364,4446589.592592592,501.0,477.2857142857143,0,0,0.0,0.0,0.0
205746.0,17,2,762,2,762,0.0,381.0,381.0,0,0,0.0,0.0,0.0
106064765.0,17,14,1126,7,563,17627976.5,174.0,80.42857142857143,7,563,17650970.5,174.0,80.42857142857143
5048.0,17,2,180,1,90,0.0,90.0,90.0,1,90,0.0,90.0,90.0
782.0,17,4,438,2,148,0.0,74.0,74.0,2,290,0.0,147.0,145.0
90050587.0,17,28,13364,28,13364,3335206.925925926,501.0,477.2857142857143,0,0,0.0,0.0,0.0
108103819.0,17,5,955,5,955,27025954.75,191.0,191.0,0,0,0.0,0.0,0.0
43112.0,6,14,4740,7,653,6558.833333333333,249.0,93.28571428571428,7,4087,6834.0,1514.0,583.8571428571429
90257018.0,6,12,1832,8,1016,12893859.714285716,188.0,127.0,4,816,30030586.0,204.0,204.0
2296.0,17,4,344,2,150,0.0,75.0,75.0,2,194,0.0,103.0,97.0
14834.0,6,10,1065,5,534,3055.75,262.0,106.8,5,531,3383.0,259.0,106.2
91420738.0,6,24,1829,13,989,7615359.666666667,95.0,76.07692307692308,11,840,9140887.8,95.0,76.36363636363636
106216.0,17,2,762,2,762,0.0,381.0,381.0,0,0,0.0,0.0,0.0
122530386.0,6,49,3234,25,1650,5105432.75,66.0,66.0,24,1584,4925382.043478261,66.0,66.0
310033.0,6,6,412,4,272,103344.33333333331,74.0,68.0,2,140,0.0,74.0,70.0
40147.0,6,14,4740,7,653,6499.333333333333,249.0,93.28571428571428,7,4087,6296.333333333333,1514.0,583.8571428571429
864944.0,6,9,1096,6,625,172988.8,287.0,104.16666666666669,3,471,294645.0,331.0,157.0
111277367.0,6,192,21664,96,15106,1169075.505263158,284.0,157.35416666666666,96,6558,1169075.3263157897,140.0,68.3125
387970.0,6,3,202,2,128,0.0,74.0,64.0,1,74,0.0,74.0,74.0
23964.0,6,10,1066,5,490,3304.0,218.0,98.0,5,576,5611.0,304.0,115.2
33703077.0,6,5,336,2,134,0.0,68.0,67.0,3,202,15463349.5,70.0,67.33333333333333
10138.0,17,2,414,1,88,0.0,88.0,88.0,1,326,0.0,326.0,326.0
114904435.0,6,48,3168,24,1584,4995845.0,66.0,66.0,24,1584,4982168.0,66.0,66.0
2796968.0,6,2,132,1,66,0.0,66.0,66.0,1,66,0.0,66.0,66.0
33396.0,6,14,4740,7,653,5447.833333333333,249.0,93.28571428571428,7,4087,5321.5,1514.0,583.8571428571429
106312.0,17,2,286,2,286,0.0,143.0,143.0,0,0,0.0,0.0,0.0
14636762.0,6,20,1607,10,975,1592329.0,315.0,97.5,10,632,1592306.2222222222,78.0,63.2
22053.0,6,14,4740,7,653,3142.5,249.0,93.28571428571428,7,4087,3473.5,1514.0,583.8571428571429
90258426.0,6,12,1832,8,1016,12894060.857142856,188.0,127.0,4,816,30031120.0,204.0,204.0
39283.0,6,14,4740,7,653,6403.666666666667,249.0,93.28571428571428,7,4087,6410.666666666667,1514.0,583.8571428571429
82564.0,6,12,1320,7,789,13760.666666666666,253.0,112.71428571428572,5,531,16126.25,259.0,106.2
151630.0,17,2,414,1,88,0.0,88.0,88.0,1,326,0.0,326.0,326.0
340579.0,6,10,1221,6,636,68115.8,298.0,106.0,4,585,107736.66666666669,379.0,146.25
108106056.0,17,5,1005,5,1005,27026514.0,201.0,201.0,0,0,0.0,0.0,0.0
64612.0,6,14,4740,7,653,10657.5,249.0,93.28571428571428,7,4087,9748.666666666666,1514.0,583.8571428571429
110458002.0,6,36,2596,18,1348,6485504.647058823,139.0,74.88888888888889,18,1248,6485503.352941177,123.0,69.33333333333333
782.0,17,4,438,2,148,0.0,74.0,74.0,2,290,0.0,147.0,145.0
328866.0,6,6,412,4,272,109622.0,74.0,68.0,2,140,0.0,74.0,70.0
108105409.0,17,5,955,5,955,27026352.25,191.0,191.0,0,0,0.0,0.0,0.0
112171154.0,6,211,23802,106,16650,1068296.704761905,284.0,157.0754716981132,105,7152,1068610.2884615385,140.0,68.11428571428571
2339.0,17,4,344,2,150,0.0,75.0,75.0,2,194,0.0,103.0,97.0
109065.0,17,2,286,2,286,0.0,143.0,143.0,0,0,0.0,0.0,0.0
21632.0,17,2,582,1,83,0.0,83.0,83.0,1,499,0.0,499.0,499.0
18983.0,6,20,7606,11,978,1898.3,310.0,88.9090909090909,9,6628,1829.875,1514.0,736.4444444444445
110964024.0,6,34,2482,17,1288,6921764.5,139.0,75.76470588235294,17,1194,6921759.6875,123.0,70.23529411764706
1025873.0,6,11,1134,6,558,205174.6,220.0,93.0,5,576,255993.5,304.0,115.2
10471531.0,6,6,412,3,206,5164728.0,74.0,68.66666666666667,3,206,5164613.0,74.0,68.66666666666667
99777.0,17,2,762,2,762,0.0,381.0,381.0,0,0,0.0,0.0,0.0
119551967.0,6,22,1680,10,745,13283551.888888888,95.0,74.5,12,935,10844297.272727272,95.0,77.91666666666667
108111383.0,17,5,955,5,955,27027845.75,191.0,191.0,0,0,0.0,0.0,0.0
206860.0,6,3,426,2,280,0.0,214.0,140.0,1,146,0.0,146.0,146.0
47480.0,6,14,4740,7,653,7789.666666666667,249.0,93.28571428571428,7,4087,7481.333333333333,1514.0,583.8571428571429
14931.0,6,13,1459,7,862,2242.833333333333,271.0,123.14285714285714,6,597,2774.8,259.0,99.5
2173104.0,6,24,7545,13,2516,181092.0,1034.0,193.53846153846155,11,5029,186276.9,1510.0,457.1818181818182
216653.0,6,3,426,2,280,0.0,214.0,140.0,1,146,0.0,146.0,146.0
90251277.0,6,12,1832,8,1016,12893039.57142857,188.0,127.0,4,816,30028488.0,204.0,204.0
206195.0,6,3,426,2,280,0.0,214.0,140.0,1,146,0.0,146.0,146.0
5627889.0,6,5,336,2,134,0.0,68.0,67.0,3,202,1425511.5,70.0,67.33333333333333
90061002.0,17,28,13364,28,13364,3335592.6666666665,501.0,477.2857142857143,0,0,0.0,0.0,0.0
400491.0,6,3,1604,2,851,0.0,785.0,425.5,1,753,0.0,753.0,753.0
10463371.0,6,7,478,4,272,3442139.333333333,74.0,68.0,3,206,5163091.0,74.0,68.66666666666667
8653.0,17,2,498,1,80,0.0,80.0,80.0,1,418,0.0,418.0,418.0
23481.0,6,10,2032,5,524,5544.0,252.0,104.8,5,1508,5430.0,1236.0,301.6
90293861.0,6,16,1192,8,596,12892118.57142857,95.0,74.5,8,596,12898271.285714284,95.0,74.5
320242.0,17,4,1400,4,1400,106747.33333333331,350.0,350.0,0,0,0.0,0.0,0.0
0.0,17,1,350,1,350,0.0,350.0,350.0,0,0,0.0,0.0,0.0
265162.0,6,10,1221,6,636,53032.4,298.0,106.0,4,585,81808.0,379.0,146.25
100477810.0,6,182,20628,91,14400,1114027.611111111,284.0,158.24175824175825,91,6228,1114027.888888889,140.0,68.43956043956044
120140601.0,6,234,26528,117,7944,1028733.25,140.0,67.8974358974359,117,18584,1028653.025862069,284.0,158.83760683760684
105760567.0,6,44,2904,22,1452,5036217.476190476,66.0,66.0,22,1452,5021251.095238095,66.0,66.0
302341.0,6,6,412,4,272,100780.33333333331,74.0,68.0,2,140,0.0,74.0,70.0
203671.0,17,2,180,1,90,0.0,90.0,90.0,1,90,0.0,90.0,90.0
146100.0,6,3,337,2,214,0.0,160.0,107.0,1,123,0.0,123.0,123.0
317377.0,6,6,412,4,272,105792.33333333331,74.0,68.0,2,140,0.0,74.0,70.0
299573.0,6,6,412,4,272,99857.66666666669,74.0,68.0,2,140,0.0,74.0,70.0
2795347.0,6,2,132,1,66,0.0,66.0,66.0,1,66,0.0,66.0,66.0
101982.0,17,2,762,2,762,0.0,381.0,381.0,0,0,0.0,0.0,0.0
90277406.0,6,16,1192,8,596,12891075.142857144,95.0,74.5,8,596,12896202.0,95.0,74.5
111684.0,17,2,286,2,286,0.0,143.0,143.0,0,0,0.0,0.0,0.0
124998507.0,6,31,2097,16,1149,8333233.8,123.0,71.8125,15,948,8363708.785714285,123.0,63.2
157786.0,17,2,180,1,90,0.0,90.0,90.0,1,90,0.0,90.0,90.0
90260031.0,6,12,1832,8,1016,12894290.142857144,188.0,127.0,4,816,30031485.33333333,204.0,204.0
299817.0,6,6,412,4,272,99939.0,74.0,68.0,2,140,0.0,74.0,70.0
302652.0,6,6,412,4,272,100884.0,74.0,68.0,2,140,0.0,74.0,70.0
90527162.0,6,13,2036,8,1016,12932451.714285716,188.0,127.0,5,1020,22591179.75,204.0,204.0
90219179.0,6,17,1287,8,596,12853494.714285716,95.0,74.5,9,691,11251679.5,95.0,76.77777777777777
106359378.0,6,29,2052,15,1089,7581669.642857143,123.0,72.6,14,963,8164872.923076923,123.0,68.78571428571429
57392.0,6,14,4740,7,653,8757.833333333334,249.0,93.28571428571428,7,4087,8809.666666666666,1514.0,583.8571428571429
98879527.0,6,189,21376,95,14950,1051909.8617021276,284.0,157.3684210526316,94,6426,1040865.6451612904,140.0,68.36170212765957
810.0,17,4,438,2,148,0.0,74.0,74.0,2,290,0.0,147.0,145.0
1302405.0,6,4,264,2,132,0.0,66.0,66.0,2,132,0.0,66.0,66.0
382274.0,6,3,204,1,68,0.0,68.0,68.0,2,136,0.0,70.0,68.0
252114.0,6,3,337,2,214,0.0,160.0,107.0,1,123,0.0,123.0,123.0
32227.0,6,14,4740,7,653,5130.333333333333,249.0,93.28571428571428,7,4087,5218.333333333333,1514.0,583.8571428571429
143950.0,17,2,180,1,90,0.0,90.0,90.0,1,90,0.0,90.0,90.0
16358571.999999998,6,24,7569,13,2049,1363214.3333333333,408.0,157.6153846153846,11,5520,1227447.9,1514.0,501.8181818181818
2098883.0,6,24,7544,12,2450,190807.54545454544,1034.0,204.16666666666663,12,5094,161981.36363636365,1510.0,424.5
217733.0,6,3,426,2,280,0.0,214.0,140.0,1,146,0.0,146.0,146.0
2339.0,17,4,344,2,150,0.0,75.0,75.0,2,194,0.0,103.0,97.0
35774.0,6,14,4740,7,653,4925.666666666667,249.0,93.28571428571428,7,4087,5751.833333333333,1514.0,583.8571428571429
4424.0,17,2,626,1,72,0.0,72.0,72.0,1,554,0.0,554.0,554.0
120682745.0,6,22,1680,11,840,12068274.5,95.0,76.36363636363636,11,840,9043370.5,95.0,76.36363636363636
205164.0,17,2,762,2,762,0.0,381.0,381.0,0,0,0.0,0.0,0.0
118237054.0,6,34,2334,17,1209,7376317.75,123.0,71.11764705882354,17,1125,7376314.6875,123.0,66.17647058823529
352.0,17,2,156,1,78,0.0,78.0,78.0,1,78,0.0,78.0,78.0
103458453.0,17,14,864,7,432,17167294.0,174.0,61.71428571428572,7,432,17000165.833333332,174.0,61.71428571428572
90258394.0,6,13,2036,8,1016,12894056.285714284,188.0,127.0,5,1020,22523420.75,204.0,204.0
2798654.0,6,2,132,1,66,0.0,66.0,66.0,1,66,0.0,66.0,66.0
5000.0,17,5,550,5,550,1250.0,110.0,110.0,0,0,0.0,0.0,0.0
135127218.0,17,6,1206,6,1206,27025443.6,201.0,201.0,0,0,0.0,0.0,0.0
335.0,17,2,267,1,83,0.0,83.0,83.0,1,184,0.0,184.0,184.0
307283.0,6,6,412,4,272,102427.66666666669,74.0,68.0,2,140,0.0,74.0,70.0
153490.0,17,2,180,1,90,0.0,90.0,90.0,1,90,0.0,90.0,90.0
135136841.0,17,6,1206,6,1206,27027368.2,201.0,201.0,0,0,0.0,0.0,0.0
100270.0,17,2,286,2,286,0.0,143.0,143.0,0,0,0.0,0.0,0.0
43672.0,6,10,2032,5,524,10758.5,252.0,104.8,5,1508,10152.0,1236.0,301.6
102149062.0,17,14,864,7,432,17001043.833333332,174.0,61.71428571428572,7,432,17000196.666666668,174.0,61.71428571428572
119021618.0,17,14,864,7,432,19834611.166666668,174.0,61.71428571428572,7,432,19833493.83333333,174.0,61.71428571428572
149265779.0,6,30,3202,15,1602,8540121.142857144,358.0,106.8,15,1600,10646418.5,426.0,106.66666666666669
2309.0,17,4,344,2,150,0.0,75.0,75.0,2,194,0.0,103.0,97.0
11575.0,6,11,1132,6,556,2246.4,218.0,92.66666666666669,5,576,2528.0,304.0,115.2
248054.0,6,3,337,2,214,0.0,160.0,107.0,1,123,0.0,123.0,123.0
30839709.0,6,5,336,2,134,0.0,68.0,67.0,3,202,14123073.5,70.0,67.33333333333333
798.0,17,4,438,2,148,0.0,74.0,74.0,2,290,0.0,147.0,145.0
1119376.0,6,13,1386,7,789,186562.66666666663,253.0,112.71428571428572,6,597,221216.8,259.0,99.5
10464008.0,6,7,478,4,272,3442558.6666666665,74.0,68.0,3,206,5163730.0,74.0,68.66666666666667
120128347.0,6,12,1832,8,1016,17137291.285714287,188.0,127.0,4,816,30033573.0,204.0,204.0
445927.0,6,10,967,5,390,75414.25,162.0,78.0,5,577,75349.75,349.0,115.4
90031787.0,17,28,13364,28,13364,3334510.6296296297,501.0,477.2857142857143,0,0,0.0,0.0,0.0
13712.0,6,11,2098,6,590,2663.8,252.0,98.33333333333331,5,1508,3171.0,1236.0,301.6
0.0,17,1,342,1,342,0.0,342.0,342.0,0,0,0.0,0.0,0.0
6431.0,17,4,823,2,163,0.0,89.0,81.5,2,660,0.0,443.0,330.0
120124059.0,6,15,2444,7,1428,20020676.5,204.0,204.0,8,1016,17098818.57142857,188.0,127.0
2318.0,17,4,344,2,150,0.0,75.0,75.0,2,194,0.0,103.0,97.0
931200.0,6,12,2714,7,742,155200.0,338.0,106.0,5,1972,163766.25,1514.0,394.4
162780.0,6,11,1131,6,600,32343.6,262.0,100.0,5,531,2980.5,259.0,106.2
92337050.0,17,16,5472,16,5472,6155803.333333333,342.0,342.0,0,0,0.0,0.0,0.0
229648.0,17,2,359,1,75,0.0,75.0,75.0,1,284,0.0,284.0,284.0
23482.0,6,14,4740,7,653,3795.6666666666665,249.0,93.28571428571428,7,4087,3781.0,1514.0,583.8571428571429
26211.0,6,10,2032,5,524,6182.25,252.0,104.8,5,1508,6300.75,1236.0,301.6
116203261.0,6,47,3102,24,1584,5039063.130434782,66.0,66.0,23,1518,5150433.590909091,66.0,66.0
32039.0,6,14,4740,7,653,4873.333333333333,249.0,93.28571428571428,7,4087,5138.333333333333,1514.0,583.8571428571429
91451701.0,6,22,1680,12,935,8312845.545454546,95.0,77.91666666666667,10,745,10160127.111111112,95.0,74.5
129008919.0,17,15,907,8,475,18429845.57142857,174.0,59.375,7,432,18166831.166666668,174.0,61.71428571428572
2477487.0,6,3,1604,1,753,0.0,753.0,753.0,2,851,0.0,785.0,425.5
32450.0,6,14,4740,7,653,4831.666666666667,249.0,93.28571428571428,7,4087,5044.833333333333,1514.0,583.8571428571429
135136040.0,17,6,1146,6,1146,27027208.0,191.0,191.0,0,0,0.0,0.0,0.0
299216.0,6,6,412,4,272,99738.66666666669,74.0,68.0,2,140,0.0,74.0,70.0
209356.0,17,2,180,1,90,0.0,90.0,90.0,1,90,0.0,90.0,90.0
304.0,17,2,168,1,76,0.0,76.0,76.0,1,92,0.0,92.0,92.0
110387566.0,17,16,1212,8,606,15714435.285714284,174.0,75.75,8,606,15715063.0,174.0,75.75
307978.0,6,6,412,4,272,102659.33333333331,74.0,68.0,2,140,0.0,74.0,70.0
207089.0,6,3,426,2,280,0.0,214.0,140.0,1,146,0.0,146.0,146.0
125001040.0,17,15,907,8,475,17857291.42857143,174.0,59.375,7,432,17501108.666666668,174.0,61.71428571428572
135140126.0,17,6,1146,6,1146,27028025.2,191.0,191.0,0,0,0.0,0.0,0.0
30114.0,6,10,2032,5,524,7303.0,252.0,104.8,5,1508,7104.5,1236.0,301.6
133001133.0,17,15,907,8,475,19000161.85714286,174.0,59.375,7,432,18867019.0,174.0,61.71428571428572
153432.0,17,2,180,1,90,0.0,90.0,90.0,1,90,0.0,90.0,90.0
0.0,17,1,44,1,44,0.0,44.0,44.0,0,0,0.0,0.0,0.0
196852.0,17,2,180,1,90,0.0,90.0,90.0,1,90,0.0,90.0,90.0
108102739.0,17,5,955,5,955,27025684.75,191.0,191.0,0,0,0.0,0.0,0.0
469.0,17,2,267,1,83,0.0,83.0,83.0,1,184,0.0,184.0,184.0
504697.0,6,5,336,2,134,0.0,68.0,67.0,3,202,194132.0,70.0,67.33333333333333
103309946.0,6,44,2904,22,1452,4912850.095238095,66.0,66.0,22,1452,4913349.238095238,66.0,66.0
144823.0,17,2,180,1,70,0.0,70.0,70.0,1,110,0.0,110.0,110.0
3004385.0,6,12,2172,7,664,500642.3333333333,252.0,94.85714285714286,5,1508,1910.0,1236.0,301.6
417.0,17,2,166,1,75,0.0,75.0,75.0,1,91,0.0,91.0,91.0
45458.0,6,14,4740,7,653,7249.333333333333,249.0,93.28571428571428,7,4087,7009.166666666667,1514.0,583.8571428571429
116831623.0,6,32,2220,16,1149,7774384.2,123.0,71.8125,16,1071,7774381.533333333,123.0,66.9375
113840107.0,6,78,7282,47,4159,2474784.934782609,139.0,88.48936170212765,31,3123,3787458.4,123.0,100.74193548387096
14744452.0,6,20,1607,10,975,1604447.6666666667,315.0,97.5,10,632,1604420.111111111,78.0,63.2
155106.0,6,3,337,2,214,0.0,160.0,107.0,1,123,0.0,123.0,123.0
143907.0,17,2,180,1,90,0.0,90.0,90.0,1,90,0.0,90.0,90.0
72129.0,6,10,1065,5,534,17843.5,262.0,106.8,5,531,17336.0,259.0,106.2
210477.0,6,3,426,2,280,0.0,214.0,140.0,1,146,0.0,146.0,146.0
29757.0,6,14,4740,7,653,4830.333333333333,249.0,93.28571428571428,7,4087,4500.166666666667,1514.0,583.8571428571429
99794.0,17,4,820,2,156,0.0,78.0,78.0,2,664,0.0,332.0,332.0
108088142.0,17,5,1005,5,1005,27022035.5,201.0,201.0,0,0,0.0,0.0,0.0
60667.0,6,14,4740,7,653,9980.666666666666,249.0,93.28571428571428,7,4087,7573.166666666667,1514.0,583.8571428571429
153430.0,17,2,180,1,90,0.0,90.0,90.0,1,90,0.0,90.0,90.0
236971.0,17,2,180,1,90,0.0,90.0,90.0,1,90,0.0,90.0,90.0
26707.0,6,14,4740,7,653,4295.0,249.0,93.28571428571428,7,4087,4311.333333333333,1514.0,583.8571428571429
2299.0,17,2,691,1,349,0.0,349.0,349.0,1,342,0.0,342.0,342.0
696.0,17,4,438,2,148,0.0,74.0,74.0,2,290,0.0,147.0,145.0
297146.0,6,6,412,4,272,99048.66666666669,74.0,68.0,2,140,0.0,74.0,70.0
5632198.0,6,5,336,2,134,0.0,68.0,67.0,3,202,1527340.0,70.0,67.33333333333333
7127.0,17,2,180,1,90,0.0,90.0,90.0,1,90,0.0,90.0,90.0
106960.0,17,2,286,2,286,0.0,143.0,143.0,0,0,0.0,0.0,0.0
149845516.0,17,36,17126,36,17126,4281300.457142857,501.0,475.72222222222223,0,0,0.0,0.0,0.0
99613.0,6,12,1413,6,816,16922.2,291.0,136.0,6,597,14597.4,259.0,99.5
120005811.0,17,13,821,7,432,20000968.5,174.0,61.71428571428572,6,389,20000151.2,174.0,64.83333333333333
2322.0,17,4,344,2,150,0.0,75.0,75.0,2,194,0.0,103.0,97.0
148839.0,17,2,493,1,88,0.0,88.0,88.0,1,405,0.0,405.0,405.0
320784.0,17,4,1400,4,1400,106928.0,350.0,350.0,0,0,0.0,0.0,0.0
2263.0,17,4,344,2,150,0.0,75.0,75.0,2,194,0.0,103.0,97.0
303494.0,6,6,412,4,272,101164.66666666669,74.0,68.0,2,140,0.0,74.0,70.0
135130525.0,17,6,1146,6,1146,27026105.0,191.0,191.0,0,0,0.0,0.0,0.0
333056.0,6,3,202,2,128,0.0,74.0,64.0,1,74,0.0,74.0,74.0
4372.0,17,2,598,1,72,0.0,72.0,72.0,1,526,0.0,526.0,526.0
211887.0,17,2,180,1,90,0.0,90.0,90.0,1,90,0.0,90.0,90.0
20283.0,6,2,145,2,145,0.0,91.0,72.5,0,0,0.0,0.0,0.0
2421.0,17,4,344,2,150,0.0,75.0,75.0,2,194,0.0,103.0,97.0
10921151.0,6,8,544,4,272,3594715.0,74.0,68.0,4,272,3594650.0,74.0,68.0
207087.0,6,3,426,2,280,0.0,214.0,140.0,1,146,0.0,146.0,146.0
25249.0,6,10,2032,5,524,6076.5,252.0,104.8,5,1508,5759.25,1236.0,301.6
247656.0,6,2,132,1,66,0.0,66.0,66.0,1,66,0.0,66.0,66.0
90669279.0,6,21,1585,10,745,10074364.333333334,95.0,74.5,11,840,9041479.0,95.0,76.36363636363636
90095172.0,6,10,1440,7,828,15015862.0,188.0,118.28571428571428,3,612,30028187.5,204.0,204.0
90302496.0,6,19,1436,10,745,10028095.111111112,95.0,74.5,9,691,11287493.5,95.0,76.77777777777777
144013.0,17,2,180,1,90,0.0,90.0,90.0,1,90,0.0,90.0,90.0
10523000.0,6,6,412,3,206,5193222.5,74.0,68.66666666666667,3,206,5193137.5,74.0,68.66666666666667
284376.0,17,2,363,1,79,0.0,79.0,79.0,1,284,0.0,284.0,284.0
456.0,17,2,508,2,508,0.0,257.0,254.0,0,0,0.0,0.0,0.0
131113.0,6,3,337,2,214,0.0,160.0,107.0,1,123,0.0,123.0,123.0
119744123.0,6,47,3102,24,1584,5206254.652173913,66.0,66.0,23,1518,5144000.5,66.0,66.0
49772.0,6,14,4740,7,653,7819.833333333333,249.0,93.28571428571428,7,4087,7093.0,1514.0,583.8571428571429
2615454.0,6,3,1777,2,951,0.0,885.0,475.5,1,826,0.0,826.0,826.0
14845.0,6,11,2098,6,590,2663.6,252.0,98.33333333333331,5,1508,3476.0,1236.0,301.6
119080839.0,6,49,4420,29,2512,4245177.0,139.0,86.62068965517241,20,1908,6255955.368421053,123.0,95.4
90024819.0,17,28,13364,28,13364,3334252.5555555555,501.0,477.2857142857143,0,0,0.0,0.0,0.0
36102.0,6,10,2032,5,524,8494.0,252.0,104.8,5,1508,8671.0,1236.0,301.6
1156634.0,6,13,3011,8,2383,165233.42857142858,1514.0,297.875,5,628,221029.75,331.0,125.6
24771.0,17,4,823,2,163,0.0,89.0,81.5,2,660,0.0,443.0,330.0
138848.0,6,2,132,1,66,0.0,66.0,66.0,1,66,0.0,66.0,66.0
31827.0,6,10,2032,5,524,7721.25,252.0,104.8,5,1508,7399.0,1236.0,301.6
316918.0,17,4,1400,4,1400,105639.33333333331,350.0,350.0,0,0,0.0,0.0,0.0
108109629.0,17,5,1005,5,1005,27027407.25,201.0,201.0,0,0,0.0,0.0,0.0
209439.0,17,2,180,1,90,0.0,90.0,90.0,1,90,0.0,90.0,90.0
129111585.0,6,30,1974,15,948,8509062.642857144,123.0,63.2,15,1026,8509043.285714285,123.0,68.4
58700.0,6,14,4740,7,653,9658.666666666666,249.0,93.28571428571428,7,4087,9585.333333333334,1514.0,583.8571428571429
55326.0,6,10,2032,5,524,13616.75,252.0,104.8,5,1508,11485.0,1236.0,301.6
37533.0,6,14,4740,7,653,6095.333333333333,249.0,93.28571428571428,7,4087,5534.0,1514.0,583.8571428571429
157667.0,6,3,337,2,214,0.0,160.0,107.0,1,123,0.0,123.0,123.0
205131.0,17,2,762,2,762,0.0,381.0,381.0,0,0,0.0,0.0,0.0
32200.0,6,10,2032,5,524,7710.0,252.0,104.8,5,1508,7783.0,1236.0,301.6
2251.0,17,4,344,2,150,0.0,75.0,75.0,2,194,0.0,103.0,97.0
3361317.0,6,187,154215,108,144700,31414.17757009346,1510.0,1339.8148148148148,79,9515,38786.38461538462,1510.0,120.44303797468356
200708.0,17,4,6056,4,6056,66902.66666666667,1514.0,1514.0,0,0,0.0,0.0,0.0
14631912.0,6,19,1553,9,921,1791427.375,315.0,102.33333333333331,10,632,1592350.5555555555,78.0,63.2
1302550.0,6,4,264,2,132,0.0,66.0,66.0,2,132,0.0,66.0,66.0
19163.0,6,14,4740,7,653,3021.833333333333,249.0,93.28571428571428,7,4087,2559.6666666666665,1514.0,583.8571428571429
132191.0,6,3,337,2,214,0.0,160.0,107.0,1,123,0.0,123.0,123.0
205814.0,17,2,180,1,90,0.0,90.0,90.0,1,90,0.0,90.0,90.0
90063965.0,17,28,13364,28,13364,3335702.407407407,501.0,477.2857142857143,0,0,0.0,0.0,0.0
53685.0,6,14,4740,7,653,8824.5,249.0,93.28571428571428,7,4087,8704.166666666666,1514.0,583.8571428571429
175981.0,6,13,1513,7,882,28604.83333333333,291.0,126.0,6,631,32878.6,293.0,105.16666666666669
217550.0,6,3,426,2,280,0.0,214.0,140.0,1,146,0.0,146.0,146.0
1308781.0,6,4,264,2,132,0.0,66.0,66.0,2,132,0.0,66.0,66.0
285354.0,17,2,363,1,79,0.0,79.0,79.0,1,284,0.0,284.0,284.0
11523.0,6,11,1133,6,602,2042.6,264.0,100.33333333333331,5,531,2376.0,259.0,106.2
9575.0,17,2,582,1,83,0.0,83.0,83.0,1,499,0.0,499.0,499.0
31267.000000000004,6,14,4740,7,653,4123.5,249.0,93.28571428571428,7,4087,4262.5,1514.0,583.8571428571429
2071.0,17,4,344,2,150,0.0,75.0,75.0,2,194,0.0,103.0,97.0
72646.0,6,14,4740,7,653,5826.166666666667,249.0,93.28571428571428,7,4087,11317.0,1514.0,583.8571428571429
216392.0,17,2,180,1,90,0.0,90.0,90.0,1,90,0.0,90.0,90.0
91687781.0,6,29,2062,15,1017,6549097.428571428,123.0,67.8,14,1045,6284808.461538462,139.0,74.64285714285714
129323810.0,17,26,6233,15,4881,9237415.0,1214.0,325.4,11,1352,10939335.7,522.0,122.9090909090909
104289257.0,6,44,2904,22,1452,4957769.761904762,66.0,66.0,22,1452,4960780.80952381,66.0,66.0
333.0,17,2,250,1,93,0.0,93.0,93.0,1,157,0.0,157.0,157.0
122949.0,6,3,373,2,238,0.0,172.0,119.0,1,135,0.0,135.0,135.0
195128.0,17,4,1524,4,1524,65042.66666666666,381.0,381.0,0,0,0.0,0.0,0.0
153369.0,17,2,180,1,90,0.0,90.0,90.0,1,90,0.0,90.0,90.0
149645.0,17,2,180,1,90,0.0,90.0,90.0,1,90,0.0,90.0,90.0
153557.0,17,2,180,1,90,0.0,90.0,90.0,1,90,0.0,90.0,90.0
220714.0,6,3,426,2,280,0.0,214.0,140.0,1,146,0.0,146.0,146.0
135138711.0,17,6,1146,6,1146,27027742.2,191.0,191.0,0,0,0.0,0.0,0.0
2127.0,17,4,344,2,150,0.0,75.0,75.0,2,194,0.0,103.0,97.0
2126.0,17,4,344,2,150,0.0,75.0,75.0,2,194,0.0,103.0,97.0
40135.0,6,10,2032,5,524,9784.25,252.0,104.8,5,1508,9737.0,1236.0,301.6
2352.0,17,4,344,2,150,0.0,75.0,75.0,2,194,0.0,103.0,97.0
2395.0,17,4,344,2,150,0.0,75.0,75.0,2,194,0.0,103.0,97.0
20011.0,17,2,582,1,83,0.0,83.0,83.0,1,499,0.0,499.0,499.0
1302450.0,6,4,264,2,132,0.0,66.0,66.0,2,132,0.0,66.0,66.0
1181926.0,6,13,3020,8,2392,168846.57142857142,1514.0,299.0,5,628,226574.5,331.0,125.6
108095608.0,17,5,1005,5,1005,27023902.0,201.0,201.0,0,0,0.0,0.0,0.0
119347667.0,6,233,26446,117,8018,1028859.198275862,140.0,68.52991452991454,116,18428,1029756.9565217393,336.0,158.86206896551724
14822.0,6,13,1459,7,862,2364.5,271.0,123.14285714285714,6,597,2762.8,259.0,99.5
45808.0,6,10,2032,5,524,11227.25,252.0,104.8,5,1508,11221.75,1236.0,301.6
2802432.0,6,2,132,1,66,0.0,66.0,66.0,1,66,0.0,66.0,66.0
284696.0,17,2,363,1,79,0.0,79.0,79.0,1,284,0.0,284.0,284.0
216305.0,17,2,180,1,90,0.0,90.0,90.0,1,90,0.0,90.0,90.0
43627.0,6,10,2032,5,524,8647.0,252.0,104.8,5,1508,9562.25,1236.0,301.6
233539.0,6,3,337,2,214,0.0,160.0,107.0,1,123,0.0,123.0,123.0
82662.0,6,10,2032,5,524,18765.5,252.0,104.8,5,1508,19762.25,1236.0,301.6
2797863.0,6,2,132,1,66,0.0,66.0,66.0,1,66,0.0,66.0,66.0
26202.0,6,14,4740,7,653,4103.833333333333,249.0,93.28571428571428,7,4087,3707.5,1514.0,583.8571428571429
8345647.0,17,3,1034,2,684,0.0,342.0,342.0,1,350,0.0,350.0,350.0
153440.0,17,2,180,1,90,0.0,90.0,90.0,1,90,0.0,90.0,90.0
22927.0,6,20,7606,11,978,2292.7,310.0,88.9090909090909,9,6628,2258.125,1514.0,736.4444444444445
1039849.0,6,11,1134,6,558,207969.8,220.0,93.0,5,576,255832.0,304.0,115.2
1307967.0,6,4,264,2,132,0.0,66.0,66.0,2,132,0.0,66.0,66.0
190781.0,17,2,180,1,90,0.0,90.0,90.0,1,90,0.0,90.0,90.0
108107514.0,17,5,1005,5,1005,27026878.5,201.0,201.0,0,0,0.0,0.0,0.0
207117.0,6,3,426,2,280,0.0,214.0,140.0,1,146,0.0,146.0,146.0
66267.0,6,14,4740,7,653,10916.5,249.0,93.28571428571428,7,4087,10691.166666666666,1514.0,583.8571428571429
1840.0,17,2,664,1,322,0.0,322.0,322.0,1,342,0.0,342.0,342.0
143885.0,17,2,180,1,90,0.0,90.0,90.0,1,90,0.0,90.0,90.0
135127335.0,17,6,1146,6,1146,27025467.0,191.0,191.0,0,0,0.0,0.0,0.0
207787.0,6,10,1221,6,636,41557.4,298.0,106.0,4,585,68036.33333333333,379.0,146.25
322854.0,17,4,1400,4,1400,107618.0,350.0,350.0,0,0,0.0,0.0,0.0
120445841.0,6,30,1974,15,948,7890094.142857143,123.0,63.2,15,1026,7890129.928571428,123.0,68.4
105009776.0,17,13,821,7,432,17501629.333333332,174.0,61.71428571428572,6,389,17000158.4,174.0,64.83333333333333
33895.0,6,12,1413,7,882,5649.166666666667,291.0,126.0,5,531,6548.5,259.0,106.2
122138449.0,6,47,3102,23,1518,5151987.727272728,66.0,66.0,24,1584,5310355.304347826,66.0,66.0
146231.0,6,3,337,2,214,0.0,160.0,107.0,1,123,0.0,123.0,123.0
5005169.0,17,4,849,2,166,0.0,83.0,83.0,2,683,0.0,499.0,341.5
135145329.0,17,6,1146,6,1146,27029065.8,191.0,191.0,0,0,0.0,0.0,0.0
284146.0,17,2,363,1,79,0.0,79.0,79.0,1,284,0.0,284.0,284.0
106733.0,17,2,700,2,700,0.0,350.0,350.0,0,0,0.0,0.0,0.0
0.0,17,1,381,1,381,0.0,381.0,381.0,0,0,0.0,0.0,0.0
196747.0,17,2,180,1,90,0.0,90.0,90.0,1,90,0.0,90.0,90.0
144621.0,17,2,180,1,70,0.0,70.0,70.0,1,110,0.0,110.0,110.0
16143.000000000002,6,20,7606,11,978,1614.3,310.0,88.9090909090909,9,6628,1798.875,1514.0,736.4444444444445
190880.0,17,2,180,1,90,0.0,90.0,90.0,1,90,0.0,90.0,90.0
216644.0,17,2,180,1,90,0.0,90.0,90.0,1,90,0.0,90.0,90.0
120088153.0,6,640,80324,320,21342,374922.2037617555,140.0,66.69375,320,58982,374236.4451410658,336.0,184.31875
308475.0,17,4,1400,4,1400,102825.0,350.0,350.0,0,0,0.0,0.0,0.0
347.0,17,2,267,1,83,0.0,83.0,83.0,1,184,0.0,184.0,184.0
197053.0,17,2,180,1,90,0.0,90.0,90.0,1,90,0.0,90.0,90.0
147620.0,6,3,337,2,214,0.0,160.0,107.0,1,123,0.0,123.0,123.0
9328.0,17,2,539,1,86,0.0,86.0,86.0,1,453,0.0,453.0,453.0
108575.0,17,2,286,2,286,0.0,143.0,143.0,0,0,0.0,0.0,0.0
28443.0,6,10,2032,5,524,4594.75,252.0,104.8,5,1508,6198.0,1236.0,301.6
235897.0,17,4,1524,4,1524,78632.33333333333,381.0,381.0,0,0,0.0,0.0,0.0
244072.0,6,3,337,2,214,0.0,160.0,107.0,1,123,0.0,123.0,123.0
2791142.0,6,2,132,1,66,0.0,66.0,66.0,1,66,0.0,66.0,66.0
90255818.0,6,12,1832,8,1016,12893688.285714284,188.0,127.0,4,816,30030644.666666668,204.0,204.0
2467.0,17,4,344,2,150,0.0,75.0,75.0,2,194,0.0,103.0,97.0
245562.0,6,3,337,2,214,0.0,160.0,107.0,1,123,0.0,123.0,123.0
111343.0,17,2,286,2,286,0.0,143.0,143.0,0,0,0.0,0.0,0.0
91442.0,6,14,4740,7,653,14968.666666666666,249.0,93.28571428571428,7,4087,10302.833333333334,1514.0,583.8571428571429
3941730.0,6,186,152402,105,142754,37901.25,1510.0,1359.5619047619048,81,9648,45473.675,1510.0,119.11111111111111
19084.0,6,14,4740,7,653,2193.333333333333,249.0,93.28571428571428,7,4087,3040.833333333333,1514.0,583.8571428571429
144946.0,17,2,180,1,70,0.0,70.0,70.0,1,110,0.0,110.0,110.0
122687848.0,6,48,3168,24,1584,5118562.826086956,66.0,66.0,24,1584,5089765.782608695,66.0,66.0
68681.0,6,14,4740,7,653,10555.833333333334,249.0,93.28571428571428,7,4087,10955.166666666666,1514.0,583.8571428571429
108108783.0,17,5,1005,5,1005,27027195.75,201.0,201.0,0,0,0.0,0.0,0.0
318231.0,17,4,1400,4,1400,106077.0,350.0,350.0,0,0,0.0,0.0,0.0
16545.0,6,10,2032,5,524,3899.25,252.0,104.8,5,1508,3521.25,1236.0,301.6
1298310.0,6,4,264,2,132,0.0,66.0,66.0,2,132,0.0,66.0,66.0
90033790.0,6,16,1233,8,596,8607780.0,95.0,74.5,8,637,12860637.142857144,95.0,79.625
307706.0,6,3,202,2,128,0.0,74.0,64.0,1,74,0.0,74.0,74.0
215394.0,17,2,180,1,90,0.0,90.0,90.0,1,90,0.0,90.0,90.0
108323618.0,6,202,22758,101,15870,1081191.04,284.0,157.12871287128712,101,6888,1081191.2,140.0,68.1980198019802
262444.0,6,4,391,2,214,0.0,160.0,107.0,2,177,0.0,123.0,88.5
120326894.0,6,210,23770,105,7238,1148979.5961538462,140.0,68.93333333333334,105,16532,1149015.048076923,284.0,157.44761904761904
204946.0,17,2,180,1,90,0.0,90.0,90.0,1,90,0.0,90.0,90.0
0.0,17,1,90,1,90,0.0,90.0,90.0,0,0,0.0,0.0,0.0
309525.0,6,6,412,4,272,103175.0,74.0,68.0,2,140,0.0,74.0,70.0
210850.0,6,3,426,2,280,0.0,214.0,140.0,1,146,0.0,146.0,146.0
22207.0,6,14,4740,7,653,3424.833333333333,249.0,93.28571428571428,7,4087,3558.0,1514.0,583.8571428571429
240064.0,17,2,180,1,90,0.0,90.0,90.0,1,90,0.0,90.0,90.0
846464.0,6,2,132,1,66,0.0,66.0,66.0,1,66,0.0,66.0,66.0
110862306.0,6,30,1974,15,1026,7903317.357142857,123.0,68.4,15,948,7903317.785714285,123.0,63.2
306992.0,6,6,412,4,272,102330.66666666669,74.0,68.0,2,140,0.0,74.0,70.0
32953.0,6,14,4740,7,653,5372.833333333333,249.0,93.28571428571428,7,4087,5311.833333333333,1514.0,583.8571428571429
43834.0,6,10,2032,5,524,10727.0,252.0,104.8,5,1508,10152.0,1236.0,301.6
446660.0,17,4,360,2,140,0.0,70.0,70.0,2,220,0.0,110.0,110.0
629.0,17,2,762,2,762,0.0,381.0,381.0,0,0,0.0,0.0,0.0
7784.0,6,10,2032,5,524,1723.5,252.0,104.8,5,1508,1663.0,1236.0,301.6
15799.0,6,11,1131,6,600,2542.2,262.0,100.0,5,531,3631.0,259.0,106.2
110027.0,17,2,286,2,286,0.0,143.0,143.0,0,0,0.0,0.0,0.0
13518827.0,6,18,1495,9,921,1651132.5,315.0,102.33333333333331,9,574,1651143.25,78.0,63.77777777777778
120123024.0,6,13,2020,9,1204,15015378.0,188.0,133.77777777777777,4,816,30031183.0,204.0,204.0
317.0,17,2,174,1,79,0.0,79.0,79.0,1,95,0.0,95.0,95.0
1213746.0,6,13,3013,8,2385,173392.2857142857,1514.0,298.125,5,628,234591.25,331.0,125.6
197110.0,17,4,6056,4,6056,65703.33333333333,1514.0,1514.0,0,0,0.0,0.0,0.0
252378.0,6,10,1221,6,636,50475.6,298.0,106.0,4,585,78410.33333333333,379.0,146.25
108102359.0,17,5,955,5,955,27025589.75,191.0,191.0,0,0,0.0,0.0,0.0
90254219.0,6,12,1832,8,1016,12893459.857142856,188.0,127.0,4,816,30029426.0,204.0,204.0
108817.0,17,2,762,2,762,0.0,381.0,381.0,0,0,0.0,0.0,0.0
96157381.0,6,58,12243,29,6452,3434192.1785714286,1514.0,222.48275862068965,29,5791,3425296.714285714,1514.0,199.6896551724137
1472143.0,6,4,276,2,128,0.0,74.0,64.0,2,148,0.0,74.0,74.0
115273344.0,6,221,24912,111,7622,1047939.490909091,140.0,68.66666666666667,110,17290,1048101.76146789,390.0,157.1818181818182
67232.0,6,10,2032,5,524,16603.0,252.0,104.8,5,1508,14238.75,1236.0,301.6
112527.0,17,2,286,2,286,0.0,143.0,143.0,0,0,0.0,0.0,0.0
303637.0,6,6,412,4,272,101212.33333333331,74.0,68.0,2,140,0.0,74.0,70.0
10460275.0,6,6,412,3,206,5161841.5,74.0,68.66666666666667,3,206,5161715.5,74.0,68.66666666666667
42074.0,6,10,2032,5,524,9662.0,252.0,104.8,5,1508,9973.0,1236.0,301.6
31733.0,6,14,4740,7,653,4788.166666666667,249.0,93.28571428571428,7,4087,4347.666666666667,1514.0,583.8571428571429
3126559.0,17,3,1026,3,1026,1563279.5,342.0,342.0,0,0,0.0,0.0,0.0
232975.0,6,3,337,2,214,0.0,160.0,107.0,1,123,0.0,123.0,123.0
33868.0,6,10,2032,5,524,7733.75,252.0,104.8,5,1508,8173.75,1236.0,301.6
90301325.0,6,19,1436,10,745,10028136.666666666,95.0,74.5,9,691,11286636.125,95.0,76.77777777777777
109851902.0,6,44,2904,22,1452,5231042.952380952,66.0,66.0,22,1452,5220751.0,66.0,66.0
59024.0,6,14,4740,7,653,9463.166666666666,249.0,93.28571428571428,7,4087,5000.833333333333,1514.0,583.8571428571429
304222.0,6,10,1221,6,636,60844.4,298.0,106.0,4,585,94410.33333333331,379.0,146.25
5624996.0,6,5,336,2,134,0.0,68.0,67.0,3,202,1424901.0,70.0,67.33333333333333
183344.0,6,10,1066,5,490,45570.25,218.0,98.0,5,576,44641.5,304.0,115.2
35200.0,6,10,2032,5,524,7870.5,252.0,104.8,5,1508,8026.0,1236.0,301.6
30193.0,6,14,4740,7,653,4908.166666666667,249.0,93.28571428571428,7,4087,4894.166666666667,1514.0,583.8571428571429
10472128.0,6,7,478,4,272,3444148.6666666665,74.0,68.0,3,206,5166084.5,74.0,68.66666666666667
414.0,17,2,152,1,76,0.0,76.0,76.0,1,76,0.0,76.0,76.0
119852556.0,6,14,2102,5,1020,29962567.25,204.0,204.0,9,1082,14981416.125,188.0,120.22222222222224
241764.0,6,3,337,2,214,0.0,160.0,107.0,1,123,0.0,123.0,123.0
237366.0,6,3,337,2,214,0.0,160.0,107.0,1,123,0.0,123.0,123.0
1063470.0,6,3,1604,2,851,0.0,785.0,425.5,1,753,0.0,753.0,753.0
4562.0,17,2,180,1,90,0.0,90.0,90.0,1,90,0.0,90.0,90.0
146045.0,6,3,337,2,214,0.0,160.0,107.0,1,123,0.0,123.0,123.0
214301.0,17,2,180,1,90,0.0,90.0,90.0,1,90,0.0,90.0,90.0
108134298.0,17,5,955,5,955,27033574.5,191.0,191.0,0,0,0.0,0.0,0.0
269177.0,6,10,1221,6,636,53835.4,298.0,106.0,4,585,84218.66666666667,379.0,146.25
108105573.0,17,5,955,5,955,27026393.25,191.0,191.0,0,0,0.0,0.0,0.0
128889716.0,6,34,2334,17,1125,7431404.1875,123.0,66.17647058823529,17,1209,7431395.4375,123.0,71.11764705882354
116820636.0,6,33,2290,17,1125,7301289.75,123.0,66.17647058823529,16,1165,7107854.8,139.0,72.8125
67368.0,6,14,4740,7,653,10644.333333333334,249.0,93.28571428571428,7,4087,7985.833333333333,1514.0,583.8571428571429
111188.0,17,4,1400,4,1400,37062.66666666666,350.0,350.0,0,0,0.0,0.0,0.0
12035.0,6,11,1131,6,600,2152.6,262.0,100.0,5,531,2790.5,259.0,106.2
810.0,17,2,762,2,762,0.0,381.0,381.0,0,0,0.0,0.0,0.0
313683.0,17,4,1400,4,1400,104561.0,350.0,350.0,0,0,0.0,0.0,0.0
3007446.0,6,12,2172,7,664,500720.3333333333,252.0,94.85714285714286,5,1508,2682.5,1236.0,301.6
232551.0,6,3,337,2,214,0.0,160.0,107.0,1,123,0.0,123.0,123.0
90256414.0,6,13,2036,8,1016,12893773.42857143,188.0,127.0,5,1020,22522576.5,204.0,204.0
4533.0,17,2,598,1,72,0.0,72.0,72.0,1,526,0.0,526.0,526.0
209481.0,17,2,180,1,90,0.0,90.0,90.0,1,90,0.0,90.0,90.0
10548304.0,6,7,478,4,272,3470666.0,74.0,68.0,3,206,5205918.5,74.0,68.66666666666667
1391837.0,17,16,1120,16,1120,92789.13333333332,70.0,70.0,0,0,0.0,0.0,0.0
232464.0,6,3,337,2,214,0.0,160.0,107.0,1,123,0.0,123.0,123.0
17718.0,6,10,2032,5,524,4129.25,252.0,104.8,5,1508,4182.5,1236.0,301.6
318.0,17,2,174,1,79,0.0,79.0,79.0,1,95,0.0,95.0,95.0
105231.0,17,2,286,2,286,0.0,143.0,143.0,0,0,0.0,0.0,0.0
0.0,17,1,55,1,55,0.0,55.0,55.0,0,0,0.0,0.0,0.0
105880224.0,6,198,22298,99,6830,1072051.051020408,140.0,68.98989898989899,99,15468,1072012.8163265309,284.0,156.24242424242425
140657.0,6,2,132,1,66,0.0,66.0,66.0,1,66,0.0,66.0,66.0
218104.0,6,3,426,2,280,0.0,214.0,140.0,1,146,0.0,146.0,146.0
34097.0,17,2,582,1,83,0.0,83.0,83.0,1,499,0.0,499.0,499.0
10525024.0,6,7,478,4,272,3463042.333333333,74.0,68.0,3,206,5188964.0,74.0,68.66666666666667
35476.0,6,10,1067,5,536,8157.75,264.0,107.2,5,531,6706.25,259.0,106.2
104445953.0,6,44,2904,22,1452,4973616.80952381,66.0,66.0,22,1452,4958917.952380952,66.0,66.0
92640014.0,17,12,778,6,389,18495982.0,174.0,64.83333333333333,6,389,18503749.2,174.0,64.83333333333333
209710.0,17,2,180,1,90,0.0,90.0,90.0,1,90,0.0,90.0,90.0
34128.0,6,10,2032,5,524,8306.75,252.0,104.8,5,1508,8226.5,1236.0,301.6
261636.0,6,12,1447,6,816,51291.6,291.0,136.0,6,631,51558.2,293.0,105.16666666666669
18093.0,6,10,2032,5,524,4326.5,252.0,104.8,5,1508,4219.25,1236.0,301.6
102601.0,17,2,286,2,286,0.0,143.0,143.0,0,0,0.0,0.0,0.0
48621.0,6,10,2032,5,524,11949.0,252.0,104.8,5,1508,11859.25,1236.0,301.6
112729182.0,6,48,3168,24,1584,4901268.782608695,66.0,66.0,24,1584,4891871.652173913,66.0,66.0
27495042.0,17,5,1710,5,1710,6873760.5,342.0,342.0,0,0,0.0,0.0,0.0
65339.99999999999,6,13,1394,7,797,10890.0,253.0,113.85714285714286,6,597,12325.6,259.0,99.5
205878.0,17,2,180,1,90,0.0,90.0,90.0,1,90,0.0,90.0,90.0
1308842.0,6,4,264,2,132,0.0,66.0,66.0,2,132,0.0,66.0,66.0
47496426.0,6,7,1874,3,887,22270445.5,753.0,295.6666666666667,4,987,15012005.666666666,785.0,246.75
431081.0,6,3,1604,2,851,0.0,785.0,425.5,1,753,0.0,753.0,753.0
228305.0,17,2,180,1,90,0.0,90.0,90.0,1,90,0.0,90.0,90.0
214067.0,17,2,180,1,90,0.0,90.0,90.0,1,90,0.0,90.0,90.0
4593.0,17,4,344,2,150,0.0,75.0,75.0,2,194,0.0,103.0,97.0
9465.0,6,10,2032,5,524,2136.75,252.0,104.8,5,1508,2091.0,1236.0,301.6
331310.0,6,6,412,4,272,110436.66666666669,74.0,68.0,2,140,0.0,74.0,70.0
50505.0,6,2,132,1,66,0.0,66.0,66.0,1,66,0.0,66.0,66.0
96248591.0,6,44,4138,27,2392,3701868.884615385,139.0,88.5925925925926,17,1746,6002019.75,123.0,102.70588235294116
105878.0,17,2,700,2,700,0.0,350.0,350.0,0,0,0.0,0.0,0.0
108239.0,17,2,286,2,286,0.0,143.0,143.0,0,0,0.0,0.0,0.0
2958673.0,6,12,2172,7,664,492959.3333333333,252.0,94.85714285714286,5,1508,2349.75,1236.0,301.6
192645.0,17,2,180,1,90,0.0,90.0,90.0,1,90,0.0,90.0,90.0
17084.0,6,10,2032,5,524,4043.75,252.0,104.8,5,1508,3985.75,1236.0,301.6
745.0,17,4,438,2,148,0.0,74.0,74.0,2,290,0.0,147.0,145.0
90687486.0,6,15,2302,9,1204,11316887.0,188.0,133.77777777777777,6,1098,18104835.2,204.0,183.0
321.0,17,2,174,1,79,0.0,79.0,79.0,1,95,0.0,95.0,95.0
103762.0,17,2,286,2,286,0.0,143.0,143.0,0,0,0.0,0.0,0.0
103615.0,17,2,286,2,286,0.0,143.0,143.0,0,0,0.0,0.0,0.0
1314740.0,6,4,264,2,132,0.0,66.0,66.0,2,132,0.0,66.0,66.0
98785.0,6,11,1131,6,600,19415.4,262.0,100.0,5,531,2897.75,259.0,106.2
119709646.0,6,768,133450,385,25928,311671.1979166667,214.0,67.34545454545454,383,107522,313020.277486911,1514.0,280.73629242819845
118028378.0,6,35,2536,18,1248,6942845.764705882,123.0,69.33333333333333,17,1288,6882745.1875,139.0,75.76470588235294
101420295.0,17,14,864,7,432,16835123.333333332,174.0,61.71428571428572,7,432,16833400.0,174.0,61.71428571428572
206185.0,6,10,1221,6,636,41237.0,298.0,106.0,4,585,67301.33333333333,379.0,146.25
77808.0,6,14,4740,7,653,11394.5,249.0,93.28571428571428,7,4087,11925.166666666666,1514.0,583.8571428571429
143902.0,17,2,180,1,90,0.0,90.0,90.0,1,90,0.0,90.0,90.0
319.0,17,2,174,1,79,0.0,79.0,79.0,1,95,0.0,95.0,95.0
426416.0,6,10,1221,6,636,85283.2,298.0,106.0,4,585,136612.0,379.0,146.25
113618110.0,6,46,3036,23,1518,5150438.636363637,66.0,66.0,23,1518,5150442.5,66.0,66.0
298791.0,6,6,412,4,272,99597.0,74.0,68.0,2,140,0.0,74.0,70.0
108105220.0,17,5,955,5,955,27026305.0,191.0,191.0,0,0,0.0,0.0,0.0
51524257.0,6,8,2113,3,960,24517188.0,826.0,320.0,5,1153,12237450.25,885.0,230.6
302.0,17,2,156,1,78,0.0,78.0,78.0,1,78,0.0,78.0,78.0
562142.0,6,15,4815,7,742,93570.66666666669,230.0,106.0,8,4073,80005.28571428571,1514.0,509.125
285713.0,17,4,704,2,148,0.0,74.0,74.0,2,556,0.0,280.0,278.0
103200466.0,6,42,2772,21,1386,5160001.7,66.0,66.0,21,1386,5160010.7,66.0,66.0
0.0,17,1,342,1,342,0.0,342.0,342.0,0,0,0.0,0.0,0.0
90093572.0,6,12,1848,5,1020,22522810.25,204.0,204.0,7,828,15015211.333333334,188.0,118.28571428571428
10468769.0,6,7,478,4,272,3443858.0,74.0,68.0,3,206,5165683.5,74.0,68.66666666666667
1031762.0,6,11,1134,6,558,206352.4,220.0,93.0,5,576,255739.0,304.0,115.2
51491.0,6,14,4740,7,653,8427.166666666666,249.0,93.28571428571428,7,4087,8361.833333333334,1514.0,583.8571428571429
90261754.0,6,16,2368,9,1204,11282719.25,188.0,133.77777777777777,7,1164,15016030.166666666,204.0,166.28571428571428
153544.0,17,2,180,1,90,0.0,90.0,90.0,1,90,0.0,90.0,90.0
17101588.0,17,10,3500,10,3500,1900176.4444444445,350.0,350.0,0,0,0.0,0.0,0.0
80680.0,6,14,4740,7,653,13314.0,249.0,93.28571428571428,7,4087,7394.333333333333,1514.0,583.8571428571429
99470.0,17,2,286,2,286,0.0,143.0,143.0,0,0,0.0,0.0,0.0
41373.0,6,10,2032,5,524,10126.0,252.0,104.8,5,1508,9740.0,1236.0,301.6
123416411.0,6,48,3168,24,1584,5049763.695652174,66.0,66.0,24,1584,5251808.869565218,66.0,66.0
0.0,17,1,44,1,44,0.0,44.0,44.0,0,0,0.0,0.0,0.0
105766.0,17,2,762,2,762,0.0,381.0,381.0,0,0,0.0,0.0,0.0
137779.0,17,4,344,2,150,0.0,75.0,75.0,2,194,0.0,103.0,97.0
302423.0,6,6,412,4,272,100807.66666666669,74.0,68.0,2,140,0.0,74.0,70.0
727.0,17,4,438,2,148,0.0,74.0,74.0,2,290,0.0,147.0,145.0
90254403.0,6,12,1832,8,1016,12893486.142857144,188.0,127.0,4,816,30029965.33333333,204.0,204.0
22049.0,6,14,4740,7,653,3000.6666666666665,249.0,93.28571428571428,7,4087,3498.1666666666665,1514.0,583.8571428571429
23943.0,6,14,4740,7,653,3031.5,249.0,93.28571428571428,7,4087,3851.0,1514.0,583.8571428571429
102960.0,17,2,286,2,286,0.0,143.0,143.0,0,0,0.0,0.0,0.0
10866805.0,6,8,544,4,272,3577093.6666666665,74.0,68.0,4,272,3577013.0,74.0,68.0
90550116.0,6,14,2240,8,1016,12935730.857142856,188.0,127.0,6,1224,18077742.2,204.0,204.0
118859881.0,6,48,3168,24,1584,5167820.913043479,66.0,66.0,24,1584,5158421.913043479,66.0,66.0
90526816.0,6,17,2572,9,1204,11315852.0,188.0,133.77777777777777,8,1368,12908942.714285716,204.0,171.0
121478.0,6,3,337,2,214,0.0,160.0,107.0,1,123,0.0,123.0,123.0
55284.0,6,14,4740,7,653,8337.833333333334,249.0,93.28571428571428,7,4087,8782.166666666666,1514.0,583.8571428571429
1306869.0,6,4,264,2,132,0.0,66.0,66.0,2,132,0.0,66.0,66.0
121616754.0,6,31,2050,16,1102,8107783.6,139.0,68.875,15,948,7958220.928571428,123.0,63.2
46700.0,6,14,4740,7,653,6581.5,249.0,93.28571428571428,7,4087,6949.166666666667,1514.0,583.8571428571429
166978.0,17,2,180,1,90,0.0,90.0,90.0,1,90,0.0,90.0,90.0
298266.0,6,6,412,4,272,99422.0,74.0,68.0,2,140,0.0,74.0,70.0
2799190.0,6,2,132,1,66,0.0,66.0,66.0,1,66,0.0,66.0,66.0
42378.0,6,14,4740,7,653,6867.166666666667,249.0,93.28571428571428,7,4087,6345.0,1514.0,583.8571428571429
22396.0,6,10,771,5,384,4174.25,112.0,76.8,5,387,5397.75,115.0,77.4
135135671.0,17,6,1206,6,1206,27027134.2,201.0,201.0,0,0,0.0,0.0,0.0
108104178.0,17,5,1005,5,1005,27026044.5,201.0,201.0,0,0,0.0,0.0,0.0
216576.0,17,2,180,1,90,0.0,90.0,90.0,1,90,0.0,90.0,90.0
26770.0,6,14,4740,7,653,3733.1666666666665,249.0,93.28571428571428,7,4087,4323.333333333333,1514.0,583.8571428571429
128939593.0,6,35,2394,18,1269,7584681.94117647,123.0,70.5,17,1125,7421080.625,123.0,66.17647058823529
201121.0,17,4,6056,4,6056,67040.33333333333,1514.0,1514.0,0,0,0.0,0.0,0.0
66405.0,6,14,4740,7,653,10887.5,249.0,93.28571428571428,7,4087,9326.833333333334,1514.0,583.8571428571429
135128664.0,17,6,1146,6,1146,27025732.8,191.0,191.0,0,0,0.0,0.0,0.0
228374.0,17,2,180,1,90,0.0,90.0,90.0,1,90,0.0,90.0,90.0
135632.0,6,2,132,1,66,0.0,66.0,66.0,1,66,0.0,66.0,66.0
159039.0,6,3,337,2,214,0.0,160.0,107.0,1,123,0.0,123.0,123.0
112000948.0,17,15,1169,8,606,16000135.42857143,174.0,75.75,7,563,15335064.333333334,174.0,80.42857142857143
1542585.0,6,7,499,3,198,715552.5,66.0,66.0,4,301,457255.0,103.0,75.25
113609603.0,6,46,3036,23,1518,5150439.7727272725,66.0,66.0,23,1518,5150434.954545454,66.0,66.0
251134.00000000003,17,4,1524,4,1524,83711.33333333333,381.0,381.0,0,0,0.0,0.0,0.0
120126435.0,6,14,2240,6,1224,24025287.0,204.0,204.0,8,1016,17137693.14285714,188.0,127.0
8976.0,17,2,582,1,83,0.0,83.0,83.0,1,499,0.0,499.0,499.0
520105.00000000006,6,5,367,2,132,0.0,66.0,66.0,3,235,260052.5,103.0,78.33333333333333
214084.0,6,10,2032,5,524,53153.0,252.0,104.8,5,1508,48924.0,1236.0,301.6
90021699.0,17,28,13364,28,13364,3334137.0,501.0,477.2857142857143,0,0,0.0,0.0,0.0
2335.0,17,4,344,2,150,0.0,75.0,75.0,2,194,0.0,103.0,97.0
90024880.0,17,28,13364,28,13364,3334254.814814815,501.0,477.2857142857143,0,0,0.0,0.0,0.0
353.0,17,2,267,1,83,0.0,83.0,83.0,1,184,0.0,184.0,184.0
318378.0,17,4,1400,4,1400,106126.0,350.0,350.0,0,0,0.0,0.0,0.0
97395.0,17,2,762,2,762,0.0,381.0,381.0,0,0,0.0,0.0,0.0
26979.0,6,10,2032,5,524,6274.5,252.0,104.8,5,1508,6259.25,1236.0,301.6
246344.0,6,3,337,2,214,0.0,160.0,107.0,1,123,0.0,123.0,123.0
108319306.0,6,32,2220,16,1149,7206896.4,123.0,71.8125,16,1071,7206894.733333333,123.0,66.9375
1483.0,17,2,762,2,762,0.0,381.0,381.0,0,0,0.0,0.0,0.0
35564.0,6,14,4740,7,653,5771.166666666667,249.0,93.28571428571428,7,4087,4925.5,1514.0,583.8571428571429
262849.0,6,10,1221,6,636,52569.8,298.0,106.0,4,585,81897.0,379.0,146.25
120005931.0,6,16,1192,8,596,17143704.42857143,95.0,74.5,8,596,17108058.57142857,95.0,74.5
127106.0,6,2,132,1,66,0.0,66.0,66.0,1,66,0.0,66.0,66.0
143958.0,17,2,180,1,90,0.0,90.0,90.0,1,90,0.0,90.0,90.0
192854.0,17,2,180,1,90,0.0,90.0,90.0,1,90,0.0,90.0,90.0
284471.0,17,2,414,1,88,0.0,88.0,88.0,1,326,0.0,326.0,326.0
236656.0,6,3,426,2,280,0.0,214.0,140.0,1,146,0.0,146.0,146.0
1314852.0,6,4,264,2,132,0.0,66.0,66.0,2,132,0.0,66.0,66.0
2592898.0,6,2,132,1,66,0.0,66.0,66.0,1,66,0.0,66.0,66.0
23608.0,6,14,4740,7,653,3825.3333333333335,249.0,93.28571428571428,7,4087,3302.6666666666665,1514.0,583.8571428571429
281298.0,17,2,363,1,79,0.0,79.0,79.0,1,284,0.0,284.0,284.0
2351.0,17,4,344,2,150,0.0,75.0,75.0,2,194,0.0,103.0,97.0
3144.0,17,2,224,1,76,0.0,76.0,76.0,1,148,0.0,148.0,148.0
266644.0,6,3,337,2,214,0.0,160.0,107.0,1,123,0.0,123.0,123.0
208972.0,6,3,426,2,280,0.0,214.0,140.0,1,146,0.0,146.0,146.0
22592.0,6,14,4740,7,653,3343.833333333333,249.0,93.28571428571428,7,4087,3629.5,1514.0,583.8571428571429
120856341.0,17,14,864,7,432,16835085.833333332,174.0,61.71428571428572,7,432,16833491.666666668,174.0,61.71428571428572
27439.0,6,14,4740,7,653,4232.333333333333,249.0,93.28571428571428,7,4087,4386.833333333333,1514.0,583.8571428571429
207447.0,6,3,426,2,280,0.0,214.0,140.0,1,146,0.0,146.0,146.0
107643470.0,6,30,2122,15,1105,7673388.642857143,139.0,73.66666666666667,15,1017,7673386.214285715,123.0,67.8
108110161.0,17,5,955,5,955,27027540.25,191.0,191.0,0,0,0.0,0.0,0.0
117827062.0,6,31,2097,16,1071,7855108.133333334,123.0,66.9375,15,1026,8415928.285714285,123.0,68.4
159951.0,6,3,337,2,214,0.0,160.0,107.0,1,123,0.0,123.0,123.0
201723.0,17,2,180,1,90,0.0,90.0,90.0,1,90,0.0,90.0,90.0
1302399.0,6,4,264,2,132,0.0,66.0,66.0,2,132,0.0,66.0,66.0
146658.0,6,3,337,2,214,0.0,160.0,107.0,1,123,0.0,123.0,123.0
98366.0,6,10,1066,5,490,21996.0,218.0,98.0,5,576,24114.25,304.0,115.2
5005397.0,17,4,849,2,166,0.0,83.0,83.0,2,683,0.0,499.0,341.5
4063.0,17,2,582,1,83,0.0,83.0,83.0,1,499,0.0,499.0,499.0
10859237.0,6,7,478,3,206,5361322.5,74.0,68.66666666666667,4,272,3574141.0,74.0,68.0
171739.0,17,2,180,1,90,0.0,90.0,90.0,1,90,0.0,90.0,90.0
116920697.0,6,35,2542,18,1348,6864990.705882353,139.0,74.88888888888889,17,1194,7294056.5625,123.0,70.23529411764706
108107397.0,17,5,1005,5,1005,27026849.25,201.0,201.0,0,0,0.0,0.0,0.0
43717.0,6,14,4740,7,653,7160.333333333333,249.0,93.28571428571428,7,4087,6910.833333333333,1514.0,583.8571428571429
0.0,17,1,55,1,55,0.0,55.0,55.0,0,0,0.0,0.0,0.0
433.0,17,2,160,1,80,0.0,80.0,80.0,1,80,0.0,80.0,80.0
30299.0,6,14,4740,7,653,4332.166666666667,249.0,93.28571428571428,7,4087,4621.166666666667,1514.0,583.8571428571429
24858.0,6,10,2032,5,524,5948.25,252.0,104.8,5,1508,5636.0,1236.0,301.6
21203408.0,6,26,7627,14,3735,179554.61538461538,1514.0,266.7857142857143,12,3892,1908924.0909090908,1514.0,324.3333333333333
166397.0,17,2,180,1,90,0.0,90.0,90.0,1,90,0.0,90.0,90.0
232254.0,6,3,337,2,214,0.0,160.0,107.0,1,123,0.0,123.0,123.0
209538.0,17,2,180,1,90,0.0,90.0,90.0,1,90,0.0,90.0,90.0
90046202.0,17,28,13364,28,13364,3335044.5185185187,501.0,477.2857142857143,0,0,0.0,0.0,0.0
744289.0,17,5,961,3,234,371956.0,78.0,78.0,2,727,0.0,395.0,363.5
90050572.0,17,28,13364,28,13364,3335206.3703703703,501.0,477.2857142857143,0,0,0.0,0.0,0.0
206750.0,6,10,1221,6,636,41350.0,298.0,106.0,4,585,67678.0,379.0,146.25
106258647.0,6,192,21664,96,15106,1116247.8,284.0,157.35416666666666,96,6558,1116247.3157894737,140.0,68.3125
5624658.0,6,5,336,2,134,0.0,68.0,67.0,3,202,1525942.5,70.0,67.33333333333333
49944.0,6,14,4740,7,653,8200.666666666666,249.0,93.28571428571428,7,4087,8086.166666666667,1514.0,583.8571428571429
90031555.0,17,28,13364,28,13364,3334502.037037037,501.0,477.2857142857143,0,0,0.0,0.0,0.0
120121954.0,6,15,2428,9,1204,15015244.25,188.0,133.77777777777777,6,1224,18072150.4,204.0,204.0
228306.0,17,2,180,1,90,0.0,90.0,90.0,1,90,0.0,90.0,90.0
108116555.0,17,5,1005,5,1005,27029138.75,201.0,201.0,0,0,0.0,0.0,0.0
406157.0,6,3,1604,1,753,0.0,753.0,753.0,2,851,0.0,785.0,425.5
14395.0,6,10,2032,5,524,3277.75,252.0,104.8,5,1508,2813.0,1236.0,301.6
99239869.0,6,29,2046,15,1017,7088529.428571428,123.0,67.8,14,1029,7042297.769230769,123.0,73.5
3193337.0,6,18,1577,9,1003,361507.625,315.0,111.44444444444444,9,574,361471.75,78.0,63.77777777777778
5627150.0,6,4,270,2,134,0.0,68.0,67.0,2,136,0.0,70.0,68.0
135128323.0,17,6,1146,6,1146,27025664.6,191.0,191.0,0,0,0.0,0.0,0.0
206159.0,6,3,426,2,280,0.0,214.0,140.0,1,146,0.0,146.0,146.0
119306861.0,6,200,22680,100,6822,1196917.4747474748,140.0,68.22,100,15858,1196775.9595959596,284.0,158.58
300785.0,6,6,412,4,272,100261.66666666669,74.0,68.0,2,140,0.0,74.0,70.0
153530.0,17,2,180,1,90,0.0,90.0,90.0,1,90,0.0,90.0,90.0
135123644.0,17,6,1146,6,1146,27024728.8,191.0,191.0,0,0,0.0,0.0,0.0
308091.0,6,6,412,4,272,102697.0,74.0,68.0,2,140,0.0,74.0,70.0
192061.0,17,2,180,1,90,0.0,90.0,90.0,1,90,0.0,90.0,90.0
306717.0,6,6,412,4,272,102239.0,74.0,68.0,2,140,0.0,74.0,70.0
874254.0,6,10,1333,6,796,174850.8,458.0,132.66666666666666,4,537,200464.3333333333,331.0,134.25
1845.0,17,2,192,1,88,0.0,88.0,88.0,1,104,0.0,104.0,104.0
339654.0,6,3,1604,1,753,0.0,753.0,753.0,2,851,0.0,785.0,425.5
146061.0,6,3,337,2,214,0.0,160.0,107.0,1,123,0.0,123.0,123.0
233339.0,6,3,373,2,238,0.0,172.0,119.0,1,135,0.0,135.0,135.0
108102078.0,17,5,955,5,955,27025519.5,191.0,191.0,0,0,0.0,0.0,0.0
90251999.0,6,12,1832,8,1016,12893142.714285716,188.0,127.0,4,816,30028799.33333333,204.0,204.0
250773.00000000003,17,4,6056,4,6056,83590.99999999999,1514.0,1514.0,0,0,0.0,0.0,0.0
90094095.0,6,11,1644,7,828,15015682.5,188.0,118.28571428571428,4,816,20020713.666666668,204.0,204.0
146155.0,6,3,337,2,214,0.0,160.0,107.0,1,123,0.0,123.0,123.0
196789.0,17,2,180,1,90,0.0,90.0,90.0,1,90,0.0,90.0,90.0
118035900.0,6,30,1974,15,1026,8415728.57142857,123.0,68.4,15,948,8415726.642857144,123.0,63.2
825.0,17,2,762,2,762,0.0,381.0,381.0,0,0,0.0,0.0,0.0
10437569.0,6,7,478,4,272,3433563.333333333,74.0,68.0,3,206,5150249.0,74.0,68.66666666666667
5008.0,17,4,344,2,150,0.0,75.0,75.0,2,194,0.0,103.0,97.0
108109955.0,17,5,1005,5,1005,27027488.75,201.0,201.0,0,0,0.0,0.0,0.0
108095504.0,17,5,1005,5,1005,27023876.0,201.0,201.0,0,0,0.0,0.0,0.0
116377811.0,6,249,28306,125,8472,938530.7338709678,140.0,67.776,124,19834,937848.0975609756,284.0,159.9516129032258
6788.0,17,2,582,1,83,0.0,83.0,83.0,1,499,0.0,499.0,499.0
2006.0,17,4,344,2,150,0.0,75.0,75.0,2,194,0.0,103.0,97.0
102976648.0,6,191,21582,96,15090,1083964.7157894736,284.0,157.1875,95,6492,1084426.085106383,140.0,68.33684210526316
121770295.0,17,14,864,7,432,17000782.166666668,174.0,61.71428571428572,7,432,17000197.833333332,174.0,61.71428571428572
121838.0,6,3,337,2,214,0.0,160.0,107.0,1,123,0.0,123.0,123.0
323354.0,17,4,1400,4,1400,107784.66666666669,350.0,350.0,0,0,0.0,0.0,0.0
501660.0,6,5,336,2,134,0.0,68.0,67.0,3,202,192333.0,70.0,67.33333333333333
119661170.0,6,218,24534,109,17118,1106067.9537037036,284.0,157.045871559633,109,7416,1106074.2777777778,140.0,68.03669724770643
207448.0,17,2,762,2,762,0.0,381.0,381.0,0,0,0.0,0.0,0.0
107701.0,17,2,700,2,700,0.0,350.0,350.0,0,0,0.0,0.0,0.0
308173.0,17,2,246,1,76,0.0,76.0,76.0,1,170,0.0,170.0,170.0
135132345.0,17,6,1206,6,1206,27026469.0,201.0,201.0,0,0,0.0,0.0,0.0
332.0,17,2,208,1,72,0.0,72.0,72.0,1,136,0.0,136.0,136.0
501963.00000000006,6,5,336,2,134,0.0,68.0,67.0,3,202,192564.0,70.0,67.33333333333333
118323349.0,6,33,2274,17,1125,7395209.3125,123.0,66.17647058823529,16,1149,7649565.533333333,123.0,71.8125
40036.0,6,14,4740,7,653,6498.666666666667,249.0,93.28571428571428,7,4087,6340.833333333333,1514.0,583.8571428571429
135132725.0,17,6,1206,6,1206,27026545.0,201.0,201.0,0,0,0.0,0.0,0.0
108104836.0,17,5,955,5,955,27026209.0,191.0,191.0,0,0,0.0,0.0,0.0
196947.0,17,2,180,1,90,0.0,90.0,90.0,1,90,0.0,90.0,90.0
113520250.0,6,46,3036,23,1518,5159999.7727272725,66.0,66.0,23,1518,5160000.181818182,66.0,66.0
207218.0,6,3,426,2,280,0.0,214.0,140.0,1,146,0.0,146.0,146.0
299242.0,17,2,246,1,76,0.0,76.0,76.0,1,170,0.0,170.0,170.0
144863.0,17,2,180,1,70,0.0,70.0,70.0,1,110,0.0,110.0,110.0
105634209.0,6,44,2904,22,1452,5030200.428571428,66.0,66.0,22,1452,5017080.619047619,66.0,66.0
322198.0,17,4,1400,4,1400,107399.33333333331,350.0,350.0,0,0,0.0,0.0,0.0
27026.0,6,10,2032,5,524,6173.5,252.0,104.8,5,1508,6438.75,1236.0,301.6
304.0,17,2,164,1,82,0.0,82.0,82.0,1,82,0.0,82.0,82.0
312.0,17,2,174,1,79,0.0,79.0,79.0,1,95,0.0,95.0,95.0
2595575.0,6,2,132,1,66,0.0,66.0,66.0,1,66,0.0,66.0,66.0
90036355.0,17,28,13364,28,13364,3334679.814814815,501.0,477.2857142857143,0,0,0.0,0.0,0.0
96922048.0,6,181,20382,91,6228,1076911.6444444444,140.0,68.43956043956044,90,14154,1078572.1460674158,284.0,157.26666666666668
51239.0,6,12,1320,6,723,9697.2,253.0,120.5,6,597,6320.4,259.0,99.5
1879.0,17,2,192,1,88,0.0,88.0,88.0,1,104,0.0,104.0,104.0
245329.0,6,3,337,2,214,0.0,160.0,107.0,1,123,0.0,123.0,123.0
459618.0,6,4,508,2,238,0.0,172.0,119.0,2,270,0.0,135.0,135.0
109359.0,17,2,286,2,286,0.0,143.0,143.0,0,0,0.0,0.0,0.0
312693.0,17,4,1400,4,1400,104231.0,350.0,350.0,0,0,0.0,0.0,0.0
105941.0,17,2,700,2,700,0.0,350.0,350.0,0,0,0.0,0.0,0.0
148004.0,17,2,180,1,90,0.0,90.0,90.0,1,90,0.0,90.0,90.0
228380.0,17,2,180,1,90,0.0,90.0,90.0,1,90,0.0,90.0,90.0
145403.0,6,3,337,2,214,0.0,160.0,107.0,1,123,0.0,123.0,123.0
10463939.0,6,7,478,4,272,3442648.333333333,74.0,68.0,3,206,5163867.0,74.0,68.66666666666667
106629.0,17,4,1400,4,1400,35543.0,350.0,350.0,0,0,0.0,0.0,0.0
28989.0,6,14,4740,7,653,4638.333333333333,249.0,93.28571428571428,7,4087,3947.1666666666665,1514.0,583.8571428571429
3006936.0,6,12,2172,7,664,501027.6666666667,252.0,94.85714285714286,5,1508,1640.0,1236.0,301.6
37411.0,6,10,2032,5,524,9120.75,252.0,104.8,5,1508,6919.0,1236.0,301.6
409.0,17,2,410,1,78,0.0,78.0,78.0,1,332,0.0,332.0,332.0
143460.0,6,2,132,1,66,0.0,66.0,66.0,1,66,0.0,66.0,66.0
108404.0,17,2,286,2,286,0.0,143.0,143.0,0,0,0.0,0.0,0.0
120188475.0,6,236,26676,118,8010,1020467.47008547,140.0,67.88135593220339,118,18666,1020102.2393162394,284.0,158.1864406779661
105101.0,17,2,286,2,286,0.0,143.0,143.0,0,0,0.0,0.0,0.0
210348.0,6,3,426,2,280,0.0,214.0,140.0,1,146,0.0,146.0,146.0
197300.0,17,2,180,1,90,0.0,90.0,90.0,1,90,0.0,90.0,90.0
123850555.0,6,49,3234,25,1650,5160439.791666667,66.0,66.0,24,1584,4991870.826086956,66.0,66.0
107273.0,17,2,286,2,286,0.0,143.0,143.0,0,0,0.0,0.0,0.0
10514005.0,6,6,412,3,206,5188928.5,74.0,68.66666666666667,3,206,5188788.5,74.0,68.66666666666667
138795.0,6,2,132,1,66,0.0,66.0,66.0,1,66,0.0,66.0,66.0
357.0,17,2,166,1,75,0.0,75.0,75.0,1,91,0.0,91.0,91.0
85551.0,17,2,180,1,90,0.0,90.0,90.0,1,90,0.0,90.0,90.0
6722.0,17,4,823,2,163,0.0,89.0,81.5,2,660,0.0,443.0,330.0
26911.0,6,10,2032,5,524,6476.0,252.0,104.8,5,1508,5922.0,1236.0,301.6
205915.0,17,2,180,1,90,0.0,90.0,90.0,1,90,0.0,90.0,90.0
216647.0,17,2,180,1,90,0.0,90.0,90.0,1,90,0.0,90.0,90.0
5887.0,17,2,3028,2,3028,0.0,1514.0,1514.0,0,0,0.0,0.0,0.0
1230746.0,6,11,1134,6,558,246149.2,220.0,93.0,5,576,306198.25,304.0,115.2
156596.0,6,3,337,2,214,0.0,160.0,107.0,1,123,0.0,123.0,123.0
307.0,17,2,160,1,80,0.0,80.0,80.0,1,80,0.0,80.0,80.0
32084.0,6,14,4740,7,653,4810.333333333333,249.0,93.28571428571428,7,4087,4771.166666666667,1514.0,583.8571428571429
90455277.0,6,14,2141,8,1080,12922182.42857143,204.0,135.0,6,1061,18057184.4,199.0,176.83333333333334
2019965.0,17,4,525,2,150,0.0,75.0,75.0,2,375,0.0,284.0,187.5
1025642.0,6,11,1134,6,558,205128.4,220.0,93.0,5,576,256002.75,304.0,115.2
103969497.0,6,219,24600,110,7482,953848.5963302752,140.0,68.01818181818182,109,17118,954027.9629629628,284.0,157.045871559633
99918.0,17,2,762,2,762,0.0,381.0,381.0,0,0,0.0,0.0,0.0
95567968.0,17,15,5138,14,4788,5731398.0,342.0,342.0,1,350,0.0,350.0,350.0
90739299.0,6,17,1287,9,691,11336815.5,95.0,76.77777777777777,8,596,12962032.0,95.0,74.5
116876960.0,6,51,4036,27,2156,4486966.923076923,139.0,79.85185185185185,24,1880,5072221.695652174,139.0,78.33333333333333
228286.0,17,2,180,1,90,0.0,90.0,90.0,1,90,0.0,90.0,90.0
297825.0,6,6,412,4,272,99275.0,74.0,68.0,2,140,0.0,74.0,70.0
358.0,17,2,267,1,83,0.0,83.0,83.0,1,184,0.0,184.0,184.0
37413.0,6,14,4740,7,653,6030.666666666667,249.0,93.28571428571428,7,4087,6097.666666666667,1514.0,583.8571428571429
136817.0,6,2,132,1,66,0.0,66.0,66.0,1,66,0.0,66.0,66.0
103752.0,17,2,286,2,286,0.0,143.0,143.0,0,0,0.0,0.0,0.0
1922025.0,6,24,6999,12,1981,174729.54545454544,575.0,165.08333333333334,12,5018,147153.45454545456,1510.0,418.1666666666667
120223713.0,6,238,26918,119,8150,994722.5254237287,140.0,68.4873949579832,119,18768,1011992.0762711863,284.0,157.71428571428572
103409.0,17,2,286,2,286,0.0,143.0,143.0,0,0,0.0,0.0,0.0
224954.0,6,3,426,2,280,0.0,214.0,140.0,1,146,0.0,146.0,146.0
480595.0,17,2,363,1,79,0.0,79.0,79.0,1,284,0.0,284.0,284.0
120057210.0,17,29,13785,29,13785,4287757.5,501.0,475.3448275862069,0,0,0.0,0.0,0.0
135133799.0,17,6,1206,6,1206,27026759.8,201.0,201.0,0,0,0.0,0.0,0.0
244070.0,17,2,180,1,90,0.0,90.0,90.0,1,90,0.0,90.0,90.0
120122333.0,6,12,1832,8,1016,17137160.42857143,188.0,127.0,4,816,30030546.33333333,204.0,204.0
153463.0,17,2,180,1,90,0.0,90.0,90.0,1,90,0.0,90.0,90.0
246092.0,6,3,337,2,214,0.0,160.0,107.0,1,123,0.0,123.0,123.0
333.0,17,2,166,1,75,0.0,75.0,75.0,1,91,0.0,91.0,91.0
2426.0,17,4,344,2,150,0.0,75.0,75.0,2,194,0.0,103.0,97.0
97105681.0,6,184,20760,92,14466,1064730.5384615385,284.0,157.2391304347826,92,6294,1064730.4175824176,140.0,68.41304347826087
153428.0,17,2,180,1,90,0.0,90.0,90.0,1,90,0.0,90.0,90.0
209441.0,17,2,180,1,90,0.0,90.0,90.0,1,90,0.0,90.0,90.0
8294506.999999999,17,3,1034,2,684,0.0,342.0,342.0,1,350,0.0,350.0,350.0
102665.0,17,2,286,2,286,0.0,143.0,143.0,0,0,0.0,0.0,0.0
2017.0,17,4,344,2,150,0.0,75.0,75.0,2,194,0.0,103.0,97.0
32679622.000000004,6,5,336,2,134,0.0,68.0,67.0,3,202,14950205.0,70.0,67.33333333333333
216504.0,17,2,180,1,90,0.0,90.0,90.0,1,90,0.0,90.0,90.0
107037.0,17,2,762,2,762,0.0,381.0,381.0,0,0,0.0,0.0,0.0
46734.0,6,10,2032,5,524,10549.5,252.0,104.8,5,1508,10765.25,1236.0,301.6
15637.000000000002,6,10,2032,5,524,3120.0,252.0,104.8,5,1508,3696.0,1236.0,301.6
243792.0,6,3,426,2,280,0.0,214.0,140.0,1,146,0.0,146.0,146.0
97651076.0,6,32,2358,17,1272,6089691.9375,123.0,74.82352941176471,15,1086,6959646.928571428,123.0,72.4
217947.0,6,3,426,2,280,0.0,214.0,140.0,1,146,0.0,146.0,146.0
117488.0,6,2,132,1,66,0.0,66.0,66.0,1,66,0.0,66.0,66.0
121746.0,6,3,373,2,238,0.0,172.0,119.0,1,135,0.0,135.0,135.0
95678226.0,6,30,2122,15,1105,6818729.214285715,139.0,73.66666666666667,15,1017,6818731.642857143,123.0,67.8
109282.0,17,4,1400,4,1400,36427.333333333336,350.0,350.0,0,0,0.0,0.0,0.0
402937.0,6,3,1604,1,753,0.0,753.0,753.0,2,851,0.0,785.0,425.5
135129062.0,17,6,1146,6,1146,27025812.4,191.0,191.0,0,0,0.0,0.0,0.0
3275.0,17,2,762,2,762,0.0,381.0,381.0,0,0,0.0,0.0,0.0
30122.0,6,14,4740,7,653,4664.666666666667,249.0,93.28571428571428,7,4087,4884.666666666667,1514.0,583.8571428571429
2821731.0,6,11,2106,6,598,564174.2,252.0,99.66666666666669,5,1508,1768.25,1236.0,301.6
10441498.0,6,6,412,3,206,5149773.0,74.0,68.66666666666667,3,206,5149636.5,74.0,68.66666666666667
259813.00000000003,6,3,337,2,214,0.0,160.0,107.0,1,123,0.0,123.0,123.0
30305.0,6,14,4740,7,653,4503.166666666667,249.0,93.28571428571428,7,4087,4810.833333333333,1514.0,583.8571428571429
48638310.0,6,8,1940,3,887,22894754.0,753.0,295.6666666666667,5,1053,11463037.5,785.0,210.6
34463.0,6,11,2098,6,590,6839.0,252.0,98.33333333333331,5,1508,7448.5,1236.0,301.6
2865719.0,6,3,1602,1,752,0.0,752.0,752.0,2,850,0.0,784.0,425.0
1150477.0,6,13,3010,8,2382,164353.85714285713,1514.0,297.75,5,628,219508.75,331.0,125.6
2029.0,17,6,1230,3,234,714.0,78.0,78.0,3,996,800.5,332.0,332.0
9776.0,17,4,823,2,163,0.0,89.0,81.5,2,660,0.0,443.0,330.0
102886.0,17,2,286,2,286,0.0,143.0,143.0,0,0,0.0,0.0,0.0
34764.0,6,14,4740,7,653,5589.333333333333,249.0,93.28571428571428,7,4087,5542.666666666667,1514.0,583.8571428571429
333.0,17,2,166,1,75,0.0,75.0,75.0,1,91,0.0,91.0,91.0
318237.0,17,4,1400,4,1400,106079.0,350.0,350.0,0,0,0.0,0.0,0.0
103301.0,17,2,286,2,286,0.0,143.0,143.0,0,0,0.0,0.0,0.0
16616.0,6,14,4740,7,653,2518.833333333333,249.0,93.28571428571428,7,4087,2623.333333333333,1514.0,583.8571428571429
120468.0,6,3,337,2,214,0.0,160.0,107.0,1,123,0.0,123.0,123.0
109260.0,6,10,1065,5,534,27086.0,262.0,106.8,5,531,2294.75,259.0,106.2
17745.0,6,14,4740,7,653,2019.6666666666667,249.0,93.28571428571428,7,4087,2822.1666666666665,1514.0,583.8571428571429
281264.0,17,2,363,1,79,0.0,79.0,79.0,1,284,0.0,284.0,284.0
874553.0,6,9,1268,6,797,174910.6,459.0,132.83333333333334,3,471,299671.0,331.0,157.0
197026.0,17,2,180,1,90,0.0,90.0,90.0,1,90,0.0,90.0,90.0
35350.0,6,14,4740,7,653,5467.5,249.0,93.28571428571428,7,4087,5026.5,1514.0,583.8571428571429
102127.0,17,2,762,2,762,0.0,381.0,381.0,0,0,0.0,0.0,0.0
44430.0,6,14,4740,7,653,6165.833333333333,249.0,93.28571428571428,7,4087,6486.0,1514.0,583.8571428571429
202863.0,17,4,6056,4,6056,67621.0,1514.0,1514.0,0,0,0.0,0.0,0.0
298007.0,6,6,412,4,272,99335.66666666669,74.0,68.0,2,140,0.0,74.0,70.0
108108702.0,17,5,1005,5,1005,27027175.5,201.0,201.0,0,0,0.0,0.0,0.0
2805980.0,6,2,132,1,66,0.0,66.0,66.0,1,66,0.0,66.0,66.0
2195.0,17,4,344,2,150,0.0,75.0,75.0,2,194,0.0,103.0,97.0
32018.0,6,11,2098,6,590,6101.6,252.0,98.33333333333331,5,1508,5152.25,1236.0,301.6
171592.0,17,2,180,1,90,0.0,90.0,90.0,1,90,0.0,90.0,90.0
90920919.0,6,21,1585,11,840,9091657.3,95.0,76.36363636363636,10,745,10101069.333333334,95.0,74.5
6401.0,17,4,823,2,163,0.0,89.0,81.5,2,660,0.0,443.0,330.0
197078.0,17,2,180,1,90,0.0,90.0,90.0,1,90,0.0,90.0,90.0
144075.0,17,2,180,1,90,0.0,90.0,90.0,1,90,0.0,90.0,90.0
90060783.0,17,28,13364,28,13364,3335584.5555555555,501.0,477.2857142857143,0,0,0.0,0.0,0.0
155187.0,6,3,337,2,214,0.0,160.0,107.0,1,123,0.0,123.0,123.0
437076.0,6,11,1021,6,444,58678.0,162.0,74.0,5,577,73168.25,349.0,115.4
158055.0,6,3,337,2,214,0.0,160.0,107.0,1,123,0.0,123.0,123.0
107764.0,17,2,286,2,286,0.0,143.0,143.0,0,0,0.0,0.0,0.0
254077.0,6,3,337,2,214,0.0,160.0,107.0,1,123,0.0,123.0,123.0
316.0,17,2,174,1,79,0.0,79.0,79.0,1,95,0.0,95.0,95.0
23923.0,6,14,4740,7,653,3522.6666666666665,249.0,93.28571428571428,7,4087,2604.6666666666665,1514.0,583.8571428571429
4589.0,17,2,614,1,72,0.0,72.0,72.0,1,542,0.0,542.0,542.0
36122.0,6,14,4740,7,653,5897.5,249.0,93.28571428571428,7,4087,5260.0,1514.0,583.8571428571429
314.0,17,2,174,1,79,0.0,79.0,79.0,1,95,0.0,95.0,95.0
114380948.0,6,47,3102,24,1584,4959711.0,66.0,66.0,23,1518,5150860.0,66.0,66.0
119514797.0,6,250,28086,125,19540,962084.3145161292,284.0,156.32,125,8546,962084.0483870968,140.0,68.368
42037.0,6,14,4740,7,653,6875.5,249.0,93.28571428571428,7,4087,6801.333333333333,1514.0,583.8571428571429
10869296.0,6,8,544,4,272,3577876.0,74.0,68.0,4,272,3577792.6666666665,74.0,68.0
32045.0,6,10,2032,5,524,6710.0,252.0,104.8,5,1508,7450.5,1236.0,301.6
90254420.0,6,13,2036,8,1016,12893488.57142857,188.0,127.0,5,1020,22521869.5,204.0,204.0
135137925.0,17,6,1206,6,1206,27027585.0,201.0,201.0,0,0,0.0,0.0,0.0
61279.0,6,14,4740,7,653,9981.333333333334,249.0,93.28571428571428,7,4087,10070.666666666666,1514.0,583.8571428571429
46775503.0,6,8,1940,3,887,22397624.5,753.0,295.6666666666667,5,1053,11003158.25,785.0,210.6
44583.0,6,14,4740,7,653,5393.666666666667,249.0,93.28571428571428,7,4087,5925.0,1514.0,583.8571428571429
445.0,17,2,508,2,508,0.0,257.0,254.0,0,0,0.0,0.0,0.0
154148.0,17,2,414,1,88,0.0,88.0,88.0,1,326,0.0,326.0,326.0
214632.0,6,14,4740,7,653,19942.666666666668,249.0,93.28571428571428,7,4087,34850.666666666664,1514.0,583.8571428571429
861524.0,6,4,264,2,132,0.0,66.0,66.0,2,132,0.0,66.0,66.0
2928.0,17,4,344,2,150,0.0,75.0,75.0,2,194,0.0,103.0,97.0
31977.0,6,14,4740,7,653,5210.0,249.0,93.28571428571428,7,4087,5194.166666666667,1514.0,583.8571428571429
144003.0,17,2,180,1,90,0.0,90.0,90.0,1,90,0.0,90.0,90.0
58239.0,6,14,4740,7,653,9199.5,249.0,93.28571428571428,7,4087,9384.333333333334,1514.0,583.8571428571429
34346.0,6,14,4740,7,653,5548.0,249.0,93.28571428571428,7,4087,5342.333333333333,1514.0,583.8571428571429
52614.0,6,14,4740,7,653,8107.5,249.0,93.28571428571428,7,4087,8431.5,1514.0,583.8571428571429
127398854.0,17,14,864,7,432,18000932.166666668,174.0,61.71428571428572,7,432,18000189.166666668,174.0,61.71428571428572
1443.0,17,5,550,5,550,360.75,110.0,110.0,0,0,0.0,0.0,0.0
196879.0,17,2,180,1,90,0.0,90.0,90.0,1,90,0.0,90.0,90.0
102880104.0,6,43,2838,22,1452,4899040.142857143,66.0,66.0,21,1386,5143990.15,66.0,66.0
42397.0,6,14,4740,7,653,6903.666666666667,249.0,93.28571428571428,7,4087,5455.0,1514.0,583.8571428571429
2031.0,17,4,344,2,150,0.0,75.0,75.0,2,194,0.0,103.0,97.0
90284709.0,6,14,2240,8,1016,12897815.57142857,188.0,127.0,6,1224,18023985.4,204.0,204.0
90222900.0,6,24,2212,11,899,8996979.4,154.0,81.72727272727273,13,1313,7500569.25,257.0,101.0
21476.0,6,14,4740,7,653,3078.1666666666665,249.0,93.28571428571428,7,4087,3396.1666666666665,1514.0,583.8571428571429
1317116.0,6,4,264,2,132,0.0,66.0,66.0,2,132,0.0,66.0,66.0
99626085.0,17,12,778,6,389,19899938.4,174.0,64.83333333333333,6,389,19893196.8,174.0,64.83333333333333
299.0,17,2,164,1,82,0.0,82.0,82.0,1,82,0.0,82.0,82.0
254479.0,6,12,1373,7,714,42413.16666666666,298.0,102.0,5,659,59409.0,379.0,131.8
216553.0,6,3,426,2,280,0.0,214.0,140.0,1,146,0.0,146.0,146.0
307352.0,6,6,412,4,272,102450.66666666669,74.0,68.0,2,140,0.0,74.0,70.0
120205357.0,6,230,26084,115,7886,1047294.5789473684,140.0,68.57391304347826,115,18198,1047168.7894736842,374.0,158.24347826086955
227708.0,6,12,1373,7,714,37951.333333333336,298.0,102.0,5,659,55944.5,379.0,131.8
120361939.0,6,221,25056,111,17574,1094199.4454545456,284.0,158.32432432432432,110,7482,1094792.1651376146,140.0,68.01818181818182
90056112.0,17,28,13364,28,13364,3335411.5555555555,501.0,477.2857142857143,0,0,0.0,0.0,0.0
155202.0,6,3,337,2,214,0.0,160.0,107.0,1,123,0.0,123.0,123.0
1298843.0,6,4,264,2,132,0.0,66.0,66.0,2,132,0.0,66.0,66.0
102744582.0,6,31,2182,16,1165,6835222.733333333,139.0,72.8125,15,1017,7323451.071428572,123.0,67.8
7182.0,17,2,582,1,83,0.0,83.0,83.0,1,499,0.0,499.0,499.0
12958496.0,17,20,7568,20,7568,682026.1052631579,394.0,378.4,0,0,0.0,0.0,0.0
120145343.0,6,230,26174,115,7886,1046640.903508772,140.0,68.57391304347826,115,18288,1049123.8596491227,374.0,159.02608695652174
135128747.0,17,6,1146,6,1146,27025749.4,191.0,191.0,0,0,0.0,0.0,0.0
0.0,6,1,172,1,172,0.0,172.0,172.0,0,0,0.0,0.0,0.0
2308.0,17,4,344,2,150,0.0,75.0,75.0,2,194,0.0,103.0,97.0
1303047.0,17,6,1230,3,234,651311.0,78.0,78.0,3,996,647351.0,332.0,332.0
196904.0,17,2,180,1,90,0.0,90.0,90.0,1,90,0.0,90.0,90.0
840.0,17,4,438,2,148,0.0,74.0,74.0,2,290,0.0,147.0,145.0
10436829.0,6,7,478,4,272,3433687.6666666665,74.0,68.0,3,206,5150435.5,74.0,68.66666666666667
303095.0,6,6,412,4,272,101031.66666666669,74.0,68.0,2,140,0.0,74.0,70.0
921908.0,6,12,2715,7,743,153651.33333333334,339.0,106.14285714285714,5,1972,162353.5,1514.0,394.4
307.0,17,2,174,1,79,0.0,79.0,79.0,1,95,0.0,95.0,95.0
2509765.0,6,25,7573,14,3735,193058.84615384616,1514.0,266.7857142857143,11,3838,224672.3,1514.0,348.90909090909093
103370.0,17,2,286,2,286,0.0,143.0,143.0,0,0,0.0,0.0,0.0
487533.0,6,4,1670,2,851,0.0,785.0,425.5,2,819,0.0,753.0,409.5
90253158.0,6,14,2240,8,1016,12893308.285714284,188.0,127.0,6,1224,18017889.4,204.0,204.0
117721760.0,17,16,1212,8,606,16794691.14285714,174.0,75.75,8,606,16691264.57142857,174.0,75.75
90216700.0,6,26,2105,12,1062,8179392.363636363,222.0,88.5,14,1043,6924003.538461538,95.0,74.5
108106135.0,17,5,1005,5,1005,27026533.75,201.0,201.0,0,0,0.0,0.0,0.0
388.0,17,2,762,2,762,0.0,381.0,381.0,0,0,0.0,0.0,0.0
260651.00000000003,6,3,337,2,214,0.0,160.0,107.0,1,123,0.0,123.0,123.0
301756.0,6,6,412,4,272,100585.33333333331,74.0,68.0,2,140,0.0,74.0,70.0
249182.0,6,10,1221,6,636,49836.4,298.0,106.0,4,585,77651.33333333333,379.0,146.25
103005.0,17,2,286,2,286,0.0,143.0,143.0,0,0,0.0,0.0,0.0
55387.0,6,11,1131,6,600,10806.8,262.0,100.0,5,531,2867.0,259.0,106.2
135129220.0,17,6,1206,6,1206,27025844.0,201.0,201.0,0,0,0.0,0.0,0.0
161124.0,6,3,337,2,214,0.0,160.0,107.0,1,123,0.0,123.0,123.0
135130358.0,17,6,1146,6,1146,27026071.6,191.0,191.0,0,0,0.0,0.0,0.0
3006983.0,6,11,2106,6,598,601224.8,252.0,99.66666666666669,5,1508,1686.0,1236.0,301.6
4294.0,17,2,614,1,72,0.0,72.0,72.0,1,542,0.0,542.0,542.0
819.0,17,4,438,2,148,0.0,74.0,74.0,2,290,0.0,147.0,145.0
32849.0,6,14,4740,7,653,5349.666666666667,249.0,93.28571428571428,7,4087,5337.333333333333,1514.0,583.8571428571429
103015.0,17,2,286,2,286,0.0,143.0,143.0,0,0,0.0,0.0,0.0
233888.0,6,3,337,2,214,0.0,160.0,107.0,1,123,0.0,123.0,123.0
18054.0,6,14,4740,7,653,2695.6666666666665,249.0,93.28571428571428,7,4087,2470.6666666666665,1514.0,583.8571428571429
218499.0,6,3,426,2,280,0.0,214.0,140.0,1,146,0.0,146.0,146.0
228404.0,17,2,180,1,90,0.0,90.0,90.0,1,90,0.0,90.0,90.0
2659.0,17,2,762,2,762,0.0,381.0,381.0,0,0,0.0,0.0,0.0
228298.0,17,2,180,1,90,0.0,90.0,90.0,1,90,0.0,90.0,90.0
312813.0,17,4,1400,4,1400,104271.0,350.0,350.0,0,0,0.0,0.0,0.0
23343.0,6,14,4679,7,596,3742.8333333333335,192.0,85.14285714285714,7,4083,3742.8333333333335,1514.0,583.2857142857143
96593454.0,17,15,5138,14,4788,5730830.384615385,342.0,342.0,1,350,0.0,350.0,350.0
441089.0,6,10,967,5,390,74153.25,162.0,78.0,5,577,74094.75,349.0,115.4
90257213.0,6,16,2368,9,1204,11282151.625,188.0,133.77777777777777,7,1164,15015517.166666666,204.0,166.28571428571428
90524080.0,6,14,2240,8,1016,12932011.42857143,188.0,127.0,6,1224,18072604.8,204.0,204.0
90021277.0,17,28,13364,28,13364,3334121.3703703703,501.0,477.2857142857143,0,0,0.0,0.0,0.0
29969.0,6,10,2032,5,524,7257.75,252.0,104.8,5,1508,7087.0,1236.0,301.6
108109598.0,17,5,1005,5,1005,27027399.5,201.0,201.0,0,0,0.0,0.0,0.0
90929133.0,6,21,1585,11,840,9092255.4,95.0,76.36363636363636,10,745,10102369.333333334,95.0,74.5
119755.0,17,2,180,1,70,0.0,70.0,70.0,1,110,0.0,110.0,110.0
12146.0,6,11,1133,6,602,2429.2,264.0,100.33333333333331,5,531,2402.25,259.0,106.2
14658326.0,6,20,1607,10,975,1594013.7777777778,315.0,97.5,10,632,1594005.888888889,78.0,63.2
37088.0,6,14,4740,7,653,6068.0,249.0,93.28571428571428,7,4087,5475.0,1514.0,583.8571428571429
120371585.0,6,229,25874,115,18054,1055891.096491228,284.0,156.9913043478261,114,7820,1056065.4336283186,140.0,68.59649122807018
44480.0,6,10,2032,5,524,10286.0,252.0,104.8,5,1508,10864.25,1236.0,301.6
529571.0,17,6,2100,6,2100,105914.2,350.0,350.0,0,0,0.0,0.0,0.0
310877.0,6,5,336,3,202,155438.5,70.0,67.33333333333333,2,134,0.0,68.0,67.0
1777669.0,6,2,132,1,66,0.0,66.0,66.0,1,66,0.0,66.0,66.0
18334.0,6,14,4740,7,653,2880.6666666666665,249.0,93.28571428571428,7,4087,2919.833333333333,1514.0,583.8571428571429
217682.0,6,3,426,2,280,0.0,214.0,140.0,1,146,0.0,146.0,146.0
135130353.0,17,6,1146,6,1146,27026070.6,191.0,191.0,0,0,0.0,0.0,0.0
31222.0,6,14,4740,7,653,5031.0,249.0,93.28571428571428,7,4087,4531.333333333333,1514.0,583.8571428571429
21228.0,6,2,145,2,145,0.0,91.0,72.5,0,0,0.0,0.0,0.0
37990.0,6,14,4740,7,653,6224.5,249.0,93.28571428571428,7,4087,6192.5,1514.0,583.8571428571429
234381.0,6,3,426,2,280,0.0,214.0,140.0,1,146,0.0,146.0,146.0
107938.0,17,2,700,2,700,0.0,350.0,350.0,0,0,0.0,0.0,0.0
108112056.0,17,5,1005,5,1005,27028014.0,201.0,201.0,0,0,0.0,0.0,0.0
124005932.0,17,15,1169,8,606,17715133.14285714,174.0,75.75,7,563,17333578.333333332,174.0,80.42857142857143
125016250.0,17,15,907,8,475,17859464.285714287,174.0,59.375,7,432,17500158.5,174.0,61.71428571428572
19967.0,17,2,582,1,83,0.0,83.0,83.0,1,499,0.0,499.0,499.0
91435063.0,6,24,1829,13,989,7617723.166666667,95.0,76.07692307692308,11,840,9142937.5,95.0,76.36363636363636
10491142.0,6,7,478,4,272,3449983.333333333,74.0,68.0,3,206,5174827.5,74.0,68.66666666666667
1775552.0,6,2,132,1,66,0.0,66.0,66.0,1,66,0.0,66.0,66.0
120126999.0,6,15,2444,7,1428,20021166.5,204.0,204.0,8,1016,17137183.714285713,188.0,127.0
3556.0,17,2,414,1,88,0.0,88.0,88.0,1,326,0.0,326.0,326.0
120057.0,17,2,180,1,70,0.0,70.0,70.0,1,110,0.0,110.0,110.0
105802.0,17,2,286,2,286,0.0,143.0,143.0,0,0,0.0,0.0,0.0
48305.0,6,10,2032,5,524,11852.75,252.0,104.8,5,1508,11528.0,1236.0,301.6
90019474.0,17,28,13364,28,13364,3334054.592592593,501.0,477.2857142857143,0,0,0.0,0.0,0.0
20589.0,17,2,582,1,83,0.0,83.0,83.0,1,499,0.0,499.0,499.0
1171600.0,6,13,3005,8,2377,167371.42857142858,1514.0,297.125,5,628,223959.25,331.0,125.6
1967.0,17,4,344,2,150,0.0,75.0,75.0,2,194,0.0,103.0,97.0
22599.0,6,14,4740,7,653,3518.333333333333,249.0,93.28571428571428,7,4087,3630.0,1514.0,583.8571428571429
3086774.0,6,4,270,2,134,0.0,68.0,67.0,2,136,0.0,70.0,68.0
108126231.0,17,5,1005,5,1005,27031557.75,201.0,201.0,0,0,0.0,0.0,0.0
207341.0,6,3,426,2,280,0.0,214.0,140.0,1,146,0.0,146.0,146.0
0.0,17,1,72,1,72,0.0,72.0,72.0,0,0,0.0,0.0,0.0
41299.0,6,14,4740,7,653,6758.0,249.0,93.28571428571428,7,4087,6744.166666666667,1514.0,583.8571428571429
106888080.0,6,28,1860,14,966,8205544.538461538,123.0,69.0,14,894,8205542.615384615,123.0,63.85714285714285
135128682.0,17,6,1206,6,1206,27025736.4,201.0,201.0,0,0,0.0,0.0,0.0
4486.0,17,2,618,1,72,0.0,72.0,72.0,1,546,0.0,546.0,546.0
27175563.0,17,5,1710,5,1710,6793890.75,342.0,342.0,0,0,0.0,0.0,0.0
311343.0,6,6,412,4,272,103781.0,74.0,68.0,2,140,0.0,74.0,70.0
36019.0,6,10,2032,5,524,7618.0,252.0,104.8,5,1508,8220.0,1236.0,301.6
120218277.0,6,232,26232,116,7878,1038235.9304347826,140.0,67.91379310344827,116,18354,1038343.852173913,284.0,158.22413793103448
210108.0,6,10,1221,6,636,42021.6,298.0,106.0,4,585,69162.0,379.0,146.25
2010.0,17,4,344,2,150,0.0,75.0,75.0,2,194,0.0,103.0,97.0
120317653.0,6,217,24670,109,17246,1114052.3425925926,284.0,158.22018348623854,108,7424,1114928.6728971964,140.0,68.74074074074075
104444497.0,6,195,22234,98,6690,1076747.3917525774,140.0,68.26530612244898,97,15544,1084272.46875,300.0,160.24742268041237
0.0,6,1,54,0,0,0.0,0.0,0.0,1,54,0.0,54.0,54.0
51183.0,6,10,2032,5,524,12556.25,252.0,104.8,5,1508,10012.25,1236.0,301.6
0.0,17,1,381,1,381,0.0,381.0,381.0,0,0,0.0,0.0,0.0
143902.0,17,2,180,1,90,0.0,90.0,90.0,1,90,0.0,90.0,90.0
2881.0,17,2,224,1,76,0.0,76.0,76.0,1,148,0.0,148.0,148.0
2303.0,17,4,344,2,150,0.0,75.0,75.0,2,194,0.0,103.0,97.0
298119.0,6,6,412,4,272,99373.0,74.0,68.0,2,140,0.0,74.0,70.0
120239169.0,6,627,109282,315,88246,382927.2898089172,1514.0,280.1460317460317,312,21036,385154.4115755627,214.0,67.42307692307692
207794.0,6,3,426,2,280,0.0,214.0,140.0,1,146,0.0,146.0,146.0
14651.0,6,11,1132,6,556,2930.2,218.0,92.66666666666669,5,576,2581.75,304.0,115.2
2065.0,17,4,344,2,150,0.0,75.0,75.0,2,194,0.0,103.0,97.0
318496.0,17,4,1400,4,1400,106165.33333333331,350.0,350.0,0,0,0.0,0.0,0.0
75151191.0,6,9,842,9,842,9393898.875,97.0,93.55555555555556,0,0,0.0,0.0,0.0
40430.0,6,10,2032,5,524,9867.0,252.0,104.8,5,1508,9797.75,1236.0,301.6
163951.0,6,3,337,2,214,0.0,160.0,107.0,1,123,0.0,123.0,123.0
3068044.0,6,2,132,1,66,0.0,66.0,66.0,1,66,0.0,66.0,66.0
371.0,17,2,267,1,83,0.0,83.0,83.0,1,184,0.0,184.0,184.0
53707.0,6,10,1065,5,534,12678.75,262.0,106.8,5,531,12757.25,259.0,106.2
153465.0,17,2,180,1,90,0.0,90.0,90.0,1,90,0.0,90.0,90.0
147951.0,17,2,180,1,90,0.0,90.0,90.0,1,90,0.0,90.0,90.0
17520.0,6,11,2098,6,590,3062.6,252.0,98.33333333333331,5,1508,3893.75,1236.0,301.6
3985.0,17,2,582,1,83,0.0,83.0,83.0,1,499,0.0,499.0,499.0
10489176.0,6,7,478,4,272,3449775.6666666665,74.0,68.0,3,206,5174564.5,74.0,68.66666666666667
26808.0,6,14,4740,7,653,3821.1666666666665,249.0,93.28571428571428,7,4087,3970.5,1514.0,583.8571428571429
16917.0,17,2,180,1,90,0.0,90.0,90.0,1,90,0.0,90.0,90.0
201753.0,17,2,180,1,90,0.0,90.0,90.0,1,90,0.0,90.0,90.0
2798572.0,6,2,132,1,66,0.0,66.0,66.0,1,66,0.0,66.0,66.0
277700.0,6,10,1221,6,636,55540.0,298.0,106.0,4,585,86426.66666666667,379.0,146.25
2407.0,17,4,344,2,150,0.0,75.0,75.0,2,194,0.0,103.0,97.0
90059400.0,17,28,13364,28,13364,3335533.333333333,501.0,477.2857142857143,0,0,0.0,0.0,0.0
119853593.0,6,13,1898,9,1082,14981699.125,188.0,120.22222222222224,4,816,30030674.33333333,204.0,204.0
453505.0,17,2,363,1,75,0.0,75.0,75.0,1,288,0.0,288.0,288.0
78333.0,6,12,1320,7,789,13055.5,253.0,112.71428571428572,5,531,15088.0,259.0,106.2
110573802.0,6,32,2236,16,1165,7357196.466666667,139.0,72.8125,16,1071,7357197.733333333,123.0,66.9375
153440.0,17,2,180,1,90,0.0,90.0,90.0,1,90,0.0,90.0,90.0
2948940.0,6,2,132,1,66,0.0,66.0,66.0,1,66,0.0,66.0,66.0
25225.0,6,20,7606,11,978,2522.5,310.0,88.9090909090909,9,6628,2910.5,1514.0,736.4444444444445
299670.0,6,6,412,4,272,99890.0,74.0,68.0,2,140,0.0,74.0,70.0
125001112.0,17,15,907,8,475,17857301.714285713,174.0,59.375,7,432,17501157.166666668,174.0,61.71428571428572
90096916.0,6,11,1644,4,816,30031492.0,204.0,204.0,7,828,15015761.5,188.0,118.28571428571428
119438423.0,6,219,24818,110,17328,1095765.3486238532,284.0,157.52727272727273,109,7490,1096360.5277777778,140.0,68.71559633027523
21762.0,6,14,4740,7,653,2497.6666666666665,249.0,93.28571428571428,7,4087,3140.333333333333,1514.0,583.8571428571429
143934.0,17,2,180,1,90,0.0,90.0,90.0,1,90,0.0,90.0,90.0
10123.0,17,2,582,1,83,0.0,83.0,83.0,1,499,0.0,499.0,499.0
24028439.0,17,3,1026,3,1026,12014219.5,342.0,342.0,0,0,0.0,0.0,0.0
220286.0,6,3,426,2,280,0.0,214.0,140.0,1,146,0.0,146.0,146.0
148007.0,6,3,373,2,238,0.0,172.0,119.0,1,135,0.0,135.0,135.0
105453811.0,6,43,2838,22,1452,5021598.142857143,66.0,66.0,21,1386,5159995.35,66.0,66.0
233597.0,6,3,337,2,214,0.0,160.0,107.0,1,123,0.0,123.0,123.0
44923.0,6,12,1413,7,882,7487.166666666667,291.0,126.0,5,531,9061.25,259.0,106.2
2596036.0,6,2,132,1,66,0.0,66.0,66.0,1,66,0.0,66.0,66.0
228275.0,17,2,180,1,90,0.0,90.0,90.0,1,90,0.0,90.0,90.0
291378.0,17,2,180,1,90,0.0,90.0,90.0,1,90,0.0,90.0,90.0
316157.0,17,4,1400,4,1400,105385.66666666669,350.0,350.0,0,0,0.0,0.0,0.0
107090.0,17,2,700,2,700,0.0,350.0,350.0,0,0,0.0,0.0,0.0
49064.0,6,14,4740,7,653,7678.333333333333,249.0,93.28571428571428,7,4087,8039.5,1514.0,583.8571428571429
216778.0,6,3,426,2,280,0.0,214.0,140.0,1,146,0.0,146.0,146.0
201784.0,17,4,6056,4,6056,67261.33333333333,1514.0,1514.0,0,0,0.0,0.0,0.0
102888.0,17,2,286,2,286,0.0,143.0,143.0,0,0,0.0,0.0,0.0
228305.0,17,2,180,1,90,0.0,90.0,90.0,1,90,0.0,90.0,90.0
108107952.0,17,5,955,5,955,27026988.0,191.0,191.0,0,0,0.0,0.0,0.0
16793.0,17,2,180,1,90,0.0,90.0,90.0,1,90,0.0,90.0,90.0
50021.0,6,14,4740,7,653,8182.0,249.0,93.28571428571428,7,4087,7875.0,1514.0,583.8571428571429
206894.0,17,2,180,1,90,0.0,90.0,90.0,1,90,0.0,90.0,90.0
24789.0,6,10,2032,5,524,5980.0,252.0,104.8,5,1508,4980.25,1236.0,301.6
108106231.0,17,5,955,5,955,27026557.75,191.0,191.0,0,0,0.0,0.0,0.0
100061150.0,17,12,778,6,389,19945752.0,174.0,64.83333333333333,6,389,19980448.2,174.0,64.83333333333333
12339.0,6,13,1459,7,862,1926.6666666666667,271.0,123.14285714285714,6,597,2314.6,259.0,99.5
12114357.0,6,8,602,5,404,3028247.25,103.0,80.8,3,198,153046.5,66.0,66.0
39442515.0,6,33,10980,18,3951,140778.41176470587,1514.0,219.5,15,7029,2802691.9285714286,1514.0,468.6
331.0,17,2,156,1,78,0.0,78.0,78.0,1,78,0.0,78.0,78.0
120118971.0,6,12,1832,8,1016,17136903.57142857,188.0,127.0,4,816,30030001.33333333,204.0,204.0
216636.0,17,2,180,1,90,0.0,90.0,90.0,1,90,0.0,90.0,90.0
5409.0,17,2,180,1,90,0.0,90.0,90.0,1,90,0.0,90.0,90.0
481537.0,6,3,1604,1,753,0.0,753.0,753.0,2,851,0.0,785.0,425.5
36408.0,6,14,4740,7,653,5853.666666666667,249.0,93.28571428571428,7,4087,5399.333333333333,1514.0,583.8571428571429
405.0,17,2,410,1,78,0.0,78.0,78.0,1,332,0.0,332.0,332.0
302260.0,6,6,412,4,272,100753.33333333331,74.0,68.0,2,140,0.0,74.0,70.0
308329.0,6,6,412,4,272,102776.33333333331,74.0,68.0,2,140,0.0,74.0,70.0
58508.0,6,14,4740,7,653,8952.0,249.0,93.28571428571428,7,4087,8775.5,1514.0,583.8571428571429
6435.0,17,4,823,2,163,0.0,89.0,81.5,2,660,0.0,443.0,330.0
314.0,17,2,174,1,79,0.0,79.0,79.0,1,95,0.0,95.0,95.0
2795491.0,6,2,132,1,66,0.0,66.0,66.0,1,66,0.0,66.0,66.0
107223.0,17,2,286,2,286,0.0,143.0,143.0,0,0,0.0,0.0,0.0
303638.0,6,2,132,1,66,0.0,66.0,66.0,1,66,0.0,66.0,66.0
1758200.0,6,22,6443,12,1529,159836.36363636365,357.0,127.41666666666669,10,4914,161101.11111111112,1510.0,491.4
1311911.0,17,7,490,7,490,218651.8333333333,70.0,70.0,0,0,0.0,0.0,0.0
1036309.0,6,11,1134,6,558,207261.8,220.0,93.0,5,576,256761.75,304.0,115.2
9809.0,17,4,344,2,150,0.0,75.0,75.0,2,194,0.0,103.0,97.0
16509.0,6,14,4740,7,653,2630.833333333333,249.0,93.28571428571428,7,4087,2619.5,1514.0,583.8571428571429
322740.0,6,5,367,3,235,161370.0,103.0,78.33333333333333,2,132,0.0,66.0,66.0
135128019.0,17,6,1146,6,1146,27025603.8,191.0,191.0,0,0,0.0,0.0,0.0
51779.0,6,10,2032,5,524,10515.25,252.0,104.8,5,1508,12682.25,1236.0,301.6
112064089.0,6,31,2182,16,1165,7470939.266666667,139.0,72.8125,15,1017,7989127.428571428,123.0,67.8
313605.0,17,2,180,1,90,0.0,90.0,90.0,1,90,0.0,90.0,90.0
55198.0,6,14,4740,7,653,7975.0,249.0,93.28571428571428,7,4087,8268.333333333334,1514.0,583.8571428571429
90269819.0,6,16,2368,9,1204,11283727.375,188.0,133.77777777777777,7,1164,15017284.833333334,204.0,166.28571428571428
5586504.0,6,4,270,2,134,0.0,68.0,67.0,2,136,0.0,70.0,68.0
10469213.0,6,7,478,4,272,3444301.333333333,74.0,68.0,3,206,5166332.0,74.0,68.66666666666667
82771.0,6,19,7540,10,912,9110.444444444443,310.0,91.2,9,6628,10034.625,1514.0,736.4444444444445
85300.0,6,17,5768,9,750,10662.5,202.0,83.33333333333333,8,5018,11429.714285714286,1514.0,627.25
0.0,17,1,55,1,55,0.0,55.0,55.0,0,0,0.0,0.0,0.0
90032437.0,17,28,13364,28,13364,3334534.703703704,501.0,477.2857142857143,0,0,0.0,0.0,0.0
108106322.0,17,5,1005,5,1005,27026580.5,201.0,201.0,0,0,0.0,0.0,0.0
2797971.0,6,2,132,1,66,0.0,66.0,66.0,1,66,0.0,66.0,66.0
0.0,17,1,55,1,55,0.0,55.0,55.0,0,0,0.0,0.0,0.0
217973.0,17,2,180,1,90,0.0,90.0,90.0,1,90,0.0,90.0,90.0
117932321.0,6,27,2032,14,1084,9068377.461538462,95.0,77.42857142857143,13,948,9825817.416666666,95.0,72.92307692307692
202505.0,6,12,1373,7,714,33750.833333333336,298.0,102.0,5,659,49670.0,379.0,131.8
1057698.0,6,13,1394,7,797,176283.0,253.0,113.85714285714286,6,597,208559.0,259.0,99.5
90299315.0,6,16,1192,8,596,12892463.857142856,95.0,74.5,8,596,12898870.285714284,95.0,74.5
28547.0,6,14,4740,7,653,4296.833333333333,249.0,93.28571428571428,7,4087,4434.833333333333,1514.0,583.8571428571429
787.0,17,4,438,2,148,0.0,74.0,74.0,2,290,0.0,147.0,145.0
339.0,17,2,160,1,80,0.0,80.0,80.0,1,80,0.0,80.0,80.0
233499.0,6,3,373,2,238,0.0,172.0,119.0,1,135,0.0,135.0,135.0
90045758.0,17,28,13364,28,13364,3335028.074074074,501.0,477.2857142857143,0,0,0.0,0.0,0.0
96565265.0,17,14,1126,7,563,16094210.833333334,174.0,80.42857142857143,7,563,15990247.833333334,174.0,80.42857142857143
2576061.0,6,2,132,1,66,0.0,66.0,66.0,1,66,0.0,66.0,66.0
143890.0,17,2,180,1,90,0.0,90.0,90.0,1,90,0.0,90.0,90.0
100801679.0,17,12,778,6,389,20160335.8,174.0,64.83333333333333,6,389,19990791.6,174.0,64.83333333333333
2404.0,17,4,344,2,150,0.0,75.0,75.0,2,194,0.0,103.0,97.0
2029.0,17,4,344,2,150,0.0,75.0,75.0,2,194,0.0,103.0,97.0
135132324.0,17,6,1146,6,1146,27026464.8,191.0,191.0,0,0,0.0,0.0,0.0
144836.0,17,2,180,1,90,0.0,90.0,90.0,1,90,0.0,90.0,90.0
1063258.0,6,3,204,2,136,0.0,70.0,68.0,1,68,0.0,68.0,68.0
99353786.0,17,12,778,6,389,19800161.0,174.0,64.83333333333333,6,389,19791904.6,174.0,64.83333333333333
106983.0,17,2,286,2,286,0.0,143.0,143.0,0,0,0.0,0.0,0.0
39873.0,6,14,4740,7,653,5992.666666666667,249.0,93.28571428571428,7,4087,6423.666666666667,1514.0,583.8571428571429
108101403.0,17,5,955,5,955,27025350.75,191.0,191.0,0,0,0.0,0.0,0.0
307162.0,6,6,412,4,272,102387.33333333331,74.0,68.0,2,140,0.0,74.0,70.0
302042.0,6,6,412,4,272,100680.66666666669,74.0,68.0,2,140,0.0,74.0,70.0
102929.0,17,2,286,2,286,0.0,143.0,143.0,0,0,0.0,0.0,0.0
2796273.0,6,2,132,1,66,0.0,66.0,66.0,1,66,0.0,66.0,66.0
36981.0,6,14,4740,7,653,5088.333333333333,249.0,93.28571428571428,7,4087,6010.5,1514.0,583.8571428571429
108108841.0,17,5,955,5,955,27027210.25,191.0,191.0,0,0,0.0,0.0,0.0
108109135.0,17,5,955,5,955,27027283.75,191.0,191.0,0,0,0.0,0.0,0.0
293481.0,6,6,412,4,272,97827.0,74.0,68.0,2,140,0.0,74.0,70.0
10933528.0,6,8,544,4,272,3599115.333333333,74.0,68.0,4,272,3599021.6666666665,74.0,68.0
108108510.0,17,5,1005,5,1005,27027127.5,201.0,201.0,0,0,0.0,0.0,0.0
32583.0,6,14,4740,7,653,4687.833333333333,249.0,93.28571428571428,7,4087,4932.0,1514.0,583.8571428571429
52009.0,6,14,4740,7,653,8502.333333333334,249.0,93.28571428571428,7,4087,8528.0,1514.0,583.8571428571429
139412.0,6,2,132,1,66,0.0,66.0,66.0,1,66,0.0,66.0,66.0
5622727.0,6,5,336,2,134,0.0,68.0,67.0,3,202,1522846.0,70.0,67.33333333333333
98901.0,17,2,762,2,762,0.0,381.0,381.0,0,0,0.0,0.0,0.0
7347984.0,6,10,746,4,264,1706240.6666666667,66.0,66.0,6,482,1121967.2,103.0,80.33333333333333
232047.0,6,3,337,2,214,0.0,160.0,107.0,1,123,0.0,123.0,123.0
153415.0,17,2,180,1,90,0.0,90.0,90.0,1,90,0.0,90.0,90.0
4600205.0,6,5,336,2,134,0.0,68.0,67.0,3,202,1527620.5,70.0,67.33333333333333
112059682.0,6,34,2350,17,1225,6990228.875,139.0,72.05882352941177,17,1125,6990229.9375,123.0,66.17647058823529
119849816.0,17,34,16284,34,16284,3631812.606060606,501.0,478.9411764705882,0,0,0.0,0.0,0.0
90534053.0,6,13,2036,8,1016,12933436.142857144,188.0,127.0,5,1020,22591993.25,204.0,204.0
13376.0,6,11,1131,6,600,2423.2,262.0,100.0,5,531,3045.75,259.0,106.2
23584.0,6,14,4740,7,653,3762.5,249.0,93.28571428571428,7,4087,3783.5,1514.0,583.8571428571429
901599.0,6,12,2715,7,743,150266.5,339.0,106.14285714285714,5,1972,156501.75,1514.0,394.4
105044943.0,6,44,2904,22,1452,5002140.142857143,66.0,66.0,22,1452,4987170.095238095,66.0,66.0
206218.0,6,3,426,2,280,0.0,214.0,140.0,1,146,0.0,146.0,146.0
210165.0,17,2,180,1,90,0.0,90.0,90.0,1,90,0.0,90.0,90.0
3675301.0,6,5,336,2,134,0.0,68.0,67.0,3,202,1474828.0,70.0,67.33333333333333
143893.0,17,2,180,1,90,0.0,90.0,90.0,1,90,0.0,90.0,90.0
301075.0,6,6,412,4,272,100358.33333333331,74.0,68.0,2,140,0.0,74.0,70.0
54980.0,6,14,4740,7,653,8995.333333333334,249.0,93.28571428571428,7,4087,8692.333333333334,1514.0,583.8571428571429
298646.0,6,6,412,4,272,99548.66666666669,74.0,68.0,2,140,0.0,74.0,70.0
302390.0,6,2,132,1,66,0.0,66.0,66.0,1,66,0.0,66.0,66.0
44219.0,6,2,145,2,145,0.0,91.0,72.5,0,0,0.0,0.0,0.0
143940.0,17,2,180,1,90,0.0,90.0,90.0,1,90,0.0,90.0,90.0
1210921.0,6,13,3010,8,2382,172988.7142857143,1514.0,297.75,5,628,233784.0,331.0,125.6
125377673.0,6,18,2808,18,2808,7375157.235294118,156.0,156.0,0,0,0.0,0.0,0.0
42717.0,6,14,4740,7,653,6907.333333333333,249.0,93.28571428571428,7,4087,6900.833333333333,1514.0,583.8571428571429
338.0,17,2,166,1,75,0.0,75.0,75.0,1,91,0.0,91.0,91.0
318021.0,17,4,1400,4,1400,106007.0,350.0,350.0,0,0,0.0,0.0,0.0
143873.0,17,2,180,1,90,0.0,90.0,90.0,1,90,0.0,90.0,90.0
107821.0,17,2,762,2,762,0.0,381.0,381.0,0,0,0.0,0.0,0.0
6985.0,17,2,582,1,83,0.0,83.0,83.0,1,499,0.0,499.0,499.0
303479.0,6,6,412,4,272,101159.66666666669,74.0,68.0,2,140,0.0,74.0,70.0
26120579.0,17,5,1718,4,1368,685152.0,342.0,342.0,1,350,0.0,350.0,350.0
218352.0,6,3,426,2,280,0.0,214.0,140.0,1,146,0.0,146.0,146.0
408.0,17,2,174,1,79,0.0,79.0,79.0,1,95,0.0,95.0,95.0
35752.0,6,10,2032,5,524,8692.25,252.0,104.8,5,1508,8699.5,1236.0,301.6
3302937.0,6,202,171464,118,161618,28230.23076923077,1510.0,1369.6440677966102,84,9846,36077.60240963855,1510.0,117.21428571428572
20659.0,6,14,4740,7,653,2696.333333333333,249.0,93.28571428571428,7,4087,2951.5,1514.0,583.8571428571429
0.0,17,1,55,1,55,0.0,55.0,55.0,0,0,0.0,0.0,0.0
964924.0,6,12,1354,6,723,191522.0,253.0,120.5,6,631,191599.8,293.0,105.16666666666669
6186.0,17,4,344,2,150,0.0,75.0,75.0,2,194,0.0,103.0,97.0
106329.0,17,2,762,2,762,0.0,381.0,381.0,0,0,0.0,0.0,0.0
54051.0,6,14,4740,7,653,8831.666666666666,249.0,93.28571428571428,7,4087,7712.333333333333,1514.0,583.8571428571429
202933.0,17,4,6056,4,6056,67644.33333333333,1514.0,1514.0,0,0,0.0,0.0,0.0
50724.0,6,14,4740,7,653,8125.333333333333,249.0,93.28571428571428,7,4087,4707.666666666667,1514.0,583.8571428571429
2074.0,17,4,344,2,150,0.0,75.0,75.0,2,194,0.0,103.0,97.0
12024.0,17,2,180,1,90,0.0,90.0,90.0,1,90,0.0,90.0,90.0
120060000.0,17,28,13364,28,13364,4446666.666666667,501.0,477.2857142857143,0,0,0.0,0.0,0.0
117220645.0,6,48,3168,24,1584,5096549.782608695,66.0,66.0,24,1584,5084549.0869565215,66.0,66.0
104004005.0,6,32,2236,16,1165,6933600.333333333,139.0,72.8125,16,1071,6919194.6,123.0,66.9375
90056142.0,17,28,13364,28,13364,3335412.6666666665,501.0,477.2857142857143,0,0,0.0,0.0,0.0
4276.0,17,2,614,1,72,0.0,72.0,72.0,1,542,0.0,542.0,542.0
58734000.0,17,9,3086,8,2736,5110258.428571428,342.0,342.0,1,350,0.0,350.0,350.0
284384.0,17,2,363,1,79,0.0,79.0,79.0,1,284,0.0,284.0,284.0
113520001.0,6,45,2970,23,1518,5160000.045454546,66.0,66.0,22,1452,5233158.142857143,66.0,66.0
123013.0,6,15,4806,8,719,17466.571428571428,249.0,89.875,7,4087,19006.5,1514.0,583.8571428571429
307582.0,6,6,412,4,272,102527.33333333331,74.0,68.0,2,140,0.0,74.0,70.0
107402.0,17,2,286,2,286,0.0,143.0,143.0,0,0,0.0,0.0,0.0
330.0,17,2,208,1,72,0.0,72.0,72.0,1,136,0.0,136.0,136.0
90044676.0,17,28,13364,28,13364,3334988.0,501.0,477.2857142857143,0,0,0.0,0.0,0.0
120018741.0,17,29,13785,29,13785,4286383.607142857,501.0,475.3448275862069,0,0,0.0,0.0,0.0
120125770.0,6,13,2036,5,1020,30031442.5,204.0,204.0,8,1016,17137650.0,188.0,127.0
90017393.0,17,28,13364,28,13364,3333977.5185185187,501.0,477.2857142857143,0,0,0.0,0.0,0.0
108091201.0,17,5,1005,5,1005,27022800.25,201.0,201.0,0,0,0.0,0.0,0.0
101870817.0,17,14,864,7,432,16833516.666666668,174.0,61.71428571428572,7,432,16834220.5,174.0,61.71428571428572
217875.0,6,3,426,2,280,0.0,214.0,140.0,1,146,0.0,146.0,146.0
135124818.0,17,6,1206,6,1206,27024963.6,201.0,201.0,0,0,0.0,0.0,0.0
119078706.0,6,23,1734,11,840,11907870.6,95.0,76.36363636363636,12,894,10802540.545454543,95.0,74.5
284081.0,17,2,363,1,79,0.0,79.0,79.0,1,284,0.0,284.0,284.0
5627502.0,6,5,336,2,134,0.0,68.0,67.0,3,202,1526140.0,70.0,67.33333333333333
229359.0,17,4,1400,4,1400,76453.0,350.0,350.0,0,0,0.0,0.0,0.0
115808433.0,6,48,3168,24,1584,5035149.260869565,66.0,66.0,24,1584,5021482.0869565215,66.0,66.0
104010344.0,6,28,1860,14,966,7985076.230769231,123.0,69.0,14,894,7985075.384615385,123.0,63.85714285714285
103439.0,17,2,286,2,286,0.0,143.0,143.0,0,0,0.0,0.0,0.0
135132694.0,17,6,1146,6,1146,27026538.8,191.0,191.0,0,0,0.0,0.0,0.0
0.0,17,1,44,1,44,0.0,44.0,44.0,0,0,0.0,0.0,0.0
22833.0,6,11,2098,6,590,4148.4,252.0,98.33333333333331,5,1508,5359.5,1236.0,301.6
1296408.0,6,4,264,2,132,0.0,66.0,66.0,2,132,0.0,66.0,66.0
114000942.0,17,13,821,7,432,19000157.0,174.0,61.71428571428572,6,389,18801567.0,174.0,64.83333333333333
7960.0,17,2,582,1,83,0.0,83.0,83.0,1,499,0.0,499.0,499.0
90051195.0,17,28,13364,28,13364,3335229.4444444445,501.0,477.2857142857143,0,0,0.0,0.0,0.0
217721.0,6,3,426,2,280,0.0,214.0,140.0,1,146,0.0,146.0,146.0
1222165.0,6,11,1134,6,558,244433.0,220.0,93.0,5,576,303194.0,304.0,115.2
153492.0,17,2,180,1,90,0.0,90.0,90.0,1,90,0.0,90.0,90.0
0.0,17,1,342,1,342,0.0,342.0,342.0,0,0,0.0,0.0,0.0
143932.0,6,2,132,1,66,0.0,66.0,66.0,1,66,0.0,66.0,66.0
107597600.0,6,30,2106,15,1089,7670123.785714285,123.0,72.6,15,1017,7670124.642857143,123.0,67.8
52042.0,6,14,4740,7,653,8540.833333333334,249.0,93.28571428571428,7,4087,8488.833333333334,1514.0,583.8571428571429
36643.0,6,10,2032,5,524,8920.5,252.0,104.8,5,1508,8526.5,1236.0,301.6
49145.0,6,14,4740,7,653,8049.833333333333,249.0,93.28571428571428,7,4087,8033.166666666667,1514.0,583.8571428571429
7690044.0,6,5,1736,2,819,0.0,753.0,409.5,3,917,3778152.5,785.0,305.6666666666667
18749.0,6,10,2032,5,524,4471.0,252.0,104.8,5,1508,4337.75,1236.0,301.6
90307205.0,6,16,1192,8,596,12893714.285714284,95.0,74.5,8,596,12898967.714285716,95.0,74.5
119296456.0,6,697,88982,349,23330,342805.908045977,140.0,66.84813753581662,348,65652,343180.2622478386,464.0,188.6551724137931
3079958.0,6,4,270,2,134,0.0,68.0,67.0,2,136,0.0,70.0,68.0
1244843.0,6,7,499,4,301,405951.6666666667,103.0,75.25,3,198,613620.0,66.0,66.0
26807.0,6,14,4740,7,653,4318.5,249.0,93.28571428571428,7,4087,3434.5,1514.0,583.8571428571429
108099039.0,17,5,955,5,955,27024759.75,191.0,191.0,0,0,0.0,0.0,0.0
41655.0,6,14,4740,7,653,6813.666666666667,249.0,93.28571428571428,7,4087,6636.0,1514.0,583.8571428571429
385.0,17,2,410,1,78,0.0,78.0,78.0,1,332,0.0,332.0,332.0
2347.0,17,4,344,2,150,0.0,75.0,75.0,2,194,0.0,103.0,97.0
149330.0,6,3,337,2,214,0.0,160.0,107.0,1,123,0.0,123.0,123.0
986568.0,6,12,1447,6,816,195515.6,291.0,136.0,6,631,195883.6,293.0,105.16666666666669
208221.0,6,3,426,2,280,0.0,214.0,140.0,1,146,0.0,146.0,146.0
105055318.0,6,279,32896,140,23500,755793.654676259,284.0,167.85714285714286,139,9396,753835.7898550725,140.0,67.59712230215827
216242.0,6,10,1221,6,636,43248.4,298.0,106.0,4,585,70231.33333333333,379.0,146.25
29536.0,6,14,4740,7,653,4552.833333333333,249.0,93.28571428571428,7,4087,4773.166666666667,1514.0,583.8571428571429
10318.0,17,4,823,2,163,0.0,89.0,81.5,2,660,0.0,443.0,330.0
119965509.0,6,726,106230,364,24246,330436.826446281,140.0,66.60989010989012,362,81984,332309.02216066484,1514.0,226.47513812154696
1945541.0,17,4,1368,4,1368,648513.6666666666,342.0,342.0,0,0,0.0,0.0,0.0
11374.0,6,13,1459,7,862,1778.0,271.0,123.14285714285714,6,597,2065.8,259.0,99.5
308114.0,6,6,412,4,272,102704.66666666669,74.0,68.0,2,140,0.0,74.0,70.0
58200.0,6,12,1320,6,723,10062.8,253.0,120.5,6,597,11016.8,259.0,99.5
2710.0,17,2,180,1,90,0.0,90.0,90.0,1,90,0.0,90.0,90.0
9761.0,17,4,823,2,163,0.0,89.0,81.5,2,660,0.0,443.0,330.0
38678.0,6,14,4740,7,653,6164.166666666667,249.0,93.28571428571428,7,4087,6248.5,1514.0,583.8571428571429
90527215.0,6,14,2240,8,1016,12932459.285714284,188.0,127.0,6,1224,18072743.4,204.0,204.0
90491549.0,6,14,1043,8,596,12921438.714285716,95.0,74.5,6,447,12139829.8,95.0,74.5
106170783.0,17,14,864,7,432,17667971.833333332,174.0,61.71428571428572,7,432,17666830.666666668,174.0,61.71428571428572
120058359.0,17,29,13785,29,13785,4287798.535714285,501.0,475.3448275862069,0,0,0.0,0.0,0.0
228223.0,17,2,180,1,90,0.0,90.0,90.0,1,90,0.0,90.0,90.0
61870.0,6,12,1328,7,797,10311.666666666666,253.0,113.85714285714286,5,531,13553.75,259.0,106.2
149245.0,6,14,4740,7,653,22185.83333333333,249.0,93.28571428571428,7,4087,24316.0,1514.0,583.8571428571429
2434.0,17,4,344,2,150,0.0,75.0,75.0,2,194,0.0,103.0,97.0
12319.0,17,4,823,2,163,0.0,89.0,81.5,2,660,0.0,443.0,330.0
2347.0,17,4,344,2,150,0.0,75.0,75.0,2,194,0.0,103.0,97.0
10463232.0,6,6,412,3,206,5163218.5,74.0,68.66666666666667,3,206,5163160.5,74.0,68.66666666666667
246594.0,6,3,337,2,214,0.0,160.0,107.0,1,123,0.0,123.0,123.0
36967.0,6,11,2098,6,590,6882.8,252.0,98.33333333333331,5,1508,8681.0,1236.0,301.6
103278852.0,6,29,2068,15,1105,7377060.857142857,139.0,73.66666666666667,14,963,7927878.0,123.0,68.78571428571429
25734.0,6,10,2032,5,524,6206.0,252.0,104.8,5,1508,6075.75,1236.0,301.6
70602.0,6,14,4740,7,653,11403.833333333334,249.0,93.28571428571428,7,4087,11292.5,1514.0,583.8571428571429
1040846.0,6,11,1134,6,558,208169.2,220.0,93.0,5,576,256907.25,304.0,115.2
13110.0,6,10,1065,5,534,2982.25,262.0,106.8,5,531,2945.75,259.0,106.2
359.0,17,2,160,1,80,0.0,80.0,80.0,1,80,0.0,80.0,80.0
72643200.0,6,9,1479,9,1479,9080400.0,172.0,164.33333333333334,0,0,0.0,0.0,0.0
932.0,17,4,438,2,148,0.0,74.0,74.0,2,290,0.0,147.0,145.0
25027.0,6,12,1320,6,723,3914.4,253.0,120.5,6,597,4197.4,259.0,99.5
79176.0,6,10,2032,5,524,12288.5,252.0,104.8,5,1508,16152.25,1236.0,301.6
204578.0,6,10,1221,6,636,40915.6,298.0,106.0,4,585,66869.66666666667,379.0,146.25
28877.0,6,13,4412,6,409,5632.6,127.0,68.16666666666667,7,4003,4267.0,1514.0,571.8571428571429
110959654.0,6,31,2182,16,1165,7383679.533333333,139.0,72.8125,15,1017,7911083.071428572,123.0,67.8
9734.0,17,4,823,2,163,0.0,89.0,81.5,2,660,0.0,443.0,330.0
2337.0,17,4,344,2,150,0.0,75.0,75.0,2,194,0.0,103.0,97.0
700.0,17,2,762,2,762,0.0,381.0,381.0,0,0,0.0,0.0,0.0
2615824.0,6,3,1602,1,752,0.0,752.0,752.0,2,850,0.0,784.0,425.0
2394.0,17,4,344,2,150,0.0,75.0,75.0,2,194,0.0,103.0,97.0
115955053.0,6,47,3102,24,1584,5029543.347826087,66.0,66.0,23,1518,5135460.318181818,66.0,66.0
235021.0,6,3,337,2,214,0.0,160.0,107.0,1,123,0.0,123.0,123.0
2803021.0,6,2,132,1,66,0.0,66.0,66.0,1,66,0.0,66.0,66.0
400.0,17,2,762,2,762,0.0,381.0,381.0,0,0,0.0,0.0,0.0
90255307.0,6,13,2036,8,1016,12893615.285714284,188.0,127.0,5,1020,22514067.25,204.0,204.0
123177.0,6,3,373,2,238,0.0,172.0,119.0,1,135,0.0,135.0,135.0
103397.0,17,2,286,2,286,0.0,143.0,143.0,0,0,0.0,0.0,0.0
144000.0,17,2,180,1,90,0.0,90.0,90.0,1,90,0.0,90.0,90.0
36014615.0,6,33,10980,18,3951,149778.9411764706,1514.0,219.5,15,7029,2557078.3571428573,1514.0,468.6
42094.0,6,10,2032,5,524,10303.75,252.0,104.8,5,1508,8141.25,1236.0,301.6
308412.0,6,6,412,4,272,102804.0,74.0,68.0,2,140,0.0,74.0,70.0
1340311.0,6,4,264,2,132,0.0,66.0,66.0,2,132,0.0,66.0,66.0
218516.0,6,3,426,2,280,0.0,214.0,140.0,1,146,0.0,146.0,146.0
196941.0,17,2,180,1,90,0.0,90.0,90.0,1,90,0.0,90.0,90.0
120135811.0,6,725,97402,363,24180,331866.8812154696,140.0,66.61157024793388,362,73222,332134.17451523547,390.0,202.2707182320442
108444859.0,6,192,21776,96,15218,1139260.6842105263,284.0,158.52083333333334,96,6558,1139260.505263158,140.0,68.3125
407089.0,6,4,508,2,238,0.0,172.0,119.0,2,270,0.0,135.0,135.0
128003187.0,17,15,907,8,475,18286169.57142857,174.0,59.375,7,432,18000205.333333332,174.0,61.71428571428572
50965.0,17,2,180,1,90,0.0,90.0,90.0,1,90,0.0,90.0,90.0
46556.0,6,10,2032,5,524,11420.75,252.0,104.8,5,1508,10623.0,1236.0,301.6
1301478.0,6,4,264,2,132,0.0,66.0,66.0,2,132,0.0,66.0,66.0
14686.0,6,11,2098,6,590,2814.2,252.0,98.33333333333331,5,1508,3400.0,1236.0,301.6
293213.0,17,4,1524,4,1524,97737.66666666669,381.0,381.0,0,0,0.0,0.0,0.0
2484.0,17,4,344,2,150,0.0,75.0,75.0,2,194,0.0,103.0,97.0
31340.0,6,14,4740,7,653,5050.0,249.0,93.28571428571428,7,4087,5054.5,1514.0,583.8571428571429
2238.0,17,4,344,2,150,0.0,75.0,75.0,2,194,0.0,103.0,97.0
106260873.0,17,14,864,7,432,17667506.833333332,174.0,61.71428571428572,7,432,17666820.333333332,174.0,61.71428571428572
4098.0,17,2,582,1,83,0.0,83.0,83.0,1,499,0.0,499.0,499.0
103387174.0,6,45,3916,25,2146,4307798.916666667,139.0,85.84,20,1770,5429494.368421053,123.0,88.5
35604.0,6,14,4740,7,653,5807.333333333333,249.0,93.28571428571428,7,4087,5467.0,1514.0,583.8571428571429
33093.0,6,14,4740,7,653,5154.0,249.0,93.28571428571428,7,4087,4447.5,1514.0,583.8571428571429
318013.0,17,4,1400,4,1400,106004.33333333331,350.0,350.0,0,0,0.0,0.0,0.0
153486.0,17,2,180,1,90,0.0,90.0,90.0,1,90,0.0,90.0,90.0
0.0,17,1,342,1,342,0.0,342.0,342.0,0,0,0.0,0.0,0.0
16683107.0,6,20,1611,9,921,2046357.625,315.0,102.33333333333331,11,690,1637068.6,78.0,62.72727272727273
106621222.0,6,44,2904,22,1452,5077201.047619048,66.0,66.0,22,1452,5062502.619047619,66.0,66.0
2372.0,17,4,344,2,150,0.0,75.0,75.0,2,194,0.0,103.0,97.0
113583659.0,6,35,2526,18,1332,6668684.823529412,123.0,74.0,17,1194,7085476.75,123.0,70.23529411764706
4799152.0,6,13,1489,7,858,799858.6666666666,291.0,122.57142857142856,6,631,957302.8,293.0,105.16666666666669
1825344.0,6,4,276,2,128,0.0,74.0,64.0,2,148,0.0,74.0,74.0
108606.0,6,2,132,1,66,0.0,66.0,66.0,1,66,0.0,66.0,66.0
153418.0,17,2,180,1,90,0.0,90.0,90.0,1,90,0.0,90.0,90.0
19882.0,6,10,2032,5,524,4646.25,252.0,104.8,5,1508,4399.25,1236.0,301.6
196805.0,17,2,180,1,90,0.0,90.0,90.0,1,90,0.0,90.0,90.0
384807.0,6,3,204,2,136,0.0,70.0,68.0,1,68,0.0,68.0,68.0
25773.0,6,14,4740,7,653,4095.5,249.0,93.28571428571428,7,4087,4124.166666666667,1514.0,583.8571428571429
2323.0,17,4,344,2,150,0.0,75.0,75.0,2,194,0.0,103.0,97.0
207153.0,6,3,426,2,280,0.0,214.0,140.0,1,146,0.0,146.0,146.0
126215814.0,6,22,1807,10,913,10722756.0,222.0,91.3,12,894,11452590.181818182,95.0,74.5
14478.0,6,10,1066,5,490,3093.75,218.0,98.0,5,576,3114.5,304.0,115.2
283206.0,6,10,1221,6,636,56641.2,298.0,106.0,4,585,88697.33333333333,379.0,146.25
22669.0,6,10,2032,5,524,5411.0,252.0,104.8,5,1508,5307.25,1236.0,301.6
207182.0,6,3,426,2,280,0.0,214.0,140.0,1,146,0.0,146.0,146.0
495.0,17,2,508,2,508,0.0,257.0,254.0,0,0,0.0,0.0,0.0
105116.0,17,2,286,2,286,0.0,143.0,143.0,0,0,0.0,0.0,0.0
90306392.0,6,168,18984,84,13218,1085435.8915662651,284.0,157.35714285714286,84,5766,1085436.2289156627,140.0,68.64285714285714
298530.0,6,6,412,4,272,99510.0,74.0,68.0,2,140,0.0,74.0,70.0
134717.0,6,2,132,1,66,0.0,66.0,66.0,1,66,0.0,66.0,66.0
147382.0,17,4,704,2,148,0.0,74.0,74.0,2,556,0.0,280.0,278.0
125001097.0,17,14,864,8,475,17857299.57142857,174.0,59.375,6,389,17201285.2,174.0,64.83333333333333
3442.0,17,4,344,2,150,0.0,75.0,75.0,2,194,0.0,103.0,97.0
99903150.0,17,12,778,6,389,19980630.0,174.0,64.83333333333333,6,389,19881491.2,174.0,64.83333333333333
42695.0,6,10,2032,5,524,6910.75,252.0,104.8,5,1508,10348.0,1236.0,301.6
35156.0,6,13,1479,7,882,5494.0,291.0,126.0,6,597,5880.4,259.0,99.5
114972106.0,6,48,3168,24,1584,4998787.217391305,66.0,66.0,24,1584,4985494.956521739,66.0,66.0
39195.0,6,11,2098,6,590,7544.2,252.0,98.33333333333331,5,1508,9140.0,1236.0,301.6
155355.0,6,3,337,2,214,0.0,160.0,107.0,1,123,0.0,123.0,123.0
41648.0,6,14,4740,7,653,6767.833333333333,249.0,93.28571428571428,7,4087,6692.833333333333,1514.0,583.8571428571429
216812.0,17,2,180,1,90,0.0,90.0,90.0,1,90,0.0,90.0,90.0
220400.0,6,10,1221,6,636,44080.0,298.0,106.0,4,585,71921.33333333333,379.0,146.25
216392.0,17,2,180,1,90,0.0,90.0,90.0,1,90,0.0,90.0,90.0
66052.0,17,2,180,1,90,0.0,90.0,90.0,1,90,0.0,90.0,90.0
58573.0,6,10,2032,5,524,14315.25,252.0,104.8,5,1508,13404.75,1236.0,301.6
2419.0,17,4,344,2,150,0.0,75.0,75.0,2,194,0.0,103.0,97.0
17443443.0,6,23,8609,13,1719,1453620.25,408.0,132.23076923076923,10,6890,1481197.888888889,1514.0,689.0
90211519.0,6,19,1436,9,691,11245871.125,95.0,76.77777777777777,10,745,10000530.444444444,95.0,74.5
206301.0,6,3,426,2,280,0.0,214.0,140.0,1,146,0.0,146.0,146.0
297976.0,6,6,412,4,272,99325.33333333331,74.0,68.0,2,140,0.0,74.0,70.0
207139.0,6,3,426,2,280,0.0,214.0,140.0,1,146,0.0,146.0,146.0
3099.0,17,2,224,1,76,0.0,76.0,76.0,1,148,0.0,148.0,148.0
197030.0,17,2,180,1,90,0.0,90.0,90.0,1,90,0.0,90.0,90.0
790.0,17,2,762,2,762,0.0,381.0,381.0,0,0,0.0,0.0,0.0
90259396.0,6,12,1832,8,1016,12894199.42857143,188.0,127.0,4,816,30031312.666666668,204.0,204.0
243957.0,6,3,337,2,214,0.0,160.0,107.0,1,123,0.0,123.0,123.0
37610.0,6,14,4740,7,653,6094.333333333333,249.0,93.28571428571428,7,4087,5612.166666666667,1514.0,583.8571428571429
205830.0,17,2,180,1,90,0.0,90.0,90.0,1,90,0.0,90.0,90.0
3509.0,17,2,414,1,88,0.0,88.0,88.0,1,326,0.0,326.0,326.0
2799549.0,6,2,132,1,66,0.0,66.0,66.0,1,66,0.0,66.0,66.0
118665228.0,6,230,25866,115,17980,1039034.9561403508,284.0,156.34782608695653,115,7886,1039034.754385965,140.0,68.57391304347826
108106118.0,17,5,1005,5,1005,27026529.5,201.0,201.0,0,0,0.0,0.0,0.0
2581170.0,6,25,7573,14,3735,198551.53846153847,1514.0,266.7857142857143,11,3838,231927.5,1514.0,348.90909090909093
10476072.0,6,7,478,4,272,3446858.333333333,74.0,68.0,3,206,5170152.5,74.0,68.66666666666667
120044387.0,17,29,13785,29,13785,4287299.535714285,501.0,475.3448275862069,0,0,0.0,0.0,0.0
7161952.0,17,8,2155,4,365,2386110.333333333,103.0,91.25,4,1790,2384318.0,545.0,447.5
3153.0,17,2,359,1,75,0.0,75.0,75.0,1,284,0.0,284.0,284.0
493273.0,6,5,336,2,134,0.0,68.0,67.0,3,202,192033.0,70.0,67.33333333333333
108104628.0,17,5,1005,5,1005,27026157.0,201.0,201.0,0,0,0.0,0.0,0.0
17714.0,6,14,4740,7,653,2757.1666666666665,249.0,93.28571428571428,7,4087,2735.1666666666665,1514.0,583.8571428571429
238264.0,17,2,180,1,90,0.0,90.0,90.0,1,90,0.0,90.0,90.0
328104.0,6,10,1221,6,636,65620.8,298.0,106.0,4,585,108329.66666666669,379.0,146.25
123456053.0,6,49,3234,25,1650,5144002.208333333,66.0,66.0,24,1584,5099542.521739131,66.0,66.0
116001546.0,17,13,821,7,432,19333591.0,174.0,61.71428571428572,6,389,19200845.0,174.0,64.83333333333333
9960.0,17,4,823,2,163,0.0,89.0,81.5,2,660,0.0,443.0,330.0
143431.0,6,2,132,1,66,0.0,66.0,66.0,1,66,0.0,66.0,66.0
2374.0,17,4,344,2,150,0.0,75.0,75.0,2,194,0.0,103.0,97.0
228242.0,17,2,180,1,90,0.0,90.0,90.0,1,90,0.0,90.0,90.0
92713024.0,6,38,2508,19,1254,5135434.555555556,66.0,66.0,19,1254,5135433.0,66.0,66.0
700.0,17,4,438,2,148,0.0,74.0,74.0,2,290,0.0,147.0,145.0
90010221.0,17,27,12943,27,12943,3461931.576923077,501.0,479.3703703703704,0,0,0.0,0.0,0.0
113344244.0,6,46,3036,23,1518,5151999.363636363,66.0,66.0,23,1518,5152000.0,66.0,66.0
103232.0,17,2,286,2,286,0.0,143.0,143.0,0,0,0.0,0.0,0.0
158636.0,6,3,337,2,214,0.0,160.0,107.0,1,123,0.0,123.0,123.0
894404.0,6,12,2708,7,742,149067.33333333334,338.0,106.0,5,1966,154681.75,1514.0,393.2
2350.0,17,4,344,2,150,0.0,75.0,75.0,2,194,0.0,103.0,97.0
416.0,17,2,410,1,78,0.0,78.0,78.0,1,332,0.0,332.0,332.0
44643.0,6,10,2032,5,524,10504.0,252.0,104.8,5,1508,8979.5,1236.0,301.6
115313870.0,6,48,3168,24,1584,5013646.521739131,66.0,66.0,24,1584,5000402.739130435,66.0,66.0
95881756.0,17,14,4796,13,4446,6244307.583333333,342.0,342.0,1,350,0.0,350.0,350.0
0.0,17,1,55,1,55,0.0,55.0,55.0,0,0,0.0,0.0,0.0
228618.0,17,2,180,1,90,0.0,90.0,90.0,1,90,0.0,90.0,90.0
1023020.0,6,11,1134,6,558,204604.0,220.0,93.0,5,576,254704.0,304.0,115.2
122130.0,6,3,337,2,214,0.0,160.0,107.0,1,123,0.0,123.0,123.0
9130.0,17,2,539,1,86,0.0,86.0,86.0,1,453,0.0,453.0,453.0
10482946.0,6,6,412,3,206,5173356.0,74.0,68.66666666666667,3,206,5173252.0,74.0,68.66666666666667
306527.0,6,6,412,4,272,102175.66666666669,74.0,68.0,2,140,0.0,74.0,70.0
103719.0,6,15,4806,8,719,13758.0,249.0,89.875,7,4087,16666.833333333332,1514.0,583.8571428571429
35645.0,6,14,4740,7,653,5819.166666666667,249.0,93.28571428571428,7,4087,5375.5,1514.0,583.8571428571429
51085.0,6,10,2032,5,524,12544.75,252.0,104.8,5,1508,10954.0,1236.0,301.6
103396728.0,17,14,864,7,432,17166831.666666668,174.0,61.71428571428572,7,432,17168113.166666668,174.0,61.71428571428572
120318550.0,6,257,29306,129,20562,939988.671875,374.0,159.3953488372093,128,8744,939168.7795275592,140.0,68.3125
91923.0,17,3,1143,3,1143,45961.5,381.0,381.0,0,0,0.0,0.0,0.0
1403966.0,17,7,490,7,490,233994.3333333333,70.0,70.0,0,0,0.0,0.0,0.0
295845.0,6,6,412,4,272,98615.0,74.0,68.0,2,140,0.0,74.0,70.0
102715.0,17,2,286,2,286,0.0,143.0,143.0,0,0,0.0,0.0,0.0
317.0,17,2,174,1,79,0.0,79.0,79.0,1,95,0.0,95.0,95.0
730.0,17,2,684,2,684,0.0,342.0,342.0,0,0,0.0,0.0,0.0
120000835.0,6,17,1246,9,650,15000104.375,95.0,72.22222222222223,8,596,12892712.57142857,95.0,74.5
35237.0,6,14,4740,7,653,5404.0,249.0,93.28571428571428,7,4087,5627.333333333333,1514.0,583.8571428571429
135135837.0,17,6,1146,6,1146,27027167.4,191.0,191.0,0,0,0.0,0.0,0.0
100491.0,17,2,762,2,762,0.0,381.0,381.0,0,0,0.0,0.0,0.0
90020864.0,17,28,13364,28,13364,3334106.074074074,501.0,477.2857142857143,0,0,0.0,0.0,0.0
100938542.0,6,209,23506,105,7152,970562.903846154,140.0,68.11428571428571,104,16354,971046.4660194176,284.0,157.25
436271.0,6,11,1021,6,444,58474.2,162.0,74.0,5,577,72959.25,349.0,115.4
102199.0,17,2,286,2,286,0.0,143.0,143.0,0,0,0.0,0.0,0.0
104701043.0,6,36,3004,20,1657,5510581.210526316,139.0,82.85,16,1347,6965655.533333333,123.0,84.1875
135130352.0,17,6,1206,6,1206,27026070.4,201.0,201.0,0,0,0.0,0.0,0.0
318.0,17,2,208,1,72,0.0,72.0,72.0,1,136,0.0,136.0,136.0
373.0,17,2,160,1,80,0.0,80.0,80.0,1,80,0.0,80.0,80.0
26876075.0,17,5,1710,5,1710,6719018.75,342.0,342.0,0,0,0.0,0.0,0.0
33001.0,6,14,4740,7,653,5087.666666666667,249.0,93.28571428571428,7,4087,5217.0,1514.0,583.8571428571429
33971.0,6,14,4740,7,653,4830.5,249.0,93.28571428571428,7,4087,5528.333333333333,1514.0,583.8571428571429
119619267.0,6,221,25024,111,17468,1087447.8818181818,284.0,157.36936936936937,110,7556,1095351.9449541285,140.0,68.69090909090909
228409.0,17,2,180,1,90,0.0,90.0,90.0,1,90,0.0,90.0,90.0
0.0,6,1,66,1,66,0.0,66.0,66.0,0,0,0.0,0.0,0.0
115542.0,17,2,286,2,286,0.0,143.0,143.0,0,0,0.0,0.0,0.0
51728710.0,6,8,2113,3,960,24536503.5,826.0,320.0,5,1153,12237077.75,885.0,230.6
4085.0,17,2,582,1,83,0.0,83.0,83.0,1,499,0.0,499.0,499.0
46618817.0,6,8,1307,8,1307,6659831.0,172.0,163.375,0,0,0.0,0.0,0.0
312838.0,17,4,1400,4,1400,104279.33333333331,350.0,350.0,0,0,0.0,0.0,0.0
1679234.0,6,21,4235,11,1393,167923.4,311.0,126.63636363636364,10,2842,161581.77777777778,1514.0,284.2
26510.0,6,14,4740,7,653,3898.5,249.0,93.28571428571428,7,4087,4111.333333333333,1514.0,583.8571428571429
40069.0,6,10,2032,5,524,7837.25,252.0,104.8,5,1508,9259.0,1236.0,301.6
42221.0,6,14,4740,7,653,6440.0,249.0,93.28571428571428,7,4087,6277.0,1514.0,583.8571428571429
108107562.0,17,5,1005,5,1005,27026890.5,201.0,201.0,0,0,0.0,0.0,0.0
114494984.0,6,48,3168,24,1584,4978042.782608695,66.0,66.0,24,1584,4966061.478260869,66.0,66.0
1807.0,17,4,344,2,150,0.0,75.0,75.0,2,194,0.0,103.0,97.0
306746.0,6,6,412,4,272,102248.66666666669,74.0,68.0,2,140,0.0,74.0,70.0
108107806.0,17,5,1005,5,1005,27026951.5,201.0,201.0,0,0,0.0,0.0,0.0
10481319.0,6,7,478,4,272,3448424.333333333,74.0,68.0,3,206,5172539.0,74.0,68.66666666666667
868462.0,6,9,1267,6,796,173692.4,458.0,132.66666666666666,3,471,297898.0,331.0,157.0
216520.0,17,2,180,1,90,0.0,90.0,90.0,1,90,0.0,90.0,90.0
2904.0,17,2,224,1,76,0.0,76.0,76.0,1,148,0.0,148.0,148.0
90054098.0,17,28,13364,28,13364,3335336.962962963,501.0,477.2857142857143,0,0,0.0,0.0,0.0
45448.0,6,14,4740,7,653,7445.166666666667,249.0,93.28571428571428,7,4087,7437.166666666667,1514.0,583.8571428571429
108378919.0,6,43,2838,22,1452,5160889.523809524,66.0,66.0,21,1386,5159984.65,66.0,66.0
250237.0,17,4,6056,4,6056,83412.33333333333,1514.0,1514.0,0,0,0.0,0.0,0.0
22454.0,6,14,4740,7,653,3622.0,249.0,93.28571428571428,7,4087,3606.0,1514.0,583.8571428571429
108100096.0,17,5,1005,5,1005,27025024.0,201.0,201.0,0,0,0.0,0.0,0.0
312796.0,17,4,1400,4,1400,104265.33333333331,350.0,350.0,0,0,0.0,0.0,0.0
2102072.0,6,24,7544,13,2516,175172.66666666666,1034.0,193.53846153846155,11,5028,179374.3,1510.0,457.09090909090907
300938.0,6,6,412,4,272,100312.66666666669,74.0,68.0,2,140,0.0,74.0,70.0
108110119.0,17,5,955,5,955,27027529.75,191.0,191.0,0,0,0.0,0.0,0.0
0.0,17,1,381,1,381,0.0,381.0,381.0,0,0,0.0,0.0,0.0
8207366.0,17,3,1034,2,684,0.0,342.0,342.0,1,350,0.0,350.0,350.0
2023380.0,17,4,525,2,150,0.0,75.0,75.0,2,375,0.0,284.0,187.5
1314688.0,6,4,264,2,132,0.0,66.0,66.0,2,132,0.0,66.0,66.0
15485959.0,6,7,499,4,301,3951105.0,103.0,75.25,3,198,6149681.5,66.0,66.0
1517.0,17,2,762,2,762,0.0,381.0,381.0,0,0,0.0,0.0,0.0
317545.0,6,6,412,4,272,105848.33333333331,74.0,68.0,2,140,0.0,74.0,70.0
259891.0,6,3,337,2,214,0.0,160.0,107.0,1,123,0.0,123.0,123.0
10934995.0,6,8,544,4,272,3599492.0,74.0,68.0,4,272,3599421.333333333,74.0,68.0
32602338.000000004,6,5,336,2,134,0.0,68.0,67.0,3,202,14938507.0,70.0,67.33333333333333
317038.0,17,4,1400,4,1400,105679.33333333331,350.0,350.0,0,0,0.0,0.0,0.0
116286995.0,6,48,3168,24,1584,5055956.304347826,66.0,66.0,24,1584,5042858.391304348,66.0,66.0
135130576.0,17,6,1146,6,1146,27026115.2,191.0,191.0,0,0,0.0,0.0,0.0
233627.0,6,3,337,2,214,0.0,160.0,107.0,1,123,0.0,123.0,123.0
90032023.0,17,28,13364,28,13364,3334519.3703703703,501.0,477.2857142857143,0,0,0.0,0.0,0.0
135141877.0,17,6,1146,6,1146,27028375.4,191.0,191.0,0,0,0.0,0.0,0.0
51355.0,6,14,4740,7,653,8349.666666666666,249.0,93.28571428571428,7,4087,8269.666666666666,1514.0,583.8571428571429
120244409.0,6,22,1639,11,840,11999595.6,95.0,76.36363636363636,11,799,11999001.6,95.0,72.63636363636364
107430.0,17,2,286,2,286,0.0,143.0,143.0,0,0,0.0,0.0,0.0
120006116.0,6,22,1680,11,840,12000611.6,95.0,76.36363636363636,11,840,8975560.2,95.0,76.36363636363636
18802.0,6,14,4740,7,653,3014.6666666666665,249.0,93.28571428571428,7,4087,3001.5,1514.0,583.8571428571429
52812.0,6,11,2098,6,590,10183.2,252.0,98.33333333333331,5,1508,11604.75,1236.0,301.6
5619903.0,6,4,270,2,134,0.0,68.0,67.0,2,136,0.0,70.0,68.0
116297212.0,6,48,3168,24,1584,5056400.521739131,66.0,66.0,24,1584,5043310.869565218,66.0,66.0
300898.0,6,6,412,4,272,100299.33333333331,74.0,68.0,2,140,0.0,74.0,70.0
246657.0,6,3,337,2,214,0.0,160.0,107.0,1,123,0.0,123.0,123.0
1057.0,17,4,438,2,148,0.0,74.0,74.0,2,290,0.0,147.0,145.0
22727.0,6,10,2032,5,524,5434.0,252.0,104.8,5,1508,5408.75,1236.0,301.6
4259.0,17,2,602,1,72,0.0,72.0,72.0,1,530,0.0,530.0,530.0
135147939.0,17,6,1206,6,1206,27029587.8,201.0,201.0,0,0,0.0,0.0,0.0
356.0,17,2,267,1,83,0.0,83.0,83.0,1,184,0.0,184.0,184.0
173051.0,6,11,1132,6,556,34013.4,218.0,92.66666666666669,5,576,42980.25,304.0,115.2
216602.0,17,2,180,1,90,0.0,90.0,90.0,1,90,0.0,90.0,90.0
124001143.0,17,15,907,8,475,17714449.0,174.0,59.375,7,432,17334817.0,174.0,61.71428571428572
47000481.0,6,144,31343,71,23788,353304.6285714286,566.0,335.0422535211268,73,7555,648960.9861111111,898.0,103.4931506849315
135142376.0,17,6,1146,6,1146,27028475.2,191.0,191.0,0,0,0.0,0.0,0.0
9532490.0,6,5,1736,2,819,0.0,753.0,409.5,3,917,4698609.5,785.0,305.6666666666667
42766.0,6,10,2032,5,524,10442.5,252.0,104.8,5,1508,10431.0,1236.0,301.6
113472118.0,6,46,3036,23,1518,5157812.0,66.0,66.0,23,1518,5157812.227272728,66.0,66.0
232082.0,6,3,337,2,214,0.0,160.0,107.0,1,123,0.0,123.0,123.0
144890.0,17,2,180,1,70,0.0,70.0,70.0,1,110,0.0,110.0,110.0
99172549.0,6,184,20760,92,14466,1087560.043956044,284.0,157.2391304347826,92,6294,1087559.1758241758,140.0,68.41304347826087
135131496.0,17,6,1146,6,1146,27026299.2,191.0,191.0,0,0,0.0,0.0,0.0
217872.0,6,3,426,2,280,0.0,214.0,140.0,1,146,0.0,146.0,146.0
1310092.0,6,4,264,2,132,0.0,66.0,66.0,2,132,0.0,66.0,66.0
52753.0,6,10,2032,5,524,10620.75,252.0,104.8,5,1508,11956.0,1236.0,301.6
81968.0,6,14,4740,7,653,6281.0,249.0,93.28571428571428,7,4087,13338.666666666666,1514.0,583.8571428571429
36894.0,6,14,4740,7,653,5980.0,249.0,93.28571428571428,7,4087,6010.333333333333,1514.0,583.8571428571429
104780.0,17,2,286,2,286,0.0,143.0,143.0,0,0,0.0,0.0,0.0
228273.0,17,2,180,1,90,0.0,90.0,90.0,1,90,0.0,90.0,90.0
73224.0,17,3,1143,3,1143,36612.0,381.0,381.0,0,0,0.0,0.0,0.0
4264.0,17,2,620,1,75,0.0,75.0,75.0,1,545,0.0,545.0,545.0
18832.0,6,14,4740,7,653,2365.6666666666665,249.0,93.28571428571428,7,4087,3001.5,1514.0,583.8571428571429
41200.0,6,14,4740,7,653,6598.666666666667,249.0,93.28571428571428,7,4087,5770.666666666667,1514.0,583.8571428571429
90048658.0,17,28,13364,28,13364,3335135.4814814813,501.0,477.2857142857143,0,0,0.0,0.0,0.0
98193.0,17,2,762,2,762,0.0,381.0,381.0,0,0,0.0,0.0,0.0
247102.0,17,2,180,1,90,0.0,90.0,90.0,1,90,0.0,90.0,90.0
108101101.0,17,5,1005,5,1005,27025275.25,201.0,201.0,0,0,0.0,0.0,0.0
90053297.0,17,28,13364,28,13364,3335307.296296296,501.0,477.2857142857143,0,0,0.0,0.0,0.0
98871.0,17,2,286,2,286,0.0,143.0,143.0,0,0,0.0,0.0,0.0
196871.0,17,2,180,1,90,0.0,90.0,90.0,1,90,0.0,90.0,90.0
108109592.0,17,5,1005,5,1005,27027398.0,201.0,201.0,0,0,0.0,0.0,0.0
104684362.0,6,43,2838,22,1452,4970507.238095238,66.0,66.0,21,1386,5150451.8,66.0,66.0
103329.0,17,2,286,2,286,0.0,143.0,143.0,0,0,0.0,0.0,0.0
20310.0,6,14,4740,7,653,3128.6666666666665,249.0,93.28571428571428,7,4087,2729.333333333333,1514.0,583.8571428571429
303119.0,6,2,132,1,66,0.0,66.0,66.0,1,66,0.0,66.0,66.0
1664847.0,6,4,276,2,128,0.0,74.0,64.0,2,148,0.0,74.0,74.0
216589.0,17,2,180,1,90,0.0,90.0,90.0,1,90,0.0,90.0,90.0
310712.0,17,4,1400,4,1400,103570.66666666669,350.0,350.0,0,0,0.0,0.0,0.0
151184.0,17,2,414,1,88,0.0,88.0,88.0,1,326,0.0,326.0,326.0
135136437.0,17,6,1206,6,1206,27027287.4,201.0,201.0,0,0,0.0,0.0,0.0
24476.0,6,14,4740,7,653,3528.1666666666665,249.0,93.28571428571428,7,4087,3725.8333333333335,1514.0,583.8571428571429
304547.0,6,3,202,2,128,0.0,74.0,64.0,1,74,0.0,74.0,74.0
90028124.0,17,28,13364,28,13364,3334374.962962963,501.0,477.2857142857143,0,0,0.0,0.0,0.0
155097.0,6,2,132,1,66,0.0,66.0,66.0,1,66,0.0,66.0,66.0
312647.0,17,4,1400,4,1400,104215.66666666669,350.0,350.0,0,0,0.0,0.0,0.0
1193245.0,6,11,1134,6,558,238649.0,220.0,93.0,5,576,297341.75,304.0,115.2
120123399.0,6,13,2020,9,1204,15015424.875,188.0,133.77777777777777,4,816,30031932.33333333,204.0,204.0
659395.0,6,11,1287,6,636,131879.0,298.0,106.0,5,651,163899.5,379.0,130.2
367466.0,6,4,508,2,238,0.0,172.0,119.0,2,270,0.0,135.0,135.0
120324652.0,6,286,32930,143,9660,841688.6126760563,140.0,67.55244755244755,143,23270,841598.9929577465,374.0,162.72727272727272
3771262.0,6,5,336,2,134,0.0,68.0,67.0,3,202,1525107.0,70.0,67.33333333333333
93718989.0,17,14,1126,7,563,15501231.666666666,174.0,80.42857142857143,7,563,15500045.166666666,174.0,80.42857142857143
235954.0,6,3,337,2,214,0.0,160.0,107.0,1,123,0.0,123.0,123.0
2020542.0,17,4,525,2,150,0.0,75.0,75.0,2,375,0.0,284.0,187.5
2099801.0,6,23,7478,12,2450,190891.0,1034.0,204.16666666666663,11,5028,179451.0,1510.0,457.09090909090907
27149.0,6,10,2032,5,524,5789.75,252.0,104.8,5,1508,6456.5,1236.0,301.6
246848.0,17,4,6056,4,6056,82282.66666666667,1514.0,1514.0,0,0,0.0,0.0,0.0
117613627.0,6,216,24574,108,17212,1097180.261682243,300.0,159.37037037037038,108,7362,1097169.140186916,140.0,68.16666666666667
247245.0,6,3,426,2,280,0.0,214.0,140.0,1,146,0.0,146.0,146.0
43931.0,6,14,4740,7,653,7157.333333333333,249.0,93.28571428571428,7,4087,6676.833333333333,1514.0,583.8571428571429
9000911.0,17,4,300,4,300,3000303.6666666665,75.0,75.0,0,0,0.0,0.0,0.0
117807.0,17,4,1400,4,1400,39269.0,350.0,350.0,0,0,0.0,0.0,0.0
5837115.0,6,5,336,2,134,0.0,68.0,67.0,3,202,1528339.5,70.0,67.33333333333333
27033.0,6,10,2032,5,524,5862.0,252.0,104.8,5,1508,6182.75,1236.0,301.6
119577735.0,6,19,1395,10,745,13281519.888888888,95.0,74.5,9,650,14940886.5,95.0,72.22222222222223
153547.0,17,2,180,1,90,0.0,90.0,90.0,1,90,0.0,90.0,90.0
37198.0,6,14,4740,7,653,6034.666666666667,249.0,93.28571428571428,7,4087,5850.666666666667,1514.0,583.8571428571429
10512674.0,6,7,478,4,272,3458929.333333333,74.0,68.0,3,206,5188273.5,74.0,68.66666666666667
209520.0,17,2,180,1,90,0.0,90.0,90.0,1,90,0.0,90.0,90.0
108113736.0,17,5,955,5,955,27028434.0,191.0,191.0,0,0,0.0,0.0,0.0
112986099.0,6,35,2542,18,1348,6633582.94117647,139.0,74.88888888888889,17,1194,7048179.75,123.0,70.23529411764706
121299627.0,6,236,27216,118,8010,1004096.9316239316,140.0,67.88135593220339,118,19206,1020852.0512820513,336.0,162.76271186440678
107206.0,17,2,286,2,286,0.0,143.0,143.0,0,0,0.0,0.0,0.0
300546.0,6,6,412,4,272,100182.0,74.0,68.0,2,140,0.0,74.0,70.0
62517.0,6,14,4740,7,653,8085.666666666667,249.0,93.28571428571428,7,4087,10187.333333333334,1514.0,583.8571428571429
135137053.0,17,6,1146,6,1146,27027410.6,191.0,191.0,0,0,0.0,0.0,0.0
292931.0,17,2,246,1,76,0.0,76.0,76.0,1,170,0.0,170.0,170.0
105727581.0,17,14,864,7,432,17501335.333333332,174.0,61.71428571428572,7,432,17500207.0,174.0,61.71428571428572
275322.0,6,10,1221,6,636,55064.4,298.0,106.0,4,585,86439.33333333333,379.0,146.25
119655808.0,6,230,26022,115,18198,1047724.3421052631,284.0,158.24347826086955,115,7824,1047723.7807017544,140.0,68.03478260869565
1017.0,17,4,438,2,148,0.0,74.0,74.0,2,290,0.0,147.0,145.0
2001286.0,17,4,525,2,150,0.0,75.0,75.0,2,375,0.0,284.0,187.5
108106129.0,17,5,1005,5,1005,27026532.25,201.0,201.0,0,0,0.0,0.0,0.0
18229.0,6,11,2098,6,590,3183.4,252.0,98.33333333333331,5,1508,3992.0,1236.0,301.6
280253.0,17,2,389,1,86,0.0,86.0,86.0,1,303,0.0,303.0,303.0
39101.0,6,10,2032,5,524,8788.75,252.0,104.8,5,1508,9453.25,1236.0,301.6
120421522.0,6,249,28148,125,19742,971141.3064516129,284.0,157.936,124,8406,970645.3170731708,140.0,67.79032258064517
109831.0,17,2,286,2,286,0.0,143.0,143.0,0,0,0.0,0.0,0.0
300035.0,6,6,412,4,272,100011.66666666669,74.0,68.0,2,140,0.0,74.0,70.0
90009347.0,17,28,13364,28,13364,3333679.5185185187,501.0,477.2857142857143,0,0,0.0,0.0,0.0
306808.0,6,6,412,4,272,102269.33333333331,74.0,68.0,2,140,0.0,74.0,70.0
131684.0,6,3,337,2,214,0.0,160.0,107.0,1,123,0.0,123.0,123.0
90529669.0,6,14,2240,8,1016,12932809.857142856,188.0,127.0,6,1224,18073207.0,204.0,204.0
228321.0,17,2,180,1,90,0.0,90.0,90.0,1,90,0.0,90.0,90.0
301366.0,6,6,412,4,272,100455.33333333331,74.0,68.0,2,140,0.0,74.0,70.0
104052421.0,6,44,2904,22,1452,4954877.19047619,66.0,66.0,22,1452,4944580.80952381,66.0,66.0
3007880.0,6,11,2106,6,598,601404.8,252.0,99.66666666666669,5,1508,1770.25,1236.0,301.6
135140123.0,17,6,1206,6,1206,27028024.6,201.0,201.0,0,0,0.0,0.0,0.0
2383.0,17,4,344,2,150,0.0,75.0,75.0,2,194,0.0,103.0,97.0
232498.0,6,3,337,2,214,0.0,160.0,107.0,1,123,0.0,123.0,123.0
109365840.0,6,244,28050,122,19702,902065.6859504132,284.0,161.49180327868854,122,8348,902066.6446280992,140.0,68.42622950819673
90280389.0,6,18,1341,9,691,11285048.625,95.0,76.77777777777777,9,650,11249487.125,95.0,72.22222222222223
135136810.0,17,6,1146,6,1146,27027362.0,191.0,191.0,0,0,0.0,0.0,0.0
2065.0,17,4,344,2,150,0.0,75.0,75.0,2,194,0.0,103.0,97.0
284854.0,17,2,180,1,90,0.0,90.0,90.0,1,90,0.0,90.0,90.0
135128456.0,17,6,1206,6,1206,27025691.2,201.0,201.0,0,0,0.0,0.0,0.0
90258079.0,6,12,1832,8,1016,12894011.285714284,188.0,127.0,4,816,30030222.0,204.0,204.0
135140323.0,17,6,1146,6,1146,27028064.6,191.0,191.0,0,0,0.0,0.0,0.0
38411.0,6,14,4740,7,653,5695.166666666667,249.0,93.28571428571428,7,4087,6030.666666666667,1514.0,583.8571428571429
205959.0,6,3,426,2,280,0.0,214.0,140.0,1,146,0.0,146.0,146.0
196910.0,17,2,180,1,90,0.0,90.0,90.0,1,90,0.0,90.0,90.0
287428.0,17,2,359,1,75,0.0,75.0,75.0,1,284,0.0,284.0,284.0
102562712.0,17,14,864,7,432,17001409.833333332,174.0,61.71428571428572,7,432,17000210.166666668,174.0,61.71428571428572
201763.0,17,2,180,1,90,0.0,90.0,90.0,1,90,0.0,90.0,90.0
118883600.0,6,34,2334,17,1209,7430225.0,123.0,71.11764705882354,17,1125,7416705.6875,123.0,66.17647058823529
208254.0,6,3,426,2,280,0.0,214.0,140.0,1,146,0.0,146.0,146.0
2647588.0,6,26,7627,14,3735,203660.6153846153,1514.0,266.7857142857143,12,3892,218237.8181818181,1514.0,324.3333333333333
47797.0,6,14,4740,7,653,7485.5,249.0,93.28571428571428,7,4087,6526.5,1514.0,583.8571428571429
756.0,17,4,438,2,148,0.0,74.0,74.0,2,290,0.0,147.0,145.0
281399.0,17,2,363,1,79,0.0,79.0,79.0,1,284,0.0,284.0,284.0
325.0,17,2,164,1,82,0.0,82.0,82.0,1,82,0.0,82.0,82.0
172371.0,17,2,414,1,88,0.0,88.0,88.0,1,326,0.0,326.0,326.0
123839865.0,6,49,3234,25,1650,5159994.375,66.0,66.0,24,1584,5124653.913043479,66.0,66.0
43761.0,6,14,4740,7,653,7131.833333333333,249.0,93.28571428571428,7,4087,6761.333333333333,1514.0,583.8571428571429
113520291.0,6,46,3036,23,1518,5160001.590909091,66.0,66.0,23,1518,5160001.681818182,66.0,66.0
3526.0,17,4,344,2,150,0.0,75.0,75.0,2,194,0.0,103.0,97.0
10533079.0,6,7,478,4,272,3463776.0,74.0,68.0,3,206,5195538.0,74.0,68.66666666666667
3171752.0,6,18,1495,9,921,358680.75,315.0,102.33333333333331,9,574,358651.75,78.0,63.77777777777778
209635.0,17,2,180,1,90,0.0,90.0,90.0,1,90,0.0,90.0,90.0
90741586.0,6,20,1531,11,840,9069157.3,95.0,76.36363636363636,9,691,11342122.125,95.0,76.77777777777777
845165.0,6,9,1096,6,625,169033.0,287.0,104.16666666666669,3,471,284104.0,331.0,157.0
303541.0,6,3,202,2,128,0.0,74.0,64.0,1,74,0.0,74.0,74.0
321.0,17,2,166,1,75,0.0,75.0,75.0,1,91,0.0,91.0,91.0
216492.0,17,2,180,1,90,0.0,90.0,90.0,1,90,0.0,90.0,90.0
881260.0,6,10,1162,6,625,176252.0,287.0,104.16666666666669,4,537,201841.3333333333,331.0,134.25
107462.0,17,2,286,2,286,0.0,143.0,143.0,0,0,0.0,0.0,0.0
228226.0,17,2,180,1,90,0.0,90.0,90.0,1,90,0.0,90.0,90.0
98672.0,17,2,762,2,762,0.0,381.0,381.0,0,0,0.0,0.0,0.0
90864059.0,6,175,19604,88,6030,1044414.4712643678,140.0,68.52272727272727,87,13574,1044506.8023255814,284.0,156.02298850574712
90257518.0,6,15,2444,8,1016,12893931.142857144,188.0,127.0,7,1428,15015360.833333334,204.0,204.0
90255077.0,6,13,2036,8,1016,12893582.42857143,188.0,127.0,5,1020,22522778.75,204.0,204.0
103089.0,17,2,286,2,286,0.0,143.0,143.0,0,0,0.0,0.0,0.0
68722947.0,6,5,334,2,132,0.0,66.0,66.0,3,202,33073377.5,70.0,67.33333333333333
1037413.0,6,11,1134,6,558,207482.6,220.0,93.0,5,576,255930.75,304.0,115.2
134897935.0,17,16,1212,8,606,16455706.857142856,174.0,75.75,8,606,17122042.57142857,174.0,75.75
117183181.0,6,48,3168,24,1584,5094920.913043479,66.0,66.0,24,1584,5081461.347826087,66.0,66.0
301012.0,6,6,412,4,272,100337.33333333331,74.0,68.0,2,140,0.0,74.0,70.0
872784.0,6,10,1226,6,689,174556.8,351.0,114.83333333333331,4,537,200098.0,331.0,134.25
2698433.0,6,25,7573,14,3735,207571.7692307692,1514.0,266.7857142857143,11,3838,244646.4,1514.0,348.90909090909093
135133273.0,17,6,1146,6,1146,27026654.6,191.0,191.0,0,0,0.0,0.0,0.0
1246149.0,6,7,499,4,301,395138.0,103.0,75.25,3,198,614634.5,66.0,66.0
2423.0,17,4,344,2,150,0.0,75.0,75.0,2,194,0.0,103.0,97.0
44601.0,6,14,4740,7,653,7269.833333333333,249.0,93.28571428571428,7,4087,6001.166666666667,1514.0,583.8571428571429
1021.0,17,4,438,2,148,0.0,74.0,74.0,2,290,0.0,147.0,145.0
136598.0,6,13,1386,7,789,22766.33333333333,253.0,112.71428571428572,6,597,25979.0,259.0,99.5
90324885.0,6,16,1192,8,596,12896058.714285716,95.0,74.5,8,596,12898382.57142857,95.0,74.5
29345.0,6,14,4740,7,653,4485.0,249.0,93.28571428571428,7,4087,4734.666666666667,1514.0,583.8571428571429
3651916.0,6,5,336,2,134,0.0,68.0,67.0,3,202,1528980.5,70.0,67.33333333333333
108112108.0,17,5,955,5,955,27028027.0,191.0,191.0,0,0,0.0,0.0,0.0
29203094.0,6,10,643,6,396,5840618.8,95.0,66.0,4,247,9643051.333333334,85.0,61.75
92580954.0,6,180,20422,90,6162,1032135.0898876404,140.0,68.46666666666667,90,14260,1031113.8876404496,374.0,158.44444444444446
27178137.0,6,9,754,5,482,6754292.5,210.0,96.4,4,272,9005668.333333334,74.0,68.0
169948.0,17,4,704,2,148,0.0,74.0,74.0,2,556,0.0,280.0,278.0
29316.0,6,14,4740,7,653,4765.0,249.0,93.28571428571428,7,4087,4715.0,1514.0,583.8571428571429
90040515.0,17,28,13364,28,13364,3334833.888888889,501.0,477.2857142857143,0,0,0.0,0.0,0.0
90191476.0,6,20,1744,10,1040,9997335.0,222.0,104.0,10,704,9997344.666666666,95.0,70.4
120050967.0,17,28,13364,28,13364,4446332.111111111,501.0,477.2857142857143,0,0,0.0,0.0,0.0
218982.0,6,3,426,2,280,0.0,214.0,140.0,1,146,0.0,146.0,146.0
0.0,17,1,350,1,350,0.0,350.0,350.0,0,0,0.0,0.0,0.0
128019686.0,6,31,2034,16,1086,8534645.733333332,123.0,67.875,15,948,8415647.285714285,123.0,63.2
90060315.0,17,28,13364,28,13364,3335567.222222222,501.0,477.2857142857143,0,0,0.0,0.0,0.0
16723.0,6,14,4740,7,653,2559.5,249.0,93.28571428571428,7,4087,2607.833333333333,1514.0,583.8571428571429
147995.0,17,2,180,1,90,0.0,90.0,90.0,1,90,0.0,90.0,90.0
51086.0,6,10,2032,5,524,12261.0,252.0,104.8,5,1508,11816.75,1236.0,301.6
468355.0,6,12,1373,7,714,78059.16666666667,298.0,102.0,5,659,112795.25,379.0,131.8
91917465.0,6,24,1829,13,989,7659680.916666667,95.0,76.07692307692308,11,840,9190074.0,95.0,76.36363636363636
2452.0,17,2,180,1,90,0.0,90.0,90.0,1,90,0.0,90.0,90.0
32150.0,6,14,4740,7,653,5196.166666666667,249.0,93.28571428571428,7,4087,3875.1666666666665,1514.0,583.8571428571429
121339421.0,6,261,29978,131,21102,933380.1615384616,300.0,161.08396946564886,130,8876,924640.2170542636,140.0,68.27692307692308
310777.0,17,4,1400,4,1400,103592.33333333331,350.0,350.0,0,0,0.0,0.0,0.0
76513.0,6,14,4740,7,653,12453.166666666666,249.0,93.28571428571428,7,4087,11977.666666666666,1514.0,583.8571428571429
515.0,17,2,267,1,83,0.0,83.0,83.0,1,184,0.0,184.0,184.0
103616760.0,6,44,2904,22,1452,4934131.428571428,66.0,66.0,22,1452,4921159.904761905,66.0,66.0
32650.0,6,14,4740,7,653,4834.5,249.0,93.28571428571428,7,4087,5304.0,1514.0,583.8571428571429
41888.0,6,2,132,1,66,0.0,66.0,66.0,1,66,0.0,66.0,66.0
90012078.0,17,27,12943,27,12943,3462003.0,501.0,479.3703703703704,0,0,0.0,0.0,0.0
321924.0,17,4,1400,4,1400,107308.0,350.0,350.0,0,0,0.0,0.0,0.0
90255940.0,6,16,1233,9,691,11281992.5,95.0,76.77777777777777,7,542,15006139.5,95.0,77.42857142857143
206087.0,17,2,180,1,90,0.0,90.0,90.0,1,90,0.0,90.0,90.0
90018112.0,17,28,13364,28,13364,3334004.1481481483,501.0,477.2857142857143,0,0,0.0,0.0,0.0
8228.0,17,2,582,1,83,0.0,83.0,83.0,1,499,0.0,499.0,499.0
209499.0,17,2,180,1,90,0.0,90.0,90.0,1,90,0.0,90.0,90.0
22954566.0,6,26,7627,14,3735,187704.84615384616,1514.0,266.7857142857143,12,3892,2068161.2727272727,1514.0,324.3333333333333
8357182.0,17,3,1034,2,684,0.0,342.0,342.0,1,350,0.0,350.0,350.0
90527032.0,6,14,2240,8,1016,12932433.142857144,188.0,127.0,6,1224,18072398.0,204.0,204.0
108116787.0,17,5,955,5,955,27029196.75,191.0,191.0,0,0,0.0,0.0,0.0
18525.0,6,14,4740,7,653,2814.6666666666665,249.0,93.28571428571428,7,4087,2948.6666666666665,1514.0,583.8571428571429
3880.0,17,4,571,2,148,0.0,74.0,74.0,2,423,0.0,276.0,211.5
128647907.0,6,34,2334,17,1125,7416416.625,123.0,66.17647058823529,17,1209,7416406.125,123.0,71.11764705882354
90252120.0,6,13,2036,8,1016,12893160.0,188.0,127.0,5,1020,22521688.0,204.0,204.0
396.0,17,2,166,1,75,0.0,75.0,75.0,1,91,0.0,91.0,91.0
43421.0,6,14,4740,7,653,7050.166666666667,249.0,93.28571428571428,7,4087,6680.0,1514.0,583.8571428571429
9362.0,6,10,2032,5,524,2034.25,252.0,104.8,5,1508,1998.25,1236.0,301.6
233117.0,6,3,337,2,214,0.0,160.0,107.0,1,123,0.0,123.0,123.0
2591170.0,6,2,132,1,66,0.0,66.0,66.0,1,66,0.0,66.0,66.0
45044653.0,17,9,3086,8,2736,5106066.571428572,342.0,342.0,1,350,0.0,350.0,350.0
104345.0,17,2,286,2,286,0.0,143.0,143.0,0,0,0.0,0.0,0.0
90255539.0,6,12,1832,8,1016,12893648.42857143,188.0,127.0,4,816,30030559.33333333,204.0,204.0
44717.0,6,10,2032,5,524,10841.5,252.0,104.8,5,1508,10386.0,1236.0,301.6
58073.0,6,14,4740,7,653,9347.666666666666,249.0,93.28571428571428,7,4087,7831.833333333333,1514.0,583.8571428571429
111062733.0,6,34,2482,17,1288,6927856.9375,139.0,75.76470588235294,17,1194,6927919.0,123.0,70.23529411764706
30591.0,6,10,2032,5,524,6542.75,252.0,104.8,5,1508,7154.25,1236.0,301.6
90017133.0,17,28,13364,28,13364,3333967.888888889,501.0,477.2857142857143,0,0,0.0,0.0,0.0
90255380.0,6,14,1964,8,1016,12893625.714285716,188.0,127.0,6,948,18018595.4,204.0,158.0
90215978.0,6,16,1192,8,596,12852391.857142856,95.0,74.5,8,596,12857208.57142857,95.0,74.5
107797075.0,6,28,1860,14,966,8275471.538461538,123.0,69.0,14,894,8275483.692307692,123.0,63.85714285714285
104590.0,17,2,700,2,700,0.0,350.0,350.0,0,0,0.0,0.0,0.0
47127.0,6,14,4740,7,653,7671.166666666667,249.0,93.28571428571428,7,4087,7713.166666666667,1514.0,583.8571428571429
90053464.0,17,28,13364,28,13364,3335313.4814814813,501.0,477.2857142857143,0,0,0.0,0.0,0.0
4767.0,17,2,180,1,90,0.0,90.0,90.0,1,90,0.0,90.0,90.0
44968.0,6,14,4740,7,653,6124.666666666667,249.0,93.28571428571428,7,4087,7355.0,1514.0,583.8571428571429
103605857.0,6,43,2838,22,1452,4933599.619047619,66.0,66.0,21,1386,5144001.65,66.0,66.0
120424173.0,6,227,25706,114,17952,1065700.646017699,284.0,157.47368421052633,113,7754,1066038.7232142857,140.0,68.61946902654867
119733.0,17,2,180,1,70,0.0,70.0,70.0,1,110,0.0,110.0,110.0
108107620.0,17,5,1005,5,1005,27026905.0,201.0,201.0,0,0,0.0,0.0,0.0
318585.0,6,6,412,4,272,106195.0,74.0,68.0,2,140,0.0,74.0,70.0
209430.0,17,2,180,1,90,0.0,90.0,90.0,1,90,0.0,90.0,90.0
240258.0,6,3,373,2,238,0.0,172.0,119.0,1,135,0.0,135.0,135.0
29244.0,6,14,4740,7,653,4646.0,249.0,93.28571428571428,7,4087,4701.833333333333,1514.0,583.8571428571429
260113.0,6,3,337,2,214,0.0,160.0,107.0,1,123,0.0,123.0,123.0
20431.0,17,2,582,1,83,0.0,83.0,83.0,1,499,0.0,499.0,499.0
120676048.0,17,14,1126,7,563,16835893.666666668,174.0,80.42857142857143,7,563,16833491.666666668,174.0,80.42857142857143
36042.0,6,10,2032,5,524,7605.25,252.0,104.8,5,1508,8564.25,1236.0,301.6
112376007.0,6,202,22742,101,15780,1121608.54,284.0,156.23762376237624,101,6962,1121608.93,140.0,68.93069306930693
312099.0,6,3,202,2,128,0.0,74.0,64.0,1,74,0.0,74.0,74.0
104497431.0,6,31,2182,16,1165,6952097.066666666,139.0,72.8125,15,1017,7448655.214285715,123.0,67.8
120211431.0,6,23,1734,11,840,11999574.9,95.0,76.36363636363636,12,894,10908708.818181818,95.0,74.5
785.0,17,4,438,2,148,0.0,74.0,74.0,2,290,0.0,147.0,145.0
135131361.0,17,6,1146,6,1146,27026272.2,191.0,191.0,0,0,0.0,0.0,0.0
153398.0,17,2,180,1,90,0.0,90.0,90.0,1,90,0.0,90.0,90.0
90039677.0,17,28,13364,28,13364,3334802.851851852,501.0,477.2857142857143,0,0,0.0,0.0,0.0
90301481.0,6,16,1192,8,596,12892875.57142857,95.0,74.5,8,596,12898471.714285716,95.0,74.5
1764.0,17,2,664,1,322,0.0,322.0,322.0,1,342,0.0,342.0,342.0
44975.0,6,14,4740,7,653,6595.833333333333,249.0,93.28571428571428,7,4087,7227.666666666667,1514.0,583.8571428571429
147879.0,17,2,180,1,90,0.0,90.0,90.0,1,90,0.0,90.0,90.0
668708.0,6,6,686,3,374,295691.0,160.0,124.66666666666669,3,312,218576.5,123.0,104.0
25893.0,6,10,2032,5,524,6001.75,252.0,104.8,5,1508,5630.5,1236.0,301.6
103200258.0,6,42,2772,21,1386,5160000.2,66.0,66.0,21,1386,5159999.35,66.0,66.0
318.0,17,2,174,1,79,0.0,79.0,79.0,1,95,0.0,95.0,95.0
300797.0,17,2,180,1,90,0.0,90.0,90.0,1,90,0.0,90.0,90.0
1403353.0,17,16,1120,16,1120,93556.86666666668,70.0,70.0,0,0,0.0,0.0,0.0
118203505.0,6,34,2334,17,1209,7374227.75,123.0,71.11764705882354,17,1125,7374232.25,123.0,66.17647058823529
10120.0,17,2,571,1,86,0.0,86.0,86.0,1,485,0.0,485.0,485.0
90800410.0,6,177,19954,89,6022,1031822.8409090908,140.0,67.66292134831461,88,13932,1031853.551724138,284.0,158.3181818181818
100103657.0,17,12,778,6,389,20001736.2,174.0,64.83333333333333,6,389,20000169.4,174.0,64.83333333333333
103363.0,17,2,286,2,286,0.0,143.0,143.0,0,0,0.0,0.0,0.0
240642.0,6,3,373,2,238,0.0,172.0,119.0,1,135,0.0,135.0,135.0
233114.0,6,3,337,2,214,0.0,160.0,107.0,1,123,0.0,123.0,123.0
1315453.0,6,4,264,2,132,0.0,66.0,66.0,2,132,0.0,66.0,66.0
30454.0,6,14,4740,7,653,4954.0,249.0,93.28571428571428,7,4087,4934.166666666667,1514.0,583.8571428571429
2593642.0,6,2,132,1,66,0.0,66.0,66.0,1,66,0.0,66.0,66.0
33116.0,6,10,2032,5,524,6615.5,252.0,104.8,5,1508,7933.75,1236.0,301.6
112121202.0,17,16,1212,8,606,15858415.0,174.0,75.75,8,606,16000144.57142857,174.0,75.75
238775.0,17,2,180,1,90,0.0,90.0,90.0,1,90,0.0,90.0,90.0
135133366.0,17,6,1146,6,1146,27026673.2,191.0,191.0,0,0,0.0,0.0,0.0
32417.0,6,10,2032,5,524,7894.75,252.0,104.8,5,1508,7590.75,1236.0,301.6
2376.0,17,4,344,2,150,0.0,75.0,75.0,2,194,0.0,103.0,97.0
352925.0,17,2,180,1,90,0.0,90.0,90.0,1,90,0.0,90.0,90.0
0.0,17,1,381,1,381,0.0,381.0,381.0,0,0,0.0,0.0,0.0
16126.999999999998,6,10,2032,5,524,3810.0,252.0,104.8,5,1508,3642.25,1236.0,301.6
216481.0,17,2,180,1,90,0.0,90.0,90.0,1,90,0.0,90.0,90.0
101783.0,17,2,762,2,762,0.0,381.0,381.0,0,0,0.0,0.0,0.0
2804690.0,6,2,132,1,66,0.0,66.0,66.0,1,66,0.0,66.0,66.0
21227.0,6,10,2032,5,524,5088.75,252.0,104.8,5,1508,4613.25,1236.0,301.6
111713242.0,6,30,1974,15,1026,7964069.857142857,123.0,68.4,15,948,7964065.0,123.0,63.2
0.0,6,1,66,1,66,0.0,66.0,66.0,0,0,0.0,0.0,0.0
313140.0,17,2,180,1,90,0.0,90.0,90.0,1,90,0.0,90.0,90.0
100748.0,17,2,762,2,762,0.0,381.0,381.0,0,0,0.0,0.0,0.0
120126364.0,6,14,2224,9,1204,15015795.5,188.0,133.77777777777777,5,1020,22523978.0,204.0,204.0
26079.0,6,14,4740,7,653,4082.5,249.0,93.28571428571428,7,4087,4009.3333333333335,1514.0,583.8571428571429
216455.0,17,2,180,1,90,0.0,90.0,90.0,1,90,0.0,90.0,90.0
1177349.0,6,13,3012,8,2384,168192.7142857143,1514.0,298.0,5,628,226175.0,331.0,125.6
15243.0,6,13,1459,7,862,2496.6666666666665,271.0,123.14285714285714,6,597,2734.2,259.0,99.5
304475.0,6,6,412,4,272,101491.66666666669,74.0,68.0,2,140,0.0,74.0,70.0
10967599.0,6,8,544,4,272,3608635.6666666665,74.0,68.0,4,272,3608567.0,74.0,68.0
90257383.0,6,15,2168,8,1016,12893911.857142856,188.0,127.0,7,1152,15009635.833333334,204.0,164.57142857142858
49534.0,6,14,4740,7,653,8131.5,249.0,93.28571428571428,7,4087,7567.0,1514.0,583.8571428571429
0.0,17,1,44,1,44,0.0,44.0,44.0,0,0,0.0,0.0,0.0
108347265.0,6,28,1860,14,966,8317786.230769231,123.0,69.0,14,894,8317784.692307692,123.0,63.85714285714285
297.0,17,2,164,1,82,0.0,82.0,82.0,1,82,0.0,82.0,82.0
228348.0,17,2,180,1,90,0.0,90.0,90.0,1,90,0.0,90.0,90.0
2794470.0,6,2,132,1,66,0.0,66.0,66.0,1,66,0.0,66.0,66.0
90017413.0,17,27,12943,27,12943,3462208.1923076925,501.0,479.3703703703704,0,0,0.0,0.0,0.0
99502.0,6,14,4740,7,653,12838.333333333334,249.0,93.28571428571428,7,4087,15450.666666666666,1514.0,583.8571428571429
90291585.0,6,16,1192,8,596,12892244.142857144,95.0,74.5,8,596,12897136.42857143,95.0,74.5
45549.0,6,10,2032,5,524,9830.5,252.0,104.8,5,1508,10728.5,1236.0,301.6
204522.0,17,2,762,2,762,0.0,381.0,381.0,0,0,0.0,0.0,0.0
810.0,17,4,438,2,148,0.0,74.0,74.0,2,290,0.0,147.0,145.0
217847.0,6,3,426,2,280,0.0,214.0,140.0,1,146,0.0,146.0,146.0
36799.0,6,14,4740,7,653,5631.333333333333,249.0,93.28571428571428,7,4087,5266.833333333333,1514.0,583.8571428571429
299706.0,6,6,412,4,272,99902.0,74.0,68.0,2,140,0.0,74.0,70.0
895.0,17,4,438,2,148,0.0,74.0,74.0,2,290,0.0,147.0,145.0
112535448.0,6,46,3036,23,1518,5105444.2727272725,66.0,66.0,23,1518,5105444.318181818,66.0,66.0
105881.0,17,2,700,2,700,0.0,350.0,350.0,0,0,0.0,0.0,0.0
113640812.0,6,47,3102,24,1584,4940894.0869565215,66.0,66.0,23,1518,5151995.363636363,66.0,66.0
90060523.0,17,28,13364,28,13364,3335574.925925926,501.0,477.2857142857143,0,0,0.0,0.0,0.0
90096873.0,6,11,1644,4,816,30031906.666666668,204.0,204.0,7,828,15015581.333333334,188.0,118.28571428571428
26695.0,6,14,4740,7,653,4314.833333333333,249.0,93.28571428571428,7,4087,3559.833333333333,1514.0,583.8571428571429
120456404.0,6,25,1924,11,840,9149885.4,95.0,76.36363636363636,14,1084,9246925.846153846,95.0,77.42857142857143
2799283.0,6,2,132,1,66,0.0,66.0,66.0,1,66,0.0,66.0,66.0
1305465.0,6,4,264,2,132,0.0,66.0,66.0,2,132,0.0,66.0,66.0
103832.0,17,2,700,2,700,0.0,350.0,350.0,0,0,0.0,0.0,0.0
50429.0,6,14,4740,7,653,7962.166666666667,249.0,93.28571428571428,7,4087,7548.333333333333,1514.0,583.8571428571429
332.0,17,2,160,1,80,0.0,80.0,80.0,1,80,0.0,80.0,80.0
2778567.0,6,3,1777,2,951,0.0,885.0,475.5,1,826,0.0,826.0,826.0
218239.0,6,3,426,2,280,0.0,214.0,140.0,1,146,0.0,146.0,146.0
135132940.0,17,6,1206,6,1206,27026588.0,201.0,201.0,0,0,0.0,0.0,0.0
25896.0,17,4,344,2,150,0.0,75.0,75.0,2,194,0.0,103.0,97.0
8867.0,17,2,498,1,80,0.0,80.0,80.0,1,418,0.0,418.0,418.0
106994.0,17,2,700,2,700,0.0,350.0,350.0,0,0,0.0,0.0,0.0
25598.0,6,14,4740,7,653,4001.1666666666665,249.0,93.28571428571428,7,4087,3844.0,1514.0,583.8571428571429
22025.0,6,14,4740,7,653,2962.5,249.0,93.28571428571428,7,4087,3406.833333333333,1514.0,583.8571428571429
2449.0,17,4,344,2,150,0.0,75.0,75.0,2,194,0.0,103.0,97.0
109396012.0,17,14,864,7,432,18206183.166666668,174.0,61.71428571428572,7,432,18204359.166666668,174.0,61.71428571428572
13313.0,6,10,1065,5,534,2648.75,262.0,106.8,5,531,2957.75,259.0,106.2
27396.0,6,13,1386,7,789,4523.666666666667,253.0,112.71428571428572,6,597,5122.0,259.0,99.5
602111.0,6,4,508,2,238,0.0,172.0,119.0,2,270,0.0,135.0,135.0
207120.0,17,2,762,2,762,0.0,381.0,381.0,0,0,0.0,0.0,0.0
58754935.0,17,9,3086,8,2736,5111345.571428572,342.0,342.0,1,350,0.0,350.0,350.0
1880.0,17,2,192,1,88,0.0,88.0,88.0,1,104,0.0,104.0,104.0
234717.0,17,2,180,1,90,0.0,90.0,90.0,1,90,0.0,90.0,90.0
0.0,17,1,342,1,342,0.0,342.0,342.0,0,0,0.0,0.0,0.0
90054282.0,17,28,13364,28,13364,3335343.777777778,501.0,477.2857142857143,0,0,0.0,0.0,0.0
90066461.0,17,28,13364,28,13364,3335794.851851852,501.0,477.2857142857143,0,0,0.0,0.0,0.0
23253.0,17,4,820,2,156,0.0,78.0,78.0,2,664,0.0,332.0,332.0
15763.0,6,14,4740,7,653,2458.0,249.0,93.28571428571428,7,4087,2486.1666666666665,1514.0,583.8571428571429
170337.0,17,4,1524,4,1524,56779.0,381.0,381.0,0,0,0.0,0.0,0.0
512185.0,17,6,2100,6,2100,102437.0,350.0,350.0,0,0,0.0,0.0,0.0
57161.0,6,12,1320,7,789,9526.833333333334,253.0,112.71428571428572,5,531,11528.0,259.0,106.2
6792.0,17,2,582,1,83,0.0,83.0,83.0,1,499,0.0,499.0,499.0
90644883.0,6,15,2302,9,1204,11315449.5,188.0,133.77777777777777,6,1098,18096892.6,204.0,183.0
209644.0,17,2,180,1,90,0.0,90.0,90.0,1,90,0.0,90.0,90.0
46583885.0,6,8,1940,3,887,22182922.5,753.0,295.6666666666667,5,1053,11004048.25,785.0,210.6
364175.0,6,10,967,5,390,61257.5,162.0,78.0,5,577,61190.5,349.0,115.4
28000.0,6,14,4740,7,653,4552.833333333333,249.0,93.28571428571428,7,4087,3406.5,1514.0,583.8571428571429
1165127.0,6,13,3017,8,2389,166446.7142857143,1514.0,298.625,5,628,222395.75,331.0,125.6
217959.0,6,3,426,2,280,0.0,214.0,140.0,1,146,0.0,146.0,146.0
808.0,17,4,438,2,148,0.0,74.0,74.0,2,290,0.0,147.0,145.0
33966.0,6,10,2032,5,524,8255.25,252.0,104.8,5,1508,8024.25,1236.0,301.6
14527.0,6,10,2032,5,524,3114.0,252.0,104.8,5,1508,3388.0,1236.0,301.6
17314.0,6,14,4740,7,653,2505.833333333333,249.0,93.28571428571428,7,4087,2741.6666666666665,1514.0,583.8571428571429
105020.0,17,2,286,2,286,0.0,143.0,143.0,0,0,0.0,0.0,0.0
90287510.0,6,21,1585,11,840,9024213.6,95.0,76.36363636363636,10,745,10000556.222222222,95.0,74.5
209537.0,17,2,180,1,90,0.0,90.0,90.0,1,90,0.0,90.0,90.0
112456.0,6,10,2032,5,524,22381.75,252.0,104.8,5,1508,26182.0,1236.0,301.6
90062124.0,17,28,13364,28,13364,3335634.222222222,501.0,477.2857142857143,0,0,0.0,0.0,0.0
59650.0,6,14,4740,7,653,9705.5,249.0,93.28571428571428,7,4087,7674.166666666667,1514.0,583.8571428571429
145300.0,17,4,820,2,156,0.0,78.0,78.0,2,664,0.0,332.0,332.0
47816149.0,6,8,1940,3,887,22562405.5,753.0,295.6666666666667,5,1053,11256774.25,785.0,210.6
53363.0,6,14,4740,7,653,8735.833333333334,249.0,93.28571428571428,7,4087,8743.0,1514.0,583.8571428571429
306988.0,6,6,412,4,272,102329.33333333331,74.0,68.0,2,140,0.0,74.0,70.0
53689.0,6,10,2032,5,524,12601.75,252.0,104.8,5,1508,11931.0,1236.0,301.6
0.0,17,1,44,1,44,0.0,44.0,44.0,0,0,0.0,0.0,0.0
27280.0,6,10,2032,5,524,6601.5,252.0,104.8,5,1508,6491.5,1236.0,301.6
120375518.0,6,227,25774,114,18094,1065270.07079646,284.0,158.71929824561403,113,7680,1065498.75,140.0,67.96460176991151
2083.0,17,4,344,2,150,0.0,75.0,75.0,2,194,0.0,103.0,97.0
217574.0,6,3,426,2,280,0.0,214.0,140.0,1,146,0.0,146.0,146.0
2650366.0,6,3,1604,1,753,0.0,753.0,753.0,2,851,0.0,785.0,425.5
31643.0,6,14,4740,7,653,4303.333333333333,249.0,93.28571428571428,7,4087,5062.666666666667,1514.0,583.8571428571429
120451930.0,6,26,2898,13,1449,7623987.75,334.0,111.46153846153848,13,1449,10017517.833333334,425.0,111.46153846153848
213737.0,17,2,180,1,90,0.0,90.0,90.0,1,90,0.0,90.0,90.0
310296.0,17,4,1400,4,1400,103432.0,350.0,350.0,0,0,0.0,0.0,0.0
252547.00000000003,17,2,876,2,876,0.0,438.0,438.0,0,0,0.0,0.0,0.0
302.0,17,2,168,1,76,0.0,76.0,76.0,1,92,0.0,92.0,92.0
90259350.0,6,12,1832,8,1016,12894192.857142856,188.0,127.0,4,816,30025273.666666668,204.0,204.0
509571.0,6,5,336,2,134,0.0,68.0,67.0,3,202,191345.5,70.0,67.33333333333333
108107018.0,17,5,955,5,955,27026754.5,191.0,191.0,0,0,0.0,0.0,0.0
27751298.0,17,5,1710,5,1710,6937824.5,342.0,342.0,0,0,0.0,0.0,0.0
21751.0,17,2,582,1,83,0.0,83.0,83.0,1,499,0.0,499.0,499.0
2466.0,17,4,344,2,150,0.0,75.0,75.0,2,194,0.0,103.0,97.0
142353.0,6,2,132,1,66,0.0,66.0,66.0,1,66,0.0,66.0,66.0
15395.0,6,10,1065,5,534,3586.0,262.0,106.8,5,531,3532.0,259.0,106.2
34066.0,6,14,4740,7,653,5231.166666666667,249.0,93.28571428571428,7,4087,5203.0,1514.0,583.8571428571429
31610.0,6,14,4740,7,653,5146.666666666667,249.0,93.28571428571428,7,4087,5041.166666666667,1514.0,583.8571428571429
117328869.0,6,269,30818,135,9206,875588.5746268657,140.0,68.19259259259259,134,21612,874370.4887218045,390.0,161.28358208955223
354.0,17,2,248,1,84,0.0,84.0,84.0,1,164,0.0,164.0,164.0
16952.0,6,14,4740,7,653,2675.833333333333,249.0,93.28571428571428,7,4087,2690.333333333333,1514.0,583.8571428571429
149711958.0,17,36,17126,36,17126,4277484.514285714,501.0,475.72222222222223,0,0,0.0,0.0,0.0
323502.0,17,2,180,1,90,0.0,90.0,90.0,1,90,0.0,90.0,90.0
462313.0,6,3,204,2,136,0.0,70.0,68.0,1,68,0.0,68.0,68.0
221309.0,6,3,426,2,280,0.0,214.0,140.0,1,146,0.0,146.0,146.0
2307.0,17,4,344,2,150,0.0,75.0,75.0,2,194,0.0,103.0,97.0
51981.0,6,14,4740,7,653,8538.833333333334,249.0,93.28571428571428,7,4087,7371.0,1514.0,583.8571428571429
38225.0,6,14,4740,7,653,6199.666666666667,249.0,93.28571428571428,7,4087,5319.666666666667,1514.0,583.8571428571429
233033.0,6,3,337,2,214,0.0,160.0,107.0,1,123,0.0,123.0,123.0
302961.0,6,6,412,4,272,100987.0,74.0,68.0,2,140,0.0,74.0,70.0
1767537.0,6,22,6443,11,1463,176753.7,357.0,133.0,11,4980,145551.6,1510.0,452.7272727272728
284556.0,17,2,363,1,79,0.0,79.0,79.0,1,284,0.0,284.0,284.0
30348.0,6,10,2032,5,524,7190.5,252.0,104.8,5,1508,7178.5,1236.0,301.6
108279840.0,6,41,3276,23,1821,4912002.909090909,123.0,79.17391304347827,18,1455,6356548.411764706,123.0,80.83333333333333
763426.0,6,14,4740,7,653,126676.16666666669,249.0,93.28571428571428,7,4087,126949.66666666669,1514.0,583.8571428571429
120028740.0,17,28,13364,28,13364,4445508.888888889,501.0,477.2857142857143,0,0,0.0,0.0,0.0
174895.0,17,4,1400,4,1400,58298.333333333336,350.0,350.0,0,0,0.0,0.0,0.0
110997.0,17,2,286,2,286,0.0,143.0,143.0,0,0,0.0,0.0,0.0
1456826.0,6,19,7533,10,1403,161869.55555555556,583.0,140.3,9,6130,150466.875,1484.0,681.1111111111111
223413.0,6,3,426,2,280,0.0,214.0,140.0,1,146,0.0,146.0,146.0
307025.0,6,6,412,4,272,102341.66666666669,74.0,68.0,2,140,0.0,74.0,70.0
122688056.0,6,49,3234,25,1650,5112002.333333333,66.0,66.0,24,1584,4904617.304347826,66.0,66.0
135132496.0,17,6,1146,6,1146,27026499.2,191.0,191.0,0,0,0.0,0.0,0.0
90304210.0,6,21,1585,11,840,9026012.8,95.0,76.36363636363636,10,745,10000858.888888888,95.0,74.5
228579.0,17,2,180,1,90,0.0,90.0,90.0,1,90,0.0,90.0,90.0
102310.0,17,2,286,2,286,0.0,143.0,143.0,0,0,0.0,0.0,0.0
251552.0,6,3,337,2,214,0.0,160.0,107.0,1,123,0.0,123.0,123.0
1631906.0,6,19,7537,10,1403,181322.88888888888,583.0,140.3,9,6134,172101.375,1484.0,681.5555555555555
104562.0,17,2,700,2,700,0.0,350.0,350.0,0,0,0.0,0.0,0.0
113168342.0,6,46,3036,23,1518,5144003.909090909,66.0,66.0,23,1518,5144004.454545454,66.0,66.0
29926.0,17,4,823,2,163,0.0,89.0,81.5,2,660,0.0,443.0,330.0
58467802.0,17,9,3086,8,2736,5216595.571428572,342.0,342.0,1,350,0.0,350.0,350.0
57330.0,6,12,1320,6,723,10808.6,253.0,120.5,6,597,10929.0,259.0,99.5
108154.0,17,2,286,2,286,0.0,143.0,143.0,0,0,0.0,0.0,0.0
90750283.0,6,22,1680,12,935,8245417.181818182,95.0,77.91666666666667,10,745,10052589.222222222,95.0,74.5
10519.0,6,10,1067,5,536,2463.5,264.0,107.2,5,531,2259.75,259.0,106.2
108108345.0,17,5,1005,5,1005,27027086.25,201.0,201.0,0,0,0.0,0.0,0.0
47605144.0,6,7,1872,3,886,22753120.5,752.0,295.3333333333333,4,986,14943709.666666666,784.0,246.5
27022926.0,17,5,1710,5,1710,6755731.5,342.0,342.0,0,0,0.0,0.0,0.0
21972.0,17,2,582,1,83,0.0,83.0,83.0,1,499,0.0,499.0,499.0
108102512.0,17,5,1005,5,1005,27025628.0,201.0,201.0,0,0,0.0,0.0,0.0
93072633.0,6,39,2574,20,1320,4898546.736842105,66.0,66.0,19,1254,5143994.0,66.0,66.0
119767510.0,6,26,1937,12,894,10866214.363636363,95.0,74.5,14,1043,9209232.23076923,95.0,74.5
120007270.0,6,19,1436,10,786,13333328.0,95.0,78.6,9,650,15000332.125,95.0,72.22222222222223
317753.0,17,4,1400,4,1400,105917.66666666669,350.0,350.0,0,0,0.0,0.0,0.0
90019091.0,17,27,12943,27,12943,3462272.730769231,501.0,479.3703703703704,0,0,0.0,0.0,0.0
0.0,6,1,66,1,66,0.0,66.0,66.0,0,0,0.0,0.0,0.0
90005038.0,17,28,13364,28,13364,3333519.925925926,501.0,477.2857142857143,0,0,0.0,0.0,0.0
246379.0,6,3,337,2,214,0.0,160.0,107.0,1,123,0.0,123.0,123.0
117005953.0,17,15,1169,8,606,16715136.142857144,174.0,75.75,7,563,16166803.666666666,174.0,80.42857142857143
135135737.0,17,6,1146,6,1146,27027147.4,191.0,191.0,0,0,0.0,0.0,0.0
91446058.0,6,24,1829,13,989,7620223.0,95.0,76.07692307692308,11,840,9143083.3,95.0,76.36363636363636
3175.0,17,4,344,2,150,0.0,75.0,75.0,2,194,0.0,103.0,97.0
319494.0,6,6,412,4,272,106498.0,74.0,68.0,2,140,0.0,74.0,70.0
113190382.0,6,47,3102,24,1584,4921309.956521739,66.0,66.0,23,1518,5143990.045454546,66.0,66.0
10433773.0,6,7,478,4,272,3432730.0,74.0,68.0,3,206,5148942.0,74.0,68.66666666666667
403.0,17,2,166,1,75,0.0,75.0,75.0,1,91,0.0,91.0,91.0
328.0,17,2,174,1,79,0.0,79.0,79.0,1,95,0.0,95.0,95.0
206447.0,6,3,426,2,280,0.0,214.0,140.0,1,146,0.0,146.0,146.0
45559423.0,6,8,1940,3,887,21731339.0,753.0,295.6666666666667,5,1053,10722440.5,785.0,210.6
2303.0,17,4,344,2,150,0.0,75.0,75.0,2,194,0.0,103.0,97.0
218619.0,6,3,426,2,280,0.0,214.0,140.0,1,146,0.0,146.0,146.0
119338.0,17,4,1400,4,1400,39779.333333333336,350.0,350.0,0,0,0.0,0.0,0.0
323.0,17,2,174,1,79,0.0,79.0,79.0,1,95,0.0,95.0,95.0
107500.0,17,2,700,2,700,0.0,350.0,350.0,0,0,0.0,0.0,0.0
239199.0,17,2,180,1,90,0.0,90.0,90.0,1,90,0.0,90.0,90.0
161063.0,6,3,337,2,214,0.0,160.0,107.0,1,123,0.0,123.0,123.0
108258.0,17,2,286,2,286,0.0,143.0,143.0,0,0,0.0,0.0,0.0
438.0,17,2,248,1,84,0.0,84.0,84.0,1,164,0.0,164.0,164.0
166373.0,17,2,180,1,90,0.0,90.0,90.0,1,90,0.0,90.0,90.0
284397.0,17,2,363,1,79,0.0,79.0,79.0,1,284,0.0,284.0,284.0
19750.0,6,14,4740,7,653,2685.833333333333,249.0,93.28571428571428,7,4087,3011.833333333333,1514.0,583.8571428571429
246452.0,6,3,373,2,238,0.0,172.0,119.0,1,135,0.0,135.0,135.0
206833.0,6,3,426,2,280,0.0,214.0,140.0,1,146,0.0,146.0,146.0
108927694.0,6,194,21982,97,6698,1115458.3645833333,140.0,69.05154639175258,97,15284,1134499.3229166667,284.0,157.56701030927834
108109681.0,17,5,955,5,955,27027420.25,191.0,191.0,0,0,0.0,0.0,0.0
24835063.0,17,4,1376,3,1026,1415696.0,342.0,342.0,1,350,0.0,350.0,350.0
1052832.0,6,3,1604,1,753,0.0,753.0,753.0,2,851,0.0,785.0,425.5
302394.0,6,2,132,1,66,0.0,66.0,66.0,1,66,0.0,66.0,66.0
296.0,17,2,164,1,82,0.0,82.0,82.0,1,82,0.0,82.0,82.0
90096306.0,6,13,1776,7,828,15016051.0,188.0,118.28571428571428,6,948,12012383.0,204.0,158.0
7227.0,17,2,582,1,83,0.0,83.0,83.0,1,499,0.0,499.0,499.0
232392.0,6,3,337,2,214,0.0,160.0,107.0,1,123,0.0,123.0,123.0
90748777.0,6,17,1287,9,691,11337300.875,95.0,76.77777777777777,8,596,12963529.57142857,95.0,74.5
108102732.0,17,5,955,5,955,27025683.0,191.0,191.0,0,0,0.0,0.0,0.0
68872.0,6,14,4740,7,653,11235.166666666666,249.0,93.28571428571428,7,4087,9673.666666666666,1514.0,583.8571428571429
102843.0,17,2,286,2,286,0.0,143.0,143.0,0,0,0.0,0.0,0.0
105564968.0,6,44,2904,22,1452,5026903.238095238,66.0,66.0,22,1452,5012376.238095238,66.0,66.0
505233.00000000006,6,5,336,2,134,0.0,68.0,67.0,3,202,193647.0,70.0,67.33333333333333
90055956.0,17,28,13364,28,13364,3335405.777777778,501.0,477.2857142857143,0,0,0.0,0.0,0.0
2161597.0,6,25,7609,13,2516,180133.08333333334,1034.0,193.53846153846155,12,5093,168400.72727272726,1510.0,424.4166666666667
10465800.0,6,7,478,4,272,3443081.0,74.0,68.0,3,206,5164495.5,74.0,68.66666666666667
459.0,17,2,508,2,508,0.0,257.0,254.0,0,0,0.0,0.0,0.0
111963427.0,6,29,1930,15,948,7997387.642857143,123.0,63.2,14,982,7827907.153846154,139.0,70.14285714285714
322065.0,6,3,202,2,128,0.0,74.0,64.0,1,74,0.0,74.0,74.0
90582598.0,6,26,1762,13,922,7531514.833333333,139.0,70.92307692307692,13,840,7531511.833333333,123.0,64.61538461538461
2077.0,17,4,344,2,150,0.0,75.0,75.0,2,194,0.0,103.0,97.0
108099686.0,17,5,955,5,955,27024921.5,191.0,191.0,0,0,0.0,0.0,0.0
816.0,17,4,438,2,148,0.0,74.0,74.0,2,290,0.0,147.0,145.0
108108974.0,17,5,955,5,955,27027243.5,191.0,191.0,0,0,0.0,0.0,0.0
120792951.0,6,34,2419,17,1194,6925383.4375,123.0,70.23529411764706,17,1225,7549476.0,139.0,72.05882352941177
204640.0,17,2,180,1,90,0.0,90.0,90.0,1,90,0.0,90.0,90.0
225388.0,6,13,1394,7,797,37564.66666666666,253.0,113.85714285714286,6,597,43631.2,259.0,99.5
14152.0,6,13,1459,7,862,2095.333333333333,271.0,123.14285714285714,6,597,2618.2,259.0,99.5
203670.0,17,2,762,2,762,0.0,381.0,381.0,0,0,0.0,0.0,0.0
135139619.0,17,6,1146,6,1146,27027923.8,191.0,191.0,0,0,0.0,0.0,0.0
120000019.0,6,17,1287,9,691,15000002.375,95.0,76.77777777777777,8,596,12896588.57142857,95.0,74.5
913066.0,6,13,1420,7,789,151454.83333333334,253.0,112.71428571428572,6,631,182397.2,293.0,105.16666666666669
100245.0,17,2,286,2,286,0.0,143.0,143.0,0,0,0.0,0.0,0.0
221648.0,6,3,426,2,280,0.0,214.0,140.0,1,146,0.0,146.0,146.0
107323.0,17,2,286,2,286,0.0,143.0,143.0,0,0,0.0,0.0,0.0
51123.0,17,2,180,1,90,0.0,90.0,90.0,1,90,0.0,90.0,90.0
16790.0,17,2,180,1,90,0.0,90.0,90.0,1,90,0.0,90.0,90.0
3157.0,17,2,224,1,76,0.0,76.0,76.0,1,148,0.0,148.0,148.0
35388.0,6,14,4740,7,653,5469.666666666667,249.0,93.28571428571428,7,4087,5673.333333333333,1514.0,583.8571428571429
315785.0,17,4,1400,4,1400,105261.66666666669,350.0,350.0,0,0,0.0,0.0,0.0
42306.0,6,14,4740,7,653,6742.0,249.0,93.28571428571428,7,4087,6778.666666666667,1514.0,583.8571428571429
908.0,17,4,438,2,148,0.0,74.0,74.0,2,290,0.0,147.0,145.0
99724179.0,6,29,2052,15,1089,7107777.571428572,123.0,72.6,14,963,7654532.615384615,123.0,68.78571428571429
136946.0,6,2,132,1,66,0.0,66.0,66.0,1,66,0.0,66.0,66.0
146789.0,6,3,337,2,214,0.0,160.0,107.0,1,123,0.0,123.0,123.0
192980.0,17,2,180,1,90,0.0,90.0,90.0,1,90,0.0,90.0,90.0
129001140.0,17,15,907,8,475,18428734.285714287,174.0,59.375,7,432,18167591.666666668,174.0,61.71428571428572
489.0,17,2,508,2,508,0.0,257.0,254.0,0,0,0.0,0.0,0.0
112032496.0,6,31,2166,16,1149,7468833.066666666,123.0,71.8125,15,1017,7986887.714285715,123.0,67.8
301368.0,6,6,412,4,272,100456.0,74.0,68.0,2,140,0.0,74.0,70.0
103364.0,17,2,286,2,286,0.0,143.0,143.0,0,0,0.0,0.0,0.0
2336.0,17,4,344,2,150,0.0,75.0,75.0,2,194,0.0,103.0,97.0
120037684.0,6,668,122496,335,100000,358749.502994012,1514.0,298.5074626865672,333,22496,360910.7590361446,214.0,67.55555555555556
69252.0,6,14,4740,7,653,9810.666666666666,249.0,93.28571428571428,7,4087,10292.666666666666,1514.0,583.8571428571429
23149658.0,17,3,1034,2,684,0.0,342.0,342.0,1,350,0.0,350.0,350.0
204770.0,17,2,762,2,762,0.0,381.0,381.0,0,0,0.0,0.0,0.0
607896.0,17,2,346,1,78,0.0,78.0,78.0,1,268,0.0,268.0,268.0
90255961.0,6,16,2368,9,1204,11281995.125,188.0,133.77777777777777,7,1164,15015292.333333334,204.0,166.28571428571428
2614851.0,6,26,7627,14,3735,201142.38461538465,1514.0,266.7857142857143,12,3892,213776.7272727273,1514.0,324.3333333333333
238354.0,6,3,426,2,280,0.0,214.0,140.0,1,146,0.0,146.0,146.0
206059.0,6,3,426,2,280,0.0,214.0,140.0,1,146,0.0,146.0,146.0
303688.0,6,2,132,1,66,0.0,66.0,66.0,1,66,0.0,66.0,66.0
90023320.0,17,28,13364,28,13364,3334197.037037037,501.0,477.2857142857143,0,0,0.0,0.0,0.0
103855028.0,6,348,65628,175,11846,596867.9770114942,214.0,67.69142857142857,173,53782,602538.4302325582,1514.0,310.87861271676303
127365014.0,6,32,2242,17,1225,7960313.375,139.0,72.05882352941177,15,1017,8368853.0,123.0,67.8
90254234.0,6,13,2036,8,1016,12893462.0,188.0,127.0,5,1020,22522207.5,204.0,204.0
90524813.0,6,14,2240,8,1016,12932116.142857144,188.0,127.0,6,1224,18071944.0,204.0,204.0
236637.0,6,3,337,2,214,0.0,160.0,107.0,1,123,0.0,123.0,123.0
43922.0,6,14,4740,7,653,7197.833333333333,249.0,93.28571428571428,7,4087,6685.0,1514.0,583.8571428571429
91979114.0,6,154,17302,77,11998,1207420.4342105263,284.0,155.8181818181818,77,5304,1207420.3026315789,140.0,68.88311688311688
135116214.0,17,6,1206,6,1206,27023242.8,201.0,201.0,0,0,0.0,0.0,0.0
6501.0,17,4,823,2,163,0.0,89.0,81.5,2,660,0.0,443.0,330.0
2595663.0,6,2,132,1,66,0.0,66.0,66.0,1,66,0.0,66.0,66.0
304319.0,6,6,412,4,272,101439.66666666669,74.0,68.0,2,140,0.0,74.0,70.0
1152824.0,6,13,3015,8,2387,164689.14285714287,1514.0,298.375,5,628,220087.75,331.0,125.6
311.0,17,2,174,1,79,0.0,79.0,79.0,1,95,0.0,95.0,95.0
228221.0,17,2,180,1,90,0.0,90.0,90.0,1,90,0.0,90.0,90.0
1878398.0,6,2,132,1,66,0.0,66.0,66.0,1,66,0.0,66.0,66.0
32754.0,6,14,4740,7,653,5334.5,249.0,93.28571428571428,7,4087,5099.5,1514.0,583.8571428571429
41173.0,6,14,4740,7,653,6125.166666666667,249.0,93.28571428571428,7,4087,6575.833333333333,1514.0,583.8571428571429
323.0,17,2,174,1,79,0.0,79.0,79.0,1,95,0.0,95.0,95.0
10472710.0,6,7,478,4,272,3445211.0,74.0,68.0,3,206,5167716.0,74.0,68.66666666666667
46825.0,6,10,2032,5,524,11314.75,252.0,104.8,5,1508,11440.0,1236.0,301.6
210019.0,6,10,1221,6,636,42003.8,298.0,106.0,4,585,68831.33333333333,379.0,146.25
35796.0,6,14,4740,7,653,5795.5,249.0,93.28571428571428,7,4087,5401.0,1514.0,583.8571428571429
10176.0,6,10,1065,5,534,2303.0,262.0,106.8,5,531,2171.0,259.0,106.2
153611.0,17,2,180,1,90,0.0,90.0,90.0,1,90,0.0,90.0,90.0
108104269.0,17,5,1005,5,1005,27026067.25,201.0,201.0,0,0,0.0,0.0,0.0
108110710.0,17,5,1005,5,1005,27027677.5,201.0,201.0,0,0,0.0,0.0,0.0
5796.0,17,2,237,1,81,0.0,81.0,81.0,1,156,0.0,156.0,156.0
50900.0,17,2,180,1,90,0.0,90.0,90.0,1,90,0.0,90.0,90.0
24055.0,6,14,4740,7,653,3882.5,249.0,93.28571428571428,7,4087,3826.5,1514.0,583.8571428571429
102047588.0,6,195,22154,98,15530,1052036.9896907215,284.0,158.46938775510205,97,6624,1056682.1458333333,140.0,68.28865979381443
35600.0,6,13,1479,7,882,5814.666666666667,291.0,126.0,6,597,6071.2,259.0,99.5
5623905.0,6,4,270,2,134,0.0,68.0,67.0,2,136,0.0,70.0,68.0
232148.0,6,3,337,2,214,0.0,160.0,107.0,1,123,0.0,123.0,123.0
242097.0,6,3,337,2,214,0.0,160.0,107.0,1,123,0.0,123.0,123.0
320014.0,6,6,412,4,272,106671.33333333331,74.0,68.0,2,140,0.0,74.0,70.0
154536.0,17,4,704,2,148,0.0,74.0,74.0,2,556,0.0,280.0,278.0
37002.0,6,14,4740,7,653,4772.333333333333,249.0,93.28571428571428,7,4087,5893.5,1514.0,583.8571428571429
299651.0,6,6,412,4,272,99883.66666666669,74.0,68.0,2,140,0.0,74.0,70.0
0.0,17,1,55,1,55,0.0,55.0,55.0,0,0,0.0,0.0,0.0
135133357.0,17,6,1206,6,1206,27026671.4,201.0,201.0,0,0,0.0,0.0,0.0
2021212.0,17,4,525,2,150,0.0,75.0,75.0,2,375,0.0,284.0,187.5
2205178.0,6,19,6869,10,1501,245019.7777777777,408.0,150.1,9,5368,232727.375,1514.0,596.4444444444445
29210.0,6,14,4740,7,653,4318.5,249.0,93.28571428571428,7,4087,4307.5,1514.0,583.8571428571429
32153.0,6,11,2098,6,590,6301.2,252.0,98.33333333333331,5,1508,5570.5,1236.0,301.6
38929.0,6,14,4740,7,653,5758.5,249.0,93.28571428571428,7,4087,6316.166666666667,1514.0,583.8571428571429
217554.0,6,3,426,2,280,0.0,214.0,140.0,1,146,0.0,146.0,146.0
844431.0,6,9,1118,6,586,168886.2,248.0,97.66666666666669,3,532,284258.5,392.0,177.33333333333334
13622.0,6,10,2032,5,524,3196.25,252.0,104.8,5,1508,3140.0,1236.0,301.6
55477.0,6,14,4740,7,653,9000.0,249.0,93.28571428571428,7,4087,9085.0,1514.0,583.8571428571429
120116195.0,6,13,1760,8,1016,17136631.0,188.0,127.0,5,744,22522266.0,204.0,148.8
21707.0,6,11,1133,6,602,4077.6,264.0,100.33333333333331,5,531,3351.5,259.0,106.2
143899.0,17,2,180,1,90,0.0,90.0,90.0,1,90,0.0,90.0,90.0
75069899.0,6,9,842,9,842,9383737.375,97.0,93.55555555555556,0,0,0.0,0.0,0.0
16742.0,6,10,2032,5,524,3185.75,252.0,104.8,5,1508,3440.25,1236.0,301.6
33192.0,6,10,2032,5,524,8039.5,252.0,104.8,5,1508,7410.25,1236.0,301.6
36591270.0,6,31,9428,17,3913,149009.625,1514.0,230.1764705882353,14,5515,2798967.461538461,1514.0,393.9285714285714
303160.0,6,2,132,1,66,0.0,66.0,66.0,1,66,0.0,66.0,66.0
143334.0,6,2,132,1,66,0.0,66.0,66.0,1,66,0.0,66.0,66.0
512788.0,6,5,336,2,134,0.0,68.0,67.0,3,202,190157.0,70.0,67.33333333333333
153459.0,17,2,180,1,90,0.0,90.0,90.0,1,90,0.0,90.0,90.0
9300.0,17,2,571,1,86,0.0,86.0,86.0,1,485,0.0,485.0,485.0
2095.0,17,4,344,2,150,0.0,75.0,75.0,2,194,0.0,103.0,97.0
283044.0,17,2,363,1,79,0.0,79.0,79.0,1,284,0.0,284.0,284.0
292.0,17,2,164,1,82,0.0,82.0,82.0,1,82,0.0,82.0,82.0
92041059.0,17,12,778,6,389,18400158.4,174.0,64.83333333333333,6,389,18403666.0,174.0,64.83333333333333
104312974.0,17,14,864,7,432,17335127.666666668,174.0,61.71428571428572,7,432,17333542.5,174.0,61.71428571428572
309706.0,6,6,412,4,272,103235.33333333331,74.0,68.0,2,140,0.0,74.0,70.0
122198.0,6,3,373,2,238,0.0,172.0,119.0,1,135,0.0,135.0,135.0
90263731.0,6,12,1832,8,1016,12894818.714285716,188.0,127.0,4,816,30031113.33333333,204.0,204.0
26300822.0,6,11,738,5,342,6573403.5,95.0,68.4,6,396,5257932.8,95.0,66.0
355.0,17,2,762,2,762,0.0,381.0,381.0,0,0,0.0,0.0,0.0
7525.0,17,2,582,1,83,0.0,83.0,83.0,1,499,0.0,499.0,499.0
110008726.0,17,13,821,7,432,18334787.666666668,174.0,61.71428571428572,6,389,18000161.4,174.0,64.83333333333333
43219.0,6,14,4740,7,653,6970.0,249.0,93.28571428571428,7,4087,6426.166666666667,1514.0,583.8571428571429
311133.0,6,6,412,4,272,103711.0,74.0,68.0,2,140,0.0,74.0,70.0
300759.0,6,6,412,4,272,100253.0,74.0,68.0,2,140,0.0,74.0,70.0
197581.0,17,2,180,1,90,0.0,90.0,90.0,1,90,0.0,90.0,90.0
105145007.0,17,14,1126,7,563,17471383.0,174.0,80.42857142857143,7,563,17497483.166666668,174.0,80.42857142857143
36980897.0,6,5,336,2,134,0.0,68.0,67.0,3,202,18422247.5,70.0,67.33333333333333
506939.0,6,5,336,2,134,0.0,68.0,67.0,3,202,195238.0,70.0,67.33333333333333
90301961.0,6,16,1192,8,596,12892956.142857144,95.0,74.5,8,596,12899704.714285716,95.0,74.5
302835.0,6,6,412,4,272,100945.0,74.0,68.0,2,140,0.0,74.0,70.0
3008239.0,6,11,725,6,394,601504.6,100.0,65.66666666666667,5,331,1277.25,103.0,66.2
889308.0,6,10,1336,6,799,177861.6,461.0,133.16666666666666,4,537,204473.66666666663,331.0,134.25
37458.0,6,14,4740,7,653,6118.5,249.0,93.28571428571428,7,4087,6081.5,1514.0,583.8571428571429
18988.0,6,14,4740,7,653,3024.0,249.0,93.28571428571428,7,4087,3026.1666666666665,1514.0,583.8571428571429
299116.0,6,6,412,4,272,99705.33333333331,74.0,68.0,2,140,0.0,74.0,70.0
108505.0,17,2,286,2,286,0.0,143.0,143.0,0,0,0.0,0.0,0.0
477588.0,17,2,363,1,79,0.0,79.0,79.0,1,284,0.0,284.0,284.0
56225.0,6,10,2032,5,524,13762.75,252.0,104.8,5,1508,13486.75,1236.0,301.6
16653.0,6,10,2032,5,524,3934.5,252.0,104.8,5,1508,3609.5,1236.0,301.6
135132950.0,17,6,1146,6,1146,27026590.0,191.0,191.0,0,0,0.0,0.0,0.0
0.0,6,1,66,1,66,0.0,66.0,66.0,0,0,0.0,0.0,0.0
146039.0,6,3,337,2,214,0.0,160.0,107.0,1,123,0.0,123.0,123.0
31139.0,6,14,4740,7,653,3144.333333333333,249.0,93.28571428571428,7,4087,5050.0,1514.0,583.8571428571429
108121729.0,17,5,955,5,955,27030432.25,191.0,191.0,0,0,0.0,0.0,0.0
41488.0,6,14,4740,7,653,6083.666666666667,249.0,93.28571428571428,7,4087,6661.666666666667,1514.0,583.8571428571429
27356968.0,17,5,1710,5,1710,6839242.0,342.0,342.0,0,0,0.0,0.0,0.0
15880135.0,6,5,1736,2,819,0.0,753.0,409.5,3,917,7875412.5,785.0,305.6666666666667
120055036.0,17,29,13785,29,13785,4287679.857142857,501.0,475.3448275862069,0,0,0.0,0.0,0.0
120159213.0,6,266,30694,133,9074,904062.5227272728,140.0,68.22556390977444,133,21620,901371.4772727272,284.0,162.5563909774436
39430.0,6,2,145,2,145,0.0,91.0,72.5,0,0,0.0,0.0,0.0
153392.0,17,2,180,1,90,0.0,90.0,90.0,1,90,0.0,90.0,90.0
319486.0,6,6,412,4,272,106495.33333333331,74.0,68.0,2,140,0.0,74.0,70.0
289006.0,17,4,1400,4,1400,96335.33333333331,350.0,350.0,0,0,0.0,0.0,0.0
2780340.0,6,2,132,1,66,0.0,66.0,66.0,1,66,0.0,66.0,66.0
120375540.0,6,229,25944,115,18198,1055925.7894736845,284.0,158.24347826086955,114,7746,1056244.0088495575,140.0,67.94736842105263
106713.0,17,2,286,2,286,0.0,143.0,143.0,0,0,0.0,0.0,0.0
181442.0,17,4,1524,4,1524,60480.66666666666,381.0,381.0,0,0,0.0,0.0,0.0
153525.0,17,2,180,1,90,0.0,90.0,90.0,1,90,0.0,90.0,90.0
3573519.0,6,5,336,2,134,0.0,68.0,67.0,3,202,1424202.0,70.0,67.33333333333333
325.0,17,2,166,1,75,0.0,75.0,75.0,1,91,0.0,91.0,91.0
309.0,17,2,174,1,79,0.0,79.0,79.0,1,95,0.0,95.0,95.0
10510668.0,6,7,478,4,272,3457741.6666666665,74.0,68.0,3,206,5186498.0,74.0,68.66666666666667
107847.0,17,2,286,2,286,0.0,143.0,143.0,0,0,0.0,0.0,0.0
108102885.0,17,5,955,5,955,27025721.25,191.0,191.0,0,0,0.0,0.0,0.0
153402.0,17,2,180,1,90,0.0,90.0,90.0,1,90,0.0,90.0,90.0
34678.0,6,14,4740,7,653,5649.833333333333,249.0,93.28571428571428,7,4087,5636.833333333333,1514.0,583.8571428571429
90258488.0,6,14,2240,8,1016,12894069.714285716,188.0,127.0,6,1224,18019264.8,204.0,204.0
228210.0,17,2,180,1,90,0.0,90.0,90.0,1,90,0.0,90.0,90.0
26492.0,6,14,4740,7,653,3918.3333333333335,249.0,93.28571428571428,7,4087,4280.166666666667,1514.0,583.8571428571429
34333.0,6,10,2032,5,524,8366.75,252.0,104.8,5,1508,7375.25,1236.0,301.6
153571.0,17,2,180,1,90,0.0,90.0,90.0,1,90,0.0,90.0,90.0
15333.0,6,14,4740,7,653,2438.0,249.0,93.28571428571428,7,4087,2415.5,1514.0,583.8571428571429
303663.0,6,2,132,1,66,0.0,66.0,66.0,1,66,0.0,66.0,66.0
305627.0,6,6,412,4,272,101875.66666666669,74.0,68.0,2,140,0.0,74.0,70.0
0.0,17,1,55,1,55,0.0,55.0,55.0,0,0,0.0,0.0,0.0
227728.0,6,3,426,2,280,0.0,214.0,140.0,1,146,0.0,146.0,146.0
162438.0,17,4,6056,4,6056,54146.0,1514.0,1514.0,0,0,0.0,0.0,0.0
90747163.0,6,22,1680,12,935,8245132.545454546,95.0,77.91666666666667,10,745,10052219.333333334,95.0,74.5
209411.0,6,10,1221,6,636,41882.2,298.0,106.0,4,585,68965.33333333333,379.0,146.25
27542911.0,17,5,1710,5,1710,6885727.75,342.0,342.0,0,0,0.0,0.0,0.0
100729145.0,6,33,2422,17,1194,6295543.4375,123.0,70.23529411764706,16,1228,6049662.666666667,139.0,76.75
313.0,17,2,174,1,79,0.0,79.0,79.0,1,95,0.0,95.0,95.0
153414.0,17,2,180,1,90,0.0,90.0,90.0,1,90,0.0,90.0,90.0
214394.0,17,2,180,1,90,0.0,90.0,90.0,1,90,0.0,90.0,90.0
216386.0,6,10,1221,6,636,43277.2,298.0,106.0,4,585,70552.0,379.0,146.25
90260104.0,6,14,2240,8,1016,12894300.57142857,188.0,127.0,6,1224,18018932.6,204.0,204.0
17169.0,6,11,1131,6,600,3192.8,262.0,100.0,5,531,2647.75,259.0,106.2
144001.0,17,2,180,1,90,0.0,90.0,90.0,1,90,0.0,90.0,90.0
74975.0,6,14,4740,7,653,12051.833333333334,249.0,93.28571428571428,7,4087,11878.666666666666,1514.0,583.8571428571429
153473.0,17,2,180,1,90,0.0,90.0,90.0,1,90,0.0,90.0,90.0
90058080.0,17,28,13364,28,13364,3335484.4444444445,501.0,477.2857142857143,0,0,0.0,0.0,0.0
58780.0,6,14,4740,7,653,9620.833333333334,249.0,93.28571428571428,7,4087,9564.666666666666,1514.0,583.8571428571429
42706.0,6,10,2032,5,524,10442.0,252.0,104.8,5,1508,10411.0,1236.0,301.6
111001192.0,17,15,1169,8,606,15857313.142857144,174.0,75.75,7,563,15168209.166666666,174.0,80.42857142857143
34526.0,6,14,4740,7,653,4988.666666666667,249.0,93.28571428571428,7,4087,5345.333333333333,1514.0,583.8571428571429
135132550.0,17,6,1146,6,1146,27026510.0,191.0,191.0,0,0,0.0,0.0,0.0
39631.0,6,14,4740,7,653,5887.666666666667,249.0,93.28571428571428,7,4087,6331.166666666667,1514.0,583.8571428571429
240306.0,6,3,337,2,214,0.0,160.0,107.0,1,123,0.0,123.0,123.0
4185.0,17,2,598,1,72,0.0,72.0,72.0,1,526,0.0,526.0,526.0
10430337.0,6,7,478,4,272,3431134.333333333,74.0,68.0,3,206,5146598.0,74.0,68.66666666666667
303097.0,6,2,132,1,66,0.0,66.0,66.0,1,66,0.0,66.0,66.0
19625.0,6,10,2032,5,524,4638.5,252.0,104.8,5,1508,4665.25,1236.0,301.6
309130.0,6,6,412,4,272,103043.33333333331,74.0,68.0,2,140,0.0,74.0,70.0
18661834.0,6,26,7675,14,3783,191289.53846153847,1514.0,270.2142857142857,12,3892,1677907.181818182,1514.0,324.3333333333333
228205.0,17,2,180,1,90,0.0,90.0,90.0,1,90,0.0,90.0,90.0
25034508.0,17,5,1718,4,1368,1117021.6666666667,342.0,342.0,1,350,0.0,350.0,350.0
36590.0,6,14,4740,7,653,4493.0,249.0,93.28571428571428,7,4087,5768.5,1514.0,583.8571428571429
165820.0,17,2,180,1,90,0.0,90.0,90.0,1,90,0.0,90.0,90.0
1168154.0,6,13,3000,8,2372,166879.14285714287,1514.0,296.5,5,628,223072.0,331.0,125.6
5626269.0,6,5,336,2,134,0.0,68.0,67.0,3,202,1421234.5,70.0,67.33333333333333
916.0,17,2,762,2,762,0.0,381.0,381.0,0,0,0.0,0.0,0.0
196865.0,17,2,180,1,90,0.0,90.0,90.0,1,90,0.0,90.0,90.0
75152336.0,6,9,842,9,842,9394042.0,97.0,93.55555555555556,0,0,0.0,0.0,0.0
108343035.0,6,34,2350,17,1225,6757988.5625,139.0,72.05882352941177,17,1125,6757986.25,123.0,66.17647058823529
294045.0,17,2,246,1,76,0.0,76.0,76.0,1,170,0.0,170.0,170.0
107623552.0,6,28,1860,14,966,8262998.923076923,123.0,69.0,14,894,8263014.923076923,123.0,63.85714285714285
165948.0,17,2,180,1,90,0.0,90.0,90.0,1,90,0.0,90.0,90.0
108107103.0,17,5,1005,5,1005,27026775.75,201.0,201.0,0,0,0.0,0.0,0.0
21063.0,6,14,4740,7,653,3029.0,249.0,93.28571428571428,7,4087,3372.5,1514.0,583.8571428571429
90229104.0,6,16,1192,8,596,12854412.57142857,95.0,74.5,8,596,12859003.142857144,95.0,74.5
310.0,17,2,174,1,79,0.0,79.0,79.0,1,95,0.0,95.0,95.0
21693.0,6,14,4740,7,653,3205.333333333333,249.0,93.28571428571428,7,4087,3433.6666666666665,1514.0,583.8571428571429
77273238.0,17,14,4788,14,4788,5944095.230769231,342.0,342.0,0,0,0.0,0.0,0.0
1089.0,17,4,438,2,148,0.0,74.0,74.0,2,290,0.0,147.0,145.0
217828.0,6,3,426,2,280,0.0,214.0,140.0,1,146,0.0,146.0,146.0
90260938.0,6,12,1832,8,1016,12894419.714285716,188.0,127.0,4,816,30032370.0,204.0,204.0
507189.0,6,5,336,2,134,0.0,68.0,67.0,3,202,192923.5,70.0,67.33333333333333
1145.0,17,4,438,2,148,0.0,74.0,74.0,2,290,0.0,147.0,145.0
203875.0,17,8,12112,8,12112,29125.0,1514.0,1514.0,0,0,0.0,0.0,0.0
5628989.0,6,5,336,2,134,0.0,68.0,67.0,3,202,1417253.0,70.0,67.33333333333333
8820.0,17,2,498,1,80,0.0,80.0,80.0,1,418,0.0,418.0,418.0
508851.00000000006,6,5,336,2,134,0.0,68.0,67.0,3,202,192486.0,70.0,67.33333333333333
90285909.0,6,16,1192,8,596,12891573.42857143,95.0,74.5,8,596,12897817.42857143,95.0,74.5
206052.0,6,3,426,2,280,0.0,214.0,140.0,1,146,0.0,146.0,146.0
33374.0,6,14,4740,7,653,4971.5,249.0,93.28571428571428,7,4087,5079.833333333333,1514.0,583.8571428571429
123804694.0,6,31,2166,15,1017,8129984.928571428,123.0,67.8,16,1149,7587992.733333333,123.0,71.8125
120308593.0,6,275,31214,138,21876,878164.9124087591,374.0,158.52173913043478,137,9338,877010.6985294118,140.0,68.16058394160584
120023945.0,17,29,13785,29,13785,4286569.464285715,501.0,475.3448275862069,0,0,0.0,0.0,0.0
284637.0,17,2,180,1,90,0.0,90.0,90.0,1,90,0.0,90.0,90.0
138797.0,6,2,132,1,66,0.0,66.0,66.0,1,66,0.0,66.0,66.0
90743313.0,6,27,3073,14,1463,6977139.153846154,426.0,104.5,13,1610,7561125.333333333,358.0,123.84615384615384
24223.0,6,10,2032,5,524,5821.75,252.0,104.8,5,1508,5610.0,1236.0,301.6
13519.0,6,11,1133,6,602,2179.6,264.0,100.33333333333331,5,531,2898.75,259.0,106.2
76788.0,6,11,2098,6,590,15083.6,252.0,98.33333333333331,5,1508,17688.25,1236.0,301.6
1873639.0,6,2,132,1,66,0.0,66.0,66.0,1,66,0.0,66.0,66.0
899202.0,6,12,2709,7,742,149867.0,338.0,106.0,5,1967,155884.75,1514.0,393.4
389369.0,6,3,204,2,136,0.0,70.0,68.0,1,68,0.0,68.0,68.0
38994.0,6,14,4740,7,653,6375.0,249.0,93.28571428571428,7,4087,6359.5,1514.0,583.8571428571429
123052.0,6,3,337,2,214,0.0,160.0,107.0,1,123,0.0,123.0,123.0
441618.0,6,11,1021,6,444,59469.4,162.0,74.0,5,577,74205.25,349.0,115.4
246217.0,6,3,373,2,238,0.0,172.0,119.0,1,135,0.0,135.0,135.0
451821.0,6,10,1221,6,636,90364.2,298.0,106.0,4,585,145255.66666666666,379.0,146.25
108086096.0,17,5,1005,5,1005,27021524.0,201.0,201.0,0,0,0.0,0.0,0.0
73697.0,6,13,1394,7,797,11985.333333333334,253.0,113.85714285714286,6,597,14107.8,259.0,99.5
108109643.0,17,5,1005,5,1005,27027410.75,201.0,201.0,0,0,0.0,0.0,0.0
4980.0,17,4,344,2,150,0.0,75.0,75.0,2,194,0.0,103.0,97.0
70312482.0,6,21,1524,11,789,7031248.2,95.0,71.72727272727273,10,735,7789133.0,95.0,73.5
0.0,6,1,54,1,54,0.0,54.0,54.0,0,0,0.0,0.0,0.0
17795.0,6,11,2098,6,590,3237.2,252.0,98.33333333333331,5,1508,4066.75,1236.0,301.6
90286611.0,6,15,1097,8,596,12898087.285714284,95.0,74.5,7,501,14996468.0,95.0,71.57142857142857
2031.0,17,4,344,2,150,0.0,75.0,75.0,2,194,0.0,103.0,97.0
212161.0,6,10,1221,6,636,42432.2,298.0,106.0,4,585,69482.0,379.0,146.25
106912.0,17,2,286,2,286,0.0,143.0,143.0,0,0,0.0,0.0,0.0
108849187.0,6,30,2122,15,1017,7774941.928571428,123.0,67.8,15,1105,7046374.428571428,139.0,73.66666666666667
41478.0,6,14,4740,7,653,6669.333333333333,249.0,93.28571428571428,7,4087,6427.833333333333,1514.0,583.8571428571429
135132552.0,17,6,1146,6,1146,27026510.4,191.0,191.0,0,0,0.0,0.0,0.0
48252.0,6,14,4740,7,653,6836.5,249.0,93.28571428571428,7,4087,6036.0,1514.0,583.8571428571429
120000064.0,6,17,1287,9,691,15000008.0,95.0,76.77777777777777,8,596,12900602.0,95.0,74.5
147.0,17,2,158,2,158,0.0,79.0,79.0,0,0,0.0,0.0,0.0
107178.0,17,2,286,2,286,0.0,143.0,143.0,0,0,0.0,0.0,0.0
106374185.0,6,32,2236,16,1165,7091612.333333333,139.0,72.8125,16,1071,7077171.066666666,123.0,66.9375
44015888.0,6,7,1872,5,1052,11003972.0,784.0,210.4,2,820,0.0,752.0,410.0
120430140.0,6,231,26236,116,18338,1047218.6086956522,284.0,158.08620689655172,115,7898,1047285.6403508772,140.0,68.67826086956522
748617.0,6,2,132,1,66,0.0,66.0,66.0,1,66,0.0,66.0,66.0
241176.0,6,10,1221,6,636,48235.2,298.0,106.0,4,585,79370.66666666667,379.0,146.25
17292.0,6,10,2032,5,524,3078.75,252.0,104.8,5,1508,4098.25,1236.0,301.6
848.0,17,2,684,2,684,0.0,342.0,342.0,0,0,0.0,0.0,0.0
0.0,17,1,90,1,90,0.0,90.0,90.0,0,0,0.0,0.0,0.0
39518.0,6,14,4740,7,653,6194.333333333333,249.0,93.28571428571428,7,4087,6076.0,1514.0,583.8571428571429
91722023.0,6,28,2368,15,1056,6545879.571428572,95.0,70.4,13,1312,7642579.833333333,189.0,100.92307692307692
33782.0,6,14,4740,7,653,5279.0,249.0,93.28571428571428,7,4087,4914.333333333333,1514.0,583.8571428571429
219079.0,6,10,1221,6,636,43815.8,298.0,106.0,4,585,71798.0,379.0,146.25
113168163.0,6,47,3102,24,1584,4920344.217391305,66.0,66.0,23,1518,5143995.590909091,66.0,66.0
100568274.0,17,12,778,6,389,20113654.8,174.0,64.83333333333333,6,389,19918648.6,174.0,64.83333333333333
112382828.0,17,16,1212,8,606,15857542.0,174.0,75.75,8,606,15857277.857142856,174.0,75.75
90034514.0,17,28,13364,28,13364,3334611.6296296297,501.0,477.2857142857143,0,0,0.0,0.0,0.0
305559.0,6,10,1221,6,636,61111.8,298.0,106.0,4,585,96456.33333333331,379.0,146.25
0.0,6,1,172,1,172,0.0,172.0,172.0,0,0,0.0,0.0,0.0
108114912.0,17,5,1005,5,1005,27028728.0,201.0,201.0,0,0,0.0,0.0,0.0
45911.0,6,10,2032,5,524,10421.25,252.0,104.8,5,1508,10288.25,1236.0,301.6
307483.0,6,6,412,4,272,102494.33333333331,74.0,68.0,2,140,0.0,74.0,70.0
299055.0,6,6,412,4,272,99685.0,74.0,68.0,2,140,0.0,74.0,70.0
100538.0,17,2,762,2,762,0.0,381.0,381.0,0,0,0.0,0.0,0.0
138015.0,6,3,337,2,214,0.0,160.0,107.0,1,123,0.0,123.0,123.0
2491126.0,6,2,132,1,66,0.0,66.0,66.0,1,66,0.0,66.0,66.0
920.0,17,5,550,5,550,230.0,110.0,110.0,0,0,0.0,0.0,0.0
197076.0,17,2,180,1,90,0.0,90.0,90.0,1,90,0.0,90.0,90.0
118439.0,17,4,1400,4,1400,39479.66666666666,350.0,350.0,0,0,0.0,0.0,0.0
868638.0,6,9,1268,6,797,173727.6,459.0,132.83333333333334,3,471,296362.0,331.0,157.0
2594.0,17,2,762,2,762,0.0,381.0,381.0,0,0,0.0,0.0,0.0
10306.0,17,2,539,1,86,0.0,86.0,86.0,1,453,0.0,453.0,453.0
10476420.0,6,7,478,4,272,3444997.333333333,74.0,68.0,3,206,5167388.5,74.0,68.66666666666667
10463016.0,6,6,412,3,206,5163560.0,74.0,68.66666666666667,3,206,5163455.0,74.0,68.66666666666667
2600835.0,6,2,132,1,66,0.0,66.0,66.0,1,66,0.0,66.0,66.0
153389.0,17,2,180,1,90,0.0,90.0,90.0,1,90,0.0,90.0,90.0
320.0,17,2,174,1,79,0.0,79.0,79.0,1,95,0.0,95.0,95.0
218289.0,6,3,426,2,280,0.0,214.0,140.0,1,146,0.0,146.0,146.0
102859.0,17,2,700,2,700,0.0,350.0,350.0,0,0,0.0,0.0,0.0
5628202.0,6,5,336,2,134,0.0,68.0,67.0,3,202,1423730.0,70.0,67.33333333333333
57002.0,6,14,4740,7,653,9075.0,249.0,93.28571428571428,7,4087,8634.333333333334,1514.0,583.8571428571429
115458545.0,17,14,864,7,432,19167569.666666668,174.0,61.71428571428572,7,432,19166824.5,174.0,61.71428571428572
90004012.0,6,17,1404,9,849,11250501.5,253.0,94.33333333333331,8,555,12817101.42857143,95.0,69.375
102165.0,6,14,4740,7,653,16600.833333333332,249.0,93.28571428571428,7,4087,15969.0,1514.0,583.8571428571429
238479.0,6,3,373,2,238,0.0,172.0,119.0,1,135,0.0,135.0,135.0
68211.0,6,10,2032,5,524,16842.0,252.0,104.8,5,1508,4271.25,1236.0,301.6
2310.0,17,4,344,2,150,0.0,75.0,75.0,2,194,0.0,103.0,97.0
90535329.0,6,14,2240,8,1016,12933618.42857143,188.0,127.0,6,1224,18074263.6,204.0,204.0
33687.0,6,14,4740,7,653,5486.666666666667,249.0,93.28571428571428,7,4087,5322.5,1514.0,583.8571428571429
94861768.0,6,1948,1675992,1341,1635930,70788.68059701493,1514.0,1219.9328859060402,607,40062,156517.24092409242,66.0,66.0
90299377.0,6,16,1192,8,596,12892930.142857144,95.0,74.5,8,596,12898955.285714284,95.0,74.5
309599.0,6,6,412,4,272,103199.66666666669,74.0,68.0,2,140,0.0,74.0,70.0
2146345.0,6,25,7609,13,2516,178862.08333333334,1034.0,193.53846153846155,12,5093,166854.36363636365,1510.0,424.4166666666667
2466.0,17,4,344,2,150,0.0,75.0,75.0,2,194,0.0,103.0,97.0
27353.0,6,11,2098,6,590,4509.0,252.0,98.33333333333331,5,1508,6031.0,1236.0,301.6
16592.0,6,11,1132,6,556,3162.8,218.0,92.66666666666669,5,576,3829.5,304.0,115.2
279477.0,6,4,492,2,280,0.0,214.0,140.0,2,212,0.0,146.0,106.0
105278.0,17,2,762,2,762,0.0,381.0,381.0,0,0,0.0,0.0,0.0
3133.0,17,2,224,1,76,0.0,76.0,76.0,1,148,0.0,148.0,148.0
318726.0,17,4,1400,4,1400,106242.0,350.0,350.0,0,0,0.0,0.0,0.0
233990.0,6,3,337,2,214,0.0,160.0,107.0,1,123,0.0,123.0,123.0
319936.0,17,4,1400,4,1400,106645.33333333331,350.0,350.0,0,0,0.0,0.0,0.0
2633311.0,6,51,23848,26,19851,105332.44,1514.0,763.5,25,3997,100417.83333333331,1514.0,159.88
27305423.0,17,5,1710,5,1710,6826355.75,342.0,342.0,0,0,0.0,0.0,0.0
74260.0,6,14,4740,7,653,12170.0,249.0,93.28571428571428,7,4087,5009.666666666667,1514.0,583.8571428571429
90101544.0,6,12,1572,7,828,15016924.0,188.0,118.28571428571428,5,744,15007959.75,204.0,148.8
108107705.0,17,5,1005,5,1005,27026926.25,201.0,201.0,0,0,0.0,0.0,0.0
803.0,17,4,438,2,148,0.0,74.0,74.0,2,290,0.0,147.0,145.0
117755860.0,6,48,3168,24,1584,5119820.0,66.0,66.0,24,1584,5105594.826086956,66.0,66.0
101231873.0,17,14,864,7,432,16833514.5,174.0,61.71428571428572,7,432,16834608.5,174.0,61.71428571428572
38743.0,6,14,4740,7,653,5999.333333333333,249.0,93.28571428571428,7,4087,5771.833333333333,1514.0,583.8571428571429
113479.0,6,10,2032,5,524,28133.75,252.0,104.8,5,1508,27625.0,1236.0,301.6
98531713.0,6,30,2106,15,1089,7037979.5,123.0,72.6,15,1017,7022531.928571428,123.0,67.8
90036274.0,17,27,12943,27,12943,3462933.6153846155,501.0,479.3703703703704,0,0,0.0,0.0,0.0
1336348.0,17,16,1120,16,1120,89089.86666666667,70.0,70.0,0,0,0.0,0.0,0.0
135133284.0,17,6,1146,6,1146,27026656.8,191.0,191.0,0,0,0.0,0.0,0.0
233101.0,6,3,337,2,214,0.0,160.0,107.0,1,123,0.0,123.0,123.0
170054.0,6,3,337,2,214,0.0,160.0,107.0,1,123,0.0,123.0,123.0
2507776.0,6,2,132,1,66,0.0,66.0,66.0,1,66,0.0,66.0,66.0
2453.0,17,4,344,2,150,0.0,75.0,75.0,2,194,0.0,103.0,97.0
135128509.0,17,6,1206,6,1206,27025701.8,201.0,201.0,0,0,0.0,0.0,0.0
135133533.0,17,6,1146,6,1146,27026706.6,191.0,191.0,0,0,0.0,0.0,0.0
310738.0,17,2,180,1,90,0.0,90.0,90.0,1,90,0.0,90.0,90.0
2038.0,17,4,344,2,150,0.0,75.0,75.0,2,194,0.0,103.0,97.0
34927.0,6,10,2032,5,524,6942.75,252.0,104.8,5,1508,7863.25,1236.0,301.6
5320.0,17,4,817,2,144,0.0,72.0,72.0,2,673,0.0,546.0,336.5
790361.0,6,5,1742,3,921,395180.5,785.0,307.0,2,821,0.0,753.0,410.5
303.0,17,2,164,1,82,0.0,82.0,82.0,1,82,0.0,82.0,82.0
90289030.0,6,15,1097,8,596,12898432.857142856,95.0,74.5,7,501,14997845.5,95.0,71.57142857142857
107023.0,17,2,286,2,286,0.0,143.0,143.0,0,0,0.0,0.0,0.0
120105393.0,17,29,13785,29,13785,4289478.321428572,501.0,475.3448275862069,0,0,0.0,0.0,0.0
73077.0,6,15,4806,8,719,10335.714285714286,249.0,89.875,7,4087,11994.0,1514.0,583.8571428571429
2595916.0,6,2,132,1,66,0.0,66.0,66.0,1,66,0.0,66.0,66.0
784.0,17,5,550,5,550,196.0,110.0,110.0,0,0,0.0,0.0,0.0
103000962.0,17,13,821,7,432,17166827.0,174.0,61.71428571428572,6,389,16600618.4,174.0,64.83333333333333
23106.0,6,10,2032,5,524,5152.0,252.0,104.8,5,1508,5542.25,1236.0,301.6
306372.0,6,6,412,4,272,102124.0,74.0,68.0,2,140,0.0,74.0,70.0
44792697.0,6,12,833,7,491,7465449.5,95.0,70.14285714285714,5,342,11132826.5,95.0,68.4
31564.0,6,10,2032,5,524,6185.75,252.0,104.8,5,1508,7277.25,1236.0,301.6
2373.0,17,4,344,2,150,0.0,75.0,75.0,2,194,0.0,103.0,97.0
10480654.0,6,7,478,4,272,3448119.0,74.0,68.0,3,206,5172053.5,74.0,68.66666666666667
315313.0,17,4,1400,4,1400,105104.33333333331,350.0,350.0,0,0,0.0,0.0,0.0
298480.0,6,3,202,2,128,0.0,74.0,64.0,1,74,0.0,74.0,74.0
159948.0,6,2,128,1,74,0.0,74.0,74.0,1,54,0.0,54.0,54.0
110982419.0,6,33,2428,17,1288,6922922.75,139.0,75.76470588235294,16,1140,7384449.533333333,123.0,71.25
321827.0,6,6,412,4,272,107275.66666666669,74.0,68.0,2,140,0.0,74.0,70.0
246639.0,6,3,337,2,214,0.0,160.0,107.0,1,123,0.0,123.0,123.0
120113200.0,6,14,2240,6,1224,24022640.0,204.0,204.0,8,1016,17135417.14285714,188.0,127.0
122242.0,6,3,373,2,238,0.0,172.0,119.0,1,135,0.0,135.0,135.0
3210206.0,6,15,2265,8,1145,458600.8571428572,579.0,143.125,7,1120,498598.1666666667,732.0,160.0
108108683.0,17,5,1005,5,1005,27027170.75,201.0,201.0,0,0,0.0,0.0,0.0
22224.0,6,14,4740,7,653,2762.333333333333,249.0,93.28571428571428,7,4087,3572.5,1514.0,583.8571428571429
103484.0,17,2,700,2,700,0.0,350.0,350.0,0,0,0.0,0.0,0.0
321.0,17,2,160,1,80,0.0,80.0,80.0,1,80,0.0,80.0,80.0
108102099.0,17,5,1005,5,1005,27025524.75,201.0,201.0,0,0,0.0,0.0,0.0
20244.0,6,10,1949,5,441,4787.5,169.0,88.2,5,1508,4793.5,1236.0,301.6
91369576.0,6,24,1829,13,989,7613646.666666667,95.0,76.07692307692308,11,840,9136681.7,95.0,76.36363636363636
217916.0,6,3,426,2,280,0.0,214.0,140.0,1,146,0.0,146.0,146.0
90419896.0,6,27,1948,14,963,6955376.615384615,123.0,68.78571428571429,13,985,6854885.5,139.0,75.76923076923077
811619.0,6,6,758,3,410,397418.5,172.0,136.66666666666666,3,348,285855.5,135.0,116.0
108481.0,17,2,286,2,286,0.0,143.0,143.0,0,0,0.0,0.0,0.0
4370.0,17,2,598,1,72,0.0,72.0,72.0,1,526,0.0,526.0,526.0
42006.0,6,10,2032,5,524,10167.25,252.0,104.8,5,1508,10265.75,1236.0,301.6
108104526.0,17,5,1005,5,1005,27026131.5,201.0,201.0,0,0,0.0,0.0,0.0
312428.0,6,3,202,2,128,0.0,74.0,64.0,1,74,0.0,74.0,74.0
115912968.0,6,48,3168,24,1584,5039694.260869565,66.0,66.0,24,1584,5026444.217391305,66.0,66.0
57323.0,6,13,1386,7,789,9248.333333333334,253.0,112.71428571428572,6,597,9549.8,259.0,99.5
19294.0,6,10,2032,5,524,4457.75,252.0,104.8,5,1508,3330.25,1236.0,301.6
231731.0,17,2,180,1,90,0.0,90.0,90.0,1,90,0.0,90.0,90.0
327.0,17,2,160,1,80,0.0,80.0,80.0,1,80,0.0,80.0,80.0
702.0,17,4,438,2,148,0.0,74.0,74.0,2,290,0.0,147.0,145.0
90261167.0,6,13,2036,8,1016,12894452.42857143,188.0,127.0,5,1020,22524255.5,204.0,204.0
23284.0,6,14,4740,7,653,2690.833333333333,249.0,93.28571428571428,7,4087,3614.6666666666665,1514.0,583.8571428571429
137740.0,6,2,132,1,66,0.0,66.0,66.0,1,66,0.0,66.0,66.0
54663.0,17,4,6056,4,6056,18221.0,1514.0,1514.0,0,0,0.0,0.0,0.0
862372.0,6,9,1096,6,625,172474.4,287.0,104.16666666666669,3,471,293313.5,331.0,157.0
121226.0,6,3,337,2,214,0.0,160.0,107.0,1,123,0.0,123.0,123.0
331822.0,6,7,478,4,272,110607.33333333331,74.0,68.0,3,206,89681.0,74.0,68.66666666666667
204567.0,17,2,762,2,762,0.0,381.0,381.0,0,0,0.0,0.0,0.0
112494867.0,6,252,29728,126,21190,898234.896,336.0,168.17460317460316,126,8538,898234.728,140.0,67.76190476190476
856088.0,6,9,1096,6,625,171217.6,287.0,104.16666666666669,3,471,291725.0,331.0,157.0
108102634.0,17,5,955,5,955,27025658.5,191.0,191.0,0,0,0.0,0.0,0.0
89241837.0,17,14,4788,14,4788,6864756.692307692,342.0,342.0,0,0,0.0,0.0,0.0
5624309.0,6,5,336,2,134,0.0,68.0,67.0,3,202,1424223.5,70.0,67.33333333333333
120422845.0,6,207,23470,104,16376,1169153.8349514564,284.0,157.46153846153845,103,7094,1170596.2647058824,140.0,68.87378640776699
148714.0,6,3,373,2,238,0.0,172.0,119.0,1,135,0.0,135.0,135.0
82.0,17,2,762,2,762,0.0,381.0,381.0,0,0,0.0,0.0,0.0
239993.0,17,2,359,1,75,0.0,75.0,75.0,1,284,0.0,284.0,284.0
120254586.0,6,239,27022,120,18872,1010542.7394957984,284.0,157.26666666666668,119,8150,1002643.2711864408,140.0,68.4873949579832
198296.0,17,2,180,1,90,0.0,90.0,90.0,1,90,0.0,90.0,90.0
119610262.0,6,224,25344,112,17730,1075631.855855856,284.0,158.30357142857142,112,7614,1075631.7027027027,140.0,67.98214285714286
90031373.0,17,27,12943,27,12943,3462745.1153846155,501.0,479.3703703703704,0,0,0.0,0.0,0.0
206555.0,6,3,426,2,280,0.0,214.0,140.0,1,146,0.0,146.0,146.0
108109067.0,17,5,1005,5,1005,27027266.75,201.0,201.0,0,0,0.0,0.0,0.0
135135645.0,17,6,1206,6,1206,27027129.0,201.0,201.0,0,0,0.0,0.0,0.0
67564.0,6,12,1328,7,797,11260.666666666666,253.0,113.85714285714286,5,531,15634.5,259.0,106.2
120243960.0,6,18,1341,9,691,14999065.75,95.0,76.77777777777777,9,650,14998746.5,95.0,72.22222222222223
317471.0,17,4,1400,4,1400,105823.66666666669,350.0,350.0,0,0,0.0,0.0,0.0
40087.0,6,14,4740,7,653,5880.666666666667,249.0,93.28571428571428,7,4087,5912.0,1514.0,583.8571428571429
9389.0,17,2,539,1,86,0.0,86.0,86.0,1,453,0.0,453.0,453.0
205502.0,6,3,426,2,280,0.0,214.0,140.0,1,146,0.0,146.0,146.0
107551181.0,17,14,864,7,432,17834156.666666668,174.0,61.71428571428572,7,432,17833491.5,174.0,61.71428571428572
39483.0,6,14,4740,7,653,6086.833333333333,249.0,93.28571428571428,7,4087,6290.5,1514.0,583.8571428571429
46462.0,6,14,4740,7,653,7421.666666666667,249.0,93.28571428571428,7,4087,7384.166666666667,1514.0,583.8571428571429
116615684.0,6,41,3286,22,1777,5553127.80952381,139.0,80.77272727272727,19,1509,6466623.777777778,123.0,79.42105263157895
197430.0,17,4,6056,4,6056,65810.0,1514.0,1514.0,0,0,0.0,0.0,0.0
3036953.0,6,3,1604,2,851,0.0,785.0,425.5,1,753,0.0,753.0,753.0
113996828.0,6,30,1974,15,1026,8127222.357142857,123.0,68.4,15,948,8127223.571428572,123.0,63.2
23849.0,6,10,2032,5,524,4882.0,252.0,104.8,5,1508,5078.0,1236.0,301.6
283.0,17,2,168,1,76,0.0,76.0,76.0,1,92,0.0,92.0,92.0
90399041.0,6,27,1869,14,963,6953736.692307692,123.0,68.78571428571429,13,906,7533093.083333333,123.0,69.6923076923077
120126275.0,6,14,2240,6,1224,24025255.0,204.0,204.0,8,1016,17136606.85714286,188.0,127.0
115572744.0,17,14,864,7,432,19167985.5,174.0,61.71428571428572,7,432,19166823.5,174.0,61.71428571428572
98557944.0,17,14,1126,7,563,16334353.666666666,174.0,80.42857142857143,7,563,16333462.0,174.0,80.42857142857143
216671.0,6,3,426,2,280,0.0,214.0,140.0,1,146,0.0,146.0,146.0
6712.0,17,2,614,1,72,0.0,72.0,72.0,1,542,0.0,542.0,542.0
135139416.0,17,6,1206,6,1206,27027883.2,201.0,201.0,0,0,0.0,0.0,0.0
135137645.0,17,6,1206,6,1206,27027529.0,201.0,201.0,0,0,0.0,0.0,0.0
108107224.0,17,5,1005,5,1005,27026806.0,201.0,201.0,0,0,0.0,0.0,0.0
305.0,17,2,168,1,76,0.0,76.0,76.0,1,92,0.0,92.0,92.0
2316.0,17,4,344,2,150,0.0,75.0,75.0,2,194,0.0,103.0,97.0
3177397.0,6,18,1495,9,921,358456.625,315.0,102.33333333333331,9,574,358426.125,78.0,63.77777777777778
155279.0,6,3,337,2,214,0.0,160.0,107.0,1,123,0.0,123.0,123.0
1302398.0,6,4,264,2,132,0.0,66.0,66.0,2,132,0.0,66.0,66.0
1302457.0,6,4,264,2,132,0.0,66.0,66.0,2,132,0.0,66.0,66.0
47611013.0,6,8,2113,3,960,22334876.0,826.0,320.0,5,1153,11259420.0,885.0,230.6
5431.0,17,2,231,1,78,0.0,78.0,78.0,1,153,0.0,153.0,153.0
101755591.0,17,14,864,7,432,16932777.5,174.0,61.71428571428572,7,432,16897683.666666668,174.0,61.71428571428572
90368758.0,6,28,2008,14,1045,6951442.923076923,139.0,74.64285714285714,14,963,6934804.846153846,123.0,68.78571428571429
2430745.0,6,3,1604,2,851,0.0,785.0,425.5,1,753,0.0,753.0,753.0
2360.0,17,4,344,2,150,0.0,75.0,75.0,2,194,0.0,103.0,97.0
44513.0,6,14,4740,7,653,7042.833333333333,249.0,93.28571428571428,7,4087,6456.0,1514.0,583.8571428571429
1179439.0,6,13,3006,8,2378,168491.2857142857,1514.0,297.25,5,628,225955.5,331.0,125.6
102592.0,17,2,286,2,286,0.0,143.0,143.0,0,0,0.0,0.0,0.0
108250.0,17,4,1400,4,1400,36083.333333333336,350.0,350.0,0,0,0.0,0.0,0.0
204127.0,17,2,762,2,762,0.0,381.0,381.0,0,0,0.0,0.0,0.0
103421058.0,6,42,2772,21,1386,5155446.45,66.0,66.0,21,1386,5155444.8,66.0,66.0
53769.0,6,13,1386,7,789,8961.5,253.0,112.71428571428572,6,597,9999.2,259.0,99.5
105610.0,17,2,700,2,700,0.0,350.0,350.0,0,0,0.0,0.0,0.0
881487.0,6,10,1333,6,796,176297.4,458.0,132.66666666666666,4,537,201929.3333333333,331.0,134.25
196981.0,17,2,180,1,90,0.0,90.0,90.0,1,90,0.0,90.0,90.0
162244.0,17,2,180,1,90,0.0,90.0,90.0,1,90,0.0,90.0,90.0
1866.0,17,2,192,1,88,0.0,88.0,88.0,1,104,0.0,104.0,104.0
120413952.0,6,307,34946,154,24626,787019.2941176471,464.0,159.9090909090909,153,10320,785371.3289473684,140.0,67.45098039215686
232293.0,6,3,337,2,214,0.0,160.0,107.0,1,123,0.0,123.0,123.0
26866201.0,17,5,1710,5,1710,6716550.25,342.0,342.0,0,0,0.0,0.0,0.0
90066296.0,17,28,13364,28,13364,3335788.7407407407,501.0,477.2857142857143,0,0,0.0,0.0,0.0
112464252.0,6,46,3036,23,1518,5111999.409090909,66.0,66.0,23,1518,5111999.909090909,66.0,66.0
2792643.0,6,2,132,1,66,0.0,66.0,66.0,1,66,0.0,66.0,66.0
1307026.0,6,4,264,2,132,0.0,66.0,66.0,2,132,0.0,66.0,66.0
102140236.0,17,14,864,7,432,17003328.5,174.0,61.71428571428572,7,432,17000193.666666668,174.0,61.71428571428572
107433.0,17,2,286,2,286,0.0,143.0,143.0,0,0,0.0,0.0,0.0
45037361.0,6,7,1872,5,1052,11259340.25,784.0,210.4,2,820,0.0,752.0,410.0
364361.0,6,11,1021,6,444,49008.6,162.0,74.0,5,577,61177.5,349.0,115.4
122688006.0,6,49,3234,25,1650,5112000.25,66.0,66.0,24,1584,5139090.0869565215,66.0,66.0
100048.0,17,2,762,2,762,0.0,381.0,381.0,0,0,0.0,0.0,0.0
135128598.0,17,6,1146,6,1146,27025719.6,191.0,191.0,0,0,0.0,0.0,0.0
217921.0,17,2,180,1,90,0.0,90.0,90.0,1,90,0.0,90.0,90.0
2593072.0,6,2,132,1,66,0.0,66.0,66.0,1,66,0.0,66.0,66.0
27642322.0,17,5,1710,5,1710,6910580.5,342.0,342.0,0,0,0.0,0.0,0.0
35735.0,6,14,4740,7,653,5815.333333333333,249.0,93.28571428571428,7,4087,4402.333333333333,1514.0,583.8571428571429
351.0,17,2,174,1,79,0.0,79.0,79.0,1,95,0.0,95.0,95.0
99339725.0,17,12,778,6,389,19800164.6,174.0,64.83333333333333,6,389,19801549.0,174.0,64.83333333333333
1072012.0,6,10,1065,5,534,267657.5,262.0,106.8,5,531,2679.5,259.0,106.2
217724.0,6,3,426,2,280,0.0,214.0,140.0,1,146,0.0,146.0,146.0
105214.0,17,2,700,2,700,0.0,350.0,350.0,0,0,0.0,0.0,0.0
105971699.0,6,192,21792,96,6558,1106829.9894736842,140.0,68.3125,96,15234,1114825.8,284.0,158.6875
1276.0,17,4,438,2,148,0.0,74.0,74.0,2,290,0.0,147.0,145.0
90307636.0,6,16,1192,8,596,12893796.57142857,95.0,74.5,8,596,12900484.57142857,95.0,74.5
116797501.0,6,48,3168,24,1584,5078152.217391305,66.0,66.0,24,1584,5064691.695652174,66.0,66.0
115319851.0,6,48,3168,24,1584,5013906.565217392,66.0,66.0,24,1584,5000177.347826087,66.0,66.0
12212.0,6,11,1133,6,602,2176.8,264.0,100.33333333333331,5,531,2775.5,259.0,106.2
1301409.0,6,4,264,2,132,0.0,66.0,66.0,2,132,0.0,66.0,66.0
120036203.0,6,225,25462,113,17848,1071751.8125,284.0,157.94690265486724,112,7614,1076696.954954955,140.0,67.98214285714286
357.0,17,2,160,1,80,0.0,80.0,80.0,1,80,0.0,80.0,80.0
146571.0,6,3,337,2,214,0.0,160.0,107.0,1,123,0.0,123.0,123.0
303140.0,6,2,132,1,66,0.0,66.0,66.0,1,66,0.0,66.0,66.0
135154437.0,17,6,1206,6,1206,27030887.4,201.0,201.0,0,0,0.0,0.0,0.0
100740880.0,6,29,2052,15,1089,7180369.214285715,123.0,72.6,14,963,7732706.769230769,123.0,68.78571428571429
135123391.0,17,6,1206,6,1206,27024678.2,201.0,201.0,0,0,0.0,0.0,0.0
99086477.0,6,198,22314,99,15558,1008890.9897959183,284.0,157.15151515151516,99,6756,1008890.7959183672,140.0,68.24242424242425
308438.0,6,6,412,4,272,102812.66666666669,74.0,68.0,2,140,0.0,74.0,70.0
149287.0,17,2,414,1,88,0.0,88.0,88.0,1,326,0.0,326.0,326.0
1341267.0,17,6,1230,3,234,670447.5,78.0,78.0,3,996,670415.0,332.0,332.0
108101935.0,17,5,1005,5,1005,27025483.75,201.0,201.0,0,0,0.0,0.0,0.0
215260.0,17,2,180,1,90,0.0,90.0,90.0,1,90,0.0,90.0,90.0
47151.0,6,14,4740,7,653,6784.166666666667,249.0,93.28571428571428,7,4087,7347.333333333333,1514.0,583.8571428571429
25118.0,6,14,4740,7,653,4063.6666666666665,249.0,93.28571428571428,7,4087,3802.3333333333335,1514.0,583.8571428571429
90289453.0,6,16,1192,8,596,12891742.285714284,95.0,74.5,8,596,12897766.857142856,95.0,74.5
125201.0,6,3,337,2,214,0.0,160.0,107.0,1,123,0.0,123.0,123.0
1191753.0,6,13,3000,8,2372,170250.42857142858,1514.0,296.5,5,628,228899.75,331.0,125.6
147915.0,17,2,180,1,90,0.0,90.0,90.0,1,90,0.0,90.0,90.0
233120.0,6,3,337,2,214,0.0,160.0,107.0,1,123,0.0,123.0,123.0
204664.0,17,2,762,2,762,0.0,381.0,381.0,0,0,0.0,0.0,0.0
105437.0,17,2,700,2,700,0.0,350.0,350.0,0,0,0.0,0.0,0.0
2840433.0,6,3,1777,2,951,0.0,885.0,475.5,1,826,0.0,826.0,826.0
250333.00000000003,6,3,337,2,214,0.0,160.0,107.0,1,123,0.0,123.0,123.0
303377.0,17,2,231,1,78,0.0,78.0,78.0,1,153,0.0,153.0,153.0
320830.0,17,4,1400,4,1400,106943.33333333331,350.0,350.0,0,0,0.0,0.0,0.0
232325.0,6,3,337,2,214,0.0,160.0,107.0,1,123,0.0,123.0,123.0
107333.0,17,2,286,2,286,0.0,143.0,143.0,0,0,0.0,0.0,0.0
366340.0,17,2,363,1,75,0.0,75.0,75.0,1,288,0.0,288.0,288.0
35842.0,6,14,4740,7,653,5847.166666666667,249.0,93.28571428571428,7,4087,5827.333333333333,1514.0,583.8571428571429
108000939.0,17,13,821,7,432,18000156.5,174.0,61.71428571428572,6,389,17602589.4,174.0,64.83333333333333
120205679.0,6,228,25846,114,7820,1056508.6548672563,140.0,68.59649122807018,114,18026,1056494.2300884956,284.0,158.12280701754386
99007147.0,17,11,735,6,389,19801429.4,174.0,64.83333333333333,5,346,19750198.25,174.0,69.2
107752.0,17,2,286,2,286,0.0,143.0,143.0,0,0,0.0,0.0,0.0
13484.0,6,11,2098,6,590,2309.0,252.0,98.33333333333331,5,1508,3121.0,1236.0,301.6
208581.0,6,10,1221,6,636,41716.2,298.0,106.0,4,585,68411.66666666667,379.0,146.25
4261.0,17,2,614,1,72,0.0,72.0,72.0,1,542,0.0,542.0,542.0
148051.0,17,2,180,1,90,0.0,90.0,90.0,1,90,0.0,90.0,90.0
875755.0,6,10,1262,6,725,175151.0,387.0,120.83333333333331,4,537,200081.0,331.0,134.25
2791849.0,6,2,132,1,66,0.0,66.0,66.0,1,66,0.0,66.0,66.0
299.0,17,2,164,1,82,0.0,82.0,82.0,1,82,0.0,82.0,82.0
105948430.0,17,14,864,7,432,17501466.5,174.0,61.71428571428572,7,432,17500161.666666668,174.0,61.71428571428572
12092.0,6,12,1393,6,796,2244.2,271.0,132.66666666666666,6,597,2264.8,259.0,99.5
458869.0,6,3,1604,1,753,0.0,753.0,753.0,2,851,0.0,785.0,425.5
37691.0,6,14,4740,7,653,6006.666666666667,249.0,93.28571428571428,7,4087,6040.833333333333,1514.0,583.8571428571429
614279.0,17,4,629,3,234,289.0,78.0,78.0,1,395,0.0,395.0,395.0
2807809.0,6,2,132,1,66,0.0,66.0,66.0,1,66,0.0,66.0,66.0
284331.0,17,2,363,1,79,0.0,79.0,79.0,1,284,0.0,284.0,284.0
334979.0,6,3,202,2,128,0.0,74.0,64.0,1,74,0.0,74.0,74.0
302354.0,6,6,412,4,272,100784.66666666669,74.0,68.0,2,140,0.0,74.0,70.0
222537.0,6,3,426,2,280,0.0,214.0,140.0,1,146,0.0,146.0,146.0
113376354.0,6,46,3036,23,1518,5153458.545454546,66.0,66.0,23,1518,5153458.636363637,66.0,66.0
101101327.0,17,14,864,7,432,16835098.166666668,174.0,61.71428571428572,7,432,16833524.666666668,174.0,61.71428571428572
135139115.0,17,6,1206,6,1206,27027823.0,201.0,201.0,0,0,0.0,0.0,0.0
2590478.0,6,2,132,1,66,0.0,66.0,66.0,1,66,0.0,66.0,66.0
1769.0,17,2,664,1,322,0.0,322.0,322.0,1,342,0.0,342.0,342.0
102924.0,17,2,286,2,286,0.0,143.0,143.0,0,0,0.0,0.0,0.0
9480.0,17,2,582,1,83,0.0,83.0,83.0,1,499,0.0,499.0,499.0
153447.0,17,2,180,1,90,0.0,90.0,90.0,1,90,0.0,90.0,90.0
48696.0,6,14,4740,7,653,7949.666666666667,249.0,93.28571428571428,7,4087,7909.5,1514.0,583.8571428571429
50253.0,6,14,4740,7,653,8099.666666666667,249.0,93.28571428571428,7,4087,8009.166666666667,1514.0,583.8571428571429
24024447.0,17,3,1026,3,1026,12012223.5,342.0,342.0,0,0,0.0,0.0,0.0
2293.0,17,4,344,2,150,0.0,75.0,75.0,2,194,0.0,103.0,97.0
37049.0,6,13,1394,7,797,6005.666666666667,253.0,113.85714285714286,6,597,6736.0,259.0,99.5
90270845.0,6,16,1192,8,596,12889915.285714284,95.0,74.5,8,596,12894739.57142857,95.0,74.5
5630085.0,6,5,336,2,134,0.0,68.0,67.0,3,202,1423298.0,70.0,67.33333333333333
144800.0,17,2,180,1,70,0.0,70.0,70.0,1,110,0.0,110.0,110.0
135138885.0,17,6,1146,6,1146,27027777.0,191.0,191.0,0,0,0.0,0.0,0.0
119897849.0,6,33,2274,17,1125,7493586.6875,123.0,66.17647058823529,16,1149,7869433.266666667,123.0,71.8125
120101339.0,6,32,2226,17,1209,7506333.6875,123.0,71.11764705882354,15,1017,7849940.285714285,123.0,67.8
216320.0,17,2,180,1,90,0.0,90.0,90.0,1,90,0.0,90.0,90.0
24600.0,6,10,2032,5,524,5404.25,252.0,104.8,5,1508,5859.75,1236.0,301.6
119567384.0,6,252,29040,126,20428,954807.696,300.0,162.12698412698413,126,8612,954816.952,140.0,68.34920634920636
81.0,17,2,762,2,762,0.0,381.0,381.0,0,0,0.0,0.0,0.0
3342027.0,6,7,923,4,753,1041692.6666666666,571.0,188.25,3,170,1562848.5,62.0,56.66666666666666
251127.0,6,3,337,2,214,0.0,160.0,107.0,1,123,0.0,123.0,123.0
245509.0,6,3,337,2,214,0.0,160.0,107.0,1,123,0.0,123.0,123.0
224331.0,6,3,426,2,280,0.0,214.0,140.0,1,146,0.0,146.0,146.0
2198377.0,6,24,7545,12,2450,199852.45454545456,1034.0,204.16666666666663,12,5095,171029.27272727274,1510.0,424.5833333333333
13870.0,17,2,180,1,90,0.0,90.0,90.0,1,90,0.0,90.0,90.0
249889.0,6,3,337,2,214,0.0,160.0,107.0,1,123,0.0,123.0,123.0
106809.0,17,2,700,2,700,0.0,350.0,350.0,0,0,0.0,0.0,0.0
80867639.0,17,13,4446,13,4446,6738969.916666667,342.0,342.0,0,0,0.0,0.0,0.0
244817.0,6,3,337,2,214,0.0,160.0,107.0,1,123,0.0,123.0,123.0
2802460.0,6,2,132,1,66,0.0,66.0,66.0,1,66,0.0,66.0,66.0
35403.0,6,14,4740,7,653,5573.333333333333,249.0,93.28571428571428,7,4087,4243.5,1514.0,583.8571428571429
90027121.0,17,28,13364,28,13364,3334337.814814815,501.0,477.2857142857143,0,0,0.0,0.0,0.0
283740.0,17,2,363,1,79,0.0,79.0,79.0,1,284,0.0,284.0,284.0
260554.0,6,3,337,2,214,0.0,160.0,107.0,1,123,0.0,123.0,123.0
115189957.0,6,48,3168,24,1584,5008259.0,66.0,66.0,24,1584,4994426.956521739,66.0,66.0
90053514.0,17,27,12943,27,12943,3463596.6923076925,501.0,479.3703703703704,0,0,0.0,0.0,0.0
100519562.0,17,12,516,6,258,20001396.8,43.0,43.0,6,258,20000161.0,43.0,43.0
108110990.0,17,5,955,5,955,27027747.5,191.0,191.0,0,0,0.0,0.0,0.0
213261.0,17,2,180,1,90,0.0,90.0,90.0,1,90,0.0,90.0,90.0
376.0,17,2,160,1,80,0.0,80.0,80.0,1,80,0.0,80.0,80.0
44591879.0,6,7,1874,3,887,20994471.5,753.0,295.6666666666667,4,987,14000174.666666666,785.0,246.75
18425.0,6,2,145,2,145,0.0,91.0,72.5,0,0,0.0,0.0,0.0
1025671.0,6,11,1134,6,558,205134.2,220.0,93.0,5,576,255544.0,304.0,115.2
835.0,17,4,438,2,148,0.0,74.0,74.0,2,290,0.0,147.0,145.0
114951589.0,6,48,3168,24,1584,4997895.173913044,66.0,66.0,24,1584,4984631.304347826,66.0,66.0
1045863.0,6,13,1386,7,789,174310.5,253.0,112.71428571428572,6,597,205947.0,259.0,99.5
90755656.0,6,19,1436,10,745,10079124.888888888,95.0,74.5,9,691,11343447.875,95.0,76.77777777777777
147111.0,6,3,373,2,238,0.0,172.0,119.0,1,135,0.0,135.0,135.0
2397581.0,17,2,876,2,876,0.0,438.0,438.0,0,0,0.0,0.0,0.0
118806440.0,17,16,1212,8,606,16857340.57142857,174.0,75.75,8,606,16857961.714285713,174.0,75.75
315705.0,17,4,1524,4,1524,105235.0,381.0,381.0,0,0,0.0,0.0,0.0
299099.0,17,2,238,1,74,0.0,74.0,74.0,1,164,0.0,164.0,164.0
176021.0,6,14,4740,7,653,29213.83333333333,249.0,93.28571428571428,7,4087,27586.33333333333,1514.0,583.8571428571429
302905.0,6,6,412,4,272,100968.33333333331,74.0,68.0,2,140,0.0,74.0,70.0
206600.0,17,4,1400,4,1400,68866.66666666667,350.0,350.0,0,0,0.0,0.0,0.0
37985.0,6,14,4740,7,653,6170.166666666667,249.0,93.28571428571428,7,4087,6108.666666666667,1514.0,583.8571428571429
90308992.0,6,16,1192,8,596,12894672.0,95.0,74.5,8,596,12899732.0,95.0,74.5
117052153.0,6,47,3102,24,1584,5077261.043478261,66.0,66.0,23,1518,5135433.454545454,66.0,66.0
24425.0,6,10,2032,5,524,5368.5,252.0,104.8,5,1508,5468.0,1236.0,301.6
10507376.0,6,7,478,4,272,3455358.0,74.0,68.0,3,206,5182899.5,74.0,68.66666666666667
33174.0,6,10,2032,5,524,8006.0,252.0,104.8,5,1508,7815.0,1236.0,301.6
90528940.0,6,14,2240,8,1016,12932705.714285716,188.0,127.0,6,1224,18073016.2,204.0,204.0
4307.0,17,2,566,1,83,0.0,83.0,83.0,1,483,0.0,483.0,483.0
120167048.0,6,232,26370,116,7952,1038664.547826087,140.0,68.55172413793103,116,18418,1038774.6434782608,300.0,158.77586206896552
612040.0,17,2,473,1,78,0.0,78.0,78.0,1,395,0.0,395.0,395.0
13022.0,17,2,180,1,90,0.0,90.0,90.0,1,90,0.0,90.0,90.0
113254811.0,6,46,3036,23,1518,5135436.681818182,66.0,66.0,23,1518,5135434.909090909,66.0,66.0
362996.0,6,13,1386,7,789,60499.333333333336,253.0,112.71428571428572,6,597,70710.0,259.0,99.5
153594.0,17,2,180,1,90,0.0,90.0,90.0,1,90,0.0,90.0,90.0
899779.0,6,12,1427,6,796,178837.6,271.0,132.66666666666666,6,631,176581.0,293.0,105.16666666666669
248455.0,6,3,337,2,214,0.0,160.0,107.0,1,123,0.0,123.0,123.0
10480578.0,6,6,412,3,206,5171795.5,74.0,68.66666666666667,3,206,5171660.5,74.0,68.66666666666667
120001673.0,6,19,1522,10,872,13333519.222222222,222.0,87.2,9,650,14968867.25,95.0,72.22222222222223
228912.0,17,2,180,1,90,0.0,90.0,90.0,1,90,0.0,90.0,90.0
302748.0,6,6,412,4,272,100916.0,74.0,68.0,2,140,0.0,74.0,70.0
204672.0,17,2,762,2,762,0.0,381.0,381.0,0,0,0.0,0.0,0.0
106598467.0,6,44,2904,22,1452,5076117.476190476,66.0,66.0,22,1452,5061376.666666667,66.0,66.0
47873.0,6,10,2032,5,524,11752.0,252.0,104.8,5,1508,11265.25,1236.0,301.6
119852095.0,6,15,2306,6,1224,23969569.4,204.0,204.0,9,1082,14981359.125,188.0,120.22222222222224
121818.0,6,3,373,2,238,0.0,172.0,119.0,1,135,0.0,135.0,135.0
52142.0,6,10,2032,5,524,12019.0,252.0,104.8,5,1508,12166.0,1236.0,301.6
5622561.0,6,4,270,2,134,0.0,68.0,67.0,2,136,0.0,70.0,68.0
19534.0,6,10,1066,5,490,4486.25,218.0,98.0,5,576,4160.25,304.0,115.2
27408.0,6,14,4740,7,653,3793.3333333333335,249.0,93.28571428571428,7,4087,4409.5,1514.0,583.8571428571429
2386.0,17,4,344,2,150,0.0,75.0,75.0,2,194,0.0,103.0,97.0
504507.00000000006,6,5,336,2,134,0.0,68.0,67.0,3,202,194204.5,70.0,67.33333333333333
4392.0,17,2,180,1,90,0.0,90.0,90.0,1,90,0.0,90.0,90.0
90095949.0,6,15,2180,7,1164,15015607.833333334,204.0,166.28571428571428,8,1016,12836504.142857144,188.0,127.0
100516.0,17,2,762,2,762,0.0,381.0,381.0,0,0,0.0,0.0,0.0
331.0,17,2,208,1,72,0.0,72.0,72.0,1,136,0.0,136.0,136.0
135134695.0,17,6,1206,6,1206,27026939.0,201.0,201.0,0,0,0.0,0.0,0.0
108104213.0,17,5,1005,5,1005,27026053.25,201.0,201.0,0,0,0.0,0.0,0.0
48047.0,6,14,4740,7,653,7701.5,249.0,93.28571428571428,7,4087,7707.833333333333,1514.0,583.8571428571429
119941318.0,6,224,25328,112,17714,1078613.6036036036,284.0,158.16071428571428,112,7614,1078614.189189189,140.0,67.98214285714286
237445.0,17,2,180,1,90,0.0,90.0,90.0,1,90,0.0,90.0,90.0
305293.0,6,6,412,4,272,101764.33333333331,74.0,68.0,2,140,0.0,74.0,70.0
209731.0,17,2,180,1,90,0.0,90.0,90.0,1,90,0.0,90.0,90.0
90534233.0,6,19,1477,10,786,6749929.111111111,95.0,78.6,9,691,11280992.125,95.0,76.77777777777777
108344.0,17,2,286,2,286,0.0,143.0,143.0,0,0,0.0,0.0,0.0
153420.0,17,2,180,1,90,0.0,90.0,90.0,1,90,0.0,90.0,90.0
106415.0,17,2,286,2,286,0.0,143.0,143.0,0,0,0.0,0.0,0.0
99526479.0,17,10,692,5,346,19903536.25,174.0,69.2,5,346,20002066.5,174.0,69.2
27482770.0,17,5,1710,5,1710,6870692.5,342.0,342.0,0,0,0.0,0.0,0.0
1987.0,17,4,344,2,150,0.0,75.0,75.0,2,194,0.0,103.0,97.0
108121436.0,17,5,1005,5,1005,27030359.0,201.0,201.0,0,0,0.0,0.0,0.0
407.0,17,2,410,1,78,0.0,78.0,78.0,1,332,0.0,332.0,332.0
5618133.0,6,5,336,2,134,0.0,68.0,67.0,3,202,1522305.0,70.0,67.33333333333333
209822.0,17,2,180,1,90,0.0,90.0,90.0,1,90,0.0,90.0,90.0
90045890.0,17,28,13364,28,13364,3335032.962962963,501.0,477.2857142857143,0,0,0.0,0.0,0.0
3356224.0,6,18,5004,11,917,335346.6,249.0,83.36363636363636,7,4087,559171.5,1514.0,583.8571428571429
2612646.0,6,2,132,1,66,0.0,66.0,66.0,1,66,0.0,66.0,66.0
56670.0,6,13,1386,7,789,8818.5,253.0,112.71428571428572,6,597,10145.8,259.0,99.5
322552.0,17,4,1400,4,1400,107517.33333333331,350.0,350.0,0,0,0.0,0.0,0.0
26164.0,6,10,2032,5,524,6258.0,252.0,104.8,5,1508,5157.5,1236.0,301.6
120202093.0,6,242,27182,121,8282,994814.6333333332,140.0,68.44628099173553,121,18900,995865.2,284.0,156.19834710743802
120121455.0,6,13,2036,8,1016,17136957.14285714,188.0,127.0,5,1020,22523538.75,204.0,204.0
15703.000000000002,6,10,2032,5,524,3471.75,252.0,104.8,5,1508,3667.25,1236.0,301.6
1304070.0,17,7,490,7,490,217345.0,70.0,70.0,0,0,0.0,0.0,0.0
146208.0,6,3,337,2,214,0.0,160.0,107.0,1,123,0.0,123.0,123.0
1768491.0,6,2,132,1,66,0.0,66.0,66.0,1,66,0.0,66.0,66.0
306337.0,6,6,412,4,272,102112.33333333331,74.0,68.0,2,140,0.0,74.0,70.0
44540.0,6,10,2032,5,524,10167.75,252.0,104.8,5,1508,10611.0,1236.0,301.6
29233.0,6,14,4740,7,653,4747.333333333333,249.0,93.28571428571428,7,4087,4704.333333333333,1514.0,583.8571428571429
34103.0,6,10,2032,5,524,8295.25,252.0,104.8,5,1508,8196.75,1236.0,301.6
143932.0,17,2,180,1,90,0.0,90.0,90.0,1,90,0.0,90.0,90.0
437427.0,6,11,1021,6,444,58812.6,162.0,74.0,5,577,73285.75,349.0,115.4
345.0,17,2,160,1,80,0.0,80.0,80.0,1,80,0.0,80.0,80.0
157809.0,17,2,180,1,90,0.0,90.0,90.0,1,90,0.0,90.0,90.0
17542.0,6,10,2032,5,524,4213.0,252.0,104.8,5,1508,4157.5,1236.0,301.6
36282.0,6,14,4740,7,653,5825.833333333333,249.0,93.28571428571428,7,4087,5900.166666666667,1514.0,583.8571428571429
19903.0,17,2,582,1,83,0.0,83.0,83.0,1,499,0.0,499.0,499.0
104010678.0,6,321,36510,161,25728,650066.7375,300.0,159.80124223602485,160,10782,641138.7421383648,140.0,67.3875
44979353.0,17,10,3428,9,3078,4717165.0,342.0,342.0,1,350,0.0,350.0,350.0
90284000.0,6,21,1585,11,840,9023473.8,95.0,76.36363636363636,10,745,10000140.333333334,95.0,74.5
298720.0,17,4,6056,4,6056,99573.33333333331,1514.0,1514.0,0,0,0.0,0.0,0.0
209316.0,17,2,180,1,90,0.0,90.0,90.0,1,90,0.0,90.0,90.0
5730917.0,6,5,336,2,134,0.0,68.0,67.0,3,202,1525005.0,70.0,67.33333333333333
318296.0,17,4,1400,4,1400,106098.66666666669,350.0,350.0,0,0,0.0,0.0,0.0
228229.0,17,2,180,1,90,0.0,90.0,90.0,1,90,0.0,90.0,90.0
27266385.0,6,26,7627,14,3735,184806.0769230769,1514.0,266.7857142857143,12,3892,2459546.1818181816,1514.0,324.3333333333333
2373.0,17,4,344,2,150,0.0,75.0,75.0,2,194,0.0,103.0,97.0
21448.0,17,2,582,1,83,0.0,83.0,83.0,1,499,0.0,499.0,499.0
108105515.0,17,5,955,5,955,27026378.75,191.0,191.0,0,0,0.0,0.0,0.0
75072.0,6,14,4740,7,653,12391.666666666666,249.0,93.28571428571428,7,4087,12366.0,1514.0,583.8571428571429
38218.0,6,14,4740,7,653,5723.666666666667,249.0,93.28571428571428,7,4087,6165.666666666667,1514.0,583.8571428571429
119797984.0,17,35,16705,35,16705,3523470.117647059,501.0,477.2857142857143,0,0,0.0,0.0,0.0
149736779.0,17,36,17126,36,17126,4278193.685714286,501.0,475.72222222222223,0,0,0.0,0.0,0.0
2414663.0,6,3,1777,1,826,0.0,826.0,826.0,2,951,0.0,885.0,475.5
216988.0,6,3,426,2,280,0.0,214.0,140.0,1,146,0.0,146.0,146.0
163427.0,6,3,337,2,214,0.0,160.0,107.0,1,123,0.0,123.0,123.0
3421668.0,6,7,923,4,753,1068545.6666666667,571.0,188.25,3,170,1602916.0,62.0,56.66666666666666
87546.0,17,2,700,2,700,0.0,350.0,350.0,0,0,0.0,0.0,0.0
90050009.0,17,28,13364,28,13364,3335185.5185185187,501.0,477.2857142857143,0,0,0.0,0.0,0.0
603540.0,6,4,508,2,238,0.0,172.0,119.0,2,270,0.0,135.0,135.0
0.0,17,1,90,1,90,0.0,90.0,90.0,0,0,0.0,0.0,0.0
300639.0,6,6,412,4,272,100213.0,74.0,68.0,2,140,0.0,74.0,70.0
115473013.0,17,16,1212,8,606,16428728.857142856,174.0,75.75,8,606,16430033.714285716,174.0,75.75
2377.0,17,4,344,2,150,0.0,75.0,75.0,2,194,0.0,103.0,97.0
204911.0,17,2,762,2,762,0.0,381.0,381.0,0,0,0.0,0.0,0.0
90095362.0,6,11,1644,4,816,30031028.33333333,204.0,204.0,7,828,15015503.333333334,188.0,118.28571428571428
10493583.0,6,7,478,4,272,3452408.6666666665,74.0,68.0,3,206,5178507.5,74.0,68.66666666666667
5630178.0,6,5,336,2,134,0.0,68.0,67.0,3,202,1527054.0,70.0,67.33333333333333
43966.0,6,14,4740,7,653,6472.666666666667,249.0,93.28571428571428,7,4087,6923.5,1514.0,583.8571428571429
212812.0,6,3,426,2,280,0.0,214.0,140.0,1,146,0.0,146.0,146.0
9267.0,17,2,582,1,83,0.0,83.0,83.0,1,499,0.0,499.0,499.0
108099278.0,17,5,955,5,955,27024819.5,191.0,191.0,0,0,0.0,0.0,0.0
108104625.0,17,5,1005,5,1005,27026156.25,201.0,201.0,0,0,0.0,0.0,0.0
135127612.0,17,6,1206,6,1206,27025522.4,201.0,201.0,0,0,0.0,0.0,0.0
322.0,17,2,267,1,83,0.0,83.0,83.0,1,184,0.0,184.0,184.0
27076.0,6,10,2032,5,524,5024.75,252.0,104.8,5,1508,6506.25,1236.0,301.6
2325.0,17,4,344,2,150,0.0,75.0,75.0,2,194,0.0,103.0,97.0
363622.0,6,11,1021,6,444,48994.2,162.0,74.0,5,577,61030.0,349.0,115.4
135127848.0,17,6,1206,6,1206,27025569.6,201.0,201.0,0,0,0.0,0.0,0.0
31211.0,6,14,4740,7,653,5091.0,249.0,93.28571428571428,7,4087,3657.6666666666665,1514.0,583.8571428571429
113254964.0,6,46,3036,23,1518,5135444.454545454,66.0,66.0,23,1518,5135446.909090909,66.0,66.0
108100247.0,17,5,1005,5,1005,27025061.75,201.0,201.0,0,0,0.0,0.0,0.0
99821.0,17,2,762,2,762,0.0,381.0,381.0,0,0,0.0,0.0,0.0
211287.0,17,2,180,1,90,0.0,90.0,90.0,1,90,0.0,90.0,90.0
90257378.0,6,12,1832,8,1016,12893911.142857144,188.0,127.0,4,816,30029582.666666668,204.0,204.0
34075.0,6,10,2032,5,524,8281.75,252.0,104.8,5,1508,7945.75,1236.0,301.6
47185.0,6,14,4740,7,653,7673.166666666667,249.0,93.28571428571428,7,4087,7474.666666666667,1514.0,583.8571428571429
118043071.0,6,34,2350,17,1225,7364210.25,139.0,72.05882352941177,17,1125,7364210.625,123.0,66.17647058823529
204953.0,17,2,762,2,762,0.0,381.0,381.0,0,0,0.0,0.0,0.0
9315.0,6,10,2032,5,524,2105.25,252.0,104.8,5,1508,2070.5,1236.0,301.6
320534.0,6,3,202,2,128,0.0,74.0,64.0,1,74,0.0,74.0,74.0
42726.0,6,14,4740,7,653,6989.833333333333,249.0,93.28571428571428,7,4087,6601.5,1514.0,583.8571428571429
1310882.0,6,4,264,2,132,0.0,66.0,66.0,2,132,0.0,66.0,66.0
156766.0,6,3,337,2,214,0.0,160.0,107.0,1,123,0.0,123.0,123.0
4301.0,17,2,626,1,72,0.0,72.0,72.0,1,554,0.0,554.0,554.0
4407.0,17,2,626,1,72,0.0,72.0,72.0,1,554,0.0,554.0,554.0
503621.0,6,5,336,2,134,0.0,68.0,67.0,3,202,193161.5,70.0,67.33333333333333
90251750.0,6,12,1832,8,1016,12893107.142857144,188.0,127.0,4,816,30029014.666666668,204.0,204.0
304155.0,6,6,412,4,272,101385.0,74.0,68.0,2,140,0.0,74.0,70.0
30932.0,6,11,1132,6,556,6186.4,218.0,92.66666666666669,5,576,7239.5,304.0,115.2
97800068.0,17,12,778,6,389,19401720.4,174.0,64.83333333333333,6,389,19400164.8,174.0,64.83333333333333
90044511.0,17,27,12943,27,12943,3463250.423076923,501.0,479.3703703703704,0,0,0.0,0.0,0.0
302382.0,6,2,132,1,66,0.0,66.0,66.0,1,66,0.0,66.0,66.0
5646351.0,6,5,336,2,134,0.0,68.0,67.0,3,202,1434396.0,70.0,67.33333333333333
135130046.0,17,6,1146,6,1146,27026009.2,191.0,191.0,0,0,0.0,0.0,0.0
292748.0,17,4,1400,4,1400,97582.66666666669,350.0,350.0,0,0,0.0,0.0,0.0
242229.0,6,3,337,2,214,0.0,160.0,107.0,1,123,0.0,123.0,123.0
122314588.0,6,48,3168,24,1584,5147722.608695652,66.0,66.0,24,1584,5060029.652173913,66.0,66.0
155846.0,6,3,337,2,214,0.0,160.0,107.0,1,123,0.0,123.0,123.0
27047520.0,17,5,1710,5,1710,6761880.0,342.0,342.0,0,0,0.0,0.0,0.0
314.0,17,2,174,1,79,0.0,79.0,79.0,1,95,0.0,95.0,95.0
39375.0,6,14,4740,7,653,5704.0,249.0,93.28571428571428,7,4087,6146.333333333333,1514.0,583.8571428571429
108112421.0,17,5,955,5,955,27028105.25,191.0,191.0,0,0,0.0,0.0,0.0
103996.0,17,2,286,2,286,0.0,143.0,143.0,0,0,0.0,0.0,0.0
92437878.0,6,37,2442,19,1254,5135437.666666667,66.0,66.0,18,1188,5342151.352941177,66.0,66.0
90305576.0,6,16,1192,8,596,12893193.0,95.0,74.5,8,596,12899624.57142857,95.0,74.5
315712.0,17,4,1400,4,1400,105237.33333333331,350.0,350.0,0,0,0.0,0.0,0.0
120054580.0,17,28,13364,28,13364,4446465.925925926,501.0,477.2857142857143,0,0,0.0,0.0,0.0
65864.0,6,14,4740,7,653,10845.0,249.0,93.28571428571428,7,4087,10771.5,1514.0,583.8571428571429
1960.0,17,4,438,2,148,0.0,74.0,74.0,2,290,0.0,147.0,145.0
35298.0,6,14,4740,7,653,5389.166666666667,249.0,93.28571428571428,7,4087,4613.833333333333,1514.0,583.8571428571429
306404.0,6,6,412,4,272,102134.66666666669,74.0,68.0,2,140,0.0,74.0,70.0
108106084.0,17,5,955,5,955,27026521.0,191.0,191.0,0,0,0.0,0.0,0.0
231146.0,6,10,1221,6,636,46229.2,298.0,106.0,4,585,76069.0,379.0,146.25
298694.0,6,6,412,4,272,99564.66666666669,74.0,68.0,2,140,0.0,74.0,70.0
2282.0,17,4,344,2,150,0.0,75.0,75.0,2,194,0.0,103.0,97.0
265836.0,6,3,337,2,214,0.0,160.0,107.0,1,123,0.0,123.0,123.0
123610601.0,6,49,3234,25,1650,5150441.708333333,66.0,66.0,24,1584,5129833.304347826,66.0,66.0
3788325.0,6,5,336,2,134,0.0,68.0,67.0,3,202,1528888.5,70.0,67.33333333333333
865884.0,6,10,1333,6,796,173176.8,458.0,132.66666666666666,4,537,197709.66666666663,331.0,134.25
2036.0,17,4,344,2,150,0.0,75.0,75.0,2,194,0.0,103.0,97.0
108458.0,17,2,286,2,286,0.0,143.0,143.0,0,0,0.0,0.0,0.0
121007457.0,17,15,907,8,475,17286779.57142857,174.0,59.375,7,432,16874482.166666668,174.0,61.71428571428572
90299910.0,6,16,1192,8,596,12892752.857142856,95.0,74.5,8,596,12898622.57142857,95.0,74.5
41541.0,6,14,4740,7,653,6557.666666666667,249.0,93.28571428571428,7,4087,6202.666666666667,1514.0,583.8571428571429
241851.0,6,3,337,2,214,0.0,160.0,107.0,1,123,0.0,123.0,123.0
205992.0,17,2,180,1,90,0.0,90.0,90.0,1,90,0.0,90.0,90.0
1310677.0,6,7,499,3,198,614991.5,66.0,66.0,4,301,407596.0,103.0,75.25
120009827.0,6,19,1436,10,786,13333310.333333334,95.0,78.6,9,650,14999325.5,95.0,72.22222222222223
2314.0,17,4,344,2,150,0.0,75.0,75.0,2,194,0.0,103.0,97.0
106966.0,17,2,286,2,286,0.0,143.0,143.0,0,0,0.0,0.0,0.0
2382.0,17,4,344,2,150,0.0,75.0,75.0,2,194,0.0,103.0,97.0
40191.0,6,10,2032,5,524,9444.75,252.0,104.8,5,1508,9191.25,1236.0,301.6
35995.0,6,14,4740,7,653,5888.333333333333,249.0,93.28571428571428,7,4087,5465.166666666667,1514.0,583.8571428571429
325.0,17,2,166,1,75,0.0,75.0,75.0,1,91,0.0,91.0,91.0
112478045.0,6,37,2794,20,1531,5908524.263157895,139.0,76.55,17,1263,7016377.25,123.0,74.29411764705883
311815.0,17,4,1400,4,1400,103938.33333333331,350.0,350.0,0,0,0.0,0.0,0.0
135131259.0,17,6,1206,6,1206,27026251.8,201.0,201.0,0,0,0.0,0.0,0.0
135141542.0,17,6,1206,6,1206,27028308.4,201.0,201.0,0,0,0.0,0.0,0.0
90262923.0,6,13,2036,8,1016,12894703.285714284,188.0,127.0,5,1020,22524968.5,204.0,204.0
218876.0,6,3,426,2,280,0.0,214.0,140.0,1,146,0.0,146.0,146.0
4400.0,17,2,626,1,72,0.0,72.0,72.0,1,554,0.0,554.0,554.0
91407539.0,6,24,1829,13,989,7616882.583333333,95.0,76.07692307692308,11,840,9139823.0,95.0,76.36363636363636
310115.0,6,6,412,4,272,103371.66666666669,74.0,68.0,2,140,0.0,74.0,70.0
36270.0,6,10,2032,5,524,8834.25,252.0,104.8,5,1508,8823.0,1236.0,301.6
90294168.0,6,16,1192,8,596,12892249.142857144,95.0,74.5,8,596,12897786.857142856,95.0,74.5
160049.0,17,2,180,1,90,0.0,90.0,90.0,1,90,0.0,90.0,90.0
139119.0,6,14,4740,7,653,21624.666666666668,249.0,93.28571428571428,7,4087,21781.5,1514.0,583.8571428571429
47609777.0,6,8,2113,3,960,22571212.5,826.0,320.0,5,1153,11206638.5,885.0,230.6
112200589.0,17,16,1212,8,606,16002747.57142857,174.0,75.75,8,606,16000152.57142857,174.0,75.75
90526974.0,6,15,2444,8,1016,12932424.857142856,188.0,127.0,7,1428,15060391.5,204.0,204.0
94397137.0,17,12,778,6,389,18879427.4,174.0,64.83333333333333,6,389,18833992.2,174.0,64.83333333333333
3392.0,17,2,414,1,88,0.0,88.0,88.0,1,326,0.0,326.0,326.0
2106.0,17,4,344,2,150,0.0,75.0,75.0,2,194,0.0,103.0,97.0
335254.0,17,2,180,1,90,0.0,90.0,90.0,1,90,0.0,90.0,90.0
23245.0,6,10,2032,5,524,5513.75,252.0,104.8,5,1508,5639.25,1236.0,301.6
108107340.0,17,5,955,5,955,27026835.0,191.0,191.0,0,0,0.0,0.0,0.0
141549.0,6,14,4740,7,653,23320.166666666668,249.0,93.28571428571428,7,4087,22749.666666666668,1514.0,583.8571428571429
43444488.0,6,14,982,6,437,8685640.6,95.0,72.83333333333333,8,545,6202699.285714285,95.0,68.125
186301.0,17,2,180,1,90,0.0,90.0,90.0,1,90,0.0,90.0,90.0
16828.0,6,10,2032,5,524,3963.75,252.0,104.8,5,1508,3637.5,1236.0,301.6
563.0,17,2,508,2,508,0.0,257.0,254.0,0,0,0.0,0.0,0.0
847682.0,6,9,1267,6,796,169536.4,458.0,132.66666666666666,3,471,287543.5,331.0,157.0
233001.0,6,3,337,2,214,0.0,160.0,107.0,1,123,0.0,123.0,123.0
4480.0,17,4,806,2,144,0.0,72.0,72.0,2,662,0.0,526.0,331.0
93016783.0,6,38,2508,19,1254,5150432.166666667,66.0,66.0,19,1254,5150459.333333333,66.0,66.0
94527.0,17,2,762,2,762,0.0,381.0,381.0,0,0,0.0,0.0,0.0
238732.0,17,4,1400,4,1400,79577.33333333333,350.0,350.0,0,0,0.0,0.0,0.0
99802.0,17,2,762,2,762,0.0,381.0,381.0,0,0,0.0,0.0,0.0
136361513.0,17,14,864,7,432,19500182.0,174.0,61.71428571428572,7,432,19500863.166666668,174.0,61.71428571428572
55247.0,6,14,4740,7,653,9080.0,249.0,93.28571428571428,7,4087,8839.166666666666,1514.0,583.8571428571429
199782.0,17,4,6056,4,6056,66594.0,1514.0,1514.0,0,0,0.0,0.0,0.0
5128.0,17,4,344,2,150,0.0,75.0,75.0,2,194,0.0,103.0,97.0
2298.0,17,4,344,2,150,0.0,75.0,75.0,2,194,0.0,103.0,97.0
90254521.0,6,13,2036,8,1016,12893503.0,188.0,127.0,5,1020,22522790.0,204.0,204.0
112535543.0,6,46,3036,23,1518,5105438.7727272725,66.0,66.0,23,1518,5105438.363636363,66.0,66.0
236643.0,6,3,373,2,238,0.0,172.0,119.0,1,135,0.0,135.0,135.0
135122675.0,17,6,1146,6,1146,27024535.0,191.0,191.0,0,0,0.0,0.0,0.0
90268439.0,6,14,1043,7,542,15044739.833333334,95.0,77.42857142857143,7,501,14996265.333333334,95.0,71.57142857142857
241861.0,6,3,373,2,238,0.0,172.0,119.0,1,135,0.0,135.0,135.0
33136.0,6,14,4740,7,653,5325.166666666667,249.0,93.28571428571428,7,4087,5378.833333333333,1514.0,583.8571428571429
101578794.0,17,14,1126,7,563,16834622.666666668,174.0,80.42857142857143,7,563,16833493.666666668,174.0,80.42857142857143
308816.0,6,6,412,4,272,102938.66666666669,74.0,68.0,2,140,0.0,74.0,70.0
108109065.0,17,5,955,5,955,27027266.25,191.0,191.0,0,0,0.0,0.0,0.0
115242042.0,6,48,3168,24,1584,5010523.565217392,66.0,66.0,24,1584,4998681.478260869,66.0,66.0
45034704.0,6,7,1874,5,1053,11258676.0,785.0,210.6,2,821,0.0,753.0,410.5
228179.0,17,2,180,1,90,0.0,90.0,90.0,1,90,0.0,90.0,90.0
123796.0,6,4,439,2,238,0.0,172.0,119.0,2,201,0.0,135.0,100.5
2503.0,17,4,344,2,150,0.0,75.0,75.0,2,194,0.0,103.0,97.0
90326169.0,6,24,1829,13,989,7523250.166666667,95.0,76.07692307692308,11,840,8957543.9,95.0,76.36363636363636
109059.0,17,2,286,2,286,0.0,143.0,143.0,0,0,0.0,0.0,0.0
120229767.0,17,12,647,6,389,20143696.0,174.0,64.83333333333333,6,258,20000875.6,43.0,43.0
299959.0,6,6,412,4,272,99986.33333333331,74.0,68.0,2,140,0.0,74.0,70.0
2801840.0,6,2,132,1,66,0.0,66.0,66.0,1,66,0.0,66.0,66.0
90032979.0,17,28,13364,28,13364,3334554.777777778,501.0,477.2857142857143,0,0,0.0,0.0,0.0
14644824.0,6,20,1607,10,975,1593527.7777777778,315.0,97.5,10,632,1593485.5555555555,78.0,63.2
135136141.0,17,6,1206,6,1206,27027228.2,201.0,201.0,0,0,0.0,0.0,0.0
202379.0,17,2,762,2,762,0.0,381.0,381.0,0,0,0.0,0.0,0.0
96087487.0,6,58,12257,29,6464,3431695.964285714,1514.0,222.896551724138,29,5793,3422591.464285714,1514.0,199.7586206896552
217822.0,6,3,426,2,280,0.0,214.0,140.0,1,146,0.0,146.0,146.0
206156.0,6,3,426,2,280,0.0,214.0,140.0,1,146,0.0,146.0,146.0
135132265.0,17,6,1146,6,1146,27026453.0,191.0,191.0,0,0,0.0,0.0,0.0
28717.0,6,11,2098,6,590,4330.8,252.0,98.33333333333331,5,1508,6719.75,1236.0,301.6
0.0,6,1,60,1,60,0.0,60.0,60.0,0,0,0.0,0.0,0.0
317.0,17,2,174,1,79,0.0,79.0,79.0,1,95,0.0,95.0,95.0
539392.0,17,6,2100,6,2100,107878.4,350.0,350.0,0,0,0.0,0.0,0.0
120201524.0,6,228,25772,114,7746,1047389.8230088496,140.0,67.94736842105263,114,18026,1056513.3805309734,284.0,158.12280701754386
308086.0,6,6,412,4,272,102695.33333333331,74.0,68.0,2,140,0.0,74.0,70.0
286150.0,17,2,363,1,79,0.0,79.0,79.0,1,284,0.0,284.0,284.0
14970.0,17,2,180,1,90,0.0,90.0,90.0,1,90,0.0,90.0,90.0
97387.0,17,2,700,2,700,0.0,350.0,350.0,0,0,0.0,0.0,0.0
18564.0,6,14,4740,7,653,2780.1666666666665,249.0,93.28571428571428,7,4087,2957.1666666666665,1514.0,583.8571428571429
135129274.0,17,6,1206,6,1206,27025854.8,201.0,201.0,0,0,0.0,0.0,0.0
52196.0,6,14,4740,7,653,7988.166666666667,249.0,93.28571428571428,7,4087,8363.666666666666,1514.0,583.8571428571429
295.0,17,2,164,1,82,0.0,82.0,82.0,1,82,0.0,82.0,82.0
17670.0,6,14,4740,7,653,2713.6666666666665,249.0,93.28571428571428,7,4087,2807.1666666666665,1514.0,583.8571428571429
28272.0,6,11,2098,6,590,5639.8,252.0,98.33333333333331,5,1508,6795.25,1236.0,301.6
47785.0,6,10,2032,5,524,11713.5,252.0,104.8,5,1508,11500.25,1236.0,301.6
11905416.0,6,230,213924,68,4652,177692.776119403,210.0,68.41176470588235,162,209272,73876.3105590062,1514.0,1291.8024691358023
31401.0,6,14,4740,7,653,3887.3333333333335,249.0,93.28571428571428,7,4087,4598.666666666667,1514.0,583.8571428571429
222135.0,6,10,1221,6,636,44427.0,298.0,106.0,4,585,73095.66666666667,379.0,146.25
309.0,17,2,174,1,79,0.0,79.0,79.0,1,95,0.0,95.0,95.0
108777884.0,6,28,1860,14,966,8350924.076923077,123.0,69.0,14,894,8350927.153846154,123.0,63.85714285714285
90305865.0,6,16,1192,8,596,12894405.42857143,95.0,74.5,8,596,12899436.857142856,95.0,74.5
119865421.0,17,35,16705,35,16705,3525453.5588235296,501.0,477.2857142857143,0,0,0.0,0.0,0.0
855830.0,6,9,1269,6,798,171166.0,460.0,133.0,3,471,291613.0,331.0,157.0
90014445.0,17,28,13364,28,13364,3333868.333333333,501.0,477.2857142857143,0,0,0.0,0.0,0.0
196826.0,17,2,180,1,90,0.0,90.0,90.0,1,90,0.0,90.0,90.0
153544.0,17,2,180,1,90,0.0,90.0,90.0,1,90,0.0,90.0,90.0
1029211.0,6,11,1134,6,558,205842.2,220.0,93.0,5,576,256203.25,304.0,115.2
108120613.0,17,5,955,5,955,27030153.25,191.0,191.0,0,0,0.0,0.0,0.0
124009532.0,17,15,907,8,475,17715647.42857143,174.0,59.375,7,432,17333492.166666668,174.0,61.71428571428572
28212.0,6,14,4740,7,653,4118.0,249.0,93.28571428571428,7,4087,4568.333333333333,1514.0,583.8571428571429
2363.0,17,4,344,2,150,0.0,75.0,75.0,2,194,0.0,103.0,97.0
206105.0,6,3,426,2,280,0.0,214.0,140.0,1,146,0.0,146.0,146.0
1462.0,17,2,762,2,762,0.0,381.0,381.0,0,0,0.0,0.0,0.0
174676.0,17,4,1400,4,1400,58225.333333333336,350.0,350.0,0,0,0.0,0.0,0.0
107590366.0,17,14,864,7,432,17833503.0,174.0,61.71428571428572,7,432,17834954.833333332,174.0,61.71428571428572
818.0,17,4,438,2,148,0.0,74.0,74.0,2,290,0.0,147.0,145.0
91930736.0,6,25,1686,13,840,7660894.666666667,123.0,64.61538461538461,12,846,7429882.0,123.0,70.5
36727.0,6,14,4740,7,653,5996.333333333333,249.0,93.28571428571428,7,4087,5327.0,1514.0,583.8571428571429
5525853.0,6,5,336,2,134,0.0,68.0,67.0,3,202,1525774.5,70.0,67.33333333333333
153469.0,17,2,180,1,90,0.0,90.0,90.0,1,90,0.0,90.0,90.0
17925.0,6,12,1393,6,796,2642.6,271.0,132.66666666666666,6,597,3329.6,259.0,99.5
5009838.0,17,4,849,2,166,0.0,83.0,83.0,2,683,0.0,499.0,341.5
333.0,17,2,208,1,72,0.0,72.0,72.0,1,136,0.0,136.0,136.0
44564.0,6,2,132,1,66,0.0,66.0,66.0,1,66,0.0,66.0,66.0
216707.0,6,3,426,2,280,0.0,214.0,140.0,1,146,0.0,146.0,146.0
350.0,17,2,267,1,83,0.0,83.0,83.0,1,184,0.0,184.0,184.0
91000779.0,17,13,1083,7,563,15166796.5,174.0,80.42857142857143,6,520,14202303.0,174.0,86.66666666666667
90057151.0,17,28,13364,28,13364,3335450.037037037,501.0,477.2857142857143,0,0,0.0,0.0,0.0
135137461.0,17,6,1146,6,1146,27027492.2,191.0,191.0,0,0,0.0,0.0,0.0
2140190.0,6,24,7544,12,2450,194562.7272727273,1034.0,204.16666666666663,12,5094,167006.0,1510.0,424.5
135133884.0,17,6,1146,6,1146,27026776.8,191.0,191.0,0,0,0.0,0.0,0.0
90257791.0,6,13,2036,8,1016,12893970.142857144,188.0,127.0,5,1020,22522534.25,204.0,204.0
117877155.0,6,29,1914,15,948,8419796.785714285,123.0,63.2,14,966,8282783.076923077,123.0,69.0
120102975.0,6,14,2240,8,1016,17134758.85714286,188.0,127.0,6,1224,18017195.4,204.0,204.0
1847.0,17,2,664,1,322,0.0,322.0,322.0,1,342,0.0,342.0,342.0
2657076.0,6,3,1604,2,851,0.0,785.0,425.5,1,753,0.0,753.0,753.0
2136.0,17,2,180,1,90,0.0,90.0,90.0,1,90,0.0,90.0,90.0
42619.0,6,14,4740,7,653,6921.333333333333,249.0,93.28571428571428,7,4087,5560.333333333333,1514.0,583.8571428571429
40683.0,6,14,4740,7,653,5669.833333333333,249.0,93.28571428571428,7,4087,6277.833333333333,1514.0,583.8571428571429
1479766.0,17,16,1120,16,1120,98651.06666666668,70.0,70.0,0,0,0.0,0.0,0.0
807.0,17,5,550,5,550,201.75,110.0,110.0,0,0,0.0,0.0,0.0
135140272.0,17,6,1146,6,1146,27028054.4,191.0,191.0,0,0,0.0,0.0,0.0
32072.000000000004,6,14,4740,7,653,5218.833333333333,249.0,93.28571428571428,7,4087,5049.166666666667,1514.0,583.8571428571429
918108.0,6,4,492,2,280,0.0,214.0,140.0,2,212,0.0,146.0,106.0
72834.0,6,10,2032,5,524,17450.25,252.0,104.8,5,1508,9318.5,1236.0,301.6
204684.0,17,2,762,2,762,0.0,381.0,381.0,0,0,0.0,0.0,0.0
207331.0,6,3,426,2,280,0.0,214.0,140.0,1,146,0.0,146.0,146.0
120238639.0,6,18,1341,9,691,14999071.5,95.0,76.77777777777777,9,650,14998733.25,95.0,72.22222222222223
307904.0,6,6,412,4,272,102634.66666666669,74.0,68.0,2,140,0.0,74.0,70.0
49339.0,6,14,4740,7,653,7702.5,249.0,93.28571428571428,7,4087,5994.833333333333,1514.0,583.8571428571429
98112847.0,6,73,16587,37,7000,2725356.861111111,1514.0,189.1891891891892,36,9587,2796124.571428572,1514.0,266.30555555555554
105720113.0,6,33,2428,17,1288,6594026.75,139.0,75.76470588235294,16,1140,7033629.4,123.0,71.25
43536.0,6,14,4740,7,653,6878.5,249.0,93.28571428571428,7,4087,6765.666666666667,1514.0,583.8571428571429
112933.0,17,4,1400,4,1400,37644.333333333336,350.0,350.0,0,0,0.0,0.0,0.0
90542477.0,6,14,2240,8,1016,12934639.57142857,188.0,127.0,6,1224,18075631.8,204.0,204.0
117242167.0,6,221,24806,111,7622,1065837.8818181818,140.0,68.66666666666667,110,17184,1066109.5596330275,284.0,156.21818181818182
48019.0,6,14,4740,7,653,7872.333333333333,249.0,93.28571428571428,7,4087,7737.666666666667,1514.0,583.8571428571429
1021949.0,6,11,1134,6,558,204389.8,220.0,93.0,5,576,255030.0,304.0,115.2
2415.0,17,4,344,2,150,0.0,75.0,75.0,2,194,0.0,103.0,97.0
2800626.0,6,2,132,1,66,0.0,66.0,66.0,1,66,0.0,66.0,66.0
90093367.0,6,12,1848,5,1020,22523004.0,204.0,204.0,7,828,15015318.666666666,188.0,118.28571428571428
303919.0,6,6,412,4,272,101306.33333333331,74.0,68.0,2,140,0.0,74.0,70.0
2685222.0,6,3,204,2,136,0.0,70.0,68.0,1,68,0.0,68.0,68.0
45742.0,6,14,4740,7,653,7275.5,249.0,93.28571428571428,7,4087,5862.333333333333,1514.0,583.8571428571429
165870.0,17,2,180,1,90,0.0,90.0,90.0,1,90,0.0,90.0,90.0
95478788.0,6,25,1686,13,840,7956565.666666667,123.0,64.61538461538461,12,846,7753492.909090909,123.0,70.5
75654.0,6,10,2032,5,524,18658.25,252.0,104.8,5,1508,18555.75,1236.0,301.6
5042077.0,17,4,1164,2,166,0.0,83.0,83.0,2,998,0.0,499.0,499.0
154.0,17,3,1050,3,1050,77.0,350.0,350.0,0,0,0.0,0.0,0.0
35641.0,6,11,2098,6,590,6863.6,252.0,98.33333333333331,5,1508,8662.75,1236.0,301.6
15632108.0,17,6,2052,6,2052,3126421.6,342.0,342.0,0,0,0.0,0.0,0.0
120134808.0,6,14,2240,6,1224,24026961.6,204.0,204.0,8,1016,17136509.14285714,188.0,127.0
412.0,17,2,166,1,75,0.0,75.0,75.0,1,91,0.0,91.0,91.0
108752248.0,6,35,2542,18,1348,6397191.05882353,139.0,74.88888888888889,17,1194,6783490.4375,123.0,70.23529411764706
205753.0,17,2,180,1,90,0.0,90.0,90.0,1,90,0.0,90.0,90.0
2382.0,17,4,344,2,150,0.0,75.0,75.0,2,194,0.0,103.0,97.0
94288032.0,6,26,2034,14,1043,7249702.692307692,95.0,74.5,12,991,8545584.454545455,155.0,82.58333333333333
301195.0,6,6,412,4,272,100398.33333333331,74.0,68.0,2,140,0.0,74.0,70.0
977073.0,6,12,1354,6,723,193977.8,253.0,120.5,6,631,194551.4,293.0,105.16666666666669
38296.0,6,14,4740,7,653,6051.5,249.0,93.28571428571428,7,4087,5356.833333333333,1514.0,583.8571428571429
836.0,17,4,438,2,148,0.0,74.0,74.0,2,290,0.0,147.0,145.0
6810.0,17,4,823,2,163,0.0,89.0,81.5,2,660,0.0,443.0,330.0
146617.0,6,3,337,2,214,0.0,160.0,107.0,1,123,0.0,123.0,123.0
2290.0,17,4,344,2,150,0.0,75.0,75.0,2,194,0.0,103.0,97.0
90216315.0,6,16,1192,8,596,12853865.0,95.0,74.5,8,596,12858720.142857144,95.0,74.5
2006.0,17,4,344,2,150,0.0,75.0,75.0,2,194,0.0,103.0,97.0
264663.0,6,10,1221,6,636,52932.6,298.0,106.0,4,585,82458.0,379.0,146.25
32141.000000000004,6,14,4740,7,653,4958.833333333333,249.0,93.28571428571428,7,4087,5217.666666666667,1514.0,583.8571428571429
863.0,17,5,550,5,550,215.75,110.0,110.0,0,0,0.0,0.0,0.0
2749.0,17,4,344,2,150,0.0,75.0,75.0,2,194,0.0,103.0,97.0
241820.0,6,3,337,2,214,0.0,160.0,107.0,1,123,0.0,123.0,123.0
4281949.0,6,83,79605,28,2010,158590.7037037037,208.0,71.78571428571429,55,77595,79070.16666666667,1514.0,1410.8181818181818
29879.0,6,14,4740,7,653,4870.0,249.0,93.28571428571428,7,4087,4206.666666666667,1514.0,583.8571428571429
334.0,17,2,166,1,75,0.0,75.0,75.0,1,91,0.0,91.0,91.0
90028510.0,17,28,13364,28,13364,3334389.25925926,501.0,477.2857142857143,0,0,0.0,0.0,0.0
0.0,17,1,381,1,381,0.0,381.0,381.0,0,0,0.0,0.0,0.0
301033.0,6,6,412,4,272,100344.33333333331,74.0,68.0,2,140,0.0,74.0,70.0
143843.0,17,2,180,1,90,0.0,90.0,90.0,1,90,0.0,90.0,90.0
10472256.0,6,7,478,4,272,3445461.0,74.0,68.0,3,206,5168102.5,74.0,68.66666666666667
186015.0,17,2,180,1,90,0.0,90.0,90.0,1,90,0.0,90.0,90.0
64766.00000000001,6,14,4740,7,653,9920.0,249.0,93.28571428571428,7,4087,9610.666666666666,1514.0,583.8571428571429
218998.0,6,3,426,2,280,0.0,214.0,140.0,1,146,0.0,146.0,146.0
94040393.0,6,40,2640,20,1320,4949494.368421053,66.0,66.0,20,1320,4938113.842105263,66.0,66.0
299758.0,6,6,412,4,272,99919.33333333331,74.0,68.0,2,140,0.0,74.0,70.0
25969.0,6,14,4740,7,653,4132.666666666667,249.0,93.28571428571428,7,4087,4132.0,1514.0,583.8571428571429
298471.0,6,6,412,4,272,99490.33333333331,74.0,68.0,2,140,0.0,74.0,70.0
119337474.0,6,271,30822,136,21616,883981.2888888889,284.0,158.94117647058823,135,9206,882809.4029850747,140.0,68.19259259259259
40459.0,6,10,2032,5,524,9604.25,252.0,104.8,5,1508,7502.0,1236.0,301.6
102770.0,17,2,286,2,286,0.0,143.0,143.0,0,0,0.0,0.0,0.0
281757.0,17,4,1400,4,1400,93919.0,350.0,350.0,0,0,0.0,0.0,0.0
2390.0,17,4,344,2,150,0.0,75.0,75.0,2,194,0.0,103.0,97.0
9669.0,17,2,571,1,86,0.0,86.0,86.0,1,485,0.0,485.0,485.0
10485137.0,6,7,478,4,272,3447984.6666666665,74.0,68.0,3,206,5171869.0,74.0,68.66666666666667
347.0,17,2,250,1,93,0.0,93.0,93.0,1,157,0.0,157.0,157.0
18122.0,6,14,4740,7,653,2862.833333333333,249.0,93.28571428571428,7,4087,2880.1666666666665,1514.0,583.8571428571429
108101638.0,17,5,1005,5,1005,27025409.5,201.0,201.0,0,0,0.0,0.0,0.0
90049859.0,17,28,13364,28,13364,3335179.962962963,501.0,477.2857142857143,0,0,0.0,0.0,0.0
90047222.0,17,28,13364,28,13364,3335082.296296296,501.0,477.2857142857143,0,0,0.0,0.0,0.0
63153.0,6,10,2032,5,524,14635.5,252.0,104.8,5,1508,15236.25,1236.0,301.6
2936276.0,6,4,264,4,264,978758.6666666666,66.0,66.0,0,0,0.0,0.0,0.0
147922.0,17,2,180,1,90,0.0,90.0,90.0,1,90,0.0,90.0,90.0
51932.0,6,10,2032,5,524,12772.25,252.0,104.8,5,1508,12530.75,1236.0,301.6
35111.0,6,14,4740,7,653,5725.333333333333,249.0,93.28571428571428,7,4087,5015.833333333333,1514.0,583.8571428571429
110575.0,17,2,286,2,286,0.0,143.0,143.0,0,0,0.0,0.0,0.0
2036.0,17,4,344,2,150,0.0,75.0,75.0,2,194,0.0,103.0,97.0
284211.0,17,4,704,2,148,0.0,74.0,74.0,2,556,0.0,280.0,278.0
83244.0,17,2,762,2,762,0.0,381.0,381.0,0,0,0.0,0.0,0.0
222060.0,6,3,426,2,280,0.0,214.0,140.0,1,146,0.0,146.0,146.0
4928.0,17,4,704,2,148,0.0,74.0,74.0,2,556,0.0,280.0,278.0
204656.0,17,2,762,2,762,0.0,381.0,381.0,0,0,0.0,0.0,0.0
77.0,17,2,762,2,762,0.0,381.0,381.0,0,0,0.0,0.0,0.0
30728.0,6,10,2032,5,524,7406.25,252.0,104.8,5,1508,7121.25,1236.0,301.6
2805697.0,6,2,132,1,66,0.0,66.0,66.0,1,66,0.0,66.0,66.0
611778.0,17,2,473,1,78,0.0,78.0,78.0,1,395,0.0,395.0,395.0
120067377.0,17,29,13785,29,13785,4288120.607142857,501.0,475.3448275862069,0,0,0.0,0.0,0.0
228499.0,17,2,180,1,90,0.0,90.0,90.0,1,90,0.0,90.0,90.0
108101919.0,17,5,955,5,955,27025479.75,191.0,191.0,0,0,0.0,0.0,0.0
1388631.0,17,16,1120,16,1120,92575.4,70.0,70.0,0,0,0.0,0.0,0.0
205377.0,17,2,762,2,762,0.0,381.0,381.0,0,0,0.0,0.0,0.0
12913.0,6,10,1949,5,441,3002.5,169.0,88.2,5,1508,2641.5,1236.0,301.6
27997.0,6,14,4740,7,653,4541.166666666667,249.0,93.28571428571428,7,4087,4526.833333333333,1514.0,583.8571428571429
110461903.0,6,30,1974,15,1026,7874722.928571428,123.0,68.4,15,948,7874717.071428572,123.0,63.2
124027.0,6,10,1066,5,490,30588.0,218.0,98.0,5,576,30586.75,304.0,115.2
14663.0,6,11,1132,6,556,2881.8,218.0,92.66666666666669,5,576,3404.5,304.0,115.2
103623.0,17,2,286,2,286,0.0,143.0,143.0,0,0,0.0,0.0,0.0
2334.0,17,4,344,2,150,0.0,75.0,75.0,2,194,0.0,103.0,97.0
27657317.0,17,5,1710,5,1710,6914329.25,342.0,342.0,0,0,0.0,0.0,0.0
90023684.0,17,27,12943,27,12943,3462449.3846153845,501.0,479.3703703703704,0,0,0.0,0.0,0.0
318.0,17,2,174,1,79,0.0,79.0,79.0,1,95,0.0,95.0,95.0
308697.0,6,6,412,4,272,102899.0,74.0,68.0,2,140,0.0,74.0,70.0
94432975.0,6,40,2640,20,1320,4970156.578947368,66.0,66.0,20,1320,4955647.263157895,66.0,66.0
22190.0,6,12,1320,6,723,4172.6,253.0,120.5,6,597,3822.2,259.0,99.5
300085.0,6,6,412,4,272,100028.33333333331,74.0,68.0,2,140,0.0,74.0,70.0
162288.0,17,2,180,1,90,0.0,90.0,90.0,1,90,0.0,90.0,90.0
218879.0,6,10,1221,6,636,43775.8,298.0,106.0,4,585,71610.0,379.0,146.25
277137.0,17,2,359,1,75,0.0,75.0,75.0,1,284,0.0,284.0,284.0
860638.0,6,9,1269,6,798,172127.6,460.0,133.0,3,471,294013.5,331.0,157.0
228279.0,17,2,180,1,90,0.0,90.0,90.0,1,90,0.0,90.0,90.0
7138.0,17,2,582,1,83,0.0,83.0,83.0,1,499,0.0,499.0,499.0
209816.0,17,2,180,1,90,0.0,90.0,90.0,1,90,0.0,90.0,90.0
107903807.0,6,28,1860,14,966,8300292.846153846,123.0,69.0,14,894,8284492.692307692,123.0,63.85714285714285
2371.0,17,4,344,2,150,0.0,75.0,75.0,2,194,0.0,103.0,97.0
73996.0,6,11,2098,6,590,14286.4,252.0,98.33333333333331,5,1508,18173.0,1236.0,301.6
3173645.0,6,18,1536,9,962,358348.5,315.0,106.88888888888889,9,574,358314.875,78.0,63.77777777777778
111192.0,17,2,286,2,286,0.0,143.0,143.0,0,0,0.0,0.0,0.0
146181.0,6,3,337,2,214,0.0,160.0,107.0,1,123,0.0,123.0,123.0
44408.0,6,14,4740,7,653,7047.333333333333,249.0,93.28571428571428,7,4087,6764.5,1514.0,583.8571428571429
2041244.0,6,23,7478,12,2450,185567.63636363635,1034.0,204.16666666666663,11,5028,173726.0,1510.0,457.09090909090907
100574937.0,6,27,1816,14,894,7736533.615384615,123.0,63.85714285714285,13,922,7846857.083333333,139.0,70.92307692307692
228569.0,17,2,180,1,90,0.0,90.0,90.0,1,90,0.0,90.0,90.0
15117.0,17,2,180,1,90,0.0,90.0,90.0,1,90,0.0,90.0,90.0
1776804.0,6,2,132,1,66,0.0,66.0,66.0,1,66,0.0,66.0,66.0
343.0,17,2,267,1,83,0.0,83.0,83.0,1,184,0.0,184.0,184.0
90690052.0,6,22,1680,10,745,10048788.888888888,95.0,74.5,12,935,8224988.181818182,95.0,77.91666666666667
319.0,17,2,174,1,79,0.0,79.0,79.0,1,95,0.0,95.0,95.0
1761320.0,6,2,132,1,66,0.0,66.0,66.0,1,66,0.0,66.0,66.0
2376.0,17,4,344,2,150,0.0,75.0,75.0,2,194,0.0,103.0,97.0
35282.0,6,14,4740,7,653,5753.666666666667,249.0,93.28571428571428,7,4087,5662.666666666667,1514.0,583.8571428571429
13092.0,17,2,180,1,90,0.0,90.0,90.0,1,90,0.0,90.0,90.0
135139952.0,17,6,1206,6,1206,27027990.4,201.0,201.0,0,0,0.0,0.0,0.0
3009130.0,6,11,2106,6,598,601655.6,252.0,99.66666666666669,5,1508,2071.75,1236.0,301.6
55484.0,6,10,2032,5,524,12140.0,252.0,104.8,5,1508,9717.0,1236.0,301.6
26139.0,6,14,4740,7,653,4162.333333333333,249.0,93.28571428571428,7,4087,4185.0,1514.0,583.8571428571429
149684.0,17,2,180,1,90,0.0,90.0,90.0,1,90,0.0,90.0,90.0
153431.0,17,2,180,1,90,0.0,90.0,90.0,1,90,0.0,90.0,90.0
1936452.0,6,4,492,2,280,0.0,214.0,140.0,2,212,0.0,146.0,106.0
159660.0,6,3,337,2,214,0.0,160.0,107.0,1,123,0.0,123.0,123.0
108108382.0,17,5,955,5,955,27027095.5,191.0,191.0,0,0,0.0,0.0,0.0
116190980.0,6,47,3102,24,1584,5039954.304347826,66.0,66.0,23,1518,5135384.0,66.0,66.0
1382381.0,6,22,7112,12,2973,125671.0,1514.0,247.75,10,4139,128024.77777777778,1514.0,413.9
135127808.0,17,6,1206,6,1206,27025561.6,201.0,201.0,0,0,0.0,0.0,0.0
311211.0,6,6,412,4,272,103737.0,74.0,68.0,2,140,0.0,74.0,70.0
347765.0,17,2,180,1,90,0.0,90.0,90.0,1,90,0.0,90.0,90.0
50888.0,17,2,180,1,90,0.0,90.0,90.0,1,90,0.0,90.0,90.0
515333.00000000006,6,5,336,2,134,0.0,68.0,67.0,3,202,192208.0,70.0,67.33333333333333
1315790.0,6,4,264,2,132,0.0,66.0,66.0,2,132,0.0,66.0,66.0
2707637.0,6,2,132,1,66,0.0,66.0,66.0,1,66,0.0,66.0,66.0
14575.0,6,11,2098,6,590,2647.4,252.0,98.33333333333331,5,1508,3383.5,1236.0,301.6
1000841.0,6,13,1428,7,797,165499.83333333334,253.0,113.85714285714286,6,631,198568.2,293.0,105.16666666666669
90258476.0,6,13,2036,8,1016,12894068.0,188.0,127.0,5,1020,22522478.0,204.0,204.0
246035.0,6,3,337,2,214,0.0,160.0,107.0,1,123,0.0,123.0,123.0
115223274.0,6,737,104664,369,24576,313106.722826087,140.0,66.60162601626017,368,80088,313351.6485013624,480.0,217.6304347826087
216957.0,6,3,426,2,280,0.0,214.0,140.0,1,146,0.0,146.0,146.0
305370.0,6,6,412,4,272,101790.0,74.0,68.0,2,140,0.0,74.0,70.0
112396974.0,6,35,2526,18,1332,6611586.705882353,123.0,74.0,17,1194,7011271.9375,123.0,70.23529411764706
415126.0,17,2,176,1,80,0.0,80.0,80.0,1,96,0.0,96.0,96.0
108115424.0,17,5,955,5,955,27028856.0,191.0,191.0,0,0,0.0,0.0,0.0
90305017.0,6,16,1192,8,596,12893679.57142857,95.0,74.5,8,596,12899484.714285716,95.0,74.5
1800569.0,6,7,499,4,301,592412.0,103.0,75.25,3,198,817957.5,66.0,66.0
4618.0,17,4,344,2,150,0.0,75.0,75.0,2,194,0.0,103.0,97.0
90031183.0,17,28,13364,28,13364,3334488.25925926,501.0,477.2857142857143,0,0,0.0,0.0,0.0
25198.0,6,10,2032,5,524,6075.75,252.0,104.8,5,1508,6023.0,1236.0,301.6
188073.0,6,10,1066,5,490,46446.0,218.0,98.0,5,576,46393.75,304.0,115.2
103726981.0,6,27,1816,14,894,7978998.538461538,123.0,63.85714285714285,13,922,7793795.416666667,139.0,70.92307692307692
90285277.0,6,16,1192,8,596,12892221.285714284,95.0,74.5,8,596,12896553.57142857,95.0,74.5
2167832.0,6,3,204,2,136,0.0,70.0,68.0,1,68,0.0,68.0,68.0
315701.0,17,4,1400,4,1400,105233.66666666669,350.0,350.0,0,0,0.0,0.0,0.0
108108596.0,17,5,955,5,955,27027149.0,191.0,191.0,0,0,0.0,0.0,0.0
68390.0,6,10,2032,5,524,16654.25,252.0,104.8,5,1508,16211.5,1236.0,301.6
148927.0,6,3,373,2,238,0.0,172.0,119.0,1,135,0.0,135.0,135.0
45526.0,6,14,4740,7,653,7466.5,249.0,93.28571428571428,7,4087,5998.166666666667,1514.0,583.8571428571429
48260.0,6,14,4740,7,653,7437.333333333333,249.0,93.28571428571428,7,4087,7903.5,1514.0,583.8571428571429
0.0,6,1,66,1,66,0.0,66.0,66.0,0,0,0.0,0.0,0.0
90022024.0,17,28,13364,28,13364,3334149.037037037,501.0,477.2857142857143,0,0,0.0,0.0,0.0
246024.0,6,3,337,2,214,0.0,160.0,107.0,1,123,0.0,123.0,123.0
104555.0,17,2,286,2,286,0.0,143.0,143.0,0,0,0.0,0.0,0.0
0.0,6,1,54,0,0,0.0,0.0,0.0,1,54,0.0,54.0,54.0
58347.0,6,14,4740,7,653,8518.333333333334,249.0,93.28571428571428,7,4087,9267.333333333334,1514.0,583.8571428571429
3134.0,17,4,344,2,150,0.0,75.0,75.0,2,194,0.0,103.0,97.0
106998.0,17,2,286,2,286,0.0,143.0,143.0,0,0,0.0,0.0,0.0
115184396.0,17,14,1126,7,563,19170779.166666668,174.0,80.42857142857143,7,563,19170779.83333333,174.0,80.42857142857143
2068.0,17,4,344,2,150,0.0,75.0,75.0,2,194,0.0,103.0,97.0
299674.0,6,6,412,4,272,99891.33333333331,74.0,68.0,2,140,0.0,74.0,70.0
302682.0,6,6,412,4,272,100894.0,74.0,68.0,2,140,0.0,74.0,70.0
105901.0,17,2,700,2,700,0.0,350.0,350.0,0,0,0.0,0.0,0.0
1900.0,17,2,176,1,80,0.0,80.0,80.0,1,96,0.0,96.0,96.0
30170.0,6,14,4740,7,653,4200.333333333333,249.0,93.28571428571428,7,4087,4791.833333333333,1514.0,583.8571428571429
114624748.0,6,35,2542,18,1348,6729921.352941177,139.0,74.88888888888889,17,1194,7150478.625,123.0,70.23529411764706
40760.0,6,14,4740,7,653,6264.833333333333,249.0,93.28571428571428,7,4087,6605.833333333333,1514.0,583.8571428571429
214577.0,6,10,1221,6,636,42915.4,298.0,106.0,4,585,70281.33333333333,379.0,146.25
13610149.0,6,20,1648,10,1016,1478430.888888889,315.0,101.6,10,632,1478400.5555555555,78.0,63.2
412659.0,17,2,363,1,75,0.0,75.0,75.0,1,288,0.0,288.0,288.0
196938.0,17,2,180,1,90,0.0,90.0,90.0,1,90,0.0,90.0,90.0
6485.0,17,2,463,1,84,0.0,84.0,84.0,1,379,0.0,379.0,379.0
234603.0,6,3,337,2,214,0.0,160.0,107.0,1,123,0.0,123.0,123.0
58553.0,6,14,4740,7,653,9634.166666666666,249.0,93.28571428571428,7,4087,7907.166666666667,1514.0,583.8571428571429
310883.0,6,6,412,4,272,103627.66666666669,74.0,68.0,2,140,0.0,74.0,70.0
0.0,17,1,90,1,90,0.0,90.0,90.0,0,0,0.0,0.0,0.0
90041930.0,17,28,13364,28,13364,3334886.296296296,501.0,477.2857142857143,0,0,0.0,0.0,0.0
7001.0,17,2,582,1,83,0.0,83.0,83.0,1,499,0.0,499.0,499.0
307598.0,6,6,412,4,272,102532.66666666669,74.0,68.0,2,140,0.0,74.0,70.0
179787.0,17,2,180,1,90,0.0,90.0,90.0,1,90,0.0,90.0,90.0
157816.0,6,3,337,2,214,0.0,160.0,107.0,1,123,0.0,123.0,123.0
24707.0,6,14,4740,7,653,3995.5,249.0,93.28571428571428,7,4087,3983.0,1514.0,583.8571428571429
863780.0,6,9,1270,6,799,172756.0,461.0,133.16666666666666,3,471,295633.5,331.0,157.0
110951735.0,6,36,2734,19,1471,6151653.722222222,139.0,77.42105263157895,17,1263,6920609.5,123.0,74.29411764705883
10430586.0,6,6,412,3,206,5147443.0,74.0,68.66666666666667,3,206,5147324.0,74.0,68.66666666666667
33991.0,6,14,4740,7,653,4801.666666666667,249.0,93.28571428571428,7,4087,5482.666666666667,1514.0,583.8571428571429
90254517.0,6,13,2036,8,1016,12893502.42857143,188.0,127.0,5,1020,22522746.5,204.0,204.0
221026.0,6,3,426,2,280,0.0,214.0,140.0,1,146,0.0,146.0,146.0
40649.0,6,2,132,1,66,0.0,66.0,66.0,1,66,0.0,66.0,66.0
48930.0,6,14,4740,7,653,8031.666666666667,249.0,93.28571428571428,7,4087,7551.5,1514.0,583.8571428571429
216437.0,17,2,180,1,90,0.0,90.0,90.0,1,90,0.0,90.0,90.0
90282798.0,6,16,1192,8,596,12891170.142857144,95.0,74.5,8,596,12895943.857142856,95.0,74.5
32117.0,6,14,4740,7,653,5092.0,249.0,93.28571428571428,7,4087,4758.833333333333,1514.0,583.8571428571429
120231925.0,6,19,1395,10,745,13332316.222222222,95.0,74.5,9,650,14997497.0,95.0,72.22222222222223
146235.0,6,3,337,2,214,0.0,160.0,107.0,1,123,0.0,123.0,123.0
22489.0,6,10,2032,5,524,5077.5,252.0,104.8,5,1508,5051.75,1236.0,301.6
90094564.0,6,11,1644,4,816,30030758.33333333,204.0,204.0,7,828,15015367.333333334,188.0,118.28571428571428
155142.0,6,3,337,2,214,0.0,160.0,107.0,1,123,0.0,123.0,123.0
197061.0,17,2,180,1,90,0.0,90.0,90.0,1,90,0.0,90.0,90.0
42444.0,6,14,4740,7,653,6959.0,249.0,93.28571428571428,7,4087,5389.833333333333,1514.0,583.8571428571429
13640696.0,17,6,2052,6,2052,2728139.2,342.0,342.0,0,0,0.0,0.0,0.0
206283.0,6,3,426,2,280,0.0,214.0,140.0,1,146,0.0,146.0,146.0
143854.0,17,2,180,1,90,0.0,90.0,90.0,1,90,0.0,90.0,90.0
320857.0,17,4,1400,4,1400,106952.33333333331,350.0,350.0,0,0,0.0,0.0,0.0
5157.0,17,4,344,2,150,0.0,75.0,75.0,2,194,0.0,103.0,97.0
2805607.0,6,2,132,1,66,0.0,66.0,66.0,1,66,0.0,66.0,66.0
1065675.0,6,3,1604,2,851,0.0,785.0,425.5,1,753,0.0,753.0,753.0
329.0,17,2,208,1,72,0.0,72.0,72.0,1,136,0.0,136.0,136.0
56652.0,6,14,4740,7,653,9314.833333333334,249.0,93.28571428571428,7,4087,8017.833333333333,1514.0,583.8571428571429
105788377.0,6,201,22804,101,6962,1057883.77,140.0,68.93069306930693,100,15842,1058436.202020202,284.0,158.42
93137522.0,6,176,19962,88,13932,1068195.264367816,284.0,158.3181818181818,88,6030,1068196.2988505748,140.0,68.52272727272727
166431.0,17,2,180,1,90,0.0,90.0,90.0,1,90,0.0,90.0,90.0
120239329.0,6,234,26438,117,8018,1029424.7155172414,140.0,68.52991452991454,117,18420,1029376.4655172414,284.0,157.43589743589743
104384.0,17,2,700,2,700,0.0,350.0,350.0,0,0,0.0,0.0,0.0
241389.0,17,4,1524,4,1524,80463.0,381.0,381.0,0,0,0.0,0.0,0.0
16764.0,17,2,180,1,90,0.0,90.0,90.0,1,90,0.0,90.0,90.0
19387.0,6,10,2032,5,524,4629.0,252.0,104.8,5,1508,4616.5,1236.0,301.6
90092247.0,6,12,1848,5,1020,22522810.0,204.0,204.0,7,828,15015209.5,188.0,118.28571428571428
30958.0,6,10,2032,5,524,7514.75,252.0,104.8,5,1508,6665.5,1236.0,301.6
330.0,17,2,208,1,72,0.0,72.0,72.0,1,136,0.0,136.0,136.0
2839322.0,6,11,2106,6,598,567632.8,252.0,99.66666666666669,5,1508,3873.75,1236.0,301.6
135127810.0,17,6,1146,6,1146,27025562.0,191.0,191.0,0,0,0.0,0.0,0.0
1313939.0,6,4,264,2,132,0.0,66.0,66.0,2,132,0.0,66.0,66.0
302560.0,6,6,412,4,272,100853.33333333331,74.0,68.0,2,140,0.0,74.0,70.0
143915.0,17,2,180,1,90,0.0,90.0,90.0,1,90,0.0,90.0,90.0
90041427.0,17,28,13364,28,13364,3334867.6666666665,501.0,477.2857142857143,0,0,0.0,0.0,0.0
588326.0,6,4,508,2,238,0.0,172.0,119.0,2,270,0.0,135.0,135.0
143606.0,17,4,344,2,150,0.0,75.0,75.0,2,194,0.0,103.0,97.0
121502808.0,6,221,24912,111,17356,1104570.981818182,284.0,156.36036036036035,110,7556,1095611.7981651376,140.0,68.69090909090909
121391.0,6,3,337,2,214,0.0,160.0,107.0,1,123,0.0,123.0,123.0
43051.0,6,14,4740,7,653,6968.0,249.0,93.28571428571428,7,4087,6950.5,1514.0,583.8571428571429
120121378.0,6,16,2632,9,1204,15015172.25,188.0,133.77777777777777,7,1428,15017176.666666666,204.0,204.0
92853658.0,6,175,19604,88,6030,1067283.4252873564,140.0,68.52272727272727,87,13574,1067781.6279069767,284.0,156.02298850574712
103140.0,17,2,286,2,286,0.0,143.0,143.0,0,0,0.0,0.0,0.0
138430.0,6,2,132,1,66,0.0,66.0,66.0,1,66,0.0,66.0,66.0
233416.0,6,3,337,2,214,0.0,160.0,107.0,1,123,0.0,123.0,123.0
135139900.0,17,6,1206,6,1206,27027980.0,201.0,201.0,0,0,0.0,0.0,0.0
37082.0,6,14,4740,7,653,6027.833333333333,249.0,93.28571428571428,7,4087,5871.5,1514.0,583.8571428571429
304144.0,6,6,412,4,272,101381.33333333331,74.0,68.0,2,140,0.0,74.0,70.0
92037371.0,17,12,778,6,389,18407474.2,174.0,64.83333333333333,6,389,18353783.6,174.0,64.83333333333333
106794.0,17,2,286,2,286,0.0,143.0,143.0,0,0,0.0,0.0,0.0
2965.0,17,2,224,1,76,0.0,76.0,76.0,1,148,0.0,148.0,148.0
3052332.0,6,5,336,2,134,0.0,68.0,67.0,3,202,1526166.0,70.0,67.33333333333333
37873.0,6,10,2032,5,524,9152.25,252.0,104.8,5,1508,9117.0,1236.0,301.6
304590.0,17,4,571,2,148,0.0,74.0,74.0,2,423,0.0,280.0,211.5
441911.0,17,2,363,1,79,0.0,79.0,79.0,1,284,0.0,284.0,284.0
98447455.0,6,25,1692,13,906,8185962.25,123.0,69.6923076923077,12,786,8930145.727272727,123.0,65.5
137001157.0,17,15,907,8,475,19571593.85714286,174.0,59.375,7,432,19502405.33333333,174.0,61.71428571428572
32317.0,6,14,4740,7,653,4982.333333333333,249.0,93.28571428571428,7,4087,4427.166666666667,1514.0,583.8571428571429
10242.0,17,4,823,2,163,0.0,89.0,81.5,2,660,0.0,443.0,330.0
108097322.0,17,5,1005,5,1005,27024330.5,201.0,201.0,0,0,0.0,0.0,0.0
37329.0,6,14,4740,7,653,6098.5,249.0,93.28571428571428,7,4087,6082.166666666667,1514.0,583.8571428571429
217295.0,6,3,426,2,280,0.0,214.0,140.0,1,146,0.0,146.0,146.0
2511542.0,6,11,1979,6,527,502112.2,233.0,87.83333333333333,5,1452,3488.75,1224.0,290.4
319508.0,17,4,1400,4,1400,106502.66666666669,350.0,350.0,0,0,0.0,0.0,0.0
39992.0,6,14,4740,7,653,6536.333333333333,249.0,93.28571428571428,7,4087,6427.5,1514.0,583.8571428571429
27743.0,6,14,4740,7,653,4054.5,249.0,93.28571428571428,7,4087,4335.833333333333,1514.0,583.8571428571429
10914327.0,6,8,544,4,272,3592763.333333333,74.0,68.0,4,272,3592708.333333333,74.0,68.0
322353.0,6,6,412,4,272,107451.0,74.0,68.0,2,140,0.0,74.0,70.0
108102481.0,17,5,955,5,955,27025620.25,191.0,191.0,0,0,0.0,0.0,0.0
90001982.0,17,28,13364,28,13364,3333406.7407407407,501.0,477.2857142857143,0,0,0.0,0.0,0.0
312725.0,17,4,1400,4,1400,104241.66666666669,350.0,350.0,0,0,0.0,0.0,0.0
237169.0,6,3,337,2,214,0.0,160.0,107.0,1,123,0.0,123.0,123.0
90281842.0,6,16,1192,8,596,12890998.285714284,95.0,74.5,8,596,12896148.285714284,95.0,74.5
710594.0,6,5,336,2,134,0.0,68.0,67.0,3,202,196624.0,70.0,67.33333333333333
1019858.0,6,11,1134,6,558,203971.6,220.0,93.0,5,576,254319.25,304.0,115.2
1791437.0,17,2,876,2,876,0.0,438.0,438.0,0,0,0.0,0.0,0.0
935.0,17,5,550,5,550,233.75,110.0,110.0,0,0,0.0,0.0,0.0
160523.0,6,3,337,2,214,0.0,160.0,107.0,1,123,0.0,123.0,123.0
103118.0,17,2,286,2,286,0.0,143.0,143.0,0,0,0.0,0.0,0.0
108107650.0,17,5,1005,5,1005,27026912.5,201.0,201.0,0,0,0.0,0.0,0.0
90577524.0,6,15,2444,8,1016,12939646.285714284,188.0,127.0,7,1428,15065314.666666666,204.0,204.0
8614.0,17,4,823,2,163,0.0,89.0,81.5,2,660,0.0,443.0,330.0
68641.0,6,14,4740,7,653,7914.666666666667,249.0,93.28571428571428,7,4087,11294.666666666666,1514.0,583.8571428571429
299031.0,6,6,412,4,272,99677.0,74.0,68.0,2,140,0.0,74.0,70.0
5004050.0,17,4,849,2,166,0.0,83.0,83.0,2,683,0.0,499.0,341.5
20134.0,17,2,582,1,83,0.0,83.0,83.0,1,499,0.0,499.0,499.0
123009009.0,17,15,907,8,475,17572715.57142857,174.0,59.375,7,432,17166831.5,174.0,61.71428571428572
10970141.0,6,8,544,4,272,3611094.6666666665,74.0,68.0,4,272,3611012.3333333335,74.0,68.0
25836.0,6,14,4740,7,653,4195.333333333333,249.0,93.28571428571428,7,4087,4082.6666666666665,1514.0,583.8571428571429
41949.0,6,14,4740,7,653,6654.333333333333,249.0,93.28571428571428,7,4087,6646.0,1514.0,583.8571428571429
8311864.0,6,26,9161,14,2127,639374.1538461539,408.0,151.92857142857142,12,7034,724366.4545454546,1514.0,586.1666666666666
46295.0,6,10,2032,5,524,11220.5,252.0,104.8,5,1508,10177.0,1236.0,301.6
61637.0,6,10,2032,5,524,15176.0,252.0,104.8,5,1508,14164.25,1236.0,301.6
5830635.0,6,4,270,2,134,0.0,68.0,67.0,2,136,0.0,70.0,68.0
63208.0,6,14,4740,7,653,10060.833333333334,249.0,93.28571428571428,7,4087,7480.5,1514.0,583.8571428571429
2051067.0,17,8,1640,4,312,683562.6666666667,78.0,78.0,4,1328,683549.0,332.0,332.0
193278.0,17,4,6056,4,6056,64426.0,1514.0,1514.0,0,0,0.0,0.0,0.0
41760.0,6,10,2032,5,524,10238.5,252.0,104.8,5,1508,9416.25,1236.0,301.6
307034.0,6,7,478,4,272,102344.66666666669,74.0,68.0,3,206,77281.5,74.0,68.66666666666667
215145.0,6,12,1373,7,714,35857.5,298.0,102.0,5,659,52817.25,379.0,131.8
319174.0,17,4,1400,4,1400,106391.33333333331,350.0,350.0,0,0,0.0,0.0,0.0
299170.0,6,6,412,4,272,99723.33333333331,74.0,68.0,2,140,0.0,74.0,70.0
135134373.0,17,6,1146,6,1146,27026874.6,191.0,191.0,0,0,0.0,0.0,0.0
114570431.0,6,216,24456,108,17106,1068740.1495327102,284.0,158.38888888888889,108,7350,1068740.0841121494,140.0,68.05555555555556
321.0,17,2,174,1,79,0.0,79.0,79.0,1,95,0.0,95.0,95.0
332172.0,17,2,180,1,90,0.0,90.0,90.0,1,90,0.0,90.0,90.0
255822.0,6,3,337,2,214,0.0,160.0,107.0,1,123,0.0,123.0,123.0
4100.0,17,2,363,1,79,0.0,79.0,79.0,1,284,0.0,284.0,284.0
106138787.0,17,14,864,7,432,17666855.0,174.0,61.71428571428572,7,432,17669098.833333332,174.0,61.71428571428572
105701.0,17,2,700,2,700,0.0,350.0,350.0,0,0,0.0,0.0,0.0
84470.0,6,14,4740,7,653,13881.166666666666,249.0,93.28571428571428,7,4087,13825.5,1514.0,583.8571428571429
27358088.0,6,5,1736,2,819,0.0,753.0,409.5,3,917,13604907.0,785.0,305.6666666666667
197136.0,17,2,180,1,90,0.0,90.0,90.0,1,90,0.0,90.0,90.0
2996010.0,17,2,906,2,906,0.0,453.0,453.0,0,0,0.0,0.0,0.0
20746.0,17,2,582,1,83,0.0,83.0,83.0,1,499,0.0,499.0,499.0
108111181.0,17,5,955,5,955,27027795.25,191.0,191.0,0,0,0.0,0.0,0.0
112809024.0,6,48,3168,24,1584,4904740.173913044,66.0,66.0,24,1584,4895339.913043479,66.0,66.0
90688256.0,6,15,2302,9,1204,11316076.25,188.0,133.77777777777777,6,1098,18104630.2,204.0,183.0
9679.0,17,4,823,2,163,0.0,89.0,81.5,2,660,0.0,443.0,330.0
30606.0,6,10,2032,5,524,7418.0,252.0,104.8,5,1508,7323.0,1236.0,301.6
940.0,17,5,550,5,550,235.0,110.0,110.0,0,0,0.0,0.0,0.0
110092.0,17,2,286,2,286,0.0,143.0,143.0,0,0,0.0,0.0,0.0
0.0,17,1,342,1,342,0.0,342.0,342.0,0,0,0.0,0.0,0.0
2499773.0,6,3,1604,2,851,0.0,785.0,425.5,1,753,0.0,753.0,753.0
2133113.0,6,19,6869,10,1501,237012.5555555556,408.0,150.1,9,5368,218208.75,1514.0,596.4444444444445
366.0,17,2,174,1,79,0.0,79.0,79.0,1,95,0.0,95.0,95.0
90252102.0,6,14,2240,8,1016,12893157.42857143,188.0,127.0,6,1224,18017956.2,204.0,204.0
294039.0,17,2,363,1,79,0.0,79.0,79.0,1,284,0.0,284.0,284.0
0.0,17,1,350,1,350,0.0,350.0,350.0,0,0,0.0,0.0,0.0
1975.0,17,4,344,2,150,0.0,75.0,75.0,2,194,0.0,103.0,97.0
296209.0,17,2,224,1,76,0.0,76.0,76.0,1,148,0.0,148.0,148.0
14669093.0,6,20,1607,10,975,1592926.5555555555,315.0,97.5,10,632,1593142.111111111,78.0,63.2
160914.0,17,2,180,1,90,0.0,90.0,90.0,1,90,0.0,90.0,90.0
47881.0,6,14,4740,7,653,7860.166666666667,249.0,93.28571428571428,7,4087,7317.333333333333,1514.0,583.8571428571429
279903.0,6,10,1221,6,636,55980.6,298.0,106.0,4,585,87708.33333333333,379.0,146.25
58310.0,6,14,4740,7,653,9479.0,249.0,93.28571428571428,7,4087,9203.833333333334,1514.0,583.8571428571429
108119833.0,17,5,955,5,955,27029958.25,191.0,191.0,0,0,0.0,0.0,0.0
56411.0,6,14,4740,7,653,9224.666666666666,249.0,93.28571428571428,7,4087,6444.666666666667,1514.0,583.8571428571429
2639675.0,6,25,7573,14,3735,203051.92307692303,1514.0,266.7857142857143,11,3838,238506.4,1514.0,348.90909090909093
197112.0,17,2,180,1,90,0.0,90.0,90.0,1,90,0.0,90.0,90.0
32848.0,6,14,4740,7,653,5303.833333333333,249.0,93.28571428571428,7,4087,5264.333333333333,1514.0,583.8571428571429
117103273.0,6,224,25274,112,7688,1047341.8918918918,140.0,68.64285714285714,112,17586,1038230.5945945946,284.0,157.01785714285714
2384.0,17,2,762,2,762,0.0,381.0,381.0,0,0,0.0,0.0,0.0
197200.0,17,2,180,1,90,0.0,90.0,90.0,1,90,0.0,90.0,90.0
64323.00000000001,6,10,2032,5,524,15323.75,252.0,104.8,5,1508,15778.0,1236.0,301.6
2321.0,17,4,344,2,150,0.0,75.0,75.0,2,194,0.0,103.0,97.0
508394.0,6,5,336,2,134,0.0,68.0,67.0,3,202,194320.5,70.0,67.33333333333333
97629379.0,6,39,2574,20,1320,5138375.052631579,66.0,66.0,19,1254,5143999.111111111,66.0,66.0
313909.0,17,4,1400,4,1400,104636.33333333331,350.0,350.0,0,0,0.0,0.0,0.0
28635.0,6,10,2032,5,524,5809.5,252.0,104.8,5,1508,6866.75,1236.0,301.6
283108.0,6,12,1373,7,714,47184.66666666666,298.0,102.0,5,659,60341.0,379.0,131.8
32768.0,6,10,2032,5,524,7771.5,252.0,104.8,5,1508,7266.25,1236.0,301.6
108111622.0,17,5,955,5,955,27027905.5,191.0,191.0,0,0,0.0,0.0,0.0
108108953.0,17,5,955,5,955,27027238.25,191.0,191.0,0,0,0.0,0.0,0.0
93436635.0,17,12,778,6,389,18600193.2,174.0,64.83333333333333,6,389,18600841.4,174.0,64.83333333333333
119990029.0,6,17,1246,9,650,14998753.625,95.0,72.22222222222223,8,596,12853015.857142856,95.0,74.5
143893.0,17,2,180,1,90,0.0,90.0,90.0,1,90,0.0,90.0,90.0
207661.0,6,3,426,2,280,0.0,214.0,140.0,1,146,0.0,146.0,146.0
135130877.0,17,6,1146,6,1146,27026175.4,191.0,191.0,0,0,0.0,0.0,0.0
3180518.0,6,3,1604,2,851,0.0,785.0,425.5,1,753,0.0,753.0,753.0
107153398.0,6,201,22586,101,6962,1071533.98,140.0,68.93069306930693,100,15624,1071932.5656565656,284.0,156.24
107669.0,17,2,286,2,286,0.0,143.0,143.0,0,0,0.0,0.0,0.0
27618834.0,17,5,1710,5,1710,6904708.5,342.0,342.0,0,0,0.0,0.0,0.0
144904.0,17,2,180,1,70,0.0,70.0,70.0,1,110,0.0,110.0,110.0
120123988.0,6,14,2240,6,1224,24024797.6,204.0,204.0,8,1016,17098318.57142857,188.0,127.0
2718.0,17,2,762,2,762,0.0,381.0,381.0,0,0,0.0,0.0,0.0
1179042.0,6,13,1386,7,789,196507.0,253.0,112.71428571428572,6,597,232259.4,259.0,99.5
23488.0,6,14,4740,7,653,3407.333333333333,249.0,93.28571428571428,7,4087,3778.6666666666665,1514.0,583.8571428571429
40407.0,6,13,1479,7,882,6734.5,291.0,126.0,6,597,7363.4,259.0,99.5
298.0,17,2,174,1,79,0.0,79.0,79.0,1,95,0.0,95.0,95.0
135127037.0,17,6,1146,6,1146,27025407.4,191.0,191.0,0,0,0.0,0.0,0.0
91952716.0,17,16,5472,16,5472,6130181.066666666,342.0,342.0,0,0,0.0,0.0,0.0
1022581.0,6,11,1134,6,558,204516.2,220.0,93.0,5,576,255244.25,304.0,115.2
0.0,17,1,55,1,55,0.0,55.0,55.0,0,0,0.0,0.0,0.0
12700.0,6,10,1065,5,534,2921.0,262.0,106.8,5,531,2858.25,259.0,106.2
54451.0,6,14,4740,7,653,8952.0,249.0,93.28571428571428,7,4087,8890.333333333334,1514.0,583.8571428571429
317046.0,6,10,1221,6,636,63409.2,298.0,106.0,4,585,104681.33333333331,379.0,146.25
90020695.0,17,28,13364,28,13364,3334099.814814815,501.0,477.2857142857143,0,0,0.0,0.0,0.0
535495.0,6,15,4811,7,742,89045.16666666667,230.0,106.0,8,4069,75524.14285714286,1514.0,508.625
57893.0,6,10,2032,5,524,14247.75,252.0,104.8,5,1508,12542.0,1236.0,301.6
247059.0,17,2,180,1,90,0.0,90.0,90.0,1,90,0.0,90.0,90.0
2803168.0,6,2,132,1,66,0.0,66.0,66.0,1,66,0.0,66.0,66.0
90299335.0,6,21,1585,11,840,9025877.0,95.0,76.36363636363636,10,745,9999937.444444444,95.0,74.5
298463.0,6,6,412,4,272,99487.66666666669,74.0,68.0,2,140,0.0,74.0,70.0
153418.0,17,2,180,1,90,0.0,90.0,90.0,1,90,0.0,90.0,90.0
93998724.0,6,179,20266,90,6162,1056165.4382022473,140.0,68.46666666666667,89,14104,1056371.5227272727,374.0,158.47191011235955
90256211.0,6,12,1832,8,1016,12893744.42857143,188.0,127.0,4,816,30031114.33333333,204.0,204.0
36586.0,6,14,4740,7,653,5737.166666666667,249.0,93.28571428571428,7,4087,5934.166666666667,1514.0,583.8571428571429
120034712.0,6,226,25534,113,17780,1069913.4107142857,284.0,157.34513274336285,113,7754,1069913.5089285714,140.0,68.61946902654867
12322.0,6,10,1066,5,490,2917.5,218.0,98.0,5,576,2870.75,304.0,115.2
207874.0,6,3,426,2,280,0.0,214.0,140.0,1,146,0.0,146.0,146.0
32411.000000000004,6,14,4740,7,653,4841.0,249.0,93.28571428571428,7,4087,4796.666666666667,1514.0,583.8571428571429
10997.0,6,10,2032,5,524,2540.25,252.0,104.8,5,1508,2106.0,1236.0,301.6
102881.0,17,2,762,2,762,0.0,381.0,381.0,0,0,0.0,0.0,0.0
14920.0,17,2,180,1,90,0.0,90.0,90.0,1,90,0.0,90.0,90.0
503113.00000000006,6,6,758,3,410,212175.5,172.0,136.66666666666666,3,348,179394.0,135.0,116.0
15378.0,6,10,2032,5,524,3647.25,252.0,104.8,5,1508,3524.5,1236.0,301.6
99852052.0,17,12,778,6,389,19801091.4,174.0,64.83333333333333,6,389,19800160.8,174.0,64.83333333333333
316312.0,6,3,202,2,128,0.0,74.0,64.0,1,74,0.0,74.0,74.0
10519978.0,6,6,412,3,206,5189199.5,74.0,68.66666666666667,3,206,5189140.5,74.0,68.66666666666667
12605.0,6,10,2032,5,524,2767.5,252.0,104.8,5,1508,2922.25,1236.0,301.6
90300700.0,6,16,1192,8,596,12893441.857142856,95.0,74.5,8,596,12898727.285714284,95.0,74.5
10473062.0,6,6,412,3,206,5168029.5,74.0,68.66666666666667,3,206,5167935.0,74.0,68.66666666666667
30177.0,6,11,2098,6,590,5761.6,252.0,98.33333333333331,5,1508,6935.75,1236.0,301.6
25614.0,6,14,4740,7,653,2969.0,249.0,93.28571428571428,7,4087,3502.0,1514.0,583.8571428571429
119255764.0,6,33,2274,17,1125,7453485.25,123.0,66.17647058823529,16,1149,7270388.933333334,123.0,71.8125
228253.0,17,2,180,1,90,0.0,90.0,90.0,1,90,0.0,90.0,90.0
32668.000000000004,6,14,4740,7,653,3901.5,249.0,93.28571428571428,7,4087,5309.5,1514.0,583.8571428571429
219779.0,6,3,426,2,280,0.0,214.0,140.0,1,146,0.0,146.0,146.0
204886.0,17,4,6056,4,6056,68295.33333333333,1514.0,1514.0,0,0,0.0,0.0,0.0
313837.0,6,6,412,4,272,104612.33333333331,74.0,68.0,2,140,0.0,74.0,70.0
563.0,17,5,550,5,550,140.75,110.0,110.0,0,0,0.0,0.0,0.0
319284.0,6,6,412,4,272,106428.0,74.0,68.0,2,140,0.0,74.0,70.0
120122441.0,6,14,2224,9,1204,15015305.125,188.0,133.77777777777777,5,1020,22523380.25,204.0,204.0
119998.0,17,2,180,1,70,0.0,70.0,70.0,1,110,0.0,110.0,110.0
321.0,17,2,166,1,75,0.0,75.0,75.0,1,91,0.0,91.0,91.0
109543207.0,6,40,2800,40,2800,2808800.1794871795,70.0,70.0,0,0,0.0,0.0,0.0
292.0,17,2,174,1,79,0.0,79.0,79.0,1,95,0.0,95.0,95.0
303643.0,6,2,132,1,66,0.0,66.0,66.0,1,66,0.0,66.0,66.0
146056.0,6,3,337,2,214,0.0,160.0,107.0,1,123,0.0,123.0,123.0
33262.0,6,10,2032,5,524,7428.5,252.0,104.8,5,1508,7559.0,1236.0,301.6
2048328.0,17,6,1039,4,312,682645.6666666666,78.0,78.0,2,727,0.0,395.0,363.5
103476.0,17,2,286,2,286,0.0,143.0,143.0,0,0,0.0,0.0,0.0
3009560.0,6,11,2106,6,598,601635.4,252.0,99.66666666666669,5,1508,2399.5,1236.0,301.6
213066.0,17,4,1524,4,1524,71022.0,381.0,381.0,0,0,0.0,0.0,0.0
300.0,17,2,164,1,82,0.0,82.0,82.0,1,82,0.0,82.0,82.0
123843926.0,6,48,3168,24,1584,5035492.434782608,66.0,66.0,24,1584,5262118.0869565215,66.0,66.0
7979.0,17,2,180,1,90,0.0,90.0,90.0,1,90,0.0,90.0,90.0
76769.0,6,10,2032,5,524,16880.5,252.0,104.8,5,1508,16409.25,1236.0,301.6
54589.0,6,12,1328,7,797,9098.166666666666,253.0,113.85714285714286,5,531,11859.0,259.0,106.2
307817.0,6,6,412,4,272,102605.66666666669,74.0,68.0,2,140,0.0,74.0,70.0
204670.0,17,2,762,2,762,0.0,381.0,381.0,0,0,0.0,0.0,0.0
299258.0,6,6,412,4,272,99752.66666666669,74.0,68.0,2,140,0.0,74.0,70.0
104052.0,17,2,286,2,286,0.0,143.0,143.0,0,0,0.0,0.0,0.0
27662688.0,17,5,1710,5,1710,6915672.0,342.0,342.0,0,0,0.0,0.0,0.0
108103809.0,17,5,1005,5,1005,27025952.25,201.0,201.0,0,0,0.0,0.0,0.0
2780876.0,6,2,132,1,66,0.0,66.0,66.0,1,66,0.0,66.0,66.0
105735.0,17,2,700,2,700,0.0,350.0,350.0,0,0,0.0,0.0,0.0
881940.0,6,10,1336,6,799,176388.0,461.0,133.16666666666666,4,537,202026.0,331.0,134.25
53767.0,6,10,2032,5,524,12914.0,252.0,104.8,5,1508,11469.5,1236.0,301.6
10493970.0,6,7,478,4,272,3449928.333333333,74.0,68.0,3,206,5174784.5,74.0,68.66666666666667
119512510.0,6,222,25090,111,17468,1084521.0909090908,284.0,157.36936936936937,111,7622,1084521.2,140.0,68.66666666666667
113495261.0,6,31,2160,16,1071,7566350.733333333,123.0,66.9375,15,1089,7474172.5,123.0,72.6
80762.0,6,14,4740,7,653,13341.833333333334,249.0,93.28571428571428,7,4087,13279.0,1514.0,583.8571428571429
107833.0,17,2,286,2,286,0.0,143.0,143.0,0,0,0.0,0.0,0.0
26928.0,6,14,4740,7,653,4358.5,249.0,93.28571428571428,7,4087,4197.0,1514.0,583.8571428571429
32681215.0,6,5,336,2,134,0.0,68.0,67.0,3,202,14949055.0,70.0,67.33333333333333
146103.0,6,3,337,2,214,0.0,160.0,107.0,1,123,0.0,123.0,123.0
151398.0,17,2,414,1,88,0.0,88.0,88.0,1,326,0.0,326.0,326.0
90048086.0,17,28,13364,28,13364,3335114.296296296,501.0,477.2857142857143,0,0,0.0,0.0,0.0
1314497.0,6,4,264,2,132,0.0,66.0,66.0,2,132,0.0,66.0,66.0
18349.0,6,14,4740,7,653,2932.5,249.0,93.28571428571428,7,4087,2917.6666666666665,1514.0,583.8571428571429
353.0,17,2,267,1,83,0.0,83.0,83.0,1,184,0.0,184.0,184.0
103774.0,17,2,286,2,286,0.0,143.0,143.0,0,0,0.0,0.0,0.0
90743754.0,6,17,1287,9,691,11337594.75,95.0,76.77777777777777,8,596,12961965.142857144,95.0,74.5
146631.0,6,3,337,2,214,0.0,160.0,107.0,1,123,0.0,123.0,123.0
91437528.0,6,24,1829,13,989,7619246.5,95.0,76.07692307692308,11,840,9142741.7,95.0,76.36363636363636
112181786.0,6,32,2220,16,1149,7464381.066666666,123.0,71.8125,16,1071,7464373.6,123.0,66.9375
11625676.0,17,4,1368,4,1368,3875225.3333333335,342.0,342.0,0,0,0.0,0.0,0.0
92710137.0,6,38,2508,19,1254,5135442.611111111,66.0,66.0,19,1254,5135452.888888889,66.0,66.0
119417849.0,6,23,1734,13,989,9947247.083333334,95.0,76.07692307692308,10,745,13265223.444444444,95.0,74.5
114023230.0,6,48,3168,24,1584,4957531.739130435,66.0,66.0,24,1584,4944095.347826087,66.0,66.0
197529.0,17,2,762,2,762,0.0,381.0,381.0,0,0,0.0,0.0,0.0
60642.0,6,12,1320,7,789,10107.0,253.0,112.71428571428572,5,531,10854.25,259.0,106.2
307343.0,6,6,412,4,272,102447.66666666669,74.0,68.0,2,140,0.0,74.0,70.0
90043829.0,17,28,13364,28,13364,3334956.6296296297,501.0,477.2857142857143,0,0,0.0,0.0,0.0
101353398.0,17,14,864,7,432,16833493.166666668,174.0,61.71428571428572,7,432,16835005.0,174.0,61.71428571428572
2413.0,17,2,762,2,762,0.0,381.0,381.0,0,0,0.0,0.0,0.0
110817386.0,6,29,1914,15,948,7915527.571428572,123.0,63.2,14,966,8455036.384615384,123.0,69.0
234409.0,6,3,337,2,214,0.0,160.0,107.0,1,123,0.0,123.0,123.0
118894093.0,6,34,2350,17,1225,7417392.0,139.0,72.05882352941177,17,1125,7417389.875,123.0,66.17647058823529
108112578.0,17,5,955,5,955,27028144.5,191.0,191.0,0,0,0.0,0.0,0.0
3294439.0,17,3,1026,3,1026,1647219.5,342.0,342.0,0,0,0.0,0.0,0.0
58606.0,6,14,4740,7,653,9660.5,249.0,93.28571428571428,7,4087,9627.333333333334,1514.0,583.8571428571429
609705.0,17,4,629,3,234,130224.0,78.0,78.0,1,395,0.0,395.0,395.0
5926.0,17,2,371,1,77,0.0,77.0,77.0,1,294,0.0,294.0,294.0
90913606.0,6,21,1585,11,840,9090781.0,95.0,76.36363636363636,10,745,10100721.777777778,95.0,74.5
10476142.0,6,7,478,4,272,3444975.0,74.0,68.0,3,206,5167356.0,74.0,68.66666666666667
15068.0,17,2,582,1,83,0.0,83.0,83.0,1,499,0.0,499.0,499.0
101177510.0,6,529,66496,265,17712,383248.1439393939,140.0,66.8377358490566,264,48784,382479.5741444867,336.0,184.7878787878788
51079.0,17,2,180,1,90,0.0,90.0,90.0,1,90,0.0,90.0,90.0
143868.0,17,2,180,1,90,0.0,90.0,90.0,1,90,0.0,90.0,90.0
28285119.0,6,529,499360,144,9662,197798.0349650349,204.0,67.09722222222223,385,489698,73644.41666666667,1514.0,1271.942857142857
31752.000000000004,6,10,2032,5,524,7464.5,252.0,104.8,5,1508,7414.0,1236.0,301.6
120120967.0,6,14,2240,8,1016,17136772.85714286,188.0,127.0,6,1224,18018655.4,204.0,204.0
259870.0,6,10,1221,6,636,51974.0,298.0,106.0,4,585,80840.0,379.0,146.25
206017.0,6,3,426,2,280,0.0,214.0,140.0,1,146,0.0,146.0,146.0
109563501.0,6,33,2412,17,1272,6847718.8125,123.0,74.82352941176471,16,1140,7289790.266666667,123.0,71.25
95198753.0,6,222,25354,111,17806,863486.7636363637,284.0,160.4144144144144,111,7548,863487.0818181818,140.0,68.0
24642.0,6,10,2032,5,524,5696.75,252.0,104.8,5,1508,5844.25,1236.0,301.6
17266.0,6,20,7606,11,978,1726.6,310.0,88.9090909090909,9,6628,1887.5,1514.0,736.4444444444445
121876850.0,6,31,2034,16,1086,8125123.333333333,123.0,67.875,15,948,7976907.714285715,123.0,63.2
34113.0,6,14,4740,7,653,5566.5,249.0,93.28571428571428,7,4087,5450.833333333333,1514.0,583.8571428571429
41882.0,6,14,4740,7,653,6328.166666666667,249.0,93.28571428571428,7,4087,6772.333333333333,1514.0,583.8571428571429
41151.0,6,14,4740,7,653,6746.166666666667,249.0,93.28571428571428,7,4087,6720.166666666667,1514.0,583.8571428571429
206164.0,6,3,426,2,280,0.0,214.0,140.0,1,146,0.0,146.0,146.0
135132307.0,17,6,1206,6,1206,27026461.4,201.0,201.0,0,0,0.0,0.0,0.0
103134.0,17,2,286,2,286,0.0,143.0,143.0,0,0,0.0,0.0,0.0
297769.0,6,6,412,4,272,99256.33333333331,74.0,68.0,2,140,0.0,74.0,70.0
95285544.0,6,25,1883,12,894,8662322.181818182,95.0,74.5,13,989,7922260.583333333,95.0,76.07692307692308
120207928.0,6,226,25550,113,7754,1047372.2410714284,140.0,68.61946902654867,113,17796,1067325.857142857,284.0,157.4867256637168
0.0,6,1,172,1,172,0.0,172.0,172.0,0,0,0.0,0.0,0.0
90759181.0,6,22,1680,12,935,8247007.909090909,95.0,77.91666666666667,10,745,9999020.444444444,95.0,74.5
45088.0,6,14,4740,7,653,6995.5,249.0,93.28571428571428,7,4087,7374.166666666667,1514.0,583.8571428571429
90060733.0,17,28,13364,28,13364,3335582.703703704,501.0,477.2857142857143,0,0,0.0,0.0,0.0
30274.0,6,10,2032,5,524,7330.75,252.0,104.8,5,1508,6548.0,1236.0,301.6
147392.0,6,3,373,2,238,0.0,172.0,119.0,1,135,0.0,135.0,135.0
102718.0,17,2,762,2,762,0.0,381.0,381.0,0,0,0.0,0.0,0.0
108107358.0,17,5,955,5,955,27026839.5,191.0,191.0,0,0,0.0,0.0,0.0
416737.0,6,4,508,2,238,0.0,172.0,119.0,2,270,0.0,135.0,135.0
1515959.0,6,20,6434,12,1921,137814.45454545456,620.0,160.08333333333334,8,4513,178074.42857142858,1514.0,564.125
196982.0,17,2,180,1,90,0.0,90.0,90.0,1,90,0.0,90.0,90.0
304974.0,6,6,412,4,272,101658.0,74.0,68.0,2,140,0.0,74.0,70.0
1307927.0,6,4,264,2,132,0.0,66.0,66.0,2,132,0.0,66.0,66.0
108110321.0,17,5,1005,5,1005,27027580.25,201.0,201.0,0,0,0.0,0.0,0.0
1312370.0,6,4,264,2,132,0.0,66.0,66.0,2,132,0.0,66.0,66.0
126007790.0,17,15,907,8,475,18001112.85714286,174.0,59.375,7,432,17666880.0,174.0,61.71428571428572
3780481.0,6,5,336,2,134,0.0,68.0,67.0,3,202,1524250.5,70.0,67.33333333333333
103568.0,17,2,700,2,700,0.0,350.0,350.0,0,0,0.0,0.0,0.0
108098379.0,17,5,1005,5,1005,27024594.75,201.0,201.0,0,0,0.0,0.0,0.0
43390.0,6,14,4740,7,653,6373.333333333333,249.0,93.28571428571428,7,4087,6913.833333333333,1514.0,583.8571428571429
218885.0,6,3,426,2,280,0.0,214.0,140.0,1,146,0.0,146.0,146.0
218739.0,17,2,180,1,90,0.0,90.0,90.0,1,90,0.0,90.0,90.0
90033062.0,6,26,1762,13,922,7484760.916666667,139.0,70.92307692307692,13,840,7484775.0,123.0,64.61538461538461
216654.0,17,2,180,1,90,0.0,90.0,90.0,1,90,0.0,90.0,90.0
228144.0,17,2,180,1,90,0.0,90.0,90.0,1,90,0.0,90.0,90.0
47607345.0,6,8,1940,3,887,22866972.5,753.0,295.6666666666667,5,1053,11208865.75,785.0,210.6
0.0,17,1,55,1,55,0.0,55.0,55.0,0,0,0.0,0.0,0.0
120567171.0,6,217,24558,109,17134,1116362.6944444445,300.0,157.19266055045873,108,7424,1117147.9345794392,140.0,68.74074074074075
0.0,6,1,66,1,66,0.0,66.0,66.0,0,0,0.0,0.0,0.0
297340.0,17,4,6056,4,6056,99113.33333333331,1514.0,1514.0,0,0,0.0,0.0,0.0
358.0,17,2,267,1,83,0.0,83.0,83.0,1,184,0.0,184.0,184.0
112491123.0,6,32,2220,16,1149,7485007.2,123.0,71.8125,16,1071,7485007.666666667,123.0,66.9375
231563.0,6,10,1221,6,636,46312.6,298.0,106.0,4,585,75927.0,379.0,146.25
48654.0,6,14,4740,7,653,6609.0,249.0,93.28571428571428,7,4087,7942.0,1514.0,583.8571428571429
90049084.0,17,27,12943,27,12943,3463426.3076923075,501.0,479.3703703703704,0,0,0.0,0.0,0.0
21177.0,6,10,2032,5,524,4976.0,252.0,104.8,5,1508,4937.5,1236.0,301.6
140990.0,6,2,132,1,66,0.0,66.0,66.0,1,66,0.0,66.0,66.0
0.0,6,1,172,1,172,0.0,172.0,172.0,0,0,0.0,0.0,0.0
120982669.0,6,32,2242,17,1225,7561416.8125,139.0,72.05882352941177,15,1017,7912953.285714285,123.0,67.8
104415.0,17,2,700,2,700,0.0,350.0,350.0,0,0,0.0,0.0,0.0
108116721.0,17,5,1005,5,1005,27029180.25,201.0,201.0,0,0,0.0,0.0,0.0
21198.0,6,10,2032,5,524,5025.0,252.0,104.8,5,1508,4952.0,1236.0,301.6
322358.0,17,4,622,4,622,107452.66666666669,163.0,155.5,0,0,0.0,0.0,0.0
92349402.0,17,12,778,6,389,18400187.0,174.0,64.83333333333333,6,389,18401530.6,174.0,64.83333333333333
196857.0,17,2,180,1,90,0.0,90.0,90.0,1,90,0.0,90.0,90.0
2375.0,17,4,344,2,150,0.0,75.0,75.0,2,194,0.0,103.0,97.0
2327.0,17,4,344,2,150,0.0,75.0,75.0,2,194,0.0,103.0,97.0
359.0,17,2,267,1,83,0.0,83.0,83.0,1,184,0.0,184.0,184.0
209552.0,17,2,180,1,90,0.0,90.0,90.0,1,90,0.0,90.0,90.0
228402.0,17,2,180,1,90,0.0,90.0,90.0,1,90,0.0,90.0,90.0
245483.0,6,3,337,2,214,0.0,160.0,107.0,1,123,0.0,123.0,123.0
250249.0,17,4,6056,4,6056,83416.33333333333,1514.0,1514.0,0,0,0.0,0.0,0.0
1303127.0,6,4,264,2,132,0.0,66.0,66.0,2,132,0.0,66.0,66.0
10679.0,6,11,2098,6,590,2057.0,252.0,98.33333333333331,5,1508,1937.25,1236.0,301.6
1305693.0,6,4,264,2,132,0.0,66.0,66.0,2,132,0.0,66.0,66.0
16318.0,6,11,2098,6,590,3227.8,252.0,98.33333333333331,5,1508,3711.5,1236.0,301.6
13836.0,6,10,1067,5,536,3213.75,264.0,107.2,5,531,2896.25,259.0,106.2
120006939.0,6,21,1585,10,745,13334104.333333334,95.0,74.5,11,840,11974712.2,95.0,76.36363636363636
12018724.0,17,5,2265,5,2265,3004681.0,453.0,453.0,0,0,0.0,0.0,0.0
205574.0,17,2,180,1,90,0.0,90.0,90.0,1,90,0.0,90.0,90.0
29073.0,6,14,4740,7,653,4682.666666666667,249.0,93.28571428571428,7,4087,4709.0,1514.0,583.8571428571429
108950960.0,17,14,864,7,432,18000852.833333332,174.0,61.71428571428572,7,432,18000183.666666668,174.0,61.71428571428572
106779.0,17,2,700,2,700,0.0,350.0,350.0,0,0,0.0,0.0,0.0
11792521.0,6,5,1909,2,892,0.0,826.0,446.0,3,1017,4492421.0,885.0,339.0
219713.0,6,10,1221,6,636,43942.6,298.0,106.0,4,585,72369.0,379.0,146.25
259237.0,6,10,1221,6,636,51847.4,298.0,106.0,4,585,78867.66666666667,379.0,146.25
205627.0,17,2,180,1,90,0.0,90.0,90.0,1,90,0.0,90.0,90.0
1576.0,17,2,762,2,762,0.0,381.0,381.0,0,0,0.0,0.0,0.0
2355100.0,6,25,7573,14,3735,181161.53846153847,1514.0,266.7857142857143,11,3838,207219.8,1514.0,348.90909090909093
32603.0,6,14,4740,7,653,4791.833333333333,249.0,93.28571428571428,7,4087,5235.333333333333,1514.0,583.8571428571429
539366.0,17,6,2100,6,2100,107873.2,350.0,350.0,0,0,0.0,0.0,0.0
59923.0,6,13,1479,7,882,9435.833333333334,291.0,126.0,6,597,9704.2,259.0,99.5
120277726.0,6,21,1626,10,786,13364191.777777778,95.0,78.6,11,840,11926742.4,95.0,76.36363636363636
225427.0,17,2,180,1,90,0.0,90.0,90.0,1,90,0.0,90.0,90.0
103241.0,17,2,286,2,286,0.0,143.0,143.0,0,0,0.0,0.0,0.0
41063.0,6,14,4740,7,653,6717.333333333333,249.0,93.28571428571428,7,4087,6375.333333333333,1514.0,583.8571428571429
237497.0,17,2,180,1,90,0.0,90.0,90.0,1,90,0.0,90.0,90.0
3491225.0,6,26,7627,14,3735,268555.76923076925,1514.0,266.7857142857143,12,3892,294158.1818181818,1514.0,324.3333333333333
393.0,17,2,762,2,762,0.0,381.0,381.0,0,0,0.0,0.0,0.0
493252.0,6,3,1604,2,851,0.0,785.0,425.5,1,753,0.0,753.0,753.0
26982.0,6,14,4740,7,653,3284.333333333333,249.0,93.28571428571428,7,4087,4081.6666666666665,1514.0,583.8571428571429
48634727.0,6,8,2113,3,960,22866081.0,826.0,320.0,5,1153,11514304.5,885.0,230.6
135133173.0,17,6,1146,6,1146,27026634.6,191.0,191.0,0,0,0.0,0.0,0.0
103709.0,17,2,286,2,286,0.0,143.0,143.0,0,0,0.0,0.0,0.0
90330778.0,6,16,1192,8,596,12897184.0,95.0,74.5,8,596,12903830.0,95.0,74.5
103198755.0,6,42,2772,21,1386,5159924.9,66.0,66.0,21,1386,5159924.8,66.0,66.0
15130.0,6,14,4740,7,653,2119.1666666666665,249.0,93.28571428571428,7,4087,2391.1666666666665,1514.0,583.8571428571429
79908.0,6,14,4740,7,653,13022.166666666666,249.0,93.28571428571428,7,4087,13160.333333333334,1514.0,583.8571428571429
120243043.0,6,220,24884,110,7556,1095540.7889908256,140.0,68.69090909090909,110,17328,1095599.3394495412,284.0,157.52727272727273
110955078.0,6,32,2236,16,1165,7382616.866666666,139.0,72.8125,16,1071,7382619.466666667,123.0,66.9375
131245.0,6,13,1394,7,797,21364.5,253.0,113.85714285714286,6,597,25185.0,259.0,99.5
90795559.0,6,19,1436,10,745,10082205.666666666,95.0,74.5,9,691,11349175.875,95.0,76.77777777777777
230978.0,6,3,426,2,280,0.0,214.0,140.0,1,146,0.0,146.0,146.0
144905.0,17,2,180,1,70,0.0,70.0,70.0,1,110,0.0,110.0,110.0
2003.0,17,4,344,2,150,0.0,75.0,75.0,2,194,0.0,103.0,97.0
2065.0,17,2,932,1,590,0.0,590.0,590.0,1,342,0.0,342.0,342.0
9533.0,17,2,582,1,83,0.0,83.0,83.0,1,499,0.0,499.0,499.0
12662.0,6,11,1132,6,556,2532.4,218.0,92.66666666666669,5,576,2693.0,304.0,115.2
25026204.0,17,3,1034,2,684,0.0,342.0,342.0,1,350,0.0,350.0,350.0
307182.0,6,6,412,4,272,102394.0,74.0,68.0,2,140,0.0,74.0,70.0
29064.0,6,10,2032,5,524,6937.75,252.0,104.8,5,1508,6914.25,1236.0,301.6
307088.0,6,6,412,4,272,102362.66666666669,74.0,68.0,2,140,0.0,74.0,70.0
280209.0,17,2,363,1,79,0.0,79.0,79.0,1,284,0.0,284.0,284.0
102735630.0,17,14,864,7,432,17001450.666666668,174.0,61.71428571428572,7,432,17000164.333333332,174.0,61.71428571428572
247389.0,6,3,337,2,214,0.0,160.0,107.0,1,123,0.0,123.0,123.0
1315991.0,17,7,490,7,490,219331.8333333333,70.0,70.0,0,0,0.0,0.0,0.0
2285.0,17,4,344,2,150,0.0,75.0,75.0,2,194,0.0,103.0,97.0
45378.0,6,10,2032,5,524,11111.0,252.0,104.8,5,1508,10385.5,1236.0,301.6
348.0,17,2,267,1,83,0.0,83.0,83.0,1,184,0.0,184.0,184.0
111102242.0,6,32,2236,16,1165,7392432.2,139.0,72.8125,16,1071,7392428.6,123.0,66.9375
135121564.0,17,6,1146,6,1146,27024312.8,191.0,191.0,0,0,0.0,0.0,0.0
119990116.0,6,18,1341,10,745,13332235.111111112,95.0,74.5,8,596,12852198.0,95.0,74.5
43582.0,6,14,4740,7,653,7130.5,249.0,93.28571428571428,7,4087,6872.166666666667,1514.0,583.8571428571429
503372.00000000006,6,5,336,2,134,0.0,68.0,67.0,3,202,192565.5,70.0,67.33333333333333
38486.0,6,14,4740,7,653,6112.833333333333,249.0,93.28571428571428,7,4087,6084.666666666667,1514.0,583.8571428571429
30731.0,6,14,4740,7,653,4999.666666666667,249.0,93.28571428571428,7,4087,4536.833333333333,1514.0,583.8571428571429
28003.0,6,10,2032,5,524,6770.5,252.0,104.8,5,1508,6317.75,1236.0,301.6
749139.0,6,2,132,1,66,0.0,66.0,66.0,1,66,0.0,66.0,66.0
108112711.0,17,5,955,5,955,27028177.75,191.0,191.0,0,0,0.0,0.0,0.0
119857997.0,6,15,2306,6,1224,23970161.6,204.0,204.0,9,1082,14982105.875,188.0,120.22222222222224
5625435.0,6,5,336,2,134,0.0,68.0,67.0,3,202,1425438.0,70.0,67.33333333333333
130285.0,6,3,337,2,214,0.0,160.0,107.0,1,123,0.0,123.0,123.0
102584596.0,6,28,1860,14,966,7874478.384615385,123.0,69.0,14,894,7874503.0,123.0,63.85714285714285
190931.0,17,2,180,1,90,0.0,90.0,90.0,1,90,0.0,90.0,90.0
109448606.0,6,33,2412,17,1272,6840537.875,123.0,74.82352941176471,16,1140,7282155.2,123.0,71.25
36656.0,6,14,4740,7,653,5188.833333333333,249.0,93.28571428571428,7,4087,5751.333333333333,1514.0,583.8571428571429
102931509.0,17,14,864,7,432,17000630.666666668,174.0,61.71428571428572,7,432,17000195.0,174.0,61.71428571428572
198347.0,17,4,6056,4,6056,66115.66666666667,1514.0,1514.0,0,0,0.0,0.0,0.0
209709.0,17,4,6056,4,6056,69903.0,1514.0,1514.0,0,0,0.0,0.0,0.0
298284.0,6,6,412,4,272,99428.0,74.0,68.0,2,140,0.0,74.0,70.0
15397.0,6,10,2032,5,524,3559.25,252.0,104.8,5,1508,3087.5,1236.0,301.6
45367.0,6,11,2098,6,590,8363.4,252.0,98.33333333333331,5,1508,10783.25,1236.0,301.6
275639.0,17,2,238,1,74,0.0,74.0,74.0,1,164,0.0,164.0,164.0
30992.0,6,14,4740,7,653,5055.166666666667,249.0,93.28571428571428,7,4087,4704.833333333333,1514.0,583.8571428571429
216850.0,6,3,426,2,280,0.0,214.0,140.0,1,146,0.0,146.0,146.0
208098.0,6,3,426,2,280,0.0,214.0,140.0,1,146,0.0,146.0,146.0
314499.0,17,4,1400,4,1400,104833.0,350.0,350.0,0,0,0.0,0.0,0.0
350.0,17,2,160,1,80,0.0,80.0,80.0,1,80,0.0,80.0,80.0
1168418.0,6,13,3000,8,2372,166916.85714285713,1514.0,296.5,5,628,223936.5,331.0,125.6
90292682.0,6,16,1192,8,596,12892523.857142856,95.0,74.5,8,596,12898250.42857143,95.0,74.5
90285910.0,6,16,1192,8,596,12891870.857142856,95.0,74.5,8,596,12896550.57142857,95.0,74.5
1164385.0,6,13,3009,8,2381,166340.7142857143,1514.0,297.625,5,628,222148.5,331.0,125.6
232451.0,6,3,337,2,214,0.0,160.0,107.0,1,123,0.0,123.0,123.0
90280990.0,6,15,1097,8,596,12897284.285714284,95.0,74.5,7,501,14997545.5,95.0,71.57142857142857
75230.0,6,14,4740,7,653,12345.0,249.0,93.28571428571428,7,4087,11933.0,1514.0,583.8571428571429
7078.0,17,4,823,2,163,0.0,89.0,81.5,2,660,0.0,443.0,330.0
97236.0,17,2,762,2,762,0.0,381.0,381.0,0,0,0.0,0.0,0.0
210632.0,6,10,1221,6,636,42126.4,298.0,106.0,4,585,69141.66666666667,379.0,146.25
108103565.0,17,5,955,5,955,27025891.25,191.0,191.0,0,0,0.0,0.0,0.0
114762772.0,6,34,2350,17,1225,7172673.25,139.0,72.05882352941177,17,1125,7159824.4375,123.0,66.17647058823529
119098203.0,6,47,3102,24,1584,5166222.521739131,66.0,66.0,23,1518,5135432.5,66.0,66.0
108104968.0,17,5,1005,5,1005,27026242.0,201.0,201.0,0,0,0.0,0.0,0.0
144000.0,17,2,180,1,90,0.0,90.0,90.0,1,90,0.0,90.0,90.0
29048.0,6,14,4740,7,653,3740.5,249.0,93.28571428571428,7,4087,4692.333333333333,1514.0,583.8571428571429
10468098.0,6,7,478,4,272,3444022.333333333,74.0,68.0,3,206,5165936.5,74.0,68.66666666666667
14693.0,6,14,4740,7,653,2264.5,249.0,93.28571428571428,7,4087,2317.6666666666665,1514.0,583.8571428571429
22549.0,6,2,145,2,145,0.0,91.0,72.5,0,0,0.0,0.0,0.0
30786.0,6,14,4740,7,653,4908.5,249.0,93.28571428571428,7,4087,4537.0,1514.0,583.8571428571429
113344339.0,6,46,3036,23,1518,5152002.454545454,66.0,66.0,23,1518,5152003.727272728,66.0,66.0
135172903.0,17,6,1206,6,1206,27034580.6,201.0,201.0,0,0,0.0,0.0,0.0
255017.0,6,12,1373,7,714,42502.833333333336,298.0,102.0,5,659,62836.5,379.0,131.8
256340.0,6,3,337,2,214,0.0,160.0,107.0,1,123,0.0,123.0,123.0
490830.0,6,6,433,3,235,195761.0,103.0,78.33333333333333,3,198,205286.0,66.0,66.0
15318.0,6,10,2032,5,524,3556.0,252.0,104.8,5,1508,3564.75,1236.0,301.6
135134702.0,17,6,1206,6,1206,27026940.4,201.0,201.0,0,0,0.0,0.0,0.0
112114205.0,6,32,2220,16,1149,7459934.866666666,123.0,71.8125,16,1071,7459930.8,123.0,66.9375
90533685.0,6,14,2240,8,1016,12933383.57142857,188.0,127.0,6,1224,18073377.2,204.0,204.0
16088.000000000002,6,14,4740,7,653,2365.0,249.0,93.28571428571428,7,4087,2544.0,1514.0,583.8571428571429
2802334.0,6,2,132,1,66,0.0,66.0,66.0,1,66,0.0,66.0,66.0
100010706.0,17,14,864,7,432,16667091.5,174.0,61.71428571428572,7,432,16666830.0,174.0,61.71428571428572
1387964.0,17,16,1120,16,1120,92530.93333333332,70.0,70.0,0,0,0.0,0.0,0.0
6894.0,17,2,582,1,83,0.0,83.0,83.0,1,499,0.0,499.0,499.0
51700.0,6,14,4740,7,653,8498.166666666666,249.0,93.28571428571428,7,4087,8263.666666666666,1514.0,583.8571428571429
22308.0,17,2,582,1,83,0.0,83.0,83.0,1,499,0.0,499.0,499.0
117106311.0,6,234,26400,117,7944,1002404.1896551724,140.0,67.8974358974359,117,18456,1002466.275862069,284.0,157.74358974358975
314268.0,6,6,412,4,272,104756.0,74.0,68.0,2,140,0.0,74.0,70.0
142186.0,17,4,1524,4,1524,47395.333333333336,381.0,381.0,0,0,0.0,0.0,0.0
59386.0,6,14,4740,7,653,9460.5,249.0,93.28571428571428,7,4087,8898.5,1514.0,583.8571428571429
9811.0,17,2,582,1,83,0.0,83.0,83.0,1,499,0.0,499.0,499.0
24005.0,6,11,2098,6,590,4268.6,252.0,98.33333333333331,5,1508,5410.75,1236.0,301.6
90255390.0,6,15,2168,8,1016,12893627.142857144,188.0,127.0,7,1152,15015161.5,204.0,164.57142857142858
31954.000000000004,6,10,1066,5,490,6352.5,218.0,98.0,5,576,7578.25,304.0,115.2
3043832.0,6,5,336,3,202,1521916.0,70.0,67.33333333333333,2,134,0.0,68.0,67.0
120017708.0,17,29,13785,29,13785,4286346.714285715,501.0,475.3448275862069,0,0,0.0,0.0,0.0
1306930.0,6,4,264,2,132,0.0,66.0,66.0,2,132,0.0,66.0,66.0
166300.0,17,2,414,1,88,0.0,88.0,88.0,1,326,0.0,326.0,326.0
841350.0,6,9,1118,6,586,168270.0,248.0,97.66666666666669,3,532,283084.0,392.0,177.33333333333334
233123.0,6,3,337,2,214,0.0,160.0,107.0,1,123,0.0,123.0,123.0
258716.0,6,10,1221,6,636,51743.2,298.0,106.0,4,585,80897.33333333333,379.0,146.25
34494.0,6,14,4740,7,653,5498.333333333333,249.0,93.28571428571428,7,4087,5596.5,1514.0,583.8571428571429
40935309.0,6,4,1670,3,917,20467654.5,785.0,305.6666666666667,1,753,0.0,753.0,753.0
8743.0,17,4,344,2,150,0.0,75.0,75.0,2,194,0.0,103.0,97.0
363089.0,6,11,1021,6,444,48856.4,162.0,74.0,5,577,60881.25,349.0,115.4
25283.0,6,10,1065,5,534,5687.0,262.0,106.8,5,531,4296.0,259.0,106.2
216384.0,17,2,180,1,90,0.0,90.0,90.0,1,90,0.0,90.0,90.0
135137662.0,17,6,1206,6,1206,27027532.4,201.0,201.0,0,0,0.0,0.0,0.0
90030606.0,17,28,13364,28,13364,3334466.888888889,501.0,477.2857142857143,0,0,0.0,0.0,0.0
808.0,17,4,438,2,148,0.0,74.0,74.0,2,290,0.0,147.0,145.0
0.0,17,1,453,1,453,0.0,453.0,453.0,0,0,0.0,0.0,0.0
405190.0,6,4,508,2,238,0.0,172.0,119.0,2,270,0.0,135.0,135.0
605118.0,17,2,363,1,79,0.0,79.0,79.0,1,284,0.0,284.0,284.0
2637174.0,6,25,7573,14,3735,202859.53846153847,1514.0,266.7857142857143,11,3838,238902.9,1514.0,348.90909090909093
90259178.0,6,13,2036,8,1016,12894168.285714284,188.0,127.0,5,1020,22523026.25,204.0,204.0
2481.0,17,4,344,2,150,0.0,75.0,75.0,2,194,0.0,103.0,97.0
162650.0,6,10,1066,5,490,40298.0,218.0,98.0,5,576,40342.0,304.0,115.2
189875.0,6,11,1132,6,556,37304.6,218.0,92.66666666666669,5,576,47112.0,304.0,115.2
114477125.0,17,14,864,7,432,19000174.0,174.0,61.71428571428572,7,432,19001013.33333333,174.0,61.71428571428572
121158474.0,6,234,26528,117,8018,1028392.9137931034,140.0,68.52991452991454,117,18510,1037381.0862068966,374.0,158.2051282051282
90022074.0,17,28,13364,28,13364,3334150.888888889,501.0,477.2857142857143,0,0,0.0,0.0,0.0
146257.0,6,3,337,2,214,0.0,160.0,107.0,1,123,0.0,123.0,123.0
248688.0,6,3,373,2,238,0.0,172.0,119.0,1,135,0.0,135.0,135.0
40209.0,6,14,4740,7,653,6267.833333333333,249.0,93.28571428571428,7,4087,6457.0,1514.0,583.8571428571429
113168272.0,6,46,3036,23,1518,5144001.0,66.0,66.0,23,1518,5143999.545454546,66.0,66.0
11437.0,6,10,1066,5,490,2611.25,218.0,98.0,5,576,2233.5,304.0,115.2
110794.0,6,10,1066,5,490,26891.0,218.0,98.0,5,576,26848.5,304.0,115.2
749677.0,6,10,967,5,390,125437.25,162.0,78.0,5,577,125424.25,349.0,115.4
3959112.0,6,4,492,2,280,0.0,214.0,140.0,2,212,0.0,146.0,106.0
2806285.0,6,2,132,1,66,0.0,66.0,66.0,1,66,0.0,66.0,66.0
90080937.0,17,28,13364,28,13364,3336331.0,501.0,477.2857142857143,0,0,0.0,0.0,0.0
140471.0,6,2,132,1,66,0.0,66.0,66.0,1,66,0.0,66.0,66.0
90297329.0,6,21,1585,11,840,9025356.6,95.0,76.36363636363636,10,745,10000791.444444444,95.0,74.5
58479.0,6,14,4740,7,653,7230.0,249.0,93.28571428571428,7,4087,9568.0,1514.0,583.8571428571429
147685.0,6,3,337,2,214,0.0,160.0,107.0,1,123,0.0,123.0,123.0
108098619.0,17,5,955,5,955,27024654.75,191.0,191.0,0,0,0.0,0.0,0.0
135901.0,6,2,132,1,66,0.0,66.0,66.0,1,66,0.0,66.0,66.0
102731.0,6,14,4740,7,653,16718.333333333332,249.0,93.28571428571428,7,4087,16638.166666666668,1514.0,583.8571428571429
250029.0,6,3,337,2,214,0.0,160.0,107.0,1,123,0.0,123.0,123.0
206049.0,6,3,426,2,280,0.0,214.0,140.0,1,146,0.0,146.0,146.0
130489.0,6,3,337,2,214,0.0,160.0,107.0,1,123,0.0,123.0,123.0
3049619.0,6,3,204,1,68,0.0,68.0,68.0,2,136,0.0,70.0,68.0
144917.0,17,2,180,1,70,0.0,70.0,70.0,1,110,0.0,110.0,110.0
205608.0,17,2,180,1,90,0.0,90.0,90.0,1,90,0.0,90.0,90.0
306935.0,6,3,202,2,128,0.0,74.0,64.0,1,74,0.0,74.0,74.0
23769.0,6,10,2032,5,524,5695.5,252.0,104.8,5,1508,5677.25,1236.0,301.6
3613.0,17,2,359,1,75,0.0,75.0,75.0,1,284,0.0,284.0,284.0
206127.0,6,3,426,2,280,0.0,214.0,140.0,1,146,0.0,146.0,146.0
79714.0,6,14,4740,7,653,12821.833333333334,249.0,93.28571428571428,7,4087,13128.333333333334,1514.0,583.8571428571429
47904.0,6,10,2032,5,524,10880.75,252.0,104.8,5,1508,11179.0,1236.0,301.6
2896.0,17,4,625,2,163,0.0,89.0,81.5,2,462,0.0,245.0,231.0
374700.0,17,2,363,1,75,0.0,75.0,75.0,1,288,0.0,288.0,288.0
50852.0,6,10,2032,5,524,12154.75,252.0,104.8,5,1508,12199.25,1236.0,301.6
79707.0,6,10,2032,5,524,18820.25,252.0,104.8,5,1508,19224.75,1236.0,301.6
14021407.0,17,6,2052,6,2052,2804281.4,342.0,342.0,0,0,0.0,0.0,0.0
15911.999999999998,6,11,1133,6,602,2834.4,264.0,100.33333333333331,5,531,3609.25,259.0,106.2
319308.0,17,4,1400,4,1400,106436.0,350.0,350.0,0,0,0.0,0.0,0.0
303621.0,6,2,132,1,66,0.0,66.0,66.0,1,66,0.0,66.0,66.0
95205.0,6,10,1065,5,534,22847.0,262.0,106.8,5,531,23585.5,259.0,106.2
90052665.0,17,28,13364,28,13364,3335283.888888889,501.0,477.2857142857143,0,0,0.0,0.0,0.0
95009708.0,17,19,5758,8,1128,13572815.42857143,506.0,141.0,11,4630,9443648.2,1214.0,420.9090909090909
93107405.0,6,40,2640,20,1320,4900389.736842105,66.0,66.0,20,1320,4885880.315789473,66.0,66.0
90879491.0,6,419,54752,210,40736,434830.1004784689,554.0,193.9809523809524,209,14016,435828.88942307694,140.0,67.0622009569378
48188.0,6,14,4740,7,653,7905.333333333333,249.0,93.28571428571428,7,4087,7371.333333333333,1514.0,583.8571428571429
1307027.0,6,4,264,2,132,0.0,66.0,66.0,2,132,0.0,66.0,66.0
108106858.0,17,5,1005,5,1005,27026714.5,201.0,201.0,0,0,0.0,0.0,0.0
5626535.0,6,5,336,2,134,0.0,68.0,67.0,3,202,1423181.5,70.0,67.33333333333333
72428.0,6,11,2098,6,590,14301.8,252.0,98.33333333333331,5,1508,17530.5,1236.0,301.6
3997.0,17,2,582,1,83,0.0,83.0,83.0,1,499,0.0,499.0,499.0
120065817.0,17,29,13785,29,13785,4288064.892857143,501.0,475.3448275862069,0,0,0.0,0.0,0.0
20536.0,6,14,4740,7,653,3144.0,249.0,93.28571428571428,7,4087,3230.833333333333,1514.0,583.8571428571429
41308.0,6,14,4740,7,653,6350.666666666667,249.0,93.28571428571428,7,4087,5033.833333333333,1514.0,583.8571428571429
13178.0,17,4,823,2,163,0.0,89.0,81.5,2,660,0.0,443.0,330.0
60381.0,6,10,1065,5,534,14860.0,262.0,106.8,5,531,2347.0,259.0,106.2
325.0,17,2,174,1,79,0.0,79.0,79.0,1,95,0.0,95.0,95.0
299855.0,6,6,412,4,272,99951.66666666669,74.0,68.0,2,140,0.0,74.0,70.0
846.0,17,4,438,2,148,0.0,74.0,74.0,2,290,0.0,147.0,145.0
2105274.0,6,2,132,1,66,0.0,66.0,66.0,1,66,0.0,66.0,66.0
309791.0,17,4,1400,4,1400,103263.66666666669,350.0,350.0,0,0,0.0,0.0,0.0
90110984.0,6,12,1848,5,1020,22526031.75,204.0,204.0,7,828,14972697.0,188.0,118.28571428571428
312839.0,17,4,1400,4,1400,104279.66666666669,350.0,350.0,0,0,0.0,0.0,0.0
388.0,17,2,208,1,72,0.0,72.0,72.0,1,136,0.0,136.0,136.0
119757956.0,6,34,2350,17,1225,7471381.125,139.0,72.05882352941177,17,1125,7471381.25,123.0,66.17647058823529
300622.0,6,6,412,4,272,100207.33333333331,74.0,68.0,2,140,0.0,74.0,70.0
22751.0,6,10,2032,5,524,5083.25,252.0,104.8,5,1508,5320.75,1236.0,301.6
61853.0,6,12,1320,7,789,10308.833333333334,253.0,112.71428571428572,5,531,11926.75,259.0,106.2
27832481.0,17,5,1718,4,1368,842825.0,342.0,342.0,1,350,0.0,350.0,350.0
301193.0,6,6,412,4,272,100397.66666666669,74.0,68.0,2,140,0.0,74.0,70.0
38356.0,6,14,4740,7,653,6271.0,249.0,93.28571428571428,7,4087,5782.166666666667,1514.0,583.8571428571429
232788.0,6,12,1373,7,714,38798.0,298.0,102.0,5,659,57217.25,379.0,131.8
27148.0,6,14,4740,7,653,4028.0,249.0,93.28571428571428,7,4087,4385.833333333333,1514.0,583.8571428571429
1843092.0,17,2,896,2,896,0.0,453.0,448.0,0,0,0.0,0.0,0.0
10480263.0,6,7,478,4,272,3446332.6666666665,74.0,68.0,3,206,5169346.0,74.0,68.66666666666667
45832.0,6,14,4740,7,653,7513.166666666667,249.0,93.28571428571428,7,4087,7498.833333333333,1514.0,583.8571428571429
332.0,17,2,166,1,75,0.0,75.0,75.0,1,91,0.0,91.0,91.0
90293536.0,6,24,1829,13,989,7520463.666666667,95.0,76.07692307692308,11,840,9001298.8,95.0,76.36363636363636
4738.0,17,2,621,1,78,0.0,78.0,78.0,1,543,0.0,543.0,543.0
2114.0,17,4,344,2,150,0.0,75.0,75.0,2,194,0.0,103.0,97.0
301970.0,6,6,412,4,272,100656.66666666669,74.0,68.0,2,140,0.0,74.0,70.0
348.0,17,2,174,1,79,0.0,79.0,79.0,1,95,0.0,95.0,95.0
268789.0,17,2,180,1,90,0.0,90.0,90.0,1,90,0.0,90.0,90.0
2284.0,17,4,344,2,150,0.0,75.0,75.0,2,194,0.0,103.0,97.0
102729.0,17,2,286,2,286,0.0,143.0,143.0,0,0,0.0,0.0,0.0
309171.0,6,6,412,4,272,103057.0,74.0,68.0,2,140,0.0,74.0,70.0
196850.0,17,2,180,1,90,0.0,90.0,90.0,1,90,0.0,90.0,90.0
135135965.0,17,6,1146,6,1146,27027193.0,191.0,191.0,0,0,0.0,0.0,0.0
2974709.0,6,3,1604,2,851,0.0,785.0,425.5,1,753,0.0,753.0,753.0
45778.0,6,10,1065,5,534,10908.5,262.0,106.8,5,531,9068.5,259.0,106.2
93441619.0,17,12,778,6,389,18601015.6,174.0,64.83333333333333,6,389,18600204.6,174.0,64.83333333333333
146083.0,6,3,337,2,214,0.0,160.0,107.0,1,123,0.0,123.0,123.0
1391930.0,17,16,1120,16,1120,92795.33333333331,70.0,70.0,0,0,0.0,0.0,0.0
15949.000000000002,6,10,1067,5,536,3596.5,264.0,107.2,5,531,3684.5,259.0,106.2
105397434.0,6,224,25470,112,17856,947587.6576576576,284.0,159.42857142857142,112,7614,947586.8918918918,140.0,67.98214285714286
103090.0,17,2,286,2,286,0.0,143.0,143.0,0,0,0.0,0.0,0.0
118927236.0,6,36,2734,19,1471,6595668.888888889,139.0,77.42105263157895,17,1263,7420181.5,123.0,74.29411764705883
477.0,17,2,166,1,75,0.0,75.0,75.0,1,91,0.0,91.0,91.0
105147397.0,17,14,864,7,432,17499198.333333332,174.0,61.71428571428572,7,432,17500168.166666668,174.0,61.71428571428572
298515.0,6,6,412,4,272,99505.0,74.0,68.0,2,140,0.0,74.0,70.0
120000002.0,6,22,1680,12,935,10909091.090909092,95.0,77.91666666666667,10,745,10000839.222222222,95.0,74.5
2006.0,17,4,344,2,150,0.0,75.0,75.0,2,194,0.0,103.0,97.0
120001659.0,6,20,1490,11,799,12000165.9,95.0,72.63636363636364,9,691,14969099.5,95.0,76.77777777777777
13061.0,6,10,1067,5,536,2971.5,264.0,107.2,5,531,3056.25,259.0,106.2
160022.0,17,2,180,1,90,0.0,90.0,90.0,1,90,0.0,90.0,90.0
1284194.0,17,7,490,7,490,214032.3333333333,70.0,70.0,0,0,0.0,0.0,0.0
108107758.0,17,5,955,5,955,27026939.5,191.0,191.0,0,0,0.0,0.0,0.0
627.0,17,2,762,2,762,0.0,381.0,381.0,0,0,0.0,0.0,0.0
119286946.0,6,26,2066,14,1043,9175918.923076924,95.0,74.5,12,1023,10821067.545454543,224.0,85.25
0.0,17,1,350,1,350,0.0,350.0,350.0,0,0,0.0,0.0,0.0
90256807.0,6,12,1832,8,1016,12893829.57142857,188.0,127.0,4,816,30031496.666666668,204.0,204.0
119181640.0,6,47,3102,24,1584,5181799.0869565215,66.0,66.0,23,1518,5159991.636363637,66.0,66.0
206001.0,17,2,762,2,762,0.0,381.0,381.0,0,0,0.0,0.0,0.0
305837.0,6,3,202,2,128,0.0,74.0,64.0,1,74,0.0,74.0,74.0
84.0,17,2,762,2,762,0.0,381.0,381.0,0,0,0.0,0.0,0.0
28024.0,6,20,7606,11,978,2802.4,310.0,88.9090909090909,9,6628,3224.5,1514.0,736.4444444444445
127771108.0,6,33,2280,17,1209,7985694.25,123.0,71.11764705882354,16,1071,7838038.2,123.0,66.9375
64459.0,17,3,1143,3,1143,32229.5,381.0,381.0,0,0,0.0,0.0,0.0
24830.0,6,10,2032,5,524,5989.25,252.0,104.8,5,1508,5640.75,1236.0,301.6
108105659.0,17,5,1005,5,1005,27026414.75,201.0,201.0,0,0,0.0,0.0,0.0
228358.0,17,2,180,1,90,0.0,90.0,90.0,1,90,0.0,90.0,90.0
514604.0,6,3,1604,2,851,0.0,785.0,425.5,1,753,0.0,753.0,753.0
234111.0,6,3,373,2,238,0.0,172.0,119.0,1,135,0.0,135.0,135.0
616928.0,17,2,473,1,78,0.0,78.0,78.0,1,395,0.0,395.0,395.0
487561.0,6,3,1604,1,753,0.0,753.0,753.0,2,851,0.0,785.0,425.5
122595343.0,6,37,2719,19,1471,6810852.388888889,139.0,77.42105263157895,18,1248,6988693.882352941,123.0,69.33333333333333
118546003.0,6,29,1914,15,948,8467571.642857144,123.0,63.2,14,966,8334177.0,123.0,69.0
204660.0,17,2,762,2,762,0.0,381.0,381.0,0,0,0.0,0.0,0.0
345.0,17,2,267,1,83,0.0,83.0,83.0,1,184,0.0,184.0,184.0
101794.0,17,2,762,2,762,0.0,381.0,381.0,0,0,0.0,0.0,0.0
335856.0,17,2,614,1,72,0.0,72.0,72.0,1,542,0.0,542.0,542.0
204796.0,17,2,762,2,762,0.0,381.0,381.0,0,0,0.0,0.0,0.0
101796.0,17,2,700,2,700,0.0,350.0,350.0,0,0,0.0,0.0,0.0
46212.0,6,10,2032,5,524,9004.75,252.0,104.8,5,1508,10329.25,1236.0,301.6
2035.0,17,4,344,2,150,0.0,75.0,75.0,2,194,0.0,103.0,97.0
149266952.0,17,36,17126,36,17126,4264770.057142857,501.0,475.72222222222223,0,0,0.0,0.0,0.0
217929.0,6,3,426,2,280,0.0,214.0,140.0,1,146,0.0,146.0,146.0
67013.0,6,12,1320,6,723,12463.8,253.0,120.5,6,597,12512.6,259.0,99.5
442.0,17,2,508,2,508,0.0,257.0,254.0,0,0,0.0,0.0,0.0
153549.0,17,4,6056,4,6056,51183.0,1514.0,1514.0,0,0,0.0,0.0,0.0
298656.0,6,6,412,4,272,99552.0,74.0,68.0,2,140,0.0,74.0,70.0
121361989.0,6,241,27276,121,19134,1011349.9083333332,284.0,158.13223140495867,120,8142,1003245.7142857144,140.0,67.85
105137511.0,6,29,2052,15,1089,7495220.428571428,123.0,72.6,14,963,8071776.769230769,123.0,68.78571428571429
341.0,17,2,267,1,83,0.0,83.0,83.0,1,184,0.0,184.0,184.0
41078.0,6,14,4740,7,653,6150.666666666667,249.0,93.28571428571428,7,4087,5796.833333333333,1514.0,583.8571428571429
28787.0,6,14,4740,7,653,4677.5,249.0,93.28571428571428,7,4087,4655.833333333333,1514.0,583.8571428571429
108706538.0,6,33,2428,17,1288,6780649.0,139.0,75.76470588235294,16,1140,7232695.866666666,123.0,71.25
521529.0,6,3,1604,1,753,0.0,753.0,753.0,2,851,0.0,785.0,425.5
228329.0,17,2,180,1,90,0.0,90.0,90.0,1,90,0.0,90.0,90.0
506428.0,6,5,336,2,134,0.0,68.0,67.0,3,202,194086.5,70.0,67.33333333333333
42316.0,6,14,4740,7,653,5929.333333333333,249.0,93.28571428571428,7,4087,6773.833333333333,1514.0,583.8571428571429
509124.0,6,5,336,2,134,0.0,68.0,67.0,3,202,195011.5,70.0,67.33333333333333
31791.0,6,11,2098,6,590,6140.4,252.0,98.33333333333331,5,1508,7326.75,1236.0,301.6
280739.0,17,2,180,1,90,0.0,90.0,90.0,1,90,0.0,90.0,90.0
2808466.0,6,2,132,1,66,0.0,66.0,66.0,1,66,0.0,66.0,66.0
232899.0,6,3,337,2,214,0.0,160.0,107.0,1,123,0.0,123.0,123.0
120138523.0,6,14,2240,6,1224,24027704.6,204.0,204.0,8,1016,17137529.85714286,188.0,127.0
2998407.0,6,11,2106,6,598,599461.0,252.0,99.66666666666669,5,1508,1945.25,1236.0,301.6
20246.0,6,14,4740,7,653,3252.6666666666665,249.0,93.28571428571428,7,4087,3229.0,1514.0,583.8571428571429
6612.0,17,2,565,1,93,0.0,93.0,93.0,1,472,0.0,472.0,472.0
135131850.0,17,6,1206,6,1206,27026370.0,201.0,201.0,0,0,0.0,0.0,0.0
42306.0,6,14,4740,7,653,6865.666666666667,249.0,93.28571428571428,7,4087,6746.833333333333,1514.0,583.8571428571429
98000803.0,17,11,735,6,389,19600160.6,174.0,64.83333333333333,5,346,19500983.5,174.0,69.2
303642.0,6,2,132,1,66,0.0,66.0,66.0,1,66,0.0,66.0,66.0
108105190.0,17,5,955,5,955,27026297.5,191.0,191.0,0,0,0.0,0.0,0.0
306018.0,6,6,412,4,272,102006.0,74.0,68.0,2,140,0.0,74.0,70.0
25848.0,6,10,2032,5,524,5877.5,252.0,104.8,5,1508,5767.75,1236.0,301.6
135135393.0,17,6,1146,6,1146,27027078.6,191.0,191.0,0,0,0.0,0.0,0.0
45154.0,6,14,4740,7,653,7207.0,249.0,93.28571428571428,7,4087,7361.833333333333,1514.0,583.8571428571429
75600.0,6,14,4740,7,653,12168.166666666666,249.0,93.28571428571428,7,4087,12457.333333333334,1514.0,583.8571428571429
90529097.0,6,13,2036,8,1016,12932728.142857144,188.0,127.0,5,1020,22591313.0,204.0,204.0
19029.0,6,14,4740,7,653,3031.5,249.0,93.28571428571428,7,4087,2661.6666666666665,1514.0,583.8571428571429
148023.0,17,2,180,1,90,0.0,90.0,90.0,1,90,0.0,90.0,90.0
17444418.0,6,24,7569,13,2049,1453701.5,408.0,157.6153846153846,11,5520,1230375.1,1514.0,501.8181818181818
119385870.0,6,217,24522,109,7416,1105424.7222222222,140.0,68.03669724770643,108,17106,1096460.5046728973,284.0,158.38888888888889
2007.0,17,4,344,2,150,0.0,75.0,75.0,2,194,0.0,103.0,97.0
5614053.0,6,5,336,2,134,0.0,68.0,67.0,3,202,1522734.0,70.0,67.33333333333333
