flow_duration,protocol,TotPackets,TotBytes,tot_fwd_pkts,totlen_fwd_pkts,fwd_iat_mean,fwd_pkt_len_max,fwd_pkt_len_mean,tot_bwd_pkts,totlen_bwd_pkts,bwd_iat_mean,bwd_pkt_len_max,bwd_pkt_len_mean
68256.0,6,13,1420,7,789,11267.5,253.0,112.71428571428572,6,631,12727.2,293.0,105.16666666666669
114124553.0,6,48,3168,24,1584,4961937.0869565215,66.0,66.0,24,1584,4949949.173913044,66.0,66.0
222084.0,6,13,1386,7,789,37014.0,253.0,112.71428571428572,6,597,42825.2,259.0,99.5
10488593.0,6,7,478,4,272,3448985.0,74.0,68.0,3,206,5173368.5,74.0,68.66666666666667
56889.0,6,10,1066,5,490,13996.75,218.0,98.0,5,576,14001.0,304.0,115.2
868787.0,6,9,1269,6,798,173757.4,460.0,133.0,3,471,296387.5,331.0,157.0
122188.0,6,3,373,2,238,0.0,172.0,119.0,1,135,0.0,135.0,135.0
90040641.0,17,28,13364,28,13364,3334838.5555555555,501.0,477.2857142857143,0,0,0.0,0.0,0.0
11339.0,6,11,1132,6,556,2218.4,218.0,92.66666666666669,5,576,2546.5,304.0,115.2
2926642.0,6,3,1604,2,851,0.0,785.0,425.5,1,753,0.0,753.0,753.0
135133514.0,17,6,1146,6,1146,27026702.8,191.0,191.0,0,0,0.0,0.0,0.0
90303024.0,6,19,1436,10,745,10027710.555555556,95.0,74.5,9,691,11286822.625,95.0,76.77777777777777
108120514.0,17,5,955,5,955,27030128.5,191.0,191.0,0,0,0.0,0.0,0.0
26504.0,6,14,4740,7,653,2679.333333333333,249.0,93.28571428571428,7,4087,4282.166666666667,1514.0,583.8571428571429
10516919.0,6,7,478,4,272,3460468.6666666665,74.0,68.0,3,206,5190594.0,74.0,68.66666666666667
135133894.0,17,6,1146,6,1146,27026778.8,191.0,191.0,0,0,0.0,0.0,0.0
10700.0,6,10,2032,5,524,2362.5,252.0,104.8,5,1508,2398.25,1236.0,301.6
115243454.0,6,48,3168,24,1584,5010584.956521739,66.0,66.0,24,1584,4998417.869565218,66.0,66.0
97283655.0,6,178,20184,89,14088,1103050.1704545454,284.0,158.2921348314607,89,6096,1103043.5113636365,140.0,68.49438202247191
95046521.0,17,12,778,6,389,19000174.4,174.0,64.83333333333333,6,389,19000984.8,174.0,64.83333333333333
611.0,17,2,508,2,508,0.0,257.0,254.0,0,0,0.0,0.0,0.0
121286.0,6,3,337,2,214,0.0,160.0,107.0,1,123,0.0,123.0,123.0
2050314.0,17,6,1230,3,234,1024946.5,78.0,78.0,3,996,1024949.0,332.0,332.0
7833517.0,6,19,6869,11,1567,783351.7,408.0,142.45454545454547,8,5302,1070004.4285714286,1514.0,662.75
5833187.0,6,5,336,2,134,0.0,68.0,67.0,3,202,1527664.5,70.0,67.33333333333333
41237.0,6,14,4740,7,653,5421.666666666667,249.0,93.28571428571428,7,4087,6537.333333333333,1514.0,583.8571428571429
37487.0,6,14,4740,7,653,6121.5,249.0,93.28571428571428,7,4087,5968.0,1514.0,583.8571428571429
45456.0,6,10,2032,5,524,11050.25,252.0,104.8,5,1508,10822.75,1236.0,301.6
22525.0,6,14,4740,7,653,3414.6666666666665,249.0,93.28571428571428,7,4087,2824.833333333333,1514.0,583.8571428571429
228360.0,17,2,180,1,90,0.0,90.0,90.0,1,90,0.0,90.0,90.0
249384.0,6,3,337,2,214,0.0,160.0,107.0,1,123,0.0,123.0,123.0
51174.0,6,14,4740,7,653,7971.333333333333,249.0,93.28571428571428,7,4087,6685.666666666667,1514.0,583.8571428571429
216414.0,6,3,426,2,280,0.0,214.0,140.0,1,146,0.0,146.0,146.0
232803.0,6,3,337,2,214,0.0,160.0,107.0,1,123,0.0,123.0,123.0
20474800.0,6,27,11887,13,2073,1706233.3333333333,408.0,159.46153846153845,14,9814,1281938.0,1514.0,701.0
32986.0,6,10,2032,5,524,7713.25,252.0,104.8,5,1508,7809.75,1236.0,301.6
103963.0,17,2,286,2,286,0.0,143.0,143.0,0,0,0.0,0.0,0.0
309295.0,17,4,1400,4,1400,103098.33333333331,350.0,350.0,0,0,0.0,0.0,0.0
2593106.0,6,2,132,1,66,0.0,66.0,66.0,1,66,0.0,66.0,66.0
108108959.0,17,5,955,5,955,27027239.75,191.0,191.0,0,0,0.0,0.0,0.0
21737.0,17,2,582,1,83,0.0,83.0,83.0,1,499,0.0,499.0,499.0
308121.0,6,6,412,4,272,102707.0,74.0,68.0,2,140,0.0,74.0,70.0
206048.0,6,3,426,2,280,0.0,214.0,140.0,1,146,0.0,146.0,146.0
321.0,17,2,208,1,72,0.0,72.0,72.0,1,136,0.0,136.0,136.0
362035.0,6,10,967,5,390,60679.0,162.0,78.0,5,577,60627.0,349.0,115.4
13546.0,6,11,1133,6,602,2709.2,264.0,100.33333333333331,5,531,2710.5,259.0,106.2
4293.0,17,2,582,1,83,0.0,83.0,83.0,1,499,0.0,499.0,499.0
228489.0,17,2,180,1,90,0.0,90.0,90.0,1,90,0.0,90.0,90.0
1990443.0,17,6,1039,4,312,661443.0,78.0,78.0,2,727,0.0,395.0,363.5
49168.0,6,14,4740,7,653,8022.666666666667,249.0,93.28571428571428,7,4087,7245.5,1514.0,583.8571428571429
90112833.0,17,28,13364,28,13364,3337512.333333333,501.0,477.2857142857143,0,0,0.0,0.0,0.0
324723.0,17,4,1400,4,1400,108241.0,350.0,350.0,0,0,0.0,0.0,0.0
1351740.0,17,16,1120,16,1120,90116.0,70.0,70.0,0,0,0.0,0.0,0.0
134010903.0,17,15,907,8,475,19144414.71428572,174.0,59.375,7,432,18971732.33333333,174.0,61.71428571428572
10519977.0,6,7,478,4,272,3461449.6666666665,74.0,68.0,3,206,5192078.5,74.0,68.66666666666667
1027302.0,6,11,1134,6,558,205460.4,220.0,93.0,5,576,255358.0,304.0,115.2
90257989.0,6,12,1832,8,1016,12893998.42857143,188.0,127.0,4,816,30030878.666666668,204.0,204.0
108072538.0,17,5,955,5,955,27018134.5,191.0,191.0,0,0,0.0,0.0,0.0
108103040.0,17,5,1005,5,1005,27025760.0,201.0,201.0,0,0,0.0,0.0,0.0
2799652.0,6,2,132,1,66,0.0,66.0,66.0,1,66,0.0,66.0,66.0
90054336.0,17,28,13364,28,13364,3335345.777777778,501.0,477.2857142857143,0,0,0.0,0.0,0.0
220560.0,17,2,180,1,90,0.0,90.0,90.0,1,90,0.0,90.0,90.0
108128051.0,17,5,955,5,955,27032012.75,191.0,191.0,0,0,0.0,0.0,0.0
2872791.0,6,12,2172,7,664,478643.5,252.0,94.85714285714286,5,1508,3382.25,1236.0,301.6
35041.0,6,10,2032,5,524,8117.0,252.0,104.8,5,1508,7924.75,1236.0,301.6
169263.0,6,13,1386,7,789,28210.5,253.0,112.71428571428572,6,597,32296.6,259.0,99.5
2033764.0,17,2,876,2,876,0.0,438.0,438.0,0,0,0.0,0.0,0.0
34075.0,6,14,4740,7,653,5558.666666666667,249.0,93.28571428571428,7,4087,5084.333333333333,1514.0,583.8571428571429
121397.0,6,3,337,2,214,0.0,160.0,107.0,1,123,0.0,123.0,123.0
208565.0,6,3,426,2,280,0.0,214.0,140.0,1,146,0.0,146.0,146.0
233444.0,6,3,337,2,214,0.0,160.0,107.0,1,123,0.0,123.0,123.0
24870.0,6,14,4740,7,653,3849.5,249.0,93.28571428571428,7,4087,4014.0,1514.0,583.8571428571429
33539.0,6,10,2032,5,524,6964.25,252.0,104.8,5,1508,7774.0,1236.0,301.6
1419897.0,17,16,1120,16,1120,94659.8,70.0,70.0,0,0,0.0,0.0,0.0
39765.0,6,10,2032,5,524,9627.75,252.0,104.8,5,1508,9126.75,1236.0,301.6
120125891.0,6,14,2224,9,1204,15015736.375,188.0,133.77777777777777,5,1020,22522569.5,204.0,204.0
108156932.0,17,14,864,7,432,18001964.333333332,174.0,61.71428571428572,7,432,18000166.5,174.0,61.71428571428572
143973.0,17,2,180,1,90,0.0,90.0,90.0,1,90,0.0,90.0,90.0
153425.0,17,2,180,1,90,0.0,90.0,90.0,1,90,0.0,90.0,90.0
220787.0,17,2,180,1,90,0.0,90.0,90.0,1,90,0.0,90.0,90.0
120015984.0,17,28,13364,28,13364,4445036.444444444,501.0,477.2857142857143,0,0,0.0,0.0,0.0
59284.0,6,14,4740,7,653,8429.0,249.0,93.28571428571428,7,4087,8450.833333333334,1514.0,583.8571428571429
217179.0,6,3,426,2,280,0.0,214.0,140.0,1,146,0.0,146.0,146.0
6950.0,17,2,582,1,83,0.0,83.0,83.0,1,499,0.0,499.0,499.0
108106356.0,17,5,955,5,955,27026589.0,191.0,191.0,0,0,0.0,0.0,0.0
1745.0,17,2,762,2,762,0.0,381.0,381.0,0,0,0.0,0.0,0.0
144347.0,17,2,180,1,90,0.0,90.0,90.0,1,90,0.0,90.0,90.0
843.0,17,4,438,2,148,0.0,74.0,74.0,2,290,0.0,147.0,145.0
102855.0,17,2,286,2,286,0.0,143.0,143.0,0,0,0.0,0.0,0.0
21634.0,6,10,2032,5,524,5172.5,252.0,104.8,5,1508,5125.5,1236.0,301.6
90254236.0,6,15,2168,8,1016,12893462.285714284,188.0,127.0,7,1152,15016152.333333334,204.0,164.57142857142858
222457.0,6,3,426,2,280,0.0,214.0,140.0,1,146,0.0,146.0,146.0
216679.0,17,2,180,1,90,0.0,90.0,90.0,1,90,0.0,90.0,90.0
308552.0,6,3,202,2,128,0.0,74.0,64.0,1,74,0.0,74.0,74.0
120036188.0,17,29,13785,29,13785,4287006.714285715,501.0,475.3448275862069,0,0,0.0,0.0,0.0
654463.0,17,6,1230,3,234,327044.0,78.0,78.0,3,996,327028.0,332.0,332.0
99779.0,17,2,762,2,762,0.0,381.0,381.0,0,0,0.0,0.0,0.0
113609559.0,6,46,3036,23,1518,5150440.318181818,66.0,66.0,23,1518,5150438.045454546,66.0,66.0
11845603.0,6,18,1536,9,962,1442193.0,315.0,106.88888888888889,9,574,1442171.375,78.0,63.77777777777778
38933.0,6,10,2032,5,524,9464.0,252.0,104.8,5,1508,7939.0,1236.0,301.6
39740.0,6,14,4740,7,653,5753.333333333333,249.0,93.28571428571428,7,4087,6073.333333333333,1514.0,583.8571428571429
283904.0,6,10,1221,6,636,56780.8,298.0,106.0,4,585,89189.66666666667,379.0,146.25
305526.0,6,6,412,4,272,101842.0,74.0,68.0,2,140,0.0,74.0,70.0
13070.0,6,10,2032,5,524,3046.0,252.0,104.8,5,1508,3012.0,1236.0,301.6
103454793.0,17,14,864,7,432,17215978.0,174.0,61.71428571428572,7,432,17195745.0,174.0,61.71428571428572
318.0,17,2,174,1,79,0.0,79.0,79.0,1,95,0.0,95.0,95.0
119398647.0,6,229,25928,115,7812,1047356.552631579,140.0,67.9304347826087,114,18116,1047537.2035398232,284.0,158.91228070175438
314275.0,17,4,1400,4,1400,104758.33333333331,350.0,350.0,0,0,0.0,0.0,0.0
148372.0,17,2,414,1,88,0.0,88.0,88.0,1,326,0.0,326.0,326.0
105702501.0,6,43,2838,22,1452,5033440.666666667,66.0,66.0,21,1386,5153597.75,66.0,66.0
295.0,17,2,156,1,78,0.0,78.0,78.0,1,78,0.0,78.0,78.0
4174.0,17,2,614,1,72,0.0,72.0,72.0,1,542,0.0,542.0,542.0
10447300.0,6,7,478,4,272,3437195.6666666665,74.0,68.0,3,206,5155691.5,74.0,68.66666666666667
108111037.0,17,5,1005,5,1005,27027759.25,201.0,201.0,0,0,0.0,0.0,0.0
104208734.0,6,194,21886,97,15262,1083262.78125,284.0,157.340206185567,97,6624,1083265.5,140.0,68.28865979381443
37084.0,6,14,4740,7,653,6059.166666666667,249.0,93.28571428571428,7,4087,5945.833333333333,1514.0,583.8571428571429
24762.0,6,14,4740,7,653,4013.6666666666665,249.0,93.28571428571428,7,4087,3897.8333333333335,1514.0,583.8571428571429
108103275.0,17,5,1005,5,1005,27025818.75,201.0,201.0,0,0,0.0,0.0,0.0
217180.0,6,3,426,2,280,0.0,214.0,140.0,1,146,0.0,146.0,146.0
146171.0,6,3,337,2,214,0.0,160.0,107.0,1,123,0.0,123.0,123.0
67165.0,6,14,4740,7,653,11029.0,249.0,93.28571428571428,7,4087,10868.0,1514.0,583.8571428571429
205821.0,17,2,180,1,90,0.0,90.0,90.0,1,90,0.0,90.0,90.0
38624863.0,6,5,336,2,134,0.0,68.0,67.0,3,202,19241517.5,70.0,67.33333333333333
42017.0,6,10,2032,5,524,9591.0,252.0,104.8,5,1508,8626.5,1236.0,301.6
1919740.0,6,4,492,2,280,0.0,214.0,140.0,2,212,0.0,146.0,106.0
120437669.0,6,227,25594,114,17914,1065820.0796460176,284.0,157.140350877193,113,7680,1066109.857142857,140.0,67.96460176991151
34404.0,6,14,4740,7,653,5484.666666666667,249.0,93.28571428571428,7,4087,5597.833333333333,1514.0,583.8571428571429
292.0,17,2,168,1,76,0.0,76.0,76.0,1,92,0.0,92.0,92.0
253162.0,6,3,337,2,214,0.0,160.0,107.0,1,123,0.0,123.0,123.0
239120.0,17,2,180,1,90,0.0,90.0,90.0,1,90,0.0,90.0,90.0
26894.0,6,14,4740,7,653,4169.666666666667,249.0,93.28571428571428,7,4087,4266.166666666667,1514.0,583.8571428571429
90041153.0,17,28,13364,28,13364,3334857.5185185187,501.0,477.2857142857143,0,0,0.0,0.0,0.0
48553.0,6,14,4740,7,653,7964.666666666667,249.0,93.28571428571428,7,4087,6919.166666666667,1514.0,583.8571428571429
298047.0,6,6,412,4,272,99349.0,74.0,68.0,2,140,0.0,74.0,70.0
363.0,17,2,174,1,79,0.0,79.0,79.0,1,95,0.0,95.0,95.0
2983.0,17,2,224,1,76,0.0,76.0,76.0,1,148,0.0,148.0,148.0
62055911.0,6,17,1185,8,586,8864189.0,95.0,73.25,9,599,7750898.5,95.0,66.55555555555556
90079988.0,6,12,1848,5,1020,22518998.0,204.0,204.0,7,828,15013151.5,188.0,118.28571428571428
120964815.0,17,14,864,7,432,16834174.166666668,174.0,61.71428571428572,7,432,16833550.666666668,174.0,61.71428571428572
43751.0,6,14,4740,7,653,6676.0,249.0,93.28571428571428,7,4087,6876.666666666667,1514.0,583.8571428571429
115060483.0,6,48,3168,24,1584,5002629.695652174,66.0,66.0,24,1584,4988958.391304348,66.0,66.0
113733698.0,6,46,3036,23,1518,5155438.909090909,66.0,66.0,23,1518,5155438.909090909,66.0,66.0
232924.0,6,3,337,2,214,0.0,160.0,107.0,1,123,0.0,123.0,123.0
1303432.0,6,4,264,2,132,0.0,66.0,66.0,2,132,0.0,66.0,66.0
284822.0,17,2,363,1,79,0.0,79.0,79.0,1,284,0.0,284.0,284.0
90010789.0,17,28,13364,28,13364,3333732.925925926,501.0,477.2857142857143,0,0,0.0,0.0,0.0
100738543.0,6,28,1876,14,982,7732487.384615385,139.0,70.14285714285714,14,894,7732521.384615385,123.0,63.85714285714285
92133645.0,17,12,778,6,389,18401298.8,174.0,64.83333333333333,6,389,18400166.8,174.0,64.83333333333333
27896.0,6,14,4740,7,653,4489.333333333333,249.0,93.28571428571428,7,4087,4509.833333333333,1514.0,583.8571428571429
96223359.0,17,12,778,6,389,19201439.4,174.0,64.83333333333333,6,389,19200210.2,174.0,64.83333333333333
110987432.0,6,32,2220,16,1149,7384770.4,123.0,71.8125,16,1071,7384735.533333333,123.0,66.9375
32432.000000000004,6,10,2032,5,524,7888.75,252.0,104.8,5,1508,7621.75,1236.0,301.6
347013.0,6,10,1221,6,636,69402.6,298.0,106.0,4,585,110123.66666666669,379.0,146.25
111153028.0,17,14,1126,7,563,18498671.0,174.0,80.42857142857143,7,563,18498683.666666668,174.0,80.42857142857143
90309750.0,6,18,1382,10,786,10027000.444444444,95.0,78.6,8,596,12507619.142857144,95.0,74.5
321685.0,17,2,180,1,90,0.0,90.0,90.0,1,90,0.0,90.0,90.0
0.0,17,1,55,1,55,0.0,55.0,55.0,0,0,0.0,0.0,0.0
111977.0,17,2,286,2,286,0.0,143.0,143.0,0,0,0.0,0.0,0.0
767.0,17,4,438,2,148,0.0,74.0,74.0,2,290,0.0,147.0,145.0
38409.0,6,14,4740,7,653,6268.333333333333,249.0,93.28571428571428,7,4087,6120.166666666667,1514.0,583.8571428571429
104539906.0,17,14,864,7,432,17333504.666666668,174.0,61.71428571428572,7,432,17334168.333333332,174.0,61.71428571428572
120124473.0,6,14,2224,9,1204,15015559.125,188.0,133.77777777777777,5,1020,22523210.75,204.0,204.0
1212629.0,6,13,3010,8,2382,173232.7142857143,1514.0,297.75,5,628,234974.0,331.0,125.6
30706.0,6,14,4740,7,653,4891.0,249.0,93.28571428571428,7,4087,4915.5,1514.0,583.8571428571429
120017700.0,17,29,13785,29,13785,4286346.428571428,501.0,475.3448275862069,0,0,0.0,0.0,0.0
242423.0,6,3,337,2,214,0.0,160.0,107.0,1,123,0.0,123.0,123.0
109546220.0,6,44,2904,22,1452,5216486.666666667,66.0,66.0,22,1452,5201512.047619048,66.0,66.0
33765.0,6,14,4740,7,653,5520.666666666667,249.0,93.28571428571428,7,4087,3923.8333333333335,1514.0,583.8571428571429
110526614.0,6,32,2236,16,1165,7354045.333333333,139.0,72.8125,16,1071,7354048.133333334,123.0,66.9375
114374330.0,6,235,26642,118,8084,977558.376068376,140.0,68.50847457627118,117,18558,978101.6810344828,300.0,158.6153846153846
1027468.0,6,11,1134,6,558,205493.6,220.0,93.0,5,576,256265.0,304.0,115.2
2843928.0,6,12,2172,7,664,473885.8333333333,252.0,94.85714285714286,5,1508,1838.25,1236.0,301.6
314656.0,6,10,1221,6,636,62931.2,298.0,106.0,4,585,99342.33333333331,379.0,146.25
108109048.0,17,5,955,5,955,27027262.0,191.0,191.0,0,0,0.0,0.0,0.0
108104951.0,17,5,955,5,955,27026237.75,191.0,191.0,0,0,0.0,0.0,0.0
113520271.0,6,46,3036,23,1518,5159998.227272728,66.0,66.0,23,1518,5159995.954545454,66.0,66.0
321822.0,17,4,1400,4,1400,107274.0,350.0,350.0,0,0,0.0,0.0,0.0
81998.0,6,10,1065,5,534,20025.25,262.0,106.8,5,531,16502.0,259.0,106.2
153406.0,17,2,180,1,90,0.0,90.0,90.0,1,90,0.0,90.0,90.0
11623.0,6,10,1067,5,536,2269.25,264.0,107.2,5,531,2718.0,259.0,106.2
103813.0,17,2,286,2,286,0.0,143.0,143.0,0,0,0.0,0.0,0.0
40538.0,6,11,2098,6,590,7445.2,252.0,98.33333333333331,5,1508,9718.0,1236.0,301.6
135133242.0,17,6,1146,6,1146,27026648.4,191.0,191.0,0,0,0.0,0.0,0.0
303233.0,6,6,412,4,272,101077.66666666669,74.0,68.0,2,140,0.0,74.0,70.0
93360.0,6,10,2032,5,524,23107.25,252.0,104.8,5,1508,22215.0,1236.0,301.6
24862.0,6,14,4740,7,653,2903.833333333333,249.0,93.28571428571428,7,4087,3734.3333333333335,1514.0,583.8571428571429
196887.0,17,2,180,1,90,0.0,90.0,90.0,1,90,0.0,90.0,90.0
120001368.0,6,28,3046,14,1544,9230729.23076923,426.0,110.28571428571428,14,1502,9230070.23076923,333.0,107.28571428571428
261887.0,6,10,1221,6,636,52377.4,298.0,106.0,4,585,81897.0,379.0,146.25
108093239.0,17,5,1005,5,1005,27023309.75,201.0,201.0,0,0,0.0,0.0,0.0
217852.0,6,3,426,2,280,0.0,214.0,140.0,1,146,0.0,146.0,146.0
303180.0,6,2,132,1,66,0.0,66.0,66.0,1,66,0.0,66.0,66.0
98302583.0,17,14,1126,7,563,16333784.666666666,174.0,80.42857142857143,7,563,16333472.333333334,174.0,80.42857142857143
441631.0,6,10,1221,6,636,88326.2,298.0,106.0,4,585,141857.0,379.0,146.25
90296962.0,6,16,1192,8,596,12893003.857142856,95.0,74.5,8,596,12898993.0,95.0,74.5
296.0,17,2,174,1,79,0.0,79.0,79.0,1,95,0.0,95.0,95.0
4449.0,17,2,614,1,72,0.0,72.0,72.0,1,542,0.0,542.0,542.0
1314577.0,6,4,264,2,132,0.0,66.0,66.0,2,132,0.0,66.0,66.0
308025.0,6,6,412,4,272,102675.0,74.0,68.0,2,140,0.0,74.0,70.0
120124231.0,6,13,2020,9,1204,15015528.875,188.0,133.77777777777777,4,816,30030982.0,204.0,204.0
119358843.0,6,275,31394,138,9330,871232.4306569343,140.0,67.6086956521739,137,22064,869998.5661764706,284.0,161.05109489051094
11090.0,17,2,582,1,83,0.0,83.0,83.0,1,499,0.0,499.0,499.0
136599366.0,17,16,1343,9,780,17074920.75,174.0,86.66666666666667,7,563,16148526.833333334,174.0,80.42857142857143
2125.0,17,4,344,2,150,0.0,75.0,75.0,2,194,0.0,103.0,97.0
10471772.0,6,7,478,4,272,3445094.333333333,74.0,68.0,3,206,5167536.5,74.0,68.66666666666667
148059.0,17,2,180,1,90,0.0,90.0,90.0,1,90,0.0,90.0,90.0
217580.0,6,3,426,2,280,0.0,214.0,140.0,1,146,0.0,146.0,146.0
143936.0,17,2,180,1,90,0.0,90.0,90.0,1,90,0.0,90.0,90.0
2075.0,17,4,344,2,150,0.0,75.0,75.0,2,194,0.0,103.0,97.0
13179.0,6,10,2032,5,524,2998.5,252.0,104.8,5,1508,2625.5,1236.0,301.6
90301452.0,6,16,1192,8,596,12893665.142857144,95.0,74.5,8,596,12899457.857142856,95.0,74.5
285171.0,6,12,1373,7,714,47528.5,298.0,102.0,5,659,67185.75,379.0,131.8
545790.0,17,6,2100,6,2100,109158.0,350.0,350.0,0,0,0.0,0.0,0.0
32053.0,6,14,4740,7,653,4694.666666666667,249.0,93.28571428571428,7,4087,5206.0,1514.0,583.8571428571429
90048121.0,17,28,13364,28,13364,3335115.592592593,501.0,477.2857142857143,0,0,0.0,0.0,0.0
135131902.0,17,6,1206,6,1206,27026380.4,201.0,201.0,0,0,0.0,0.0,0.0
103535140.0,6,44,2904,22,1452,4930244.761904762,66.0,66.0,22,1452,4919946.0,66.0,66.0
102818.0,17,2,286,2,286,0.0,143.0,143.0,0,0,0.0,0.0,0.0
0.0,17,1,179,1,179,0.0,179.0,179.0,0,0,0.0,0.0,0.0
11726.0,6,11,1132,6,556,2146.2,218.0,92.66666666666669,5,576,2504.75,304.0,115.2
514.0,17,2,508,2,508,0.0,257.0,254.0,0,0,0.0,0.0,0.0
6069.0,17,2,447,1,84,0.0,84.0,84.0,1,363,0.0,363.0,363.0
119271203.0,6,21,1544,12,894,10842836.636363637,95.0,74.5,9,650,14851401.375,95.0,72.22222222222223
8923.0,6,10,2032,5,524,1986.5,252.0,104.8,5,1508,1940.5,1236.0,301.6
319.0,17,2,174,1,79,0.0,79.0,79.0,1,95,0.0,95.0,95.0
586.0,17,2,508,2,508,0.0,257.0,254.0,0,0,0.0,0.0,0.0
90257790.0,6,12,1832,8,1016,12893970.0,188.0,127.0,4,816,30031135.33333333,204.0,204.0
108113746.0,17,5,1005,5,1005,27028436.5,201.0,201.0,0,0,0.0,0.0,0.0
3005006.0,6,11,2106,6,598,600798.6,252.0,99.66666666666669,5,1508,1687.0,1236.0,301.6
33359.0,6,10,2032,5,524,7634.0,252.0,104.8,5,1508,8025.0,1236.0,301.6
162259.0,17,2,180,1,90,0.0,90.0,90.0,1,90,0.0,90.0,90.0
90075521.0,17,28,13364,28,13364,3336130.407407407,501.0,477.2857142857143,0,0,0.0,0.0,0.0
116207114.0,6,48,3168,24,1584,5052483.217391305,66.0,66.0,24,1584,5039275.173913044,66.0,66.0
7104.0,17,2,582,1,83,0.0,83.0,83.0,1,499,0.0,499.0,499.0
90082712.0,6,11,1644,4,816,30026292.0,204.0,204.0,7,828,15013588.5,188.0,118.28571428571428
295.0,17,2,168,1,76,0.0,76.0,76.0,1,92,0.0,92.0,92.0
104417.0,17,2,286,2,286,0.0,143.0,143.0,0,0,0.0,0.0,0.0
123318021.0,6,35,2542,18,1348,7254001.235294118,139.0,74.88888888888889,17,1194,7069809.75,123.0,70.23529411764706
40038.0,6,10,2032,5,524,9779.75,252.0,104.8,5,1508,9734.25,1236.0,301.6
33114.0,6,2,145,2,145,0.0,91.0,72.5,0,0,0.0,0.0,0.0
120120803.0,6,14,2224,9,1204,15015100.375,188.0,133.77777777777777,5,1020,22522810.5,204.0,204.0
229041.0,17,2,180,1,90,0.0,90.0,90.0,1,90,0.0,90.0,90.0
0.0,17,1,453,1,453,0.0,453.0,453.0,0,0,0.0,0.0,0.0
119457321.0,6,209,23602,105,7226,1148628.0865384615,140.0,68.81904761904762,104,16376,1149707.2427184463,284.0,157.46153846153845
204716.0,17,2,762,2,762,0.0,381.0,381.0,0,0,0.0,0.0,0.0
90957894.0,6,21,1585,11,840,9094977.5,95.0,76.36363636363636,10,745,10104843.222222222,95.0,74.5
235803.0,17,2,180,1,90,0.0,90.0,90.0,1,90,0.0,90.0,90.0
2575577.0,6,2,132,1,66,0.0,66.0,66.0,1,66,0.0,66.0,66.0
51279.0,6,10,2032,5,524,12591.25,252.0,104.8,5,1508,12259.0,1236.0,301.6
108109006.0,17,5,955,5,955,27027251.5,191.0,191.0,0,0,0.0,0.0,0.0
9827.0,17,2,582,1,83,0.0,83.0,83.0,1,499,0.0,499.0,499.0
120044255.0,17,29,13785,29,13785,4287294.821428572,501.0,475.3448275862069,0,0,0.0,0.0,0.0
120000039.0,6,20,1531,11,840,12000003.9,95.0,76.36363636363636,9,691,11287131.75,95.0,76.77777777777777
229056.0,6,3,426,2,280,0.0,214.0,140.0,1,146,0.0,146.0,146.0
0.0,6,1,66,1,66,0.0,66.0,66.0,0,0,0.0,0.0,0.0
109520251.0,6,188,21188,94,14688,1175322.0537634408,284.0,156.25531914893617,94,6500,1175293.0430107526,140.0,69.14893617021276
123839960.0,6,49,3234,25,1650,5159998.333333333,66.0,66.0,24,1584,4964362.130434782,66.0,66.0
102132473.0,17,14,864,7,432,17000198.0,174.0,61.71428571428572,7,432,17001188.5,174.0,61.71428571428572
228323.0,17,2,180,1,90,0.0,90.0,90.0,1,90,0.0,90.0,90.0
135134386.0,17,6,1146,6,1146,27026877.2,191.0,191.0,0,0,0.0,0.0,0.0
177404.0,17,2,180,1,90,0.0,90.0,90.0,1,90,0.0,90.0,90.0
20930.0,6,10,1067,5,536,5014.75,264.0,107.2,5,531,4507.25,259.0,106.2
34030.0,6,10,2032,5,524,6174.25,252.0,104.8,5,1508,7579.5,1236.0,301.6
300277.0,6,6,412,4,272,100092.33333333331,74.0,68.0,2,140,0.0,74.0,70.0
135132807.0,17,6,1146,6,1146,27026561.4,191.0,191.0,0,0,0.0,0.0,0.0
1444.0,17,2,762,2,762,0.0,381.0,381.0,0,0,0.0,0.0,0.0
3014.0,17,2,224,1,76,0.0,76.0,76.0,1,148,0.0,148.0,148.0
143994.0,17,2,180,1,90,0.0,90.0,90.0,1,90,0.0,90.0,90.0
221526.0,6,3,426,2,280,0.0,214.0,140.0,1,146,0.0,146.0,146.0
1771478.0,6,2,132,1,66,0.0,66.0,66.0,1,66,0.0,66.0,66.0
26212.0,6,14,4740,7,653,4213.5,249.0,93.28571428571428,7,4087,4141.833333333333,1514.0,583.8571428571429
135129462.0,17,6,1146,6,1146,27025892.4,191.0,191.0,0,0,0.0,0.0,0.0
1047860.0,6,13,1394,7,797,174643.33333333334,253.0,113.85714285714286,6,597,207601.0,259.0,99.5
15145.0,6,11,2098,6,590,2810.4,252.0,98.33333333333331,5,1508,2227.75,1236.0,301.6
314050.0,17,4,1400,4,1400,104683.33333333331,350.0,350.0,0,0,0.0,0.0,0.0
33575.0,6,14,4740,7,653,4749.166666666667,249.0,93.28571428571428,7,4087,5076.833333333333,1514.0,583.8571428571429
305812.0,6,6,412,4,272,101937.33333333331,74.0,68.0,2,140,0.0,74.0,70.0
121265.0,6,3,337,2,214,0.0,160.0,107.0,1,123,0.0,123.0,123.0
107589.0,17,2,286,2,286,0.0,143.0,143.0,0,0,0.0,0.0,0.0
135132825.0,17,6,1146,6,1146,27026565.0,191.0,191.0,0,0,0.0,0.0,0.0
111020896.0,6,30,1974,15,1026,7914646.0,123.0,68.4,15,948,7914641.357142857,123.0,63.2
102230.0,17,2,700,2,700,0.0,350.0,350.0,0,0,0.0,0.0,0.0
292.0,17,2,174,1,79,0.0,79.0,79.0,1,95,0.0,95.0,95.0
153376.0,17,2,180,1,90,0.0,90.0,90.0,1,90,0.0,90.0,90.0
90299474.0,6,16,1192,8,596,12893410.857142856,95.0,74.5,8,596,12898366.714285716,95.0,74.5
236024.0,17,4,1524,4,1524,78674.66666666667,381.0,381.0,0,0,0.0,0.0,0.0
305.0,17,2,168,1,76,0.0,76.0,76.0,1,92,0.0,92.0,92.0
2295.0,17,4,344,2,150,0.0,75.0,75.0,2,194,0.0,103.0,97.0
228207.0,17,2,180,1,90,0.0,90.0,90.0,1,90,0.0,90.0,90.0
13914.0,6,13,1459,7,862,2158.1666666666665,271.0,123.14285714285714,6,597,2476.2,259.0,99.5
38928.0,6,10,2032,5,524,8492.0,252.0,104.8,5,1508,8315.25,1236.0,301.6
95815931.0,6,167,18828,84,5766,1154408.8072289156,140.0,68.64285714285714,83,13062,1155942.8902439023,284.0,157.3734939759036
217076.0,6,10,1221,6,636,43415.2,298.0,106.0,4,585,70224.66666666667,379.0,146.25
95013751.0,6,29,2068,15,1105,6771290.571428572,139.0,73.66666666666667,14,963,7292161.076923077,123.0,68.78571428571429
120381361.0,6,217,24580,109,17156,1114642.2314814816,284.0,157.39449541284404,108,7424,1115413.859813084,140.0,68.74074074074075
33992.0,6,14,4740,7,653,3713.0,249.0,93.28571428571428,7,4087,5510.333333333333,1514.0,583.8571428571429
26966040.0,17,5,1718,4,1368,967720.6666666666,342.0,342.0,1,350,0.0,350.0,350.0
24868.0,6,14,4740,7,653,3730.3333333333335,249.0,93.28571428571428,7,4087,4009.1666666666665,1514.0,583.8571428571429
137678.0,6,2,132,1,66,0.0,66.0,66.0,1,66,0.0,66.0,66.0
92853016.0,6,26,1815,13,909,7737751.333333333,123.0,69.92307692307692,13,906,7719595.0,123.0,69.6923076923077
17057.0,17,2,180,1,90,0.0,90.0,90.0,1,90,0.0,90.0,90.0
52268.0,6,10,2032,5,524,12487.25,252.0,104.8,5,1508,12468.25,1236.0,301.6
27536.0,6,11,2098,6,590,4359.4,252.0,98.33333333333331,5,1508,4924.5,1236.0,301.6
16125648.000000002,17,10,3500,10,3500,1791738.6666666667,350.0,350.0,0,0,0.0,0.0,0.0
103369.0,17,2,286,2,286,0.0,143.0,143.0,0,0,0.0,0.0,0.0
1450.0,17,2,762,2,762,0.0,381.0,381.0,0,0,0.0,0.0,0.0
316838.0,17,4,1400,4,1400,105612.66666666669,350.0,350.0,0,0,0.0,0.0,0.0
48685.0,6,10,2032,5,524,11926.0,252.0,104.8,5,1508,10873.25,1236.0,301.6
120000076.0,6,25,1924,14,1084,9230775.076923076,95.0,77.42857142857143,11,840,8954517.8,95.0,76.36363636363636
117253666.0,6,221,24950,111,7622,1065942.4181818182,140.0,68.66666666666667,110,17328,1066065.1559633028,284.0,157.52727272727273
92254008.0,6,19,1597,10,947,10245038.444444444,256.0,94.7,9,650,11530217.25,95.0,72.22222222222223
277613.0,6,10,1221,6,636,55522.6,298.0,106.0,4,585,86380.0,379.0,146.25
146275.0,6,3,337,2,214,0.0,160.0,107.0,1,123,0.0,123.0,123.0
96543.0,6,15,4806,8,719,13415.857142857143,249.0,89.875,7,4087,15651.5,1514.0,583.8571428571429
319.0,17,2,174,1,79,0.0,79.0,79.0,1,95,0.0,95.0,95.0
228578.0,17,2,180,1,90,0.0,90.0,90.0,1,90,0.0,90.0,90.0
147908.0,17,2,180,1,90,0.0,90.0,90.0,1,90,0.0,90.0,90.0
108103966.0,17,5,955,5,955,27025991.5,191.0,191.0,0,0,0.0,0.0,0.0
365505.0,6,11,1021,6,444,49215.6,162.0,74.0,5,577,61415.0,349.0,115.4
757.0,17,4,438,2,148,0.0,74.0,74.0,2,290,0.0,147.0,145.0
0.0,17,1,55,1,55,0.0,55.0,55.0,0,0,0.0,0.0,0.0
27611794.0,17,5,1710,5,1710,6902948.5,342.0,342.0,0,0,0.0,0.0,0.0
204874.0,17,2,762,2,762,0.0,381.0,381.0,0,0,0.0,0.0,0.0
311621.0,6,6,412,4,272,103873.66666666669,74.0,68.0,2,140,0.0,74.0,70.0
102437.0,17,4,6056,4,6056,34145.666666666664,1514.0,1514.0,0,0,0.0,0.0,0.0
120038202.0,17,28,13364,28,13364,4445859.333333333,501.0,477.2857142857143,0,0,0.0,0.0,0.0
23449.0,6,14,4740,7,653,3526.333333333333,249.0,93.28571428571428,7,4087,3632.6666666666665,1514.0,583.8571428571429
98785.0,17,2,762,2,762,0.0,381.0,381.0,0,0,0.0,0.0,0.0
1627197.0,17,2,346,1,78,0.0,78.0,78.0,1,268,0.0,268.0,268.0
19865.0,6,14,4740,7,653,2929.5,249.0,93.28571428571428,7,4087,3177.5,1514.0,583.8571428571429
5935066.0,6,117,112334,36,2549,169573.3142857143,207.0,70.80555555555556,81,109785,74108.9375,1514.0,1355.3703703703704
34507.0,6,14,4740,7,653,5589.0,249.0,93.28571428571428,7,4087,4674.666666666667,1514.0,583.8571428571429
128862230.0,6,35,2410,18,1285,7580131.176470588,139.0,71.38888888888889,17,1125,7416343.375,123.0,66.17647058823529
58175.0,6,14,4740,7,653,8452.5,249.0,93.28571428571428,7,4087,8203.0,1514.0,583.8571428571429
197097.0,17,2,180,1,90,0.0,90.0,90.0,1,90,0.0,90.0,90.0
97040330.0,17,14,1126,7,563,16167286.5,174.0,80.42857142857143,7,563,16166776.333333334,174.0,80.42857142857143
0.0,6,1,60,1,60,0.0,60.0,60.0,0,0,0.0,0.0,0.0
171710.0,17,2,180,1,90,0.0,90.0,90.0,1,90,0.0,90.0,90.0
10880241.0,6,8,544,4,272,3581338.6666666665,74.0,68.0,4,272,3581267.6666666665,74.0,68.0
119411197.0,6,227,25562,114,7820,1056736.256637168,140.0,68.59649122807018,113,17742,1056961.455357143,284.0,157.00884955752213
197000.0,17,2,180,1,90,0.0,90.0,90.0,1,90,0.0,90.0,90.0
122513.0,6,3,373,2,238,0.0,172.0,119.0,1,135,0.0,135.0,135.0
120010120.0,6,21,1585,11,840,11999981.2,95.0,76.36363636363636,10,745,13334098.888888888,95.0,74.5
46346.0,6,14,4740,7,653,7572.0,249.0,93.28571428571428,7,4087,6904.666666666667,1514.0,583.8571428571429
228446.0,17,2,180,1,90,0.0,90.0,90.0,1,90,0.0,90.0,90.0
9005159.0,17,4,300,4,300,3001719.6666666665,75.0,75.0,0,0,0.0,0.0,0.0
611.0,17,2,762,2,762,0.0,381.0,381.0,0,0,0.0,0.0,0.0
306984.0,6,6,412,4,272,102328.0,74.0,68.0,2,140,0.0,74.0,70.0
167630.0,17,4,571,2,148,0.0,74.0,74.0,2,423,0.0,276.0,211.5
120004246.0,6,18,1341,9,691,14999992.375,95.0,76.77777777777777,9,650,14999913.125,95.0,72.22222222222223
39177.0,6,14,4740,7,653,4812.333333333333,249.0,93.28571428571428,7,4087,6388.666666666667,1514.0,583.8571428571429
41285.0,6,14,4740,7,653,6205.0,249.0,93.28571428571428,7,4087,6674.0,1514.0,583.8571428571429
142450.0,6,2,132,1,66,0.0,66.0,66.0,1,66,0.0,66.0,66.0
108105042.0,17,5,955,5,955,27026260.5,191.0,191.0,0,0,0.0,0.0,0.0
15034.0,17,2,180,1,90,0.0,90.0,90.0,1,90,0.0,90.0,90.0
103491.0,17,2,286,2,286,0.0,143.0,143.0,0,0,0.0,0.0,0.0
120122879.0,6,14,2240,6,1224,24024575.8,204.0,204.0,8,1016,17137239.285714287,188.0,127.0
2180.0,17,2,180,1,90,0.0,90.0,90.0,1,90,0.0,90.0,90.0
2785084.0,6,2,132,1,66,0.0,66.0,66.0,1,66,0.0,66.0,66.0
6752.0,17,4,823,2,163,0.0,89.0,81.5,2,660,0.0,443.0,330.0
499.0,17,2,508,2,508,0.0,257.0,254.0,0,0,0.0,0.0,0.0
108106255.0,17,5,955,5,955,27026563.75,191.0,191.0,0,0,0.0,0.0,0.0
44675.0,6,14,4740,7,653,7189.833333333333,249.0,93.28571428571428,7,4087,6501.333333333333,1514.0,583.8571428571429
36513.0,6,14,4740,7,653,5840.833333333333,249.0,93.28571428571428,7,4087,5817.666666666667,1514.0,583.8571428571429
2312.0,17,4,344,2,150,0.0,75.0,75.0,2,194,0.0,103.0,97.0
508.0,17,2,267,1,83,0.0,83.0,83.0,1,184,0.0,184.0,184.0
218520.0,17,2,180,1,90,0.0,90.0,90.0,1,90,0.0,90.0,90.0
206712.0,17,2,180,1,90,0.0,90.0,90.0,1,90,0.0,90.0,90.0
94315702.0,6,39,2574,20,1320,4947455.105263158,66.0,66.0,19,1254,5155422.5,66.0,66.0
2592503.0,6,2,132,1,66,0.0,66.0,66.0,1,66,0.0,66.0,66.0
284244.0,17,2,363,1,79,0.0,79.0,79.0,1,284,0.0,284.0,284.0
302219.0,6,6,412,4,272,100739.66666666669,74.0,68.0,2,140,0.0,74.0,70.0
298229.0,6,6,412,4,272,99409.66666666669,74.0,68.0,2,140,0.0,74.0,70.0
90021296.0,17,28,13364,28,13364,3334122.074074074,501.0,477.2857142857143,0,0,0.0,0.0,0.0
103421192.0,6,42,2772,21,1386,5155441.75,66.0,66.0,21,1386,5155444.1,66.0,66.0
501160.00000000006,6,5,336,2,134,0.0,68.0,67.0,3,202,195546.0,70.0,67.33333333333333
1302378.0,6,4,264,2,132,0.0,66.0,66.0,2,132,0.0,66.0,66.0
9586.0,17,2,571,1,86,0.0,86.0,86.0,1,485,0.0,485.0,485.0
31999.0,6,11,2098,6,590,5516.0,252.0,98.33333333333331,5,1508,7403.75,1236.0,301.6
62807.0,6,13,1386,7,789,10112.5,253.0,112.71428571428572,6,597,11159.4,259.0,99.5
2318.0,17,4,344,2,150,0.0,75.0,75.0,2,194,0.0,103.0,97.0
3009220.0,6,12,2172,7,664,501271.8333333333,252.0,94.85714285714286,5,1508,2376.25,1236.0,301.6
206573.0,6,3,426,2,280,0.0,214.0,140.0,1,146,0.0,146.0,146.0
37172.0,6,14,4740,7,653,4947.333333333333,249.0,93.28571428571428,7,4087,6020.666666666667,1514.0,583.8571428571429
206879.0,6,3,426,2,280,0.0,214.0,140.0,1,146,0.0,146.0,146.0
213433.0,6,10,1221,6,636,42686.6,298.0,106.0,4,585,69886.66666666667,379.0,146.25
1316354.0,17,7,490,7,490,219392.3333333333,70.0,70.0,0,0,0.0,0.0,0.0
168079.0,17,2,414,1,88,0.0,88.0,88.0,1,326,0.0,326.0,326.0
327.0,17,2,166,1,75,0.0,75.0,75.0,1,91,0.0,91.0,91.0
11510.0,6,11,2098,6,590,2015.0,252.0,98.33333333333331,5,1508,2604.75,1236.0,301.6
103589.0,17,2,286,2,286,0.0,143.0,143.0,0,0,0.0,0.0,0.0
168095.0,17,2,414,1,88,0.0,88.0,88.0,1,326,0.0,326.0,326.0
3060801.0,6,3,204,2,136,0.0,70.0,68.0,1,68,0.0,68.0,68.0
24283.0,6,10,2032,5,524,5614.0,252.0,104.8,5,1508,5279.75,1236.0,301.6
304424.0,6,7,478,4,272,101474.66666666669,74.0,68.0,3,206,76216.5,74.0,68.66666666666667
57584.0,6,10,2032,5,524,14172.0,252.0,104.8,5,1508,7903.25,1236.0,301.6
108105937.0,17,5,1005,5,1005,27026484.25,201.0,201.0,0,0,0.0,0.0,0.0
0.0,17,1,55,1,55,0.0,55.0,55.0,0,0,0.0,0.0,0.0
98130084.0,6,313,38454,157,10584,629039.0,140.0,67.4140127388535,156,27870,631562.2193548387,336.0,178.65384615384616
14640444.0,6,20,1605,10,973,1592849.7777777778,315.0,97.3,10,632,1592822.111111111,78.0,63.2
42968.0,6,10,1066,5,490,9402.5,218.0,98.0,5,576,9083.25,304.0,115.2
0.0,17,1,179,1,179,0.0,179.0,179.0,0,0,0.0,0.0,0.0
111947595.0,6,33,2296,17,1225,6983945.125,139.0,72.05882352941177,16,1071,7449538.333333333,123.0,66.9375
151488.0,17,2,414,1,88,0.0,88.0,88.0,1,326,0.0,326.0,326.0
1302388.0,6,4,264,2,132,0.0,66.0,66.0,2,132,0.0,66.0,66.0
216493.0,17,2,180,1,90,0.0,90.0,90.0,1,90,0.0,90.0,90.0
3168079.0,6,18,1495,9,921,358379.125,315.0,102.33333333333331,9,574,358345.25,78.0,63.77777777777778
274517.0,6,10,1221,6,636,54903.4,298.0,106.0,4,585,85558.0,379.0,146.25
314530.0,6,6,412,4,272,104843.33333333331,74.0,68.0,2,140,0.0,74.0,70.0
109882147.0,17,13,821,7,432,18313691.166666668,174.0,61.71428571428572,6,389,18021910.8,174.0,64.83333333333333
35034.0,6,14,4740,7,653,5458.5,249.0,93.28571428571428,7,4087,5412.833333333333,1514.0,583.8571428571429
268491.0,6,10,1221,6,636,53698.2,298.0,106.0,4,585,83548.66666666667,379.0,146.25
320994.0,17,4,1400,4,1400,106998.0,350.0,350.0,0,0,0.0,0.0,0.0
234526.0,6,3,426,2,280,0.0,214.0,140.0,1,146,0.0,146.0,146.0
311174.0,17,4,1400,4,1400,103724.66666666669,350.0,350.0,0,0,0.0,0.0,0.0
113171276.0,6,46,3036,23,1518,5144133.090909091,66.0,66.0,23,1518,5144136.636363637,66.0,66.0
298836.0,6,6,412,4,272,99612.0,74.0,68.0,2,140,0.0,74.0,70.0
42363.0,6,10,2032,5,524,9883.25,252.0,104.8,5,1508,8798.75,1236.0,301.6
108125194.0,17,5,1005,5,1005,27031298.5,201.0,201.0,0,0,0.0,0.0,0.0
231595.0,17,2,180,1,90,0.0,90.0,90.0,1,90,0.0,90.0,90.0
25593.0,6,14,4740,7,653,4140.166666666667,249.0,93.28571428571428,7,4087,4122.833333333333,1514.0,583.8571428571429
0.0,17,1,381,1,381,0.0,381.0,381.0,0,0,0.0,0.0,0.0
135152702.0,17,6,1206,6,1206,27030540.4,201.0,201.0,0,0,0.0,0.0,0.0
116477527.0,6,31,2160,16,1071,7765139.866666666,123.0,66.9375,15,1089,7606504.142857143,123.0,72.6
103105.0,17,2,286,2,286,0.0,143.0,143.0,0,0,0.0,0.0,0.0
120123231.0,6,15,2428,9,1204,15015403.875,188.0,133.77777777777777,6,1224,18072280.6,204.0,204.0
227906.0,6,13,1386,7,789,37984.333333333336,253.0,112.71428571428572,6,597,42192.0,259.0,99.5
2292.0,17,4,344,2,150,0.0,75.0,75.0,2,194,0.0,103.0,97.0
349660.0,17,4,704,2,148,0.0,74.0,74.0,2,556,0.0,280.0,278.0
25500.0,6,10,2032,5,524,6150.75,252.0,104.8,5,1508,6074.0,1236.0,301.6
90788352.0,6,19,1436,10,745,10081787.555555556,95.0,74.5,9,691,11347704.0,95.0,76.77777777777777
251912.00000000003,6,3,337,2,214,0.0,160.0,107.0,1,123,0.0,123.0,123.0
205781.0,17,2,180,1,90,0.0,90.0,90.0,1,90,0.0,90.0,90.0
913759.0,6,10,1332,6,795,182751.8,457.0,132.5,4,537,212888.0,331.0,134.25
144795.0,17,2,180,1,70,0.0,70.0,70.0,1,110,0.0,110.0,110.0
2437.0,17,4,344,2,150,0.0,75.0,75.0,2,194,0.0,103.0,97.0
120119123.0,6,12,1832,8,1016,17136723.0,188.0,127.0,4,816,30029505.666666668,204.0,204.0
217357.0,6,3,426,2,280,0.0,214.0,140.0,1,146,0.0,146.0,146.0
27267.0,6,14,4740,7,653,4192.166666666667,249.0,93.28571428571428,7,4087,3941.8333333333335,1514.0,583.8571428571429
27745.0,6,10,2032,5,524,6628.5,252.0,104.8,5,1508,6677.5,1236.0,301.6
241596.0,6,3,337,2,214,0.0,160.0,107.0,1,123,0.0,123.0,123.0
205362.0,17,2,762,2,762,0.0,381.0,381.0,0,0,0.0,0.0,0.0
2343.0,17,4,344,2,150,0.0,75.0,75.0,2,194,0.0,103.0,97.0
100684854.0,17,12,778,6,389,19979211.4,174.0,64.83333333333333,6,389,20105192.2,174.0,64.83333333333333
906383.0,6,12,2709,7,742,151063.83333333334,338.0,106.0,5,1967,157646.5,1514.0,393.4
548.0,17,2,508,2,508,0.0,257.0,254.0,0,0,0.0,0.0,0.0
107673.0,17,2,286,2,286,0.0,143.0,143.0,0,0,0.0,0.0,0.0
41588.0,6,10,2032,5,524,10201.75,252.0,104.8,5,1508,7447.75,1236.0,301.6
119867269.0,6,14,2102,5,1020,29966306.5,204.0,204.0,9,1082,14983259.125,188.0,120.22222222222224
297514.0,6,6,412,4,272,99171.33333333331,74.0,68.0,2,140,0.0,74.0,70.0
310520.0,6,3,202,2,128,0.0,74.0,64.0,1,74,0.0,74.0,74.0
8939.0,17,2,539,1,86,0.0,86.0,86.0,1,453,0.0,453.0,453.0
90057972.0,17,28,13364,28,13364,3335480.4444444445,501.0,477.2857142857143,0,0,0.0,0.0,0.0
122297.0,6,3,373,2,238,0.0,172.0,119.0,1,135,0.0,135.0,135.0
245438.0,6,3,337,2,214,0.0,160.0,107.0,1,123,0.0,123.0,123.0
120598896.0,6,33,2280,17,1209,7537431.0,123.0,71.11764705882354,16,1071,7359799.066666666,123.0,66.9375
90296167.0,6,16,1192,8,596,12893405.714285716,95.0,74.5,8,596,12898616.42857143,95.0,74.5
165578.0,6,2,132,1,66,0.0,66.0,66.0,1,66,0.0,66.0,66.0
206940.0,6,10,1221,6,636,41388.0,298.0,106.0,4,585,67909.66666666667,379.0,146.25
4278.0,17,2,626,1,72,0.0,72.0,72.0,1,554,0.0,554.0,554.0
320493.0,17,4,1400,4,1400,106831.0,350.0,350.0,0,0,0.0,0.0,0.0
17685.0,6,14,4740,7,653,2669.6666666666665,249.0,93.28571428571428,7,4087,2825.6666666666665,1514.0,583.8571428571429
297747.0,6,6,412,4,272,99249.0,74.0,68.0,2,140,0.0,74.0,70.0
39543.0,6,14,4740,7,653,6461.0,249.0,93.28571428571428,7,4087,6442.833333333333,1514.0,583.8571428571429
1377181.0,6,4,276,2,128,0.0,74.0,64.0,2,148,0.0,74.0,74.0
90257426.0,6,14,2240,8,1016,12893918.0,188.0,127.0,6,1224,18017145.4,204.0,204.0
92493512.0,17,16,5472,16,5472,6166234.133333334,342.0,342.0,0,0,0.0,0.0,0.0
45731.0,6,14,4740,7,653,7044.833333333333,249.0,93.28571428571428,7,4087,7491.0,1514.0,583.8571428571429
51523631.0,6,8,2113,3,960,24440515.5,826.0,320.0,5,1153,12236945.0,885.0,230.6
117389706.0,6,229,25800,115,7886,1029734.2631578948,140.0,68.57391304347826,114,17914,1029596.4867256638,284.0,157.140350877193
74552794.0,6,9,842,9,842,9319099.25,97.0,93.55555555555556,0,0,0.0,0.0,0.0
228626.0,17,2,180,1,90,0.0,90.0,90.0,1,90,0.0,90.0,90.0
13228.0,6,10,1067,5,536,2842.0,264.0,107.2,5,531,2875.5,259.0,106.2
2295.0,17,4,344,2,150,0.0,75.0,75.0,2,194,0.0,103.0,97.0
162413.0,17,2,180,1,90,0.0,90.0,90.0,1,90,0.0,90.0,90.0
216885.0,6,3,426,2,280,0.0,214.0,140.0,1,146,0.0,146.0,146.0
218006.0,6,3,426,2,280,0.0,214.0,140.0,1,146,0.0,146.0,146.0
205780.0,17,2,180,1,90,0.0,90.0,90.0,1,90,0.0,90.0,90.0
113940999.0,6,36,2596,18,1348,6689716.705882353,139.0,74.88888888888889,18,1248,6689720.470588235,123.0,69.33333333333333
1302484.0,6,4,264,2,132,0.0,66.0,66.0,2,132,0.0,66.0,66.0
120078220.0,6,326,38624,163,11054,736122.3888888889,140.0,67.8159509202454,163,27570,736754.2777777778,336.0,169.14110429447854
242109.0,6,3,337,2,214,0.0,160.0,107.0,1,123,0.0,123.0,123.0
1775379.0,6,2,132,1,66,0.0,66.0,66.0,1,66,0.0,66.0,66.0
153458.0,17,2,180,1,90,0.0,90.0,90.0,1,90,0.0,90.0,90.0
5144519.0,6,183,147757,103,138168,50436.46078431373,1510.0,1341.4368932038835,80,9589,61135.582278481015,1510.0,119.8625
303010.0,6,6,412,4,272,101003.33333333331,74.0,68.0,2,140,0.0,74.0,70.0
39046.0,6,14,4740,7,653,6399.0,249.0,93.28571428571428,7,4087,6249.833333333333,1514.0,583.8571428571429
6830.0,17,2,463,1,84,0.0,84.0,84.0,1,379,0.0,379.0,379.0
90099474.0,6,14,1976,8,1016,12871353.42857143,188.0,127.0,6,960,12014307.4,204.0,160.0
30096.0,6,14,4740,7,653,4359.833333333333,249.0,93.28571428571428,7,4087,4822.666666666667,1514.0,583.8571428571429
1303260.0,6,4,264,2,132,0.0,66.0,66.0,2,132,0.0,66.0,66.0
228050.0,17,4,1400,4,1400,76016.66666666667,350.0,350.0,0,0,0.0,0.0,0.0
90293849.0,6,16,1192,8,596,12892627.285714284,95.0,74.5,8,596,12898279.857142856,95.0,74.5
71362.0,17,2,620,1,75,0.0,75.0,75.0,1,545,0.0,545.0,545.0
25269.0,6,13,1386,7,789,4040.0,253.0,112.71428571428572,6,597,4517.2,259.0,99.5
5587.0,17,2,239,1,82,0.0,82.0,82.0,1,157,0.0,157.0,157.0
363167.0,6,11,1021,6,444,48805.0,162.0,74.0,5,577,60799.25,349.0,115.4
9234.0,17,2,539,1,86,0.0,86.0,86.0,1,453,0.0,453.0,453.0
16892.0,17,2,180,1,90,0.0,90.0,90.0,1,90,0.0,90.0,90.0
117876327.0,6,48,3168,24,1584,5125057.695652174,66.0,66.0,24,1584,5113208.260869565,66.0,66.0
108106134.0,17,5,955,5,955,27026533.5,191.0,191.0,0,0,0.0,0.0,0.0
90284317.0,6,16,1192,8,596,12891481.857142856,95.0,74.5,8,596,12896651.0,95.0,74.5
24345718.0,6,27,7681,14,3735,205288.38461538465,1514.0,266.7857142857143,13,3946,2010844.5,1514.0,303.53846153846155
5630432.0,6,5,336,3,202,1525267.5,70.0,67.33333333333333,2,134,0.0,68.0,67.0
319683.0,17,4,1400,4,1400,106561.0,350.0,350.0,0,0,0.0,0.0,0.0
100225.0,17,2,286,2,286,0.0,143.0,143.0,0,0,0.0,0.0,0.0
122430.0,6,3,373,2,238,0.0,172.0,119.0,1,135,0.0,135.0,135.0
203600.0,17,4,1400,4,1400,67866.66666666667,350.0,350.0,0,0,0.0,0.0,0.0
146131.0,6,3,373,2,238,0.0,172.0,119.0,1,135,0.0,135.0,135.0
90927373.0,6,21,1585,11,840,9092228.7,95.0,76.36363636363636,10,745,10102101.888888888,95.0,74.5
91887689.0,6,34,3870,16,1737,6125845.933333334,337.0,108.5625,18,2133,5387642.588235294,427.0,118.5
0.0,6,1,54,0,0,0.0,0.0,0.0,1,54,0.0,54.0,54.0
85956.0,6,14,4740,7,653,9880.666666666666,249.0,93.28571428571428,7,4087,13255.166666666666,1514.0,583.8571428571429
324.0,17,2,164,1,82,0.0,82.0,82.0,1,82,0.0,82.0,82.0
205279.0,6,10,1221,6,636,41055.8,298.0,106.0,4,585,67221.33333333333,379.0,146.25
3180016.0,6,18,1495,9,921,358459.875,315.0,102.33333333333331,9,574,358428.625,78.0,63.77777777777778
542536.0,6,2,132,1,66,0.0,66.0,66.0,1,66,0.0,66.0,66.0
107590.0,17,2,286,2,286,0.0,143.0,143.0,0,0,0.0,0.0,0.0
90055288.0,17,28,13364,28,13364,3335381.037037037,501.0,477.2857142857143,0,0,0.0,0.0,0.0
120124824.0,6,16,2356,9,1204,15015603.0,188.0,133.77777777777777,7,1152,15013626.333333334,204.0,164.57142857142858
127830861.0,6,33,2280,17,1209,7989428.8125,123.0,71.11764705882354,16,1071,7841873.333333333,123.0,66.9375
244797.0,6,3,337,2,214,0.0,160.0,107.0,1,123,0.0,123.0,123.0
146197.0,6,3,337,2,214,0.0,160.0,107.0,1,123,0.0,123.0,123.0
307211.0,17,4,1400,4,1400,102403.66666666669,350.0,350.0,0,0,0.0,0.0,0.0
321659.0,17,4,1400,4,1400,107219.66666666669,350.0,350.0,0,0,0.0,0.0,0.0
799.0,17,4,438,2,148,0.0,74.0,74.0,2,290,0.0,147.0,145.0
618450.0,17,2,335,1,88,0.0,88.0,88.0,1,247,0.0,247.0,247.0
349581.0,17,2,180,1,90,0.0,90.0,90.0,1,90,0.0,90.0,90.0
51710.0,6,14,4740,7,653,8286.666666666666,249.0,93.28571428571428,7,4087,8422.0,1514.0,583.8571428571429
3095235.0,6,3,1777,2,951,0.0,885.0,475.5,1,826,0.0,826.0,826.0
120120932.0,6,15,2428,9,1204,15015116.5,188.0,133.77777777777777,6,1224,18073471.6,204.0,204.0
120147047.0,6,240,27284,120,8216,995106.7142857144,140.0,68.46666666666667,120,19068,1002720.5294117648,284.0,158.9
42767.0,6,10,2032,5,524,10477.0,252.0,104.8,5,1508,9460.5,1236.0,301.6
39708.0,6,14,4740,7,653,5364.166666666667,249.0,93.28571428571428,7,4087,6101.5,1514.0,583.8571428571429
90031338.0,17,28,13364,28,13364,3334494.0,501.0,477.2857142857143,0,0,0.0,0.0,0.0
146967.0,6,2,132,1,66,0.0,66.0,66.0,1,66,0.0,66.0,66.0
347.0,17,2,174,1,79,0.0,79.0,79.0,1,95,0.0,95.0,95.0
82.0,17,2,762,2,762,0.0,381.0,381.0,0,0,0.0,0.0,0.0
62042.0,6,14,4740,7,653,6533.5,249.0,93.28571428571428,7,4087,10200.333333333334,1514.0,583.8571428571429
2307.0,17,4,344,2,150,0.0,75.0,75.0,2,194,0.0,103.0,97.0
108079530.0,17,5,1005,5,1005,27019882.5,201.0,201.0,0,0,0.0,0.0,0.0
74115.0,6,15,4806,8,719,10339.42857142857,249.0,89.875,7,4087,12002.0,1514.0,583.8571428571429
110806.0,17,2,286,2,286,0.0,143.0,143.0,0,0,0.0,0.0,0.0
135124044.0,17,6,1146,6,1146,27024808.8,191.0,191.0,0,0,0.0,0.0,0.0
361.0,17,2,174,1,79,0.0,79.0,79.0,1,95,0.0,95.0,95.0
124834387.0,17,15,1169,7,563,17500157.5,174.0,80.42857142857143,8,606,15143749.714285716,174.0,75.75
16836.0,17,2,180,1,90,0.0,90.0,90.0,1,90,0.0,90.0,90.0
36631.0,6,10,1065,5,534,7007.5,262.0,106.8,5,531,8840.25,259.0,106.2
37741.0,6,14,4740,7,653,6151.333333333333,249.0,93.28571428571428,7,4087,6150.5,1514.0,583.8571428571429
120222941.0,6,256,28970,128,8744,932092.8267716536,140.0,68.3125,128,20226,940154.2047244096,374.0,158.015625
154109.0,17,2,180,1,90,0.0,90.0,90.0,1,90,0.0,90.0,90.0
101872.0,17,2,700,2,700,0.0,350.0,350.0,0,0,0.0,0.0,0.0
162301.0,17,2,180,1,90,0.0,90.0,90.0,1,90,0.0,90.0,90.0
205173.0,17,2,762,2,762,0.0,381.0,381.0,0,0,0.0,0.0,0.0
97740.0,17,2,762,2,762,0.0,381.0,381.0,0,0,0.0,0.0,0.0
326566.0,17,4,1400,4,1400,108855.33333333331,350.0,350.0,0,0,0.0,0.0,0.0
83520.0,6,14,4740,7,653,12131.5,249.0,93.28571428571428,7,4087,13714.5,1514.0,583.8571428571429
119945125.0,6,33,2274,17,1125,7496542.375,123.0,66.17647058823529,16,1149,7330626.533333333,123.0,71.8125
281275.0,17,2,363,1,79,0.0,79.0,79.0,1,284,0.0,284.0,284.0
2483.0,17,2,762,2,762,0.0,381.0,381.0,0,0,0.0,0.0,0.0
93297993.0,6,38,2508,19,1254,5164879.555555556,66.0,66.0,19,1254,5164889.166666667,66.0,66.0
90021418.0,17,28,13364,28,13364,3334126.592592593,501.0,477.2857142857143,0,0,0.0,0.0,0.0
707642.0,6,5,336,2,134,0.0,68.0,67.0,3,202,243573.0,70.0,67.33333333333333
190319.0,17,2,180,1,90,0.0,90.0,90.0,1,90,0.0,90.0,90.0
204635.0,17,2,180,1,90,0.0,90.0,90.0,1,90,0.0,90.0,90.0
120308070.0,6,241,27260,121,19044,1002567.25,284.0,157.38842975206612,120,8216,1002267.2521008404,140.0,68.46666666666667
53380.0,6,14,4740,7,653,7915.333333333333,249.0,93.28571428571428,7,4087,8470.166666666666,1514.0,583.8571428571429
119455095.0,6,219,24802,110,17312,1095918.3027522936,284.0,157.38181818181818,109,7490,1096591.5,140.0,68.71559633027523
58832.0,6,14,4740,7,653,9586.0,249.0,93.28571428571428,7,4087,9075.333333333334,1514.0,583.8571428571429
47606332.0,6,8,1940,3,887,22498884.5,753.0,295.6666666666667,5,1053,11259553.0,785.0,210.6
1164247.0,6,13,3010,8,2382,166321.0,1514.0,297.75,5,628,222275.5,331.0,125.6
264757.0,6,3,337,2,214,0.0,160.0,107.0,1,123,0.0,123.0,123.0
536913.0,17,6,2100,6,2100,107382.6,350.0,350.0,0,0,0.0,0.0,0.0
149930234.0,17,36,17126,36,17126,4283720.971428571,501.0,475.72222222222223,0,0,0.0,0.0,0.0
103298363.0,6,44,2904,22,1452,4918969.666666667,66.0,66.0,22,1452,4908675.761904762,66.0,66.0
502011.0,6,5,336,2,134,0.0,68.0,67.0,3,202,196561.5,70.0,67.33333333333333
3141.0,17,2,224,1,76,0.0,76.0,76.0,1,148,0.0,148.0,148.0
120285168.0,6,227,25796,114,18042,1064470.5132743362,374.0,158.26315789473685,113,7754,1065809.419642857,140.0,68.61946902654867
71141989.0,6,9,842,9,842,8892748.625,97.0,93.55555555555556,0,0,0.0,0.0,0.0
4161.0,17,2,614,1,72,0.0,72.0,72.0,1,542,0.0,542.0,542.0
149140.0,17,2,414,1,88,0.0,88.0,88.0,1,326,0.0,326.0,326.0
121931.0,6,3,337,2,214,0.0,160.0,107.0,1,123,0.0,123.0,123.0
831.0,17,4,438,2,148,0.0,74.0,74.0,2,290,0.0,147.0,145.0
120012606.0,17,28,13364,28,13364,4444911.333333333,501.0,477.2857142857143,0,0,0.0,0.0,0.0
302366.0,6,2,132,1,66,0.0,66.0,66.0,1,66,0.0,66.0,66.0
142099.0,6,2,132,1,66,0.0,66.0,66.0,1,66,0.0,66.0,66.0
119964.0,17,2,180,1,70,0.0,70.0,70.0,1,110,0.0,110.0,110.0
503976.0,6,5,336,2,134,0.0,68.0,67.0,3,202,197361.0,70.0,67.33333333333333
4776.0,17,2,180,1,90,0.0,90.0,90.0,1,90,0.0,90.0,90.0
306942.0,6,2,132,1,66,0.0,66.0,66.0,1,66,0.0,66.0,66.0
10458543.0,6,7,478,4,272,3440810.0,74.0,68.0,3,206,5161119.5,74.0,68.66666666666667
205671.0,17,2,180,1,90,0.0,90.0,90.0,1,90,0.0,90.0,90.0
57611.0,6,14,4740,7,653,8563.833333333334,249.0,93.28571428571428,7,4087,9462.5,1514.0,583.8571428571429
361133.0,6,11,1021,6,444,48456.4,162.0,74.0,5,577,60480.5,349.0,115.4
56043.0,6,14,4740,7,653,8895.333333333334,249.0,93.28571428571428,7,4087,8430.833333333334,1514.0,583.8571428571429
100177895.0,6,166,18778,83,13078,1219057.012195122,284.0,157.56626506024097,83,5700,1219056.7926829269,140.0,68.67469879518072
1181699.0,6,11,1134,6,558,236339.8,220.0,93.0,5,576,294894.75,304.0,115.2
83205.0,6,14,4740,7,653,13703.5,249.0,93.28571428571428,7,4087,13640.166666666666,1514.0,583.8571428571429
142264616.0,6,28,2328,16,1434,9484307.733333332,255.0,89.625,12,894,10414219.818181818,95.0,74.5
108382.0,17,2,286,2,286,0.0,143.0,143.0,0,0,0.0,0.0,0.0
7607.0,17,4,344,2,150,0.0,75.0,75.0,2,194,0.0,103.0,97.0
13198.0,6,10,1066,5,490,3056.0,218.0,98.0,5,576,2772.25,304.0,115.2
21610.0,6,10,2032,5,524,5143.75,252.0,104.8,5,1508,3950.25,1236.0,301.6
219877.0,6,4,492,2,280,0.0,214.0,140.0,2,212,0.0,146.0,106.0
13988775.0,17,4,1368,4,1368,4662925.0,342.0,342.0,0,0,0.0,0.0,0.0
36482.0,6,10,2032,5,524,6649.75,252.0,104.8,5,1508,8391.75,1236.0,301.6
55925.0,6,14,4740,7,653,9196.333333333334,249.0,93.28571428571428,7,4087,9183.166666666666,1514.0,583.8571428571429
34960.0,6,2,145,2,145,0.0,91.0,72.5,0,0,0.0,0.0,0.0
135131228.0,17,6,1146,6,1146,27026245.6,191.0,191.0,0,0,0.0,0.0,0.0
2095.0,17,4,344,2,150,0.0,75.0,75.0,2,194,0.0,103.0,97.0
105255545.0,6,192,21664,96,15106,1105686.9157894736,284.0,157.35416666666666,96,6558,1105687.3368421053,140.0,68.3125
102559.0,17,2,286,2,286,0.0,143.0,143.0,0,0,0.0,0.0,0.0
26728.0,6,11,2098,6,590,4235.2,252.0,98.33333333333331,5,1508,5196.5,1236.0,301.6
97153012.0,6,30,2122,15,1105,6924083.285714285,139.0,73.66666666666667,15,1017,6924080.071428572,123.0,67.8
10881591.0,6,8,544,4,272,3581698.6666666665,74.0,68.0,4,272,3581637.0,74.0,68.0
116314810.0,6,47,3102,23,1518,5159997.954545454,66.0,66.0,24,1584,5057154.391304348,66.0,66.0
115780679.0,6,48,3168,24,1584,5033942.565217392,66.0,66.0,24,1584,5021960.478260869,66.0,66.0
36426.0,6,14,4740,7,653,5691.0,249.0,93.28571428571428,7,4087,5658.5,1514.0,583.8571428571429
220421.0,6,3,426,2,280,0.0,214.0,140.0,1,146,0.0,146.0,146.0
2800958.0,6,2,132,1,66,0.0,66.0,66.0,1,66,0.0,66.0,66.0
336.0,17,2,166,1,75,0.0,75.0,75.0,1,91,0.0,91.0,91.0
244747.0,6,3,337,2,214,0.0,160.0,107.0,1,123,0.0,123.0,123.0
23826.0,6,14,4740,7,653,3850.5,249.0,93.28571428571428,7,4087,3823.1666666666665,1514.0,583.8571428571429
112982894.0,6,45,2970,23,1518,5135586.090909091,66.0,66.0,22,1452,4991793.619047619,66.0,66.0
1788907.0,6,2,132,1,66,0.0,66.0,66.0,1,66,0.0,66.0,66.0
228732.0,17,4,1524,4,1524,76244.0,381.0,381.0,0,0,0.0,0.0,0.0
4158.0,17,4,571,2,148,0.0,74.0,74.0,2,423,0.0,276.0,211.5
34698.0,6,14,4740,7,653,5658.833333333333,249.0,93.28571428571428,7,4087,5652.0,1514.0,583.8571428571429
456.0,17,2,508,2,508,0.0,257.0,254.0,0,0,0.0,0.0,0.0
42605.0,6,14,4740,7,653,6964.166666666667,249.0,93.28571428571428,7,4087,6556.333333333333,1514.0,583.8571428571429
103392.0,17,2,286,2,286,0.0,143.0,143.0,0,0,0.0,0.0,0.0
19996.0,6,14,4740,7,653,3121.5,249.0,93.28571428571428,7,4087,3155.6666666666665,1514.0,583.8571428571429
278241.0,6,10,1221,6,636,55648.2,298.0,106.0,4,585,87278.0,379.0,146.25
3383729.0,6,159,125716,89,116795,38451.46590909091,1510.0,1312.3033707865168,70,8921,44549.44927536232,1510.0,127.44285714285714
108099073.0,17,5,1005,5,1005,27024768.25,201.0,201.0,0,0,0.0,0.0,0.0
108103405.0,17,5,955,5,955,27025851.25,191.0,191.0,0,0,0.0,0.0,0.0
232379.0,6,3,337,2,214,0.0,160.0,107.0,1,123,0.0,123.0,123.0
50523.0,6,14,4740,7,653,8297.333333333334,249.0,93.28571428571428,7,4087,7016.833333333333,1514.0,583.8571428571429
36692.0,6,14,4740,7,653,5700.666666666667,249.0,93.28571428571428,7,4087,5882.333333333333,1514.0,583.8571428571429
2803257.0,6,2,132,1,66,0.0,66.0,66.0,1,66,0.0,66.0,66.0
53217.0,6,13,1386,7,789,7255.666666666667,253.0,112.71428571428572,6,597,8803.8,259.0,99.5
136007671.0,17,15,907,8,475,19429667.285714287,174.0,59.375,7,432,19333494.33333333,174.0,61.71428571428572
859.0,17,4,820,2,156,0.0,78.0,78.0,2,664,0.0,332.0,332.0
36284.0,6,14,4740,7,653,5861.833333333333,249.0,93.28571428571428,7,4087,5875.833333333333,1514.0,583.8571428571429
90094960.0,6,11,1644,4,816,30030884.666666668,204.0,204.0,7,828,15015430.166666666,188.0,118.28571428571428
1314037.0,6,4,264,2,132,0.0,66.0,66.0,2,132,0.0,66.0,66.0
16018995.0,17,5,1905,5,1905,4004748.75,381.0,381.0,0,0,0.0,0.0,0.0
119365138.0,17,14,864,7,432,19668256.666666668,174.0,61.71428571428572,7,432,19666827.666666668,174.0,61.71428571428572
120208024.0,6,768,132316,383,25796,314680.6910994764,214.0,67.35248041775456,385,106520,312437.234375,1514.0,276.6753246753247
218836.0,6,12,1373,7,714,36472.66666666666,298.0,102.0,5,659,53966.5,379.0,131.8
16888.0,6,10,2032,5,524,3925.75,252.0,104.8,5,1508,3872.0,1236.0,301.6
74650754.0,6,9,842,9,842,9331344.25,97.0,93.55555555555556,0,0,0.0,0.0,0.0
414876.0,6,3,1604,2,851,0.0,785.0,425.5,1,753,0.0,753.0,753.0
203437.0,17,2,762,2,762,0.0,381.0,381.0,0,0,0.0,0.0,0.0
135130112.0,17,6,1146,6,1146,27026022.4,191.0,191.0,0,0,0.0,0.0,0.0
219202.0,6,3,426,2,280,0.0,214.0,140.0,1,146,0.0,146.0,146.0
3101939.0,6,157,124140,87,115219,36069.058139534885,1510.0,1324.3563218390805,70,8921,40393.42028985507,1510.0,127.44285714285714
223291.0,6,10,1221,6,636,44658.2,298.0,106.0,4,585,72137.33333333333,379.0,146.25
50814.0,6,14,4740,7,653,6167.833333333333,249.0,93.28571428571428,7,4087,7243.333333333333,1514.0,583.8571428571429
146129.0,6,3,337,2,214,0.0,160.0,107.0,1,123,0.0,123.0,123.0
131739.0,6,3,337,2,214,0.0,160.0,107.0,1,123,0.0,123.0,123.0
98403.0,6,14,4740,7,653,13876.333333333334,249.0,93.28571428571428,7,4087,15876.333333333334,1514.0,583.8571428571429
108101035.0,17,5,955,5,955,27025258.75,191.0,191.0,0,0,0.0,0.0,0.0
4369.0,17,2,614,1,72,0.0,72.0,72.0,1,542,0.0,542.0,542.0
98669399.0,6,25,1692,13,906,8204463.75,123.0,69.6923076923077,12,786,8950321.818181818,123.0,65.5
108108065.0,17,5,955,5,955,27027016.25,191.0,191.0,0,0,0.0,0.0,0.0
0.0,17,1,350,1,350,0.0,350.0,350.0,0,0,0.0,0.0,0.0
33715340.0,6,5,336,2,134,0.0,68.0,67.0,3,202,15557994.0,70.0,67.33333333333333
216671.0,17,2,180,1,90,0.0,90.0,90.0,1,90,0.0,90.0,90.0
147956.0,6,3,373,2,238,0.0,172.0,119.0,1,135,0.0,135.0,135.0
108110452.0,17,5,1005,5,1005,27027613.0,201.0,201.0,0,0,0.0,0.0,0.0
698.0,17,4,438,2,148,0.0,74.0,74.0,2,290,0.0,147.0,145.0
497.00000000000006,17,2,267,1,83,0.0,83.0,83.0,1,184,0.0,184.0,184.0
0.0,6,1,66,1,66,0.0,66.0,66.0,0,0,0.0,0.0,0.0
2545642.0,6,3,1604,2,851,0.0,785.0,425.5,1,753,0.0,753.0,753.0
309.0,17,2,164,1,82,0.0,82.0,82.0,1,82,0.0,82.0,82.0
216424.0,17,2,180,1,90,0.0,90.0,90.0,1,90,0.0,90.0,90.0
11485.0,6,10,1065,5,534,2208.0,262.0,106.8,5,531,2527.25,259.0,106.2
90256201.0,6,14,2240,8,1016,12893743.0,188.0,127.0,6,1224,18015368.0,204.0,204.0
90295562.0,6,16,1192,8,596,12892143.857142856,95.0,74.5,8,596,12897997.714285716,95.0,74.5
90745917.0,6,17,1287,9,691,11337768.0,95.0,76.77777777777777,8,596,12963185.57142857,95.0,74.5
255715.00000000003,17,4,1400,4,1400,85238.33333333333,350.0,350.0,0,0,0.0,0.0,0.0
309805.0,6,6,412,4,272,103268.33333333331,74.0,68.0,2,140,0.0,74.0,70.0
90010641.0,17,28,13364,28,13364,3333727.4444444445,501.0,477.2857142857143,0,0,0.0,0.0,0.0
216762.0,6,3,426,2,280,0.0,214.0,140.0,1,146,0.0,146.0,146.0
250075.0,6,3,337,2,214,0.0,160.0,107.0,1,123,0.0,123.0,123.0
90018813.0,17,28,13364,28,13364,3334030.111111111,501.0,477.2857142857143,0,0,0.0,0.0,0.0
45211.0,6,14,4740,7,653,7312.333333333333,249.0,93.28571428571428,7,4087,7071.333333333333,1514.0,583.8571428571429
120119453.0,6,13,2036,5,1020,30029863.25,204.0,204.0,8,1016,17136375.85714286,188.0,127.0
120039442.0,17,28,13364,28,13364,4445905.259259259,501.0,477.2857142857143,0,0,0.0,0.0,0.0
17086.0,6,11,1132,6,556,3134.0,218.0,92.66666666666669,5,576,2734.0,304.0,115.2
108108405.0,17,5,955,5,955,27027101.25,191.0,191.0,0,0,0.0,0.0,0.0
90021067.0,17,28,13364,28,13364,3334113.592592593,501.0,477.2857142857143,0,0,0.0,0.0,0.0
209643.0,17,2,180,1,90,0.0,90.0,90.0,1,90,0.0,90.0,90.0
34312.0,6,14,4740,7,653,5508.833333333333,249.0,93.28571428571428,7,4087,3862.5,1514.0,583.8571428571429
3144992.0,6,3,204,2,136,0.0,70.0,68.0,1,68,0.0,68.0,68.0
120126190.0,6,14,2224,9,1204,15015773.75,188.0,133.77777777777777,5,1020,22522905.0,204.0,204.0
143861.0,17,2,180,1,90,0.0,90.0,90.0,1,90,0.0,90.0,90.0
509662.0,6,5,336,2,134,0.0,68.0,67.0,3,202,192922.5,70.0,67.33333333333333
246214.0,6,3,337,2,214,0.0,160.0,107.0,1,123,0.0,123.0,123.0
13053.0,6,14,4740,7,653,2065.1666666666665,249.0,93.28571428571428,7,4087,2038.5,1514.0,583.8571428571429
1995.0,17,4,344,2,150,0.0,75.0,75.0,2,194,0.0,103.0,97.0
108098359.0,17,5,1005,5,1005,27024589.75,201.0,201.0,0,0,0.0,0.0,0.0
259030.0,6,3,337,2,214,0.0,160.0,107.0,1,123,0.0,123.0,123.0
982174.0,6,12,1354,6,723,194503.4,253.0,120.5,6,631,195971.0,293.0,105.16666666666669
98518187.0,6,27,1816,14,894,7578322.076923077,123.0,63.85714285714285,13,922,7359796.916666667,139.0,70.92307692307692
103084.0,17,2,286,2,286,0.0,143.0,143.0,0,0,0.0,0.0,0.0
3436483.0,17,2,876,2,876,0.0,438.0,438.0,0,0,0.0,0.0,0.0
135134717.0,17,6,1206,6,1206,27026943.4,201.0,201.0,0,0,0.0,0.0,0.0
95883871.0,6,187,21154,94,14794,1031009.365591398,284.0,157.38297872340425,93,6360,1030978.4130434784,140.0,68.38709677419355
311154.0,17,4,704,2,148,0.0,74.0,74.0,2,556,0.0,280.0,278.0
10877882.0,6,8,544,4,272,3580889.0,74.0,68.0,4,272,3580821.333333333,74.0,68.0
2803800.0,6,2,132,1,66,0.0,66.0,66.0,1,66,0.0,66.0,66.0
806.0,17,4,438,2,148,0.0,74.0,74.0,2,290,0.0,147.0,145.0
6615.0,17,2,582,1,83,0.0,83.0,83.0,1,499,0.0,499.0,499.0
90853022.0,6,163,18416,82,5560,1121642.2469135802,140.0,67.8048780487805,81,12856,1122696.3625,284.0,158.71604938271605
90528558.0,6,15,2444,8,1016,12932651.142857144,188.0,127.0,7,1428,15061010.333333334,204.0,204.0
24072953.0,17,5,1718,4,1368,703044.0,342.0,342.0,1,350,0.0,350.0,350.0
35451.0,6,14,4740,7,653,5604.0,249.0,93.28571428571428,7,4087,4818.5,1514.0,583.8571428571429
306692.0,6,6,412,4,272,102230.66666666669,74.0,68.0,2,140,0.0,74.0,70.0
18920052.0,17,3,1034,2,684,0.0,342.0,342.0,1,350,0.0,350.0,350.0
5625174.0,6,5,336,2,134,0.0,68.0,67.0,3,202,1525851.5,70.0,67.33333333333333
322121.0,17,4,1400,4,1400,107373.66666666669,350.0,350.0,0,0,0.0,0.0,0.0
1314593.0,6,4,264,2,132,0.0,66.0,66.0,2,132,0.0,66.0,66.0
120123336.0,6,15,2428,9,1204,15015417.0,188.0,133.77777777777777,6,1224,18073733.0,204.0,204.0
2347.0,17,4,344,2,150,0.0,75.0,75.0,2,194,0.0,103.0,97.0
108106953.0,17,5,1005,5,1005,27026738.25,201.0,201.0,0,0,0.0,0.0,0.0
209368.0,17,2,180,1,90,0.0,90.0,90.0,1,90,0.0,90.0,90.0
90293321.0,6,16,1192,8,596,12892715.42857143,95.0,74.5,8,596,12897278.42857143,95.0,74.5
46287.0,6,2,145,2,145,0.0,91.0,72.5,0,0,0.0,0.0,0.0
284401.0,17,2,363,1,79,0.0,79.0,79.0,1,284,0.0,284.0,284.0
105018968.0,6,44,2904,22,1452,5000903.238095238,66.0,66.0,22,1452,4985929.285714285,66.0,66.0
240430.0,6,3,337,2,214,0.0,160.0,107.0,1,123,0.0,123.0,123.0
92018986.0,6,29,2200,15,1168,6557358.857142857,139.0,77.86666666666666,14,1032,7061758.846153846,123.0,73.71428571428571
113520256.0,6,46,3036,23,1518,5160000.0,66.0,66.0,23,1518,5159997.5,66.0,66.0
321545.0,6,6,412,4,272,107181.66666666669,74.0,68.0,2,140,0.0,74.0,70.0
12395.0,6,10,2032,5,524,2809.0,252.0,104.8,5,1508,2856.75,1236.0,301.6
307672.0,6,6,412,4,272,102557.33333333331,74.0,68.0,2,140,0.0,74.0,70.0
90257338.0,6,14,2240,8,1016,12893905.42857143,188.0,127.0,6,1224,18018569.0,204.0,204.0
42999776.0,6,7,1872,5,1052,10749944.0,784.0,210.4,2,820,0.0,752.0,410.0
100368.0,6,2,132,1,66,0.0,66.0,66.0,1,66,0.0,66.0,66.0
23391.0,6,10,2032,5,524,4372.0,252.0,104.8,5,1508,5266.5,1236.0,301.6
324.0,17,2,174,1,79,0.0,79.0,79.0,1,95,0.0,95.0,95.0
2455.0,17,4,344,2,150,0.0,75.0,75.0,2,194,0.0,103.0,97.0
9365.0,17,2,571,1,86,0.0,86.0,86.0,1,485,0.0,485.0,485.0
302820.0,6,6,412,4,272,100940.0,74.0,68.0,2,140,0.0,74.0,70.0
217655.0,6,3,426,2,280,0.0,214.0,140.0,1,146,0.0,146.0,146.0
102503.0,17,2,762,2,762,0.0,381.0,381.0,0,0,0.0,0.0,0.0
316253.0,17,4,1400,4,1400,105417.66666666669,350.0,350.0,0,0,0.0,0.0,0.0
104084025.0,6,43,2838,22,1452,4941455.952380952,66.0,66.0,21,1386,5155495.0,66.0,66.0
0.0,17,1,381,1,381,0.0,381.0,381.0,0,0,0.0,0.0,0.0
100728171.0,6,196,22092,98,6690,1019486.5154639176,140.0,68.26530612244898,98,15402,1031099.3917525772,284.0,157.16326530612244
3009008.0,6,11,2106,6,598,601453.2,252.0,99.66666666666669,5,1508,2442.75,1236.0,301.6
305816.0,6,6,412,4,272,101938.66666666669,74.0,68.0,2,140,0.0,74.0,70.0
0.0,6,1,66,1,66,0.0,66.0,66.0,0,0,0.0,0.0,0.0
1035633.0,6,11,1134,6,558,207126.6,220.0,93.0,5,576,255820.5,304.0,115.2
217846.0,6,3,426,2,280,0.0,214.0,140.0,1,146,0.0,146.0,146.0
146937.0,6,3,373,2,238,0.0,172.0,119.0,1,135,0.0,135.0,135.0
112283.0,17,4,1400,4,1400,37427.66666666666,350.0,350.0,0,0,0.0,0.0,0.0
297453.0,6,6,412,4,272,99151.0,74.0,68.0,2,140,0.0,74.0,70.0
108103125.0,17,5,1005,5,1005,27025781.25,201.0,201.0,0,0,0.0,0.0,0.0
34814.0,6,14,4740,7,653,5285.666666666667,249.0,93.28571428571428,7,4087,5199.5,1514.0,583.8571428571429
212475.0,6,12,1373,7,714,35412.5,298.0,102.0,5,659,52344.0,379.0,131.8
120022153.0,17,28,13364,28,13364,4445264.925925926,501.0,477.2857142857143,0,0,0.0,0.0,0.0
17172.0,6,19,7540,11,978,1717.2,310.0,88.9090909090909,8,6562,2069.8571428571427,1514.0,820.25
690.0,17,4,438,2,148,0.0,74.0,74.0,2,290,0.0,147.0,145.0
0.0,6,1,66,1,66,0.0,66.0,66.0,0,0,0.0,0.0,0.0
90256378.0,6,12,1832,8,1016,12893768.285714284,188.0,127.0,4,816,30030860.0,204.0,204.0
237346.0,6,3,337,2,214,0.0,160.0,107.0,1,123,0.0,123.0,123.0
124006574.0,17,15,907,8,475,17715224.85714286,174.0,59.375,7,432,17333496.666666668,174.0,61.71428571428572
24454.0,6,11,2098,6,590,4582.0,252.0,98.33333333333331,5,1508,5847.25,1236.0,301.6
526913.0,17,6,2100,6,2100,105382.6,350.0,350.0,0,0,0.0,0.0,0.0
108097698.0,17,5,955,5,955,27024424.5,191.0,191.0,0,0,0.0,0.0,0.0
91497.0,6,14,4740,7,653,15121.166666666666,249.0,93.28571428571428,7,4087,11796.0,1514.0,583.8571428571429
32888381.000000004,6,26,7643,14,3751,204799.7692307692,1514.0,267.92857142857144,12,3892,2971245.0,1514.0,324.3333333333333
205797.0,17,2,180,1,90,0.0,90.0,90.0,1,90,0.0,90.0,90.0
140.0,17,2,700,2,700,0.0,350.0,350.0,0,0,0.0,0.0,0.0
879432.0,17,2,620,1,75,0.0,75.0,75.0,1,545,0.0,545.0,545.0
108105334.0,17,5,1005,5,1005,27026333.5,201.0,201.0,0,0,0.0,0.0,0.0
118898527.0,6,34,2350,17,1225,7417575.6875,139.0,72.05882352941177,17,1125,7417647.375,123.0,66.17647058823529
121001272.0,17,15,1169,8,606,17285896.0,174.0,75.75,7,563,16836358.0,174.0,80.42857142857143
2031.0,17,4,344,2,150,0.0,75.0,75.0,2,194,0.0,103.0,97.0
57514.0,6,13,1386,7,789,9263.5,253.0,112.71428571428572,6,597,10310.8,259.0,99.5
211365.0,6,10,1221,6,636,42273.0,298.0,106.0,4,585,69361.33333333333,379.0,146.25
120242781.0,6,416,50832,208,14024,579689.7342995169,140.0,67.42307692307692,208,36808,576890.6038647343,336.0,176.96153846153845
109603088.0,17,16,1212,8,606,15634759.57142857,174.0,75.75,8,606,15593908.857142856,174.0,75.75
108102079.0,17,5,955,5,955,27025519.75,191.0,191.0,0,0,0.0,0.0,0.0
21769.0,6,14,4740,7,653,3513.333333333333,249.0,93.28571428571428,7,4087,3238.333333333333,1514.0,583.8571428571429
50282.0,6,14,4740,7,653,8262.5,249.0,93.28571428571428,7,4087,7215.0,1514.0,583.8571428571429
267095.0,6,3,337,2,214,0.0,160.0,107.0,1,123,0.0,123.0,123.0
135148231.0,17,6,1206,6,1206,27029646.2,201.0,201.0,0,0,0.0,0.0,0.0
1314751.0,6,4,264,2,132,0.0,66.0,66.0,2,132,0.0,66.0,66.0
228116.0,17,2,180,1,90,0.0,90.0,90.0,1,90,0.0,90.0,90.0
209679.0,6,10,1066,5,490,51795.75,218.0,98.0,5,576,52193.0,304.0,115.2
38495.0,6,14,4740,7,653,6250.0,249.0,93.28571428571428,7,4087,6275.666666666667,1514.0,583.8571428571429
125011673.0,17,15,907,8,475,17858810.42857143,174.0,59.375,7,432,17500153.833333332,174.0,61.71428571428572
120174370.0,6,220,24884,110,7556,1094875.376146789,140.0,68.69090909090909,110,17328,1094955.6972477064,284.0,157.52727272727273
18456.0,6,10,2032,5,524,4397.75,252.0,104.8,5,1508,4168.25,1236.0,301.6
371333.0,6,3,1604,2,851,0.0,785.0,425.5,1,753,0.0,753.0,753.0
48378.0,6,14,4740,7,653,7938.833333333333,249.0,93.28571428571428,7,4087,7223.166666666667,1514.0,583.8571428571429
1167379.0,6,13,3009,8,2381,166768.42857142858,1514.0,297.625,5,628,222946.5,331.0,125.6
51766.0,6,14,4740,7,653,8109.5,249.0,93.28571428571428,7,4087,8131.166666666667,1514.0,583.8571428571429
284978.0,17,2,363,1,79,0.0,79.0,79.0,1,284,0.0,284.0,284.0
91847085.0,17,16,5472,16,5472,6123139.0,342.0,342.0,0,0,0.0,0.0,0.0
119857724.0,6,30,1990,15,1042,8545835.42857143,139.0,69.46666666666667,15,948,8545842.214285715,123.0,63.2
153371.0,17,2,180,1,90,0.0,90.0,90.0,1,90,0.0,90.0,90.0
147262.0,6,3,373,2,238,0.0,172.0,119.0,1,135,0.0,135.0,135.0
110154916.0,6,213,24152,107,7284,1039197.320754717,140.0,68.07476635514018,106,16868,1039354.9333333332,284.0,159.1320754716981
153557.0,17,2,180,1,90,0.0,90.0,90.0,1,90,0.0,90.0,90.0
90005644.0,6,20,1490,10,745,10000627.111111112,95.0,74.5,10,745,9976072.0,95.0,74.5
146120.0,6,3,337,2,214,0.0,160.0,107.0,1,123,0.0,123.0,123.0
220096.0,6,12,1373,7,714,36682.66666666666,298.0,102.0,5,659,54348.25,379.0,131.8
2355.0,17,4,344,2,150,0.0,75.0,75.0,2,194,0.0,103.0,97.0
9217.0,17,2,507,1,86,0.0,86.0,86.0,1,421,0.0,421.0,421.0
105374589.0,6,28,1876,14,982,8089121.538461538,139.0,70.14285714285714,14,894,8089120.538461538,123.0,63.85714285714285
502173.0,6,5,336,2,134,0.0,68.0,67.0,3,202,189977.5,70.0,67.33333333333333
107672048.0,6,30,2106,15,1017,7690860.571428572,123.0,67.8,15,1089,6962180.5,123.0,72.6
10385.0,17,4,344,2,150,0.0,75.0,75.0,2,194,0.0,103.0,97.0
23131.0,6,14,4740,7,653,3505.833333333333,249.0,93.28571428571428,7,4087,3531.1666666666665,1514.0,583.8571428571429
284625.0,17,2,180,1,90,0.0,90.0,90.0,1,90,0.0,90.0,90.0
246323.0,6,3,337,2,214,0.0,160.0,107.0,1,123,0.0,123.0,123.0
318207.0,17,4,1400,4,1400,106069.0,350.0,350.0,0,0,0.0,0.0,0.0
56955.0,6,14,4740,7,653,9100.833333333334,249.0,93.28571428571428,7,4087,8648.666666666666,1514.0,583.8571428571429
108104990.0,17,5,955,5,955,27026247.5,191.0,191.0,0,0,0.0,0.0,0.0
104262.0,17,2,286,2,286,0.0,143.0,143.0,0,0,0.0,0.0,0.0
56196.0,6,11,2098,6,590,10983.0,252.0,98.33333333333331,5,1508,10535.0,1236.0,301.6
96742815.0,6,28,2008,14,963,7441755.0,123.0,68.78571428571429,14,1045,6657130.230769231,139.0,74.64285714285714
9468.0,6,10,2032,5,524,2120.25,252.0,104.8,5,1508,1819.25,1236.0,301.6
779473.0,6,10,1065,5,534,194490.0,262.0,106.8,5,531,194400.25,259.0,106.2
1800.0,17,2,166,1,75,0.0,75.0,75.0,1,91,0.0,91.0,91.0
2372.0,17,4,344,2,150,0.0,75.0,75.0,2,194,0.0,103.0,97.0
120050017.0,17,29,13785,29,13785,4287500.607142857,501.0,475.3448275862069,0,0,0.0,0.0,0.0
90094611.0,6,11,1644,7,828,15015768.5,188.0,118.28571428571428,4,816,20020533.666666668,204.0,204.0
120047683.0,17,28,13364,28,13364,4446210.481481481,501.0,477.2857142857143,0,0,0.0,0.0,0.0
116001149.0,17,18,2365,10,1473,12889016.555555556,394.0,147.3,8,892,14080562.0,250.0,111.5
62763.0,6,14,4740,7,653,9912.833333333334,249.0,93.28571428571428,7,4087,9331.166666666666,1514.0,583.8571428571429
147000.0,6,3,373,2,238,0.0,172.0,119.0,1,135,0.0,135.0,135.0
332071.0,6,6,412,4,272,110690.33333333331,74.0,68.0,2,140,0.0,74.0,70.0
56642.0,6,14,4740,7,653,8709.0,249.0,93.28571428571428,7,4087,8572.833333333334,1514.0,583.8571428571429
315547.0,17,4,1400,4,1400,105182.33333333331,350.0,350.0,0,0,0.0,0.0,0.0
121001324.0,17,15,1169,8,606,17285903.42857143,174.0,75.75,7,563,16834890.166666668,174.0,80.42857142857143
92809759.0,6,40,2640,20,1320,4884724.157894737,66.0,66.0,20,1320,4873265.736842105,66.0,66.0
4390.0,17,2,614,1,72,0.0,72.0,72.0,1,542,0.0,542.0,542.0
20012.0,6,10,2032,5,524,4753.75,252.0,104.8,5,1508,4696.25,1236.0,301.6
6454.0,17,4,344,2,150,0.0,75.0,75.0,2,194,0.0,103.0,97.0
57950.0,6,12,1320,6,723,10396.2,253.0,120.5,6,597,10236.4,259.0,99.5
90031625.0,17,27,12943,27,12943,3462754.8076923075,501.0,479.3703703703704,0,0,0.0,0.0,0.0
2344.0,17,4,344,2,150,0.0,75.0,75.0,2,194,0.0,103.0,97.0
372384.0,6,3,1604,1,753,0.0,753.0,753.0,2,851,0.0,785.0,425.5
0.0,17,1,350,1,350,0.0,350.0,350.0,0,0,0.0,0.0,0.0
135129713.0,17,6,1206,6,1206,27025942.6,201.0,201.0,0,0,0.0,0.0,0.0
854302.0,6,9,1096,6,625,170860.4,287.0,104.16666666666669,3,471,289374.0,331.0,157.0
309904.0,6,3,202,2,128,0.0,74.0,64.0,1,74,0.0,74.0,74.0
104000955.0,17,13,1083,7,563,17333492.5,174.0,80.42857142857143,6,520,16801554.6,174.0,86.66666666666667
27699.0,6,14,4740,7,653,4507.5,249.0,93.28571428571428,7,4087,4434.166666666667,1514.0,583.8571428571429
98657864.0,6,40,2640,20,1320,5192519.157894737,66.0,66.0,20,1320,5176265.0,66.0,66.0
142138.0,6,2,132,1,66,0.0,66.0,66.0,1,66,0.0,66.0,66.0
0.0,17,1,55,1,55,0.0,55.0,55.0,0,0,0.0,0.0,0.0
313314.0,17,4,1400,4,1400,104438.0,350.0,350.0,0,0,0.0,0.0,0.0
9472.0,17,2,571,1,86,0.0,86.0,86.0,1,485,0.0,485.0,485.0
115608082.0,6,48,3168,24,1584,5026438.347826087,66.0,66.0,24,1584,5012977.521739131,66.0,66.0
4302.0,17,2,626,1,72,0.0,72.0,72.0,1,554,0.0,554.0,554.0
2183575.0,6,19,6869,11,1567,218357.5,408.0,142.45454545454547,8,5302,250039.0,1514.0,662.75
97642893.0,6,26,1746,13,906,8118972.333333333,123.0,69.6923076923077,13,840,8118971.083333333,123.0,64.61538461538461
90193651.0,6,24,1829,11,840,8995461.4,95.0,76.36363636363636,13,989,7499065.75,95.0,76.07692307692308
39800.0,6,10,2032,5,524,8744.0,252.0,104.8,5,1508,8599.5,1236.0,301.6
51114.0,17,2,180,1,90,0.0,90.0,90.0,1,90,0.0,90.0,90.0
135134344.0,17,6,1206,6,1206,27026868.8,201.0,201.0,0,0,0.0,0.0,0.0
22577.0,6,14,4740,7,653,3642.3333333333335,249.0,93.28571428571428,7,4087,3623.3333333333335,1514.0,583.8571428571429
118656646.0,6,33,2274,17,1125,7416040.375,123.0,66.17647058823529,16,1149,7383567.0,123.0,71.8125
128315.0,6,13,1386,7,789,21385.83333333333,253.0,112.71428571428572,6,597,24242.4,259.0,99.5
2331.0,17,4,344,2,150,0.0,75.0,75.0,2,194,0.0,103.0,97.0
90096971.0,6,12,1848,5,1020,22523879.25,204.0,204.0,7,828,15015623.666666666,188.0,118.28571428571428
51690.0,6,14,4740,7,653,8452.833333333334,249.0,93.28571428571428,7,4087,7913.666666666667,1514.0,583.8571428571429
316670.0,17,4,1400,4,1400,105556.66666666669,350.0,350.0,0,0,0.0,0.0,0.0
241360.0,6,3,337,2,214,0.0,160.0,107.0,1,123,0.0,123.0,123.0
9849.0,17,4,823,2,163,0.0,89.0,81.5,2,660,0.0,443.0,330.0
90288905.0,6,16,1192,8,596,12892057.42857143,95.0,74.5,8,596,12896069.142857144,95.0,74.5
228510.0,17,2,180,1,90,0.0,90.0,90.0,1,90,0.0,90.0,90.0
299122.0,6,6,412,4,272,99707.33333333331,74.0,68.0,2,140,0.0,74.0,70.0
263805.0,6,10,1221,6,636,52761.0,298.0,106.0,4,585,81776.0,379.0,146.25
171989.0,17,2,180,1,90,0.0,90.0,90.0,1,90,0.0,90.0,90.0
41107.0,6,2,132,1,66,0.0,66.0,66.0,1,66,0.0,66.0,66.0
27585017.0,17,5,1710,5,1710,6896254.25,342.0,342.0,0,0,0.0,0.0,0.0
113618037.0,6,46,3036,23,1518,5150434.954545454,66.0,66.0,23,1518,5150433.681818182,66.0,66.0
22534.0,6,10,2032,5,524,5393.0,252.0,104.8,5,1508,5080.75,1236.0,301.6
112006429.0,6,36,2734,19,1471,6222579.388888889,139.0,77.42105263157895,17,1263,6986892.25,123.0,74.29411764705883
103676348.0,17,14,864,7,432,17252559.166666668,174.0,61.71428571428572,7,432,17173335.333333332,174.0,61.71428571428572
103513.0,17,2,286,2,286,0.0,143.0,143.0,0,0,0.0,0.0,0.0
146305.0,6,3,337,2,214,0.0,160.0,107.0,1,123,0.0,123.0,123.0
120122386.0,6,14,2224,9,1204,15015298.25,188.0,133.77777777777777,5,1020,22526759.0,204.0,204.0
99577.0,17,4,1400,4,1400,33192.333333333336,350.0,350.0,0,0,0.0,0.0,0.0
217797.0,6,3,426,2,280,0.0,214.0,140.0,1,146,0.0,146.0,146.0
114516291.0,6,31,2182,16,1165,7620033.0,139.0,72.8125,15,1017,8164321.642857143,123.0,67.8
3225105.0,6,7,923,4,753,1006600.6666666666,571.0,188.25,3,170,1510176.0,62.0,56.66666666666666
146244.0,6,3,337,2,214,0.0,160.0,107.0,1,123,0.0,123.0,123.0
297573.0,6,6,412,4,272,99191.0,74.0,68.0,2,140,0.0,74.0,70.0
114328044.0,6,48,3168,24,1584,4970784.521739131,66.0,66.0,24,1584,4961392.217391305,66.0,66.0
153418.0,17,2,180,1,90,0.0,90.0,90.0,1,90,0.0,90.0,90.0
52312.0,6,10,2032,5,524,12829.25,252.0,104.8,5,1508,11665.5,1236.0,301.6
90034234.0,17,28,13364,28,13364,3334601.25925926,501.0,477.2857142857143,0,0,0.0,0.0,0.0
97007157.0,17,13,1083,7,563,16167859.5,174.0,80.42857142857143,6,520,15400134.8,174.0,86.66666666666667
49962.0,6,14,4740,7,653,8204.5,249.0,93.28571428571428,7,4087,7913.666666666667,1514.0,583.8571428571429
2166846.0,6,25,7611,13,2516,180570.5,1034.0,193.53846153846155,12,5095,167557.9090909091,1510.0,424.5833333333333
0.0,17,1,55,1,55,0.0,55.0,55.0,0,0,0.0,0.0,0.0
3015739.0,6,3,204,1,68,0.0,68.0,68.0,2,136,0.0,70.0,68.0
104409698.0,6,27,1800,14,894,8031481.384615385,123.0,63.85714285714285,13,906,7868745.833333333,123.0,69.6923076923077
206149.0,6,3,426,2,280,0.0,214.0,140.0,1,146,0.0,146.0,146.0
10528565.0,6,7,478,4,272,3463861.6666666665,74.0,68.0,3,206,5195675.0,74.0,68.66666666666667
205728.0,17,2,180,1,90,0.0,90.0,90.0,1,90,0.0,90.0,90.0
108109657.0,17,5,1005,5,1005,27027414.25,201.0,201.0,0,0,0.0,0.0,0.0
93225128.0,17,12,778,6,389,18645025.6,174.0,64.83333333333333,6,389,18494881.2,174.0,64.83333333333333
206068.0,6,3,426,2,280,0.0,214.0,140.0,1,146,0.0,146.0,146.0
306555.0,6,6,412,4,272,102185.0,74.0,68.0,2,140,0.0,74.0,70.0
2018.0,17,4,344,2,150,0.0,75.0,75.0,2,194,0.0,103.0,97.0
90225390.0,6,16,1192,8,596,12853043.0,95.0,74.5,8,596,12858592.285714284,95.0,74.5
90252293.0,6,13,2036,8,1016,12893184.714285716,188.0,127.0,5,1020,22521294.5,204.0,204.0
122737.0,6,3,373,2,238,0.0,172.0,119.0,1,135,0.0,135.0,135.0
3458.0,17,4,344,2,150,0.0,75.0,75.0,2,194,0.0,103.0,97.0
153019.0,17,2,414,1,88,0.0,88.0,88.0,1,326,0.0,326.0,326.0
317423.0,6,6,412,4,272,105807.66666666669,74.0,68.0,2,140,0.0,74.0,70.0
6383.0,17,4,823,2,163,0.0,89.0,81.5,2,660,0.0,443.0,330.0
206833.0,6,10,1221,6,636,41366.6,298.0,106.0,4,585,67458.33333333333,379.0,146.25
640.0,17,2,166,1,75,0.0,75.0,75.0,1,91,0.0,91.0,91.0
135129338.0,17,6,1146,6,1146,27025867.6,191.0,191.0,0,0,0.0,0.0,0.0
90263307.0,6,14,2240,8,1016,12894758.142857144,188.0,127.0,6,1224,18017526.2,204.0,204.0
146217.0,6,3,337,2,214,0.0,160.0,107.0,1,123,0.0,123.0,123.0
317.0,17,2,174,1,79,0.0,79.0,79.0,1,95,0.0,95.0,95.0
1439975.0,6,19,7533,10,1403,159997.22222222222,583.0,140.3,9,6130,147280.125,1484.0,681.1111111111111
9120.0,17,2,582,1,83,0.0,83.0,83.0,1,499,0.0,499.0,499.0
233011.0,6,3,337,2,214,0.0,160.0,107.0,1,123,0.0,123.0,123.0
51981.0,6,14,4740,7,653,8257.333333333334,249.0,93.28571428571428,7,4087,8477.166666666666,1514.0,583.8571428571429
2361.0,17,4,344,2,150,0.0,75.0,75.0,2,194,0.0,103.0,97.0
313.0,17,2,164,1,82,0.0,82.0,82.0,1,82,0.0,82.0,82.0
9177.0,17,2,586,1,81,0.0,81.0,81.0,1,505,0.0,505.0,505.0
9229.0,17,2,582,1,83,0.0,83.0,83.0,1,499,0.0,499.0,499.0
250025.0,17,4,6056,4,6056,83341.66666666667,1514.0,1514.0,0,0,0.0,0.0,0.0
71995.0,6,12,1320,7,789,11999.166666666666,253.0,112.71428571428572,5,531,16068.75,259.0,106.2
67179.0,6,14,4740,7,653,8833.0,249.0,93.28571428571428,7,4087,9744.666666666666,1514.0,583.8571428571429
307228.0,6,6,412,4,272,102409.33333333331,74.0,68.0,2,140,0.0,74.0,70.0
107836077.0,6,28,1860,14,966,8278487.384615385,123.0,69.0,14,894,8278488.692307692,123.0,63.85714285714285
30810.0,6,13,4416,6,409,5979.2,127.0,68.16666666666667,7,4007,4977.833333333333,1514.0,572.4285714285714
1314578.0,6,4,264,2,132,0.0,66.0,66.0,2,132,0.0,66.0,66.0
44925.0,6,14,4740,7,653,6868.166666666667,249.0,93.28571428571428,7,4087,6978.666666666667,1514.0,583.8571428571429
32129.0,6,14,4740,7,653,5164.166666666667,249.0,93.28571428571428,7,4087,5109.0,1514.0,583.8571428571429
137264844.0,17,14,864,7,432,19666842.666666668,174.0,61.71428571428572,7,432,19667521.0,174.0,61.71428571428572
26531.0,6,10,2032,5,524,5499.0,252.0,104.8,5,1508,6267.25,1236.0,301.6
309125.0,6,6,412,4,272,103041.66666666669,74.0,68.0,2,140,0.0,74.0,70.0
9491.0,6,11,2098,6,590,1823.2,252.0,98.33333333333331,5,1508,1884.0,1236.0,301.6
42605.0,6,14,4740,7,653,6975.333333333333,249.0,93.28571428571428,7,4087,6659.833333333333,1514.0,583.8571428571429
120119378.0,6,14,2240,6,1224,24023875.6,204.0,204.0,8,1016,17136351.14285714,188.0,127.0
144069.0,17,2,180,1,90,0.0,90.0,90.0,1,90,0.0,90.0,90.0
1314989.0,6,4,264,2,132,0.0,66.0,66.0,2,132,0.0,66.0,66.0
135136743.0,17,6,1146,6,1146,27027348.6,191.0,191.0,0,0,0.0,0.0,0.0
10490940.0,6,7,478,4,272,3449861.6666666665,74.0,68.0,3,206,5174683.0,74.0,68.66666666666667
94631847.0,17,12,778,6,389,18801650.4,174.0,64.83333333333333,6,389,18800157.0,174.0,64.83333333333333
119633728.0,6,238,27136,119,18986,1011931.466101695,336.0,159.54621848739495,119,8150,1011931.6101694916,140.0,68.4873949579832
18394.0,6,10,2032,5,524,3164.0,252.0,104.8,5,1508,3857.25,1236.0,301.6
24849.0,6,10,2032,5,524,5973.25,252.0,104.8,5,1508,5650.5,1236.0,301.6
17403.0,6,10,2032,5,524,4109.0,252.0,104.8,5,1508,4005.5,1236.0,301.6
197840.0,17,2,180,1,90,0.0,90.0,90.0,1,90,0.0,90.0,90.0
92880278.0,6,38,2508,19,1254,5160001.888888889,66.0,66.0,19,1254,5160001.833333333,66.0,66.0
393483.0,17,2,363,1,75,0.0,75.0,75.0,1,288,0.0,288.0,288.0
197104.0,17,2,180,1,90,0.0,90.0,90.0,1,90,0.0,90.0,90.0
110261.0,6,10,2032,5,524,27340.25,252.0,104.8,5,1508,26386.5,1236.0,301.6
2801520.0,6,2,132,1,66,0.0,66.0,66.0,1,66,0.0,66.0,66.0
12902.0,6,10,1065,5,534,2827.5,262.0,106.8,5,531,2879.0,259.0,106.2
120051741.0,17,29,13785,29,13785,4287562.178571428,501.0,475.3448275862069,0,0,0.0,0.0,0.0
8434.0,6,6,504,3,198,3050.5,66.0,66.0,3,306,2045.5,174.0,102.0
108103058.0,17,5,955,5,955,27025764.5,191.0,191.0,0,0,0.0,0.0,0.0
113888290.0,6,48,3168,24,1584,4951664.782608695,66.0,66.0,24,1584,4937986.739130435,66.0,66.0
135134512.0,17,6,1146,6,1146,27026902.4,191.0,191.0,0,0,0.0,0.0,0.0
483039.0,6,3,204,1,68,0.0,68.0,68.0,2,136,0.0,70.0,68.0
107526.0,17,2,286,2,286,0.0,143.0,143.0,0,0,0.0,0.0,0.0
90485175.0,6,13,1910,8,1016,12908641.714285716,188.0,127.0,5,894,15114059.5,204.0,178.8
5621584.0,6,4,270,2,134,0.0,68.0,67.0,2,136,0.0,70.0,68.0
108107795.0,17,5,955,5,955,27026948.75,191.0,191.0,0,0,0.0,0.0,0.0
405995.0,6,4,508,2,238,0.0,172.0,119.0,2,270,0.0,135.0,135.0
216737.0,6,3,426,2,280,0.0,214.0,140.0,1,146,0.0,146.0,146.0
9640.0,6,11,2098,6,590,1852.2,252.0,98.33333333333331,5,1508,2053.25,1236.0,301.6
2695559.0,6,2,132,1,66,0.0,66.0,66.0,1,66,0.0,66.0,66.0
102919.0,17,2,286,2,286,0.0,143.0,143.0,0,0,0.0,0.0,0.0
966810.0,6,2,132,1,66,0.0,66.0,66.0,1,66,0.0,66.0,66.0
40374.0,6,12,1320,6,723,6871.0,253.0,120.5,6,597,6347.4,259.0,99.5
2798947.0,6,2,132,1,66,0.0,66.0,66.0,1,66,0.0,66.0,66.0
21422.0,6,14,4740,7,653,3460.5,249.0,93.28571428571428,7,4087,3435.0,1514.0,583.8571428571429
93156059.0,6,341,43468,171,11508,547976.8176470589,140.0,67.29824561403508,170,31960,549906.9585798817,464.0,188.0
201865.0,17,2,762,2,762,0.0,381.0,381.0,0,0,0.0,0.0,0.0
120461740.0,6,235,26450,118,18432,1029587.5213675214,284.0,156.20338983050848,117,8018,1020695.4655172414,140.0,68.52991452991454
1306899.0,6,4,264,2,132,0.0,66.0,66.0,2,132,0.0,66.0,66.0
205819.0,17,2,180,1,90,0.0,90.0,90.0,1,90,0.0,90.0,90.0
249333.0,6,3,337,2,214,0.0,160.0,107.0,1,123,0.0,123.0,123.0
846660.0,6,9,1118,6,586,169332.0,248.0,97.66666666666669,3,532,286954.5,392.0,177.33333333333334
99543939.0,17,12,778,6,389,19908755.8,174.0,64.83333333333333,6,389,19877001.0,174.0,64.83333333333333
101978.0,17,2,286,2,286,0.0,143.0,143.0,0,0,0.0,0.0,0.0
217735.0,6,3,426,2,280,0.0,214.0,140.0,1,146,0.0,146.0,146.0
10940584.0,6,7,478,3,206,5399235.0,74.0,68.66666666666667,4,272,3599384.6666666665,74.0,68.0
2244.0,17,4,344,2,150,0.0,75.0,75.0,2,194,0.0,103.0,97.0
1735.0,17,4,344,2,150,0.0,75.0,75.0,2,194,0.0,103.0,97.0
342926.0,6,6,412,4,272,114308.66666666669,74.0,68.0,2,140,0.0,74.0,70.0
13977.0,6,10,1067,5,536,3313.0,264.0,107.2,5,531,3300.25,259.0,106.2
299850.0,17,2,238,1,74,0.0,74.0,74.0,1,164,0.0,164.0,164.0
3164760.0,6,18,1495,9,921,358385.75,315.0,102.33333333333331,9,574,358352.625,78.0,63.77777777777778
92102766.0,6,163,18284,82,5646,1137027.913580247,140.0,68.85365853658537,81,12638,1076764.725,284.0,156.02469135802468
103188903.0,17,14,864,7,432,17166829.666666668,174.0,61.71428571428572,7,432,17167647.5,174.0,61.71428571428572
105948.0,17,2,700,2,700,0.0,350.0,350.0,0,0,0.0,0.0,0.0
165850.0,6,10,1102,5,570,41167.25,298.0,114.0,5,532,41106.75,260.0,106.4
10463498.0,6,7,478,4,272,3442131.6666666665,74.0,68.0,3,206,5163105.5,74.0,68.66666666666667
103036.0,17,2,762,2,762,0.0,381.0,381.0,0,0,0.0,0.0,0.0
363.0,17,2,174,1,79,0.0,79.0,79.0,1,95,0.0,95.0,95.0
101057002.0,17,13,821,7,432,16816338.0,174.0,61.71428571428572,6,389,16233773.6,174.0,64.83333333333333
16949.0,6,14,4740,7,653,2511.833333333333,249.0,93.28571428571428,7,4087,2513.333333333333,1514.0,583.8571428571429
197396.0,17,2,180,1,90,0.0,90.0,90.0,1,90,0.0,90.0,90.0
90052676.0,17,27,12943,27,12943,3463564.461538461,501.0,479.3703703703704,0,0,0.0,0.0,0.0
28525.0,6,14,4740,7,653,4360.666666666667,249.0,93.28571428571428,7,4087,4613.666666666667,1514.0,583.8571428571429
302440.0,6,2,132,1,66,0.0,66.0,66.0,1,66,0.0,66.0,66.0
104443560.0,6,30,2106,15,1089,7444824.428571428,123.0,72.6,15,1017,7444824.285714285,123.0,67.8
100224976.0,17,12,778,6,389,19986327.8,174.0,64.83333333333333,6,389,20012814.6,174.0,64.83333333333333
90032823.0,17,27,12943,27,12943,3462800.8846153845,501.0,479.3703703703704,0,0,0.0,0.0,0.0
82.0,17,2,762,2,762,0.0,381.0,381.0,0,0,0.0,0.0,0.0
4239.0,17,2,614,1,72,0.0,72.0,72.0,1,542,0.0,542.0,542.0
101963.0,6,14,4740,7,653,16051.833333333334,249.0,93.28571428571428,7,4087,16637.666666666668,1514.0,583.8571428571429
228260.0,17,2,180,1,90,0.0,90.0,90.0,1,90,0.0,90.0,90.0
90790691.0,6,17,1287,9,691,11339392.125,95.0,76.77777777777777,8,596,12966440.57142857,95.0,74.5
153338.0,17,2,180,1,90,0.0,90.0,90.0,1,90,0.0,90.0,90.0
21906.0,6,10,2032,5,524,5164.0,252.0,104.8,5,1508,5106.25,1236.0,301.6
2603686.0,6,2,132,1,66,0.0,66.0,66.0,1,66,0.0,66.0,66.0
14636420.0,6,20,1607,10,975,1592151.4444444445,315.0,97.5,10,632,1592131.5555555555,78.0,63.2
149860821.0,17,36,17126,36,17126,4281737.742857143,501.0,475.72222222222223,0,0,0.0,0.0,0.0
306191.0,6,6,412,4,272,102063.66666666669,74.0,68.0,2,140,0.0,74.0,70.0
100576254.0,17,12,778,6,389,19801580.8,174.0,64.83333333333333,6,389,20000192.8,174.0,64.83333333333333
147950.0,17,2,180,1,90,0.0,90.0,90.0,1,90,0.0,90.0,90.0
33477.0,6,14,4740,7,653,5284.166666666667,249.0,93.28571428571428,7,4087,5443.833333333333,1514.0,583.8571428571429
32284.0,6,10,2032,5,524,6913.75,252.0,104.8,5,1508,6401.75,1236.0,301.6
98147899.0,17,14,1126,7,563,16333469.833333334,174.0,80.42857142857143,7,563,16334175.166666666,174.0,80.42857142857143
741.0,17,4,438,2,148,0.0,74.0,74.0,2,290,0.0,147.0,145.0
5617897.0,6,4,270,2,134,0.0,68.0,67.0,2,136,0.0,70.0,68.0
1161224.0,6,13,3010,8,2382,165889.14285714287,1514.0,297.75,5,628,221340.75,331.0,125.6
153360.0,17,2,180,1,90,0.0,90.0,90.0,1,90,0.0,90.0,90.0
40151.0,6,14,4740,7,653,6564.833333333333,249.0,93.28571428571428,7,4087,5561.666666666667,1514.0,583.8571428571429
0.0,6,1,66,1,66,0.0,66.0,66.0,0,0,0.0,0.0,0.0
108106550.0,17,5,1005,5,1005,27026637.5,201.0,201.0,0,0,0.0,0.0,0.0
0.0,17,1,381,1,381,0.0,381.0,381.0,0,0,0.0,0.0,0.0
34257.0,6,10,2032,5,524,8306.25,252.0,104.8,5,1508,8122.25,1236.0,301.6
31924.0,6,13,1479,7,882,5320.666666666667,291.0,126.0,6,597,4810.6,259.0,99.5
20099.0,6,14,4740,7,653,3239.333333333333,249.0,93.28571428571428,7,4087,2912.1666666666665,1514.0,583.8571428571429
90039604.0,17,28,13364,28,13364,3334800.1481481483,501.0,477.2857142857143,0,0,0.0,0.0,0.0
146793.0,6,3,373,2,238,0.0,172.0,119.0,1,135,0.0,135.0,135.0
15098.0,6,14,4740,7,653,2397.1666666666665,249.0,93.28571428571428,7,4087,2381.333333333333,1514.0,583.8571428571429
2447.0,17,4,344,2,150,0.0,75.0,75.0,2,194,0.0,103.0,97.0
120043123.0,6,23,1896,12,1097,10908875.090909092,257.0,91.41666666666669,11,799,11999562.0,95.0,72.63636363636364
7075.0,17,2,582,1,83,0.0,83.0,83.0,1,499,0.0,499.0,499.0
100042546.0,17,12,778,6,389,20001046.8,174.0,64.83333333333333,6,389,20000154.2,174.0,64.83333333333333
204499.0,17,3,1143,3,1143,102249.5,381.0,381.0,0,0,0.0,0.0,0.0
108095804.0,17,5,1005,5,1005,27023951.0,201.0,201.0,0,0,0.0,0.0,0.0
329.0,17,2,164,1,74,0.0,74.0,74.0,1,90,0.0,90.0,90.0
145475.0,6,2,132,1,66,0.0,66.0,66.0,1,66,0.0,66.0,66.0
2360.0,17,4,344,2,150,0.0,75.0,75.0,2,194,0.0,103.0,97.0
41686.0,6,14,4740,7,653,5894.5,249.0,93.28571428571428,7,4087,6590.5,1514.0,583.8571428571429
2325.0,17,4,344,2,150,0.0,75.0,75.0,2,194,0.0,103.0,97.0
103540908.0,6,44,2904,22,1452,4930519.428571428,66.0,66.0,22,1452,4916048.523809524,66.0,66.0
221711.0,17,2,180,1,90,0.0,90.0,90.0,1,90,0.0,90.0,90.0
120044161.0,17,29,13785,29,13785,4287291.464285715,501.0,475.3448275862069,0,0,0.0,0.0,0.0
228353.0,17,2,180,1,90,0.0,90.0,90.0,1,90,0.0,90.0,90.0
299.0,17,2,156,1,78,0.0,78.0,78.0,1,78,0.0,78.0,78.0
148025.0,17,2,180,1,90,0.0,90.0,90.0,1,90,0.0,90.0,90.0
2135522.0,6,37,15535,19,10912,118640.11111111112,1514.0,574.3157894736842,18,4623,112444.88235294116,1514.0,256.8333333333333
36047.0,6,14,4740,7,653,5423.333333333333,249.0,93.28571428571428,7,4087,5866.333333333333,1514.0,583.8571428571429
327.0,17,2,762,2,762,0.0,381.0,381.0,0,0,0.0,0.0,0.0
90289015.0,6,26,2855,13,1407,7520578.5,423.0,108.23076923076924,13,1448,7523410.083333333,335.0,111.3846153846154
90018250.0,17,28,13364,28,13364,3334009.25925926,501.0,477.2857142857143,0,0,0.0,0.0,0.0
15139.0,6,12,1393,6,796,2849.8,271.0,132.66666666666666,6,597,2829.6,259.0,99.5
45489.0,6,14,4740,7,653,7261.333333333333,249.0,93.28571428571428,7,4087,7389.333333333333,1514.0,583.8571428571429
1190697.0,6,13,3000,8,2372,170099.57142857142,1514.0,296.5,5,628,229514.5,331.0,125.6
838.0,17,4,438,2,148,0.0,74.0,74.0,2,290,0.0,147.0,145.0
10520372.0,6,7,478,4,272,3461221.6666666665,74.0,68.0,3,206,5191715.5,74.0,68.66666666666667
199099.0,17,2,180,1,90,0.0,90.0,90.0,1,90,0.0,90.0,90.0
120123587.0,6,14,2240,6,1224,24024717.4,204.0,204.0,8,1016,17137067.285714287,188.0,127.0
200050.0,17,4,6056,4,6056,66683.33333333333,1514.0,1514.0,0,0,0.0,0.0,0.0
2832971.0,6,3,1602,1,752,0.0,752.0,752.0,2,850,0.0,784.0,425.0
2081.0,17,4,344,2,150,0.0,75.0,75.0,2,194,0.0,103.0,97.0
50801.0,6,10,2032,5,524,12464.75,252.0,104.8,5,1508,9605.25,1236.0,301.6
328066.0,17,4,1400,4,1400,109355.33333333331,350.0,350.0,0,0,0.0,0.0,0.0
104748672.0,17,15,5130,15,5130,7482048.0,342.0,342.0,0,0,0.0,0.0,0.0
103312499.0,6,44,2904,22,1452,4911764.714285715,66.0,66.0,22,1452,4919126.714285715,66.0,66.0
52113.0,6,14,4740,7,653,8568.0,249.0,93.28571428571428,7,4087,7988.666666666667,1514.0,583.8571428571429
617.0,17,2,762,2,762,0.0,381.0,381.0,0,0,0.0,0.0,0.0
0.0,17,1,381,1,381,0.0,381.0,381.0,0,0,0.0,0.0,0.0
14139.0,6,10,2032,5,524,3291.5,252.0,104.8,5,1508,3168.0,1236.0,301.6
32023.000000000004,6,10,2032,5,524,7624.5,252.0,104.8,5,1508,6340.0,1236.0,301.6
300660.0,6,6,412,4,272,100220.0,74.0,68.0,2,140,0.0,74.0,70.0
1517376.0,6,19,7533,10,1403,168597.33333333334,583.0,140.3,9,6130,157642.375,1484.0,681.1111111111111
242555.0,6,3,337,2,214,0.0,160.0,107.0,1,123,0.0,123.0,123.0
162.0,17,2,3028,2,3028,0.0,1514.0,1514.0,0,0,0.0,0.0,0.0
196787.0,17,2,180,1,90,0.0,90.0,90.0,1,90,0.0,90.0,90.0
6801.0,17,2,582,1,83,0.0,83.0,83.0,1,499,0.0,499.0,499.0
232261.0,6,3,337,2,214,0.0,160.0,107.0,1,123,0.0,123.0,123.0
0.0,17,1,55,1,55,0.0,55.0,55.0,0,0,0.0,0.0,0.0
121286.0,6,3,337,2,214,0.0,160.0,107.0,1,123,0.0,123.0,123.0
90314052.0,6,16,1192,8,596,12895711.142857144,95.0,74.5,8,596,12900600.714285716,95.0,74.5
211205.0,17,2,180,1,90,0.0,90.0,90.0,1,90,0.0,90.0,90.0
447334.0,17,4,360,2,140,0.0,70.0,70.0,2,220,0.0,110.0,110.0
100416087.0,17,11,604,6,389,20083217.4,174.0,64.83333333333333,5,215,20001445.25,43.0,43.0
161146.0,6,2,128,1,74,0.0,74.0,74.0,1,54,0.0,54.0,54.0
90257306.0,6,14,2240,8,1016,12893900.857142856,188.0,127.0,6,1224,18018429.2,204.0,204.0
59983.0,6,12,1320,7,789,9997.166666666666,253.0,112.71428571428572,5,531,11240.0,259.0,106.2
3019724.0,6,11,2106,6,598,603056.4,252.0,99.66666666666669,5,1508,2975.25,1236.0,301.6
120374534.0,6,299,36032,150,25976,807882.77852349,300.0,173.17333333333335,149,10056,806290.9189189189,140.0,67.48993288590604
103788104.0,6,44,2904,22,1452,4942290.666666667,66.0,66.0,22,1452,4927316.952380952,66.0,66.0
122530460.0,6,49,3234,25,1650,5105435.833333333,66.0,66.0,24,1584,5042007.913043479,66.0,66.0
40735.0,6,14,4740,7,653,6168.0,249.0,93.28571428571428,7,4087,5298.5,1514.0,583.8571428571429
90256974.0,6,13,2036,8,1016,12893853.42857143,188.0,127.0,5,1020,22522176.0,204.0,204.0
241171.0,6,3,373,2,238,0.0,172.0,119.0,1,135,0.0,135.0,135.0
1769677.0,6,2,132,1,66,0.0,66.0,66.0,1,66,0.0,66.0,66.0
2455.0,17,4,344,2,150,0.0,75.0,75.0,2,194,0.0,103.0,97.0
38940.0,6,14,4740,7,653,6331.166666666667,249.0,93.28571428571428,7,4087,5934.333333333333,1514.0,583.8571428571429
135128918.0,17,6,1206,6,1206,27025783.6,201.0,201.0,0,0,0.0,0.0,0.0
133230.0,6,2,132,1,66,0.0,66.0,66.0,1,66,0.0,66.0,66.0
135136936.0,17,6,1146,6,1146,27027387.2,191.0,191.0,0,0,0.0,0.0,0.0
905.0,17,2,762,2,762,0.0,381.0,381.0,0,0,0.0,0.0,0.0
2082.0,17,2,180,1,90,0.0,90.0,90.0,1,90,0.0,90.0,90.0
46425.0,6,11,2098,6,590,9140.4,252.0,98.33333333333331,5,1508,11371.75,1236.0,301.6
257577.0,6,3,337,2,214,0.0,160.0,107.0,1,123,0.0,123.0,123.0
1311914.0,17,7,490,7,490,218652.3333333333,70.0,70.0,0,0,0.0,0.0,0.0
303787.0,6,2,138,1,68,0.0,68.0,68.0,1,70,0.0,70.0,70.0
24690.0,6,10,2032,5,524,5901.5,252.0,104.8,5,1508,5657.75,1236.0,301.6
25569.0,6,10,2032,5,524,5751.25,252.0,104.8,5,1508,5654.5,1236.0,301.6
121230.0,6,3,337,2,214,0.0,160.0,107.0,1,123,0.0,123.0,123.0
108599.0,17,2,286,2,286,0.0,143.0,143.0,0,0,0.0,0.0,0.0
1305730.0,6,4,264,2,132,0.0,66.0,66.0,2,132,0.0,66.0,66.0
9709.0,6,10,2032,5,524,2165.75,252.0,104.8,5,1508,2191.0,1236.0,301.6
38236.0,6,14,4740,7,653,5757.833333333333,249.0,93.28571428571428,7,4087,6235.5,1514.0,583.8571428571429
90013052.0,17,28,13364,28,13364,3333816.7407407407,501.0,477.2857142857143,0,0,0.0,0.0,0.0
3006660.0,6,11,2106,6,598,601098.2,252.0,99.66666666666669,5,1508,2131.75,1236.0,301.6
48338.0,6,14,4740,7,653,7866.666666666667,249.0,93.28571428571428,7,4087,7821.0,1514.0,583.8571428571429
120073035.0,17,28,13364,28,13364,4447149.444444444,501.0,477.2857142857143,0,0,0.0,0.0,0.0
232921.0,6,3,337,2,214,0.0,160.0,107.0,1,123,0.0,123.0,123.0
108094936.0,17,5,1005,5,1005,27023734.0,201.0,201.0,0,0,0.0,0.0,0.0
206142.0,17,4,1524,4,1524,68714.0,381.0,381.0,0,0,0.0,0.0,0.0
43593.0,6,14,4740,7,653,6250.166666666667,249.0,93.28571428571428,7,4087,7127.0,1514.0,583.8571428571429
205841.0,17,2,180,1,90,0.0,90.0,90.0,1,90,0.0,90.0,90.0
750.0,17,4,438,2,148,0.0,74.0,74.0,2,290,0.0,147.0,145.0
59301.0,6,11,2098,6,590,11677.2,252.0,98.33333333333331,5,1508,14349.25,1236.0,301.6
2023.0,17,4,344,2,150,0.0,75.0,75.0,2,194,0.0,103.0,97.0
135120218.0,17,6,1146,6,1146,27024043.6,191.0,191.0,0,0,0.0,0.0,0.0
104700567.0,17,14,4788,14,4788,8053889.769230769,342.0,342.0,0,0,0.0,0.0,0.0
41000.0,6,20,7606,11,978,4100.0,310.0,88.9090909090909,9,6628,4773.5,1514.0,736.4444444444445
195199.0,6,2,132,1,66,0.0,66.0,66.0,1,66,0.0,66.0,66.0
41506.0,6,14,4740,7,653,6349.666666666667,249.0,93.28571428571428,7,4087,5848.833333333333,1514.0,583.8571428571429
129112.0,17,2,762,2,762,0.0,381.0,381.0,0,0,0.0,0.0,0.0
43539.0,6,14,4740,7,653,6820.833333333333,249.0,93.28571428571428,7,4087,6492.333333333333,1514.0,583.8571428571429
182050.0,6,10,1066,5,490,43138.5,218.0,98.0,5,576,45249.0,304.0,115.2
20120.0,17,2,582,1,83,0.0,83.0,83.0,1,499,0.0,499.0,499.0
122978328.0,6,48,3168,24,1584,5170536.869565218,66.0,66.0,24,1584,5096681.956521739,66.0,66.0
114948977.0,6,48,3168,24,1584,4997781.608695652,66.0,66.0,24,1584,4984359.913043479,66.0,66.0
103676880.0,6,32,2358,17,1272,6466296.3125,123.0,74.82352941176471,15,1086,7390062.714285715,123.0,72.4
51308.0,6,14,4740,7,653,8424.333333333334,249.0,93.28571428571428,7,4087,8116.0,1514.0,583.8571428571429
127040496.0,6,35,2542,17,1194,7315852.875,123.0,70.23529411764706,18,1348,6885477.647058823,139.0,74.88888888888889
120172.0,17,2,180,1,70,0.0,70.0,70.0,1,110,0.0,110.0,110.0
299461.0,6,6,412,4,272,99820.33333333331,74.0,68.0,2,140,0.0,74.0,70.0
3464658.0,17,3,1026,3,1026,1732329.0,342.0,342.0,0,0,0.0,0.0,0.0
17035.0,6,10,1065,5,534,2811.5,262.0,106.8,5,531,3913.75,259.0,106.2
108894.0,17,2,286,2,286,0.0,143.0,143.0,0,0,0.0,0.0,0.0
103120.0,17,2,286,2,286,0.0,143.0,143.0,0,0,0.0,0.0,0.0
250253.0,6,3,337,2,214,0.0,160.0,107.0,1,123,0.0,123.0,123.0
51917.0,6,14,4740,7,653,8444.0,249.0,93.28571428571428,7,4087,8161.5,1514.0,583.8571428571429
90034414.0,17,27,12943,27,12943,3462862.076923077,501.0,479.3703703703704,0,0,0.0,0.0,0.0
205817.0,17,2,180,1,90,0.0,90.0,90.0,1,90,0.0,90.0,90.0
2798797.0,6,2,132,1,66,0.0,66.0,66.0,1,66,0.0,66.0,66.0
303300.0,6,6,412,4,272,101100.0,74.0,68.0,2,140,0.0,74.0,70.0
90303390.0,6,20,1490,10,704,10028126.0,95.0,70.4,10,786,10033026.0,95.0,78.6
2328.0,17,4,344,2,150,0.0,75.0,75.0,2,194,0.0,103.0,97.0
82.0,17,2,762,2,762,0.0,381.0,381.0,0,0,0.0,0.0,0.0
120380590.0,6,712,131238,358,107430,337200.53221288515,1514.0,300.08379888268155,354,23808,338403.82152974507,214.0,67.2542372881356
1035018.0,17,5,961,3,234,517288.0,78.0,78.0,2,727,0.0,395.0,363.5
41151.0,6,10,2032,5,524,9959.75,252.0,104.8,5,1508,9702.0,1236.0,301.6
135127025.0,17,6,1206,6,1206,27025405.0,201.0,201.0,0,0,0.0,0.0,0.0
120285922.0,6,235,26572,118,18628,1028084.8034188034,284.0,157.864406779661,117,7944,1027916.4137931034,140.0,67.8974358974359
27117977.0,17,5,1710,5,1710,6779494.25,342.0,342.0,0,0,0.0,0.0,0.0
233929.0,6,3,426,2,280,0.0,214.0,140.0,1,146,0.0,146.0,146.0
34171.0,6,14,4740,7,653,5091.166666666667,249.0,93.28571428571428,7,4087,5554.5,1514.0,583.8571428571429
106774.0,17,2,286,2,286,0.0,143.0,143.0,0,0,0.0,0.0,0.0
36168.0,6,14,4740,7,653,5638.666666666667,249.0,93.28571428571428,7,4087,5473.666666666667,1514.0,583.8571428571429
120040916.0,17,29,13785,29,13785,4287175.571428572,501.0,475.3448275862069,0,0,0.0,0.0,0.0
27019.0,17,4,823,2,163,0.0,89.0,81.5,2,660,0.0,443.0,330.0
69547.0,6,14,4740,7,653,10385.166666666666,249.0,93.28571428571428,7,4087,10850.833333333334,1514.0,583.8571428571429
115528229.0,17,16,1212,8,606,16481156.714285716,174.0,75.75,8,606,16417338.57142857,174.0,75.75
92447468.0,17,12,778,6,389,18400551.0,174.0,64.83333333333333,6,389,18000154.4,174.0,64.83333333333333
206369.0,6,3,426,2,280,0.0,214.0,140.0,1,146,0.0,146.0,146.0
3012.0,17,2,762,2,762,0.0,381.0,381.0,0,0,0.0,0.0,0.0
18436.0,6,10,1067,5,536,4198.0,264.0,107.2,5,531,4269.25,259.0,106.2
206346.0,17,2,762,2,762,0.0,381.0,381.0,0,0,0.0,0.0,0.0
43422.0,6,14,4740,7,653,7071.333333333333,249.0,93.28571428571428,7,4087,6631.333333333333,1514.0,583.8571428571429
284360.0,17,2,363,1,79,0.0,79.0,79.0,1,284,0.0,284.0,284.0
255345.0,6,3,337,2,214,0.0,160.0,107.0,1,123,0.0,123.0,123.0
298260.0,6,6,412,4,272,99420.0,74.0,68.0,2,140,0.0,74.0,70.0
50608.0,6,14,4740,7,653,6061.333333333333,249.0,93.28571428571428,7,4087,8297.166666666666,1514.0,583.8571428571429
5628979.0,6,4,270,2,134,0.0,68.0,67.0,2,136,0.0,70.0,68.0
107232.0,17,2,286,2,286,0.0,143.0,143.0,0,0,0.0,0.0,0.0
46788701.0,6,8,1940,3,887,22211104.0,753.0,295.6666666666667,5,1053,10999910.0,785.0,210.6
2076.0,17,4,344,2,150,0.0,75.0,75.0,2,194,0.0,103.0,97.0
106705.0,17,2,286,2,286,0.0,143.0,143.0,0,0,0.0,0.0,0.0
1309683.0,6,4,264,2,132,0.0,66.0,66.0,2,132,0.0,66.0,66.0
2248.0,17,2,180,1,90,0.0,90.0,90.0,1,90,0.0,90.0,90.0
306.0,17,2,168,1,76,0.0,76.0,76.0,1,92,0.0,92.0,92.0
232252.0,6,3,337,2,214,0.0,160.0,107.0,1,123,0.0,123.0,123.0
108105700.0,17,5,1005,5,1005,27026425.0,201.0,201.0,0,0,0.0,0.0,0.0
24010.0,6,14,4740,7,653,3754.3333333333335,249.0,93.28571428571428,7,4087,3865.0,1514.0,583.8571428571429
33869.0,6,10,2032,5,524,8171.75,252.0,104.8,5,1508,6550.5,1236.0,301.6
3936.000000000001,17,4,704,2,148,0.0,74.0,74.0,2,556,0.0,280.0,278.0
2800133.0,6,2,132,1,66,0.0,66.0,66.0,1,66,0.0,66.0,66.0
217917.0,6,3,426,2,280,0.0,214.0,140.0,1,146,0.0,146.0,146.0
2311.0,17,4,344,2,150,0.0,75.0,75.0,2,194,0.0,103.0,97.0
90164120.0,6,25,1692,13,906,7495689.916666667,123.0,69.6923076923077,12,786,8177116.272727272,123.0,65.5
15035.0,17,2,180,1,90,0.0,90.0,90.0,1,90,0.0,90.0,90.0
129304445.0,6,35,2394,18,1269,7606143.823529412,123.0,70.5,17,1125,7443984.5625,123.0,66.17647058823529
10481598.0,6,7,478,4,272,3446590.6666666665,74.0,68.0,3,206,5169754.5,74.0,68.66666666666667
308370.0,6,6,412,4,272,102790.0,74.0,68.0,2,140,0.0,74.0,70.0
28602.0,6,10,2032,5,524,6607.5,252.0,104.8,5,1508,5756.25,1236.0,301.6
103045.0,17,2,286,2,286,0.0,143.0,143.0,0,0,0.0,0.0,0.0
90254732.0,6,12,1832,8,1016,12893533.142857144,188.0,127.0,4,816,30029925.33333333,204.0,204.0
2050.0,17,4,344,2,150,0.0,75.0,75.0,2,194,0.0,103.0,97.0
115192227.0,6,207,23252,104,7160,1118371.1359223302,140.0,68.84615384615384,103,16092,1120357.794117647,284.0,156.23300970873785
2764396.0,17,2,876,2,876,0.0,438.0,438.0,0,0,0.0,0.0,0.0
10485651.0,6,7,478,4,272,3448025.333333333,74.0,68.0,3,206,5171886.5,74.0,68.66666666666667
143905.0,17,2,180,1,90,0.0,90.0,90.0,1,90,0.0,90.0,90.0
22987.0,6,10,2032,5,524,5531.5,252.0,104.8,5,1508,4806.0,1236.0,301.6
38097.0,6,13,1386,7,789,6064.166666666667,253.0,112.71428571428572,6,597,5677.0,259.0,99.5
10470136.0,6,7,478,4,272,3444678.0,74.0,68.0,3,206,5166956.0,74.0,68.66666666666667
92200921.0,17,16,5472,16,5472,6146728.066666666,342.0,342.0,0,0,0.0,0.0,0.0
0.0,6,1,66,1,66,0.0,66.0,66.0,0,0,0.0,0.0,0.0
306788.0,6,6,412,4,272,102262.66666666669,74.0,68.0,2,140,0.0,74.0,70.0
171680.0,17,2,180,1,90,0.0,90.0,90.0,1,90,0.0,90.0,90.0
105737.0,17,2,700,2,700,0.0,350.0,350.0,0,0,0.0,0.0,0.0
47611149.0,6,8,1940,3,887,22425119.5,753.0,295.6666666666667,5,1053,11209195.75,785.0,210.6
117381267.0,17,14,864,7,432,19500579.166666668,174.0,61.71428571428572,7,432,19500168.5,174.0,61.71428571428572
114407399.0,6,611,112812,309,92436,371452.5941558442,1514.0,299.1456310679612,302,20376,379300.1627906977,214.0,67.47019867549669
320.0,17,2,208,1,72,0.0,72.0,72.0,1,136,0.0,136.0,136.0
74573605.0,6,9,842,9,842,9321700.625,97.0,93.55555555555556,0,0,0.0,0.0,0.0
52975.0,6,14,4740,7,653,8693.0,249.0,93.28571428571428,7,4087,7170.5,1514.0,583.8571428571429
13325.0,17,2,762,2,762,0.0,381.0,381.0,0,0,0.0,0.0,0.0
32396.0,6,14,4740,7,653,4677.5,249.0,93.28571428571428,7,4087,5247.166666666667,1514.0,583.8571428571429
4554.0,17,2,602,1,72,0.0,72.0,72.0,1,530,0.0,530.0,530.0
153382.0,17,2,180,1,90,0.0,90.0,90.0,1,90,0.0,90.0,90.0
58155.0,6,10,2032,5,524,13868.25,252.0,104.8,5,1508,14155.75,1236.0,301.6
328.0,17,2,208,1,72,0.0,72.0,72.0,1,136,0.0,136.0,136.0
61826.0,6,12,1320,6,723,10078.6,253.0,120.5,6,597,12026.8,259.0,99.5
302433.0,6,6,412,4,272,100811.0,74.0,68.0,2,140,0.0,74.0,70.0
110124085.0,6,32,2358,17,1272,6869944.8125,123.0,74.82352941176471,15,1086,7851364.142857143,123.0,72.4
100082.0,17,2,700,2,700,0.0,350.0,350.0,0,0,0.0,0.0,0.0
148585858.0,6,22,1680,12,935,13507805.272727272,95.0,77.91666666666667,10,745,13266032.333333334,95.0,74.5
143873.0,17,2,180,1,90,0.0,90.0,90.0,1,90,0.0,90.0,90.0
27411073.0,17,5,1710,5,1710,6852768.25,342.0,342.0,0,0,0.0,0.0,0.0
32098198.0,6,7,1874,3,887,15978800.0,753.0,295.6666666666667,4,987,10654798.333333334,785.0,246.75
114338488.0,6,30,1990,15,1042,8151604.928571428,139.0,69.46666666666667,15,948,8151605.928571428,123.0,63.2
35583.0,6,14,4740,7,653,5609.333333333333,249.0,93.28571428571428,7,4087,5775.333333333333,1514.0,583.8571428571429
90096041.0,6,15,2180,7,1164,15015608.333333334,204.0,166.28571428571428,8,1016,12870444.714285716,188.0,127.0
25983.0,6,14,4740,7,653,4211.5,249.0,93.28571428571428,7,4087,4137.333333333333,1514.0,583.8571428571429
49601.0,6,10,2032,5,524,11579.75,252.0,104.8,5,1508,11536.0,1236.0,301.6
14467.0,6,13,1459,7,862,2184.5,271.0,123.14285714285714,6,597,2512.2,259.0,99.5
142230.0,6,2,132,1,66,0.0,66.0,66.0,1,66,0.0,66.0,66.0
148674.0,17,2,414,1,88,0.0,88.0,88.0,1,326,0.0,326.0,326.0
9973.0,17,4,823,2,163,0.0,89.0,81.5,2,660,0.0,443.0,330.0
116271714.0,17,16,1212,8,606,16572504.57142857,174.0,75.75,8,606,16571579.57142857,174.0,75.75
2588725.0,6,2,132,1,66,0.0,66.0,66.0,1,66,0.0,66.0,66.0
327626.0,6,6,412,4,272,109208.66666666669,74.0,68.0,2,140,0.0,74.0,70.0
90296331.0,6,12,1832,8,1016,12899475.857142856,188.0,127.0,4,816,30044836.666666668,204.0,204.0
192415.0,17,2,180,1,90,0.0,90.0,90.0,1,90,0.0,90.0,90.0
2866.0,17,2,224,1,76,0.0,76.0,76.0,1,148,0.0,148.0,148.0
90284329.0,6,16,1192,8,596,12891467.714285716,95.0,74.5,8,596,12896024.714285716,95.0,74.5
35580.0,6,10,2032,5,524,8669.75,252.0,104.8,5,1508,8608.5,1236.0,301.6
2380.0,17,4,344,2,150,0.0,75.0,75.0,2,194,0.0,103.0,97.0
2304.0,17,4,344,2,150,0.0,75.0,75.0,2,194,0.0,103.0,97.0
358.0,17,2,267,1,83,0.0,83.0,83.0,1,184,0.0,184.0,184.0
2386.0,17,4,344,2,150,0.0,75.0,75.0,2,194,0.0,103.0,97.0
78336.0,6,14,4740,7,653,12907.166666666666,249.0,93.28571428571428,7,4087,12911.833333333334,1514.0,583.8571428571429
22447.0,6,12,1413,7,882,3741.1666666666665,291.0,126.0,5,531,4650.5,259.0,106.2
2566.0,17,4,344,2,150,0.0,75.0,75.0,2,194,0.0,103.0,97.0
595230.0,6,4,508,2,238,0.0,172.0,119.0,2,270,0.0,135.0,135.0
7147.0,17,4,438,2,148,0.0,74.0,74.0,2,290,0.0,147.0,145.0
2306.0,17,4,344,2,150,0.0,75.0,75.0,2,194,0.0,103.0,97.0
321468.0,17,4,1400,4,1400,107156.0,350.0,350.0,0,0,0.0,0.0,0.0
39935.0,6,14,4740,7,653,5093.166666666667,249.0,93.28571428571428,7,4087,6334.833333333333,1514.0,583.8571428571429
148678.0,17,2,414,1,88,0.0,88.0,88.0,1,326,0.0,326.0,326.0
302464.0,6,2,132,1,66,0.0,66.0,66.0,1,66,0.0,66.0,66.0
864878.0,6,9,1268,6,797,172975.6,459.0,132.83333333333334,3,471,294624.5,331.0,157.0
100524242.0,6,33,2428,17,1288,6282765.125,139.0,75.76470588235294,16,1140,6687185.8,123.0,71.25
325851.0,6,6,412,4,272,108617.0,74.0,68.0,2,140,0.0,74.0,70.0
233810.0,6,3,337,2,214,0.0,160.0,107.0,1,123,0.0,123.0,123.0
17599.0,6,14,4740,7,653,2547.333333333333,249.0,93.28571428571428,7,4087,2798.833333333333,1514.0,583.8571428571429
120048925.0,17,28,13364,28,13364,4446256.481481481,501.0,477.2857142857143,0,0,0.0,0.0,0.0
197298.0,17,2,180,1,90,0.0,90.0,90.0,1,90,0.0,90.0,90.0
38771.0,6,14,4740,7,653,6303.166666666667,249.0,93.28571428571428,7,4087,5264.166666666667,1514.0,583.8571428571429
10220708.0,6,5,351,3,231,5110354.0,123.0,77.0,2,120,0.0,60.0,60.0
117808619.0,17,15,1169,8,606,16714998.42857143,174.0,75.75,7,563,16333529.833333334,174.0,80.42857142857143
43021.0,6,10,2032,5,524,10525.25,252.0,104.8,5,1508,8997.5,1236.0,301.6
30136.0,6,14,4740,7,653,3808.6666666666665,249.0,93.28571428571428,7,4087,4878.0,1514.0,583.8571428571429
32603.0,6,10,2032,5,524,7838.5,252.0,104.8,5,1508,6387.25,1236.0,301.6
1175456.0,6,13,3000,8,2372,167922.2857142857,1514.0,296.5,5,628,224953.5,331.0,125.6
861003.0,6,9,1269,6,798,172200.6,460.0,133.0,3,471,292725.0,331.0,157.0
119858038.0,6,16,2234,7,1152,19975769.33333333,204.0,164.57142857142858,9,1082,14982105.5,188.0,120.22222222222224
28067.0,6,14,4740,7,653,4569.166666666667,249.0,93.28571428571428,7,4087,4397.166666666667,1514.0,583.8571428571429
3599.0,17,2,414,1,88,0.0,88.0,88.0,1,326,0.0,326.0,326.0
335.0,17,2,166,1,75,0.0,75.0,75.0,1,91,0.0,91.0,91.0
284562.0,17,2,363,1,79,0.0,79.0,79.0,1,284,0.0,284.0,284.0
120251929.0,6,18,1341,9,691,14999891.125,95.0,76.77777777777777,9,650,14999997.625,95.0,72.22222222222223
42078.0,6,14,4740,7,653,6863.833333333333,249.0,93.28571428571428,7,4087,5732.166666666667,1514.0,583.8571428571429
90743110.0,6,24,1829,13,989,7558123.75,95.0,76.07692307692308,11,840,8998138.9,95.0,76.36363636363636
154064.0,17,2,180,1,90,0.0,90.0,90.0,1,90,0.0,90.0,90.0
13700439.0,17,6,2052,6,2052,2740087.8,342.0,342.0,0,0,0.0,0.0,0.0
109366.0,17,2,286,2,286,0.0,143.0,143.0,0,0,0.0,0.0,0.0
0.0,17,1,179,1,179,0.0,179.0,179.0,0,0,0.0,0.0,0.0
21577.0,6,13,1459,7,862,3334.0,271.0,123.14285714285714,6,597,4003.2,259.0,99.5
598866.0,17,2,397,1,75,0.0,75.0,75.0,1,322,0.0,322.0,322.0
712.0,17,4,438,2,148,0.0,74.0,74.0,2,290,0.0,147.0,145.0
116301099.0,6,48,3168,24,1584,5056569.521739131,66.0,66.0,24,1584,5044594.391304348,66.0,66.0
78292.0,6,10,2032,5,524,17830.75,252.0,104.8,5,1508,14530.25,1236.0,301.6
120082493.0,17,28,13364,28,13364,4447499.740740741,501.0,477.2857142857143,0,0,0.0,0.0,0.0
228245.0,17,2,180,1,90,0.0,90.0,90.0,1,90,0.0,90.0,90.0
116666971.0,6,48,3168,24,1584,5072477.0,66.0,66.0,24,1584,5060501.652173913,66.0,66.0
6600.0,17,2,582,1,83,0.0,83.0,83.0,1,499,0.0,499.0,499.0
232704.0,6,3,337,2,214,0.0,160.0,107.0,1,123,0.0,123.0,123.0
303623.0,6,2,132,1,66,0.0,66.0,66.0,1,66,0.0,66.0,66.0
400.0,17,2,174,1,79,0.0,79.0,79.0,1,95,0.0,95.0,95.0
199835.0,17,2,762,2,762,0.0,381.0,381.0,0,0,0.0,0.0,0.0
40885.0,6,14,4740,7,653,6695.333333333333,249.0,93.28571428571428,7,4087,6673.0,1514.0,583.8571428571429
44366.0,6,10,2032,5,524,10843.5,252.0,104.8,5,1508,9872.25,1236.0,301.6
10458329.0,6,7,478,4,272,3439432.0,74.0,68.0,3,206,5159028.0,74.0,68.66666666666667
2104239.0,6,19,6869,11,1567,210423.9,408.0,142.45454545454547,8,5302,239059.7142857143,1514.0,662.75
38909.0,6,14,4740,7,653,6374.333333333333,249.0,93.28571428571428,7,4087,6231.833333333333,1514.0,583.8571428571429
74553599.0,6,9,842,9,842,9319199.875,97.0,93.55555555555556,0,0,0.0,0.0,0.0
107400.0,17,2,286,2,286,0.0,143.0,143.0,0,0,0.0,0.0,0.0
5624657.0,6,4,270,2,134,0.0,68.0,67.0,2,136,0.0,70.0,68.0
14669050.0,6,20,1648,10,1016,1595027.5555555555,315.0,101.6,10,632,1595004.3333333333,78.0,63.2
119616264.0,6,48,3168,24,1584,5200707.130434782,66.0,66.0,24,1584,5191321.913043479,66.0,66.0
282688.0,17,2,180,1,90,0.0,90.0,90.0,1,90,0.0,90.0,90.0
1023923.0,6,11,1134,6,558,204784.6,220.0,93.0,5,576,254867.0,304.0,115.2
228411.0,17,2,180,1,90,0.0,90.0,90.0,1,90,0.0,90.0,90.0
120040812.0,17,29,13785,29,13785,4287171.857142857,501.0,475.3448275862069,0,0,0.0,0.0,0.0
153421.0,17,2,180,1,90,0.0,90.0,90.0,1,90,0.0,90.0,90.0
813.0,17,4,438,2,148,0.0,74.0,74.0,2,290,0.0,147.0,145.0
2797044.0,6,2,132,1,66,0.0,66.0,66.0,1,66,0.0,66.0,66.0
135133762.0,17,6,1206,6,1206,27026752.4,201.0,201.0,0,0,0.0,0.0,0.0
244774.0,6,3,337,2,214,0.0,160.0,107.0,1,123,0.0,123.0,123.0
103190.0,17,2,286,2,286,0.0,143.0,143.0,0,0,0.0,0.0,0.0
90008659.0,17,27,12943,27,12943,3461871.5,501.0,479.3703703703704,0,0,0.0,0.0,0.0
33465.0,6,14,4740,7,653,5155.166666666667,249.0,93.28571428571428,7,4087,4963.5,1514.0,583.8571428571429
26520.0,6,10,1913,5,461,5769.75,233.0,92.2,5,1452,6061.25,1224.0,290.4
770.0,17,4,438,2,148,0.0,74.0,74.0,2,290,0.0,147.0,145.0
322.0,17,2,174,1,79,0.0,79.0,79.0,1,95,0.0,95.0,95.0
171632.0,17,2,414,1,88,0.0,88.0,88.0,1,326,0.0,326.0,326.0
29924.0,6,14,4740,7,653,4866.0,249.0,93.28571428571428,7,4087,4451.5,1514.0,583.8571428571429
108117072.0,17,5,1005,5,1005,27029268.0,201.0,201.0,0,0,0.0,0.0,0.0
135136846.0,17,6,1206,6,1206,27027369.2,201.0,201.0,0,0,0.0,0.0,0.0
9374.0,6,10,1067,5,536,2177.75,264.0,107.2,5,531,2132.75,259.0,106.2
120008793.0,6,17,1246,9,650,15001099.125,95.0,72.22222222222223,8,596,17107325.285714287,95.0,74.5
78.0,17,2,762,2,762,0.0,381.0,381.0,0,0,0.0,0.0,0.0
10498639.0,6,7,478,4,272,3453913.333333333,74.0,68.0,3,206,5180746.5,74.0,68.66666666666667
324294.0,17,4,1400,4,1400,108098.0,350.0,350.0,0,0,0.0,0.0,0.0
205799.0,17,2,180,1,90,0.0,90.0,90.0,1,90,0.0,90.0,90.0
102007293.0,17,13,821,7,432,17001215.5,174.0,61.71428571428572,6,389,16400149.6,174.0,64.83333333333333
13584.0,6,11,1132,6,556,2516.0,218.0,92.66666666666669,5,576,2739.0,304.0,115.2
102000994.0,17,13,821,7,432,17000165.666666668,174.0,61.71428571428572,6,389,16400946.6,174.0,64.83333333333333
115116701.0,17,14,1126,7,563,19129960.0,174.0,80.42857142857143,7,563,19159433.166666668,174.0,80.42857142857143
149767840.0,17,36,17126,36,17126,4279081.142857143,501.0,475.72222222222223,0,0,0.0,0.0,0.0
605.0,17,2,762,2,762,0.0,381.0,381.0,0,0,0.0,0.0,0.0
37978.0,6,14,4740,7,653,6096.666666666667,249.0,93.28571428571428,7,4087,6019.666666666667,1514.0,583.8571428571429
23736.0,6,10,2032,5,524,3884.5,252.0,104.8,5,1508,5044.75,1236.0,301.6
20487.0,6,11,1133,6,602,4097.4,264.0,100.33333333333331,5,531,3646.5,259.0,106.2
316769.0,6,6,412,4,272,105589.66666666669,74.0,68.0,2,140,0.0,74.0,70.0
120011978.0,6,21,1745,11,1041,11999992.2,255.0,94.63636363636364,10,704,13330822.333333334,95.0,70.4
19507.0,6,10,2032,5,524,3578.5,252.0,104.8,5,1508,4227.75,1236.0,301.6
48520.0,6,10,2032,5,524,10047.75,252.0,104.8,5,1508,11655.5,1236.0,301.6
342.0,17,2,250,1,93,0.0,93.0,93.0,1,157,0.0,157.0,157.0
153442.0,17,2,180,1,90,0.0,90.0,90.0,1,90,0.0,90.0,90.0
2797818.0,6,2,132,1,66,0.0,66.0,66.0,1,66,0.0,66.0,66.0
0.0,6,1,66,1,66,0.0,66.0,66.0,0,0,0.0,0.0,0.0
90035564.0,17,28,13364,28,13364,3334650.5185185187,501.0,477.2857142857143,0,0,0.0,0.0,0.0
90303116.0,6,16,1192,8,596,12892947.0,95.0,74.5,8,596,12899487.42857143,95.0,74.5
2153847.0,17,6,1230,3,234,1076734.0,78.0,78.0,3,996,1076734.0,332.0,332.0
36432.0,6,14,4740,7,653,5589.833333333333,249.0,93.28571428571428,7,4087,5804.833333333333,1514.0,583.8571428571429
102123345.0,17,14,1126,7,563,16993928.666666668,174.0,80.42857142857143,7,563,16993933.166666668,174.0,80.42857142857143
534554.0,6,2,145,2,145,0.0,91.0,72.5,0,0,0.0,0.0,0.0
209470.0,17,2,762,2,762,0.0,381.0,381.0,0,0,0.0,0.0,0.0
115355080.0,6,33,2280,17,1209,7196194.6875,123.0,71.11764705882354,16,1071,7675941.933333334,123.0,66.9375
311888.0,6,3,202,2,128,0.0,74.0,64.0,1,74,0.0,74.0,74.0
75776.0,6,14,4740,7,653,12505.666666666666,249.0,93.28571428571428,7,4087,12396.833333333334,1514.0,583.8571428571429
108103139.0,17,5,955,5,955,27025784.75,191.0,191.0,0,0,0.0,0.0,0.0
1417159.0,6,4,276,2,128,0.0,74.0,64.0,2,148,0.0,74.0,74.0
67772.0,6,10,2032,5,524,16708.5,252.0,104.8,5,1508,16378.0,1236.0,301.6
109475.0,17,2,286,2,286,0.0,143.0,143.0,0,0,0.0,0.0,0.0
90769631.0,6,19,1436,10,745,10080940.666666666,95.0,74.5,9,691,11343697.0,95.0,76.77777777777777
103159.0,17,2,286,2,286,0.0,143.0,143.0,0,0,0.0,0.0,0.0
339156.0,6,6,412,4,272,113052.0,74.0,68.0,2,140,0.0,74.0,70.0
118554706.0,6,33,2296,17,1225,7396189.125,139.0,72.05882352941177,16,1071,7889265.6,123.0,66.9375
2480.0,17,4,344,2,150,0.0,75.0,75.0,2,194,0.0,103.0,97.0
98369.0,17,2,762,2,762,0.0,381.0,381.0,0,0,0.0,0.0,0.0
12611.0,6,10,2032,5,524,2990.0,252.0,104.8,5,1508,2584.25,1236.0,301.6
119313989.0,6,21,1585,10,745,13257109.888888888,95.0,74.5,11,840,11906065.0,95.0,76.36363636363636
153497.0,17,2,180,1,90,0.0,90.0,90.0,1,90,0.0,90.0,90.0
125792036.0,6,31,2182,15,1017,8271860.0,123.0,67.8,16,1165,7720394.0,139.0,72.8125
90067278.0,17,28,13364,28,13364,3335825.111111111,501.0,477.2857142857143,0,0,0.0,0.0,0.0
0.0,17,1,90,1,90,0.0,90.0,90.0,0,0,0.0,0.0,0.0
125053.0,17,2,762,2,762,0.0,381.0,381.0,0,0,0.0,0.0,0.0
101990.0,17,2,700,2,700,0.0,350.0,350.0,0,0,0.0,0.0,0.0
317586.0,17,4,1400,4,1400,105862.0,350.0,350.0,0,0,0.0,0.0,0.0
3161390.0,6,18,1495,9,921,358131.25,315.0,102.33333333333331,9,574,358105.375,78.0,63.77777777777778
133285.0,6,2,132,1,66,0.0,66.0,66.0,1,66,0.0,66.0,66.0
2589136.0,6,25,7573,14,3735,199164.3076923077,1514.0,266.7857142857143,11,3838,233883.0,1514.0,348.90909090909093
91266.0,6,14,4740,7,653,14991.333333333334,249.0,93.28571428571428,7,4087,15003.833333333334,1514.0,583.8571428571429
44273.0,6,14,4740,7,653,6346.833333333333,249.0,93.28571428571428,7,4087,7243.333333333333,1514.0,583.8571428571429
99762380.0,17,16,5480,15,5130,5717322.642857143,342.0,342.0,1,350,0.0,350.0,350.0
86.0,17,2,762,2,762,0.0,381.0,381.0,0,0,0.0,0.0,0.0
301708.0,6,6,412,4,272,100569.33333333331,74.0,68.0,2,140,0.0,74.0,70.0
90762666.0,6,22,1680,12,894,8247274.545454546,95.0,74.5,10,786,10084105.888888888,95.0,78.6
0.0,17,1,55,1,55,0.0,55.0,55.0,0,0,0.0,0.0,0.0
102389084.0,6,183,20980,91,14612,1135265.611111111,390.0,160.57142857142858,92,6368,1122788.802197802,140.0,69.21739130434783
3193215.0,17,3,1026,3,1026,1596607.5,342.0,342.0,0,0,0.0,0.0,0.0
92180265.0,17,15,5130,15,5130,6584304.642857143,342.0,342.0,0,0,0.0,0.0,0.0
117664127.0,17,14,864,7,432,19500160.0,174.0,61.71428571428572,7,432,19501051.666666668,174.0,61.71428571428572
2427.0,17,4,344,2,150,0.0,75.0,75.0,2,194,0.0,103.0,97.0
1306915.0,6,4,264,2,132,0.0,66.0,66.0,2,132,0.0,66.0,66.0
5620800.0,6,5,336,2,134,0.0,68.0,67.0,3,202,1523404.5,70.0,67.33333333333333
143896.0,17,2,180,1,90,0.0,90.0,90.0,1,90,0.0,90.0,90.0
284399.0,17,2,363,1,79,0.0,79.0,79.0,1,284,0.0,284.0,284.0
5620252.0,6,5,336,2,134,0.0,68.0,67.0,3,202,1420360.0,70.0,67.33333333333333
90295745.0,6,16,1192,8,596,12892484.857142856,95.0,74.5,8,596,12898706.714285716,95.0,74.5
315839.0,17,4,1400,4,1400,105279.66666666669,350.0,350.0,0,0,0.0,0.0,0.0
111194845.0,6,34,2350,17,1225,6936189.4375,139.0,72.05882352941177,17,1125,6936188.125,123.0,66.17647058823529
16330.999999999998,6,10,2032,5,524,3805.25,252.0,104.8,5,1508,3702.0,1236.0,301.6
2045880.0,17,5,961,3,234,1022748.0,78.0,78.0,2,727,0.0,395.0,363.5
108089360.0,17,5,1005,5,1005,27022340.0,201.0,201.0,0,0,0.0,0.0,0.0
34288.0,6,10,2032,5,524,8313.75,252.0,104.8,5,1508,8259.25,1236.0,301.6
197630.0,17,2,180,1,90,0.0,90.0,90.0,1,90,0.0,90.0,90.0
91967844.0,6,24,1829,13,989,7662373.333333333,95.0,76.07692307692308,11,840,9196177.4,95.0,76.36363636363636
2096.0,17,4,344,2,150,0.0,75.0,75.0,2,194,0.0,103.0,97.0
6524.0,17,2,447,1,84,0.0,84.0,84.0,1,363,0.0,363.0,363.0
107269.0,17,2,286,2,286,0.0,143.0,143.0,0,0,0.0,0.0,0.0
119958932.0,6,13,2036,8,1016,17136990.285714287,188.0,127.0,5,1020,15084469.25,204.0,204.0
120000333.0,6,17,1287,9,691,15000041.625,95.0,76.77777777777777,8,596,12897288.42857143,95.0,74.5
122530578.0,6,49,3234,25,1650,5105440.75,66.0,66.0,24,1584,4889736.434782608,66.0,66.0
190697.0,17,2,180,1,90,0.0,90.0,90.0,1,90,0.0,90.0,90.0
16199.000000000002,6,14,4740,7,653,2298.6666666666665,249.0,93.28571428571428,7,4087,2518.333333333333,1514.0,583.8571428571429
142064.0,6,2,132,1,66,0.0,66.0,66.0,1,66,0.0,66.0,66.0
308263.0,6,6,412,4,272,102754.33333333331,74.0,68.0,2,140,0.0,74.0,70.0
90053579.0,17,28,13364,28,13364,3335317.7407407407,501.0,477.2857142857143,0,0,0.0,0.0,0.0
120245456.0,6,220,24884,110,7482,1095738.7981651376,140.0,68.01818181818182,110,17402,1095628.4587155962,284.0,158.2
108120.0,17,2,286,2,286,0.0,143.0,143.0,0,0,0.0,0.0,0.0
90285348.0,6,16,1192,8,596,12891300.142857144,95.0,74.5,8,596,12897073.42857143,95.0,74.5
113733728.0,6,48,3168,24,1584,4940673.260869565,66.0,66.0,24,1584,4939937.347826087,66.0,66.0
315037.0,6,3,202,2,128,0.0,74.0,64.0,1,74,0.0,74.0,74.0
135130709.0,17,6,1206,6,1206,27026141.8,201.0,201.0,0,0,0.0,0.0,0.0
90016362.0,17,28,13364,28,13364,3333939.333333333,501.0,477.2857142857143,0,0,0.0,0.0,0.0
10476982.0,6,7,478,4,272,3446599.0,74.0,68.0,3,206,5169794.0,74.0,68.66666666666667
2347.0,17,4,344,2,150,0.0,75.0,75.0,2,194,0.0,103.0,97.0
508493.0,6,5,336,2,134,0.0,68.0,67.0,3,202,194806.0,70.0,67.33333333333333
111272.0,17,2,286,2,286,0.0,143.0,143.0,0,0,0.0,0.0,0.0
210065.0,6,10,1221,6,636,42013.0,298.0,106.0,4,585,68912.66666666667,379.0,146.25
104771.0,17,2,700,2,700,0.0,350.0,350.0,0,0,0.0,0.0,0.0
302.0,17,2,168,1,76,0.0,76.0,76.0,1,92,0.0,92.0,92.0
116461902.0,6,226,25614,113,17860,1037915.6607142856,300.0,158.05309734513276,113,7754,1037915.5178571428,140.0,68.61946902654867
115013717.0,6,48,3168,24,1584,5000596.391304348,66.0,66.0,24,1584,4986920.826086956,66.0,66.0
885762.0,6,9,1267,6,796,177152.4,458.0,132.66666666666666,3,471,304984.5,331.0,157.0
304519.0,6,12,1373,7,714,50753.16666666666,298.0,102.0,5,659,75471.5,379.0,131.8
99665.0,17,2,762,2,762,0.0,381.0,381.0,0,0,0.0,0.0,0.0
113855384.0,6,48,3168,24,1584,4950234.0869565215,66.0,66.0,24,1584,4938396.913043479,66.0,66.0
28122.0,6,14,4740,7,653,3767.0,249.0,93.28571428571428,7,4087,4540.666666666667,1514.0,583.8571428571429
410.0,17,2,410,1,78,0.0,78.0,78.0,1,332,0.0,332.0,332.0
316.0,17,2,168,1,76,0.0,76.0,76.0,1,92,0.0,92.0,92.0
120124151.0,6,13,2036,5,1020,30031037.75,204.0,204.0,8,1016,17136557.285714287,188.0,127.0
48113.0,6,10,2032,5,524,11677.0,252.0,104.8,5,1508,11659.5,1236.0,301.6
3590.0,17,4,344,2,150,0.0,75.0,75.0,2,194,0.0,103.0,97.0
9169.0,17,2,582,1,83,0.0,83.0,83.0,1,499,0.0,499.0,499.0
61247.0,6,14,4740,7,653,10046.166666666666,249.0,93.28571428571428,7,4087,9805.333333333334,1514.0,583.8571428571429
90786427.0,6,19,1436,10,745,10079520.222222222,95.0,74.5,9,691,11347774.75,95.0,76.77777777777777
219341.0,6,3,426,2,280,0.0,214.0,140.0,1,146,0.0,146.0,146.0
216277.0,17,2,180,1,90,0.0,90.0,90.0,1,90,0.0,90.0,90.0
302362.0,6,6,412,4,272,100787.33333333331,74.0,68.0,2,140,0.0,74.0,70.0
5833192.0,6,5,336,2,134,0.0,68.0,67.0,3,202,1522770.0,70.0,67.33333333333333
392375.0,6,3,1604,1,753,0.0,753.0,753.0,2,851,0.0,785.0,425.5
90094909.0,6,12,1848,5,1020,22522610.0,204.0,204.0,7,828,15015423.666666666,188.0,118.28571428571428
81.0,17,2,762,2,762,0.0,381.0,381.0,0,0,0.0,0.0,0.0
228419.0,17,2,180,1,90,0.0,90.0,90.0,1,90,0.0,90.0,90.0
18614.0,6,10,1067,5,536,4402.75,264.0,107.2,5,531,3343.75,259.0,106.2
95395977.0,6,26,1746,13,906,7932578.416666667,123.0,69.6923076923077,13,840,7932578.333333333,123.0,64.61538461538461
120145430.0,6,206,23314,103,7094,1169915.862745098,140.0,68.87378640776699,103,16220,1169894.431372549,284.0,157.4757281553398
2023991.0,17,4,525,2,150,0.0,75.0,75.0,2,375,0.0,284.0,187.5
200046.0,17,4,6056,4,6056,66682.0,1514.0,1514.0,0,0,0.0,0.0,0.0
116927900.0,6,48,3168,24,1584,5083821.739130435,66.0,66.0,24,1584,5070404.0,66.0,66.0
107203.0,17,2,286,2,286,0.0,143.0,143.0,0,0,0.0,0.0,0.0
108107997.0,17,5,955,5,955,27026999.25,191.0,191.0,0,0,0.0,0.0,0.0
103357616.0,6,44,2904,22,1452,4921791.238095238,66.0,66.0,22,1452,4908667.619047619,66.0,66.0
233184.0,6,3,337,2,214,0.0,160.0,107.0,1,123,0.0,123.0,123.0
2092.0,17,2,684,1,342,0.0,342.0,342.0,1,342,0.0,342.0,342.0
120086373.0,17,29,13785,29,13785,4288799.035714285,501.0,475.3448275862069,0,0,0.0,0.0,0.0
2297.0,17,4,344,2,150,0.0,75.0,75.0,2,194,0.0,103.0,97.0
49268.0,6,14,4740,7,653,7644.666666666667,249.0,93.28571428571428,7,4087,7580.0,1514.0,583.8571428571429
2592445.0,6,3,1604,1,753,0.0,753.0,753.0,2,851,0.0,785.0,425.5
90199138.0,6,20,1531,9,691,11243999.25,95.0,76.77777777777777,11,840,8998309.1,95.0,76.36363636363636
146089.0,6,3,337,2,214,0.0,160.0,107.0,1,123,0.0,123.0,123.0
106364.0,17,4,1400,4,1400,35454.666666666664,350.0,350.0,0,0,0.0,0.0,0.0
92113608.0,6,38,2508,19,1254,5105431.555555556,66.0,66.0,19,1254,5105429.5,66.0,66.0
36194.0,6,14,4740,7,653,5913.0,249.0,93.28571428571428,7,4087,5806.666666666667,1514.0,583.8571428571429
2803475.0,6,2,132,1,66,0.0,66.0,66.0,1,66,0.0,66.0,66.0
90531134.0,6,14,2240,8,1016,12933019.142857144,188.0,127.0,6,1224,18073895.6,204.0,204.0
116136359.0,17,13,821,7,432,19356059.83333333,174.0,61.71428571428572,6,389,19323606.4,174.0,64.83333333333333
135129203.0,17,6,1206,6,1206,27025840.6,201.0,201.0,0,0,0.0,0.0,0.0
107830073.0,6,28,1860,14,966,8278893.769230769,123.0,69.0,14,894,8278745.769230769,123.0,63.85714285714285
220657.0,6,4,504,3,358,110328.5,214.0,119.33333333333331,1,146,0.0,146.0,146.0
56895.0,6,14,4740,7,653,9206.833333333334,249.0,93.28571428571428,7,4087,8859.0,1514.0,583.8571428571429
120265559.0,6,218,24736,109,7490,1105908.8055555555,140.0,68.71559633027523,109,17246,1106077.6851851852,284.0,158.22018348623854
90029071.0,17,28,13364,28,13364,3334410.037037037,501.0,477.2857142857143,0,0,0.0,0.0,0.0
78595.0,6,14,4740,7,653,12943.166666666666,249.0,93.28571428571428,7,4087,11834.166666666666,1514.0,583.8571428571429
2355.0,17,4,344,2,150,0.0,75.0,75.0,2,194,0.0,103.0,97.0
93385967.0,6,40,2640,20,1320,4915050.894736842,66.0,66.0,20,1320,4898464.315789473,66.0,66.0
127808454.0,6,30,1974,15,948,8415927.714285715,123.0,63.2,15,1026,8415934.857142856,123.0,68.4
103326.0,17,2,286,2,286,0.0,143.0,143.0,0,0,0.0,0.0,0.0
5620380.0,6,5,336,2,134,0.0,68.0,67.0,3,202,1526736.5,70.0,67.33333333333333
114446543.0,6,48,3168,24,1584,4975936.652173913,66.0,66.0,24,1584,4963954.652173913,66.0,66.0
121104111.0,6,226,25534,113,7754,1065630.2857142857,140.0,68.61946902654867,113,17780,1073921.5892857143,284.0,157.34513274336285
53135.0,6,14,4740,7,653,8735.5,249.0,93.28571428571428,7,4087,8509.166666666666,1514.0,583.8571428571429
92180082.0,17,12,778,6,389,18404064.8,174.0,64.83333333333333,6,389,18298611.4,174.0,64.83333333333333
50466.0,6,12,1320,6,723,8756.0,253.0,120.5,6,597,8264.4,259.0,99.5
5403670.0,6,11,738,5,342,1349516.0,95.0,68.4,6,396,1078250.2,95.0,66.0
551.0,17,2,762,2,762,0.0,381.0,381.0,0,0,0.0,0.0,0.0
135127754.0,17,6,1206,6,1206,27025550.8,201.0,201.0,0,0,0.0,0.0,0.0
104742.0,17,2,762,2,762,0.0,381.0,381.0,0,0,0.0,0.0,0.0
329.0,17,2,166,1,75,0.0,75.0,75.0,1,91,0.0,91.0,91.0
120001205.0,17,15,907,8,475,17143029.285714287,174.0,59.375,7,432,16667997.833333334,174.0,61.71428571428572
305417.0,6,6,412,4,272,101805.66666666669,74.0,68.0,2,140,0.0,74.0,70.0
205919.0,6,3,426,2,280,0.0,214.0,140.0,1,146,0.0,146.0,146.0
209624.0,17,2,180,1,90,0.0,90.0,90.0,1,90,0.0,90.0,90.0
234045.0,6,10,1221,6,636,46809.0,298.0,106.0,4,585,76427.33333333333,379.0,146.25
135132906.0,17,6,1206,6,1206,27026581.2,201.0,201.0,0,0,0.0,0.0,0.0
102577871.0,6,44,2904,22,1452,4884660.523809524,66.0,66.0,22,1452,4874370.238095238,66.0,66.0
0.0,6,1,66,1,66,0.0,66.0,66.0,0,0,0.0,0.0,0.0
107516.0,17,2,286,2,286,0.0,143.0,143.0,0,0,0.0,0.0,0.0
153445.0,17,2,180,1,90,0.0,90.0,90.0,1,90,0.0,90.0,90.0
90025321.0,17,28,13364,28,13364,3334271.1481481483,501.0,477.2857142857143,0,0,0.0,0.0,0.0
120324583.0,6,236,26644,118,8084,1021501.2307692308,140.0,68.50847457627118,118,18560,1021528.188034188,284.0,157.28813559322035
2594101.0,6,2,132,1,66,0.0,66.0,66.0,1,66,0.0,66.0,66.0
205899.0,17,2,180,1,90,0.0,90.0,90.0,1,90,0.0,90.0,90.0
50566.0,6,10,2032,5,524,12146.25,252.0,104.8,5,1508,9658.0,1236.0,301.6
234177.0,6,3,337,2,214,0.0,160.0,107.0,1,123,0.0,123.0,123.0
24899.0,17,4,823,2,163,0.0,89.0,81.5,2,660,0.0,443.0,330.0
1302853.0,6,4,264,2,132,0.0,66.0,66.0,2,132,0.0,66.0,66.0
128905464.0,6,38,2716,20,1468,6784498.105263158,139.0,73.4,18,1248,6982599.470588235,123.0,69.33333333333333
306924.0,6,6,412,4,272,102308.0,74.0,68.0,2,140,0.0,74.0,70.0
385.0,17,2,166,1,75,0.0,75.0,75.0,1,91,0.0,91.0,91.0
9811.0,17,4,823,2,163,0.0,89.0,81.5,2,660,0.0,443.0,330.0
24489539.0,6,5,1736,2,819,0.0,753.0,409.5,3,917,12170739.5,785.0,305.6666666666667
146071.0,6,3,337,2,214,0.0,160.0,107.0,1,123,0.0,123.0,123.0
106787529.0,6,44,2904,22,1452,5085120.428571428,66.0,66.0,22,1452,5070593.0,66.0,66.0
260702.0,17,2,180,1,90,0.0,90.0,90.0,1,90,0.0,90.0,90.0
90303499.0,6,16,1192,8,596,12893597.57142857,95.0,74.5,8,596,12899394.42857143,95.0,74.5
29945.0,6,14,4740,7,653,4154.333333333333,249.0,93.28571428571428,7,4087,4717.833333333333,1514.0,583.8571428571429
120003724.0,6,25,1883,14,1043,9231055.692307692,95.0,74.5,11,840,8997130.4,95.0,76.36363636363636
100625505.0,17,13,821,7,432,16666808.333333334,174.0,61.71428571428572,6,389,20001537.2,174.0,64.83333333333333
1308617.0,6,4,264,2,132,0.0,66.0,66.0,2,132,0.0,66.0,66.0
206384.0,6,3,426,2,280,0.0,214.0,140.0,1,146,0.0,146.0,146.0
104526.0,17,2,286,2,286,0.0,143.0,143.0,0,0,0.0,0.0,0.0
50952.0,17,2,180,1,90,0.0,90.0,90.0,1,90,0.0,90.0,90.0
37351.0,6,14,4740,7,653,6096.0,249.0,93.28571428571428,7,4087,6079.666666666667,1514.0,583.8571428571429
218557.0,6,3,426,2,280,0.0,214.0,140.0,1,146,0.0,146.0,146.0
122008.0,6,3,373,2,238,0.0,172.0,119.0,1,135,0.0,135.0,135.0
2407.0,17,4,344,2,150,0.0,75.0,75.0,2,194,0.0,103.0,97.0
298057.0,6,6,412,4,272,99352.33333333331,74.0,68.0,2,140,0.0,74.0,70.0
1447900.0,6,7,499,4,301,423132.3333333333,103.0,75.25,3,198,716275.0,66.0,66.0
4221.0,17,2,598,1,72,0.0,72.0,72.0,1,526,0.0,526.0,526.0
120122947.0,6,14,2224,9,1204,15015368.375,188.0,133.77777777777777,5,1020,22523171.0,204.0,204.0
43570.0,6,4,301,2,169,0.0,103.0,84.5,2,132,0.0,66.0,66.0
44845.0,6,14,4740,7,653,7354.166666666667,249.0,93.28571428571428,7,4087,5758.166666666667,1514.0,583.8571428571429
1172070.0,6,13,3000,8,2372,167438.57142857142,1514.0,296.5,5,628,224111.25,331.0,125.6
24125.0,6,10,2032,5,524,5016.5,252.0,104.8,5,1508,5122.5,1236.0,301.6
54598.0,6,14,4740,7,653,8672.0,249.0,93.28571428571428,7,4087,8507.5,1514.0,583.8571428571429
2594263.0,6,2,132,1,66,0.0,66.0,66.0,1,66,0.0,66.0,66.0
134830.0,6,2,132,1,66,0.0,66.0,66.0,1,66,0.0,66.0,66.0
135126172.0,17,6,1146,6,1146,27025234.4,191.0,191.0,0,0,0.0,0.0,0.0
148387.0,17,2,414,1,88,0.0,88.0,88.0,1,326,0.0,326.0,326.0
47811687.0,6,8,1938,3,886,22502000.5,752.0,295.3333333333333,5,1052,11258799.0,784.0,210.4
120123826.0,6,15,2444,7,1428,20020637.666666668,204.0,204.0,8,1016,17098550.42857143,188.0,127.0
1097508.0,6,11,1134,6,558,219501.6,220.0,93.0,5,576,273733.5,304.0,115.2
92125521.0,17,16,5472,16,5472,6141701.4,342.0,342.0,0,0,0.0,0.0,0.0
92970347.0,17,15,5130,15,5130,6640739.071428572,342.0,342.0,0,0,0.0,0.0,0.0
15048386.0,6,5,370,5,370,3762096.5,74.0,74.0,0,0,0.0,0.0,0.0
90255625.0,6,12,1832,8,1016,12893660.714285716,188.0,127.0,4,816,30030390.33333333,204.0,204.0
3358863.0,6,7,923,4,753,1047646.6666666666,571.0,188.25,3,170,1571745.5,62.0,56.66666666666666
121462.0,6,3,337,2,214,0.0,160.0,107.0,1,123,0.0,123.0,123.0
12710.0,6,11,1132,6,556,2123.6,218.0,92.66666666666669,5,576,2880.75,304.0,115.2
90090248.0,6,12,1848,5,1020,22521616.0,204.0,204.0,7,828,15014687.0,188.0,118.28571428571428
306941.0,6,6,412,4,272,102313.66666666669,74.0,68.0,2,140,0.0,74.0,70.0
1302551.0,6,4,264,2,132,0.0,66.0,66.0,2,132,0.0,66.0,66.0
27383073.0,17,5,1710,5,1710,6845768.25,342.0,342.0,0,0,0.0,0.0,0.0
97145968.0,17,12,778,6,389,19397411.0,174.0,64.83333333333333,6,389,19337456.0,174.0,64.83333333333333
202599.0,17,4,6056,4,6056,67533.0,1514.0,1514.0,0,0,0.0,0.0,0.0
233906.0,6,3,337,2,214,0.0,160.0,107.0,1,123,0.0,123.0,123.0
300087.0,6,6,412,4,272,100029.0,74.0,68.0,2,140,0.0,74.0,70.0
122093730.0,17,15,1038,8,606,17441961.42857143,174.0,75.75,7,432,19505625.5,174.0,61.71428571428572
496216.0,6,5,336,2,134,0.0,68.0,67.0,3,202,192532.5,70.0,67.33333333333333
22307196.0,6,6,1981,4,1087,7435732.0,885.0,271.75,2,894,0.0,826.0,447.0
99193013.0,6,218,25572,109,18156,916461.5833333334,300.0,166.5688073394495,109,7416,916461.6018518518,140.0,68.03669724770643
1754.0,17,5,550,5,550,438.5,110.0,110.0,0,0,0.0,0.0,0.0
98074.0,17,2,762,2,762,0.0,381.0,381.0,0,0,0.0,0.0,0.0
228507.0,17,2,180,1,90,0.0,90.0,90.0,1,90,0.0,90.0,90.0
25740.0,6,14,4740,7,653,4141.166666666667,249.0,93.28571428571428,7,4087,3969.6666666666665,1514.0,583.8571428571429
131475.0,6,2,132,1,66,0.0,66.0,66.0,1,66,0.0,66.0,66.0
403.0,17,2,410,1,78,0.0,78.0,78.0,1,332,0.0,332.0,332.0
100601556.0,17,12,516,6,258,20004242.8,43.0,43.0,6,258,20000223.2,43.0,43.0
318738.0,17,4,1400,4,1400,106246.0,350.0,350.0,0,0,0.0,0.0,0.0
307958.0,6,6,412,4,272,102652.66666666669,74.0,68.0,2,140,0.0,74.0,70.0
241404.0,6,3,337,2,214,0.0,160.0,107.0,1,123,0.0,123.0,123.0
90265555.0,6,13,2036,8,1016,12895079.285714284,188.0,127.0,5,1020,22525416.75,204.0,204.0
2472.0,17,4,344,2,150,0.0,75.0,75.0,2,194,0.0,103.0,97.0
609369.0,17,2,397,1,75,0.0,75.0,75.0,1,322,0.0,322.0,322.0
25335852.0,17,4,1376,3,1026,1324470.0,342.0,342.0,1,350,0.0,350.0,350.0
83.0,17,2,762,2,762,0.0,381.0,381.0,0,0,0.0,0.0,0.0
90729953.0,6,183,20694,92,14466,997032.4505494506,284.0,157.2391304347826,91,6228,996447.4222222222,140.0,68.43956043956044
20954.0,17,2,539,1,86,0.0,86.0,86.0,1,453,0.0,453.0,453.0
882449.0,6,12,2710,7,743,147074.83333333334,339.0,106.14285714285714,5,1967,151739.25,1514.0,393.4
118000932.0,17,15,1169,8,606,16857276.0,174.0,75.75,7,563,16334105.166666666,174.0,80.42857142857143
315871.0,6,6,412,4,272,105290.33333333331,74.0,68.0,2,140,0.0,74.0,70.0
0.0,6,1,66,1,66,0.0,66.0,66.0,0,0,0.0,0.0,0.0
146175.0,6,3,337,2,214,0.0,160.0,107.0,1,123,0.0,123.0,123.0
120123825.0,6,17,2556,10,1392,13347091.666666666,188.0,139.2,7,1164,15016395.666666666,204.0,166.28571428571428
8790011.0,6,4,1843,2,892,0.0,826.0,446.0,2,951,0.0,885.0,475.5
120009086.0,6,24,1829,13,989,9999996.333333334,95.0,76.07692307692308,11,840,11999763.2,95.0,76.36363636363636
120060207.0,17,28,13364,28,13364,4446674.333333333,501.0,477.2857142857143,0,0,0.0,0.0,0.0
5635774.0,6,5,336,2,134,0.0,68.0,67.0,3,202,1520673.0,70.0,67.33333333333333
41389.0,6,10,2032,5,524,10144.0,252.0,104.8,5,1508,9695.5,1236.0,301.6
3281524.0,6,3,1604,1,753,0.0,753.0,753.0,2,851,0.0,785.0,425.5
3374360.0,6,18,1536,9,962,384034.875,315.0,106.88888888888889,9,574,384003.625,78.0,63.77777777777778
0.0,17,1,438,1,438,0.0,438.0,438.0,0,0,0.0,0.0,0.0
117888610.0,6,36,2596,18,1348,6934624.117647059,139.0,74.88888888888889,18,1248,6921887.0,123.0,69.33333333333333
121239324.0,6,32,2305,17,1288,7577457.75,139.0,75.76470588235294,15,1017,8095218.0,123.0,67.8
113373222.0,6,48,3168,24,1584,4929270.521739131,66.0,66.0,24,1584,4920345.956521739,66.0,66.0
103316.0,17,2,286,2,286,0.0,143.0,143.0,0,0,0.0,0.0,0.0
5004932.0,17,4,849,2,166,0.0,83.0,83.0,2,683,0.0,499.0,341.5
119317020.0,17,14,864,7,432,19834080.0,174.0,61.71428571428572,7,432,19833512.5,174.0,61.71428571428572
125801630.0,6,34,2334,17,1125,7238456.6875,123.0,66.17647058823529,17,1209,7663354.3125,123.0,71.11764705882354
48084.0,6,10,2032,5,524,11794.75,252.0,104.8,5,1508,11196.5,1236.0,301.6
323738.0,17,4,1400,4,1400,107912.66666666669,350.0,350.0,0,0,0.0,0.0,0.0
90293228.0,6,16,1192,8,596,12892601.57142857,95.0,74.5,8,596,12897114.57142857,95.0,74.5
313549.0,17,4,1400,4,1400,104516.33333333331,350.0,350.0,0,0,0.0,0.0,0.0
73462.0,6,14,4740,7,653,12062.0,249.0,93.28571428571428,7,4087,12051.333333333334,1514.0,583.8571428571429
37609.0,6,14,4740,7,653,6144.833333333333,249.0,93.28571428571428,7,4087,6132.166666666667,1514.0,583.8571428571429
301936.0,6,6,412,4,272,100645.33333333331,74.0,68.0,2,140,0.0,74.0,70.0
278155.0,6,10,1221,6,636,55631.0,298.0,106.0,4,585,86959.0,379.0,146.25
135133542.0,17,6,1206,6,1206,27026708.4,201.0,201.0,0,0,0.0,0.0,0.0
14415.0,6,11,2098,6,590,2264.0,252.0,98.33333333333331,5,1508,3321.75,1236.0,301.6
3501.0,17,2,414,1,88,0.0,88.0,88.0,1,326,0.0,326.0,326.0
125001124.0,17,15,907,8,475,17857303.42857143,174.0,59.375,7,432,17500958.5,174.0,61.71428571428572
40661.0,6,14,4740,7,653,6615.333333333333,249.0,93.28571428571428,7,4087,6632.833333333333,1514.0,583.8571428571429
53678.0,6,14,4740,7,653,8820.833333333334,249.0,93.28571428571428,7,4087,7813.833333333333,1514.0,583.8571428571429
4534.0,17,2,614,1,72,0.0,72.0,72.0,1,542,0.0,542.0,542.0
153512.0,17,2,180,1,90,0.0,90.0,90.0,1,90,0.0,90.0,90.0
211301.0,17,2,180,1,90,0.0,90.0,90.0,1,90,0.0,90.0,90.0
39788.0,6,10,2032,5,524,9403.75,252.0,104.8,5,1508,9599.0,1236.0,301.6
107682.0,17,2,286,2,286,0.0,143.0,143.0,0,0,0.0,0.0,0.0
2295.0,17,4,344,2,150,0.0,75.0,75.0,2,194,0.0,103.0,97.0
27211.0,6,10,2032,5,524,4687.25,252.0,104.8,5,1508,6060.0,1236.0,301.6
52048.0,6,14,4740,7,653,8138.666666666667,249.0,93.28571428571428,7,4087,8051.666666666667,1514.0,583.8571428571429
120123631.0,6,14,2224,9,1204,15015453.875,188.0,133.77777777777777,5,1020,22590677.25,204.0,204.0
31091.0,6,14,4740,7,653,4666.0,249.0,93.28571428571428,7,4087,4255.333333333333,1514.0,583.8571428571429
4412.0,17,2,614,1,72,0.0,72.0,72.0,1,542,0.0,542.0,542.0
78793.0,6,12,1328,7,797,13132.166666666666,253.0,113.85714285714286,5,531,16756.25,259.0,106.2
45969.0,6,14,4740,7,653,7542.5,249.0,93.28571428571428,7,4087,7315.5,1514.0,583.8571428571429
103521.0,17,2,286,2,286,0.0,143.0,143.0,0,0,0.0,0.0,0.0
90008615.0,17,28,13364,28,13364,3333652.407407407,501.0,477.2857142857143,0,0,0.0,0.0,0.0
123349166.0,17,14,1126,7,563,17334131.666666668,174.0,80.42857142857143,7,563,17333530.166666668,174.0,80.42857142857143
146473.0,6,3,337,2,214,0.0,160.0,107.0,1,123,0.0,123.0,123.0
365.0,17,2,267,1,83,0.0,83.0,83.0,1,184,0.0,184.0,184.0
120098080.0,6,212,23980,106,7292,1136630.9619047618,140.0,68.79245283018868,106,16688,1135959.2476190475,284.0,157.43396226415095
107000978.0,17,13,821,7,432,17833496.333333332,174.0,61.71428571428572,6,389,17401065.4,174.0,64.83333333333333
394.0,17,2,164,1,82,0.0,82.0,82.0,1,82,0.0,82.0,82.0
1180317.0,6,13,3020,8,2392,168616.7142857143,1514.0,299.0,5,628,226181.0,331.0,125.6
341.0,17,2,250,1,93,0.0,93.0,93.0,1,157,0.0,157.0,157.0
144541.0,17,2,180,1,90,0.0,90.0,90.0,1,90,0.0,90.0,90.0
307005.0,17,4,1400,4,1400,102335.0,350.0,350.0,0,0,0.0,0.0,0.0
217514.0,6,3,426,2,280,0.0,214.0,140.0,1,146,0.0,146.0,146.0
82.0,17,2,762,2,762,0.0,381.0,381.0,0,0,0.0,0.0,0.0
120068286.0,17,28,13364,28,13364,4446973.555555556,501.0,477.2857142857143,0,0,0.0,0.0,0.0
90261638.0,6,13,2036,8,1016,12894519.714285716,188.0,127.0,5,1020,22524161.5,204.0,204.0
26837.0,6,14,4740,7,653,3955.1666666666665,249.0,93.28571428571428,7,4087,4335.333333333333,1514.0,583.8571428571429
360.0,17,2,267,1,83,0.0,83.0,83.0,1,184,0.0,184.0,184.0
92016053.0,6,37,2442,19,1254,5112002.944444444,66.0,66.0,18,1188,5148451.235294118,66.0,66.0
208971.0,17,2,180,1,90,0.0,90.0,90.0,1,90,0.0,90.0,90.0
25463.0,6,11,1132,6,556,4785.6,218.0,92.66666666666669,5,576,5487.5,304.0,115.2
22488.0,17,2,582,1,83,0.0,83.0,83.0,1,499,0.0,499.0,499.0
1993.0,17,4,344,2,150,0.0,75.0,75.0,2,194,0.0,103.0,97.0
40158.0,6,10,2032,5,524,9811.0,252.0,104.8,5,1508,5313.0,1236.0,301.6
1892.0,17,4,344,2,150,0.0,75.0,75.0,2,194,0.0,103.0,97.0
28145.0,6,14,4740,7,653,4261.0,249.0,93.28571428571428,7,4087,4549.5,1514.0,583.8571428571429
25815.0,6,14,4740,7,653,3945.8333333333335,249.0,93.28571428571428,7,4087,4164.333333333333,1514.0,583.8571428571429
20053.0,6,14,4740,7,653,3143.5,249.0,93.28571428571428,7,4087,3129.333333333333,1514.0,583.8571428571429
213663.0,6,3,426,2,280,0.0,214.0,140.0,1,146,0.0,146.0,146.0
2413.0,17,4,344,2,150,0.0,75.0,75.0,2,194,0.0,103.0,97.0
298076.0,6,6,412,4,272,99358.66666666669,74.0,68.0,2,140,0.0,74.0,70.0
2502.0,17,4,344,2,150,0.0,75.0,75.0,2,194,0.0,103.0,97.0
98203199.0,6,198,22584,99,15828,999872.0918367348,284.0,159.87878787878788,99,6756,999877.0714285716,140.0,68.24242424242425
251548.0,17,4,1524,4,1524,83849.33333333333,381.0,381.0,0,0,0.0,0.0,0.0
143994.0,17,2,180,1,90,0.0,90.0,90.0,1,90,0.0,90.0,90.0
178295.0,17,2,180,1,90,0.0,90.0,90.0,1,90,0.0,90.0,90.0
2398.0,17,2,762,2,762,0.0,381.0,381.0,0,0,0.0,0.0,0.0
107846223.0,6,28,1860,14,966,8279264.076923077,123.0,69.0,14,894,8279263.615384615,123.0,63.85714285714285
10449570.0,6,7,478,4,272,3437929.0,74.0,68.0,3,206,5156821.5,74.0,68.66666666666667
186606.0,6,10,1066,5,490,44697.0,218.0,98.0,5,576,46277.25,304.0,115.2
3263.0,17,2,359,1,75,0.0,75.0,75.0,1,284,0.0,284.0,284.0
120283594.0,6,212,23868,106,7292,1137709.5047619047,140.0,68.79245283018868,106,16576,1137727.1047619048,284.0,156.37735849056602
153495.0,17,2,180,1,90,0.0,90.0,90.0,1,90,0.0,90.0,90.0
120192.0,17,2,180,1,70,0.0,70.0,70.0,1,110,0.0,110.0,110.0
750.0,17,2,762,2,762,0.0,381.0,381.0,0,0,0.0,0.0,0.0
108106342.0,17,5,1005,5,1005,27026585.5,201.0,201.0,0,0,0.0,0.0,0.0
219289.0,17,2,180,1,90,0.0,90.0,90.0,1,90,0.0,90.0,90.0
44706.0,6,10,2032,5,524,10955.75,252.0,104.8,5,1508,10161.25,1236.0,301.6
9749.0,6,10,1067,5,536,2204.25,264.0,107.2,5,531,2247.0,259.0,106.2
2972626.0,6,11,2106,6,598,594356.8,252.0,99.66666666666669,5,1508,1856.75,1236.0,301.6
110115377.0,6,28,1876,14,982,8454692.692307692,139.0,70.14285714285714,14,894,8454683.923076924,123.0,63.85714285714285
298474.0,6,6,412,4,272,99491.33333333331,74.0,68.0,2,140,0.0,74.0,70.0
96504.0,17,2,286,2,286,0.0,143.0,143.0,0,0,0.0,0.0,0.0
120124025.0,6,18,2776,9,1572,15015503.125,204.0,174.66666666666666,9,1204,14961920.0,188.0,133.77777777777777
307745.0,6,6,412,4,272,102581.66666666669,74.0,68.0,2,140,0.0,74.0,70.0
120000195.0,6,26,2019,15,1179,8571442.5,95.0,78.6,11,840,9049058.1,95.0,76.36363636363636
429808.0,6,3,1604,1,753,0.0,753.0,753.0,2,851,0.0,785.0,425.5
3006721.0,6,12,2172,7,664,500963.6666666667,252.0,94.85714285714286,5,1508,2109.75,1236.0,301.6
90030122.0,17,28,13364,28,13364,3334448.962962963,501.0,477.2857142857143,0,0,0.0,0.0,0.0
219881.0,17,2,180,1,90,0.0,90.0,90.0,1,90,0.0,90.0,90.0
504743.00000000006,6,4,270,2,134,0.0,68.0,67.0,2,136,0.0,70.0,68.0
2375.0,17,4,344,2,150,0.0,75.0,75.0,2,194,0.0,103.0,97.0
90039871.0,17,28,13364,28,13364,3334810.037037037,501.0,477.2857142857143,0,0,0.0,0.0,0.0
121869.0,6,3,373,2,238,0.0,172.0,119.0,1,135,0.0,135.0,135.0
153433.0,17,2,180,1,90,0.0,90.0,90.0,1,90,0.0,90.0,90.0
59537.0,6,2,132,1,66,0.0,66.0,66.0,1,66,0.0,66.0,66.0
108106968.0,17,5,1005,5,1005,27026742.0,201.0,201.0,0,0,0.0,0.0,0.0
107666.0,17,2,286,2,286,0.0,143.0,143.0,0,0,0.0,0.0,0.0
433.0,17,2,267,1,83,0.0,83.0,83.0,1,184,0.0,184.0,184.0
21353.0,6,10,2032,5,524,4994.5,252.0,104.8,5,1508,4939.5,1236.0,301.6
2282.0,17,4,344,2,150,0.0,75.0,75.0,2,194,0.0,103.0,97.0
14635305.0,6,20,1607,10,975,1592404.3333333333,315.0,97.5,10,632,1592469.888888889,78.0,63.2
90299050.0,6,16,2140,8,1080,12899864.285714284,204.0,135.0,8,1060,12871357.714285716,199.0,132.5
216407.0,6,3,426,2,280,0.0,214.0,140.0,1,146,0.0,146.0,146.0
178458.0,6,3,337,2,214,0.0,160.0,107.0,1,123,0.0,123.0,123.0
949.0,17,5,550,5,550,237.25,110.0,110.0,0,0,0.0,0.0,0.0
30085.0,6,10,2032,5,524,6313.0,252.0,104.8,5,1508,7248.5,1236.0,301.6
250291.0,6,3,337,2,214,0.0,160.0,107.0,1,123,0.0,123.0,123.0
10517847.0,6,7,478,4,272,3458648.333333333,74.0,68.0,3,206,5187885.0,74.0,68.66666666666667
600011.0,17,2,346,1,78,0.0,78.0,78.0,1,268,0.0,268.0,268.0
14958585.0,17,6,2718,6,2718,2991717.0,453.0,453.0,0,0,0.0,0.0,0.0
2534332.0,6,28,9195,16,3843,168955.46666666667,1514.0,240.1875,12,5352,206150.8181818181,1514.0,446.0
2924342.0,6,3,204,2,136,0.0,70.0,68.0,1,68,0.0,68.0,68.0
160081.0,6,3,337,2,214,0.0,160.0,107.0,1,123,0.0,123.0,123.0
39819.0,6,10,2032,5,524,9372.0,252.0,104.8,5,1508,7911.0,1236.0,301.6
206743.0,6,10,1221,6,636,41348.6,298.0,106.0,4,585,68069.66666666667,379.0,146.25
216438.0,17,2,180,1,90,0.0,90.0,90.0,1,90,0.0,90.0,90.0
3234891.0,6,5,336,2,134,0.0,68.0,67.0,3,202,1526605.5,70.0,67.33333333333333
153517.0,17,2,180,1,90,0.0,90.0,90.0,1,90,0.0,90.0,90.0
2277.0,17,4,344,2,150,0.0,75.0,75.0,2,194,0.0,103.0,97.0
2368.0,17,4,344,2,150,0.0,75.0,75.0,2,194,0.0,103.0,97.0
7253.0,17,2,582,1,83,0.0,83.0,83.0,1,499,0.0,499.0,499.0
112701768.0,6,34,2350,17,1225,7030368.4375,139.0,72.05882352941177,17,1125,7030369.3125,123.0,66.17647058823529
114243540.0,6,753,135664,373,25062,307078.09139784944,214.0,67.19034852546918,380,110602,301381.4248021108,1514.0,291.0578947368421
313991.0,6,3,202,2,128,0.0,74.0,64.0,1,74,0.0,74.0,74.0
304565.0,6,6,412,4,272,101521.66666666669,74.0,68.0,2,140,0.0,74.0,70.0
52612.0,6,14,4740,7,653,7936.833333333333,249.0,93.28571428571428,7,4087,8591.833333333334,1514.0,583.8571428571429
16537.0,6,10,1065,5,534,3227.0,262.0,106.8,5,531,3931.5,259.0,106.2
102176582.0,6,29,2052,15,1089,7283725.5,123.0,72.6,14,963,7844020.230769231,123.0,68.78571428571429
144311.0,17,2,180,1,90,0.0,90.0,90.0,1,90,0.0,90.0,90.0
214374.0,17,2,180,1,90,0.0,90.0,90.0,1,90,0.0,90.0,90.0
233101.0,6,3,337,2,214,0.0,160.0,107.0,1,123,0.0,123.0,123.0
125787450.0,6,59,12292,29,6407,3431329.785714286,1514.0,220.93103448275863,30,5885,4330443.655172414,1514.0,196.16666666666663
216936.0,6,3,426,2,280,0.0,214.0,140.0,1,146,0.0,146.0,146.0
3005103.0,6,12,2172,7,664,500587.5,252.0,94.85714285714286,5,1508,2208.0,1236.0,301.6
2035637.0,17,20,7472,20,7472,107138.7894736842,390.0,373.6,0,0,0.0,0.0,0.0
37540.0,6,14,4740,7,653,5581.666666666667,249.0,93.28571428571428,7,4087,5522.333333333333,1514.0,583.8571428571429
18977.0,17,4,823,2,163,0.0,89.0,81.5,2,660,0.0,443.0,330.0
47175.0,6,14,4740,7,653,7335.5,249.0,93.28571428571428,7,4087,7288.0,1514.0,583.8571428571429
205992.0,17,2,762,2,762,0.0,381.0,381.0,0,0,0.0,0.0,0.0
46871.0,6,14,4740,7,653,7668.666666666667,249.0,93.28571428571428,7,4087,7402.666666666667,1514.0,583.8571428571429
2301.0,17,4,344,2,150,0.0,75.0,75.0,2,194,0.0,103.0,97.0
5627882.0,6,5,336,2,134,0.0,68.0,67.0,3,202,1425052.5,70.0,67.33333333333333
120383484.0,6,272,30746,136,9272,885639.2222222222,140.0,68.17647058823529,136,21474,891693.1703703704,284.0,157.89705882352942
143997.0,17,2,180,1,90,0.0,90.0,90.0,1,90,0.0,90.0,90.0
2599821.0,6,2,132,1,66,0.0,66.0,66.0,1,66,0.0,66.0,66.0
318.0,17,2,174,1,79,0.0,79.0,79.0,1,95,0.0,95.0,95.0
117576.0,6,2,132,1,66,0.0,66.0,66.0,1,66,0.0,66.0,66.0
148047.0,17,2,180,1,90,0.0,90.0,90.0,1,90,0.0,90.0,90.0
90103244.0,6,12,1848,5,1020,22525175.0,204.0,204.0,7,828,15016971.166666666,188.0,118.28571428571428
108107864.0,17,5,955,5,955,27026966.0,191.0,191.0,0,0,0.0,0.0,0.0
146554.0,6,3,337,2,214,0.0,160.0,107.0,1,123,0.0,123.0,123.0
32784.0,6,2,145,2,145,0.0,91.0,72.5,0,0,0.0,0.0,0.0
16785906.0,6,29,9249,16,3843,175131.93333333332,1514.0,240.1875,13,5406,1380814.8333333333,1514.0,415.84615384615387
77910.0,6,10,2032,5,524,18567.5,252.0,104.8,5,1508,14602.5,1236.0,301.6
2954571.0,6,5,336,2,134,0.0,68.0,67.0,3,202,194371.0,70.0,67.33333333333333
61967.0,6,14,4740,7,653,10171.166666666666,249.0,93.28571428571428,7,4087,9698.833333333334,1514.0,583.8571428571429
302368.0,6,6,412,4,272,100789.33333333331,74.0,68.0,2,140,0.0,74.0,70.0
216948.0,6,10,1221,6,636,43389.6,298.0,106.0,4,585,71402.33333333333,379.0,146.25
120124825.0,6,13,2020,9,1204,15015603.125,188.0,133.77777777777777,4,816,30020230.0,204.0,204.0
219078.0,6,10,1221,6,636,43815.6,298.0,106.0,4,585,72178.33333333333,379.0,146.25
1058054.0,6,11,1134,6,558,211610.8,220.0,93.0,5,576,263072.25,304.0,115.2
311086.0,17,4,1400,4,1400,103695.33333333331,350.0,350.0,0,0,0.0,0.0,0.0
10852680.0,6,7,478,3,206,5355340.5,74.0,68.66666666666667,4,272,3570144.6666666665,74.0,68.0
107329.0,6,15,4806,8,719,15002.857142857143,249.0,89.875,7,4087,17226.666666666668,1514.0,583.8571428571429
2387821.0,6,3,1777,1,826,0.0,826.0,826.0,2,951,0.0,885.0,475.5
1355534.0,6,4,492,2,280,0.0,214.0,140.0,2,212,0.0,146.0,106.0
102647.0,17,2,286,2,286,0.0,143.0,143.0,0,0,0.0,0.0,0.0
501989.0,6,4,270,2,134,0.0,68.0,67.0,2,136,0.0,70.0,68.0
232815.0,6,3,337,2,214,0.0,160.0,107.0,1,123,0.0,123.0,123.0
485.0,17,2,508,2,508,0.0,257.0,254.0,0,0,0.0,0.0,0.0
46759.0,6,14,4740,7,653,7624.666666666667,249.0,93.28571428571428,7,4087,7251.5,1514.0,583.8571428571429
2326.0,17,4,344,2,150,0.0,75.0,75.0,2,194,0.0,103.0,97.0
259882.0,6,10,1221,6,636,51976.4,298.0,106.0,4,585,80729.33333333333,379.0,146.25
37172.0,6,10,2032,5,524,8339.5,252.0,104.8,5,1508,6225.5,1236.0,301.6
116841559.0,6,31,2166,16,1149,7789437.266666667,123.0,71.8125,15,1017,7618012.857142857,123.0,67.8
135134788.0,17,6,1146,6,1146,27026957.6,191.0,191.0,0,0,0.0,0.0,0.0
135126958.0,17,6,1146,6,1146,27025391.6,191.0,191.0,0,0,0.0,0.0,0.0
1479740.0,17,16,1120,16,1120,98649.33333333331,70.0,70.0,0,0,0.0,0.0,0.0
55728.0,6,10,2032,5,524,13633.25,252.0,104.8,5,1508,13359.0,1236.0,301.6
108104607.0,17,5,955,5,955,27026151.75,191.0,191.0,0,0,0.0,0.0,0.0
90762482.0,6,219,24828,110,7482,832683.3211009174,140.0,68.01818181818182,109,17346,830924.675925926,300.0,159.13761467889907
2043.0,17,4,344,2,150,0.0,75.0,75.0,2,194,0.0,103.0,97.0
14563.0,6,10,1067,5,536,3476.75,264.0,107.2,5,531,3310.5,259.0,106.2
153500.0,17,2,180,1,90,0.0,90.0,90.0,1,90,0.0,90.0,90.0
39253.0,6,10,2032,5,524,7551.75,252.0,104.8,5,1508,9134.75,1236.0,301.6
1131406.0,6,20,6434,12,1921,102855.09090909093,620.0,160.08333333333334,8,4513,132788.2857142857,1514.0,564.125
15273153.0,6,5,1736,2,819,0.0,753.0,409.5,3,917,7568072.5,785.0,305.6666666666667
120295296.0,6,573,79026,287,59928,420612.9230769231,480.0,208.808362369338,286,19098,418446.7228070176,140.0,66.77622377622377
299541.0,6,6,412,4,272,99847.0,74.0,68.0,2,140,0.0,74.0,70.0
101013666.0,17,14,864,7,432,16833496.0,174.0,61.71428571428572,7,432,16834573.333333332,174.0,61.71428571428572
90311429.0,6,27,2073,15,1138,6446729.428571428,95.0,75.86666666666666,12,935,8184378.090909091,95.0,77.91666666666667
8572.0,17,4,823,2,163,0.0,89.0,81.5,2,660,0.0,443.0,330.0
3178354.0,6,18,1495,9,921,358153.25,315.0,102.33333333333331,9,574,358134.875,78.0,63.77777777777778
14346.0,6,14,4740,7,653,2277.5,249.0,93.28571428571428,7,4087,2229.0,1514.0,583.8571428571429
91359986.0,6,22,1680,12,935,8304402.363636363,95.0,77.91666666666667,10,745,10149647.333333334,95.0,74.5
812.0,17,4,438,2,148,0.0,74.0,74.0,2,290,0.0,147.0,145.0
315817.0,17,2,238,1,74,0.0,74.0,74.0,1,164,0.0,164.0,164.0
0.0,6,1,172,1,172,0.0,172.0,172.0,0,0,0.0,0.0,0.0
308879.0,6,7,478,4,272,102959.66666666669,74.0,68.0,3,206,79168.5,74.0,68.66666666666667
114728455.0,6,48,3168,24,1584,4988193.695652174,66.0,66.0,24,1584,4976217.217391305,66.0,66.0
121290307.0,6,248,27954,124,8480,970954.325203252,140.0,68.38709677419355,124,19474,979486.7479674796,284.0,157.0483870967742
2277455.0,6,50,23782,26,19851,91098.2,1514.0,763.5,24,3931,89760.69565217392,1514.0,163.79166666666666
34972.0,6,14,4740,7,653,4241.0,249.0,93.28571428571428,7,4087,5504.0,1514.0,583.8571428571429
789332.0,6,6,758,3,410,292029.5,172.0,136.66666666666666,3,348,279205.5,135.0,116.0
505473.0,6,5,336,2,134,0.0,68.0,67.0,3,202,192489.0,70.0,67.33333333333333
2118.0,17,4,344,2,150,0.0,75.0,75.0,2,194,0.0,103.0,97.0
2448849.0,6,3,204,2,136,0.0,70.0,68.0,1,68,0.0,68.0,68.0
405517.0,6,4,508,2,238,0.0,172.0,119.0,2,270,0.0,135.0,135.0
98854287.0,6,48,4068,26,2190,3954171.48,123.0,84.23076923076923,22,1878,4697047.761904762,123.0,85.36363636363636
1177257.0,6,13,3010,8,2382,168179.57142857142,1514.0,297.75,5,628,225388.25,331.0,125.6
209472.0,17,2,180,1,90,0.0,90.0,90.0,1,90,0.0,90.0,90.0
98417027.0,17,12,778,6,389,19601699.2,174.0,64.83333333333333,6,389,19600206.6,174.0,64.83333333333333
228217.0,17,2,180,1,90,0.0,90.0,90.0,1,90,0.0,90.0,90.0
90319010.0,6,24,1829,13,989,7521164.5,95.0,76.07692307692308,11,840,9001370.0,95.0,76.36363636363636
197140.0,17,2,180,1,90,0.0,90.0,90.0,1,90,0.0,90.0,90.0
2304.0,17,4,344,2,150,0.0,75.0,75.0,2,194,0.0,103.0,97.0
97756739.0,6,29,2052,15,1089,6967210.428571428,123.0,72.6,14,963,7503143.923076923,123.0,68.78571428571429
2261.0,17,4,344,2,150,0.0,75.0,75.0,2,194,0.0,103.0,97.0
45757.0,6,10,1066,5,490,8647.5,218.0,98.0,5,576,11018.25,304.0,115.2
147451.0,6,3,373,2,238,0.0,172.0,119.0,1,135,0.0,135.0,135.0
42101.0,6,14,4740,7,653,6897.833333333333,249.0,93.28571428571428,7,4087,6879.333333333333,1514.0,583.8571428571429
120014406.0,6,21,1585,11,840,11999996.5,95.0,76.36363636363636,10,745,13333968.222222222,95.0,74.5
233217.0,6,3,337,2,214,0.0,160.0,107.0,1,123,0.0,123.0,123.0
81864.0,6,15,4806,8,719,11285.57142857143,249.0,89.875,7,4087,13018.666666666666,1514.0,583.8571428571429
40100.0,6,13,1394,7,797,6067.333333333333,253.0,113.85714285714286,6,597,7114.8,259.0,99.5
91667555.0,6,19,1477,11,881,9161561.4,95.0,80.0909090909091,8,596,13029783.0,95.0,74.5
146334.0,6,3,337,2,214,0.0,160.0,107.0,1,123,0.0,123.0,123.0
119532246.0,17,34,16284,34,16284,3622189.272727273,501.0,478.9411764705882,0,0,0.0,0.0,0.0
110627091.0,17,15,1169,8,606,15714817.57142857,174.0,75.75,7,563,15166842.166666666,174.0,80.42857142857143
500.0,17,2,508,2,508,0.0,257.0,254.0,0,0,0.0,0.0,0.0
196863.0,17,2,180,1,90,0.0,90.0,90.0,1,90,0.0,90.0,90.0
35473.0,6,14,4740,7,653,5472.333333333333,249.0,93.28571428571428,7,4087,5221.0,1514.0,583.8571428571429
1950.0,17,2,192,1,88,0.0,88.0,88.0,1,104,0.0,104.0,104.0
90028292.0,17,28,13364,28,13364,3334381.185185185,501.0,477.2857142857143,0,0,0.0,0.0,0.0
383210.0,6,12,1373,7,714,63868.333333333336,298.0,102.0,5,659,95046.25,379.0,131.8
153451.0,17,2,180,1,90,0.0,90.0,90.0,1,90,0.0,90.0,90.0
9139.0,17,2,582,1,83,0.0,83.0,83.0,1,499,0.0,499.0,499.0
114004214.0,6,198,22314,99,6756,1155073.6734693877,140.0,68.24242424242425,99,15558,1155091.306122449,284.0,157.15151515151516
41527.0,6,13,1479,7,882,6921.166666666667,291.0,126.0,6,597,7414.6,259.0,99.5
164548.0,17,2,414,1,88,0.0,88.0,88.0,1,326,0.0,326.0,326.0
231968.0,6,3,337,2,214,0.0,160.0,107.0,1,123,0.0,123.0,123.0
228420.0,17,2,180,1,90,0.0,90.0,90.0,1,90,0.0,90.0,90.0
99970941.0,17,12,778,6,389,19992934.4,174.0,64.83333333333333,6,389,19962405.4,174.0,64.83333333333333
81130.0,6,14,4740,7,653,13228.833333333334,249.0,93.28571428571428,7,4087,12913.833333333334,1514.0,583.8571428571429
108106324.0,17,5,1005,5,1005,27026581.0,201.0,201.0,0,0,0.0,0.0,0.0
146073.0,6,3,337,2,214,0.0,160.0,107.0,1,123,0.0,123.0,123.0
108098331.0,17,5,1005,5,1005,27024582.75,201.0,201.0,0,0,0.0,0.0,0.0
2326.0,17,4,344,2,150,0.0,75.0,75.0,2,194,0.0,103.0,97.0
14676.0,6,14,4740,7,653,2195.1666666666665,249.0,93.28571428571428,7,4087,2269.5,1514.0,583.8571428571429
90296926.0,6,16,1192,8,596,12893591.714285716,95.0,74.5,8,596,12897882.42857143,95.0,74.5
0.0,6,1,66,1,66,0.0,66.0,66.0,0,0,0.0,0.0,0.0
255342.0,6,12,1373,7,714,42557.0,298.0,102.0,5,659,62084.75,379.0,131.8
8831.0,6,11,1132,6,556,1766.2,218.0,92.66666666666669,5,576,1698.75,304.0,115.2
123318781.0,17,14,864,7,432,17333540.833333332,174.0,61.71428571428572,7,432,17334393.833333332,174.0,61.71428571428572
1541805.0,6,4,276,2,128,0.0,74.0,64.0,2,148,0.0,74.0,74.0
366.0,17,2,202,1,87,0.0,87.0,87.0,1,115,0.0,115.0,115.0
90297390.0,6,16,1192,8,596,12892563.142857144,95.0,74.5,8,596,12897655.57142857,95.0,74.5
103152295.0,6,42,2772,21,1386,5157601.55,66.0,66.0,21,1386,5157601.85,66.0,66.0
120068.0,17,2,180,1,70,0.0,70.0,70.0,1,110,0.0,110.0,110.0
300795.0,6,6,412,4,272,100265.0,74.0,68.0,2,140,0.0,74.0,70.0
41879.0,6,10,2032,5,524,10229.0,252.0,104.8,5,1508,9582.75,1236.0,301.6
74090572.0,6,9,842,9,842,9261321.5,97.0,93.55555555555556,0,0,0.0,0.0,0.0
108103627.0,17,5,955,5,955,27025906.75,191.0,191.0,0,0,0.0,0.0,0.0
153465.0,17,2,180,1,90,0.0,90.0,90.0,1,90,0.0,90.0,90.0
4312.0,17,2,614,1,72,0.0,72.0,72.0,1,542,0.0,542.0,542.0
24983373.0,17,5,1718,4,1368,972246.0,342.0,342.0,1,350,0.0,350.0,350.0
308267.0,17,4,1400,4,1400,102755.66666666669,350.0,350.0,0,0,0.0,0.0,0.0
135751.0,6,2,132,1,66,0.0,66.0,66.0,1,66,0.0,66.0,66.0
750017.0,6,11,1021,6,444,100424.4,162.0,74.0,5,577,125345.25,349.0,115.4
102637.0,17,2,700,2,700,0.0,350.0,350.0,0,0,0.0,0.0,0.0
22896.0,6,14,4740,7,653,2887.0,249.0,93.28571428571428,7,4087,3495.1666666666665,1514.0,583.8571428571429
610.0,17,2,762,2,762,0.0,381.0,381.0,0,0,0.0,0.0,0.0
292.0,17,2,156,1,78,0.0,78.0,78.0,1,78,0.0,78.0,78.0
120047505.0,17,28,13364,28,13364,4446203.888888889,501.0,477.2857142857143,0,0,0.0,0.0,0.0
2802714.0,6,2,132,1,66,0.0,66.0,66.0,1,66,0.0,66.0,66.0
303722.0,6,2,132,1,66,0.0,66.0,66.0,1,66,0.0,66.0,66.0
113618942.0,6,46,3036,23,1518,5150442.318181818,66.0,66.0,23,1518,5150437.863636363,66.0,66.0
697.0,17,4,438,2,148,0.0,74.0,74.0,2,290,0.0,147.0,145.0
1215230.0,17,7,490,7,490,202538.3333333333,70.0,70.0,0,0,0.0,0.0,0.0
3006318.0,6,12,2172,7,664,500871.8333333333,252.0,94.85714285714286,5,1508,2132.5,1236.0,301.6
120119737.0,6,15,2428,9,1204,15014967.125,188.0,133.77777777777777,6,1224,18073677.4,204.0,204.0
97274232.0,17,12,778,6,389,19400955.0,174.0,64.83333333333333,6,389,19400223.0,174.0,64.83333333333333
29408.0,6,14,4740,7,653,4674.0,249.0,93.28571428571428,7,4087,4618.666666666667,1514.0,583.8571428571429
315724.0,17,4,1400,4,1400,105241.33333333331,350.0,350.0,0,0,0.0,0.0,0.0
221019.0,6,3,426,2,280,0.0,214.0,140.0,1,146,0.0,146.0,146.0
51065.0,6,14,4740,7,653,5865.333333333333,249.0,93.28571428571428,7,4087,8020.0,1514.0,583.8571428571429
287578.0,6,12,1373,7,714,47929.66666666666,298.0,102.0,5,659,67759.0,379.0,131.8
63646.99999999999,6,14,4740,7,653,10390.333333333334,249.0,93.28571428571428,7,4087,10471.333333333334,1514.0,583.8571428571429
146142.0,6,3,337,2,214,0.0,160.0,107.0,1,123,0.0,123.0,123.0
106225.0,17,2,700,2,700,0.0,350.0,350.0,0,0,0.0,0.0,0.0
92113876.0,6,38,2508,19,1254,5105443.722222222,66.0,66.0,19,1254,5105444.611111111,66.0,66.0
18743.0,6,10,2032,5,524,4462.5,252.0,104.8,5,1508,4402.0,1236.0,301.6
90034987.0,17,28,13364,28,13364,3334629.1481481483,501.0,477.2857142857143,0,0,0.0,0.0,0.0
5556.0,17,2,180,1,90,0.0,90.0,90.0,1,90,0.0,90.0,90.0
92069828.0,6,26,1762,13,922,7654482.833333333,139.0,70.92307692307692,13,840,7654485.0,123.0,64.61538461538461
467959.0,6,3,204,2,136,0.0,70.0,68.0,1,68,0.0,68.0,68.0
579082.0,6,4,508,2,238,0.0,172.0,119.0,2,270,0.0,135.0,135.0
90367209.0,6,12,1848,7,828,15061201.5,188.0,118.28571428571428,5,1020,15083658.5,204.0,204.0
108106983.0,17,5,955,5,955,27026745.75,191.0,191.0,0,0,0.0,0.0,0.0
490.0,17,2,762,2,762,0.0,381.0,381.0,0,0,0.0,0.0,0.0
90751971.0,6,23,2099,13,1354,7559235.25,257.0,104.15384615384616,10,745,10082455.666666666,95.0,74.5
135139847.0,17,6,1206,6,1206,27027969.4,201.0,201.0,0,0,0.0,0.0,0.0
3380.0,17,2,224,1,76,0.0,76.0,76.0,1,148,0.0,148.0,148.0
230601.0,6,3,426,2,280,0.0,214.0,140.0,1,146,0.0,146.0,146.0
78248334.0,6,27,1971,14,1033,6016898.230769231,95.0,73.78571428571429,13,938,6520069.75,95.0,72.15384615384616
2580535.0,6,2,132,1,66,0.0,66.0,66.0,1,66,0.0,66.0,66.0
148583.0,17,2,414,1,88,0.0,88.0,88.0,1,326,0.0,326.0,326.0
18082.0,6,14,4740,7,653,2802.6666666666665,249.0,93.28571428571428,7,4087,2339.833333333333,1514.0,583.8571428571429
865445.0,6,9,1266,6,795,173089.0,457.0,132.5,3,471,294879.0,331.0,157.0
206054.0,6,3,426,2,280,0.0,214.0,140.0,1,146,0.0,146.0,146.0
222028.0,6,13,1394,7,797,37004.66666666666,253.0,113.85714285714286,6,597,42453.4,259.0,99.5
3133.0,17,4,625,2,163,0.0,89.0,81.5,2,462,0.0,245.0,231.0
60379.0,6,14,4740,7,653,9880.166666666666,249.0,93.28571428571428,7,4087,9909.333333333334,1514.0,583.8571428571429
90675.0,6,14,4740,7,653,13833.0,249.0,93.28571428571428,7,4087,14349.833333333334,1514.0,583.8571428571429
317195.0,17,4,1400,4,1400,105731.66666666669,350.0,350.0,0,0,0.0,0.0,0.0
198027.0,17,2,180,1,90,0.0,90.0,90.0,1,90,0.0,90.0,90.0
44978.0,6,10,2032,5,524,11003.25,252.0,104.8,5,1508,4202.75,1236.0,301.6
96023665.0,6,185,20826,93,6360,1043735.4891304348,140.0,68.38709677419355,92,14466,1043776.5604395604,284.0,157.2391304347826
3014421.0,6,11,2106,6,598,602624.2,252.0,99.66666666666669,5,1508,1719.75,1236.0,301.6
1291742.0,17,7,490,7,490,215290.3333333333,70.0,70.0,0,0,0.0,0.0,0.0
30576.0,6,14,4740,7,653,4920.166666666667,249.0,93.28571428571428,7,4087,4000.8333333333335,1514.0,583.8571428571429
315782.0,6,6,412,4,272,105260.66666666669,74.0,68.0,2,140,0.0,74.0,70.0
141843.0,6,2,132,1,66,0.0,66.0,66.0,1,66,0.0,66.0,66.0
90023041.0,17,28,13364,28,13364,3334186.703703704,501.0,477.2857142857143,0,0,0.0,0.0,0.0
114283925.0,6,351,42296,176,30450,653051.0,284.0,173.01136363636363,175,11846,650816.9885057472,140.0,67.69142857142857
119375624.0,6,18,1341,9,691,14916468.0,95.0,76.77777777777777,9,650,14920385.125,95.0,72.22222222222223
135133096.0,17,6,1146,6,1146,27026619.2,191.0,191.0,0,0,0.0,0.0,0.0
149777.0,6,3,373,2,238,0.0,172.0,119.0,1,135,0.0,135.0,135.0
1028.0,17,2,762,2,762,0.0,381.0,381.0,0,0,0.0,0.0,0.0
242081.0,6,3,337,2,214,0.0,160.0,107.0,1,123,0.0,123.0,123.0
0.0,17,1,381,1,381,0.0,381.0,381.0,0,0,0.0,0.0,0.0
135128528.0,17,6,1206,6,1206,27025705.6,201.0,201.0,0,0,0.0,0.0,0.0
310247.0,6,3,202,2,128,0.0,74.0,64.0,1,74,0.0,74.0,74.0
90366237.0,6,12,1848,5,1020,22591272.75,204.0,204.0,7,828,15060616.333333334,188.0,118.28571428571428
37687.0,6,14,4740,7,653,6162.333333333333,249.0,93.28571428571428,7,4087,5673.0,1514.0,583.8571428571429
2021501.0,17,4,525,2,150,0.0,75.0,75.0,2,375,0.0,284.0,187.5
216497.0,17,2,180,1,90,0.0,90.0,90.0,1,90,0.0,90.0,90.0
117278837.0,6,31,2166,16,1149,7818589.133333334,123.0,71.8125,15,1017,8361625.642857143,123.0,67.8
108111270.0,17,5,955,5,955,27027817.5,191.0,191.0,0,0,0.0,0.0,0.0
238261.0,6,13,1386,7,789,39710.16666666666,253.0,112.71428571428572,6,597,45347.4,259.0,99.5
0.0,17,1,453,1,453,0.0,453.0,453.0,0,0,0.0,0.0,0.0
153377.0,17,2,180,1,90,0.0,90.0,90.0,1,90,0.0,90.0,90.0
36049.0,6,12,1447,6,816,5398.2,291.0,136.0,6,631,6472.8,293.0,105.16666666666669
2064.0,17,4,344,2,150,0.0,75.0,75.0,2,194,0.0,103.0,97.0
27701790.0,17,5,1710,5,1710,6925447.5,342.0,342.0,0,0,0.0,0.0,0.0
90046559.0,17,28,13364,28,13364,3335057.7407407407,501.0,477.2857142857143,0,0,0.0,0.0,0.0
90285573.0,6,16,1192,8,596,12891406.142857144,95.0,74.5,8,596,12896680.57142857,95.0,74.5
120123039.0,6,15,2444,7,1428,20020506.5,204.0,204.0,8,1016,17136581.285714287,188.0,127.0
2589528.0,6,2,132,1,66,0.0,66.0,66.0,1,66,0.0,66.0,66.0
164595.0,17,2,414,1,88,0.0,88.0,88.0,1,326,0.0,326.0,326.0
284900.0,17,2,363,1,79,0.0,79.0,79.0,1,284,0.0,284.0,284.0
120110864.0,6,1061,246222,544,211286,220801.1399631676,1514.0,388.3933823529412,517,34936,232354.6996124031,214.0,67.57446808510639
19318.0,17,4,344,2,150,0.0,75.0,75.0,2,194,0.0,103.0,97.0
5618926.0,6,5,336,2,134,0.0,68.0,67.0,3,202,1421420.5,70.0,67.33333333333333
153472.0,17,2,180,1,90,0.0,90.0,90.0,1,90,0.0,90.0,90.0
105521.0,17,2,700,2,700,0.0,350.0,350.0,0,0,0.0,0.0,0.0
108104547.0,17,5,955,5,955,27026136.75,191.0,191.0,0,0,0.0,0.0,0.0
3176254.0,6,18,1495,9,921,358169.0,315.0,102.33333333333331,9,574,358134.875,78.0,63.77777777777778
322733.0,17,4,1400,4,1400,107577.66666666669,350.0,350.0,0,0,0.0,0.0,0.0
3271881.0,6,164,133669,94,124747,35181.51612903226,1510.0,1327.095744680851,70,8922,43022.97101449275,1510.0,127.45714285714286
108109699.0,17,5,1005,5,1005,27027424.75,201.0,201.0,0,0,0.0,0.0,0.0
48729909.0,6,7,1874,3,887,22821403.0,753.0,295.6666666666667,4,987,15354886.333333334,785.0,246.75
10515959.0,6,7,478,4,272,3458578.6666666665,74.0,68.0,3,206,5187760.5,74.0,68.66666666666667
828.0,17,4,438,2,148,0.0,74.0,74.0,2,290,0.0,147.0,145.0
2639.0,17,4,344,2,150,0.0,75.0,75.0,2,194,0.0,103.0,97.0
36372.0,6,14,4740,7,653,5695.5,249.0,93.28571428571428,7,4087,5693.0,1514.0,583.8571428571429
117002007.0,17,13,821,7,432,19500334.5,174.0,61.71428571428572,6,389,19401130.8,174.0,64.83333333333333
205792.0,6,3,426,2,280,0.0,214.0,140.0,1,146,0.0,146.0,146.0
0.0,17,1,55,1,55,0.0,55.0,55.0,0,0,0.0,0.0,0.0
1669256.0,6,2,132,1,66,0.0,66.0,66.0,1,66,0.0,66.0,66.0
109354512.0,6,32,2220,16,1149,7275910.533333333,123.0,71.8125,16,1071,7275907.666666667,123.0,66.9375
120029709.0,17,28,13364,28,13364,4445544.777777778,501.0,477.2857142857143,0,0,0.0,0.0,0.0
102433377.0,6,44,2904,22,1452,4877779.857142857,66.0,66.0,22,1452,4868570.142857143,66.0,66.0
228232.0,17,2,180,1,90,0.0,90.0,90.0,1,90,0.0,90.0,90.0
108104740.0,17,5,1005,5,1005,27026185.0,201.0,201.0,0,0,0.0,0.0,0.0
90287726.0,6,17,1287,9,691,11279703.0,95.0,76.77777777777777,8,596,12897307.857142856,95.0,74.5
551.0,17,2,508,2,508,0.0,257.0,254.0,0,0,0.0,0.0,0.0
11450.0,17,2,582,1,83,0.0,83.0,83.0,1,499,0.0,499.0,499.0
26633.0,6,10,2032,5,524,6420.25,252.0,104.8,5,1508,6377.5,1236.0,301.6
2455.0,17,4,344,2,150,0.0,75.0,75.0,2,194,0.0,103.0,97.0
99805340.0,17,12,778,6,389,19961068.0,174.0,64.83333333333333,6,389,19894449.4,174.0,64.83333333333333
130001324.0,17,17,1255,9,649,16250165.5,174.0,72.11111111111111,8,606,15754439.42857143,174.0,75.75
2437854.0,6,5,486,3,354,1110924.5,222.0,118.0,2,132,0.0,66.0,66.0
91863415.0,6,24,1829,13,989,7655024.083333333,95.0,76.07692307692308,11,840,9183545.3,95.0,76.36363636363636
49036.0,6,14,4740,7,653,7185.833333333333,249.0,93.28571428571428,7,4087,7958.666666666667,1514.0,583.8571428571429
1192732.0,6,13,3004,8,2376,170390.2857142857,1514.0,297.0,5,628,229273.75,331.0,125.6
307050.0,6,3,202,2,128,0.0,74.0,64.0,1,74,0.0,74.0,74.0
1016807.0,17,6,1230,3,234,508214.50000000006,78.0,78.0,3,996,508202.50000000006,332.0,332.0
117645244.0,6,272,31180,136,9272,871446.2518518518,140.0,68.17647058823529,136,21908,869786.6814814815,284.0,161.08823529411765
216717.0,6,3,426,2,280,0.0,214.0,140.0,1,146,0.0,146.0,146.0
123250516.0,6,49,3234,25,1650,5135438.166666667,66.0,66.0,24,1584,5021017.478260869,66.0,66.0
196996.0,17,2,180,1,90,0.0,90.0,90.0,1,90,0.0,90.0,90.0
2424.0,17,4,344,2,150,0.0,75.0,75.0,2,194,0.0,103.0,97.0
212315.0,17,2,614,1,72,0.0,72.0,72.0,1,542,0.0,542.0,542.0
105467245.0,17,14,864,7,432,17500994.666666668,174.0,61.71428571428572,7,432,17500160.5,174.0,61.71428571428572
153037.0,17,4,6056,4,6056,51012.333333333336,1514.0,1514.0,0,0,0.0,0.0,0.0
149645.0,17,2,180,1,90,0.0,90.0,90.0,1,90,0.0,90.0,90.0
90916841.0,6,21,1585,11,840,9091392.8,95.0,76.36363636363636,10,745,10101047.666666666,95.0,74.5
297949.0,6,6,412,4,272,99316.33333333331,74.0,68.0,2,140,0.0,74.0,70.0
27381941.0,17,5,1710,5,1710,6845485.25,342.0,342.0,0,0,0.0,0.0,0.0
10455884.0,6,7,478,4,272,3439643.333333333,74.0,68.0,3,206,5159338.0,74.0,68.66666666666667
114598456.0,6,34,2482,17,1288,7162403.5,139.0,75.76470588235294,17,1194,7149593.625,123.0,70.23529411764706
5623624.0,6,5,336,2,134,0.0,68.0,67.0,3,202,1525072.0,70.0,67.33333333333333
3251.0,17,2,359,1,75,0.0,75.0,75.0,1,284,0.0,284.0,284.0
135131188.0,17,6,1206,6,1206,27026237.6,201.0,201.0,0,0,0.0,0.0,0.0
265300.0,6,3,337,2,214,0.0,160.0,107.0,1,123,0.0,123.0,123.0
157501.0,6,3,337,2,214,0.0,160.0,107.0,1,123,0.0,123.0,123.0
314966.0,17,4,1400,4,1400,104988.66666666669,350.0,350.0,0,0,0.0,0.0,0.0
90302405.0,6,16,1192,8,596,12893072.57142857,95.0,74.5,8,596,12899995.57142857,95.0,74.5
108097780.0,17,5,955,5,955,27024445.0,191.0,191.0,0,0,0.0,0.0,0.0
4252.0,17,2,598,1,72,0.0,72.0,72.0,1,526,0.0,526.0,526.0
90047626.0,17,28,13364,28,13364,3335097.25925926,501.0,477.2857142857143,0,0,0.0,0.0,0.0
221291.0,17,4,1400,4,1400,73763.66666666667,350.0,350.0,0,0,0.0,0.0,0.0
6643.0,17,2,582,1,83,0.0,83.0,83.0,1,499,0.0,499.0,499.0
143149.0,6,2,132,1,66,0.0,66.0,66.0,1,66,0.0,66.0,66.0
9250.0,17,2,539,1,86,0.0,86.0,86.0,1,453,0.0,453.0,453.0
120063110.0,17,29,13785,29,13785,4287968.214285715,501.0,475.3448275862069,0,0,0.0,0.0,0.0
46227088.0,6,9,1479,9,1479,5778386.0,172.0,164.33333333333334,0,0,0.0,0.0,0.0
62788.0,6,14,4740,7,653,10172.0,249.0,93.28571428571428,7,4087,8944.333333333334,1514.0,583.8571428571429
120124165.0,6,12,1832,8,1016,17137780.285714287,188.0,127.0,4,816,30020303.666666668,204.0,204.0
232928.0,6,3,337,2,214,0.0,160.0,107.0,1,123,0.0,123.0,123.0
20337.0,17,2,566,1,83,0.0,83.0,83.0,1,483,0.0,483.0,483.0
108095639.0,17,5,955,5,955,27023909.75,191.0,191.0,0,0,0.0,0.0,0.0
14884.0,6,10,2032,5,524,3492.0,252.0,104.8,5,1508,2480.75,1236.0,301.6
1164804.0,6,13,3012,8,2384,166400.57142857142,1514.0,298.0,5,628,222368.75,331.0,125.6
3498.0,17,2,414,1,88,0.0,88.0,88.0,1,326,0.0,326.0,326.0
2060.0,17,4,344,2,150,0.0,75.0,75.0,2,194,0.0,103.0,97.0
748611.0,6,2,132,1,66,0.0,66.0,66.0,1,66,0.0,66.0,66.0
2017827.0,17,4,525,2,150,0.0,75.0,75.0,2,375,0.0,284.0,187.5
3482.0,17,4,344,2,150,0.0,75.0,75.0,2,194,0.0,103.0,97.0
302400.0,6,2,132,1,66,0.0,66.0,66.0,1,66,0.0,66.0,66.0
105253.0,17,2,286,2,286,0.0,143.0,143.0,0,0,0.0,0.0,0.0
70276.0,17,2,604,1,75,0.0,75.0,75.0,1,529,0.0,529.0,529.0
102372.0,6,10,1065,5,534,25034.75,262.0,106.8,5,531,24717.0,259.0,106.2
5833446.0,6,5,336,2,134,0.0,68.0,67.0,3,202,1474125.0,70.0,67.33333333333333
91091433.0,6,23,1775,10,786,10098529.777777778,95.0,78.6,13,989,7573890.166666667,95.0,76.07692307692308
301.0,17,2,174,1,79,0.0,79.0,79.0,1,95,0.0,95.0,95.0
1771725.0,6,2,132,1,66,0.0,66.0,66.0,1,66,0.0,66.0,66.0
120037642.0,6,18,1341,9,691,14999507.625,95.0,76.77777777777777,9,650,14999101.5,95.0,72.22222222222223
308122.0,6,6,412,4,272,102707.33333333331,74.0,68.0,2,140,0.0,74.0,70.0
24828.0,6,14,4740,7,653,3976.5,249.0,93.28571428571428,7,4087,2917.1666666666665,1514.0,583.8571428571429
64379.00000000001,6,14,4740,7,653,10151.166666666666,249.0,93.28571428571428,7,4087,8904.666666666666,1514.0,583.8571428571429
38709.0,6,14,4740,7,653,6032.166666666667,249.0,93.28571428571428,7,4087,5932.333333333333,1514.0,583.8571428571429
108102082.0,17,5,1005,5,1005,27025520.5,201.0,201.0,0,0,0.0,0.0,0.0
90583765.0,6,15,2444,8,1016,12940537.857142856,188.0,127.0,7,1428,15065530.833333334,204.0,204.0
71664.0,17,2,614,1,72,0.0,72.0,72.0,1,542,0.0,542.0,542.0
94135638.0,6,184,20760,92,14466,1032093.5274725276,284.0,157.2391304347826,92,6294,1032093.6923076924,140.0,68.41304347826087
33502.0,6,14,4740,7,653,5219.0,249.0,93.28571428571428,7,4087,5334.666666666667,1514.0,583.8571428571429
90093414.0,6,15,2180,7,1164,15015189.333333334,204.0,166.28571428571428,8,1016,12834049.285714284,188.0,127.0
120296907.0,6,228,25756,114,7820,1057246.442477876,140.0,68.59649122807018,114,17936,1064531.1946902657,284.0,157.33333333333334
93729499.0,6,39,2574,20,1320,4916852.7894736845,66.0,66.0,19,1254,5150438.5,66.0,66.0
56034.0,6,10,2032,5,524,12885.5,252.0,104.8,5,1508,12431.5,1236.0,301.6
2093.0,17,4,344,2,150,0.0,75.0,75.0,2,194,0.0,103.0,97.0
33704985.0,6,5,336,2,134,0.0,68.0,67.0,3,202,16778703.5,70.0,67.33333333333333
21352.0,6,14,4740,7,653,3262.333333333333,249.0,93.28571428571428,7,4087,3421.833333333333,1514.0,583.8571428571429
135130783.0,17,6,1206,6,1206,27026156.6,201.0,201.0,0,0,0.0,0.0,0.0
8540.0,6,10,2032,5,524,1856.25,252.0,104.8,5,1508,1871.75,1236.0,301.6
50730583.0,6,8,2639,4,1640,16319773.333333334,753.0,410.0,4,999,15984650.333333334,785.0,249.75
108727.0,17,4,1400,4,1400,36242.333333333336,350.0,350.0,0,0,0.0,0.0,0.0
206911.0,6,3,426,2,280,0.0,214.0,140.0,1,146,0.0,146.0,146.0
232127.0,6,3,337,2,214,0.0,160.0,107.0,1,123,0.0,123.0,123.0
106263.0,17,2,700,2,700,0.0,350.0,350.0,0,0,0.0,0.0,0.0
322221.0,17,4,1400,4,1400,107407.0,350.0,350.0,0,0,0.0,0.0,0.0
2347373.0,6,26,7627,14,3735,180567.15384615384,1514.0,266.7857142857143,12,3892,190168.63636363635,1514.0,324.3333333333333
71610.0,6,14,4740,7,653,11191.666666666666,249.0,93.28571428571428,7,4087,10884.0,1514.0,583.8571428571429
757231.0,6,10,967,5,390,127210.25,162.0,78.0,5,577,127139.75,349.0,115.4
298033.0,6,6,412,4,272,99344.33333333331,74.0,68.0,2,140,0.0,74.0,70.0
2079254.0,6,25,7610,13,2516,173271.16666666666,1034.0,193.53846153846155,12,5094,160978.72727272726,1510.0,424.5
118932907.0,6,38,2710,19,1408,6595382.277777778,139.0,74.10526315789474,19,1302,6595383.111111111,123.0,68.52631578947368
140472.0,6,2,132,1,66,0.0,66.0,66.0,1,66,0.0,66.0,66.0
109528.0,17,2,286,2,286,0.0,143.0,143.0,0,0,0.0,0.0,0.0
525736.0,6,3,1604,1,753,0.0,753.0,753.0,2,851,0.0,785.0,425.5
228364.0,17,2,180,1,90,0.0,90.0,90.0,1,90,0.0,90.0,90.0
36919.0,6,14,4740,7,653,5928.166666666667,249.0,93.28571428571428,7,4087,5359.166666666667,1514.0,583.8571428571429
34664.0,6,10,2032,5,524,8276.0,252.0,104.8,5,1508,6909.75,1236.0,301.6
311685.0,17,2,333,1,87,0.0,87.0,87.0,1,246,0.0,246.0,246.0
488.0,17,2,208,1,72,0.0,72.0,72.0,1,136,0.0,136.0,136.0
750.0,17,4,438,2,148,0.0,74.0,74.0,2,290,0.0,147.0,145.0
153435.0,17,2,180,1,90,0.0,90.0,90.0,1,90,0.0,90.0,90.0
34319.0,6,14,4740,7,653,5513.0,249.0,93.28571428571428,7,4087,4861.833333333333,1514.0,583.8571428571429
190852.0,17,2,180,1,90,0.0,90.0,90.0,1,90,0.0,90.0,90.0
118679255.0,6,36,2464,18,1285,6968414.0,139.0,71.38888888888889,18,1179,6968414.294117647,123.0,65.5
114858978.0,6,47,3102,24,1584,4980778.304347826,66.0,66.0,23,1518,5150447.7727272725,66.0,66.0
204992.0,17,2,762,2,762,0.0,381.0,381.0,0,0,0.0,0.0,0.0
15098.0,17,2,598,1,72,0.0,72.0,72.0,1,526,0.0,526.0,526.0
233715.0,6,3,337,2,214,0.0,160.0,107.0,1,123,0.0,123.0,123.0
601008.0,17,2,346,1,78,0.0,78.0,78.0,1,268,0.0,268.0,268.0
48543.0,6,10,2032,5,524,11795.0,252.0,104.8,5,1508,11274.0,1236.0,301.6
16710.0,17,2,180,1,90,0.0,90.0,90.0,1,90,0.0,90.0,90.0
52894.0,6,14,4740,7,653,8594.0,249.0,93.28571428571428,7,4087,7599.166666666667,1514.0,583.8571428571429
4264.0,17,2,598,1,72,0.0,72.0,72.0,1,526,0.0,526.0,526.0
135134097.0,17,6,1146,6,1146,27026819.4,191.0,191.0,0,0,0.0,0.0,0.0
90257098.0,6,13,2036,8,1016,12893871.142857144,188.0,127.0,5,1020,22522491.25,204.0,204.0
208228.0,6,3,426,2,280,0.0,214.0,140.0,1,146,0.0,146.0,146.0
43209.0,6,10,2032,5,524,10557.75,252.0,104.8,5,1508,10435.75,1236.0,301.6
226375.0,6,13,1394,7,797,37729.16666666666,253.0,113.85714285714286,6,597,43964.4,259.0,99.5
108104826.0,17,5,955,5,955,27026206.5,191.0,191.0,0,0,0.0,0.0,0.0
306140.0,6,6,412,4,272,102046.66666666669,74.0,68.0,2,140,0.0,74.0,70.0
153542.0,17,2,180,1,90,0.0,90.0,90.0,1,90,0.0,90.0,90.0
2628196.0,6,25,7573,14,3735,202168.92307692303,1514.0,266.7857142857143,11,3838,237302.6,1514.0,348.90909090909093
14702.0,6,13,1459,7,862,2226.1666666666665,271.0,123.14285714285714,6,597,2603.6,259.0,99.5
104392.0,17,2,286,2,286,0.0,143.0,143.0,0,0,0.0,0.0,0.0
416.0,17,2,248,1,84,0.0,84.0,84.0,1,164,0.0,164.0,164.0
51677.0,6,10,2032,5,524,12299.5,252.0,104.8,5,1508,11511.5,1236.0,301.6
10488.0,6,2,177,1,123,0.0,123.0,123.0,1,54,0.0,54.0,54.0
108112390.0,17,5,955,5,955,27028097.5,191.0,191.0,0,0,0.0,0.0,0.0
321972.0,17,4,704,2,148,0.0,74.0,74.0,2,556,0.0,280.0,278.0
740698.0,6,2,132,1,66,0.0,66.0,66.0,1,66,0.0,66.0,66.0
9128.0,17,2,582,1,83,0.0,83.0,83.0,1,499,0.0,499.0,499.0
221981.0,6,3,426,2,280,0.0,214.0,140.0,1,146,0.0,146.0,146.0
23363.0,6,10,2032,5,524,5521.75,252.0,104.8,5,1508,5371.75,1236.0,301.6
228197.0,17,2,180,1,90,0.0,90.0,90.0,1,90,0.0,90.0,90.0
114529039.0,6,48,3168,24,1584,4979523.434782608,66.0,66.0,24,1584,4967542.130434782,66.0,66.0
211251.0,6,3,426,2,280,0.0,214.0,140.0,1,146,0.0,146.0,146.0
107338.0,17,2,286,2,286,0.0,143.0,143.0,0,0,0.0,0.0,0.0
153436.0,17,2,180,1,90,0.0,90.0,90.0,1,90,0.0,90.0,90.0
123602917.0,6,35,2542,17,1194,7101119.9375,123.0,70.23529411764706,18,1348,6818535.470588235,139.0,74.88888888888889
5008179.0,17,4,376,2,152,0.0,76.0,76.0,2,224,0.0,148.0,112.0
2038968.0,6,4,270,2,134,0.0,68.0,67.0,2,136,0.0,70.0,68.0
14506.0,6,13,1459,7,862,2247.0,271.0,123.14285714285714,6,597,2592.6,259.0,99.5
315664.0,17,4,1400,4,1400,105221.33333333331,350.0,350.0,0,0,0.0,0.0,0.0
321.0,17,2,208,1,72,0.0,72.0,72.0,1,136,0.0,136.0,136.0
108317871.0,17,6,1311,5,1005,27027285.0,201.0,201.0,1,306,0.0,306.0,306.0
146233.0,6,3,337,2,214,0.0,160.0,107.0,1,123,0.0,123.0,123.0
120115289.0,6,15,2444,8,1016,17136160.14285714,188.0,127.0,7,1428,15012806.666666666,204.0,204.0
35892.0,6,14,4740,7,653,5828.5,249.0,93.28571428571428,7,4087,5609.0,1514.0,583.8571428571429
46431.0,6,14,4740,7,653,7611.166666666667,249.0,93.28571428571428,7,4087,6914.666666666667,1514.0,583.8571428571429
90534911.0,6,14,2240,8,1016,12933558.714285716,188.0,127.0,6,1224,18072646.0,204.0,204.0
90257091.0,6,14,2240,8,1016,12893870.142857144,188.0,127.0,6,1224,18018285.0,204.0,204.0
90734997.0,6,17,1287,9,691,11336477.75,95.0,76.77777777777777,8,596,12960696.42857143,95.0,74.5
120074329.0,17,28,13364,28,13364,4447197.37037037,501.0,477.2857142857143,0,0,0.0,0.0,0.0
228464.0,17,2,180,1,90,0.0,90.0,90.0,1,90,0.0,90.0,90.0
33134519.0,6,7,1874,3,887,16491647.000000002,753.0,295.6666666666667,4,987,10995976.333333334,785.0,246.75
104826588.0,6,44,2904,22,1452,4991742.285714285,66.0,66.0,22,1452,4972938.523809524,66.0,66.0
68156.0,6,14,4740,7,653,11229.0,249.0,93.28571428571428,7,4087,8840.0,1514.0,583.8571428571429
135133483.0,17,6,1206,6,1206,27026696.6,201.0,201.0,0,0,0.0,0.0,0.0
252796.00000000003,6,10,1221,6,636,50559.2,298.0,106.0,4,585,78617.66666666667,379.0,146.25
103364540.0,6,42,2772,21,1386,5168214.45,66.0,66.0,21,1386,5168213.25,66.0,66.0
196879.0,17,2,180,1,90,0.0,90.0,90.0,1,90,0.0,90.0,90.0
108108748.0,17,5,1005,5,1005,27027187.0,201.0,201.0,0,0,0.0,0.0,0.0
117004677.0,17,13,821,7,432,19500779.5,174.0,61.71428571428572,6,389,19400153.6,174.0,64.83333333333333
404.0,17,2,508,2,508,0.0,257.0,254.0,0,0,0.0,0.0,0.0
149651.0,17,2,180,1,90,0.0,90.0,90.0,1,90,0.0,90.0,90.0
901191.0,6,12,2710,7,743,150198.5,339.0,106.14285714285714,5,1967,157149.0,1514.0,393.4
2248.0,17,4,344,2,150,0.0,75.0,75.0,2,194,0.0,103.0,97.0
451469.0,6,10,1221,6,636,90293.8,298.0,106.0,4,585,145010.66666666666,379.0,146.25
130726.0,6,3,337,2,214,0.0,160.0,107.0,1,123,0.0,123.0,123.0
2368.0,17,4,344,2,150,0.0,75.0,75.0,2,194,0.0,103.0,97.0
139111.0,6,15,4806,8,719,19234.571428571428,249.0,89.875,7,4087,20094.33333333333,1514.0,583.8571428571429
29255.0,6,12,1393,6,796,5717.0,271.0,132.66666666666666,6,597,5629.4,259.0,99.5
322160.0,17,4,1400,4,1400,107386.66666666669,350.0,350.0,0,0,0.0,0.0,0.0
3243.0,17,2,224,1,76,0.0,76.0,76.0,1,148,0.0,148.0,148.0
298729.0,6,6,412,4,272,99576.33333333331,74.0,68.0,2,140,0.0,74.0,70.0
302468.0,6,2,132,1,66,0.0,66.0,66.0,1,66,0.0,66.0,66.0
772.0,17,4,438,2,148,0.0,74.0,74.0,2,290,0.0,147.0,145.0
90042521.0,17,28,13364,28,13364,3334908.185185185,501.0,477.2857142857143,0,0,0.0,0.0,0.0
113930151.0,6,1026,256338,497,33764,229694.82258064515,214.0,67.93561368209255,529,222574,215760.95643939395,1514.0,420.7448015122873
20763.0,6,10,2032,5,524,4785.25,252.0,104.8,5,1508,4892.25,1236.0,301.6
1308002.0,17,7,490,7,490,218000.3333333333,70.0,70.0,0,0,0.0,0.0,0.0
250535.0,17,4,6056,4,6056,83511.66666666667,1514.0,1514.0,0,0,0.0,0.0,0.0
120165591.0,6,32,2299,16,1071,7847674.133333334,123.0,66.9375,16,1228,7345314.8,139.0,76.75
1026270.0,6,11,1134,6,558,205254.0,220.0,93.0,5,576,255785.25,304.0,115.2
4182.0,17,2,510,1,79,0.0,79.0,79.0,1,431,0.0,431.0,431.0
256311.0,6,10,1221,6,636,51262.2,298.0,106.0,4,585,79719.66666666667,379.0,146.25
228309.0,17,2,180,1,90,0.0,90.0,90.0,1,90,0.0,90.0,90.0
2253.0,17,4,344,2,150,0.0,75.0,75.0,2,194,0.0,103.0,97.0
136766.0,6,2,132,1,66,0.0,66.0,66.0,1,66,0.0,66.0,66.0
140488.0,6,2,132,1,66,0.0,66.0,66.0,1,66,0.0,66.0,66.0
5528.0,17,2,180,1,90,0.0,90.0,90.0,1,90,0.0,90.0,90.0
2047.0,17,4,344,2,150,0.0,75.0,75.0,2,194,0.0,103.0,97.0
5627038.0,6,5,336,2,134,0.0,68.0,67.0,3,202,1520095.5,70.0,67.33333333333333
301926.0,6,6,412,4,272,100642.0,74.0,68.0,2,140,0.0,74.0,70.0
865509.0,6,11,2643,7,742,144251.5,338.0,106.0,4,1901,197551.0,1514.0,475.25
26750.0,6,14,4740,7,653,4276.166666666667,249.0,93.28571428571428,7,4087,3928.5,1514.0,583.8571428571429
120000090.0,6,17,1287,9,691,15000011.25,95.0,76.77777777777777,8,596,12900014.57142857,95.0,74.5
101958109.0,6,30,2122,15,1105,7282722.071428572,139.0,73.66666666666667,15,1017,7267271.357142857,123.0,67.8
0.0,6,1,66,0,0,0.0,0.0,0.0,1,66,0.0,66.0,66.0
216689.0,6,3,426,2,280,0.0,214.0,140.0,1,146,0.0,146.0,146.0
26058.0,6,10,2032,5,524,5957.5,252.0,104.8,5,1508,5624.0,1236.0,301.6
825.0,17,4,438,2,148,0.0,74.0,74.0,2,290,0.0,147.0,145.0
228248.0,17,2,180,1,90,0.0,90.0,90.0,1,90,0.0,90.0,90.0
90052893.0,17,22,10444,22,10444,4288233.0,501.0,474.7272727272728,0,0,0.0,0.0,0.0
10456680.0,6,7,478,4,272,3440057.0,74.0,68.0,3,206,5159991.5,74.0,68.66666666666667
120122791.0,6,14,2224,9,1204,15015348.875,188.0,133.77777777777777,5,1020,22522901.5,204.0,204.0
120125137.0,6,12,1832,8,1016,17137454.14285714,188.0,127.0,4,816,30032316.0,204.0,204.0
22885.0,6,20,7606,11,978,2288.5,310.0,88.9090909090909,9,6628,2516.875,1514.0,736.4444444444445
205912.0,17,2,180,1,90,0.0,90.0,90.0,1,90,0.0,90.0,90.0
103046652.0,6,181,20366,91,6302,1144962.8,140.0,69.25274725274726,90,14064,1145615.0337078653,284.0,156.26666666666668
321.0,17,2,174,1,79,0.0,79.0,79.0,1,95,0.0,95.0,95.0
104430510.0,6,32,2236,16,1165,6948404.933333334,139.0,72.8125,16,1071,6948374.466666667,123.0,66.9375
91949671.0,6,162,18318,81,12750,1146680.2,284.0,157.40740740740742,81,5568,1146681.4125,140.0,68.74074074074075
41829.0,6,10,2032,5,524,10173.75,252.0,104.8,5,1508,7792.5,1236.0,301.6
1307196.0,6,4,264,2,132,0.0,66.0,66.0,2,132,0.0,66.0,66.0
115063432.0,6,30,1974,15,1026,8203402.5,123.0,68.4,15,948,8203399.928571428,123.0,63.2
1163209.0,6,13,3009,8,2381,166172.7142857143,1514.0,297.625,5,628,221857.25,331.0,125.6
2310953.0,6,3,1604,2,851,0.0,785.0,425.5,1,753,0.0,753.0,753.0
842.0,17,4,438,2,148,0.0,74.0,74.0,2,290,0.0,147.0,145.0
120017140.0,17,28,13364,28,13364,4445079.259259259,501.0,477.2857142857143,0,0,0.0,0.0,0.0
117628358.0,6,37,2656,19,1408,6522906.666666667,139.0,74.10526315789474,18,1248,6906616.411764706,123.0,69.33333333333333
2036.0,17,4,344,2,150,0.0,75.0,75.0,2,194,0.0,103.0,97.0
303637.0,6,2,132,1,66,0.0,66.0,66.0,1,66,0.0,66.0,66.0
6459.0,17,4,823,2,163,0.0,89.0,81.5,2,660,0.0,443.0,330.0
135129305.0,17,6,1206,6,1206,27025861.0,201.0,201.0,0,0,0.0,0.0,0.0
319790.0,6,7,478,4,272,106596.66666666669,74.0,68.0,3,206,75790.5,74.0,68.66666666666667
48909.0,6,10,2032,5,524,11998.5,252.0,104.8,5,1508,9100.5,1236.0,301.6
153420.0,17,2,180,1,90,0.0,90.0,90.0,1,90,0.0,90.0,90.0
124006597.0,6,46,3765,20,1701,6001159.684210527,123.0,85.05,26,2064,4960195.76,123.0,79.38461538461539
22859228.0,17,3,1034,2,684,0.0,342.0,342.0,1,350,0.0,350.0,350.0
15892202.0,17,6,2052,6,2052,3178440.4,342.0,342.0,0,0,0.0,0.0,0.0
135128106.0,17,6,1206,6,1206,27025621.2,201.0,201.0,0,0,0.0,0.0,0.0
862889.0,6,9,1096,6,625,172577.8,287.0,104.16666666666669,3,471,293651.0,331.0,157.0
27982.0,6,14,4740,7,653,2808.333333333333,249.0,93.28571428571428,7,4087,4258.833333333333,1514.0,583.8571428571429
135133075.0,17,6,1206,6,1206,27026615.0,201.0,201.0,0,0,0.0,0.0,0.0
211359.0,17,2,180,1,90,0.0,90.0,90.0,1,90,0.0,90.0,90.0
24794.0,6,14,4740,7,653,3383.833333333333,249.0,93.28571428571428,7,4087,3753.5,1514.0,583.8571428571429
6746.0,17,2,582,1,83,0.0,83.0,83.0,1,499,0.0,499.0,499.0
831255.0,6,9,1118,6,586,166251.0,248.0,97.66666666666669,3,532,279284.5,392.0,177.33333333333334
1020298.0,6,11,1134,6,558,204059.6,220.0,93.0,5,576,254281.75,304.0,115.2
216797.0,6,3,426,2,280,0.0,214.0,140.0,1,146,0.0,146.0,146.0
101954.0,17,2,762,2,762,0.0,381.0,381.0,0,0,0.0,0.0,0.0
90257373.0,6,12,1832,8,1016,12893910.42857143,188.0,127.0,4,816,30030955.33333333,204.0,204.0
207317.0,6,3,426,2,280,0.0,214.0,140.0,1,146,0.0,146.0,146.0
143937.0,17,2,180,1,90,0.0,90.0,90.0,1,90,0.0,90.0,90.0
121008635.0,17,15,907,8,475,17286947.85714286,174.0,59.375,7,432,16833498.166666668,174.0,61.71428571428572
216673.0,17,2,180,1,90,0.0,90.0,90.0,1,90,0.0,90.0,90.0
251446.0,6,3,337,2,214,0.0,160.0,107.0,1,123,0.0,123.0,123.0
169090.0,6,10,2032,5,524,41801.5,252.0,104.8,5,1508,41576.5,1236.0,301.6
66811.0,6,14,4740,7,653,10850.0,249.0,93.28571428571428,7,4087,10007.666666666666,1514.0,583.8571428571429
303691.0,6,6,412,4,272,101230.33333333331,74.0,68.0,2,140,0.0,74.0,70.0
298759.0,6,6,412,4,272,99586.33333333331,74.0,68.0,2,140,0.0,74.0,70.0
51124.0,17,2,180,1,90,0.0,90.0,90.0,1,90,0.0,90.0,90.0
153485.0,17,2,180,1,90,0.0,90.0,90.0,1,90,0.0,90.0,90.0
14660348.0,6,19,1553,9,921,1791611.0,315.0,102.33333333333331,10,632,1591549.888888889,78.0,63.2
180020.0,17,2,180,1,90,0.0,90.0,90.0,1,90,0.0,90.0,90.0
107853198.0,6,28,1860,14,966,8296399.846153846,123.0,69.0,14,894,8279746.846153846,123.0,63.85714285714285
108099349.0,17,5,1005,5,1005,27024837.25,201.0,201.0,0,0,0.0,0.0,0.0
308911.0,6,6,412,4,272,102970.33333333331,74.0,68.0,2,140,0.0,74.0,70.0
90016718.0,17,28,13364,28,13364,3333952.5185185187,501.0,477.2857142857143,0,0,0.0,0.0,0.0
114459427.0,6,34,2482,17,1288,7153714.1875,139.0,75.76470588235294,17,1194,7140196.375,123.0,70.23529411764706
2774000.0,6,3,1777,1,826,0.0,826.0,826.0,2,951,0.0,885.0,475.5
90009628.0,17,27,12943,27,12943,3461908.769230769,501.0,479.3703703703704,0,0,0.0,0.0,0.0
108112685.0,17,5,1005,5,1005,27028171.25,201.0,201.0,0,0,0.0,0.0,0.0
120055482.0,17,28,13364,28,13364,4446499.333333333,501.0,477.2857142857143,0,0,0.0,0.0,0.0
102720.0,17,2,286,2,286,0.0,143.0,143.0,0,0,0.0,0.0,0.0
6467286.0,17,6,831,3,219,3169941.5,76.0,73.0,3,612,3069934.0,207.0,204.0
38727.0,6,11,2098,6,590,7569.8,252.0,98.33333333333331,5,1508,8588.5,1236.0,301.6
75995.0,6,14,4740,7,653,12539.333333333334,249.0,93.28571428571428,7,4087,10310.833333333334,1514.0,583.8571428571429
381.0,17,2,166,1,75,0.0,75.0,75.0,1,91,0.0,91.0,91.0
54596.0,6,14,4740,7,653,8972.333333333334,249.0,93.28571428571428,7,4087,8131.5,1514.0,583.8571428571429
106094.0,17,4,1400,4,1400,35364.666666666664,350.0,350.0,0,0,0.0,0.0,0.0
301692.0,6,6,412,4,272,100564.0,74.0,68.0,2,140,0.0,74.0,70.0
304075.0,6,6,412,4,272,101358.33333333331,74.0,68.0,2,140,0.0,74.0,70.0
313.0,17,2,164,1,82,0.0,82.0,82.0,1,82,0.0,82.0,82.0
143945.0,17,2,180,1,90,0.0,90.0,90.0,1,90,0.0,90.0,90.0
5610762.0,6,5,336,2,134,0.0,68.0,67.0,3,202,1423401.0,70.0,67.33333333333333
90292330.0,6,16,1192,8,596,12892652.285714284,95.0,74.5,8,596,12897162.142857144,95.0,74.5
314.0,17,2,174,1,79,0.0,79.0,79.0,1,95,0.0,95.0,95.0
103318048.0,6,42,2772,21,1386,5150437.7,66.0,66.0,21,1386,5150438.35,66.0,66.0
90254424.0,6,16,2368,9,1204,11281803.0,188.0,133.77777777777777,7,1164,15015033.666666666,204.0,166.28571428571428
122597280.0,6,36,2596,18,1248,6624263.176470588,123.0,69.33333333333333,18,1348,6774173.0,139.0,74.88888888888889
283.0,17,2,156,1,78,0.0,78.0,78.0,1,78,0.0,78.0,78.0
783.0,17,2,508,2,508,0.0,257.0,254.0,0,0,0.0,0.0,0.0
2003.0,17,4,344,2,150,0.0,75.0,75.0,2,194,0.0,103.0,97.0
0.0,17,1,44,1,44,0.0,44.0,44.0,0,0,0.0,0.0,0.0
15177.0,17,2,180,1,90,0.0,90.0,90.0,1,90,0.0,90.0,90.0
6372.0,17,2,180,1,90,0.0,90.0,90.0,1,90,0.0,90.0,90.0
10850597.0,6,8,544,4,272,3571130.333333333,74.0,68.0,4,272,3570999.6666666665,74.0,68.0
75649.0,6,14,4740,7,653,12486.0,249.0,93.28571428571428,7,4087,12355.833333333334,1514.0,583.8571428571429
498638.0,6,5,336,2,134,0.0,68.0,67.0,3,202,193990.5,70.0,67.33333333333333
153457.0,17,2,180,1,90,0.0,90.0,90.0,1,90,0.0,90.0,90.0
482756.0,6,3,1604,1,753,0.0,753.0,753.0,2,851,0.0,785.0,425.5
312182.0,6,6,412,4,272,104060.66666666669,74.0,68.0,2,140,0.0,74.0,70.0
103032.0,17,2,700,2,700,0.0,350.0,350.0,0,0,0.0,0.0,0.0
107707.0,17,2,286,2,286,0.0,143.0,143.0,0,0,0.0,0.0,0.0
38958.0,6,14,4740,7,653,6183.0,249.0,93.28571428571428,7,4087,6274.333333333333,1514.0,583.8571428571429
43179.0,6,14,4740,7,653,7075.5,249.0,93.28571428571428,7,4087,6835.0,1514.0,583.8571428571429
119830092.0,17,35,16705,35,16705,3524414.470588235,501.0,477.2857142857143,0,0,0.0,0.0,0.0
19605.0,6,2,145,2,145,0.0,91.0,72.5,0,0,0.0,0.0,0.0
21616.0,6,14,4740,7,653,3446.0,249.0,93.28571428571428,7,4087,3462.1666666666665,1514.0,583.8571428571429
43742.0,6,14,4740,7,653,6925.833333333333,249.0,93.28571428571428,7,4087,7010.666666666667,1514.0,583.8571428571429
207355.0,6,3,426,2,280,0.0,214.0,140.0,1,146,0.0,146.0,146.0
50256.0,6,14,4740,7,653,8133.5,249.0,93.28571428571428,7,4087,7677.666666666667,1514.0,583.8571428571429
883526.0,6,10,1334,6,797,176705.2,459.0,132.83333333333334,4,537,202778.3333333333,331.0,134.25
49145.0,6,14,4740,7,653,6783.5,249.0,93.28571428571428,7,4087,8053.333333333333,1514.0,583.8571428571429
79.0,17,2,762,2,762,0.0,381.0,381.0,0,0,0.0,0.0,0.0
90047351.0,17,28,13364,28,13364,3335087.074074074,501.0,477.2857142857143,0,0,0.0,0.0,0.0
135134036.0,17,6,1146,6,1146,27026807.2,191.0,191.0,0,0,0.0,0.0,0.0
143951.0,17,2,180,1,90,0.0,90.0,90.0,1,90,0.0,90.0,90.0
302972.0,6,6,412,4,272,100990.66666666669,74.0,68.0,2,140,0.0,74.0,70.0
110584234.0,6,34,2334,17,1209,6898019.625,123.0,71.11764705882354,17,1125,6898022.3125,123.0,66.17647058823529
36422.0,17,2,582,1,83,0.0,83.0,83.0,1,499,0.0,499.0,499.0
2993.0,17,2,224,1,76,0.0,76.0,76.0,1,148,0.0,148.0,148.0
110226.0,17,2,286,2,286,0.0,143.0,143.0,0,0,0.0,0.0,0.0
70342.0,6,14,4740,7,653,11475.166666666666,249.0,93.28571428571428,7,4087,11188.333333333334,1514.0,583.8571428571429
751232.0,6,2,132,1,66,0.0,66.0,66.0,1,66,0.0,66.0,66.0
28844.0,6,10,2032,5,524,6624.75,252.0,104.8,5,1508,6930.5,1236.0,301.6
190950.0,17,2,180,1,90,0.0,90.0,90.0,1,90,0.0,90.0,90.0
347.0,17,2,267,1,83,0.0,83.0,83.0,1,184,0.0,184.0,184.0
90053342.0,17,28,13364,28,13364,3335308.962962963,501.0,477.2857142857143,0,0,0.0,0.0,0.0
108107534.0,17,5,955,5,955,27026883.5,191.0,191.0,0,0,0.0,0.0,0.0
2793666.0,6,2,132,1,66,0.0,66.0,66.0,1,66,0.0,66.0,66.0
212541.0,6,10,1221,6,636,42508.2,298.0,106.0,4,585,69417.66666666667,379.0,146.25
28576.0,6,10,2032,5,524,6870.5,252.0,104.8,5,1508,6654.5,1236.0,301.6
90751231.0,6,19,1436,10,745,10078821.666666666,95.0,74.5,9,691,11342622.375,95.0,76.77777777777777
135121192.0,17,6,1146,6,1146,27024238.4,191.0,191.0,0,0,0.0,0.0,0.0
90528819.0,6,13,2036,8,1016,12932688.42857143,188.0,127.0,5,1020,22589613.25,204.0,204.0
10510536.0,6,6,412,3,206,5186985.0,74.0,68.66666666666667,3,206,5186888.0,74.0,68.66666666666667
90270869.0,6,19,1436,10,745,10025665.111111112,95.0,74.5,9,691,11281680.875,95.0,76.77777777777777
540511.0,17,6,2100,6,2100,108102.2,350.0,350.0,0,0,0.0,0.0,0.0
90523260.0,6,13,2036,8,1016,12931894.285714284,188.0,127.0,5,1020,22590368.25,204.0,204.0
90770092.0,6,17,1287,9,691,11340444.75,95.0,76.77777777777777,8,596,12965205.285714284,95.0,74.5
41101.0,6,10,2032,5,524,8285.75,252.0,104.8,5,1508,9890.5,1236.0,301.6
27409964.0,17,5,1710,5,1710,6852491.0,342.0,342.0,0,0,0.0,0.0,0.0
122225.0,6,3,373,2,238,0.0,172.0,119.0,1,135,0.0,135.0,135.0
40000.0,6,14,4740,7,653,6503.5,249.0,93.28571428571428,7,4087,5971.833333333333,1514.0,583.8571428571429
15789.000000000002,6,14,4740,7,653,2463.833333333333,249.0,93.28571428571428,7,4087,2493.1666666666665,1514.0,583.8571428571429
108125485.0,17,5,1005,5,1005,27031371.25,201.0,201.0,0,0,0.0,0.0,0.0
321.0,17,2,174,1,79,0.0,79.0,79.0,1,95,0.0,95.0,95.0
49442.0,6,14,4740,7,653,7238.333333333333,249.0,93.28571428571428,7,4087,7538.333333333333,1514.0,583.8571428571429
288.0,17,2,156,1,78,0.0,78.0,78.0,1,78,0.0,78.0,78.0
30770.0,6,14,4740,7,653,4911.0,249.0,93.28571428571428,7,4087,4991.333333333333,1514.0,583.8571428571429
204495.0,17,2,762,2,762,0.0,381.0,381.0,0,0,0.0,0.0,0.0
307353.0,6,6,412,4,272,102451.0,74.0,68.0,2,140,0.0,74.0,70.0
126944149.0,17,14,864,7,432,17833504.166666668,174.0,61.71428571428572,7,432,17834461.166666668,174.0,61.71428571428572
108092697.0,17,5,955,5,955,27023174.25,191.0,191.0,0,0,0.0,0.0,0.0
1190601.0,6,11,1134,6,558,238120.2,220.0,93.0,5,576,296359.0,304.0,115.2
304077.0,17,2,180,1,90,0.0,90.0,90.0,1,90,0.0,90.0,90.0
218772.0,6,3,426,2,280,0.0,214.0,140.0,1,146,0.0,146.0,146.0
14643695.0,6,20,1607,10,975,1592940.111111111,315.0,97.5,10,632,1592914.111111111,78.0,63.2
307535.0,6,6,412,4,272,102511.66666666669,74.0,68.0,2,140,0.0,74.0,70.0
167156.0,17,4,571,2,148,0.0,74.0,74.0,2,423,0.0,276.0,211.5
135113991.0,17,6,1146,6,1146,27022798.2,191.0,191.0,0,0,0.0,0.0,0.0
36455.0,6,14,4740,7,653,3983.6666666666665,249.0,93.28571428571428,7,4087,5910.833333333333,1514.0,583.8571428571429
98940.0,17,2,762,2,762,0.0,381.0,381.0,0,0,0.0,0.0,0.0
294.0,17,2,156,1,78,0.0,78.0,78.0,1,78,0.0,78.0,78.0
827.0,17,4,438,2,148,0.0,74.0,74.0,2,290,0.0,147.0,145.0
299299.0,6,6,412,4,272,99766.33333333331,74.0,68.0,2,140,0.0,74.0,70.0
302439.0,6,2,132,1,66,0.0,66.0,66.0,1,66,0.0,66.0,66.0
10443772.0,6,7,478,4,272,3435922.333333333,74.0,68.0,3,206,5153772.5,74.0,68.66666666666667
411915.0,6,4,508,2,238,0.0,172.0,119.0,2,270,0.0,135.0,135.0
148034.0,17,2,180,1,90,0.0,90.0,90.0,1,90,0.0,90.0,90.0
16738.0,17,2,180,1,90,0.0,90.0,90.0,1,90,0.0,90.0,90.0
107436528.0,6,30,2122,15,1105,7674037.714285715,139.0,73.66666666666667,15,1017,7659157.142857143,123.0,67.8
108129376.0,17,5,955,5,955,27032344.0,191.0,191.0,0,0,0.0,0.0,0.0
196878.0,17,2,180,1,90,0.0,90.0,90.0,1,90,0.0,90.0,90.0
90658367.0,6,15,2302,9,1204,11317396.75,188.0,133.77777777777777,6,1098,18099745.0,204.0,183.0
5825254.0,6,4,270,2,134,0.0,68.0,67.0,2,136,0.0,70.0,68.0
143967.0,17,2,180,1,90,0.0,90.0,90.0,1,90,0.0,90.0,90.0
303670.0,6,6,412,4,272,101223.33333333331,74.0,68.0,2,140,0.0,74.0,70.0
135143372.0,17,6,1206,6,1206,27028674.4,201.0,201.0,0,0,0.0,0.0,0.0
90539392.0,6,14,2240,8,1016,12934198.857142856,188.0,127.0,6,1224,18075178.2,204.0,204.0
216693.0,6,3,426,2,280,0.0,214.0,140.0,1,146,0.0,146.0,146.0
425.0,17,2,168,1,76,0.0,76.0,76.0,1,92,0.0,92.0,92.0
0.0,17,1,72,1,72,0.0,72.0,72.0,0,0,0.0,0.0,0.0
207048.0,6,3,426,2,280,0.0,214.0,140.0,1,146,0.0,146.0,146.0
24753.0,6,10,2032,5,524,5763.75,252.0,104.8,5,1508,5188.5,1236.0,301.6
103753153.0,6,43,2838,22,1452,4940612.904761905,66.0,66.0,21,1386,5160002.4,66.0,66.0
844463.0,6,9,1118,6,586,168892.6,248.0,97.66666666666669,3,532,284418.0,392.0,177.33333333333334
10350.0,6,11,2098,6,590,1724.2,252.0,98.33333333333331,5,1508,2339.75,1236.0,301.6
64717.0,6,10,2032,5,524,15964.75,252.0,104.8,5,1508,13265.25,1236.0,301.6
108115547.0,17,5,955,5,955,27028886.75,191.0,191.0,0,0,0.0,0.0,0.0
11759.0,6,10,1067,5,536,2259.25,264.0,107.2,5,531,2567.75,259.0,106.2
534164.0,6,2,132,1,66,0.0,66.0,66.0,1,66,0.0,66.0,66.0
217274.0,17,2,180,1,90,0.0,90.0,90.0,1,90,0.0,90.0,90.0
104282.0,17,2,286,2,286,0.0,143.0,143.0,0,0,0.0,0.0,0.0
313064.0,6,3,202,2,128,0.0,74.0,64.0,1,74,0.0,74.0,74.0
135144286.0,17,6,1146,6,1146,27028857.2,191.0,191.0,0,0,0.0,0.0,0.0
298138.0,6,6,412,4,272,99379.33333333331,74.0,68.0,2,140,0.0,74.0,70.0
261766.0,6,10,1221,6,636,52353.2,298.0,106.0,4,585,81886.33333333333,379.0,146.25
771.0,17,4,438,2,148,0.0,74.0,74.0,2,290,0.0,147.0,145.0
2321.0,17,4,344,2,150,0.0,75.0,75.0,2,194,0.0,103.0,97.0
217414.0,17,2,180,1,90,0.0,90.0,90.0,1,90,0.0,90.0,90.0
14995.0,6,14,4740,7,653,2303.0,249.0,93.28571428571428,7,4087,2356.0,1514.0,583.8571428571429
322603.0,17,4,1400,4,1400,107534.33333333331,350.0,350.0,0,0,0.0,0.0,0.0
2322439.0,6,25,7573,14,3735,178649.15384615384,1514.0,266.7857142857143,11,3838,207641.3,1514.0,348.90909090909093
2993010.0,6,148,115504,83,106912,36500.12195121951,1510.0,1288.0963855421687,65,8592,42023.421875,1510.0,132.1846153846154
120027365.0,17,29,13785,29,13785,4286691.607142857,501.0,475.3448275862069,0,0,0.0,0.0,0.0
318.0,17,2,174,1,79,0.0,79.0,79.0,1,95,0.0,95.0,95.0
2409.0,17,4,344,2,150,0.0,75.0,75.0,2,194,0.0,103.0,97.0
115898919.0,17,16,1212,8,606,16534112.42857143,174.0,75.75,8,606,16507467.142857144,174.0,75.75
107374.0,17,2,700,2,700,0.0,350.0,350.0,0,0,0.0,0.0,0.0
322235.0,17,6,2100,6,2100,64447.0,350.0,350.0,0,0,0.0,0.0,0.0
0.0,17,1,72,1,72,0.0,72.0,72.0,0,0,0.0,0.0,0.0
90037755.0,17,28,13364,28,13364,3334731.6666666665,501.0,477.2857142857143,0,0,0.0,0.0,0.0
41237.0,6,14,4740,7,653,6272.0,249.0,93.28571428571428,7,4087,6740.666666666667,1514.0,583.8571428571429
321150.0,17,4,1400,4,1400,107050.0,350.0,350.0,0,0,0.0,0.0,0.0
10486777.0,6,7,478,4,272,3449979.6666666665,74.0,68.0,3,206,5174897.0,74.0,68.66666666666667
108111040.0,17,5,1005,5,1005,27027760.0,201.0,201.0,0,0,0.0,0.0,0.0
90211594.0,6,16,1192,8,596,12852828.857142856,95.0,74.5,8,596,12858103.285714284,95.0,74.5
14663647.0,6,20,1607,10,975,1592784.2222222222,315.0,97.5,10,632,1592417.888888889,78.0,63.2
119975583.0,6,25,1883,12,894,10885322.090909092,95.0,74.5,13,989,9983326.5,95.0,76.07692307692308
205805.0,6,3,426,2,280,0.0,214.0,140.0,1,146,0.0,146.0,146.0
302368.0,6,2,132,1,66,0.0,66.0,66.0,1,66,0.0,66.0,66.0
5623678.0,6,5,336,2,134,0.0,68.0,67.0,3,202,1526553.0,70.0,67.33333333333333
108098305.0,17,5,955,5,955,27024576.25,191.0,191.0,0,0,0.0,0.0,0.0
312430.0,17,4,1400,4,1400,104143.33333333331,350.0,350.0,0,0,0.0,0.0,0.0
0.0,17,1,88,1,88,0.0,88.0,88.0,0,0,0.0,0.0,0.0
135138948.0,17,6,1206,6,1206,27027789.6,201.0,201.0,0,0,0.0,0.0,0.0
9316.0,17,2,498,1,80,0.0,80.0,80.0,1,418,0.0,418.0,418.0
158497.0,6,3,337,2,214,0.0,160.0,107.0,1,123,0.0,123.0,123.0
309261.0,6,6,412,4,272,103087.0,74.0,68.0,2,140,0.0,74.0,70.0
116459003.0,6,195,22048,98,6764,1200608.2783505155,140.0,69.0204081632653,97,15284,1191672.03125,284.0,157.56701030927834
120211863.0,6,33,3533,16,1865,7999707.666666667,360.0,116.5625,17,1668,7497293.5,426.0,98.11764705882354
97133382.0,17,14,1126,7,563,16162265.333333334,174.0,80.42857142857143,7,563,16113829.333333334,174.0,80.42857142857143
90091619.0,6,14,2098,8,1138,12870231.285714284,188.0,142.25,6,960,12011670.4,204.0,160.0
332.0,17,2,166,1,75,0.0,75.0,75.0,1,91,0.0,91.0,91.0
237784.0,17,2,180,1,90,0.0,90.0,90.0,1,90,0.0,90.0,90.0
18697.0,6,14,4740,7,653,2920.833333333333,249.0,93.28571428571428,7,4087,2976.0,1514.0,583.8571428571429
34380.0,6,14,4740,7,653,5578.166666666667,249.0,93.28571428571428,7,4087,5424.666666666667,1514.0,583.8571428571429
1971.0,17,2,180,1,90,0.0,90.0,90.0,1,90,0.0,90.0,90.0
26115.0,6,14,4740,7,653,4231.833333333333,249.0,93.28571428571428,7,4087,3912.5,1514.0,583.8571428571429
14968.0,17,2,180,1,90,0.0,90.0,90.0,1,90,0.0,90.0,90.0
145196.0,17,2,180,1,70,0.0,70.0,70.0,1,110,0.0,110.0,110.0
3404736.0,6,7,923,4,753,1062544.0,571.0,188.25,3,170,1594150.0,62.0,56.66666666666666
159993.0,6,2,128,1,74,0.0,74.0,74.0,1,54,0.0,54.0,54.0
103453739.0,6,43,2838,22,1452,4912036.095238095,66.0,66.0,21,1386,5150434.7,66.0,66.0
205647.0,17,2,762,2,762,0.0,381.0,381.0,0,0,0.0,0.0,0.0
108114826.0,17,5,1005,5,1005,27028706.5,201.0,201.0,0,0,0.0,0.0,0.0
9486.0,17,2,539,1,86,0.0,86.0,86.0,1,453,0.0,453.0,453.0
23397.0,6,10,2032,5,524,5625.75,252.0,104.8,5,1508,5456.5,1236.0,301.6
90943581.0,6,21,1585,11,840,9093745.7,95.0,76.36363636363636,10,745,10103793.555555556,95.0,74.5
102846.0,17,2,286,2,286,0.0,143.0,143.0,0,0,0.0,0.0,0.0
104350226.0,6,26,1746,13,840,8695852.166666666,123.0,64.61538461538461,13,906,7845638.916666667,123.0,69.6923076923077
4454.0,17,2,180,1,90,0.0,90.0,90.0,1,90,0.0,90.0,90.0
2345.0,17,4,344,2,150,0.0,75.0,75.0,2,194,0.0,103.0,97.0
197036.0,17,2,180,1,90,0.0,90.0,90.0,1,90,0.0,90.0,90.0
5625514.0,6,5,336,2,134,0.0,68.0,67.0,3,202,1525076.0,70.0,67.33333333333333
323.0,17,2,174,1,79,0.0,79.0,79.0,1,95,0.0,95.0,95.0
61434.0,6,10,2032,5,524,13781.25,252.0,104.8,5,1508,14937.25,1236.0,301.6
326.0,17,2,166,1,75,0.0,75.0,75.0,1,91,0.0,91.0,91.0
68934.0,6,14,4740,7,653,10008.833333333334,249.0,93.28571428571428,7,4087,9709.666666666666,1514.0,583.8571428571429
62392.0,6,14,4740,7,653,10179.0,249.0,93.28571428571428,7,4087,9145.666666666666,1514.0,583.8571428571429
41260.0,6,14,4740,7,653,6197.666666666667,249.0,93.28571428571428,7,4087,6611.833333333333,1514.0,583.8571428571429
90069959.0,17,28,13364,28,13364,3335924.407407407,501.0,477.2857142857143,0,0,0.0,0.0,0.0
102718.0,17,2,700,2,700,0.0,350.0,350.0,0,0,0.0,0.0,0.0
196841.0,17,2,180,1,90,0.0,90.0,90.0,1,90,0.0,90.0,90.0
13110.0,6,10,2032,5,524,3046.0,252.0,104.8,5,1508,3024.75,1236.0,301.6
42734.0,6,14,4740,7,653,6885.5,249.0,93.28571428571428,7,4087,6911.0,1514.0,583.8571428571429
120373718.0,6,207,23502,104,16482,1168676.8737864078,284.0,158.48076923076923,103,7020,1159741.4607843135,140.0,68.15533980582525
20185.0,6,2,145,2,145,0.0,91.0,72.5,0,0,0.0,0.0,0.0
308369.0,6,6,412,4,272,102789.66666666669,74.0,68.0,2,140,0.0,74.0,70.0
115401647.0,6,33,2290,17,1125,7212576.875,123.0,66.17647058823529,16,1165,7027755.066666666,139.0,72.8125
120489383.0,6,221,25310,111,17754,1095358.027272727,442.0,159.94594594594594,110,7556,1094546.0917431193,140.0,68.69090909090909
2373.0,17,4,344,2,150,0.0,75.0,75.0,2,194,0.0,103.0,97.0
20924027.0,17,3,1034,2,684,0.0,342.0,342.0,1,350,0.0,350.0,350.0
207141.0,6,3,426,2,280,0.0,214.0,140.0,1,146,0.0,146.0,146.0
148039.0,17,2,180,1,90,0.0,90.0,90.0,1,90,0.0,90.0,90.0
1158159.0,6,13,3010,8,2382,165451.2857142857,1514.0,297.75,5,628,221406.0,331.0,125.6
531606.0,17,6,2100,6,2100,106321.2,350.0,350.0,0,0,0.0,0.0,0.0
108109483.0,17,5,955,5,955,27027370.75,191.0,191.0,0,0,0.0,0.0,0.0
5339.0,17,4,344,2,150,0.0,75.0,75.0,2,194,0.0,103.0,97.0
1297629.0,6,4,264,2,132,0.0,66.0,66.0,2,132,0.0,66.0,66.0
246344.0,6,3,337,2,214,0.0,160.0,107.0,1,123,0.0,123.0,123.0
302333.0,6,2,132,1,66,0.0,66.0,66.0,1,66,0.0,66.0,66.0
96270751.0,17,14,1126,7,563,16000176.666666666,174.0,80.42857142857143,7,563,16000983.166666666,174.0,80.42857142857143
233009.0,6,3,337,2,214,0.0,160.0,107.0,1,123,0.0,123.0,123.0
60598.0,6,13,1479,7,882,9224.333333333334,291.0,126.0,6,597,9502.6,259.0,99.5
246044.0,6,10,1221,6,636,49208.8,298.0,106.0,4,585,76631.33333333333,379.0,146.25
98000799.0,17,11,735,6,389,19600159.8,174.0,64.83333333333333,5,346,19501175.5,174.0,69.2
110305612.0,6,203,23054,102,16154,1092134.7722772278,284.0,158.37254901960785,101,6900,1092552.53,140.0,68.31683168316832
108106105.0,17,5,955,5,955,27026526.25,191.0,191.0,0,0,0.0,0.0,0.0
155935.0,17,2,414,1,88,0.0,88.0,88.0,1,326,0.0,326.0,326.0
121151027.0,6,30,2037,15,948,8416031.714285715,123.0,63.2,15,1089,7940409.142857143,123.0,72.6
146738.0,6,3,373,2,238,0.0,172.0,119.0,1,135,0.0,135.0,135.0
319.0,17,2,174,1,79,0.0,79.0,79.0,1,95,0.0,95.0,95.0
2341.0,17,4,344,2,150,0.0,75.0,75.0,2,194,0.0,103.0,97.0
46446.0,6,2,145,2,145,0.0,91.0,72.5,0,0,0.0,0.0,0.0
309924.0,6,6,412,4,272,103308.0,74.0,68.0,2,140,0.0,74.0,70.0
106930.0,17,2,286,2,286,0.0,143.0,143.0,0,0,0.0,0.0,0.0
146819.0,6,4,439,2,238,0.0,172.0,119.0,2,201,0.0,135.0,100.5
108109120.0,17,5,1005,5,1005,27027280.0,201.0,201.0,0,0,0.0,0.0,0.0
19240.0,6,14,4740,7,653,2678.0,249.0,93.28571428571428,7,4087,2911.333333333333,1514.0,583.8571428571429
307686.0,6,6,412,4,272,102562.0,74.0,68.0,2,140,0.0,74.0,70.0
298254.0,6,6,412,4,272,99418.0,74.0,68.0,2,140,0.0,74.0,70.0
118892882.0,17,14,864,7,432,19667714.666666668,174.0,61.71428571428572,7,432,19666836.0,174.0,61.71428571428572
2051.0,17,4,344,2,150,0.0,75.0,75.0,2,194,0.0,103.0,97.0
90212827.0,6,16,1192,8,596,12852313.142857144,95.0,74.5,8,596,12856704.714285716,95.0,74.5
2594186.0,6,2,132,1,66,0.0,66.0,66.0,1,66,0.0,66.0,66.0
108101890.0,17,5,955,5,955,27025472.5,191.0,191.0,0,0,0.0,0.0,0.0
53482.0,6,14,4740,7,653,8716.5,249.0,93.28571428571428,7,4087,7740.0,1514.0,583.8571428571429
108095724.0,17,5,955,5,955,27023931.0,191.0,191.0,0,0,0.0,0.0,0.0
336.0,17,2,174,1,79,0.0,79.0,79.0,1,95,0.0,95.0,95.0
3105721.0,6,3,204,2,136,0.0,70.0,68.0,1,68,0.0,68.0,68.0
233192.0,6,3,337,2,214,0.0,160.0,107.0,1,123,0.0,123.0,123.0
2410.0,17,4,344,2,150,0.0,75.0,75.0,2,194,0.0,103.0,97.0
308344.0,6,6,412,4,272,102781.33333333331,74.0,68.0,2,140,0.0,74.0,70.0
247299.0,6,3,337,2,214,0.0,160.0,107.0,1,123,0.0,123.0,123.0
543469.0,6,2,132,1,66,0.0,66.0,66.0,1,66,0.0,66.0,66.0
290737.0,17,2,620,1,75,0.0,75.0,75.0,1,545,0.0,545.0,545.0
108109483.0,17,5,1005,5,1005,27027370.75,201.0,201.0,0,0,0.0,0.0,0.0
90805676.0,6,19,1436,10,745,10083784.888888888,95.0,74.5,9,691,11349806.875,95.0,76.77777777777777
90095566.0,6,12,1848,5,1020,22523160.5,204.0,204.0,7,828,15015525.0,188.0,118.28571428571428
90292684.0,6,16,1192,8,596,12892743.57142857,95.0,74.5,8,596,12897604.0,95.0,74.5
90534686.0,6,13,2036,8,1016,12933526.57142857,188.0,127.0,5,1020,22591430.25,204.0,204.0
51160.0,17,2,180,1,90,0.0,90.0,90.0,1,90,0.0,90.0,90.0
213832.0,17,2,180,1,90,0.0,90.0,90.0,1,90,0.0,90.0,90.0
303152.0,6,2,132,1,66,0.0,66.0,66.0,1,66,0.0,66.0,66.0
90523232.0,6,17,2572,9,1204,11315404.0,188.0,133.77777777777777,8,1368,12908601.285714284,204.0,171.0
289.0,17,2,156,1,78,0.0,78.0,78.0,1,78,0.0,78.0,78.0
317882.0,17,4,1400,4,1400,105960.66666666669,350.0,350.0,0,0,0.0,0.0,0.0
135133611.0,17,6,1146,6,1146,27026722.2,191.0,191.0,0,0,0.0,0.0,0.0
10493159.0,6,7,478,4,272,3452079.0,74.0,68.0,3,206,5178028.5,74.0,68.66666666666667
123839808.0,6,49,3234,25,1650,5159992.0,66.0,66.0,24,1584,4996406.739130435,66.0,66.0
207251.0,17,2,762,2,762,0.0,381.0,381.0,0,0,0.0,0.0,0.0
95575558.0,17,14,1126,7,563,15929259.666666666,174.0,80.42857142857143,7,563,15834813.0,174.0,80.42857142857143
135136720.0,17,6,1146,6,1146,27027344.0,191.0,191.0,0,0,0.0,0.0,0.0
110973052.0,6,32,2236,16,1165,7383820.533333333,139.0,72.8125,16,1071,7383824.733333333,123.0,66.9375
103024.0,17,2,286,2,286,0.0,143.0,143.0,0,0,0.0,0.0,0.0
66108.0,6,16,5719,9,753,8263.5,217.0,83.66666666666667,7,4966,10360.5,1514.0,709.4285714285714
35467.0,6,2,132,1,66,0.0,66.0,66.0,1,66,0.0,66.0,66.0
2367.0,17,4,344,2,150,0.0,75.0,75.0,2,194,0.0,103.0,97.0
2385204.0,6,49,23728,25,19797,99383.5,1514.0,791.88,24,3931,93974.0,1514.0,163.79166666666666
120129077.0,6,14,2224,9,1204,15016134.625,188.0,133.77777777777777,5,1020,22523954.75,204.0,204.0
42002.0,6,10,2032,5,524,10205.75,252.0,104.8,5,1508,9831.25,1236.0,301.6
216392.0,17,2,180,1,90,0.0,90.0,90.0,1,90,0.0,90.0,90.0
108105397.0,17,5,955,5,955,27026349.25,191.0,191.0,0,0,0.0,0.0,0.0
147969.0,17,2,180,1,90,0.0,90.0,90.0,1,90,0.0,90.0,90.0
320.0,17,2,174,1,79,0.0,79.0,79.0,1,95,0.0,95.0,95.0
147941.0,17,2,180,1,90,0.0,90.0,90.0,1,90,0.0,90.0,90.0
3632.0,17,4,438,2,148,0.0,74.0,74.0,2,290,0.0,147.0,145.0
314809.0,6,10,1221,6,636,62961.8,298.0,106.0,4,585,99522.33333333331,379.0,146.25
153416.0,17,2,180,1,90,0.0,90.0,90.0,1,90,0.0,90.0,90.0
16191.0,6,10,2032,5,524,3766.25,252.0,104.8,5,1508,3661.25,1236.0,301.6
309705.0,17,4,1400,4,1400,103235.0,350.0,350.0,0,0,0.0,0.0,0.0
420844.0,6,3,204,2,136,0.0,70.0,68.0,1,68,0.0,68.0,68.0
309362.0,17,2,246,1,76,0.0,76.0,76.0,1,170,0.0,170.0,170.0
783.0,17,4,438,2,148,0.0,74.0,74.0,2,290,0.0,147.0,145.0
335.0,17,2,166,1,75,0.0,75.0,75.0,1,91,0.0,91.0,91.0
123758659.0,6,34,2472,18,1332,7279921.117647059,123.0,74.0,16,1140,7570466.666666667,123.0,71.25
772.0,17,4,438,2,148,0.0,74.0,74.0,2,290,0.0,147.0,145.0
112180258.0,6,207,23396,104,7086,1089128.718446602,140.0,68.13461538461539,103,16310,1089674.068627451,284.0,158.3495145631068
3012917.0,6,11,2106,6,598,601841.2,252.0,99.66666666666669,5,1508,2960.25,1236.0,301.6
215808.0,6,10,1221,6,636,43161.6,298.0,106.0,4,585,69711.0,379.0,146.25
4405513.0,6,19,1553,9,921,511728.75,315.0,102.33333333333331,10,632,454837.3333333333,78.0,63.2
9908.0,6,10,1067,5,536,2142.5,264.0,107.2,5,531,2052.0,259.0,106.2
1644830.0,17,6,1230,3,234,822231.5,78.0,78.0,3,996,822140.5,332.0,332.0
120179497.0,6,242,27506,121,8208,994443.2083333334,140.0,67.83471074380165,121,19298,994610.6,284.0,159.48760330578511
106770741.0,6,31,2182,16,1165,7103635.533333333,139.0,72.8125,15,1017,7611015.071428572,123.0,67.8
4386.0,17,2,614,1,72,0.0,72.0,72.0,1,542,0.0,542.0,542.0
196800.0,17,2,180,1,90,0.0,90.0,90.0,1,90,0.0,90.0,90.0
209568.0,17,2,180,1,90,0.0,90.0,90.0,1,90,0.0,90.0,90.0
2806204.0,6,2,132,1,66,0.0,66.0,66.0,1,66,0.0,66.0,66.0
135137083.0,17,6,1206,6,1206,27027416.6,201.0,201.0,0,0,0.0,0.0,0.0
206027.0,6,3,426,2,280,0.0,214.0,140.0,1,146,0.0,146.0,146.0
2331.0,17,4,344,2,150,0.0,75.0,75.0,2,194,0.0,103.0,97.0
108102663.0,17,5,955,5,955,27025665.75,191.0,191.0,0,0,0.0,0.0,0.0
379581.0,17,2,363,1,75,0.0,75.0,75.0,1,288,0.0,288.0,288.0
37684.0,6,14,4740,7,653,5731.5,249.0,93.28571428571428,7,4087,6059.166666666667,1514.0,583.8571428571429
113617277.0,6,46,3036,23,1518,5150438.954545454,66.0,66.0,23,1518,5150440.5,66.0,66.0
2378.0,17,4,344,2,150,0.0,75.0,75.0,2,194,0.0,103.0,97.0
123440554.0,6,35,2394,18,1269,7261209.05882353,123.0,70.5,17,1125,7078200.1875,123.0,66.17647058823529
107056.0,17,2,286,2,286,0.0,143.0,143.0,0,0,0.0,0.0,0.0
258806.0,6,10,1221,6,636,51761.2,298.0,106.0,4,585,80865.33333333333,379.0,146.25
44019.0,6,10,2032,5,524,9174.0,252.0,104.8,5,1508,9965.0,1236.0,301.6
125626.0,17,4,1400,4,1400,41875.333333333336,350.0,350.0,0,0,0.0,0.0,0.0
90020944.0,17,28,13364,28,13364,3334109.037037037,501.0,477.2857142857143,0,0,0.0,0.0,0.0
3212316.0,6,3,1604,1,753,0.0,753.0,753.0,2,851,0.0,785.0,425.5
90290118.0,6,16,1192,8,596,12892141.857142856,95.0,74.5,8,596,12898229.57142857,95.0,74.5
107617541.0,6,27,1800,14,894,8278238.384615385,123.0,63.85714285714285,13,906,8136079.25,123.0,69.6923076923077
132202.0,6,2,132,1,66,0.0,66.0,66.0,1,66,0.0,66.0,66.0
47589.0,6,14,4740,7,653,7807.833333333333,249.0,93.28571428571428,7,4087,7351.666666666667,1514.0,583.8571428571429
31889.0,6,10,2032,5,524,7535.25,252.0,104.8,5,1508,7154.25,1236.0,301.6
161303.0,17,2,180,1,90,0.0,90.0,90.0,1,90,0.0,90.0,90.0
398.0,17,2,267,1,83,0.0,83.0,83.0,1,184,0.0,184.0,184.0
2418.0,17,4,344,2,150,0.0,75.0,75.0,2,194,0.0,103.0,97.0
135129628.0,17,6,1146,6,1146,27025925.6,191.0,191.0,0,0,0.0,0.0,0.0
228190.0,17,2,180,1,90,0.0,90.0,90.0,1,90,0.0,90.0,90.0
243424.0,6,3,373,2,238,0.0,172.0,119.0,1,135,0.0,135.0,135.0
16262675.000000002,17,6,2052,6,2052,3252535.0,342.0,342.0,0,0,0.0,0.0,0.0
90097115.0,6,13,2052,6,1224,18018937.2,204.0,204.0,7,828,15015497.5,188.0,118.28571428571428
269039.0,17,2,180,1,90,0.0,90.0,90.0,1,90,0.0,90.0,90.0
90259001.0,6,13,2036,8,1016,12894143.0,188.0,127.0,5,1020,22523528.25,204.0,204.0
147403.0,6,3,373,2,238,0.0,172.0,119.0,1,135,0.0,135.0,135.0
104654.0,17,2,286,2,286,0.0,143.0,143.0,0,0,0.0,0.0,0.0
216741.0,6,10,1221,6,636,43348.2,298.0,106.0,4,585,70936.33333333333,379.0,146.25
155189.0,17,4,1400,4,1400,51729.66666666666,350.0,350.0,0,0,0.0,0.0,0.0
153482.0,17,2,180,1,90,0.0,90.0,90.0,1,90,0.0,90.0,90.0
232365.0,6,3,337,2,214,0.0,160.0,107.0,1,123,0.0,123.0,123.0
21804.0,6,11,1133,6,602,3921.6,264.0,100.33333333333331,5,531,4401.5,259.0,106.2
144964.0,17,2,180,1,70,0.0,70.0,70.0,1,110,0.0,110.0,110.0
224468.0,6,4,492,2,280,0.0,214.0,140.0,2,212,0.0,146.0,106.0
143.0,17,2,762,2,762,0.0,381.0,381.0,0,0,0.0,0.0,0.0
131200.0,6,3,337,2,214,0.0,160.0,107.0,1,123,0.0,123.0,123.0
131627.0,6,4,439,2,238,0.0,172.0,119.0,2,201,0.0,135.0,100.5
302352.0,6,2,132,1,66,0.0,66.0,66.0,1,66,0.0,66.0,66.0
120124129.0,6,14,2224,9,1204,15015516.125,188.0,133.77777777777777,5,1020,22522960.0,204.0,204.0
202739.0,17,2,762,2,762,0.0,381.0,381.0,0,0,0.0,0.0,0.0
109368626.0,6,196,22108,98,15418,1125292.7731958765,284.0,157.3265306122449,98,6690,1125292.93814433,140.0,68.26530612244898
469.0,17,2,508,2,508,0.0,257.0,254.0,0,0,0.0,0.0,0.0
348.0,17,2,267,1,83,0.0,83.0,83.0,1,184,0.0,184.0,184.0
270255.0,6,10,1221,6,636,54051.0,298.0,106.0,4,585,84710.66666666667,379.0,146.25
4362.0,17,2,614,1,72,0.0,72.0,72.0,1,542,0.0,542.0,542.0
143865.0,17,2,180,1,90,0.0,90.0,90.0,1,90,0.0,90.0,90.0
2322.0,17,4,344,2,150,0.0,75.0,75.0,2,194,0.0,103.0,97.0
12424922.0,6,8,602,5,404,1926536.5,103.0,80.8,3,198,2510634.0,66.0,66.0
46674.0,6,13,1479,7,882,7346.0,291.0,126.0,6,597,7458.8,259.0,99.5
303116.0,6,2,132,1,66,0.0,66.0,66.0,1,66,0.0,66.0,66.0
228133.0,17,2,180,1,90,0.0,90.0,90.0,1,90,0.0,90.0,90.0
604611.0,17,3,551,2,156,0.0,78.0,78.0,1,395,0.0,395.0,395.0
242212.0,6,3,337,2,214,0.0,160.0,107.0,1,123,0.0,123.0,123.0
90012743.0,17,28,13364,28,13364,3333805.296296296,501.0,477.2857142857143,0,0,0.0,0.0,0.0
90032187.0,17,27,12943,27,12943,3462776.423076923,501.0,479.3703703703704,0,0,0.0,0.0,0.0
303875.0,6,3,202,2,128,0.0,74.0,64.0,1,74,0.0,74.0,74.0
10522202.0,6,7,478,4,272,3461767.6666666665,74.0,68.0,3,206,5192520.0,74.0,68.66666666666667
108108385.0,17,5,1005,5,1005,27027096.25,201.0,201.0,0,0,0.0,0.0,0.0
2351.0,17,4,344,2,150,0.0,75.0,75.0,2,194,0.0,103.0,97.0
40871.0,6,14,4740,7,653,6688.833333333333,249.0,93.28571428571428,7,4087,6560.0,1514.0,583.8571428571429
108106882.0,17,5,955,5,955,27026720.5,191.0,191.0,0,0,0.0,0.0,0.0
404824.0,6,4,508,2,238,0.0,172.0,119.0,2,270,0.0,135.0,135.0
2814402.0,6,2,132,1,66,0.0,66.0,66.0,1,66,0.0,66.0,66.0
285.0,17,2,168,1,76,0.0,76.0,76.0,1,92,0.0,92.0,92.0
112450.0,6,12,1447,6,816,21520.4,291.0,136.0,6,631,21684.6,293.0,105.16666666666669
2797912.0,6,2,132,1,66,0.0,66.0,66.0,1,66,0.0,66.0,66.0
146996.0,6,3,373,2,238,0.0,172.0,119.0,1,135,0.0,135.0,135.0
107734.0,17,2,286,2,286,0.0,143.0,143.0,0,0,0.0,0.0,0.0
721.0,17,4,438,2,148,0.0,74.0,74.0,2,290,0.0,147.0,145.0
36742.0,6,10,2032,5,524,8092.5,252.0,104.8,5,1508,8878.0,1236.0,301.6
2663223.0,6,25,7573,14,3735,204863.3076923077,1514.0,266.7857142857143,11,3838,239708.2,1514.0,348.90909090909093
216355.0,17,2,180,1,90,0.0,90.0,90.0,1,90,0.0,90.0,90.0
302726.0,6,6,412,4,272,100908.66666666669,74.0,68.0,2,140,0.0,74.0,70.0
2293.0,17,4,344,2,150,0.0,75.0,75.0,2,194,0.0,103.0,97.0
57496.0,6,10,2032,5,524,14124.0,252.0,104.8,5,1508,13228.5,1236.0,301.6
218279.0,17,2,180,1,90,0.0,90.0,90.0,1,90,0.0,90.0,90.0
121139316.0,6,220,24884,110,7482,1094396.9724770642,140.0,68.01818181818182,110,17402,1094436.2018348624,284.0,158.2
121186.0,6,3,337,2,214,0.0,160.0,107.0,1,123,0.0,123.0,123.0
303068.0,6,6,412,4,272,101022.66666666669,74.0,68.0,2,140,0.0,74.0,70.0
2625.0,17,4,344,2,150,0.0,75.0,75.0,2,194,0.0,103.0,97.0
94047080.0,6,18,1477,9,650,11755885.0,95.0,72.22222222222223,9,827,11723087.0,231.0,91.88888888888889
120067619.0,17,29,13785,29,13785,4288129.25,501.0,475.3448275862069,0,0,0.0,0.0,0.0
10100.0,6,11,2098,6,590,1881.0,252.0,98.33333333333331,5,1508,1634.25,1236.0,301.6
10560052.0,6,7,478,4,272,3472765.0,74.0,68.0,3,206,5208974.0,74.0,68.66666666666667
49327.0,6,10,1066,5,490,11292.5,218.0,98.0,5,576,11503.0,304.0,115.2
2959775.0,6,3,1777,2,951,0.0,885.0,475.5,1,826,0.0,826.0,826.0
206999.0,17,2,180,1,90,0.0,90.0,90.0,1,90,0.0,90.0,90.0
6577.0,17,4,438,2,148,0.0,74.0,74.0,2,290,0.0,147.0,145.0
2277.0,17,2,691,1,349,0.0,349.0,349.0,1,342,0.0,342.0,342.0
1061464.0,6,12,2710,7,742,176910.66666666666,338.0,106.0,5,1968,196477.5,1514.0,393.6
120121240.0,6,14,2224,9,1204,15015155.0,188.0,133.77777777777777,5,1020,22523430.0,204.0,204.0
96492.0,6,14,4740,7,653,14734.166666666666,249.0,93.28571428571428,7,4087,15515.5,1514.0,583.8571428571429
1892895.0,6,27,7945,14,3957,145607.3076923077,1514.0,282.6428571428572,13,3988,131753.0,1514.0,306.7692307692308
329.0,17,2,174,1,79,0.0,79.0,79.0,1,95,0.0,95.0,95.0
29376.0,6,14,4740,7,653,4786.333333333333,249.0,93.28571428571428,7,4087,4699.333333333333,1514.0,583.8571428571429
248672.0,6,3,373,2,238,0.0,172.0,119.0,1,135,0.0,135.0,135.0
99424015.0,6,28,2008,14,963,7648001.153846154,123.0,68.78571428571429,14,1045,6863280.692307692,139.0,74.64285714285714
103123.0,17,2,286,2,286,0.0,143.0,143.0,0,0,0.0,0.0,0.0
968006.0,6,4,264,2,132,0.0,66.0,66.0,2,132,0.0,66.0,66.0
2313462.0,6,3,1604,2,851,0.0,785.0,425.5,1,753,0.0,753.0,753.0
238495.0,6,3,337,2,214,0.0,160.0,107.0,1,123,0.0,123.0,123.0
10484748.0,6,7,478,4,272,3449549.333333333,74.0,68.0,3,206,5174213.5,74.0,68.66666666666667
32132.0,6,10,2032,5,524,7793.75,252.0,104.8,5,1508,7692.5,1236.0,301.6
263487.0,6,12,1373,7,714,43914.5,298.0,102.0,5,659,61844.5,379.0,131.8
0.0,6,1,66,1,66,0.0,66.0,66.0,0,0,0.0,0.0,0.0
205931.0,6,3,426,2,280,0.0,214.0,140.0,1,146,0.0,146.0,146.0
104676.0,17,2,700,2,700,0.0,350.0,350.0,0,0,0.0,0.0,0.0
5005298.0,17,4,849,2,166,0.0,83.0,83.0,2,683,0.0,499.0,341.5
24338.0,6,10,2032,5,524,5379.25,252.0,104.8,5,1508,5840.5,1236.0,301.6
54055986.0,17,3,603,3,603,27027993.0,201.0,201.0,0,0,0.0,0.0,0.0
2518699.0,6,30,9358,17,3897,157418.6875,1514.0,229.23529411764707,13,5461,188822.16666666663,1514.0,420.0769230769231
1172028.0,6,13,3000,8,2372,167432.57142857142,1514.0,296.5,5,628,224879.0,331.0,125.6
341.0,17,2,166,1,75,0.0,75.0,75.0,1,91,0.0,91.0,91.0
863140.0,6,9,1270,6,799,172628.0,461.0,133.16666666666666,3,471,293729.5,331.0,157.0
44537.0,6,14,4740,7,653,6423.333333333333,249.0,93.28571428571428,7,4087,5400.0,1514.0,583.8571428571429
2676831.0,6,3,204,2,136,0.0,70.0,68.0,1,68,0.0,68.0,68.0
110304.0,17,2,286,2,286,0.0,143.0,143.0,0,0,0.0,0.0,0.0
135119977.0,17,6,1206,6,1206,27023995.4,201.0,201.0,0,0,0.0,0.0,0.0
117254710.0,6,47,3102,24,1584,5086067.347826087,66.0,66.0,23,1518,5135432.409090909,66.0,66.0
307273.0,6,6,412,4,272,102424.33333333331,74.0,68.0,2,140,0.0,74.0,70.0
147285.0,6,3,373,2,238,0.0,172.0,119.0,1,135,0.0,135.0,135.0
214030.0,6,10,1221,6,636,42806.0,298.0,106.0,4,585,70182.33333333333,379.0,146.25
43621.0,6,2,132,1,66,0.0,66.0,66.0,1,66,0.0,66.0,66.0
91878545.0,6,27,2073,15,1138,6562626.214285715,95.0,75.86666666666666,12,935,8351897.272727272,95.0,77.91666666666667
135134064.0,17,6,1146,6,1146,27026812.8,191.0,191.0,0,0,0.0,0.0,0.0
14088.0,17,4,344,2,150,0.0,75.0,75.0,2,194,0.0,103.0,97.0
122199.0,6,11,2098,6,590,24223.2,252.0,98.33333333333331,5,1508,29436.5,1236.0,301.6
2129.0,17,4,344,2,150,0.0,75.0,75.0,2,194,0.0,103.0,97.0
156648.0,6,3,337,2,214,0.0,160.0,107.0,1,123,0.0,123.0,123.0
98379322.0,17,12,778,6,389,19601063.6,174.0,64.83333333333333,6,389,19600168.2,174.0,64.83333333333333
97419920.0,6,25,1686,13,840,8118326.666666667,123.0,64.61538461538461,12,846,7929017.818181818,123.0,70.5
40612.0,6,14,4740,7,653,6644.666666666667,249.0,93.28571428571428,7,4087,6143.833333333333,1514.0,583.8571428571429
58994.0,6,10,2032,5,524,14528.0,252.0,104.8,5,1508,13918.5,1236.0,301.6
13204.0,6,10,2032,5,524,3055.75,252.0,104.8,5,1508,3049.25,1236.0,301.6
257172.0,6,3,337,2,214,0.0,160.0,107.0,1,123,0.0,123.0,123.0
20191.0,6,10,2032,5,524,4835.0,252.0,104.8,5,1508,4428.25,1236.0,301.6
26492.0,6,10,2032,5,524,6392.25,252.0,104.8,5,1508,6162.75,1236.0,301.6
148029.0,17,2,180,1,90,0.0,90.0,90.0,1,90,0.0,90.0,90.0
13608.0,6,14,4740,7,653,2019.8333333333333,249.0,93.28571428571428,7,4087,2125.333333333333,1514.0,583.8571428571429
120124423.0,6,13,2036,5,1020,30031105.75,204.0,204.0,8,1016,17137125.42857143,188.0,127.0
90042087.0,17,28,13364,28,13364,3334892.111111111,501.0,477.2857142857143,0,0,0.0,0.0,0.0
2311.0,17,4,344,2,150,0.0,75.0,75.0,2,194,0.0,103.0,97.0
21959217.0,17,3,1034,2,684,0.0,342.0,342.0,1,350,0.0,350.0,350.0
2345.0,17,4,344,2,150,0.0,75.0,75.0,2,194,0.0,103.0,97.0
319494.0,17,4,1400,4,1400,106498.0,350.0,350.0,0,0,0.0,0.0,0.0
15929814.0,17,6,2052,6,2052,3185962.8,342.0,342.0,0,0,0.0,0.0,0.0
120366385.0,6,281,31636,141,22174,859759.8928571428,300.0,157.26241134751774,140,9462,858493.2446043165,140.0,67.58571428571429
379565.0,6,3,204,2,136,0.0,70.0,68.0,1,68,0.0,68.0,68.0
6006.0,17,2,447,1,84,0.0,84.0,84.0,1,363,0.0,363.0,363.0
108102853.0,17,5,1005,5,1005,27025713.25,201.0,201.0,0,0,0.0,0.0,0.0
120394676.0,6,237,26816,119,18732,1020293.8644067796,284.0,157.41176470588235,118,8084,1020407.7264957264,140.0,68.50847457627118
2739.0,17,4,344,2,150,0.0,75.0,75.0,2,194,0.0,103.0,97.0
113408296.0,6,46,3036,23,1518,5154910.636363637,66.0,66.0,23,1518,5154909.818181818,66.0,66.0
18788.0,6,14,4740,7,653,2976.1666666666665,249.0,93.28571428571428,7,4087,2996.333333333333,1514.0,583.8571428571429
216934.0,6,3,426,2,280,0.0,214.0,140.0,1,146,0.0,146.0,146.0
30705.0,6,11,2098,6,590,6069.2,252.0,98.33333333333331,5,1508,7158.5,1236.0,301.6
284348.0,17,2,365,1,80,0.0,80.0,80.0,1,285,0.0,285.0,285.0
120236216.0,6,28,2127,13,1030,9999990.583333334,95.0,79.23076923076923,15,1097,8571420.857142856,95.0,73.13333333333334
39422.0,6,14,4740,7,653,6167.0,249.0,93.28571428571428,7,4087,5917.333333333333,1514.0,583.8571428571429
4897.0,17,4,344,2,150,0.0,75.0,75.0,2,194,0.0,103.0,97.0
90710842.0,6,16,1233,8,637,12958691.714285716,95.0,79.625,8,596,8634190.57142857,95.0,74.5
46681.0,6,14,4740,7,653,7558.5,249.0,93.28571428571428,7,4087,6916.5,1514.0,583.8571428571429
90328762.0,6,17,1287,9,691,11282368.375,95.0,76.77777777777777,8,596,12837612.857142856,95.0,74.5
120037864.0,17,28,13364,28,13364,4445846.814814814,501.0,477.2857142857143,0,0,0.0,0.0,0.0
49807.0,6,14,4740,7,653,8177.333333333333,249.0,93.28571428571428,7,4087,8123.333333333333,1514.0,583.8571428571429
0.0,6,1,54,0,0,0.0,0.0,0.0,1,54,0.0,54.0,54.0
6600.0,17,2,582,1,83,0.0,83.0,83.0,1,499,0.0,499.0,499.0
875866.0,6,9,1196,6,725,175173.2,387.0,120.83333333333331,3,471,300118.0,331.0,157.0
153434.0,17,2,180,1,90,0.0,90.0,90.0,1,90,0.0,90.0,90.0
2043.0,17,4,344,2,150,0.0,75.0,75.0,2,194,0.0,103.0,97.0
193731.0,17,2,180,1,90,0.0,90.0,90.0,1,90,0.0,90.0,90.0
345.0,17,2,174,1,79,0.0,79.0,79.0,1,95,0.0,95.0,95.0
65740.0,6,10,2032,5,524,16197.5,252.0,104.8,5,1508,15743.75,1236.0,301.6
128542.0,6,11,1132,6,556,25298.2,218.0,92.66666666666669,5,576,31119.0,304.0,115.2
32724002.0,6,5,336,2,134,0.0,68.0,67.0,3,202,14961352.5,70.0,67.33333333333333
142762.0,6,2,132,1,66,0.0,66.0,66.0,1,66,0.0,66.0,66.0
101014650.0,6,29,2062,15,1017,7215301.285714285,123.0,67.8,14,1045,7002079.846153846,139.0,74.64285714285714
10436622.0,6,7,478,4,272,3432186.0,74.0,68.0,3,206,5148152.0,74.0,68.66666666666667
1242358.0,6,7,499,3,198,612790.0,66.0,66.0,4,301,402753.3333333333,103.0,75.25
450004.0,6,6,758,3,410,186689.5,172.0,136.66666666666666,3,348,165331.5,135.0,116.0
1188026.0,6,13,3020,8,2392,169718.0,1514.0,299.0,5,628,228112.0,331.0,125.6
10034.0,17,2,582,1,83,0.0,83.0,83.0,1,499,0.0,499.0,499.0
102437.0,17,2,286,2,286,0.0,143.0,143.0,0,0,0.0,0.0,0.0
0.0,6,1,172,1,172,0.0,172.0,172.0,0,0,0.0,0.0,0.0
14643220.0,6,20,1607,10,975,1592809.111111111,315.0,97.5,10,632,1592788.111111111,78.0,63.2
2873899.0,6,3,204,2,134,0.0,68.0,67.0,1,70,0.0,70.0,70.0
251470.00000000003,6,3,337,2,214,0.0,160.0,107.0,1,123,0.0,123.0,123.0
9788.0,17,2,582,1,83,0.0,83.0,83.0,1,499,0.0,499.0,499.0
0.0,6,1,172,1,172,0.0,172.0,172.0,0,0,0.0,0.0,0.0
5601808.0,6,4,270,2,134,0.0,68.0,67.0,2,136,0.0,70.0,68.0
113520266.0,6,46,3036,23,1518,5160000.7727272725,66.0,66.0,23,1518,5160000.545454546,66.0,66.0
4089513.0,6,187,152560,107,142978,38580.31132075472,1510.0,1336.2429906542056,80,9582,47549.443037974685,1510.0,119.775
2463.0,17,4,344,2,150,0.0,75.0,75.0,2,194,0.0,103.0,97.0
108116953.0,17,5,955,5,955,27029238.25,191.0,191.0,0,0,0.0,0.0,0.0
206064.0,6,3,426,2,280,0.0,214.0,140.0,1,146,0.0,146.0,146.0
14359.0,6,13,1459,7,862,2169.6666666666665,271.0,123.14285714285714,6,597,2589.4,259.0,99.5
240321.0,6,3,337,2,214,0.0,160.0,107.0,1,123,0.0,123.0,123.0
104137.0,17,2,286,2,286,0.0,143.0,143.0,0,0,0.0,0.0,0.0
108114482.0,17,5,955,5,955,27028620.5,191.0,191.0,0,0,0.0,0.0,0.0
232912.0,6,3,337,2,214,0.0,160.0,107.0,1,123,0.0,123.0,123.0
75427.0,6,14,4740,7,653,12445.666666666666,249.0,93.28571428571428,7,4087,11349.166666666666,1514.0,583.8571428571429
107721.0,17,2,286,2,286,0.0,143.0,143.0,0,0,0.0,0.0,0.0
4553.0,17,2,598,1,72,0.0,72.0,72.0,1,526,0.0,526.0,526.0
90046167.0,17,28,13364,28,13364,3335043.222222222,501.0,477.2857142857143,0,0,0.0,0.0,0.0
50936.0,17,2,180,1,90,0.0,90.0,90.0,1,90,0.0,90.0,90.0
97000834.0,17,11,735,6,389,19400166.8,174.0,64.83333333333333,5,346,19001321.0,174.0,69.2
147519.0,6,3,373,2,238,0.0,172.0,119.0,1,135,0.0,135.0,135.0
103665.0,17,2,286,2,286,0.0,143.0,143.0,0,0,0.0,0.0,0.0
90257084.0,6,12,1832,8,1016,12893869.142857144,188.0,127.0,4,816,30030985.0,204.0,204.0
148012.0,17,2,180,1,90,0.0,90.0,90.0,1,90,0.0,90.0,90.0
284392.0,17,2,363,1,79,0.0,79.0,79.0,1,284,0.0,284.0,284.0
48391.0,6,14,4740,7,653,6906.833333333333,249.0,93.28571428571428,7,4087,7881.166666666667,1514.0,583.8571428571429
321500.0,17,4,1400,4,1400,107166.66666666669,350.0,350.0,0,0,0.0,0.0,0.0
143959.0,17,2,180,1,90,0.0,90.0,90.0,1,90,0.0,90.0,90.0
120165.0,17,2,180,1,70,0.0,70.0,70.0,1,110,0.0,110.0,110.0
90284559.0,6,16,1192,8,596,12890869.285714284,95.0,74.5,8,596,12896810.857142856,95.0,74.5
207734.0,6,3,426,2,280,0.0,214.0,140.0,1,146,0.0,146.0,146.0
8798.0,6,10,2032,5,524,1985.5,252.0,104.8,5,1508,1952.5,1236.0,301.6
220008.0,6,3,426,2,280,0.0,214.0,140.0,1,146,0.0,146.0,146.0
29921.0,6,14,4740,7,653,4477.666666666667,249.0,93.28571428571428,7,4087,4848.333333333333,1514.0,583.8571428571429
337.0,17,2,168,1,76,0.0,76.0,76.0,1,92,0.0,92.0,92.0
228397.0,17,2,180,1,90,0.0,90.0,90.0,1,90,0.0,90.0,90.0
242254.0,6,3,337,2,214,0.0,160.0,107.0,1,123,0.0,123.0,123.0
119852292.0,6,16,2510,7,1428,19974991.0,204.0,204.0,9,1082,14981387.5,188.0,120.22222222222224
3260314.0,6,194,169461,117,160076,28106.1551724138,1510.0,1368.1709401709402,77,9385,38849.59210526316,1510.0,121.88311688311688
232669.0,6,3,337,2,214,0.0,160.0,107.0,1,123,0.0,123.0,123.0
14702.0,6,10,1065,5,534,2562.75,262.0,106.8,5,531,3395.75,259.0,106.2
15994444.0,17,2,684,2,684,0.0,342.0,342.0,0,0,0.0,0.0,0.0
221953.0,6,3,426,2,280,0.0,214.0,140.0,1,146,0.0,146.0,146.0
115736078.0,6,48,3168,24,1584,5032003.391304348,66.0,66.0,24,1584,5018580.478260869,66.0,66.0
5004103.0,17,4,629,2,156,0.0,78.0,78.0,2,473,0.0,268.0,236.5
33699786.0,6,5,336,2,134,0.0,68.0,67.0,3,202,15564300.5,70.0,67.33333333333333
2086676.0,6,19,6869,11,1567,208667.6,408.0,142.45454545454547,8,5302,236111.2857142857,1514.0,662.75
306861.0,6,6,412,4,272,102287.0,74.0,68.0,2,140,0.0,74.0,70.0
108110110.0,17,5,1005,5,1005,27027527.5,201.0,201.0,0,0,0.0,0.0,0.0
950286.0,6,12,1427,6,796,189019.0,271.0,132.66666666666666,6,631,187799.8,293.0,105.16666666666669
36523.0,6,14,4740,7,653,5515.5,249.0,93.28571428571428,7,4087,5258.0,1514.0,583.8571428571429
82570.0,6,14,4740,7,653,12942.0,249.0,93.28571428571428,7,4087,13150.5,1514.0,583.8571428571429
344.0,17,2,160,1,80,0.0,80.0,80.0,1,80,0.0,80.0,80.0
104770601.0,17,14,864,7,432,17334869.166666668,174.0,61.71428571428572,7,432,17333554.333333332,174.0,61.71428571428572
317406.0,17,4,1400,4,1400,105802.0,350.0,350.0,0,0,0.0,0.0,0.0
292.0,17,2,156,1,78,0.0,78.0,78.0,1,78,0.0,78.0,78.0
24782973.0,6,26,7627,14,3735,188860.38461538465,1514.0,266.7857142857143,12,3892,2234343.0,1514.0,324.3333333333333
847.0,17,4,438,2,148,0.0,74.0,74.0,2,290,0.0,147.0,145.0
149279938.0,6,22,1680,10,745,13286840.333333334,95.0,74.5,12,935,13551241.454545457,95.0,77.91666666666667
14630935.0,6,20,1648,10,1016,1591666.4444444445,315.0,101.6,10,632,1591614.4444444445,78.0,63.2
101984.0,17,2,762,2,762,0.0,381.0,381.0,0,0,0.0,0.0,0.0
27248525.0,17,5,1710,5,1710,6812131.25,342.0,342.0,0,0,0.0,0.0,0.0
33386.0,6,10,2032,5,524,7951.5,252.0,104.8,5,1508,7050.0,1236.0,301.6
316.0,17,2,166,1,75,0.0,75.0,75.0,1,91,0.0,91.0,91.0
299.0,17,2,156,1,78,0.0,78.0,78.0,1,78,0.0,78.0,78.0
228371.0,17,2,180,1,90,0.0,90.0,90.0,1,90,0.0,90.0,90.0
120064760.0,17,29,13785,29,13785,4288027.142857143,501.0,475.3448275862069,0,0,0.0,0.0,0.0
14561370.0,6,19,1594,9,962,1779130.5,315.0,106.88888888888889,10,632,1581551.0,78.0,63.2
113168318.0,6,46,3036,23,1518,5144002.318181818,66.0,66.0,23,1518,5144001.863636363,66.0,66.0
298.0,17,2,168,1,76,0.0,76.0,76.0,1,92,0.0,92.0,92.0
42325.0,6,14,4740,7,653,6759.333333333333,249.0,93.28571428571428,7,4087,6891.0,1514.0,583.8571428571429
304178.0,6,6,412,4,272,101392.66666666669,74.0,68.0,2,140,0.0,74.0,70.0
3209035.0,6,14,4740,7,653,534678.6666666666,249.0,93.28571428571428,7,4087,533907.5,1514.0,583.8571428571429
90255999.0,6,12,1832,8,1016,12893714.142857144,188.0,127.0,4,816,30031403.33333333,204.0,204.0
39850333.0,6,5,336,2,134,0.0,68.0,67.0,3,202,19856798.5,70.0,67.33333333333333
860747.0,6,9,1269,6,798,172149.4,460.0,133.0,3,471,293904.5,331.0,157.0
14642010.0,6,20,1607,10,975,1592626.0,315.0,97.5,10,632,1592599.0,78.0,63.2
120030039.0,17,28,13364,28,13364,4445557.0,501.0,477.2857142857143,0,0,0.0,0.0,0.0
15963.999999999998,6,14,4740,7,653,2013.0,249.0,93.28571428571428,7,4087,2443.333333333333,1514.0,583.8571428571429
68523.0,6,12,1328,6,731,12886.8,253.0,121.83333333333331,6,597,11461.8,259.0,99.5
302468.0,6,2,132,1,66,0.0,66.0,66.0,1,66,0.0,66.0,66.0
90256759.0,6,13,2036,8,1016,12893822.714285716,188.0,127.0,5,1020,22522927.0,204.0,204.0
150001168.0,17,36,17126,36,17126,4285747.657142857,501.0,475.72222222222223,0,0,0.0,0.0,0.0
2793371.0,6,2,132,1,66,0.0,66.0,66.0,1,66,0.0,66.0,66.0
90000830.0,17,11,735,6,389,18000166.0,174.0,64.83333333333333,5,346,20066781.75,174.0,69.2
298172.0,6,6,412,4,272,99390.66666666669,74.0,68.0,2,140,0.0,74.0,70.0
26277.0,6,11,2098,6,590,5255.4,252.0,98.33333333333331,5,1508,4579.25,1236.0,301.6
47123055.0,6,8,1307,8,1307,6731865.0,172.0,163.375,0,0,0.0,0.0,0.0
120292566.0,6,227,25706,114,17952,1064535.982300885,284.0,157.47368421052633,113,7754,1055471.6964285714,140.0,68.61946902654867
123455913.0,6,48,3168,24,1584,5138310.652173913,66.0,66.0,24,1584,5129534.652173913,66.0,66.0
105530.0,17,2,700,2,700,0.0,350.0,350.0,0,0,0.0,0.0,0.0
30155.0,17,2,180,1,90,0.0,90.0,90.0,1,90,0.0,90.0,90.0
14643591.0,6,20,1607,10,975,1592289.888888889,315.0,97.5,10,632,1592259.2222222222,78.0,63.2
108100847.0,17,5,955,5,955,27025211.75,191.0,191.0,0,0,0.0,0.0,0.0
135138058.0,17,6,1146,6,1146,27027611.6,191.0,191.0,0,0,0.0,0.0,0.0
17437.0,6,2,145,2,145,0.0,91.0,72.5,0,0,0.0,0.0,0.0
318985.0,17,4,1400,4,1400,106328.33333333331,350.0,350.0,0,0,0.0,0.0,0.0
108106352.0,17,5,955,5,955,27026588.0,191.0,191.0,0,0,0.0,0.0,0.0
120008982.0,6,20,1531,11,881,11999994.2,95.0,80.0909090909091,9,650,14942318.0,95.0,72.22222222222223
135133699.0,17,6,1206,6,1206,27026739.8,201.0,201.0,0,0,0.0,0.0,0.0
49694.0,6,14,4740,7,653,7910.833333333333,249.0,93.28571428571428,7,4087,7816.833333333333,1514.0,583.8571428571429
122314578.0,6,48,3168,24,1584,5216004.695652174,66.0,66.0,24,1584,4992269.826086956,66.0,66.0
216510.0,17,2,180,1,90,0.0,90.0,90.0,1,90,0.0,90.0,90.0
498763.0,6,5,336,2,134,0.0,68.0,67.0,3,202,191941.0,70.0,67.33333333333333
34680.0,6,14,4740,7,653,5619.833333333333,249.0,93.28571428571428,7,4087,5240.333333333333,1514.0,583.8571428571429
312.0,17,2,174,1,79,0.0,79.0,79.0,1,95,0.0,95.0,95.0
2325.0,17,4,344,2,150,0.0,75.0,75.0,2,194,0.0,103.0,97.0
91022136.0,17,12,778,6,389,18201649.6,174.0,64.83333333333333,6,389,18000156.4,174.0,64.83333333333333
108767.0,17,2,286,2,286,0.0,143.0,143.0,0,0,0.0,0.0,0.0
96719939.0,6,61,12545,30,6603,3335170.310344828,1514.0,220.1,31,5942,3215410.9,1514.0,191.67741935483872
103541.0,17,2,286,2,286,0.0,143.0,143.0,0,0,0.0,0.0,0.0
204678.0,17,2,762,2,762,0.0,381.0,381.0,0,0,0.0,0.0,0.0
6589.0,17,4,823,2,163,0.0,89.0,81.5,2,660,0.0,443.0,330.0
198044.0,17,2,180,1,90,0.0,90.0,90.0,1,90,0.0,90.0,90.0
1307653.0,6,4,264,2,132,0.0,66.0,66.0,2,132,0.0,66.0,66.0
362841.0,6,10,967,5,390,60873.75,162.0,78.0,5,577,60806.5,349.0,115.4
207404.0,6,3,426,2,280,0.0,214.0,140.0,1,146,0.0,146.0,146.0
108102095.0,17,5,1005,5,1005,27025523.75,201.0,201.0,0,0,0.0,0.0,0.0
135130836.0,17,6,1206,6,1206,27026167.2,201.0,201.0,0,0,0.0,0.0,0.0
508329.00000000006,6,4,270,2,134,0.0,68.0,67.0,2,136,0.0,70.0,68.0
146128.0,6,3,337,2,214,0.0,160.0,107.0,1,123,0.0,123.0,123.0
108108840.0,17,5,1005,5,1005,27027210.0,201.0,201.0,0,0,0.0,0.0,0.0
216767.0,6,3,426,2,280,0.0,214.0,140.0,1,146,0.0,146.0,146.0
135130084.0,17,6,1146,6,1146,27026016.8,191.0,191.0,0,0,0.0,0.0,0.0
3077240.0,6,4,270,2,134,0.0,68.0,67.0,2,136,0.0,70.0,68.0
97939.0,6,14,4740,7,653,16200.5,249.0,93.28571428571428,7,4087,15686.166666666666,1514.0,583.8571428571429
302439.0,6,2,132,1,66,0.0,66.0,66.0,1,66,0.0,66.0,66.0
53644.0,6,10,2032,5,524,11552.0,252.0,104.8,5,1508,11089.25,1236.0,301.6
90290473.0,6,21,1585,11,840,9025030.2,95.0,76.36363636363636,10,745,9952866.333333334,95.0,74.5
90049883.0,17,28,13364,28,13364,3335180.851851852,501.0,477.2857142857143,0,0,0.0,0.0,0.0
120120189.0,6,14,2224,9,1204,15015023.625,188.0,133.77777777777777,5,1020,22593589.0,204.0,204.0
148213.0,17,2,180,1,90,0.0,90.0,90.0,1,90,0.0,90.0,90.0
250139.0,6,3,337,2,214,0.0,160.0,107.0,1,123,0.0,123.0,123.0
284781.0,17,2,363,1,79,0.0,79.0,79.0,1,284,0.0,284.0,284.0
305501.0,6,6,412,4,272,101833.66666666669,74.0,68.0,2,140,0.0,74.0,70.0
55302.0,6,14,4740,7,653,8289.666666666666,249.0,93.28571428571428,7,4087,8905.0,1514.0,583.8571428571429
100722311.0,6,38,3240,22,1824,4786024.571428572,123.0,82.9090909090909,16,1416,6700435.266666667,123.0,88.5
445.0,17,2,508,2,508,0.0,257.0,254.0,0,0,0.0,0.0,0.0
90030334.0,17,28,13364,28,13364,3334456.814814815,501.0,477.2857142857143,0,0,0.0,0.0,0.0
108102821.0,17,5,1005,5,1005,27025705.25,201.0,201.0,0,0,0.0,0.0,0.0
878.0,17,4,820,2,156,0.0,78.0,78.0,2,664,0.0,332.0,332.0
852275.0,6,9,1096,6,625,170455.0,287.0,104.16666666666669,3,471,288391.5,331.0,157.0
2575051.0,6,2,132,1,66,0.0,66.0,66.0,1,66,0.0,66.0,66.0
1512.0,17,2,762,2,762,0.0,381.0,381.0,0,0,0.0,0.0,0.0
405837.0,6,3,1604,2,851,0.0,785.0,425.5,1,753,0.0,753.0,753.0
22492.0,6,2,145,2,145,0.0,91.0,72.5,0,0,0.0,0.0,0.0
10932362.0,6,8,544,4,272,3599054.0,74.0,68.0,4,272,3598972.6666666665,74.0,68.0
289.0,17,2,164,1,82,0.0,82.0,82.0,1,82,0.0,82.0,82.0
5624534.0,6,5,336,2,134,0.0,68.0,67.0,3,202,1522456.0,70.0,67.33333333333333
2330.0,17,4,344,2,150,0.0,75.0,75.0,2,194,0.0,103.0,97.0
103230.0,17,2,286,2,286,0.0,143.0,143.0,0,0,0.0,0.0,0.0
102402418.0,6,44,2904,22,1452,4876305.619047619,66.0,66.0,22,1452,4868570.523809524,66.0,66.0
146148.0,6,3,337,2,214,0.0,160.0,107.0,1,123,0.0,123.0,123.0
217824.0,6,3,426,2,280,0.0,214.0,140.0,1,146,0.0,146.0,146.0
63084.0,6,14,4740,7,653,9650.5,249.0,93.28571428571428,7,4087,10333.666666666666,1514.0,583.8571428571429
49534.0,6,14,4740,7,653,8128.833333333333,249.0,93.28571428571428,7,4087,6883.333333333333,1514.0,583.8571428571429
146521.0,6,3,337,2,214,0.0,160.0,107.0,1,123,0.0,123.0,123.0
90295019.0,6,13,2036,8,1016,12899288.42857143,188.0,127.0,5,1020,22532432.25,204.0,204.0
2479.0,17,4,344,2,150,0.0,75.0,75.0,2,194,0.0,103.0,97.0
307038.0,6,6,412,4,272,102346.0,74.0,68.0,2,140,0.0,74.0,70.0
45064.0,6,14,4740,7,653,7362.166666666667,249.0,93.28571428571428,7,4087,6573.5,1514.0,583.8571428571429
472.0,17,2,508,2,508,0.0,257.0,254.0,0,0,0.0,0.0,0.0
211268.0,17,2,180,1,90,0.0,90.0,90.0,1,90,0.0,90.0,90.0
153373.0,17,2,180,1,90,0.0,90.0,90.0,1,90,0.0,90.0,90.0
29908.0,6,14,4740,7,653,4414.166666666667,249.0,93.28571428571428,7,4087,4648.0,1514.0,583.8571428571429
2314.0,17,4,344,2,150,0.0,75.0,75.0,2,194,0.0,103.0,97.0
353866.0,6,4,508,2,238,0.0,172.0,119.0,2,270,0.0,135.0,135.0
108105130.0,17,5,1005,5,1005,27026282.5,201.0,201.0,0,0,0.0,0.0,0.0
313977.0,17,4,1400,4,1400,104659.0,350.0,350.0,0,0,0.0,0.0,0.0
133723.0,6,2,132,1,66,0.0,66.0,66.0,1,66,0.0,66.0,66.0
424003.0,6,4,270,2,134,0.0,68.0,67.0,2,136,0.0,70.0,68.0
44866.0,6,10,2032,5,524,10989.75,252.0,104.8,5,1508,9703.0,1236.0,301.6
107743890.0,6,30,2106,15,1089,7680556.5,123.0,72.6,15,1017,7680570.428571428,123.0,67.8
207119.0,6,3,426,2,280,0.0,214.0,140.0,1,146,0.0,146.0,146.0
52438.0,6,12,1320,7,789,8739.666666666666,253.0,112.71428571428572,5,531,10263.25,259.0,106.2
303160.0,6,2,132,1,66,0.0,66.0,66.0,1,66,0.0,66.0,66.0
290122.0,6,11,1287,6,636,58024.4,298.0,106.0,5,651,71808.0,379.0,130.2
207059.0,6,3,426,2,280,0.0,214.0,140.0,1,146,0.0,146.0,146.0
106104.0,17,2,700,2,700,0.0,350.0,350.0,0,0,0.0,0.0,0.0
90284908.0,6,14,1043,7,542,15047484.666666666,95.0,77.42857142857143,7,501,14996442.833333334,95.0,71.57142857142857
108530.0,6,14,4740,7,653,17856.166666666668,249.0,93.28571428571428,7,4087,17138.166666666668,1514.0,583.8571428571429
332560.0,6,6,412,4,272,110853.33333333331,74.0,68.0,2,140,0.0,74.0,70.0
194627.0,17,4,1524,4,1524,64875.66666666666,381.0,381.0,0,0,0.0,0.0,0.0
311592.0,17,4,622,4,622,103864.0,163.0,155.5,0,0,0.0,0.0,0.0
90023009.0,17,28,13364,28,13364,3334185.5185185187,501.0,477.2857142857143,0,0,0.0,0.0,0.0
42754.0,6,10,2032,5,524,9359.5,252.0,104.8,5,1508,10013.75,1236.0,301.6
2378.0,17,4,344,2,150,0.0,75.0,75.0,2,194,0.0,103.0,97.0
28567.0,6,10,2032,5,524,6896.75,252.0,104.8,5,1508,6859.75,1236.0,301.6
3797.0,17,4,344,2,150,0.0,75.0,75.0,2,194,0.0,103.0,97.0
296.0,17,2,156,1,78,0.0,78.0,78.0,1,78,0.0,78.0,78.0
506755.0,6,5,336,2,134,0.0,68.0,67.0,3,202,194727.0,70.0,67.33333333333333
92440404.0,6,40,2640,20,1320,4865284.421052632,66.0,66.0,20,1320,4853910.210526316,66.0,66.0
307300.0,6,6,412,4,272,102433.33333333331,74.0,68.0,2,140,0.0,74.0,70.0
300520.0,6,6,412,4,272,100173.33333333331,74.0,68.0,2,140,0.0,74.0,70.0
102732.0,17,2,286,2,286,0.0,143.0,143.0,0,0,0.0,0.0,0.0
15079306.0,17,6,2718,6,2718,3015861.2,453.0,453.0,0,0,0.0,0.0,0.0
107834059.0,6,28,1860,14,966,8278335.538461538,123.0,69.0,14,894,8278334.846153846,123.0,63.85714285714285
750894.0,6,2,132,1,66,0.0,66.0,66.0,1,66,0.0,66.0,66.0
2020.0,17,4,344,2,150,0.0,75.0,75.0,2,194,0.0,103.0,97.0
246173.0,6,12,1373,7,714,41028.833333333336,298.0,102.0,5,659,60874.5,379.0,131.8
234476.0,6,3,373,2,238,0.0,172.0,119.0,1,135,0.0,135.0,135.0
0.0,17,1,350,1,350,0.0,350.0,350.0,0,0,0.0,0.0,0.0
5627669.0,6,5,336,2,134,0.0,68.0,67.0,3,202,1523379.0,70.0,67.33333333333333
206848.0,6,3,426,2,280,0.0,214.0,140.0,1,146,0.0,146.0,146.0
40900.0,6,14,4740,7,653,6690.0,249.0,93.28571428571428,7,4087,6596.0,1514.0,583.8571428571429
216904.0,6,10,1221,6,636,43380.8,298.0,106.0,4,585,71188.0,379.0,146.25
23809.0,6,14,4740,7,653,3733.3333333333335,249.0,93.28571428571428,7,4087,3785.6666666666665,1514.0,583.8571428571429
29282.0,6,10,2032,5,524,6299.5,252.0,104.8,5,1508,7042.75,1236.0,301.6
110977.0,17,2,286,2,286,0.0,143.0,143.0,0,0,0.0,0.0,0.0
65764.0,6,14,4740,7,653,10560.666666666666,249.0,93.28571428571428,7,4087,10559.833333333334,1514.0,583.8571428571429
1981.0,17,4,344,2,150,0.0,75.0,75.0,2,194,0.0,103.0,97.0
120274623.0,6,211,23786,106,16560,1145472.6,284.0,156.2264150943396,105,7226,1146549.951923077,140.0,68.81904761904762
45058.0,6,14,4740,7,653,6845.666666666667,249.0,93.28571428571428,7,4087,5755.666666666667,1514.0,583.8571428571429
90734678.0,6,19,1436,10,745,10076951.333333334,95.0,74.5,9,691,11341067.125,95.0,76.77777777777777
107076410.0,6,43,2838,22,1452,5088598.952380952,66.0,66.0,21,1386,5105438.75,66.0,66.0
841779.0,6,9,1118,6,586,168355.8,248.0,97.66666666666669,3,532,282805.0,392.0,177.33333333333334
107428.0,17,2,286,2,286,0.0,143.0,143.0,0,0,0.0,0.0,0.0
135127145.0,17,6,1146,6,1146,27025429.0,191.0,191.0,0,0,0.0,0.0,0.0
47608322.0,6,8,2113,3,960,22842086.5,826.0,320.0,5,1153,11206312.5,885.0,230.6
43030.0,6,10,1066,5,490,10589.5,218.0,98.0,5,576,10471.75,304.0,115.2
2271640.0,6,2,132,1,66,0.0,66.0,66.0,1,66,0.0,66.0,66.0
118619494.0,6,278,31476,139,22080,858001.8260869565,300.0,158.84892086330936,139,9396,858002.3333333334,140.0,67.59712230215827
43331.0,6,14,4740,7,653,7096.666666666667,249.0,93.28571428571428,7,4087,6571.5,1514.0,583.8571428571429
213694.0,17,2,180,1,90,0.0,90.0,90.0,1,90,0.0,90.0,90.0
102133828.0,6,182,20644,91,14416,1132430.7666666666,390.0,158.41758241758242,91,6228,1132429.8444444444,140.0,68.43956043956044
30365.0,6,14,4740,7,653,4880.666666666667,249.0,93.28571428571428,7,4087,4829.5,1514.0,583.8571428571429
91569254.0,6,600,99694,297,19898,309261.35135135136,214.0,66.996632996633,303,79796,301240.93377483444,1514.0,263.35313531353137
43526.0,6,10,2032,5,524,10587.25,252.0,104.8,5,1508,10608.25,1236.0,301.6
1078.0,17,2,762,2,762,0.0,381.0,381.0,0,0,0.0,0.0,0.0
90027449.0,17,27,12943,27,12943,3462594.1923076925,501.0,479.3703703703704,0,0,0.0,0.0,0.0
206264.0,6,3,426,2,280,0.0,214.0,140.0,1,146,0.0,146.0,146.0
2338.0,17,4,344,2,150,0.0,75.0,75.0,2,194,0.0,103.0,97.0
3225.0,17,4,344,2,150,0.0,75.0,75.0,2,194,0.0,103.0,97.0
36765.0,6,10,2032,5,524,6867.0,252.0,104.8,5,1508,8606.5,1236.0,301.6
120033784.0,17,14,864,7,432,16833492.5,174.0,61.71428571428572,7,432,16835124.666666668,174.0,61.71428571428572
524821.0,6,6,758,3,410,239126.5,172.0,136.66666666666666,3,348,190226.0,135.0,116.0
239803.0,6,3,337,2,214,0.0,160.0,107.0,1,123,0.0,123.0,123.0
135129424.0,17,6,1146,6,1146,27025884.8,191.0,191.0,0,0,0.0,0.0,0.0
101184929.0,6,168,18984,84,13218,1216500.4457831325,284.0,157.35714285714286,84,5766,1216502.6024096385,140.0,68.64285714285714
22988.0,6,10,2032,5,524,3764.25,252.0,104.8,5,1508,4927.25,1236.0,301.6
301.0,17,2,168,1,76,0.0,76.0,76.0,1,92,0.0,92.0,92.0
198793.0,17,2,180,1,90,0.0,90.0,90.0,1,90,0.0,90.0,90.0
2797551.0,6,2,132,1,66,0.0,66.0,66.0,1,66,0.0,66.0,66.0
4399.0,17,4,704,2,148,0.0,74.0,74.0,2,556,0.0,280.0,278.0
135129985.0,17,6,1206,6,1206,27025997.0,201.0,201.0,0,0,0.0,0.0,0.0
90228106.0,6,16,1192,8,596,12853929.57142857,95.0,74.5,8,596,12858942.285714284,95.0,74.5
20399.0,6,10,2032,5,524,4271.25,252.0,104.8,5,1508,4447.75,1236.0,301.6
21990.0,17,2,180,1,90,0.0,90.0,90.0,1,90,0.0,90.0,90.0
120058711.0,17,29,13785,29,13785,4287811.107142857,501.0,475.3448275862069,0,0,0.0,0.0,0.0
1464.0,6,2,177,1,123,0.0,123.0,123.0,1,54,0.0,54.0,54.0
120050023.0,17,29,13785,29,13785,4287500.821428572,501.0,475.3448275862069,0,0,0.0,0.0,0.0
120123295.0,6,14,2240,6,1224,24024659.0,204.0,204.0,8,1016,17098558.14285714,188.0,127.0
341.0,17,2,174,1,79,0.0,79.0,79.0,1,95,0.0,95.0,95.0
96072040.0,17,14,1126,7,563,16001848.333333334,174.0,80.42857142857143,7,563,16000135.0,174.0,80.42857142857143
90092487.0,6,13,2052,6,1224,18018022.0,204.0,204.0,7,828,14969299.166666666,188.0,118.28571428571428
306441.0,6,6,412,4,272,102147.0,74.0,68.0,2,140,0.0,74.0,70.0
459.0,17,2,508,2,508,0.0,257.0,254.0,0,0,0.0,0.0,0.0
228227.0,17,2,180,1,90,0.0,90.0,90.0,1,90,0.0,90.0,90.0
120258282.0,6,222,25090,111,7622,1085745.709090909,140.0,68.66666666666667,111,17468,1085765.481818182,284.0,157.36936936936937
89488.0,6,14,4740,7,653,13929.5,249.0,93.28571428571428,7,4087,14434.0,1514.0,583.8571428571429
103022483.0,6,29,2052,15,1089,7343329.142857143,123.0,72.6,14,963,7908154.307692308,123.0,68.78571428571429
113928176.0,6,204,23108,102,6954,1119944.9207920793,140.0,68.17647058823529,102,16154,1120841.504950495,284.0,158.37254901960785
309423.0,6,6,412,4,272,103141.0,74.0,68.0,2,140,0.0,74.0,70.0
14484.0,6,14,4740,7,653,2222.0,249.0,93.28571428571428,7,4087,2277.833333333333,1514.0,583.8571428571429
105136.0,17,2,286,2,286,0.0,143.0,143.0,0,0,0.0,0.0,0.0
108114142.0,17,5,1005,5,1005,27028535.5,201.0,201.0,0,0,0.0,0.0,0.0
28544.0,6,10,2032,5,524,6166.5,252.0,104.8,5,1508,5469.75,1236.0,301.6
146108.0,6,3,337,2,214,0.0,160.0,107.0,1,123,0.0,123.0,123.0
135128112.0,17,6,1206,6,1206,27025622.4,201.0,201.0,0,0,0.0,0.0,0.0
2466048.0,6,3,204,2,136,0.0,70.0,68.0,1,68,0.0,68.0,68.0
2355.0,17,4,344,2,150,0.0,75.0,75.0,2,194,0.0,103.0,97.0
16821.0,6,11,2098,6,590,3085.8,252.0,98.33333333333331,5,1508,3753.0,1236.0,301.6
153813.0,17,2,180,1,90,0.0,90.0,90.0,1,90,0.0,90.0,90.0
268304.0,6,10,1221,6,636,53660.8,298.0,106.0,4,585,82380.33333333333,379.0,146.25
90014846.0,6,14,1043,7,542,15002474.333333334,95.0,77.42857142857143,7,501,14953971.333333334,95.0,71.57142857142857
9704.0,17,2,582,1,83,0.0,83.0,83.0,1,499,0.0,499.0,499.0
5005835.0,17,4,849,2,166,0.0,83.0,83.0,2,683,0.0,499.0,341.5
116217324.0,17,16,1212,8,606,16571570.857142856,174.0,75.75,8,606,16572091.57142857,174.0,75.75
108104547.0,17,5,955,5,955,27026136.75,191.0,191.0,0,0,0.0,0.0,0.0
13617723.0,6,19,1553,9,921,1663499.375,315.0,102.33333333333331,10,632,1478632.7777777778,78.0,63.2
120000111.0,6,17,1287,9,691,15000013.875,95.0,76.77777777777777,8,596,12897273.57142857,95.0,74.5
301922.0,17,2,246,1,76,0.0,76.0,76.0,1,170,0.0,170.0,170.0
2428.0,17,4,344,2,150,0.0,75.0,75.0,2,194,0.0,103.0,97.0
824.0,17,4,438,2,148,0.0,74.0,74.0,2,290,0.0,147.0,145.0
218177.0,6,3,426,2,280,0.0,214.0,140.0,1,146,0.0,146.0,146.0
2134.0,17,2,932,1,590,0.0,590.0,590.0,1,342,0.0,342.0,342.0
362754.0,6,11,1021,6,444,48733.4,162.0,74.0,5,577,60809.75,349.0,115.4
206047.0,6,3,426,2,280,0.0,214.0,140.0,1,146,0.0,146.0,146.0
3002490.0,6,12,2172,7,664,500153.5,252.0,94.85714285714286,5,1508,1979.0,1236.0,301.6
90260800.0,6,12,1832,8,1016,12894400.0,188.0,127.0,4,816,30031879.0,204.0,204.0
39655.0,6,10,2032,5,524,7719.25,252.0,104.8,5,1508,7238.0,1236.0,301.6
103200184.0,6,42,2772,21,1386,5159996.6,66.0,66.0,21,1386,5159996.45,66.0,66.0
245405.0,6,3,337,2,214,0.0,160.0,107.0,1,123,0.0,123.0,123.0
136186.0,6,2,132,1,66,0.0,66.0,66.0,1,66,0.0,66.0,66.0
0.0,17,1,55,1,55,0.0,55.0,55.0,0,0,0.0,0.0,0.0
363.0,17,2,168,1,76,0.0,76.0,76.0,1,92,0.0,92.0,92.0
353.0,17,2,267,1,83,0.0,83.0,83.0,1,184,0.0,184.0,184.0
246222.0,6,3,337,2,214,0.0,160.0,107.0,1,123,0.0,123.0,123.0
308083.0,6,6,412,4,272,102694.33333333331,74.0,68.0,2,140,0.0,74.0,70.0
122001514.0,17,15,907,8,475,17428787.714285713,174.0,59.375,7,432,17001208.833333332,174.0,61.71428571428572
205996.0,17,2,180,1,90,0.0,90.0,90.0,1,90,0.0,90.0,90.0
298021.0,6,6,412,4,272,99340.33333333331,74.0,68.0,2,140,0.0,74.0,70.0
23144.0,6,10,2032,5,524,4937.75,252.0,104.8,5,1508,4450.5,1236.0,301.6
153447.0,17,2,180,1,90,0.0,90.0,90.0,1,90,0.0,90.0,90.0
5622754.0,6,5,336,2,134,0.0,68.0,67.0,3,202,1420877.5,70.0,67.33333333333333
819.0,17,4,438,2,148,0.0,74.0,74.0,2,290,0.0,147.0,145.0
0.0,6,1,66,1,66,0.0,66.0,66.0,0,0,0.0,0.0,0.0
153435.0,17,2,180,1,90,0.0,90.0,90.0,1,90,0.0,90.0,90.0
2805770.0,6,2,132,1,66,0.0,66.0,66.0,1,66,0.0,66.0,66.0
30463.0,6,14,4740,7,653,4761.833333333333,249.0,93.28571428571428,7,4087,4871.5,1514.0,583.8571428571429
108114516.0,17,5,1005,5,1005,27028629.0,201.0,201.0,0,0,0.0,0.0,0.0
867494.0,6,9,1096,6,625,173498.8,287.0,104.16666666666669,3,471,295979.5,331.0,157.0
2318.0,17,4,344,2,150,0.0,75.0,75.0,2,194,0.0,103.0,97.0
2362328.0,6,3,1604,1,753,0.0,753.0,753.0,2,851,0.0,785.0,425.5
1737135.0,6,23,6509,12,1529,157921.36363636365,357.0,127.41666666666669,11,4980,142663.2,1510.0,452.7272727272728
2265.0,17,4,344,2,150,0.0,75.0,75.0,2,194,0.0,103.0,97.0
246818.0,6,3,337,2,214,0.0,160.0,107.0,1,123,0.0,123.0,123.0
307419.0,6,6,412,4,272,102473.0,74.0,68.0,2,140,0.0,74.0,70.0
153460.0,17,2,180,1,90,0.0,90.0,90.0,1,90,0.0,90.0,90.0
299258.0,6,6,412,4,272,99752.66666666669,74.0,68.0,2,140,0.0,74.0,70.0
33911.0,6,14,4740,7,653,4920.666666666667,249.0,93.28571428571428,7,4087,5422.333333333333,1514.0,583.8571428571429
143166.0,17,4,571,2,148,0.0,74.0,74.0,2,423,0.0,276.0,211.5
77619.0,6,12,1320,7,789,12936.5,253.0,112.71428571428572,5,531,17429.5,259.0,106.2
413.0,17,2,762,2,762,0.0,381.0,381.0,0,0,0.0,0.0,0.0
108107838.0,17,5,1005,5,1005,27026959.5,201.0,201.0,0,0,0.0,0.0,0.0
129400.0,6,2,132,1,66,0.0,66.0,66.0,1,66,0.0,66.0,66.0
25796.0,6,14,4740,7,653,4005.6666666666665,249.0,93.28571428571428,7,4087,4161.5,1514.0,583.8571428571429
498575.0,6,6,758,3,410,202661.0,172.0,136.66666666666666,3,348,176943.5,135.0,116.0
334.0,17,2,166,1,75,0.0,75.0,75.0,1,91,0.0,91.0,91.0
56499.0,6,14,4740,7,653,7697.833333333333,249.0,93.28571428571428,7,4087,8411.0,1514.0,583.8571428571429
90010235.0,17,28,13364,28,13364,3333712.407407407,501.0,477.2857142857143,0,0,0.0,0.0,0.0
36068.0,6,14,4740,7,653,5884.666666666667,249.0,93.28571428571428,7,4087,5874.0,1514.0,583.8571428571429
13441.0,6,11,1132,6,556,1868.0,218.0,92.66666666666669,5,576,3082.5,304.0,115.2
2787822.0,6,2,132,1,66,0.0,66.0,66.0,1,66,0.0,66.0,66.0
13760.0,6,13,1459,7,862,2051.1666666666665,271.0,123.14285714285714,6,597,2225.2,259.0,99.5
58640.0,6,14,4740,7,653,9649.833333333334,249.0,93.28571428571428,7,4087,8830.333333333334,1514.0,583.8571428571429
120064132.0,6,233,26318,117,8018,1035035.6206896552,140.0,68.52991452991454,116,18300,1037689.3304347828,336.0,157.75862068965515
90041569.0,17,28,13364,28,13364,3334872.925925926,501.0,477.2857142857143,0,0,0.0,0.0,0.0
42490.0,6,10,2032,5,524,10334.5,252.0,104.8,5,1508,10283.0,1236.0,301.6
140929.0,17,4,571,2,148,0.0,74.0,74.0,2,423,0.0,280.0,211.5
336.0,17,2,166,1,75,0.0,75.0,75.0,1,91,0.0,91.0,91.0
108357.0,17,2,286,2,286,0.0,143.0,143.0,0,0,0.0,0.0,0.0
228700.0,17,2,180,1,90,0.0,90.0,90.0,1,90,0.0,90.0,90.0
135135447.0,17,6,1146,6,1146,27027089.4,191.0,191.0,0,0,0.0,0.0,0.0
986.0,17,4,438,2,148,0.0,74.0,74.0,2,290,0.0,147.0,145.0
40094.0,6,13,1479,7,882,5668.166666666667,291.0,126.0,6,597,7478.4,259.0,99.5
16282537.999999998,17,5,1710,5,1710,4070634.5,342.0,342.0,0,0,0.0,0.0,0.0
107149.0,17,2,286,2,286,0.0,143.0,143.0,0,0,0.0,0.0,0.0
90024337.0,17,28,13364,28,13364,3334234.703703704,501.0,477.2857142857143,0,0,0.0,0.0,0.0
3811169.0,6,4,270,2,134,0.0,68.0,67.0,2,136,0.0,70.0,68.0
108104389.0,17,5,1005,5,1005,27026097.25,201.0,201.0,0,0,0.0,0.0,0.0
0.0,17,1,55,1,55,0.0,55.0,55.0,0,0,0.0,0.0,0.0
667797.0,6,4,508,2,238,0.0,172.0,119.0,2,270,0.0,135.0,135.0
715969.0,6,2,132,1,66,0.0,66.0,66.0,1,66,0.0,66.0,66.0
15879.999999999998,6,10,2032,5,524,3164.75,252.0,104.8,5,1508,3405.75,1236.0,301.6
115037231.0,17,14,864,7,432,19166868.5,174.0,61.71428571428572,7,432,19167595.0,174.0,61.71428571428572
117015885.0,17,13,821,7,432,19502647.5,174.0,61.71428571428572,6,389,19400176.6,174.0,64.83333333333333
43638.0,6,11,2098,6,590,7494.8,252.0,98.33333333333331,5,1508,10639.0,1236.0,301.6
2698679.0,6,2,132,1,66,0.0,66.0,66.0,1,66,0.0,66.0,66.0
2289.0,17,4,344,2,150,0.0,75.0,75.0,2,194,0.0,103.0,97.0
108100444.0,17,5,955,5,955,27025111.0,191.0,191.0,0,0,0.0,0.0,0.0
146806.0,6,3,373,2,238,0.0,172.0,119.0,1,135,0.0,135.0,135.0
1112071.0,6,13,1386,7,789,185345.16666666663,253.0,112.71428571428572,6,597,221272.2,259.0,99.5
53460.0,6,14,4740,7,653,7860.833333333333,249.0,93.28571428571428,7,4087,8653.5,1514.0,583.8571428571429
106456.0,17,2,286,2,286,0.0,143.0,143.0,0,0,0.0,0.0,0.0
115389463.0,6,421,52962,211,14222,549473.6333333333,140.0,67.40284360189574,210,38740,547113.8086124402,480.0,184.47619047619048
219571.0,6,3,426,2,280,0.0,214.0,140.0,1,146,0.0,146.0,146.0
52122.0,6,14,4740,7,653,8527.666666666666,249.0,93.28571428571428,7,4087,8532.333333333334,1514.0,583.8571428571429
37659.0,6,14,4740,7,653,5289.833333333333,249.0,93.28571428571428,7,4087,6032.666666666667,1514.0,583.8571428571429
40949.0,17,2,180,1,90,0.0,90.0,90.0,1,90,0.0,90.0,90.0
30473.0,6,14,4740,7,653,4454.333333333333,249.0,93.28571428571428,7,4087,4885.833333333333,1514.0,583.8571428571429
32255.0,6,2,145,2,145,0.0,91.0,72.5,0,0,0.0,0.0,0.0
7177.0,17,2,582,1,83,0.0,83.0,83.0,1,499,0.0,499.0,499.0
92811580.0,6,187,21138,94,6426,997973.9784946236,140.0,68.36170212765957,93,14712,997537.0326086956,284.0,158.19354838709677
90526180.0,6,15,2444,8,1016,12932311.42857143,188.0,127.0,7,1428,15060485.0,204.0,204.0
135137096.0,17,6,1206,6,1206,27027419.2,201.0,201.0,0,0,0.0,0.0,0.0
236147.0,17,2,180,1,90,0.0,90.0,90.0,1,90,0.0,90.0,90.0
153349.0,17,2,180,1,90,0.0,90.0,90.0,1,90,0.0,90.0,90.0
0.0,6,1,66,1,66,0.0,66.0,66.0,0,0,0.0,0.0,0.0
50671.0,17,2,180,1,90,0.0,90.0,90.0,1,90,0.0,90.0,90.0
135134047.0,17,6,1146,6,1146,27026809.4,191.0,191.0,0,0,0.0,0.0,0.0
277641.0,17,2,363,1,79,0.0,79.0,79.0,1,284,0.0,284.0,284.0
75350.0,6,14,4740,7,653,11395.166666666666,249.0,93.28571428571428,7,4087,12419.833333333334,1514.0,583.8571428571429
113608802.0,6,48,3168,24,1584,4939513.130434782,66.0,66.0,24,1584,4930118.130434782,66.0,66.0
120124059.0,6,14,2240,8,1016,17137104.57142857,188.0,127.0,6,1224,18018102.8,204.0,204.0
62216.0,6,14,4740,7,653,8816.666666666666,249.0,93.28571428571428,7,4087,10234.166666666666,1514.0,583.8571428571429
307379.0,6,3,202,2,128,0.0,74.0,64.0,1,74,0.0,74.0,74.0
121530.0,6,2,132,1,66,0.0,66.0,66.0,1,66,0.0,66.0,66.0
114891911.0,6,48,3168,24,1584,4995300.478260869,66.0,66.0,24,1584,4985902.130434782,66.0,66.0
2019.0,17,4,344,2,150,0.0,75.0,75.0,2,194,0.0,103.0,97.0
205911.0,17,2,762,2,762,0.0,381.0,381.0,0,0,0.0,0.0,0.0
1630352.0,6,20,7599,11,1469,163035.2,583.0,133.54545454545453,9,6130,171272.25,1484.0,681.1111111111111
300116.0,6,6,412,4,272,100038.66666666669,74.0,68.0,2,140,0.0,74.0,70.0
196981.0,17,2,180,1,90,0.0,90.0,90.0,1,90,0.0,90.0,90.0
114179326.0,6,48,3168,24,1584,4964318.521739131,66.0,66.0,24,1584,4951268.217391305,66.0,66.0
52665.0,6,10,2032,5,524,12183.0,252.0,104.8,5,1508,12696.5,1236.0,301.6
120037687.0,17,28,13364,28,13364,4445840.259259259,501.0,477.2857142857143,0,0,0.0,0.0,0.0
98161449.0,6,400,64798,200,51302,492192.2060301508,1514.0,256.51,200,13496,492192.01005025127,214.0,67.48
232112.0,6,3,337,2,214,0.0,160.0,107.0,1,123,0.0,123.0,123.0
73762.0,6,14,4740,7,653,11994.0,249.0,93.28571428571428,7,4087,11986.833333333334,1514.0,583.8571428571429
839.0,17,4,438,2,148,0.0,74.0,74.0,2,290,0.0,147.0,145.0
103646255.0,6,32,2236,16,1165,6896041.333333333,139.0,72.8125,16,1071,6896111.533333333,123.0,66.9375
26308.0,6,14,4740,7,653,4213.833333333333,249.0,93.28571428571428,7,4087,4083.0,1514.0,583.8571428571429
24558.0,6,14,4740,7,653,3708.6666666666665,249.0,93.28571428571428,7,4087,3216.1666666666665,1514.0,583.8571428571429
5827501.0,6,4,270,2,134,0.0,68.0,67.0,2,136,0.0,70.0,68.0
120405283.0,6,227,25706,114,18026,1065533.4778761065,284.0,158.12280701754386,113,7680,1065758.794642857,140.0,67.96460176991151
44088.0,6,10,2032,5,524,10160.25,252.0,104.8,5,1508,10466.75,1236.0,301.6
7162.0,17,2,414,1,88,0.0,88.0,88.0,1,326,0.0,326.0,326.0
46864.0,6,14,4740,7,653,7648.5,249.0,93.28571428571428,7,4087,5873.333333333333,1514.0,583.8571428571429
302981.0,6,6,412,4,272,100993.66666666669,74.0,68.0,2,140,0.0,74.0,70.0
4981.0,17,2,180,1,90,0.0,90.0,90.0,1,90,0.0,90.0,90.0
119576990.0,6,222,25122,111,17574,1085107.9636363636,284.0,158.32432432432432,111,7548,1085107.9363636365,140.0,68.0
120202718.0,6,324,36894,162,10914,741327.546583851,140.0,67.37037037037037,162,25980,741450.1366459627,374.0,160.37037037037038
90306816.0,6,19,1436,10,745,10027052.666666666,95.0,74.5,9,691,11286435.375,95.0,76.77777777777777
10509841.0,6,7,478,4,272,3456671.0,74.0,68.0,3,206,5184918.5,74.0,68.66666666666667
135129525.0,17,6,1206,6,1206,27025905.0,201.0,201.0,0,0,0.0,0.0,0.0
228265.0,17,2,180,1,90,0.0,90.0,90.0,1,90,0.0,90.0,90.0
135131082.0,17,6,1206,6,1206,27026216.4,201.0,201.0,0,0,0.0,0.0,0.0
2354.0,17,4,344,2,150,0.0,75.0,75.0,2,194,0.0,103.0,97.0
9812.0,17,2,571,1,86,0.0,86.0,86.0,1,485,0.0,485.0,485.0
1315873.0,17,7,490,7,490,219312.16666666663,70.0,70.0,0,0,0.0,0.0,0.0
2597585.0,6,2,132,1,66,0.0,66.0,66.0,1,66,0.0,66.0,66.0
29139.0,6,14,4740,7,653,4166.666666666667,249.0,93.28571428571428,7,4087,4713.833333333333,1514.0,583.8571428571429
143958.0,17,2,180,1,90,0.0,90.0,90.0,1,90,0.0,90.0,90.0
37481.0,6,14,4740,7,653,5479.5,249.0,93.28571428571428,7,4087,6114.0,1514.0,583.8571428571429
90049855.0,17,28,13364,28,13364,3335179.814814815,501.0,477.2857142857143,0,0,0.0,0.0,0.0
153569.0,17,2,180,1,90,0.0,90.0,90.0,1,90,0.0,90.0,90.0
74274.0,6,14,4740,7,653,11895.833333333334,249.0,93.28571428571428,7,4087,12089.166666666666,1514.0,583.8571428571429
193402.0,17,2,180,1,90,0.0,90.0,90.0,1,90,0.0,90.0,90.0
106446425.0,17,14,864,7,432,17668746.0,174.0,61.71428571428572,7,432,17666877.333333332,174.0,61.71428571428572
5822082.0,6,5,336,2,134,0.0,68.0,67.0,3,202,1526671.0,70.0,67.33333333333333
1307030.0,6,4,264,2,132,0.0,66.0,66.0,2,132,0.0,66.0,66.0
27876.0,6,11,2098,6,590,4798.0,252.0,98.33333333333331,5,1508,6687.0,1236.0,301.6
432.0,17,2,410,1,78,0.0,78.0,78.0,1,332,0.0,332.0,332.0
90043191.0,17,28,13364,28,13364,3334933.0,501.0,477.2857142857143,0,0,0.0,0.0,0.0
39772.0,6,10,2032,5,524,9696.25,252.0,104.8,5,1508,9664.75,1236.0,301.6
108103499.0,17,5,1005,5,1005,27025874.75,201.0,201.0,0,0,0.0,0.0,0.0
123647974.0,6,49,3234,25,1650,5151998.916666667,66.0,66.0,24,1584,5046777.130434782,66.0,66.0
196974.0,17,2,180,1,90,0.0,90.0,90.0,1,90,0.0,90.0,90.0
847.0,17,2,762,2,762,0.0,381.0,381.0,0,0,0.0,0.0,0.0
115500765.0,6,48,3168,24,1584,5021772.391304348,66.0,66.0,24,1584,5008333.0,66.0,66.0
118480317.0,6,327,38500,164,11120,726873.1104294478,140.0,67.8048780487805,163,27380,725036.3333333334,284.0,167.9754601226994
102899.0,17,2,286,2,286,0.0,143.0,143.0,0,0,0.0,0.0,0.0
162408.0,6,3,337,2,214,0.0,160.0,107.0,1,123,0.0,123.0,123.0
2382.0,17,4,344,2,150,0.0,75.0,75.0,2,194,0.0,103.0,97.0
2117.0,17,4,344,2,150,0.0,75.0,75.0,2,194,0.0,103.0,97.0
29831.0,6,11,2098,6,590,5383.8,252.0,98.33333333333331,5,1508,5618.25,1236.0,301.6
260237.0,6,3,337,2,214,0.0,160.0,107.0,1,123,0.0,123.0,123.0
72952.0,17,4,823,2,163,0.0,89.0,81.5,2,660,0.0,443.0,330.0
59779.0,6,14,4740,7,653,9746.666666666666,249.0,93.28571428571428,7,4087,9353.666666666666,1514.0,583.8571428571429
201206.0,17,2,614,1,72,0.0,72.0,72.0,1,542,0.0,542.0,542.0
337371.0,6,3,1604,2,851,0.0,785.0,425.5,1,753,0.0,753.0,753.0
90532535.0,6,14,2240,8,1016,12933219.285714284,188.0,127.0,6,1224,18073302.2,204.0,204.0
239541.0,17,2,180,1,90,0.0,90.0,90.0,1,90,0.0,90.0,90.0
3147.0,17,4,344,2,150,0.0,75.0,75.0,2,194,0.0,103.0,97.0
117814016.0,6,29,1914,15,948,8415286.857142856,123.0,63.2,14,966,8278026.846153846,123.0,69.0
311.0,17,2,156,1,78,0.0,78.0,78.0,1,78,0.0,78.0,78.0
103317972.0,6,42,2772,21,1386,5150434.0,66.0,66.0,21,1386,5150436.55,66.0,66.0
2794825.0,6,3,204,2,136,0.0,70.0,68.0,1,68,0.0,68.0,68.0
27056486.0,17,5,1710,5,1710,6764121.5,342.0,342.0,0,0,0.0,0.0,0.0
2449.0,17,4,344,2,150,0.0,75.0,75.0,2,194,0.0,103.0,97.0
2821990.0,6,3,1602,2,850,0.0,784.0,425.0,1,752,0.0,752.0,752.0
107836789.0,6,28,1860,14,966,8278534.230769231,123.0,69.0,14,894,8278538.0,123.0,63.85714285714285
430041.0,6,4,508,2,238,0.0,172.0,119.0,2,270,0.0,135.0,135.0
32888.0,6,10,2032,5,524,7919.25,252.0,104.8,5,1508,7949.25,1236.0,301.6
144770.0,17,2,180,1,70,0.0,70.0,70.0,1,110,0.0,110.0,110.0
102645.0,17,2,762,2,762,0.0,381.0,381.0,0,0,0.0,0.0,0.0
90042936.0,17,27,12943,27,12943,3463189.846153846,501.0,479.3703703703704,0,0,0.0,0.0,0.0
246065.0,6,3,337,2,214,0.0,160.0,107.0,1,123,0.0,123.0,123.0
234969.0,6,3,337,2,214,0.0,160.0,107.0,1,123,0.0,123.0,123.0
91088205.0,6,27,1938,14,1029,7006785.0,123.0,73.5,13,909,7572671.416666667,123.0,69.92307692307692
298810.0,6,6,412,4,272,99603.33333333331,74.0,68.0,2,140,0.0,74.0,70.0
1695160.0,6,22,6443,11,1463,169516.0,357.0,133.0,11,4980,136611.4,1510.0,452.7272727272728
40418.0,6,14,4740,7,653,6568.166666666667,249.0,93.28571428571428,7,4087,6189.666666666667,1514.0,583.8571428571429
233153.0,6,3,337,2,214,0.0,160.0,107.0,1,123,0.0,123.0,123.0
97634227.0,6,26,1746,13,906,8118153.916666667,123.0,69.6923076923077,13,840,8118178.333333333,123.0,64.61538461538461
719.0,17,4,438,2,148,0.0,74.0,74.0,2,290,0.0,147.0,145.0
108107925.0,17,5,1005,5,1005,27026981.25,201.0,201.0,0,0,0.0,0.0,0.0
0.0,17,1,55,1,55,0.0,55.0,55.0,0,0,0.0,0.0,0.0
58523.0,6,14,4740,7,653,9582.166666666666,249.0,93.28571428571428,7,4087,8211.333333333334,1514.0,583.8571428571429
143869.0,17,2,180,1,90,0.0,90.0,90.0,1,90,0.0,90.0,90.0
38932.0,6,14,4740,7,653,6329.833333333333,249.0,93.28571428571428,7,4087,5678.0,1514.0,583.8571428571429
5364489.0,17,6,635,6,635,1072897.8,128.0,105.83333333333331,0,0,0.0,0.0,0.0
229742.0,6,3,426,2,280,0.0,214.0,140.0,1,146,0.0,146.0,146.0
487.0,17,2,508,2,508,0.0,257.0,254.0,0,0,0.0,0.0,0.0
2566769.0,6,11,1134,6,558,513353.8,220.0,93.0,5,576,640594.75,304.0,115.2
42282.0,6,14,4740,7,653,6488.166666666667,249.0,93.28571428571428,7,4087,5951.666666666667,1514.0,583.8571428571429
79.0,17,2,762,2,762,0.0,381.0,381.0,0,0,0.0,0.0,0.0
487.0,17,2,508,2,508,0.0,257.0,254.0,0,0,0.0,0.0,0.0
14880.0,6,10,2032,5,524,3451.0,252.0,104.8,5,1508,3118.75,1236.0,301.6
33454.0,6,10,2032,5,524,8134.5,252.0,104.8,5,1508,8079.0,1236.0,301.6
241698.0,6,3,337,2,214,0.0,160.0,107.0,1,123,0.0,123.0,123.0
108106527.0,17,5,955,5,955,27026631.75,191.0,191.0,0,0,0.0,0.0,0.0
284281.0,17,2,363,1,79,0.0,79.0,79.0,1,284,0.0,284.0,284.0
98500393.0,17,12,778,6,389,19600153.8,174.0,64.83333333333333,6,389,19601870.2,174.0,64.83333333333333
210049.0,6,3,426,2,280,0.0,214.0,140.0,1,146,0.0,146.0,146.0
10424263.0,6,6,412,3,206,5143636.0,74.0,68.66666666666667,3,206,5143557.0,74.0,68.66666666666667
135106747.0,17,6,1146,6,1146,27021349.4,191.0,191.0,0,0,0.0,0.0,0.0
120054111.0,6,29,1920,15,1026,8575293.642857144,123.0,68.4,14,894,8449346.384615384,123.0,63.85714285714285
108102136.0,17,5,1005,5,1005,27025534.0,201.0,201.0,0,0,0.0,0.0,0.0
261796.0,6,3,337,2,214,0.0,160.0,107.0,1,123,0.0,123.0,123.0
165859.0,17,2,180,1,90,0.0,90.0,90.0,1,90,0.0,90.0,90.0
119122419.0,6,47,3102,24,1584,5179224.956521739,66.0,66.0,23,1518,5159997.0,66.0,66.0
2842203.0,6,4,270,3,202,1421101.5,70.0,67.33333333333333,1,68,0.0,68.0,68.0
2596187.0,6,2,132,1,66,0.0,66.0,66.0,1,66,0.0,66.0,66.0
6382.0,17,4,823,2,163,0.0,89.0,81.5,2,660,0.0,443.0,330.0
108725661.0,6,32,2236,16,1165,7233987.133333334,139.0,72.8125,16,1071,7233989.733333333,123.0,66.9375
2331.0,17,4,344,2,150,0.0,75.0,75.0,2,194,0.0,103.0,97.0
259021.0,6,10,1221,6,636,51804.2,298.0,106.0,4,585,79983.33333333333,379.0,146.25
123807020.0,6,49,3234,24,1584,4948499.434782608,66.0,66.0,25,1650,5158615.666666667,66.0,66.0
125785125.0,6,77,14680,38,7598,2788745.4324324327,1514.0,199.94736842105263,39,7082,3304747.947368421,1514.0,181.5897435897436
1348051.0,17,16,1120,16,1120,89870.06666666667,70.0,70.0,0,0,0.0,0.0,0.0
115032290.0,17,14,864,7,432,19001691.33333333,174.0,61.71428571428572,7,432,19000164.5,174.0,61.71428571428572
120120738.0,6,12,1832,8,1016,17137070.285714287,188.0,127.0,4,816,30025853.666666668,204.0,204.0
5628276.0,6,5,336,2,134,0.0,68.0,67.0,3,202,1424053.0,70.0,67.33333333333333
241621.0,6,3,337,2,214,0.0,160.0,107.0,1,123,0.0,123.0,123.0
90093695.0,6,11,1644,7,828,15015615.833333334,188.0,118.28571428571428,4,816,20018516.33333333,204.0,204.0
604740.0,17,2,346,1,78,0.0,78.0,78.0,1,268,0.0,268.0,268.0
237668.0,6,3,373,2,238,0.0,172.0,119.0,1,135,0.0,135.0,135.0
298691.0,6,6,412,4,272,99563.66666666669,74.0,68.0,2,140,0.0,74.0,70.0
26685.0,6,14,4740,7,653,4316.5,249.0,93.28571428571428,7,4087,4127.333333333333,1514.0,583.8571428571429
148087.0,17,2,180,1,90,0.0,90.0,90.0,1,90,0.0,90.0,90.0
117260656.0,6,227,25738,114,7746,1037704.9203539822,140.0,67.94736842105263,113,17992,1038746.6785714284,284.0,159.2212389380531
107215.0,17,2,286,2,286,0.0,143.0,143.0,0,0,0.0,0.0,0.0
125824978.0,6,57,11822,28,5989,3559747.777777778,1514.0,213.8928571428572,29,5833,4486410.75,1514.0,201.1379310344828
2079282.0,6,25,7610,13,2516,173273.5,1034.0,193.53846153846155,12,5094,161386.36363636365,1510.0,424.5
0.0,17,1,44,1,44,0.0,44.0,44.0,0,0,0.0,0.0,0.0
1302905.0,6,4,264,2,132,0.0,66.0,66.0,2,132,0.0,66.0,66.0
43692.0,6,14,4740,7,653,6712.666666666667,249.0,93.28571428571428,7,4087,6476.0,1514.0,583.8571428571429
318290.0,17,4,1400,4,1400,106096.66666666669,350.0,350.0,0,0,0.0,0.0,0.0
46141.0,6,14,4740,7,653,7071.666666666667,249.0,93.28571428571428,7,4087,5762.833333333333,1514.0,583.8571428571429
108107044.0,17,5,1005,5,1005,27026761.0,201.0,201.0,0,0,0.0,0.0,0.0
12131.0,6,10,1066,5,490,2865.0,218.0,98.0,5,576,2625.5,304.0,115.2
103862961.0,6,44,2904,22,1452,4945855.285714285,66.0,66.0,22,1452,4932734.142857143,66.0,66.0
135136909.0,17,6,1146,6,1146,27027381.8,191.0,191.0,0,0,0.0,0.0,0.0
1302424.0,6,4,264,2,132,0.0,66.0,66.0,2,132,0.0,66.0,66.0
90753155.0,6,19,1436,10,745,10079220.444444444,95.0,74.5,9,691,11343221.75,95.0,76.77777777777777
90760498.0,6,171,19362,86,13530,1067770.5647058825,284.0,157.32558139534885,85,5832,1069399.2976190476,140.0,68.61176470588235
299838.0,6,6,412,4,272,99946.0,74.0,68.0,2,140,0.0,74.0,70.0
90621017.0,6,33,2560,17,1351,5663813.5625,139.0,79.47058823529412,16,1209,6026969.2,123.0,75.5625
248940.0,6,3,337,2,214,0.0,160.0,107.0,1,123,0.0,123.0,123.0
2550531.0,6,25,7573,14,3735,196194.6923076923,1514.0,266.7857142857143,11,3838,226816.3,1514.0,348.90909090909093
333.0,17,2,174,1,79,0.0,79.0,79.0,1,95,0.0,95.0,95.0
232857.0,6,3,337,2,214,0.0,160.0,107.0,1,123,0.0,123.0,123.0
143913.0,17,2,180,1,90,0.0,90.0,90.0,1,90,0.0,90.0,90.0
103505.0,17,2,286,2,286,0.0,143.0,143.0,0,0,0.0,0.0,0.0
90255661.0,6,13,2036,8,1016,12893665.857142856,188.0,127.0,5,1020,22522703.75,204.0,204.0
6414.0,17,4,823,2,163,0.0,89.0,81.5,2,660,0.0,443.0,330.0
120040025.0,17,29,13785,29,13785,4287143.75,501.0,475.3448275862069,0,0,0.0,0.0,0.0
103429.0,17,2,286,2,286,0.0,143.0,143.0,0,0,0.0,0.0,0.0
104452.0,17,2,700,2,700,0.0,350.0,350.0,0,0,0.0,0.0,0.0
53574083.0,6,8,2113,3,960,25439188.0,826.0,320.0,5,1153,12749763.25,885.0,230.6
326.0,17,2,166,1,75,0.0,75.0,75.0,1,91,0.0,91.0,91.0
32005.0,6,14,4740,7,653,5210.833333333333,249.0,93.28571428571428,7,4087,4266.333333333333,1514.0,583.8571428571429
95765.0,6,10,2032,5,524,23667.75,252.0,104.8,5,1508,22870.75,1236.0,301.6
2333.0,17,4,344,2,150,0.0,75.0,75.0,2,194,0.0,103.0,97.0
20489.0,17,2,582,1,83,0.0,83.0,83.0,1,499,0.0,499.0,499.0
14972.0,6,11,1133,6,602,2994.4,264.0,100.33333333333331,5,531,1960.75,259.0,106.2
248920.0,17,4,6056,4,6056,82973.33333333333,1514.0,1514.0,0,0,0.0,0.0,0.0
5005180.0,17,4,849,2,166,0.0,83.0,83.0,2,683,0.0,499.0,341.5
20622.0,17,2,582,1,83,0.0,83.0,83.0,1,499,0.0,499.0,499.0
321043.0,17,4,1400,4,1400,107014.33333333331,350.0,350.0,0,0,0.0,0.0,0.0
144101.0,6,2,132,1,66,0.0,66.0,66.0,1,66,0.0,66.0,66.0
66918.0,6,14,4740,7,653,10914.166666666666,249.0,93.28571428571428,7,4087,9957.0,1514.0,583.8571428571429
206178.0,6,3,426,2,280,0.0,214.0,140.0,1,146,0.0,146.0,146.0
837947.0,6,9,1118,6,586,167589.4,248.0,97.66666666666669,3,532,282603.0,392.0,177.33333333333334
69685.0,17,2,620,1,75,0.0,75.0,75.0,1,545,0.0,545.0,545.0
90339661.0,6,19,1436,10,745,10031778.111111112,95.0,74.5,9,691,11292157.375,95.0,76.77777777777777
206303.0,6,3,426,2,280,0.0,214.0,140.0,1,146,0.0,146.0,146.0
121421.0,6,3,337,2,214,0.0,160.0,107.0,1,123,0.0,123.0,123.0
153567.0,17,2,180,1,90,0.0,90.0,90.0,1,90,0.0,90.0,90.0
142796.0,6,2,132,1,66,0.0,66.0,66.0,1,66,0.0,66.0,66.0
6190.0,17,4,344,2,150,0.0,75.0,75.0,2,194,0.0,103.0,97.0
207815.0,17,4,1400,4,1400,69271.66666666667,350.0,350.0,0,0,0.0,0.0,0.0
34503.0,6,14,4740,7,653,5021.833333333333,249.0,93.28571428571428,7,4087,5540.5,1514.0,583.8571428571429
120121099.0,6,16,2632,9,1204,15015137.375,188.0,133.77777777777777,7,1428,15066503.0,204.0,204.0
144048.0,17,2,180,1,90,0.0,90.0,90.0,1,90,0.0,90.0,90.0
216427.0,17,2,180,1,90,0.0,90.0,90.0,1,90,0.0,90.0,90.0
10520567.0,6,7,478,4,272,3461258.6666666665,74.0,68.0,3,206,5191769.0,74.0,68.66666666666667
103813.0,17,2,286,2,286,0.0,143.0,143.0,0,0,0.0,0.0,0.0
201352.0,17,2,180,1,90,0.0,90.0,90.0,1,90,0.0,90.0,90.0
103221.0,17,2,286,2,286,0.0,143.0,143.0,0,0,0.0,0.0,0.0
107841.0,17,2,286,2,286,0.0,143.0,143.0,0,0,0.0,0.0,0.0
90756681.0,6,18,1341,9,691,11344585.125,95.0,76.77777777777777,9,650,11307479.0,95.0,72.22222222222223
310691.0,6,6,412,4,272,103563.66666666669,74.0,68.0,2,140,0.0,74.0,70.0
0.0,17,1,90,1,90,0.0,90.0,90.0,0,0,0.0,0.0,0.0
192948.0,17,2,180,1,90,0.0,90.0,90.0,1,90,0.0,90.0,90.0
12318.0,6,10,1065,5,534,2432.5,262.0,106.8,5,531,2742.25,259.0,106.2
307898.0,6,6,412,4,272,102632.66666666669,74.0,68.0,2,140,0.0,74.0,70.0
108114055.0,17,5,955,5,955,27028513.75,191.0,191.0,0,0,0.0,0.0,0.0
135119720.0,17,6,1146,6,1146,27023944.0,191.0,191.0,0,0,0.0,0.0,0.0
21758.0,6,14,4740,7,653,3501.333333333333,249.0,93.28571428571428,7,4087,2439.1666666666665,1514.0,583.8571428571429
18674.0,6,14,4740,7,653,2933.333333333333,249.0,93.28571428571428,7,4087,2977.1666666666665,1514.0,583.8571428571429
540.0,17,2,508,2,508,0.0,257.0,254.0,0,0,0.0,0.0,0.0
246209.0,6,3,337,2,214,0.0,160.0,107.0,1,123,0.0,123.0,123.0
105295.0,17,2,700,2,700,0.0,350.0,350.0,0,0,0.0,0.0,0.0
105288491.0,6,44,2904,22,1452,5013737.666666667,66.0,66.0,22,1452,4998772.047619048,66.0,66.0
43822.0,6,10,2032,5,524,10393.0,252.0,104.8,5,1508,10477.25,1236.0,301.6
3581804.0,6,5,336,2,134,0.0,68.0,67.0,3,202,1427602.5,70.0,67.33333333333333
108105649.0,17,5,955,5,955,27026412.25,191.0,191.0,0,0,0.0,0.0,0.0
418803.0,6,4,508,2,238,0.0,172.0,119.0,2,270,0.0,135.0,135.0
153440.0,17,2,180,1,90,0.0,90.0,90.0,1,90,0.0,90.0,90.0
132001348.0,17,15,907,8,475,18857335.42857143,174.0,59.375,7,432,18527574.0,174.0,61.71428571428572
204739.0,17,2,762,2,762,0.0,381.0,381.0,0,0,0.0,0.0,0.0
105830.0,17,2,700,2,700,0.0,350.0,350.0,0,0,0.0,0.0,0.0
143942.0,17,2,180,1,90,0.0,90.0,90.0,1,90,0.0,90.0,90.0
49653.0,6,10,2032,5,524,12156.5,252.0,104.8,5,1508,11297.0,1236.0,301.6
476.0,17,2,508,2,508,0.0,257.0,254.0,0,0,0.0,0.0,0.0
2355.0,17,4,344,2,150,0.0,75.0,75.0,2,194,0.0,103.0,97.0
102133.0,17,2,286,2,286,0.0,143.0,143.0,0,0,0.0,0.0,0.0
220171.0,17,2,180,1,90,0.0,90.0,90.0,1,90,0.0,90.0,90.0
207265.0,6,4,492,2,280,0.0,214.0,140.0,2,212,0.0,146.0,106.0
2324.0,17,4,344,2,150,0.0,75.0,75.0,2,194,0.0,103.0,97.0
20568.0,6,11,1133,6,602,4088.6,264.0,100.33333333333331,5,531,3394.75,259.0,106.2
228395.0,17,2,180,1,90,0.0,90.0,90.0,1,90,0.0,90.0,90.0
5836532.0,6,4,270,2,134,0.0,68.0,67.0,2,136,0.0,70.0,68.0
110229946.0,17,14,864,7,432,18334552.0,174.0,61.71428571428572,7,432,18333550.0,174.0,61.71428571428572
560903.0,6,5,336,2,134,0.0,68.0,67.0,3,202,205610.5,70.0,67.33333333333333
22362.0,6,10,2032,5,524,5362.75,252.0,104.8,5,1508,5278.25,1236.0,301.6
107538.0,17,2,286,2,286,0.0,143.0,143.0,0,0,0.0,0.0,0.0
222180.0,6,3,426,2,280,0.0,214.0,140.0,1,146,0.0,146.0,146.0
124001610.0,17,15,907,8,475,17714515.714285713,174.0,59.375,7,432,17334689.666666668,174.0,61.71428571428572
51398.0,6,14,4740,7,653,8441.166666666666,249.0,93.28571428571428,7,4087,6945.666666666667,1514.0,583.8571428571429
120456194.0,6,231,26150,116,18264,1047445.1652173912,284.0,157.44827586206895,115,7886,1047533.052631579,140.0,68.57391304347826
238669.0,6,3,337,2,214,0.0,160.0,107.0,1,123,0.0,123.0,123.0
889747.0,6,9,1270,6,799,177949.4,461.0,133.16666666666666,3,471,303116.5,331.0,157.0
147593.0,17,2,180,1,90,0.0,90.0,90.0,1,90,0.0,90.0,90.0
283942.0,17,2,363,1,79,0.0,79.0,79.0,1,284,0.0,284.0,284.0
233868.0,6,3,373,2,238,0.0,172.0,119.0,1,135,0.0,135.0,135.0
302388.0,6,2,132,1,66,0.0,66.0,66.0,1,66,0.0,66.0,66.0
204865.0,17,2,180,1,90,0.0,90.0,90.0,1,90,0.0,90.0,90.0
1946.0,17,2,180,1,90,0.0,90.0,90.0,1,90,0.0,90.0,90.0
90684360.0,6,24,1829,11,840,9068436.0,95.0,76.36363636363636,13,989,7536242.583333333,95.0,76.07692307692308
0.0,17,1,44,1,44,0.0,44.0,44.0,0,0,0.0,0.0,0.0
122687768.0,6,48,3168,24,1584,5132241.0,66.0,66.0,24,1584,5076081.565217392,66.0,66.0
2594600.0,6,2,132,1,66,0.0,66.0,66.0,1,66,0.0,66.0,66.0
109570022.0,6,27,1800,14,894,8428463.23076923,123.0,63.85714285714285,13,906,8280706.5,123.0,69.6923076923077
98304.0,17,2,762,2,762,0.0,381.0,381.0,0,0,0.0,0.0,0.0
113408431.0,6,46,3036,23,1518,5154909.045454546,66.0,66.0,23,1518,5154915.863636363,66.0,66.0
2692494.0,6,3,1604,1,753,0.0,753.0,753.0,2,851,0.0,785.0,425.5
101344086.0,17,14,864,7,432,16833556.5,174.0,61.71428571428572,7,432,16835709.0,174.0,61.71428571428572
44277.0,6,10,2032,5,524,10757.0,252.0,104.8,5,1508,10722.0,1236.0,301.6
146787.0,6,3,373,2,238,0.0,172.0,119.0,1,135,0.0,135.0,135.0
263185.0,6,10,1221,6,636,52637.0,298.0,106.0,4,585,82002.0,379.0,146.25
311246.0,17,4,622,4,622,103748.66666666669,163.0,155.5,0,0,0.0,0.0,0.0
120403138.0,6,213,24020,107,16716,1135878.6603773586,284.0,156.22429906542055,106,7304,1127052.419047619,140.0,68.90566037735849
146132.0,6,3,337,2,214,0.0,160.0,107.0,1,123,0.0,123.0,123.0
135136916.0,17,6,1206,6,1206,27027383.2,201.0,201.0,0,0,0.0,0.0,0.0
51927.0,6,14,4740,7,653,7437.0,249.0,93.28571428571428,7,4087,7035.666666666667,1514.0,583.8571428571429
94068865.0,6,226,25512,113,17832,837979.8214285715,284.0,157.8053097345133,113,7680,837966.375,140.0,67.96460176991151
91413965.0,6,24,1829,13,989,7617254.333333333,95.0,76.07692307692308,11,840,9140694.7,95.0,76.36363636363636
354.0,17,2,267,1,83,0.0,83.0,83.0,1,184,0.0,184.0,184.0
2412858.0,6,46,23530,25,19797,100535.75,1514.0,791.88,21,3733,109221.2,1514.0,177.76190476190476
103207.0,17,2,286,2,286,0.0,143.0,143.0,0,0,0.0,0.0,0.0
353.0,17,2,267,1,83,0.0,83.0,83.0,1,184,0.0,184.0,184.0
34325.0,6,14,4740,7,653,5598.5,249.0,93.28571428571428,7,4087,5442.5,1514.0,583.8571428571429
228235.0,17,2,180,1,90,0.0,90.0,90.0,1,90,0.0,90.0,90.0
1012742.0,6,11,1131,6,600,202393.4,262.0,100.0,5,531,252986.75,259.0,106.2
0.0,17,1,55,1,55,0.0,55.0,55.0,0,0,0.0,0.0,0.0
146179.0,6,3,337,2,214,0.0,160.0,107.0,1,123,0.0,123.0,123.0
31462.0,6,11,2098,6,590,5794.0,252.0,98.33333333333331,5,1508,7214.75,1236.0,301.6
21797.0,17,2,582,1,83,0.0,83.0,83.0,1,499,0.0,499.0,499.0
49488.0,6,14,4740,7,653,7977.333333333333,249.0,93.28571428571428,7,4087,6084.333333333333,1514.0,583.8571428571429
216803.0,17,2,180,1,90,0.0,90.0,90.0,1,90,0.0,90.0,90.0
90053426.0,17,28,13364,28,13364,3335312.074074074,501.0,477.2857142857143,0,0,0.0,0.0,0.0
2820224.0,6,11,2106,6,598,563828.0,252.0,99.66666666666669,5,1508,2926.5,1236.0,301.6
38556.0,6,10,2032,5,524,9396.0,252.0,104.8,5,1508,9258.75,1236.0,301.6
3182354.0,6,18,1536,9,962,359628.0,315.0,106.88888888888889,9,574,359599.75,78.0,63.77777777777778
802.0,17,4,438,2,148,0.0,74.0,74.0,2,290,0.0,147.0,145.0
143846.0,17,2,180,1,90,0.0,90.0,90.0,1,90,0.0,90.0,90.0
308598.0,17,4,1400,4,1400,102866.0,350.0,350.0,0,0,0.0,0.0,0.0
228342.0,17,2,180,1,90,0.0,90.0,90.0,1,90,0.0,90.0,90.0
143504.0,6,2,132,1,66,0.0,66.0,66.0,1,66,0.0,66.0,66.0
302852.0,6,6,412,4,272,100950.66666666669,74.0,68.0,2,140,0.0,74.0,70.0
1388638.0,17,6,1230,3,234,694131.5,78.0,78.0,3,996,694113.0,332.0,332.0
102840.0,17,2,286,2,286,0.0,143.0,143.0,0,0,0.0,0.0,0.0
53439.0,6,10,2032,5,524,12917.25,252.0,104.8,5,1508,10760.0,1236.0,301.6
28926.0,6,11,2098,6,590,5262.6,252.0,98.33333333333331,5,1508,6030.75,1236.0,301.6
146329.0,6,3,337,2,214,0.0,160.0,107.0,1,123,0.0,123.0,123.0
315477.0,17,4,1400,4,1400,105159.0,350.0,350.0,0,0,0.0,0.0,0.0
5003988.0,17,4,849,2,166,0.0,83.0,83.0,2,683,0.0,499.0,341.5
2749513.0,6,25,7573,14,3735,211501.0,1514.0,266.7857142857143,11,3838,249340.5,1514.0,348.90909090909093
1298744.0,6,4,264,2,132,0.0,66.0,66.0,2,132,0.0,66.0,66.0
2837002.0,6,3,1604,1,753,0.0,753.0,753.0,2,851,0.0,785.0,425.5
143942.0,17,2,180,1,90,0.0,90.0,90.0,1,90,0.0,90.0,90.0
153446.0,17,2,180,1,90,0.0,90.0,90.0,1,90,0.0,90.0,90.0
205214.0,17,2,762,2,762,0.0,381.0,381.0,0,0,0.0,0.0,0.0
326.0,17,2,166,1,75,0.0,75.0,75.0,1,91,0.0,91.0,91.0
207148.0,6,3,426,2,280,0.0,214.0,140.0,1,146,0.0,146.0,146.0
210697.0,17,2,180,1,90,0.0,90.0,90.0,1,90,0.0,90.0,90.0
9851.0,17,2,582,1,83,0.0,83.0,83.0,1,499,0.0,499.0,499.0
16640.0,6,14,4740,7,653,2515.333333333333,249.0,93.28571428571428,7,4087,2636.833333333333,1514.0,583.8571428571429
2103018.0,6,23,7478,11,2384,210301.8,1034.0,216.72727272727272,12,5094,163574.81818181818,1510.0,424.5
146121.0,6,3,337,2,214,0.0,160.0,107.0,1,123,0.0,123.0,123.0
219933.0,6,3,426,2,280,0.0,214.0,140.0,1,146,0.0,146.0,146.0
208489.0,6,3,426,2,280,0.0,214.0,140.0,1,146,0.0,146.0,146.0
135142046.0,17,6,1146,6,1146,27028409.2,191.0,191.0,0,0,0.0,0.0,0.0
90048006.0,17,28,13364,28,13364,3335111.333333333,501.0,477.2857142857143,0,0,0.0,0.0,0.0
2335.0,17,4,344,2,150,0.0,75.0,75.0,2,194,0.0,103.0,97.0
1311992.0,6,4,264,2,132,0.0,66.0,66.0,2,132,0.0,66.0,66.0
19255546.0,6,26,8815,14,1785,1481195.8461538462,408.0,127.5,12,7030,1384065.9090909092,1514.0,585.8333333333334
299551.0,6,6,412,4,272,99850.33333333331,74.0,68.0,2,140,0.0,74.0,70.0
122007636.0,17,15,907,8,475,17429662.285714287,174.0,59.375,7,432,17000168.833333332,174.0,61.71428571428572
9470.0,17,2,539,1,86,0.0,86.0,86.0,1,453,0.0,453.0,453.0
95788805.0,6,40,2640,20,1320,5041516.052631579,66.0,66.0,20,1320,5025461.52631579,66.0,66.0
5265.0,17,4,344,2,150,0.0,75.0,75.0,2,194,0.0,103.0,97.0
103122.0,17,2,286,2,286,0.0,143.0,143.0,0,0,0.0,0.0,0.0
113001356.0,17,15,1169,8,606,16143050.857142856,174.0,75.75,7,563,15500648.333333334,174.0,80.42857142857143
17889.0,6,10,2032,5,524,4122.25,252.0,104.8,5,1508,3500.25,1236.0,301.6
120414966.0,6,233,26244,117,18292,1038060.051724138,284.0,156.34188034188034,116,7952,1038148.1391304348,140.0,68.55172413793103
6859.0,17,4,823,2,163,0.0,89.0,81.5,2,660,0.0,443.0,330.0
242573.0,6,3,337,2,214,0.0,160.0,107.0,1,123,0.0,123.0,123.0
302413.0,6,2,132,1,66,0.0,66.0,66.0,1,66,0.0,66.0,66.0
6828.0,17,2,582,1,83,0.0,83.0,83.0,1,499,0.0,499.0,499.0
304317.0,6,6,412,4,272,101439.0,74.0,68.0,2,140,0.0,74.0,70.0
6843.0,17,2,582,1,83,0.0,83.0,83.0,1,499,0.0,499.0,499.0
31096.0,6,11,2098,6,590,5739.4,252.0,98.33333333333331,5,1508,7524.0,1236.0,301.6
153428.0,17,2,180,1,90,0.0,90.0,90.0,1,90,0.0,90.0,90.0
90030788.0,17,28,13364,28,13364,3334473.6296296297,501.0,477.2857142857143,0,0,0.0,0.0,0.0
49097.0,6,10,2032,5,524,12036.75,252.0,104.8,5,1508,11965.75,1236.0,301.6
46518.0,6,14,4740,7,653,7579.333333333333,249.0,93.28571428571428,7,4087,7510.0,1514.0,583.8571428571429
18272.0,6,11,2098,6,590,3654.4,252.0,98.33333333333331,5,1508,3718.5,1236.0,301.6
75093536.0,6,9,842,9,842,9386692.0,97.0,93.55555555555556,0,0,0.0,0.0,0.0
42779.0,6,14,4740,7,653,7007.666666666667,249.0,93.28571428571428,7,4087,6590.333333333333,1514.0,583.8571428571429
2696.0,17,2,174,1,79,0.0,79.0,79.0,1,95,0.0,95.0,95.0
99968449.0,17,12,778,6,389,19961497.4,174.0,64.83333333333333,6,389,16083288.6,174.0,64.83333333333333
2879332.0,6,12,2172,7,664,479787.8333333333,252.0,94.85714285714286,5,1508,2870.0,1236.0,301.6
2006.0,17,4,344,2,150,0.0,75.0,75.0,2,194,0.0,103.0,97.0
51827.0,6,14,4740,7,653,8386.833333333334,249.0,93.28571428571428,7,4087,7753.5,1514.0,583.8571428571429
57351.0,6,14,4740,7,653,9432.833333333334,249.0,93.28571428571428,7,4087,9114.333333333334,1514.0,583.8571428571429
45773.0,6,10,2032,5,524,11227.25,252.0,104.8,5,1508,10672.0,1236.0,301.6
46823.0,6,10,2032,5,524,10976.75,252.0,104.8,5,1508,8425.75,1236.0,301.6
90255739.0,6,16,2368,9,1204,11281967.375,188.0,133.77777777777777,7,1164,15015144.333333334,204.0,166.28571428571428
317023.0,17,4,1400,4,1400,105674.33333333331,350.0,350.0,0,0,0.0,0.0,0.0
120007373.0,6,22,1639,11,799,12000737.3,95.0,72.63636363636364,11,840,11974680.7,95.0,76.36363636363636
151683.0,17,2,414,1,88,0.0,88.0,88.0,1,326,0.0,326.0,326.0
2585.0,17,4,344,2,150,0.0,75.0,75.0,2,194,0.0,103.0,97.0
205792.0,17,2,180,1,90,0.0,90.0,90.0,1,90,0.0,90.0,90.0
247069.0,17,2,180,1,90,0.0,90.0,90.0,1,90,0.0,90.0,90.0
50987.0,6,10,2032,5,524,12262.5,252.0,104.8,5,1508,11715.25,1236.0,301.6
216797.0,17,2,180,1,90,0.0,90.0,90.0,1,90,0.0,90.0,90.0
21904.0,6,10,2032,5,524,5230.0,252.0,104.8,5,1508,5199.25,1236.0,301.6
94722.0,17,3,1143,3,1143,47361.0,381.0,381.0,0,0,0.0,0.0,0.0
117176699.0,6,48,3168,24,1584,5094639.0869565215,66.0,66.0,24,1584,5082670.869565218,66.0,66.0
95743230.0,17,12,778,6,389,19148646.0,174.0,64.83333333333333,6,389,19093085.6,174.0,64.83333333333333
2031.0,17,4,344,2,150,0.0,75.0,75.0,2,194,0.0,103.0,97.0
135134622.0,17,6,1146,6,1146,27026924.4,191.0,191.0,0,0,0.0,0.0,0.0
205869.0,17,2,180,1,90,0.0,90.0,90.0,1,90,0.0,90.0,90.0
120124884.0,6,13,2020,9,1204,15015610.5,188.0,133.77777777777777,4,816,30030447.33333333,204.0,204.0
275680.0,6,12,1373,7,714,45946.66666666666,298.0,102.0,5,659,64873.0,379.0,131.8
23284.0,6,14,4740,7,653,3638.8333333333335,249.0,93.28571428571428,7,4087,3318.6666666666665,1514.0,583.8571428571429
2049770.0,17,4,820,2,156,0.0,78.0,78.0,2,664,0.0,332.0,332.0
143945.0,17,2,180,1,90,0.0,90.0,90.0,1,90,0.0,90.0,90.0
120290808.0,6,222,24962,111,7622,1085856.9363636365,140.0,68.66666666666667,111,17340,1086041.4636363636,284.0,156.21621621621622
60524.0,6,12,1328,7,797,10087.333333333334,253.0,113.85714285714286,5,531,12183.5,259.0,106.2
193968.0,17,4,1524,4,1524,64656.0,381.0,381.0,0,0,0.0,0.0,0.0
147897.0,17,2,180,1,90,0.0,90.0,90.0,1,90,0.0,90.0,90.0
105701.0,17,2,700,2,700,0.0,350.0,350.0,0,0,0.0,0.0,0.0
3899.0,17,4,704,2,148,0.0,74.0,74.0,2,556,0.0,280.0,278.0
205715.0,17,2,180,1,90,0.0,90.0,90.0,1,90,0.0,90.0,90.0
2132903.0,6,19,6869,11,1567,213290.3,408.0,142.45454545454547,8,5302,242408.14285714287,1514.0,662.75
121001415.0,17,15,907,8,475,17285916.42857143,174.0,59.375,7,432,16827532.666666668,174.0,61.71428571428572
136895.0,6,2,132,1,66,0.0,66.0,66.0,1,66,0.0,66.0,66.0
522818.0,17,2,363,1,79,0.0,79.0,79.0,1,284,0.0,284.0,284.0
778.0,17,4,438,2,148,0.0,74.0,74.0,2,290,0.0,147.0,145.0
2799888.0,6,2,132,1,66,0.0,66.0,66.0,1,66,0.0,66.0,66.0
2010.0,17,4,344,2,150,0.0,75.0,75.0,2,194,0.0,103.0,97.0
2423.0,17,4,344,2,150,0.0,75.0,75.0,2,194,0.0,103.0,97.0
5624387.0,6,4,270,2,134,0.0,68.0,67.0,2,136,0.0,70.0,68.0
4467.0,17,4,834,2,144,0.0,72.0,72.0,2,690,0.0,554.0,345.0
120125459.0,6,14,2224,9,1204,15015682.375,188.0,133.77777777777777,5,1020,22590303.25,204.0,204.0
90523981.0,6,15,2444,8,1016,12931997.285714284,188.0,127.0,7,1428,15059896.5,204.0,204.0
144167.0,17,2,180,1,90,0.0,90.0,90.0,1,90,0.0,90.0,90.0
121198.0,6,3,337,2,214,0.0,160.0,107.0,1,123,0.0,123.0,123.0
26964.0,6,14,4740,7,653,4370.166666666667,249.0,93.28571428571428,7,4087,4069.0,1514.0,583.8571428571429
0.0,6,1,66,1,66,0.0,66.0,66.0,0,0,0.0,0.0,0.0
31730.0,6,14,4740,7,653,5134.5,249.0,93.28571428571428,7,4087,4788.666666666667,1514.0,583.8571428571429
120122560.0,6,14,2224,9,1204,15015320.0,188.0,133.77777777777777,5,1020,22523594.0,204.0,204.0
37960.0,6,14,4740,7,653,6212.166666666667,249.0,93.28571428571428,7,4087,6183.833333333333,1514.0,583.8571428571429
120341.0,6,10,1065,5,534,29522.5,262.0,106.8,5,531,2392.0,259.0,106.2
47592.0,6,14,4740,7,653,7812.833333333333,249.0,93.28571428571428,7,4087,6137.833333333333,1514.0,583.8571428571429
108113760.0,17,5,1005,5,1005,27028440.0,201.0,201.0,0,0,0.0,0.0,0.0
90033755.0,17,28,13364,28,13364,3334583.5185185187,501.0,477.2857142857143,0,0,0.0,0.0,0.0
98284935.0,17,12,778,6,389,19625209.0,174.0,64.83333333333333,6,389,19492656.6,174.0,64.83333333333333
196939.0,17,2,180,1,90,0.0,90.0,90.0,1,90,0.0,90.0,90.0
526725.0,6,10,967,5,390,87435.25,162.0,78.0,5,577,90642.75,349.0,115.4
288730.0,17,2,180,1,90,0.0,90.0,90.0,1,90,0.0,90.0,90.0
28001.0,6,10,2032,5,524,6761.5,252.0,104.8,5,1508,6558.0,1236.0,301.6
103276451.0,17,14,864,7,432,17212741.833333332,174.0,61.71428571428572,7,432,17160098.833333332,174.0,61.71428571428572
17900.0,6,10,2032,5,524,4245.0,252.0,104.8,5,1508,3725.0,1236.0,301.6
143925.0,17,2,180,1,90,0.0,90.0,90.0,1,90,0.0,90.0,90.0
859649.0,6,9,1267,6,796,171929.8,458.0,132.66666666666666,3,471,293521.5,331.0,157.0
627967.0,17,2,346,1,78,0.0,78.0,78.0,1,268,0.0,268.0,268.0
738.0,17,2,762,2,762,0.0,381.0,381.0,0,0,0.0,0.0,0.0
307193.0,6,6,412,4,272,102397.66666666669,74.0,68.0,2,140,0.0,74.0,70.0
232529.0,6,3,337,2,214,0.0,160.0,107.0,1,123,0.0,123.0,123.0
312694.0,17,4,1400,4,1400,104231.33333333331,350.0,350.0,0,0,0.0,0.0,0.0
112424913.0,6,32,2220,16,1149,7480612.266666667,123.0,71.8125,16,1071,7480613.6,123.0,66.9375
123839737.0,6,48,3168,24,1584,5147149.695652174,66.0,66.0,24,1584,5150326.652173913,66.0,66.0
56746.0,6,14,4740,7,653,9335.666666666666,249.0,93.28571428571428,7,4087,8633.5,1514.0,583.8571428571429
5637814.0,6,5,336,2,134,0.0,68.0,67.0,3,202,1428078.5,70.0,67.33333333333333
104700.0,17,2,286,2,286,0.0,143.0,143.0,0,0,0.0,0.0,0.0
317228.0,17,4,1400,4,1400,105742.66666666669,350.0,350.0,0,0,0.0,0.0,0.0
316716.0,17,4,1400,4,1400,105572.0,350.0,350.0,0,0,0.0,0.0,0.0
148109.0,17,4,6056,4,6056,49369.66666666666,1514.0,1514.0,0,0,0.0,0.0,0.0
73549.0,6,10,2032,5,524,18071.25,252.0,104.8,5,1508,16077.75,1236.0,301.6
572347.0,6,4,508,2,238,0.0,172.0,119.0,2,270,0.0,135.0,135.0
108105393.0,17,5,1005,5,1005,27026348.25,201.0,201.0,0,0,0.0,0.0,0.0
2086988.0,6,19,6869,11,1567,208698.8,408.0,142.45454545454547,8,5302,234937.8571428572,1514.0,662.75
90286681.0,6,12,1832,8,1016,12898097.285714284,188.0,127.0,4,816,30030960.0,204.0,204.0
121418.0,6,3,337,2,214,0.0,160.0,107.0,1,123,0.0,123.0,123.0
90974992.0,6,20,1531,10,786,10102661.666666666,95.0,78.6,10,745,10107695.333333334,95.0,74.5
15917.0,6,10,2032,5,524,3738.25,252.0,104.8,5,1508,3547.0,1236.0,301.6
146277.0,6,3,337,2,214,0.0,160.0,107.0,1,123,0.0,123.0,123.0
509766.00000000006,6,5,336,2,134,0.0,68.0,67.0,3,202,194833.0,70.0,67.33333333333333
157412.0,6,3,337,2,214,0.0,160.0,107.0,1,123,0.0,123.0,123.0
1306966.0,6,4,264,2,132,0.0,66.0,66.0,2,132,0.0,66.0,66.0
90031941.0,17,28,13364,28,13364,3334516.333333333,501.0,477.2857142857143,0,0,0.0,0.0,0.0
2357.0,17,4,344,2,150,0.0,75.0,75.0,2,194,0.0,103.0,97.0
99382.0,17,2,762,2,762,0.0,381.0,381.0,0,0,0.0,0.0,0.0
24695.0,6,11,2098,6,590,3545.8,252.0,98.33333333333331,5,1508,5926.75,1236.0,301.6
35094.0,6,14,4740,7,653,5559.5,249.0,93.28571428571428,7,4087,5596.833333333333,1514.0,583.8571428571429
3439.0,17,2,363,1,79,0.0,79.0,79.0,1,284,0.0,284.0,284.0
91875977.0,6,183,20604,92,6294,1009626.1208791208,140.0,68.41304347826087,91,14310,1009282.1888888888,284.0,157.25274725274724
153467.0,17,2,180,1,90,0.0,90.0,90.0,1,90,0.0,90.0,90.0
86614.0,6,14,4740,7,653,13893.166666666666,249.0,93.28571428571428,7,4087,13792.333333333334,1514.0,583.8571428571429
124916095.0,6,50,3300,25,1650,4938336.208333333,66.0,66.0,25,1650,5191191.541666667,66.0,66.0
153509.0,17,2,180,1,90,0.0,90.0,90.0,1,90,0.0,90.0,90.0
122388380.0,6,196,22384,98,6764,1190167.824742268,140.0,69.0204081632653,98,15620,1256838.7835051543,284.0,159.3877551020408
143212.0,6,2,132,1,66,0.0,66.0,66.0,1,66,0.0,66.0,66.0
27590.0,6,14,4740,7,653,4474.833333333333,249.0,93.28571428571428,7,4087,4366.166666666667,1514.0,583.8571428571429
102840.0,17,2,286,2,286,0.0,143.0,143.0,0,0,0.0,0.0,0.0
1412231.0,17,16,1120,16,1120,94148.73333333334,70.0,70.0,0,0,0.0,0.0,0.0
18123.0,6,10,2032,5,524,4309.5,252.0,104.8,5,1508,4162.75,1236.0,301.6
153446.0,17,2,180,1,90,0.0,90.0,90.0,1,90,0.0,90.0,90.0
23083111.0,17,3,1034,2,684,0.0,342.0,342.0,1,350,0.0,350.0,350.0
99389.0,17,2,762,2,762,0.0,381.0,381.0,0,0,0.0,0.0,0.0
90706705.0,6,21,1585,10,745,10078522.777777778,95.0,74.5,11,840,9044563.0,95.0,76.36363636363636
83645963.0,17,13,4454,12,4104,6805542.454545454,342.0,342.0,1,350,0.0,350.0,350.0
2228.0,17,2,691,1,349,0.0,349.0,349.0,1,342,0.0,342.0,342.0
108112704.0,17,5,955,5,955,27028176.0,191.0,191.0,0,0,0.0,0.0,0.0
90524084.0,6,29,2200,15,1168,6466006.0,139.0,77.86666666666666,14,1032,6946743.769230769,123.0,73.71428571428571
120001155.0,17,15,1169,8,606,17143022.14285714,174.0,75.75,7,563,16667517.5,174.0,80.42857142857143
5622022.0,6,4,270,2,134,0.0,68.0,67.0,2,136,0.0,70.0,68.0
1468252.0,6,4,276,2,128,0.0,74.0,64.0,2,148,0.0,74.0,74.0
114535241.0,17,13,821,7,432,19089206.83333333,174.0,61.71428571428572,6,389,18876537.4,174.0,64.83333333333333
128308816.0,6,37,2640,19,1392,7128267.555555556,123.0,73.26315789473684,18,1248,6947454.764705882,123.0,69.33333333333333
0.0,17,1,90,1,90,0.0,90.0,90.0,0,0,0.0,0.0,0.0
206179.0,17,2,180,1,90,0.0,90.0,90.0,1,90,0.0,90.0,90.0
216946.0,6,3,426,2,280,0.0,214.0,140.0,1,146,0.0,146.0,146.0
108101881.0,17,5,955,5,955,27025470.25,191.0,191.0,0,0,0.0,0.0,0.0
545638.0,6,2,132,1,66,0.0,66.0,66.0,1,66,0.0,66.0,66.0
135142196.0,17,6,1206,6,1206,27028439.2,201.0,201.0,0,0,0.0,0.0,0.0
120037583.0,17,29,13785,29,13785,4287056.535714285,501.0,475.3448275862069,0,0,0.0,0.0,0.0
302352.0,6,6,412,4,272,100784.0,74.0,68.0,2,140,0.0,74.0,70.0
108104402.0,17,5,1005,5,1005,27026100.5,201.0,201.0,0,0,0.0,0.0,0.0
10453054.0,6,7,478,4,272,3438608.6666666665,74.0,68.0,3,206,5157805.5,74.0,68.66666666666667
129518.0,6,2,132,1,66,0.0,66.0,66.0,1,66,0.0,66.0,66.0
46787203.0,6,7,1874,3,887,22046465.5,753.0,295.6666666666667,4,987,14670546.0,785.0,246.75
2214.0,17,4,344,2,150,0.0,75.0,75.0,2,194,0.0,103.0,97.0
123416415.0,6,48,3168,24,1584,4987412.695652174,66.0,66.0,24,1584,5314157.391304348,66.0,66.0
18243429.0,6,26,7627,14,3735,198883.84615384616,1514.0,266.7857142857143,12,3892,1639893.7272727273,1514.0,324.3333333333333
120181991.0,6,228,25746,114,7832,1057329.168141593,140.0,68.70175438596492,114,17914,1056310.2389380531,284.0,157.140350877193
2095.0,17,4,344,2,150,0.0,75.0,75.0,2,194,0.0,103.0,97.0
120001250.0,6,18,1341,9,650,15000156.25,95.0,72.22222222222223,9,691,14967641.125,95.0,76.77777777777777
135135043.0,17,6,1146,6,1146,27027008.6,191.0,191.0,0,0,0.0,0.0,0.0
146714.0,6,3,373,2,238,0.0,172.0,119.0,1,135,0.0,135.0,135.0
135133048.0,17,6,1146,6,1146,27026609.6,191.0,191.0,0,0,0.0,0.0,0.0
305.0,17,2,168,1,76,0.0,76.0,76.0,1,92,0.0,92.0,92.0
90256693.0,6,13,2036,8,1016,12893813.285714284,188.0,127.0,5,1020,22523091.0,204.0,204.0
83027.0,6,13,1394,7,797,13837.833333333334,253.0,113.85714285714286,6,597,13635.0,259.0,99.5
0.0,6,1,66,1,66,0.0,66.0,66.0,0,0,0.0,0.0,0.0
220566.0,6,3,426,2,280,0.0,214.0,140.0,1,146,0.0,146.0,146.0
103895.0,17,2,286,2,286,0.0,143.0,143.0,0,0,0.0,0.0,0.0
29576.0,6,14,4740,7,653,4427.5,249.0,93.28571428571428,7,4087,4433.0,1514.0,583.8571428571429
218191.0,17,2,180,1,90,0.0,90.0,90.0,1,90,0.0,90.0,90.0
232221.0,6,3,337,2,214,0.0,160.0,107.0,1,123,0.0,123.0,123.0
148119.0,6,3,373,2,238,0.0,172.0,119.0,1,135,0.0,135.0,135.0
153410.0,17,2,180,1,90,0.0,90.0,90.0,1,90,0.0,90.0,90.0
2596495.0,6,2,132,1,66,0.0,66.0,66.0,1,66,0.0,66.0,66.0
384.0,17,2,762,2,762,0.0,381.0,381.0,0,0,0.0,0.0,0.0
252669.0,6,10,1221,6,636,50533.8,298.0,106.0,4,585,78755.66666666667,379.0,146.25
233773.0,6,3,373,2,238,0.0,172.0,119.0,1,135,0.0,135.0,135.0
6239.0,17,2,180,1,90,0.0,90.0,90.0,1,90,0.0,90.0,90.0
207861.0,6,3,426,2,280,0.0,214.0,140.0,1,146,0.0,146.0,146.0
849717.0,6,9,1096,6,625,169943.4,287.0,104.16666666666669,3,471,288603.5,331.0,157.0
760.0,17,4,438,2,148,0.0,74.0,74.0,2,290,0.0,147.0,145.0
508663.0,6,5,336,2,134,0.0,68.0,67.0,3,202,195093.0,70.0,67.33333333333333
77782830.0,6,22,1534,11,802,7778283.0,139.0,72.9090909090909,11,732,7756636.2,123.0,66.54545454545455
306974.0,6,6,412,4,272,102324.66666666669,74.0,68.0,2,140,0.0,74.0,70.0
186083.0,17,2,180,1,90,0.0,90.0,90.0,1,90,0.0,90.0,90.0
10478530.0,6,7,478,4,272,3447635.6666666665,74.0,68.0,3,206,5171360.0,74.0,68.66666666666667
33879.0,6,14,4740,7,653,4915.333333333333,249.0,93.28571428571428,7,4087,5475.333333333333,1514.0,583.8571428571429
178178.0,17,2,180,1,90,0.0,90.0,90.0,1,90,0.0,90.0,90.0
25250.0,6,10,2032,5,524,5837.75,252.0,104.8,5,1508,6147.75,1236.0,301.6
122978363.0,6,48,3168,24,1584,4953710.652173913,66.0,66.0,24,1584,5313514.739130435,66.0,66.0
209636.0,17,2,180,1,90,0.0,90.0,90.0,1,90,0.0,90.0,90.0
56928.0,6,14,4740,7,653,9061.0,249.0,93.28571428571428,7,4087,9217.5,1514.0,583.8571428571429
17370.0,6,14,4740,7,653,2419.1666666666665,249.0,93.28571428571428,7,4087,2758.1666666666665,1514.0,583.8571428571429
40458.0,6,14,4740,7,653,6621.666666666667,249.0,93.28571428571428,7,4087,6151.666666666667,1514.0,583.8571428571429
135130749.0,17,6,1206,6,1206,27026149.8,201.0,201.0,0,0,0.0,0.0,0.0
29465.0,17,2,582,1,83,0.0,83.0,83.0,1,499,0.0,499.0,499.0
12640.0,6,13,1459,7,862,1898.0,271.0,123.14285714285714,6,597,2355.2,259.0,99.5
90295743.0,6,16,1192,8,596,12891807.714285716,95.0,74.5,8,596,12898510.285714284,95.0,74.5
330869.0,17,4,1400,4,1400,110289.66666666669,350.0,350.0,0,0,0.0,0.0,0.0
46346.0,6,14,4740,7,653,7600.833333333333,249.0,93.28571428571428,7,4087,7388.833333333333,1514.0,583.8571428571429
319.0,17,2,174,1,79,0.0,79.0,79.0,1,95,0.0,95.0,95.0
23960.0,6,14,4740,7,653,3752.1666666666665,249.0,93.28571428571428,7,4087,3837.1666666666665,1514.0,583.8571428571429
106884.0,17,2,286,2,286,0.0,143.0,143.0,0,0,0.0,0.0,0.0
58715216.0,17,9,3086,8,2736,5107367.428571428,342.0,342.0,1,350,0.0,350.0,350.0
111386301.0,6,30,1974,15,1026,7941259.714285715,123.0,68.4,15,948,7941400.142857143,123.0,63.2
146623.0,6,3,337,2,214,0.0,160.0,107.0,1,123,0.0,123.0,123.0
115332395.0,17,16,1212,8,606,16428712.142857144,174.0,75.75,8,606,16429648.857142856,174.0,75.75
99015638.0,6,32,2484,16,1209,6601013.666666667,123.0,75.5625,16,1275,6088344.266666667,123.0,79.6875
102073721.0,6,249,28036,125,19630,823175.1693548387,284.0,157.04,124,8406,821542.9593495935,140.0,67.79032258064517
20870.0,6,10,2032,5,524,3973.5,252.0,104.8,5,1508,4976.25,1236.0,301.6
101758883.0,6,220,25656,110,7482,926102.6055045872,140.0,68.01818181818182,110,18174,926117.8440366972,284.0,165.21818181818182
107624.0,17,2,286,2,286,0.0,143.0,143.0,0,0,0.0,0.0,0.0
206574.0,17,2,762,2,762,0.0,381.0,381.0,0,0,0.0,0.0,0.0
143998.0,17,2,180,1,90,0.0,90.0,90.0,1,90,0.0,90.0,90.0
317449.0,17,4,1400,4,1400,105816.33333333331,350.0,350.0,0,0,0.0,0.0,0.0
2991.0,17,2,224,1,76,0.0,76.0,76.0,1,148,0.0,148.0,148.0
90293830.0,6,16,1192,8,596,12891944.42857143,95.0,74.5,8,596,12897265.142857144,95.0,74.5
2112.0,17,4,344,2,150,0.0,75.0,75.0,2,194,0.0,103.0,97.0
129011606.0,17,15,907,8,475,18430229.42857143,174.0,59.375,7,432,18166837.33333333,174.0,61.71428571428572
90044543.0,17,27,12943,27,12943,3463251.653846154,501.0,479.3703703703704,0,0,0.0,0.0,0.0
311552.0,17,4,622,4,622,103850.66666666669,163.0,155.5,0,0,0.0,0.0,0.0
2021744.0,17,4,525,2,150,0.0,75.0,75.0,2,375,0.0,284.0,187.5
97994407.0,6,28,2008,14,963,7538031.307692308,123.0,68.78571428571429,14,1045,7147314.692307692,139.0,74.64285714285714
35013.0,6,13,1386,7,789,5618.833333333333,253.0,112.71428571428572,6,597,6244.0,259.0,99.5
63922.00000000001,6,14,4740,7,653,9835.333333333334,249.0,93.28571428571428,7,4087,6531.333333333333,1514.0,583.8571428571429
15059.0,17,2,180,1,90,0.0,90.0,90.0,1,90,0.0,90.0,90.0
201557.0,6,10,1221,6,636,40311.4,298.0,106.0,4,585,66337.33333333333,379.0,146.25
120120777.0,6,14,2224,9,1204,15015097.125,188.0,133.77777777777777,5,1020,22519833.75,204.0,204.0
138629.0,17,4,344,2,150,0.0,75.0,75.0,2,194,0.0,103.0,97.0
5012644.0,17,4,448,2,152,0.0,76.0,76.0,2,296,0.0,148.0,148.0
21492.0,6,10,2032,5,524,4249.5,252.0,104.8,5,1508,4847.0,1236.0,301.6
373.0,17,2,267,1,83,0.0,83.0,83.0,1,184,0.0,184.0,184.0
4346.0,17,2,614,1,72,0.0,72.0,72.0,1,542,0.0,542.0,542.0
117983934.0,17,16,1212,8,606,16854847.714285713,174.0,75.75,8,606,16756706.714285716,174.0,75.75
113520266.0,6,46,3036,23,1518,5160000.181818182,66.0,66.0,23,1518,5160000.545454546,66.0,66.0
211995.0,6,10,1221,6,636,42399.0,298.0,106.0,4,585,69695.33333333333,379.0,146.25
40662.0,6,14,4740,7,653,5997.166666666667,249.0,93.28571428571428,7,4087,5910.666666666667,1514.0,583.8571428571429
34843.0,6,14,4740,7,653,5323.666666666667,249.0,93.28571428571428,7,4087,5664.166666666667,1514.0,583.8571428571429
90993221.0,6,174,19522,87,13558,1055555.6395348837,284.0,155.83908045977012,87,5964,1055556.4302325582,140.0,68.55172413793103
108413.0,17,2,286,2,286,0.0,143.0,143.0,0,0,0.0,0.0,0.0
1048201.0,6,11,1134,6,558,209640.2,220.0,93.0,5,576,259473.75,304.0,115.2
36186.0,6,14,4740,7,653,5123.0,249.0,93.28571428571428,7,4087,5217.666666666667,1514.0,583.8571428571429
116542758.0,6,48,3168,24,1584,5067076.434782608,66.0,66.0,24,1584,5053967.043478261,66.0,66.0
21456.0,6,10,2032,5,524,4955.0,252.0,104.8,5,1508,4908.25,1236.0,301.6
175235.0,17,4,704,2,148,0.0,74.0,74.0,2,556,0.0,280.0,278.0
32914667.0,6,7,1874,3,887,16393883.499999998,753.0,295.6666666666667,4,987,10928636.333333334,785.0,246.75
135135157.0,17,6,1146,6,1146,27027031.4,191.0,191.0,0,0,0.0,0.0,0.0
37701.0,6,14,4740,7,653,6153.666666666667,249.0,93.28571428571428,7,4087,5145.666666666667,1514.0,583.8571428571429
146136.0,6,3,337,2,214,0.0,160.0,107.0,1,123,0.0,123.0,123.0
360.0,17,2,160,1,80,0.0,80.0,80.0,1,80,0.0,80.0,80.0
113618928.0,6,46,3036,23,1518,5150437.363636363,66.0,66.0,23,1518,5150436.2727272725,66.0,66.0
17095.0,6,14,4740,7,653,2516.5,249.0,93.28571428571428,7,4087,2713.5,1514.0,583.8571428571429
309895.0,6,6,412,4,272,103298.33333333331,74.0,68.0,2,140,0.0,74.0,70.0
204819.0,17,4,1400,4,1400,68273.0,350.0,350.0,0,0,0.0,0.0,0.0
57941.0,6,12,1320,7,789,9656.833333333334,253.0,112.71428571428572,5,531,11085.5,259.0,106.2
123101.0,6,14,4740,7,653,20343.5,249.0,93.28571428571428,7,4087,19366.83333333333,1514.0,583.8571428571429
196817.0,17,2,180,1,90,0.0,90.0,90.0,1,90,0.0,90.0,90.0
108108589.0,17,5,955,5,955,27027147.25,191.0,191.0,0,0,0.0,0.0,0.0
135141137.0,17,6,1146,6,1146,27028227.4,191.0,191.0,0,0,0.0,0.0,0.0
43242.0,6,12,1320,6,723,8300.4,253.0,120.5,6,597,6084.2,259.0,99.5
205670.0,17,2,180,1,90,0.0,90.0,90.0,1,90,0.0,90.0,90.0
153440.0,17,2,180,1,90,0.0,90.0,90.0,1,90,0.0,90.0,90.0
6919.0,17,2,582,1,83,0.0,83.0,83.0,1,499,0.0,499.0,499.0
106463183.0,17,14,864,7,432,17667445.0,174.0,61.71428571428572,7,432,17666891.0,174.0,61.71428571428572
308251.0,6,6,412,4,272,102750.33333333331,74.0,68.0,2,140,0.0,74.0,70.0
44496.0,6,14,4740,7,653,6848.333333333333,249.0,93.28571428571428,7,4087,5053.166666666667,1514.0,583.8571428571429
344.0,17,2,250,1,93,0.0,93.0,93.0,1,157,0.0,157.0,157.0
97572.0,17,2,762,2,762,0.0,381.0,381.0,0,0,0.0,0.0,0.0
2411310.0,6,3,1604,2,851,0.0,785.0,425.5,1,753,0.0,753.0,753.0
135132526.0,17,6,1146,6,1146,27026505.2,191.0,191.0,0,0,0.0,0.0,0.0
103301.0,17,2,286,2,286,0.0,143.0,143.0,0,0,0.0,0.0,0.0
10520.0,6,10,1067,5,536,2451.25,264.0,107.2,5,531,2236.5,259.0,106.2
904962.0,6,10,1334,6,797,180992.4,459.0,132.83333333333334,4,537,209794.66666666663,331.0,134.25
0.0,17,1,99,1,99,0.0,99.0,99.0,0,0,0.0,0.0,0.0
135130973.0,17,6,1146,6,1146,27026194.6,191.0,191.0,0,0,0.0,0.0,0.0
327109.0,17,4,1400,4,1400,109036.33333333331,350.0,350.0,0,0,0.0,0.0,0.0
13360.0,6,10,1066,5,490,2569.0,218.0,98.0,5,576,3063.5,304.0,115.2
32701.0,6,14,4740,7,653,5160.166666666667,249.0,93.28571428571428,7,4087,4925.833333333333,1514.0,583.8571428571429
2314.0,17,4,344,2,150,0.0,75.0,75.0,2,194,0.0,103.0,97.0
69592.0,17,2,614,1,72,0.0,72.0,72.0,1,542,0.0,542.0,542.0
37705.0,6,14,4740,7,653,6061.0,249.0,93.28571428571428,7,4087,5852.166666666667,1514.0,583.8571428571429
405.0,17,2,410,1,78,0.0,78.0,78.0,1,332,0.0,332.0,332.0
1291096.0,17,2,359,1,75,0.0,75.0,75.0,1,284,0.0,284.0,284.0
2845.0,17,2,224,1,76,0.0,76.0,76.0,1,148,0.0,148.0,148.0
47614539.0,6,8,2113,3,960,22525411.0,826.0,320.0,5,1153,11206874.0,885.0,230.6
283947.0,17,2,363,1,79,0.0,79.0,79.0,1,284,0.0,284.0,284.0
90075811.0,17,28,13364,28,13364,3336141.1481481483,501.0,477.2857142857143,0,0,0.0,0.0,0.0
63950.00000000001,6,13,1479,7,882,10658.333333333334,291.0,126.0,6,597,11741.6,259.0,99.5
108119979.0,17,5,1005,5,1005,27029994.75,201.0,201.0,0,0,0.0,0.0,0.0
90042053.0,17,28,13364,28,13364,3334890.851851852,501.0,477.2857142857143,0,0,0.0,0.0,0.0
166093.0,17,2,414,1,88,0.0,88.0,88.0,1,326,0.0,326.0,326.0
2021490.0,17,4,525,2,150,0.0,75.0,75.0,2,375,0.0,284.0,187.5
143930.0,17,2,180,1,90,0.0,90.0,90.0,1,90,0.0,90.0,90.0
53728.0,6,13,1479,7,882,8954.666666666666,291.0,126.0,6,597,8112.8,259.0,99.5
2796973.0,6,2,132,1,66,0.0,66.0,66.0,1,66,0.0,66.0,66.0
31046.0,6,10,2032,5,524,7413.5,252.0,104.8,5,1508,7455.5,1236.0,301.6
1851.0,17,2,664,1,322,0.0,322.0,322.0,1,342,0.0,342.0,342.0
70355.0,6,14,4740,7,653,9943.333333333334,249.0,93.28571428571428,7,4087,10476.0,1514.0,583.8571428571429
104754882.0,6,44,2904,22,1452,4988327.714285715,66.0,66.0,22,1452,4973442.666666667,66.0,66.0
104114.0,17,2,286,2,286,0.0,143.0,143.0,0,0,0.0,0.0,0.0
5624813.0,6,5,336,2,134,0.0,68.0,67.0,3,202,1524616.0,70.0,67.33333333333333
180055.0,6,13,1386,7,789,30009.166666666668,253.0,112.71428571428572,6,597,33907.4,259.0,99.5
145198.0,17,4,704,2,148,0.0,74.0,74.0,2,556,0.0,280.0,278.0
481087.0,6,3,204,2,136,0.0,70.0,68.0,1,68,0.0,68.0,68.0
19764.0,6,2,145,2,145,0.0,91.0,72.5,0,0,0.0,0.0,0.0
102524811.0,6,2117,1844522,1461,1801226,70190.75068493151,1514.0,1232.8720054757016,656,43296,156518.4961832061,66.0,66.0
115688320.0,6,48,3168,24,1584,5029926.956521739,66.0,66.0,24,1584,5017943.521739131,66.0,66.0
120042725.0,17,28,13364,28,13364,4446026.851851852,501.0,477.2857142857143,0,0,0.0,0.0,0.0
5630577.0,6,5,336,2,134,0.0,68.0,67.0,3,202,1425376.5,70.0,67.33333333333333
123647967.0,6,49,3234,25,1650,5151998.625,66.0,66.0,24,1584,5193549.739130435,66.0,66.0
2459.0,17,4,344,2,150,0.0,75.0,75.0,2,194,0.0,103.0,97.0
120112286.0,6,12,1832,8,1016,17135684.285714287,188.0,127.0,4,816,30031286.0,204.0,204.0
13618849.0,6,20,1728,10,1096,1479351.6666666667,315.0,109.6,10,632,1479320.888888889,78.0,63.2
297115.0,6,6,412,4,272,99038.33333333331,74.0,68.0,2,140,0.0,74.0,70.0
298939.0,6,6,412,4,272,99646.33333333331,74.0,68.0,2,140,0.0,74.0,70.0
90016182.0,17,27,12943,27,12943,3462160.846153846,501.0,479.3703703703704,0,0,0.0,0.0,0.0
60042.0,6,12,1320,6,723,9548.8,253.0,120.5,6,597,11365.2,259.0,99.5
1083366.0,6,13,1386,7,789,180561.0,253.0,112.71428571428572,6,597,215322.2,259.0,99.5
16317663.0,17,6,2052,6,2052,3263532.6,342.0,342.0,0,0,0.0,0.0,0.0
2224966.0,6,2,132,1,66,0.0,66.0,66.0,1,66,0.0,66.0,66.0
4597664.0,6,5,336,2,134,0.0,68.0,67.0,3,202,1526393.5,70.0,67.33333333333333
2162087.0,6,2,132,1,66,0.0,66.0,66.0,1,66,0.0,66.0,66.0
41649.0,6,14,4740,7,653,6770.666666666667,249.0,93.28571428571428,7,4087,6571.333333333333,1514.0,583.8571428571429
90211885.0,6,16,1192,8,596,12852720.0,95.0,74.5,8,596,12858079.285714284,95.0,74.5
247455.0,6,3,337,2,214,0.0,160.0,107.0,1,123,0.0,123.0,123.0
42312.0,6,10,2032,5,524,10129.5,252.0,104.8,5,1508,9937.5,1236.0,301.6
51770.0,6,10,2032,5,524,12680.25,252.0,104.8,5,1508,12129.0,1236.0,301.6
103223566.0,6,204,22980,102,16026,1019990.9306930694,284.0,157.11764705882354,102,6954,1019991.1782178218,140.0,68.17647058823529
61101.0,6,14,4740,7,653,9562.833333333334,249.0,93.28571428571428,7,4087,9846.0,1514.0,583.8571428571429
20018.0,6,10,2032,5,524,4779.75,252.0,104.8,5,1508,4789.25,1236.0,301.6
811.0,17,4,438,2,148,0.0,74.0,74.0,2,290,0.0,147.0,145.0
31954.000000000004,6,13,1479,7,882,5126.333333333333,291.0,126.0,6,597,4933.4,259.0,99.5
123001127.0,17,15,1169,8,606,17571589.57142857,174.0,75.75,7,563,17167864.666666668,174.0,80.42857142857143
707.0,17,4,438,2,148,0.0,74.0,74.0,2,290,0.0,147.0,145.0
90028967.0,17,28,13364,28,13364,3334406.185185185,501.0,477.2857142857143,0,0,0.0,0.0,0.0
56774.0,6,10,2032,5,524,12926.5,252.0,104.8,5,1508,12689.0,1236.0,301.6
90034436.0,17,27,12943,27,12943,3462862.923076923,501.0,479.3703703703704,0,0,0.0,0.0,0.0
110980.0,17,4,1400,4,1400,36993.333333333336,350.0,350.0,0,0,0.0,0.0,0.0
855038.0,6,9,1267,6,796,171007.6,458.0,132.66666666666666,3,471,289849.5,331.0,157.0
102987453.0,6,30,2122,15,1105,7340828.0,139.0,73.66666666666667,15,1017,7340827.857142857,123.0,67.8
324.0,17,2,174,1,79,0.0,79.0,79.0,1,95,0.0,95.0,95.0
108103778.0,17,5,955,5,955,27025944.5,191.0,191.0,0,0,0.0,0.0,0.0
118707641.0,6,35,2536,18,1248,6982802.411764706,123.0,69.33333333333333,17,1288,6925452.6875,139.0,75.76470588235294
135134682.0,17,6,1146,6,1146,27026936.4,191.0,191.0,0,0,0.0,0.0,0.0
108103639.0,17,5,955,5,955,27025909.75,191.0,191.0,0,0,0.0,0.0,0.0
1991.0,17,4,344,2,150,0.0,75.0,75.0,2,194,0.0,103.0,97.0
123825895.0,17,14,864,7,432,17333444.0,174.0,61.71428571428572,7,432,17334187.0,174.0,61.71428571428572
101269364.0,17,14,864,7,432,16834263.666666668,174.0,61.71428571428572,7,432,16833495.833333332,174.0,61.71428571428572
16863806.0,6,20,1611,9,921,2060279.125,315.0,102.33333333333331,11,690,1648348.2,78.0,62.72727272727273
94046833.0,6,184,20760,92,14466,1031116.1208791208,284.0,157.2391304347826,92,6294,1031116.912087912,140.0,68.41304347826087
101165972.0,17,14,864,7,432,16834505.666666668,174.0,61.71428571428572,7,432,16833511.5,174.0,61.71428571428572
111121.0,17,2,762,2,762,0.0,381.0,381.0,0,0,0.0,0.0,0.0
0.0,6,1,172,1,172,0.0,172.0,172.0,0,0,0.0,0.0,0.0
31018.0,6,14,4740,7,653,5061.0,249.0,93.28571428571428,7,4087,4377.666666666667,1514.0,583.8571428571429
60799.0,6,14,4740,7,653,8837.5,249.0,93.28571428571428,7,4087,9466.166666666666,1514.0,583.8571428571429
120008186.0,6,21,1585,11,840,11999987.3,95.0,76.36363636363636,10,745,13333253.333333334,95.0,74.5
3008.0,17,2,224,1,76,0.0,76.0,76.0,1,148,0.0,148.0,148.0
124414785.0,6,35,2410,18,1285,7318516.764705882,139.0,71.38888888888889,17,1125,7138302.125,123.0,66.17647058823529
135131185.0,17,6,1146,6,1146,27026237.0,191.0,191.0,0,0,0.0,0.0,0.0
1433.0,17,2,762,2,762,0.0,381.0,381.0,0,0,0.0,0.0,0.0
245075.0,6,3,337,2,214,0.0,160.0,107.0,1,123,0.0,123.0,123.0
1321007.0,6,4,264,2,132,0.0,66.0,66.0,2,132,0.0,66.0,66.0
108578959.0,6,33,2412,17,1272,6772681.0,123.0,74.82352941176471,16,1140,7224207.066666666,123.0,71.25
21823.0,6,14,4740,7,653,3252.6666666666665,249.0,93.28571428571428,7,4087,3398.833333333333,1514.0,583.8571428571429
146626.0,6,3,337,2,214,0.0,160.0,107.0,1,123,0.0,123.0,123.0
46239.0,6,10,2032,5,524,11337.75,252.0,104.8,5,1508,10175.0,1236.0,301.6
117670045.0,6,218,24662,109,17172,1087638.3055555555,284.0,157.54128440366972,109,7490,1087644.0925925926,140.0,68.71559633027523
30897.0,6,10,2032,5,524,7503.5,252.0,104.8,5,1508,6835.25,1236.0,301.6
88742.0,6,14,4740,7,653,14650.666666666666,249.0,93.28571428571428,7,4087,11348.0,1514.0,583.8571428571429
120000867.0,6,17,1287,9,691,15000108.375,95.0,76.77777777777777,8,596,12857815.57142857,95.0,74.5
7819.0,17,2,582,1,83,0.0,83.0,83.0,1,499,0.0,499.0,499.0
43370.0,6,13,1479,7,882,7228.333333333333,291.0,126.0,6,597,5222.8,259.0,99.5
46423.0,6,14,4740,7,653,7600.166666666667,249.0,93.28571428571428,7,4087,6294.166666666667,1514.0,583.8571428571429
30849.0,6,14,4740,7,653,4988.0,249.0,93.28571428571428,7,4087,4999.5,1514.0,583.8571428571429
33928.0,6,14,4740,7,653,5432.0,249.0,93.28571428571428,7,4087,5107.5,1514.0,583.8571428571429
135132178.0,17,6,1146,6,1146,27026435.6,191.0,191.0,0,0,0.0,0.0,0.0
115062660.0,6,48,3168,24,1584,5002724.347826087,66.0,66.0,24,1584,4990728.347826087,66.0,66.0
10558194.0,6,7,478,4,272,3472290.0,74.0,68.0,3,206,5208312.0,74.0,68.66666666666667
9763.0,17,2,582,1,83,0.0,83.0,83.0,1,499,0.0,499.0,499.0
419.0,17,2,300,1,80,0.0,80.0,80.0,1,220,0.0,220.0,220.0
190891.0,17,2,180,1,90,0.0,90.0,90.0,1,90,0.0,90.0,90.0
1877188.0,6,2,132,1,66,0.0,66.0,66.0,1,66,0.0,66.0,66.0
2074.0,17,4,344,2,150,0.0,75.0,75.0,2,194,0.0,103.0,97.0
232413.0,17,2,180,1,90,0.0,90.0,90.0,1,90,0.0,90.0,90.0
27724.0,6,14,4740,7,653,4496.166666666667,249.0,93.28571428571428,7,4087,4335.0,1514.0,583.8571428571429
864.0,17,4,438,2,148,0.0,74.0,74.0,2,290,0.0,147.0,145.0
61654.0,6,12,1413,6,816,11905.6,291.0,136.0,6,597,11225.2,259.0,99.5
3607.0,17,4,344,2,150,0.0,75.0,75.0,2,194,0.0,103.0,97.0
122302.0,6,3,373,2,238,0.0,172.0,119.0,1,135,0.0,135.0,135.0
197969.0,17,4,6056,4,6056,65989.66666666667,1514.0,1514.0,0,0,0.0,0.0,0.0
1302375.0,6,4,264,2,132,0.0,66.0,66.0,2,132,0.0,66.0,66.0
90296137.0,6,19,1436,10,745,10027643.888888888,95.0,74.5,9,691,11285660.5,95.0,76.77777777777777
104937351.0,17,15,5130,15,5130,7495525.071428572,342.0,342.0,0,0,0.0,0.0,0.0
90063075.0,17,28,13364,28,13364,3335669.4444444445,501.0,477.2857142857143,0,0,0.0,0.0,0.0
204501.0,17,2,762,2,762,0.0,381.0,381.0,0,0,0.0,0.0,0.0
0.0,6,1,54,1,54,0.0,54.0,54.0,0,0,0.0,0.0,0.0
90034952.0,17,28,13364,28,13364,3334627.851851852,501.0,477.2857142857143,0,0,0.0,0.0,0.0
747738.0,6,2,132,1,66,0.0,66.0,66.0,1,66,0.0,66.0,66.0
905608.0,6,12,1354,6,723,179734.8,253.0,120.5,6,631,180692.4,293.0,105.16666666666669
162244.0,17,2,180,1,90,0.0,90.0,90.0,1,90,0.0,90.0,90.0
298894.0,6,6,412,4,272,99631.33333333331,74.0,68.0,2,140,0.0,74.0,70.0
300855.0,6,6,412,4,272,100285.0,74.0,68.0,2,140,0.0,74.0,70.0
108105083.0,17,5,1005,5,1005,27026270.75,201.0,201.0,0,0,0.0,0.0,0.0
39353.0,6,14,4740,7,653,6429.166666666667,249.0,93.28571428571428,7,4087,6288.0,1514.0,583.8571428571429
105625.0,17,2,700,2,700,0.0,350.0,350.0,0,0,0.0,0.0,0.0
120123733.0,6,14,2240,6,1224,24024746.6,204.0,204.0,8,1016,17136682.42857143,188.0,127.0
104141833.0,6,195,22064,98,6764,1073627.144329897,140.0,69.0204081632653,97,15300,1074001.4375,284.0,157.7319587628866
248650.0,6,12,1373,7,714,41441.66666666666,298.0,102.0,5,659,57848.25,379.0,131.8
213641.0,17,2,180,1,90,0.0,90.0,90.0,1,90,0.0,90.0,90.0
135135972.0,17,6,1146,6,1146,27027194.4,191.0,191.0,0,0,0.0,0.0,0.0
232953.0,6,3,337,2,214,0.0,160.0,107.0,1,123,0.0,123.0,123.0
10395.0,6,11,1133,6,602,1950.0,264.0,100.33333333333331,5,531,2047.75,259.0,106.2
90033045.0,17,27,12943,27,12943,3462809.423076923,501.0,479.3703703703704,0,0,0.0,0.0,0.0
359.0,17,2,166,1,75,0.0,75.0,75.0,1,91,0.0,91.0,91.0
323523.0,17,4,1400,4,1400,107841.0,350.0,350.0,0,0,0.0,0.0,0.0
2372.0,17,4,344,2,150,0.0,75.0,75.0,2,194,0.0,103.0,97.0
318591.0,6,6,412,4,272,106197.0,74.0,68.0,2,140,0.0,74.0,70.0
109047.0,17,2,762,2,762,0.0,381.0,381.0,0,0,0.0,0.0,0.0
1091955.0,6,12,1447,6,816,216910.2,291.0,136.0,6,631,218215.4,293.0,105.16666666666669
101350958.0,17,14,864,7,432,16833499.0,174.0,61.71428571428572,7,432,16834260.666666668,174.0,61.71428571428572
4249.0,17,2,618,1,82,0.0,82.0,82.0,1,536,0.0,536.0,536.0
319828.0,17,4,1400,4,1400,106609.33333333331,350.0,350.0,0,0,0.0,0.0,0.0
285839.0,6,10,1221,6,636,57167.8,298.0,106.0,4,585,91547.66666666669,379.0,146.25
773671.0,6,11,1021,6,444,130943.2,162.0,74.0,5,577,163244.5,349.0,115.4
307936.0,6,6,412,4,272,102645.33333333331,74.0,68.0,2,140,0.0,74.0,70.0
261050.0,6,3,337,2,214,0.0,160.0,107.0,1,123,0.0,123.0,123.0
149928.0,6,13,1386,7,789,24988.0,253.0,112.71428571428572,6,597,27250.0,259.0,99.5
2611373.0,6,25,7573,14,3735,200874.84615384616,1514.0,266.7857142857143,11,3838,235878.9,1514.0,348.90909090909093
119609694.0,17,13,690,7,432,19934949.0,174.0,61.71428571428572,6,258,20001826.4,43.0,43.0
233514.0,6,3,373,2,238,0.0,172.0,119.0,1,135,0.0,135.0,135.0
68417.0,6,14,4740,7,653,11093.333333333334,249.0,93.28571428571428,7,4087,10479.0,1514.0,583.8571428571429
143969.0,17,2,180,1,90,0.0,90.0,90.0,1,90,0.0,90.0,90.0
131861932.0,17,16,1212,8,606,18837418.85714286,174.0,75.75,8,606,15997973.0,174.0,75.75
31458.0,6,14,4740,7,653,4292.5,249.0,93.28571428571428,7,4087,5104.5,1514.0,583.8571428571429
146197.0,6,3,337,2,214,0.0,160.0,107.0,1,123,0.0,123.0,123.0
90272931.0,6,31,2314,16,1228,6003802.4,139.0,76.75,15,1086,6432646.214285715,123.0,72.4
1315528.0,6,4,264,2,132,0.0,66.0,66.0,2,132,0.0,66.0,66.0
2558042.0,6,25,7573,14,3735,196772.4615384616,1514.0,266.7857142857143,11,3838,231093.8,1514.0,348.90909090909093
248176.0,6,3,337,2,214,0.0,160.0,107.0,1,123,0.0,123.0,123.0
44532.0,6,10,2032,5,524,10600.75,252.0,104.8,5,1508,10816.25,1236.0,301.6
120002462.0,6,18,1341,9,691,14999971.875,95.0,76.77777777777777,9,650,14999505.875,95.0,72.22222222222223
118753145.0,6,48,3168,24,1584,5163180.217391305,66.0,66.0,24,1584,5153782.826086956,66.0,66.0
56360.0,6,14,4740,7,653,8899.166666666666,249.0,93.28571428571428,7,4087,7609.333333333333,1514.0,583.8571428571429
135142955.0,17,6,1146,6,1146,27028591.0,191.0,191.0,0,0,0.0,0.0,0.0
2397.0,17,4,344,2,150,0.0,75.0,75.0,2,194,0.0,103.0,97.0
206138.0,6,3,426,2,280,0.0,214.0,140.0,1,146,0.0,146.0,146.0
209723.0,6,10,1221,6,636,41944.6,298.0,106.0,4,585,68638.66666666667,379.0,146.25
112810.0,17,4,1400,4,1400,37603.333333333336,350.0,350.0,0,0,0.0,0.0,0.0
297384.0,6,6,412,4,272,99128.0,74.0,68.0,2,140,0.0,74.0,70.0
120125706.0,6,13,2020,9,1204,15015713.25,188.0,133.77777777777777,4,816,30033161.666666668,204.0,204.0
120032909.0,17,29,13785,29,13785,4286889.607142857,501.0,475.3448275862069,0,0,0.0,0.0,0.0
862115.0,6,9,1096,6,625,172423.0,287.0,104.16666666666669,3,471,294700.0,331.0,157.0
210891.0,17,2,180,1,90,0.0,90.0,90.0,1,90,0.0,90.0,90.0
1199966.0,17,7,490,7,490,199994.3333333333,70.0,70.0,0,0,0.0,0.0,0.0
23613.0,6,13,1459,7,862,3714.5,271.0,123.14285714285714,6,597,4414.8,259.0,99.5
104919.0,17,2,286,2,286,0.0,143.0,143.0,0,0,0.0,0.0,0.0
94377.0,6,14,4740,7,653,14815.166666666666,249.0,93.28571428571428,7,4087,14948.5,1514.0,583.8571428571429
108492633.0,6,31,2166,16,1149,7218462.6,123.0,71.8125,15,1017,7734066.642857143,123.0,67.8
54359.0,6,10,2032,5,524,13350.25,252.0,104.8,5,1508,11941.75,1236.0,301.6
111009468.0,6,30,1974,15,1026,7913820.714285715,123.0,68.4,15,948,7913820.428571428,123.0,63.2
46578.0,6,14,4740,7,653,7642.5,249.0,93.28571428571428,7,4087,7536.166666666667,1514.0,583.8571428571429
30528.0,6,10,2032,5,524,7050.25,252.0,104.8,5,1508,5701.75,1236.0,301.6
14968.0,17,2,180,1,90,0.0,90.0,90.0,1,90,0.0,90.0,90.0
2798201.0,6,2,132,1,66,0.0,66.0,66.0,1,66,0.0,66.0,66.0
350.0,17,2,267,1,83,0.0,83.0,83.0,1,184,0.0,184.0,184.0
135128989.0,17,6,1206,6,1206,27025797.8,201.0,201.0,0,0,0.0,0.0,0.0
504492.00000000006,6,5,336,2,134,0.0,68.0,67.0,3,202,193067.0,70.0,67.33333333333333
146060.0,6,3,337,2,214,0.0,160.0,107.0,1,123,0.0,123.0,123.0
857751.0,6,9,1096,6,625,171550.2,287.0,104.16666666666669,3,471,291028.5,331.0,157.0
301042.0,6,6,412,4,272,100347.33333333331,74.0,68.0,2,140,0.0,74.0,70.0
5632602.0,6,5,336,2,134,0.0,68.0,67.0,3,202,1434275.5,70.0,67.33333333333333
36997.0,6,14,4740,7,653,6006.333333333333,249.0,93.28571428571428,7,4087,5833.833333333333,1514.0,583.8571428571429
534219.0,6,4,508,2,238,0.0,172.0,119.0,2,270,0.0,135.0,135.0
13904.0,6,14,4740,7,653,2165.333333333333,249.0,93.28571428571428,7,4087,2140.0,1514.0,583.8571428571429
121134649.0,6,31,2034,16,1086,8075643.266666667,123.0,67.875,15,948,7923834.214285715,123.0,63.2
2362.0,17,4,344,2,150,0.0,75.0,75.0,2,194,0.0,103.0,97.0
234542.0,6,3,337,2,214,0.0,160.0,107.0,1,123,0.0,123.0,123.0
135139599.0,17,6,1146,6,1146,27027919.8,191.0,191.0,0,0,0.0,0.0,0.0
205824.0,17,4,1400,4,1400,68608.0,350.0,350.0,0,0,0.0,0.0,0.0
41592.0,6,14,4740,7,653,6616.666666666667,249.0,93.28571428571428,7,4087,6638.833333333333,1514.0,583.8571428571429
221799.0,17,2,180,1,90,0.0,90.0,90.0,1,90,0.0,90.0,90.0
48888.0,6,14,4740,7,653,8018.166666666667,249.0,93.28571428571428,7,4087,7659.0,1514.0,583.8571428571429
247470.0,6,3,337,2,214,0.0,160.0,107.0,1,123,0.0,123.0,123.0
90252313.0,6,14,2240,8,1016,12893187.57142857,188.0,127.0,6,1224,18018031.2,204.0,204.0
20117.0,17,2,582,1,83,0.0,83.0,83.0,1,499,0.0,499.0,499.0
232003.0,6,10,1221,6,636,46400.6,298.0,106.0,4,585,76440.66666666667,379.0,146.25
868798.0,6,9,1267,6,796,173759.6,458.0,132.66666666666666,3,471,296548.0,331.0,157.0
99444197.0,17,14,1126,7,563,16501616.5,174.0,80.42857142857143,7,563,16500201.333333334,174.0,80.42857142857143
108112176.0,17,5,955,5,955,27028044.0,191.0,191.0,0,0,0.0,0.0,0.0
846481.0,6,12,1354,6,723,168294.2,253.0,120.5,6,631,167734.2,293.0,105.16666666666669
811.0,17,4,438,2,148,0.0,74.0,74.0,2,290,0.0,147.0,145.0
151512.0,17,2,414,1,88,0.0,88.0,88.0,1,326,0.0,326.0,326.0
120545839.0,6,223,25278,112,17730,1085998.5495495496,284.0,158.30357142857142,111,7548,1086401.8909090909,140.0,68.0
126534639.0,17,14,864,7,432,17834225.166666668,174.0,61.71428571428572,7,432,17833526.5,174.0,61.71428571428572
23212.0,6,14,4740,7,653,3597.6666666666665,249.0,93.28571428571428,7,4087,3637.0,1514.0,583.8571428571429
5629795.0,6,5,336,2,134,0.0,68.0,67.0,3,202,1530333.0,70.0,67.33333333333333
536967.0,6,4,492,2,280,0.0,214.0,140.0,2,212,0.0,146.0,106.0
3174922.0,6,7,923,4,753,989622.6666666666,571.0,188.25,3,170,1484807.5,62.0,56.66666666666666
331.0,17,2,166,1,75,0.0,75.0,75.0,1,91,0.0,91.0,91.0
301.0,17,2,168,1,76,0.0,76.0,76.0,1,92,0.0,92.0,92.0
20447.0,6,10,2032,5,524,4836.25,252.0,104.8,5,1508,3488.25,1236.0,301.6
120008348.0,6,461,56968,231,15468,521775.4260869565,140.0,66.96103896103897,230,41500,522968.0480349345,284.0,180.43478260869568
1169023.0,6,13,3017,8,2389,167003.2857142857,1514.0,298.625,5,628,224122.0,331.0,125.6
329.0,17,2,160,1,80,0.0,80.0,80.0,1,80,0.0,80.0,80.0
39032.0,6,14,4740,7,653,6327.833333333333,249.0,93.28571428571428,7,4087,5468.166666666667,1514.0,583.8571428571429
115117897.0,6,196,22220,98,6690,1178318.9484536082,140.0,68.26530612244898,98,15530,1178303.855670103,284.0,158.46938775510205
135127456.0,17,6,1206,6,1206,27025491.2,201.0,201.0,0,0,0.0,0.0,0.0
1752129.0,6,22,6443,12,1529,159284.45454545456,357.0,127.41666666666669,10,4914,160855.11111111112,1510.0,491.4
319574.0,17,4,1400,4,1400,106524.66666666669,350.0,350.0,0,0,0.0,0.0,0.0
27118.0,17,4,823,2,163,0.0,89.0,81.5,2,660,0.0,443.0,330.0
2909357.0,6,130,95645,69,87317,42784.66176470588,1510.0,1265.463768115942,61,8328,43423.45,1510.0,136.52459016393442
119816019.0,6,20,1490,10,745,13312891.0,95.0,74.5,10,745,13285292.222222222,95.0,74.5
116000966.0,17,15,1169,8,606,16571566.57142857,174.0,75.75,7,563,17498148.666666668,174.0,80.42857142857143
135132557.0,17,6,1146,6,1146,27026511.4,191.0,191.0,0,0,0.0,0.0,0.0
41485.0,6,14,4740,7,653,6006.5,249.0,93.28571428571428,7,4087,6016.5,1514.0,583.8571428571429
9648.0,17,2,582,1,83,0.0,83.0,83.0,1,499,0.0,499.0,499.0
255598.0,6,3,337,2,214,0.0,160.0,107.0,1,123,0.0,123.0,123.0
144067.0,17,2,180,1,90,0.0,90.0,90.0,1,90,0.0,90.0,90.0
153532.0,17,2,180,1,90,0.0,90.0,90.0,1,90,0.0,90.0,90.0
217742.0,6,3,426,2,280,0.0,214.0,140.0,1,146,0.0,146.0,146.0
90029583.0,17,28,13364,28,13364,3334429.0,501.0,477.2857142857143,0,0,0.0,0.0,0.0
124225653.0,6,39,2902,20,1531,6538192.263157895,139.0,76.55,19,1371,6334638.222222222,123.0,72.15789473684211
90032430.0,17,28,13364,28,13364,3334534.4444444445,501.0,477.2857142857143,0,0,0.0,0.0,0.0
198071.0,17,2,180,1,90,0.0,90.0,90.0,1,90,0.0,90.0,90.0
315177.0,6,6,412,4,272,105059.0,74.0,68.0,2,140,0.0,74.0,70.0
3577062.0,6,5,336,2,134,0.0,68.0,67.0,3,202,1423936.5,70.0,67.33333333333333
144986.0,17,2,180,1,70,0.0,70.0,70.0,1,110,0.0,110.0,110.0
105952.0,17,2,700,2,700,0.0,350.0,350.0,0,0,0.0,0.0,0.0
24986.0,6,10,2032,5,524,5998.5,252.0,104.8,5,1508,5931.5,1236.0,301.6
197093.0,17,2,180,1,90,0.0,90.0,90.0,1,90,0.0,90.0,90.0
82755.0,6,2,157,1,103,0.0,103.0,103.0,1,54,0.0,54.0,54.0
120039786.0,17,28,13364,28,13364,4445918.0,501.0,477.2857142857143,0,0,0.0,0.0,0.0
747975.0,6,2,132,1,66,0.0,66.0,66.0,1,66,0.0,66.0,66.0
110443014.0,6,32,2236,16,1165,7362867.6,139.0,72.8125,16,1071,7348437.733333333,123.0,66.9375
2380.0,17,4,344,2,150,0.0,75.0,75.0,2,194,0.0,103.0,97.0
34608.0,6,13,1479,7,882,5768.0,291.0,126.0,6,597,5291.0,259.0,99.5
90266101.0,6,12,1832,8,1016,12895157.285714284,188.0,127.0,4,816,30033421.33333333,204.0,204.0
33084.0,6,10,2032,5,524,8031.75,252.0,104.8,5,1508,7769.5,1236.0,301.6
120292367.0,6,224,25200,112,7688,1067056.6846846847,140.0,68.64285714285714,112,17512,1080883.5045045046,284.0,156.35714285714286
284076.0,17,2,363,1,79,0.0,79.0,79.0,1,284,0.0,284.0,284.0
68811.0,6,10,2032,5,524,16850.0,252.0,104.8,5,1508,16285.75,1236.0,301.6
129006287.0,17,15,907,8,475,18429469.57142857,174.0,59.375,7,432,18166832.33333333,174.0,61.71428571428572
90055883.0,17,28,13364,28,13364,3335403.074074074,501.0,477.2857142857143,0,0,0.0,0.0,0.0
126565751.0,17,14,864,7,432,17833507.333333332,174.0,61.71428571428572,7,432,19930109.166666668,174.0,61.71428571428572
528165.0,17,2,876,2,876,0.0,438.0,438.0,0,0,0.0,0.0,0.0
119160811.0,17,16,1212,8,606,17000134.285714287,174.0,75.75,8,606,17001040.85714286,174.0,75.75
67781.0,6,11,2098,6,590,13111.8,252.0,98.33333333333331,5,1508,14571.0,1236.0,301.6
504793.00000000006,6,5,336,2,134,0.0,68.0,67.0,3,202,193697.0,70.0,67.33333333333333
2740022.0,6,2,134,1,68,0.0,68.0,68.0,1,66,0.0,66.0,66.0
241296.0,6,3,337,2,214,0.0,160.0,107.0,1,123,0.0,123.0,123.0
15011.0,6,14,4740,7,653,2342.0,249.0,93.28571428571428,7,4087,2368.0,1514.0,583.8571428571429
208495.0,6,3,426,2,280,0.0,214.0,140.0,1,146,0.0,146.0,146.0
90021694.0,17,27,12943,27,12943,3462372.846153846,501.0,479.3703703703704,0,0,0.0,0.0,0.0
145043.0,17,2,180,1,70,0.0,70.0,70.0,1,110,0.0,110.0,110.0
305625.0,6,6,412,4,272,101875.0,74.0,68.0,2,140,0.0,74.0,70.0
1156389.0,6,13,3020,8,2392,165198.42857142858,1514.0,299.0,5,628,220952.0,331.0,125.6
33060.0,6,10,2032,5,524,7685.25,252.0,104.8,5,1508,7272.75,1236.0,301.6
2798440.0,6,2,132,1,66,0.0,66.0,66.0,1,66,0.0,66.0,66.0
2791.0,17,2,239,1,82,0.0,82.0,82.0,1,157,0.0,157.0,157.0
209247.0,17,4,6056,4,6056,69749.0,1514.0,1514.0,0,0,0.0,0.0,0.0
116396506.0,6,211,23728,106,7218,1108538.1523809524,140.0,68.09433962264151,105,16510,1109189.1346153845,284.0,157.23809523809524
1226902.0,17,7,490,7,490,204483.66666666663,70.0,70.0,0,0,0.0,0.0,0.0
56275.0,6,14,4740,7,653,9171.666666666666,249.0,93.28571428571428,7,4087,9236.833333333334,1514.0,583.8571428571429
219533.0,6,3,426,2,280,0.0,214.0,140.0,1,146,0.0,146.0,146.0
4597386.0,6,5,336,2,134,0.0,68.0,67.0,3,202,1526590.5,70.0,67.33333333333333
92006600.0,17,11,735,6,389,18401320.0,174.0,64.83333333333333,5,346,18000159.25,174.0,69.2
399.0,17,2,410,1,78,0.0,78.0,78.0,1,332,0.0,332.0,332.0
314807.0,17,4,1400,4,1400,104935.66666666669,350.0,350.0,0,0,0.0,0.0,0.0
143897.0,17,2,180,1,90,0.0,90.0,90.0,1,90,0.0,90.0,90.0
278744.0,6,10,1221,6,636,55748.8,298.0,106.0,4,585,87221.0,379.0,146.25
90209060.0,6,22,1680,10,745,9996831.222222222,95.0,74.5,12,935,8182142.636363637,95.0,77.91666666666667
2405.0,17,4,344,2,150,0.0,75.0,75.0,2,194,0.0,103.0,97.0
0.0,17,1,179,1,179,0.0,179.0,179.0,0,0,0.0,0.0,0.0
216568.0,17,2,180,1,90,0.0,90.0,90.0,1,90,0.0,90.0,90.0
587890.0,6,4,508,2,238,0.0,172.0,119.0,2,270,0.0,135.0,135.0
111379355.0,6,203,23026,102,7028,1102765.891089109,140.0,68.90196078431373,101,15998,1111603.03,284.0,158.3960396039604
1323273.0,6,4,264,2,132,0.0,66.0,66.0,2,132,0.0,66.0,66.0
90258913.0,6,12,1832,8,1016,12894130.42857143,188.0,127.0,4,816,30031457.33333333,204.0,204.0
119548010.0,6,213,24040,107,7284,1127811.4150943395,140.0,68.07476635514018,106,16756,1128701.0,284.0,158.0754716981132
103883.0,17,2,700,2,700,0.0,350.0,350.0,0,0,0.0,0.0,0.0
302459.0,6,2,132,1,66,0.0,66.0,66.0,1,66,0.0,66.0,66.0
2623201.0,6,11,1134,6,558,524640.2,220.0,93.0,5,576,654229.0,304.0,115.2
0.0,17,1,179,1,179,0.0,179.0,179.0,0,0,0.0,0.0,0.0
120247.0,17,2,180,1,70,0.0,70.0,70.0,1,110,0.0,110.0,110.0
100245199.0,17,12,516,6,258,20001106.0,43.0,43.0,6,258,20000190.2,43.0,43.0
2638988.0,6,2,132,1,66,0.0,66.0,66.0,1,66,0.0,66.0,66.0
2397.0,17,2,684,1,342,0.0,342.0,342.0,1,342,0.0,342.0,342.0
47945.0,6,14,4740,7,653,7866.166666666667,249.0,93.28571428571428,7,4087,7527.0,1514.0,583.8571428571429
2858001.0,6,12,2172,7,664,476177.8333333333,252.0,94.85714285714286,5,1508,1979.25,1236.0,301.6
120295537.0,6,215,24230,108,16872,1124257.3551401868,284.0,156.22222222222223,107,7358,1125047.8962264152,140.0,68.76635514018692
32327.0,6,10,2032,5,524,7881.5,252.0,104.8,5,1508,4560.25,1236.0,301.6
5622462.0,6,5,336,2,134,0.0,68.0,67.0,3,202,1526292.0,70.0,67.33333333333333
317406.0,6,10,1221,6,636,63481.2,298.0,106.0,4,585,100410.33333333331,379.0,146.25
205502.0,17,2,762,2,762,0.0,381.0,381.0,0,0,0.0,0.0,0.0
91799.0,6,14,4740,7,653,14413.166666666666,249.0,93.28571428571428,7,4087,15142.5,1514.0,583.8571428571429
28216.0,6,14,4740,7,653,4508.333333333333,249.0,93.28571428571428,7,4087,4568.333333333333,1514.0,583.8571428571429
53355.0,6,10,2032,5,524,12912.75,252.0,104.8,5,1508,10791.25,1236.0,301.6
314952.0,17,4,1400,4,1400,104984.0,350.0,350.0,0,0,0.0,0.0,0.0
2457.0,17,4,344,2,150,0.0,75.0,75.0,2,194,0.0,103.0,97.0
333704.0,6,6,412,4,272,111234.66666666669,74.0,68.0,2,140,0.0,74.0,70.0
90379764.0,6,12,1848,5,1020,22591505.0,204.0,204.0,7,828,15062899.833333334,188.0,118.28571428571428
373648.0,6,2,132,1,66,0.0,66.0,66.0,1,66,0.0,66.0,66.0
146200.0,6,3,337,2,214,0.0,160.0,107.0,1,123,0.0,123.0,123.0
321970.0,17,4,1400,4,1400,107323.33333333331,350.0,350.0,0,0,0.0,0.0,0.0
147898.0,17,2,180,1,90,0.0,90.0,90.0,1,90,0.0,90.0,90.0
312783.0,6,6,412,4,272,104261.0,74.0,68.0,2,140,0.0,74.0,70.0
37840.0,6,14,4740,7,653,6188.5,249.0,93.28571428571428,7,4087,5607.333333333333,1514.0,583.8571428571429
828079.0,6,9,1118,6,586,165615.8,248.0,97.66666666666669,3,532,277736.5,392.0,177.33333333333334
122266.0,6,3,373,2,238,0.0,172.0,119.0,1,135,0.0,135.0,135.0
240713.0,17,2,180,1,90,0.0,90.0,90.0,1,90,0.0,90.0,90.0
217050.0,6,3,426,2,280,0.0,214.0,140.0,1,146,0.0,146.0,146.0
314328.0,17,4,622,4,622,104776.0,163.0,155.5,0,0,0.0,0.0,0.0
8824.0,17,2,498,1,80,0.0,80.0,80.0,1,418,0.0,418.0,418.0
104696328.0,6,33,2422,17,1194,6543493.125,123.0,70.23529411764706,16,1228,6467052.333333333,139.0,76.75
103364.0,17,2,286,2,286,0.0,143.0,143.0,0,0,0.0,0.0,0.0
3481.0,17,2,414,1,88,0.0,88.0,88.0,1,326,0.0,326.0,326.0
2105309.0,6,19,6869,10,1501,233923.22222222225,408.0,150.1,9,5368,220025.0,1514.0,596.4444444444445
247980.0,6,3,337,2,214,0.0,160.0,107.0,1,123,0.0,123.0,123.0
14982.0,17,2,180,1,90,0.0,90.0,90.0,1,90,0.0,90.0,90.0
146189.0,6,3,337,2,214,0.0,160.0,107.0,1,123,0.0,123.0,123.0
37681.0,6,10,2032,5,524,7517.5,252.0,104.8,5,1508,9072.25,1236.0,301.6
0.0,6,1,54,0,0,0.0,0.0,0.0,1,54,0.0,54.0,54.0
108111887.0,17,5,955,5,955,27027971.75,191.0,191.0,0,0,0.0,0.0,0.0
233190.0,6,3,337,2,214,0.0,160.0,107.0,1,123,0.0,123.0,123.0
50188.0,6,10,2032,5,524,11122.75,252.0,104.8,5,1508,11222.25,1236.0,301.6
120341917.0,17,14,864,7,432,20056986.166666668,174.0,61.71428571428572,7,432,19960925.666666668,174.0,61.71428571428572
2400.0,17,4,344,2,150,0.0,75.0,75.0,2,194,0.0,103.0,97.0
108116195.0,17,5,1005,5,1005,27029048.75,201.0,201.0,0,0,0.0,0.0,0.0
120009890.0,17,14,1126,8,606,17144270.0,174.0,75.75,6,520,16200175.8,174.0,86.66666666666667
292661.0,17,2,180,1,90,0.0,90.0,90.0,1,90,0.0,90.0,90.0
386.0,17,2,208,1,72,0.0,72.0,72.0,1,136,0.0,136.0,136.0
233320.0,6,3,337,2,214,0.0,160.0,107.0,1,123,0.0,123.0,123.0
55157.0,6,14,4740,7,653,7795.0,249.0,93.28571428571428,7,4087,8383.666666666666,1514.0,583.8571428571429
45708.0,6,14,4740,7,653,6659.166666666667,249.0,93.28571428571428,7,4087,6634.333333333333,1514.0,583.8571428571429
107014.0,17,2,700,2,700,0.0,350.0,350.0,0,0,0.0,0.0,0.0
217840.0,6,3,426,2,280,0.0,214.0,140.0,1,146,0.0,146.0,146.0
124601407.0,6,52,4572,22,2016,5457921.095238095,123.0,91.63636363636364,30,2556,3952285.793103448,123.0,85.2
26721499.0,6,26,7627,14,3735,179325.38461538462,1514.0,266.7857142857143,12,3892,2410634.636363636,1514.0,324.3333333333333
317521.0,17,4,1400,4,1400,105840.33333333331,350.0,350.0,0,0,0.0,0.0,0.0
113891184.0,6,37,2656,19,1408,6315303.222222222,139.0,74.10526315789474,18,1248,6686793.823529412,123.0,69.33333333333333
120024.0,17,2,180,1,70,0.0,70.0,70.0,1,110,0.0,110.0,110.0
120479654.0,6,219,24802,110,17312,1105317.9266055045,284.0,157.38181818181818,109,7490,1107014.0648148148,140.0,68.71559633027523
28705.0,6,10,2032,5,524,6421.0,252.0,104.8,5,1508,6812.25,1236.0,301.6
2366411.0,6,3,1604,1,753,0.0,753.0,753.0,2,851,0.0,785.0,425.5
135127387.0,17,6,1146,6,1146,27025477.4,191.0,191.0,0,0,0.0,0.0,0.0
38684.0,6,2,145,2,145,0.0,91.0,72.5,0,0,0.0,0.0,0.0
98955522.0,17,12,778,6,389,19601113.8,174.0,64.83333333333333,6,389,19600205.8,174.0,64.83333333333333
339.0,17,2,164,1,74,0.0,74.0,74.0,1,90,0.0,90.0,90.0
239408.0,6,3,337,2,214,0.0,160.0,107.0,1,123,0.0,123.0,123.0
141324.0,6,2,132,1,66,0.0,66.0,66.0,1,66,0.0,66.0,66.0
115380533.0,6,35,2473,18,1248,6787090.176470588,123.0,69.33333333333333,17,1225,7197310.375,139.0,72.05882352941177
36301.0,6,14,4740,7,653,4686.833333333333,249.0,93.28571428571428,7,4087,5881.666666666667,1514.0,583.8571428571429
15509.0,6,14,4740,7,653,2319.6666666666665,249.0,93.28571428571428,7,4087,2446.0,1514.0,583.8571428571429
14643927.0,6,23,1781,12,1091,1303370.6363636365,315.0,90.91666666666669,11,690,1433677.2,78.0,62.72727272727273
75745.0,6,13,1394,7,797,12570.166666666666,253.0,113.85714285714286,6,597,13232.8,259.0,99.5
104941521.0,17,15,5130,15,5130,7495822.928571428,342.0,342.0,0,0,0.0,0.0,0.0
47605368.0,6,8,2113,3,960,22390001.0,826.0,320.0,5,1153,11257926.25,885.0,230.6
303932.0,6,6,412,4,272,101310.66666666669,74.0,68.0,2,140,0.0,74.0,70.0
121290561.0,6,296,35824,148,10064,813224.537414966,140.0,68.0,148,25760,819457.6054421769,464.0,174.05405405405406
90043530.0,17,28,13364,28,13364,3334945.5555555555,501.0,477.2857142857143,0,0,0.0,0.0,0.0
102000954.0,17,13,821,7,432,17000159.0,174.0,61.71428571428572,6,389,16401451.0,174.0,64.83333333333333
146172.0,6,3,337,2,214,0.0,160.0,107.0,1,123,0.0,123.0,123.0
216902.0,6,3,426,2,280,0.0,214.0,140.0,1,146,0.0,146.0,146.0
107402.0,17,2,286,2,286,0.0,143.0,143.0,0,0,0.0,0.0,0.0
147877.0,17,2,180,1,90,0.0,90.0,90.0,1,90,0.0,90.0,90.0
90213575.0,6,25,1924,11,840,8997390.7,95.0,76.36363636363636,14,1084,6923707.846153846,95.0,77.42857142857143
9005532.0,6,11,2106,6,598,1800924.8,252.0,99.66666666666669,5,1508,1504.0,1236.0,301.6
31193.0,6,10,2032,5,524,6903.25,252.0,104.8,5,1508,7539.0,1236.0,301.6
120000515.0,6,17,1287,9,691,15000064.375,95.0,76.77777777777777,8,596,12858303.857142856,95.0,74.5
327.0,17,2,168,1,76,0.0,76.0,76.0,1,92,0.0,92.0,92.0
263141.0,6,3,337,2,214,0.0,160.0,107.0,1,123,0.0,123.0,123.0
90034871.0,17,28,13364,28,13364,3334624.851851852,501.0,477.2857142857143,0,0,0.0,0.0,0.0
120088390.0,6,228,25878,114,7820,1055538.1592920355,140.0,68.59649122807018,114,18058,1056526.3982300884,300.0,158.40350877192984
22511.0,6,10,2032,5,524,5188.5,252.0,104.8,5,1508,4273.75,1236.0,301.6
90256813.0,6,14,2240,8,1016,12893830.42857143,188.0,127.0,6,1224,18018707.0,204.0,204.0
121561.0,6,3,337,2,214,0.0,160.0,107.0,1,123,0.0,123.0,123.0
125008458.0,17,15,907,8,475,17858351.14285714,174.0,59.375,7,432,17573664.166666668,174.0,61.71428571428572
313751.0,6,6,412,4,272,104583.66666666669,74.0,68.0,2,140,0.0,74.0,70.0
218424.0,6,4,492,2,280,0.0,214.0,140.0,2,212,0.0,146.0,106.0
90040168.0,17,27,12943,27,12943,3463083.3846153845,501.0,479.3703703703704,0,0,0.0,0.0,0.0
143849.0,17,2,180,1,90,0.0,90.0,90.0,1,90,0.0,90.0,90.0
204698.0,17,2,762,2,762,0.0,381.0,381.0,0,0,0.0,0.0,0.0
19702.0,6,2,145,2,145,0.0,91.0,72.5,0,0,0.0,0.0,0.0
300460.0,6,6,412,4,272,100153.33333333331,74.0,68.0,2,140,0.0,74.0,70.0
42670.0,6,14,4740,7,653,6983.833333333333,249.0,93.28571428571428,7,4087,6724.833333333333,1514.0,583.8571428571429
237785.0,6,3,337,2,214,0.0,160.0,107.0,1,123,0.0,123.0,123.0
115082725.0,6,436,55350,218,14610,526543.0783410139,140.0,67.01834862385321,218,40740,527053.1290322581,570.0,186.88073394495413
144043.0,17,2,180,1,90,0.0,90.0,90.0,1,90,0.0,90.0,90.0
110184788.0,6,30,1990,15,1042,7854940.142857143,139.0,69.46666666666667,15,948,7854936.5,123.0,63.2
342.0,17,2,267,1,83,0.0,83.0,83.0,1,184,0.0,184.0,184.0
27389680.0,17,5,1710,5,1710,6847420.0,342.0,342.0,0,0,0.0,0.0,0.0
218677.0,17,2,180,1,90,0.0,90.0,90.0,1,90,0.0,90.0,90.0
14835.0,6,11,2098,6,590,2884.6,252.0,98.33333333333331,5,1508,3468.0,1236.0,301.6
228420.0,17,2,180,1,90,0.0,90.0,90.0,1,90,0.0,90.0,90.0
297196.0,17,2,180,1,90,0.0,90.0,90.0,1,90,0.0,90.0,90.0
43178.0,6,14,4740,7,653,7069.833333333333,249.0,93.28571428571428,7,4087,6927.833333333333,1514.0,583.8571428571429
2050.0,17,4,344,2,150,0.0,75.0,75.0,2,194,0.0,103.0,97.0
135123632.0,17,6,1206,6,1206,27024726.4,201.0,201.0,0,0,0.0,0.0,0.0
231876.0,6,10,1221,6,636,46375.2,298.0,106.0,4,585,76251.33333333333,379.0,146.25
275541.0,17,2,238,1,74,0.0,74.0,74.0,1,164,0.0,164.0,164.0
310628.0,17,4,1400,4,1400,103542.66666666669,350.0,350.0,0,0,0.0,0.0,0.0
0.0,17,1,55,1,55,0.0,55.0,55.0,0,0,0.0,0.0,0.0
20699.0,17,4,823,2,163,0.0,89.0,81.5,2,660,0.0,443.0,330.0
129020.0,6,13,1386,7,789,21503.33333333333,253.0,112.71428571428572,6,597,24235.4,259.0,99.5
103768046.0,6,44,2904,22,1452,4941335.523809524,66.0,66.0,22,1452,4926679.571428572,66.0,66.0
47384.0,6,14,4740,7,653,6573.333333333333,249.0,93.28571428571428,7,4087,7687.666666666667,1514.0,583.8571428571429
90035550.0,17,28,13364,28,13364,3334650.0,501.0,477.2857142857143,0,0,0.0,0.0,0.0
2087.0,17,4,344,2,150,0.0,75.0,75.0,2,194,0.0,103.0,97.0
36654.0,6,14,4740,7,653,5888.333333333333,249.0,93.28571428571428,7,4087,5667.833333333333,1514.0,583.8571428571429
40929.0,6,10,2032,5,524,10003.75,252.0,104.8,5,1508,9816.5,1236.0,301.6
859800.0,6,12,1447,6,816,170863.4,291.0,136.0,6,631,171534.4,293.0,105.16666666666669
237448.0,17,2,180,1,90,0.0,90.0,90.0,1,90,0.0,90.0,90.0
96702990.0,6,60,12460,30,6571,3334585.8620689656,1514.0,219.03333333333333,30,5889,3324978.5517241377,1514.0,196.3
104396149.0,6,192,21664,96,15106,1096640.9368421054,284.0,157.35416666666666,96,6558,1096641.4842105263,140.0,68.3125
747671.0,6,2,132,1,66,0.0,66.0,66.0,1,66,0.0,66.0,66.0
103217.0,17,2,286,2,286,0.0,143.0,143.0,0,0,0.0,0.0,0.0
439147.0,6,10,967,5,390,73750.0,162.0,78.0,5,577,73681.75,349.0,115.4
485751.0,6,5,336,2,134,0.0,68.0,67.0,3,202,191842.0,70.0,67.33333333333333
146130.0,6,2,132,1,66,0.0,66.0,66.0,1,66,0.0,66.0,66.0
153364.0,17,2,180,1,90,0.0,90.0,90.0,1,90,0.0,90.0,90.0
0.0,17,1,55,1,55,0.0,55.0,55.0,0,0,0.0,0.0,0.0
7262.0,17,4,344,2,150,0.0,75.0,75.0,2,194,0.0,103.0,97.0
4473.0,17,2,614,1,72,0.0,72.0,72.0,1,542,0.0,542.0,542.0
120058327.0,17,28,13364,28,13364,4446604.703703703,501.0,477.2857142857143,0,0,0.0,0.0,0.0
315.0,17,2,174,1,79,0.0,79.0,79.0,1,95,0.0,95.0,95.0
45420.0,6,10,2032,5,524,11124.0,252.0,104.8,5,1508,8814.5,1236.0,301.6
280226.0,17,2,180,1,90,0.0,90.0,90.0,1,90,0.0,90.0,90.0
123307020.0,6,48,3168,24,1584,5093796.652173913,66.0,66.0,24,1584,5199539.869565218,66.0,66.0
109862667.0,6,35,2542,18,1348,6449804.0,139.0,74.88888888888889,17,1194,6852915.4375,123.0,70.23529411764706
1503699.0,6,19,7533,10,1403,167077.66666666666,583.0,140.3,9,6130,154735.75,1484.0,681.1111111111111
137396947.0,17,14,864,7,432,19666888.5,174.0,61.71428571428572,7,432,19667956.5,174.0,61.71428571428572
2780508.0,6,2,132,1,66,0.0,66.0,66.0,1,66,0.0,66.0,66.0
3012781.0,6,11,2106,6,598,601235.4,252.0,99.66666666666669,5,1508,3112.25,1236.0,301.6
121118479.0,6,226,25406,113,7754,1065813.0982142857,140.0,68.61946902654867,113,17652,1074041.892857143,284.0,156.21238938053096
100816046.0,17,21,6106,9,1302,12501230.25,506.0,144.66666666666666,12,4804,9137163.727272728,1214.0,400.3333333333333
247016.0,17,2,180,1,90,0.0,90.0,90.0,1,90,0.0,90.0,90.0
54389.0,6,14,4740,7,653,7669.166666666667,249.0,93.28571428571428,7,4087,8776.666666666666,1514.0,583.8571428571429
118035346.0,6,47,3102,23,1518,5112072.681818182,66.0,66.0,24,1584,5131956.304347826,66.0,66.0
105857964.0,6,200,22536,100,6822,1060922.4141414142,140.0,68.22,100,15714,1061002.5656565656,284.0,157.14
105828.0,17,2,286,2,286,0.0,143.0,143.0,0,0,0.0,0.0,0.0
262437.0,6,10,1221,6,636,52487.4,298.0,106.0,4,585,81884.0,379.0,146.25
4276.0,17,2,620,1,75,0.0,75.0,75.0,1,545,0.0,545.0,545.0
117933716.0,6,37,2650,19,1302,6551873.111111111,123.0,68.52631578947368,18,1348,6337286.882352941,139.0,74.88888888888889
20981.0,6,11,2098,6,590,3958.0,252.0,98.33333333333331,5,1508,4453.75,1236.0,301.6
144017.0,17,2,180,1,90,0.0,90.0,90.0,1,90,0.0,90.0,90.0
5739327.0,6,5,336,2,134,0.0,68.0,67.0,3,202,1479442.5,70.0,67.33333333333333
15000.0,6,10,2032,5,524,2736.25,252.0,104.8,5,1508,3465.0,1236.0,301.6
5627702.0,6,5,336,2,134,0.0,68.0,67.0,3,202,1524848.5,70.0,67.33333333333333
250256.0,6,3,337,2,214,0.0,160.0,107.0,1,123,0.0,123.0,123.0
309623.0,6,6,412,4,272,103207.66666666669,74.0,68.0,2,140,0.0,74.0,70.0
20009.0,6,10,2032,5,524,4772.25,252.0,104.8,5,1508,4248.5,1236.0,301.6
71100.0,6,22,9138,12,962,6463.636363636364,228.0,80.16666666666667,10,8176,7207.0,1514.0,817.6
555926.0,6,4,492,2,280,0.0,214.0,140.0,2,212,0.0,146.0,106.0
113254858.0,6,46,3036,23,1518,5135441.954545454,66.0,66.0,23,1518,5135434.727272728,66.0,66.0
120252200.0,6,224,25328,112,7614,1076084.2882882883,140.0,67.98214285714286,112,17714,1082198.4144144144,284.0,158.16071428571428
146118.0,6,3,337,2,214,0.0,160.0,107.0,1,123,0.0,123.0,123.0
1226084.0,6,11,1134,6,558,245216.8,220.0,93.0,5,576,303811.5,304.0,115.2
305954.0,6,6,412,4,272,101984.66666666669,74.0,68.0,2,140,0.0,74.0,70.0
209754.0,6,12,1373,7,714,34959.0,298.0,102.0,5,659,51592.75,379.0,131.8
10523936.0,6,7,478,4,272,3460830.0,74.0,68.0,3,206,5191142.0,74.0,68.66666666666667
260728.00000000003,6,3,337,2,214,0.0,160.0,107.0,1,123,0.0,123.0,123.0
27162.0,6,10,2032,5,524,6344.75,252.0,104.8,5,1508,6557.25,1236.0,301.6
108142560.0,6,769,127484,382,25582,283809.43044619425,214.0,66.96858638743456,387,101902,280107.2797927461,1514.0,263.312661498708
90008693.0,17,28,13364,28,13364,3333655.296296296,501.0,477.2857142857143,0,0,0.0,0.0,0.0
217885.0,6,3,426,2,280,0.0,214.0,140.0,1,146,0.0,146.0,146.0
276475.0,6,10,1221,6,636,55295.0,298.0,106.0,4,585,86192.66666666667,379.0,146.25
14632784.0,6,20,1607,10,975,1592397.5555555555,315.0,97.5,10,632,1592375.5555555555,78.0,63.2
94004791.0,17,13,1083,7,563,15667465.166666666,174.0,80.42857142857143,6,520,14800122.4,174.0,86.66666666666667
318560.0,17,4,1400,4,1400,106186.66666666669,350.0,350.0,0,0,0.0,0.0,0.0
145980.0,6,3,373,2,238,0.0,172.0,119.0,1,135,0.0,135.0,135.0
2367.0,17,4,344,2,150,0.0,75.0,75.0,2,194,0.0,103.0,97.0
90053899.0,17,28,13364,28,13364,3335329.592592593,501.0,477.2857142857143,0,0,0.0,0.0,0.0
206182.0,17,2,180,1,90,0.0,90.0,90.0,1,90,0.0,90.0,90.0
2351.0,17,4,344,2,150,0.0,75.0,75.0,2,194,0.0,103.0,97.0
1033805.0,6,11,1134,6,558,206761.00000000003,220.0,93.0,5,576,255953.75,304.0,115.2
2320.0,17,4,344,2,150,0.0,75.0,75.0,2,194,0.0,103.0,97.0
197055.0,17,2,180,1,90,0.0,90.0,90.0,1,90,0.0,90.0,90.0
74309.0,6,14,4740,7,653,11703.833333333334,249.0,93.28571428571428,7,4087,11387.0,1514.0,583.8571428571429
9435.0,17,2,582,1,83,0.0,83.0,83.0,1,499,0.0,499.0,499.0
146088.0,6,3,337,2,214,0.0,160.0,107.0,1,123,0.0,123.0,123.0
46019.0,6,14,4740,7,653,7510.5,249.0,93.28571428571428,7,4087,6461.666666666667,1514.0,583.8571428571429
43808.0,6,14,4740,7,653,7179.333333333333,249.0,93.28571428571428,7,4087,6728.0,1514.0,583.8571428571429
836906.0,6,9,1118,6,586,167381.2,248.0,97.66666666666669,3,532,280600.0,392.0,177.33333333333334
5624894.0,6,5,336,2,134,0.0,68.0,67.0,3,202,1422752.5,70.0,67.33333333333333
206120.0,6,3,426,2,280,0.0,214.0,140.0,1,146,0.0,146.0,146.0
120440506.0,6,227,25706,114,18026,1065845.185840708,284.0,158.12280701754386,113,7680,1066107.857142857,140.0,67.96460176991151
504392.0,6,5,336,2,134,0.0,68.0,67.0,3,202,192103.0,70.0,67.33333333333333
0.0,17,1,342,1,342,0.0,342.0,342.0,0,0,0.0,0.0,0.0
26353.0,6,14,4740,7,653,4213.0,249.0,93.28571428571428,7,4087,4137.0,1514.0,583.8571428571429
107775342.0,6,206,23186,103,7094,1049921.1764705882,140.0,68.87378640776699,103,16092,1049766.9803921569,284.0,156.23300970873785
2397.0,17,4,344,2,150,0.0,75.0,75.0,2,194,0.0,103.0,97.0
90257083.0,6,12,1832,8,1016,12893869.0,188.0,127.0,4,816,30031209.666666668,204.0,204.0
108006207.0,17,14,864,7,432,18001034.5,174.0,61.71428571428572,7,432,17833529.166666668,174.0,61.71428571428572
59860.0,6,10,2032,5,524,14592.0,252.0,104.8,5,1508,14290.25,1236.0,301.6
120931545.0,6,26,2060,16,1315,8062103.0,95.0,82.1875,10,745,10417420.444444444,95.0,74.5
108107929.0,17,5,1005,5,1005,27026982.25,201.0,201.0,0,0,0.0,0.0,0.0
281.0,17,2,156,1,78,0.0,78.0,78.0,1,78,0.0,78.0,78.0
120808340.0,6,872,153600,433,29096,277744.375,214.0,67.19630484988453,439,124504,275165.5616438356,1514.0,283.60820045558086
100071437.0,17,14,864,7,432,16667631.0,174.0,61.71428571428572,7,432,16666808.5,174.0,61.71428571428572
218075.0,6,3,426,2,280,0.0,214.0,140.0,1,146,0.0,146.0,146.0
98907860.0,6,241,29330,121,8208,824232.1666666666,140.0,67.83471074380165,120,21122,822322.6554621849,284.0,176.01666666666668
93424918.0,6,27,1938,14,1029,7169930.307692308,123.0,73.5,13,909,7767418.25,123.0,69.92307692307692
2494559.0,6,33,9472,17,5512,155909.9375,1514.0,324.2352941176471,16,3960,145763.33333333334,1514.0,247.5
200360.0,17,2,180,1,90,0.0,90.0,90.0,1,90,0.0,90.0,90.0
30783.0,6,14,4740,7,653,3616.1666666666665,249.0,93.28571428571428,7,4087,4990.166666666667,1514.0,583.8571428571429
120072701.0,17,29,13785,29,13785,4288310.75,501.0,475.3448275862069,0,0,0.0,0.0,0.0
239448.0,17,2,180,1,90,0.0,90.0,90.0,1,90,0.0,90.0,90.0
90285837.0,6,15,2306,8,1016,12897976.714285716,188.0,127.0,7,1290,15020762.166666666,204.0,184.28571428571428
205960.0,17,2,180,1,90,0.0,90.0,90.0,1,90,0.0,90.0,90.0
0.0,17,1,381,1,381,0.0,381.0,381.0,0,0,0.0,0.0,0.0
10528516.0,6,7,478,4,272,3462957.0,74.0,68.0,3,206,5194325.5,74.0,68.66666666666667
5623140.0,6,4,270,2,134,0.0,68.0,67.0,2,136,0.0,70.0,68.0
36171.0,6,10,2032,5,524,8837.0,252.0,104.8,5,1508,6354.75,1236.0,301.6
123455771.0,6,48,3168,24,1584,4944886.826086956,66.0,66.0,24,1584,5322945.739130435,66.0,66.0
100732968.0,6,29,2052,15,1089,7180554.785714285,123.0,72.6,14,963,7732884.076923077,123.0,68.78571428571429
124625258.0,17,15,1169,8,606,17803608.285714287,174.0,75.75,7,563,17507044.666666668,174.0,80.42857142857143
5824196.0,6,4,270,2,134,0.0,68.0,67.0,2,136,0.0,70.0,68.0
284906.0,17,2,363,1,79,0.0,79.0,79.0,1,284,0.0,284.0,284.0
315.0,17,2,174,1,79,0.0,79.0,79.0,1,95,0.0,95.0,95.0
113694928.0,6,45,2970,23,1518,5167951.2727272725,66.0,66.0,22,1452,5241603.285714285,66.0,66.0
3091926.0,6,20,7614,11,986,309107.0,310.0,89.63636363636364,9,6628,9940.75,1514.0,736.4444444444445
12636.0,6,10,1065,5,534,2748.25,262.0,106.8,5,531,2834.25,259.0,106.2
129492.0,6,2,132,1,66,0.0,66.0,66.0,1,66,0.0,66.0,66.0
147903.0,17,2,180,1,90,0.0,90.0,90.0,1,90,0.0,90.0,90.0
121243.0,6,3,337,2,214,0.0,160.0,107.0,1,123,0.0,123.0,123.0
54862.0,6,14,4740,7,653,8892.166666666666,249.0,93.28571428571428,7,4087,7551.166666666667,1514.0,583.8571428571429
90284617.0,6,21,1585,11,840,9024184.8,95.0,76.36363636363636,10,745,9999869.111111112,95.0,74.5
1041887.0,6,11,1134,6,558,208377.4,220.0,93.0,5,576,257519.75,304.0,115.2
239301.0,17,2,180,1,90,0.0,90.0,90.0,1,90,0.0,90.0,90.0
90305817.0,6,12,1832,8,1016,12900831.0,188.0,127.0,4,816,30046434.666666668,204.0,204.0
100617263.0,17,12,778,6,389,20001494.8,174.0,64.83333333333333,6,389,19800148.6,174.0,64.83333333333333
90015233.0,6,23,1775,10,745,10001692.555555556,95.0,74.5,13,1030,7480262.75,95.0,79.23076923076923
41839.0,6,14,4740,7,653,6621.666666666667,249.0,93.28571428571428,7,4087,6640.333333333333,1514.0,583.8571428571429
909.0,17,4,360,2,172,0.0,86.0,86.0,2,188,0.0,102.0,94.0
1130.0,17,2,508,2,508,0.0,257.0,254.0,0,0,0.0,0.0,0.0
337.0,17,2,267,1,83,0.0,83.0,83.0,1,184,0.0,184.0,184.0
27327392.0,17,5,1710,5,1710,6831848.0,342.0,342.0,0,0,0.0,0.0,0.0
346.0,17,2,267,1,83,0.0,83.0,83.0,1,184,0.0,184.0,184.0
303980.0,6,6,412,4,272,101326.66666666669,74.0,68.0,2,140,0.0,74.0,70.0
12206.0,6,10,2032,5,524,2725.25,252.0,104.8,5,1508,2623.0,1236.0,301.6
2799289.0,6,2,132,1,66,0.0,66.0,66.0,1,66,0.0,66.0,66.0
3575108.0,6,5,336,2,134,0.0,68.0,67.0,3,202,1525125.5,70.0,67.33333333333333
196779.0,17,2,180,1,90,0.0,90.0,90.0,1,90,0.0,90.0,90.0
103455032.0,6,44,2904,22,1452,4926430.095238095,66.0,66.0,22,1452,4916139.285714285,66.0,66.0
315876.0,17,4,622,4,622,105292.0,163.0,155.5,0,0,0.0,0.0,0.0
90694310.0,6,21,1585,10,745,10077145.555555556,95.0,74.5,11,840,9043334.0,95.0,76.36363636363636
104023471.0,6,31,3255,16,1655,6933951.333333333,426.0,103.4375,15,1600,7429889.0,334.0,106.66666666666669
354.0,17,2,267,1,83,0.0,83.0,83.0,1,184,0.0,184.0,184.0
2064.0,17,4,344,2,150,0.0,75.0,75.0,2,194,0.0,103.0,97.0
119988775.0,6,15,1138,7,542,15047877.666666666,95.0,77.42857142857143,8,596,17105130.14285714,95.0,74.5
2339.0,17,4,344,2,150,0.0,75.0,75.0,2,194,0.0,103.0,97.0
15827392.0,6,21,7017,12,1641,1438853.818181818,408.0,136.75,9,5376,1780667.125,1514.0,597.3333333333334
113145273.0,6,47,3102,24,1584,4909974.913043479,66.0,66.0,23,1518,5105429.227272728,66.0,66.0
20599.0,6,14,4740,7,653,3146.5,249.0,93.28571428571428,7,4087,3298.0,1514.0,583.8571428571429
138820.0,6,2,132,1,66,0.0,66.0,66.0,1,66,0.0,66.0,66.0
50328.0,6,10,2032,5,524,12350.25,252.0,104.8,5,1508,10931.0,1236.0,301.6
764277.0,6,12,1354,6,723,152153.8,253.0,120.5,6,631,152409.8,293.0,105.16666666666669
108102640.0,17,5,1005,5,1005,27025660.0,201.0,201.0,0,0,0.0,0.0,0.0
5004652.0,17,4,849,2,166,0.0,83.0,83.0,2,683,0.0,499.0,341.5
54679.0,6,10,2032,5,524,13443.0,252.0,104.8,5,1508,12188.25,1236.0,301.6
11280.0,6,10,1067,5,536,2654.0,264.0,107.2,5,531,2260.5,259.0,106.2
305219.0,6,10,1221,6,636,61043.8,298.0,106.0,4,585,95623.33333333331,379.0,146.25
125817439.0,6,62,12484,30,6445,3314630.4482758623,1514.0,214.8333333333333,32,6039,4051678.967741936,1514.0,188.71875
2039.0,17,4,344,2,150,0.0,75.0,75.0,2,194,0.0,103.0,97.0
101209209.0,6,225,25934,112,7688,910748.099099099,140.0,68.64285714285714,113,18246,903570.2946428572,284.0,161.46902654867256
438.0,17,2,410,1,78,0.0,78.0,78.0,1,332,0.0,332.0,332.0
2068593.0,17,6,1230,3,234,1034106.5,78.0,78.0,3,996,1034070.5,332.0,332.0
162419.0,6,3,337,2,214,0.0,160.0,107.0,1,123,0.0,123.0,123.0
90863696.0,6,167,18844,84,5766,1094743.3253012048,140.0,68.64285714285714,83,13078,1095547.463414634,284.0,157.56626506024097
19330.0,6,14,4740,7,653,2749.1666666666665,249.0,93.28571428571428,7,4087,3083.6666666666665,1514.0,583.8571428571429
3633851.0,6,5,336,2,134,0.0,68.0,67.0,3,202,1045537.0,70.0,67.33333333333333
32916.0,6,14,4740,7,653,5291.0,249.0,93.28571428571428,7,4087,5199.0,1514.0,583.8571428571429
90071400.0,17,28,13364,28,13364,3335977.777777778,501.0,477.2857142857143,0,0,0.0,0.0,0.0
56445.0,6,14,4740,7,653,9230.333333333334,249.0,93.28571428571428,7,4087,9124.0,1514.0,583.8571428571429
266197.0,17,2,180,1,90,0.0,90.0,90.0,1,90,0.0,90.0,90.0
135116217.0,17,6,1206,6,1206,27023243.4,201.0,201.0,0,0,0.0,0.0,0.0
2962.0,17,2,224,1,76,0.0,76.0,76.0,1,148,0.0,148.0,148.0
34457.0,6,14,4740,7,653,5417.333333333333,249.0,93.28571428571428,7,4087,5369.0,1514.0,583.8571428571429
135129097.0,17,6,1146,6,1146,27025819.4,191.0,191.0,0,0,0.0,0.0,0.0
24039.0,6,10,2032,5,524,5727.5,252.0,104.8,5,1508,5719.5,1236.0,301.6
103009415.0,17,14,864,7,432,17167732.333333332,174.0,61.71428571428572,7,432,17166825.166666668,174.0,61.71428571428572
265438.0,6,10,1221,6,636,53087.6,298.0,106.0,4,585,82685.66666666667,379.0,146.25
1265142.0,6,20,6916,11,3099,126514.2,1514.0,281.72727272727275,9,3817,130839.25,1514.0,424.1111111111111
41084.0,6,14,4740,7,653,5096.166666666667,249.0,93.28571428571428,7,4087,6091.5,1514.0,583.8571428571429
2589945.0,6,2,132,1,66,0.0,66.0,66.0,1,66,0.0,66.0,66.0
307802.0,6,6,412,4,272,102600.66666666669,74.0,68.0,2,140,0.0,74.0,70.0
2028.0,17,4,344,2,150,0.0,75.0,75.0,2,194,0.0,103.0,97.0
282926.0,6,10,1221,6,636,56585.2,298.0,106.0,4,585,85854.33333333333,379.0,146.25
171679.0,17,2,180,1,90,0.0,90.0,90.0,1,90,0.0,90.0,90.0
2310.0,17,4,344,2,150,0.0,75.0,75.0,2,194,0.0,103.0,97.0
94036582.0,6,162,18408,81,12840,1172898.7875,284.0,158.5185185185185,81,5568,1172883.725,140.0,68.74074074074075
135127927.0,17,6,1206,6,1206,27025585.4,201.0,201.0,0,0,0.0,0.0,0.0
121244.0,6,3,337,2,214,0.0,160.0,107.0,1,123,0.0,123.0,123.0
2409.0,17,4,344,2,150,0.0,75.0,75.0,2,194,0.0,103.0,97.0
35298.0,6,14,4740,7,653,5757.5,249.0,93.28571428571428,7,4087,5751.5,1514.0,583.8571428571429
1040510.0,6,13,1386,7,789,173418.33333333334,253.0,112.71428571428572,6,597,206649.4,259.0,99.5
236881.0,6,3,373,2,238,0.0,172.0,119.0,1,135,0.0,135.0,135.0
120127943.0,6,14,2240,6,1224,24025588.6,204.0,204.0,8,1016,17098108.714285713,188.0,127.0
93000914.0,17,12,778,6,389,18600182.8,174.0,64.83333333333333,6,389,18401199.2,174.0,64.83333333333333
24990.0,6,14,4740,7,653,3923.8333333333335,249.0,93.28571428571428,7,4087,3688.8333333333335,1514.0,583.8571428571429
171593.0,17,2,180,1,90,0.0,90.0,90.0,1,90,0.0,90.0,90.0
547780.0,6,2,132,1,66,0.0,66.0,66.0,1,66,0.0,66.0,66.0
16926.0,17,2,180,1,90,0.0,90.0,90.0,1,90,0.0,90.0,90.0
104574026.0,17,14,864,7,432,17333509.5,174.0,61.71428571428572,7,432,17333798.666666668,174.0,61.71428571428572
36447.0,6,10,1066,5,490,7782.25,218.0,98.0,5,576,8638.5,304.0,115.2
36487.0,6,14,4740,7,653,5952.666666666667,249.0,93.28571428571428,7,4087,5942.666666666667,1514.0,583.8571428571429
31809.0,6,13,4412,6,409,6173.0,127.0,68.16666666666667,7,4003,5070.5,1514.0,571.8571428571429
246196.0,6,3,373,2,238,0.0,172.0,119.0,1,135,0.0,135.0,135.0
13892641.0,17,6,2052,6,2052,2778528.2,342.0,342.0,0,0,0.0,0.0,0.0
108963576.0,6,32,2236,16,1165,7249813.6,139.0,72.8125,16,1071,7249833.133333334,123.0,66.9375
109451.0,17,2,286,2,286,0.0,143.0,143.0,0,0,0.0,0.0,0.0
205811.0,17,2,180,1,90,0.0,90.0,90.0,1,90,0.0,90.0,90.0
28184.0,6,11,1133,6,602,2787.8,264.0,100.33333333333331,5,531,5739.5,259.0,106.2
61790.0,6,20,7606,11,978,6179.0,310.0,88.9090909090909,9,6628,6865.75,1514.0,736.4444444444445
287805.0,17,4,704,2,148,0.0,74.0,74.0,2,556,0.0,280.0,278.0
53605.0,6,10,2032,5,524,13167.5,252.0,104.8,5,1508,12094.75,1236.0,301.6
90052209.0,17,27,12943,27,12943,3463546.5,501.0,479.3703703703704,0,0,0.0,0.0,0.0
120074952.0,17,28,13364,28,13364,4447220.444444444,501.0,477.2857142857143,0,0,0.0,0.0,0.0
228221.0,17,2,180,1,90,0.0,90.0,90.0,1,90,0.0,90.0,90.0
14633176.0,6,20,1607,10,975,1592376.3333333333,315.0,97.5,10,632,1592422.6666666667,78.0,63.2
15553.0,6,11,2098,6,590,2310.0,252.0,98.33333333333331,5,1508,3328.0,1236.0,301.6
171845.0,17,4,1524,4,1524,57281.66666666666,381.0,381.0,0,0,0.0,0.0,0.0
143691.0,6,2,132,1,66,0.0,66.0,66.0,1,66,0.0,66.0,66.0
120005887.0,6,20,1618,10,745,13333330.777777778,95.0,74.5,10,873,13333468.888888888,223.0,87.3
36397.0,6,14,4740,7,653,5878.5,249.0,93.28571428571428,7,4087,5790.666666666667,1514.0,583.8571428571429
119582987.0,6,226,25550,113,17870,1065782.4464285714,284.0,158.141592920354,113,7680,1065782.9375,140.0,67.96460176991151
304700.0,17,4,1524,4,1524,101566.66666666669,381.0,381.0,0,0,0.0,0.0,0.0
348203.0,6,3,204,2,136,0.0,70.0,68.0,1,68,0.0,68.0,68.0
272855.0,6,10,1221,6,636,54571.0,298.0,106.0,4,585,85479.33333333333,379.0,146.25
2054.0,17,2,664,1,322,0.0,322.0,322.0,1,342,0.0,342.0,342.0
96909628.0,6,56,16252,35,6087,2850283.1764705884,486.0,173.9142857142857,21,10165,1631434.1,1514.0,484.04761904761904
135130711.0,17,6,1146,6,1146,27026142.2,191.0,191.0,0,0,0.0,0.0,0.0
2407.0,17,4,344,2,150,0.0,75.0,75.0,2,194,0.0,103.0,97.0
56958.0,6,14,4740,7,653,8288.666666666666,249.0,93.28571428571428,7,4087,9283.166666666666,1514.0,583.8571428571429
2377.0,17,4,344,2,150,0.0,75.0,75.0,2,194,0.0,103.0,97.0
5652709.0,6,184,158666,111,149547,51386.94545454546,1510.0,1347.2702702702702,73,9119,73175.91666666667,1510.0,124.91780821917808
93239280.0,6,39,2574,20,1320,4893004.894736842,66.0,66.0,19,1254,5135440.111111111,66.0,66.0
119166411.0,6,32,2220,16,1071,7944427.4,123.0,66.9375,16,1149,7413677.066666666,123.0,71.8125
320.0,17,2,208,1,72,0.0,72.0,72.0,1,136,0.0,136.0,136.0
38500.0,6,14,4740,7,653,5558.5,249.0,93.28571428571428,7,4087,5575.333333333333,1514.0,583.8571428571429
33689.0,6,14,4740,7,653,5126.833333333333,249.0,93.28571428571428,7,4087,5480.333333333333,1514.0,583.8571428571429
956.0,17,4,438,2,148,0.0,74.0,74.0,2,290,0.0,147.0,145.0
242065.0,6,3,373,2,238,0.0,172.0,119.0,1,135,0.0,135.0,135.0
554356.0,6,2,145,2,145,0.0,91.0,72.5,0,0,0.0,0.0,0.0
108111593.0,17,5,955,5,955,27027898.25,191.0,191.0,0,0,0.0,0.0,0.0
28109.0,6,14,4740,7,653,4561.0,249.0,93.28571428571428,7,4087,4491.166666666667,1514.0,583.8571428571429
215665.0,6,3,426,2,280,0.0,214.0,140.0,1,146,0.0,146.0,146.0
2342.0,17,4,344,2,150,0.0,75.0,75.0,2,194,0.0,103.0,97.0
15044.0,17,2,180,1,90,0.0,90.0,90.0,1,90,0.0,90.0,90.0
109233922.0,6,28,1876,14,982,8386018.076923077,139.0,70.14285714285714,14,894,8386017.461538462,123.0,63.85714285714285
108104414.0,17,5,1005,5,1005,27026103.5,201.0,201.0,0,0,0.0,0.0,0.0
56165.0,6,14,4740,7,653,7767.833333333333,249.0,93.28571428571428,7,4087,9033.166666666666,1514.0,583.8571428571429
99106950.0,6,334,39406,167,28162,595731.3493975904,374.0,168.63473053892216,167,11244,595728.4096385542,140.0,67.32934131736526
12922.0,17,2,582,1,83,0.0,83.0,83.0,1,499,0.0,499.0,499.0
16900.0,17,2,180,1,90,0.0,90.0,90.0,1,90,0.0,90.0,90.0
90308088.0,6,16,1192,8,596,12893830.142857144,95.0,74.5,8,596,12899457.57142857,95.0,74.5
93819.0,17,2,286,2,286,0.0,143.0,143.0,0,0,0.0,0.0,0.0
158525.0,6,12,1354,6,723,31011.0,253.0,120.5,6,631,29134.0,293.0,105.16666666666669
101664.0,17,2,762,2,762,0.0,381.0,381.0,0,0,0.0,0.0,0.0
103532.0,17,2,286,2,286,0.0,143.0,143.0,0,0,0.0,0.0,0.0
36570195.0,6,5,336,2,134,0.0,68.0,67.0,3,202,18216354.5,70.0,67.33333333333333
2796632.0,6,2,132,1,66,0.0,66.0,66.0,1,66,0.0,66.0,66.0
32684.0,6,11,2098,6,590,5968.6,252.0,98.33333333333331,5,1508,7919.0,1236.0,301.6
2076.0,17,4,344,2,150,0.0,75.0,75.0,2,194,0.0,103.0,97.0
0.0,17,1,90,1,90,0.0,90.0,90.0,0,0,0.0,0.0,0.0
232095.0,6,3,337,2,214,0.0,160.0,107.0,1,123,0.0,123.0,123.0
107951195.0,6,44,2904,22,1452,5140533.095238095,66.0,66.0,22,1452,5127413.904761905,66.0,66.0
3177423.0,6,18,1495,9,921,358372.0,315.0,102.33333333333331,9,574,358370.625,78.0,63.77777777777778
507373.0,6,5,336,2,134,0.0,68.0,67.0,3,202,194648.5,70.0,67.33333333333333
6489.0,17,2,582,1,83,0.0,83.0,83.0,1,499,0.0,499.0,499.0
148065.0,17,2,180,1,90,0.0,90.0,90.0,1,90,0.0,90.0,90.0
36619.0,6,14,4740,7,653,5943.333333333333,249.0,93.28571428571428,7,4087,5878.666666666667,1514.0,583.8571428571429
585085.0,17,2,346,1,78,0.0,78.0,78.0,1,268,0.0,268.0,268.0
90255686.0,6,14,2240,8,1016,12893669.42857143,188.0,127.0,6,1224,18017526.8,204.0,204.0
1185304.0,6,13,3010,8,2382,169329.14285714287,1514.0,297.75,5,628,228159.0,331.0,125.6
110218.0,17,4,1400,4,1400,36739.333333333336,350.0,350.0,0,0,0.0,0.0,0.0
22923.0,6,14,4740,7,653,3410.1666666666665,249.0,93.28571428571428,7,4087,3689.3333333333335,1514.0,583.8571428571429
142420.0,6,2,132,1,66,0.0,66.0,66.0,1,66,0.0,66.0,66.0
26844.0,6,14,4740,7,653,4176.333333333333,249.0,93.28571428571428,7,4087,3968.5,1514.0,583.8571428571429
90092468.0,6,10,1440,7,828,15015411.333333334,188.0,118.28571428571428,3,612,30034933.5,204.0,204.0
102860597.0,6,280,35048,140,9536,734115.309352518,140.0,68.11428571428571,140,25512,734111.4244604317,300.0,182.22857142857143
1308364.0,17,7,490,7,490,218060.66666666663,70.0,70.0,0,0,0.0,0.0,0.0
2537695.0,6,3,1604,2,851,0.0,785.0,425.5,1,753,0.0,753.0,753.0
2429.0,17,4,344,2,150,0.0,75.0,75.0,2,194,0.0,103.0,97.0
30968.0,6,14,4740,7,653,4994.833333333333,249.0,93.28571428571428,7,4087,5001.666666666667,1514.0,583.8571428571429
144123.0,17,2,180,1,90,0.0,90.0,90.0,1,90,0.0,90.0,90.0
103631.0,17,2,286,2,286,0.0,143.0,143.0,0,0,0.0,0.0,0.0
90263729.0,6,12,1832,8,1016,12894818.42857143,188.0,127.0,4,816,30032481.33333333,204.0,204.0
241236.0,6,3,337,2,214,0.0,160.0,107.0,1,123,0.0,123.0,123.0
103419.0,6,14,4740,7,653,15277.833333333334,249.0,93.28571428571428,7,4087,15541.333333333334,1514.0,583.8571428571429
304282.0,17,2,363,1,79,0.0,79.0,79.0,1,284,0.0,284.0,284.0
768.0,17,5,550,5,550,192.0,110.0,110.0,0,0,0.0,0.0,0.0
26387.0,6,14,4740,7,653,4101.833333333333,249.0,93.28571428571428,7,4087,4187.666666666667,1514.0,583.8571428571429
90028445.0,17,28,13364,28,13364,3334386.851851852,501.0,477.2857142857143,0,0,0.0,0.0,0.0
114154920.0,6,47,3102,24,1584,4949847.0869565215,66.0,66.0,23,1518,5150439.2727272725,66.0,66.0
836.0,17,4,438,2,148,0.0,74.0,74.0,2,290,0.0,147.0,145.0
4188.0,17,4,344,2,150,0.0,75.0,75.0,2,194,0.0,103.0,97.0
394955.0,6,3,1604,1,753,0.0,753.0,753.0,2,851,0.0,785.0,425.5
33000.0,6,14,4740,7,653,5331.666666666667,249.0,93.28571428571428,7,4087,3953.0,1514.0,583.8571428571429
300447.0,6,6,412,4,272,100149.0,74.0,68.0,2,140,0.0,74.0,70.0
46937.0,6,14,4740,7,653,7265.333333333333,249.0,93.28571428571428,7,4087,5567.666666666667,1514.0,583.8571428571429
115548610.0,6,48,3168,24,1584,5023852.608695652,66.0,66.0,24,1584,5010588.521739131,66.0,66.0
62146.0,6,14,4740,7,653,10033.5,249.0,93.28571428571428,7,4087,9999.0,1514.0,583.8571428571429
17828.0,6,14,4740,7,653,2703.833333333333,249.0,93.28571428571428,7,4087,2323.333333333333,1514.0,583.8571428571429
6433495.0,6,11,1167,6,881,1242828.0,571.0,146.83333333333334,5,286,1553725.25,62.0,57.2
307262.0,6,6,412,4,272,102420.66666666669,74.0,68.0,2,140,0.0,74.0,70.0
0.0,17,1,99,1,99,0.0,99.0,99.0,0,0,0.0,0.0,0.0
107344502.0,6,32,2220,16,1149,7141899.2,123.0,71.8125,16,1071,7141896.666666667,123.0,66.9375
2350.0,17,4,344,2,150,0.0,75.0,75.0,2,194,0.0,103.0,97.0
237200.0,6,3,337,2,214,0.0,160.0,107.0,1,123,0.0,123.0,123.0
304168.0,6,6,412,4,272,101389.33333333331,74.0,68.0,2,140,0.0,74.0,70.0
120283.0,17,2,180,1,70,0.0,70.0,70.0,1,110,0.0,110.0,110.0
1916.0,17,2,508,2,508,0.0,257.0,254.0,0,0,0.0,0.0,0.0
123456043.0,6,49,3234,25,1650,5144001.791666667,66.0,66.0,24,1584,5120388.652173913,66.0,66.0
215958.0,17,2,180,1,90,0.0,90.0,90.0,1,90,0.0,90.0,90.0
232824.0,6,3,337,2,214,0.0,160.0,107.0,1,123,0.0,123.0,123.0
32158.0,6,14,4740,7,653,5007.166666666667,249.0,93.28571428571428,7,4087,5223.666666666667,1514.0,583.8571428571429
108106580.0,17,5,955,5,955,27026645.0,191.0,191.0,0,0,0.0,0.0,0.0
90045294.0,17,28,13364,28,13364,3335010.888888889,501.0,477.2857142857143,0,0,0.0,0.0,0.0
124001426.0,17,15,907,8,475,17714489.42857143,174.0,59.375,7,432,17334365.333333332,174.0,61.71428571428572
84.0,17,2,762,2,762,0.0,381.0,381.0,0,0,0.0,0.0,0.0
90020359.0,17,28,13364,28,13364,3334087.3703703703,501.0,477.2857142857143,0,0,0.0,0.0,0.0
106468.0,17,2,286,2,286,0.0,143.0,143.0,0,0,0.0,0.0,0.0
483.0,17,2,508,2,508,0.0,257.0,254.0,0,0,0.0,0.0,0.0
27537000.0,17,5,1710,5,1710,6884250.0,342.0,342.0,0,0,0.0,0.0,0.0
207881.0,17,4,6056,4,6056,69293.66666666667,1514.0,1514.0,0,0,0.0,0.0,0.0
307370.0,6,6,412,4,272,102456.66666666669,74.0,68.0,2,140,0.0,74.0,70.0
90259192.0,6,14,2240,8,1016,12894170.285714284,188.0,127.0,6,1224,18018713.8,204.0,204.0
2026.0,17,4,344,2,150,0.0,75.0,75.0,2,194,0.0,103.0,97.0
105842.0,17,2,700,2,700,0.0,350.0,350.0,0,0,0.0,0.0,0.0
876218.0,6,10,1162,6,625,175243.6,287.0,104.16666666666669,4,537,201226.0,331.0,134.25
245502.0,6,3,337,2,214,0.0,160.0,107.0,1,123,0.0,123.0,123.0
233005.0,6,3,337,2,214,0.0,160.0,107.0,1,123,0.0,123.0,123.0
2417.0,17,2,664,1,322,0.0,322.0,322.0,1,342,0.0,342.0,342.0
1736016.0,6,23,6509,12,1529,157819.63636363635,357.0,127.41666666666669,11,4980,143144.9,1510.0,452.7272727272728
90093768.0,6,12,1832,7,950,15015628.0,188.0,135.71428571428572,5,882,15017000.5,204.0,176.4
2316.0,17,4,344,2,150,0.0,75.0,75.0,2,194,0.0,103.0,97.0
9060.0,17,2,498,1,80,0.0,80.0,80.0,1,418,0.0,418.0,418.0
56053.0,6,14,4740,7,653,9208.833333333334,249.0,93.28571428571428,7,4087,8923.0,1514.0,583.8571428571429
52409.0,6,14,4740,7,653,8497.5,249.0,93.28571428571428,7,4087,7295.5,1514.0,583.8571428571429
2176.0,17,4,344,2,150,0.0,75.0,75.0,2,194,0.0,103.0,97.0
18940.0,6,19,7540,11,978,1894.0,310.0,88.9090909090909,8,6562,1870.2857142857144,1514.0,820.25
2713.0,17,2,224,1,76,0.0,76.0,76.0,1,148,0.0,148.0,148.0
209354.0,17,2,180,1,90,0.0,90.0,90.0,1,90,0.0,90.0,90.0
1259342.0,6,20,6916,11,3099,125934.2,1514.0,281.72727272727275,9,3817,130114.75,1514.0,424.1111111111111
5005273.0,17,4,849,2,166,0.0,83.0,83.0,2,683,0.0,499.0,341.5
121172.0,6,3,337,2,214,0.0,160.0,107.0,1,123,0.0,123.0,123.0
320470.0,17,4,1400,4,1400,106823.33333333331,350.0,350.0,0,0,0.0,0.0,0.0
90537508.0,6,15,2444,8,1016,12933929.714285716,188.0,127.0,7,1428,15062656.666666666,204.0,204.0
207153.0,6,3,426,2,280,0.0,214.0,140.0,1,146,0.0,146.0,146.0
120447718.0,6,2389,2107466,726,47916,165515.48827586207,66.0,66.0,1663,2059550,72199.2166064982,1514.0,1238.4546001202646
1167695.0,6,11,1134,6,558,233539.0,220.0,93.0,5,576,291140.0,304.0,115.2
232330.0,6,3,337,2,214,0.0,160.0,107.0,1,123,0.0,123.0,123.0
28390.0,6,14,4740,7,653,4606.166666666667,249.0,93.28571428571428,7,4087,4375.833333333333,1514.0,583.8571428571429
36757.0,6,10,2032,5,524,8933.25,252.0,104.8,5,1508,8601.25,1236.0,301.6
307804.0,6,6,412,4,272,102601.33333333331,74.0,68.0,2,140,0.0,74.0,70.0
739.0,17,4,438,2,148,0.0,74.0,74.0,2,290,0.0,147.0,145.0
18921.0,6,10,2032,5,524,4222.5,252.0,104.8,5,1508,4203.75,1236.0,301.6
3749427.0,6,5,336,2,134,0.0,68.0,67.0,3,202,1422265.5,70.0,67.33333333333333
90033332.0,17,28,13364,28,13364,3334567.851851852,501.0,477.2857142857143,0,0,0.0,0.0,0.0
1315544.0,6,4,264,2,132,0.0,66.0,66.0,2,132,0.0,66.0,66.0
157100.0,6,3,337,2,214,0.0,160.0,107.0,1,123,0.0,123.0,123.0
108623.0,17,2,286,2,286,0.0,143.0,143.0,0,0,0.0,0.0,0.0
38009.0,6,10,1065,5,534,8298.75,262.0,106.8,5,531,8078.25,259.0,106.2
515204.0,17,2,363,1,79,0.0,79.0,79.0,1,284,0.0,284.0,284.0
14341.0,17,2,180,1,90,0.0,90.0,90.0,1,90,0.0,90.0,90.0
160743.0,6,3,337,2,214,0.0,160.0,107.0,1,123,0.0,123.0,123.0
143894.0,17,2,180,1,90,0.0,90.0,90.0,1,90,0.0,90.0,90.0
108104433.0,17,5,955,5,955,27026108.25,191.0,191.0,0,0,0.0,0.0,0.0
1038621.0,6,11,1134,6,558,207724.2,220.0,93.0,5,576,257345.5,304.0,115.2
120499058.0,6,221,24912,111,17356,1095445.981818182,284.0,156.36036036036035,110,7556,1076974.3119266054,140.0,68.69090909090909
10520214.0,6,7,478,4,272,3461179.0,74.0,68.0,3,206,5191644.5,74.0,68.66666666666667
102095.0,17,2,286,2,286,0.0,143.0,143.0,0,0,0.0,0.0,0.0
677.0,17,2,508,2,508,0.0,257.0,254.0,0,0,0.0,0.0,0.0
120212267.0,6,503,68420,252,16940,478933.3346613546,140.0,67.22222222222223,251,51480,479901.292,570.0,205.0996015936255
8111909.000000001,17,4,1376,3,1026,36639.0,342.0,342.0,1,350,0.0,350.0,350.0
5620705.0,6,5,336,3,202,1424266.5,70.0,67.33333333333333,2,134,0.0,68.0,67.0
2390.0,17,4,344,2,150,0.0,75.0,75.0,2,194,0.0,103.0,97.0
17302.0,6,14,4740,7,653,2722.833333333333,249.0,93.28571428571428,7,4087,2724.333333333333,1514.0,583.8571428571429
120091441.0,6,38,2848,20,1531,6309231.842105263,139.0,76.55,18,1317,7051492.647058823,123.0,73.16666666666667
1496854.0,17,5,961,3,234,748237.5,78.0,78.0,2,727,0.0,395.0,363.5
119943317.0,6,33,2296,17,1225,7482965.625,139.0,72.05882352941177,16,1071,7981820.066666666,123.0,66.9375
208264.0,6,3,426,2,280,0.0,214.0,140.0,1,146,0.0,146.0,146.0
120002875.0,6,17,1246,9,650,15000359.375,95.0,72.22222222222223,8,596,17106527.0,95.0,74.5
207444.0,6,10,1221,6,636,41488.8,298.0,106.0,4,585,67580.33333333333,379.0,146.25
621790.0,17,4,629,3,234,627.5,78.0,78.0,1,395,0.0,395.0,395.0
120126473.0,6,17,2556,10,1392,13347385.888888888,188.0,139.2,7,1164,15012820.5,204.0,166.28571428571428
153410.0,17,2,180,1,90,0.0,90.0,90.0,1,90,0.0,90.0,90.0
19994.0,6,10,2032,5,524,3564.5,252.0,104.8,5,1508,4694.0,1236.0,301.6
317622.0,6,3,202,2,128,0.0,74.0,64.0,1,74,0.0,74.0,74.0
120174.0,17,2,180,1,70,0.0,70.0,70.0,1,110,0.0,110.0,110.0
204403.0,17,2,180,1,90,0.0,90.0,90.0,1,90,0.0,90.0,90.0
153421.0,17,2,180,1,90,0.0,90.0,90.0,1,90,0.0,90.0,90.0
27909.0,6,14,4740,7,653,4254.666666666667,249.0,93.28571428571428,7,4087,4416.833333333333,1514.0,583.8571428571429
16854.0,6,11,2098,6,590,2958.2,252.0,98.33333333333331,5,1508,3923.5,1236.0,301.6
1554504.0,6,4,492,2,280,0.0,214.0,140.0,2,212,0.0,146.0,106.0
28554.0,6,10,2032,5,524,6890.25,252.0,104.8,5,1508,6006.0,1236.0,301.6
284591.0,17,4,704,2,148,0.0,74.0,74.0,2,556,0.0,280.0,278.0
4602744.0,6,5,336,2,134,0.0,68.0,67.0,3,202,1526801.0,70.0,67.33333333333333
107467.0,17,2,286,2,286,0.0,143.0,143.0,0,0,0.0,0.0,0.0
10470604.0,6,7,478,4,272,3444806.0,74.0,68.0,3,206,5167128.0,74.0,68.66666666666667
90055260.0,17,28,13364,28,13364,3335380.0,501.0,477.2857142857143,0,0,0.0,0.0,0.0
119121069.0,6,37,2725,18,1317,7007121.705882353,123.0,73.16666666666667,19,1408,6605747.777777778,139.0,74.10526315789474
135136808.0,17,6,1206,6,1206,27027361.6,201.0,201.0,0,0,0.0,0.0,0.0
38160.0,6,14,4740,7,653,6233.333333333333,249.0,93.28571428571428,7,4087,6159.5,1514.0,583.8571428571429
320013.0,17,4,1400,4,1400,106671.0,350.0,350.0,0,0,0.0,0.0,0.0
71100.0,17,2,630,1,82,0.0,82.0,82.0,1,548,0.0,548.0,548.0
5619633.0,6,5,336,2,134,0.0,68.0,67.0,3,202,1421932.0,70.0,67.33333333333333
2326.0,17,4,344,2,150,0.0,75.0,75.0,2,194,0.0,103.0,97.0
120308993.0,6,226,25610,113,7766,1068521.5982142857,140.0,68.72566371681415,113,17844,1057729.982142857,300.0,157.91150442477877
258983.00000000003,6,3,337,2,214,0.0,160.0,107.0,1,123,0.0,123.0,123.0
120033156.0,6,19,1395,10,745,13332046.888888888,95.0,74.5,9,650,14999114.5,95.0,72.22222222222223
120528052.0,6,33,2280,17,1209,7533003.25,123.0,71.11764705882354,16,1071,7355643.266666667,123.0,66.9375
2357782.0,6,25,7573,14,3735,181367.84615384616,1514.0,266.7857142857143,11,3838,210011.5,1514.0,348.90909090909093
121420.0,6,3,337,2,214,0.0,160.0,107.0,1,123,0.0,123.0,123.0
28283.0,6,14,4740,7,653,4358.166666666667,249.0,93.28571428571428,7,4087,4380.833333333333,1514.0,583.8571428571429
146418.0,6,3,337,2,214,0.0,160.0,107.0,1,123,0.0,123.0,123.0
28217.0,6,14,4740,7,653,4583.333333333333,249.0,93.28571428571428,7,4087,4511.833333333333,1514.0,583.8571428571429
36280.0,6,14,4740,7,653,5923.5,249.0,93.28571428571428,7,4087,4379.5,1514.0,583.8571428571429
367301.0,17,2,363,1,75,0.0,75.0,75.0,1,288,0.0,288.0,288.0
12231.0,6,10,1949,5,441,2758.75,169.0,88.2,5,1508,2677.25,1236.0,301.6
2223130.0,6,47,23596,24,19731,96657.82608695651,1514.0,822.125,23,3865,89907.45454545454,1514.0,168.04347826086956
196950.0,17,2,180,1,90,0.0,90.0,90.0,1,90,0.0,90.0,90.0
1173074.0,6,13,3011,8,2383,167582.0,1514.0,297.875,5,628,224366.25,331.0,125.6
397.0,17,2,160,1,80,0.0,80.0,80.0,1,80,0.0,80.0,80.0
14151.0,6,10,2032,5,524,2891.75,252.0,104.8,5,1508,2775.5,1236.0,301.6
4802921.0,6,5,336,2,134,0.0,68.0,67.0,3,202,1525926.5,70.0,67.33333333333333
302257.0,6,6,412,4,272,100752.33333333331,74.0,68.0,2,140,0.0,74.0,70.0
1659986.0,6,7,499,3,198,818714.5,66.0,66.0,4,301,484574.6666666667,103.0,75.25
120046791.0,17,28,13364,28,13364,4446177.444444444,501.0,477.2857142857143,0,0,0.0,0.0,0.0
239149.0,17,2,180,1,70,0.0,70.0,70.0,1,110,0.0,110.0,110.0
90274143.0,6,13,2036,8,1016,12896306.142857144,188.0,127.0,5,1020,22527778.5,204.0,204.0
197061.0,17,2,180,1,90,0.0,90.0,90.0,1,90,0.0,90.0,90.0
166632.0,17,2,180,1,90,0.0,90.0,90.0,1,90,0.0,90.0,90.0
153372.0,17,2,180,1,90,0.0,90.0,90.0,1,90,0.0,90.0,90.0
0.0,17,1,80,1,80,0.0,80.0,80.0,0,0,0.0,0.0,0.0
14930.0,6,14,4740,7,653,2377.833333333333,249.0,93.28571428571428,7,4087,2349.833333333333,1514.0,583.8571428571429
2543155.0,6,3,1777,1,826,0.0,826.0,826.0,2,951,0.0,885.0,475.5
532.0,17,2,508,2,508,0.0,257.0,254.0,0,0,0.0,0.0,0.0
2446.0,17,4,344,2,150,0.0,75.0,75.0,2,194,0.0,103.0,97.0
90231768.0,6,16,1192,8,596,12883892.285714284,95.0,74.5,8,596,12885091.42857143,95.0,74.5
1019182.0,6,11,1134,6,558,203836.4,220.0,93.0,5,576,254138.0,304.0,115.2
3300187.0,6,9,1031,5,807,773707.25,571.0,161.4,4,224,1031838.0,62.0,56.0
103307728.0,6,44,2904,22,1452,4919415.619047619,66.0,66.0,22,1452,4906302.952380952,66.0,66.0
114134239.0,6,30,1990,15,1042,8137027.214285715,139.0,69.46666666666667,15,948,8137016.928571428,123.0,63.2
58221.0,6,14,4740,7,653,9578.833333333334,249.0,93.28571428571428,7,4087,7238.333333333333,1514.0,583.8571428571429
120000983.0,17,14,864,7,432,20000163.83333333,174.0,61.71428571428572,7,432,16667656.666666666,174.0,61.71428571428572
14640656.0,6,20,1607,10,975,1592981.4444444445,315.0,97.5,10,632,1592952.888888889,78.0,63.2
226460.0,6,10,1221,6,636,45292.0,298.0,106.0,4,585,74334.66666666667,379.0,146.25
90527633.0,6,13,2036,8,1016,12932519.0,188.0,127.0,5,1020,22589918.25,204.0,204.0
10479358.0,6,7,478,4,272,3447372.6666666665,74.0,68.0,3,206,5170969.5,74.0,68.66666666666667
38867.0,6,14,4740,7,653,6349.333333333333,249.0,93.28571428571428,7,4087,5602.666666666667,1514.0,583.8571428571429
281002.0,17,2,363,1,79,0.0,79.0,79.0,1,284,0.0,284.0,284.0
96914729.0,6,219,24780,110,17364,889125.9541284404,284.0,157.85454545454544,109,7416,893102.6018518518,140.0,68.03669724770643
207077.0,6,3,426,2,280,0.0,214.0,140.0,1,146,0.0,146.0,146.0
230682.0,6,10,1221,6,636,46136.4,298.0,106.0,4,585,76027.33333333333,379.0,146.25
303125.0,6,2,132,1,66,0.0,66.0,66.0,1,66,0.0,66.0,66.0
154196.0,17,2,180,1,90,0.0,90.0,90.0,1,90,0.0,90.0,90.0
108113528.0,17,5,955,5,955,27028382.0,191.0,191.0,0,0,0.0,0.0,0.0
2003.0,17,4,344,2,150,0.0,75.0,75.0,2,194,0.0,103.0,97.0
851733.0,6,9,1096,6,625,170346.6,287.0,104.16666666666669,3,471,288060.5,331.0,157.0
196974.0,17,2,180,1,90,0.0,90.0,90.0,1,90,0.0,90.0,90.0
28738.0,6,14,4740,7,653,4505.666666666667,249.0,93.28571428571428,7,4087,3819.1666666666665,1514.0,583.8571428571429
99957494.0,17,10,430,5,215,20000834.75,43.0,43.0,5,215,20000175.25,43.0,43.0
356249.0,6,4,508,2,238,0.0,172.0,119.0,2,270,0.0,135.0,135.0
108099658.0,17,5,1005,5,1005,27024914.5,201.0,201.0,0,0,0.0,0.0,0.0
247899.0,6,4,439,2,238,0.0,172.0,119.0,2,201,0.0,135.0,100.5
120125046.0,6,16,2490,10,1392,13347227.333333334,188.0,139.2,6,1098,18098199.8,204.0,183.0
349.0,17,2,160,1,80,0.0,80.0,80.0,1,80,0.0,80.0,80.0
108359.0,17,2,286,2,286,0.0,143.0,143.0,0,0,0.0,0.0,0.0
234186.0,6,3,373,2,238,0.0,172.0,119.0,1,135,0.0,135.0,135.0
214387.0,6,10,1221,6,636,42877.4,298.0,106.0,4,585,70395.0,379.0,146.25
415816.0,6,3,1604,1,753,0.0,753.0,753.0,2,851,0.0,785.0,425.5
207764.0,6,3,426,2,280,0.0,214.0,140.0,1,146,0.0,146.0,146.0
1994.0,17,4,344,2,150,0.0,75.0,75.0,2,194,0.0,103.0,97.0
90025107.0,17,28,13364,28,13364,3334263.222222222,501.0,477.2857142857143,0,0,0.0,0.0,0.0
118380319.0,6,217,24490,109,7490,1096114.0648148148,140.0,68.71559633027523,108,17000,1086835.3364485982,284.0,157.40740740740742
111145.0,17,2,286,2,286,0.0,143.0,143.0,0,0,0.0,0.0,0.0
277188.0,17,2,363,1,79,0.0,79.0,79.0,1,284,0.0,284.0,284.0
32658.0,6,14,4740,7,653,5040.833333333333,249.0,93.28571428571428,7,4087,5164.833333333333,1514.0,583.8571428571429
95015423.0,6,28,2008,14,1045,7308878.692307692,139.0,74.64285714285714,14,963,7293036.230769231,123.0,68.78571428571429
5588.0,17,2,180,1,90,0.0,90.0,90.0,1,90,0.0,90.0,90.0
90050172.0,17,27,12943,27,12943,3463468.153846154,501.0,479.3703703703704,0,0,0.0,0.0,0.0
173990.0,6,3,337,2,214,0.0,160.0,107.0,1,123,0.0,123.0,123.0
4286.0,17,2,582,1,83,0.0,83.0,83.0,1,499,0.0,499.0,499.0
308334.0,6,6,412,4,272,102778.0,74.0,68.0,2,140,0.0,74.0,70.0
533.0,17,2,508,2,508,0.0,257.0,254.0,0,0,0.0,0.0,0.0
121378.0,6,3,337,2,214,0.0,160.0,107.0,1,123,0.0,123.0,123.0
120304.0,17,2,180,1,70,0.0,70.0,70.0,1,110,0.0,110.0,110.0
9606.0,6,10,1067,5,536,2086.0,264.0,107.2,5,531,2131.5,259.0,106.2
43352.0,6,14,4740,7,653,7115.5,249.0,93.28571428571428,7,4087,7083.666666666667,1514.0,583.8571428571429
213625.0,17,2,180,1,90,0.0,90.0,90.0,1,90,0.0,90.0,90.0
103004011.0,17,14,1126,7,563,17167335.166666668,174.0,80.42857142857143,7,563,17000220.5,174.0,80.42857142857143
33329.0,6,10,2032,5,524,6791.75,252.0,104.8,5,1508,8000.0,1236.0,301.6
115651434.0,6,30,1974,15,1026,8245405.428571428,123.0,68.4,15,948,8245402.928571428,123.0,63.2
196789.0,17,2,180,1,90,0.0,90.0,90.0,1,90,0.0,90.0,90.0
146830.0,6,2,132,1,66,0.0,66.0,66.0,1,66,0.0,66.0,66.0
77385.0,6,14,4740,7,653,11150.833333333334,249.0,93.28571428571428,7,4087,12763.0,1514.0,583.8571428571429
286039.0,17,4,1400,4,1400,95346.33333333331,350.0,350.0,0,0,0.0,0.0,0.0
186627.0,17,2,626,1,72,0.0,72.0,72.0,1,554,0.0,554.0,554.0
2962520.0,6,11,2106,6,598,592293.8,252.0,99.66666666666669,5,1508,2876.75,1236.0,301.6
316.0,17,2,174,1,79,0.0,79.0,79.0,1,95,0.0,95.0,95.0
233883.0,6,3,337,2,214,0.0,160.0,107.0,1,123,0.0,123.0,123.0
19615.0,6,14,4740,7,653,3145.6666666666665,249.0,93.28571428571428,7,4087,3130.833333333333,1514.0,583.8571428571429
109093.0,17,2,286,2,286,0.0,143.0,143.0,0,0,0.0,0.0,0.0
10478182.0,6,7,478,4,272,3446183.6666666665,74.0,68.0,3,206,5169164.0,74.0,68.66666666666667
90257231.0,6,13,2036,8,1016,12893890.142857144,188.0,127.0,5,1020,22523183.25,204.0,204.0
7355.0,6,2,132,1,66,0.0,66.0,66.0,1,66,0.0,66.0,66.0
275248.0,6,10,1221,6,636,55049.6,298.0,106.0,4,585,86285.66666666667,379.0,146.25
90031867.0,17,28,13364,28,13364,3334513.592592593,501.0,477.2857142857143,0,0,0.0,0.0,0.0
90092775.0,6,11,1644,7,828,15015462.5,188.0,118.28571428571428,4,816,20021024.0,204.0,204.0
205728.0,17,2,180,1,90,0.0,90.0,90.0,1,90,0.0,90.0,90.0
310060.0,17,4,1400,4,1400,103353.33333333331,350.0,350.0,0,0,0.0,0.0,0.0
37773.0,6,10,2032,5,524,8867.25,252.0,104.8,5,1508,9155.25,1236.0,301.6
53146.0,6,14,4740,7,653,8736.333333333334,249.0,93.28571428571428,7,4087,8652.166666666666,1514.0,583.8571428571429
12970.0,6,10,2032,5,524,2773.0,252.0,104.8,5,1508,2976.75,1236.0,301.6
135141721.0,17,6,1146,6,1146,27028344.2,191.0,191.0,0,0,0.0,0.0,0.0
72217.0,6,14,4740,7,653,11433.0,249.0,93.28571428571428,7,4087,9449.0,1514.0,583.8571428571429
120006962.0,6,17,1287,9,691,15000870.25,95.0,76.77777777777777,8,596,12859130.42857143,95.0,74.5
281544.0,17,2,363,1,79,0.0,79.0,79.0,1,284,0.0,284.0,284.0
171095.0,17,4,704,2,148,0.0,74.0,74.0,2,556,0.0,280.0,278.0
103160.0,17,2,286,2,286,0.0,143.0,143.0,0,0,0.0,0.0,0.0
242872.0,17,4,6056,4,6056,80957.33333333333,1514.0,1514.0,0,0,0.0,0.0,0.0
357.0,17,2,248,1,84,0.0,84.0,84.0,1,164,0.0,164.0,164.0
107342.0,17,2,286,2,286,0.0,143.0,143.0,0,0,0.0,0.0,0.0
879626.0,6,10,1336,6,799,175925.2,461.0,133.16666666666666,4,537,201351.3333333333,331.0,134.25
209626.0,6,3,426,2,280,0.0,214.0,140.0,1,146,0.0,146.0,146.0
90004160.0,17,28,13364,28,13364,3333487.407407407,501.0,477.2857142857143,0,0,0.0,0.0,0.0
18116.0,6,14,4740,7,653,2802.6666666666665,249.0,93.28571428571428,7,4087,2838.1666666666665,1514.0,583.8571428571429
2310.0,17,4,344,2,150,0.0,75.0,75.0,2,194,0.0,103.0,97.0
90294176.0,6,26,2858,13,1410,7521064.833333333,426.0,108.46153846153848,13,1448,7523734.833333333,330.0,111.3846153846154
90042861.0,17,28,13364,28,13364,3334920.777777778,501.0,477.2857142857143,0,0,0.0,0.0,0.0
37776.0,6,10,2032,5,524,9215.0,252.0,104.8,5,1508,8622.25,1236.0,301.6
80.0,17,2,762,2,762,0.0,381.0,381.0,0,0,0.0,0.0,0.0
239352.0,17,2,180,1,90,0.0,90.0,90.0,1,90,0.0,90.0,90.0
308273.0,6,6,412,4,272,102757.66666666669,74.0,68.0,2,140,0.0,74.0,70.0
1306262.0,6,4,264,2,132,0.0,66.0,66.0,2,132,0.0,66.0,66.0
10472667.0,6,7,478,4,272,3444234.6666666665,74.0,68.0,3,206,5166245.0,74.0,68.66666666666667
97149003.0,6,209,23550,105,7164,934125.028846154,140.0,68.22857142857143,104,16386,937445.3592233008,300.0,157.55769230769232
34014.0,6,14,4740,7,653,4440.166666666667,249.0,93.28571428571428,7,4087,5467.333333333333,1514.0,583.8571428571429
50546.0,6,14,4740,7,653,8293.166666666666,249.0,93.28571428571428,7,4087,8090.5,1514.0,583.8571428571429
30090.0,6,10,2032,5,524,7231.25,252.0,104.8,5,1508,7063.25,1236.0,301.6
37034.0,6,14,4740,7,653,5169.0,249.0,93.28571428571428,7,4087,6039.333333333333,1514.0,583.8571428571429
15608.0,6,14,4740,7,653,2491.6666666666665,249.0,93.28571428571428,7,4087,2412.0,1514.0,583.8571428571429
1495870.0,6,8,602,3,198,205779.5,66.0,66.0,5,404,349607.75,103.0,80.8
120278851.0,6,224,25200,112,7688,1076136.1171171172,140.0,68.64285714285714,112,17512,1080855.6486486488,284.0,156.35714285714286
114140965.0,6,47,3102,24,1584,4962639.826086956,66.0,66.0,23,1518,5143993.727272728,66.0,66.0
2889.0,17,2,224,1,76,0.0,76.0,76.0,1,148,0.0,148.0,148.0
26050.0,6,14,4740,7,653,4191.166666666667,249.0,93.28571428571428,7,4087,4200.666666666667,1514.0,583.8571428571429
19762.0,17,4,823,2,163,0.0,89.0,81.5,2,660,0.0,443.0,330.0
10462455.0,6,6,412,3,206,5162779.0,74.0,68.66666666666667,3,206,5162634.5,74.0,68.66666666666667
2511417.0,6,3,1604,1,753,0.0,753.0,753.0,2,851,0.0,785.0,425.5
90288728.0,6,16,1192,8,596,12891456.714285716,95.0,74.5,8,596,12896551.285714284,95.0,74.5
108124097.0,17,5,955,5,955,27031024.25,191.0,191.0,0,0,0.0,0.0,0.0
120123612.0,6,13,2020,9,1204,15015451.5,188.0,133.77777777777777,4,816,30031491.33333333,204.0,204.0
302822.0,6,6,412,4,272,100940.66666666669,74.0,68.0,2,140,0.0,74.0,70.0
42461.0,6,14,4740,7,653,5973.666666666667,249.0,93.28571428571428,7,4087,5764.0,1514.0,583.8571428571429
20965289.0,17,3,1034,2,684,0.0,342.0,342.0,1,350,0.0,350.0,350.0
544397.0,6,2,132,1,66,0.0,66.0,66.0,1,66,0.0,66.0,66.0
197055.0,17,2,180,1,90,0.0,90.0,90.0,1,90,0.0,90.0,90.0
18881.0,6,14,4740,7,653,2891.6666666666665,249.0,93.28571428571428,7,4087,3008.833333333333,1514.0,583.8571428571429
212888.0,6,3,426,2,280,0.0,214.0,140.0,1,146,0.0,146.0,146.0
41484.0,6,14,4740,7,653,6792.333333333333,249.0,93.28571428571428,7,4087,6138.5,1514.0,583.8571428571429
135134558.0,17,6,1146,6,1146,27026911.6,191.0,191.0,0,0,0.0,0.0,0.0
120026299.0,17,29,13785,29,13785,4286653.535714285,501.0,475.3448275862069,0,0,0.0,0.0,0.0
107831995.0,6,44,2904,22,1452,5134856.904761905,66.0,66.0,22,1452,5121880.761904762,66.0,66.0
0.0,17,1,44,1,44,0.0,44.0,44.0,0,0,0.0,0.0,0.0
30823.0,6,14,4740,7,653,5026.166666666667,249.0,93.28571428571428,7,4087,4798.333333333333,1514.0,583.8571428571429
108106068.0,17,5,1005,5,1005,27026517.0,201.0,201.0,0,0,0.0,0.0,0.0
270592.0,6,10,1221,6,636,54118.4,298.0,106.0,4,585,84673.33333333333,379.0,146.25
1992.0,17,4,344,2,150,0.0,75.0,75.0,2,194,0.0,103.0,97.0
2350.0,17,4,344,2,150,0.0,75.0,75.0,2,194,0.0,103.0,97.0
199415.0,17,2,762,2,762,0.0,381.0,381.0,0,0,0.0,0.0,0.0
758.0,17,4,438,2,148,0.0,74.0,74.0,2,290,0.0,147.0,145.0
1474761.0,6,4,276,2,128,0.0,74.0,64.0,2,148,0.0,74.0,74.0
865.0,17,4,438,2,148,0.0,74.0,74.0,2,290,0.0,147.0,145.0
103254.0,17,2,286,2,286,0.0,143.0,143.0,0,0,0.0,0.0,0.0
108113006.0,17,5,1005,5,1005,27028251.5,201.0,201.0,0,0,0.0,0.0,0.0
308717.0,6,6,412,4,272,102905.66666666669,74.0,68.0,2,140,0.0,74.0,70.0
113000969.0,17,13,821,7,432,18833494.83333333,174.0,61.71428571428572,6,389,18600639.0,174.0,64.83333333333333
108109435.0,17,5,955,5,955,27027358.75,191.0,191.0,0,0,0.0,0.0,0.0
409.0,17,2,410,1,78,0.0,78.0,78.0,1,332,0.0,332.0,332.0
0.0,6,1,172,1,172,0.0,172.0,172.0,0,0,0.0,0.0,0.0
216577.0,17,2,180,1,90,0.0,90.0,90.0,1,90,0.0,90.0,90.0
209870.0,6,3,426,2,280,0.0,214.0,140.0,1,146,0.0,146.0,146.0
4804562.0,6,5,336,2,134,0.0,68.0,67.0,3,202,1525902.5,70.0,67.33333333333333
90254436.0,6,14,2240,8,1016,12893490.857142856,188.0,127.0,6,1224,18018402.2,204.0,204.0
33746.0,6,10,2032,5,524,8232.25,252.0,104.8,5,1508,7270.5,1236.0,301.6
39212.0,6,14,4740,7,653,6407.666666666667,249.0,93.28571428571428,7,4087,6398.333333333333,1514.0,583.8571428571429
5625476.0,6,5,336,2,134,0.0,68.0,67.0,3,202,1525565.5,70.0,67.33333333333333
27211.0,6,11,2098,6,590,5196.0,252.0,98.33333333333331,5,1508,6235.75,1236.0,301.6
59550216.0,17,9,3086,8,2736,5214123.428571428,342.0,342.0,1,350,0.0,350.0,350.0
309837.0,6,6,412,4,272,103279.0,74.0,68.0,2,140,0.0,74.0,70.0
306836.0,6,6,412,4,272,102278.66666666669,74.0,68.0,2,140,0.0,74.0,70.0
342909.0,6,10,1221,6,636,68581.8,298.0,106.0,4,585,108898.66666666669,379.0,146.25
147381.0,6,3,373,2,238,0.0,172.0,119.0,1,135,0.0,135.0,135.0
261879.0,6,10,1221,6,636,52375.8,298.0,106.0,4,585,80671.66666666667,379.0,146.25
153439.0,17,2,180,1,90,0.0,90.0,90.0,1,90,0.0,90.0,90.0
83455445.0,17,15,5138,14,4788,5895032.538461538,342.0,342.0,1,350,0.0,350.0,350.0
120965170.0,6,32,2226,17,1209,7560323.125,123.0,71.11764705882354,15,1017,7911752.857142857,123.0,67.8
90060845.0,17,28,13364,28,13364,3335586.851851852,501.0,477.2857142857143,0,0,0.0,0.0,0.0
356.0,17,2,156,1,78,0.0,78.0,78.0,1,78,0.0,78.0,78.0
564260.0,6,10,1221,6,636,112852.0,298.0,106.0,4,585,186944.3333333333,379.0,146.25
63314.99999999999,6,14,4740,7,653,9738.666666666666,249.0,93.28571428571428,7,4087,10401.166666666666,1514.0,583.8571428571429
40805.0,6,14,4740,7,653,6580.166666666667,249.0,93.28571428571428,7,4087,6508.666666666667,1514.0,583.8571428571429
90039988.0,17,28,13364,28,13364,3334814.3703703703,501.0,477.2857142857143,0,0,0.0,0.0,0.0
15074.0,6,10,2032,5,524,2700.75,252.0,104.8,5,1508,3035.5,1236.0,301.6
105688609.0,17,14,1126,7,563,17603622.666666668,174.0,80.42857142857143,7,563,17588280.5,174.0,80.42857142857143
302812.0,6,6,412,4,272,100937.33333333331,74.0,68.0,2,140,0.0,74.0,70.0
859416.0,6,9,1196,6,725,171883.2,387.0,120.83333333333331,3,471,292211.5,331.0,157.0
20420.0,17,2,582,1,83,0.0,83.0,83.0,1,499,0.0,499.0,499.0
45356.0,17,2,180,1,90,0.0,90.0,90.0,1,90,0.0,90.0,90.0
4600402.0,6,5,336,2,134,0.0,68.0,67.0,3,202,1423572.0,70.0,67.33333333333333
120129062.0,6,220,24884,110,7556,1094676.4403669725,140.0,68.69090909090909,110,17328,1094494.376146789,284.0,157.52727272727273
113485813.0,17,14,864,7,432,18834474.0,174.0,61.71428571428572,7,432,18833499.166666668,174.0,61.71428571428572
120012907.0,6,18,1341,9,691,14999992.25,95.0,76.77777777777777,9,650,15000379.0,95.0,72.22222222222223
2112099.0,6,25,7611,13,2516,176008.25,1034.0,193.53846153846155,12,5095,164472.9090909091,1510.0,424.5833333333333
90292293.0,6,14,1043,7,542,15048715.5,95.0,77.42857142857143,7,501,14997195.833333334,95.0,71.57142857142857
120047761.0,17,29,13785,29,13785,4287420.035714285,501.0,475.3448275862069,0,0,0.0,0.0,0.0
90021720.0,17,28,13364,28,13364,3334137.777777778,501.0,477.2857142857143,0,0,0.0,0.0,0.0
209793.0,6,3,426,2,280,0.0,214.0,140.0,1,146,0.0,146.0,146.0
30185.0,6,10,2032,5,524,6061.75,252.0,104.8,5,1508,7040.25,1236.0,301.6
16236182.0,17,6,2052,6,2052,3247236.4,342.0,342.0,0,0,0.0,0.0,0.0
101766.0,17,2,762,2,762,0.0,381.0,381.0,0,0,0.0,0.0,0.0
10905264.0,6,8,544,4,272,3588252.333333333,74.0,68.0,4,272,3588186.0,74.0,68.0
197576.0,17,2,180,1,90,0.0,90.0,90.0,1,90,0.0,90.0,90.0
41267.0,6,14,4740,7,653,6751.0,249.0,93.28571428571428,7,4087,6058.666666666667,1514.0,583.8571428571429
55368.0,6,14,4740,7,653,9109.0,249.0,93.28571428571428,7,4087,7877.666666666667,1514.0,583.8571428571429
108110329.0,17,5,1005,5,1005,27027582.25,201.0,201.0,0,0,0.0,0.0,0.0
0.0,6,1,54,0,0,0.0,0.0,0.0,1,54,0.0,54.0,54.0
351.0,17,2,160,1,80,0.0,80.0,80.0,1,80,0.0,80.0,80.0
90256731.0,6,13,2036,8,1016,12893818.714285716,188.0,127.0,5,1020,22523427.75,204.0,204.0
3343608.0,6,192,151123,105,141080,32150.07692307692,1510.0,1343.6190476190477,87,10043,35404.46511627907,1510.0,115.4367816091954
70797.0,6,14,4740,7,653,10828.333333333334,249.0,93.28571428571428,7,4087,11615.666666666666,1514.0,583.8571428571429
207297.0,6,3,426,2,280,0.0,214.0,140.0,1,146,0.0,146.0,146.0
80318.0,6,14,4740,7,653,12631.166666666666,249.0,93.28571428571428,7,4087,12307.0,1514.0,583.8571428571429
302281.0,6,2,138,1,68,0.0,68.0,68.0,1,70,0.0,70.0,70.0
246112.0,6,3,337,2,214,0.0,160.0,107.0,1,123,0.0,123.0,123.0
148825.0,17,2,414,1,88,0.0,88.0,88.0,1,326,0.0,326.0,326.0
100928.0,17,2,762,2,762,0.0,381.0,381.0,0,0,0.0,0.0,0.0
135130583.0,17,6,1206,6,1206,27026116.6,201.0,201.0,0,0,0.0,0.0,0.0
0.0,17,1,453,1,453,0.0,453.0,453.0,0,0,0.0,0.0,0.0
120027544.0,17,29,13785,29,13785,4286698.0,501.0,475.3448275862069,0,0,0.0,0.0,0.0
120037872.0,6,22,1639,12,894,10908308.636363637,95.0,74.5,10,745,13331977.222222222,95.0,74.5
90760574.0,6,19,1436,10,745,10079281.888888888,95.0,74.5,9,691,11344188.5,95.0,76.77777777777777
108107494.0,17,5,955,5,955,27026873.5,191.0,191.0,0,0,0.0,0.0,0.0
22043.0,6,14,4740,7,653,2947.333333333333,249.0,93.28571428571428,7,4087,3466.0,1514.0,583.8571428571429
92764925.0,6,30,2254,15,1086,6626066.071428572,123.0,72.4,15,1168,5897300.357142857,139.0,77.86666666666666
15218.0,17,2,582,1,83,0.0,83.0,83.0,1,499,0.0,499.0,499.0
14705905.0,6,20,1607,10,975,1592423.2222222222,315.0,97.5,10,632,1597431.2222222222,78.0,63.2
317495.0,17,4,1400,4,1400,105831.66666666669,350.0,350.0,0,0,0.0,0.0,0.0
442011.0,17,2,363,1,79,0.0,79.0,79.0,1,284,0.0,284.0,284.0
102270348.0,6,469,63946,235,48280,437052.7692307693,336.0,205.4468085106383,234,15666,437973.43776824034,140.0,66.94871794871794
36986.0,6,10,2032,5,524,8785.75,252.0,104.8,5,1508,8209.0,1236.0,301.6
120048624.0,17,29,13785,29,13785,4287450.857142857,501.0,475.3448275862069,0,0,0.0,0.0,0.0
239171.0,17,2,180,1,90,0.0,90.0,90.0,1,90,0.0,90.0,90.0
121238.0,6,3,337,2,214,0.0,160.0,107.0,1,123,0.0,123.0,123.0
143951.0,17,2,180,1,90,0.0,90.0,90.0,1,90,0.0,90.0,90.0
52438.0,6,14,4740,7,653,8313.166666666666,249.0,93.28571428571428,7,4087,7554.5,1514.0,583.8571428571429
207144.0,6,3,426,2,280,0.0,214.0,140.0,1,146,0.0,146.0,146.0
204600.0,17,2,762,2,762,0.0,381.0,381.0,0,0,0.0,0.0,0.0
2039.0,17,4,344,2,150,0.0,75.0,75.0,2,194,0.0,103.0,97.0
34682.0,6,14,4740,7,653,5663.166666666667,249.0,93.28571428571428,7,4087,5644.166666666667,1514.0,583.8571428571429
108101530.0,17,5,955,5,955,27025382.5,191.0,191.0,0,0,0.0,0.0,0.0
2483045.0,6,25,7573,14,3735,191003.4615384616,1514.0,266.7857142857143,11,3838,222774.1,1514.0,348.90909090909093
290381.0,6,10,1221,6,636,58076.2,298.0,106.0,4,585,91353.66666666669,379.0,146.25
323119.0,17,4,1400,4,1400,107706.33333333331,350.0,350.0,0,0,0.0,0.0,0.0
302510.0,17,4,1400,4,1400,100836.66666666669,350.0,350.0,0,0,0.0,0.0,0.0
17437010.0,6,27,8881,15,1851,1245500.7142857143,408.0,123.4,12,7030,1262489.4545454546,1514.0,585.8333333333334
10462.0,17,4,823,2,163,0.0,89.0,81.5,2,660,0.0,443.0,330.0
24746.0,6,10,1975,5,467,2347.25,195.0,93.4,5,1508,5471.75,1236.0,301.6
111421644.0,6,31,2166,16,1149,7413703.733333333,123.0,71.8125,15,1017,7943271.142857143,123.0,67.8
41412.0,6,14,4740,7,653,6342.666666666667,249.0,93.28571428571428,7,4087,5647.833333333333,1514.0,583.8571428571429
1401643.0,17,6,1230,3,234,700639.0,78.0,78.0,3,996,700617.5,332.0,332.0
106286355.0,6,32,2236,16,1165,7072089.4,139.0,72.8125,16,1071,7072088.533333333,123.0,66.9375
153516.0,17,2,180,1,90,0.0,90.0,90.0,1,90,0.0,90.0,90.0
15261.0,17,2,180,1,90,0.0,90.0,90.0,1,90,0.0,90.0,90.0
108108082.0,17,5,1005,5,1005,27027020.5,201.0,201.0,0,0,0.0,0.0,0.0
3014055.0,6,11,2106,6,598,602633.4,252.0,99.66666666666669,5,1508,3415.5,1236.0,301.6
3232.0,17,4,344,2,150,0.0,75.0,75.0,2,194,0.0,103.0,97.0
102570.0,17,2,286,2,286,0.0,143.0,143.0,0,0,0.0,0.0,0.0
121334965.0,6,285,32774,143,23180,854471.5845070423,284.0,162.0979020979021,142,9594,845821.5815602837,140.0,67.56338028169014
349.0,17,2,160,1,80,0.0,80.0,80.0,1,80,0.0,80.0,80.0
879.0,17,4,438,2,148,0.0,74.0,74.0,2,290,0.0,147.0,145.0
19157.0,6,11,1132,6,556,3831.4,218.0,92.66666666666669,5,576,3826.5,304.0,115.2
938559.0,17,2,876,2,876,0.0,438.0,438.0,0,0,0.0,0.0,0.0
2051135.0,17,8,1640,4,312,683581.3333333334,78.0,78.0,4,1328,683569.3333333334,332.0,332.0
313927.0,6,6,412,4,272,104642.33333333331,74.0,68.0,2,140,0.0,74.0,70.0
144032.0,17,2,180,1,90,0.0,90.0,90.0,1,90,0.0,90.0,90.0
200939.0,17,4,6056,4,6056,66979.66666666667,1514.0,1514.0,0,0,0.0,0.0,0.0
37261.0,6,14,4740,7,653,6089.333333333333,249.0,93.28571428571428,7,4087,6076.166666666667,1514.0,583.8571428571429
120123795.0,6,13,2036,5,1020,30030948.75,204.0,204.0,8,1016,17136960.57142857,188.0,127.0
218771.0,6,3,426,2,280,0.0,214.0,140.0,1,146,0.0,146.0,146.0
120184407.0,6,615,96658,308,20698,391480.1530944625,214.0,67.2012987012987,307,75960,391964.5784313725,1514.0,247.42671009771988
153388.0,17,2,180,1,90,0.0,90.0,90.0,1,90,0.0,90.0,90.0
2383.0,17,4,344,2,150,0.0,75.0,75.0,2,194,0.0,103.0,97.0
47606492.0,6,8,1940,3,887,22373989.5,753.0,295.6666666666667,5,1053,11258765.0,785.0,210.6
15383.0,17,4,344,2,150,0.0,75.0,75.0,2,194,0.0,103.0,97.0
90682452.0,6,21,1585,10,745,10075828.0,95.0,74.5,11,840,9043367.0,95.0,76.36363636363636
148667.0,17,2,414,1,88,0.0,88.0,88.0,1,326,0.0,326.0,326.0
165855.0,17,2,180,1,90,0.0,90.0,90.0,1,90,0.0,90.0,90.0
103855.0,17,2,286,2,286,0.0,143.0,143.0,0,0,0.0,0.0,0.0
2357.0,17,4,344,2,150,0.0,75.0,75.0,2,194,0.0,103.0,97.0
350.0,17,2,248,1,84,0.0,84.0,84.0,1,164,0.0,164.0,164.0
340.0,17,2,160,1,80,0.0,80.0,80.0,1,80,0.0,80.0,80.0
123820692.0,17,14,864,7,432,17333440.333333332,174.0,61.71428571428572,7,432,17334119.666666668,174.0,61.71428571428572
107332.0,17,2,286,2,286,0.0,143.0,143.0,0,0,0.0,0.0,0.0
99042242.0,6,30,2260,16,1228,6588424.6,139.0,76.75,14,1032,7602022.384615385,123.0,73.71428571428571
214440.0,6,10,1221,6,636,42888.0,298.0,106.0,4,585,70322.0,379.0,146.25
228437.0,17,2,180,1,90,0.0,90.0,90.0,1,90,0.0,90.0,90.0
90258169.0,6,13,2036,8,1016,12894024.142857144,188.0,127.0,5,1020,22523358.0,204.0,204.0
201378.0,17,4,6056,4,6056,67126.0,1514.0,1514.0,0,0,0.0,0.0,0.0
90289950.0,6,23,1859,12,894,8206962.090909091,95.0,74.5,11,965,8998697.6,220.0,87.72727272727273
217137.0,17,2,180,1,90,0.0,90.0,90.0,1,90,0.0,90.0,90.0
1661705.0,6,4,276,2,128,0.0,74.0,64.0,2,148,0.0,74.0,74.0
2028.0,17,4,344,2,150,0.0,75.0,75.0,2,194,0.0,103.0,97.0
258872.0,6,3,337,2,214,0.0,160.0,107.0,1,123,0.0,123.0,123.0
115323801.0,6,229,25758,115,7812,1011612.2894736842,140.0,67.9304347826087,114,17946,1011505.4867256638,300.0,157.42105263157896
123839983.0,6,49,3234,25,1650,5159999.291666667,66.0,66.0,24,1584,4952257.478260869,66.0,66.0
121321.0,6,3,337,2,214,0.0,160.0,107.0,1,123,0.0,123.0,123.0
12450.0,17,4,823,2,163,0.0,89.0,81.5,2,660,0.0,443.0,330.0
108118276.0,17,5,955,5,955,27029569.0,191.0,191.0,0,0,0.0,0.0,0.0
213588.0,17,2,180,1,90,0.0,90.0,90.0,1,90,0.0,90.0,90.0
166992.0,17,4,1524,4,1524,55664.0,381.0,381.0,0,0,0.0,0.0,0.0
66078.0,6,12,1320,6,723,11661.2,253.0,120.5,6,597,12269.4,259.0,99.5
50355.0,6,10,2032,5,524,12339.25,252.0,104.8,5,1508,12297.75,1236.0,301.6
2441900.0,6,2,132,1,66,0.0,66.0,66.0,1,66,0.0,66.0,66.0
108103377.0,17,5,955,5,955,27025844.25,191.0,191.0,0,0,0.0,0.0,0.0
2971654.0,6,3,204,2,136,0.0,70.0,68.0,1,68,0.0,68.0,68.0
827.0,17,4,438,2,148,0.0,74.0,74.0,2,290,0.0,147.0,145.0
97327152.0,6,27,1938,14,1029,7470097.0,123.0,73.5,13,909,8092606.583333333,123.0,69.92307692307692
321736.0,17,4,1400,4,1400,107245.33333333331,350.0,350.0,0,0,0.0,0.0,0.0
139006070.0,17,15,907,8,475,19858010.0,174.0,59.375,7,432,19833549.5,174.0,61.71428571428572
102500.0,17,2,286,2,286,0.0,143.0,143.0,0,0,0.0,0.0,0.0
117098739.0,6,32,2104,16,1102,7792182.533333333,139.0,68.875,16,1002,7792180.666666667,123.0,62.625
57787.0,6,14,4740,7,653,9459.5,249.0,93.28571428571428,7,4087,8546.0,1514.0,583.8571428571429
90523536.0,6,14,2240,8,1016,12931933.714285716,188.0,127.0,6,1224,18072216.6,204.0,204.0
54113.0,6,14,4740,7,653,8893.833333333334,249.0,93.28571428571428,7,4087,8724.666666666666,1514.0,583.8571428571429
14946.0,17,2,180,1,90,0.0,90.0,90.0,1,90,0.0,90.0,90.0
327.0,17,2,174,1,79,0.0,79.0,79.0,1,95,0.0,95.0,95.0
146270.0,6,3,337,2,214,0.0,160.0,107.0,1,123,0.0,123.0,123.0
6985.0,17,2,582,1,83,0.0,83.0,83.0,1,499,0.0,499.0,499.0
218091.0,17,2,414,1,88,0.0,88.0,88.0,1,326,0.0,326.0,326.0
117815590.0,6,31,2160,16,1071,7854343.533333333,123.0,66.9375,15,1089,7702174.5,123.0,72.6
216215.0,17,2,180,1,90,0.0,90.0,90.0,1,90,0.0,90.0,90.0
232205.0,6,3,337,2,214,0.0,160.0,107.0,1,123,0.0,123.0,123.0
155878.0,17,2,180,1,90,0.0,90.0,90.0,1,90,0.0,90.0,90.0
9056.0,17,2,507,1,86,0.0,86.0,86.0,1,421,0.0,421.0,421.0
9893.0,17,2,582,1,83,0.0,83.0,83.0,1,499,0.0,499.0,499.0
105587692.0,6,28,1860,14,966,8105515.230769231,123.0,69.0,14,894,8105513.692307692,123.0,63.85714285714285
121380.0,6,3,337,2,214,0.0,160.0,107.0,1,123,0.0,123.0,123.0
153451.0,17,2,180,1,90,0.0,90.0,90.0,1,90,0.0,90.0,90.0
108105725.0,17,5,955,5,955,27026431.25,191.0,191.0,0,0,0.0,0.0,0.0
100961.0,17,2,286,2,286,0.0,143.0,143.0,0,0,0.0,0.0,0.0
219234.0,6,3,426,2,280,0.0,214.0,140.0,1,146,0.0,146.0,146.0
106632.0,17,2,700,2,700,0.0,350.0,350.0,0,0,0.0,0.0,0.0
155485.0,17,2,180,1,90,0.0,90.0,90.0,1,90,0.0,90.0,90.0
311149.0,6,3,204,2,136,0.0,70.0,68.0,1,68,0.0,68.0,68.0
216727.0,6,3,426,2,280,0.0,214.0,140.0,1,146,0.0,146.0,146.0
24881.0,6,10,2032,5,524,6006.0,252.0,104.8,5,1508,5759.25,1236.0,301.6
16146.0,6,14,4740,7,653,2238.6666666666665,249.0,93.28571428571428,7,4087,2554.333333333333,1514.0,583.8571428571429
90009975.0,17,28,13364,28,13364,3333702.777777778,501.0,477.2857142857143,0,0,0.0,0.0,0.0
47584.0,6,14,4740,7,653,7195.166666666667,249.0,93.28571428571428,7,4087,6496.0,1514.0,583.8571428571429
120174632.0,6,836,162294,416,28048,289577.4265060241,214.0,67.42307692307692,420,134246,286251.5727923628,1514.0,319.6333333333333
2173988.0,6,19,6869,11,1567,217398.8,408.0,142.45454545454547,8,5302,248375.8571428572,1514.0,662.75
90259514.0,6,13,2036,8,1016,12894216.285714284,188.0,127.0,5,1020,22523722.0,204.0,204.0
95855400.0,17,14,4796,13,4446,6230367.833333333,342.0,342.0,1,350,0.0,350.0,350.0
233865.0,6,3,337,2,214,0.0,160.0,107.0,1,123,0.0,123.0,123.0
204526.0,17,2,762,2,762,0.0,381.0,381.0,0,0,0.0,0.0,0.0
25865.0,6,10,2032,5,524,4648.0,252.0,104.8,5,1508,5615.0,1236.0,301.6
318779.0,17,4,1400,4,1400,106259.66666666669,350.0,350.0,0,0,0.0,0.0,0.0
90253137.0,6,12,1832,8,1016,12893305.285714284,188.0,127.0,4,816,30029759.0,204.0,204.0
35141.0,6,14,4740,7,653,5577.833333333333,249.0,93.28571428571428,7,4087,5141.0,1514.0,583.8571428571429
632272.0,6,4,508,2,238,0.0,172.0,119.0,2,270,0.0,135.0,135.0
2383.0,17,4,344,2,150,0.0,75.0,75.0,2,194,0.0,103.0,97.0
153265.0,17,4,6056,4,6056,51088.333333333336,1514.0,1514.0,0,0,0.0,0.0,0.0
165905.0,17,2,180,1,90,0.0,90.0,90.0,1,90,0.0,90.0,90.0
13539.0,6,11,1132,6,556,2528.8,218.0,92.66666666666669,5,576,2559.0,304.0,115.2
120052363.0,17,28,13364,28,13364,4446383.814814814,501.0,477.2857142857143,0,0,0.0,0.0,0.0
196923.0,17,2,180,1,90,0.0,90.0,90.0,1,90,0.0,90.0,90.0
90550.0,6,11,2098,6,590,18087.0,252.0,98.33333333333331,5,1508,21609.5,1236.0,301.6
18204815.0,6,26,7643,14,3751,198546.0769230769,1514.0,267.92857142857144,12,3892,1635341.4545454546,1514.0,324.3333333333333
217758.0,6,3,426,2,280,0.0,214.0,140.0,1,146,0.0,146.0,146.0
33358.0,6,14,4740,7,653,4581.666666666667,249.0,93.28571428571428,7,4087,5419.833333333333,1514.0,583.8571428571429
303025.0,6,6,412,4,272,101008.33333333331,74.0,68.0,2,140,0.0,74.0,70.0
1571.0,17,2,192,1,88,0.0,88.0,88.0,1,104,0.0,104.0,104.0
142105.0,6,14,4740,7,653,22498.33333333333,249.0,93.28571428571428,7,4087,22631.166666666668,1514.0,583.8571428571429
98877073.0,6,191,21582,96,15090,1040811.2947368422,284.0,157.1875,95,6492,1040855.0957446808,140.0,68.33684210526316
15104.0,17,2,180,1,90,0.0,90.0,90.0,1,90,0.0,90.0,90.0
90259180.0,6,14,2240,8,1016,12894168.57142857,188.0,127.0,6,1224,18019608.2,204.0,204.0
300.0,17,2,164,1,82,0.0,82.0,82.0,1,82,0.0,82.0,82.0
4013259.0,6,190,155970,109,146321,37159.80555555556,1510.0,1342.394495412844,81,9649,46191.7125,1510.0,119.12345679012346
135142260.0,17,6,1146,6,1146,27028452.0,191.0,191.0,0,0,0.0,0.0,0.0
90296033.0,6,17,1287,9,691,11280969.375,95.0,76.77777777777777,8,596,12760103.714285716,95.0,74.5
124312393.0,17,14,864,7,432,17500832.166666668,174.0,61.71428571428572,7,432,17500197.833333332,174.0,61.71428571428572
207079.0,6,3,426,2,280,0.0,214.0,140.0,1,146,0.0,146.0,146.0
90257391.0,6,13,2036,8,1016,12893913.0,188.0,127.0,5,1020,22523136.25,204.0,204.0
367.0,17,2,160,1,80,0.0,80.0,80.0,1,80,0.0,80.0,80.0
112319454.0,6,45,2970,23,1518,5105429.727272728,66.0,66.0,22,1452,4929267.80952381,66.0,66.0
135133827.0,17,6,1146,6,1146,27026765.4,191.0,191.0,0,0,0.0,0.0,0.0
320468.0,6,6,412,4,272,106822.66666666669,74.0,68.0,2,140,0.0,74.0,70.0
207081.0,6,3,426,2,280,0.0,214.0,140.0,1,146,0.0,146.0,146.0
354.0,17,2,267,1,83,0.0,83.0,83.0,1,184,0.0,184.0,184.0
207120.0,17,2,762,2,762,0.0,381.0,381.0,0,0,0.0,0.0,0.0
3265.0,17,4,344,2,150,0.0,75.0,75.0,2,194,0.0,103.0,97.0
99689307.0,6,29,2068,15,1105,7105233.428571428,139.0,73.66666666666667,14,963,7651789.384615385,123.0,68.78571428571429
288814.0,17,2,363,1,79,0.0,79.0,79.0,1,284,0.0,284.0,284.0
113323382.0,6,211,23914,106,16688,1079270.3047619048,284.0,157.43396226415095,105,7226,1079659.3365384615,140.0,68.81904761904762
27311190.0,17,5,1710,5,1710,6827797.5,342.0,342.0,0,0,0.0,0.0,0.0
108345.0,17,2,286,2,286,0.0,143.0,143.0,0,0,0.0,0.0,0.0
10471628.0,6,7,478,4,272,3445337.333333333,74.0,68.0,3,206,5167893.0,74.0,68.66666666666667
0.0,17,1,381,1,381,0.0,381.0,381.0,0,0,0.0,0.0,0.0
1149551.0,6,13,3011,8,2383,164221.57142857142,1514.0,297.875,5,628,219287.5,331.0,125.6
103347.0,17,2,286,2,286,0.0,143.0,143.0,0,0,0.0,0.0,0.0
103242.0,17,2,762,2,762,0.0,381.0,381.0,0,0,0.0,0.0,0.0
289914.0,17,2,414,1,88,0.0,88.0,88.0,1,326,0.0,326.0,326.0
302775.0,6,6,412,4,272,100925.0,74.0,68.0,2,140,0.0,74.0,70.0
90285746.0,6,16,1192,8,596,12891711.857142856,95.0,74.5,8,596,12896155.42857143,95.0,74.5
26987367.0,17,5,1710,5,1710,6746841.75,342.0,342.0,0,0,0.0,0.0,0.0
9702.0,17,2,582,1,83,0.0,83.0,83.0,1,499,0.0,499.0,499.0
126097.0,17,4,1400,4,1400,42032.333333333336,350.0,350.0,0,0,0.0,0.0,0.0
120034091.0,17,28,13364,28,13364,4445707.074074074,501.0,477.2857142857143,0,0,0.0,0.0,0.0
191335.0,17,2,180,1,90,0.0,90.0,90.0,1,90,0.0,90.0,90.0
108109112.0,17,5,1005,5,1005,27027278.0,201.0,201.0,0,0,0.0,0.0,0.0
90595358.0,6,14,2240,8,1016,12942194.0,188.0,127.0,6,1224,18073782.8,204.0,204.0
40647.0,6,2,132,1,66,0.0,66.0,66.0,1,66,0.0,66.0,66.0
39415.0,6,14,4740,7,653,6443.666666666667,249.0,93.28571428571428,7,4087,5955.833333333333,1514.0,583.8571428571429
48678.0,6,14,4740,7,653,7988.166666666667,249.0,93.28571428571428,7,4087,7279.666666666667,1514.0,583.8571428571429
3174239.0,6,18,1495,9,921,358158.75,315.0,102.33333333333331,9,574,358115.0,78.0,63.77777777777778
49849.0,6,2,132,1,66,0.0,66.0,66.0,1,66,0.0,66.0,66.0
3353566.0,6,161,131195,92,122339,36852.37362637363,1510.0,1329.7717391304348,69,8856,44700.42647058824,1510.0,128.34782608695653
123840101.0,6,49,3234,25,1650,5160004.208333333,66.0,66.0,24,1584,4993193.652173913,66.0,66.0
120126022.0,6,285,34664,143,9734,845957.9014084507,140.0,68.06993006993007,142,24930,848957.6808510638,284.0,175.56338028169014
25056271.0,17,3,1034,2,684,0.0,342.0,342.0,1,350,0.0,350.0,350.0
2024.0,17,4,344,2,150,0.0,75.0,75.0,2,194,0.0,103.0,97.0
135139303.0,17,6,1146,6,1146,27027860.6,191.0,191.0,0,0,0.0,0.0,0.0
2592697.0,6,25,7573,14,3735,199438.2307692308,1514.0,266.7857142857143,11,3838,234045.8,1514.0,348.90909090909093
55781.0,6,14,4740,7,653,8736.166666666666,249.0,93.28571428571428,7,4087,9113.166666666666,1514.0,583.8571428571429
44789.0,6,14,4740,7,653,7306.333333333333,249.0,93.28571428571428,7,4087,7189.333333333333,1514.0,583.8571428571429
196861.0,17,2,180,1,90,0.0,90.0,90.0,1,90,0.0,90.0,90.0
90287419.0,6,17,1287,9,691,11280418.0,95.0,76.77777777777777,8,596,12829111.285714284,95.0,74.5
4473.0,17,2,614,1,72,0.0,72.0,72.0,1,542,0.0,542.0,542.0
119730002.0,6,25,1842,13,948,9977500.166666666,95.0,72.92307692307692,12,894,10845162.363636363,95.0,74.5
764.0,17,5,550,5,550,191.0,110.0,110.0,0,0,0.0,0.0,0.0
0.0,6,1,54,1,54,0.0,54.0,54.0,0,0,0.0,0.0,0.0
135131055.0,17,6,1146,6,1146,27026211.0,191.0,191.0,0,0,0.0,0.0,0.0
4441.0,17,2,626,1,72,0.0,72.0,72.0,1,554,0.0,554.0,554.0
135129581.0,17,6,1146,6,1146,27025916.2,191.0,191.0,0,0,0.0,0.0,0.0
6765.0,17,2,582,1,83,0.0,83.0,83.0,1,499,0.0,499.0,499.0
228251.0,17,2,180,1,90,0.0,90.0,90.0,1,90,0.0,90.0,90.0
47275.0,6,14,4740,7,653,7755.333333333333,249.0,93.28571428571428,7,4087,7644.166666666667,1514.0,583.8571428571429
13985953.0,17,6,2052,6,2052,2797190.6,342.0,342.0,0,0,0.0,0.0,0.0
26614.0,6,11,2098,6,590,4385.8,252.0,98.33333333333331,5,1508,5978.5,1236.0,301.6
108101647.0,17,5,1005,5,1005,27025411.75,201.0,201.0,0,0,0.0,0.0,0.0
103198810.0,6,30,2106,15,1089,7355926.357142857,123.0,72.6,15,1017,7355926.071428572,123.0,67.8
7342.0,17,2,582,1,83,0.0,83.0,83.0,1,499,0.0,499.0,499.0
307158.0,6,6,412,4,272,102386.0,74.0,68.0,2,140,0.0,74.0,70.0
302417.0,6,2,132,1,66,0.0,66.0,66.0,1,66,0.0,66.0,66.0
107434.0,17,2,286,2,286,0.0,143.0,143.0,0,0,0.0,0.0,0.0
83.0,17,2,762,2,762,0.0,381.0,381.0,0,0,0.0,0.0,0.0
2177.0,17,4,344,2,150,0.0,75.0,75.0,2,194,0.0,103.0,97.0
146731.0,6,2,132,1,66,0.0,66.0,66.0,1,66,0.0,66.0,66.0
36362.0,6,14,4740,7,653,5867.166666666667,249.0,93.28571428571428,7,4087,5293.0,1514.0,583.8571428571429
108423477.0,6,206,23202,103,16108,1060865.5,284.0,156.38834951456312,103,7094,1060865.568627451,140.0,68.87378640776699
20780.0,6,10,1067,5,536,4506.5,264.0,107.2,5,531,4568.25,259.0,106.2
107550094.0,6,44,2904,22,1452,5121433.047619048,66.0,66.0,22,1452,5108462.476190476,66.0,66.0
241921.0,6,3,337,2,214,0.0,160.0,107.0,1,123,0.0,123.0,123.0
11733.0,6,10,2032,5,524,2692.25,252.0,104.8,5,1508,2694.5,1236.0,301.6
532716.0,6,12,2212,6,694,104888.2,233.0,115.66666666666669,6,1518,106168.2,1224.0,253.0
4847.0,17,4,344,2,150,0.0,75.0,75.0,2,194,0.0,103.0,97.0
24570.0,6,10,2032,5,524,5901.0,252.0,104.8,5,1508,5204.75,1236.0,301.6
3486528.0,6,7,923,4,753,1090002.3333333333,571.0,188.25,3,170,1635347.5,62.0,56.66666666666666
120545945.0,6,35,2548,19,1408,6696996.944444444,139.0,74.10526315789474,16,1140,7356412.4,123.0,71.25
147142.0,6,3,373,2,238,0.0,172.0,119.0,1,135,0.0,135.0,135.0
103247.0,17,2,286,2,286,0.0,143.0,143.0,0,0,0.0,0.0,0.0
16872.0,6,14,4740,7,653,2495.5,249.0,93.28571428571428,7,4087,2636.333333333333,1514.0,583.8571428571429
217976.0,6,3,426,2,280,0.0,214.0,140.0,1,146,0.0,146.0,146.0
102685.0,17,2,762,2,762,0.0,381.0,381.0,0,0,0.0,0.0,0.0
120128604.0,6,14,2240,6,1224,24025720.8,204.0,204.0,8,1016,17137771.714285713,188.0,127.0
877325.0,6,10,1333,6,796,175465.0,458.0,132.66666666666666,4,537,200548.3333333333,331.0,134.25
208358.0,6,3,426,2,280,0.0,214.0,140.0,1,146,0.0,146.0,146.0
90018880.0,17,28,13364,28,13364,3334032.592592593,501.0,477.2857142857143,0,0,0.0,0.0,0.0
317300.0,6,6,412,4,272,105766.66666666669,74.0,68.0,2,140,0.0,74.0,70.0
1314021.0,6,4,264,2,132,0.0,66.0,66.0,2,132,0.0,66.0,66.0
257301.0,17,4,1400,4,1400,85767.0,350.0,350.0,0,0,0.0,0.0,0.0
14737009.0,6,20,1648,10,1016,1604238.7777777778,315.0,101.6,10,632,1604216.111111111,78.0,63.2
19148.0,6,11,1133,6,602,2633.8,264.0,100.33333333333331,5,531,4368.25,259.0,106.2
2021791.0,17,4,525,2,150,0.0,75.0,75.0,2,375,0.0,284.0,187.5
119200283.0,6,48,3168,24,1584,5182621.0,66.0,66.0,24,1584,5173224.478260869,66.0,66.0
108322.0,17,2,286,2,286,0.0,143.0,143.0,0,0,0.0,0.0,0.0
21296.0,6,10,2032,5,524,4935.0,252.0,104.8,5,1508,4297.75,1236.0,301.6
103430.0,17,2,286,2,286,0.0,143.0,143.0,0,0,0.0,0.0,0.0
88198.0,6,14,4740,7,653,13759.833333333334,249.0,93.28571428571428,7,4087,14315.333333333334,1514.0,583.8571428571429
90073672.0,17,28,13364,28,13364,3336061.925925926,501.0,477.2857142857143,0,0,0.0,0.0,0.0
3344514.0,6,3,204,2,136,0.0,70.0,68.0,1,68,0.0,68.0,68.0
216479.0,17,2,180,1,90,0.0,90.0,90.0,1,90,0.0,90.0,90.0
120257261.0,6,196,22204,98,6764,1231134.0515463918,140.0,69.0204081632653,98,15440,1231260.731958763,284.0,157.55102040816325
114357431.0,6,29,1914,15,948,8168387.928571428,123.0,63.2,14,966,8012042.0,123.0,69.0
14076616.0,17,6,2052,6,2052,2815323.2,342.0,342.0,0,0,0.0,0.0,0.0
64720.0,6,14,4740,7,653,8204.0,249.0,93.28571428571428,7,4087,9692.0,1514.0,583.8571428571429
108108014.0,17,5,955,5,955,27027003.5,191.0,191.0,0,0,0.0,0.0,0.0
120124484.0,6,13,2020,9,1204,15015560.5,188.0,133.77777777777777,4,816,30003960.666666668,204.0,204.0
44183.0,6,10,2032,5,524,10766.0,252.0,104.8,5,1508,10336.5,1236.0,301.6
4651.0,17,2,614,1,72,0.0,72.0,72.0,1,542,0.0,542.0,542.0
153520.0,17,2,180,1,90,0.0,90.0,90.0,1,90,0.0,90.0,90.0
2083669.0,6,4,492,2,280,0.0,214.0,140.0,2,212,0.0,146.0,106.0
156159.0,6,11,1132,6,556,31231.8,218.0,92.66666666666669,5,576,38574.25,304.0,115.2
1298515.0,6,4,264,2,132,0.0,66.0,66.0,2,132,0.0,66.0,66.0
2574079.0,6,53,23956,28,19959,95336.25925925926,1514.0,712.8214285714286,25,3997,98224.66666666669,1514.0,159.88
159848.0,6,10,2032,5,524,33326.25,252.0,104.8,5,1508,20060.5,1236.0,301.6
306969.0,6,6,412,4,272,102323.0,74.0,68.0,2,140,0.0,74.0,70.0
46275.0,6,14,4740,7,653,7293.666666666667,249.0,93.28571428571428,7,4087,5440.5,1514.0,583.8571428571429
149714.0,17,2,180,1,90,0.0,90.0,90.0,1,90,0.0,90.0,90.0
47786.0,6,10,2032,5,524,10776.75,252.0,104.8,5,1508,11553.0,1236.0,301.6
2799758.0,6,2,132,1,66,0.0,66.0,66.0,1,66,0.0,66.0,66.0
3005409.0,6,11,2106,6,598,600875.4,252.0,99.66666666666669,5,1508,1673.25,1236.0,301.6
102967.0,17,2,286,2,286,0.0,143.0,143.0,0,0,0.0,0.0,0.0
120078213.0,17,28,13364,28,13364,4447341.222222222,501.0,477.2857142857143,0,0,0.0,0.0,0.0
197621.0,17,2,180,1,90,0.0,90.0,90.0,1,90,0.0,90.0,90.0
4913.0,17,4,704,2,148,0.0,74.0,74.0,2,556,0.0,280.0,278.0
119774322.0,17,13,821,7,432,19962387.0,174.0,61.71428571428572,6,389,20092767.0,174.0,64.83333333333333
196914.0,17,2,180,1,90,0.0,90.0,90.0,1,90,0.0,90.0,90.0
90032330.0,17,28,13364,28,13364,3334530.7407407407,501.0,477.2857142857143,0,0,0.0,0.0,0.0
298266.0,6,6,412,4,272,99422.0,74.0,68.0,2,140,0.0,74.0,70.0
204889.0,17,2,180,1,90,0.0,90.0,90.0,1,90,0.0,90.0,90.0
844620.0,6,9,1196,6,725,168924.0,387.0,120.83333333333331,3,471,285955.5,331.0,157.0
21447.0,6,10,2032,5,524,5145.5,252.0,104.8,5,1508,5074.0,1236.0,301.6
66547134.0,6,9,1479,9,1479,8318391.75,172.0,164.33333333333334,0,0,0.0,0.0,0.0
153451.0,17,2,180,1,90,0.0,90.0,90.0,1,90,0.0,90.0,90.0
135125479.0,17,6,1146,6,1146,27025095.8,191.0,191.0,0,0,0.0,0.0,0.0
323840.0,17,4,1400,4,1400,107946.66666666669,350.0,350.0,0,0,0.0,0.0,0.0
216806.0,6,10,1221,6,636,43361.2,298.0,106.0,4,585,71039.0,379.0,146.25
246194.0,6,3,337,2,214,0.0,160.0,107.0,1,123,0.0,123.0,123.0
10478105.0,6,7,478,4,272,3446973.0,74.0,68.0,3,206,5170344.0,74.0,68.66666666666667
120120284.0,6,12,1832,8,1016,17136882.57142857,188.0,127.0,4,816,30031246.33333333,204.0,204.0
108105043.0,17,5,955,5,955,27026260.75,191.0,191.0,0,0,0.0,0.0,0.0
139708.0,6,13,1479,7,882,23284.666666666668,291.0,126.0,6,597,23038.6,259.0,99.5
147891.0,17,2,180,1,90,0.0,90.0,90.0,1,90,0.0,90.0,90.0
2031.0,17,4,344,2,150,0.0,75.0,75.0,2,194,0.0,103.0,97.0
231948.0,6,10,1221,6,636,46389.6,298.0,106.0,4,585,75895.33333333333,379.0,146.25
1479.0,17,5,550,5,550,369.75,110.0,110.0,0,0,0.0,0.0,0.0
2599556.0,6,2,132,1,66,0.0,66.0,66.0,1,66,0.0,66.0,66.0
215938.0,6,3,426,2,280,0.0,214.0,140.0,1,146,0.0,146.0,146.0
4445.0,17,2,582,1,83,0.0,83.0,83.0,1,499,0.0,499.0,499.0
90526291.0,6,14,2240,8,1016,12932327.285714284,188.0,127.0,6,1224,18071826.4,204.0,204.0
153450.0,17,2,180,1,90,0.0,90.0,90.0,1,90,0.0,90.0,90.0
126001358.0,17,15,907,8,475,18000194.0,174.0,59.375,7,432,17668075.0,174.0,61.71428571428572
149293916.0,6,22,1680,10,745,13286295.777777778,95.0,74.5,12,935,13553501.272727272,95.0,77.91666666666667
44552.0,6,14,4740,7,653,7246.666666666667,249.0,93.28571428571428,7,4087,6356.333333333333,1514.0,583.8571428571429
237950.0,6,3,426,2,280,0.0,214.0,140.0,1,146,0.0,146.0,146.0
90018249.0,17,28,13364,28,13364,3334009.222222222,501.0,477.2857142857143,0,0,0.0,0.0,0.0
1780614.0,6,23,6507,12,1529,161789.0,357.0,127.41666666666669,11,4978,147941.1,1510.0,452.54545454545456
3337.0,17,4,625,2,163,0.0,89.0,81.5,2,462,0.0,245.0,231.0
135116180.0,17,6,1206,6,1206,27023236.0,201.0,201.0,0,0,0.0,0.0,0.0
108110091.0,17,5,955,5,955,27027522.75,191.0,191.0,0,0,0.0,0.0,0.0
120239505.0,6,246,28734,123,8340,979862.631147541,140.0,67.8048780487805,123,20394,978812.8770491804,300.0,165.8048780487805
543.0,17,2,508,2,508,0.0,257.0,254.0,0,0,0.0,0.0,0.0
1177824.0,6,13,3006,8,2378,168260.57142857142,1514.0,297.25,5,628,225540.75,331.0,125.6
101597.0,17,2,762,2,762,0.0,381.0,381.0,0,0,0.0,0.0,0.0
403903.0,17,6,2100,6,2100,80780.6,350.0,350.0,0,0,0.0,0.0,0.0
305263.0,6,6,412,4,272,101754.33333333331,74.0,68.0,2,140,0.0,74.0,70.0
46431.0,6,14,4740,7,653,7616.0,249.0,93.28571428571428,7,4087,6891.5,1514.0,583.8571428571429
12100041.0,6,35,9014,18,4742,711767.1176470588,1514.0,263.44444444444446,17,4272,564184.375,1514.0,251.2941176470588
90316113.0,6,16,1192,8,596,12893516.57142857,95.0,74.5,8,596,12900079.142857144,95.0,74.5
146090.0,6,3,337,2,214,0.0,160.0,107.0,1,123,0.0,123.0,123.0
121236.0,6,3,337,2,214,0.0,160.0,107.0,1,123,0.0,123.0,123.0
108105123.0,17,5,1005,5,1005,27026280.75,201.0,201.0,0,0,0.0,0.0,0.0
262481.0,6,10,1221,6,636,52496.2,298.0,106.0,4,585,81499.66666666667,379.0,146.25
81.0,17,2,762,2,762,0.0,381.0,381.0,0,0,0.0,0.0,0.0
2324.0,17,4,344,2,150,0.0,75.0,75.0,2,194,0.0,103.0,97.0
827.0,17,4,438,2,148,0.0,74.0,74.0,2,290,0.0,147.0,145.0
119996879.0,6,24,1829,11,840,9135117.6,95.0,76.36363636363636,13,989,9979338.25,95.0,76.07692307692308
217713.0,6,3,426,2,280,0.0,214.0,140.0,1,146,0.0,146.0,146.0
238943.0,6,3,337,2,214,0.0,160.0,107.0,1,123,0.0,123.0,123.0
232889.0,6,3,337,2,214,0.0,160.0,107.0,1,123,0.0,123.0,123.0
2414.0,17,4,344,2,150,0.0,75.0,75.0,2,194,0.0,103.0,97.0
196980.0,17,2,180,1,90,0.0,90.0,90.0,1,90,0.0,90.0,90.0
10458291.0,6,7,478,4,272,3440429.333333333,74.0,68.0,3,206,5160568.0,74.0,68.66666666666667
38620.0,6,12,1320,7,789,6436.666666666667,253.0,112.71428571428572,5,531,5992.5,259.0,106.2
2340.0,17,4,344,2,150,0.0,75.0,75.0,2,194,0.0,103.0,97.0
146162.0,6,4,439,2,238,0.0,172.0,119.0,2,201,0.0,135.0,100.5
98289155.0,6,29,2062,15,1017,7020620.714285715,123.0,67.8,14,1045,7184956.076923077,139.0,74.64285714285714
319044.0,17,4,1400,4,1400,106348.0,350.0,350.0,0,0,0.0,0.0,0.0
233610.0,6,3,337,2,214,0.0,160.0,107.0,1,123,0.0,123.0,123.0
517.0,17,2,762,2,762,0.0,381.0,381.0,0,0,0.0,0.0,0.0
42065.0,6,14,4740,7,653,6218.833333333333,249.0,93.28571428571428,7,4087,6220.0,1514.0,583.8571428571429
15155669.0,17,6,2718,6,2718,3031133.8,453.0,453.0,0,0,0.0,0.0,0.0
209471.0,17,2,180,1,90,0.0,90.0,90.0,1,90,0.0,90.0,90.0
16434.0,6,10,2032,5,524,3688.75,252.0,104.8,5,1508,3594.5,1236.0,301.6
312111.0,6,3,202,2,128,0.0,74.0,64.0,1,74,0.0,74.0,74.0
135138844.0,17,6,1206,6,1206,27027768.8,201.0,201.0,0,0,0.0,0.0,0.0
241721.0,6,3,337,2,214,0.0,160.0,107.0,1,123,0.0,123.0,123.0
39062.0,6,10,2032,5,524,9566.5,252.0,104.8,5,1508,9189.0,1236.0,301.6
313.0,17,2,174,1,79,0.0,79.0,79.0,1,95,0.0,95.0,95.0
311572.0,17,4,1400,4,1400,103857.33333333331,350.0,350.0,0,0,0.0,0.0,0.0
117009697.0,6,48,3168,24,1584,5087378.130434782,66.0,66.0,24,1584,5075394.217391305,66.0,66.0
218381.0,6,4,492,2,280,0.0,214.0,140.0,2,212,0.0,146.0,106.0
3250939.0,17,3,1026,3,1026,1625469.5,342.0,342.0,0,0,0.0,0.0,0.0
131315.0,6,3,337,2,214,0.0,160.0,107.0,1,123,0.0,123.0,123.0
120358824.0,6,225,25532,113,17844,1074632.357142857,300.0,157.91150442477877,112,7688,1075982.81981982,140.0,68.64285714285714
145533.0,6,2,132,1,66,0.0,66.0,66.0,1,66,0.0,66.0,66.0
10928531.0,6,8,544,4,272,3597390.6666666665,74.0,68.0,4,272,3597309.333333333,74.0,68.0
1187808.0,6,13,3020,8,2392,169686.85714285713,1514.0,299.0,5,628,228052.5,331.0,125.6
112623392.0,6,31,2166,16,1149,7493830.8,123.0,71.8125,15,1017,8029104.142857143,123.0,67.8
135144510.0,17,6,1146,6,1146,27028902.0,191.0,191.0,0,0,0.0,0.0,0.0
31601.0,6,11,2098,6,590,5832.2,252.0,98.33333333333331,5,1508,7645.75,1236.0,301.6
94676167.0,6,26,1762,13,922,7871707.5,139.0,70.92307692307692,13,840,7871711.25,123.0,64.61538461538461
108105044.0,17,5,1005,5,1005,27026261.0,201.0,201.0,0,0,0.0,0.0,0.0
322046.0,17,4,1400,4,1400,107348.66666666669,350.0,350.0,0,0,0.0,0.0,0.0
153401.0,17,2,180,1,90,0.0,90.0,90.0,1,90,0.0,90.0,90.0
108111850.0,17,5,1005,5,1005,27027962.5,201.0,201.0,0,0,0.0,0.0,0.0
36746.0,6,14,4740,7,653,5912.666666666667,249.0,93.28571428571428,7,4087,5895.333333333333,1514.0,583.8571428571429
94328383.0,17,14,1126,7,563,15667847.0,174.0,80.42857142857143,7,563,15666811.666666666,174.0,80.42857142857143
1157062.0,6,13,3000,8,2372,165294.57142857142,1514.0,296.5,5,628,221094.5,331.0,125.6
324.0,17,2,166,1,75,0.0,75.0,75.0,1,91,0.0,91.0,91.0
120281705.0,6,18,1382,9,691,14999994.25,95.0,76.77777777777777,9,691,15034737.5,95.0,76.77777777777777
29318.0,6,13,1479,7,882,4766.666666666667,291.0,126.0,6,597,5271.6,259.0,99.5
38774.0,6,14,4740,7,653,5921.666666666667,249.0,93.28571428571428,7,4087,5040.833333333333,1514.0,583.8571428571429
90048027.0,17,28,13364,28,13364,3335112.111111111,501.0,477.2857142857143,0,0,0.0,0.0,0.0
608.0,17,2,508,2,508,0.0,257.0,254.0,0,0,0.0,0.0,0.0
316335.0,6,12,1354,6,723,61733.2,253.0,120.5,6,631,62415.8,293.0,105.16666666666669
113057718.0,6,29,1936,15,1042,8075551.285714285,139.0,69.46666666666667,14,894,7912073.846153846,123.0,63.85714285714285
1156927.0,6,13,3010,8,2382,165275.2857142857,1514.0,297.75,5,628,221080.5,331.0,125.6
48211.0,6,12,1413,6,816,8443.8,291.0,136.0,6,597,8582.6,259.0,99.5
90347208.0,6,14,2240,8,1016,12906744.0,188.0,127.0,6,1224,18024849.6,204.0,204.0
66107.0,6,14,4740,7,653,10894.333333333334,249.0,93.28571428571428,7,4087,10865.0,1514.0,583.8571428571429
108105164.0,17,5,955,5,955,27026291.0,191.0,191.0,0,0,0.0,0.0,0.0
298279.0,6,6,412,4,272,99426.33333333331,74.0,68.0,2,140,0.0,74.0,70.0
149979437.0,17,36,17126,36,17126,4285126.771428571,501.0,475.72222222222223,0,0,0.0,0.0,0.0
108111211.0,17,5,955,5,955,27027802.75,191.0,191.0,0,0,0.0,0.0,0.0
146260.0,6,3,337,2,214,0.0,160.0,107.0,1,123,0.0,123.0,123.0
108098500.0,17,5,955,5,955,27024625.0,191.0,191.0,0,0,0.0,0.0,0.0
3252943.0,6,18,1495,9,921,368065.375,315.0,102.33333333333331,9,574,368189.375,78.0,63.77777777777778
1040.0,17,2,508,2,508,0.0,257.0,254.0,0,0,0.0,0.0,0.0
76934640.0,17,14,4788,14,4788,5918049.230769231,342.0,342.0,0,0,0.0,0.0,0.0
0.0,17,1,72,1,72,0.0,72.0,72.0,0,0,0.0,0.0,0.0
90180395.0,17,14,1126,7,563,15030065.833333334,174.0,80.42857142857143,7,563,14904175.0,174.0,80.42857142857143
49017.0,6,14,4740,7,653,7583.0,249.0,93.28571428571428,7,4087,7938.333333333333,1514.0,583.8571428571429
10873244.0,6,8,544,4,272,3578806.0,74.0,68.0,4,272,3578728.0,74.0,68.0
33895.0,6,14,4740,7,653,5322.0,249.0,93.28571428571428,7,4087,5447.666666666667,1514.0,583.8571428571429
5630626.0,6,5,336,2,134,0.0,68.0,67.0,3,202,1521260.0,70.0,67.33333333333333
36446.0,6,14,4740,7,653,5483.666666666667,249.0,93.28571428571428,7,4087,5352.0,1514.0,583.8571428571429
319.0,17,2,174,1,79,0.0,79.0,79.0,1,95,0.0,95.0,95.0
364096.0,6,11,1021,6,444,49148.6,162.0,74.0,5,577,61041.5,349.0,115.4
204491.0,17,2,762,2,762,0.0,381.0,381.0,0,0,0.0,0.0,0.0
77343.0,6,14,4740,7,653,12744.333333333334,249.0,93.28571428571428,7,4087,12009.833333333334,1514.0,583.8571428571429
90289350.0,6,16,1192,8,596,12892187.714285716,95.0,74.5,8,596,12897192.0,95.0,74.5
103205066.0,6,222,25116,111,17568,936259.1272727272,300.0,158.27027027027026,111,7548,936259.9363636364,140.0,68.0
207162.0,17,2,762,2,762,0.0,381.0,381.0,0,0,0.0,0.0,0.0
1519.0,17,2,762,2,762,0.0,381.0,381.0,0,0,0.0,0.0,0.0
302630.0,6,6,412,4,272,100876.66666666669,74.0,68.0,2,140,0.0,74.0,70.0
111017104.0,6,31,2182,16,1165,7386752.0,139.0,72.8125,15,1017,7914371.5,123.0,67.8
116151.0,17,4,1400,4,1400,38717.0,350.0,350.0,0,0,0.0,0.0,0.0
300500.0,6,6,412,4,272,100166.66666666669,74.0,68.0,2,140,0.0,74.0,70.0
108111060.0,17,5,955,5,955,27027765.0,191.0,191.0,0,0,0.0,0.0,0.0
146120.0,6,3,337,2,214,0.0,160.0,107.0,1,123,0.0,123.0,123.0
16488.0,17,4,823,2,163,0.0,89.0,81.5,2,660,0.0,443.0,330.0
340.0,17,2,166,1,75,0.0,75.0,75.0,1,91,0.0,91.0,91.0
82882688.0,17,14,4796,13,4446,6236854.666666667,342.0,342.0,1,350,0.0,350.0,350.0
147975.0,17,2,180,1,90,0.0,90.0,90.0,1,90,0.0,90.0,90.0
146207.0,6,3,337,2,214,0.0,160.0,107.0,1,123,0.0,123.0,123.0
1969.0,17,4,344,2,150,0.0,75.0,75.0,2,194,0.0,103.0,97.0
13615807.0,6,19,1594,9,962,1663692.375,315.0,106.88888888888889,10,632,1478812.111111111,78.0,63.2
63866.00000000001,6,14,4740,7,653,10112.333333333334,249.0,93.28571428571428,7,4087,10184.333333333334,1514.0,583.8571428571429
90043692.0,17,27,12943,27,12943,3463218.923076923,501.0,479.3703703703704,0,0,0.0,0.0,0.0
90023728.0,17,28,13364,28,13364,3334212.1481481483,501.0,477.2857142857143,0,0,0.0,0.0,0.0
135136809.0,17,6,1206,6,1206,27027361.8,201.0,201.0,0,0,0.0,0.0,0.0
108098114.0,17,5,1005,5,1005,27024528.5,201.0,201.0,0,0,0.0,0.0,0.0
143791.0,6,2,132,1,66,0.0,66.0,66.0,1,66,0.0,66.0,66.0
120204404.0,6,366,42350,183,30050,659332.3846153846,464.0,164.20765027322403,183,12300,659333.532967033,140.0,67.21311475409836
121176.0,6,3,337,2,214,0.0,160.0,107.0,1,123,0.0,123.0,123.0
106822.0,17,2,286,2,286,0.0,143.0,143.0,0,0,0.0,0.0,0.0
90293450.0,6,19,1436,10,745,10027224.444444444,95.0,74.5,9,691,11284961.625,95.0,76.77777777777777
303150.0,6,2,132,1,66,0.0,66.0,66.0,1,66,0.0,66.0,66.0
2595212.0,6,2,132,1,66,0.0,66.0,66.0,1,66,0.0,66.0,66.0
249651.0,6,3,337,2,214,0.0,160.0,107.0,1,123,0.0,123.0,123.0
38951.0,6,10,2032,5,524,8885.5,252.0,104.8,5,1508,8640.0,1236.0,301.6
108114442.0,17,5,1005,5,1005,27028610.5,201.0,201.0,0,0,0.0,0.0,0.0
309501.0,17,4,1400,4,1400,103167.0,350.0,350.0,0,0,0.0,0.0,0.0
252959.0,6,3,337,2,214,0.0,160.0,107.0,1,123,0.0,123.0,123.0
90005628.0,17,28,13364,28,13364,3333541.777777778,501.0,477.2857142857143,0,0,0.0,0.0,0.0
135132221.0,17,6,1146,6,1146,27026444.2,191.0,191.0,0,0,0.0,0.0,0.0
620561.0,6,4,508,2,238,0.0,172.0,119.0,2,270,0.0,135.0,135.0
90074029.0,17,28,13364,28,13364,3336075.1481481483,501.0,477.2857142857143,0,0,0.0,0.0,0.0
108108042.0,17,5,1005,5,1005,27027010.5,201.0,201.0,0,0,0.0,0.0,0.0
5601130.0,6,5,336,2,134,0.0,68.0,67.0,3,202,1526052.0,70.0,67.33333333333333
280048.0,17,2,180,1,90,0.0,90.0,90.0,1,90,0.0,90.0,90.0
6426.0,17,4,823,2,163,0.0,89.0,81.5,2,660,0.0,443.0,330.0
2325.0,17,4,344,2,150,0.0,75.0,75.0,2,194,0.0,103.0,97.0
37795.0,6,12,1320,6,723,7009.6,253.0,120.5,6,597,6663.0,259.0,99.5
2428038.0,6,3,1604,1,753,0.0,753.0,753.0,2,851,0.0,785.0,425.5
56354.0,6,10,2032,5,524,12123.75,252.0,104.8,5,1508,11991.75,1236.0,301.6
325.0,17,2,174,1,79,0.0,79.0,79.0,1,95,0.0,95.0,95.0
211273.0,17,2,180,1,90,0.0,90.0,90.0,1,90,0.0,90.0,90.0
107425049.0,6,286,33374,143,9660,756497.0845070423,140.0,67.55244755244755,143,23714,756447.5070422535,390.0,165.83216783216784
21298.0,6,10,2032,5,524,4185.75,252.0,104.8,5,1508,4599.0,1236.0,301.6
120153500.0,6,224,25312,112,7688,1075062.2882882883,140.0,68.64285714285714,112,17624,1074926.4144144144,284.0,157.35714285714286
90309423.0,6,16,2140,8,1080,12901346.142857144,204.0,135.0,8,1060,12872902.142857144,199.0,132.5
45782.0,6,14,4740,7,653,7504.833333333333,249.0,93.28571428571428,7,4087,6619.0,1514.0,583.8571428571429
219411.0,6,4,492,2,280,0.0,214.0,140.0,2,212,0.0,146.0,106.0
243036.0,6,3,337,2,214,0.0,160.0,107.0,1,123,0.0,123.0,123.0
21611.0,6,14,4740,7,653,3441.333333333333,249.0,93.28571428571428,7,4087,3417.0,1514.0,583.8571428571429
0.0,17,1,80,1,80,0.0,80.0,80.0,0,0,0.0,0.0,0.0
46787426.0,6,8,1940,3,887,22244238.5,753.0,295.6666666666667,5,1053,11002067.5,785.0,210.6
102959145.0,6,206,23186,103,16092,1009403.3823529412,284.0,156.23300970873785,103,7094,1007232.6274509804,140.0,68.87378640776699
108110731.0,17,5,955,5,955,27027682.75,191.0,191.0,0,0,0.0,0.0,0.0
303220.0,6,2,132,1,66,0.0,66.0,66.0,1,66,0.0,66.0,66.0
92456108.0,17,16,5472,16,5472,6163740.533333333,342.0,342.0,0,0,0.0,0.0,0.0
294.0,17,2,164,1,82,0.0,82.0,82.0,1,82,0.0,82.0,82.0
118941581.0,6,228,25846,114,7820,1052580.3628318585,140.0,68.59649122807018,114,18026,1050724.7787610618,284.0,158.12280701754386
107121200.0,17,14,864,7,432,17834340.833333332,174.0,61.71428571428572,7,432,17833511.5,174.0,61.71428571428572
233071.0,6,3,337,2,214,0.0,160.0,107.0,1,123,0.0,123.0,123.0
119397730.0,6,219,24712,110,7556,1095392.0183486238,140.0,68.69090909090909,109,17156,1095939.7777777778,284.0,157.39449541284404
118529601.0,6,30,1974,15,1026,8450984.57142857,123.0,68.4,15,948,8450974.714285715,123.0,63.2
6982.0,17,2,582,1,83,0.0,83.0,83.0,1,499,0.0,499.0,499.0
35587.0,6,14,4740,7,653,5504.666666666667,249.0,93.28571428571428,7,4087,5104.833333333333,1514.0,583.8571428571429
99483.0,17,2,762,2,762,0.0,381.0,381.0,0,0,0.0,0.0,0.0
17243.0,17,2,582,1,83,0.0,83.0,83.0,1,499,0.0,499.0,499.0
823.0,17,4,438,2,148,0.0,74.0,74.0,2,290,0.0,147.0,145.0
10477779.0,6,7,478,4,272,3446748.0,74.0,68.0,3,206,5170011.5,74.0,68.66666666666667
5626929.0,6,4,270,2,134,0.0,68.0,67.0,2,136,0.0,70.0,68.0
90527778.0,6,13,2036,8,1016,12932539.714285716,188.0,127.0,5,1020,22591096.75,204.0,204.0
108110535.0,17,5,1005,5,1005,27027633.75,201.0,201.0,0,0,0.0,0.0,0.0
3776826.0,6,5,336,2,134,0.0,68.0,67.0,3,202,1523770.0,70.0,67.33333333333333
316072.0,6,6,412,4,272,105357.33333333331,74.0,68.0,2,140,0.0,74.0,70.0
1568057.0,6,2,132,1,66,0.0,66.0,66.0,1,66,0.0,66.0,66.0
291.0,17,2,168,1,76,0.0,76.0,76.0,1,92,0.0,92.0,92.0
110230.0,17,2,286,2,286,0.0,143.0,143.0,0,0,0.0,0.0,0.0
2596937.0,6,2,132,1,66,0.0,66.0,66.0,1,66,0.0,66.0,66.0
6348.0,17,4,823,2,163,0.0,89.0,81.5,2,660,0.0,443.0,330.0
103881993.0,6,44,2904,22,1452,4946761.571428572,66.0,66.0,22,1452,4936469.380952381,66.0,66.0
107872396.0,6,43,2838,22,1452,5123825.666666667,66.0,66.0,21,1386,5135444.85,66.0,66.0
1028285.0,6,11,1134,6,558,205657.00000000003,220.0,93.0,5,576,255840.25,304.0,115.2
128277552.0,6,36,2602,19,1408,7126530.666666667,139.0,74.10526315789474,17,1194,7379771.9375,123.0,70.23529411764706
130513.0,6,3,337,2,214,0.0,160.0,107.0,1,123,0.0,123.0,123.0
90045994.0,17,28,13364,28,13364,3335036.814814815,501.0,477.2857142857143,0,0,0.0,0.0,0.0
26568.0,6,14,4740,7,653,3670.6666666666665,249.0,93.28571428571428,7,4087,4288.833333333333,1514.0,583.8571428571429
0.0,17,1,55,1,55,0.0,55.0,55.0,0,0,0.0,0.0,0.0
232449.0,6,3,337,2,214,0.0,160.0,107.0,1,123,0.0,123.0,123.0
221811.0,6,3,426,2,280,0.0,214.0,140.0,1,146,0.0,146.0,146.0
42776.0,6,13,1386,7,789,6939.833333333333,253.0,112.71428571428572,6,597,7556.8,259.0,99.5
36558.0,17,2,582,1,83,0.0,83.0,83.0,1,499,0.0,499.0,499.0
5004279.0,17,4,849,2,166,0.0,83.0,83.0,2,683,0.0,499.0,341.5
498772.0,6,4,270,2,134,0.0,68.0,67.0,2,136,0.0,70.0,68.0
241984.0,6,3,337,2,214,0.0,160.0,107.0,1,123,0.0,123.0,123.0
318333.0,17,4,1400,4,1400,106111.0,350.0,350.0,0,0,0.0,0.0,0.0
107078.0,17,2,286,2,286,0.0,143.0,143.0,0,0,0.0,0.0,0.0
2353.0,17,4,344,2,150,0.0,75.0,75.0,2,194,0.0,103.0,97.0
99921345.0,6,417,55462,209,41512,480391.0817307693,480.0,198.622009569378,208,13950,477694.1690821256,140.0,67.0673076923077
232935.0,6,3,337,2,214,0.0,160.0,107.0,1,123,0.0,123.0,123.0
29370.0,6,10,2032,5,524,7111.5,252.0,104.8,5,1508,7068.5,1236.0,301.6
40766.0,6,10,2032,5,524,7093.75,252.0,104.8,5,1508,9907.75,1236.0,301.6
90295436.0,6,19,1436,10,745,10027119.666666666,95.0,74.5,9,691,11286689.625,95.0,76.77777777777777
90365282.0,6,11,1644,7,828,15060880.333333334,188.0,118.28571428571428,4,816,20112297.33333333,204.0,204.0
110981534.0,6,31,2182,16,1165,7385139.266666667,139.0,72.8125,15,1017,7912650.5,123.0,67.8
33928.0,6,14,4740,7,653,5139.5,249.0,93.28571428571428,7,4087,5181.833333333333,1514.0,583.8571428571429
4350.0,17,4,344,2,150,0.0,75.0,75.0,2,194,0.0,103.0,97.0
310.0,17,2,164,1,82,0.0,82.0,82.0,1,82,0.0,82.0,82.0
90258939.0,6,13,1898,8,1016,12894134.142857144,188.0,127.0,5,882,22524214.0,204.0,176.4
71299.0,6,14,4740,7,653,10986.0,249.0,93.28571428571428,7,4087,11010.166666666666,1514.0,583.8571428571429
103757.0,17,2,286,2,286,0.0,143.0,143.0,0,0,0.0,0.0,0.0
49780.0,6,14,4740,7,653,8033.666666666667,249.0,93.28571428571428,7,4087,7207.833333333333,1514.0,583.8571428571429
311525.0,17,4,622,4,622,103841.66666666669,163.0,155.5,0,0,0.0,0.0,0.0
209548.0,17,2,180,1,90,0.0,90.0,90.0,1,90,0.0,90.0,90.0
44807.0,6,14,4740,7,653,7304.666666666667,249.0,93.28571428571428,7,4087,6740.5,1514.0,583.8571428571429
68813.0,6,14,4740,7,653,11309.333333333334,249.0,93.28571428571428,7,4087,8979.166666666666,1514.0,583.8571428571429
45611.0,6,14,4740,7,653,6938.0,249.0,93.28571428571428,7,4087,7046.666666666667,1514.0,583.8571428571429
135137558.0,17,6,1146,6,1146,27027511.6,191.0,191.0,0,0,0.0,0.0,0.0
90091160.0,6,10,1440,7,828,15015193.333333334,188.0,118.28571428571428,3,612,30029798.0,204.0,204.0
10537220.0,6,7,478,4,272,3465226.6666666665,74.0,68.0,3,206,5197705.0,74.0,68.66666666666667
12836.0,6,12,1393,6,796,2417.0,271.0,132.66666666666666,6,597,2410.2,259.0,99.5
322176.0,6,6,412,4,272,107392.0,74.0,68.0,2,140,0.0,74.0,70.0
206431.0,17,2,180,1,90,0.0,90.0,90.0,1,90,0.0,90.0,90.0
2340.0,17,4,344,2,150,0.0,75.0,75.0,2,194,0.0,103.0,97.0
4370.0,17,2,614,1,72,0.0,72.0,72.0,1,542,0.0,542.0,542.0
216612.0,6,3,426,2,280,0.0,214.0,140.0,1,146,0.0,146.0,146.0
42963.0,6,14,4740,7,653,4819.166666666667,249.0,93.28571428571428,7,4087,6573.666666666667,1514.0,583.8571428571429
434.0,17,2,166,1,75,0.0,75.0,75.0,1,91,0.0,91.0,91.0
114417335.0,6,47,3102,24,1584,4974649.913043479,66.0,66.0,23,1518,5160014.5,66.0,66.0
216339.0,17,2,180,1,90,0.0,90.0,90.0,1,90,0.0,90.0,90.0
934.0,17,4,438,2,148,0.0,74.0,74.0,2,290,0.0,147.0,145.0
53420.0,6,14,4740,7,653,8272.333333333334,249.0,93.28571428571428,7,4087,8239.666666666666,1514.0,583.8571428571429
112656244.0,6,31,2097,16,1071,7510416.266666667,123.0,66.9375,15,1026,8031350.285714285,123.0,68.4
171706.0,17,2,180,1,90,0.0,90.0,90.0,1,90,0.0,90.0,90.0
90264754.0,6,13,2036,8,1016,12894964.857142856,188.0,127.0,5,1020,22519306.0,204.0,204.0
146075.0,6,3,337,2,214,0.0,160.0,107.0,1,123,0.0,123.0,123.0
213673.0,17,2,180,1,90,0.0,90.0,90.0,1,90,0.0,90.0,90.0
297490.0,6,6,412,4,272,99163.33333333331,74.0,68.0,2,140,0.0,74.0,70.0
146191.0,6,3,337,2,214,0.0,160.0,107.0,1,123,0.0,123.0,123.0
650.0,17,2,762,2,762,0.0,381.0,381.0,0,0,0.0,0.0,0.0
9388.0,17,2,539,1,86,0.0,86.0,86.0,1,453,0.0,453.0,453.0
19054.0,17,2,582,1,83,0.0,83.0,83.0,1,499,0.0,499.0,499.0
53314.0,6,14,4740,7,653,8627.5,249.0,93.28571428571428,7,4087,8369.833333333334,1514.0,583.8571428571429
21719.0,17,2,582,1,83,0.0,83.0,83.0,1,499,0.0,499.0,499.0
46340.0,6,10,2032,5,524,10948.75,252.0,104.8,5,1508,10233.25,1236.0,301.6
66123.0,17,4,344,2,150,0.0,75.0,75.0,2,194,0.0,103.0,97.0
15020300.0,17,6,2718,6,2718,3004060.0,453.0,453.0,0,0,0.0,0.0,0.0
169366.0,17,2,414,1,88,0.0,88.0,88.0,1,326,0.0,326.0,326.0
108105314.0,17,5,1005,5,1005,27026328.5,201.0,201.0,0,0,0.0,0.0,0.0
92846636.0,6,26,1746,13,906,7720182.5,123.0,69.6923076923077,13,840,7720027.916666667,123.0,64.61538461538461
97028185.0,6,31,2298,16,1212,6468545.666666667,123.0,75.75,15,1086,6915137.071428572,123.0,72.4
100702.0,17,2,286,2,286,0.0,143.0,143.0,0,0,0.0,0.0,0.0
12874.0,6,11,1133,6,602,2323.8,264.0,100.33333333333331,5,531,2758.75,259.0,106.2
18131.0,6,20,7606,11,978,1813.1,310.0,88.9090909090909,9,6628,2120.0,1514.0,736.4444444444445
4037.0,17,2,762,2,762,0.0,381.0,381.0,0,0,0.0,0.0,0.0
25898.0,6,14,4740,7,653,4036.8333333333335,249.0,93.28571428571428,7,4087,3998.0,1514.0,583.8571428571429
318.0,17,2,174,1,79,0.0,79.0,79.0,1,95,0.0,95.0,95.0
2061862.0,6,19,6869,11,1567,206186.2,408.0,142.45454545454547,8,5302,234054.14285714287,1514.0,662.75
442796.0,6,10,967,5,390,74695.25,162.0,78.0,5,577,74632.75,349.0,115.4
146178.0,6,3,337,2,214,0.0,160.0,107.0,1,123,0.0,123.0,123.0
146860.0,6,3,337,2,214,0.0,160.0,107.0,1,123,0.0,123.0,123.0
39396.0,6,12,1413,7,882,6566.0,291.0,126.0,5,531,8426.0,259.0,106.2
196978.0,17,2,180,1,90,0.0,90.0,90.0,1,90,0.0,90.0,90.0
90052965.0,17,28,13364,28,13364,3335295.0,501.0,477.2857142857143,0,0,0.0,0.0,0.0
147948.0,17,2,180,1,90,0.0,90.0,90.0,1,90,0.0,90.0,90.0
57157.0,6,13,1394,7,797,8814.5,253.0,113.85714285714286,6,597,10258.0,259.0,99.5
10823416.0,6,7,478,3,206,5343368.0,74.0,68.66666666666667,4,272,3562159.333333333,74.0,68.0
228390.0,17,2,180,1,90,0.0,90.0,90.0,1,90,0.0,90.0,90.0
147916.0,17,2,180,1,90,0.0,90.0,90.0,1,90,0.0,90.0,90.0
107549.0,17,2,286,2,286,0.0,143.0,143.0,0,0,0.0,0.0,0.0
216432.0,17,2,180,1,90,0.0,90.0,90.0,1,90,0.0,90.0,90.0
2422.0,17,4,344,2,150,0.0,75.0,75.0,2,194,0.0,103.0,97.0
10479671.0,6,7,478,4,272,3447763.333333333,74.0,68.0,3,206,5171543.0,74.0,68.66666666666667
27175270.0,17,5,1710,5,1710,6793817.5,342.0,342.0,0,0,0.0,0.0,0.0
284655.0,17,2,414,1,88,0.0,88.0,88.0,1,326,0.0,326.0,326.0
4285.0,17,2,602,1,72,0.0,72.0,72.0,1,530,0.0,530.0,530.0
103038195.0,6,44,2904,22,1452,4906580.714285715,66.0,66.0,22,1452,4896281.19047619,66.0,66.0
120296589.0,6,225,25356,113,17742,1074076.6875,284.0,157.00884955752213,112,7614,1047539.1351351351,140.0,67.98214285714286
327.0,17,2,208,1,72,0.0,72.0,72.0,1,136,0.0,136.0,136.0
108115033.0,17,5,955,5,955,27028758.25,191.0,191.0,0,0,0.0,0.0,0.0
90030354.0,17,28,13364,28,13364,3334457.5555555555,501.0,477.2857142857143,0,0,0.0,0.0,0.0
122428463.0,6,36,2602,19,1408,6801581.277777778,139.0,74.10526315789474,17,1194,7014093.625,123.0,70.23529411764706
90284250.0,6,21,1585,11,840,9023892.0,95.0,76.36363636363636,10,745,10000421.111111112,95.0,74.5
108104373.0,17,5,955,5,955,27026093.25,191.0,191.0,0,0,0.0,0.0,0.0
55568.0,6,14,4740,7,653,9141.0,249.0,93.28571428571428,7,4087,8416.833333333334,1514.0,583.8571428571429
34729.0,6,14,4740,7,653,5231.833333333333,249.0,93.28571428571428,7,4087,5653.166666666667,1514.0,583.8571428571429
19312.0,6,14,4740,7,653,3097.833333333333,249.0,93.28571428571428,7,4087,2346.333333333333,1514.0,583.8571428571429
209447.0,6,3,426,2,280,0.0,214.0,140.0,1,146,0.0,146.0,146.0
35353.0,6,10,2032,5,524,8035.5,252.0,104.8,5,1508,8557.75,1236.0,301.6
120000001.0,6,22,1680,12,935,10909091.0,95.0,77.91666666666667,10,745,10105002.555555556,95.0,74.5
9493.0,6,10,1067,5,536,2104.0,264.0,107.2,5,531,2165.75,259.0,106.2
119856083.0,6,14,2102,9,1082,14982010.375,188.0,120.22222222222224,5,1020,22525377.5,204.0,204.0
90015227.0,17,28,13364,28,13364,3333897.296296296,501.0,477.2857142857143,0,0,0.0,0.0,0.0
198178.0,17,2,180,1,90,0.0,90.0,90.0,1,90,0.0,90.0,90.0
211934.0,6,3,426,2,280,0.0,214.0,140.0,1,146,0.0,146.0,146.0
210578.0,6,10,1221,6,636,42115.6,298.0,106.0,4,585,68920.33333333333,379.0,146.25
51008.0,6,14,4740,7,653,8339.833333333334,249.0,93.28571428571428,7,4087,8265.333333333334,1514.0,583.8571428571429
1796014.0,17,6,1293,3,234,896683.0,78.0,78.0,3,1059,603523.0,395.0,353.0
26193.0,6,13,4412,6,409,4983.6,127.0,68.16666666666667,7,4003,4005.3333333333335,1514.0,571.8571428571429
363715.0,6,3,204,2,136,0.0,70.0,68.0,1,68,0.0,68.0,68.0
41098.0,6,14,4740,7,653,6680.5,249.0,93.28571428571428,7,4087,6397.833333333333,1514.0,583.8571428571429
146131.0,6,3,337,2,214,0.0,160.0,107.0,1,123,0.0,123.0,123.0
48541.0,6,12,1320,6,723,9040.8,253.0,120.5,6,597,8478.2,259.0,99.5
102587.0,17,2,762,2,762,0.0,381.0,381.0,0,0,0.0,0.0,0.0
84.0,17,2,762,2,762,0.0,381.0,381.0,0,0,0.0,0.0,0.0
153376.0,17,2,180,1,90,0.0,90.0,90.0,1,90,0.0,90.0,90.0
1168234.0,6,13,3010,8,2382,166890.57142857142,1514.0,297.75,5,628,223157.5,331.0,125.6
2327.0,17,4,344,2,150,0.0,75.0,75.0,2,194,0.0,103.0,97.0
209625.0,17,2,180,1,90,0.0,90.0,90.0,1,90,0.0,90.0,90.0
703.0,17,4,438,2,148,0.0,74.0,74.0,2,290,0.0,147.0,145.0
846270.0,6,9,1196,6,725,169254.0,387.0,120.83333333333331,3,471,285376.5,331.0,157.0
116333827.0,6,48,3168,24,1584,5057992.478260869,66.0,66.0,24,1584,5046148.782608695,66.0,66.0
103928.0,17,2,286,2,286,0.0,143.0,143.0,0,0,0.0,0.0,0.0
15352.0,6,10,2032,5,524,3605.0,252.0,104.8,5,1508,3482.0,1236.0,301.6
198937.0,17,4,6056,4,6056,66312.33333333333,1514.0,1514.0,0,0,0.0,0.0,0.0
1544.0,17,2,762,2,762,0.0,381.0,381.0,0,0,0.0,0.0,0.0
121321.0,6,3,337,2,214,0.0,160.0,107.0,1,123,0.0,123.0,123.0
123020545.0,6,32,2220,16,1071,7535584.133333334,123.0,66.9375,16,1149,7535593.066666666,123.0,71.8125
89281.0,6,14,4740,7,653,13184.0,249.0,93.28571428571428,7,4087,13530.333333333334,1514.0,583.8571428571429
327.0,17,2,166,1,75,0.0,75.0,75.0,1,91,0.0,91.0,91.0
15604.0,17,2,180,1,90,0.0,90.0,90.0,1,90,0.0,90.0,90.0
120041499.0,6,33,2274,17,1125,7502593.6875,123.0,66.17647058823529,16,1149,7322644.066666666,123.0,71.8125
258042.0,6,12,1373,7,714,43007.0,298.0,102.0,5,659,60104.75,379.0,131.8
217240.0,17,2,180,1,90,0.0,90.0,90.0,1,90,0.0,90.0,90.0
2105710.0,6,25,7610,13,2516,175475.83333333334,1034.0,193.53846153846155,12,5094,163377.63636363635,1510.0,424.5
46361.0,6,10,2032,5,524,11354.75,252.0,104.8,5,1508,11291.25,1236.0,301.6
54391.0,6,14,4740,7,653,8879.833333333334,249.0,93.28571428571428,7,4087,8223.833333333334,1514.0,583.8571428571429
2165393.0,6,36,15469,19,10912,120299.61111111112,1514.0,574.3157894736842,17,4557,121280.6875,1514.0,268.05882352941177
199447.0,17,2,180,1,90,0.0,90.0,90.0,1,90,0.0,90.0,90.0
62678.0,6,14,4740,7,653,10116.166666666666,249.0,93.28571428571428,7,4087,9879.833333333334,1514.0,583.8571428571429
104615.0,17,2,700,2,700,0.0,350.0,350.0,0,0,0.0,0.0,0.0
58010.0,6,14,4740,7,653,9009.833333333334,249.0,93.28571428571428,7,4087,8840.333333333334,1514.0,583.8571428571429
135798765.0,17,14,864,7,432,19333497.666666668,174.0,61.71428571428572,7,432,19334501.666666668,174.0,61.71428571428572
26430.0,6,10,2032,5,524,3753.75,252.0,104.8,5,1508,5980.25,1236.0,301.6
21111.0,6,11,1131,6,600,3883.6,262.0,100.0,5,531,3802.0,259.0,106.2
216618.0,17,2,180,1,90,0.0,90.0,90.0,1,90,0.0,90.0,90.0
90763411.0,6,24,1829,13,989,7559556.666666667,95.0,76.07692307692308,11,840,9046381.9,95.0,76.36363636363636
273088.0,6,10,1221,6,636,54617.6,298.0,106.0,4,585,85513.33333333333,379.0,146.25
213636.0,17,2,180,1,90,0.0,90.0,90.0,1,90,0.0,90.0,90.0
146043.0,6,3,337,2,214,0.0,160.0,107.0,1,123,0.0,123.0,123.0
135134550.0,17,6,1146,6,1146,27026910.0,191.0,191.0,0,0,0.0,0.0,0.0
857.0,17,4,438,2,148,0.0,74.0,74.0,2,290,0.0,147.0,145.0
120123238.0,6,14,2086,9,1204,15015404.75,188.0,133.77777777777777,5,882,22523770.75,204.0,176.4
135137580.0,17,6,1206,6,1206,27027516.0,201.0,201.0,0,0,0.0,0.0,0.0
4359.0,17,2,614,1,72,0.0,72.0,72.0,1,542,0.0,542.0,542.0
120122732.0,6,12,1832,8,1016,17137006.85714286,188.0,127.0,4,816,30031223.0,204.0,204.0
41945858.0,17,9,3078,9,3078,5243232.25,342.0,342.0,0,0,0.0,0.0,0.0
10462310.0,6,7,478,4,272,3441889.6666666665,74.0,68.0,3,206,5162749.5,74.0,68.66666666666667
90286277.0,6,19,1436,10,745,10026183.888888888,95.0,74.5,9,691,11285104.75,95.0,76.77777777777777
216538.0,17,2,180,1,90,0.0,90.0,90.0,1,90,0.0,90.0,90.0
135148192.0,17,6,1206,6,1206,27029638.4,201.0,201.0,0,0,0.0,0.0,0.0
153388.0,17,2,180,1,90,0.0,90.0,90.0,1,90,0.0,90.0,90.0
129122.0,6,2,132,1,66,0.0,66.0,66.0,1,66,0.0,66.0,66.0
108108624.0,17,5,955,5,955,27027156.0,191.0,191.0,0,0,0.0,0.0,0.0
108104937.0,17,5,1005,5,1005,27026234.25,201.0,201.0,0,0,0.0,0.0,0.0
25086.0,6,14,4740,7,653,4034.5,249.0,93.28571428571428,7,4087,3481.833333333333,1514.0,583.8571428571429
704.0,17,2,762,2,762,0.0,381.0,381.0,0,0,0.0,0.0,0.0
31573.0,6,14,4740,7,653,5133.666666666667,249.0,93.28571428571428,7,4087,5045.666666666667,1514.0,583.8571428571429
201977.0,6,10,1221,6,636,40395.4,298.0,106.0,4,585,66200.66666666667,379.0,146.25
331.0,17,2,267,1,83,0.0,83.0,83.0,1,184,0.0,184.0,184.0
26114.0,6,14,4740,7,653,3802.0,249.0,93.28571428571428,7,4087,3781.8333333333335,1514.0,583.8571428571429
1986891.0,6,4,492,2,280,0.0,214.0,140.0,2,212,0.0,146.0,106.0
135126524.0,17,6,1146,6,1146,27025304.8,191.0,191.0,0,0,0.0,0.0,0.0
2462.0,17,4,344,2,150,0.0,75.0,75.0,2,194,0.0,103.0,97.0
109962.0,17,2,286,2,286,0.0,143.0,143.0,0,0,0.0,0.0,0.0
127001129.0,17,15,907,8,475,18143018.42857143,174.0,59.375,7,432,17834124.833333332,174.0,61.71428571428572
0.0,17,1,443,1,443,0.0,443.0,443.0,0,0,0.0,0.0,0.0
205733.0,17,2,180,1,90,0.0,90.0,90.0,1,90,0.0,90.0,90.0
857365.0,6,9,1268,6,797,171473.0,459.0,132.83333333333334,3,471,290780.5,331.0,157.0
51486.0,6,14,4740,7,653,8113.333333333333,249.0,93.28571428571428,7,4087,8335.333333333334,1514.0,583.8571428571429
247995.0,6,3,337,2,214,0.0,160.0,107.0,1,123,0.0,123.0,123.0
116600.0,17,4,1400,4,1400,38866.66666666666,350.0,350.0,0,0,0.0,0.0,0.0
24623.0,6,10,2032,5,524,3872.25,252.0,104.8,5,1508,5823.75,1236.0,301.6
495395.0,6,5,336,2,134,0.0,68.0,67.0,3,202,195002.5,70.0,67.33333333333333
2746.0,17,4,344,2,150,0.0,75.0,75.0,2,194,0.0,103.0,97.0
16634.0,6,11,1133,6,602,3276.6,264.0,100.33333333333331,5,531,2221.5,259.0,106.2
90744263.0,6,19,1436,10,745,10077871.666666666,95.0,74.5,9,691,11341754.25,95.0,76.77777777777777
45439.0,6,14,4740,7,653,7237.833333333333,249.0,93.28571428571428,7,4087,7427.5,1514.0,583.8571428571429
141566.0,6,2,132,1,66,0.0,66.0,66.0,1,66,0.0,66.0,66.0
59211.0,6,14,4740,7,653,9738.333333333334,249.0,93.28571428571428,7,4087,6983.833333333333,1514.0,583.8571428571429
228392.0,17,2,180,1,90,0.0,90.0,90.0,1,90,0.0,90.0,90.0
73573015.0,6,9,842,9,842,9196626.875,97.0,93.55555555555556,0,0,0.0,0.0,0.0
31350.000000000004,6,14,4740,7,653,5098.333333333333,249.0,93.28571428571428,7,4087,5080.166666666667,1514.0,583.8571428571429
143929.0,17,2,180,1,90,0.0,90.0,90.0,1,90,0.0,90.0,90.0
120118774.0,6,43,3654,19,1647,6129769.277777778,123.0,86.6842105263158,24,2007,5222536.565217392,123.0,83.625
3882972.0,6,5,336,2,134,0.0,68.0,67.0,3,202,1576766.5,70.0,67.33333333333333
26082.0,6,14,4740,7,653,4229.833333333333,249.0,93.28571428571428,7,4087,3993.6666666666665,1514.0,583.8571428571429
227004.0,6,3,234,2,180,0.0,126.0,90.0,1,54,0.0,54.0,54.0
236037.0,6,3,426,2,280,0.0,214.0,140.0,1,146,0.0,146.0,146.0
316097.0,17,4,1400,4,1400,105365.66666666669,350.0,350.0,0,0,0.0,0.0,0.0
128869442.0,6,36,2602,19,1408,7159413.444444444,139.0,74.10526315789474,17,1194,7416733.25,123.0,70.23529411764706
10468567.0,6,7,478,4,272,3443853.0,74.0,68.0,3,206,5165658.5,74.0,68.66666666666667
108099243.0,17,5,955,5,955,27024810.75,191.0,191.0,0,0,0.0,0.0,0.0
121548.0,6,3,337,2,214,0.0,160.0,107.0,1,123,0.0,123.0,123.0
1167865.0,6,13,3010,8,2382,166837.85714285713,1514.0,297.75,5,628,223034.25,331.0,125.6
120074603.0,17,29,13785,29,13785,4288378.678571428,501.0,475.3448275862069,0,0,0.0,0.0,0.0
104016.0,17,2,286,2,286,0.0,143.0,143.0,0,0,0.0,0.0,0.0
815.0,17,4,438,2,148,0.0,74.0,74.0,2,290,0.0,147.0,145.0
262252.0,6,3,337,2,214,0.0,160.0,107.0,1,123,0.0,123.0,123.0
122010386.0,17,15,907,8,475,17430055.14285714,174.0,59.375,7,432,16960987.333333332,174.0,61.71428571428572
90018083.0,17,28,13364,28,13364,3334003.074074074,501.0,477.2857142857143,0,0,0.0,0.0,0.0
3006695.0,6,12,2172,7,664,501003.3333333333,252.0,94.85714285714286,5,1508,2203.75,1236.0,301.6
94881085.0,6,40,2640,20,1320,4993741.315789473,66.0,66.0,20,1320,4977196.631578947,66.0,66.0
307.0,17,2,174,1,79,0.0,79.0,79.0,1,95,0.0,95.0,95.0
4307.0,17,2,602,1,72,0.0,72.0,72.0,1,530,0.0,530.0,530.0
110851556.0,6,30,1974,15,1026,7902564.357142857,123.0,68.4,15,948,7902555.571428572,123.0,63.2
149884584.0,17,36,17126,36,17126,4282416.685714286,501.0,475.72222222222223,0,0,0.0,0.0,0.0
108682930.0,6,37,2788,19,1471,6037940.555555556,139.0,77.42105263157895,18,1317,6380396.117647059,123.0,73.16666666666667
245618.0,17,4,6056,4,6056,81872.66666666667,1514.0,1514.0,0,0,0.0,0.0,0.0
2729.0,17,5,550,5,550,682.25,110.0,110.0,0,0,0.0,0.0,0.0
110142253.0,6,35,2526,18,1332,6466249.764705882,123.0,74.0,17,1194,6870391.625,123.0,70.23529411764706
126058653.0,6,31,2034,16,1086,8403910.2,123.0,67.875,15,948,8275426.642857143,123.0,63.2
108104646.0,17,5,955,5,955,27026161.5,191.0,191.0,0,0,0.0,0.0,0.0
105053217.0,17,14,1126,7,563,17334245.666666668,174.0,80.42857142857143,7,563,17333498.833333332,174.0,80.42857142857143
63696444.0,17,11,3770,10,3420,4665920.222222222,342.0,342.0,1,350,0.0,350.0,350.0
120025520.0,17,28,13364,28,13364,4445389.62962963,501.0,477.2857142857143,0,0,0.0,0.0,0.0
90043326.0,17,28,13364,28,13364,3334938.0,501.0,477.2857142857143,0,0,0.0,0.0,0.0
2395.0,17,4,344,2,150,0.0,75.0,75.0,2,194,0.0,103.0,97.0
143833.0,17,2,180,1,90,0.0,90.0,90.0,1,90,0.0,90.0,90.0
35981.0,6,10,2032,5,524,8755.5,252.0,104.8,5,1508,8172.5,1236.0,301.6
747.0,17,2,762,2,762,0.0,381.0,381.0,0,0,0.0,0.0,0.0
41804.0,6,14,4740,7,653,6548.0,249.0,93.28571428571428,7,4087,6820.666666666667,1514.0,583.8571428571429
2082755.0,6,19,6869,11,1567,208275.5,408.0,142.45454545454547,8,5302,235032.0,1514.0,662.75
45828.0,6,14,4740,7,653,7512.333333333333,249.0,93.28571428571428,7,4087,7073.666666666667,1514.0,583.8571428571429
303093.0,6,2,132,1,66,0.0,66.0,66.0,1,66,0.0,66.0,66.0
108107399.0,17,5,955,5,955,27026849.75,191.0,191.0,0,0,0.0,0.0,0.0
17066.0,6,14,4740,7,653,2530.6666666666665,249.0,93.28571428571428,7,4087,2662.6666666666665,1514.0,583.8571428571429
250396.0,6,4,439,2,238,0.0,172.0,119.0,2,201,0.0,135.0,100.5
51773.0,6,14,4740,7,653,8476.666666666666,249.0,93.28571428571428,7,4087,7922.0,1514.0,583.8571428571429
46696.0,6,14,4740,7,653,7506.666666666667,249.0,93.28571428571428,7,4087,6136.833333333333,1514.0,583.8571428571429
37576392.0,17,22,7700,22,7700,1789352.0,350.0,350.0,0,0,0.0,0.0,0.0
305604.0,17,2,180,1,90,0.0,90.0,90.0,1,90,0.0,90.0,90.0
39035.0,6,13,1386,7,789,6240.166666666667,253.0,112.71428571428572,6,597,7414.6,259.0,99.5
29413.0,6,14,4740,7,653,4750.5,249.0,93.28571428571428,7,4087,4300.833333333333,1514.0,583.8571428571429
113773.0,17,4,1400,4,1400,37924.333333333336,350.0,350.0,0,0,0.0,0.0,0.0
1453.0,17,5,550,5,550,363.25,110.0,110.0,0,0,0.0,0.0,0.0
5622322.0,6,4,270,2,134,0.0,68.0,67.0,2,136,0.0,70.0,68.0
1220284.0,6,13,3010,8,2382,174326.2857142857,1514.0,297.75,5,628,236100.5,331.0,125.6
2422.0,17,4,344,2,150,0.0,75.0,75.0,2,194,0.0,103.0,97.0
21602.0,17,2,582,1,83,0.0,83.0,83.0,1,499,0.0,499.0,499.0
0.0,17,1,55,1,55,0.0,55.0,55.0,0,0,0.0,0.0,0.0
254093.0,6,3,337,2,214,0.0,160.0,107.0,1,123,0.0,123.0,123.0
28487.0,6,14,4740,7,653,4429.166666666667,249.0,93.28571428571428,7,4087,4603.166666666667,1514.0,583.8571428571429
37389.0,6,14,4740,7,653,5804.166666666667,249.0,93.28571428571428,7,4087,5030.166666666667,1514.0,583.8571428571429
147955.0,17,2,180,1,90,0.0,90.0,90.0,1,90,0.0,90.0,90.0
147212.0,6,3,373,2,238,0.0,172.0,119.0,1,135,0.0,135.0,135.0
120457296.0,6,233,26388,117,18510,1038424.9655172414,284.0,158.2051282051282,116,7878,1034071.547826087,140.0,67.91379310344827
115579265.0,6,47,3102,24,1584,5025174.782608695,66.0,66.0,23,1518,5143997.681818182,66.0,66.0
90097593.0,6,11,1644,4,816,30031657.666666668,204.0,204.0,7,828,15015875.5,188.0,118.28571428571428
218483.0,6,3,426,2,280,0.0,214.0,140.0,1,146,0.0,146.0,146.0
318342.0,6,2,132,1,66,0.0,66.0,66.0,1,66,0.0,66.0,66.0
121177042.0,6,40,3285,23,1884,5508047.363636363,123.0,81.91304347826087,17,1401,6981932.1875,123.0,82.41176470588235
22754.0,6,10,2032,5,524,5464.5,252.0,104.8,5,1508,5447.25,1236.0,301.6
24702.0,6,10,2032,5,524,5932.5,252.0,104.8,5,1508,5883.0,1236.0,301.6
119576667.0,6,20,1490,11,840,11952826.5,95.0,76.36363636363636,9,650,14941927.25,95.0,72.22222222222223
308737.0,6,6,412,4,272,102912.33333333331,74.0,68.0,2,140,0.0,74.0,70.0
119612.0,17,4,1400,4,1400,39870.66666666666,350.0,350.0,0,0,0.0,0.0,0.0
24080184.0,6,5,1736,2,819,0.0,753.0,409.5,3,917,11972649.5,785.0,305.6666666666667
0.0,17,1,381,1,381,0.0,381.0,381.0,0,0,0.0,0.0,0.0
120065850.0,6,466,54668,233,38994,516638.5560344828,300.0,167.35622317596565,233,15674,516638.4267241379,140.0,67.27038626609442
108101741.0,17,5,955,5,955,27025435.25,191.0,191.0,0,0,0.0,0.0,0.0
5631957.0,6,5,336,2,134,0.0,68.0,67.0,3,202,1426067.5,70.0,67.33333333333333
119675197.0,17,34,16284,34,16284,3626521.121212121,501.0,478.9411764705882,0,0,0.0,0.0,0.0
206145.0,6,3,426,2,280,0.0,214.0,140.0,1,146,0.0,146.0,146.0
120000533.0,17,29,13785,29,13785,4285733.321428572,501.0,475.3448275862069,0,0,0.0,0.0,0.0
93673461.0,6,40,2640,20,1320,4930182.157894737,66.0,66.0,20,1320,4913640.263157895,66.0,66.0
120240406.0,6,22,1639,11,840,11999642.0,95.0,76.36363636363636,11,799,12000013.2,95.0,72.63636363636364
0.0,17,1,90,1,90,0.0,90.0,90.0,0,0,0.0,0.0,0.0
40718.0,6,14,4740,7,653,6618.5,249.0,93.28571428571428,7,4087,6572.5,1514.0,583.8571428571429
0.0,17,1,381,1,381,0.0,381.0,381.0,0,0,0.0,0.0,0.0
304912.0,6,6,412,4,272,101637.33333333331,74.0,68.0,2,140,0.0,74.0,70.0
145651.0,6,2,132,1,66,0.0,66.0,66.0,1,66,0.0,66.0,66.0
299223.0,6,6,412,4,272,99741.0,74.0,68.0,2,140,0.0,74.0,70.0
2328.0,17,4,344,2,150,0.0,75.0,75.0,2,194,0.0,103.0,97.0
204513.0,17,2,180,1,90,0.0,90.0,90.0,1,90,0.0,90.0,90.0
108107548.0,17,5,955,5,955,27026887.0,191.0,191.0,0,0,0.0,0.0,0.0
105358.0,17,2,762,2,762,0.0,381.0,381.0,0,0,0.0,0.0,0.0
135128404.0,17,6,1206,6,1206,27025680.8,201.0,201.0,0,0,0.0,0.0,0.0
308203.0,6,6,412,4,272,102734.33333333331,74.0,68.0,2,140,0.0,74.0,70.0
310646.0,6,6,412,4,272,103548.66666666669,74.0,68.0,2,140,0.0,74.0,70.0
230579.0,17,2,180,1,90,0.0,90.0,90.0,1,90,0.0,90.0,90.0
108104831.0,17,5,955,5,955,27026207.75,191.0,191.0,0,0,0.0,0.0,0.0
217996.0,6,3,426,2,280,0.0,214.0,140.0,1,146,0.0,146.0,146.0
61303.0,6,14,4740,7,653,9997.833333333334,249.0,93.28571428571428,7,4087,7291.666666666667,1514.0,583.8571428571429
1306634.0,6,4,264,2,132,0.0,66.0,66.0,2,132,0.0,66.0,66.0
217853.0,6,4,492,2,280,0.0,214.0,140.0,2,212,0.0,146.0,106.0
101046742.0,6,191,21492,96,6558,1063649.9157894736,140.0,68.3125,95,14934,1063977.255319149,284.0,157.2
92808014.0,6,171,19484,86,5824,1091858.988235294,140.0,67.72093023255815,85,13660,1092571.6904761903,336.0,160.7058823529412
90038718.0,17,28,13364,28,13364,3334767.333333333,501.0,477.2857142857143,0,0,0.0,0.0,0.0
15025773.0,6,5,370,5,370,3756443.25,74.0,74.0,0,0,0.0,0.0,0.0
343492.0,6,12,1373,7,714,57248.66666666666,298.0,102.0,5,659,80903.75,379.0,131.8
120007763.0,17,28,13364,28,13364,4444731.962962963,501.0,477.2857142857143,0,0,0.0,0.0,0.0
118568661.0,6,228,25644,114,17898,1047376.2743362832,284.0,157.0,114,7746,1047376.1415929204,140.0,67.94736842105263
316129.0,17,4,1400,4,1400,105376.33333333331,350.0,350.0,0,0,0.0,0.0,0.0
3033372.0,6,12,2172,7,664,505504.3333333333,252.0,94.85714285714286,5,1508,8809.25,1236.0,301.6
103042.0,17,2,286,2,286,0.0,143.0,143.0,0,0,0.0,0.0,0.0
24109.0,6,14,4740,7,653,3562.333333333333,249.0,93.28571428571428,7,4087,3388.5,1514.0,583.8571428571429
299940.0,6,6,412,4,272,99980.0,74.0,68.0,2,140,0.0,74.0,70.0
112535522.0,6,46,3036,23,1518,5105431.227272728,66.0,66.0,23,1518,5105436.954545454,66.0,66.0
247257.0,6,3,337,2,214,0.0,160.0,107.0,1,123,0.0,123.0,123.0
84.0,17,2,762,2,762,0.0,381.0,381.0,0,0,0.0,0.0,0.0
207884.0,17,2,762,2,762,0.0,381.0,381.0,0,0,0.0,0.0,0.0
359.0,17,2,160,1,80,0.0,80.0,80.0,1,80,0.0,80.0,80.0
987553.0,6,10,1336,6,799,197510.6,461.0,133.16666666666666,4,537,236784.66666666663,331.0,134.25
206222.0,6,3,426,2,280,0.0,214.0,140.0,1,146,0.0,146.0,146.0
296.0,17,2,156,1,78,0.0,78.0,78.0,1,78,0.0,78.0,78.0
236904.0,6,3,337,2,214,0.0,160.0,107.0,1,123,0.0,123.0,123.0
199127.0,6,10,1066,5,490,47902.75,218.0,98.0,5,576,49574.5,304.0,115.2
4253.0,17,2,582,1,83,0.0,83.0,83.0,1,499,0.0,499.0,499.0
107285.0,17,2,286,2,286,0.0,143.0,143.0,0,0,0.0,0.0,0.0
98055988.0,17,14,1126,7,563,16333470.0,174.0,80.42857142857143,7,563,16334695.333333334,174.0,80.42857142857143
123610565.0,6,49,3234,25,1650,5150440.208333333,66.0,66.0,24,1584,4928765.739130435,66.0,66.0
36222.0,6,10,2032,5,524,8333.0,252.0,104.8,5,1508,8442.75,1236.0,301.6
27725.0,6,14,4740,7,653,3988.3333333333335,249.0,93.28571428571428,7,4087,4424.5,1514.0,583.8571428571429
2326.0,17,4,344,2,150,0.0,75.0,75.0,2,194,0.0,103.0,97.0
308472.0,17,4,1400,4,1400,102824.0,350.0,350.0,0,0,0.0,0.0,0.0
3179355.0,6,18,1493,9,919,358416.125,315.0,102.11111111111111,9,574,358387.375,78.0,63.77777777777778
233491.0,17,2,180,1,90,0.0,90.0,90.0,1,90,0.0,90.0,90.0
2470.0,17,4,344,2,150,0.0,75.0,75.0,2,194,0.0,103.0,97.0
113167665.0,6,46,3036,23,1518,5143969.454545454,66.0,66.0,23,1518,5143972.636363637,66.0,66.0
849458.0,6,9,1196,6,725,169891.6,387.0,120.83333333333331,3,471,288407.5,331.0,157.0
4476.0,17,2,614,1,72,0.0,72.0,72.0,1,542,0.0,542.0,542.0
133243.0,6,2,132,1,66,0.0,66.0,66.0,1,66,0.0,66.0,66.0
111211515.0,6,30,1974,15,1026,7928246.785714285,123.0,68.4,15,948,7928248.5,123.0,63.2
108717507.0,6,30,2122,15,1105,7750112.857142857,139.0,73.66666666666667,15,1017,7750118.0,123.0,67.8
108568357.0,6,44,2904,22,1452,5169921.761904762,66.0,66.0,22,1452,5155215.380952381,66.0,66.0
267855.0,6,10,1221,6,636,53571.0,298.0,106.0,4,585,83731.0,379.0,146.25
90305207.0,6,16,1192,8,596,12894272.714285716,95.0,74.5,8,596,12899393.42857143,95.0,74.5
91017277.0,6,25,1686,13,840,7584773.083333333,123.0,64.61538461538461,12,846,7346772.545454546,123.0,70.5
9972.0,17,4,823,2,163,0.0,89.0,81.5,2,660,0.0,443.0,330.0
48823.0,6,14,4740,7,653,7563.166666666667,249.0,93.28571428571428,7,4087,7970.0,1514.0,583.8571428571429
14651686.0,6,20,1648,10,1016,1592754.2222222222,315.0,101.6,10,632,1592732.2222222222,78.0,63.2
2800900.0,6,2,132,1,66,0.0,66.0,66.0,1,66,0.0,66.0,66.0
90260407.0,6,12,1832,8,1016,12894343.857142856,188.0,127.0,4,816,30030542.0,204.0,204.0
298042.0,6,6,412,4,272,99347.33333333331,74.0,68.0,2,140,0.0,74.0,70.0
108108317.0,17,5,1005,5,1005,27027079.25,201.0,201.0,0,0,0.0,0.0,0.0
122122.0,6,3,373,2,238,0.0,172.0,119.0,1,135,0.0,135.0,135.0
218902.0,6,3,426,2,280,0.0,214.0,140.0,1,146,0.0,146.0,146.0
5624383.0,6,5,336,2,134,0.0,68.0,67.0,3,202,1524023.0,70.0,67.33333333333333
1171036.0,6,13,3010,8,2382,167290.85714285713,1514.0,297.75,5,628,223984.5,331.0,125.6
70421.0,6,14,4740,7,653,10354.666666666666,249.0,93.28571428571428,7,4087,10872.0,1514.0,583.8571428571429
99221.0,17,2,762,2,762,0.0,381.0,381.0,0,0,0.0,0.0,0.0
275096.0,6,10,1221,6,636,55019.2,298.0,106.0,4,585,86283.0,379.0,146.25
2416.0,17,4,344,2,150,0.0,75.0,75.0,2,194,0.0,103.0,97.0
121547006.0,6,35,2542,17,1194,6972663.1875,123.0,70.23529411764706,18,1348,6562503.0,139.0,74.88888888888889
841140.0,6,9,1118,6,586,168228.0,248.0,97.66666666666669,3,532,282502.0,392.0,177.33333333333334
99083429.0,17,12,778,6,389,19800938.2,174.0,64.83333333333333,6,389,19800173.0,174.0,64.83333333333333
239.0,17,4,1524,4,1524,79.66666666666667,381.0,381.0,0,0,0.0,0.0,0.0
72232.0,6,14,4740,7,653,11668.5,249.0,93.28571428571428,7,4087,11621.333333333334,1514.0,583.8571428571429
90225669.0,6,16,1192,8,596,12854805.857142856,95.0,74.5,8,596,12860019.142857144,95.0,74.5
307685.0,6,6,412,4,272,102561.66666666669,74.0,68.0,2,140,0.0,74.0,70.0
271064.0,17,4,1524,4,1524,90354.66666666669,381.0,381.0,0,0,0.0,0.0,0.0
14862.0,6,10,2032,5,524,3494.75,252.0,104.8,5,1508,3454.0,1236.0,301.6
90064769.0,17,28,13364,28,13364,3335732.185185185,501.0,477.2857142857143,0,0,0.0,0.0,0.0
108102546.0,17,5,955,5,955,27025636.5,191.0,191.0,0,0,0.0,0.0,0.0
19141.0,6,11,1131,6,600,3054.4,262.0,100.0,5,531,4376.0,259.0,106.2
9809.0,17,2,582,1,83,0.0,83.0,83.0,1,499,0.0,499.0,499.0
29702.0,6,14,4740,7,653,4558.833333333333,249.0,93.28571428571428,7,4087,4606.833333333333,1514.0,583.8571428571429
294050.0,6,10,1221,6,636,58810.0,298.0,106.0,4,585,92644.33333333331,379.0,146.25
441845.0,6,4,508,2,238,0.0,172.0,119.0,2,270,0.0,135.0,135.0
316598.0,6,3,202,2,128,0.0,74.0,64.0,1,74,0.0,74.0,74.0
5622694.0,6,4,270,2,134,0.0,68.0,67.0,2,136,0.0,70.0,68.0
27976.0,6,10,2032,5,524,6741.25,252.0,104.8,5,1508,6440.0,1236.0,301.6
43101.0,6,14,4740,7,653,7020.833333333333,249.0,93.28571428571428,7,4087,6648.166666666667,1514.0,583.8571428571429
303632.0,6,2,132,1,66,0.0,66.0,66.0,1,66,0.0,66.0,66.0
114182270.0,6,30,1974,15,1026,8141224.571428572,123.0,68.4,15,948,8141223.642857143,123.0,63.2
10016078.0,17,3,270,3,270,5008039.0,90.0,90.0,0,0,0.0,0.0,0.0
18081.0,6,10,1067,5,536,3107.25,264.0,107.2,5,531,3709.5,259.0,106.2
322995.0,17,4,1400,4,1400,107665.0,350.0,350.0,0,0,0.0,0.0,0.0
112226213.0,6,231,26038,116,18226,975880.1130434782,284.0,157.1206896551724,115,7812,975399.9736842106,140.0,67.9304347826087
88804.0,6,14,4740,7,653,14670.0,249.0,93.28571428571428,7,4087,14312.0,1514.0,583.8571428571429
322186.0,17,4,1400,4,1400,107395.33333333331,350.0,350.0,0,0,0.0,0.0,0.0
6411.0,17,4,823,2,163,0.0,89.0,81.5,2,660,0.0,443.0,330.0
95608952.0,6,180,20422,90,14260,1071839.2471910112,284.0,158.44444444444446,90,6162,1071839.6629213484,140.0,68.46666666666667
216583.0,17,2,180,1,90,0.0,90.0,90.0,1,90,0.0,90.0,90.0
1483572.0,6,7,499,3,198,721551.5,66.0,66.0,4,301,447398.3333333333,103.0,75.25
300227.0,6,6,412,4,272,100075.66666666669,74.0,68.0,2,140,0.0,74.0,70.0
636.0,17,2,762,2,762,0.0,381.0,381.0,0,0,0.0,0.0,0.0
310788.0,17,4,1400,4,1400,103596.0,350.0,350.0,0,0,0.0,0.0,0.0
7110.0,17,2,582,1,83,0.0,83.0,83.0,1,499,0.0,499.0,499.0
258492.0,6,10,1221,6,636,51698.4,298.0,106.0,4,585,80214.33333333333,379.0,146.25
45489.0,6,14,4740,7,653,7038.333333333333,249.0,93.28571428571428,7,4087,6524.333333333333,1514.0,583.8571428571429
233688.0,6,3,337,2,214,0.0,160.0,107.0,1,123,0.0,123.0,123.0
2466.0,17,4,344,2,150,0.0,75.0,75.0,2,194,0.0,103.0,97.0
100199545.0,17,12,778,6,389,20039909.0,174.0,64.83333333333333,6,389,20000957.4,174.0,64.83333333333333
40822.0,6,14,4740,7,653,5095.666666666667,249.0,93.28571428571428,7,4087,6586.5,1514.0,583.8571428571429
273989.0,6,10,1221,6,636,54797.8,298.0,106.0,4,585,85400.66666666667,379.0,146.25
237341.0,17,2,180,1,90,0.0,90.0,90.0,1,90,0.0,90.0,90.0
310713.0,6,6,412,4,272,103571.0,74.0,68.0,2,140,0.0,74.0,70.0
13917038.0,17,6,2052,6,2052,2783407.6,342.0,342.0,0,0,0.0,0.0,0.0
55686.0,6,14,4740,7,653,9147.333333333334,249.0,93.28571428571428,7,4087,9001.666666666666,1514.0,583.8571428571429
16879.0,17,2,180,1,90,0.0,90.0,90.0,1,90,0.0,90.0,90.0
217726.0,6,3,426,2,280,0.0,214.0,140.0,1,146,0.0,146.0,146.0
135134423.0,17,6,1146,6,1146,27026884.6,191.0,191.0,0,0,0.0,0.0,0.0
121988.0,6,3,337,2,214,0.0,160.0,107.0,1,123,0.0,123.0,123.0
20510.0,17,2,582,1,83,0.0,83.0,83.0,1,499,0.0,499.0,499.0
1171753.0,6,13,3013,8,2385,167393.2857142857,1514.0,298.125,5,628,224796.25,331.0,125.6
120207.0,17,2,180,1,70,0.0,70.0,70.0,1,110,0.0,110.0,110.0
248084.0,6,3,354,2,288,0.0,222.0,144.0,1,66,0.0,66.0,66.0
108109506.0,17,5,955,5,955,27027376.5,191.0,191.0,0,0,0.0,0.0,0.0
102338285.0,17,14,864,7,432,17000767.833333332,174.0,61.71428571428572,7,432,17000177.833333332,174.0,61.71428571428572
205129.0,17,2,180,1,90,0.0,90.0,90.0,1,90,0.0,90.0,90.0
310.0,17,2,174,1,79,0.0,79.0,79.0,1,95,0.0,95.0,95.0
323644.0,17,4,1400,4,1400,107881.33333333331,350.0,350.0,0,0,0.0,0.0,0.0
119963607.0,6,12,1832,4,816,30036157.33333333,204.0,204.0,8,1016,17137327.42857143,188.0,127.0
120006688.0,6,21,1585,11,840,11999989.5,95.0,76.36363636363636,10,745,13332983.777777778,95.0,74.5
2441.0,17,4,344,2,150,0.0,75.0,75.0,2,194,0.0,103.0,97.0
1309738.0,6,4,264,2,132,0.0,66.0,66.0,2,132,0.0,66.0,66.0
14646212.0,6,20,1607,10,975,1592959.7777777778,315.0,97.5,10,632,1592928.6666666667,78.0,63.2
35109877.0,17,12,5436,12,5436,3191807.0,453.0,453.0,0,0,0.0,0.0,0.0
121325.0,6,3,337,2,214,0.0,160.0,107.0,1,123,0.0,123.0,123.0
1024266.0,6,11,1134,6,558,204853.2,220.0,93.0,5,576,254747.25,304.0,115.2
442.0,17,2,166,1,75,0.0,75.0,75.0,1,91,0.0,91.0,91.0
1041997.0,6,11,1134,6,558,208399.4,220.0,93.0,5,576,258475.25,304.0,115.2
14992.0,6,10,2032,5,524,3208.5,252.0,104.8,5,1508,3143.25,1236.0,301.6
103099947.0,17,14,864,7,432,17000897.833333332,174.0,61.71428571428572,7,432,17166851.666666668,174.0,61.71428571428572
31911.000000000004,6,14,4740,7,653,4753.833333333333,249.0,93.28571428571428,7,4087,4979.5,1514.0,583.8571428571429
90005118.0,6,22,1680,13,1030,7500426.5,95.0,79.23076923076923,9,650,11155713.375,95.0,72.22222222222223
26655.0,6,14,4740,7,653,4281.0,249.0,93.28571428571428,7,4087,4303.0,1514.0,583.8571428571429
38561.0,6,10,2032,5,524,9159.0,252.0,104.8,5,1508,9195.0,1236.0,301.6
123534044.0,6,225,25468,113,17780,1102982.5357142857,284.0,157.34513274336285,112,7688,1062256.81981982,140.0,68.64285714285714
39649.0,6,10,2032,5,524,9215.25,252.0,104.8,5,1508,9338.75,1236.0,301.6
44960.0,6,10,2032,5,524,11023.0,252.0,104.8,5,1508,8908.75,1236.0,301.6
2014.0,17,4,344,2,150,0.0,75.0,75.0,2,194,0.0,103.0,97.0
16021.0,6,11,2098,6,590,2995.4,252.0,98.33333333333331,5,1508,3716.5,1236.0,301.6
197045.0,17,2,180,1,90,0.0,90.0,90.0,1,90,0.0,90.0,90.0
118305591.0,6,223,25172,112,7688,1065816.1351351351,140.0,68.64285714285714,111,17484,1066122.6727272726,284.0,157.51351351351352
99079119.0,6,189,21270,95,6492,1054033.180851064,140.0,68.33684210526316,94,14778,1054374.3333333333,284.0,157.2127659574468
108117291.0,17,5,1005,5,1005,27029322.75,201.0,201.0,0,0,0.0,0.0,0.0
112464196.0,6,46,3036,23,1518,5111997.863636363,66.0,66.0,23,1518,5111995.909090909,66.0,66.0
320003.0,6,6,412,4,272,106667.66666666669,74.0,68.0,2,140,0.0,74.0,70.0
99504543.0,6,471,63918,236,48186,423423.5872340425,390.0,204.1779661016949,235,15732,420777.2606837607,140.0,66.94468085106384
5642533.0,6,5,336,2,134,0.0,68.0,67.0,3,202,1535295.0,70.0,67.33333333333333
122314633.0,6,48,3168,24,1584,5125313.478260869,66.0,66.0,24,1584,5082441.869565218,66.0,66.0
321595.0,6,6,544,3,350,80829.5,210.0,116.66666666666669,3,194,80821.5,74.0,64.66666666666667
14641333.0,6,20,1607,10,975,1592632.3333333333,315.0,97.5,10,632,1592603.5555555555,78.0,63.2
97618869.0,17,14,1126,7,563,16167241.166666666,174.0,80.42857142857143,7,563,16166801.0,174.0,80.42857142857143
198378.0,17,2,180,1,90,0.0,90.0,90.0,1,90,0.0,90.0,90.0
86394.0,6,13,1394,7,797,14399.0,253.0,113.85714285714286,6,597,14926.4,259.0,99.5
4804001.0,6,5,336,2,134,0.0,68.0,67.0,3,202,1526555.5,70.0,67.33333333333333
33893.0,17,2,180,1,90,0.0,90.0,90.0,1,90,0.0,90.0,90.0
122791271.0,17,14,1126,7,563,17260990.666666668,174.0,80.42857142857143,7,563,17167821.0,174.0,80.42857142857143
228336.0,17,2,180,1,90,0.0,90.0,90.0,1,90,0.0,90.0,90.0
209522.0,17,2,180,1,90,0.0,90.0,90.0,1,90,0.0,90.0,90.0
90258809.0,6,12,1832,8,1016,12894115.57142857,188.0,127.0,4,816,30031178.0,204.0,204.0
39530.0,6,14,4740,7,653,6061.666666666667,249.0,93.28571428571428,7,4087,6147.0,1514.0,583.8571428571429
153438.0,17,2,180,1,90,0.0,90.0,90.0,1,90,0.0,90.0,90.0
222397.0,6,3,426,2,280,0.0,214.0,140.0,1,146,0.0,146.0,146.0
335.0,17,2,166,1,75,0.0,75.0,75.0,1,91,0.0,91.0,91.0
613064.0,6,5,336,2,134,0.0,68.0,67.0,3,202,191842.5,70.0,67.33333333333333
1480317.0,17,16,1120,16,1120,98687.8,70.0,70.0,0,0,0.0,0.0,0.0
21338.0,17,2,582,1,83,0.0,83.0,83.0,1,499,0.0,499.0,499.0
64390.0,6,14,4740,7,653,10606.666666666666,249.0,93.28571428571428,7,4087,9386.166666666666,1514.0,583.8571428571429
25365.0,6,14,4740,7,653,4078.5,249.0,93.28571428571428,7,4087,4079.5,1514.0,583.8571428571429
110001131.0,17,14,864,7,432,18333521.83333333,174.0,61.71428571428572,7,432,18167808.5,174.0,61.71428571428572
117438.0,17,4,1400,4,1400,39146.0,350.0,350.0,0,0,0.0,0.0,0.0
203625.0,17,2,762,2,762,0.0,381.0,381.0,0,0,0.0,0.0,0.0
288.0,17,2,174,1,79,0.0,79.0,79.0,1,95,0.0,95.0,95.0
306933.0,6,6,412,4,272,102311.0,74.0,68.0,2,140,0.0,74.0,70.0
39953.0,6,14,4740,7,653,5746.166666666667,249.0,93.28571428571428,7,4087,6521.833333333333,1514.0,583.8571428571429
120054455.0,17,28,13364,28,13364,4446461.296296297,501.0,477.2857142857143,0,0,0.0,0.0,0.0
321174.0,6,6,412,4,272,107058.0,74.0,68.0,2,140,0.0,74.0,70.0
241030.0,6,3,373,2,238,0.0,172.0,119.0,1,135,0.0,135.0,135.0
49180.0,6,10,2032,5,524,10863.75,252.0,104.8,5,1508,11085.75,1236.0,301.6
3555.0,17,4,344,2,150,0.0,75.0,75.0,2,194,0.0,103.0,97.0
158318.0,17,2,180,1,70,0.0,70.0,70.0,1,110,0.0,110.0,110.0
1317838.0,6,4,264,2,132,0.0,66.0,66.0,2,132,0.0,66.0,66.0
90998321.0,6,21,1585,11,840,9098530.7,95.0,76.36363636363636,10,745,10109869.0,95.0,74.5
312320.0,17,4,1400,4,1400,104106.66666666669,350.0,350.0,0,0,0.0,0.0,0.0
228282.0,17,2,180,1,90,0.0,90.0,90.0,1,90,0.0,90.0,90.0
25317.0,6,14,4740,7,653,4029.1666666666665,249.0,93.28571428571428,7,4087,4067.6666666666665,1514.0,583.8571428571429
46122.0,17,2,180,1,90,0.0,90.0,90.0,1,90,0.0,90.0,90.0
5819733.0,6,4,270,2,134,0.0,68.0,67.0,2,136,0.0,70.0,68.0
23839.0,6,10,2032,5,524,4989.0,252.0,104.8,5,1508,5701.0,1236.0,301.6
42969.0,6,10,2032,5,524,9013.5,252.0,104.8,5,1508,8841.5,1236.0,301.6
58760.0,6,14,4740,7,653,6145.666666666667,249.0,93.28571428571428,7,4087,8955.833333333334,1514.0,583.8571428571429
129228435.0,6,30,1974,15,948,8517424.357142856,123.0,63.2,15,1026,8517423.642857144,123.0,68.4
204844.0,17,2,762,2,762,0.0,381.0,381.0,0,0,0.0,0.0,0.0
273175.0,6,10,1221,6,636,54635.0,298.0,106.0,4,585,85300.33333333333,379.0,146.25
96102829.0,17,14,1126,7,563,16000868.166666666,174.0,80.42857142857143,7,563,16000138.0,174.0,80.42857142857143
90280712.0,6,16,1192,8,596,12891406.57142857,95.0,74.5,8,596,12896610.285714284,95.0,74.5
108105558.0,17,5,1005,5,1005,27026389.5,201.0,201.0,0,0,0.0,0.0,0.0
302404.0,6,2,132,1,66,0.0,66.0,66.0,1,66,0.0,66.0,66.0
264952.0,6,3,337,2,214,0.0,160.0,107.0,1,123,0.0,123.0,123.0
250281.0,6,3,373,2,238,0.0,172.0,119.0,1,135,0.0,135.0,135.0
27482811.0,17,5,1710,5,1710,6870702.75,342.0,342.0,0,0,0.0,0.0,0.0
0.0,6,1,172,1,172,0.0,172.0,172.0,0,0,0.0,0.0,0.0
18626.0,6,14,4740,7,653,2598.833333333333,249.0,93.28571428571428,7,4087,2972.833333333333,1514.0,583.8571428571429
148044.0,17,2,180,1,90,0.0,90.0,90.0,1,90,0.0,90.0,90.0
90091930.0,6,15,2180,7,1164,15014922.5,204.0,166.28571428571428,8,1016,12836785.714285716,188.0,127.0
205974.0,6,3,426,2,280,0.0,214.0,140.0,1,146,0.0,146.0,146.0
228140.0,17,2,180,1,90,0.0,90.0,90.0,1,90,0.0,90.0,90.0
196030.0,6,10,1066,5,490,48110.0,218.0,98.0,5,576,48656.0,304.0,115.2
146216.0,6,3,337,2,214,0.0,160.0,107.0,1,123,0.0,123.0,123.0
34420.0,6,14,4740,7,653,4615.0,249.0,93.28571428571428,7,4087,4508.5,1514.0,583.8571428571429
147879.0,17,2,180,1,90,0.0,90.0,90.0,1,90,0.0,90.0,90.0
120438448.0,6,221,25146,111,17664,1094894.981818182,284.0,159.13513513513513,110,7482,1095645.1651376146,140.0,68.01818181818182
120728657.0,6,30,2037,15,948,8074485.357142857,123.0,63.2,15,1089,7910325.642857143,123.0,72.6
120544636.0,6,215,24386,108,17016,1126585.38317757,284.0,157.55555555555554,107,7370,1127378.7452830188,140.0,68.8785046728972
3014567.0,6,11,2106,6,598,602729.2,252.0,99.66666666666669,5,1508,3969.5,1236.0,301.6
57172.0,6,14,4740,7,653,9241.833333333334,249.0,93.28571428571428,7,4087,7630.333333333333,1514.0,583.8571428571429
146729.0,6,3,337,2,214,0.0,160.0,107.0,1,123,0.0,123.0,123.0
28613.0,6,13,1386,7,789,4229.5,253.0,112.71428571428572,6,597,5071.4,259.0,99.5
303663.0,6,6,412,4,272,101221.0,74.0,68.0,2,140,0.0,74.0,70.0
169108.0,17,6,1230,3,234,84371.5,78.0,78.0,3,996,84344.0,332.0,332.0
10494522.0,6,7,478,4,272,3451091.6666666665,74.0,68.0,3,206,5176546.0,74.0,68.66666666666667
122101.0,6,3,373,2,238,0.0,172.0,119.0,1,135,0.0,135.0,135.0
153407.0,17,2,180,1,90,0.0,90.0,90.0,1,90,0.0,90.0,90.0
1125.0,17,2,174,1,79,0.0,79.0,79.0,1,95,0.0,95.0,95.0
33177.0,6,10,2032,5,524,7966.75,252.0,104.8,5,1508,8035.25,1236.0,301.6
120044906.0,6,200,22766,100,6908,1210087.4848484849,140.0,69.08,100,15858,1208842.5454545454,284.0,158.58
41314.0,6,14,4740,7,653,6651.333333333333,249.0,93.28571428571428,7,4087,6223.5,1514.0,583.8571428571429
10458500.0,6,7,478,4,272,3440911.6666666665,74.0,68.0,3,206,5161266.0,74.0,68.66666666666667
90293394.0,6,16,1192,8,596,12892820.857142856,95.0,74.5,8,596,12897717.714285716,95.0,74.5
90255510.0,6,13,2036,8,1016,12893644.285714284,188.0,127.0,5,1020,22519756.0,204.0,204.0
29936.0,6,14,4740,7,653,4232.833333333333,249.0,93.28571428571428,7,4087,4208.5,1514.0,583.8571428571429
93112183.0,6,38,2508,19,1254,5155439.388888889,66.0,66.0,19,1254,5155451.722222222,66.0,66.0
209480.0,17,2,180,1,90,0.0,90.0,90.0,1,90,0.0,90.0,90.0
51107.0,6,14,4740,7,653,7507.833333333333,249.0,93.28571428571428,7,4087,7752.5,1514.0,583.8571428571429
330359.0,6,3,1604,2,851,0.0,785.0,425.5,1,753,0.0,753.0,753.0
110023.0,17,2,700,2,700,0.0,350.0,350.0,0,0,0.0,0.0,0.0
290812.0,17,2,180,1,90,0.0,90.0,90.0,1,90,0.0,90.0,90.0
369260.0,6,10,1221,6,636,73852.0,298.0,106.0,4,585,116576.0,379.0,146.25
45786.0,6,14,4740,7,653,7455.333333333333,249.0,93.28571428571428,7,4087,7437.0,1514.0,583.8571428571429
317982.0,17,4,1400,4,1400,105994.0,350.0,350.0,0,0,0.0,0.0,0.0
120062523.0,17,28,13364,28,13364,4446760.111111111,501.0,477.2857142857143,0,0,0.0,0.0,0.0
2506.0,17,4,344,2,150,0.0,75.0,75.0,2,194,0.0,103.0,97.0
281649.0,17,2,180,1,90,0.0,90.0,90.0,1,90,0.0,90.0,90.0
49904.0,6,14,4740,7,653,7834.166666666667,249.0,93.28571428571428,7,4087,7867.666666666667,1514.0,583.8571428571429
206251.0,6,3,426,2,280,0.0,214.0,140.0,1,146,0.0,146.0,146.0
232447.0,6,3,337,2,214,0.0,160.0,107.0,1,123,0.0,123.0,123.0
200031.0,17,4,6056,4,6056,66677.0,1514.0,1514.0,0,0,0.0,0.0,0.0
120038896.0,6,267,31098,134,9140,902548.090225564,140.0,68.2089552238806,133,21958,901505.7272727272,284.0,165.09774436090223
60534.0,6,14,4740,7,653,9963.833333333334,249.0,93.28571428571428,7,4087,9936.0,1514.0,583.8571428571429
130313503.0,17,15,907,7,432,18500187.33333333,174.0,61.71428571428572,8,475,18572973.14285714,174.0,59.375
341.0,17,2,160,1,80,0.0,80.0,80.0,1,80,0.0,80.0,80.0
95003802.0,6,167,18934,84,13234,1144624.1204819276,284.0,157.54761904761904,83,5700,1145538.4146341465,140.0,68.67469879518072
5826253.0,6,4,270,2,134,0.0,68.0,67.0,2,136,0.0,70.0,68.0
419.0,17,2,508,2,508,0.0,257.0,254.0,0,0,0.0,0.0,0.0
751276.0,6,2,132,1,66,0.0,66.0,66.0,1,66,0.0,66.0,66.0
1045.0,17,5,550,5,550,261.25,110.0,110.0,0,0,0.0,0.0,0.0
297.0,17,2,156,1,78,0.0,78.0,78.0,1,78,0.0,78.0,78.0
506036.00000000006,6,5,336,2,134,0.0,68.0,67.0,3,202,194213.5,70.0,67.33333333333333
106586.0,17,2,286,2,286,0.0,143.0,143.0,0,0,0.0,0.0,0.0
27070.0,6,14,4740,7,653,4129.333333333333,249.0,93.28571428571428,7,4087,4253.5,1514.0,583.8571428571429
98045082.0,6,28,1992,14,963,7541929.384615385,123.0,68.78571428571429,14,1029,6933742.846153846,123.0,73.5
228173.0,17,2,180,1,90,0.0,90.0,90.0,1,90,0.0,90.0,90.0
3078653.0,6,4,270,2,134,0.0,68.0,67.0,2,136,0.0,70.0,68.0
135984.0,17,4,1524,4,1524,45328.0,381.0,381.0,0,0,0.0,0.0,0.0
108110935.0,17,5,1005,5,1005,27027733.75,201.0,201.0,0,0,0.0,0.0,0.0
153387.0,17,2,180,1,90,0.0,90.0,90.0,1,90,0.0,90.0,90.0
2301.0,17,4,344,2,150,0.0,75.0,75.0,2,194,0.0,103.0,97.0
2799540.0,6,2,132,1,66,0.0,66.0,66.0,1,66,0.0,66.0,66.0
206533.0,6,3,426,2,280,0.0,214.0,140.0,1,146,0.0,146.0,146.0
726.0,17,4,438,2,148,0.0,74.0,74.0,2,290,0.0,147.0,145.0
35728.0,6,10,2032,5,524,8517.0,252.0,104.8,5,1508,8660.5,1236.0,301.6
232964.0,6,3,337,2,214,0.0,160.0,107.0,1,123,0.0,123.0,123.0
309489.0,17,4,1400,4,1400,103163.0,350.0,350.0,0,0,0.0,0.0,0.0
90025509.0,17,28,13364,28,13364,3334278.111111111,501.0,477.2857142857143,0,0,0.0,0.0,0.0
48324.0,6,13,1386,7,789,7167.333333333333,253.0,112.71428571428572,6,597,9070.8,259.0,99.5
188074.0,17,2,180,1,90,0.0,90.0,90.0,1,90,0.0,90.0,90.0
94033761.0,6,39,2574,20,1320,4934656.631578947,66.0,66.0,19,1254,5135408.277777778,66.0,66.0
111293633.0,6,217,24534,109,7428,1030496.6018518518,140.0,68.14678899082568,108,17106,1020853.1962616822,284.0,158.38888888888889
313665.0,17,4,1400,4,1400,104555.0,350.0,350.0,0,0,0.0,0.0,0.0
83046055.0,17,14,4796,13,4446,6228530.416666667,342.0,342.0,1,350,0.0,350.0,350.0
105001157.0,17,13,821,7,432,17500192.833333332,174.0,61.71428571428572,6,389,17001212.6,174.0,64.83333333333333
37216.0,6,14,4740,7,653,5424.5,249.0,93.28571428571428,7,4087,5914.5,1514.0,583.8571428571429
183701.0,17,2,180,1,90,0.0,90.0,90.0,1,90,0.0,90.0,90.0
19593.0,6,11,2098,6,590,3639.6,252.0,98.33333333333331,5,1508,4621.25,1236.0,301.6
309912.0,17,4,622,4,622,103304.0,163.0,155.5,0,0,0.0,0.0,0.0
3037557.0,6,4,1843,3,1017,1518778.5,885.0,339.0,1,826,0.0,826.0,826.0
1966.0,17,4,344,2,150,0.0,75.0,75.0,2,194,0.0,103.0,97.0
268979.0,6,10,1221,6,636,53795.8,298.0,106.0,4,585,81312.66666666667,379.0,146.25
209933.0,6,10,1221,6,636,41986.6,298.0,106.0,4,585,68719.33333333333,379.0,146.25
2358.0,17,4,344,2,150,0.0,75.0,75.0,2,194,0.0,103.0,97.0
42507.0,6,14,4740,7,653,6904.333333333333,249.0,93.28571428571428,7,4087,6902.0,1514.0,583.8571428571429
58685.0,6,14,4740,7,653,9652.666666666666,249.0,93.28571428571428,7,4087,9324.833333333334,1514.0,583.8571428571429
106899878.0,6,423,57224,212,43076,506634.4928909953,480.0,203.18867924528303,211,14148,507976.8095238095,140.0,67.0521327014218
217710.0,17,2,180,1,90,0.0,90.0,90.0,1,90,0.0,90.0,90.0
50530.0,6,10,2032,5,524,12395.5,252.0,104.8,5,1508,12426.5,1236.0,301.6
500836.0,6,5,336,2,134,0.0,68.0,67.0,3,202,192826.0,70.0,67.33333333333333
158555.0,17,2,180,1,90,0.0,90.0,90.0,1,90,0.0,90.0,90.0
795.0,17,4,438,2,148,0.0,74.0,74.0,2,290,0.0,147.0,145.0
119527810.0,6,233,26372,117,8018,1030412.1551724138,140.0,68.52991452991454,116,18354,1021249.4782608696,284.0,158.22413793103448
399.0,17,2,762,2,762,0.0,381.0,381.0,0,0,0.0,0.0,0.0
303229.0,6,6,412,4,272,101076.33333333331,74.0,68.0,2,140,0.0,74.0,70.0
120077393.0,17,28,13364,28,13364,4447310.851851852,501.0,477.2857142857143,0,0,0.0,0.0,0.0
542.0,17,2,508,2,508,0.0,257.0,254.0,0,0,0.0,0.0,0.0
219129.0,6,3,426,2,280,0.0,214.0,140.0,1,146,0.0,146.0,146.0
440439.0,6,11,1021,6,444,59288.0,162.0,74.0,5,577,73933.5,349.0,115.4
44716.0,6,14,4740,7,653,6886.5,249.0,93.28571428571428,7,4087,6730.166666666667,1514.0,583.8571428571429
319.0,17,2,174,1,79,0.0,79.0,79.0,1,95,0.0,95.0,95.0
113281245.0,17,14,864,7,432,18833507.666666668,174.0,61.71428571428572,7,432,18834477.166666668,174.0,61.71428571428572
11543.0,6,10,1066,5,490,2529.0,218.0,98.0,5,576,2582.0,304.0,115.2
90255032.0,6,14,2240,8,1016,12893576.0,188.0,127.0,6,1224,18018278.2,204.0,204.0
207386.0,6,3,426,2,280,0.0,214.0,140.0,1,146,0.0,146.0,146.0
13852.0,6,11,1132,6,556,2552.0,218.0,92.66666666666669,5,576,2610.5,304.0,115.2
303173.0,6,2,132,1,66,0.0,66.0,66.0,1,66,0.0,66.0,66.0
5838694.0,6,5,336,2,134,0.0,68.0,67.0,3,202,1529601.5,70.0,67.33333333333333
116035.0,6,15,4806,8,719,16468.0,249.0,89.875,7,4087,18887.33333333333,1514.0,583.8571428571429
135130858.0,17,6,1146,6,1146,27026171.6,191.0,191.0,0,0,0.0,0.0,0.0
135133014.0,17,6,1206,6,1206,27026602.8,201.0,201.0,0,0,0.0,0.0,0.0
100001092.0,17,11,473,6,258,20000218.4,43.0,43.0,5,215,20001605.0,43.0,43.0
232802.0,6,3,337,2,214,0.0,160.0,107.0,1,123,0.0,123.0,123.0
9374.0,17,2,582,1,83,0.0,83.0,83.0,1,499,0.0,499.0,499.0
25204.0,6,14,4740,7,653,4048.6666666666665,249.0,93.28571428571428,7,4087,4065.3333333333335,1514.0,583.8571428571429
90254487.0,6,12,1832,8,1016,12893498.142857144,188.0,127.0,4,816,30025399.0,204.0,204.0
90027399.0,17,28,13364,28,13364,3334348.111111111,501.0,477.2857142857143,0,0,0.0,0.0,0.0
1220037.0,6,13,3001,8,2373,174291.0,1514.0,296.625,5,628,236073.5,331.0,125.6
120121686.0,6,15,2444,7,1428,20020281.0,204.0,204.0,8,1016,17137058.0,188.0,127.0
90036958.0,17,28,13364,28,13364,3334702.1481481483,501.0,477.2857142857143,0,0,0.0,0.0,0.0
120385176.0,6,223,25208,112,17586,1084551.1351351351,284.0,157.01785714285714,111,7622,1084963.6181818182,140.0,68.66666666666667
288.0,17,2,156,1,78,0.0,78.0,78.0,1,78,0.0,78.0,78.0
205840.0,17,2,180,1,90,0.0,90.0,90.0,1,90,0.0,90.0,90.0
40823108.0,6,8,1307,8,1307,5831872.571428572,172.0,163.375,0,0,0.0,0.0,0.0
255338.0,6,3,337,2,214,0.0,160.0,107.0,1,123,0.0,123.0,123.0
213633.0,17,2,180,1,90,0.0,90.0,90.0,1,90,0.0,90.0,90.0
139539.0,6,2,132,1,66,0.0,66.0,66.0,1,66,0.0,66.0,66.0
135129919.0,17,6,1206,6,1206,27025983.8,201.0,201.0,0,0,0.0,0.0,0.0
214352.0,6,10,1221,6,636,42870.4,298.0,106.0,4,585,70244.33333333333,379.0,146.25
108100680.0,17,5,1005,5,1005,27025170.0,201.0,201.0,0,0,0.0,0.0,0.0
102622.0,17,2,286,2,286,0.0,143.0,143.0,0,0,0.0,0.0,0.0
218069.0,6,3,426,2,280,0.0,214.0,140.0,1,146,0.0,146.0,146.0
90042684.0,17,28,13364,28,13364,3334914.222222222,501.0,477.2857142857143,0,0,0.0,0.0,0.0
2786605.0,6,2,132,1,66,0.0,66.0,66.0,1,66,0.0,66.0,66.0
1280629.0,17,7,490,7,490,213438.16666666663,70.0,70.0,0,0,0.0,0.0,0.0
153539.0,17,2,180,1,90,0.0,90.0,90.0,1,90,0.0,90.0,90.0
322905.0,6,6,412,4,272,107635.0,74.0,68.0,2,140,0.0,74.0,70.0
316932.0,17,4,1400,4,1400,105644.0,350.0,350.0,0,0,0.0,0.0,0.0
224253.0,6,13,1386,7,789,37375.5,253.0,112.71428571428572,6,597,42877.8,259.0,99.5
325.0,17,2,174,1,79,0.0,79.0,79.0,1,95,0.0,95.0,95.0
146192.0,6,3,337,2,214,0.0,160.0,107.0,1,123,0.0,123.0,123.0
27307814.0,17,5,1710,5,1710,6826953.5,342.0,342.0,0,0,0.0,0.0,0.0
108111115.0,17,5,1005,5,1005,27027778.75,201.0,201.0,0,0,0.0,0.0,0.0
253589.0,6,3,337,2,214,0.0,160.0,107.0,1,123,0.0,123.0,123.0
21078.0,6,14,4740,7,653,3391.0,249.0,93.28571428571428,7,4087,3329.833333333333,1514.0,583.8571428571429
102588.0,17,2,762,2,762,0.0,381.0,381.0,0,0,0.0,0.0,0.0
52791.0,6,14,4740,7,653,8506.166666666666,249.0,93.28571428571428,7,4087,6911.166666666667,1514.0,583.8571428571429
122395880.0,17,14,1126,7,563,17333492.833333332,174.0,80.42857142857143,7,563,17167229.666666668,174.0,80.42857142857143
94822.0,17,2,762,2,762,0.0,381.0,381.0,0,0,0.0,0.0,0.0
2072.0,17,4,344,2,150,0.0,75.0,75.0,2,194,0.0,103.0,97.0
103439162.0,6,30,2106,15,1089,7388511.571428572,123.0,72.6,15,1017,7373061.714285715,123.0,67.8
103779.0,17,2,286,2,286,0.0,143.0,143.0,0,0,0.0,0.0,0.0
12192.0,6,13,1459,7,862,1902.6666666666667,271.0,123.14285714285714,6,597,2287.4,259.0,99.5
100330.0,17,2,286,2,286,0.0,143.0,143.0,0,0,0.0,0.0,0.0
5623765.0,6,4,270,2,134,0.0,68.0,67.0,2,136,0.0,70.0,68.0
119795422.0,17,35,16705,35,16705,3523394.7647058824,501.0,477.2857142857143,0,0,0.0,0.0,0.0
233748.0,6,3,337,2,214,0.0,160.0,107.0,1,123,0.0,123.0,123.0
14434.0,17,2,180,1,90,0.0,90.0,90.0,1,90,0.0,90.0,90.0
37695.0,6,14,4740,7,653,5645.333333333333,249.0,93.28571428571428,7,4087,5480.0,1514.0,583.8571428571429
40024.0,6,14,4740,7,653,6503.5,249.0,93.28571428571428,7,4087,6251.333333333333,1514.0,583.8571428571429
288.0,17,2,156,1,78,0.0,78.0,78.0,1,78,0.0,78.0,78.0
206574.0,6,3,426,2,280,0.0,214.0,140.0,1,146,0.0,146.0,146.0
108101861.0,17,5,1005,5,1005,27025465.25,201.0,201.0,0,0,0.0,0.0,0.0
153668.0,17,2,180,1,90,0.0,90.0,90.0,1,90,0.0,90.0,90.0
2893.0,17,2,224,1,76,0.0,76.0,76.0,1,148,0.0,148.0,148.0
97654959.0,6,213,24024,107,7284,921273.1981132076,140.0,68.07476635514018,106,16740,924166.9523809524,284.0,157.9245283018868
95009166.0,17,11,735,6,389,19001833.2,174.0,64.83333333333333,5,346,18750188.75,174.0,69.2
564685.0,17,6,1230,3,234,282154.0,78.0,78.0,3,996,282137.0,332.0,332.0
100623385.0,17,11,473,6,258,20000151.0,43.0,43.0,5,215,25001219.5,43.0,43.0
343179.0,6,6,412,4,272,114393.0,74.0,68.0,2,140,0.0,74.0,70.0
605.0,17,2,762,2,762,0.0,381.0,381.0,0,0,0.0,0.0,0.0
70663.0,6,14,4740,7,653,10930.333333333334,249.0,93.28571428571428,7,4087,10260.833333333334,1514.0,583.8571428571429
2351.0,17,4,344,2,150,0.0,75.0,75.0,2,194,0.0,103.0,97.0
4128189.0,6,4,1668,2,818,0.0,752.0,409.0,2,850,0.0,784.0,425.0
120363408.0,17,14,864,7,432,16833505.166666668,174.0,61.71428571428572,7,432,16834478.666666668,174.0,61.71428571428572
30931592.0,6,4,270,3,202,15465796.0,70.0,67.33333333333333,1,68,0.0,68.0,68.0
0.0,6,1,66,1,66,0.0,66.0,66.0,0,0,0.0,0.0,0.0
106864600.0,6,190,21570,95,6492,1135004.7340425532,140.0,68.33684210526316,95,15078,1128093.8085106383,284.0,158.7157894736842
269197.0,17,2,180,1,90,0.0,90.0,90.0,1,90,0.0,90.0,90.0
78591.0,6,10,2032,5,524,17684.0,252.0,104.8,5,1508,18856.25,1236.0,301.6
2076245.0,6,24,7544,12,2450,188749.54545454544,1034.0,204.16666666666663,12,5094,161237.63636363635,1510.0,424.5
2217.0,17,2,932,1,590,0.0,590.0,590.0,1,342,0.0,342.0,342.0
61519.0,6,14,4740,7,653,9321.333333333334,249.0,93.28571428571428,7,4087,8277.166666666666,1514.0,583.8571428571429
1243987.0,17,7,490,7,490,207331.16666666663,70.0,70.0,0,0,0.0,0.0,0.0
142638.0,6,2,132,1,66,0.0,66.0,66.0,1,66,0.0,66.0,66.0
2071886.0,6,24,7544,12,2450,188353.2727272728,1034.0,204.16666666666663,12,5094,161390.45454545456,1510.0,424.5
310023.0,6,6,412,4,272,103341.0,74.0,68.0,2,140,0.0,74.0,70.0
199984.0,17,4,6056,4,6056,66661.33333333333,1514.0,1514.0,0,0,0.0,0.0,0.0
252030.0,17,4,6056,4,6056,84009.99999999999,1514.0,1514.0,0,0,0.0,0.0,0.0
219387.0,6,3,426,2,280,0.0,214.0,140.0,1,146,0.0,146.0,146.0
97853352.0,6,538,87226,269,18136,365109.4514925373,214.0,67.42007434944237,269,69090,364030.26492537314,1514.0,256.8401486988848
200756.0,17,4,6056,4,6056,66918.66666666667,1514.0,1514.0,0,0,0.0,0.0,0.0
123840058.0,6,49,3234,25,1650,5160002.416666667,66.0,66.0,24,1584,5022161.391304348,66.0,66.0
240425.0,6,3,337,2,214,0.0,160.0,107.0,1,123,0.0,123.0,123.0
43607.0,6,14,4740,7,653,6957.666666666667,249.0,93.28571428571428,7,4087,6447.5,1514.0,583.8571428571429
1478.0,17,2,192,1,88,0.0,88.0,88.0,1,104,0.0,104.0,104.0
118644446.0,6,218,24752,109,17336,1096660.0833333333,284.0,159.045871559633,109,7416,1096660.0,140.0,68.03669724770643
137210.0,6,2,132,1,66,0.0,66.0,66.0,1,66,0.0,66.0,66.0
135160103.0,17,6,1206,6,1206,27032020.6,201.0,201.0,0,0,0.0,0.0,0.0
213946.0,17,2,604,1,75,0.0,75.0,75.0,1,529,0.0,529.0,529.0
27003.0,17,4,823,2,163,0.0,89.0,81.5,2,660,0.0,443.0,330.0
26660.0,6,14,4740,7,653,4278.0,249.0,93.28571428571428,7,4087,2406.6666666666665,1514.0,583.8571428571429
253996.0,6,3,337,2,214,0.0,160.0,107.0,1,123,0.0,123.0,123.0
19037033.0,6,6,1981,4,1087,6345677.666666667,885.0,271.75,2,894,0.0,826.0,447.0
171701.0,17,2,180,1,90,0.0,90.0,90.0,1,90,0.0,90.0,90.0
113820997.0,6,35,2542,18,1348,6682653.647058823,139.0,74.88888888888889,17,1194,7100323.8125,123.0,70.23529411764706
39459.0,6,10,2032,5,524,9594.25,252.0,104.8,5,1508,8915.25,1236.0,301.6
295.0,17,2,164,1,82,0.0,82.0,82.0,1,82,0.0,82.0,82.0
74681.0,6,10,2032,5,524,18242.0,252.0,104.8,5,1508,18071.0,1236.0,301.6
597729.0,6,4,508,2,238,0.0,172.0,119.0,2,270,0.0,135.0,135.0
120055428.0,17,28,13364,28,13364,4446497.333333333,501.0,477.2857142857143,0,0,0.0,0.0,0.0
108105603.0,17,5,955,5,955,27026400.75,191.0,191.0,0,0,0.0,0.0,0.0
162340.0,17,2,180,1,90,0.0,90.0,90.0,1,90,0.0,90.0,90.0
15042.0,6,10,2032,5,524,2925.25,252.0,104.8,5,1508,3146.25,1236.0,301.6
2375.0,17,4,344,2,150,0.0,75.0,75.0,2,194,0.0,103.0,97.0
70545.0,6,10,2032,5,524,17482.5,252.0,104.8,5,1508,9136.5,1236.0,301.6
79876.0,6,11,1131,6,600,15752.8,262.0,100.0,5,531,18134.75,259.0,106.2
305290.0,6,6,412,4,272,101763.33333333331,74.0,68.0,2,140,0.0,74.0,70.0
1046726.0,6,11,1134,6,558,209345.2,220.0,93.0,5,576,257693.5,304.0,115.2
208232.0,6,3,426,2,280,0.0,214.0,140.0,1,146,0.0,146.0,146.0
233053.0,6,3,337,2,214,0.0,160.0,107.0,1,123,0.0,123.0,123.0
15699.000000000002,6,10,2032,5,524,3669.5,252.0,104.8,5,1508,3641.5,1236.0,301.6
90042400.0,17,27,12943,27,12943,3463169.230769231,501.0,479.3703703703704,0,0,0.0,0.0,0.0
96050054.0,6,66,16042,34,6793,2910607.696969697,1514.0,199.7941176470588,32,9249,3090137.35483871,1514.0,289.03125
104342.0,17,2,286,2,286,0.0,143.0,143.0,0,0,0.0,0.0,0.0
19300.0,6,11,2098,6,590,3860.0,252.0,98.33333333333331,5,1508,4541.75,1236.0,301.6
284099.0,17,2,363,1,79,0.0,79.0,79.0,1,284,0.0,284.0,284.0
2455.0,17,4,344,2,150,0.0,75.0,75.0,2,194,0.0,103.0,97.0
2903273.0,6,2,132,1,66,0.0,66.0,66.0,1,66,0.0,66.0,66.0
531.0,17,2,508,2,508,0.0,257.0,254.0,0,0,0.0,0.0,0.0
106063671.0,17,14,864,7,432,17666867.166666668,174.0,61.71428571428572,7,432,17667970.333333332,174.0,61.71428571428572
233237.0,6,3,337,2,214,0.0,160.0,107.0,1,123,0.0,123.0,123.0
1792.0,17,2,684,1,342,0.0,342.0,342.0,1,342,0.0,342.0,342.0
39576.0,6,14,4740,7,653,6435.0,249.0,93.28571428571428,7,4087,6375.0,1514.0,583.8571428571429
121362.0,6,3,337,2,214,0.0,160.0,107.0,1,123,0.0,123.0,123.0
401463.0,17,2,363,1,75,0.0,75.0,75.0,1,288,0.0,288.0,288.0
10481523.0,6,7,478,4,272,3446686.6666666665,74.0,68.0,3,206,5169938.0,74.0,68.66666666666667
120299536.0,6,31,2050,16,1102,8019969.066666666,139.0,68.875,15,948,7864188.571428572,123.0,63.2
5628149.0,6,5,336,2,134,0.0,68.0,67.0,3,202,1422948.0,70.0,67.33333333333333
105585984.0,17,14,864,7,432,17501735.166666668,174.0,61.71428571428572,7,432,17500196.333333332,174.0,61.71428571428572
209895.0,6,10,1221,6,636,41979.0,298.0,106.0,4,585,69114.0,379.0,146.25
27697.0,6,10,2032,5,524,6666.75,252.0,104.8,5,1508,6334.5,1236.0,301.6
124011780.0,17,15,907,8,475,17715968.57142857,174.0,59.375,7,432,17333498.666666668,174.0,61.71428571428572
1310214.0,6,4,264,2,132,0.0,66.0,66.0,2,132,0.0,66.0,66.0
311235.0,17,4,1400,4,1400,103745.0,350.0,350.0,0,0,0.0,0.0,0.0
232216.0,6,3,337,2,214,0.0,160.0,107.0,1,123,0.0,123.0,123.0
232967.0,6,3,337,2,214,0.0,160.0,107.0,1,123,0.0,123.0,123.0
120132896.0,6,524,66204,262,48690,459454.7816091954,336.0,185.8396946564885,262,17514,459454.4865900383,140.0,66.8473282442748
108109692.0,17,5,1005,5,1005,27027423.0,201.0,201.0,0,0,0.0,0.0,0.0
868217.0,17,2,876,2,876,0.0,438.0,438.0,0,0,0.0,0.0,0.0
60938.0,6,14,4740,7,653,9095.333333333334,249.0,93.28571428571428,7,4087,10012.333333333334,1514.0,583.8571428571429
130755.0,6,3,337,2,214,0.0,160.0,107.0,1,123,0.0,123.0,123.0
90254103.0,6,13,2036,8,1016,12893443.285714284,188.0,127.0,5,1020,22522509.25,204.0,204.0
120000050.0,6,18,1382,9,691,15000006.25,95.0,76.77777777777777,9,691,14968736.625,95.0,76.77777777777777
29758.0,6,10,2032,5,524,6168.5,252.0,104.8,5,1508,6724.25,1236.0,301.6
234477.0,6,3,373,2,238,0.0,172.0,119.0,1,135,0.0,135.0,135.0
90531491.0,6,14,2240,8,1016,12933070.142857144,188.0,127.0,6,1224,18073106.6,204.0,204.0
97065647.0,6,179,20266,90,14170,1090625.2471910112,284.0,157.44444444444446,89,6096,1091072.568181818,140.0,68.49438202247191
153448.0,17,2,180,1,90,0.0,90.0,90.0,1,90,0.0,90.0,90.0
102273402.0,17,14,864,7,432,17001221.333333332,174.0,61.71428571428572,7,432,17000203.666666668,174.0,61.71428571428572
146954.0,6,3,373,2,238,0.0,172.0,119.0,1,135,0.0,135.0,135.0
51591.0,6,10,2032,5,524,12667.25,252.0,104.8,5,1508,9021.0,1236.0,301.6
10033.0,6,10,2032,5,524,2186.5,252.0,104.8,5,1508,2223.75,1236.0,301.6
103461.0,17,2,286,2,286,0.0,143.0,143.0,0,0,0.0,0.0,0.0
153447.0,17,2,180,1,90,0.0,90.0,90.0,1,90,0.0,90.0,90.0
24740.0,6,14,4740,7,653,4001.0,249.0,93.28571428571428,7,4087,3982.3333333333335,1514.0,583.8571428571429
113053662.0,17,14,864,7,432,18833507.666666668,174.0,61.71428571428572,7,432,18834365.33333333,174.0,61.71428571428572
321508.0,6,6,412,4,272,107169.33333333331,74.0,68.0,2,140,0.0,74.0,70.0
114408480.0,6,48,3168,24,1584,4974281.739130435,66.0,66.0,24,1584,4964882.391304348,66.0,66.0
4640.0,17,4,344,2,150,0.0,75.0,75.0,2,194,0.0,103.0,97.0
97525918.0,6,40,2640,20,1320,5132943.052631579,66.0,66.0,20,1320,5116696.947368421,66.0,66.0
0.0,6,1,66,1,66,0.0,66.0,66.0,0,0,0.0,0.0,0.0
31727.0,6,14,4740,7,653,5167.333333333333,249.0,93.28571428571428,7,4087,4880.166666666667,1514.0,583.8571428571429
305459.0,6,6,412,4,272,101819.66666666669,74.0,68.0,2,140,0.0,74.0,70.0
297451.0,6,6,412,4,272,99150.33333333331,74.0,68.0,2,140,0.0,74.0,70.0
2090.0,17,4,344,2,150,0.0,75.0,75.0,2,194,0.0,103.0,97.0
2596566.0,6,2,132,1,66,0.0,66.0,66.0,1,66,0.0,66.0,66.0
135158848.0,17,6,1146,6,1146,27031769.6,191.0,191.0,0,0,0.0,0.0,0.0
107297.0,17,2,700,2,700,0.0,350.0,350.0,0,0,0.0,0.0,0.0
20828.0,17,2,582,1,83,0.0,83.0,83.0,1,499,0.0,499.0,499.0
107488.0,17,2,286,2,286,0.0,143.0,143.0,0,0,0.0,0.0,0.0
90912012.0,6,21,1585,11,840,9090480.6,95.0,76.36363636363636,10,745,10100319.444444444,95.0,74.5
27451.0,6,10,2032,5,524,6230.25,252.0,104.8,5,1508,6583.75,1236.0,301.6
91794338.0,6,181,20382,91,6228,1019937.088888889,140.0,68.43956043956044,90,14154,1021171.4494382022,284.0,157.26666666666668
124243010.0,6,220,24884,110,7556,1075787.5504587155,140.0,68.69090909090909,110,17328,1131441.1926605504,284.0,157.52727272727273
29854.0,6,14,4740,7,653,4346.0,249.0,93.28571428571428,7,4087,4350.5,1514.0,583.8571428571429
11351.0,6,2,177,1,123,0.0,123.0,123.0,1,54,0.0,54.0,54.0
135135634.0,17,6,1206,6,1206,27027126.8,201.0,201.0,0,0,0.0,0.0,0.0
206826.0,6,3,426,2,280,0.0,214.0,140.0,1,146,0.0,146.0,146.0
121375565.0,6,303,34772,152,24584,803811.6887417219,284.0,161.73684210526315,151,10188,795420.66,140.0,67.47019867549669
38895.0,6,14,4740,7,653,6362.166666666667,249.0,93.28571428571428,7,4087,5793.666666666667,1514.0,583.8571428571429
207171.0,6,3,426,2,280,0.0,214.0,140.0,1,146,0.0,146.0,146.0
221900.0,6,3,426,2,280,0.0,214.0,140.0,1,146,0.0,146.0,146.0
5725108.0,6,5,336,2,134,0.0,68.0,67.0,3,202,1522735.5,70.0,67.33333333333333
108111429.0,17,5,1005,5,1005,27027857.25,201.0,201.0,0,0,0.0,0.0,0.0
135134803.0,17,6,1206,6,1206,27026960.6,201.0,201.0,0,0,0.0,0.0,0.0
26819.0,6,10,2032,5,524,6472.0,252.0,104.8,5,1508,4432.0,1236.0,301.6
135759.0,6,2,132,1,66,0.0,66.0,66.0,1,66,0.0,66.0,66.0
91432810.0,6,24,1829,13,989,7618349.333333333,95.0,76.07692307692308,11,840,9142148.3,95.0,76.36363636363636
40057.0,6,14,4740,7,653,5926.0,249.0,93.28571428571428,7,4087,6535.833333333333,1514.0,583.8571428571429
108946.0,17,2,286,2,286,0.0,143.0,143.0,0,0,0.0,0.0,0.0
105774.0,17,2,700,2,700,0.0,350.0,350.0,0,0,0.0,0.0,0.0
50703198.0,6,8,2113,3,960,24025238.5,826.0,320.0,5,1153,11980900.75,885.0,230.6
2376.0,17,4,344,2,150,0.0,75.0,75.0,2,194,0.0,103.0,97.0
2592614.0,6,2,132,1,66,0.0,66.0,66.0,1,66,0.0,66.0,66.0
103551.0,17,2,286,2,286,0.0,143.0,143.0,0,0,0.0,0.0,0.0
120197014.0,6,356,41054,178,12044,671909.9209039548,140.0,67.66292134831461,178,29010,679067.8870056497,300.0,162.97752808988764
253962.00000000003,6,3,337,2,214,0.0,160.0,107.0,1,123,0.0,123.0,123.0
197270.0,17,2,180,1,90,0.0,90.0,90.0,1,90,0.0,90.0,90.0
242714.0,6,3,337,2,214,0.0,160.0,107.0,1,123,0.0,123.0,123.0
90258359.0,6,12,1832,8,1016,12894051.285714284,188.0,127.0,4,816,30030749.666666668,204.0,204.0
31832.0,6,14,4740,7,653,4428.666666666667,249.0,93.28571428571428,7,4087,5116.833333333333,1514.0,583.8571428571429
26818.0,6,11,2098,6,590,5217.0,252.0,98.33333333333331,5,1508,5857.25,1236.0,301.6
105621.0,17,2,700,2,700,0.0,350.0,350.0,0,0,0.0,0.0,0.0
90515782.0,6,15,2168,8,1016,12930826.0,188.0,127.0,7,1152,15052673.666666666,204.0,164.57142857142858
10469622.0,6,7,478,4,272,3444419.0,74.0,68.0,3,206,5166509.5,74.0,68.66666666666667
298208.0,6,6,412,4,272,99402.66666666669,74.0,68.0,2,140,0.0,74.0,70.0
339.0,17,2,166,1,75,0.0,75.0,75.0,1,91,0.0,91.0,91.0
47813707.0,6,8,2113,3,960,22645400.5,826.0,320.0,5,1153,11257791.0,885.0,230.6
167795.0,17,2,414,1,88,0.0,88.0,88.0,1,326,0.0,326.0,326.0
43473.0,6,12,1393,6,796,8077.8,271.0,132.66666666666666,6,597,7064.8,259.0,99.5
216585.0,17,2,180,1,90,0.0,90.0,90.0,1,90,0.0,90.0,90.0
111502503.0,6,32,2236,16,1165,7419116.266666667,139.0,72.8125,16,1071,7419118.0,123.0,66.9375
143830.0,17,2,180,1,90,0.0,90.0,90.0,1,90,0.0,90.0,90.0
19096.0,6,14,4740,7,653,3020.5,249.0,93.28571428571428,7,4087,3047.333333333333,1514.0,583.8571428571429
4496.0,17,2,614,1,72,0.0,72.0,72.0,1,542,0.0,542.0,542.0
204705.0,17,2,762,2,762,0.0,381.0,381.0,0,0,0.0,0.0,0.0
305257.0,17,4,704,2,148,0.0,74.0,74.0,2,556,0.0,280.0,278.0
108756.0,17,2,286,2,286,0.0,143.0,143.0,0,0,0.0,0.0,0.0
91420869.0,6,24,1829,13,989,7617658.75,95.0,76.07692307692308,11,840,9141193.4,95.0,76.36363636363636
9808.0,17,2,582,1,83,0.0,83.0,83.0,1,499,0.0,499.0,499.0
107489782.0,6,206,23510,103,7094,1053821.392156863,140.0,68.87378640776699,103,16416,1051670.8823529412,284.0,159.37864077669903
35821.0,6,14,4740,7,653,5809.166666666667,249.0,93.28571428571428,7,4087,5559.833333333333,1514.0,583.8571428571429
121375942.0,6,289,33128,145,23328,842888.4861111111,284.0,160.88275862068966,144,9800,834958.1678321678,140.0,68.05555555555556
211164.0,17,2,180,1,90,0.0,90.0,90.0,1,90,0.0,90.0,90.0
306511.0,6,6,412,4,272,102170.33333333331,74.0,68.0,2,140,0.0,74.0,70.0
199578.0,17,4,6056,4,6056,66526.0,1514.0,1514.0,0,0,0.0,0.0,0.0
911.0,17,5,550,5,550,227.75,110.0,110.0,0,0,0.0,0.0,0.0
108104940.0,17,5,1005,5,1005,27026235.0,201.0,201.0,0,0,0.0,0.0,0.0
154.0,17,2,700,2,700,0.0,350.0,350.0,0,0,0.0,0.0,0.0
837671.0,6,9,1118,6,586,167534.2,248.0,97.66666666666669,3,532,282481.5,392.0,177.33333333333334
314403.0,17,4,1400,4,1400,104801.0,350.0,350.0,0,0,0.0,0.0,0.0
39849976.0,6,5,336,2,134,0.0,68.0,67.0,3,202,19839132.0,70.0,67.33333333333333
9054.0,17,2,507,1,86,0.0,86.0,86.0,1,421,0.0,421.0,421.0
90469049.0,6,24,1829,11,840,9046904.9,95.0,76.36363636363636,13,989,7520837.25,95.0,76.07692307692308
90014446.0,17,28,13364,28,13364,3333868.3703703703,501.0,477.2857142857143,0,0,0.0,0.0,0.0
2435.0,17,4,344,2,150,0.0,75.0,75.0,2,194,0.0,103.0,97.0
39570.0,6,10,2032,5,524,9359.75,252.0,104.8,5,1508,8996.25,1236.0,301.6
21645632.0,6,6,1981,4,1087,7215210.666666667,885.0,271.75,2,894,0.0,826.0,447.0
312245.0,17,4,1400,4,1400,104081.66666666669,350.0,350.0,0,0,0.0,0.0,0.0
843457.0,6,9,1196,6,725,168691.4,387.0,120.83333333333331,3,471,283900.0,331.0,157.0
405682.0,6,4,508,2,238,0.0,172.0,119.0,2,270,0.0,135.0,135.0
332.0,17,2,166,1,75,0.0,75.0,75.0,1,91,0.0,91.0,91.0
116257278.0,6,48,3168,24,1584,5054664.260869565,66.0,66.0,24,1584,5041206.782608695,66.0,66.0
2513.0,17,2,508,2,508,0.0,257.0,254.0,0,0,0.0,0.0,0.0
494116.0,6,5,336,2,134,0.0,68.0,67.0,3,202,192912.0,70.0,67.33333333333333
160200.0,17,2,180,1,90,0.0,90.0,90.0,1,90,0.0,90.0,90.0
0.0,17,1,381,1,381,0.0,381.0,381.0,0,0,0.0,0.0,0.0
121248.0,6,3,337,2,214,0.0,160.0,107.0,1,123,0.0,123.0,123.0
143831.0,17,2,180,1,90,0.0,90.0,90.0,1,90,0.0,90.0,90.0
505866.00000000006,6,4,270,2,134,0.0,68.0,67.0,2,136,0.0,70.0,68.0
16277.0,6,10,2032,5,524,2841.5,252.0,104.8,5,1508,3670.75,1236.0,301.6
316139.0,6,6,412,4,272,105379.66666666669,74.0,68.0,2,140,0.0,74.0,70.0
90230125.0,6,27,1938,14,1029,6940778.846153846,123.0,73.5,13,909,7501133.333333333,123.0,69.92307692307692
301665.0,6,6,412,4,272,100555.0,74.0,68.0,2,140,0.0,74.0,70.0
120342113.0,6,225,25468,113,17780,1074483.1517857143,284.0,157.34513274336285,112,7688,1074782.189189189,140.0,68.64285714285714
5825.0,17,4,344,2,150,0.0,75.0,75.0,2,194,0.0,103.0,97.0
5616416.0,6,5,336,2,134,0.0,68.0,67.0,3,202,1525369.0,70.0,67.33333333333333
135133771.0,17,6,1206,6,1206,27026754.2,201.0,201.0,0,0,0.0,0.0,0.0
120135658.0,6,17,2572,8,1368,17162236.85714286,204.0,171.0,9,1204,14965980.0,188.0,133.77777777777777
1446021.0,17,6,1230,3,234,722823.5,78.0,78.0,3,996,722805.5,332.0,332.0
307306.0,6,6,412,4,272,102435.33333333331,74.0,68.0,2,140,0.0,74.0,70.0
240647.0,6,3,337,2,214,0.0,160.0,107.0,1,123,0.0,123.0,123.0
104164.0,17,2,286,2,286,0.0,143.0,143.0,0,0,0.0,0.0,0.0
101352446.0,17,14,864,7,432,16833504.333333332,174.0,61.71428571428572,7,432,16834483.5,174.0,61.71428571428572
107553.0,17,2,700,2,700,0.0,350.0,350.0,0,0,0.0,0.0,0.0
320412.0,17,4,1400,4,1400,106804.0,350.0,350.0,0,0,0.0,0.0,0.0
316003.0,17,4,1400,4,1400,105334.33333333331,350.0,350.0,0,0,0.0,0.0,0.0
77850.0,6,14,4740,7,653,10702.666666666666,249.0,93.28571428571428,7,4087,11626.833333333334,1514.0,583.8571428571429
1190127.0,6,13,3017,8,2389,170018.14285714287,1514.0,298.625,5,628,228656.5,331.0,125.6
3005689.0,6,12,2172,7,664,500783.3333333333,252.0,94.85714285714286,5,1508,1743.0,1236.0,301.6
135135476.0,17,6,1146,6,1146,27027095.2,191.0,191.0,0,0,0.0,0.0,0.0
6652414.0,6,6,470,2,132,0.0,66.0,66.0,4,338,2217471.333333333,103.0,84.5
33584.0,6,14,4740,7,653,5315.166666666667,249.0,93.28571428571428,7,4087,5239.5,1514.0,583.8571428571429
74465.0,6,14,4740,7,653,11082.333333333334,249.0,93.28571428571428,7,4087,11948.833333333334,1514.0,583.8571428571429
44077.0,6,10,2032,5,524,9917.25,252.0,104.8,5,1508,10746.25,1236.0,301.6
341.0,17,2,168,1,76,0.0,76.0,76.0,1,92,0.0,92.0,92.0
108780188.0,6,25,1983,12,1086,9887229.454545457,256.0,90.5,13,897,9064379.5,95.0,69.0
58886716.0,17,9,3086,8,2736,5108856.571428572,342.0,342.0,1,350,0.0,350.0,350.0
121101072.0,6,238,26882,119,8076,1011507.3389830508,140.0,67.8655462184874,119,18806,1011531.593220339,284.0,158.03361344537817
216978.0,6,3,426,2,280,0.0,214.0,140.0,1,146,0.0,146.0,146.0
302388.0,6,2,132,1,66,0.0,66.0,66.0,1,66,0.0,66.0,66.0
317724.0,17,4,1400,4,1400,105908.0,350.0,350.0,0,0,0.0,0.0,0.0
302211.0,6,6,412,4,272,100737.0,74.0,68.0,2,140,0.0,74.0,70.0
217005.0,6,3,426,2,280,0.0,214.0,140.0,1,146,0.0,146.0,146.0
228721.0,17,2,180,1,90,0.0,90.0,90.0,1,90,0.0,90.0,90.0
318905.0,6,3,202,2,128,0.0,74.0,64.0,1,74,0.0,74.0,74.0
41580.0,6,14,4740,7,653,6692.166666666667,249.0,93.28571428571428,7,4087,6361.166666666667,1514.0,583.8571428571429
2137780.0,6,25,7610,13,2516,178148.33333333334,1034.0,193.53846153846155,12,5094,166527.54545454544,1510.0,424.5
18487.0,6,2,145,2,145,0.0,91.0,72.5,0,0,0.0,0.0,0.0
246111.0,6,3,373,2,238,0.0,172.0,119.0,1,135,0.0,135.0,135.0
298196.0,6,6,412,4,272,99398.66666666669,74.0,68.0,2,140,0.0,74.0,70.0
43189.0,6,14,4740,7,653,6356.5,249.0,93.28571428571428,7,4087,5626.0,1514.0,583.8571428571429
17761.0,6,11,2098,6,590,3389.6,252.0,98.33333333333331,5,1508,4126.25,1236.0,301.6
17099.0,6,19,7540,11,978,1709.9,310.0,88.9090909090909,8,6562,2136.428571428572,1514.0,820.25
139668.0,17,4,1400,4,1400,46556.0,350.0,350.0,0,0,0.0,0.0,0.0
21566.0,6,10,2032,5,524,5173.75,252.0,104.8,5,1508,4783.0,1236.0,301.6
144087.0,17,2,180,1,90,0.0,90.0,90.0,1,90,0.0,90.0,90.0
241941.0,6,3,337,2,214,0.0,160.0,107.0,1,123,0.0,123.0,123.0
47479.0,6,14,4740,7,653,7672.166666666667,249.0,93.28571428571428,7,4087,6801.333333333333,1514.0,583.8571428571429
2353.0,17,4,344,2,150,0.0,75.0,75.0,2,194,0.0,103.0,97.0
5627227.0,6,5,336,2,134,0.0,68.0,67.0,3,202,1522906.5,70.0,67.33333333333333
0.0,17,1,100,1,100,0.0,100.0,100.0,0,0,0.0,0.0,0.0
108104124.0,17,5,1005,5,1005,27026031.0,201.0,201.0,0,0,0.0,0.0,0.0
306672.0,6,6,412,4,272,102224.0,74.0,68.0,2,140,0.0,74.0,70.0
114247041.0,6,48,3168,24,1584,4967262.652173913,66.0,66.0,24,1584,4957867.173913044,66.0,66.0
146050.0,6,3,337,2,214,0.0,160.0,107.0,1,123,0.0,123.0,123.0
729.0,17,4,438,2,148,0.0,74.0,74.0,2,290,0.0,147.0,145.0
3059.0,17,4,344,2,150,0.0,75.0,75.0,2,194,0.0,103.0,97.0
120124574.0,6,14,2224,9,1204,15015571.75,188.0,133.77777777777777,5,1020,22523437.25,204.0,204.0
205948.0,6,3,426,2,280,0.0,214.0,140.0,1,146,0.0,146.0,146.0
111060376.0,6,32,2236,16,1165,7389623.4,139.0,72.8125,16,1071,7389624.466666667,123.0,66.9375
108106833.0,17,5,1005,5,1005,27026708.25,201.0,201.0,0,0,0.0,0.0,0.0
244466.0,6,3,337,2,214,0.0,160.0,107.0,1,123,0.0,123.0,123.0
43152.0,6,14,4740,7,653,7022.333333333333,249.0,93.28571428571428,7,4087,6350.833333333333,1514.0,583.8571428571429
247291.0,6,3,373,2,238,0.0,172.0,119.0,1,135,0.0,135.0,135.0
104594.0,17,2,286,2,286,0.0,143.0,143.0,0,0,0.0,0.0,0.0
0.0,17,1,72,1,72,0.0,72.0,72.0,0,0,0.0,0.0,0.0
11385.0,6,10,1067,5,536,2681.25,264.0,107.2,5,531,2642.75,259.0,106.2
12656.0,6,11,1132,6,556,2180.2,218.0,92.66666666666669,5,576,2827.0,304.0,115.2
5077.0,17,2,762,2,762,0.0,381.0,381.0,0,0,0.0,0.0,0.0
22577.0,6,13,1459,7,862,3605.8333333333335,271.0,123.14285714285714,6,597,4249.6,259.0,99.5
509466.0,6,5,336,2,134,0.0,68.0,67.0,3,202,196336.5,70.0,67.33333333333333
108108099.0,17,5,955,5,955,27027024.75,191.0,191.0,0,0,0.0,0.0,0.0
21715.0,17,2,180,1,90,0.0,90.0,90.0,1,90,0.0,90.0,90.0
941736.0,6,12,1362,6,731,187192.0,253.0,121.83333333333331,6,631,187359.4,293.0,105.16666666666669
26562.0,6,14,4740,7,653,4137.0,249.0,93.28571428571428,7,4087,4293.666666666667,1514.0,583.8571428571429
52741.0,6,14,4740,7,653,7794.833333333333,249.0,93.28571428571428,7,4087,8193.166666666666,1514.0,583.8571428571429
504358.0,6,5,336,2,134,0.0,68.0,67.0,3,202,193910.5,70.0,67.33333333333333
103566394.0,6,34,2742,19,1518,5741352.166666667,123.0,79.89473684210526,15,1224,7381744.571428572,123.0,81.6
1031271.0,6,11,1134,6,558,206254.2,220.0,93.0,5,576,256774.0,304.0,115.2
206058.0,6,3,426,2,280,0.0,214.0,140.0,1,146,0.0,146.0,146.0
44534.0,6,14,4740,7,653,7288.5,249.0,93.28571428571428,7,4087,7284.333333333333,1514.0,583.8571428571429
94903699.0,6,265,32004,133,23070,718967.4166666666,390.0,173.45864661654136,132,8934,716634.465648855,140.0,67.68181818181819
15594.0,6,12,1393,6,796,2971.6,271.0,132.66666666666666,6,597,2606.0,259.0,99.5
109445.0,17,2,286,2,286,0.0,143.0,143.0,0,0,0.0,0.0,0.0
90290389.0,6,16,1192,8,596,12891565.0,95.0,74.5,8,596,12898248.714285716,95.0,74.5
90695580.0,6,21,1585,10,745,10077286.666666666,95.0,74.5,11,840,9043459.5,95.0,76.36363636363636
25224.0,6,10,2032,5,524,5584.25,252.0,104.8,5,1508,6020.75,1236.0,301.6
4308.0,17,2,602,1,72,0.0,72.0,72.0,1,530,0.0,530.0,530.0
223674.0,17,2,180,1,90,0.0,90.0,90.0,1,90,0.0,90.0,90.0
2804790.0,6,2,132,1,66,0.0,66.0,66.0,1,66,0.0,66.0,66.0
209882.0,6,10,1221,6,636,41976.4,298.0,106.0,4,585,68857.0,379.0,146.25
2298.0,17,4,344,2,150,0.0,75.0,75.0,2,194,0.0,103.0,97.0
6785.0,17,2,582,1,83,0.0,83.0,83.0,1,499,0.0,499.0,499.0
314.0,17,2,160,1,80,0.0,80.0,80.0,1,80,0.0,80.0,80.0
21075.0,6,11,2098,6,590,3602.4,252.0,98.33333333333331,5,1508,4926.25,1236.0,301.6
16413930.0,6,30,9635,16,2457,1094262.0,408.0,153.5625,14,7178,1004994.0769230768,1514.0,512.7142857142857
412596.0,6,10,1221,6,636,82519.2,298.0,106.0,4,585,129807.66666666669,379.0,146.25
10916871.0,6,8,544,4,272,3593746.0,74.0,68.0,4,272,3593668.0,74.0,68.0
315245.0,17,4,1400,4,1400,105081.66666666669,350.0,350.0,0,0,0.0,0.0,0.0
121809.0,6,3,337,2,214,0.0,160.0,107.0,1,123,0.0,123.0,123.0
113618887.0,6,46,3036,23,1518,5150435.863636363,66.0,66.0,23,1518,5150440.2727272725,66.0,66.0
2801351.0,6,2,132,1,66,0.0,66.0,66.0,1,66,0.0,66.0,66.0
90042715.0,17,28,13364,28,13364,3334915.3703703703,501.0,477.2857142857143,0,0,0.0,0.0,0.0
113618070.0,6,46,3036,23,1518,5150438.909090909,66.0,66.0,23,1518,5150432.181818182,66.0,66.0
135116356.0,17,6,1206,6,1206,27023271.2,201.0,201.0,0,0,0.0,0.0,0.0
2544.0,17,4,344,2,150,0.0,75.0,75.0,2,194,0.0,103.0,97.0
119619504.0,6,220,24868,110,17312,1095440.2201834864,284.0,157.38181818181818,110,7556,1095439.880733945,140.0,68.69090909090909
21061.0,6,14,4740,7,653,2226.333333333333,249.0,93.28571428571428,7,4087,3350.0,1514.0,583.8571428571429
115096437.0,17,14,864,7,432,19168247.83333333,174.0,61.71428571428572,7,432,19166860.666666668,174.0,61.71428571428572
97838153.0,6,40,2640,20,1320,5149376.47368421,66.0,66.0,20,1320,5132832.105263158,66.0,66.0
135148663.0,17,6,1206,6,1206,27029732.6,201.0,201.0,0,0,0.0,0.0,0.0
49697.0,6,14,4740,7,653,8159.5,249.0,93.28571428571428,7,4087,7311.166666666667,1514.0,583.8571428571429
27303.0,6,10,2032,5,524,6586.0,252.0,104.8,5,1508,5917.75,1236.0,301.6
120189900.0,6,639,99288,320,77790,376095.84952978056,1514.0,243.09375,319,21498,377278.320754717,214.0,67.39184952978056
106411857.0,17,14,864,7,432,17735309.5,174.0,61.71428571428572,7,432,17669747.666666668,174.0,61.71428571428572
4351.0,17,2,598,1,72,0.0,72.0,72.0,1,526,0.0,526.0,526.0
107905.0,17,2,286,2,286,0.0,143.0,143.0,0,0,0.0,0.0,0.0
4595306.0,6,5,336,2,134,0.0,68.0,67.0,3,202,1423690.5,70.0,67.33333333333333
2689667.0,6,2,132,1,66,0.0,66.0,66.0,1,66,0.0,66.0,66.0
206032.0,17,2,180,1,90,0.0,90.0,90.0,1,90,0.0,90.0,90.0
8815.0,17,2,498,1,80,0.0,80.0,80.0,1,418,0.0,418.0,418.0
2802472.0,6,2,132,1,66,0.0,66.0,66.0,1,66,0.0,66.0,66.0
153677.0,17,2,180,1,90,0.0,90.0,90.0,1,90,0.0,90.0,90.0
148157.0,17,2,180,1,90,0.0,90.0,90.0,1,90,0.0,90.0,90.0
2050.0,17,4,344,2,150,0.0,75.0,75.0,2,194,0.0,103.0,97.0
96203839.0,17,12,778,6,389,19200183.2,174.0,64.83333333333333,6,389,19200862.2,174.0,64.83333333333333
2423.0,17,4,344,2,150,0.0,75.0,75.0,2,194,0.0,103.0,97.0
606581.0,17,6,1230,3,234,303103.5,78.0,78.0,3,996,303086.0,332.0,332.0
303575.0,6,2,132,1,66,0.0,66.0,66.0,1,66,0.0,66.0,66.0
364.0,17,2,267,1,83,0.0,83.0,83.0,1,184,0.0,184.0,184.0
67414.0,6,10,2032,5,524,16149.25,252.0,104.8,5,1508,14107.0,1236.0,301.6
91066678.0,6,33,2412,17,1272,5678885.9375,123.0,74.82352941176471,16,1140,6057448.533333333,123.0,71.25
6490.0,17,2,582,1,83,0.0,83.0,83.0,1,499,0.0,499.0,499.0
87835.0,6,12,1413,7,882,14639.166666666666,291.0,126.0,5,531,18132.0,259.0,106.2
298845.0,6,6,412,4,272,99615.0,74.0,68.0,2,140,0.0,74.0,70.0
121108107.0,6,47,3102,23,1518,5143991.954545454,66.0,66.0,24,1584,5265558.652173913,66.0,66.0
108100955.0,17,5,1005,5,1005,27025238.75,201.0,201.0,0,0,0.0,0.0,0.0
339.0,17,2,166,1,75,0.0,75.0,75.0,1,91,0.0,91.0,91.0
117646088.0,6,222,25118,111,17558,1067553.472727273,284.0,158.18018018018017,111,7560,1067552.0727272728,140.0,68.10810810810811
105001068.0,6,44,2904,22,1452,5000050.857142857,66.0,66.0,22,1452,4986932.619047619,66.0,66.0
219654.0,6,3,426,2,280,0.0,214.0,140.0,1,146,0.0,146.0,146.0
12062.0,17,4,823,2,163,0.0,89.0,81.5,2,660,0.0,443.0,330.0
91108498.0,6,24,1829,11,840,9110849.8,95.0,76.36363636363636,13,989,7571689.416666667,95.0,76.07692307692308
17040.0,6,10,1067,5,536,4096.75,264.0,107.2,5,531,2731.75,259.0,106.2
90533352.0,6,14,2240,8,1016,12933336.0,188.0,127.0,6,1224,18072244.8,204.0,204.0
812.0,17,2,762,2,762,0.0,381.0,381.0,0,0,0.0,0.0,0.0
228162.0,17,2,180,1,90,0.0,90.0,90.0,1,90,0.0,90.0,90.0
9517.0,17,2,582,1,83,0.0,83.0,83.0,1,499,0.0,499.0,499.0
113634839.0,6,34,2350,17,1225,7088689.6875,139.0,72.05882352941177,17,1125,7088657.75,123.0,66.17647058823529
10464900.0,6,7,478,4,272,3442693.6666666665,74.0,68.0,3,206,5163926.5,74.0,68.66666666666667
118816.0,17,4,1400,4,1400,39605.333333333336,350.0,350.0,0,0,0.0,0.0,0.0
57250.0,6,12,1447,6,816,10386.0,291.0,136.0,6,631,10565.4,293.0,105.16666666666669
105589.0,17,2,762,2,762,0.0,381.0,381.0,0,0,0.0,0.0,0.0
2641827.0,6,51,23848,26,19851,105673.08,1514.0,763.5,25,3997,101278.95833333331,1514.0,159.88
120692.0,6,3,337,2,214,0.0,160.0,107.0,1,123,0.0,123.0,123.0
120095268.0,6,236,26734,118,8084,1020421.3247863248,140.0,68.50847457627118,118,18650,1019089.4615384616,284.0,158.05084745762713
16734.0,6,14,4740,7,653,2564.0,249.0,93.28571428571428,7,4087,2526.833333333333,1514.0,583.8571428571429
120119145.0,6,12,1832,8,1016,17136950.14285714,188.0,127.0,4,816,30031053.33333333,204.0,204.0
103554.0,17,2,286,2,286,0.0,143.0,143.0,0,0,0.0,0.0,0.0
90292106.0,6,17,2434,9,1204,11286513.25,188.0,133.77777777777777,8,1230,12875292.857142856,204.0,153.75
108103921.0,17,5,955,5,955,27025980.25,191.0,191.0,0,0,0.0,0.0,0.0
502548.0,6,5,336,2,134,0.0,68.0,67.0,3,202,194112.0,70.0,67.33333333333333
2842355.0,6,12,2172,7,664,473582.3333333333,252.0,94.85714285714286,5,1508,2225.0,1236.0,301.6
8708.0,17,4,823,2,163,0.0,89.0,81.5,2,660,0.0,443.0,330.0
494128.0,6,2,145,2,145,0.0,91.0,72.5,0,0,0.0,0.0,0.0
113009095.0,6,36,2734,19,1471,6266288.5,139.0,77.42105263157895,17,1263,7049574.5625,123.0,74.29411764705883
107741.0,17,2,286,2,286,0.0,143.0,143.0,0,0,0.0,0.0,0.0
110153348.0,6,28,1860,14,966,8456730.76923077,123.0,69.0,14,894,8456718.307692308,123.0,63.85714285714285
1023944.0,6,11,1134,6,558,204788.8,220.0,93.0,5,576,254109.5,304.0,115.2
22748.0,6,14,4740,7,653,3584.5,249.0,93.28571428571428,7,4087,3646.6666666666665,1514.0,583.8571428571429
25968.0,6,14,4740,7,653,4165.5,249.0,93.28571428571428,7,4087,3685.0,1514.0,583.8571428571429
815.0,17,5,550,5,550,203.75,110.0,110.0,0,0,0.0,0.0,0.0
98580717.0,6,28,2146,15,1168,7041479.785714285,139.0,77.86666666666666,13,978,8197986.083333333,123.0,75.23076923076923
303137.0,6,2,132,1,66,0.0,66.0,66.0,1,66,0.0,66.0,66.0
2484.0,17,4,344,2,150,0.0,75.0,75.0,2,194,0.0,103.0,97.0
318456.0,17,4,1400,4,1400,106152.0,350.0,350.0,0,0,0.0,0.0,0.0
98334820.0,17,12,778,6,389,19601066.0,174.0,64.83333333333333,6,389,19600165.6,174.0,64.83333333333333
216960.0,6,3,426,2,280,0.0,214.0,140.0,1,146,0.0,146.0,146.0
962285.0,17,10,3736,10,3736,106920.55555555556,390.0,373.6,0,0,0.0,0.0,0.0
834965.0,6,9,1118,6,586,166993.0,248.0,97.66666666666669,3,532,279707.0,392.0,177.33333333333334
2378.0,17,4,344,2,150,0.0,75.0,75.0,2,194,0.0,103.0,97.0
90254488.0,6,15,2168,8,1016,12893498.285714284,188.0,127.0,7,1152,15015565.333333334,204.0,164.57142857142858
120236165.0,6,18,1341,9,691,14999996.25,95.0,76.77777777777777,9,650,14999958.5,95.0,72.22222222222223
120001013.0,17,14,864,7,432,20000168.83333333,174.0,61.71428571428572,7,432,16667768.5,174.0,61.71428571428572
2123.0,17,4,344,2,150,0.0,75.0,75.0,2,194,0.0,103.0,97.0
962044.0,6,12,1354,6,723,190264.4,253.0,120.5,6,631,191497.2,293.0,105.16666666666669
207131.0,6,3,426,2,280,0.0,214.0,140.0,1,146,0.0,146.0,146.0
196868.0,17,2,180,1,90,0.0,90.0,90.0,1,90,0.0,90.0,90.0
47614537.0,6,7,1872,3,886,22453325.5,752.0,295.3333333333333,4,986,15015067.333333334,784.0,246.5
37483.0,6,14,4740,7,653,5514.333333333333,249.0,93.28571428571428,7,4087,6122.333333333333,1514.0,583.8571428571429
217728.0,6,3,426,2,280,0.0,214.0,140.0,1,146,0.0,146.0,146.0
10850385.0,6,8,544,4,272,3571083.333333333,74.0,68.0,4,272,3571005.0,74.0,68.0
10858923.0,6,8,544,4,272,3572649.333333333,74.0,68.0,4,272,3572584.0,74.0,68.0
105000997.0,17,13,821,7,432,17500166.166666668,174.0,61.71428571428572,6,389,17001436.8,174.0,64.83333333333333
103518500.0,17,14,864,7,432,17226251.5,174.0,61.71428571428572,7,432,17251802.666666668,174.0,61.71428571428572
36971.0,6,10,2032,5,524,9029.5,252.0,104.8,5,1508,8316.5,1236.0,301.6
116259853.0,6,48,3168,24,1584,5054776.217391305,66.0,66.0,24,1584,5041680.695652174,66.0,66.0
2286.0,17,2,508,2,508,0.0,257.0,254.0,0,0,0.0,0.0,0.0
239832.0,6,3,373,2,238,0.0,172.0,119.0,1,135,0.0,135.0,135.0
746803.0,6,2,132,1,66,0.0,66.0,66.0,1,66,0.0,66.0,66.0
13618688.0,6,21,1700,11,1068,1330775.0,315.0,97.0909090909091,10,632,1478611.6666666667,78.0,63.2
318.0,17,2,166,1,75,0.0,75.0,75.0,1,91,0.0,91.0,91.0
3776816.0,6,5,336,2,134,0.0,68.0,67.0,3,202,1524290.0,70.0,67.33333333333333
322006.0,17,4,1400,4,1400,107335.33333333331,350.0,350.0,0,0,0.0,0.0,0.0
120380390.0,6,33,2296,17,1225,7523774.375,139.0,72.05882352941177,16,1071,7345357.333333333,123.0,66.9375
120212097.0,6,18,1341,9,691,14999494.0,95.0,76.77777777777777,9,650,14999487.75,95.0,72.22222222222223
120004905.0,6,20,1490,10,745,13333878.333333334,95.0,74.5,10,745,13302612.555555556,95.0,74.5
137290.0,17,2,192,1,88,0.0,88.0,88.0,1,104,0.0,104.0,104.0
108107990.0,17,5,955,5,955,27026997.5,191.0,191.0,0,0,0.0,0.0,0.0
528077.0,6,3,204,1,68,0.0,68.0,68.0,2,136,0.0,70.0,68.0
39472.0,6,14,4740,7,653,6401.666666666667,249.0,93.28571428571428,7,4087,6198.5,1514.0,583.8571428571429
12486.0,6,10,1065,5,534,2924.0,262.0,106.8,5,531,2775.5,259.0,106.2
83510525.0,17,14,4796,13,4446,6222177.416666667,342.0,342.0,1,350,0.0,350.0,350.0
38050.0,6,14,4740,7,653,5838.833333333333,249.0,93.28571428571428,7,4087,5685.166666666667,1514.0,583.8571428571429
29812.0,6,14,4740,7,653,4517.833333333333,249.0,93.28571428571428,7,4087,4811.833333333333,1514.0,583.8571428571429
667756.0,6,10,1124,6,608,133551.2,222.0,101.33333333333331,4,516,140749.33333333334,206.0,129.0
308072.0,6,6,412,4,272,102690.66666666669,74.0,68.0,2,140,0.0,74.0,70.0
120000042.0,6,24,1870,13,1030,10000003.5,95.0,79.23076923076923,11,840,9176710.6,95.0,76.36363636363636
5631918.0,6,5,336,2,134,0.0,68.0,67.0,3,202,1529708.5,70.0,67.33333333333333
129806051.0,6,35,2394,18,1269,7635650.05882353,123.0,70.5,17,1125,7475300.6875,123.0,66.17647058823529
298709.0,6,6,412,4,272,99569.66666666669,74.0,68.0,2,140,0.0,74.0,70.0
90256338.0,6,13,2036,8,1016,12893762.57142857,188.0,127.0,5,1020,22523442.25,204.0,204.0
217675.0,6,3,426,2,280,0.0,214.0,140.0,1,146,0.0,146.0,146.0
299113.0,6,6,412,4,272,99704.33333333331,74.0,68.0,2,140,0.0,74.0,70.0
202681.0,17,4,6056,4,6056,67560.33333333333,1514.0,1514.0,0,0,0.0,0.0,0.0
90050947.0,17,28,13364,28,13364,3335220.25925926,501.0,477.2857142857143,0,0,0.0,0.0,0.0
303752.0,6,6,412,4,272,101250.66666666669,74.0,68.0,2,140,0.0,74.0,70.0
318.0,17,2,174,1,79,0.0,79.0,79.0,1,95,0.0,95.0,95.0
35841.0,6,14,4740,7,653,5817.833333333333,249.0,93.28571428571428,7,4087,5569.666666666667,1514.0,583.8571428571429
97426328.0,17,14,1126,7,563,16166814.833333334,174.0,80.42857142857143,7,563,16167521.666666666,174.0,80.42857142857143
23908.0,6,14,4740,7,653,3832.1666666666665,249.0,93.28571428571428,7,4087,3841.0,1514.0,583.8571428571429
2430.0,17,4,344,2,150,0.0,75.0,75.0,2,194,0.0,103.0,97.0
7803.0,17,4,344,2,150,0.0,75.0,75.0,2,194,0.0,103.0,97.0
2431.0,17,4,344,2,150,0.0,75.0,75.0,2,194,0.0,103.0,97.0
419734.0,6,10,1221,6,636,83946.8,298.0,106.0,4,585,138200.0,379.0,146.25
247081.0,6,3,337,2,214,0.0,160.0,107.0,1,123,0.0,123.0,123.0
119469633.0,6,223,25262,112,17640,1076303.0,284.0,157.5,111,7622,1076678.681818182,140.0,68.66666666666667
93088228.0,6,176,19904,88,13948,1067506.4367816092,284.0,158.5,88,5956,1067506.8620689656,140.0,67.68181818181819
44615.0,6,14,4740,7,653,7267.833333333333,249.0,93.28571428571428,7,4087,5708.833333333333,1514.0,583.8571428571429
26022.0,6,14,4740,7,653,4222.833333333333,249.0,93.28571428571428,7,4087,4201.0,1514.0,583.8571428571429
108108503.0,17,5,1005,5,1005,27027125.75,201.0,201.0,0,0,0.0,0.0,0.0
39787.0,6,14,4740,7,653,6510.666666666667,249.0,93.28571428571428,7,4087,5824.0,1514.0,583.8571428571429
2430.0,17,4,344,2,150,0.0,75.0,75.0,2,194,0.0,103.0,97.0
90653.0,6,14,4740,7,653,14552.166666666666,249.0,93.28571428571428,7,4087,8722.166666666666,1514.0,583.8571428571429
40885.0,6,14,4740,7,653,6473.0,249.0,93.28571428571428,7,4087,6674.333333333333,1514.0,583.8571428571429
1215027.0,6,13,3010,8,2382,173575.2857142857,1514.0,297.75,5,628,234736.25,331.0,125.6
57448.0,6,14,4740,7,653,8564.5,249.0,93.28571428571428,7,4087,9436.833333333334,1514.0,583.8571428571429
99186.0,17,2,762,2,762,0.0,381.0,381.0,0,0,0.0,0.0,0.0
60767.0,6,14,4740,7,653,9632.833333333334,249.0,93.28571428571428,7,4087,9123.333333333334,1514.0,583.8571428571429
146978.0,6,3,373,2,238,0.0,172.0,119.0,1,135,0.0,135.0,135.0
129495.0,6,2,132,1,66,0.0,66.0,66.0,1,66,0.0,66.0,66.0
37344.0,6,13,1459,7,862,6028.333333333333,271.0,123.14285714285714,6,597,3385.8,259.0,99.5
103115.0,17,2,286,2,286,0.0,143.0,143.0,0,0,0.0,0.0,0.0
207308.0,6,3,426,2,280,0.0,214.0,140.0,1,146,0.0,146.0,146.0
103333839.0,6,44,2904,22,1452,4920659.0,66.0,66.0,22,1452,4910364.19047619,66.0,66.0
233229.0,6,3,337,2,214,0.0,160.0,107.0,1,123,0.0,123.0,123.0
213583.0,17,2,180,1,90,0.0,90.0,90.0,1,90,0.0,90.0,90.0
318290.0,17,4,1400,4,1400,106096.66666666669,350.0,350.0,0,0,0.0,0.0,0.0
369.0,17,2,267,1,83,0.0,83.0,83.0,1,184,0.0,184.0,184.0
123310589.0,6,48,3168,24,1584,4985064.304347826,66.0,66.0,24,1584,5304250.956521739,66.0,66.0
144991.0,17,2,180,1,70,0.0,70.0,70.0,1,110,0.0,110.0,110.0
46911.0,6,10,2032,5,524,11465.25,252.0,104.8,5,1508,10948.25,1236.0,301.6
135133441.0,17,6,1146,6,1146,27026688.2,191.0,191.0,0,0,0.0,0.0,0.0
27338.0,6,14,4740,7,653,3036.333333333333,249.0,93.28571428571428,7,4087,4370.833333333333,1514.0,583.8571428571429
13981133.0,17,6,2052,6,2052,2796226.6,342.0,342.0,0,0,0.0,0.0,0.0
3168.0,17,4,344,2,150,0.0,75.0,75.0,2,194,0.0,103.0,97.0
98686.0,17,2,762,2,762,0.0,381.0,381.0,0,0,0.0,0.0,0.0
219445.0,6,3,426,2,280,0.0,214.0,140.0,1,146,0.0,146.0,146.0
142795.0,17,4,6056,4,6056,47598.333333333336,1514.0,1514.0,0,0,0.0,0.0,0.0
108094199.0,17,5,955,5,955,27023549.75,191.0,191.0,0,0,0.0,0.0,0.0
209646.0,17,2,180,1,90,0.0,90.0,90.0,1,90,0.0,90.0,90.0
2485001.0,6,25,7609,13,2516,207083.41666666663,1034.0,193.53846153846155,12,5093,198561.8181818181,1510.0,424.4166666666667
330.0,17,2,166,1,75,0.0,75.0,75.0,1,91,0.0,91.0,91.0
0.0,17,1,350,1,350,0.0,350.0,350.0,0,0,0.0,0.0,0.0
263703.0,6,3,337,2,214,0.0,160.0,107.0,1,123,0.0,123.0,123.0
4386.0,17,4,625,2,163,0.0,89.0,81.5,2,462,0.0,245.0,231.0
120035777.0,17,29,13785,29,13785,4286992.035714285,501.0,475.3448275862069,0,0,0.0,0.0,0.0
99724653.0,17,17,5822,16,5472,5318670.533333333,342.0,342.0,1,350,0.0,350.0,350.0
60932.0,6,14,4740,7,653,10032.166666666666,249.0,93.28571428571428,7,4087,9054.5,1514.0,583.8571428571429
215095.0,6,3,426,2,280,0.0,214.0,140.0,1,146,0.0,146.0,146.0
1104044.0,6,13,1386,7,789,184007.3333333333,253.0,112.71428571428572,6,597,218592.0,259.0,99.5
4240.0,17,2,626,1,72,0.0,72.0,72.0,1,554,0.0,554.0,554.0
234177.0,6,3,373,2,238,0.0,172.0,119.0,1,135,0.0,135.0,135.0
90042020.0,17,28,13364,28,13364,3334889.6296296297,501.0,477.2857142857143,0,0,0.0,0.0,0.0
33337.0,6,14,4740,7,653,5432.0,249.0,93.28571428571428,7,4087,5273.333333333333,1514.0,583.8571428571429
2025.0,17,4,344,2,150,0.0,75.0,75.0,2,194,0.0,103.0,97.0
91675506.0,6,25,1924,14,1084,7047316.615384615,95.0,77.42857142857143,11,840,9139490.8,95.0,76.36363636363636
402422.0,6,4,508,2,238,0.0,172.0,119.0,2,270,0.0,135.0,135.0
306819.0,6,6,412,4,272,102273.0,74.0,68.0,2,140,0.0,74.0,70.0
146319.0,6,3,337,2,214,0.0,160.0,107.0,1,123,0.0,123.0,123.0
772.0,17,4,438,2,148,0.0,74.0,74.0,2,290,0.0,147.0,145.0
120271549.0,6,285,34114,143,24520,846982.7394366197,300.0,171.46853146853147,142,9594,839170.7446808511,140.0,67.56338028169014
151812.0,17,2,414,1,88,0.0,88.0,88.0,1,326,0.0,326.0,326.0
310.0,17,2,174,1,79,0.0,79.0,79.0,1,95,0.0,95.0,95.0
0.0,17,1,80,1,80,0.0,80.0,80.0,0,0,0.0,0.0,0.0
135136041.0,17,6,1206,6,1206,27027208.2,201.0,201.0,0,0,0.0,0.0,0.0
90291317.0,6,21,1585,11,840,9023871.1,95.0,76.36363636363636,10,745,9999886.222222222,95.0,74.5
317.0,17,2,174,1,79,0.0,79.0,79.0,1,95,0.0,95.0,95.0
2318.0,17,4,344,2,150,0.0,75.0,75.0,2,194,0.0,103.0,97.0
10864444.0,6,8,544,4,272,3576106.6666666665,74.0,68.0,4,272,3576039.333333333,74.0,68.0
153493.0,17,2,180,1,90,0.0,90.0,90.0,1,90,0.0,90.0,90.0
90256147.0,6,12,1832,8,1016,12893735.285714284,188.0,127.0,4,816,30031407.0,204.0,204.0
90256928.0,6,13,2036,8,1016,12893846.857142856,188.0,127.0,5,1020,22523109.25,204.0,204.0
21384.0,6,10,2032,5,524,4698.75,252.0,104.8,5,1508,5001.5,1236.0,301.6
220154.0,6,3,426,2,280,0.0,214.0,140.0,1,146,0.0,146.0,146.0
115390808.0,6,34,2334,17,1209,7198439.1875,123.0,71.11764705882354,17,1125,7198447.25,123.0,66.17647058823529
135127448.0,17,6,1146,6,1146,27025489.6,191.0,191.0,0,0,0.0,0.0,0.0
28993.0,6,10,1065,5,534,6071.25,262.0,106.8,5,531,6897.5,259.0,106.2
153444.0,17,2,180,1,90,0.0,90.0,90.0,1,90,0.0,90.0,90.0
206187.0,6,3,426,2,280,0.0,214.0,140.0,1,146,0.0,146.0,146.0
230363.0,17,2,180,1,90,0.0,90.0,90.0,1,90,0.0,90.0,90.0
115273.0,17,4,1400,4,1400,38424.333333333336,350.0,350.0,0,0,0.0,0.0,0.0
106539.0,17,2,286,2,286,0.0,143.0,143.0,0,0,0.0,0.0,0.0
3508.0,17,4,344,2,150,0.0,75.0,75.0,2,194,0.0,103.0,97.0
40915.0,6,14,4740,7,653,6690.833333333333,249.0,93.28571428571428,7,4087,6537.833333333333,1514.0,583.8571428571429
246073.0,6,3,373,2,238,0.0,172.0,119.0,1,135,0.0,135.0,135.0
2379.0,17,4,344,2,150,0.0,75.0,75.0,2,194,0.0,103.0,97.0
114461250.0,6,48,3168,24,1584,4976576.0869565215,66.0,66.0,24,1584,4964593.652173913,66.0,66.0
11505676.0,17,4,1368,4,1368,3835225.3333333335,342.0,342.0,0,0,0.0,0.0,0.0
5430.0,17,4,344,2,150,0.0,75.0,75.0,2,194,0.0,103.0,97.0
30205.0,6,14,4740,7,653,4912.166666666667,249.0,93.28571428571428,7,4087,4892.666666666667,1514.0,583.8571428571429
207115.0,6,10,1221,6,636,41423.0,298.0,106.0,4,585,67684.33333333333,379.0,146.25
113138051.0,6,702,107974,351,84438,323251.5742857143,1514.0,240.56410256410257,351,23536,320958.8028571429,214.0,67.05413105413105
84.0,17,2,762,2,762,0.0,381.0,381.0,0,0,0.0,0.0,0.0
102286345.0,17,14,864,7,432,17001467.333333332,174.0,61.71428571428572,7,432,17000169.166666668,174.0,61.71428571428572
59234037.0,17,9,3086,8,2736,5176403.571428572,342.0,342.0,1,350,0.0,350.0,350.0
120103145.0,6,224,25328,112,7614,1074564.225225225,140.0,67.98214285714286,112,17714,1074625.945945946,284.0,158.16071428571428
17707.0,6,11,2098,6,590,3155.4,252.0,98.33333333333331,5,1508,3532.5,1236.0,301.6
24183.0,6,14,4740,7,653,3855.0,249.0,93.28571428571428,7,4087,3872.5,1514.0,583.8571428571429
25962.0,6,10,2032,5,524,6264.0,252.0,104.8,5,1508,5680.0,1236.0,301.6
303160.0,6,6,412,4,272,101053.33333333331,74.0,68.0,2,140,0.0,74.0,70.0
23296.0,6,14,4740,7,653,3446.5,249.0,93.28571428571428,7,4087,3061.1666666666665,1514.0,583.8571428571429
809.0,17,2,762,2,762,0.0,381.0,381.0,0,0,0.0,0.0,0.0
312230.0,17,4,1400,4,1400,104076.66666666669,350.0,350.0,0,0,0.0,0.0,0.0
218614.0,6,10,1221,6,636,43722.8,298.0,106.0,4,585,71457.66666666667,379.0,146.25
1037925.0,6,11,1134,6,558,207585.0,220.0,93.0,5,576,258692.5,304.0,115.2
298623.0,6,6,412,4,272,99541.0,74.0,68.0,2,140,0.0,74.0,70.0
117000969.0,17,13,821,7,432,19500161.5,174.0,61.71428571428572,6,389,19400787.8,174.0,64.83333333333333
306889.0,6,6,412,4,272,102296.33333333331,74.0,68.0,2,140,0.0,74.0,70.0
197053.0,17,2,180,1,90,0.0,90.0,90.0,1,90,0.0,90.0,90.0
63507.99999999999,6,14,4740,7,653,10132.833333333334,249.0,93.28571428571428,7,4087,10443.166666666666,1514.0,583.8571428571429
46587.0,6,14,4740,7,653,7389.833333333333,249.0,93.28571428571428,7,4087,7326.833333333333,1514.0,583.8571428571429
36182.0,17,2,582,1,83,0.0,83.0,83.0,1,499,0.0,499.0,499.0
244100.0,6,3,337,2,214,0.0,160.0,107.0,1,123,0.0,123.0,123.0
104000998.0,17,12,1040,7,563,17333499.666666668,174.0,80.42857142857143,5,477,15975922.25,174.0,95.4
9729.0,17,2,571,1,86,0.0,86.0,86.0,1,485,0.0,485.0,485.0
357.0,17,2,160,1,80,0.0,80.0,80.0,1,80,0.0,80.0,80.0
22799.0,6,10,2032,5,524,4993.25,252.0,104.8,5,1508,5128.75,1236.0,301.6
100881858.0,17,14,1126,7,563,16667539.833333334,174.0,80.42857142857143,7,563,16666812.5,174.0,80.42857142857143
121441.0,6,3,337,2,214,0.0,160.0,107.0,1,123,0.0,123.0,123.0
120044244.0,17,29,13785,29,13785,4287294.428571428,501.0,475.3448275862069,0,0,0.0,0.0,0.0
318443.0,6,6,412,4,272,106147.66666666669,74.0,68.0,2,140,0.0,74.0,70.0
90021522.0,17,27,12943,27,12943,3462366.230769231,501.0,479.3703703703704,0,0,0.0,0.0,0.0
243118.0,6,10,1221,6,636,48623.6,298.0,106.0,4,585,80192.33333333333,379.0,146.25
148000.0,17,2,180,1,90,0.0,90.0,90.0,1,90,0.0,90.0,90.0
90043469.0,17,28,13364,28,13364,3334943.296296296,501.0,477.2857142857143,0,0,0.0,0.0,0.0
0.0,17,1,55,1,55,0.0,55.0,55.0,0,0,0.0,0.0,0.0
380.0,17,2,762,2,762,0.0,381.0,381.0,0,0,0.0,0.0,0.0
135124377.0,17,6,1146,6,1146,27024875.4,191.0,191.0,0,0,0.0,0.0,0.0
90015445.0,17,28,13364,28,13364,3333905.3703703703,501.0,477.2857142857143,0,0,0.0,0.0,0.0
304481.0,6,6,412,4,272,101493.66666666669,74.0,68.0,2,140,0.0,74.0,70.0
107401.0,17,2,286,2,286,0.0,143.0,143.0,0,0,0.0,0.0,0.0
102880201.0,6,42,2772,21,1386,5143997.3,66.0,66.0,21,1386,5143996.95,66.0,66.0
63438.99999999999,6,14,4740,7,653,8925.0,249.0,93.28571428571428,7,4087,10425.166666666666,1514.0,583.8571428571429
33146.0,6,14,4740,7,653,3842.3333333333335,249.0,93.28571428571428,7,4087,5383.166666666667,1514.0,583.8571428571429
116001315.0,17,13,821,7,432,19333552.5,174.0,61.71428571428572,6,389,19200170.4,174.0,64.83333333333333
205829.0,17,2,180,1,90,0.0,90.0,90.0,1,90,0.0,90.0,90.0
315511.0,17,4,1400,4,1400,105170.33333333331,350.0,350.0,0,0,0.0,0.0,0.0
2341.0,17,4,344,2,150,0.0,75.0,75.0,2,194,0.0,103.0,97.0
140412.0,6,2,132,1,66,0.0,66.0,66.0,1,66,0.0,66.0,66.0
191297.0,17,2,180,1,90,0.0,90.0,90.0,1,90,0.0,90.0,90.0
100536064.0,17,12,778,6,389,20003227.0,174.0,64.83333333333333,6,389,20075426.8,174.0,64.83333333333333
120456449.0,17,14,1126,7,563,16833491.0,174.0,80.42857142857143,7,563,16834168.5,174.0,80.42857142857143
864794.0,6,10,1162,6,625,172958.8,287.0,104.16666666666669,4,537,197419.3333333333,331.0,134.25
307347.0,6,6,412,4,272,102449.0,74.0,68.0,2,140,0.0,74.0,70.0
44405.0,6,14,4740,7,653,7054.5,249.0,93.28571428571428,7,4087,5834.333333333333,1514.0,583.8571428571429
9314.0,17,2,571,1,86,0.0,86.0,86.0,1,485,0.0,485.0,485.0
316946.0,17,4,1400,4,1400,105648.66666666669,350.0,350.0,0,0,0.0,0.0,0.0
63428913.0,17,11,3770,10,3420,4612693.888888889,342.0,342.0,1,350,0.0,350.0,350.0
858.0,17,4,438,2,148,0.0,74.0,74.0,2,290,0.0,147.0,145.0
90290937.0,6,21,1585,11,840,9024310.6,95.0,76.36363636363636,10,745,9951441.555555556,95.0,74.5
21488.0,6,14,4740,7,653,2851.333333333333,249.0,93.28571428571428,7,4087,3320.5,1514.0,583.8571428571429
112238533.0,6,235,26360,118,8084,959303.7008547008,140.0,68.50847457627118,117,18276,958632.2155172414,284.0,156.2051282051282
148017.0,17,2,180,1,90,0.0,90.0,90.0,1,90,0.0,90.0,90.0
9237.0,17,2,571,1,86,0.0,86.0,86.0,1,485,0.0,485.0,485.0
120695928.0,6,32,2220,16,1071,7380533.466666667,123.0,66.9375,16,1149,7380543.133333334,123.0,71.8125
12253.0,6,10,1066,5,490,2898.75,218.0,98.0,5,576,2203.25,304.0,115.2
37019.0,6,14,4740,7,653,6010.833333333333,249.0,93.28571428571428,7,4087,6031.5,1514.0,583.8571428571429
107094790.0,6,43,2838,22,1452,5099739.80952381,66.0,66.0,21,1386,5151993.7,66.0,66.0
55753.0,6,14,4740,7,653,8414.166666666666,249.0,93.28571428571428,7,4087,8568.5,1514.0,583.8571428571429
147276.0,6,3,373,2,238,0.0,172.0,119.0,1,135,0.0,135.0,135.0
213642.0,17,2,762,2,762,0.0,381.0,381.0,0,0,0.0,0.0,0.0
121227.0,6,3,337,2,214,0.0,160.0,107.0,1,123,0.0,123.0,123.0
1324753.0,6,4,264,2,132,0.0,66.0,66.0,2,132,0.0,66.0,66.0
2427.0,17,4,344,2,150,0.0,75.0,75.0,2,194,0.0,103.0,97.0
90093248.0,6,11,1644,4,816,30029884.0,204.0,204.0,7,828,15015334.666666666,188.0,118.28571428571428
51461.0,6,10,2032,5,524,12613.75,252.0,104.8,5,1508,12236.25,1236.0,301.6
2022.0,17,4,344,2,150,0.0,75.0,75.0,2,194,0.0,103.0,97.0
3005457.0,6,12,2172,7,664,500666.8333333333,252.0,94.85714285714286,5,1508,2037.25,1236.0,301.6
9415.0,17,2,539,1,86,0.0,86.0,86.0,1,453,0.0,453.0,453.0
303704.0,6,2,132,1,66,0.0,66.0,66.0,1,66,0.0,66.0,66.0
408.0,17,2,410,1,78,0.0,78.0,78.0,1,332,0.0,332.0,332.0
247254.0,6,3,373,2,238,0.0,172.0,119.0,1,135,0.0,135.0,135.0
108107543.0,17,5,955,5,955,27026885.75,191.0,191.0,0,0,0.0,0.0,0.0
107096.0,17,2,286,2,286,0.0,143.0,143.0,0,0,0.0,0.0,0.0
2480534.0,6,3,204,1,68,0.0,68.0,68.0,2,136,0.0,70.0,68.0
135135401.0,17,6,1206,6,1206,27027080.2,201.0,201.0,0,0,0.0,0.0,0.0
69663.0,17,2,618,1,74,0.0,74.0,74.0,1,544,0.0,544.0,544.0
361.0,17,2,204,1,88,0.0,88.0,88.0,1,116,0.0,116.0,116.0
332.0,17,2,166,1,75,0.0,75.0,75.0,1,91,0.0,91.0,91.0
10892904.0,6,8,544,4,272,3584382.6666666665,74.0,68.0,4,272,3584318.6666666665,74.0,68.0
6888.0,17,2,582,1,83,0.0,83.0,83.0,1,499,0.0,499.0,499.0
234504.0,6,3,373,2,238,0.0,172.0,119.0,1,135,0.0,135.0,135.0
92917308.0,6,187,21334,94,15048,999110.8387096776,284.0,160.08510638297872,93,6286,998716.0652173914,140.0,67.59139784946237
154.0,17,2,3028,2,3028,0.0,1514.0,1514.0,0,0,0.0,0.0,0.0
27318876.0,17,5,1710,5,1710,6829719.0,342.0,342.0,0,0,0.0,0.0,0.0
120124348.0,6,13,2036,5,1020,30031087.0,204.0,204.0,8,1016,17137013.0,188.0,127.0
108104851.0,17,5,1005,5,1005,27026212.75,201.0,201.0,0,0,0.0,0.0,0.0
5616929.0,6,5,336,2,134,0.0,68.0,67.0,3,202,1522915.5,70.0,67.33333333333333
306514.0,17,4,1524,4,1524,102171.33333333331,381.0,381.0,0,0,0.0,0.0,0.0
33095.0,6,14,4740,7,653,5272.666666666667,249.0,93.28571428571428,7,4087,3914.6666666666665,1514.0,583.8571428571429
22324.0,17,2,180,1,90,0.0,90.0,90.0,1,90,0.0,90.0,90.0
0.0,17,1,350,1,350,0.0,350.0,350.0,0,0,0.0,0.0,0.0
106466562.0,6,32,2220,16,1149,7082971.666666667,123.0,71.8125,16,1071,7082971.866666666,123.0,66.9375
119437402.0,6,271,31902,136,22696,884721.4962962962,284.0,166.88235294117646,135,9206,883552.8805970149,140.0,68.19259259259259
120120556.0,6,12,1832,8,1016,17136885.714285713,188.0,127.0,4,816,30030817.666666668,204.0,204.0
1166348.0,6,13,3010,8,2382,166621.14285714287,1514.0,297.75,5,628,222655.0,331.0,125.6
121493.0,6,3,337,2,214,0.0,160.0,107.0,1,123,0.0,123.0,123.0
458.0,17,2,373,1,86,0.0,86.0,86.0,1,287,0.0,287.0,287.0
893193.0,6,11,2644,7,743,148865.5,339.0,106.14285714285714,4,1901,206872.3333333333,1514.0,475.25
52706.0,6,14,4740,7,653,8628.833333333334,249.0,93.28571428571428,7,4087,8525.166666666666,1514.0,583.8571428571429
5775745.0,17,4,692,2,156,0.0,78.0,78.0,2,536,0.0,268.0,268.0
1213709.0,17,7,490,7,490,202284.8333333333,70.0,70.0,0,0,0.0,0.0,0.0
18976.0,6,14,4740,7,653,2904.833333333333,249.0,93.28571428571428,7,4087,2455.5,1514.0,583.8571428571429
120020806.0,6,21,1585,11,840,11997508.1,95.0,76.36363636363636,10,745,13330665.555555556,95.0,74.5
10538133.0,6,8,602,5,404,1668330.75,103.0,80.8,3,198,2082788.0,66.0,66.0
1029559.0,6,11,1134,6,558,205911.8,220.0,93.0,5,576,256618.25,304.0,115.2
1569789.0,6,2,132,1,66,0.0,66.0,66.0,1,66,0.0,66.0,66.0
27521201.0,17,5,1710,5,1710,6880300.25,342.0,342.0,0,0,0.0,0.0,0.0
65686.0,17,2,180,1,90,0.0,90.0,90.0,1,90,0.0,90.0,90.0
2078139.0,6,18,6803,10,1501,230904.3333333333,408.0,150.1,8,5302,235026.4285714285,1514.0,662.75
1178101.0,6,13,3010,8,2382,168300.14285714287,1514.0,297.75,5,628,225640.25,331.0,125.6
108698499.0,6,32,2220,16,1149,7246566.6,123.0,71.8125,16,1071,7232134.666666667,123.0,66.9375
315546.0,17,4,1400,4,1400,105182.0,350.0,350.0,0,0,0.0,0.0,0.0
234022.0,6,3,373,2,238,0.0,172.0,119.0,1,135,0.0,135.0,135.0
108122907.0,17,5,1005,5,1005,27030726.75,201.0,201.0,0,0,0.0,0.0,0.0
301879.0,17,2,246,1,76,0.0,76.0,76.0,1,170,0.0,170.0,170.0
4346.0,17,2,614,1,72,0.0,72.0,72.0,1,542,0.0,542.0,542.0
325525.0,6,6,412,4,272,108508.33333333331,74.0,68.0,2,140,0.0,74.0,70.0
5725286.0,6,4,270,2,134,0.0,68.0,67.0,2,136,0.0,70.0,68.0
0.0,17,1,55,1,55,0.0,55.0,55.0,0,0,0.0,0.0,0.0
30720.0,6,10,2032,5,524,7395.5,252.0,104.8,5,1508,7333.5,1236.0,301.6
125815488.0,6,55,12100,28,6372,3559727.962962963,1514.0,227.57142857142856,27,5728,4830730.153846154,1514.0,212.14814814814807
38298.0,6,14,4740,7,653,6127.166666666667,249.0,93.28571428571428,7,4087,6243.5,1514.0,583.8571428571429
217515.0,6,3,426,2,280,0.0,214.0,140.0,1,146,0.0,146.0,146.0
14634829.0,6,20,1646,10,1014,1593016.4444444445,315.0,101.4,10,632,1592951.2222222222,78.0,63.2
122291.0,6,3,337,2,214,0.0,160.0,107.0,1,123,0.0,123.0,123.0
108805.0,17,2,286,2,286,0.0,143.0,143.0,0,0,0.0,0.0,0.0
121170675.0,6,224,25524,112,7688,1065831.2612612613,140.0,68.64285714285714,112,17836,1085895.5315315316,336.0,159.25
146291.0,6,3,337,2,214,0.0,160.0,107.0,1,123,0.0,123.0,123.0
152696.0,6,3,373,2,238,0.0,172.0,119.0,1,135,0.0,135.0,135.0
14257.0,6,11,1131,6,600,2603.6,262.0,100.0,5,531,3236.0,259.0,106.2
23668.0,6,10,2032,5,524,5690.75,252.0,104.8,5,1508,5353.75,1236.0,301.6
254484.0,6,3,337,2,214,0.0,160.0,107.0,1,123,0.0,123.0,123.0
237772.0,6,3,337,2,214,0.0,160.0,107.0,1,123,0.0,123.0,123.0
130644664.0,17,14,864,7,432,18500169.666666668,174.0,61.71428571428572,7,432,18501581.0,174.0,61.71428571428572
112274271.0,6,32,2220,16,1149,7484951.4,123.0,71.8125,16,1071,7470519.866666666,123.0,66.9375
262529.0,6,3,337,2,214,0.0,160.0,107.0,1,123,0.0,123.0,123.0
108107731.0,17,5,955,5,955,27026932.75,191.0,191.0,0,0,0.0,0.0,0.0
102209.0,17,2,286,2,286,0.0,143.0,143.0,0,0,0.0,0.0,0.0
22323.0,6,10,2032,5,524,3787.0,252.0,104.8,5,1508,5072.5,1236.0,301.6
135129653.0,17,6,1146,6,1146,27025930.6,191.0,191.0,0,0,0.0,0.0,0.0
10477914.0,6,7,478,4,272,3445350.6666666665,74.0,68.0,3,206,5167922.0,74.0,68.66666666666667
124688317.0,6,35,2473,18,1348,7334606.882352941,139.0,74.88888888888889,17,1125,7188672.25,123.0,66.17647058823529
90523774.0,6,14,2240,8,1016,12931967.714285716,188.0,127.0,6,1224,18072099.4,204.0,204.0
90287094.0,6,16,1192,8,596,12892255.857142856,95.0,74.5,8,596,12897800.714285716,95.0,74.5
81172.0,6,10,2032,5,524,9972.25,252.0,104.8,5,1508,18488.5,1236.0,301.6
48198.0,6,14,4740,7,653,7696.666666666667,249.0,93.28571428571428,7,4087,7885.0,1514.0,583.8571428571429
125009314.0,17,15,907,8,475,17858473.42857143,174.0,59.375,7,432,17460910.666666668,174.0,61.71428571428572
221282.0,6,12,1373,7,714,36880.333333333336,298.0,102.0,5,659,54676.0,379.0,131.8
261045.00000000003,6,10,1221,6,636,52209.0,298.0,106.0,4,585,81181.0,379.0,146.25
3869587.0,6,5,336,2,134,0.0,68.0,67.0,3,202,1425721.5,70.0,67.33333333333333
2054.0,17,4,344,2,150,0.0,75.0,75.0,2,194,0.0,103.0,97.0
39719.0,6,14,4740,7,653,6446.166666666667,249.0,93.28571428571428,7,4087,6314.166666666667,1514.0,583.8571428571429
210721.0,17,2,180,1,90,0.0,90.0,90.0,1,90,0.0,90.0,90.0
15604263.0,6,26,7627,14,3735,207207.84615384616,1514.0,266.7857142857143,12,3892,1398989.4545454546,1514.0,324.3333333333333
27731258.0,17,5,1710,5,1710,6932814.5,342.0,342.0,0,0,0.0,0.0,0.0
322031.0,17,4,1400,4,1400,107343.66666666669,350.0,350.0,0,0,0.0,0.0,0.0
9986.0,17,2,539,1,86,0.0,86.0,86.0,1,453,0.0,453.0,453.0
108726.0,17,4,1400,4,1400,36242.0,350.0,350.0,0,0,0.0,0.0,0.0
143910.0,17,2,180,1,90,0.0,90.0,90.0,1,90,0.0,90.0,90.0
16924.0,6,14,4740,7,653,2272.0,249.0,93.28571428571428,7,4087,2689.333333333333,1514.0,583.8571428571429
51159.0,6,14,4740,7,653,7389.166666666667,249.0,93.28571428571428,7,4087,7988.666666666667,1514.0,583.8571428571429
57973.0,6,14,4740,7,653,9495.833333333334,249.0,93.28571428571428,7,4087,8417.333333333334,1514.0,583.8571428571429
90019978.0,17,28,13364,28,13364,3334073.25925926,501.0,477.2857142857143,0,0,0.0,0.0,0.0
532.0,17,2,508,2,508,0.0,257.0,254.0,0,0,0.0,0.0,0.0
14667487.0,6,20,1607,10,975,1592566.888888889,315.0,97.5,10,632,1592272.4444444445,78.0,63.2
1087254.0,6,13,1394,7,797,181209.0,253.0,113.85714285714286,6,597,216182.2,259.0,99.5
92835298.0,6,181,20398,91,6228,1031503.3111111112,140.0,68.43956043956044,90,14170,1031397.595505618,284.0,157.44444444444446
11010.0,6,12,1393,6,796,2025.4,271.0,132.66666666666666,6,597,1894.6,259.0,99.5
153620.0,17,2,180,1,90,0.0,90.0,90.0,1,90,0.0,90.0,90.0
1649126.0,6,7,499,4,301,545606.0,103.0,75.25,3,198,716875.0,66.0,66.0
308785.0,6,6,412,4,272,102928.33333333331,74.0,68.0,2,140,0.0,74.0,70.0
56294.0,6,12,1320,7,789,9382.333333333334,253.0,112.71428571428572,5,531,10304.5,259.0,106.2
121018002.0,17,15,907,8,475,17288286.0,174.0,59.375,7,432,16833492.5,174.0,61.71428571428572
99603.0,6,10,1949,5,441,12637.0,169.0,88.2,5,1508,24621.75,1236.0,301.6
209354.0,6,3,426,2,280,0.0,214.0,140.0,1,146,0.0,146.0,146.0
129039092.0,17,15,907,8,475,18434156.0,174.0,59.375,7,432,18166833.33333333,174.0,61.71428571428572
3488.0,17,2,359,1,75,0.0,75.0,75.0,1,284,0.0,284.0,284.0
120037552.0,17,29,13785,29,13785,4287055.428571428,501.0,475.3448275862069,0,0,0.0,0.0,0.0
153509.0,17,2,180,1,90,0.0,90.0,90.0,1,90,0.0,90.0,90.0
216509.0,6,3,426,2,280,0.0,214.0,140.0,1,146,0.0,146.0,146.0
43438.0,6,14,4740,7,653,7069.666666666667,249.0,93.28571428571428,7,4087,6652.833333333333,1514.0,583.8571428571429
297.0,17,2,156,1,78,0.0,78.0,78.0,1,78,0.0,78.0,78.0
20010.0,17,2,582,1,83,0.0,83.0,83.0,1,499,0.0,499.0,499.0
34547.0,6,2,145,2,145,0.0,91.0,72.5,0,0,0.0,0.0,0.0
864212.0,6,9,1096,6,625,172842.4,287.0,104.16666666666669,3,471,294511.0,331.0,157.0
2247.0,17,4,344,2,150,0.0,75.0,75.0,2,194,0.0,103.0,97.0
1313805.0,6,4,264,2,132,0.0,66.0,66.0,2,132,0.0,66.0,66.0
309457.0,6,6,412,4,272,103152.33333333331,74.0,68.0,2,140,0.0,74.0,70.0
2427.0,17,4,344,2,150,0.0,75.0,75.0,2,194,0.0,103.0,97.0
25035.0,6,10,2032,5,524,5971.25,252.0,104.8,5,1508,6026.5,1236.0,301.6
866101.0,6,9,1096,6,625,173220.2,287.0,104.16666666666669,3,471,295150.5,331.0,157.0
32749.0,6,13,1386,7,789,5458.166666666667,253.0,112.71428571428572,6,597,6068.6,259.0,99.5
146759.0,6,3,373,2,238,0.0,172.0,119.0,1,135,0.0,135.0,135.0
147233.0,6,3,373,2,238,0.0,172.0,119.0,1,135,0.0,135.0,135.0
21776609.0,6,6,1981,4,1087,7258869.666666667,885.0,271.75,2,894,0.0,826.0,447.0
29370.0,6,10,2032,5,524,7055.25,252.0,104.8,5,1508,6305.25,1236.0,301.6
120038942.0,17,29,13785,29,13785,4287105.071428572,501.0,475.3448275862069,0,0,0.0,0.0,0.0
0.0,6,1,66,1,66,0.0,66.0,66.0,0,0,0.0,0.0,0.0
90645649.0,6,15,2302,9,1204,11316720.5,188.0,133.77777777777777,6,1098,18092376.8,204.0,183.0
260507.0,6,3,337,2,214,0.0,160.0,107.0,1,123,0.0,123.0,123.0
1035518.0,6,11,1134,6,558,207103.60000000003,220.0,93.0,5,576,257661.75,304.0,115.2
135140344.0,17,6,1206,6,1206,27028068.8,201.0,201.0,0,0,0.0,0.0,0.0
9936089.0,17,4,1376,3,1026,15825.5,342.0,342.0,1,350,0.0,350.0,350.0
24958.0,6,10,2032,5,524,5300.5,252.0,104.8,5,1508,5470.5,1236.0,301.6
2516.0,17,4,344,2,150,0.0,75.0,75.0,2,194,0.0,103.0,97.0
157297.0,6,3,337,2,214,0.0,160.0,107.0,1,123,0.0,123.0,123.0
122770196.0,6,36,2533,18,1248,6634344.352941177,123.0,69.33333333333333,18,1285,7221693.470588235,139.0,71.38888888888889
90094880.0,6,11,1644,4,816,30030851.666666668,204.0,204.0,7,828,15015432.5,188.0,118.28571428571428
90207754.0,6,16,1192,8,596,12852747.42857143,95.0,74.5,8,596,12857585.42857143,95.0,74.5
16174.0,6,14,4740,7,653,2423.1666666666665,249.0,93.28571428571428,7,4087,2557.5,1514.0,583.8571428571429
116000963.0,17,15,1169,8,606,16571566.142857144,174.0,75.75,7,563,17520465.333333332,174.0,80.42857142857143
120494276.0,17,14,864,7,432,19890334.83333333,174.0,61.71428571428572,7,432,20055897.33333333,174.0,61.71428571428572
135128040.0,17,6,1146,6,1146,27025608.0,191.0,191.0,0,0,0.0,0.0,0.0
3119.0,17,2,224,1,76,0.0,76.0,76.0,1,148,0.0,148.0,148.0
441523.0,6,10,967,5,390,74350.75,162.0,78.0,5,577,74282.75,349.0,115.4
90052034.0,17,28,13364,28,13364,3335260.5185185187,501.0,477.2857142857143,0,0,0.0,0.0,0.0
33263.0,6,13,1479,7,882,5543.833333333333,291.0,126.0,6,597,5526.6,259.0,99.5
1831425.0,6,19,7533,10,1403,203491.66666666663,583.0,140.3,9,6130,197364.25,1484.0,681.1111111111111
120101140.0,6,514,92034,257,74554,468304.4765625,1514.0,290.0933852140078,257,17480,468304.43359375,214.0,68.01556420233463
90258992.0,6,12,1832,8,1016,12894141.714285716,188.0,127.0,4,816,30032062.0,204.0,204.0
20429.0,6,14,4740,7,653,3200.6666666666665,249.0,93.28571428571428,7,4087,3269.5,1514.0,583.8571428571429
90087682.0,6,10,1440,7,828,15014613.666666666,188.0,118.28571428571428,3,612,30029258.5,204.0,204.0
96000678.0,17,11,735,6,389,19200135.6,174.0,64.83333333333333,5,346,19000906.75,174.0,69.2
209481.0,17,2,180,1,90,0.0,90.0,90.0,1,90,0.0,90.0,90.0
6926.0,17,2,582,1,83,0.0,83.0,83.0,1,499,0.0,499.0,499.0
298062.0,6,6,412,4,272,99354.0,74.0,68.0,2,140,0.0,74.0,70.0
808.0,17,4,438,2,148,0.0,74.0,74.0,2,290,0.0,147.0,145.0
31975.000000000004,6,14,4740,7,653,4652.833333333333,249.0,93.28571428571428,7,4087,4550.0,1514.0,583.8571428571429
0.0,17,1,381,1,381,0.0,381.0,381.0,0,0,0.0,0.0,0.0
2393.0,17,4,344,2,150,0.0,75.0,75.0,2,194,0.0,103.0,97.0
157496.0,6,3,337,2,214,0.0,160.0,107.0,1,123,0.0,123.0,123.0
128709704.0,6,35,2542,17,1194,7420265.0,123.0,70.23529411764706,18,1348,6983773.0,139.0,74.88888888888889
121359.0,6,3,337,2,214,0.0,160.0,107.0,1,123,0.0,123.0,123.0
108109638.0,17,5,1005,5,1005,27027409.5,201.0,201.0,0,0,0.0,0.0,0.0
90257942.0,6,13,2036,8,1016,12893991.714285716,188.0,127.0,5,1020,22519666.25,204.0,204.0
1614389.0,17,6,1230,3,234,807004.0,78.0,78.0,3,996,806992.0,332.0,332.0
20140.0,17,2,582,1,83,0.0,83.0,83.0,1,499,0.0,499.0,499.0
135138150.0,17,6,1206,6,1206,27027630.0,201.0,201.0,0,0,0.0,0.0,0.0
61938.0,6,10,1066,5,490,13605.5,218.0,98.0,5,576,15273.25,304.0,115.2
16825.0,17,2,180,1,90,0.0,90.0,90.0,1,90,0.0,90.0,90.0
1300170.0,6,4,264,2,132,0.0,66.0,66.0,2,132,0.0,66.0,66.0
219684.0,6,10,1221,6,636,43936.8,298.0,106.0,4,585,71996.33333333333,379.0,146.25
24846.0,6,14,4740,7,653,4007.8333333333335,249.0,93.28571428571428,7,4087,4002.1666666666665,1514.0,583.8571428571429
195291.0,17,4,6056,4,6056,65097.0,1514.0,1514.0,0,0,0.0,0.0,0.0
24814.0,6,10,2032,5,524,5972.5,252.0,104.8,5,1508,5736.25,1236.0,301.6
10531458.0,6,7,478,4,272,3464960.0,74.0,68.0,3,206,5197286.5,74.0,68.66666666666667
116497114.0,6,48,3168,24,1584,5065091.913043479,66.0,66.0,24,1584,5053115.608695652,66.0,66.0
2020753.0,17,4,525,2,150,0.0,75.0,75.0,2,375,0.0,284.0,187.5
90256230.0,6,20,3042,10,1392,10028470.0,188.0,139.2,10,1650,10009732.111111112,204.0,165.0
204590.0,17,2,762,2,762,0.0,381.0,381.0,0,0,0.0,0.0,0.0
135135575.0,17,6,1206,6,1206,27027115.0,201.0,201.0,0,0,0.0,0.0,0.0
135133128.0,17,6,1146,6,1146,27026625.6,191.0,191.0,0,0,0.0,0.0,0.0
23216.0,6,14,4740,7,653,3565.1666666666665,249.0,93.28571428571428,7,4087,3721.0,1514.0,583.8571428571429
208985.0,17,4,1400,4,1400,69661.66666666667,350.0,350.0,0,0,0.0,0.0,0.0
117715066.0,6,47,3102,24,1584,5106073.956521739,66.0,66.0,23,1518,5135436.727272728,66.0,66.0
84.0,17,2,762,2,762,0.0,381.0,381.0,0,0,0.0,0.0,0.0
91230.0,6,14,4740,7,653,14719.5,249.0,93.28571428571428,7,4087,13623.666666666666,1514.0,583.8571428571429
90258927.0,6,12,1832,8,1016,12894132.42857143,188.0,127.0,4,816,30030879.666666668,204.0,204.0
153590.0,17,2,180,1,90,0.0,90.0,90.0,1,90,0.0,90.0,90.0
1400591.0,17,5,961,3,234,700109.5,78.0,78.0,2,727,0.0,395.0,363.5
338.0,17,2,166,1,75,0.0,75.0,75.0,1,91,0.0,91.0,91.0
143851.0,17,2,180,1,90,0.0,90.0,90.0,1,90,0.0,90.0,90.0
299945.0,6,6,412,4,272,99981.66666666669,74.0,68.0,2,140,0.0,74.0,70.0
706818.0,6,10,1065,5,534,176493.75,262.0,106.8,5,531,176269.5,259.0,106.2
4428.0,17,2,614,1,72,0.0,72.0,72.0,1,542,0.0,542.0,542.0
16309.0,6,14,4740,7,653,2563.6666666666665,249.0,93.28571428571428,7,4087,2562.333333333333,1514.0,583.8571428571429
216190.0,17,2,180,1,90,0.0,90.0,90.0,1,90,0.0,90.0,90.0
105390.0,17,2,286,2,286,0.0,143.0,143.0,0,0,0.0,0.0,0.0
90526679.0,6,14,2240,8,1016,12932382.714285716,188.0,127.0,6,1224,18072847.4,204.0,204.0
30034.0,6,14,4740,7,653,4814.166666666667,249.0,93.28571428571428,7,4087,4416.5,1514.0,583.8571428571429
120007178.0,6,20,1651,10,947,13333327.666666666,256.0,94.7,10,704,13333181.777777778,95.0,70.4
534907.0,6,15,4811,7,742,88996.16666666667,230.0,106.0,8,4069,76182.85714285714,1514.0,508.625
145315.0,17,2,180,1,90,0.0,90.0,90.0,1,90,0.0,90.0,90.0
33760.0,6,14,4740,7,653,5090.833333333333,249.0,93.28571428571428,7,4087,4123.666666666667,1514.0,583.8571428571429
19745.0,6,2,145,2,145,0.0,91.0,72.5,0,0,0.0,0.0,0.0
206960.0,17,2,180,1,90,0.0,90.0,90.0,1,90,0.0,90.0,90.0
90057528.0,17,28,13364,28,13364,3335464.0,501.0,477.2857142857143,0,0,0.0,0.0,0.0
90027408.0,17,28,13364,28,13364,3334348.4444444445,501.0,477.2857142857143,0,0,0.0,0.0,0.0
363396.0,6,10,1221,6,636,72679.2,298.0,106.0,4,585,119834.0,379.0,146.25
157908.0,17,2,180,1,90,0.0,90.0,90.0,1,90,0.0,90.0,90.0
2384.0,17,4,344,2,150,0.0,75.0,75.0,2,194,0.0,103.0,97.0
334.0,17,2,166,1,75,0.0,75.0,75.0,1,91,0.0,91.0,91.0
322850.0,17,4,1400,4,1400,107616.66666666669,350.0,350.0,0,0,0.0,0.0,0.0
531437.0,17,2,876,2,876,0.0,438.0,438.0,0,0,0.0,0.0,0.0
2053.0,17,2,664,1,322,0.0,322.0,322.0,1,342,0.0,342.0,342.0
46242.0,6,10,1065,5,534,11372.75,262.0,106.8,5,531,9795.75,259.0,106.2
120000222.0,6,17,1287,8,596,17142888.85714286,95.0,74.5,9,691,14969087.875,95.0,76.77777777777777
210653.0,17,2,414,1,88,0.0,88.0,88.0,1,326,0.0,326.0,326.0
126001474.0,17,15,907,8,475,18000210.57142857,174.0,59.375,7,432,17668062.166666668,174.0,61.71428571428572
321.0,17,2,160,1,80,0.0,80.0,80.0,1,80,0.0,80.0,80.0
24920.0,6,14,4740,7,653,3946.0,249.0,93.28571428571428,7,4087,3822.5,1514.0,583.8571428571429
2350.0,17,4,344,2,150,0.0,75.0,75.0,2,194,0.0,103.0,97.0
2450.0,17,2,762,2,762,0.0,381.0,381.0,0,0,0.0,0.0,0.0
1313640.0,6,4,264,2,132,0.0,66.0,66.0,2,132,0.0,66.0,66.0
311210.0,17,4,1400,4,1400,103736.66666666669,350.0,350.0,0,0,0.0,0.0,0.0
120120768.0,6,17,2572,8,1368,17160109.714285713,204.0,171.0,9,1204,14994690.125,188.0,133.77777777777777
509670.0,6,5,336,2,134,0.0,68.0,67.0,3,202,193624.0,70.0,67.33333333333333
90735372.0,6,18,1382,10,786,10076880.888888888,95.0,78.6,8,596,12960799.857142856,95.0,74.5
16236.0,6,14,4740,7,653,2481.1666666666665,249.0,93.28571428571428,7,4087,2493.333333333333,1514.0,583.8571428571429
153514.0,17,2,180,1,90,0.0,90.0,90.0,1,90,0.0,90.0,90.0
299616.0,17,2,246,1,76,0.0,76.0,76.0,1,170,0.0,170.0,170.0
2087.0,17,4,344,2,150,0.0,75.0,75.0,2,194,0.0,103.0,97.0
1280273.0,17,7,490,7,490,213378.8333333333,70.0,70.0,0,0,0.0,0.0,0.0
234130.0,6,3,373,2,238,0.0,172.0,119.0,1,135,0.0,135.0,135.0
120119363.0,6,13,2020,9,1204,15014920.375,188.0,133.77777777777777,4,816,30030359.0,204.0,204.0
90032800.0,17,27,12943,27,12943,3462800.0,501.0,479.3703703703704,0,0,0.0,0.0,0.0
262763.0,6,10,1221,6,636,52552.6,298.0,106.0,4,585,81504.33333333333,379.0,146.25
849262.0,6,9,1096,6,625,169852.4,287.0,104.16666666666669,3,471,286854.0,331.0,157.0
147937.0,17,2,180,1,90,0.0,90.0,90.0,1,90,0.0,90.0,90.0
216421.0,17,2,180,1,90,0.0,90.0,90.0,1,90,0.0,90.0,90.0
23052169.0,17,3,1034,2,684,0.0,342.0,342.0,1,350,0.0,350.0,350.0
39083.0,6,10,2032,5,524,9056.75,252.0,104.8,5,1508,9140.25,1236.0,301.6
120075362.0,17,29,13785,29,13785,4288405.785714285,501.0,475.3448275862069,0,0,0.0,0.0,0.0
0.0,6,1,160,1,160,0.0,160.0,160.0,0,0,0.0,0.0,0.0
1302364.0,6,4,264,2,132,0.0,66.0,66.0,2,132,0.0,66.0,66.0
256029.0,6,3,337,2,214,0.0,160.0,107.0,1,123,0.0,123.0,123.0
153446.0,17,2,180,1,90,0.0,90.0,90.0,1,90,0.0,90.0,90.0
117828190.0,6,29,1914,15,948,8416299.285714285,123.0,63.2,14,966,8278979.076923077,123.0,69.0
147252.0,6,3,373,2,238,0.0,172.0,119.0,1,135,0.0,135.0,135.0
143406.0,6,2,132,1,66,0.0,66.0,66.0,1,66,0.0,66.0,66.0
120011250.0,6,18,1341,9,691,14999994.25,95.0,76.77777777777777,9,650,14999817.75,95.0,72.22222222222223
21717.0,6,2,145,2,145,0.0,91.0,72.5,0,0,0.0,0.0,0.0
233089.0,6,3,337,2,214,0.0,160.0,107.0,1,123,0.0,123.0,123.0
14655.0,6,20,7606,11,978,1465.5,310.0,88.9090909090909,9,6628,1714.0,1514.0,736.4444444444445
2343.0,17,4,344,2,150,0.0,75.0,75.0,2,194,0.0,103.0,97.0
121235.0,6,3,337,2,214,0.0,160.0,107.0,1,123,0.0,123.0,123.0
12480.0,6,13,1459,7,862,1855.5,271.0,123.14285714285714,6,597,2323.8,259.0,99.5
113805795.0,6,34,2482,17,1194,7112835.8125,123.0,70.23529411764706,17,1288,6488777.5625,139.0,75.76470588235294
39571.0,6,14,4740,7,653,6062.666666666667,249.0,93.28571428571428,7,4087,6266.5,1514.0,583.8571428571429
311881.0,6,6,412,4,272,103960.33333333331,74.0,68.0,2,140,0.0,74.0,70.0
904191.0,6,6,1808,4,987,301397.0,785.0,246.75,2,821,0.0,753.0,410.5
103047.0,17,2,286,2,286,0.0,143.0,143.0,0,0,0.0,0.0,0.0
307425.0,6,6,412,4,272,102475.0,74.0,68.0,2,140,0.0,74.0,70.0
117420115.0,6,385,44774,193,13034,611563.0989583334,140.0,67.53367875647669,192,31740,604011.6387434555,284.0,165.3125
2771353.0,6,2,132,1,66,0.0,66.0,66.0,1,66,0.0,66.0,66.0
104005.0,17,2,286,2,286,0.0,143.0,143.0,0,0,0.0,0.0,0.0
1304716.0,6,4,264,2,132,0.0,66.0,66.0,2,132,0.0,66.0,66.0
116607778.0,6,48,3168,24,1584,5069903.391304348,66.0,66.0,24,1584,5056444.391304348,66.0,66.0
47794.0,6,12,1320,6,723,8604.6,253.0,120.5,6,597,7757.4,259.0,99.5
2040.0,17,4,344,2,150,0.0,75.0,75.0,2,194,0.0,103.0,97.0
1695822.0,6,21,6377,10,1397,188424.66666666663,357.0,139.7,11,4980,139240.3,1510.0,452.7272727272728
2328.0,17,4,344,2,150,0.0,75.0,75.0,2,194,0.0,103.0,97.0
143039.0,6,2,132,1,66,0.0,66.0,66.0,1,66,0.0,66.0,66.0
2837246.0,6,3,204,2,136,0.0,70.0,68.0,1,68,0.0,68.0,68.0
146298.0,6,3,337,2,214,0.0,160.0,107.0,1,123,0.0,123.0,123.0
930.0,17,4,820,2,156,0.0,78.0,78.0,2,664,0.0,332.0,332.0
108113107.0,17,5,1005,5,1005,27028276.75,201.0,201.0,0,0,0.0,0.0,0.0
941355.0,6,12,2718,7,743,156892.5,339.0,106.14285714285714,5,1975,166560.5,1514.0,395.0
108107433.0,17,5,955,5,955,27026858.25,191.0,191.0,0,0,0.0,0.0,0.0
120772900.0,6,47,3102,23,1518,5160002.954545454,66.0,66.0,24,1584,5250984.608695652,66.0,66.0
108104948.0,17,5,1005,5,1005,27026237.0,201.0,201.0,0,0,0.0,0.0,0.0
23121473.0,17,3,1034,2,684,0.0,342.0,342.0,1,350,0.0,350.0,350.0
120282148.0,6,230,26100,115,7812,1047893.201754386,140.0,67.9304347826087,115,18288,1047807.6315789474,374.0,159.02608695652174
96233282.0,6,844,174496,414,27842,231140.9200968523,214.0,67.2512077294686,430,146654,224282.45454545456,1514.0,341.0558139534884
353.0,17,2,160,1,80,0.0,80.0,80.0,1,80,0.0,80.0,80.0
232828.0,17,2,180,1,90,0.0,90.0,90.0,1,90,0.0,90.0,90.0
27764936.0,6,10,643,6,396,5552987.2,95.0,66.0,4,247,9172888.333333334,85.0,61.75
99005332.0,17,12,778,6,389,19801066.4,174.0,64.83333333333333,6,389,19800183.4,174.0,64.83333333333333
1302145.0,6,4,264,2,132,0.0,66.0,66.0,2,132,0.0,66.0,66.0
146561.0,6,3,337,2,214,0.0,160.0,107.0,1,123,0.0,123.0,123.0
117001018.0,17,13,821,7,432,19500169.666666668,174.0,61.71428571428572,6,389,19400861.0,174.0,64.83333333333333
25185.0,6,10,2032,5,524,6080.5,252.0,104.8,5,1508,5586.25,1236.0,301.6
135133836.0,17,6,1146,6,1146,27026767.2,191.0,191.0,0,0,0.0,0.0,0.0
120121663.0,6,14,2240,6,1224,24024332.6,204.0,204.0,8,1016,17136572.714285713,188.0,127.0
117857102.0,6,31,2166,16,1149,7842750.066666666,123.0,71.8125,15,1017,8402904.0,123.0,67.8
103272.0,17,2,286,2,286,0.0,143.0,143.0,0,0,0.0,0.0,0.0
219429.0,6,3,426,2,280,0.0,214.0,140.0,1,146,0.0,146.0,146.0
111265213.0,6,36,2734,19,1471,6181400.722222222,139.0,77.42105263157895,17,1263,6940557.125,123.0,74.29411764705883
100234967.0,17,12,778,6,389,20009256.6,174.0,64.83333333333333,6,389,20014973.8,174.0,64.83333333333333
249699.0,6,3,373,2,238,0.0,172.0,119.0,1,135,0.0,135.0,135.0
120540961.0,6,207,23342,104,16248,1170300.5922330096,284.0,156.23076923076923,103,7094,1171711.8333333333,140.0,68.87378640776699
12177.0,6,10,1065,5,534,2771.5,262.0,106.8,5,531,2829.25,259.0,106.2
113254693.0,6,46,3036,23,1518,5135438.454545454,66.0,66.0,23,1518,5135437.818181818,66.0,66.0
142132.0,6,2,132,1,66,0.0,66.0,66.0,1,66,0.0,66.0,66.0
27485619.0,17,5,1710,5,1710,6871404.75,342.0,342.0,0,0,0.0,0.0,0.0
104176224.0,17,14,864,7,432,17334310.666666668,174.0,61.71428571428572,7,432,17333495.333333332,174.0,61.71428571428572
144089.0,17,2,180,1,90,0.0,90.0,90.0,1,90,0.0,90.0,90.0
135136260.0,17,6,1146,6,1146,27027252.0,191.0,191.0,0,0,0.0,0.0,0.0
228340.0,17,2,180,1,90,0.0,90.0,90.0,1,90,0.0,90.0,90.0
90044653.0,17,28,13364,28,13364,3334987.1481481483,501.0,477.2857142857143,0,0,0.0,0.0,0.0
99295327.0,6,182,20538,91,14310,1100890.2,284.0,157.25274725274724,91,6228,1100884.4777777777,140.0,68.43956043956044
307714.0,6,6,412,4,272,102571.33333333331,74.0,68.0,2,140,0.0,74.0,70.0
16166940.0,17,6,2052,6,2052,3233388.0,342.0,342.0,0,0,0.0,0.0,0.0
90005902.0,6,17,1287,9,691,11250737.75,95.0,76.77777777777777,8,596,12789592.857142856,95.0,74.5
299548.0,6,6,412,4,272,99849.33333333331,74.0,68.0,2,140,0.0,74.0,70.0
121386763.0,6,213,24136,107,16844,1145158.141509434,284.0,157.42056074766356,106,7292,1137468.9238095237,140.0,68.79245283018868
164139.0,6,10,1066,5,490,40684.5,218.0,98.0,5,576,39933.0,304.0,115.2
47399.0,6,14,4740,7,653,7637.333333333333,249.0,93.28571428571428,7,4087,7761.166666666667,1514.0,583.8571428571429
102729528.0,17,14,864,7,432,17121588.0,174.0,61.71428571428572,7,432,17077021.0,174.0,61.71428571428572
1502273.0,6,8,602,3,198,204811.0,66.0,66.0,5,404,350699.25,103.0,80.8
1066678.0,6,3,204,2,136,0.0,70.0,68.0,1,68,0.0,68.0,68.0
90017218.0,17,28,13364,28,13364,3333971.037037037,501.0,477.2857142857143,0,0,0.0,0.0,0.0
4305.0,17,2,598,1,72,0.0,72.0,72.0,1,526,0.0,526.0,526.0
218513.0,6,3,426,2,280,0.0,214.0,140.0,1,146,0.0,146.0,146.0
7000.0,17,2,582,1,83,0.0,83.0,83.0,1,499,0.0,499.0,499.0
102324495.0,6,42,2772,21,1386,5105432.0,66.0,66.0,21,1386,5105429.7,66.0,66.0
16043.000000000002,6,10,2032,5,524,3651.25,252.0,104.8,5,1508,3613.5,1236.0,301.6
97993554.0,6,34,2604,18,1395,5751641.294117647,123.0,77.5,16,1209,6518522.8,123.0,75.5625
103314.0,17,2,286,2,286,0.0,143.0,143.0,0,0,0.0,0.0,0.0
216656.0,6,3,426,2,280,0.0,214.0,140.0,1,146,0.0,146.0,146.0
1578952.0,6,2,132,1,66,0.0,66.0,66.0,1,66,0.0,66.0,66.0
146210.0,6,10,1065,5,534,36262.5,262.0,106.8,5,531,2163.25,259.0,106.2
313015.0,6,6,412,4,272,104338.33333333331,74.0,68.0,2,140,0.0,74.0,70.0
209550.0,17,2,180,1,90,0.0,90.0,90.0,1,90,0.0,90.0,90.0
782.0,17,2,762,2,762,0.0,381.0,381.0,0,0,0.0,0.0,0.0
16317.000000000002,6,14,4740,7,653,2497.6666666666665,249.0,93.28571428571428,7,4087,2537.0,1514.0,583.8571428571429
123455572.0,6,48,3168,24,1584,4960442.0,66.0,66.0,24,1584,5307380.260869565,66.0,66.0
214640.0,6,12,1373,7,714,35773.333333333336,298.0,102.0,5,659,52787.75,379.0,131.8
1283564.0,17,7,490,7,490,213927.3333333333,70.0,70.0,0,0,0.0,0.0,0.0
18883205.0,6,27,7681,15,3789,193588.2857142857,1514.0,252.6,12,3892,1697084.181818182,1514.0,324.3333333333333
302258.0,6,6,412,4,272,100752.66666666669,74.0,68.0,2,140,0.0,74.0,70.0
90768883.0,6,19,1436,10,745,10079876.777777778,95.0,74.5,9,691,11344594.25,95.0,76.77777777777777
120058930.0,17,29,13785,29,13785,4287818.928571428,501.0,475.3448275862069,0,0,0.0,0.0,0.0
2059.0,17,4,344,2,150,0.0,75.0,75.0,2,194,0.0,103.0,97.0
304375.0,6,6,412,4,272,101458.33333333331,74.0,68.0,2,140,0.0,74.0,70.0
120086705.0,6,31,2113,16,1165,8005780.333333333,139.0,72.8125,15,948,8014526.142857143,123.0,63.2
120030884.0,17,28,13364,28,13364,4445588.296296297,501.0,477.2857142857143,0,0,0.0,0.0,0.0
117407308.0,6,233,26282,117,7944,1012131.9655172414,140.0,67.8974358974359,116,18338,1012053.7217391304,284.0,158.08620689655172
93568355.0,6,40,2640,20,1320,4924650.263157895,66.0,66.0,20,1320,4913268.52631579,66.0,66.0
92113518.0,6,38,2508,19,1254,5105435.111111111,66.0,66.0,19,1254,5105420.777777778,66.0,66.0
205927.0,17,2,180,1,90,0.0,90.0,90.0,1,90,0.0,90.0,90.0
246064.0,6,3,337,2,214,0.0,160.0,107.0,1,123,0.0,123.0,123.0
337986.0,6,10,1221,6,636,67597.2,298.0,106.0,4,585,106720.66666666669,379.0,146.25
90306776.0,6,16,1192,8,596,12893520.42857143,95.0,74.5,8,596,12900488.42857143,95.0,74.5
1993.0,17,4,344,2,150,0.0,75.0,75.0,2,194,0.0,103.0,97.0
116897006.0,6,39,2902,20,1531,6152474.0,139.0,76.55,19,1371,6481922.388888889,123.0,72.15789473684211
202250.0,17,2,762,2,762,0.0,381.0,381.0,0,0,0.0,0.0,0.0
228222.0,17,2,180,1,90,0.0,90.0,90.0,1,90,0.0,90.0,90.0
1167926.0,6,13,3014,8,2386,166846.57142857142,1514.0,298.25,5,628,223071.75,331.0,125.6
3003899.0,6,12,2172,7,664,500365.3333333333,252.0,94.85714285714286,5,1508,1874.75,1236.0,301.6
196946.0,17,2,180,1,90,0.0,90.0,90.0,1,90,0.0,90.0,90.0
1306012.0,17,7,490,7,490,217668.66666666663,70.0,70.0,0,0,0.0,0.0,0.0
108063.0,17,2,286,2,286,0.0,143.0,143.0,0,0,0.0,0.0,0.0
135132733.0,17,6,1206,6,1206,27026546.6,201.0,201.0,0,0,0.0,0.0,0.0
763.0,17,2,684,2,684,0.0,342.0,342.0,0,0,0.0,0.0,0.0
308005.0,6,6,412,4,272,102668.33333333331,74.0,68.0,2,140,0.0,74.0,70.0
122340.0,17,4,1400,4,1400,40780.0,350.0,350.0,0,0,0.0,0.0,0.0
209858.0,17,2,180,1,90,0.0,90.0,90.0,1,90,0.0,90.0,90.0
186021.0,17,2,180,1,90,0.0,90.0,90.0,1,90,0.0,90.0,90.0
2812631.0,6,3,1604,2,851,0.0,785.0,425.5,1,753,0.0,753.0,753.0
90773428.0,6,22,1680,12,894,8246939.818181818,95.0,74.5,10,786,10085072.555555556,95.0,78.6
311320.0,17,4,1400,4,1400,103773.33333333331,350.0,350.0,0,0,0.0,0.0,0.0
386.0,17,2,267,1,83,0.0,83.0,83.0,1,184,0.0,184.0,184.0
2317.0,17,4,344,2,150,0.0,75.0,75.0,2,194,0.0,103.0,97.0
120121763.0,6,13,2020,9,1204,15015220.375,188.0,133.77777777777777,4,816,30030914.666666668,204.0,204.0
209579.0,17,2,180,1,90,0.0,90.0,90.0,1,90,0.0,90.0,90.0
239007.0,6,3,373,2,238,0.0,172.0,119.0,1,135,0.0,135.0,135.0
1690868.0,6,4,492,2,280,0.0,214.0,140.0,2,212,0.0,146.0,106.0
298455.0,6,6,412,4,272,99485.0,74.0,68.0,2,140,0.0,74.0,70.0
108106123.0,17,5,1005,5,1005,27026530.75,201.0,201.0,0,0,0.0,0.0,0.0
143955.0,17,2,180,1,90,0.0,90.0,90.0,1,90,0.0,90.0,90.0
853832.0,6,2,132,1,66,0.0,66.0,66.0,1,66,0.0,66.0,66.0
247133.0,17,2,180,1,90,0.0,90.0,90.0,1,90,0.0,90.0,90.0
17338.0,17,2,598,1,72,0.0,72.0,72.0,1,526,0.0,526.0,526.0
120272518.0,6,226,25422,113,7754,1066617.7142857143,140.0,68.61946902654867,113,17668,1066502.5892857143,284.0,156.35398230088495
108111718.0,17,5,955,5,955,27027929.5,191.0,191.0,0,0,0.0,0.0,0.0
100632.0,17,2,286,2,286,0.0,143.0,143.0,0,0,0.0,0.0,0.0
144807.0,17,4,704,2,148,0.0,74.0,74.0,2,556,0.0,280.0,278.0
120246662.0,6,220,24740,110,7556,1095486.0366972478,140.0,68.69090909090909,110,17184,1096517.752293578,284.0,156.21818181818182
216353.0,6,3,426,2,280,0.0,214.0,140.0,1,146,0.0,146.0,146.0
28159.0,6,14,4740,7,653,4574.833333333333,249.0,93.28571428571428,7,4087,4560.5,1514.0,583.8571428571429
112030.0,17,2,286,2,286,0.0,143.0,143.0,0,0,0.0,0.0,0.0
83766.0,6,14,4740,7,653,13031.666666666666,249.0,93.28571428571428,7,4087,13268.166666666666,1514.0,583.8571428571429
849.0,17,5,550,5,550,212.25,110.0,110.0,0,0,0.0,0.0,0.0
120000978.0,17,15,907,8,475,17142996.85714286,174.0,59.375,7,432,16668195.833333334,174.0,61.71428571428572
113732233.0,6,46,3036,23,1518,5155448.818181818,66.0,66.0,23,1518,5155459.863636363,66.0,66.0
101596860.0,17,16,5480,15,5130,5698694.0,342.0,342.0,1,350,0.0,350.0,350.0
3159454.0,6,15,2266,8,1147,451350.5714285714,581.0,143.375,7,1119,492111.8333333333,731.0,159.85714285714286
53989.0,6,12,1320,7,789,8998.166666666666,253.0,112.71428571428572,5,531,11185.25,259.0,106.2
135132729.0,17,6,1206,6,1206,27026545.8,201.0,201.0,0,0,0.0,0.0,0.0
108001278.0,17,13,821,7,432,18000213.0,174.0,61.71428571428572,6,389,17600991.4,174.0,64.83333333333333
2416.0,17,4,344,2,150,0.0,75.0,75.0,2,194,0.0,103.0,97.0
105120068.0,6,207,23486,104,7086,1020583.1844660194,140.0,68.13461538461539,103,16400,1021820.911764706,374.0,159.2233009708738
53904.0,6,14,4740,7,653,8490.5,249.0,93.28571428571428,7,4087,8820.0,1514.0,583.8571428571429
120608032.0,6,373,44088,187,31590,648430.2795698924,284.0,168.93048128342247,186,12498,646395.2864864864,140.0,67.19354838709677
90023729.0,17,28,13364,28,13364,3334212.185185185,501.0,477.2857142857143,0,0,0.0,0.0,0.0
410.0,17,2,267,1,83,0.0,83.0,83.0,1,184,0.0,184.0,184.0
135131776.0,17,6,1146,6,1146,27026355.2,191.0,191.0,0,0,0.0,0.0,0.0
111026113.0,6,31,2182,16,1165,7387339.333333333,139.0,72.8125,15,1017,7915007.571428572,123.0,67.8
1772010.0,6,4,276,2,128,0.0,74.0,64.0,2,148,0.0,74.0,74.0
37228.0,6,14,4740,7,653,6059.0,249.0,93.28571428571428,7,4087,5818.333333333333,1514.0,583.8571428571429
298.0,17,2,168,1,76,0.0,76.0,76.0,1,92,0.0,92.0,92.0
127942.0,6,10,1066,5,490,29125.0,218.0,98.0,5,576,31618.0,304.0,115.2
592922.0,6,4,508,2,238,0.0,172.0,119.0,2,270,0.0,135.0,135.0
317901.0,17,4,1400,4,1400,105967.0,350.0,350.0,0,0,0.0,0.0,0.0
51504.0,6,10,2032,5,524,12486.25,252.0,104.8,5,1508,9053.25,1236.0,301.6
2299.0,17,4,344,2,150,0.0,75.0,75.0,2,194,0.0,103.0,97.0
32527.0,6,10,2032,5,524,5677.25,252.0,104.8,5,1508,7560.75,1236.0,301.6
1770796.0,6,2,132,1,66,0.0,66.0,66.0,1,66,0.0,66.0,66.0
15044.0,17,2,180,1,90,0.0,90.0,90.0,1,90,0.0,90.0,90.0
917.0,17,5,550,5,550,229.25,110.0,110.0,0,0,0.0,0.0,0.0
1332.0,17,4,438,2,148,0.0,74.0,74.0,2,290,0.0,147.0,145.0
103451892.0,6,44,2904,22,1452,4926280.571428572,66.0,66.0,22,1452,4913274.285714285,66.0,66.0
120045879.0,17,29,13785,29,13785,4287352.821428572,501.0,475.3448275862069,0,0,0.0,0.0,0.0
104832718.0,6,206,23218,103,7020,1019611.3823529412,140.0,68.15533980582525,103,16198,1019816.2450980392,284.0,157.2621359223301
2804942.0,6,2,132,1,66,0.0,66.0,66.0,1,66,0.0,66.0,66.0
48596.0,6,14,4740,7,653,6918.5,249.0,93.28571428571428,7,4087,7881.0,1514.0,583.8571428571429
254436.0,17,4,6056,4,6056,84812.0,1514.0,1514.0,0,0,0.0,0.0,0.0
206165.0,6,3,426,2,280,0.0,214.0,140.0,1,146,0.0,146.0,146.0
2141362.0,6,25,7609,13,2516,178446.83333333334,1034.0,193.53846153846155,12,5093,166707.81818181818,1510.0,424.4166666666667
134119.0,17,2,700,2,700,0.0,350.0,350.0,0,0,0.0,0.0,0.0
2799472.0,6,3,1604,1,753,0.0,753.0,753.0,2,851,0.0,785.0,425.5
44344.0,6,14,4740,7,653,4806.166666666667,249.0,93.28571428571428,7,4087,7258.166666666667,1514.0,583.8571428571429
209523.0,17,2,180,1,90,0.0,90.0,90.0,1,90,0.0,90.0,90.0
307.0,17,2,174,1,79,0.0,79.0,79.0,1,95,0.0,95.0,95.0
241071.0,6,3,337,2,214,0.0,160.0,107.0,1,123,0.0,123.0,123.0
103327.0,17,2,286,2,286,0.0,143.0,143.0,0,0,0.0,0.0,0.0
2024.0,17,4,344,2,150,0.0,75.0,75.0,2,194,0.0,103.0,97.0
319843.0,17,4,1400,4,1400,106614.33333333331,350.0,350.0,0,0,0.0,0.0,0.0
90277106.0,6,16,1192,8,596,12890957.57142857,95.0,74.5,8,596,12896150.714285716,95.0,74.5
309237.0,6,6,412,4,272,103079.0,74.0,68.0,2,140,0.0,74.0,70.0
113614406.0,6,46,3036,23,1518,5150438.818181818,66.0,66.0,23,1518,5150437.954545454,66.0,66.0
32785269.0,6,5,336,2,134,0.0,68.0,67.0,3,202,15002300.5,70.0,67.33333333333333
99405525.0,17,12,778,6,389,19881105.0,174.0,64.83333333333333,6,389,19838537.0,174.0,64.83333333333333
108681414.0,6,34,2482,17,1288,6778665.4375,139.0,75.76470588235294,17,1194,6778829.6875,123.0,70.23529411764706
120000467.0,6,16,1192,8,596,17142923.85714286,95.0,74.5,8,596,17105780.14285714,95.0,74.5
12183.0,6,11,1131,6,600,2140.2,262.0,100.0,5,531,2708.75,259.0,106.2
305914.0,6,6,412,4,272,101971.33333333331,74.0,68.0,2,140,0.0,74.0,70.0
108102468.0,17,5,1005,5,1005,27025617.0,201.0,201.0,0,0,0.0,0.0,0.0
43266.0,6,10,2032,5,524,9812.0,252.0,104.8,5,1508,10547.75,1236.0,301.6
1698.0,17,2,762,2,762,0.0,381.0,381.0,0,0,0.0,0.0,0.0
3066.0,17,2,224,1,76,0.0,76.0,76.0,1,148,0.0,148.0,148.0
308174.0,6,6,412,4,272,102724.66666666669,74.0,68.0,2,140,0.0,74.0,70.0
38708.0,6,10,2032,5,524,9298.25,252.0,104.8,5,1508,9350.25,1236.0,301.6
123303769.0,6,232,26088,116,7952,1026105.052173913,140.0,68.55172413793103,116,18136,1065175.1217391305,284.0,156.3448275862069
2277.0,17,4,344,2,150,0.0,75.0,75.0,2,194,0.0,103.0,97.0
207777.0,6,3,426,2,280,0.0,214.0,140.0,1,146,0.0,146.0,146.0
120560.0,6,3,337,2,214,0.0,160.0,107.0,1,123,0.0,123.0,123.0
103662.0,17,2,700,2,700,0.0,350.0,350.0,0,0,0.0,0.0,0.0
321339.0,17,4,1400,4,1400,107113.0,350.0,350.0,0,0,0.0,0.0,0.0
297123.0,6,6,412,4,272,99041.0,74.0,68.0,2,140,0.0,74.0,70.0
92880358.0,6,38,2508,19,1254,5160006.0,66.0,66.0,19,1254,5160006.277777778,66.0,66.0
196936.0,17,2,180,1,90,0.0,90.0,90.0,1,90,0.0,90.0,90.0
143399.0,6,2,132,1,66,0.0,66.0,66.0,1,66,0.0,66.0,66.0
108565008.0,17,14,864,7,432,17834321.666666668,174.0,61.71428571428572,7,432,17833493.166666668,174.0,61.71428571428572
92549435.0,6,28,2061,14,1032,7119187.307692308,123.0,73.71428571428571,14,1029,7101651.384615385,123.0,73.5
119001022.0,17,15,1169,8,606,17000146.0,174.0,75.75,7,563,16501188.833333334,174.0,80.42857142857143
3013234.0,6,11,2106,6,598,601953.0,252.0,99.66666666666669,5,1508,2567.0,1236.0,301.6
90527463.0,6,15,2444,8,1016,12932494.714285716,188.0,127.0,7,1428,15061126.333333334,204.0,204.0
112979788.0,6,45,2970,23,1518,5135444.909090909,66.0,66.0,22,1452,4981117.142857143,66.0,66.0
40859.0,6,10,2032,5,524,10004.5,252.0,104.8,5,1508,9849.75,1236.0,301.6
135100458.0,17,6,1146,6,1146,27020091.6,191.0,191.0,0,0,0.0,0.0,0.0
47544.0,6,14,4740,7,653,6394.0,249.0,93.28571428571428,7,4087,6367.833333333333,1514.0,583.8571428571429
117958.0,17,2,286,2,286,0.0,143.0,143.0,0,0,0.0,0.0,0.0
120149070.0,6,283,31832,142,9594,852121.0638297872,140.0,67.56338028169014,141,22238,850924.1214285714,284.0,157.7163120567376
306167.0,6,6,412,4,272,102055.66666666669,74.0,68.0,2,140,0.0,74.0,70.0
121384.0,6,3,337,2,214,0.0,160.0,107.0,1,123,0.0,123.0,123.0
248199.0,6,3,337,2,214,0.0,160.0,107.0,1,123,0.0,123.0,123.0
275014.0,6,12,1373,7,714,45835.66666666666,298.0,102.0,5,659,64429.75,379.0,131.8
135131414.0,17,6,1206,6,1206,27026282.8,201.0,201.0,0,0,0.0,0.0,0.0
870958.0,6,9,1270,6,799,174191.6,461.0,133.16666666666666,3,471,297491.0,331.0,157.0
99758.0,17,2,762,2,762,0.0,381.0,381.0,0,0,0.0,0.0,0.0
30613.0,6,14,4740,7,653,4650.0,249.0,93.28571428571428,7,4087,4854.833333333333,1514.0,583.8571428571429
120100118.0,6,32,2242,17,1225,7506257.375,139.0,72.05882352941177,15,1017,7849968.428571428,123.0,67.8
153478.0,17,2,180,1,90,0.0,90.0,90.0,1,90,0.0,90.0,90.0
34331.0,6,10,2032,5,524,7762.25,252.0,104.8,5,1508,8301.0,1236.0,301.6
101390064.0,6,29,2068,15,1105,7226742.5,139.0,73.66666666666667,14,963,7782647.076923077,123.0,68.78571428571429
107292.0,17,2,762,2,762,0.0,381.0,381.0,0,0,0.0,0.0,0.0
146047.0,6,3,337,2,214,0.0,160.0,107.0,1,123,0.0,123.0,123.0
0.0,17,1,178,1,178,0.0,178.0,178.0,0,0,0.0,0.0,0.0
27989.0,6,14,4740,7,653,4221.5,249.0,93.28571428571428,7,4087,3979.8333333333335,1514.0,583.8571428571429
94499453.0,6,179,20340,90,14244,1061791.606741573,284.0,158.26666666666668,89,6096,1067282.056818182,140.0,68.49438202247191
9485.0,17,2,539,1,86,0.0,86.0,86.0,1,453,0.0,453.0,453.0
12312.0,6,13,1459,7,862,2052.0,271.0,123.14285714285714,6,597,2208.6,259.0,99.5
32314.000000000004,6,14,4740,7,653,5270.333333333333,249.0,93.28571428571428,7,4087,5245.333333333333,1514.0,583.8571428571429
122688049.0,6,49,3234,25,1650,5112002.041666667,66.0,66.0,24,1584,5030817.869565218,66.0,66.0
108111.0,17,2,762,2,762,0.0,381.0,381.0,0,0,0.0,0.0,0.0
90033925.0,17,28,13364,28,13364,3334589.814814815,501.0,477.2857142857143,0,0,0.0,0.0,0.0
143948.0,17,2,180,1,90,0.0,90.0,90.0,1,90,0.0,90.0,90.0
100238184.0,17,14,1126,7,563,16679542.5,174.0,80.42857142857143,7,563,16655680.333333334,174.0,80.42857142857143
123712025.0,6,49,3234,25,1650,5154667.708333333,66.0,66.0,24,1584,5114737.826086956,66.0,66.0
1166927.0,6,13,3010,8,2382,166703.85714285713,1514.0,297.75,5,628,222937.0,331.0,125.6
53791.0,6,14,4740,7,653,8338.166666666666,249.0,93.28571428571428,7,4087,8006.5,1514.0,583.8571428571429
35766.0,6,10,2032,5,524,8715.25,252.0,104.8,5,1508,7986.25,1236.0,301.6
20114.0,6,11,1133,6,602,3836.2,264.0,100.33333333333331,5,531,4330.25,259.0,106.2
6994.0,17,4,344,2,150,0.0,75.0,75.0,2,194,0.0,103.0,97.0
36860.0,6,10,2032,5,524,8790.75,252.0,104.8,5,1508,8931.5,1236.0,301.6
217095.0,6,3,426,2,280,0.0,214.0,140.0,1,146,0.0,146.0,146.0
147928.0,17,2,180,1,90,0.0,90.0,90.0,1,90,0.0,90.0,90.0
237252.0,6,3,337,2,214,0.0,160.0,107.0,1,123,0.0,123.0,123.0
120119084.0,6,14,2240,6,1224,24023816.8,204.0,204.0,8,1016,17136183.285714287,188.0,127.0
22091.0,6,14,4740,7,653,3342.1666666666665,249.0,93.28571428571428,7,4087,3542.1666666666665,1514.0,583.8571428571429
113659639.0,6,46,3036,23,1518,5152258.227272728,66.0,66.0,23,1518,5152261.863636363,66.0,66.0
128010434.0,17,15,907,8,475,18287204.85714286,174.0,59.375,7,432,18000162.833333332,174.0,61.71428571428572
90038027.0,17,28,13364,28,13364,3334741.7407407407,501.0,477.2857142857143,0,0,0.0,0.0,0.0
100783552.0,6,32,2352,16,1212,6704523.866666666,123.0,75.75,16,1140,6704502.6,123.0,71.25
1180908.0,6,13,3000,8,2372,168701.14285714287,1514.0,296.5,5,628,226329.25,331.0,125.6
108104735.0,17,5,1005,5,1005,27026183.75,201.0,201.0,0,0,0.0,0.0,0.0
106031792.0,6,30,2106,15,1089,7558283.714285715,123.0,72.6,15,1017,7558294.857142857,123.0,67.8
294.0,17,2,156,1,78,0.0,78.0,78.0,1,78,0.0,78.0,78.0
922549.0,6,13,1428,7,797,153083.5,253.0,113.85714285714286,6,631,183752.2,293.0,105.16666666666669
1472060.0,17,16,1120,16,1120,98137.33333333331,70.0,70.0,0,0,0.0,0.0,0.0
3293.0,17,2,363,1,79,0.0,79.0,79.0,1,284,0.0,284.0,284.0
132001123.0,17,15,907,8,475,18857303.285714287,174.0,59.375,7,432,18667934.33333333,174.0,61.71428571428572
135135676.0,17,6,1206,6,1206,27027135.2,201.0,201.0,0,0,0.0,0.0,0.0
17348.0,6,10,2032,5,524,4057.5,252.0,104.8,5,1508,3999.75,1236.0,301.6
153399.0,17,2,180,1,90,0.0,90.0,90.0,1,90,0.0,90.0,90.0
64289.0,6,12,1320,7,789,10714.833333333334,253.0,112.71428571428572,5,531,14352.75,259.0,106.2
3422424.0,17,4,1382,2,698,0.0,349.0,349.0,2,684,0.0,342.0,342.0
16641.0,6,14,4740,7,653,2559.0,249.0,93.28571428571428,7,4087,2585.833333333333,1514.0,583.8571428571429
78828.0,6,10,2032,5,524,18305.75,252.0,104.8,5,1508,19279.5,1236.0,301.6
20409.0,17,2,582,1,83,0.0,83.0,83.0,1,499,0.0,499.0,499.0
90301048.0,6,16,1192,8,596,12893023.42857143,95.0,74.5,8,596,12899523.857142856,95.0,74.5
18892.0,6,2,145,2,145,0.0,91.0,72.5,0,0,0.0,0.0,0.0
331.0,17,2,267,1,83,0.0,83.0,83.0,1,184,0.0,184.0,184.0
33094.0,6,14,4740,7,653,5214.333333333333,249.0,93.28571428571428,7,4087,4566.166666666667,1514.0,583.8571428571429
2050639.0,17,6,1230,3,234,1025132.0,78.0,78.0,3,996,1025108.5,332.0,332.0
216439.0,17,2,180,1,90,0.0,90.0,90.0,1,90,0.0,90.0,90.0
13704.0,6,11,1132,6,556,2668.0,218.0,92.66666666666669,5,576,2750.75,304.0,115.2
228495.0,17,2,180,1,90,0.0,90.0,90.0,1,90,0.0,90.0,90.0
30645.0,6,14,4740,7,653,4722.166666666667,249.0,93.28571428571428,7,4087,4784.833333333333,1514.0,583.8571428571429
2437.0,17,4,344,2,150,0.0,75.0,75.0,2,194,0.0,103.0,97.0
90595578.0,6,28,1992,14,1029,6968890.615384615,123.0,73.5,14,963,6953126.384615385,123.0,68.78571428571429
5624499.0,6,5,336,2,134,0.0,68.0,67.0,3,202,1421118.0,70.0,67.33333333333333
505.0,17,2,166,1,75,0.0,75.0,75.0,1,91,0.0,91.0,91.0
650593.0,6,2,132,1,66,0.0,66.0,66.0,1,66,0.0,66.0,66.0
39646965.0,6,5,336,2,134,0.0,68.0,67.0,3,202,19753987.0,70.0,67.33333333333333
88945905.0,17,14,4788,14,4788,6841992.692307692,342.0,342.0,0,0,0.0,0.0,0.0
303074.0,6,2,132,1,66,0.0,66.0,66.0,1,66,0.0,66.0,66.0
1452.0,17,2,762,2,762,0.0,381.0,381.0,0,0,0.0,0.0,0.0
102659.0,17,2,286,2,286,0.0,143.0,143.0,0,0,0.0,0.0,0.0
135131034.0,17,6,1146,6,1146,27026206.8,191.0,191.0,0,0,0.0,0.0,0.0
90301186.0,6,16,1192,8,596,12894305.42857143,95.0,74.5,8,596,12890414.285714284,95.0,74.5
2313626.0,6,47,23596,24,19731,100592.43478260867,1514.0,822.125,23,3865,95495.63636363635,1514.0,168.04347826086956
14263318.0,17,6,2052,6,2052,2852663.6,342.0,342.0,0,0,0.0,0.0,0.0
233213.0,6,3,337,2,214,0.0,160.0,107.0,1,123,0.0,123.0,123.0
143851.0,17,2,180,1,90,0.0,90.0,90.0,1,90,0.0,90.0,90.0
300186.0,6,6,412,4,272,100062.0,74.0,68.0,2,140,0.0,74.0,70.0
246107.0,6,3,337,2,214,0.0,160.0,107.0,1,123,0.0,123.0,123.0
22666.0,6,14,4740,7,653,3626.1666666666665,249.0,93.28571428571428,7,4087,3595.333333333333,1514.0,583.8571428571429
124014.0,6,10,2032,5,524,30789.25,252.0,104.8,5,1508,27691.5,1236.0,301.6
104681528.0,6,28,1860,14,966,8035821.923076923,123.0,69.0,14,894,8035822.153846154,123.0,63.85714285714285
37707.0,6,14,4740,7,653,6158.833333333333,249.0,93.28571428571428,7,4087,6026.666666666667,1514.0,583.8571428571429
221636.0,6,13,1386,7,789,36939.333333333336,253.0,112.71428571428572,6,597,43288.0,259.0,99.5
110270251.0,17,15,1169,8,606,15752893.0,174.0,75.75,7,563,18166985.0,174.0,80.42857142857143
141711.0,17,4,704,2,148,0.0,74.0,74.0,2,556,0.0,280.0,278.0
117896439.0,6,31,2182,16,1165,7845354.133333334,139.0,72.8125,15,1017,8405744.214285715,123.0,67.8
120124178.0,6,14,2224,9,1204,15015522.25,188.0,133.77777777777777,5,1020,22523629.0,204.0,204.0
44279.0,6,10,2032,5,524,10844.0,252.0,104.8,5,1508,10824.5,1236.0,301.6
20629.0,17,4,823,2,163,0.0,89.0,81.5,2,660,0.0,443.0,330.0
117296019.0,6,48,3168,24,1584,5099826.913043479,66.0,66.0,24,1584,5086146.695652174,66.0,66.0
191049.0,17,2,180,1,90,0.0,90.0,90.0,1,90,0.0,90.0,90.0
55928.0,6,14,4740,7,653,9045.666666666666,249.0,93.28571428571428,7,4087,9055.0,1514.0,583.8571428571429
270828.0,17,4,1524,4,1524,90276.0,381.0,381.0,0,0,0.0,0.0,0.0
20635.0,6,10,2032,5,524,4218.75,252.0,104.8,5,1508,4677.75,1236.0,301.6
2294.0,17,4,344,2,150,0.0,75.0,75.0,2,194,0.0,103.0,97.0
2423.0,17,4,344,2,150,0.0,75.0,75.0,2,194,0.0,103.0,97.0
119631482.0,6,214,24292,107,16934,1126569.1981132077,284.0,158.26168224299064,107,7358,1126568.575471698,140.0,68.76635514018692
6265.0,17,4,344,2,150,0.0,75.0,75.0,2,194,0.0,103.0,97.0
295870.0,6,6,412,4,272,98623.33333333331,74.0,68.0,2,140,0.0,74.0,70.0
282117.0,17,2,180,1,90,0.0,90.0,90.0,1,90,0.0,90.0,90.0
40897.0,6,10,2032,5,524,10004.25,252.0,104.8,5,1508,9668.25,1236.0,301.6
90093602.0,6,10,1562,7,950,15015600.333333334,188.0,135.71428571428572,3,612,30031786.5,204.0,204.0
31298.0,6,14,4740,7,653,4228.333333333333,249.0,93.28571428571428,7,4087,4740.333333333333,1514.0,583.8571428571429
110710.0,17,2,286,2,286,0.0,143.0,143.0,0,0,0.0,0.0,0.0
2322.0,17,4,344,2,150,0.0,75.0,75.0,2,194,0.0,103.0,97.0
14897.0,17,2,180,1,90,0.0,90.0,90.0,1,90,0.0,90.0,90.0
108705231.0,6,32,2236,16,1165,7232624.866666666,139.0,72.8125,16,1071,7232626.266666667,123.0,66.9375
37888.0,6,10,2032,5,524,9198.25,252.0,104.8,5,1508,8372.75,1236.0,301.6
110065.0,17,4,1400,4,1400,36688.333333333336,350.0,350.0,0,0,0.0,0.0,0.0
135130817.0,17,6,1146,6,1146,27026163.4,191.0,191.0,0,0,0.0,0.0,0.0
250779.0,17,4,6056,4,6056,83593.0,1514.0,1514.0,0,0,0.0,0.0,0.0
300441.0,6,6,412,4,272,100147.0,74.0,68.0,2,140,0.0,74.0,70.0
17347.0,6,14,4740,7,653,2296.0,249.0,93.28571428571428,7,4087,2758.6666666666665,1514.0,583.8571428571429
118701787.0,6,236,26750,118,18666,1014545.188034188,284.0,158.1864406779661,118,8084,1012618.5384615384,140.0,68.50847457627118
34017940.0,17,11,4983,11,4983,3401794.0,453.0,453.0,0,0,0.0,0.0,0.0
146291.0,6,3,337,2,214,0.0,160.0,107.0,1,123,0.0,123.0,123.0
108108439.0,17,5,1005,5,1005,27027109.75,201.0,201.0,0,0,0.0,0.0,0.0
90830695.0,6,239,29944,120,8068,763283.1512605041,140.0,67.23333333333333,119,21876,761898.0593220339,300.0,183.83193277310923
503638.00000000006,6,5,336,2,134,0.0,68.0,67.0,3,202,191418.5,70.0,67.33333333333333
111497797.0,6,184,20760,92,14466,1222886.3296703296,284.0,157.2391304347826,92,6294,1222886.076923077,140.0,68.41304347826087
100574549.0,6,29,1983,15,1017,7183896.357142857,123.0,67.8,14,966,7720645.769230769,123.0,69.0
1714833.0,6,23,6509,12,1529,155893.9090909091,357.0,127.41666666666669,11,4980,141082.0,1510.0,452.7272727272728
108121300.0,17,5,955,5,955,27030325.0,191.0,191.0,0,0,0.0,0.0,0.0
134649.0,6,2,132,1,66,0.0,66.0,66.0,1,66,0.0,66.0,66.0
55363.0,6,14,4740,7,653,8529.666666666666,249.0,93.28571428571428,7,4087,9055.166666666666,1514.0,583.8571428571429
5521535.0,6,5,336,2,134,0.0,68.0,67.0,3,202,1421632.0,70.0,67.33333333333333
51728795.0,6,8,2113,3,960,24537038.5,826.0,320.0,5,1153,12287258.25,885.0,230.6
108111142.0,17,5,955,5,955,27027785.5,191.0,191.0,0,0,0.0,0.0,0.0
109071372.0,6,44,2904,22,1452,5193874.857142857,66.0,66.0,22,1452,5178995.333333333,66.0,66.0
3221372.0,6,3,1604,1,753,0.0,753.0,753.0,2,851,0.0,785.0,425.5
120003641.0,6,17,1287,9,691,15000455.125,95.0,76.77777777777777,8,596,12858732.42857143,95.0,74.5
19292.0,6,11,2098,6,590,3499.8,252.0,98.33333333333331,5,1508,3484.75,1236.0,301.6
0.0,17,1,55,1,55,0.0,55.0,55.0,0,0,0.0,0.0,0.0
232414.0,6,3,337,2,214,0.0,160.0,107.0,1,123,0.0,123.0,123.0
118890723.0,6,34,2334,17,1209,7430670.1875,123.0,71.11764705882354,17,1125,7417162.75,123.0,66.17647058823529
111452.0,17,2,286,2,286,0.0,143.0,143.0,0,0,0.0,0.0,0.0
4407.0,17,4,344,2,150,0.0,75.0,75.0,2,194,0.0,103.0,97.0
5005041.0,17,4,849,2,166,0.0,83.0,83.0,2,683,0.0,499.0,341.5
153426.0,17,2,180,1,90,0.0,90.0,90.0,1,90,0.0,90.0,90.0
108101138.0,17,5,955,5,955,27025284.5,191.0,191.0,0,0,0.0,0.0,0.0
1133066.0,6,20,6434,12,1921,103006.0,620.0,160.08333333333334,8,4513,133091.42857142858,1514.0,564.125
2095.0,17,4,344,2,150,0.0,75.0,75.0,2,194,0.0,103.0,97.0
228116.0,17,2,180,1,90,0.0,90.0,90.0,1,90,0.0,90.0,90.0
108106465.0,17,5,955,5,955,27026616.25,191.0,191.0,0,0,0.0,0.0,0.0
327.0,17,2,166,1,75,0.0,75.0,75.0,1,91,0.0,91.0,91.0
209650.0,17,2,180,1,90,0.0,90.0,90.0,1,90,0.0,90.0,90.0
317.0,17,2,164,1,82,0.0,82.0,82.0,1,82,0.0,82.0,82.0
147057.0,6,3,373,2,238,0.0,172.0,119.0,1,135,0.0,135.0,135.0
944.0,17,2,762,2,762,0.0,381.0,381.0,0,0,0.0,0.0,0.0
347.0,17,2,160,1,80,0.0,80.0,80.0,1,80,0.0,80.0,80.0
20460.0,6,2,145,2,145,0.0,91.0,72.5,0,0,0.0,0.0,0.0
105222224.0,17,14,1126,7,563,17537037.333333332,174.0,80.42857142857143,7,563,17381331.666666668,174.0,80.42857142857143
361.0,17,2,166,1,75,0.0,75.0,75.0,1,91,0.0,91.0,91.0
219555.0,6,3,426,2,280,0.0,214.0,140.0,1,146,0.0,146.0,146.0
90051237.0,17,28,13364,28,13364,3335231.0,501.0,477.2857142857143,0,0,0.0,0.0,0.0
232438.0,6,3,337,2,214,0.0,160.0,107.0,1,123,0.0,123.0,123.0
34281.0,6,2,145,2,145,0.0,91.0,72.5,0,0,0.0,0.0,0.0
90033910.0,17,27,12943,27,12943,3462842.6923076925,501.0,479.3703703703704,0,0,0.0,0.0,0.0
288450.0,17,4,1400,4,1400,96150.0,350.0,350.0,0,0,0.0,0.0,0.0
178310.0,17,2,180,1,90,0.0,90.0,90.0,1,90,0.0,90.0,90.0
255576.00000000003,6,3,337,2,214,0.0,160.0,107.0,1,123,0.0,123.0,123.0
146087.0,6,3,337,2,214,0.0,160.0,107.0,1,123,0.0,123.0,123.0
143941.0,17,2,180,1,90,0.0,90.0,90.0,1,90,0.0,90.0,90.0
322194.0,17,4,1400,4,1400,107398.0,350.0,350.0,0,0,0.0,0.0,0.0
7788.0,17,4,344,2,150,0.0,75.0,75.0,2,194,0.0,103.0,97.0
147890.0,17,2,180,1,90,0.0,90.0,90.0,1,90,0.0,90.0,90.0
228342.0,17,2,180,1,90,0.0,90.0,90.0,1,90,0.0,90.0,90.0
2613386.0,6,25,7573,14,3735,201029.6923076923,1514.0,266.7857142857143,11,3838,236027.6,1514.0,348.90909090909093
6832.0,17,2,582,1,83,0.0,83.0,83.0,1,499,0.0,499.0,499.0
34615.0,6,10,2032,5,524,8383.0,252.0,104.8,5,1508,8404.25,1236.0,301.6
53546.0,6,14,4740,7,653,8763.0,249.0,93.28571428571428,7,4087,6909.5,1514.0,583.8571428571429
3462.0,17,2,414,1,88,0.0,88.0,88.0,1,326,0.0,326.0,326.0
90061083.0,17,28,13364,28,13364,3335595.6666666665,501.0,477.2857142857143,0,0,0.0,0.0,0.0
120061034.0,17,29,13785,29,13785,4287894.071428572,501.0,475.3448275862069,0,0,0.0,0.0,0.0
311276.0,6,3,202,2,128,0.0,74.0,64.0,1,74,0.0,74.0,74.0
734.0,17,4,438,2,148,0.0,74.0,74.0,2,290,0.0,147.0,145.0
538686.0,17,6,2100,6,2100,107737.2,350.0,350.0,0,0,0.0,0.0,0.0
121853.0,6,3,337,2,214,0.0,160.0,107.0,1,123,0.0,123.0,123.0
58079.0,6,14,4740,7,653,8916.0,249.0,93.28571428571428,7,4087,9510.666666666666,1514.0,583.8571428571429
313631.0,6,6,412,4,272,104543.66666666669,74.0,68.0,2,140,0.0,74.0,70.0
214010.0,17,4,1524,4,1524,71336.66666666667,381.0,381.0,0,0,0.0,0.0,0.0
2328363.0,6,25,7573,14,3735,179104.84615384616,1514.0,266.7857142857143,11,3838,207894.4,1514.0,348.90909090909093
219273.0,6,3,426,2,280,0.0,214.0,140.0,1,146,0.0,146.0,146.0
90299458.0,6,20,1531,10,786,10027579.0,95.0,78.6,10,745,9935635.111111112,95.0,74.5
54395.0,6,10,2032,5,524,13128.75,252.0,104.8,5,1508,12560.75,1236.0,301.6
120705.0,6,3,337,2,214,0.0,160.0,107.0,1,123,0.0,123.0,123.0
120242367.0,6,216,24312,108,7350,1115940.5046728973,140.0,68.05555555555556,108,16962,1097573.1495327102,284.0,157.05555555555554
218327.0,6,3,426,2,280,0.0,214.0,140.0,1,146,0.0,146.0,146.0
2371.0,17,4,344,2,150,0.0,75.0,75.0,2,194,0.0,103.0,97.0
90061626.0,17,28,13364,28,13364,3335615.777777778,501.0,477.2857142857143,0,0,0.0,0.0,0.0
143295.0,6,2,132,1,66,0.0,66.0,66.0,1,66,0.0,66.0,66.0
212235.0,17,2,180,1,90,0.0,90.0,90.0,1,90,0.0,90.0,90.0
1283955.0,17,7,490,7,490,213992.5,70.0,70.0,0,0,0.0,0.0,0.0
120021961.0,17,28,13364,28,13364,4445257.814814814,501.0,477.2857142857143,0,0,0.0,0.0,0.0
850263.0,6,9,1196,6,725,170052.6,387.0,120.83333333333331,3,471,288804.0,331.0,157.0
196937.0,17,2,180,1,90,0.0,90.0,90.0,1,90,0.0,90.0,90.0
242709.0,6,3,337,2,214,0.0,160.0,107.0,1,123,0.0,123.0,123.0
103155.0,17,2,286,2,286,0.0,143.0,143.0,0,0,0.0,0.0,0.0
37046.0,6,10,2032,5,524,8848.5,252.0,104.8,5,1508,7611.5,1236.0,301.6
442.0,17,2,166,1,75,0.0,75.0,75.0,1,91,0.0,91.0,91.0
120286558.0,6,229,25928,115,18108,1055145.245614035,284.0,157.4608695652174,114,7820,1057311.796460177,140.0,68.59649122807018
474.0,17,2,508,2,508,0.0,257.0,254.0,0,0,0.0,0.0,0.0
121319.0,6,3,337,2,214,0.0,160.0,107.0,1,123,0.0,123.0,123.0
2800379.0,6,2,132,1,66,0.0,66.0,66.0,1,66,0.0,66.0,66.0
139.0,17,3,1050,3,1050,69.5,350.0,350.0,0,0,0.0,0.0,0.0
537479.0,17,6,2100,6,2100,107495.8,350.0,350.0,0,0,0.0,0.0,0.0
58540.0,6,10,2032,5,524,14404.25,252.0,104.8,5,1508,11159.25,1236.0,301.6
2792156.0,6,11,2106,6,598,558246.0,252.0,99.66666666666669,5,1508,3061.5,1236.0,301.6
108348013.0,17,7,1452,6,1146,21669602.6,191.0,191.0,1,306,0.0,306.0,306.0
123609698.0,6,32,2226,17,1209,7725606.125,123.0,71.11764705882354,15,1017,8100677.357142857,123.0,67.8
92009347.0,17,16,5472,16,5472,6133956.466666667,342.0,342.0,0,0,0.0,0.0,0.0
449838.0,6,3,204,1,68,0.0,68.0,68.0,2,136,0.0,70.0,68.0
153504.0,17,2,180,1,90,0.0,90.0,90.0,1,90,0.0,90.0,90.0
38221.0,6,14,4740,7,653,6246.833333333333,249.0,93.28571428571428,7,4087,5703.5,1514.0,583.8571428571429
68686.0,6,14,4740,7,653,11093.5,249.0,93.28571428571428,7,4087,10404.166666666666,1514.0,583.8571428571429
291374.0,17,2,246,1,76,0.0,76.0,76.0,1,170,0.0,170.0,170.0
321236.0,17,4,1400,4,1400,107078.66666666669,350.0,350.0,0,0,0.0,0.0,0.0
308865.0,6,3,202,2,128,0.0,74.0,64.0,1,74,0.0,74.0,74.0
217937.0,6,3,426,2,280,0.0,214.0,140.0,1,146,0.0,146.0,146.0
119600828.0,6,244,27548,122,19200,986729.0661157024,284.0,157.37704918032787,122,8348,986740.5123966942,140.0,68.42622950819673
323949.0,17,4,1400,4,1400,107983.0,350.0,350.0,0,0,0.0,0.0,0.0
121461.0,6,3,337,2,214,0.0,160.0,107.0,1,123,0.0,123.0,123.0
49284.0,6,14,4740,7,653,7904.0,249.0,93.28571428571428,7,4087,6437.5,1514.0,583.8571428571429
90224380.0,6,16,1192,8,596,12853810.142857144,95.0,74.5,8,596,12858074.714285716,95.0,74.5
14349.0,6,14,4740,7,653,2286.0,249.0,93.28571428571428,7,4087,2253.6666666666665,1514.0,583.8571428571429
204718.0,17,2,762,2,762,0.0,381.0,381.0,0,0,0.0,0.0,0.0
353594.0,6,6,412,4,272,117864.66666666669,74.0,68.0,2,140,0.0,74.0,70.0
108814827.0,17,14,864,7,432,18109116.0,174.0,61.71428571428572,7,432,17866001.5,174.0,61.71428571428572
4419.0,17,2,598,1,72,0.0,72.0,72.0,1,526,0.0,526.0,526.0
106636830.0,6,28,2008,14,963,8202833.076923077,123.0,68.78571428571429,14,1045,7418968.076923077,139.0,74.64285714285714
2349.0,17,4,344,2,150,0.0,75.0,75.0,2,194,0.0,103.0,97.0
45661.0,6,14,4740,7,653,7491.5,249.0,93.28571428571428,7,4087,6372.666666666667,1514.0,583.8571428571429
218367.0,6,3,426,2,280,0.0,214.0,140.0,1,146,0.0,146.0,146.0
2807.0,17,2,180,1,90,0.0,90.0,90.0,1,90,0.0,90.0,90.0
220239.0,6,4,492,2,280,0.0,214.0,140.0,2,212,0.0,146.0,106.0
35819.0,6,14,4740,7,653,5844.333333333333,249.0,93.28571428571428,7,4087,5830.5,1514.0,583.8571428571429
37469.0,6,14,4740,7,653,6115.666666666667,249.0,93.28571428571428,7,4087,6105.0,1514.0,583.8571428571429
120050324.0,17,29,13785,29,13785,4287511.571428572,501.0,475.3448275862069,0,0,0.0,0.0,0.0
239087.0,17,2,180,1,90,0.0,90.0,90.0,1,90,0.0,90.0,90.0
267823.0,6,4,492,2,280,0.0,214.0,140.0,2,212,0.0,146.0,106.0
102185458.0,6,179,20188,90,6174,1148151.2134831462,140.0,68.6,89,14014,1149465.693181818,284.0,157.46067415730337
14292535.0,17,6,2052,6,2052,2858507.0,342.0,342.0,0,0,0.0,0.0,0.0
2008.0,17,4,344,2,150,0.0,75.0,75.0,2,194,0.0,103.0,97.0
90256898.0,6,12,1832,8,1016,12893842.57142857,188.0,127.0,4,816,30031660.666666668,204.0,204.0
40372.0,6,14,4740,7,653,6609.166666666667,249.0,93.28571428571428,7,4087,4955.333333333333,1514.0,583.8571428571429
244964.0,6,3,337,2,214,0.0,160.0,107.0,1,123,0.0,123.0,123.0
46744.0,6,14,4740,7,653,7623.666666666667,249.0,93.28571428571428,7,4087,7649.5,1514.0,583.8571428571429
126983721.0,17,14,864,7,432,17834568.833333332,174.0,61.71428571428572,7,432,17833497.833333332,174.0,61.71428571428572
0.0,6,1,66,1,66,0.0,66.0,66.0,0,0,0.0,0.0,0.0
120000169.0,6,17,1287,9,691,15000021.125,95.0,76.77777777777777,8,596,12898995.42857143,95.0,74.5
1024402.0,6,11,1134,6,558,204880.4,220.0,93.0,5,576,254431.25,304.0,115.2
202785.0,6,10,1221,6,636,40557.0,298.0,106.0,4,585,66175.33333333333,379.0,146.25
5632483.0,6,5,336,2,134,0.0,68.0,67.0,3,202,1411107.0,70.0,67.33333333333333
205980.0,17,2,180,1,90,0.0,90.0,90.0,1,90,0.0,90.0,90.0
12612348.0,6,5,1736,2,819,0.0,753.0,409.5,3,917,6233722.5,785.0,305.6666666666667
118906191.0,6,35,2526,18,1332,6994481.823529412,123.0,74.0,17,1194,7418156.625,123.0,70.23529411764706
285089.0,17,2,363,1,79,0.0,79.0,79.0,1,284,0.0,284.0,284.0
31564.0,6,14,4740,7,653,4531.333333333333,249.0,93.28571428571428,7,4087,4909.166666666667,1514.0,583.8571428571429
230720.0,6,12,1373,7,714,38453.333333333336,298.0,102.0,5,659,56340.0,379.0,131.8
33120.0,6,14,4740,7,653,5349.333333333333,249.0,93.28571428571428,7,4087,5385.833333333333,1514.0,583.8571428571429
114189.0,17,2,286,2,286,0.0,143.0,143.0,0,0,0.0,0.0,0.0
146115.0,6,3,337,2,214,0.0,160.0,107.0,1,123,0.0,123.0,123.0
135154390.0,17,6,1146,6,1146,27030878.0,191.0,191.0,0,0,0.0,0.0,0.0
40617.0,6,14,4740,7,653,6186.666666666667,249.0,93.28571428571428,7,4087,6333.166666666667,1514.0,583.8571428571429
54667.0,6,14,4740,7,653,8821.833333333334,249.0,93.28571428571428,7,4087,7043.0,1514.0,583.8571428571429
108112119.0,17,5,955,5,955,27028029.75,191.0,191.0,0,0,0.0,0.0,0.0
747.0,17,4,438,2,148,0.0,74.0,74.0,2,290,0.0,147.0,145.0
99429.0,17,2,762,2,762,0.0,381.0,381.0,0,0,0.0,0.0,0.0
120200391.0,6,18,1341,9,691,14999369.375,95.0,76.77777777777777,9,650,14999352.5,95.0,72.22222222222223
108100918.0,17,5,1005,5,1005,27025229.5,201.0,201.0,0,0,0.0,0.0,0.0
216436.0,17,2,180,1,90,0.0,90.0,90.0,1,90,0.0,90.0,90.0
105147340.0,17,15,5130,15,5130,7510524.285714285,342.0,342.0,0,0,0.0,0.0,0.0
4158.0,17,2,582,1,83,0.0,83.0,83.0,1,499,0.0,499.0,499.0
97205.0,17,2,762,2,762,0.0,381.0,381.0,0,0,0.0,0.0,0.0
10460027.0,6,7,478,4,272,3441397.333333333,74.0,68.0,3,206,5161985.0,74.0,68.66666666666667
2112.0,17,2,684,1,342,0.0,342.0,342.0,1,342,0.0,342.0,342.0
32682745.0,6,5,336,2,134,0.0,68.0,67.0,3,202,16269723.500000002,70.0,67.33333333333333
108089426.0,17,5,1005,5,1005,27022356.5,201.0,201.0,0,0,0.0,0.0,0.0
105552121.0,6,958,223074,468,31702,225816.9721627409,214.0,67.73931623931624,490,191372,215813.33946830267,1514.0,390.55510204081634
2069283.0,6,18,6803,10,1501,229920.3333333333,408.0,150.1,8,5302,233078.57142857145,1514.0,662.75
52357570.0,17,4,360,2,180,0.0,90.0,90.0,2,180,0.0,90.0,90.0
4469.0,17,2,626,1,72,0.0,72.0,72.0,1,554,0.0,554.0,554.0
228318.0,17,2,180,1,90,0.0,90.0,90.0,1,90,0.0,90.0,90.0
90258444.0,6,12,1832,8,1016,12894063.42857143,188.0,127.0,4,816,30031239.33333333,204.0,204.0
206157.0,6,3,426,2,280,0.0,214.0,140.0,1,146,0.0,146.0,146.0
29933.0,6,14,4740,7,653,4178.666666666667,249.0,93.28571428571428,7,4087,4714.833333333333,1514.0,583.8571428571429
450951.0,6,10,1221,6,636,90190.2,298.0,106.0,4,585,144977.0,379.0,146.25
297575.0,6,6,412,4,272,99191.66666666669,74.0,68.0,2,140,0.0,74.0,70.0
41175.0,6,10,2032,5,524,10003.75,252.0,104.8,5,1508,9202.75,1236.0,301.6
108972.0,17,2,286,2,286,0.0,143.0,143.0,0,0,0.0,0.0,0.0
135129477.0,17,6,1146,6,1146,27025895.4,191.0,191.0,0,0,0.0,0.0,0.0
48929.0,6,14,4740,7,653,8023.333333333333,249.0,93.28571428571428,7,4087,7828.0,1514.0,583.8571428571429
15899.0,6,14,4740,7,653,2492.833333333333,249.0,93.28571428571428,7,4087,2513.5,1514.0,583.8571428571429
135127423.0,17,6,1206,6,1206,27025484.6,201.0,201.0,0,0,0.0,0.0,0.0
90045751.0,17,28,13364,28,13364,3335027.814814815,501.0,477.2857142857143,0,0,0.0,0.0,0.0
135133354.0,17,6,1206,6,1206,27026670.8,201.0,201.0,0,0,0.0,0.0,0.0
205829.0,17,2,180,1,90,0.0,90.0,90.0,1,90,0.0,90.0,90.0
120064995.0,6,457,53910,229,15348,526600.8552631579,140.0,67.02183406113537,228,38562,527926.8810572687,284.0,169.1315789473684
101016066.0,17,12,516,6,258,20001372.2,43.0,43.0,6,258,20000168.0,43.0,43.0
109934.0,17,2,762,2,762,0.0,381.0,381.0,0,0,0.0,0.0,0.0
112991008.0,6,31,2166,16,1149,7519109.666666667,123.0,71.8125,15,1017,8056184.428571428,123.0,67.8
2327.0,17,4,344,2,150,0.0,75.0,75.0,2,194,0.0,103.0,97.0
239207.0,17,2,180,1,90,0.0,90.0,90.0,1,90,0.0,90.0,90.0
931380.0,17,10,3776,10,3776,103486.66666666669,394.0,377.6,0,0,0.0,0.0,0.0
843.0,17,2,762,2,762,0.0,381.0,381.0,0,0,0.0,0.0,0.0
115001132.0,17,15,1169,8,606,16428733.142857144,174.0,75.75,7,563,15832275.166666666,174.0,80.42857142857143
153472.0,17,2,180,1,90,0.0,90.0,90.0,1,90,0.0,90.0,90.0
120277394.0,17,15,1169,7,563,20046232.33333333,174.0,80.42857142857143,8,606,17117297.285714287,174.0,75.75
4702.0,17,4,571,2,148,0.0,74.0,74.0,2,423,0.0,280.0,211.5
95304261.0,6,39,2574,20,1320,5016000.105263158,66.0,66.0,19,1254,5159994.722222222,66.0,66.0
3179274.0,6,18,1495,9,921,358368.875,315.0,102.33333333333331,9,574,358337.625,78.0,63.77777777777778
233085.0,6,3,337,2,214,0.0,160.0,107.0,1,123,0.0,123.0,123.0
29004.0,6,14,4740,7,653,4667.833333333333,249.0,93.28571428571428,7,4087,3847.8333333333335,1514.0,583.8571428571429
7094.0,17,2,582,1,83,0.0,83.0,83.0,1,499,0.0,499.0,499.0
103317.0,17,2,286,2,286,0.0,143.0,143.0,0,0,0.0,0.0,0.0
103999.0,17,2,286,2,286,0.0,143.0,143.0,0,0,0.0,0.0,0.0
208093.0,17,2,762,2,762,0.0,381.0,381.0,0,0,0.0,0.0,0.0
115287.0,17,4,1400,4,1400,38429.0,350.0,350.0,0,0,0.0,0.0,0.0
34619.0,6,14,4740,7,653,5647.0,249.0,93.28571428571428,7,4087,5631.666666666667,1514.0,583.8571428571429
16780.0,6,14,4740,7,653,2284.833333333333,249.0,93.28571428571428,7,4087,2659.833333333333,1514.0,583.8571428571429
40495.0,6,14,4740,7,653,5937.666666666667,249.0,93.28571428571428,7,4087,6243.666666666667,1514.0,583.8571428571429
328.0,17,2,166,1,75,0.0,75.0,75.0,1,91,0.0,91.0,91.0
317697.0,17,4,1400,4,1400,105899.0,350.0,350.0,0,0,0.0,0.0,0.0
90256546.0,6,14,2240,8,1016,12893792.285714284,188.0,127.0,6,1224,18018401.6,204.0,204.0
90058651.0,17,28,13364,28,13364,3335505.592592593,501.0,477.2857142857143,0,0,0.0,0.0,0.0
22861361.0,6,5,1736,2,819,0.0,753.0,409.5,3,917,11363929.0,785.0,305.6666666666667
200579.0,17,4,6056,4,6056,66859.66666666667,1514.0,1514.0,0,0,0.0,0.0,0.0
19504.0,6,14,4740,7,653,3131.1666666666665,249.0,93.28571428571428,7,4087,3095.5,1514.0,583.8571428571429
2452.0,17,4,344,2,150,0.0,75.0,75.0,2,194,0.0,103.0,97.0
60737244.0,6,4,270,2,134,0.0,68.0,67.0,2,136,0.0,70.0,68.0
19651.0,6,10,2032,5,524,4682.25,252.0,104.8,5,1508,4495.25,1236.0,301.6
283192.0,17,2,363,1,79,0.0,79.0,79.0,1,284,0.0,284.0,284.0
27069.0,6,14,4740,7,653,4299.166666666667,249.0,93.28571428571428,7,4087,4194.0,1514.0,583.8571428571429
328.0,17,2,174,1,79,0.0,79.0,79.0,1,95,0.0,95.0,95.0
120119878.0,6,16,2368,7,1164,20019979.666666668,204.0,166.28571428571428,9,1204,14994727.0,188.0,133.77777777777777
113520304.0,6,46,3036,23,1518,5160001.5,66.0,66.0,23,1518,5159999.909090909,66.0,66.0
90255591.0,6,17,2572,9,1204,11281948.875,188.0,133.77777777777777,8,1368,12870621.0,204.0,171.0
20875.0,17,4,344,2,150,0.0,75.0,75.0,2,194,0.0,103.0,97.0
112464254.0,6,46,3036,23,1518,5112000.181818182,66.0,66.0,23,1518,5111997.136363637,66.0,66.0
840351.0,6,5,1742,3,921,420175.5,785.0,307.0,2,821,0.0,753.0,410.5
210488.0,6,10,1221,6,636,42097.6,298.0,106.0,4,585,69203.33333333333,379.0,146.25
5832815.0,6,4,270,2,134,0.0,68.0,67.0,2,136,0.0,70.0,68.0
102026.0,17,2,286,2,286,0.0,143.0,143.0,0,0,0.0,0.0,0.0
30390.0,6,14,4740,7,653,4939.0,249.0,93.28571428571428,7,4087,4931.666666666667,1514.0,583.8571428571429
2796094.0,6,2,132,1,66,0.0,66.0,66.0,1,66,0.0,66.0,66.0
3408.0,17,4,571,2,148,0.0,74.0,74.0,2,423,0.0,280.0,211.5
90056888.0,17,28,13364,28,13364,3335440.296296296,501.0,477.2857142857143,0,0,0.0,0.0,0.0
9130.0,17,2,582,1,83,0.0,83.0,83.0,1,499,0.0,499.0,499.0
119277869.0,6,751,97550,376,72504,318074.3173333333,336.0,192.82978723404256,375,25046,316461.0,140.0,66.78933333333333
299860.0,6,6,412,4,272,99953.33333333331,74.0,68.0,2,140,0.0,74.0,70.0
1303664.0,6,4,264,2,132,0.0,66.0,66.0,2,132,0.0,66.0,66.0
147929.0,17,2,180,1,90,0.0,90.0,90.0,1,90,0.0,90.0,90.0
241984.0,6,3,337,2,214,0.0,160.0,107.0,1,123,0.0,123.0,123.0
233043.0,6,3,337,2,214,0.0,160.0,107.0,1,123,0.0,123.0,123.0
148913.0,17,2,414,1,88,0.0,88.0,88.0,1,326,0.0,326.0,326.0
62765.0,6,14,4740,7,653,10156.5,249.0,93.28571428571428,7,4087,7992.5,1514.0,583.8571428571429
119792752.0,6,19,1395,10,745,13283224.0,95.0,74.5,9,650,14943739.875,95.0,72.22222222222223
24157.0,6,10,2032,5,524,5210.75,252.0,104.8,5,1508,5754.75,1236.0,301.6
119807821.0,6,23,1734,11,840,11980782.1,95.0,76.36363636363636,12,894,10868164.636363637,95.0,74.5
120761854.0,6,228,25820,114,7820,1057639.725663717,140.0,68.59649122807018,114,18000,1061567.1327433628,300.0,157.89473684210526
149050.0,6,3,373,2,238,0.0,172.0,119.0,1,135,0.0,135.0,135.0
1246060.0,6,7,499,4,301,411330.6666666667,103.0,75.25,3,198,613982.0,66.0,66.0
558.0,17,2,508,2,508,0.0,257.0,254.0,0,0,0.0,0.0,0.0
9983.0,17,4,823,2,163,0.0,89.0,81.5,2,660,0.0,443.0,330.0
2747893.0,6,25,7573,14,3735,211376.38461538465,1514.0,266.7857142857143,11,3838,248328.2,1514.0,348.90909090909093
392161.0,17,2,363,1,75,0.0,75.0,75.0,1,288,0.0,288.0,288.0
45831.0,6,14,4740,7,653,7408.833333333333,249.0,93.28571428571428,7,4087,7496.5,1514.0,583.8571428571429
24540.0,6,14,4740,7,653,3873.6666666666665,249.0,93.28571428571428,7,4087,3854.3333333333335,1514.0,583.8571428571429
291994.0,17,2,224,1,76,0.0,76.0,76.0,1,148,0.0,148.0,148.0
222037.0,17,2,180,1,90,0.0,90.0,90.0,1,90,0.0,90.0,90.0
0.0,6,1,66,1,66,0.0,66.0,66.0,0,0,0.0,0.0,0.0
107930.0,17,2,286,2,286,0.0,143.0,143.0,0,0,0.0,0.0,0.0
143937.0,17,2,180,1,90,0.0,90.0,90.0,1,90,0.0,90.0,90.0
258110.0,6,3,337,2,214,0.0,160.0,107.0,1,123,0.0,123.0,123.0
2041.0,17,4,344,2,150,0.0,75.0,75.0,2,194,0.0,103.0,97.0
295887.0,17,4,1524,4,1524,98629.0,381.0,381.0,0,0,0.0,0.0,0.0
120119990.0,6,14,2240,6,1224,24023998.0,204.0,204.0,8,1016,17097433.714285713,188.0,127.0
120010024.0,17,29,13785,29,13785,4286072.285714285,501.0,475.3448275862069,0,0,0.0,0.0,0.0
127945348.0,6,34,2350,17,1125,7372507.4375,123.0,66.17647058823529,17,1225,7713318.25,139.0,72.05882352941177
2278.0,17,4,344,2,150,0.0,75.0,75.0,2,194,0.0,103.0,97.0
319.0,17,2,174,1,79,0.0,79.0,79.0,1,95,0.0,95.0,95.0
303896.0,6,6,412,4,272,101298.66666666669,74.0,68.0,2,140,0.0,74.0,70.0
108111144.0,17,5,955,5,955,27027786.0,191.0,191.0,0,0,0.0,0.0,0.0
2801289.0,6,2,132,1,66,0.0,66.0,66.0,1,66,0.0,66.0,66.0
122025170.0,6,30,1990,15,948,8002725.571428572,123.0,63.2,15,1042,8002738.142857143,139.0,69.46666666666667
220729.0,6,3,426,2,280,0.0,214.0,140.0,1,146,0.0,146.0,146.0
107078.0,17,2,700,2,700,0.0,350.0,350.0,0,0,0.0,0.0,0.0
22446.0,6,14,4740,7,653,3291.1666666666665,249.0,93.28571428571428,7,4087,3549.333333333333,1514.0,583.8571428571429
109000920.0,17,13,821,7,432,18166820.0,174.0,61.71428571428572,6,389,17804187.2,174.0,64.83333333333333
2325.0,17,4,344,2,150,0.0,75.0,75.0,2,194,0.0,103.0,97.0
16729.0,6,14,4740,7,653,2480.1666666666665,249.0,93.28571428571428,7,4087,2225.333333333333,1514.0,583.8571428571429
1029120.0,6,11,1134,6,558,205824.00000000003,220.0,93.0,5,576,255435.5,304.0,115.2
2799236.0,6,2,132,1,66,0.0,66.0,66.0,1,66,0.0,66.0,66.0
19279.0,6,10,2032,5,524,4588.0,252.0,104.8,5,1508,4436.25,1236.0,301.6
49631.0,6,14,4740,7,653,7951.833333333333,249.0,93.28571428571428,7,4087,7751.333333333333,1514.0,583.8571428571429
2422.0,17,4,344,2,150,0.0,75.0,75.0,2,194,0.0,103.0,97.0
96659715.0,6,182,20554,91,6228,1065166.9666666666,140.0,68.43956043956044,91,14326,1064968.3777777778,284.0,157.42857142857142
108109145.0,17,5,955,5,955,27027286.25,191.0,191.0,0,0,0.0,0.0,0.0
258326.0,6,3,373,2,238,0.0,172.0,119.0,1,135,0.0,135.0,135.0
248272.0,6,3,337,2,214,0.0,160.0,107.0,1,123,0.0,123.0,123.0
6880.0,17,2,582,1,83,0.0,83.0,83.0,1,499,0.0,499.0,499.0
95425064.0,6,40,2640,20,1320,5022371.7894736845,66.0,66.0,20,1320,5007876.578947368,66.0,66.0
125087824.0,6,30,2037,15,948,8409366.142857144,123.0,63.2,15,1089,8415569.0,123.0,72.6
1241219.0,6,7,499,4,301,387400.0,103.0,75.25,3,198,613000.0,66.0,66.0
128172297.0,6,35,2463,17,1194,7386741.1875,123.0,70.23529411764706,18,1269,7539385.588235294,123.0,70.5
120042493.0,17,29,13785,29,13785,4287231.892857143,501.0,475.3448275862069,0,0,0.0,0.0,0.0
283798.0,17,2,363,1,79,0.0,79.0,79.0,1,284,0.0,284.0,284.0
90287320.0,6,23,1911,12,853,8204303.636363637,95.0,71.08333333333333,11,1058,9028497.3,154.0,96.1818181818182
262996.0,6,10,1221,6,636,52599.2,298.0,106.0,4,585,82288.33333333333,379.0,146.25
90302471.0,6,17,1287,9,691,11282486.75,95.0,76.77777777777777,8,596,12833525.857142856,95.0,74.5
41990387.0,6,4,1670,3,917,20995193.5,785.0,305.6666666666667,1,753,0.0,753.0,753.0
206625.0,17,2,180,1,90,0.0,90.0,90.0,1,90,0.0,90.0,90.0
126831.0,6,12,1320,7,789,21138.5,253.0,112.71428571428572,5,531,30304.5,259.0,106.2
302416.0,6,2,132,1,66,0.0,66.0,66.0,1,66,0.0,66.0,66.0
37294.0,6,10,2032,5,524,6014.75,252.0,104.8,5,1508,8141.75,1236.0,301.6
144188.0,17,2,180,1,90,0.0,90.0,90.0,1,90,0.0,90.0,90.0
90025205.0,17,28,13364,28,13364,3334266.851851852,501.0,477.2857142857143,0,0,0.0,0.0,0.0
718952.0,17,6,1230,3,234,359236.5,78.0,78.0,3,996,359282.0,332.0,332.0
14009.0,6,11,2098,6,590,2315.8,252.0,98.33333333333331,5,1508,2969.0,1236.0,301.6
4030619.0,6,12,2128,7,620,671769.8333333334,252.0,88.57142857142857,5,1508,1000666.0,1236.0,301.6
337.0,17,2,248,1,84,0.0,84.0,84.0,1,164,0.0,164.0,164.0
1050957.0,6,13,1386,7,789,175159.5,253.0,112.71428571428572,6,597,207609.6,259.0,99.5
124352583.0,6,32,2157,16,1071,7624554.0,123.0,66.9375,16,1086,8290050.4,123.0,67.875
316.0,17,2,174,1,79,0.0,79.0,79.0,1,95,0.0,95.0,95.0
122668.0,6,4,439,2,238,0.0,172.0,119.0,2,201,0.0,135.0,100.5
120553127.0,6,315,36458,158,25800,767854.3121019108,570.0,163.29113924050634,157,10658,766124.0576923077,140.0,67.88535031847134
108109262.0,17,5,1005,5,1005,27027315.5,201.0,201.0,0,0,0.0,0.0,0.0
10455441.0,6,7,478,4,272,3439771.333333333,74.0,68.0,3,206,5159572.5,74.0,68.66666666666667
188476.0,17,2,180,1,90,0.0,90.0,90.0,1,90,0.0,90.0,90.0
120285394.0,6,236,26580,118,8084,1021148.1794871796,140.0,68.50847457627118,118,18496,1021055.264957265,300.0,156.74576271186442
80210.0,6,10,2032,5,524,19440.0,252.0,104.8,5,1508,19780.0,1236.0,301.6
119757533.0,6,226,25566,113,17886,1067337.5625,284.0,158.28318584070797,113,7680,1067339.7857142857,140.0,67.96460176991151
121715.0,6,3,337,2,214,0.0,160.0,107.0,1,123,0.0,123.0,123.0
2088.0,17,4,344,2,150,0.0,75.0,75.0,2,194,0.0,103.0,97.0
111431.0,17,2,286,2,286,0.0,143.0,143.0,0,0,0.0,0.0,0.0
44571.0,6,10,2032,5,524,10878.0,252.0,104.8,5,1508,10397.5,1236.0,301.6
214334.0,17,2,359,1,75,0.0,75.0,75.0,1,284,0.0,284.0,284.0
50818.0,6,14,4740,7,653,7119.666666666667,249.0,93.28571428571428,7,4087,8229.333333333334,1514.0,583.8571428571429
138001256.0,17,17,1255,9,649,17250157.0,174.0,72.11111111111111,8,606,16791255.42857143,174.0,75.75
123610571.0,6,49,3234,25,1650,5150440.458333333,66.0,66.0,24,1584,5040733.043478261,66.0,66.0
144017.0,17,2,180,1,90,0.0,90.0,90.0,1,90,0.0,90.0,90.0
90052104.0,17,28,13364,28,13364,3335263.111111111,501.0,477.2857142857143,0,0,0.0,0.0,0.0
771.0,17,4,438,2,148,0.0,74.0,74.0,2,290,0.0,147.0,145.0
120058238.0,17,28,13364,28,13364,4446601.407407408,501.0,477.2857142857143,0,0,0.0,0.0,0.0
83008414.0,17,14,4796,13,4446,6228764.25,342.0,342.0,1,350,0.0,350.0,350.0
118254453.0,6,34,2482,17,1194,7390878.125,123.0,70.23529411764706,17,1288,6766789.625,139.0,75.76470588235294
20029.0,6,14,4740,7,653,3190.5,249.0,93.28571428571428,7,4087,3202.0,1514.0,583.8571428571429
205789.0,17,2,180,1,90,0.0,90.0,90.0,1,90,0.0,90.0,90.0
120247447.0,6,230,25978,115,7886,1047555.4561403508,140.0,68.57391304347826,115,18092,1047638.5877192982,284.0,157.3217391304348
91614685.0,17,12,778,6,389,18201556.0,174.0,64.83333333333333,6,389,18200166.0,174.0,64.83333333333333
2893042.0,6,3,1604,1,753,0.0,753.0,753.0,2,851,0.0,785.0,425.5
117008632.0,17,15,1169,8,606,16715518.857142856,174.0,75.75,7,563,16166781.333333334,174.0,80.42857142857143
2007.0,17,4,344,2,150,0.0,75.0,75.0,2,194,0.0,103.0,97.0
91538259.0,6,521,67318,261,49936,352070.2269230769,374.0,191.3256704980843,260,17382,352106.75675675675,140.0,66.85384615384615
108112870.0,17,5,1005,5,1005,27028217.5,201.0,201.0,0,0,0.0,0.0,0.0
2779858.0,6,3,202,1,66,0.0,66.0,66.0,2,136,0.0,70.0,68.0
111700398.0,6,30,1974,15,1026,7963994.357142857,123.0,68.4,15,948,7963996.142857143,123.0,63.2
15017.0,17,2,180,1,90,0.0,90.0,90.0,1,90,0.0,90.0,90.0
51082.0,6,14,4740,7,653,8393.166666666666,249.0,93.28571428571428,7,4087,7823.5,1514.0,583.8571428571429
287.0,17,2,174,1,79,0.0,79.0,79.0,1,95,0.0,95.0,95.0
213655.0,17,2,180,1,90,0.0,90.0,90.0,1,90,0.0,90.0,90.0
228166.0,17,2,180,1,90,0.0,90.0,90.0,1,90,0.0,90.0,90.0
2101.0,17,4,344,2,150,0.0,75.0,75.0,2,194,0.0,103.0,97.0
303369.0,6,6,412,4,272,101123.0,74.0,68.0,2,140,0.0,74.0,70.0
90283515.0,6,16,1192,8,596,12891345.142857144,95.0,74.5,8,596,12897052.857142856,95.0,74.5
228254.0,17,2,180,1,90,0.0,90.0,90.0,1,90,0.0,90.0,90.0
213132.0,17,2,414,1,88,0.0,88.0,88.0,1,326,0.0,326.0,326.0
2368.0,17,4,344,2,150,0.0,75.0,75.0,2,194,0.0,103.0,97.0
3373.0,17,2,359,1,75,0.0,75.0,75.0,1,284,0.0,284.0,284.0
107085.0,17,2,286,2,286,0.0,143.0,143.0,0,0,0.0,0.0,0.0
5005469.0,17,4,629,2,156,0.0,78.0,78.0,2,473,0.0,268.0,236.5
10436446.0,6,6,412,3,206,5148602.5,74.0,68.66666666666667,3,206,5148507.0,74.0,68.66666666666667
100705.0,17,2,286,2,286,0.0,143.0,143.0,0,0,0.0,0.0,0.0
35786.0,6,14,4740,7,653,5846.0,249.0,93.28571428571428,7,4087,5621.333333333333,1514.0,583.8571428571429
3799.0,17,4,344,2,150,0.0,75.0,75.0,2,194,0.0,103.0,97.0
120027824.0,17,28,13364,28,13364,4445474.962962963,501.0,477.2857142857143,0,0,0.0,0.0,0.0
90923240.0,6,21,1585,11,840,9090890.0,95.0,76.36363636363636,10,745,10100546.888888888,95.0,74.5
10477324.0,6,7,478,4,272,3445457.6666666665,74.0,68.0,3,206,5166374.0,74.0,68.66666666666667
90296559.0,6,16,1192,8,596,12893564.57142857,95.0,74.5,8,596,12898326.0,95.0,74.5
301666.0,6,6,412,4,272,100555.33333333331,74.0,68.0,2,140,0.0,74.0,70.0
2601048.0,6,2,132,1,66,0.0,66.0,66.0,1,66,0.0,66.0,66.0
5132.0,17,4,344,2,150,0.0,75.0,75.0,2,194,0.0,103.0,97.0
90093612.0,6,11,1644,4,816,30030422.33333333,204.0,204.0,7,828,15014970.0,188.0,118.28571428571428
120112054.0,6,13,2036,5,1020,30028013.5,204.0,204.0,8,1016,17135705.0,188.0,127.0
90258671.0,6,16,2372,8,1016,12894095.857142856,188.0,127.0,8,1356,12866416.57142857,204.0,169.5
90051310.0,17,28,13364,28,13364,3335233.703703704,501.0,477.2857142857143,0,0,0.0,0.0,0.0
2452.0,17,4,344,2,150,0.0,75.0,75.0,2,194,0.0,103.0,97.0
2062.0,17,4,344,2,150,0.0,75.0,75.0,2,194,0.0,103.0,97.0
86601.0,6,14,4740,7,653,14231.166666666666,249.0,93.28571428571428,7,4087,13684.5,1514.0,583.8571428571429
2796396.0,6,2,132,1,66,0.0,66.0,66.0,1,66,0.0,66.0,66.0
228390.0,17,2,180,1,90,0.0,90.0,90.0,1,90,0.0,90.0,90.0
90029598.0,17,28,13364,28,13364,3334429.5555555555,501.0,477.2857142857143,0,0,0.0,0.0,0.0
228375.0,17,2,180,1,90,0.0,90.0,90.0,1,90,0.0,90.0,90.0
63886.0,6,15,4806,8,719,8951.714285714286,249.0,89.875,7,4087,10315.666666666666,1514.0,583.8571428571429
7724894.0,17,6,1665,3,273,3857895.5,103.0,91.0,3,1392,3688603.0,545.0,464.0
46266.0,6,14,4740,7,653,7573.333333333333,249.0,93.28571428571428,7,4087,7438.166666666667,1514.0,583.8571428571429
91000818.0,17,13,1083,7,563,15166803.0,174.0,80.42857142857143,6,520,14201768.6,174.0,86.66666666666667
213735.0,17,2,180,1,90,0.0,90.0,90.0,1,90,0.0,90.0,90.0
48167.0,6,10,2032,5,524,11753.75,252.0,104.8,5,1508,11517.5,1236.0,301.6
98110.0,17,2,762,2,762,0.0,381.0,381.0,0,0,0.0,0.0,0.0
5613519.0,6,5,336,2,134,0.0,68.0,67.0,3,202,1423512.5,70.0,67.33333333333333
2600.0,17,4,344,2,150,0.0,75.0,75.0,2,194,0.0,103.0,97.0
90254667.0,6,12,1832,8,1016,12893523.857142856,188.0,127.0,4,816,30024223.33333333,204.0,204.0
109266320.0,6,28,2014,15,1105,7789304.928571428,139.0,73.66666666666667,13,909,9087292.333333334,123.0,69.92307692307692
281097.0,17,2,363,1,79,0.0,79.0,79.0,1,284,0.0,284.0,284.0
6454060.0,6,12,744,5,330,1535470.5,106.0,66.0,7,414,1023615.5,78.0,59.142857142857146
51219.0,17,2,180,1,90,0.0,90.0,90.0,1,90,0.0,90.0,90.0
118225671.0,6,47,3102,24,1584,5140236.043478261,66.0,66.0,23,1518,5143994.863636363,66.0,66.0
120001069.0,17,15,1169,8,606,17143009.85714286,174.0,75.75,7,563,16667669.833333334,174.0,80.42857142857143
563.0,17,2,508,2,508,0.0,257.0,254.0,0,0,0.0,0.0,0.0
123839791.0,6,48,3168,24,1584,5065886.043478261,66.0,66.0,24,1584,5231549.913043479,66.0,66.0
90257838.0,6,13,2036,8,1016,12893976.857142856,188.0,127.0,5,1020,22523249.0,204.0,204.0
112543988.0,17,14,864,7,432,18668092.33333333,174.0,61.71428571428572,7,432,18666832.166666668,174.0,61.71428571428572
120522774.0,6,173,19568,87,13596,1401427.6046511629,284.0,156.27586206896552,86,5972,1407603.4235294117,140.0,69.44186046511628
284370.0,17,4,704,2,148,0.0,74.0,74.0,2,556,0.0,280.0,278.0
319097.0,6,3,1604,1,753,0.0,753.0,753.0,2,851,0.0,785.0,425.5
206609.0,6,3,426,2,280,0.0,214.0,140.0,1,146,0.0,146.0,146.0
308041.0,6,6,412,4,272,102680.33333333331,74.0,68.0,2,140,0.0,74.0,70.0
45544.0,6,10,2032,5,524,11080.5,252.0,104.8,5,1508,10644.5,1236.0,301.6
4605612.0,6,19,1676,9,1044,537272.125,315.0,116.0,10,632,477546.5555555556,78.0,63.2
302210.0,6,6,412,4,272,100736.66666666669,74.0,68.0,2,140,0.0,74.0,70.0
4704311.0,6,5,336,2,134,0.0,68.0,67.0,3,202,1626980.0,70.0,67.33333333333333
298635.0,6,6,412,4,272,99545.0,74.0,68.0,2,140,0.0,74.0,70.0
207321.0,6,3,426,2,280,0.0,214.0,140.0,1,146,0.0,146.0,146.0
120000061.0,6,26,2019,15,1179,8571432.92857143,95.0,78.6,11,840,8953818.2,95.0,76.36363636363636
30781.0,6,14,4740,7,653,4584.166666666667,249.0,93.28571428571428,7,4087,4484.166666666667,1514.0,583.8571428571429
220841.0,17,2,180,1,90,0.0,90.0,90.0,1,90,0.0,90.0,90.0
112265594.0,17,14,864,7,432,18666836.5,174.0,61.71428571428572,7,432,18667809.5,174.0,61.71428571428572
32510.0,6,10,2032,5,524,7908.5,252.0,104.8,5,1508,7890.0,1236.0,301.6
120043118.0,17,28,13364,28,13364,4446041.407407408,501.0,477.2857142857143,0,0,0.0,0.0,0.0
307932.0,6,6,412,4,272,102644.0,74.0,68.0,2,140,0.0,74.0,70.0
309823.0,17,4,1400,4,1400,103274.33333333331,350.0,350.0,0,0,0.0,0.0,0.0
2598747.0,6,2,132,1,66,0.0,66.0,66.0,1,66,0.0,66.0,66.0
120125292.0,6,15,2444,7,1428,20020882.0,204.0,204.0,8,1016,17136996.285714287,188.0,127.0
104422518.0,6,30,2122,15,1017,7458751.285714285,123.0,67.8,15,1105,7329931.571428572,139.0,73.66666666666667
120031144.0,17,28,13364,28,13364,4445597.925925926,501.0,477.2857142857143,0,0,0.0,0.0,0.0
111713.0,17,2,286,2,286,0.0,143.0,143.0,0,0,0.0,0.0,0.0
81229.0,6,10,2032,5,524,19493.25,252.0,104.8,5,1508,19570.25,1236.0,301.6
9356.0,6,10,2032,5,524,2110.5,252.0,104.8,5,1508,1684.0,1236.0,301.6
55676.0,6,14,4740,7,653,9039.0,249.0,93.28571428571428,7,4087,8297.0,1514.0,583.8571428571429
42122.0,6,14,4740,7,653,6851.333333333333,249.0,93.28571428571428,7,4087,6329.666666666667,1514.0,583.8571428571429
134006752.0,17,15,907,8,475,19143821.71428572,174.0,59.375,7,432,18991858.33333333,174.0,61.71428571428572
7776.0,17,2,582,1,83,0.0,83.0,83.0,1,499,0.0,499.0,499.0
4796393.0,6,5,336,2,134,0.0,68.0,67.0,3,202,1523125.0,70.0,67.33333333333333
39592.0,6,11,2098,6,590,7473.8,252.0,98.33333333333331,5,1508,6650.0,1236.0,301.6
96942827.0,6,173,19584,87,13686,1127242.1744186047,284.0,157.31034482758622,86,5898,1128190.3176470587,140.0,68.5813953488372
2595575.0,6,2,132,1,66,0.0,66.0,66.0,1,66,0.0,66.0,66.0
35533.0,6,14,4740,7,653,5793.666666666667,249.0,93.28571428571428,7,4087,5610.666666666667,1514.0,583.8571428571429
102976.0,17,2,286,2,286,0.0,143.0,143.0,0,0,0.0,0.0,0.0
19815.0,6,14,4740,7,653,2907.1666666666665,249.0,93.28571428571428,7,4087,3172.0,1514.0,583.8571428571429
413.0,17,2,166,1,75,0.0,75.0,75.0,1,91,0.0,91.0,91.0
531227.0,17,6,2100,6,2100,106245.4,350.0,350.0,0,0,0.0,0.0,0.0
120119187.0,6,13,2020,9,1204,15014898.375,188.0,133.77777777777777,4,816,30029351.33333333,204.0,204.0
146240.0,6,3,337,2,214,0.0,160.0,107.0,1,123,0.0,123.0,123.0
104001131.0,17,13,821,7,432,17333521.833333332,174.0,61.71428571428572,6,389,16801322.2,174.0,64.83333333333333
822.0,17,4,438,2,148,0.0,74.0,74.0,2,290,0.0,147.0,145.0
90010554.0,17,28,13364,28,13364,3333724.222222222,501.0,477.2857142857143,0,0,0.0,0.0,0.0
38821397.0,6,5,336,2,134,0.0,68.0,67.0,3,202,19345046.5,70.0,67.33333333333333
17741.0,6,14,4740,7,653,2316.0,249.0,93.28571428571428,7,4087,2821.333333333333,1514.0,583.8571428571429
3527.0,17,2,762,2,762,0.0,381.0,381.0,0,0,0.0,0.0,0.0
427303.0,6,10,1221,6,636,85460.6,298.0,106.0,4,585,136031.33333333334,379.0,146.25
90021464.0,17,28,13364,28,13364,3334128.296296296,501.0,477.2857142857143,0,0,0.0,0.0,0.0
228271.0,17,2,180,1,90,0.0,90.0,90.0,1,90,0.0,90.0,90.0
108112311.0,17,5,1005,5,1005,27028077.75,201.0,201.0,0,0,0.0,0.0,0.0
51095.0,6,14,4740,7,653,8391.833333333334,249.0,93.28571428571428,7,4087,6882.0,1514.0,583.8571428571429
41480.0,6,10,2032,5,524,10102.0,252.0,104.8,5,1508,9551.25,1236.0,301.6
22069.0,6,14,4740,7,653,3439.1666666666665,249.0,93.28571428571428,7,4087,3446.1666666666665,1514.0,583.8571428571429
98266663.0,6,29,2046,15,1017,7019014.642857143,123.0,67.8,14,1029,6967254.0,123.0,73.5
1307001.0,6,4,264,2,132,0.0,66.0,66.0,2,132,0.0,66.0,66.0
105160800.0,17,14,864,7,432,17500170.666666668,174.0,61.71428571428572,7,432,17501466.0,174.0,61.71428571428572
69259.0,17,2,608,1,75,0.0,75.0,75.0,1,533,0.0,533.0,533.0
145069.0,17,2,180,1,70,0.0,70.0,70.0,1,110,0.0,110.0,110.0
90303826.0,6,16,1192,8,596,12893162.714285716,95.0,74.5,8,596,12898855.714285716,95.0,74.5
110998597.0,6,30,1974,15,1026,7913055.357142857,123.0,68.4,15,948,7913055.428571428,123.0,63.2
58047.0,6,14,4740,7,653,8971.0,249.0,93.28571428571428,7,4087,9349.833333333334,1514.0,583.8571428571429
120118496.0,6,12,1832,8,1016,17136544.714285713,188.0,127.0,4,816,30030081.666666668,204.0,204.0
122001137.0,17,15,907,8,475,17428733.85714286,174.0,59.375,7,432,17001539.166666668,174.0,61.71428571428572
147984.0,17,2,180,1,90,0.0,90.0,90.0,1,90,0.0,90.0,90.0
393717.0,6,3,204,1,68,0.0,68.0,68.0,2,136,0.0,70.0,68.0
470758.0,6,3,204,1,68,0.0,68.0,68.0,2,136,0.0,70.0,68.0
2346.0,17,4,344,2,150,0.0,75.0,75.0,2,194,0.0,103.0,97.0
108110646.0,17,5,955,5,955,27027661.5,191.0,191.0,0,0,0.0,0.0,0.0
204720.0,17,2,762,2,762,0.0,381.0,381.0,0,0,0.0,0.0,0.0
90303506.0,6,16,1192,8,596,12893930.714285716,95.0,74.5,8,596,12899919.57142857,95.0,74.5
19103.0,6,10,2032,5,524,4555.75,252.0,104.8,5,1508,4474.25,1236.0,301.6
38606.0,6,10,2032,5,524,9380.25,252.0,104.8,5,1508,9410.75,1236.0,301.6
118881230.0,6,34,2350,17,1225,7416580.1875,139.0,72.05882352941177,17,1125,7416576.0625,123.0,66.17647058823529
104906943.0,17,15,1169,8,606,14964001.42857143,174.0,75.75,7,563,17341189.333333332,174.0,80.42857142857143
5836457.0,6,5,336,2,134,0.0,68.0,67.0,3,202,1526958.5,70.0,67.33333333333333
0.0,6,1,54,0,0,0.0,0.0,0.0,1,54,0.0,54.0,54.0
10488338.0,6,7,478,4,272,3450781.6666666665,74.0,68.0,3,206,5176072.0,74.0,68.66666666666667
116633608.0,6,48,3168,24,1584,5071026.434782608,66.0,66.0,24,1584,5057777.217391305,66.0,66.0
90020623.0,6,22,1766,11,967,9002062.3,222.0,87.9090909090909,11,799,8978818.1,95.0,72.63636363636364
40580.0,6,10,2032,5,524,8604.75,252.0,104.8,5,1508,7582.0,1236.0,301.6
35009.0,6,14,4740,7,653,5662.333333333333,249.0,93.28571428571428,7,4087,5242.0,1514.0,583.8571428571429
70022.0,6,10,2032,5,524,16888.0,252.0,104.8,5,1508,16312.25,1236.0,301.6
3007979.0,6,12,2172,7,664,501225.1666666667,252.0,94.85714285714286,5,1508,1785.0,1236.0,301.6
10937501.0,6,8,544,4,272,3600203.333333333,74.0,68.0,4,272,3600137.0,74.0,68.0
98233535.0,6,40,2640,20,1320,5170186.052631579,66.0,66.0,20,1320,5154310.52631579,66.0,66.0
310910.0,17,4,1400,4,1400,103636.66666666669,350.0,350.0,0,0,0.0,0.0,0.0
35933.0,6,10,2032,5,524,7888.75,252.0,104.8,5,1508,8157.0,1236.0,301.6
93122486.0,17,12,778,6,389,18601234.6,174.0,64.83333333333333,6,389,18600252.0,174.0,64.83333333333333
90528956.0,6,14,2240,8,1016,12932708.0,188.0,127.0,6,1224,18072727.6,204.0,204.0
20310.0,17,2,582,1,83,0.0,83.0,83.0,1,499,0.0,499.0,499.0
25153.0,6,10,2032,5,524,5901.75,252.0,104.8,5,1508,5705.0,1236.0,301.6
205969.0,6,3,426,2,280,0.0,214.0,140.0,1,146,0.0,146.0,146.0
108114843.0,17,5,955,5,955,27028710.75,191.0,191.0,0,0,0.0,0.0,0.0
167168.0,17,4,1524,4,1524,55722.66666666666,381.0,381.0,0,0,0.0,0.0,0.0
51995.0,6,14,4740,7,653,8370.666666666666,249.0,93.28571428571428,7,4087,7722.666666666667,1514.0,583.8571428571429
22866.0,6,20,7606,11,978,2286.6,310.0,88.9090909090909,9,6628,2533.75,1514.0,736.4444444444445
1283936.0,17,7,490,7,490,213989.3333333333,70.0,70.0,0,0,0.0,0.0,0.0
82258.0,17,2,762,2,762,0.0,381.0,381.0,0,0,0.0,0.0,0.0
95404977.0,6,40,2640,20,1320,5021314.578947368,66.0,66.0,20,1320,5004807.368421053,66.0,66.0
338937.0,6,3,1604,1,753,0.0,753.0,753.0,2,851,0.0,785.0,425.5
143882.0,17,2,180,1,90,0.0,90.0,90.0,1,90,0.0,90.0,90.0
71538.0,17,2,604,1,75,0.0,75.0,75.0,1,529,0.0,529.0,529.0
2781779.0,6,2,132,1,66,0.0,66.0,66.0,1,66,0.0,66.0,66.0
95878206.0,6,199,22470,100,6822,968466.7272727272,140.0,68.22,99,15648,967716.5306122449,284.0,158.06060606060606
216496.0,17,2,180,1,90,0.0,90.0,90.0,1,90,0.0,90.0,90.0
39016.0,6,14,4740,7,653,6074.0,249.0,93.28571428571428,7,4087,6311.666666666667,1514.0,583.8571428571429
261369.00000000003,6,10,1221,6,636,52273.8,298.0,106.0,4,585,80178.33333333333,379.0,146.25
105067699.0,17,15,5130,15,5130,7504835.642857143,342.0,342.0,0,0,0.0,0.0,0.0
2392.0,17,4,344,2,150,0.0,75.0,75.0,2,194,0.0,103.0,97.0
118463505.0,6,209,23602,105,7226,1139072.1634615385,140.0,68.81904761904762,104,16376,1140058.1747572816,284.0,157.46153846153845
31825.0,6,14,4740,7,653,4719.833333333333,249.0,93.28571428571428,7,4087,5161.833333333333,1514.0,583.8571428571429
120000109.0,6,18,1341,9,650,15000013.625,95.0,72.22222222222223,9,691,14967395.375,95.0,76.77777777777777
134754.0,6,13,1386,7,789,22459.0,253.0,112.71428571428572,6,597,25116.6,259.0,99.5
29897.0,6,14,4740,7,653,4792.666666666667,249.0,93.28571428571428,7,4087,4840.5,1514.0,583.8571428571429
102539.0,17,2,286,2,286,0.0,143.0,143.0,0,0,0.0,0.0,0.0
206203.0,6,3,426,2,280,0.0,214.0,140.0,1,146,0.0,146.0,146.0
217254.0,17,2,414,1,88,0.0,88.0,88.0,1,326,0.0,326.0,326.0
0.0,6,1,66,1,66,0.0,66.0,66.0,0,0,0.0,0.0,0.0
344.0,17,2,267,1,83,0.0,83.0,83.0,1,184,0.0,184.0,184.0
12662.0,6,14,4740,7,653,2003.5,249.0,93.28571428571428,7,4087,1978.6666666666667,1514.0,583.8571428571429
2443.0,17,4,344,2,150,0.0,75.0,75.0,2,194,0.0,103.0,97.0
3236.0,17,2,224,1,76,0.0,76.0,76.0,1,148,0.0,148.0,148.0
210733.0,6,3,426,2,280,0.0,214.0,140.0,1,146,0.0,146.0,146.0
246720.0,6,10,1221,6,636,49344.0,298.0,106.0,4,585,79885.33333333333,379.0,146.25
12084839.0,17,5,2265,5,2265,3021209.75,453.0,453.0,0,0,0.0,0.0,0.0
141303.0,6,2,132,1,66,0.0,66.0,66.0,1,66,0.0,66.0,66.0
625262.0,17,2,363,1,79,0.0,79.0,79.0,1,284,0.0,284.0,284.0
805.0,17,4,438,2,148,0.0,74.0,74.0,2,290,0.0,147.0,145.0
144917.0,17,2,180,1,70,0.0,70.0,70.0,1,110,0.0,110.0,110.0
149300215.0,17,36,17126,36,17126,4265720.428571428,501.0,475.72222222222223,0,0,0.0,0.0,0.0
410.0,17,2,410,1,78,0.0,78.0,78.0,1,332,0.0,332.0,332.0
148064.0,17,2,180,1,90,0.0,90.0,90.0,1,90,0.0,90.0,90.0
2395156.0,6,25,7573,14,3735,184242.7692307692,1514.0,266.7857142857143,11,3838,212026.9,1514.0,348.90909090909093
302403.0,6,2,132,1,66,0.0,66.0,66.0,1,66,0.0,66.0,66.0
10482611.0,6,7,478,4,272,3448711.333333333,74.0,68.0,3,206,5172954.0,74.0,68.66666666666667
39427.0,6,14,4740,7,653,6440.5,249.0,93.28571428571428,7,4087,5517.5,1514.0,583.8571428571429
0.0,6,1,54,0,0,0.0,0.0,0.0,1,54,0.0,54.0,54.0
105817863.0,6,32,2236,16,1165,7040134.666666667,139.0,72.8125,16,1071,7040133.0,123.0,66.9375
153315.0,17,2,180,1,90,0.0,90.0,90.0,1,90,0.0,90.0,90.0
36758.0,6,14,4740,7,653,6004.0,249.0,93.28571428571428,7,4087,5288.0,1514.0,583.8571428571429
153529.0,17,2,180,1,90,0.0,90.0,90.0,1,90,0.0,90.0,90.0
324245.0,17,4,1400,4,1400,108081.66666666669,350.0,350.0,0,0,0.0,0.0,0.0
29769.0,6,10,2032,5,524,7142.0,252.0,104.8,5,1508,6261.25,1236.0,301.6
320.0,17,2,174,1,79,0.0,79.0,79.0,1,95,0.0,95.0,95.0
1419879.0,17,16,1120,16,1120,94658.6,70.0,70.0,0,0,0.0,0.0,0.0
135137817.0,17,6,1146,6,1146,27027563.4,191.0,191.0,0,0,0.0,0.0,0.0
813.0,17,4,438,2,148,0.0,74.0,74.0,2,290,0.0,147.0,145.0
120070383.0,17,28,13364,28,13364,4447051.222222222,501.0,477.2857142857143,0,0,0.0,0.0,0.0
135140635.0,17,6,1206,6,1206,27028127.0,201.0,201.0,0,0,0.0,0.0,0.0
310.0,17,2,174,1,79,0.0,79.0,79.0,1,95,0.0,95.0,95.0
120016545.0,17,29,13785,29,13785,4286305.178571428,501.0,475.3448275862069,0,0,0.0,0.0,0.0
232903.0,6,3,337,2,214,0.0,160.0,107.0,1,123,0.0,123.0,123.0
206003.0,6,3,426,2,280,0.0,214.0,140.0,1,146,0.0,146.0,146.0
110010032.0,6,196,22076,98,6764,1124354.1649484537,140.0,69.0204081632653,98,15312,1125653.7113402062,284.0,156.24489795918367
196941.0,17,2,180,1,90,0.0,90.0,90.0,1,90,0.0,90.0,90.0
165879.0,17,2,180,1,90,0.0,90.0,90.0,1,90,0.0,90.0,90.0
1648082.0,6,7,499,4,301,498037.0,103.0,75.25,3,198,716284.0,66.0,66.0
102347.0,17,2,762,2,762,0.0,381.0,381.0,0,0,0.0,0.0,0.0
311103.0,17,4,622,4,622,103701.0,163.0,155.5,0,0,0.0,0.0,0.0
2395.0,17,4,344,2,150,0.0,75.0,75.0,2,194,0.0,103.0,97.0
103697623.0,17,14,864,7,432,17166835.166666668,174.0,61.71428571428572,7,432,17167763.166666668,174.0,61.71428571428572
109009994.0,17,13,821,7,432,18168332.33333333,174.0,61.71428571428572,6,389,17800174.6,174.0,64.83333333333333
90292690.0,6,16,1192,8,596,12891969.285714284,95.0,74.5,8,596,12897140.857142856,95.0,74.5
310256.0,17,4,1400,4,1400,103418.66666666669,350.0,350.0,0,0,0.0,0.0,0.0
135136438.0,17,6,1206,6,1206,27027287.6,201.0,201.0,0,0,0.0,0.0,0.0
29788.0,6,11,1131,6,600,5242.6,262.0,100.0,5,531,6080.5,259.0,106.2
1378125.0,6,4,276,2,128,0.0,74.0,64.0,2,148,0.0,74.0,74.0
4585.0,17,2,614,1,72,0.0,72.0,72.0,1,542,0.0,542.0,542.0
2069.0,17,4,344,2,150,0.0,75.0,75.0,2,194,0.0,103.0,97.0
121305.0,6,3,337,2,214,0.0,160.0,107.0,1,123,0.0,123.0,123.0
298162.0,6,6,412,4,272,99387.33333333331,74.0,68.0,2,140,0.0,74.0,70.0
112464245.0,6,46,3036,23,1518,5111999.863636363,66.0,66.0,23,1518,5112000.0,66.0,66.0
1172850.0,6,13,3010,8,2382,167550.0,1514.0,297.75,5,628,225045.0,331.0,125.6
148016.0,17,2,180,1,90,0.0,90.0,90.0,1,90,0.0,90.0,90.0
107628.0,17,2,286,2,286,0.0,143.0,143.0,0,0,0.0,0.0,0.0
97689811.0,6,29,2277,13,1126,8140817.583333333,154.0,86.61538461538461,16,1151,6495191.933333334,95.0,71.9375
90004630.0,17,28,13364,28,13364,3333504.814814815,501.0,477.2857142857143,0,0,0.0,0.0,0.0
31132.0,6,10,2032,5,524,7544.0,252.0,104.8,5,1508,7540.25,1236.0,301.6
17221.0,6,14,4740,7,653,2392.1666666666665,249.0,93.28571428571428,7,4087,2737.333333333333,1514.0,583.8571428571429
146065.0,6,3,337,2,214,0.0,160.0,107.0,1,123,0.0,123.0,123.0
107199.0,17,2,286,2,286,0.0,143.0,143.0,0,0,0.0,0.0,0.0
217915.0,6,3,426,2,280,0.0,214.0,140.0,1,146,0.0,146.0,146.0
113520146.0,6,46,3036,23,1518,5159994.5,66.0,66.0,23,1518,5159992.227272728,66.0,66.0
135137144.0,17,6,1146,6,1146,27027428.8,191.0,191.0,0,0,0.0,0.0,0.0
302307.0,6,6,412,4,272,100769.0,74.0,68.0,2,140,0.0,74.0,70.0
354516.0,17,2,180,1,90,0.0,90.0,90.0,1,90,0.0,90.0,90.0
90252871.0,6,14,2240,8,1016,12893267.285714284,188.0,127.0,6,1224,18016927.2,204.0,204.0
2288.0,17,4,344,2,150,0.0,75.0,75.0,2,194,0.0,103.0,97.0
636380.0,6,4,508,2,238,0.0,172.0,119.0,2,270,0.0,135.0,135.0
122191.0,6,3,337,2,214,0.0,160.0,107.0,1,123,0.0,123.0,123.0
32086.000000000004,6,14,4740,7,653,3962.0,249.0,93.28571428571428,7,4087,5210.833333333333,1514.0,583.8571428571429
98229953.0,6,176,20016,88,13986,1126606.0,284.0,158.9318181818182,88,6030,1126598.9770114943,140.0,68.52272727272727
26817.0,6,10,2032,5,524,5230.0,252.0,104.8,5,1508,6097.0,1236.0,301.6
291989.0,17,2,180,1,90,0.0,90.0,90.0,1,90,0.0,90.0,90.0
30330.0,6,14,4740,7,653,4566.0,249.0,93.28571428571428,7,4087,4915.5,1514.0,583.8571428571429
224987.0,6,12,1373,7,714,37497.833333333336,298.0,102.0,5,659,55412.75,379.0,131.8
121326.0,6,3,337,2,214,0.0,160.0,107.0,1,123,0.0,123.0,123.0
64782.00000000001,6,14,4740,7,653,10668.0,249.0,93.28571428571428,7,4087,10488.333333333334,1514.0,583.8571428571429
108615.0,17,2,286,2,286,0.0,143.0,143.0,0,0,0.0,0.0,0.0
2795622.0,6,2,132,1,66,0.0,66.0,66.0,1,66,0.0,66.0,66.0
146604.0,6,3,337,2,214,0.0,160.0,107.0,1,123,0.0,123.0,123.0
5621996.0,6,4,270,2,134,0.0,68.0,67.0,2,136,0.0,70.0,68.0
126006047.0,17,15,907,8,475,18000863.85714286,174.0,59.375,7,432,17666827.0,174.0,61.71428571428572
121842.0,6,3,373,2,238,0.0,172.0,119.0,1,135,0.0,135.0,135.0
361513.0,6,11,1021,6,444,48488.6,162.0,74.0,5,577,60538.25,349.0,115.4
22023.0,17,2,582,1,83,0.0,83.0,83.0,1,499,0.0,499.0,499.0
209674.0,17,2,180,1,90,0.0,90.0,90.0,1,90,0.0,90.0,90.0
143906.0,17,2,180,1,90,0.0,90.0,90.0,1,90,0.0,90.0,90.0
138889.0,6,2,132,1,66,0.0,66.0,66.0,1,66,0.0,66.0,66.0
117742479.0,6,224,25274,112,17586,1058805.2162162163,284.0,157.01785714285714,112,7688,1058804.0990990992,140.0,68.64285714285714
1109867.0,6,13,1394,7,797,184977.8333333333,253.0,113.85714285714286,6,597,219783.8,259.0,99.5
355.0,17,2,166,1,75,0.0,75.0,75.0,1,91,0.0,91.0,91.0
303629.0,6,2,132,1,66,0.0,66.0,66.0,1,66,0.0,66.0,66.0
10581.0,17,2,582,1,83,0.0,83.0,83.0,1,499,0.0,499.0,499.0
38574.0,6,14,4740,7,653,5550.0,249.0,93.28571428571428,7,4087,6294.0,1514.0,583.8571428571429
28383.0,6,14,4740,7,653,4312.833333333333,249.0,93.28571428571428,7,4087,4593.166666666667,1514.0,583.8571428571429
90837276.0,6,20,1531,10,786,10087152.888888888,95.0,78.6,10,745,10091945.666666666,95.0,74.5
149497425.0,17,35,16705,35,16705,4396983.088235294,501.0,477.2857142857143,0,0,0.0,0.0,0.0
52944.0,6,12,1413,7,882,8824.0,291.0,126.0,5,531,12662.5,259.0,106.2
205905.0,17,2,180,1,90,0.0,90.0,90.0,1,90,0.0,90.0,90.0
295.0,17,2,156,1,78,0.0,78.0,78.0,1,78,0.0,78.0,78.0
234414.0,6,3,337,2,214,0.0,160.0,107.0,1,123,0.0,123.0,123.0
90046252.0,17,28,13364,28,13364,3335046.3703703703,501.0,477.2857142857143,0,0,0.0,0.0,0.0
232919.0,17,2,180,1,90,0.0,90.0,90.0,1,90,0.0,90.0,90.0
319.0,17,2,174,1,79,0.0,79.0,79.0,1,95,0.0,95.0,95.0
323.0,17,2,174,1,79,0.0,79.0,79.0,1,95,0.0,95.0,95.0
302525.0,6,6,412,4,272,100841.66666666669,74.0,68.0,2,140,0.0,74.0,70.0
9867.0,6,10,2032,5,524,2002.75,252.0,104.8,5,1508,2122.5,1236.0,301.6
2581240.0,6,25,7589,14,3751,198556.92307692303,1514.0,267.92857142857144,11,3838,233679.0,1514.0,348.90909090909093
47005.0,6,14,4740,7,653,7579.666666666667,249.0,93.28571428571428,7,4087,7645.666666666667,1514.0,583.8571428571429
108112683.0,17,5,1005,5,1005,27028170.75,201.0,201.0,0,0,0.0,0.0,0.0
134304.0,6,2,132,1,66,0.0,66.0,66.0,1,66,0.0,66.0,66.0
303104.0,6,2,132,1,66,0.0,66.0,66.0,1,66,0.0,66.0,66.0
1296409.0,6,4,264,2,132,0.0,66.0,66.0,2,132,0.0,66.0,66.0
310072.0,6,3,202,2,128,0.0,74.0,64.0,1,74,0.0,74.0,74.0
314.0,17,2,174,1,79,0.0,79.0,79.0,1,95,0.0,95.0,95.0
1166253.0,6,13,3010,8,2382,166607.57142857142,1514.0,297.75,5,628,223401.25,331.0,125.6
120004379.0,6,25,1924,14,1125,9230763.923076924,95.0,80.35714285714286,11,799,11999999.6,95.0,72.63636363636364
3931.0,17,4,571,2,148,0.0,74.0,74.0,2,423,0.0,276.0,211.5
14660602.0,6,20,1607,10,975,1592104.0,315.0,97.5,10,632,1593884.6666666667,78.0,63.2
83.0,17,2,762,2,762,0.0,381.0,381.0,0,0,0.0,0.0,0.0
307268.0,6,6,412,4,272,102422.66666666669,74.0,68.0,2,140,0.0,74.0,70.0
306912.0,6,2,132,1,66,0.0,66.0,66.0,1,66,0.0,66.0,66.0
1780172.0,6,2,132,1,66,0.0,66.0,66.0,1,66,0.0,66.0,66.0
206359.0,6,3,426,2,280,0.0,214.0,140.0,1,146,0.0,146.0,146.0
108648179.0,6,32,2220,16,1149,7243211.933333334,123.0,71.8125,16,1071,7228804.2,123.0,66.9375
16922.0,17,2,180,1,90,0.0,90.0,90.0,1,90,0.0,90.0,90.0
2943380.0,6,3,1604,1,753,0.0,753.0,753.0,2,851,0.0,785.0,425.5
10884772.0,6,8,544,4,272,3582932.0,74.0,68.0,4,272,3582859.333333333,74.0,68.0
96126958.0,6,30,2106,15,1089,6850782.571428572,123.0,72.6,15,1017,6850782.785714285,123.0,67.8
3006855.0,6,12,2172,7,664,501016.1666666667,252.0,94.85714285714286,5,1508,1989.5,1236.0,301.6
120122893.0,6,13,2020,9,1204,15015361.625,188.0,133.77777777777777,4,816,30030112.33333333,204.0,204.0
5628775.0,6,5,336,2,134,0.0,68.0,67.0,3,202,1523322.0,70.0,67.33333333333333
85061.0,17,6,1230,3,234,42341.5,78.0,78.0,3,996,42323.0,332.0,332.0
113676394.0,6,46,3036,23,1518,5167097.636363637,66.0,66.0,23,1518,5167097.227272728,66.0,66.0
101471.0,17,2,700,2,700,0.0,350.0,350.0,0,0,0.0,0.0,0.0
33166.0,6,14,4740,7,653,5403.666666666667,249.0,93.28571428571428,7,4087,5186.333333333333,1514.0,583.8571428571429
327896.0,6,6,412,4,272,109298.66666666669,74.0,68.0,2,140,0.0,74.0,70.0
90051632.0,17,28,13364,28,13364,3335245.6296296297,501.0,477.2857142857143,0,0,0.0,0.0,0.0
135130177.0,17,6,1146,6,1146,27026035.4,191.0,191.0,0,0,0.0,0.0,0.0
228265.0,17,2,180,1,90,0.0,90.0,90.0,1,90,0.0,90.0,90.0
107847417.0,6,28,1860,14,966,8295955.153846154,123.0,69.0,14,894,8279304.461538462,123.0,63.85714285714285
33293.0,6,11,2098,6,590,4923.2,252.0,98.33333333333331,5,1508,7452.25,1236.0,301.6
302787.0,6,6,412,4,272,100929.0,74.0,68.0,2,140,0.0,74.0,70.0
100451.0,17,2,762,2,762,0.0,381.0,381.0,0,0,0.0,0.0,0.0
113618934.0,6,46,3036,23,1518,5150438.2727272725,66.0,66.0,23,1518,5150437.727272728,66.0,66.0
228150.0,17,2,180,1,90,0.0,90.0,90.0,1,90,0.0,90.0,90.0
18501.0,6,10,2032,5,524,4406.5,252.0,104.8,5,1508,4354.0,1236.0,301.6
281848.0,17,2,363,1,79,0.0,79.0,79.0,1,284,0.0,284.0,284.0
131196.0,6,3,337,2,214,0.0,160.0,107.0,1,123,0.0,123.0,123.0
228496.0,17,2,180,1,90,0.0,90.0,90.0,1,90,0.0,90.0,90.0
19522.0,6,14,4740,7,653,2936.5,249.0,93.28571428571428,7,4087,3060.6666666666665,1514.0,583.8571428571429
153373.0,17,2,180,1,90,0.0,90.0,90.0,1,90,0.0,90.0,90.0
40967.0,6,10,2032,5,524,9457.0,252.0,104.8,5,1508,9648.5,1236.0,301.6
320.0,17,2,174,1,79,0.0,79.0,79.0,1,95,0.0,95.0,95.0
119851726.0,6,13,1898,9,1082,14981465.75,188.0,120.22222222222224,4,816,30031082.33333333,204.0,204.0
112690868.0,6,48,3168,24,1584,4899602.956521739,66.0,66.0,24,1584,4890205.347826087,66.0,66.0
120121655.0,6,12,1832,8,1016,17136814.57142857,188.0,127.0,4,816,30031795.33333333,204.0,204.0
4245.0,17,2,582,1,83,0.0,83.0,83.0,1,499,0.0,499.0,499.0
174230.0,6,3,337,2,214,0.0,160.0,107.0,1,123,0.0,123.0,123.0
203718.0,17,2,762,2,762,0.0,381.0,381.0,0,0,0.0,0.0,0.0
50068.0,6,14,4740,7,653,8105.5,249.0,93.28571428571428,7,4087,7599.666666666667,1514.0,583.8571428571429
142523.0,17,2,176,1,80,0.0,80.0,80.0,1,96,0.0,96.0,96.0
145944.0,6,3,337,2,214,0.0,160.0,107.0,1,123,0.0,123.0,123.0
307781.0,6,6,412,4,272,102593.66666666669,74.0,68.0,2,140,0.0,74.0,70.0
828.0,17,4,438,2,148,0.0,74.0,74.0,2,290,0.0,147.0,145.0
90484363.0,6,13,1910,8,1016,12909628.857142856,188.0,127.0,5,894,15113484.75,204.0,178.8
1315072.0,17,7,490,7,490,219178.66666666663,70.0,70.0,0,0,0.0,0.0,0.0
106797.0,17,2,286,2,286,0.0,143.0,143.0,0,0,0.0,0.0,0.0
4782.0,17,4,571,2,148,0.0,74.0,74.0,2,423,0.0,276.0,211.5
299185.0,6,6,412,4,272,99728.33333333331,74.0,68.0,2,140,0.0,74.0,70.0
120308315.0,6,212,24008,106,7230,1128178.780952381,140.0,68.20754716981132,106,16778,1137960.561904762,284.0,158.28301886792454
90014395.0,17,28,13364,28,13364,3333866.4814814813,501.0,477.2857142857143,0,0,0.0,0.0,0.0
10538287.0,6,7,478,4,272,3467426.0,74.0,68.0,3,206,5201051.0,74.0,68.66666666666667
1067919.0,6,13,1386,7,789,177986.5,253.0,112.71428571428572,6,597,207440.6,259.0,99.5
90031066.0,17,28,13364,28,13364,3334483.925925926,501.0,477.2857142857143,0,0,0.0,0.0,0.0
0.0,6,1,172,1,172,0.0,172.0,172.0,0,0,0.0,0.0,0.0
45051.0,6,14,4740,7,653,7312.5,249.0,93.28571428571428,7,4087,6954.0,1514.0,583.8571428571429
90259364.0,6,12,1832,8,1016,12894194.857142856,188.0,127.0,4,816,30031825.33333333,204.0,204.0
356.0,17,2,267,1,83,0.0,83.0,83.0,1,184,0.0,184.0,184.0
13724.0,6,11,1132,6,556,1990.0,218.0,92.66666666666669,5,576,2970.0,304.0,115.2
218994.0,17,2,180,1,90,0.0,90.0,90.0,1,90,0.0,90.0,90.0
90306420.0,6,16,1192,8,596,12893583.0,95.0,74.5,8,596,12900538.57142857,95.0,74.5
427.0,17,2,410,1,78,0.0,78.0,78.0,1,332,0.0,332.0,332.0
90282263.0,6,19,1436,10,745,10026460.444444444,95.0,74.5,9,691,11284230.625,95.0,76.77777777777777
103925738.0,17,14,864,7,432,17167893.833333332,174.0,61.71428571428572,7,432,17166856.833333332,174.0,61.71428571428572
0.0,17,1,55,1,55,0.0,55.0,55.0,0,0,0.0,0.0,0.0
90258652.0,6,13,2036,8,1016,12894093.142857144,188.0,127.0,5,1020,22523999.0,204.0,204.0
305.0,17,2,156,1,78,0.0,78.0,78.0,1,78,0.0,78.0,78.0
20154.0,17,2,582,1,83,0.0,83.0,83.0,1,499,0.0,499.0,499.0
44240.0,6,13,1394,7,797,7373.333333333333,253.0,113.85714285714286,6,597,7919.0,259.0,99.5
120124445.0,6,14,2224,9,1204,15015555.625,188.0,133.77777777777777,5,1020,22523583.25,204.0,204.0
1987.0,17,4,344,2,150,0.0,75.0,75.0,2,194,0.0,103.0,97.0
2108078.0,6,25,7610,13,2516,175633.75,1034.0,193.53846153846155,12,5094,164118.0909090909,1510.0,424.5
225180.0,6,13,1386,7,789,37530.0,253.0,112.71428571428572,6,597,43753.4,259.0,99.5
196311.0,17,2,180,1,90,0.0,90.0,90.0,1,90,0.0,90.0,90.0
148036.0,17,2,180,1,90,0.0,90.0,90.0,1,90,0.0,90.0,90.0
25184.0,6,10,2032,5,524,5613.75,252.0,104.8,5,1508,5943.5,1236.0,301.6
222912.0,17,2,762,2,762,0.0,381.0,381.0,0,0,0.0,0.0,0.0
107388154.0,6,55,4878,32,2739,3464134.0,123.0,85.59375,23,2139,4871967.181818182,123.0,93.0
30533700.0,6,5,336,2,134,0.0,68.0,67.0,3,202,15144824.0,70.0,67.33333333333333
108105493.0,17,5,955,5,955,27026373.25,191.0,191.0,0,0,0.0,0.0,0.0
4287.0,17,2,598,1,72,0.0,72.0,72.0,1,526,0.0,526.0,526.0
40067.0,6,14,4740,7,653,4912.833333333333,249.0,93.28571428571428,7,4087,6290.666666666667,1514.0,583.8571428571429
76141.0,6,14,4740,7,653,11893.0,249.0,93.28571428571428,7,4087,12215.666666666666,1514.0,583.8571428571429
2026.0,17,4,344,2,150,0.0,75.0,75.0,2,194,0.0,103.0,97.0
298959.0,6,6,412,4,272,99653.0,74.0,68.0,2,140,0.0,74.0,70.0
90061699.0,17,28,13364,28,13364,3335618.4814814813,501.0,477.2857142857143,0,0,0.0,0.0,0.0
46309.0,6,14,4740,7,653,7597.0,249.0,93.28571428571428,7,4087,7475.833333333333,1514.0,583.8571428571429
107712.0,17,2,286,2,286,0.0,143.0,143.0,0,0,0.0,0.0,0.0
153.0,17,2,3028,2,3028,0.0,1514.0,1514.0,0,0,0.0,0.0,0.0
196996.0,17,2,180,1,90,0.0,90.0,90.0,1,90,0.0,90.0,90.0
52478.0,6,10,2032,5,524,12896.0,252.0,104.8,5,1508,8163.75,1236.0,301.6
120028562.0,17,15,1038,8,606,17146937.42857143,174.0,75.75,7,432,19871401.33333333,174.0,61.71428571428572
110979018.0,6,30,1974,15,1026,7911661.285714285,123.0,68.4,15,948,7911659.5,123.0,63.2
324.0,17,2,174,1,79,0.0,79.0,79.0,1,95,0.0,95.0,95.0
284266.0,17,2,363,1,79,0.0,79.0,79.0,1,284,0.0,284.0,284.0
120217884.0,6,23,1734,11,840,11996268.0,95.0,76.36363636363636,12,894,10906377.545454543,95.0,74.5
233040.0,6,3,337,2,214,0.0,160.0,107.0,1,123,0.0,123.0,123.0
192244.0,17,4,1524,4,1524,64081.333333333336,381.0,381.0,0,0,0.0,0.0,0.0
40952.0,6,14,4740,7,653,6026.666666666667,249.0,93.28571428571428,7,4087,6688.5,1514.0,583.8571428571429
38620961.0,6,5,336,2,134,0.0,68.0,67.0,3,202,19241978.0,70.0,67.33333333333333
234397.0,6,3,337,2,214,0.0,160.0,107.0,1,123,0.0,123.0,123.0
90301603.0,6,14,2102,8,1016,12900229.0,188.0,127.0,6,1086,18027499.4,204.0,181.0
206009.0,6,4,492,2,280,0.0,214.0,140.0,2,212,0.0,146.0,106.0
79.0,17,2,700,2,700,0.0,350.0,350.0,0,0,0.0,0.0,0.0
317196.0,17,4,1400,4,1400,105732.0,350.0,350.0,0,0,0.0,0.0,0.0
206979.0,17,2,762,2,762,0.0,381.0,381.0,0,0,0.0,0.0,0.0
2261214.0,6,49,23728,25,19797,94217.25,1514.0,791.88,24,3931,89064.60869565218,1514.0,163.79166666666666
90281147.0,6,16,1192,8,596,12891290.857142856,95.0,74.5,8,596,12894798.857142856,95.0,74.5
33481.0,6,10,2032,5,524,7747.25,252.0,104.8,5,1508,7445.0,1236.0,301.6
345.0,17,2,174,1,79,0.0,79.0,79.0,1,95,0.0,95.0,95.0
3190953.0,6,18,1495,9,921,359826.75,315.0,102.33333333333331,9,574,359800.625,78.0,63.77777777777778
10461503.0,6,7,478,4,272,3441562.0,74.0,68.0,3,206,5162228.5,74.0,68.66666666666667
850209.0,6,9,1096,6,625,170041.8,287.0,104.16666666666669,3,471,287276.0,331.0,157.0
34945.0,6,14,4740,7,653,5653.666666666667,249.0,93.28571428571428,7,4087,5466.166666666667,1514.0,583.8571428571429
24325.0,17,2,180,1,90,0.0,90.0,90.0,1,90,0.0,90.0,90.0
120197303.0,6,414,48472,207,13958,581842.9563106796,140.0,67.42995169082126,207,34514,583470.4077669902,284.0,166.7342995169082
300801.0,6,6,412,4,272,100267.0,74.0,68.0,2,140,0.0,74.0,70.0
299461.0,6,6,412,4,272,99820.33333333331,74.0,68.0,2,140,0.0,74.0,70.0
146277.0,6,3,337,2,214,0.0,160.0,107.0,1,123,0.0,123.0,123.0
90091893.0,6,11,1644,7,828,15015315.5,188.0,118.28571428571428,4,816,20020700.33333333,204.0,204.0
232464.0,6,3,337,2,214,0.0,160.0,107.0,1,123,0.0,123.0,123.0
196552.0,17,4,6056,4,6056,65517.333333333336,1514.0,1514.0,0,0,0.0,0.0,0.0
97457818.0,17,12,778,6,389,19403887.0,174.0,64.83333333333333,6,389,19400163.0,174.0,64.83333333333333
526819.0,6,6,758,3,410,254447.5,172.0,136.66666666666666,3,348,189842.5,135.0,116.0
135135771.0,17,6,1206,6,1206,27027154.2,201.0,201.0,0,0,0.0,0.0,0.0
108101027.0,17,5,1005,5,1005,27025256.75,201.0,201.0,0,0,0.0,0.0,0.0
135134901.0,17,6,1146,6,1146,27026980.2,191.0,191.0,0,0,0.0,0.0,0.0
217769.0,6,3,426,2,280,0.0,214.0,140.0,1,146,0.0,146.0,146.0
329551.0,17,6,2100,6,2100,65910.2,350.0,350.0,0,0,0.0,0.0,0.0
97679338.0,6,26,1746,13,906,8121957.583333333,123.0,69.6923076923077,13,840,8121952.333333333,123.0,64.61538461538461
135303.0,6,2,132,1,66,0.0,66.0,66.0,1,66,0.0,66.0,66.0
314972.0,17,4,1400,4,1400,104990.66666666669,350.0,350.0,0,0,0.0,0.0,0.0
408.0,17,2,410,1,78,0.0,78.0,78.0,1,332,0.0,332.0,332.0
498235.0,6,3,204,2,136,0.0,70.0,68.0,1,68,0.0,68.0,68.0
5635051.0,6,5,336,2,134,0.0,68.0,67.0,3,202,1528082.5,70.0,67.33333333333333
492537.0,6,3,1604,2,851,0.0,785.0,425.5,1,753,0.0,753.0,753.0
95447.0,17,2,286,2,286,0.0,143.0,143.0,0,0,0.0,0.0,0.0
37850.0,6,14,4740,7,653,5963.166666666667,249.0,93.28571428571428,7,4087,6173.333333333333,1514.0,583.8571428571429
30465.0,6,14,4740,7,653,4925.166666666667,249.0,93.28571428571428,7,4087,4464.666666666667,1514.0,583.8571428571429
117073159.0,6,221,26188,108,7350,953163.476635514,140.0,68.05555555555556,113,18838,1037846.0982142856,284.0,166.7079646017699
197301.0,17,2,180,1,90,0.0,90.0,90.0,1,90,0.0,90.0,90.0
30819.0,6,10,2032,5,524,6891.25,252.0,104.8,5,1508,7234.0,1236.0,301.6
108098657.0,17,5,1005,5,1005,27024664.25,201.0,201.0,0,0,0.0,0.0,0.0
120161212.0,6,262,30440,131,8868,910042.3153846152,140.0,67.69465648854961,131,21572,918104.5461538462,336.0,164.67175572519085
209197.0,17,2,762,2,762,0.0,381.0,381.0,0,0,0.0,0.0,0.0
23975.0,6,10,2032,5,524,5388.5,252.0,104.8,5,1508,5356.25,1236.0,301.6
2330.0,17,4,344,2,150,0.0,75.0,75.0,2,194,0.0,103.0,97.0
108107714.0,17,5,955,5,955,27026928.5,191.0,191.0,0,0,0.0,0.0,0.0
308068.0,6,6,412,4,272,102689.33333333331,74.0,68.0,2,140,0.0,74.0,70.0
120331574.0,6,214,24202,107,7358,1127531.150943396,140.0,68.76635514018692,107,16844,1127432.141509434,284.0,157.42056074766356
401821.0,6,3,1604,2,851,0.0,785.0,425.5,1,753,0.0,753.0,753.0
241592.0,6,3,337,2,214,0.0,160.0,107.0,1,123,0.0,123.0,123.0
299911.0,6,6,412,4,272,99970.33333333331,74.0,68.0,2,140,0.0,74.0,70.0
19178.0,6,10,2032,5,524,4592.5,252.0,104.8,5,1508,3516.75,1236.0,301.6
326.0,17,2,208,1,72,0.0,72.0,72.0,1,136,0.0,136.0,136.0
107413.0,17,2,286,2,286,0.0,143.0,143.0,0,0,0.0,0.0,0.0
103493.0,17,2,286,2,286,0.0,143.0,143.0,0,0,0.0,0.0,0.0
116115.0,6,11,1132,6,556,22724.8,218.0,92.66666666666669,5,576,28696.5,304.0,115.2
17174.0,6,14,4740,7,653,2739.5,249.0,93.28571428571428,7,4087,2637.333333333333,1514.0,583.8571428571429
74989.0,6,10,2032,5,524,17687.5,252.0,104.8,5,1508,18448.25,1236.0,301.6
3065134.0,6,156,123487,87,114631,35641.09302325582,1510.0,1317.5977011494251,69,8856,40557.39705882353,1510.0,128.34782608695653
22814.0,6,10,2032,5,524,5474.25,252.0,104.8,5,1508,5374.75,1236.0,301.6
251022.00000000003,6,3,337,2,214,0.0,160.0,107.0,1,123,0.0,123.0,123.0
43454.0,6,10,2032,5,524,10545.75,252.0,104.8,5,1508,8159.5,1236.0,301.6
43533.0,6,14,4740,7,653,7122.666666666667,249.0,93.28571428571428,7,4087,6700.833333333333,1514.0,583.8571428571429
108112453.0,17,5,955,5,955,27028113.25,191.0,191.0,0,0,0.0,0.0,0.0
72732.0,6,10,2032,5,524,17949.5,252.0,104.8,5,1508,16298.75,1236.0,301.6
88101.0,6,14,4740,7,653,13425.166666666666,249.0,93.28571428571428,7,4087,11700.5,1514.0,583.8571428571429
1570054.0,6,2,132,1,66,0.0,66.0,66.0,1,66,0.0,66.0,66.0
334.0,17,2,166,1,75,0.0,75.0,75.0,1,91,0.0,91.0,91.0
42092.0,6,10,2032,5,524,10279.75,252.0,104.8,5,1508,9041.25,1236.0,301.6
19601.0,6,10,2032,5,524,4693.25,252.0,104.8,5,1508,4657.75,1236.0,301.6
249634.0,6,3,337,2,214,0.0,160.0,107.0,1,123,0.0,123.0,123.0
142261.0,6,2,132,1,66,0.0,66.0,66.0,1,66,0.0,66.0,66.0
299253.0,6,6,412,4,272,99751.0,74.0,68.0,2,140,0.0,74.0,70.0
120120035.0,6,13,2036,8,1016,17137205.85714286,188.0,127.0,5,1020,22522460.25,204.0,204.0
41275.0,6,13,1386,7,789,5929.666666666667,253.0,112.71428571428572,6,597,7293.4,259.0,99.5
33035.0,6,20,7606,11,978,3303.5,310.0,88.9090909090909,9,6628,3866.875,1514.0,736.4444444444445
108101849.0,17,5,1005,5,1005,27025462.25,201.0,201.0,0,0,0.0,0.0,0.0
104796920.0,17,15,5130,15,5130,7485494.285714285,342.0,342.0,0,0,0.0,0.0,0.0
204730.0,17,2,762,2,762,0.0,381.0,381.0,0,0,0.0,0.0,0.0
27156607.0,17,5,1710,5,1710,6789151.75,342.0,342.0,0,0,0.0,0.0,0.0
84.0,17,2,762,2,762,0.0,381.0,381.0,0,0,0.0,0.0,0.0
305422.0,6,6,412,4,272,101807.33333333331,74.0,68.0,2,140,0.0,74.0,70.0
108111355.0,17,5,1005,5,1005,27027838.75,201.0,201.0,0,0,0.0,0.0,0.0
214192.0,17,4,1524,4,1524,71397.33333333333,381.0,381.0,0,0,0.0,0.0,0.0
120200034.0,6,20,1531,9,691,14940874.0,95.0,76.77777777777777,11,840,11998387.8,95.0,76.36363636363636
4458.0,17,2,626,1,72,0.0,72.0,72.0,1,554,0.0,554.0,554.0
305710.0,6,3,202,2,128,0.0,74.0,64.0,1,74,0.0,74.0,74.0
125856765.0,6,63,15897,33,6716,3005723.25,1514.0,203.5151515151515,30,9181,4332433.448275862,1514.0,306.03333333333336
101016744.0,17,14,4796,13,4446,6398770.916666667,342.0,342.0,1,350,0.0,350.0,350.0
217485.0,17,2,180,1,90,0.0,90.0,90.0,1,90,0.0,90.0,90.0
310082.0,6,6,412,4,272,103360.66666666669,74.0,68.0,2,140,0.0,74.0,70.0
20200.0,6,14,4740,7,653,3080.6666666666665,249.0,93.28571428571428,7,4087,3225.5,1514.0,583.8571428571429
106428653.0,6,39,3172,21,1717,5310333.75,139.0,81.76190476190476,18,1455,6247451.764705882,123.0,80.83333333333333
149649.0,17,2,180,1,90,0.0,90.0,90.0,1,90,0.0,90.0,90.0
34475.0,6,2,145,2,145,0.0,91.0,72.5,0,0,0.0,0.0,0.0
87671.0,6,10,1066,5,490,20792.75,218.0,98.0,5,576,21643.25,304.0,115.2
108105744.0,17,5,955,5,955,27026436.0,191.0,191.0,0,0,0.0,0.0,0.0
511565.00000000006,6,5,336,2,134,0.0,68.0,67.0,3,202,188649.5,70.0,67.33333333333333
1303121.0,6,4,264,2,132,0.0,66.0,66.0,2,132,0.0,66.0,66.0
330.0,17,2,208,1,72,0.0,72.0,72.0,1,136,0.0,136.0,136.0
508207.0,6,5,336,2,134,0.0,68.0,67.0,3,202,195885.5,70.0,67.33333333333333
2339.0,17,4,344,2,150,0.0,75.0,75.0,2,194,0.0,103.0,97.0
205300.0,17,4,6056,4,6056,68433.33333333333,1514.0,1514.0,0,0,0.0,0.0,0.0
30172.0,6,10,2032,5,524,7385.5,252.0,104.8,5,1508,5644.0,1236.0,301.6
90032039.0,17,28,13364,28,13364,3334519.962962963,501.0,477.2857142857143,0,0,0.0,0.0,0.0
2200.0,17,4,344,2,150,0.0,75.0,75.0,2,194,0.0,103.0,97.0
153402.0,17,2,180,1,90,0.0,90.0,90.0,1,90,0.0,90.0,90.0
204358.0,17,2,762,2,762,0.0,381.0,381.0,0,0,0.0,0.0,0.0
206170.0,6,3,426,2,280,0.0,214.0,140.0,1,146,0.0,146.0,146.0
2800563.0,6,2,132,1,66,0.0,66.0,66.0,1,66,0.0,66.0,66.0
32543.000000000004,6,14,4740,7,653,5270.5,249.0,93.28571428571428,7,4087,4870.833333333333,1514.0,583.8571428571429
211133.0,17,4,1524,4,1524,70377.66666666667,381.0,381.0,0,0,0.0,0.0,0.0
291045.0,6,10,1221,6,636,58209.0,298.0,106.0,4,585,91619.0,379.0,146.25
135130902.0,17,6,1146,6,1146,27026180.4,191.0,191.0,0,0,0.0,0.0,0.0
5622623.0,6,5,336,2,134,0.0,68.0,67.0,3,202,1526048.5,70.0,67.33333333333333
107466.0,17,4,1400,4,1400,35822.0,350.0,350.0,0,0,0.0,0.0,0.0
4109.0,17,2,582,1,83,0.0,83.0,83.0,1,499,0.0,499.0,499.0
29019.0,17,2,582,1,83,0.0,83.0,83.0,1,499,0.0,499.0,499.0
27906.0,6,14,4740,7,653,4425.0,249.0,93.28571428571428,7,4087,4508.5,1514.0,583.8571428571429
107342006.0,6,212,24012,106,16794,1020255.6476190476,284.0,158.43396226415095,106,7218,1020255.1428571428,140.0,68.09433962264151
103664243.0,17,14,864,7,432,17168615.333333332,174.0,61.71428571428572,7,432,17166831.166666668,174.0,61.71428571428572
162388.0,17,2,180,1,90,0.0,90.0,90.0,1,90,0.0,90.0,90.0
84511.0,6,14,4740,7,653,13587.5,249.0,93.28571428571428,7,4087,13250.833333333334,1514.0,583.8571428571429
10454558.0,6,7,478,4,272,3439096.6666666665,74.0,68.0,3,206,5158549.5,74.0,68.66666666666667
15090797.0,17,6,2052,6,2052,3018159.4,342.0,342.0,0,0,0.0,0.0,0.0
114407415.0,17,14,864,7,432,19000859.0,174.0,61.71428571428572,7,432,19000163.166666668,174.0,61.71428571428572
196898.0,17,2,180,1,90,0.0,90.0,90.0,1,90,0.0,90.0,90.0
5005532.0,17,4,534,2,166,0.0,83.0,83.0,2,368,0.0,184.0,184.0
0.0,17,1,342,1,342,0.0,342.0,342.0,0,0,0.0,0.0,0.0
207235.0,6,3,426,2,280,0.0,214.0,140.0,1,146,0.0,146.0,146.0
120168237.0,6,276,31714,138,9404,871160.6131386862,140.0,68.14492753623189,138,22310,871177.7883211679,284.0,161.66666666666666
1478814.0,17,16,1120,16,1120,98587.6,70.0,70.0,0,0,0.0,0.0,0.0
116163986.0,6,38,2848,20,1531,6113894.0,139.0,76.55,18,1317,6820438.882352941,123.0,73.16666666666667
39645446.0,6,5,336,2,134,0.0,68.0,67.0,3,202,19744346.0,70.0,67.33333333333333
163061.0,6,11,1132,6,556,32279.6,218.0,92.66666666666669,5,576,40503.0,304.0,115.2
3172807.0,6,18,1495,9,921,358122.0,315.0,102.33333333333331,9,574,358083.875,78.0,63.77777777777778
764813.0,6,10,1065,5,534,190997.5,262.0,106.8,5,531,190918.5,259.0,106.2
127026024.0,17,15,907,7,432,17834452.5,174.0,61.71428571428572,8,475,18143014.0,174.0,59.375
157971.0,6,3,337,2,214,0.0,160.0,107.0,1,123,0.0,123.0,123.0
301221.0,6,6,412,4,272,100407.0,74.0,68.0,2,140,0.0,74.0,70.0
212837.0,6,10,1221,6,636,42567.4,298.0,106.0,4,585,69554.33333333333,379.0,146.25
120123806.0,6,14,2224,9,1204,15015475.75,188.0,133.77777777777777,5,1020,22520646.25,204.0,204.0
108100956.0,17,5,955,5,955,27025239.0,191.0,191.0,0,0,0.0,0.0,0.0
303169.0,6,6,412,4,272,101056.33333333331,74.0,68.0,2,140,0.0,74.0,70.0
3008468.0,6,11,2106,6,598,601482.8,252.0,99.66666666666669,5,1508,1708.0,1236.0,301.6
90038578.0,17,28,13364,28,13364,3334762.1481481483,501.0,477.2857142857143,0,0,0.0,0.0,0.0
90067425.0,17,28,13364,28,13364,3335830.5555555555,501.0,477.2857142857143,0,0,0.0,0.0,0.0
102621.0,17,2,286,2,286,0.0,143.0,143.0,0,0,0.0,0.0,0.0
69651.0,6,14,4740,7,653,10178.0,249.0,93.28571428571428,7,4087,9126.0,1514.0,583.8571428571429
120058274.0,17,29,13785,29,13785,4287795.5,501.0,475.3448275862069,0,0,0.0,0.0,0.0
135138673.0,17,6,1146,6,1146,27027734.6,191.0,191.0,0,0,0.0,0.0,0.0
222558.0,6,10,1221,6,636,44511.6,298.0,106.0,4,585,73226.33333333333,379.0,146.25
107779.0,17,2,286,2,286,0.0,143.0,143.0,0,0,0.0,0.0,0.0
1030376.0,6,11,1134,6,558,206075.2,220.0,93.0,5,576,256413.0,304.0,115.2
20752.0,6,14,4740,7,653,3305.6666666666665,249.0,93.28571428571428,7,4087,3255.5,1514.0,583.8571428571429
90212985.0,6,16,1192,8,596,12853571.0,95.0,74.5,8,596,12858321.0,95.0,74.5
300415.0,6,6,412,4,272,100138.33333333331,74.0,68.0,2,140,0.0,74.0,70.0
299847.0,6,3,426,2,280,0.0,214.0,140.0,1,146,0.0,146.0,146.0
156423.0,17,2,180,1,90,0.0,90.0,90.0,1,90,0.0,90.0,90.0
121528.0,6,3,337,2,214,0.0,160.0,107.0,1,123,0.0,123.0,123.0
90072595.0,17,28,13364,28,13364,3336022.037037037,501.0,477.2857142857143,0,0,0.0,0.0,0.0
2413.0,17,4,344,2,150,0.0,75.0,75.0,2,194,0.0,103.0,97.0
50779.0,17,2,180,1,90,0.0,90.0,90.0,1,90,0.0,90.0,90.0
90755639.0,6,171,19272,86,5898,1067713.4,140.0,68.5813953488372,85,13374,1068210.7261904762,284.0,157.34117647058824
17152.0,6,10,2032,5,524,3392.0,252.0,104.8,5,1508,3720.75,1236.0,301.6
37901.0,6,14,4740,7,653,5954.0,249.0,93.28571428571428,7,4087,6122.833333333333,1514.0,583.8571428571429
53272.0,6,14,4740,7,653,8422.833333333334,249.0,93.28571428571428,7,4087,8448.666666666666,1514.0,583.8571428571429
35564.0,6,10,2032,5,524,8680.5,252.0,104.8,5,1508,8108.0,1236.0,301.6
36154.0,6,10,2032,5,524,8789.5,252.0,104.8,5,1508,7859.5,1236.0,301.6
204482.0,17,2,180,1,90,0.0,90.0,90.0,1,90,0.0,90.0,90.0
90747556.0,6,22,1680,12,894,8245888.636363637,95.0,74.5,10,786,10081951.777777778,95.0,78.6
90252126.0,6,12,1832,8,1016,12893160.857142856,188.0,127.0,4,816,30028811.33333333,204.0,204.0
2102.0,17,4,344,2,150,0.0,75.0,75.0,2,194,0.0,103.0,97.0
90292466.0,6,16,1192,8,596,12891532.57142857,95.0,74.5,8,596,12898496.57142857,95.0,74.5
13420086.0,6,20,1607,10,975,1456574.6666666667,315.0,97.5,10,632,1456549.0,78.0,63.2
204561.0,17,2,762,2,762,0.0,381.0,381.0,0,0,0.0,0.0,0.0
2592163.0,6,2,132,1,66,0.0,66.0,66.0,1,66,0.0,66.0,66.0
143931.0,17,2,180,1,90,0.0,90.0,90.0,1,90,0.0,90.0,90.0
3364.0,17,2,414,1,88,0.0,88.0,88.0,1,326,0.0,326.0,326.0
37813.0,6,10,2032,5,524,7941.0,252.0,104.8,5,1508,8822.25,1236.0,301.6
1302526.0,6,4,264,2,132,0.0,66.0,66.0,2,132,0.0,66.0,66.0
2385.0,17,4,344,2,150,0.0,75.0,75.0,2,194,0.0,103.0,97.0
11724.0,6,10,1066,5,490,2767.75,218.0,98.0,5,576,2333.75,304.0,115.2
93694.0,6,12,1320,6,723,18185.4,253.0,120.5,6,597,17452.0,259.0,99.5
2797825.0,6,2,132,1,66,0.0,66.0,66.0,1,66,0.0,66.0,66.0
47603680.0,6,8,2113,3,960,22707245.0,826.0,320.0,5,1153,11207030.75,885.0,230.6
2948.0,17,2,224,1,76,0.0,76.0,76.0,1,148,0.0,148.0,148.0
50938.0,6,10,2032,5,524,12502.5,252.0,104.8,5,1508,11149.0,1236.0,301.6
206190.0,6,3,426,2,280,0.0,214.0,140.0,1,146,0.0,146.0,146.0
90254734.0,6,13,2036,8,1016,12893533.42857143,188.0,127.0,5,1020,22522360.5,204.0,204.0
90256297.0,6,16,2368,9,1204,11282037.125,188.0,133.77777777777777,7,1164,15015265.0,204.0,166.28571428571428
139.0,17,3,1050,3,1050,69.5,350.0,350.0,0,0,0.0,0.0,0.0
216737.0,6,3,426,2,280,0.0,214.0,140.0,1,146,0.0,146.0,146.0
107363343.0,6,250,28564,125,20092,864097.4435483871,390.0,160.736,125,8472,864096.8709677419,140.0,67.776
63672.00000000001,6,14,4740,7,653,10482.833333333334,249.0,93.28571428571428,7,4087,9264.333333333334,1514.0,583.8571428571429
2595629.0,6,2,132,1,66,0.0,66.0,66.0,1,66,0.0,66.0,66.0
104354.0,17,2,286,2,286,0.0,143.0,143.0,0,0,0.0,0.0,0.0
92113743.0,6,38,2508,19,1254,5105437.444444444,66.0,66.0,19,1254,5105435.277777778,66.0,66.0
35041.0,6,14,4740,7,653,5533.0,249.0,93.28571428571428,7,4087,5596.833333333333,1514.0,583.8571428571429
918209.0,6,12,2718,7,743,153034.83333333334,339.0,106.14285714285714,5,1975,161394.0,1514.0,395.0
143324.0,6,2,132,1,66,0.0,66.0,66.0,1,66,0.0,66.0,66.0
120138368.0,6,14,2224,9,1204,15017296.0,188.0,133.77777777777777,5,1020,22525725.25,204.0,204.0
153356.0,17,2,180,1,90,0.0,90.0,90.0,1,90,0.0,90.0,90.0
97070847.0,6,181,20398,91,6228,1078564.9666666666,140.0,68.43956043956044,90,14170,1079120.3146067415,284.0,157.44444444444446
1040379.0,6,11,1134,6,558,208075.8,220.0,93.0,5,576,258501.25,304.0,115.2
112234527.0,17,14,864,7,432,18667579.0,174.0,61.71428571428572,7,432,18666832.5,174.0,61.71428571428572
114242364.0,6,211,23696,106,7292,1088022.5142857144,140.0,68.79245283018868,105,16404,1089677.8461538462,284.0,156.22857142857143
95775.0,17,2,762,2,762,0.0,381.0,381.0,0,0,0.0,0.0,0.0
812.0,17,5,550,5,550,203.0,110.0,110.0,0,0,0.0,0.0,0.0
10517110.0,6,7,478,4,272,3458512.0,74.0,68.0,3,206,5187640.5,74.0,68.66666666666667
2053.0,17,4,344,2,150,0.0,75.0,75.0,2,194,0.0,103.0,97.0
122216.0,6,3,373,2,238,0.0,172.0,119.0,1,135,0.0,135.0,135.0
28055.0,6,14,4740,7,653,4543.333333333333,249.0,93.28571428571428,7,4087,3821.5,1514.0,583.8571428571429
310655.0,17,4,1400,4,1400,103551.66666666669,350.0,350.0,0,0,0.0,0.0,0.0
320950.0,6,6,412,4,272,106983.33333333331,74.0,68.0,2,140,0.0,74.0,70.0
42806.0,6,14,4740,7,653,7011.666666666667,249.0,93.28571428571428,7,4087,6721.666666666667,1514.0,583.8571428571429
507586.0,6,4,270,2,134,0.0,68.0,67.0,2,136,0.0,70.0,68.0
1310068.0,6,4,264,2,132,0.0,66.0,66.0,2,132,0.0,66.0,66.0
15452.0,17,2,598,1,72,0.0,72.0,72.0,1,526,0.0,526.0,526.0
12442.0,6,10,1067,5,536,2877.75,264.0,107.2,5,531,2243.5,259.0,106.2
107478.0,17,2,286,2,286,0.0,143.0,143.0,0,0,0.0,0.0,0.0
232233.0,6,3,337,2,214,0.0,160.0,107.0,1,123,0.0,123.0,123.0
31143.0,6,14,4740,7,653,4894.166666666667,249.0,93.28571428571428,7,4087,4932.0,1514.0,583.8571428571429
106739.0,17,2,286,2,286,0.0,143.0,143.0,0,0,0.0,0.0,0.0
49239.0,6,14,4740,7,653,8038.333333333333,249.0,93.28571428571428,7,4087,6644.166666666667,1514.0,583.8571428571429
50203.0,6,14,4740,7,653,8237.0,249.0,93.28571428571428,7,4087,7790.0,1514.0,583.8571428571429
108725996.0,6,721,128208,356,23940,306212.261971831,214.0,67.24719101123596,365,104268,293651.09065934067,1514.0,285.6657534246575
109676697.0,6,28,1860,14,966,8420069.692307692,123.0,69.0,14,894,8420079.384615384,123.0,63.85714285714285
103741.0,17,2,700,2,700,0.0,350.0,350.0,0,0,0.0,0.0,0.0
123250705.0,6,49,3234,25,1650,5135446.041666667,66.0,66.0,24,1584,4973621.521739131,66.0,66.0
108316985.0,6,31,2176,16,1071,7221132.333333333,123.0,66.9375,15,1105,7172333.285714285,139.0,73.66666666666667
28338.0,6,14,4740,7,653,4441.666666666667,249.0,93.28571428571428,7,4087,4329.0,1514.0,583.8571428571429
44483.0,6,14,4740,7,653,7242.0,249.0,93.28571428571428,7,4087,7190.5,1514.0,583.8571428571429
354.0,17,2,762,2,762,0.0,381.0,381.0,0,0,0.0,0.0,0.0
103204.0,17,2,286,2,286,0.0,143.0,143.0,0,0,0.0,0.0,0.0
311733.0,6,6,412,4,272,103911.0,74.0,68.0,2,140,0.0,74.0,70.0
13376.0,6,11,1133,6,602,2485.8,264.0,100.33333333333331,5,531,2819.75,259.0,106.2
119836390.0,6,15,2306,6,1224,23966791.8,204.0,204.0,9,1082,14979398.125,188.0,120.22222222222224
218154.0,6,3,426,2,280,0.0,214.0,140.0,1,146,0.0,146.0,146.0
114771219.0,6,47,3102,24,1584,4976393.608695652,66.0,66.0,23,1518,5155439.818181818,66.0,66.0
92203027.0,6,171,19160,86,13402,1082195.5294117648,284.0,155.8372093023256,85,5758,1093750.4404761903,140.0,67.74117647058823
155918.0,17,2,180,1,90,0.0,90.0,90.0,1,90,0.0,90.0,90.0
113794475.0,6,48,3168,24,1584,4947585.869565218,66.0,66.0,24,1584,4938188.739130435,66.0,66.0
328.0,17,2,208,1,72,0.0,72.0,72.0,1,136,0.0,136.0,136.0
228342.0,17,2,180,1,90,0.0,90.0,90.0,1,90,0.0,90.0,90.0
96664962.0,17,12,778,6,389,19301029.6,174.0,64.83333333333333,6,389,19302332.0,174.0,64.83333333333333
2801360.0,6,2,132,1,66,0.0,66.0,66.0,1,66,0.0,66.0,66.0
201681.0,17,2,180,1,90,0.0,90.0,90.0,1,90,0.0,90.0,90.0
12772.0,6,10,1067,5,536,3029.5,264.0,107.2,5,531,2926.5,259.0,106.2
115581943.0,6,34,2334,17,1209,7210368.75,123.0,71.11764705882354,17,1125,7210368.3125,123.0,66.17647058823529
105916852.0,6,33,2428,17,1288,6606349.5,139.0,75.76470588235294,16,1140,7046773.066666666,123.0,71.25
120125418.0,6,16,2632,9,1204,15015677.25,188.0,133.77777777777777,7,1428,15015181.166666666,204.0,204.0
0.0,17,1,44,1,44,0.0,44.0,44.0,0,0,0.0,0.0,0.0
102880102.0,6,42,2772,21,1386,5143992.4,66.0,66.0,21,1386,5143992.55,66.0,66.0
15709.999999999998,6,10,2032,5,524,3489.0,252.0,104.8,5,1508,3364.0,1236.0,301.6
0.0,17,1,381,1,381,0.0,381.0,381.0,0,0,0.0,0.0,0.0
90024093.0,17,28,13364,28,13364,3334225.6666666665,501.0,477.2857142857143,0,0,0.0,0.0,0.0
87261.0,6,14,4740,7,653,13122.166666666666,249.0,93.28571428571428,7,4087,13084.0,1514.0,583.8571428571429
309722.0,6,6,412,4,272,103240.66666666669,74.0,68.0,2,140,0.0,74.0,70.0
107433673.0,6,208,23542,104,16444,1040955.9514563108,374.0,158.1153846153846,104,7098,1040956.1650485436,140.0,68.25
228342.0,17,2,180,1,90,0.0,90.0,90.0,1,90,0.0,90.0,90.0
26243.0,6,10,2032,5,524,5867.75,252.0,104.8,5,1508,6250.25,1236.0,301.6
305252.0,6,6,412,4,272,101750.66666666669,74.0,68.0,2,140,0.0,74.0,70.0
108101688.0,17,5,955,5,955,27025422.0,191.0,191.0,0,0,0.0,0.0,0.0
800.0,17,4,438,2,148,0.0,74.0,74.0,2,290,0.0,147.0,145.0
107074.0,17,2,286,2,286,0.0,143.0,143.0,0,0,0.0,0.0,0.0
135128893.0,17,6,1146,6,1146,27025778.6,191.0,191.0,0,0,0.0,0.0,0.0
109158.0,17,2,700,2,700,0.0,350.0,350.0,0,0,0.0,0.0,0.0
207458.0,17,2,331,1,75,0.0,75.0,75.0,1,256,0.0,256.0,256.0
16805.0,6,14,4740,7,653,2686.333333333333,249.0,93.28571428571428,7,4087,2662.333333333333,1514.0,583.8571428571429
111969293.0,6,210,23790,105,7152,1069694.5576923075,140.0,68.11428571428571,105,16638,1076353.75,284.0,158.45714285714286
90276481.0,6,12,1832,8,1016,12896640.142857144,188.0,127.0,4,816,30036788.666666668,204.0,204.0
90021157.0,17,28,13364,28,13364,3334116.925925926,501.0,477.2857142857143,0,0,0.0,0.0,0.0
173558.0,6,7,746,4,457,57852.66666666666,251.0,114.25,3,289,70097.5,149.0,96.33333333333331
148740.0,17,2,414,1,88,0.0,88.0,88.0,1,326,0.0,326.0,326.0
1843503.0,17,2,896,2,896,0.0,453.0,448.0,0,0,0.0,0.0,0.0
112234024.0,6,215,24156,108,7350,1048916.112149533,140.0,68.05555555555556,107,16806,1049036.5849056605,284.0,157.06542056074767
2340.0,17,4,344,2,150,0.0,75.0,75.0,2,194,0.0,103.0,97.0
32265.000000000004,6,10,2032,5,524,5267.0,252.0,104.8,5,1508,7604.5,1236.0,301.6
321339.0,17,4,1400,4,1400,107113.0,350.0,350.0,0,0,0.0,0.0,0.0
51528234.0,6,8,2113,3,960,24544348.0,826.0,320.0,5,1153,12238066.25,885.0,230.6
37082.0,6,14,4740,7,653,5928.5,249.0,93.28571428571428,7,4087,5869.666666666667,1514.0,583.8571428571429
37583.0,6,14,4740,7,653,5122.833333333333,249.0,93.28571428571428,7,4087,6131.666666666667,1514.0,583.8571428571429
99211599.0,6,188,21252,94,14826,1064477.752688172,300.0,157.72340425531914,94,6426,1064477.7311827955,140.0,68.36170212765957
2334.0,17,4,344,2,150,0.0,75.0,75.0,2,194,0.0,103.0,97.0
114370411.0,6,30,1974,15,1026,8153897.428571428,123.0,68.4,15,948,8153898.428571428,123.0,63.2
104776722.0,17,14,864,7,432,17436097.833333332,174.0,61.71428571428572,7,432,17193110.5,174.0,61.71428571428572
472652.0,17,2,346,1,78,0.0,78.0,78.0,1,268,0.0,268.0,268.0
687.0,17,2,762,2,762,0.0,381.0,381.0,0,0,0.0,0.0,0.0
302440.0,6,2,132,1,66,0.0,66.0,66.0,1,66,0.0,66.0,66.0
149133.0,6,3,337,2,214,0.0,160.0,107.0,1,123,0.0,123.0,123.0
132961.0,6,2,132,1,66,0.0,66.0,66.0,1,66,0.0,66.0,66.0
44989.0,6,14,4740,7,653,7366.333333333333,249.0,93.28571428571428,7,4087,7333.166666666667,1514.0,583.8571428571429
171673.0,17,2,180,1,90,0.0,90.0,90.0,1,90,0.0,90.0,90.0
90370564.0,6,12,1848,5,1020,22592071.75,204.0,204.0,7,828,15061368.166666666,188.0,118.28571428571428
0.0,17,1,55,1,55,0.0,55.0,55.0,0,0,0.0,0.0,0.0
458336.0,6,6,758,3,410,178480.0,172.0,136.66666666666666,3,348,169192.0,135.0,116.0
103100.0,17,2,286,2,286,0.0,143.0,143.0,0,0,0.0,0.0,0.0
14089.0,6,14,4740,7,653,2236.833333333333,249.0,93.28571428571428,7,4087,2212.5,1514.0,583.8571428571429
148534.0,17,2,414,1,88,0.0,88.0,88.0,1,326,0.0,326.0,326.0
2295.0,17,4,344,2,150,0.0,75.0,75.0,2,194,0.0,103.0,97.0
50500.0,6,14,4740,7,653,8223.0,249.0,93.28571428571428,7,4087,7230.833333333333,1514.0,583.8571428571429
130192.0,6,3,337,2,214,0.0,160.0,107.0,1,123,0.0,123.0,123.0
284246.0,17,2,363,1,79,0.0,79.0,79.0,1,284,0.0,284.0,284.0
209451.0,17,2,180,1,90,0.0,90.0,90.0,1,90,0.0,90.0,90.0
197493.0,17,2,180,1,90,0.0,90.0,90.0,1,90,0.0,90.0,90.0
1698858.0,6,23,6509,12,1529,154441.63636363635,357.0,127.41666666666669,11,4980,138927.3,1510.0,452.7272727272728
3741.0,17,4,344,2,150,0.0,75.0,75.0,2,194,0.0,103.0,97.0
144860.0,17,2,180,1,70,0.0,70.0,70.0,1,110,0.0,110.0,110.0
39342.0,6,14,4740,7,653,6256.166666666667,249.0,93.28571428571428,7,4087,5781.333333333333,1514.0,583.8571428571429
2422.0,17,4,344,2,150,0.0,75.0,75.0,2,194,0.0,103.0,97.0
206476.0,6,3,426,2,280,0.0,214.0,140.0,1,146,0.0,146.0,146.0
212369.0,6,10,1221,6,636,42473.8,298.0,106.0,4,585,69949.66666666667,379.0,146.25
218120.0,6,3,426,2,280,0.0,214.0,140.0,1,146,0.0,146.0,146.0
120554363.0,17,15,1038,8,606,17222051.85714286,174.0,75.75,7,432,18166833.5,174.0,61.71428571428572
103706127.0,17,14,864,7,432,17167917.166666668,174.0,61.71428571428572,7,432,17166834.833333332,174.0,61.71428571428572
120021952.0,17,29,13785,29,13785,4286498.285714285,501.0,475.3448275862069,0,0,0.0,0.0,0.0
108021405.0,6,44,2904,22,1452,5143876.428571428,66.0,66.0,22,1452,5129180.380952381,66.0,66.0
18526.0,6,14,4740,7,653,2932.333333333333,249.0,93.28571428571428,7,4087,2793.833333333333,1514.0,583.8571428571429
166942.0,17,4,571,2,148,0.0,74.0,74.0,2,423,0.0,276.0,211.5
17761.0,17,2,180,1,90,0.0,90.0,90.0,1,90,0.0,90.0,90.0
611804.0,17,3,551,2,156,0.0,78.0,78.0,1,395,0.0,395.0,395.0
10481183.0,6,7,478,4,272,3447007.333333333,74.0,68.0,3,206,5170400.5,74.0,68.66666666666667
3707901.0,6,166,133276,93,124156,40303.27173913043,1510.0,1335.010752688172,73,9120,47114.069444444445,1510.0,124.93150684931508
15595.0,6,11,1133,6,602,3119.0,264.0,100.33333333333331,5,531,3090.25,259.0,106.2
2320.0,17,4,344,2,150,0.0,75.0,75.0,2,194,0.0,103.0,97.0
103264.0,17,2,286,2,286,0.0,143.0,143.0,0,0,0.0,0.0,0.0
108104317.0,17,5,1005,5,1005,27026079.25,201.0,201.0,0,0,0.0,0.0,0.0
206068.0,6,3,426,2,280,0.0,214.0,140.0,1,146,0.0,146.0,146.0
1355.0,17,6,1230,3,234,269.5,78.0,78.0,3,996,346.5,332.0,332.0
101181.0,17,2,762,2,762,0.0,381.0,381.0,0,0,0.0,0.0,0.0
93357.0,17,3,1143,3,1143,46678.5,381.0,381.0,0,0,0.0,0.0,0.0
4204.0,17,4,704,2,148,0.0,74.0,74.0,2,556,0.0,280.0,278.0
107149.0,17,2,286,2,286,0.0,143.0,143.0,0,0,0.0,0.0,0.0
207563.0,6,3,426,2,280,0.0,214.0,140.0,1,146,0.0,146.0,146.0
36137.0,6,10,2032,5,524,8208.0,252.0,104.8,5,1508,7189.25,1236.0,301.6
586045.0,6,3,198,2,132,0.0,66.0,66.0,1,66,0.0,66.0,66.0
90239007.0,6,19,1436,9,691,11248250.125,95.0,76.77777777777777,10,745,10002634.444444444,95.0,74.5
4352204.0,6,171,148408,103,139618,42668.66666666666,1510.0,1355.514563106796,68,8790,60231.880597014926,1510.0,129.26470588235293
90047187.0,17,28,13364,28,13364,3335081.0,501.0,477.2857142857143,0,0,0.0,0.0,0.0
90037431.0,17,28,13364,28,13364,3334719.6666666665,501.0,477.2857142857143,0,0,0.0,0.0,0.0
100421665.0,17,12,516,6,258,20000218.2,43.0,43.0,6,258,20001026.8,43.0,43.0
2130388.0,6,24,7543,12,2450,193671.63636363635,1034.0,204.16666666666663,12,5093,165167.0909090909,1510.0,424.4166666666667
308575.0,6,6,412,4,272,102858.33333333331,74.0,68.0,2,140,0.0,74.0,70.0
4993.0,17,2,180,1,90,0.0,90.0,90.0,1,90,0.0,90.0,90.0
237403.0,17,2,180,1,90,0.0,90.0,90.0,1,90,0.0,90.0,90.0
204282.0,17,2,762,2,762,0.0,381.0,381.0,0,0,0.0,0.0,0.0
402167.0,6,4,508,2,238,0.0,172.0,119.0,2,270,0.0,135.0,135.0
4233424.0,17,4,1382,2,698,0.0,349.0,349.0,2,684,0.0,342.0,342.0
248125.0,6,3,337,2,214,0.0,160.0,107.0,1,123,0.0,123.0,123.0
90308641.0,6,16,1192,8,596,12893371.57142857,95.0,74.5,8,596,12899683.857142856,95.0,74.5
207637.0,6,3,426,2,280,0.0,214.0,140.0,1,146,0.0,146.0,146.0
193230.0,17,2,180,1,90,0.0,90.0,90.0,1,90,0.0,90.0,90.0
122231931.0,17,14,995,7,432,19166860.83333333,174.0,61.71428571428572,7,563,17845079.166666668,174.0,80.42857142857143
90219133.0,6,21,1585,10,745,9997688.444444444,95.0,74.5,11,840,9001416.7,95.0,76.36363636363636
741.0,17,4,438,2,148,0.0,74.0,74.0,2,290,0.0,147.0,145.0
91600241.0,17,12,778,6,389,18200827.6,174.0,64.83333333333333,6,389,18200157.8,174.0,64.83333333333333
907966.0,6,12,2709,7,742,151327.66666666666,338.0,106.0,5,1967,158064.25,1514.0,393.4
216770.0,6,3,426,2,280,0.0,214.0,140.0,1,146,0.0,146.0,146.0
1448466.0,6,7,499,4,301,433706.3333333333,103.0,75.25,3,198,717267.0,66.0,66.0
143829.0,17,2,180,1,90,0.0,90.0,90.0,1,90,0.0,90.0,90.0
90253408.0,6,12,1832,8,1016,12893344.0,188.0,127.0,4,816,30030441.33333333,204.0,204.0
96890580.0,6,30,2260,16,1228,6444993.4,139.0,76.75,14,1032,7436527.230769231,123.0,73.71428571428571
32588.0,6,14,4740,7,653,5308.5,249.0,93.28571428571428,7,4087,4805.333333333333,1514.0,583.8571428571429
108109307.0,17,5,1005,5,1005,27027326.75,201.0,201.0,0,0,0.0,0.0,0.0
92016328.0,6,38,2508,19,1254,5112004.166666667,66.0,66.0,19,1254,5112003.666666667,66.0,66.0
1302484.0,6,4,264,2,132,0.0,66.0,66.0,2,132,0.0,66.0,66.0
1316327.0,6,7,499,4,301,421931.0,103.0,75.25,3,198,613538.0,66.0,66.0
120201177.0,6,18,1341,9,691,14999456.75,95.0,76.77777777777777,9,650,14999465.875,95.0,72.22222222222223
230627.0,6,13,1386,7,789,38437.833333333336,253.0,112.71428571428572,6,597,41835.0,259.0,99.5
2148103.0,6,25,7611,13,2516,179008.58333333334,1034.0,193.53846153846155,12,5095,166827.0,1510.0,424.5833333333333
344525.0,17,2,582,1,83,0.0,83.0,83.0,1,499,0.0,499.0,499.0
3186331.0,6,18,1495,9,921,359834.125,315.0,102.33333333333331,9,574,359801.125,78.0,63.77777777777778
2442.0,17,4,344,2,150,0.0,75.0,75.0,2,194,0.0,103.0,97.0
112591267.0,6,211,23728,106,16576,1070247.6857142858,284.0,156.37735849056602,105,7152,1080195.5865384615,140.0,68.11428571428571
234331.0,6,3,337,2,214,0.0,160.0,107.0,1,123,0.0,123.0,123.0
31079.0,6,14,4740,7,653,4588.666666666667,249.0,93.28571428571428,7,4087,5004.666666666667,1514.0,583.8571428571429
113414207.0,17,15,1431,8,737,16202029.57142857,174.0,92.125,7,694,16512543.0,174.0,99.14285714285714
110907.0,17,2,286,2,286,0.0,143.0,143.0,0,0,0.0,0.0,0.0
707473.0,6,6,758,3,410,318460.5,172.0,136.66666666666666,3,348,237968.0,135.0,116.0
30507.0,6,14,4740,7,653,4780.833333333333,249.0,93.28571428571428,7,4087,4948.833333333333,1514.0,583.8571428571429
90257785.0,6,12,1832,8,1016,12893969.285714284,188.0,127.0,4,816,30031167.33333333,204.0,204.0
1841.0,17,2,192,1,88,0.0,88.0,88.0,1,104,0.0,104.0,104.0
13581.0,6,10,2032,5,524,2649.0,252.0,104.8,5,1508,3143.25,1236.0,301.6
147937.0,17,2,180,1,90,0.0,90.0,90.0,1,90,0.0,90.0,90.0
324239.0,6,6,412,4,272,108079.66666666669,74.0,68.0,2,140,0.0,74.0,70.0
120375637.0,6,233,26356,117,18404,1037721.0086206896,284.0,157.2991452991453,116,7952,1038600.5565217392,140.0,68.55172413793103
206261.0,17,2,762,2,762,0.0,381.0,381.0,0,0,0.0,0.0,0.0
102569.0,17,2,286,2,286,0.0,143.0,143.0,0,0,0.0,0.0,0.0
9088.0,17,2,762,2,762,0.0,381.0,381.0,0,0,0.0,0.0,0.0
121198.0,6,3,337,2,214,0.0,160.0,107.0,1,123,0.0,123.0,123.0
80899.0,6,12,1320,7,789,13483.166666666666,253.0,112.71428571428572,5,531,17004.25,259.0,106.2
384982.0,17,2,414,1,88,0.0,88.0,88.0,1,326,0.0,326.0,326.0
32755.0,6,10,2032,5,524,7927.0,252.0,104.8,5,1508,7948.0,1236.0,301.6
247298.0,6,3,337,2,214,0.0,160.0,107.0,1,123,0.0,123.0,123.0
198133.0,17,2,180,1,90,0.0,90.0,90.0,1,90,0.0,90.0,90.0
216908.0,6,3,426,2,280,0.0,214.0,140.0,1,146,0.0,146.0,146.0
93213208.0,6,174,19788,87,13898,1081370.6511627906,300.0,159.7471264367816,87,5890,1081370.8372093022,140.0,67.70114942528735
233618.0,6,3,337,2,214,0.0,160.0,107.0,1,123,0.0,123.0,123.0
157820.0,6,11,1132,6,556,31564.0,218.0,92.66666666666669,5,576,38983.75,304.0,115.2
90278257.0,6,13,2036,8,1016,12896893.857142856,188.0,127.0,5,1020,22528408.5,204.0,204.0
206008.0,17,2,180,1,90,0.0,90.0,90.0,1,90,0.0,90.0,90.0
27187.0,6,14,4740,7,653,4384.666666666667,249.0,93.28571428571428,7,4087,4383.666666666667,1514.0,583.8571428571429
257296.00000000003,6,3,337,2,214,0.0,160.0,107.0,1,123,0.0,123.0,123.0
25950.0,6,14,4740,7,653,4171.166666666667,249.0,93.28571428571428,7,4087,3584.833333333333,1514.0,583.8571428571429
90253110.0,6,13,2036,8,1016,12893301.42857143,188.0,127.0,5,1020,22522122.25,204.0,204.0
105195681.0,17,14,864,7,432,17500164.833333332,174.0,61.71428571428572,7,432,17500959.166666668,174.0,61.71428571428572
135135379.0,17,6,1206,6,1206,27027075.8,201.0,201.0,0,0,0.0,0.0,0.0
135133265.0,17,6,1146,6,1146,27026653.0,191.0,191.0,0,0,0.0,0.0,0.0
2648516.0,6,25,7573,14,3735,203732.0,1514.0,266.7857142857143,11,3838,240133.7,1514.0,348.90909090909093
183497.0,6,12,1447,6,816,35542.4,291.0,136.0,6,631,35890.0,293.0,105.16666666666669
14138877.0,6,11,738,5,342,3534170.75,95.0,68.4,6,396,2827273.8,95.0,66.0
251417.0,17,4,6056,4,6056,83805.66666666667,1514.0,1514.0,0,0,0.0,0.0,0.0
18392.0,6,14,4740,7,653,2903.833333333333,249.0,93.28571428571428,7,4087,2925.833333333333,1514.0,583.8571428571429
211520.0,6,10,1221,6,636,42304.0,298.0,106.0,4,585,69298.66666666667,379.0,146.25
300143.0,6,6,412,4,272,100047.66666666669,74.0,68.0,2,140,0.0,74.0,70.0
155597.0,6,3,337,2,214,0.0,160.0,107.0,1,123,0.0,123.0,123.0
5617128.0,6,5,336,2,134,0.0,68.0,67.0,3,202,1373064.5,70.0,67.33333333333333
5903.0,17,4,823,2,163,0.0,89.0,81.5,2,660,0.0,443.0,330.0
118657274.0,6,216,24424,108,17000,1106935.4485981308,284.0,157.40740740740742,108,7424,1106935.4485981308,140.0,68.74074074074075
153423.0,17,2,180,1,90,0.0,90.0,90.0,1,90,0.0,90.0,90.0
153429.0,17,2,180,1,90,0.0,90.0,90.0,1,90,0.0,90.0,90.0
125822582.0,6,63,12701,31,6621,3224677.966666667,1514.0,213.5806451612904,32,6080,4051821.709677419,1514.0,190.0
115995349.0,17,15,1169,8,606,16570764.142857144,174.0,75.75,7,563,16000136.0,174.0,80.42857142857143
5623249.0,6,5,336,2,134,0.0,68.0,67.0,3,202,1424660.0,70.0,67.33333333333333
90307885.0,6,20,1531,11,840,9024342.8,95.0,76.36363636363636,9,691,11230556.625,95.0,76.77777777777777
120016544.0,17,28,13364,28,13364,4445057.185185186,501.0,477.2857142857143,0,0,0.0,0.0,0.0
20066.0,6,10,1067,5,536,4781.25,264.0,107.2,5,531,4125.75,259.0,106.2
21551.0,17,2,539,1,86,0.0,86.0,86.0,1,453,0.0,453.0,453.0
261436.0,6,10,1221,6,636,52287.2,298.0,106.0,4,585,81652.33333333333,379.0,146.25
304.0,17,2,164,1,82,0.0,82.0,82.0,1,82,0.0,82.0,82.0
19090.0,17,2,571,1,86,0.0,86.0,86.0,1,485,0.0,485.0,485.0
5833118.0,6,4,270,2,134,0.0,68.0,67.0,2,136,0.0,70.0,68.0
146104.0,6,3,337,2,214,0.0,160.0,107.0,1,123,0.0,123.0,123.0
2292.0,17,4,344,2,150,0.0,75.0,75.0,2,194,0.0,103.0,97.0
216219.0,17,2,180,1,90,0.0,90.0,90.0,1,90,0.0,90.0,90.0
10882141.0,6,8,544,4,272,3582036.0,74.0,68.0,4,272,3581948.0,74.0,68.0
53469.0,6,14,4740,7,653,8634.833333333334,249.0,93.28571428571428,7,4087,8349.333333333334,1514.0,583.8571428571429
237259.0,6,3,337,2,214,0.0,160.0,107.0,1,123,0.0,123.0,123.0
2352497.0,6,25,7573,14,3735,180961.3076923077,1514.0,266.7857142857143,11,3838,210634.1,1514.0,348.90909090909093
144070.0,17,2,180,1,90,0.0,90.0,90.0,1,90,0.0,90.0,90.0
226550.0,6,10,1221,6,636,45310.0,298.0,106.0,4,585,74333.33333333333,379.0,146.25
306977.0,6,6,412,4,272,102325.66666666669,74.0,68.0,2,140,0.0,74.0,70.0
118296295.0,6,235,26520,118,8010,1011079.4444444444,140.0,67.88135593220339,117,18510,1010845.2931034482,284.0,158.2051282051282
6732.0,17,2,582,1,83,0.0,83.0,83.0,1,499,0.0,499.0,499.0
90043820.0,17,28,13364,28,13364,3334956.296296296,501.0,477.2857142857143,0,0,0.0,0.0,0.0
602542.0,17,2,346,1,78,0.0,78.0,78.0,1,268,0.0,268.0,268.0
137124.0,6,2,132,1,66,0.0,66.0,66.0,1,66,0.0,66.0,66.0
17102.0,6,10,1949,5,441,3991.75,169.0,88.2,5,1508,4019.75,1236.0,301.6
2800421.0,6,2,132,1,66,0.0,66.0,66.0,1,66,0.0,66.0,66.0
217774.0,6,3,426,2,280,0.0,214.0,140.0,1,146,0.0,146.0,146.0
121519.0,6,3,337,2,214,0.0,160.0,107.0,1,123,0.0,123.0,123.0
576.0,17,7,3341,7,3341,96.0,501.0,477.2857142857143,0,0,0.0,0.0,0.0
106295.0,17,2,286,2,286,0.0,143.0,143.0,0,0,0.0,0.0,0.0
221812.0,17,2,180,1,90,0.0,90.0,90.0,1,90,0.0,90.0,90.0
258613.0,6,3,337,2,214,0.0,160.0,107.0,1,123,0.0,123.0,123.0
205867.0,17,2,180,1,90,0.0,90.0,90.0,1,90,0.0,90.0,90.0
19542.0,6,11,2098,6,590,3545.4,252.0,98.33333333333331,5,1508,4579.75,1236.0,301.6
140962.0,6,2,132,1,66,0.0,66.0,66.0,1,66,0.0,66.0,66.0
135135465.0,17,6,1206,6,1206,27027093.0,201.0,201.0,0,0,0.0,0.0,0.0
120006776.0,6,1106,256184,540,36454,222630.33580705008,214.0,67.50740740740741,566,219730,212397.8300884956,1514.0,388.2155477031802
160285.0,17,2,180,1,90,0.0,90.0,90.0,1,90,0.0,90.0,90.0
246015.0,6,3,337,2,214,0.0,160.0,107.0,1,123,0.0,123.0,123.0
39783.0,6,14,4740,7,653,6421.333333333333,249.0,93.28571428571428,7,4087,6423.666666666667,1514.0,583.8571428571429
135128061.0,17,6,1206,6,1206,27025612.2,201.0,201.0,0,0,0.0,0.0,0.0
341482.0,17,6,1230,3,234,170549.5,78.0,78.0,3,996,170534.0,332.0,332.0
290892.0,6,10,1221,6,636,58178.4,298.0,106.0,4,585,91350.0,379.0,146.25
208987.0,6,10,1221,6,636,41797.4,298.0,106.0,4,585,68652.0,379.0,146.25
120004701.0,6,24,1829,13,989,9999997.916666666,95.0,76.07692307692308,11,840,12000073.3,95.0,76.36363636363636
26929277.0,17,5,1710,5,1710,6732319.25,342.0,342.0,0,0,0.0,0.0,0.0
491920.0,6,3,204,1,68,0.0,68.0,68.0,2,136,0.0,70.0,68.0
218090.0,6,3,426,2,280,0.0,214.0,140.0,1,146,0.0,146.0,146.0
33368876.0,6,3,202,2,136,0.0,70.0,68.0,1,66,0.0,66.0,66.0
4537.0,17,2,614,1,72,0.0,72.0,72.0,1,542,0.0,542.0,542.0
120121819.0,6,12,1832,8,1016,17136988.85714286,188.0,127.0,4,816,30029831.666666668,204.0,204.0
151636.0,17,2,414,1,88,0.0,88.0,88.0,1,326,0.0,326.0,326.0
135133690.0,17,6,1206,6,1206,27026738.0,201.0,201.0,0,0,0.0,0.0,0.0
99919992.0,17,12,778,6,389,19915767.8,174.0,64.83333333333333,6,389,19952037.2,174.0,64.83333333333333
209220.0,6,12,1447,6,816,40406.0,291.0,136.0,6,631,39246.4,293.0,105.16666666666669
115451660.0,6,48,3168,24,1584,5019637.391304348,66.0,66.0,24,1584,5005927.304347826,66.0,66.0
119848330.0,6,226,26010,113,18256,1068153.1875,300.0,161.55752212389382,113,7754,1068153.517857143,140.0,68.61946902654867
242912.0,6,3,373,2,238,0.0,172.0,119.0,1,135,0.0,135.0,135.0
190868.0,17,2,180,1,90,0.0,90.0,90.0,1,90,0.0,90.0,90.0
308173.0,6,6,412,4,272,102724.33333333331,74.0,68.0,2,140,0.0,74.0,70.0
135131567.0,17,6,1146,6,1146,27026313.4,191.0,191.0,0,0,0.0,0.0,0.0
2326.0,17,4,344,2,150,0.0,75.0,75.0,2,194,0.0,103.0,97.0
107237.0,17,2,286,2,286,0.0,143.0,143.0,0,0,0.0,0.0,0.0
119988843.0,17,35,16705,35,16705,3529083.617647059,501.0,477.2857142857143,0,0,0.0,0.0,0.0
858733.0,6,9,1096,6,625,171746.6,287.0,104.16666666666669,3,471,291544.5,331.0,157.0
94475698.0,17,12,778,6,389,18800817.6,174.0,64.83333333333333,6,389,18800228.8,174.0,64.83333333333333
104312714.0,17,13,821,6,389,20801095.0,174.0,64.83333333333333,7,432,17333488.166666668,174.0,61.71428571428572
104109134.0,17,14,864,7,432,17333496.0,174.0,61.71428571428572,7,432,17334568.666666668,174.0,61.71428571428572
508465.0,6,2,145,2,145,0.0,91.0,72.5,0,0,0.0,0.0,0.0
3209626.0,6,3,1777,1,826,0.0,826.0,826.0,2,951,0.0,885.0,475.5
245160.0,17,2,180,1,90,0.0,90.0,90.0,1,90,0.0,90.0,90.0
353.0,17,2,267,1,83,0.0,83.0,83.0,1,184,0.0,184.0,184.0
22284.0,6,20,7606,11,978,2228.4,310.0,88.9090909090909,9,6628,2525.125,1514.0,736.4444444444445
0.0,17,1,80,1,80,0.0,80.0,80.0,0,0,0.0,0.0,0.0
303269.0,6,6,412,4,272,101089.66666666669,74.0,68.0,2,140,0.0,74.0,70.0
223956.0,17,2,414,1,88,0.0,88.0,88.0,1,326,0.0,326.0,326.0
90313034.0,6,19,1436,10,745,10029102.333333334,95.0,74.5,9,691,11287907.375,95.0,76.77777777777777
63135.0,6,14,4740,7,653,10317.0,249.0,93.28571428571428,7,4087,10313.333333333334,1514.0,583.8571428571429
21863.0,17,2,180,1,90,0.0,90.0,90.0,1,90,0.0,90.0,90.0
34314.0,6,14,4740,7,653,4622.5,249.0,93.28571428571428,7,4087,5372.666666666667,1514.0,583.8571428571429
313764.0,6,6,412,4,272,104588.0,74.0,68.0,2,140,0.0,74.0,70.0
2203943.0,6,12,1914,4,426,734387.6666666666,220.0,106.5,8,1488,314688.8571428572,304.0,186.0
228238.0,17,2,180,1,90,0.0,90.0,90.0,1,90,0.0,90.0,90.0
153402.0,17,2,180,1,90,0.0,90.0,90.0,1,90,0.0,90.0,90.0
143848.0,17,2,180,1,90,0.0,90.0,90.0,1,90,0.0,90.0,90.0
207506.0,6,10,1221,6,636,41501.2,298.0,106.0,4,585,67745.0,379.0,146.25
90257416.0,6,13,2036,8,1016,12893916.57142857,188.0,127.0,5,1020,22523653.75,204.0,204.0
33307.0,6,14,4740,7,653,5178.333333333333,249.0,93.28571428571428,7,4087,5353.333333333333,1514.0,583.8571428571429
3053515.0,6,3,204,1,68,0.0,68.0,68.0,2,136,0.0,70.0,68.0
32109.0,6,10,2032,5,524,7253.75,252.0,104.8,5,1508,7147.75,1236.0,301.6
121415935.0,6,217,24484,109,17134,1124221.6203703703,284.0,157.19266055045873,108,7350,1115206.4392523365,140.0,68.05555555555556
90300670.0,6,16,1192,8,596,12893190.57142857,95.0,74.5,8,596,12899309.57142857,95.0,74.5
2487956.0,6,3,1604,2,851,0.0,785.0,425.5,1,753,0.0,753.0,753.0
4136.0,17,4,625,2,163,0.0,89.0,81.5,2,462,0.0,245.0,231.0
42139.0,6,14,4740,7,653,6863.666666666667,249.0,93.28571428571428,7,4087,6889.833333333333,1514.0,583.8571428571429
153432.0,17,2,180,1,90,0.0,90.0,90.0,1,90,0.0,90.0,90.0
247184.0,6,3,373,2,238,0.0,172.0,119.0,1,135,0.0,135.0,135.0
356.0,17,2,166,1,75,0.0,75.0,75.0,1,91,0.0,91.0,91.0
36948.0,6,14,4740,7,653,6010.666666666667,249.0,93.28571428571428,7,4087,5937.0,1514.0,583.8571428571429
135150875.0,17,6,1146,6,1146,27030175.0,191.0,191.0,0,0,0.0,0.0,0.0
245035.0,6,10,1221,6,636,49007.0,298.0,106.0,4,585,79590.0,379.0,146.25
103050.0,17,2,286,2,286,0.0,143.0,143.0,0,0,0.0,0.0,0.0
305876.0,6,3,202,2,128,0.0,74.0,64.0,1,74,0.0,74.0,74.0
3476.0,17,2,414,1,88,0.0,88.0,88.0,1,326,0.0,326.0,326.0
28081.0,6,10,2032,5,524,6707.5,252.0,104.8,5,1508,6737.25,1236.0,301.6
108102784.0,17,5,955,5,955,27025696.0,191.0,191.0,0,0,0.0,0.0,0.0
135152812.0,17,6,1206,6,1206,27030562.4,201.0,201.0,0,0,0.0,0.0,0.0
1173999.0,6,13,3017,8,2389,167714.14285714287,1514.0,298.625,5,628,225336.75,331.0,125.6
127401581.0,17,14,864,7,432,18000169.5,174.0,61.71428571428572,7,432,18000788.0,174.0,61.71428571428572
38236.0,6,20,7606,11,978,3823.6,310.0,88.9090909090909,9,6628,4554.5,1514.0,736.4444444444445
109240912.0,6,33,2428,17,1288,6814104.4375,139.0,75.76470588235294,16,1140,7268377.0,123.0,71.25
207147.0,6,3,426,2,280,0.0,214.0,140.0,1,146,0.0,146.0,146.0
117002302.0,17,13,821,7,432,19500174.0,174.0,61.71428571428572,6,389,20102370.0,174.0,64.83333333333333
2291.0,17,4,344,2,150,0.0,75.0,75.0,2,194,0.0,103.0,97.0
119961874.0,6,13,2036,5,1020,22523229.5,204.0,204.0,8,1016,17098335.85714286,188.0,127.0
14229978.0,6,20,1607,10,975,1546368.888888889,315.0,97.5,10,632,1546337.3333333333,78.0,63.2
153398.0,17,2,180,1,90,0.0,90.0,90.0,1,90,0.0,90.0,90.0
14557355.0,6,116,32094,60,25691,246734.8305084745,581.0,428.1833333333333,56,6403,260712.6181818182,732.0,114.33928571428572
108579.0,17,4,1400,4,1400,36193.0,350.0,350.0,0,0,0.0,0.0,0.0
317562.0,17,4,1400,4,1400,105854.0,350.0,350.0,0,0,0.0,0.0,0.0
197297.0,17,2,180,1,90,0.0,90.0,90.0,1,90,0.0,90.0,90.0
321716.0,17,4,1400,4,1400,107238.66666666669,350.0,350.0,0,0,0.0,0.0,0.0
196944.0,17,2,180,1,90,0.0,90.0,90.0,1,90,0.0,90.0,90.0
120013143.0,6,533,83604,265,17860,453620.2083333333,214.0,67.39622641509433,268,65744,449424.4794007491,1514.0,245.3134328358209
120108966.0,6,15,2168,7,1152,20018161.0,204.0,164.57142857142858,8,1016,17134855.285714287,188.0,127.0
45076.0,6,14,4740,7,653,5048.333333333333,249.0,93.28571428571428,7,4087,7340.666666666667,1514.0,583.8571428571429
38644.0,6,14,4740,7,653,5611.833333333333,249.0,93.28571428571428,7,4087,5962.5,1514.0,583.8571428571429
322300.0,6,6,412,4,272,107433.33333333331,74.0,68.0,2,140,0.0,74.0,70.0
89241.0,6,12,1328,7,797,14873.5,253.0,113.85714285714286,5,531,20824.75,259.0,106.2
102008009.0,17,13,821,7,432,17001334.833333332,174.0,61.71428571428572,6,389,19958491.8,174.0,64.83333333333333
83150.0,6,14,4740,7,653,13674.833333333334,249.0,93.28571428571428,7,4087,13109.333333333334,1514.0,583.8571428571429
5629406.0,6,4,270,2,134,0.0,68.0,67.0,2,136,0.0,70.0,68.0
217661.0,6,3,426,2,280,0.0,214.0,140.0,1,146,0.0,146.0,146.0
2770.0,17,4,344,2,150,0.0,75.0,75.0,2,194,0.0,103.0,97.0
111770428.0,6,34,2482,17,1288,6972161.0625,139.0,75.76470588235294,17,1194,6972158.25,123.0,70.23529411764706
108108119.0,17,5,955,5,955,27027029.75,191.0,191.0,0,0,0.0,0.0,0.0
305425.0,6,3,202,2,128,0.0,74.0,64.0,1,74,0.0,74.0,74.0
43645.0,6,14,4740,7,653,6584.5,249.0,93.28571428571428,7,4087,6161.666666666667,1514.0,583.8571428571429
2434.0,17,4,344,2,150,0.0,75.0,75.0,2,194,0.0,103.0,97.0
206673.0,17,2,180,1,90,0.0,90.0,90.0,1,90,0.0,90.0,90.0
0.0,17,1,381,1,381,0.0,381.0,381.0,0,0,0.0,0.0,0.0
157603.0,6,3,337,2,214,0.0,160.0,107.0,1,123,0.0,123.0,123.0
91396080.0,6,24,1829,13,989,7615468.25,95.0,76.07692307692308,11,840,9138681.8,95.0,76.36363636363636
623622.0,6,4,508,2,238,0.0,172.0,119.0,2,270,0.0,135.0,135.0
2090.0,17,4,344,2,150,0.0,75.0,75.0,2,194,0.0,103.0,97.0
108106674.0,17,5,1005,5,1005,27026668.5,201.0,201.0,0,0,0.0,0.0,0.0
245950.0,6,3,337,2,214,0.0,160.0,107.0,1,123,0.0,123.0,123.0
100899511.0,6,32,2220,16,1149,6712237.866666666,123.0,71.8125,16,1071,6712244.4,123.0,66.9375
22521.0,6,14,4740,7,653,3630.6666666666665,249.0,93.28571428571428,7,4087,3593.0,1514.0,583.8571428571429
1471738.0,17,16,1120,16,1120,98115.86666666668,70.0,70.0,0,0,0.0,0.0,0.0
0.0,17,1,72,1,72,0.0,72.0,72.0,0,0,0.0,0.0,0.0
2063812.0,6,28,8251,15,4067,147415.14285714287,1514.0,271.1333333333333,13,4184,144629.33333333334,1514.0,321.84615384615387
3638053.0,6,5,336,2,134,0.0,68.0,67.0,3,202,532785.0,70.0,67.33333333333333
0.0,17,1,90,1,90,0.0,90.0,90.0,0,0,0.0,0.0,0.0
299.0,17,2,168,1,76,0.0,76.0,76.0,1,92,0.0,92.0,92.0
211246.0,6,3,426,2,280,0.0,214.0,140.0,1,146,0.0,146.0,146.0
209610.0,6,3,426,2,280,0.0,214.0,140.0,1,146,0.0,146.0,146.0
111004334.0,6,30,1990,15,1042,7913443.357142857,139.0,69.46666666666667,15,948,7913401.428571428,123.0,63.2
146417.0,6,3,337,2,214,0.0,160.0,107.0,1,123,0.0,123.0,123.0
334834.0,17,4,1400,4,1400,111611.33333333331,350.0,350.0,0,0,0.0,0.0,0.0
108103269.0,17,5,955,5,955,27025817.25,191.0,191.0,0,0,0.0,0.0,0.0
322.0,17,2,174,1,79,0.0,79.0,79.0,1,95,0.0,95.0,95.0
14435.0,6,11,1133,6,602,2784.8,264.0,100.33333333333331,5,531,2327.5,259.0,106.2
100582.0,17,2,762,2,762,0.0,381.0,381.0,0,0,0.0,0.0,0.0
243112.0,6,3,337,2,214,0.0,160.0,107.0,1,123,0.0,123.0,123.0
44767.0,6,13,1386,7,789,7143.5,253.0,112.71428571428572,6,597,8279.2,259.0,99.5
148013.0,17,2,180,1,90,0.0,90.0,90.0,1,90,0.0,90.0,90.0
55473.0,6,13,1479,7,882,9245.5,291.0,126.0,6,597,8485.0,259.0,99.5
2178.0,17,4,344,2,150,0.0,75.0,75.0,2,194,0.0,103.0,97.0
249101.0,6,3,337,2,214,0.0,160.0,107.0,1,123,0.0,123.0,123.0
4951.0,17,4,344,2,150,0.0,75.0,75.0,2,194,0.0,103.0,97.0
14634240.0,6,20,1689,10,1057,1592389.5555555555,315.0,105.7,10,632,1592364.2222222222,78.0,63.2
120016786.0,17,28,13364,28,13364,4445066.148148148,501.0,477.2857142857143,0,0,0.0,0.0,0.0
146431.0,17,4,704,2,148,0.0,74.0,74.0,2,556,0.0,280.0,278.0
90034896.0,17,27,12943,27,12943,3462880.6153846155,501.0,479.3703703703704,0,0,0.0,0.0,0.0
90259957.0,6,12,1832,8,1016,12894279.57142857,188.0,127.0,4,816,30031900.666666668,204.0,204.0
33619.0,6,14,4740,7,653,5433.833333333333,249.0,93.28571428571428,7,4087,5393.833333333333,1514.0,583.8571428571429
24491151.0,6,5,1909,2,892,0.0,826.0,446.0,3,1017,12174397.5,885.0,339.0
219292.0,6,12,1373,7,714,36548.66666666666,298.0,102.0,5,659,54161.75,379.0,131.8
306754.0,6,6,412,4,272,102251.33333333331,74.0,68.0,2,140,0.0,74.0,70.0
120123094.0,6,13,2020,9,1204,15015386.75,188.0,133.77777777777777,4,816,30041560.0,204.0,204.0
46388.0,6,10,2032,5,524,10706.0,252.0,104.8,5,1508,11027.25,1236.0,301.6
210734.0,6,10,1221,6,636,42146.8,298.0,106.0,4,585,69423.0,379.0,146.25
120039125.0,6,21,1585,10,745,13337680.555555556,95.0,74.5,11,840,11977757.3,95.0,76.36363636363636
108104450.0,17,5,955,5,955,27026112.5,191.0,191.0,0,0,0.0,0.0,0.0
537527.0,17,6,2100,6,2100,107505.4,350.0,350.0,0,0,0.0,0.0,0.0
146985.0,6,3,373,2,238,0.0,172.0,119.0,1,135,0.0,135.0,135.0
232341.0,6,3,337,2,214,0.0,160.0,107.0,1,123,0.0,123.0,123.0
108672941.0,6,36,2596,18,1348,6392525.94117647,139.0,74.88888888888889,18,1248,6379343.411764706,123.0,69.33333333333333
145447.0,6,3,337,2,214,0.0,160.0,107.0,1,123,0.0,123.0,123.0
121798841.0,17,14,1126,7,563,17000174.0,174.0,80.42857142857143,7,563,17000685.833333332,174.0,80.42857142857143
2897.0,17,4,344,2,150,0.0,75.0,75.0,2,194,0.0,103.0,97.0
18347.0,6,11,2098,6,590,3548.8,252.0,98.33333333333331,5,1508,4217.25,1236.0,301.6
135132074.0,17,6,1146,6,1146,27026414.8,191.0,191.0,0,0,0.0,0.0,0.0
1100505.0,17,2,876,2,876,0.0,438.0,438.0,0,0,0.0,0.0,0.0
166613.0,17,4,1524,4,1524,55537.66666666666,381.0,381.0,0,0,0.0,0.0,0.0
1332689.0,6,7,499,4,301,430903.6666666667,103.0,75.25,3,198,613062.5,66.0,66.0
2289322.0,6,49,23728,25,19797,95388.41666666669,1514.0,791.88,24,3931,90307.08695652174,1514.0,163.79166666666666
2060.0,17,4,344,2,150,0.0,75.0,75.0,2,194,0.0,103.0,97.0
34320.0,6,14,4740,7,653,5380.833333333333,249.0,93.28571428571428,7,4087,5579.833333333333,1514.0,583.8571428571429
344.0,17,2,250,1,93,0.0,93.0,93.0,1,157,0.0,157.0,157.0
2430.0,17,4,344,2,150,0.0,75.0,75.0,2,194,0.0,103.0,97.0
834.0,17,4,438,2,148,0.0,74.0,74.0,2,290,0.0,147.0,145.0
39648.0,6,10,2032,5,524,9594.5,252.0,104.8,5,1508,7819.5,1236.0,301.6
123840011.0,6,49,3234,25,1650,5160000.458333333,66.0,66.0,24,1584,4956129.826086956,66.0,66.0
228147.0,17,2,180,1,90,0.0,90.0,90.0,1,90,0.0,90.0,90.0
104879281.0,17,15,5130,15,5130,7491377.214285715,342.0,342.0,0,0,0.0,0.0,0.0
163249.0,6,11,1132,6,556,32649.8,218.0,92.66666666666669,5,576,40348.5,304.0,115.2
247283.0,17,2,180,1,90,0.0,90.0,90.0,1,90,0.0,90.0,90.0
23956144.0,6,26,7627,14,3735,193950.15384615384,1514.0,266.7857142857143,12,3892,2159214.727272727,1514.0,324.3333333333333
2332.0,17,4,344,2,150,0.0,75.0,75.0,2,194,0.0,103.0,97.0
256878.0,6,3,337,2,214,0.0,160.0,107.0,1,123,0.0,123.0,123.0
198188.0,17,2,180,1,90,0.0,90.0,90.0,1,90,0.0,90.0,90.0
51693.0,6,13,1394,7,797,8441.666666666666,253.0,113.85714285714286,6,597,9145.0,259.0,99.5
109894467.0,6,26,1683,13,840,9157872.25,123.0,64.61538461538461,13,843,9140753.5,123.0,64.84615384615384
9251.0,6,10,2032,5,524,1966.0,252.0,104.8,5,1508,2051.0,1236.0,301.6
29710423.0,6,26,8753,13,2029,2475868.583333333,408.0,156.07692307692307,13,6724,2162052.083333333,1514.0,517.2307692307693
9073.0,17,2,498,1,80,0.0,80.0,80.0,1,418,0.0,418.0,418.0
10474639.0,6,7,478,4,272,3445987.6666666665,74.0,68.0,3,206,5168909.0,74.0,68.66666666666667
1567202.0,6,2,132,1,66,0.0,66.0,66.0,1,66,0.0,66.0,66.0
206991.0,6,3,426,2,280,0.0,214.0,140.0,1,146,0.0,146.0,146.0
125824092.0,6,35,2733,20,1578,6622320.631578947,123.0,78.9,15,1155,8486961.5,123.0,77.0
143904.0,17,2,180,1,90,0.0,90.0,90.0,1,90,0.0,90.0,90.0
33178.0,6,10,2032,5,524,7804.25,252.0,104.8,5,1508,5119.75,1236.0,301.6
108109642.0,17,5,1005,5,1005,27027410.5,201.0,201.0,0,0,0.0,0.0,0.0
251903.0,6,3,373,2,238,0.0,172.0,119.0,1,135,0.0,135.0,135.0
207206.0,6,3,426,2,280,0.0,214.0,140.0,1,146,0.0,146.0,146.0
95158779.0,6,40,2640,20,1320,5008356.7894736845,66.0,66.0,20,1320,4996980.947368421,66.0,66.0
42738.0,6,14,4740,7,653,6935.166666666667,249.0,93.28571428571428,7,4087,6967.666666666667,1514.0,583.8571428571429
206905.0,17,2,762,2,762,0.0,381.0,381.0,0,0,0.0,0.0,0.0
108109762.0,17,5,1005,5,1005,27027440.5,201.0,201.0,0,0,0.0,0.0,0.0
397860.0,6,3,1604,2,851,0.0,785.0,425.5,1,753,0.0,753.0,753.0
3006940.0,6,156,120986,87,112130,34964.41860465116,1510.0,1288.8505747126435,69,8856,39758.57352941176,1510.0,128.34782608695653
10306.0,6,10,1067,5,536,2411.5,264.0,107.2,5,531,2311.5,259.0,106.2
108107281.0,17,5,955,5,955,27026820.25,191.0,191.0,0,0,0.0,0.0,0.0
190369.0,17,2,762,2,762,0.0,381.0,381.0,0,0,0.0,0.0,0.0
297519.0,6,6,412,4,272,99173.0,74.0,68.0,2,140,0.0,74.0,70.0
586968.0,6,4,508,2,238,0.0,172.0,119.0,2,270,0.0,135.0,135.0
2594650.0,6,2,132,1,66,0.0,66.0,66.0,1,66,0.0,66.0,66.0
2474.0,17,4,344,2,150,0.0,75.0,75.0,2,194,0.0,103.0,97.0
90035606.0,17,28,13364,28,13364,3334652.074074074,501.0,477.2857142857143,0,0,0.0,0.0,0.0
104737642.0,17,14,864,7,432,17334426.666666668,174.0,61.71428571428572,7,432,17333487.333333332,174.0,61.71428571428572
34324.0,6,12,1320,7,789,5720.666666666667,253.0,112.71428571428572,5,531,5681.0,259.0,106.2
2285.0,17,4,344,2,150,0.0,75.0,75.0,2,194,0.0,103.0,97.0
572464.0,6,4,508,2,238,0.0,172.0,119.0,2,270,0.0,135.0,135.0
9225.0,17,2,582,1,83,0.0,83.0,83.0,1,499,0.0,499.0,499.0
2359.0,17,2,762,2,762,0.0,381.0,381.0,0,0,0.0,0.0,0.0
103026.0,17,2,286,2,286,0.0,143.0,143.0,0,0,0.0,0.0,0.0
46472.0,6,14,4740,7,653,6632.166666666667,249.0,93.28571428571428,7,4087,6583.666666666667,1514.0,583.8571428571429
108104798.0,17,5,1005,5,1005,27026199.5,201.0,201.0,0,0,0.0,0.0,0.0
308058.0,6,6,412,4,272,102686.0,74.0,68.0,2,140,0.0,74.0,70.0
324156.0,17,2,176,1,80,0.0,80.0,80.0,1,96,0.0,96.0,96.0
119888064.0,17,35,16705,35,16705,3526119.529411765,501.0,477.2857142857143,0,0,0.0,0.0,0.0
53958.0,6,14,4740,7,653,8427.666666666666,249.0,93.28571428571428,7,4087,8705.5,1514.0,583.8571428571429
278221.0,6,10,1221,6,636,55644.2,298.0,106.0,4,585,87241.33333333333,379.0,146.25
416.0,17,2,410,1,78,0.0,78.0,78.0,1,332,0.0,332.0,332.0
120128935.0,6,272,31682,136,9272,883853.6814814815,140.0,68.17647058823529,136,22410,883857.7111111111,284.0,164.77941176470588
275522.0,17,2,180,1,90,0.0,90.0,90.0,1,90,0.0,90.0,90.0
26604.0,17,2,582,1,83,0.0,83.0,83.0,1,499,0.0,499.0,499.0
208604.0,6,10,1221,6,636,41720.8,298.0,106.0,4,585,68318.66666666667,379.0,146.25
30805.0,6,14,4740,7,653,4958.833333333333,249.0,93.28571428571428,7,4087,4016.3333333333335,1514.0,583.8571428571429
242021.0,6,3,337,2,214,0.0,160.0,107.0,1,123,0.0,123.0,123.0
206009.0,6,3,426,2,280,0.0,214.0,140.0,1,146,0.0,146.0,146.0
120471194.0,6,223,25294,112,17672,1085326.0720720722,300.0,157.78571428571428,111,7622,1085819.8363636364,140.0,68.66666666666667
302404.0,6,2,132,1,66,0.0,66.0,66.0,1,66,0.0,66.0,66.0
199462.0,6,3,337,2,214,0.0,160.0,107.0,1,123,0.0,123.0,123.0
234664.0,6,3,337,2,214,0.0,160.0,107.0,1,123,0.0,123.0,123.0
209150.0,17,2,180,1,90,0.0,90.0,90.0,1,90,0.0,90.0,90.0
7245.0,17,2,180,1,90,0.0,90.0,90.0,1,90,0.0,90.0,90.0
121455.0,6,3,337,2,214,0.0,160.0,107.0,1,123,0.0,123.0,123.0
299607.0,6,6,412,4,272,99869.0,74.0,68.0,2,140,0.0,74.0,70.0
27407.0,6,14,4740,7,653,4226.333333333333,249.0,93.28571428571428,7,4087,4104.333333333333,1514.0,583.8571428571429
117044618.0,17,14,864,7,432,19501171.666666668,174.0,61.71428571428572,7,432,19500166.0,174.0,61.71428571428572
30698.0,6,13,1479,7,882,5116.333333333333,291.0,126.0,6,597,4726.0,259.0,99.5
95542528.0,17,12,778,6,389,19000157.8,174.0,64.83333333333333,6,389,19001198.8,174.0,64.83333333333333
9558.0,17,2,539,1,86,0.0,86.0,86.0,1,453,0.0,453.0,453.0
92111941.0,17,12,778,6,389,18402435.4,174.0,64.83333333333333,6,389,18400172.6,174.0,64.83333333333333
10935769.0,6,8,544,4,272,3599775.333333333,74.0,68.0,4,272,3599704.333333333,74.0,68.0
147958.0,17,2,180,1,90,0.0,90.0,90.0,1,90,0.0,90.0,90.0
317800.0,6,6,412,4,272,105933.33333333331,74.0,68.0,2,140,0.0,74.0,70.0
98478232.0,6,32,2368,16,1228,6565215.466666667,139.0,76.75,16,1140,6550791.266666667,123.0,71.25
249938.0,6,3,337,2,214,0.0,160.0,107.0,1,123,0.0,123.0,123.0
25085.0,6,14,4740,7,653,3523.5,249.0,93.28571428571428,7,4087,3877.1666666666665,1514.0,583.8571428571429
147187.0,6,3,337,2,214,0.0,160.0,107.0,1,123,0.0,123.0,123.0
99561792.0,17,13,1083,7,563,16500129.666666666,174.0,80.42857142857143,6,520,17120284.0,174.0,86.66666666666667
107365.0,17,2,286,2,286,0.0,143.0,143.0,0,0,0.0,0.0,0.0
311964.0,17,4,622,4,622,103988.0,163.0,155.5,0,0,0.0,0.0,0.0
25949.0,6,13,1386,7,789,4065.8333333333335,253.0,112.71428571428572,6,597,3881.6,259.0,99.5
108108008.0,17,5,955,5,955,27027002.0,191.0,191.0,0,0,0.0,0.0,0.0
144077.0,17,2,180,1,90,0.0,90.0,90.0,1,90,0.0,90.0,90.0
42173.0,6,14,4740,7,653,6594.5,249.0,93.28571428571428,7,4087,5476.5,1514.0,583.8571428571429
117308432.0,17,14,864,7,432,19524582.0,174.0,61.71428571428572,7,432,19509066.166666668,174.0,61.71428571428572
148025.0,17,2,180,1,90,0.0,90.0,90.0,1,90,0.0,90.0,90.0
153481.0,17,2,180,1,90,0.0,90.0,90.0,1,90,0.0,90.0,90.0
50642.0,6,14,4740,7,653,8057.833333333333,249.0,93.28571428571428,7,4087,7140.5,1514.0,583.8571428571429
113725680.0,6,48,3168,24,1584,4944594.782608695,66.0,66.0,24,1584,4931489.0,66.0,66.0
901.0,17,4,438,2,148,0.0,74.0,74.0,2,290,0.0,147.0,145.0
309158.0,6,6,412,4,272,103052.66666666669,74.0,68.0,2,140,0.0,74.0,70.0
294346.0,6,10,1221,6,636,58869.2,298.0,106.0,4,585,92681.33333333331,379.0,146.25
3311.0,17,2,231,1,78,0.0,78.0,78.0,1,153,0.0,153.0,153.0
5374.0,17,4,344,2,150,0.0,75.0,75.0,2,194,0.0,103.0,97.0
730.0,17,2,762,2,762,0.0,381.0,381.0,0,0,0.0,0.0,0.0
321905.0,6,6,412,4,272,107301.66666666669,74.0,68.0,2,140,0.0,74.0,70.0
2409.0,17,4,344,2,150,0.0,75.0,75.0,2,194,0.0,103.0,97.0
108665511.0,6,35,2542,18,1348,6379396.294117647,139.0,74.88888888888889,17,1194,6778097.4375,123.0,70.23529411764706
56811.0,6,12,1328,7,797,9468.5,253.0,113.85714285714286,5,531,11269.75,259.0,106.2
1203896.0,17,7,490,7,490,200649.3333333333,70.0,70.0,0,0,0.0,0.0,0.0
309045.0,17,4,1400,4,1400,103015.0,350.0,350.0,0,0,0.0,0.0,0.0
207762.0,6,10,1221,6,636,41552.4,298.0,106.0,4,585,68075.0,379.0,146.25
323969.0,17,4,1400,4,1400,107989.66666666669,350.0,350.0,0,0,0.0,0.0,0.0
120036201.0,17,28,13364,28,13364,4445785.222222222,501.0,477.2857142857143,0,0,0.0,0.0,0.0
146070.0,6,3,337,2,214,0.0,160.0,107.0,1,123,0.0,123.0,123.0
132005400.0,17,15,907,8,475,18857914.285714287,174.0,59.375,7,432,18666829.666666668,174.0,61.71428571428572
15026843.0,17,6,2718,6,2718,3005368.6,453.0,453.0,0,0,0.0,0.0,0.0
307528.0,17,4,704,2,148,0.0,74.0,74.0,2,556,0.0,280.0,278.0
37498.0,6,14,4740,7,653,6120.5,249.0,93.28571428571428,7,4087,5630.5,1514.0,583.8571428571429
5004826.0,17,4,849,2,166,0.0,83.0,83.0,2,683,0.0,499.0,341.5
812102.0,17,4,883,2,156,0.0,78.0,78.0,2,727,0.0,395.0,363.5
46771.0,6,14,4740,7,653,7642.333333333333,249.0,93.28571428571428,7,4087,7335.666666666667,1514.0,583.8571428571429
147833.0,6,3,337,2,214,0.0,160.0,107.0,1,123,0.0,123.0,123.0
18315612.0,6,26,7627,14,3735,180233.3076923077,1514.0,266.7857142857143,12,3892,1646459.0909090908,1514.0,324.3333333333333
119000971.0,17,13,821,7,432,19833495.166666668,174.0,61.71428571428572,6,389,19800251.2,174.0,64.83333333333333
60267.0,6,14,4740,7,653,9637.166666666666,249.0,93.28571428571428,7,4087,9784.666666666666,1514.0,583.8571428571429
109001006.0,17,13,821,7,432,18166834.33333333,174.0,61.71428571428572,6,389,17801225.8,174.0,64.83333333333333
34132.0,6,14,4740,7,653,5223.833333333333,249.0,93.28571428571428,7,4087,5015.166666666667,1514.0,583.8571428571429
0.0,6,1,54,0,0,0.0,0.0,0.0,1,54,0.0,54.0,54.0
24177.0,6,10,1067,5,536,4934.25,264.0,107.2,5,531,4715.5,259.0,106.2
217826.0,6,3,426,2,280,0.0,214.0,140.0,1,146,0.0,146.0,146.0
51260.0,6,14,4740,7,653,8093.833333333333,249.0,93.28571428571428,7,4087,8338.166666666666,1514.0,583.8571428571429
13509877.0,6,20,1607,10,975,1467737.7777777778,315.0,97.5,10,632,1467685.3333333333,78.0,63.2
200682.0,17,4,6056,4,6056,66894.0,1514.0,1514.0,0,0,0.0,0.0,0.0
156408.0,17,2,180,1,90,0.0,90.0,90.0,1,90,0.0,90.0,90.0
148635.0,17,2,398,1,88,0.0,88.0,88.0,1,310,0.0,310.0,310.0
129007237.0,17,15,907,8,475,18429605.285714287,174.0,59.375,7,432,18166891.0,174.0,61.71428571428572
2386.0,17,4,344,2,150,0.0,75.0,75.0,2,194,0.0,103.0,97.0
2459.0,17,4,344,2,150,0.0,75.0,75.0,2,194,0.0,103.0,97.0
90763415.0,6,17,1287,9,691,11339202.75,95.0,76.77777777777777,8,596,12965391.857142856,95.0,74.5
846856.0,6,9,1096,6,625,169371.2,287.0,104.16666666666669,3,471,285859.0,331.0,157.0
43124.0,6,14,4740,7,653,6827.333333333333,249.0,93.28571428571428,7,4087,5481.333333333333,1514.0,583.8571428571429
101946.0,17,2,286,2,286,0.0,143.0,143.0,0,0,0.0,0.0,0.0
572.0,17,5,550,5,550,143.0,110.0,110.0,0,0,0.0,0.0,0.0
46670.0,6,10,2032,5,524,10784.0,252.0,104.8,5,1508,9535.25,1236.0,301.6
149840224.0,17,36,17126,36,17126,4281149.257142857,501.0,475.72222222222223,0,0,0.0,0.0,0.0
116333142.0,6,32,2236,16,1071,7755542.8,123.0,66.9375,16,1165,7075444.266666667,139.0,72.8125
2599.0,17,4,344,2,150,0.0,75.0,75.0,2,194,0.0,103.0,97.0
310197.0,17,4,704,2,148,0.0,74.0,74.0,2,556,0.0,280.0,278.0
98052641.0,6,195,22132,98,6690,1010851.969072165,140.0,68.26530612244898,97,15442,1010715.59375,300.0,159.1958762886598
33377.0,6,13,1386,7,789,5215.333333333333,253.0,112.71428571428572,6,597,5662.4,259.0,99.5
17165.0,6,14,4740,7,653,2593.833333333333,249.0,93.28571428571428,7,4087,2723.0,1514.0,583.8571428571429
121001273.0,17,15,907,8,475,17285896.14285714,174.0,59.375,7,432,16834958.0,174.0,61.71428571428572
252628.00000000003,17,4,6056,4,6056,84209.33333333333,1514.0,1514.0,0,0,0.0,0.0,0.0
970.0,17,4,438,2,148,0.0,74.0,74.0,2,290,0.0,147.0,145.0
205016.0,17,2,762,2,762,0.0,381.0,381.0,0,0,0.0,0.0,0.0
90262238.0,6,12,1832,8,1016,12894605.42857143,188.0,127.0,4,816,30031843.33333333,204.0,204.0
198885.0,17,2,180,1,90,0.0,90.0,90.0,1,90,0.0,90.0,90.0
142006.0,6,2,132,1,66,0.0,66.0,66.0,1,66,0.0,66.0,66.0
309075.0,17,2,238,1,74,0.0,74.0,74.0,1,164,0.0,164.0,164.0
90257149.0,6,13,2036,8,1016,12893878.42857143,188.0,127.0,5,1020,22522940.75,204.0,204.0
206017.0,6,3,426,2,280,0.0,214.0,140.0,1,146,0.0,146.0,146.0
2466992.0,6,25,7573,14,3735,189768.6153846153,1514.0,266.7857142857143,11,3838,220304.5,1514.0,348.90909090909093
149627.0,17,2,180,1,90,0.0,90.0,90.0,1,90,0.0,90.0,90.0
108109163.0,17,5,1005,5,1005,27027290.75,201.0,201.0,0,0,0.0,0.0,0.0
108101008.0,17,5,1005,5,1005,27025252.0,201.0,201.0,0,0,0.0,0.0,0.0
102174.0,17,2,762,2,762,0.0,381.0,381.0,0,0,0.0,0.0,0.0
52175.0,6,14,4740,7,653,7142.5,249.0,93.28571428571428,7,4087,8234.666666666666,1514.0,583.8571428571429
300467.0,6,6,412,4,272,100155.66666666669,74.0,68.0,2,140,0.0,74.0,70.0
298357.0,6,6,412,4,272,99452.33333333331,74.0,68.0,2,140,0.0,74.0,70.0
90218176.0,6,19,1436,9,691,11245370.375,95.0,76.77777777777777,10,745,9999896.666666666,95.0,74.5
1023351.0,6,11,1134,6,558,204670.2,220.0,93.0,5,576,254998.25,304.0,115.2
107091124.0,17,14,864,7,432,17834338.5,174.0,61.71428571428572,7,432,17833471.333333332,174.0,61.71428571428572
281095.0,17,2,363,1,79,0.0,79.0,79.0,1,284,0.0,284.0,284.0
197386.0,17,2,180,1,90,0.0,90.0,90.0,1,90,0.0,90.0,90.0
9540.0,17,2,582,1,83,0.0,83.0,83.0,1,499,0.0,499.0,499.0
90059855.0,17,28,13364,28,13364,3335550.185185185,501.0,477.2857142857143,0,0,0.0,0.0,0.0
108090248.0,17,5,1005,5,1005,27022562.0,201.0,201.0,0,0,0.0,0.0,0.0
255591.0,6,13,1386,7,789,42598.5,253.0,112.71428571428572,6,597,49271.2,259.0,99.5
308250.0,6,6,412,4,272,102750.0,74.0,68.0,2,140,0.0,74.0,70.0
103313.0,17,2,286,2,286,0.0,143.0,143.0,0,0,0.0,0.0,0.0
100456219.0,17,11,604,6,389,20091243.8,174.0,64.83333333333333,5,215,20001765.25,43.0,43.0
308081.0,6,6,412,4,272,102693.66666666669,74.0,68.0,2,140,0.0,74.0,70.0
21073106.0,17,3,1034,2,684,0.0,342.0,342.0,1,350,0.0,350.0,350.0
309906.0,6,6,412,4,272,103302.0,74.0,68.0,2,140,0.0,74.0,70.0
302328.0,6,6,412,4,272,100776.0,74.0,68.0,2,140,0.0,74.0,70.0
42112.0,6,10,2032,5,524,9615.25,252.0,104.8,5,1508,10143.0,1236.0,301.6
298342.0,6,6,412,4,272,99447.33333333331,74.0,68.0,2,140,0.0,74.0,70.0
110460301.0,6,32,2236,16,1165,7349671.333333333,139.0,72.8125,16,1071,7349673.0,123.0,66.9375
1173930.0,6,13,3010,8,2382,167704.2857142857,1514.0,297.75,5,628,224555.0,331.0,125.6
4373.0,17,2,614,1,72,0.0,72.0,72.0,1,542,0.0,542.0,542.0
119636973.0,6,48,3168,24,1584,5201607.521739131,66.0,66.0,24,1584,5188150.304347826,66.0,66.0
1772.0,17,2,180,1,90,0.0,90.0,90.0,1,90,0.0,90.0,90.0
308196.0,6,6,412,4,272,102732.0,74.0,68.0,2,140,0.0,74.0,70.0
120346516.0,6,208,23548,104,7172,1160559.349514563,140.0,68.96153846153847,104,16376,1160387.475728155,284.0,157.46153846153845
0.0,17,1,453,1,453,0.0,453.0,453.0,0,0,0.0,0.0,0.0
2276.0,17,4,344,2,150,0.0,75.0,75.0,2,194,0.0,103.0,97.0
48042.0,6,14,4740,7,653,6599.0,249.0,93.28571428571428,7,4087,7826.833333333333,1514.0,583.8571428571429
285537.0,17,2,180,1,90,0.0,90.0,90.0,1,90,0.0,90.0,90.0
135132318.0,17,6,1146,6,1146,27026463.6,191.0,191.0,0,0,0.0,0.0,0.0
303610.0,6,2,132,1,66,0.0,66.0,66.0,1,66,0.0,66.0,66.0
305352.0,6,3,202,2,128,0.0,74.0,64.0,1,74,0.0,74.0,74.0
100850.0,17,2,762,2,762,0.0,381.0,381.0,0,0,0.0,0.0,0.0
90025328.0,17,28,13364,28,13364,3334271.407407407,501.0,477.2857142857143,0,0,0.0,0.0,0.0
108107520.0,17,5,1005,5,1005,27026880.0,201.0,201.0,0,0,0.0,0.0,0.0
91421490.0,6,24,1829,13,989,7617851.833333333,95.0,76.07692307692308,11,840,9141322.4,95.0,76.36363636363636
307441.0,6,6,412,4,272,102480.33333333331,74.0,68.0,2,140,0.0,74.0,70.0
288.0,17,2,156,1,78,0.0,78.0,78.0,1,78,0.0,78.0,78.0
135132381.0,17,6,1146,6,1146,27026476.2,191.0,191.0,0,0,0.0,0.0,0.0
597090.0,6,3,198,2,132,0.0,66.0,66.0,1,66,0.0,66.0,66.0
0.0,17,1,453,1,453,0.0,453.0,453.0,0,0,0.0,0.0,0.0
113251809.0,6,46,3036,23,1518,5135442.0,66.0,66.0,23,1518,5135305.590909091,66.0,66.0
341.0,17,2,267,1,83,0.0,83.0,83.0,1,184,0.0,184.0,184.0
233286.0,6,3,337,2,214,0.0,160.0,107.0,1,123,0.0,123.0,123.0
205752.0,17,2,180,1,90,0.0,90.0,90.0,1,90,0.0,90.0,90.0
39661.0,6,14,4740,7,653,5377.833333333333,249.0,93.28571428571428,7,4087,6125.666666666667,1514.0,583.8571428571429
745.0,17,4,438,2,148,0.0,74.0,74.0,2,290,0.0,147.0,145.0
241356.0,6,3,337,2,214,0.0,160.0,107.0,1,123,0.0,123.0,123.0
2799539.0,6,2,132,1,66,0.0,66.0,66.0,1,66,0.0,66.0,66.0
2100077.0,6,25,7611,13,2516,175006.41666666666,1034.0,193.53846153846155,12,5095,162855.36363636365,1510.0,424.5833333333333
33201.0,6,10,2032,5,524,8087.0,252.0,104.8,5,1508,6463.5,1236.0,301.6
237064.0,17,2,180,1,90,0.0,90.0,90.0,1,90,0.0,90.0,90.0
292727.0,6,28,15117,15,1146,20909.071428571428,214.0,76.4,13,13971,24180.08333333333,1514.0,1074.6923076923076
0.0,17,1,381,1,381,0.0,381.0,381.0,0,0,0.0,0.0,0.0
108104017.0,17,5,1005,5,1005,27026004.25,201.0,201.0,0,0,0.0,0.0,0.0
135128027.0,17,6,1206,6,1206,27025605.4,201.0,201.0,0,0,0.0,0.0,0.0
90254391.0,6,12,1832,8,1016,12893484.42857143,188.0,127.0,4,816,30030683.666666668,204.0,204.0
34716.0,6,14,4740,7,653,5662.5,249.0,93.28571428571428,7,4087,5614.0,1514.0,583.8571428571429
0.0,17,1,44,1,44,0.0,44.0,44.0,0,0,0.0,0.0,0.0
0.0,6,1,66,1,66,0.0,66.0,66.0,0,0,0.0,0.0,0.0
115769150.0,6,30,1974,15,1026,8253551.428571428,123.0,68.4,15,948,8253793.928571428,123.0,63.2
9580.0,17,2,582,1,83,0.0,83.0,83.0,1,499,0.0,499.0,499.0
120484541.0,6,249,29494,125,21002,971649.5241935484,336.0,168.016,124,8492,972621.512195122,140.0,68.48387096774194
298251.0,6,6,412,4,272,99417.0,74.0,68.0,2,140,0.0,74.0,70.0
90288452.0,6,16,1192,8,596,12891003.285714284,95.0,74.5,8,596,12897401.714285716,95.0,74.5
90935547.0,6,29,2068,15,1105,6479953.142857143,139.0,73.66666666666667,14,963,6978424.538461538,123.0,68.78571428571429
131847.0,6,2,132,1,66,0.0,66.0,66.0,1,66,0.0,66.0,66.0
877233.0,6,10,1262,6,725,175446.6,387.0,120.83333333333331,4,537,201456.0,331.0,134.25
121254.0,6,3,337,2,214,0.0,160.0,107.0,1,123,0.0,123.0,123.0
2389.0,17,4,344,2,150,0.0,75.0,75.0,2,194,0.0,103.0,97.0
2775974.0,6,2,132,1,66,0.0,66.0,66.0,1,66,0.0,66.0,66.0
2798510.0,6,2,132,1,66,0.0,66.0,66.0,1,66,0.0,66.0,66.0
0.0,6,1,54,1,54,0.0,54.0,54.0,0,0,0.0,0.0,0.0
102343308.0,17,14,1126,7,563,17000152.333333332,174.0,80.42857142857143,7,563,17000776.833333332,174.0,80.42857142857143
27155114.0,17,5,1710,5,1710,6788778.5,342.0,342.0,0,0,0.0,0.0,0.0
10253.0,17,4,823,2,163,0.0,89.0,81.5,2,660,0.0,443.0,330.0
284414.0,17,2,363,1,79,0.0,79.0,79.0,1,284,0.0,284.0,284.0
90771123.0,6,24,1829,13,989,7560113.666666667,95.0,76.07692307692308,11,840,9048310.9,95.0,76.36363636363636
15045.0,6,14,4740,7,653,2398.833333333333,249.0,93.28571428571428,7,4087,2315.5,1514.0,583.8571428571429
120268405.0,6,206,23308,103,7094,1171024.0196078431,140.0,68.87378640776699,103,16214,1161975.31372549,390.0,157.41747572815535
113103388.0,6,31,2182,16,1165,7540225.866666666,139.0,72.8125,15,1017,7350016.285714285,123.0,67.8
2351672.0,6,3,1604,2,851,0.0,785.0,425.5,1,753,0.0,753.0,753.0
108109568.0,17,5,1005,5,1005,27027392.0,201.0,201.0,0,0,0.0,0.0,0.0
27107020.0,17,5,1710,5,1710,6776755.0,342.0,342.0,0,0,0.0,0.0,0.0
127807596.0,6,30,1974,15,948,8415907.785714285,123.0,63.2,15,1026,8415904.785714285,123.0,68.4
462.0,17,2,508,2,508,0.0,257.0,254.0,0,0,0.0,0.0,0.0
216288.0,17,2,180,1,90,0.0,90.0,90.0,1,90,0.0,90.0,90.0
2081.0,17,4,344,2,150,0.0,75.0,75.0,2,194,0.0,103.0,97.0
169035.0,17,2,414,1,88,0.0,88.0,88.0,1,326,0.0,326.0,326.0
122978181.0,6,48,3168,24,1584,5126510.739130435,66.0,66.0,24,1584,5140691.130434782,66.0,66.0
90295904.0,6,16,1192,8,596,12892516.57142857,95.0,74.5,8,596,12898350.57142857,95.0,74.5
2506.0,17,4,344,2,150,0.0,75.0,75.0,2,194,0.0,103.0,97.0
204930.0,17,2,762,2,762,0.0,381.0,381.0,0,0,0.0,0.0,0.0
2455.0,17,4,344,2,150,0.0,75.0,75.0,2,194,0.0,103.0,97.0
3005680.0,6,164,137658,96,128868,31638.736842105263,1510.0,1342.375,68,8790,40250.14925373135,1510.0,129.26470588235293
17973.0,6,10,1065,5,534,3670.0,262.0,106.8,5,531,3731.0,259.0,106.2
304762.0,6,6,412,4,272,101587.33333333331,74.0,68.0,2,140,0.0,74.0,70.0
107283018.0,17,14,864,7,432,17880503.0,174.0,61.71428571428572,7,432,17816054.666666668,174.0,61.71428571428572
204612.0,17,2,180,1,90,0.0,90.0,90.0,1,90,0.0,90.0,90.0
0.0,17,1,44,1,44,0.0,44.0,44.0,0,0,0.0,0.0,0.0
123302006.0,6,48,3168,24,1584,4988412.173913044,66.0,66.0,24,1584,5308358.217391305,66.0,66.0
143373.0,6,2,132,1,66,0.0,66.0,66.0,1,66,0.0,66.0,66.0
5817050.0,6,5,336,2,134,0.0,68.0,67.0,3,202,1521588.5,70.0,67.33333333333333
97248.0,17,4,1400,4,1400,32416.0,350.0,350.0,0,0,0.0,0.0,0.0
216874.0,17,2,180,1,90,0.0,90.0,90.0,1,90,0.0,90.0,90.0
228255.0,17,2,180,1,90,0.0,90.0,90.0,1,90,0.0,90.0,90.0
206044.0,17,2,180,1,90,0.0,90.0,90.0,1,90,0.0,90.0,90.0
5363.0,17,2,231,1,78,0.0,78.0,78.0,1,153,0.0,153.0,153.0
90260026.0,6,12,1832,8,1016,12894289.42857143,188.0,127.0,4,816,30031417.666666668,204.0,204.0
97945033.0,6,204,23146,103,7032,960245.4215686276,140.0,68.27184466019418,101,16114,968561.13,300.0,159.54455445544554
235442.0,6,3,373,2,238,0.0,172.0,119.0,1,135,0.0,135.0,135.0
43410.0,6,13,1479,7,882,7235.0,291.0,126.0,6,597,7280.4,259.0,99.5
23431.0,6,10,2032,5,524,5406.5,252.0,104.8,5,1508,5602.25,1236.0,301.6
120124015.0,6,14,2240,6,1224,24024803.0,204.0,204.0,8,1016,17097756.57142857,188.0,127.0
123209473.0,6,48,3168,24,1584,4922340.869565218,66.0,66.0,24,1584,5356922.217391305,66.0,66.0
37501.0,6,10,2032,5,524,8402.5,252.0,104.8,5,1508,7941.0,1236.0,301.6
108110303.0,17,5,955,5,955,27027575.75,191.0,191.0,0,0,0.0,0.0,0.0
104621202.0,6,44,2904,22,1452,4981962.0,66.0,66.0,22,1452,4967068.476190476,66.0,66.0
112407346.0,6,31,2166,16,1149,7479420.333333333,123.0,71.8125,15,1017,8013683.0,123.0,67.8
27327607.0,17,5,1710,5,1710,6831901.75,342.0,342.0,0,0,0.0,0.0,0.0
1638.0,17,2,192,1,88,0.0,88.0,88.0,1,104,0.0,104.0,104.0
56663.0,6,14,4740,7,653,9268.5,249.0,93.28571428571428,7,4087,8537.0,1514.0,583.8571428571429
2803070.0,6,2,132,1,66,0.0,66.0,66.0,1,66,0.0,66.0,66.0
244301.0,6,3,373,2,238,0.0,172.0,119.0,1,135,0.0,135.0,135.0
2024.0,17,4,344,2,150,0.0,75.0,75.0,2,194,0.0,103.0,97.0
120114.0,17,2,180,1,70,0.0,70.0,70.0,1,110,0.0,110.0,110.0
844866.0,6,9,1118,6,586,168973.2,248.0,97.66666666666669,3,532,284537.5,392.0,177.33333333333334
1054807.0,6,13,1479,7,882,175801.16666666666,291.0,126.0,6,597,208480.6,259.0,99.5
106586.0,17,2,286,2,286,0.0,143.0,143.0,0,0,0.0,0.0,0.0
120129667.0,6,400,48102,200,34582,602583.5829145729,336.0,172.91,200,13520,602584.4221105528,140.0,67.6
198065.0,17,2,180,1,90,0.0,90.0,90.0,1,90,0.0,90.0,90.0
335.0,17,2,174,1,79,0.0,79.0,79.0,1,95,0.0,95.0,95.0
18525.0,6,11,2098,6,590,3480.4,252.0,98.33333333333331,5,1508,4357.25,1236.0,301.6
338.0,17,2,174,1,79,0.0,79.0,79.0,1,95,0.0,95.0,95.0
303708.0,6,2,132,1,66,0.0,66.0,66.0,1,66,0.0,66.0,66.0
10475207.0,6,6,412,3,206,5169214.0,74.0,68.66666666666667,3,206,5169108.5,74.0,68.66666666666667
108105604.0,17,5,1005,5,1005,27026401.0,201.0,201.0,0,0,0.0,0.0,0.0
309388.0,17,2,180,1,90,0.0,90.0,90.0,1,90,0.0,90.0,90.0
0.0,17,1,90,1,90,0.0,90.0,90.0,0,0,0.0,0.0,0.0
91835703.0,6,25,1686,13,840,7652937.25,123.0,64.61538461538461,12,846,7441041.727272727,123.0,70.5
32830.0,6,10,2032,5,524,7824.0,252.0,104.8,5,1508,6088.0,1236.0,301.6
48060.0,17,3,1026,3,1026,24030.0,342.0,342.0,0,0,0.0,0.0,0.0
90015551.0,17,28,13364,28,13364,3333909.296296296,501.0,477.2857142857143,0,0,0.0,0.0,0.0
121441.0,6,3,337,2,214,0.0,160.0,107.0,1,123,0.0,123.0,123.0
108102253.0,17,5,955,5,955,27025563.25,191.0,191.0,0,0,0.0,0.0,0.0
91963438.0,6,182,20554,91,14326,1019423.2111111112,284.0,157.42857142857142,91,6228,1019424.0333333332,140.0,68.43956043956044
3168392.0,6,18,1577,9,1003,358369.0,315.0,111.44444444444444,9,574,358340.5,78.0,63.77777777777778
45823.0,6,14,4740,7,653,7220.166666666667,249.0,93.28571428571428,7,4087,7221.0,1514.0,583.8571428571429
146139.0,6,3,337,2,214,0.0,160.0,107.0,1,123,0.0,123.0,123.0
6790.0,17,2,582,1,83,0.0,83.0,83.0,1,499,0.0,499.0,499.0
242716.0,6,3,373,2,238,0.0,172.0,119.0,1,135,0.0,135.0,135.0
120036035.0,17,29,13785,29,13785,4287001.25,501.0,475.3448275862069,0,0,0.0,0.0,0.0
303364.0,6,6,412,4,272,101121.33333333331,74.0,68.0,2,140,0.0,74.0,70.0
90531484.0,6,13,2036,8,1016,12933069.142857144,188.0,127.0,5,1020,22592120.75,204.0,204.0
336.0,17,2,166,1,75,0.0,75.0,75.0,1,91,0.0,91.0,91.0
67219.0,6,13,1394,7,797,10969.666666666666,253.0,113.85714285714286,6,597,10512.0,259.0,99.5
1306934.0,6,4,264,2,132,0.0,66.0,66.0,2,132,0.0,66.0,66.0
3101.0,17,2,224,1,76,0.0,76.0,76.0,1,148,0.0,148.0,148.0
375852.0,17,2,180,1,90,0.0,90.0,90.0,1,90,0.0,90.0,90.0
109551084.0,6,206,23214,103,16182,1071958.4019607843,284.0,157.10679611650485,103,7032,1071958.6176470588,140.0,68.27184466019418
51077.0,17,2,180,1,90,0.0,90.0,90.0,1,90,0.0,90.0,90.0
28110.0,6,14,4740,7,653,4574.833333333333,249.0,93.28571428571428,7,4087,4457.0,1514.0,583.8571428571429
42980.0,6,13,1386,7,789,6875.166666666667,253.0,112.71428571428572,6,597,6054.6,259.0,99.5
48293.0,6,14,4740,7,653,7557.666666666667,249.0,93.28571428571428,7,4087,7648.833333333333,1514.0,583.8571428571429
112653.0,17,4,1400,4,1400,37551.0,350.0,350.0,0,0,0.0,0.0,0.0
107388.0,17,2,286,2,286,0.0,143.0,143.0,0,0,0.0,0.0,0.0
2315.0,17,4,344,2,150,0.0,75.0,75.0,2,194,0.0,103.0,97.0
303140.0,6,2,132,1,66,0.0,66.0,66.0,1,66,0.0,66.0,66.0
111304223.0,6,32,2236,16,1165,7405932.133333334,139.0,72.8125,16,1071,7405880.533333333,123.0,66.9375
144224.0,17,2,180,1,90,0.0,90.0,90.0,1,90,0.0,90.0,90.0
90021434.0,17,28,13364,28,13364,3334127.185185185,501.0,477.2857142857143,0,0,0.0,0.0,0.0
32673557.000000004,6,5,336,2,134,0.0,68.0,67.0,3,202,14950657.5,70.0,67.33333333333333
107515.0,17,2,286,2,286,0.0,143.0,143.0,0,0,0.0,0.0,0.0
0.0,17,1,342,1,342,0.0,342.0,342.0,0,0,0.0,0.0,0.0
122301.0,6,3,373,2,238,0.0,172.0,119.0,1,135,0.0,135.0,135.0
897242.0,6,12,2714,7,742,149540.33333333334,338.0,106.0,5,1972,155386.25,1514.0,394.4
320.0,17,2,174,1,79,0.0,79.0,79.0,1,95,0.0,95.0,95.0
301259.0,6,3,202,2,128,0.0,74.0,64.0,1,74,0.0,74.0,74.0
3572718.0,6,5,336,2,134,0.0,68.0,67.0,3,202,1422352.0,70.0,67.33333333333333
2086.0,17,4,344,2,150,0.0,75.0,75.0,2,194,0.0,103.0,97.0
153535.0,17,2,180,1,90,0.0,90.0,90.0,1,90,0.0,90.0,90.0
114019.0,17,4,1400,4,1400,38006.333333333336,350.0,350.0,0,0,0.0,0.0,0.0
91077.0,6,14,4740,7,653,10327.0,249.0,93.28571428571428,7,4087,12084.666666666666,1514.0,583.8571428571429
334.0,17,2,160,1,80,0.0,80.0,80.0,1,80,0.0,80.0,80.0
16097.0,6,14,4740,7,653,2364.0,249.0,93.28571428571428,7,4087,2537.0,1514.0,583.8571428571429
315810.0,6,6,412,4,272,105270.0,74.0,68.0,2,140,0.0,74.0,70.0
271445.0,6,3,337,2,214,0.0,160.0,107.0,1,123,0.0,123.0,123.0
95735888.0,6,264,30232,132,8934,724425.0076335878,140.0,67.68181818181819,132,21298,728036.1526717558,284.0,161.34848484848484
108104957.0,17,5,1005,5,1005,27026239.25,201.0,201.0,0,0,0.0,0.0,0.0
1487812.0,17,16,1120,16,1120,99187.46666666666,70.0,70.0,0,0,0.0,0.0,0.0
113927970.0,6,47,3102,24,1584,4953379.173913044,66.0,66.0,23,1518,5112001.363636363,66.0,66.0
71450.0,6,10,2032,5,524,17634.5,252.0,104.8,5,1508,17225.0,1236.0,301.6
90975499.0,6,172,19300,86,13402,1067767.611764706,284.0,155.8372093023256,86,5898,1067763.8,140.0,68.5813953488372
103594.0,17,2,286,2,286,0.0,143.0,143.0,0,0,0.0,0.0,0.0
46114.0,6,14,4740,7,653,6403.5,249.0,93.28571428571428,7,4087,7317.5,1514.0,583.8571428571429
31358.0,6,13,4416,6,409,5739.6,127.0,68.16666666666667,7,4007,5095.833333333333,1514.0,572.4285714285714
6789.0,17,2,582,1,83,0.0,83.0,83.0,1,499,0.0,499.0,499.0
48668.0,6,14,4740,7,653,7991.5,249.0,93.28571428571428,7,4087,7970.166666666667,1514.0,583.8571428571429
2279659.0,6,49,23728,25,19797,94985.79166666669,1514.0,791.88,24,3931,89851.95652173914,1514.0,163.79166666666666
3010304.0,6,12,2172,7,664,501293.8333333333,252.0,94.85714285714286,5,1508,3002.25,1236.0,301.6
65429.0,6,14,4740,7,653,10470.166666666666,249.0,93.28571428571428,7,4087,10546.833333333334,1514.0,583.8571428571429
1936152.0,6,4,492,2,280,0.0,214.0,140.0,2,212,0.0,146.0,106.0
3292007.0,17,3,1026,3,1026,1646003.5,342.0,342.0,0,0,0.0,0.0,0.0
147894.0,17,2,180,1,90,0.0,90.0,90.0,1,90,0.0,90.0,90.0
50959.0,6,14,4740,7,653,7938.0,249.0,93.28571428571428,7,4087,8014.333333333333,1514.0,583.8571428571429
216811.0,6,3,426,2,280,0.0,214.0,140.0,1,146,0.0,146.0,146.0
402.0,17,2,410,1,78,0.0,78.0,78.0,1,332,0.0,332.0,332.0
5618475.0,6,5,336,2,134,0.0,68.0,67.0,3,202,1370087.5,70.0,67.33333333333333
0.0,17,1,55,1,55,0.0,55.0,55.0,0,0,0.0,0.0,0.0
28041.0,6,10,2032,5,524,6715.75,252.0,104.8,5,1508,6658.5,1236.0,301.6
91438931.0,6,22,1680,12,935,8311104.727272727,95.0,77.91666666666667,10,745,10159754.777777778,95.0,74.5
36341.0,6,14,4740,7,653,5175.166666666667,249.0,93.28571428571428,7,4087,5884.0,1514.0,583.8571428571429
10497904.0,6,7,478,4,272,3454012.0,74.0,68.0,3,206,5180886.0,74.0,68.66666666666667
34151701.0,6,7,1874,3,887,17001806.5,753.0,295.6666666666667,4,987,11339671.666666666,785.0,246.75
284919.0,17,2,363,1,79,0.0,79.0,79.0,1,284,0.0,284.0,284.0
105752787.0,6,44,2904,22,1452,5035847.0,66.0,66.0,22,1452,5020875.0,66.0,66.0
346.0,17,2,164,1,82,0.0,82.0,82.0,1,82,0.0,82.0,82.0
123856700.0,6,48,3168,24,1584,5074744.434782608,66.0,66.0,24,1584,5227960.043478261,66.0,66.0
106633302.0,6,29,2052,15,1089,7601255.642857143,123.0,72.6,14,963,8185968.923076923,123.0,68.78571428571429
90295769.0,6,21,1585,11,840,9025086.6,95.0,76.36363636363636,10,745,10000610.222222222,95.0,74.5
107631.0,17,2,286,2,286,0.0,143.0,143.0,0,0,0.0,0.0,0.0
119047476.0,17,14,864,7,432,19834499.33333333,174.0,61.71428571428572,7,432,19833493.83333333,174.0,61.71428571428572
2085227.0,6,19,6869,11,1567,208522.7,408.0,142.45454545454547,8,5302,234892.14285714287,1514.0,662.75
3582114.0,6,5,336,2,134,0.0,68.0,67.0,3,202,1423568.5,70.0,67.33333333333333
348.0,17,2,152,1,76,0.0,76.0,76.0,1,76,0.0,76.0,76.0
108105227.0,17,5,955,5,955,27026306.75,191.0,191.0,0,0,0.0,0.0,0.0
76488.0,6,10,2032,5,524,18401.25,252.0,104.8,5,1508,18786.5,1236.0,301.6
90532723.0,6,13,2036,8,1016,12933246.142857144,188.0,127.0,5,1020,22592358.0,204.0,204.0
26317.0,6,14,4740,7,653,4265.666666666667,249.0,93.28571428571428,7,4087,4248.5,1514.0,583.8571428571429
38743.0,6,14,4740,7,653,6328.166666666667,249.0,93.28571428571428,7,4087,6191.666666666667,1514.0,583.8571428571429
1487237.0,6,20,7599,11,1469,148723.7,583.0,133.54545454545453,9,6130,153621.0,1484.0,681.1111111111111
198156.0,17,2,180,1,90,0.0,90.0,90.0,1,90,0.0,90.0,90.0
62431.0,6,14,4740,7,653,9943.666666666666,249.0,93.28571428571428,7,4087,9396.5,1514.0,583.8571428571429
107925411.0,6,206,23202,103,7094,1055159.392156863,140.0,68.87378640776699,103,16108,1050154.9803921569,284.0,156.38834951456312
15078675.0,17,6,2718,6,2718,3015735.0,453.0,453.0,0,0,0.0,0.0,0.0
9946.0,17,2,582,1,83,0.0,83.0,83.0,1,499,0.0,499.0,499.0
142397.0,6,2,132,1,66,0.0,66.0,66.0,1,66,0.0,66.0,66.0
113168281.0,6,46,3036,23,1518,5144001.7727272725,66.0,66.0,23,1518,5143999.318181818,66.0,66.0
27978.0,6,14,4740,7,653,4013.6666666666665,249.0,93.28571428571428,7,4087,4389.166666666667,1514.0,583.8571428571429
120062362.0,17,28,13364,28,13364,4446754.148148148,501.0,477.2857142857143,0,0,0.0,0.0,0.0
97666533.0,6,63,12277,32,6255,3150533.3225806453,1514.0,195.46875,31,6022,3247220.9,1514.0,194.25806451612905
14357.0,17,2,582,1,83,0.0,83.0,83.0,1,499,0.0,499.0,499.0
90045644.0,17,27,12943,27,12943,3463294.0,501.0,479.3703703703704,0,0,0.0,0.0,0.0
2348.0,17,4,344,2,150,0.0,75.0,75.0,2,194,0.0,103.0,97.0
6035.0,17,2,180,1,90,0.0,90.0,90.0,1,90,0.0,90.0,90.0
40760.0,6,12,1320,6,723,7726.6,253.0,120.5,6,597,7555.0,259.0,99.5
169409.0,6,11,1132,6,556,33881.8,218.0,92.66666666666669,5,576,41662.0,304.0,115.2
253501.0,17,4,1524,4,1524,84500.33333333333,381.0,381.0,0,0,0.0,0.0,0.0
2594135.0,6,2,132,1,66,0.0,66.0,66.0,1,66,0.0,66.0,66.0
206216.0,6,3,426,2,280,0.0,214.0,140.0,1,146,0.0,146.0,146.0
103114.0,17,2,286,2,286,0.0,143.0,143.0,0,0,0.0,0.0,0.0
90052498.0,17,28,13364,28,13364,3335277.703703704,501.0,477.2857142857143,0,0,0.0,0.0,0.0
232208.0,6,3,337,2,214,0.0,160.0,107.0,1,123,0.0,123.0,123.0
264261.0,6,3,337,2,214,0.0,160.0,107.0,1,123,0.0,123.0,123.0
2800310.0,6,2,132,1,66,0.0,66.0,66.0,1,66,0.0,66.0,66.0
120125322.0,6,13,2036,5,1020,30031330.5,204.0,204.0,8,1016,17137060.42857143,188.0,127.0
20492.0,6,14,4740,7,653,3213.333333333333,249.0,93.28571428571428,7,4087,3278.1666666666665,1514.0,583.8571428571429
302037.0,6,6,412,4,272,100679.0,74.0,68.0,2,140,0.0,74.0,70.0
2406.0,17,4,344,2,150,0.0,75.0,75.0,2,194,0.0,103.0,97.0
109001236.0,17,13,821,7,432,18166872.666666668,174.0,61.71428571428572,6,389,19897971.6,174.0,64.83333333333333
5624841.0,6,5,336,2,134,0.0,68.0,67.0,3,202,1522260.5,70.0,67.33333333333333
120123327.0,6,13,2036,8,1016,17137309.14285714,188.0,127.0,5,1020,22515281.75,204.0,204.0
108104347.0,17,5,1005,5,1005,27026086.75,201.0,201.0,0,0,0.0,0.0,0.0
102462.0,17,2,286,2,286,0.0,143.0,143.0,0,0,0.0,0.0,0.0
115858876.0,6,462,87948,231,72184,502841.39130434784,1514.0,312.4848484848485,231,15764,502841.3086956522,214.0,68.24242424242425
4373.0,17,2,598,1,72,0.0,72.0,72.0,1,526,0.0,526.0,526.0
109901094.0,6,32,2220,16,1149,7312354.733333333,123.0,71.8125,16,1071,7312360.466666667,123.0,66.9375
620676.0,17,2,346,1,78,0.0,78.0,78.0,1,268,0.0,268.0,268.0
103071.0,17,2,286,2,286,0.0,143.0,143.0,0,0,0.0,0.0,0.0
284258.0,17,2,363,1,79,0.0,79.0,79.0,1,284,0.0,284.0,284.0
192996.0,17,2,180,1,90,0.0,90.0,90.0,1,90,0.0,90.0,90.0
22597.0,6,14,4740,7,653,2931.0,249.0,93.28571428571428,7,4087,3163.1666666666665,1514.0,583.8571428571429
0.0,17,1,179,1,179,0.0,179.0,179.0,0,0,0.0,0.0,0.0
305367.0,17,2,620,1,75,0.0,75.0,75.0,1,545,0.0,545.0,545.0
104453065.0,17,14,864,7,432,17408844.166666668,174.0,61.71428571428572,7,432,17305715.0,174.0,61.71428571428572
27185.0,6,14,4740,7,653,4210.0,249.0,93.28571428571428,7,4087,4392.166666666667,1514.0,583.8571428571429
123913643.0,17,14,864,7,432,17333532.166666668,174.0,61.71428571428572,7,432,17334686.5,174.0,61.71428571428572
236349.0,6,3,337,2,214,0.0,160.0,107.0,1,123,0.0,123.0,123.0
305064.0,6,6,412,4,272,101688.0,74.0,68.0,2,140,0.0,74.0,70.0
299309.0,6,6,412,4,272,99769.66666666669,74.0,68.0,2,140,0.0,74.0,70.0
216696.0,6,3,426,2,280,0.0,214.0,140.0,1,146,0.0,146.0,146.0
103305.0,17,2,286,2,286,0.0,143.0,143.0,0,0,0.0,0.0,0.0
2669.0,17,2,664,1,322,0.0,322.0,322.0,1,342,0.0,342.0,342.0
360804.0,6,3,1604,2,851,0.0,785.0,425.5,1,753,0.0,753.0,753.0
82906987.0,17,14,4796,13,4446,6229330.75,342.0,342.0,1,350,0.0,350.0,350.0
2604315.0,6,2,132,1,66,0.0,66.0,66.0,1,66,0.0,66.0,66.0
3111.0,17,2,224,1,76,0.0,76.0,76.0,1,148,0.0,148.0,148.0
14631300.0,6,20,1648,10,1016,1592120.5555555555,315.0,101.6,10,632,1592102.7777777778,78.0,63.2
241755.0,6,3,337,2,214,0.0,160.0,107.0,1,123,0.0,123.0,123.0
46788972.0,6,8,1940,3,887,22186293.5,753.0,295.6666666666667,5,1053,11004023.25,785.0,210.6
48954.0,6,14,4740,7,653,8031.5,249.0,93.28571428571428,7,4087,7834.0,1514.0,583.8571428571429
3005395.0,6,11,2106,6,598,600906.0,252.0,99.66666666666669,5,1508,1783.25,1236.0,301.6
2052.0,17,4,344,2,150,0.0,75.0,75.0,2,194,0.0,103.0,97.0
5625335.0,6,5,336,2,134,0.0,68.0,67.0,3,202,1420980.0,70.0,67.33333333333333
239480.0,6,3,337,2,214,0.0,160.0,107.0,1,123,0.0,123.0,123.0
67689.0,6,10,2032,5,524,16591.75,252.0,104.8,5,1508,15868.25,1236.0,301.6
106163.0,17,2,286,2,286,0.0,143.0,143.0,0,0,0.0,0.0,0.0
306102.0,6,6,412,4,272,102034.0,74.0,68.0,2,140,0.0,74.0,70.0
307215.0,6,6,412,4,272,102405.0,74.0,68.0,2,140,0.0,74.0,70.0
42953.0,6,14,4740,7,653,7008.5,249.0,93.28571428571428,7,4087,6354.333333333333,1514.0,583.8571428571429
2593599.0,6,2,132,1,66,0.0,66.0,66.0,1,66,0.0,66.0,66.0
0.0,17,1,179,1,179,0.0,179.0,179.0,0,0,0.0,0.0,0.0
90057832.0,17,28,13364,28,13364,3335475.25925926,501.0,477.2857142857143,0,0,0.0,0.0,0.0
2591775.0,6,2,132,1,66,0.0,66.0,66.0,1,66,0.0,66.0,66.0
120082635.0,17,28,13364,28,13364,4447505.0,501.0,477.2857142857143,0,0,0.0,0.0,0.0
5073332.0,6,28,7875,15,2660,362380.8571428572,1034.0,177.33333333333334,13,5215,397175.3333333333,1510.0,401.1538461538461
135139575.0,17,6,1206,6,1206,27027915.0,201.0,201.0,0,0,0.0,0.0,0.0
290598.0,6,10,1221,6,636,58119.6,298.0,106.0,4,585,91329.66666666669,379.0,146.25
90030555.0,17,28,13364,28,13364,3334465.0,501.0,477.2857142857143,0,0,0.0,0.0,0.0
0.0,17,1,55,1,55,0.0,55.0,55.0,0,0,0.0,0.0,0.0
312117.0,6,3,204,2,136,0.0,70.0,68.0,1,68,0.0,68.0,68.0
90259910.0,6,13,2036,8,1016,12894272.857142856,188.0,127.0,5,1020,22523105.75,204.0,204.0
90044333.0,17,28,13364,28,13364,3334975.296296296,501.0,477.2857142857143,0,0,0.0,0.0,0.0
206120.0,6,3,426,2,280,0.0,214.0,140.0,1,146,0.0,146.0,146.0
104606.0,17,2,762,2,762,0.0,381.0,381.0,0,0,0.0,0.0,0.0
318214.0,17,4,1400,4,1400,106071.33333333331,350.0,350.0,0,0,0.0,0.0,0.0
21754.0,6,10,2032,5,524,5196.75,252.0,104.8,5,1508,5023.75,1236.0,301.6
113003.0,17,2,286,2,286,0.0,143.0,143.0,0,0,0.0,0.0,0.0
30180.0,6,14,4740,7,653,4899.5,249.0,93.28571428571428,7,4087,4646.666666666667,1514.0,583.8571428571429
246099.0,6,3,337,2,214,0.0,160.0,107.0,1,123,0.0,123.0,123.0
107255588.0,6,203,23116,102,7028,1061936.5148514851,140.0,68.90196078431373,101,16088,1062230.41,374.0,159.2871287128713
41273.0,6,14,4740,7,653,4544.833333333333,249.0,93.28571428571428,7,4087,6729.666666666667,1514.0,583.8571428571429
23977.0,6,20,7606,11,978,2397.7,310.0,88.9090909090909,9,6628,2797.375,1514.0,736.4444444444445
135130603.0,17,6,1206,6,1206,27026120.6,201.0,201.0,0,0,0.0,0.0,0.0
3174655.0,6,18,1536,9,962,358368.75,315.0,106.88888888888889,9,574,358349.375,78.0,63.77777777777778
29728.0,6,13,1386,7,789,4826.166666666667,253.0,112.71428571428572,6,597,5044.8,259.0,99.5
31659965.0,6,5,336,2,134,0.0,68.0,67.0,3,202,15762638.0,70.0,67.33333333333333
207053.0,6,3,426,2,280,0.0,214.0,140.0,1,146,0.0,146.0,146.0
120023702.0,17,29,13785,29,13785,4286560.785714285,501.0,475.3448275862069,0,0,0.0,0.0,0.0
102708.0,17,2,286,2,286,0.0,143.0,143.0,0,0,0.0,0.0,0.0
2803720.0,6,2,132,1,66,0.0,66.0,66.0,1,66,0.0,66.0,66.0
135104257.0,17,6,1206,6,1206,27020851.4,201.0,201.0,0,0,0.0,0.0,0.0
314546.0,6,6,412,4,272,104848.66666666669,74.0,68.0,2,140,0.0,74.0,70.0
13632052.0,6,20,1607,10,975,1480114.3333333333,315.0,97.5,10,632,1480088.888888889,78.0,63.2
123648006.0,6,48,3168,24,1584,5061867.0869565215,66.0,66.0,24,1584,5227600.956521739,66.0,66.0
103715.0,17,2,286,2,286,0.0,143.0,143.0,0,0,0.0,0.0,0.0
515561.00000000006,6,3,1604,1,753,0.0,753.0,753.0,2,851,0.0,785.0,425.5
108104942.0,17,5,955,5,955,27026235.5,191.0,191.0,0,0,0.0,0.0,0.0
232098.0,6,3,337,2,214,0.0,160.0,107.0,1,123,0.0,123.0,123.0
145764.0,6,3,337,2,214,0.0,160.0,107.0,1,123,0.0,123.0,123.0
55805497.0,6,8,1940,4,953,18600022.666666668,753.0,238.25,4,987,16656778.666666666,785.0,246.75
195075.0,17,4,1524,4,1524,65025.0,381.0,381.0,0,0,0.0,0.0,0.0
108109777.0,17,5,955,5,955,27027444.25,191.0,191.0,0,0,0.0,0.0,0.0
1165023.0,6,13,3018,8,2390,166431.85714285713,1514.0,298.75,5,628,222329.5,331.0,125.6
121505.0,6,3,337,2,214,0.0,160.0,107.0,1,123,0.0,123.0,123.0
100585.0,17,2,762,2,762,0.0,381.0,381.0,0,0,0.0,0.0,0.0
1311164.0,6,4,264,2,132,0.0,66.0,66.0,2,132,0.0,66.0,66.0
299013.0,6,6,412,4,272,99671.0,74.0,68.0,2,140,0.0,74.0,70.0
193373.0,6,10,1066,5,490,47463.75,218.0,98.0,5,576,48138.75,304.0,115.2
100226783.0,17,12,778,6,389,20045356.6,174.0,64.83333333333333,6,389,19997854.2,174.0,64.83333333333333
42982.0,6,14,4740,7,653,7042.666666666667,249.0,93.28571428571428,7,4087,5698.0,1514.0,583.8571428571429
50085.0,6,14,4740,7,653,8221.666666666666,249.0,93.28571428571428,7,4087,8053.833333333333,1514.0,583.8571428571429
207929.0,17,2,762,2,762,0.0,381.0,381.0,0,0,0.0,0.0,0.0
121245.0,6,3,337,2,214,0.0,160.0,107.0,1,123,0.0,123.0,123.0
307527.0,6,6,412,4,272,102509.0,74.0,68.0,2,140,0.0,74.0,70.0
108109785.0,17,5,1005,5,1005,27027446.25,201.0,201.0,0,0,0.0,0.0,0.0
235119.0,6,3,373,2,238,0.0,172.0,119.0,1,135,0.0,135.0,135.0
325349.0,6,6,412,4,272,108449.66666666669,74.0,68.0,2,140,0.0,74.0,70.0
209466.0,17,2,180,1,90,0.0,90.0,90.0,1,90,0.0,90.0,90.0
39248.0,6,10,2032,5,524,9598.25,252.0,104.8,5,1508,9536.0,1236.0,301.6
144891.0,17,2,180,1,70,0.0,70.0,70.0,1,110,0.0,110.0,110.0
314943.0,17,4,1400,4,1400,104981.0,350.0,350.0,0,0,0.0,0.0,0.0
43640.0,6,14,4740,7,653,7111.0,249.0,93.28571428571428,7,4087,7083.333333333333,1514.0,583.8571428571429
120084943.0,17,28,13364,28,13364,4447590.481481481,501.0,477.2857142857143,0,0,0.0,0.0,0.0
49474.0,6,14,4740,7,653,7653.5,249.0,93.28571428571428,7,4087,7609.5,1514.0,583.8571428571429
26307203.0,17,5,1718,4,1368,789565.3333333334,342.0,342.0,1,350,0.0,350.0,350.0
216888.0,6,3,426,2,280,0.0,214.0,140.0,1,146,0.0,146.0,146.0
49678793.0,6,8,2113,3,960,23517493.5,826.0,320.0,5,1153,11724973.0,885.0,230.6
301486.0,6,6,412,4,272,100495.33333333331,74.0,68.0,2,140,0.0,74.0,70.0
218419.0,6,3,426,2,280,0.0,214.0,140.0,1,146,0.0,146.0,146.0
209579.0,17,2,180,1,90,0.0,90.0,90.0,1,90,0.0,90.0,90.0
135132437.0,17,6,1146,6,1146,27026487.4,191.0,191.0,0,0,0.0,0.0,0.0
303628.0,6,6,412,4,272,101209.33333333331,74.0,68.0,2,140,0.0,74.0,70.0
505478.0,6,4,270,2,134,0.0,68.0,67.0,2,136,0.0,70.0,68.0
108097053.0,17,5,1005,5,1005,27024263.25,201.0,201.0,0,0,0.0,0.0,0.0
516322.0,6,5,336,2,134,0.0,68.0,67.0,3,202,199243.5,70.0,67.33333333333333
13355.0,17,4,344,2,150,0.0,75.0,75.0,2,194,0.0,103.0,97.0
41473.0,6,14,4740,7,653,6011.0,249.0,93.28571428571428,7,4087,6140.833333333333,1514.0,583.8571428571429
93326431.0,17,12,778,6,389,18601945.4,174.0,64.83333333333333,6,389,18600190.8,174.0,64.83333333333333
3162.0,17,2,180,1,90,0.0,90.0,90.0,1,90,0.0,90.0,90.0
232565.0,6,3,337,2,214,0.0,160.0,107.0,1,123,0.0,123.0,123.0
120111381.0,6,228,25862,114,7820,1055614.3008849558,140.0,68.59649122807018,114,18042,1056076.9646017698,284.0,158.26315789473685
302835.0,6,6,412,4,272,100945.0,74.0,68.0,2,140,0.0,74.0,70.0
4582.0,17,4,813,2,144,0.0,72.0,72.0,2,669,0.0,542.0,334.5
14663275.0,6,20,1771,10,1139,1595589.3333333333,324.0,113.9,10,632,1595568.0,78.0,63.2
243002.0,6,3,337,2,214,0.0,160.0,107.0,1,123,0.0,123.0,123.0
90918227.0,6,21,1585,11,840,9091578.8,95.0,76.36363636363636,10,745,10100812.0,95.0,74.5
2592442.0,6,2,132,1,66,0.0,66.0,66.0,1,66,0.0,66.0,66.0
308799.0,6,6,412,4,272,102933.0,74.0,68.0,2,140,0.0,74.0,70.0
9014966.0,17,4,300,4,300,3004988.6666666665,75.0,75.0,0,0,0.0,0.0,0.0
34761788.0,6,5,336,2,134,0.0,68.0,67.0,3,202,17310486.5,70.0,67.33333333333333
971195.0,17,10,3744,10,3744,107910.55555555556,390.0,374.4,0,0,0.0,0.0,0.0
135130151.0,17,6,1146,6,1146,27026030.2,191.0,191.0,0,0,0.0,0.0,0.0
7096.0,17,2,582,1,83,0.0,83.0,83.0,1,499,0.0,499.0,499.0
209495.0,17,2,762,2,762,0.0,381.0,381.0,0,0,0.0,0.0,0.0
12105.0,17,2,582,1,83,0.0,83.0,83.0,1,499,0.0,499.0,499.0
120063385.0,17,29,13785,29,13785,4287978.035714285,501.0,475.3448275862069,0,0,0.0,0.0,0.0
33336.0,6,10,2032,5,524,7415.75,252.0,104.8,5,1508,7439.25,1236.0,301.6
228231.0,17,2,180,1,90,0.0,90.0,90.0,1,90,0.0,90.0,90.0
1245583.0,6,7,499,4,301,403877.3333333333,103.0,75.25,3,198,616275.0,66.0,66.0
120862396.0,6,33,2280,17,1209,7553899.75,123.0,71.11764705882354,16,1071,7377453.6,123.0,66.9375
384.0,17,2,174,1,79,0.0,79.0,79.0,1,95,0.0,95.0,95.0
90758338.0,6,19,1436,10,745,10079682.555555556,95.0,74.5,9,691,11344659.25,95.0,76.77777777777777
90032268.0,17,27,12943,27,12943,3462779.5384615385,501.0,479.3703703703704,0,0,0.0,0.0,0.0
228264.0,17,2,180,1,90,0.0,90.0,90.0,1,90,0.0,90.0,90.0
40861.0,6,14,4740,7,653,6174.666666666667,249.0,93.28571428571428,7,4087,6629.833333333333,1514.0,583.8571428571429
34086.0,6,10,2032,5,524,7698.25,252.0,104.8,5,1508,8269.75,1236.0,301.6
108130709.0,17,5,955,5,955,27032677.25,191.0,191.0,0,0,0.0,0.0,0.0
114171664.0,6,47,3102,24,1584,4954685.347826087,66.0,66.0,23,1518,5105433.909090909,66.0,66.0
39162.0,6,14,4740,7,653,6198.0,249.0,93.28571428571428,7,4087,6218.5,1514.0,583.8571428571429
220039.0,6,3,426,2,280,0.0,214.0,140.0,1,146,0.0,146.0,146.0
28420.0,6,13,1479,7,882,4736.666666666667,291.0,126.0,6,597,5148.8,259.0,99.5
135134290.0,17,6,1146,6,1146,27026858.0,191.0,191.0,0,0,0.0,0.0,0.0
311381.0,17,4,622,4,622,103793.66666666669,163.0,155.5,0,0,0.0,0.0,0.0
2711907.0,6,3,1777,2,951,0.0,885.0,475.5,1,826,0.0,826.0,826.0
36250.0,6,14,4740,7,653,5869.5,249.0,93.28571428571428,7,4087,5392.5,1514.0,583.8571428571429
135153966.0,17,6,1146,6,1146,27030793.2,191.0,191.0,0,0,0.0,0.0,0.0
216452.0,6,10,1221,6,636,43290.4,298.0,106.0,4,585,70024.33333333333,379.0,146.25
205721.0,17,2,762,2,762,0.0,381.0,381.0,0,0,0.0,0.0,0.0
113168273.0,6,46,3036,23,1518,5144000.954545454,66.0,66.0,23,1518,5144000.727272728,66.0,66.0
2314.0,17,4,344,2,150,0.0,75.0,75.0,2,194,0.0,103.0,97.0
166452.0,17,4,704,2,148,0.0,74.0,74.0,2,556,0.0,280.0,278.0
108097918.0,17,5,1005,5,1005,27024479.5,201.0,201.0,0,0,0.0,0.0,0.0
108105888.0,17,5,955,5,955,27026472.0,191.0,191.0,0,0,0.0,0.0,0.0
1806.0,17,2,684,1,342,0.0,342.0,342.0,1,342,0.0,342.0,342.0
162269.0,17,2,180,1,90,0.0,90.0,90.0,1,90,0.0,90.0,90.0
320505.0,17,4,1400,4,1400,106835.0,350.0,350.0,0,0,0.0,0.0,0.0
203164.0,17,2,180,1,90,0.0,90.0,90.0,1,90,0.0,90.0,90.0
10481970.0,6,7,478,4,272,3448702.6666666665,74.0,68.0,3,206,5172926.5,74.0,68.66666666666667
209848.0,6,3,426,2,280,0.0,214.0,140.0,1,146,0.0,146.0,146.0
1305628.0,6,4,264,2,132,0.0,66.0,66.0,2,132,0.0,66.0,66.0
2251.0,17,4,344,2,150,0.0,75.0,75.0,2,194,0.0,103.0,97.0
40901.0,6,14,4740,7,653,6373.0,249.0,93.28571428571428,7,4087,6557.333333333333,1514.0,583.8571428571429
116618782.0,6,220,24974,110,17492,1067911.8256880734,284.0,159.01818181818183,110,7482,1067910.990825688,140.0,68.01818181818182
0.0,6,1,66,1,66,0.0,66.0,66.0,0,0,0.0,0.0,0.0
299990.0,6,6,412,4,272,99996.66666666669,74.0,68.0,2,140,0.0,74.0,70.0
67229.0,6,14,4740,7,653,9833.833333333334,249.0,93.28571428571428,7,4087,11064.166666666666,1514.0,583.8571428571429
144664.0,17,2,180,1,90,0.0,90.0,90.0,1,90,0.0,90.0,90.0
300620.0,6,6,412,4,272,100206.66666666669,74.0,68.0,2,140,0.0,74.0,70.0
38620283.0,6,5,336,2,134,0.0,68.0,67.0,3,202,19242052.0,70.0,67.33333333333333
30613.0,6,14,4740,7,653,4832.666666666667,249.0,93.28571428571428,7,4087,4335.833333333333,1514.0,583.8571428571429
597898.0,6,4,508,2,238,0.0,172.0,119.0,2,270,0.0,135.0,135.0
107325.0,17,2,286,2,286,0.0,143.0,143.0,0,0,0.0,0.0,0.0
331.0,17,2,267,1,83,0.0,83.0,83.0,1,184,0.0,184.0,184.0
209539.0,17,2,180,1,90,0.0,90.0,90.0,1,90,0.0,90.0,90.0
21831.0,6,12,1413,7,882,3638.5,291.0,126.0,5,531,4720.25,259.0,106.2
2311.0,17,4,344,2,150,0.0,75.0,75.0,2,194,0.0,103.0,97.0
883.0,17,4,438,2,148,0.0,74.0,74.0,2,290,0.0,147.0,145.0
146594.0,6,3,337,2,214,0.0,160.0,107.0,1,123,0.0,123.0,123.0
228193.0,17,2,180,1,90,0.0,90.0,90.0,1,90,0.0,90.0,90.0
0.0,6,1,66,0,0,0.0,0.0,0.0,1,66,0.0,66.0,66.0
317183.0,17,4,1400,4,1400,105727.66666666669,350.0,350.0,0,0,0.0,0.0,0.0
90253990.0,6,16,2368,9,1204,11281748.75,188.0,133.77777777777777,7,1164,15014984.666666666,204.0,166.28571428571428
204664.0,17,2,762,2,762,0.0,381.0,381.0,0,0,0.0,0.0,0.0
8727.0,17,4,704,2,148,0.0,74.0,74.0,2,556,0.0,280.0,278.0
109701.0,6,2,132,1,66,0.0,66.0,66.0,1,66,0.0,66.0,66.0
315.0,17,2,174,1,79,0.0,79.0,79.0,1,95,0.0,95.0,95.0
25456.0,6,20,7606,11,978,2545.6,310.0,88.9090909090909,9,6628,2887.125,1514.0,736.4444444444445
47555.0,6,14,4740,7,653,7319.0,249.0,93.28571428571428,7,4087,7355.666666666667,1514.0,583.8571428571429
11844.0,6,10,1067,5,536,2710.75,264.0,107.2,5,531,2040.0,259.0,106.2
873196.0,6,10,1334,6,797,174639.2,459.0,132.83333333333334,4,537,199175.3333333333,331.0,134.25
120152752.0,6,252,28758,126,8538,954699.992,140.0,67.76190476190476,126,20220,954653.4,284.0,160.47619047619048
205175.0,17,3,1143,3,1143,102587.5,381.0,381.0,0,0,0.0,0.0,0.0
103374.0,17,2,286,2,286,0.0,143.0,143.0,0,0,0.0,0.0,0.0
4805614.0,6,5,336,2,134,0.0,68.0,67.0,3,202,1518359.0,70.0,67.33333333333333
135117664.0,17,6,1206,6,1206,27023532.8,201.0,201.0,0,0,0.0,0.0,0.0
90259348.0,6,12,1832,8,1016,12894192.57142857,188.0,127.0,4,816,30029973.33333333,204.0,204.0
527708.0,6,3,204,1,68,0.0,68.0,68.0,2,136,0.0,70.0,68.0
316595.0,17,4,1400,4,1400,105531.66666666669,350.0,350.0,0,0,0.0,0.0,0.0
9719.0,6,10,2032,5,524,2122.5,252.0,104.8,5,1508,1842.75,1236.0,301.6
300.0,17,2,168,1,76,0.0,76.0,76.0,1,92,0.0,92.0,92.0
144807.0,17,2,180,1,70,0.0,70.0,70.0,1,110,0.0,110.0,110.0
45094.0,6,14,4740,7,653,6908.833333333333,249.0,93.28571428571428,7,4087,7375.666666666667,1514.0,583.8571428571429
47724.0,6,12,1320,6,723,9204.6,253.0,120.5,6,597,7357.8,259.0,99.5
352702.0,6,3,1604,1,753,0.0,753.0,753.0,2,851,0.0,785.0,425.5
105067403.0,17,15,5130,15,5130,7504814.5,342.0,342.0,0,0,0.0,0.0,0.0
313900.0,6,10,1221,6,636,62780.0,298.0,106.0,4,585,97735.66666666669,379.0,146.25
0.0,17,1,453,1,453,0.0,453.0,453.0,0,0,0.0,0.0,0.0
310506.0,17,4,622,4,622,103502.0,163.0,155.5,0,0,0.0,0.0,0.0
51010.0,17,2,180,1,90,0.0,90.0,90.0,1,90,0.0,90.0,90.0
300374.0,6,6,412,4,272,100124.66666666669,74.0,68.0,2,140,0.0,74.0,70.0
57812664.0,17,9,3086,8,2736,5104922.714285715,342.0,342.0,1,350,0.0,350.0,350.0
124209401.0,6,33,2296,17,1225,7763087.5625,139.0,72.05882352941177,16,1071,7600587.666666667,123.0,66.9375
156392.0,17,2,180,1,90,0.0,90.0,90.0,1,90,0.0,90.0,90.0
9842.0,17,2,582,1,83,0.0,83.0,83.0,1,499,0.0,499.0,499.0
253592.0,6,3,337,2,214,0.0,160.0,107.0,1,123,0.0,123.0,123.0
2433.0,17,2,762,2,762,0.0,381.0,381.0,0,0,0.0,0.0,0.0
197062.0,17,2,180,1,90,0.0,90.0,90.0,1,90,0.0,90.0,90.0
2364.0,17,4,344,2,150,0.0,75.0,75.0,2,194,0.0,103.0,97.0
123301185.0,6,48,3168,24,1584,5188634.391304348,66.0,66.0,24,1584,5107921.173913044,66.0,66.0
19678.0,6,11,1133,6,602,3673.0,264.0,100.33333333333331,5,531,4401.25,259.0,106.2
108100695.0,17,5,1005,5,1005,27025173.75,201.0,201.0,0,0,0.0,0.0,0.0
219422.0,6,3,426,2,280,0.0,214.0,140.0,1,146,0.0,146.0,146.0
313944.0,17,4,1400,4,1400,104648.0,350.0,350.0,0,0,0.0,0.0,0.0
1228041.0,17,7,490,7,490,204673.5,70.0,70.0,0,0,0.0,0.0,0.0
38947.0,6,14,4740,7,653,6231.5,249.0,93.28571428571428,7,4087,5591.666666666667,1514.0,583.8571428571429
2697.0,17,2,508,2,508,0.0,257.0,254.0,0,0,0.0,0.0,0.0
10486587.0,6,6,412,3,206,5172547.0,74.0,68.66666666666667,3,206,5172438.0,74.0,68.66666666666667
1944.0,17,2,192,1,88,0.0,88.0,88.0,1,104,0.0,104.0,104.0
302038.0,6,6,412,4,272,100679.33333333331,74.0,68.0,2,140,0.0,74.0,70.0
2473.0,17,4,344,2,150,0.0,75.0,75.0,2,194,0.0,103.0,97.0
242516.0,6,3,337,2,214,0.0,160.0,107.0,1,123,0.0,123.0,123.0
90306816.0,6,16,1192,8,596,12892389.57142857,95.0,74.5,8,596,12900576.714285716,95.0,74.5
3395.0,17,2,414,1,88,0.0,88.0,88.0,1,326,0.0,326.0,326.0
101848.0,17,2,762,2,762,0.0,381.0,381.0,0,0,0.0,0.0,0.0
105654.0,17,2,700,2,700,0.0,350.0,350.0,0,0,0.0,0.0,0.0
228332.0,17,2,180,1,90,0.0,90.0,90.0,1,90,0.0,90.0,90.0
90043432.0,17,28,13364,28,13364,3334941.925925926,501.0,477.2857142857143,0,0,0.0,0.0,0.0
90771117.0,6,19,1436,10,745,10080923.444444444,95.0,74.5,9,691,11344666.0,95.0,76.77777777777777
308344.0,6,6,412,4,272,102781.33333333331,74.0,68.0,2,140,0.0,74.0,70.0
90053120.0,17,27,12943,27,12943,3463581.5384615385,501.0,479.3703703703704,0,0,0.0,0.0,0.0
2797733.0,6,2,132,1,66,0.0,66.0,66.0,1,66,0.0,66.0,66.0
616185.0,6,4,508,2,238,0.0,172.0,119.0,2,270,0.0,135.0,135.0
4400.0,17,2,614,1,72,0.0,72.0,72.0,1,542,0.0,542.0,542.0
114113463.0,6,35,2542,18,1348,6712556.647058823,139.0,74.88888888888889,17,1194,7118576.25,123.0,70.23529411764706
107440.0,17,2,286,2,286,0.0,143.0,143.0,0,0,0.0,0.0,0.0
1184104.0,6,13,3019,8,2391,169157.7142857143,1514.0,298.875,5,628,227129.0,331.0,125.6
309273.0,6,6,412,4,272,103091.0,74.0,68.0,2,140,0.0,74.0,70.0
356.0,17,2,267,1,83,0.0,83.0,83.0,1,184,0.0,184.0,184.0
308992.0,6,12,1373,7,714,51498.66666666666,298.0,102.0,5,659,67619.75,379.0,131.8
10653690.0,6,7,478,4,272,3490740.6666666665,74.0,68.0,3,206,5236059.0,74.0,68.66666666666667
108105994.0,17,5,1005,5,1005,27026498.5,201.0,201.0,0,0,0.0,0.0,0.0
185109.0,17,2,180,1,90,0.0,90.0,90.0,1,90,0.0,90.0,90.0
206324.0,6,3,426,2,280,0.0,214.0,140.0,1,146,0.0,146.0,146.0
2875507.0,6,4,270,2,134,0.0,68.0,67.0,2,136,0.0,70.0,68.0
113254717.0,6,46,3036,23,1518,5135437.045454546,66.0,66.0,23,1518,5135436.545454546,66.0,66.0
307477.0,6,6,412,4,272,102492.33333333331,74.0,68.0,2,140,0.0,74.0,70.0
36625.0,6,10,2032,5,524,7900.0,252.0,104.8,5,1508,8590.5,1236.0,301.6
108105234.0,17,5,1005,5,1005,27026308.5,201.0,201.0,0,0,0.0,0.0,0.0
87001.0,6,14,4740,7,653,14075.333333333334,249.0,93.28571428571428,7,4087,13589.166666666666,1514.0,583.8571428571429
127776.0,6,12,1413,6,816,25075.0,291.0,136.0,6,597,22036.0,259.0,99.5
108109221.0,17,5,955,5,955,27027305.25,191.0,191.0,0,0,0.0,0.0,0.0
30024.0,6,14,4740,7,653,4486.333333333333,249.0,93.28571428571428,7,4087,4864.666666666667,1514.0,583.8571428571429
159088.0,17,4,1400,4,1400,53029.333333333336,350.0,350.0,0,0,0.0,0.0,0.0
120153222.0,6,298,34314,149,10056,808621.2432432432,140.0,67.48993288590604,149,24258,806293.2432432432,284.0,162.80536912751677
248704.0,6,3,337,2,214,0.0,160.0,107.0,1,123,0.0,123.0,123.0
27663.0,6,14,4740,7,653,4499.0,249.0,93.28571428571428,7,4087,4284.5,1514.0,583.8571428571429
3014530.0,17,4,1382,2,698,0.0,349.0,349.0,2,684,0.0,342.0,342.0
2028.0,17,4,344,2,150,0.0,75.0,75.0,2,194,0.0,103.0,97.0
230103.0,17,2,180,1,90,0.0,90.0,90.0,1,90,0.0,90.0,90.0
206974.0,6,3,426,2,280,0.0,214.0,140.0,1,146,0.0,146.0,146.0
232669.0,6,3,337,2,214,0.0,160.0,107.0,1,123,0.0,123.0,123.0
120120063.0,6,14,2240,8,1016,17136689.57142857,188.0,127.0,6,1224,18018182.0,204.0,204.0
105207.0,17,2,700,2,700,0.0,350.0,350.0,0,0,0.0,0.0,0.0
14632659.0,6,20,1607,10,975,1592241.888888889,315.0,97.5,10,632,1592212.4444444445,78.0,63.2
90825393.0,6,19,1436,10,745,10087166.444444444,95.0,74.5,9,691,11351928.875,95.0,76.77777777777777
207228.0,6,3,426,2,280,0.0,214.0,140.0,1,146,0.0,146.0,146.0
90035700.0,17,27,12943,27,12943,3462911.5384615385,501.0,479.3703703703704,0,0,0.0,0.0,0.0
23889.0,6,14,4740,7,653,3853.6666666666665,249.0,93.28571428571428,7,4087,3766.8333333333335,1514.0,583.8571428571429
12502.0,6,10,1066,5,490,2884.0,218.0,98.0,5,576,2834.0,304.0,115.2
115492192.0,6,34,2419,17,1194,7218262.0,123.0,70.23529411764706,17,1225,7203940.875,139.0,72.05882352941177
210664.0,17,2,762,2,762,0.0,381.0,381.0,0,0,0.0,0.0,0.0
2275.0,17,4,344,2,150,0.0,75.0,75.0,2,194,0.0,103.0,97.0
198177.0,17,2,180,1,90,0.0,90.0,90.0,1,90,0.0,90.0,90.0
228247.0,17,2,180,1,90,0.0,90.0,90.0,1,90,0.0,90.0,90.0
108100384.0,17,5,955,5,955,27025096.0,191.0,191.0,0,0,0.0,0.0,0.0
307424.0,6,6,412,4,272,102474.66666666669,74.0,68.0,2,140,0.0,74.0,70.0
300049.0,6,6,412,4,272,100016.33333333331,74.0,68.0,2,140,0.0,74.0,70.0
4380.0,17,2,602,1,72,0.0,72.0,72.0,1,530,0.0,530.0,530.0
144000.0,17,2,180,1,90,0.0,90.0,90.0,1,90,0.0,90.0,90.0
505325.0,6,5,336,2,134,0.0,68.0,67.0,3,202,195164.0,70.0,67.33333333333333
16320.999999999998,6,14,4740,7,653,2582.0,249.0,93.28571428571428,7,4087,2579.6666666666665,1514.0,583.8571428571429
10466699.0,6,6,412,3,206,5165519.0,74.0,68.66666666666667,3,206,5165412.0,74.0,68.66666666666667
26244.0,6,14,4740,7,653,4043.3333333333335,249.0,93.28571428571428,7,4087,4236.166666666667,1514.0,583.8571428571429
90220978.0,6,17,1287,8,596,12852133.714285716,95.0,74.5,9,691,11250609.375,95.0,76.77777777777777
2033.0,17,4,344,2,150,0.0,75.0,75.0,2,194,0.0,103.0,97.0
2048283.0,6,27,7945,14,3957,157560.23076923078,1514.0,282.6428571428572,13,3988,137829.5,1514.0,306.7692307692308
172184.0,17,2,180,1,90,0.0,90.0,90.0,1,90,0.0,90.0,90.0
303242.0,6,2,132,1,66,0.0,66.0,66.0,1,66,0.0,66.0,66.0
10526601.0,6,7,478,4,272,3463518.6666666665,74.0,68.0,3,206,5195181.5,74.0,68.66666666666667
63706.0,6,10,2032,5,524,14714.75,252.0,104.8,5,1508,15209.0,1236.0,301.6
21270.0,6,10,1065,5,534,4848.0,262.0,106.8,5,531,3734.5,259.0,106.2
210674.0,6,3,426,2,280,0.0,214.0,140.0,1,146,0.0,146.0,146.0
322494.0,6,6,412,4,272,107498.0,74.0,68.0,2,140,0.0,74.0,70.0
58261.0,6,10,1065,5,534,14035.0,262.0,106.8,5,531,2470.25,259.0,106.2
108110660.0,17,5,1005,5,1005,27027665.0,201.0,201.0,0,0,0.0,0.0,0.0
228310.0,17,2,180,1,90,0.0,90.0,90.0,1,90,0.0,90.0,90.0
120033672.0,17,28,13364,28,13364,4445691.555555556,501.0,477.2857142857143,0,0,0.0,0.0,0.0
2433745.0,6,3,1604,2,851,0.0,785.0,425.5,1,753,0.0,753.0,753.0
36391.0,6,13,1479,7,882,6065.166666666667,291.0,126.0,6,597,6055.0,259.0,99.5
108107363.0,17,5,1005,5,1005,27026840.75,201.0,201.0,0,0,0.0,0.0,0.0
90563231.0,6,26,1746,13,906,7528963.083333333,123.0,69.6923076923077,13,840,7528961.916666667,123.0,64.61538461538461
35780.0,6,14,4740,7,653,4919.166666666667,249.0,93.28571428571428,7,4087,5644.166666666667,1514.0,583.8571428571429
302284.0,6,6,412,4,272,100761.33333333331,74.0,68.0,2,140,0.0,74.0,70.0
325.0,17,2,174,1,79,0.0,79.0,79.0,1,95,0.0,95.0,95.0
117265536.0,6,48,3168,24,1584,5098501.565217392,66.0,66.0,24,1584,5085044.695652174,66.0,66.0
196818.0,17,2,180,1,90,0.0,90.0,90.0,1,90,0.0,90.0,90.0
23219.0,6,14,4740,7,653,3111.0,249.0,93.28571428571428,7,4087,3726.8333333333335,1514.0,583.8571428571429
91001089.0,17,11,735,6,389,18200217.8,174.0,64.83333333333333,5,346,17751273.25,174.0,69.2
2388.0,17,4,344,2,150,0.0,75.0,75.0,2,194,0.0,103.0,97.0
4297.0,17,2,180,1,90,0.0,90.0,90.0,1,90,0.0,90.0,90.0
102682334.0,17,14,864,7,432,17000867.166666668,174.0,61.71428571428572,7,432,17000156.666666668,174.0,61.71428571428572
4587.0,17,4,344,2,150,0.0,75.0,75.0,2,194,0.0,103.0,97.0
102224.0,17,2,286,2,286,0.0,143.0,143.0,0,0,0.0,0.0,0.0
143974.0,17,2,180,1,90,0.0,90.0,90.0,1,90,0.0,90.0,90.0
35275.0,6,14,4740,7,653,5755.833333333333,249.0,93.28571428571428,7,4087,5650.166666666667,1514.0,583.8571428571429
3090961.0,6,4,270,2,134,0.0,68.0,67.0,2,136,0.0,70.0,68.0
143937.0,17,2,180,1,90,0.0,90.0,90.0,1,90,0.0,90.0,90.0
28135.0,6,10,2032,5,524,6813.25,252.0,104.8,5,1508,6501.25,1236.0,301.6
128882631.0,6,36,2602,19,1408,7160146.166666667,139.0,74.10526315789474,17,1194,7417634.9375,123.0,70.23529411764706
42103.0,6,14,4740,7,653,6895.333333333333,249.0,93.28571428571428,7,4087,6876.333333333333,1514.0,583.8571428571429
42032.0,6,14,4740,7,653,6848.833333333333,249.0,93.28571428571428,7,4087,6662.666666666667,1514.0,583.8571428571429
104805944.0,17,15,5130,15,5130,7486138.857142857,342.0,342.0,0,0,0.0,0.0,0.0
117018634.0,17,13,952,7,563,19503105.666666668,174.0,80.42857142857143,6,389,19281507.2,174.0,64.83333333333333
154743.0,17,2,180,1,90,0.0,90.0,90.0,1,90,0.0,90.0,90.0
253591.0,6,10,1221,6,636,50718.2,298.0,106.0,4,585,78665.33333333333,379.0,146.25
1314664.0,6,4,264,2,132,0.0,66.0,66.0,2,132,0.0,66.0,66.0
3044159.0,6,4,270,3,202,1522079.5,70.0,67.33333333333333,1,68,0.0,68.0,68.0
277428.0,17,2,586,1,81,0.0,81.0,81.0,1,505,0.0,505.0,505.0
105721.0,17,2,762,2,762,0.0,381.0,381.0,0,0,0.0,0.0,0.0
252431.00000000003,6,10,1221,6,636,50486.2,298.0,106.0,4,585,81663.33333333333,379.0,146.25
90027031.0,17,28,13364,28,13364,3334334.4814814813,501.0,477.2857142857143,0,0,0.0,0.0,0.0
43191.0,6,14,4740,7,653,7080.166666666667,249.0,93.28571428571428,7,4087,7004.166666666667,1514.0,583.8571428571429
308014.0,6,6,412,4,272,102671.33333333331,74.0,68.0,2,140,0.0,74.0,70.0
105388.0,17,2,762,2,762,0.0,381.0,381.0,0,0,0.0,0.0,0.0
98419421.0,6,18,1502,9,852,12302427.625,256.0,94.66666666666669,9,650,12266643.375,95.0,72.22222222222223
308373.0,6,6,412,4,272,102791.0,74.0,68.0,2,140,0.0,74.0,70.0
336.0,17,2,267,1,83,0.0,83.0,83.0,1,184,0.0,184.0,184.0
90026666.0,17,28,13364,28,13364,3334320.962962963,501.0,477.2857142857143,0,0,0.0,0.0,0.0
51749.0,6,14,4740,7,653,8240.0,249.0,93.28571428571428,7,4087,8069.166666666667,1514.0,583.8571428571429
0.0,17,1,55,1,55,0.0,55.0,55.0,0,0,0.0,0.0,0.0
33181.0,6,14,4740,7,653,4534.333333333333,249.0,93.28571428571428,7,4087,5261.333333333333,1514.0,583.8571428571429
249132.0,17,4,6056,4,6056,83044.0,1514.0,1514.0,0,0,0.0,0.0,0.0
216041.0,6,12,1373,7,714,36006.833333333336,298.0,102.0,5,659,53333.5,379.0,131.8
403.0,17,2,410,1,78,0.0,78.0,78.0,1,332,0.0,332.0,332.0
108103585.0,17,5,1005,5,1005,27025896.25,201.0,201.0,0,0,0.0,0.0,0.0
515392.0,6,4,270,2,134,0.0,68.0,67.0,2,136,0.0,70.0,68.0
103321.0,17,2,286,2,286,0.0,143.0,143.0,0,0,0.0,0.0,0.0
52215.0,6,14,4740,7,653,6608.666666666667,249.0,93.28571428571428,7,4087,8562.5,1514.0,583.8571428571429
121474.0,6,3,337,2,214,0.0,160.0,107.0,1,123,0.0,123.0,123.0
117091339.0,6,21,1585,12,935,10640405.090909092,95.0,77.91666666666667,9,650,14635684.125,95.0,72.22222222222223
120001.0,17,2,180,1,70,0.0,70.0,70.0,1,110,0.0,110.0,110.0
216692.0,17,2,180,1,90,0.0,90.0,90.0,1,90,0.0,90.0,90.0
35263.0,6,14,4740,7,653,4781.5,249.0,93.28571428571428,7,4087,5162.833333333333,1514.0,583.8571428571429
288.0,17,2,164,1,82,0.0,82.0,82.0,1,82,0.0,82.0,82.0
90302033.0,6,16,1192,8,596,12894290.0,95.0,74.5,8,596,12899428.57142857,95.0,74.5
90241043.0,6,13,2036,8,1016,12891577.57142857,188.0,127.0,5,1020,22518895.25,204.0,204.0
106619907.0,17,16,1474,8,737,15208540.857142856,174.0,92.125,8,737,15081528.714285716,174.0,92.125
135124673.0,17,6,1146,6,1146,27024934.6,191.0,191.0,0,0,0.0,0.0,0.0
120979801.0,6,35,2542,18,1348,7116458.882352941,139.0,74.88888888888889,17,1194,6923669.625,123.0,70.23529411764706
43191.0,6,14,4740,7,653,7074.833333333333,249.0,93.28571428571428,7,4087,6575.333333333333,1514.0,583.8571428571429
31718.000000000004,6,10,2032,5,524,7692.25,252.0,104.8,5,1508,7349.0,1236.0,301.6
204526.0,17,2,180,1,90,0.0,90.0,90.0,1,90,0.0,90.0,90.0
108099804.0,17,5,955,5,955,27024951.0,191.0,191.0,0,0,0.0,0.0,0.0
106105.0,17,2,286,2,286,0.0,143.0,143.0,0,0,0.0,0.0,0.0
10478518.0,6,7,478,4,272,3445600.6666666665,74.0,68.0,3,206,5168275.5,74.0,68.66666666666667
10534883.0,6,7,478,4,272,3465838.0,74.0,68.0,3,206,5198648.5,74.0,68.66666666666667
1020339.0,6,11,1134,6,558,204067.8,220.0,93.0,5,576,253722.25,304.0,115.2
980519.0,6,13,1420,7,789,162498.83333333334,253.0,112.71428571428572,6,631,195511.8,293.0,105.16666666666669
209422.0,17,2,180,1,90,0.0,90.0,90.0,1,90,0.0,90.0,90.0
100051490.0,17,12,778,6,389,19963404.0,174.0,64.83333333333333,6,389,19978512.4,174.0,64.83333333333333
108113384.0,17,5,955,5,955,27028346.0,191.0,191.0,0,0,0.0,0.0,0.0
108105014.0,17,5,1005,5,1005,27026253.5,201.0,201.0,0,0,0.0,0.0,0.0
109494973.0,17,14,864,7,432,18167934.166666668,174.0,61.71428571428572,7,432,18166827.5,174.0,61.71428571428572
4805864.0,6,5,336,2,134,0.0,68.0,67.0,3,202,1526330.5,70.0,67.33333333333333
264150.0,6,10,1221,6,636,52830.0,298.0,106.0,4,585,82302.66666666667,379.0,146.25
108984288.0,6,32,2236,16,1165,7251228.0,139.0,72.8125,16,1071,7251238.8,123.0,66.9375
405.0,17,2,174,1,79,0.0,79.0,79.0,1,95,0.0,95.0,95.0
209351.0,17,2,180,1,90,0.0,90.0,90.0,1,90,0.0,90.0,90.0
120476023.0,6,243,27542,122,19248,995669.611570248,300.0,157.7704918032787,121,8294,995357.125,140.0,68.54545454545455
319694.0,17,4,1400,4,1400,106564.66666666669,350.0,350.0,0,0,0.0,0.0,0.0
219897.0,6,3,426,2,280,0.0,214.0,140.0,1,146,0.0,146.0,146.0
218503.0,6,3,426,2,280,0.0,214.0,140.0,1,146,0.0,146.0,146.0
119983126.0,17,34,16284,34,16284,3635852.303030303,501.0,478.9411764705882,0,0,0.0,0.0,0.0
214123.0,17,2,180,1,90,0.0,90.0,90.0,1,90,0.0,90.0,90.0
44833.0,6,14,4740,7,653,6783.666666666667,249.0,93.28571428571428,7,4087,7284.666666666667,1514.0,583.8571428571429
120051383.0,17,28,13364,28,13364,4446347.518518519,501.0,477.2857142857143,0,0,0.0,0.0,0.0
138735.0,6,2,132,1,66,0.0,66.0,66.0,1,66,0.0,66.0,66.0
135135920.0,17,6,1206,6,1206,27027184.0,201.0,201.0,0,0,0.0,0.0,0.0
135129592.0,17,6,1146,6,1146,27025918.4,191.0,191.0,0,0,0.0,0.0,0.0
830865.0,6,9,1118,6,586,166173.0,248.0,97.66666666666669,3,532,279112.5,392.0,177.33333333333334
44562.0,6,14,4740,7,653,7109.833333333333,249.0,93.28571428571428,7,4087,7148.666666666667,1514.0,583.8571428571429
58795152.0,17,9,3086,8,2736,5107672.142857143,342.0,342.0,1,350,0.0,350.0,350.0
216827.0,6,3,426,2,280,0.0,214.0,140.0,1,146,0.0,146.0,146.0
9697961.0,17,3,1034,2,684,0.0,342.0,342.0,1,350,0.0,350.0,350.0
332.0,17,2,250,1,93,0.0,93.0,93.0,1,157,0.0,157.0,157.0
100031.0,17,2,762,2,762,0.0,381.0,381.0,0,0,0.0,0.0,0.0
38172.0,6,12,1320,6,723,6842.6,253.0,120.5,6,597,5974.0,259.0,99.5
120041555.0,17,29,13785,29,13785,4287198.392857143,501.0,475.3448275862069,0,0,0.0,0.0,0.0
90766313.0,6,18,1382,10,786,10080002.111111112,95.0,78.6,8,596,12898279.42857143,95.0,74.5
90776079.0,6,19,1436,10,745,10079311.666666666,95.0,74.5,9,691,11346049.75,95.0,76.77777777777777
241854.0,6,3,337,2,214,0.0,160.0,107.0,1,123,0.0,123.0,123.0
90046724.0,17,28,13364,28,13364,3335063.851851852,501.0,477.2857142857143,0,0,0.0,0.0,0.0
56462.0,6,14,4740,7,653,9272.666666666666,249.0,93.28571428571428,7,4087,8968.833333333334,1514.0,583.8571428571429
322747.0,17,4,1400,4,1400,107582.33333333331,350.0,350.0,0,0,0.0,0.0,0.0
2847695.0,6,11,2106,6,598,569291.0,252.0,99.66666666666669,5,1508,2270.75,1236.0,301.6
120052558.0,17,29,13785,29,13785,4287591.357142857,501.0,475.3448275862069,0,0,0.0,0.0,0.0
107451.0,17,2,286,2,286,0.0,143.0,143.0,0,0,0.0,0.0,0.0
90266637.0,6,12,1832,8,1016,12895233.857142856,188.0,127.0,4,816,30034403.33333333,204.0,204.0
500789.00000000006,6,5,336,2,134,0.0,68.0,67.0,3,202,192026.5,70.0,67.33333333333333
32885003.0,6,5,336,2,134,0.0,68.0,67.0,3,202,15052728.5,70.0,67.33333333333333
297027.0,6,6,412,4,272,99009.0,74.0,68.0,2,140,0.0,74.0,70.0
148007.0,17,2,180,1,90,0.0,90.0,90.0,1,90,0.0,90.0,90.0
26514.0,6,14,4740,7,653,4290.0,249.0,93.28571428571428,7,4087,4279.666666666667,1514.0,583.8571428571429
220020.0,17,2,180,1,90,0.0,90.0,90.0,1,90,0.0,90.0,90.0
46791619.0,6,8,2113,3,960,22285594.0,826.0,320.0,5,1153,11259150.75,885.0,230.6
115535937.0,6,30,1974,15,1026,8237156.285714285,123.0,68.4,15,948,8237152.0,123.0,63.2
845185.0,6,9,1268,6,797,169037.0,459.0,132.83333333333334,3,471,286248.5,331.0,157.0
113167987.0,6,46,3036,23,1518,5143988.2727272725,66.0,66.0,23,1518,5143987.727272728,66.0,66.0
190323.0,17,2,618,1,74,0.0,74.0,74.0,1,544,0.0,544.0,544.0
250025.0,6,3,337,2,214,0.0,160.0,107.0,1,123,0.0,123.0,123.0
341.0,17,2,248,1,84,0.0,84.0,84.0,1,164,0.0,164.0,164.0
333120.0,6,10,1221,6,636,66624.0,298.0,106.0,4,585,109560.33333333331,379.0,146.25
107685.0,17,2,286,2,286,0.0,143.0,143.0,0,0,0.0,0.0,0.0
196987.0,17,2,180,1,90,0.0,90.0,90.0,1,90,0.0,90.0,90.0
0.0,17,1,90,1,90,0.0,90.0,90.0,0,0,0.0,0.0,0.0
90051486.0,17,28,13364,28,13364,3335240.222222222,501.0,477.2857142857143,0,0,0.0,0.0,0.0
90063795.0,17,28,13364,28,13364,3335696.111111111,501.0,477.2857142857143,0,0,0.0,0.0,0.0
209511.0,17,2,180,1,90,0.0,90.0,90.0,1,90,0.0,90.0,90.0
165820.0,17,2,180,1,90,0.0,90.0,90.0,1,90,0.0,90.0,90.0
59580.0,6,14,4740,7,653,7483.5,249.0,93.28571428571428,7,4087,9790.5,1514.0,583.8571428571429
715.0,17,2,762,2,762,0.0,381.0,381.0,0,0,0.0,0.0,0.0
227731.0,17,4,1400,4,1400,75910.33333333333,350.0,350.0,0,0,0.0,0.0,0.0
108471057.0,6,31,2166,16,1149,7217003.066666666,123.0,71.8125,15,1017,7732500.785714285,123.0,67.8
104260415.0,6,196,22220,98,15530,1072627.0,284.0,158.46938775510205,98,6690,1072630.907216495,140.0,68.26530612244898
116291965.0,6,48,3168,24,1584,5056172.391304348,66.0,66.0,24,1584,5042753.347826087,66.0,66.0
108105213.0,17,5,1005,5,1005,27026303.25,201.0,201.0,0,0,0.0,0.0,0.0
90020548.0,17,27,12943,27,12943,3462328.769230769,501.0,479.3703703703704,0,0,0.0,0.0,0.0
113618072.0,6,46,3036,23,1518,5150442.045454546,66.0,66.0,23,1518,5150434.227272728,66.0,66.0
12734.0,6,13,1459,7,862,1915.3333333333333,271.0,123.14285714285714,6,597,2395.0,259.0,99.5
962368.0,6,12,1362,6,731,190435.6,253.0,121.83333333333331,6,631,191886.4,293.0,105.16666666666669
111140.0,17,2,286,2,286,0.0,143.0,143.0,0,0,0.0,0.0,0.0
107917.0,6,14,4740,7,653,17776.666666666668,249.0,93.28571428571428,7,4087,17405.833333333332,1514.0,583.8571428571429
1162472.0,6,13,3010,8,2382,166067.42857142858,1514.0,297.75,5,628,221689.0,331.0,125.6
119594451.0,17,14,864,7,432,19920547.33333333,174.0,61.71428571428572,7,432,19905729.83333333,174.0,61.71428571428572
216325.0,17,2,180,1,90,0.0,90.0,90.0,1,90,0.0,90.0,90.0
319.0,17,2,174,1,79,0.0,79.0,79.0,1,95,0.0,95.0,95.0
47821.0,6,10,2032,5,524,11575.5,252.0,104.8,5,1508,11402.75,1236.0,301.6
21281.0,6,14,4740,7,653,3433.6666666666665,249.0,93.28571428571428,7,4087,3308.5,1514.0,583.8571428571429
2906.0,17,2,224,1,76,0.0,76.0,76.0,1,148,0.0,148.0,148.0
114403661.0,17,13,821,7,432,19040791.83333333,174.0,61.71428571428572,6,389,18953734.4,174.0,64.83333333333333
113344196.0,6,46,3036,23,1518,5151997.7727272725,66.0,66.0,23,1518,5151997.818181818,66.0,66.0
16185.999999999998,6,14,4740,7,653,2535.6666666666665,249.0,93.28571428571428,7,4087,2517.333333333333,1514.0,583.8571428571429
114932507.0,6,18,1601,10,947,12770278.555555556,256.0,94.7,8,654,16374015.857142856,153.0,81.75
218813.0,6,3,426,2,280,0.0,214.0,140.0,1,146,0.0,146.0,146.0
301415.0,6,6,412,4,272,100471.66666666669,74.0,68.0,2,140,0.0,74.0,70.0
144302.0,6,2,132,1,66,0.0,66.0,66.0,1,66,0.0,66.0,66.0
1878162.0,6,20,7599,11,1469,187816.2,583.0,133.54545454545453,9,6130,203345.875,1484.0,681.1111111111111
1640.0,17,2,762,2,762,0.0,381.0,381.0,0,0,0.0,0.0,0.0
107833611.0,6,28,1860,14,966,8294893.153846154,123.0,69.0,14,894,8278266.076923077,123.0,63.85714285714285
107064.0,17,2,286,2,286,0.0,143.0,143.0,0,0,0.0,0.0,0.0
143412.0,6,2,132,1,66,0.0,66.0,66.0,1,66,0.0,66.0,66.0
90013181.0,6,19,1436,10,786,10001464.555555556,95.0,78.6,9,650,11214868.125,95.0,72.22222222222223
109878801.0,17,15,1169,8,606,15696971.57142857,174.0,75.75,7,563,18159036.666666668,174.0,80.42857142857143
246047.0,6,3,373,2,238,0.0,172.0,119.0,1,135,0.0,135.0,135.0
1302520.0,6,4,264,2,132,0.0,66.0,66.0,2,132,0.0,66.0,66.0
120460875.0,6,227,25578,114,17824,1066025.442477876,284.0,156.35087719298247,113,7754,1067246.8660714286,140.0,68.61946902654867
328569.0,6,6,412,4,272,109523.0,74.0,68.0,2,140,0.0,74.0,70.0
110139728.0,6,205,23062,103,7020,1079801.2549019607,140.0,68.15533980582525,102,16042,1080250.900990099,284.0,157.27450980392155
90370092.0,6,14,2256,7,1428,15061466.166666666,204.0,204.0,7,828,15016683.166666666,188.0,118.28571428571428
233436.0,6,3,337,2,214,0.0,160.0,107.0,1,123,0.0,123.0,123.0
135141030.0,17,6,1206,6,1206,27028206.0,201.0,201.0,0,0,0.0,0.0,0.0
117531692.0,6,232,26088,116,18210,1020132.0782608696,284.0,156.98275862068965,116,7878,1020132.1565217392,140.0,67.91379310344827
48544.0,6,10,2032,5,524,10988.0,252.0,104.8,5,1508,9407.75,1236.0,301.6
63512.0,6,14,4740,7,653,8015.666666666667,249.0,93.28571428571428,7,4087,10351.333333333334,1514.0,583.8571428571429
336.0,17,2,208,1,72,0.0,72.0,72.0,1,136,0.0,136.0,136.0
308399.0,6,6,412,4,272,102799.66666666669,74.0,68.0,2,140,0.0,74.0,70.0
700631.0,6,11,1021,6,444,93299.2,162.0,74.0,5,577,117195.0,349.0,115.4
107754.0,17,2,286,2,286,0.0,143.0,143.0,0,0,0.0,0.0,0.0
90030249.0,17,28,13364,28,13364,3334453.6666666665,501.0,477.2857142857143,0,0,0.0,0.0,0.0
122072.0,6,3,337,2,214,0.0,160.0,107.0,1,123,0.0,123.0,123.0
90046971.0,17,28,13364,28,13364,3335073.0,501.0,477.2857142857143,0,0,0.0,0.0,0.0
108105764.0,17,5,955,5,955,27026441.0,191.0,191.0,0,0,0.0,0.0,0.0
113628946.0,6,46,3036,23,1518,5150893.954545454,66.0,66.0,23,1518,5150891.5,66.0,66.0
2043.0,17,4,344,2,150,0.0,75.0,75.0,2,194,0.0,103.0,97.0
381.0,17,2,250,1,93,0.0,93.0,93.0,1,157,0.0,157.0,157.0
2797718.0,6,2,132,1,66,0.0,66.0,66.0,1,66,0.0,66.0,66.0
2137.0,17,4,344,2,150,0.0,75.0,75.0,2,194,0.0,103.0,97.0
108098865.0,17,5,1005,5,1005,27024716.25,201.0,201.0,0,0,0.0,0.0,0.0
46669.0,6,10,2032,5,524,9607.0,252.0,104.8,5,1508,10951.0,1236.0,301.6
388.0,17,2,762,2,762,0.0,381.0,381.0,0,0,0.0,0.0,0.0
0.0,17,1,80,1,80,0.0,80.0,80.0,0,0,0.0,0.0,0.0
118578038.0,6,30,1974,15,1026,8454429.285714285,123.0,68.4,15,948,8454429.92857143,123.0,63.2
715894.0,6,2,132,1,66,0.0,66.0,66.0,1,66,0.0,66.0,66.0
4195.0,17,2,582,1,83,0.0,83.0,83.0,1,499,0.0,499.0,499.0
103416.0,17,2,286,2,286,0.0,143.0,143.0,0,0,0.0,0.0,0.0
875764.0,6,10,1334,6,797,175152.8,459.0,132.83333333333334,4,537,200059.0,331.0,134.25
196943.0,17,2,180,1,90,0.0,90.0,90.0,1,90,0.0,90.0,90.0
321.0,17,2,174,1,79,0.0,79.0,79.0,1,95,0.0,95.0,95.0
143817.0,6,11,2098,6,590,28697.6,252.0,98.33333333333331,5,1508,17852.0,1236.0,301.6
2312.0,17,4,344,2,150,0.0,75.0,75.0,2,194,0.0,103.0,97.0
14613.0,17,2,180,1,90,0.0,90.0,90.0,1,90,0.0,90.0,90.0
19726.0,17,2,582,1,83,0.0,83.0,83.0,1,499,0.0,499.0,499.0
135136977.0,17,6,1146,6,1146,27027395.4,191.0,191.0,0,0,0.0,0.0,0.0
203813.0,17,2,762,2,762,0.0,381.0,381.0,0,0,0.0,0.0,0.0
1660789.0,6,23,6509,12,1529,150980.81818181818,357.0,127.41666666666669,11,4980,136037.8,1510.0,452.7272727272728
232942.0,6,3,337,2,214,0.0,160.0,107.0,1,123,0.0,123.0,123.0
59610.0,6,13,1386,7,789,9935.0,253.0,112.71428571428572,6,597,10353.0,259.0,99.5
202581.0,17,2,762,2,762,0.0,381.0,381.0,0,0,0.0,0.0,0.0
9787.0,17,2,582,1,83,0.0,83.0,83.0,1,499,0.0,499.0,499.0
121491.0,6,3,337,2,214,0.0,160.0,107.0,1,123,0.0,123.0,123.0
41750.0,6,10,2032,5,524,10230.0,252.0,104.8,5,1508,9695.75,1236.0,301.6
241106.0,6,3,337,2,214,0.0,160.0,107.0,1,123,0.0,123.0,123.0
15802.0,6,14,4740,7,653,2518.5,249.0,93.28571428571428,7,4087,2494.6666666666665,1514.0,583.8571428571429
15155.0,17,2,180,1,90,0.0,90.0,90.0,1,90,0.0,90.0,90.0
41755.0,6,10,2032,5,524,7770.5,252.0,104.8,5,1508,9176.5,1236.0,301.6
148606.0,6,3,337,2,214,0.0,160.0,107.0,1,123,0.0,123.0,123.0
33593.0,6,10,1065,5,534,7629.0,262.0,106.8,5,531,7423.75,259.0,106.2
20235.0,6,12,1413,7,882,3372.5,291.0,126.0,5,531,4248.25,259.0,106.2
108107385.0,17,5,1005,5,1005,27026846.25,201.0,201.0,0,0,0.0,0.0,0.0
41960357.0,6,4,270,3,202,20980178.5,70.0,67.33333333333333,1,68,0.0,68.0,68.0
5608831.0,6,5,336,2,134,0.0,68.0,67.0,3,202,1524942.5,70.0,67.33333333333333
3294486.0,6,13,5783,8,1092,470640.8571428572,408.0,136.5,5,4691,320203.5,1514.0,938.2
14921.0,17,2,180,1,90,0.0,90.0,90.0,1,90,0.0,90.0,90.0
218096.0,6,3,426,2,280,0.0,214.0,140.0,1,146,0.0,146.0,146.0
301949.0,6,6,412,4,272,100649.66666666669,74.0,68.0,2,140,0.0,74.0,70.0
2798971.0,6,2,132,1,66,0.0,66.0,66.0,1,66,0.0,66.0,66.0
107931.0,17,2,286,2,286,0.0,143.0,143.0,0,0,0.0,0.0,0.0
196762.0,17,2,180,1,90,0.0,90.0,90.0,1,90,0.0,90.0,90.0
27285.0,6,10,2032,5,524,6594.0,252.0,104.8,5,1508,6046.0,1236.0,301.6
205717.0,17,2,180,1,90,0.0,90.0,90.0,1,90,0.0,90.0,90.0
2686032.0,6,3,1604,1,753,0.0,753.0,753.0,2,851,0.0,785.0,425.5
92375158.0,6,40,2640,20,1320,4861850.421052632,66.0,66.0,20,1320,4850475.421052632,66.0,66.0
100485.0,17,2,762,2,762,0.0,381.0,381.0,0,0,0.0,0.0,0.0
3154.0,17,2,224,1,76,0.0,76.0,76.0,1,148,0.0,148.0,148.0
90038531.0,17,28,13364,28,13364,3334760.407407407,501.0,477.2857142857143,0,0,0.0,0.0,0.0
102771.0,17,2,762,2,762,0.0,381.0,381.0,0,0,0.0,0.0,0.0
149715850.0,6,16,2494,10,1270,16635094.444444444,188.0,127.0,6,1224,18016546.0,204.0,204.0
90366878.0,6,14,2256,7,1428,15060968.333333334,204.0,204.0,7,828,15060967.5,188.0,118.28571428571428
57174.0,6,10,2032,5,524,13661.75,252.0,104.8,5,1508,13739.0,1236.0,301.6
90062210.0,17,28,13364,28,13364,3335637.407407407,501.0,477.2857142857143,0,0,0.0,0.0,0.0
291.0,17,2,164,1,82,0.0,82.0,82.0,1,82,0.0,82.0,82.0
90046060.0,17,28,13364,28,13364,3335039.25925926,501.0,477.2857142857143,0,0,0.0,0.0,0.0
304674.0,6,6,412,4,272,101558.0,74.0,68.0,2,140,0.0,74.0,70.0
55285.0,6,10,2032,5,524,12926.25,252.0,104.8,5,1508,11559.25,1236.0,301.6
37442.0,6,14,4740,7,653,6063.333333333333,249.0,93.28571428571428,7,4087,5476.5,1514.0,583.8571428571429
66200.0,6,14,4740,7,653,9460.833333333334,249.0,93.28571428571428,7,4087,9533.333333333334,1514.0,583.8571428571429
108105567.0,17,5,955,5,955,27026391.75,191.0,191.0,0,0,0.0,0.0,0.0
10437999.0,6,6,412,3,206,5151256.5,74.0,68.66666666666667,3,206,5151150.5,74.0,68.66666666666667
30378.0,6,13,1479,7,882,5063.0,291.0,126.0,6,597,5408.6,259.0,99.5
46793.0,6,14,4740,7,653,7631.5,249.0,93.28571428571428,7,4087,7301.666666666667,1514.0,583.8571428571429
266935.0,6,10,1221,6,636,53387.0,298.0,106.0,4,585,83552.33333333333,379.0,146.25
119891.0,17,4,1400,4,1400,39963.66666666666,350.0,350.0,0,0,0.0,0.0,0.0
252098.0,6,3,337,2,214,0.0,160.0,107.0,1,123,0.0,123.0,123.0
90256172.0,6,13,2036,8,1016,12893738.857142856,188.0,127.0,5,1020,22522711.5,204.0,204.0
1989.0,17,4,344,2,150,0.0,75.0,75.0,2,194,0.0,103.0,97.0
153485.0,17,2,180,1,90,0.0,90.0,90.0,1,90,0.0,90.0,90.0
46108.0,6,14,4740,7,653,7567.166666666667,249.0,93.28571428571428,7,4087,7121.666666666667,1514.0,583.8571428571429
2476438.0,6,25,7573,14,3735,190495.2307692308,1514.0,266.7857142857143,11,3838,221169.0,1514.0,348.90909090909093
108108555.0,17,5,955,5,955,27027138.75,191.0,191.0,0,0,0.0,0.0,0.0
10487065.0,6,7,478,4,272,3449982.333333333,74.0,68.0,3,206,5174882.5,74.0,68.66666666666667
157743.0,17,2,414,1,88,0.0,88.0,88.0,1,326,0.0,326.0,326.0
120823.0,17,4,1400,4,1400,40274.333333333336,350.0,350.0,0,0,0.0,0.0,0.0
306324.0,6,6,412,4,272,102108.0,74.0,68.0,2,140,0.0,74.0,70.0
19181.0,6,2,145,2,145,0.0,91.0,72.5,0,0,0.0,0.0,0.0
2405.0,17,4,344,2,150,0.0,75.0,75.0,2,194,0.0,103.0,97.0
7266.0,17,4,344,2,150,0.0,75.0,75.0,2,194,0.0,103.0,97.0
301026.0,6,6,412,4,272,100342.0,74.0,68.0,2,140,0.0,74.0,70.0
2428290.0,6,3,1604,1,753,0.0,753.0,753.0,2,851,0.0,785.0,425.5
114044417.0,6,48,3168,24,1584,4958452.913043479,66.0,66.0,24,1584,4946466.217391305,66.0,66.0
97139049.0,17,12,778,6,389,19400162.0,174.0,64.83333333333333,6,389,19402916.6,174.0,64.83333333333333
135133493.0,17,6,1206,6,1206,27026698.6,201.0,201.0,0,0,0.0,0.0,0.0
74545124.0,6,9,842,9,842,9318140.5,97.0,93.55555555555556,0,0,0.0,0.0,0.0
90733594.0,6,20,1531,11,840,9068998.4,95.0,76.36363636363636,9,691,11340269.0,95.0,76.77777777777777
104975.0,17,2,286,2,286,0.0,143.0,143.0,0,0,0.0,0.0,0.0
209492.0,17,2,180,1,90,0.0,90.0,90.0,1,90,0.0,90.0,90.0
120018621.0,17,28,13364,28,13364,4445134.111111111,501.0,477.2857142857143,0,0,0.0,0.0,0.0
299729.0,6,6,412,4,272,99909.66666666669,74.0,68.0,2,140,0.0,74.0,70.0
1321.0,17,4,820,2,156,0.0,78.0,78.0,2,664,0.0,332.0,332.0
333314.0,6,3,204,2,136,0.0,70.0,68.0,1,68,0.0,68.0,68.0
119481253.0,6,213,24136,107,16844,1127181.6320754718,284.0,157.42056074766356,106,7292,1128165.7904761904,140.0,68.79245283018868
90010006.0,17,27,12943,27,12943,3461923.3076923075,501.0,479.3703703703704,0,0,0.0,0.0,0.0
90031888.0,17,28,13364,28,13364,3334514.3703703703,501.0,477.2857142857143,0,0,0.0,0.0,0.0
30697.0,6,14,4740,7,653,4889.833333333333,249.0,93.28571428571428,7,4087,4717.333333333333,1514.0,583.8571428571429
25035.0,6,14,4740,7,653,3402.833333333333,249.0,93.28571428571428,7,4087,3919.5,1514.0,583.8571428571429
3002831.0,6,3,1604,2,851,0.0,785.0,425.5,1,753,0.0,753.0,753.0
120265104.0,6,210,23864,105,7226,1148639.4038461538,140.0,68.81904761904762,105,16638,1138628.6634615385,374.0,158.45714285714286
90208627.0,6,27,2397,12,894,8179355.0,95.0,74.5,15,1503,6428803.714285715,257.0,100.2
120001193.0,17,14,864,7,432,20000198.83333333,174.0,61.71428571428572,7,432,16667290.333333334,174.0,61.71428571428572
0.0,6,1,66,1,66,0.0,66.0,66.0,0,0,0.0,0.0,0.0
2428.0,17,4,344,2,150,0.0,75.0,75.0,2,194,0.0,103.0,97.0
4351.0,17,4,344,2,150,0.0,75.0,75.0,2,194,0.0,103.0,97.0
4467.0,17,2,180,1,90,0.0,90.0,90.0,1,90,0.0,90.0,90.0
1737809.0,6,23,6509,12,1529,157982.63636363635,357.0,127.41666666666669,11,4980,142775.9,1510.0,452.7272727272728
44965172.0,6,7,1874,3,887,22482586.0,753.0,295.6666666666667,4,987,13963267.333333334,785.0,246.75
21520.0,6,10,2032,5,524,4765.0,252.0,104.8,5,1508,4989.0,1236.0,301.6
143976.0,17,2,180,1,90,0.0,90.0,90.0,1,90,0.0,90.0,90.0
303.0,17,2,168,1,76,0.0,76.0,76.0,1,92,0.0,92.0,92.0
25819.0,6,14,4740,7,653,4128.833333333333,249.0,93.28571428571428,7,4087,3642.1666666666665,1514.0,583.8571428571429
135124150.0,17,6,1206,6,1206,27024830.0,201.0,201.0,0,0,0.0,0.0,0.0
10455730.0,6,7,478,4,272,3439765.0,74.0,68.0,3,206,5159564.0,74.0,68.66666666666667
336.0,17,2,166,1,75,0.0,75.0,75.0,1,91,0.0,91.0,91.0
218290.0,6,3,426,2,280,0.0,214.0,140.0,1,146,0.0,146.0,146.0
206059.0,6,3,426,2,280,0.0,214.0,140.0,1,146,0.0,146.0,146.0
126999.0,17,2,180,1,70,0.0,70.0,70.0,1,110,0.0,110.0,110.0
197098.0,17,2,180,1,90,0.0,90.0,90.0,1,90,0.0,90.0,90.0
234129.0,6,4,439,2,238,0.0,172.0,119.0,2,201,0.0,135.0,100.5
108100087.0,17,5,955,5,955,27025021.75,191.0,191.0,0,0,0.0,0.0,0.0
12879.0,6,11,1132,6,556,2575.8,218.0,92.66666666666669,5,576,2513.0,304.0,115.2
1176200.0,6,13,3000,8,2372,168028.57142857142,1514.0,296.5,5,628,225114.5,331.0,125.6
3410.0,17,2,359,1,75,0.0,75.0,75.0,1,284,0.0,284.0,284.0
135136644.0,17,6,1146,6,1146,27027328.8,191.0,191.0,0,0,0.0,0.0,0.0
391.0,17,2,410,1,78,0.0,78.0,78.0,1,332,0.0,332.0,332.0
118207577.0,17,14,1126,7,563,19674771.33333333,174.0,80.42857142857143,7,563,19674769.5,174.0,80.42857142857143
122914167.0,6,31,2034,16,1086,8194277.8,123.0,67.875,15,948,8050980.214285715,123.0,63.2
120153621.0,6,30,2037,15,948,8237601.928571428,123.0,63.2,15,1089,7869196.714285715,123.0,72.6
205909.0,17,2,180,1,90,0.0,90.0,90.0,1,90,0.0,90.0,90.0
2329.0,17,4,344,2,150,0.0,75.0,75.0,2,194,0.0,103.0,97.0
135133279.0,17,6,1146,6,1146,27026655.8,191.0,191.0,0,0,0.0,0.0,0.0
1040830.0,6,11,1134,6,558,208166.0,220.0,93.0,5,576,257501.5,304.0,115.2
41098.0,6,14,4740,7,653,5192.5,249.0,93.28571428571428,7,4087,6674.166666666667,1514.0,583.8571428571429
228244.0,17,2,180,1,90,0.0,90.0,90.0,1,90,0.0,90.0,90.0
122687720.0,6,48,3168,24,1584,5172198.608695652,66.0,66.0,24,1584,5036125.565217392,66.0,66.0
315.0,17,2,168,1,76,0.0,76.0,76.0,1,92,0.0,92.0,92.0
50319.0,6,10,2032,5,524,11984.0,252.0,104.8,5,1508,11122.25,1236.0,301.6
5829849.0,6,5,336,2,134,0.0,68.0,67.0,3,202,1526816.0,70.0,67.33333333333333
117553400.0,6,48,3168,24,1584,5111017.391304348,66.0,66.0,24,1584,5097586.869565218,66.0,66.0
307848.0,6,6,412,4,272,102616.0,74.0,68.0,2,140,0.0,74.0,70.0
695.0,17,4,438,2,148,0.0,74.0,74.0,2,290,0.0,147.0,145.0
120000079.0,6,17,1287,9,691,15000009.875,95.0,76.77777777777777,8,596,12897268.714285716,95.0,74.5
129129.0,6,11,1132,6,556,24929.2,218.0,92.66666666666669,5,576,31974.0,304.0,115.2
203997.0,17,2,762,2,762,0.0,381.0,381.0,0,0,0.0,0.0,0.0
108137163.0,17,14,864,7,432,18000180.833333332,174.0,61.71428571428572,7,432,17999698.5,174.0,61.71428571428572
283551.0,6,10,1221,6,636,56710.2,298.0,106.0,4,585,88729.0,379.0,146.25
49196.0,6,14,4740,7,653,5370.166666666667,249.0,93.28571428571428,7,4087,7828.0,1514.0,583.8571428571429
27358.0,6,10,2032,5,524,6598.75,252.0,104.8,5,1508,4197.0,1236.0,301.6
50742.0,17,2,180,1,90,0.0,90.0,90.0,1,90,0.0,90.0,90.0
316903.0,17,4,1400,4,1400,105634.33333333331,350.0,350.0,0,0,0.0,0.0,0.0
2208571.0,6,3,1604,2,851,0.0,785.0,425.5,1,753,0.0,753.0,753.0
108114886.0,17,5,955,5,955,27028721.5,191.0,191.0,0,0,0.0,0.0,0.0
55327.0,6,14,4740,7,653,9099.0,249.0,93.28571428571428,7,4087,8700.166666666666,1514.0,583.8571428571429
211112.0,17,2,762,2,762,0.0,381.0,381.0,0,0,0.0,0.0,0.0
90052303.0,17,28,13364,28,13364,3335270.4814814813,501.0,477.2857142857143,0,0,0.0,0.0,0.0
190823.0,17,2,180,1,90,0.0,90.0,90.0,1,90,0.0,90.0,90.0
196971.0,17,2,180,1,90,0.0,90.0,90.0,1,90,0.0,90.0,90.0
312156.0,17,4,1400,4,1400,104052.0,350.0,350.0,0,0,0.0,0.0,0.0
2457.0,17,4,344,2,150,0.0,75.0,75.0,2,194,0.0,103.0,97.0
9113.0,17,2,507,1,86,0.0,86.0,86.0,1,421,0.0,421.0,421.0
1168826.0,6,13,3019,8,2391,166975.14285714287,1514.0,298.875,5,628,224031.0,331.0,125.6
116933399.0,6,48,3168,24,1584,5084060.826086956,66.0,66.0,24,1584,5070859.913043479,66.0,66.0
103911.0,17,2,286,2,286,0.0,143.0,143.0,0,0,0.0,0.0,0.0
105404.0,17,2,700,2,700,0.0,350.0,350.0,0,0,0.0,0.0,0.0
2389446.0,6,3,204,1,68,0.0,68.0,68.0,2,136,0.0,70.0,68.0
234679.0,6,10,1221,6,636,46935.8,298.0,106.0,4,585,77004.66666666667,379.0,146.25
234755.0,6,3,337,2,214,0.0,160.0,107.0,1,123,0.0,123.0,123.0
34977.0,6,2,145,2,145,0.0,91.0,72.5,0,0,0.0,0.0,0.0
874442.0,6,10,1162,6,625,174888.4,287.0,104.16666666666669,4,537,199627.3333333333,331.0,134.25
14781.0,6,11,2098,6,590,2768.4,252.0,98.33333333333331,5,1508,2890.25,1236.0,301.6
128125893.0,6,40,2962,21,1591,6406294.65,139.0,75.76190476190476,19,1371,6552054.944444444,123.0,72.15789473684211
90909271.0,6,180,20316,90,14154,1019034.4943820224,284.0,157.26666666666668,90,6162,1019034.5617977527,140.0,68.46666666666667
1811.0,17,2,192,1,88,0.0,88.0,88.0,1,104,0.0,104.0,104.0
90293849.0,6,19,1436,10,745,10027210.666666666,95.0,74.5,9,691,11286432.375,95.0,76.77777777777777
120197769.0,6,18,1341,9,691,14999146.5,95.0,76.77777777777777,9,650,14999136.25,95.0,72.22222222222223
275720.0,6,10,1221,6,636,55144.0,298.0,106.0,4,585,86504.0,379.0,146.25
135130867.0,17,6,1146,6,1146,27026173.4,191.0,191.0,0,0,0.0,0.0,0.0
48691.0,6,14,4740,7,653,7987.333333333333,249.0,93.28571428571428,7,4087,6816.333333333333,1514.0,583.8571428571429
91707270.0,17,16,5472,16,5472,6113818.0,342.0,342.0,0,0,0.0,0.0,0.0
0.0,17,1,381,1,381,0.0,381.0,381.0,0,0,0.0,0.0,0.0
5624808.0,6,5,336,2,134,0.0,68.0,67.0,3,202,1513279.0,70.0,67.33333333333333
64978.99999999999,6,10,2032,5,524,14544.75,252.0,104.8,5,1508,15947.75,1236.0,301.6
153365.0,17,2,180,1,90,0.0,90.0,90.0,1,90,0.0,90.0,90.0
125371092.0,17,14,864,7,432,17666892.333333332,174.0,61.71428571428572,7,432,17668002.666666668,174.0,61.71428571428572
91459613.0,6,24,1829,13,989,7620197.666666667,95.0,76.07692307692308,11,840,9144588.9,95.0,76.36363636363636
16994.0,17,2,180,1,90,0.0,90.0,90.0,1,90,0.0,90.0,90.0
1735126.0,6,22,6441,12,1529,157738.72727272726,357.0,127.41666666666669,10,4912,158744.22222222222,1510.0,491.2
310771.0,6,6,412,4,272,103590.33333333331,74.0,68.0,2,140,0.0,74.0,70.0
98146420.0,17,14,1126,7,563,16334322.166666666,174.0,80.42857142857143,7,563,16333469.666666666,174.0,80.42857142857143
14026.0,6,2,145,2,145,0.0,91.0,72.5,0,0,0.0,0.0,0.0
135143130.0,17,6,1206,6,1206,27028626.0,201.0,201.0,0,0,0.0,0.0,0.0
32584.000000000004,6,11,2098,6,590,5056.0,252.0,98.33333333333331,5,1508,6935.0,1236.0,301.6
2427.0,17,4,344,2,150,0.0,75.0,75.0,2,194,0.0,103.0,97.0
300.0,17,2,164,1,82,0.0,82.0,82.0,1,82,0.0,82.0,82.0
40992.0,6,10,2032,5,524,10043.25,252.0,104.8,5,1508,8302.75,1236.0,301.6
123224824.0,6,34,2356,18,1285,7248519.05882353,139.0,71.38888888888889,16,1071,7534849.666666667,123.0,66.9375
12038.0,6,11,2098,6,590,2213.6,252.0,98.33333333333331,5,1508,2348.25,1236.0,301.6
2371.0,17,4,344,2,150,0.0,75.0,75.0,2,194,0.0,103.0,97.0
0.0,17,1,381,1,381,0.0,381.0,381.0,0,0,0.0,0.0,0.0
437.0,17,2,508,2,508,0.0,257.0,254.0,0,0,0.0,0.0,0.0
46903.0,6,14,4740,7,653,6212.666666666667,249.0,93.28571428571428,7,4087,6872.166666666667,1514.0,583.8571428571429
1062405.0,6,3,1604,1,753,0.0,753.0,753.0,2,851,0.0,785.0,425.5
5837557.0,6,4,270,2,134,0.0,68.0,67.0,2,136,0.0,70.0,68.0
5627995.0,6,5,336,2,134,0.0,68.0,67.0,3,202,1526046.5,70.0,67.33333333333333
90556421.0,6,15,2444,8,1016,12936631.57142857,188.0,127.0,7,1428,15061103.5,204.0,204.0
10442984.0,6,6,412,3,206,5152983.5,74.0,68.66666666666667,3,206,5151841.5,74.0,68.66666666666667
135127172.0,17,6,1206,6,1206,27025434.4,201.0,201.0,0,0,0.0,0.0,0.0
117235476.0,6,48,3168,24,1584,5097194.608695652,66.0,66.0,24,1584,5085218.304347826,66.0,66.0
27592695.0,17,5,1710,5,1710,6898173.75,342.0,342.0,0,0,0.0,0.0,0.0
257319.00000000003,6,10,1221,6,636,51463.8,298.0,106.0,4,585,79973.0,379.0,146.25
210154.0,6,10,1221,6,636,42030.8,298.0,106.0,4,585,68768.33333333333,379.0,146.25
446197.0,17,4,360,2,140,0.0,70.0,70.0,2,220,0.0,110.0,110.0
770.0,17,4,438,2,148,0.0,74.0,74.0,2,290,0.0,147.0,145.0
147945.0,17,2,180,1,90,0.0,90.0,90.0,1,90,0.0,90.0,90.0
304165.0,6,6,412,4,272,101388.33333333331,74.0,68.0,2,140,0.0,74.0,70.0
90052272.0,17,27,12943,27,12943,3463548.923076923,501.0,479.3703703703704,0,0,0.0,0.0,0.0
304137.0,6,6,412,4,272,101379.0,74.0,68.0,2,140,0.0,74.0,70.0
220288.0,6,3,426,2,280,0.0,214.0,140.0,1,146,0.0,146.0,146.0
66647506.00000001,17,9,3086,8,2736,5178220.285714285,342.0,342.0,1,350,0.0,350.0,350.0
390617.0,6,3,204,2,136,0.0,70.0,68.0,1,68,0.0,68.0,68.0
9596.0,17,2,571,1,86,0.0,86.0,86.0,1,485,0.0,485.0,485.0
148375.0,17,2,414,1,88,0.0,88.0,88.0,1,326,0.0,326.0,326.0
403.0,17,2,410,1,78,0.0,78.0,78.0,1,332,0.0,332.0,332.0
28924.0,6,14,4740,7,653,4361.0,249.0,93.28571428571428,7,4087,4646.166666666667,1514.0,583.8571428571429
5237.0,17,2,180,1,90,0.0,90.0,90.0,1,90,0.0,90.0,90.0
116275582.0,6,215,24262,108,16978,1086687.6822429907,284.0,157.2037037037037,107,7284,1078325.5849056605,140.0,68.07476635514018
3164214.0,6,3,204,2,136,0.0,70.0,68.0,1,68,0.0,68.0,68.0
117349368.0,6,48,3168,24,1584,5102146.434782608,66.0,66.0,24,1584,5088717.869565218,66.0,66.0
124716207.0,17,14,995,8,606,17816601.0,174.0,75.75,6,389,20116320.0,174.0,64.83333333333333
116228541.0,6,47,3102,24,1584,5039971.304347826,66.0,66.0,23,1518,5150432.7727272725,66.0,66.0
14052.0,6,14,4740,7,653,2166.1666666666665,249.0,93.28571428571428,7,4087,2203.6666666666665,1514.0,583.8571428571429
162238.0,17,2,180,1,90,0.0,90.0,90.0,1,90,0.0,90.0,90.0
27491818.0,17,5,1710,5,1710,6872954.5,342.0,342.0,0,0,0.0,0.0,0.0
27822.0,6,14,4740,7,653,4004.1666666666665,249.0,93.28571428571428,7,4087,3999.5,1514.0,583.8571428571429
26528.0,6,14,4740,7,653,4078.0,249.0,93.28571428571428,7,4087,4281.666666666667,1514.0,583.8571428571429
122987058.0,6,36,2586,19,1392,6832614.333333333,123.0,73.26315789473684,17,1194,7049158.75,123.0,70.23529411764706
25179.0,6,14,4740,7,653,3142.5,249.0,93.28571428571428,7,4087,3962.3333333333335,1514.0,583.8571428571429
197047.0,17,2,180,1,90,0.0,90.0,90.0,1,90,0.0,90.0,90.0
135131443.0,17,6,1146,6,1146,27026288.6,191.0,191.0,0,0,0.0,0.0,0.0
120059667.0,17,28,13364,28,13364,4446654.333333333,501.0,477.2857142857143,0,0,0.0,0.0,0.0
254901.0,6,3,337,2,214,0.0,160.0,107.0,1,123,0.0,123.0,123.0
782897.0,6,6,758,3,410,376068.5,172.0,136.66666666666666,3,348,267358.5,135.0,116.0
68224.0,6,13,1394,7,797,10953.833333333334,253.0,113.85714285714286,6,597,11926.4,259.0,99.5
0.0,17,1,90,1,90,0.0,90.0,90.0,0,0,0.0,0.0,0.0
53043.0,6,14,4740,7,653,8288.333333333334,249.0,93.28571428571428,7,4087,8709.333333333334,1514.0,583.8571428571429
510091.0,6,5,336,2,134,0.0,68.0,67.0,3,202,192273.0,70.0,67.33333333333333
148724.0,17,4,571,2,148,0.0,74.0,74.0,2,423,0.0,276.0,211.5
233168.0,6,3,337,2,214,0.0,160.0,107.0,1,123,0.0,123.0,123.0
115629463.0,6,389,44842,195,31742,596028.1597938144,284.0,162.77948717948718,194,13100,597891.5854922279,140.0,67.52577319587628
2209.0,17,4,344,2,150,0.0,75.0,75.0,2,194,0.0,103.0,97.0
909.0,17,5,550,5,550,227.25,110.0,110.0,0,0,0.0,0.0,0.0
128938336.0,6,38,2716,20,1468,6786228.210526316,139.0,73.4,18,1248,6984438.882352941,123.0,69.33333333333333
176505.0,6,11,1132,6,556,35113.2,218.0,92.66666666666669,5,576,43920.5,304.0,115.2
301221.0,6,6,412,4,272,100407.0,74.0,68.0,2,140,0.0,74.0,70.0
31085.0,6,14,4740,7,653,4991.666666666667,249.0,93.28571428571428,7,4087,5042.0,1514.0,583.8571428571429
120064892.0,17,29,13785,29,13785,4288031.857142857,501.0,475.3448275862069,0,0,0.0,0.0,0.0
37945.0,6,14,4740,7,653,5635.5,249.0,93.28571428571428,7,4087,6103.833333333333,1514.0,583.8571428571429
45032194.0,6,7,1872,5,1052,11258048.5,784.0,210.4,2,820,0.0,752.0,410.0
10475492.0,6,6,412,3,206,5169854.5,74.0,68.66666666666667,3,206,5169768.5,74.0,68.66666666666667
90314530.0,6,21,1585,11,840,9026417.2,95.0,76.36363636363636,10,745,10004464.888888888,95.0,74.5
385.0,17,2,174,1,79,0.0,79.0,79.0,1,95,0.0,95.0,95.0
153497.0,17,2,180,1,90,0.0,90.0,90.0,1,90,0.0,90.0,90.0
232382.0,6,10,1221,6,636,46476.4,298.0,106.0,4,585,76270.66666666667,379.0,146.25
6462.0,17,4,344,2,150,0.0,75.0,75.0,2,194,0.0,103.0,97.0
303688.0,6,2,132,1,66,0.0,66.0,66.0,1,66,0.0,66.0,66.0
110163980.0,6,28,1860,14,966,8457544.23076923,123.0,69.0,14,894,8457547.76923077,123.0,63.85714285714285
92476464.0,17,16,5472,16,5472,6165097.6,342.0,342.0,0,0,0.0,0.0,0.0
9070.0,17,2,539,1,86,0.0,86.0,86.0,1,453,0.0,453.0,453.0
249139.0,17,4,6056,4,6056,83046.33333333333,1514.0,1514.0,0,0,0.0,0.0,0.0
90928694.0,6,21,1585,11,840,9092255.2,95.0,76.36363636363636,10,745,10102804.777777778,95.0,74.5
14268.0,6,10,1066,5,490,2714.25,218.0,98.0,5,576,3054.0,304.0,115.2
307321.0,6,6,412,4,272,102440.33333333331,74.0,68.0,2,140,0.0,74.0,70.0
167307.0,17,2,180,1,90,0.0,90.0,90.0,1,90,0.0,90.0,90.0
115408.0,6,14,4740,7,653,17791.5,249.0,93.28571428571428,7,4087,17227.333333333332,1514.0,583.8571428571429
542.0,17,2,508,2,508,0.0,257.0,254.0,0,0,0.0,0.0,0.0
120125491.0,6,13,2020,9,1204,15015686.375,188.0,133.77777777777777,4,816,30031269.33333333,204.0,204.0
20234.0,6,14,4740,7,653,3236.1666666666665,249.0,93.28571428571428,7,4087,2930.1666666666665,1514.0,583.8571428571429
91841480.0,6,171,19234,86,13402,1080488.0,284.0,155.8372093023256,85,5832,1068646.75,140.0,68.61176470588235
3730.0,17,4,344,2,150,0.0,75.0,75.0,2,194,0.0,103.0,97.0
23051.0,6,10,1067,5,536,4917.75,264.0,107.2,5,531,5026.25,259.0,106.2
19767.0,6,10,2032,5,524,4714.5,252.0,104.8,5,1508,4718.5,1236.0,301.6
140129.0,6,2,132,1,66,0.0,66.0,66.0,1,66,0.0,66.0,66.0
120066916.0,17,28,13364,28,13364,4446922.814814814,501.0,477.2857142857143,0,0,0.0,0.0,0.0
2480.0,17,2,180,1,90,0.0,90.0,90.0,1,90,0.0,90.0,90.0
202783.0,17,4,6056,4,6056,67594.33333333333,1514.0,1514.0,0,0,0.0,0.0,0.0
7563.0,17,2,582,1,83,0.0,83.0,83.0,1,499,0.0,499.0,499.0
108102846.0,17,5,955,5,955,27025711.5,191.0,191.0,0,0,0.0,0.0,0.0
302414.0,6,6,412,4,272,100804.66666666669,74.0,68.0,2,140,0.0,74.0,70.0
326.0,17,2,174,1,79,0.0,79.0,79.0,1,95,0.0,95.0,95.0
318597.0,17,2,246,1,76,0.0,76.0,76.0,1,170,0.0,170.0,170.0
241237.0,6,3,337,2,214,0.0,160.0,107.0,1,123,0.0,123.0,123.0
223390.0,6,10,1221,6,636,44678.0,298.0,106.0,4,585,72978.66666666667,379.0,146.25
108086516.0,17,5,955,5,955,27021629.0,191.0,191.0,0,0,0.0,0.0,0.0
205277.0,17,2,762,2,762,0.0,381.0,381.0,0,0,0.0,0.0,0.0
50931.0,17,2,180,1,90,0.0,90.0,90.0,1,90,0.0,90.0,90.0
119523239.0,6,846,150916,426,122752,281231.1505882353,1514.0,288.15023474178406,420,28164,284693.2959427208,214.0,67.05714285714286
3983879.0,6,182,148113,104,138662,38678.436893203885,1510.0,1333.2884615384614,78,9451,47688.24675324676,1510.0,121.16666666666669
105268773.0,6,44,2904,22,1452,5012798.714285715,66.0,66.0,22,1452,5002503.428571428,66.0,66.0
121400.0,6,3,337,2,214,0.0,160.0,107.0,1,123,0.0,123.0,123.0
90291870.0,6,13,1898,8,1016,12898838.57142857,188.0,127.0,5,882,22532372.25,204.0,176.4
135358146.0,17,8,1643,7,1337,22559691.0,191.0,191.0,1,306,0.0,306.0,306.0
146200.0,6,2,132,1,66,0.0,66.0,66.0,1,66,0.0,66.0,66.0
205752.0,17,2,180,1,90,0.0,90.0,90.0,1,90,0.0,90.0,90.0
298324.0,17,2,180,1,90,0.0,90.0,90.0,1,90,0.0,90.0,90.0
191124.0,17,2,180,1,90,0.0,90.0,90.0,1,90,0.0,90.0,90.0
332078.0,17,6,2100,6,2100,66415.6,350.0,350.0,0,0,0.0,0.0,0.0
2448.0,17,4,344,2,150,0.0,75.0,75.0,2,194,0.0,103.0,97.0
26369.0,6,14,4740,7,653,3590.833333333333,249.0,93.28571428571428,7,4087,4254.333333333333,1514.0,583.8571428571429
103459.0,17,2,286,2,286,0.0,143.0,143.0,0,0,0.0,0.0,0.0
10511374.0,6,7,478,4,272,3456620.333333333,74.0,68.0,3,206,5184799.0,74.0,68.66666666666667
53331.0,6,14,4740,7,653,8755.166666666666,249.0,93.28571428571428,7,4087,8697.833333333334,1514.0,583.8571428571429
21088.0,6,14,4740,7,653,3294.1666666666665,249.0,93.28571428571428,7,4087,2541.0,1514.0,583.8571428571429
1161664.0,6,13,3009,8,2381,165952.0,1514.0,297.625,5,628,221430.75,331.0,125.6
205913.0,17,2,180,1,90,0.0,90.0,90.0,1,90,0.0,90.0,90.0
112535678.0,6,46,3036,23,1518,5105440.363636363,66.0,66.0,23,1518,5105447.045454546,66.0,66.0
96483608.0,17,14,1126,7,563,16000539.5,174.0,80.42857142857143,7,563,16000168.0,174.0,80.42857142857143
457995.0,17,2,363,1,75,0.0,75.0,75.0,1,288,0.0,288.0,288.0
119957803.0,17,35,16705,35,16705,3528170.6764705884,501.0,477.2857142857143,0,0,0.0,0.0,0.0
120325346.0,6,212,23980,106,7292,1138256.8476190476,140.0,68.79245283018868,106,16688,1138087.9714285715,284.0,157.43396226415095
159118.0,6,2,128,1,74,0.0,74.0,74.0,1,54,0.0,54.0,54.0
3225.0,17,2,762,2,762,0.0,381.0,381.0,0,0,0.0,0.0,0.0
308609.0,6,6,412,4,272,102869.66666666669,74.0,68.0,2,140,0.0,74.0,70.0
1649299.0,6,21,4235,11,1393,164929.9,311.0,126.63636363636364,10,2842,159671.88888888888,1514.0,284.2
108073.0,17,2,286,2,286,0.0,143.0,143.0,0,0,0.0,0.0,0.0
20483.0,6,10,2032,5,524,4315.25,252.0,104.8,5,1508,4841.5,1236.0,301.6
14624.0,6,11,1133,6,602,2853.8,264.0,100.33333333333331,5,531,2780.75,259.0,106.2
2407.0,17,4,344,2,150,0.0,75.0,75.0,2,194,0.0,103.0,97.0
90526912.0,6,13,2036,8,1016,12932416.0,188.0,127.0,5,1020,22591178.0,204.0,204.0
16949.0,6,10,1067,5,536,4051.25,264.0,107.2,5,531,3146.75,259.0,106.2
2790241.0,6,2,132,1,66,0.0,66.0,66.0,1,66,0.0,66.0,66.0
108734737.0,6,32,2220,16,1149,7234581.466666667,123.0,71.8125,16,1071,7234581.8,123.0,66.9375
61430.0,6,12,1328,7,797,10238.333333333334,253.0,113.85714285714286,5,531,12819.75,259.0,106.2
48511.0,6,14,4740,7,653,7961.833333333333,249.0,93.28571428571428,7,4087,7511.5,1514.0,583.8571428571429
273625.0,6,10,1221,6,636,54725.0,298.0,106.0,4,585,85389.0,379.0,146.25
309040.0,6,6,412,4,272,103013.33333333331,74.0,68.0,2,140,0.0,74.0,70.0
108102281.0,17,5,1005,5,1005,27025570.25,201.0,201.0,0,0,0.0,0.0,0.0
135134430.0,17,6,1206,6,1206,27026886.0,201.0,201.0,0,0,0.0,0.0,0.0
74618.0,6,14,4740,7,653,12283.5,249.0,93.28571428571428,7,4087,9401.333333333334,1514.0,583.8571428571429
502851.00000000006,6,5,336,2,134,0.0,68.0,67.0,3,202,192862.0,70.0,67.33333333333333
90257733.0,6,12,1832,8,1016,12893961.857142856,188.0,127.0,4,816,30030331.0,204.0,204.0
120000233.0,6,32,3392,17,1789,7500014.5625,424.0,105.23529411764706,15,1603,7998067.214285715,360.0,106.86666666666666
120065158.0,17,29,13785,29,13785,4288041.357142857,501.0,475.3448275862069,0,0,0.0,0.0,0.0
90536814.0,6,15,2444,8,1016,12933830.57142857,188.0,127.0,7,1428,15062192.666666666,204.0,204.0
48004.0,6,12,1413,7,882,8000.666666666667,291.0,126.0,5,531,7724.75,259.0,106.2
15987.000000000002,6,11,1133,6,602,2806.6,264.0,100.33333333333331,5,531,3278.75,259.0,106.2
103379.0,17,2,286,2,286,0.0,143.0,143.0,0,0,0.0,0.0,0.0
43289015.0,6,7,1874,5,1053,10822253.75,785.0,210.6,2,821,0.0,753.0,410.5
113731763.0,6,46,3036,23,1518,5155441.181818182,66.0,66.0,23,1518,5155421.727272728,66.0,66.0
120215956.0,6,220,24878,110,7482,1095320.7889908256,140.0,68.01818181818182,110,17396,1095335.5688073395,300.0,158.14545454545456
101416.0,17,2,762,2,762,0.0,381.0,381.0,0,0,0.0,0.0,0.0
121285725.0,17,14,1126,7,563,17005486.833333332,174.0,80.42857142857143,7,563,17001330.666666668,174.0,80.42857142857143
4576.0,17,2,614,1,72,0.0,72.0,72.0,1,542,0.0,542.0,542.0
120210838.0,6,22,1639,11,881,11999466.8,95.0,80.0909090909091,11,758,11999471.2,95.0,68.9090909090909
30630491.0,17,2,110,2,110,0.0,55.0,55.0,0,0,0.0,0.0,0.0
205944.0,6,3,426,2,280,0.0,214.0,140.0,1,146,0.0,146.0,146.0
2595801.0,6,2,132,1,66,0.0,66.0,66.0,1,66,0.0,66.0,66.0
91730.0,6,13,1386,7,789,14581.833333333334,253.0,112.71428571428572,6,597,17707.8,259.0,99.5
211490.0,17,2,634,1,82,0.0,82.0,82.0,1,552,0.0,552.0,552.0
16806.0,17,2,180,1,90,0.0,90.0,90.0,1,90,0.0,90.0,90.0
17718887.0,6,20,1611,9,921,2177086.25,315.0,102.33333333333331,11,690,1741644.9,78.0,62.72727272727273
150244.0,6,13,1386,7,789,25040.666666666668,253.0,112.71428571428572,6,597,26428.8,259.0,99.5
236715.0,17,2,180,1,90,0.0,90.0,90.0,1,90,0.0,90.0,90.0
359.0,17,2,166,1,75,0.0,75.0,75.0,1,91,0.0,91.0,91.0
16847.0,6,2,145,2,145,0.0,91.0,72.5,0,0,0.0,0.0,0.0
135132514.0,17,6,1146,6,1146,27026502.8,191.0,191.0,0,0,0.0,0.0,0.0
41476.0,6,14,4740,7,653,6138.0,249.0,93.28571428571428,7,4087,6289.333333333333,1514.0,583.8571428571429
39763.0,6,14,4740,7,653,6051.5,249.0,93.28571428571428,7,4087,6187.0,1514.0,583.8571428571429
2376642.0,6,3,1777,1,826,0.0,826.0,826.0,2,951,0.0,885.0,475.5
37396.0,6,10,1065,5,534,8924.75,262.0,106.8,5,531,8709.0,259.0,106.2
303653.0,6,2,132,1,66,0.0,66.0,66.0,1,66,0.0,66.0,66.0
138001162.0,17,15,907,8,475,19714451.71428572,174.0,59.375,7,432,19667434.83333333,174.0,61.71428571428572
16693.0,6,14,4740,7,653,2545.0,249.0,93.28571428571428,7,4087,2644.833333333333,1514.0,583.8571428571429
228177.0,17,2,180,1,90,0.0,90.0,90.0,1,90,0.0,90.0,90.0
120877655.0,17,14,864,7,432,16834434.333333332,174.0,61.71428571428572,7,432,16833550.166666668,174.0,61.71428571428572
65918.0,6,14,4740,7,653,10268.666666666666,249.0,93.28571428571428,7,4087,10818.666666666666,1514.0,583.8571428571429
160291.0,6,2,128,1,74,0.0,74.0,74.0,1,54,0.0,54.0,54.0
121201.0,6,3,337,2,214,0.0,160.0,107.0,1,123,0.0,123.0,123.0
851546.0,6,9,1269,6,798,170309.2,460.0,133.0,3,471,288012.5,331.0,157.0
2598.0,17,2,180,1,90,0.0,90.0,90.0,1,90,0.0,90.0,90.0
16469.0,6,14,4740,7,653,2498.333333333333,249.0,93.28571428571428,7,4087,2608.1666666666665,1514.0,583.8571428571429
90892754.0,6,153,17380,77,12216,1195957.2894736845,284.0,158.64935064935065,76,5164,1184239.44,140.0,67.94736842105263
199845.0,17,2,180,1,90,0.0,90.0,90.0,1,90,0.0,90.0,90.0
45254.0,6,12,1320,7,789,7542.333333333333,253.0,112.71428571428572,5,531,8570.5,259.0,106.2
130810.0,6,3,337,2,214,0.0,160.0,107.0,1,123,0.0,123.0,123.0
114400593.0,6,48,3168,24,1584,4973938.826086956,66.0,66.0,24,1584,4961966.739130435,66.0,66.0
710.0,17,4,438,2,148,0.0,74.0,74.0,2,290,0.0,147.0,145.0
206194.0,6,3,426,2,280,0.0,214.0,140.0,1,146,0.0,146.0,146.0
14246.0,17,4,344,2,150,0.0,75.0,75.0,2,194,0.0,103.0,97.0
45257.0,6,14,4740,7,653,7424.0,249.0,93.28571428571428,7,4087,7375.5,1514.0,583.8571428571429
90036538.0,17,28,13364,28,13364,3334686.592592593,501.0,477.2857142857143,0,0,0.0,0.0,0.0
213687.0,17,2,180,1,90,0.0,90.0,90.0,1,90,0.0,90.0,90.0
119711511.0,6,212,23996,106,16704,1138060.4952380953,284.0,157.58490566037736,106,7292,1138059.980952381,140.0,68.79245283018868
9216.0,17,2,582,1,83,0.0,83.0,83.0,1,499,0.0,499.0,499.0
314.0,17,2,174,1,79,0.0,79.0,79.0,1,95,0.0,95.0,95.0
90010988.0,17,28,13364,28,13364,3333740.296296296,501.0,477.2857142857143,0,0,0.0,0.0,0.0
90300625.0,6,21,1585,11,840,9025075.7,95.0,76.36363636363636,10,745,10000045.0,95.0,74.5
111601.0,17,2,286,2,286,0.0,143.0,143.0,0,0,0.0,0.0,0.0
2048.0,17,4,344,2,150,0.0,75.0,75.0,2,194,0.0,103.0,97.0
839413.0,6,9,1118,6,586,167882.6,248.0,97.66666666666669,3,532,282184.0,392.0,177.33333333333334
146300.0,6,3,337,2,214,0.0,160.0,107.0,1,123,0.0,123.0,123.0
889919.0,6,12,2711,7,743,148319.83333333334,339.0,106.14285714285714,5,1968,153582.75,1514.0,393.6
5830104.0,6,4,270,2,134,0.0,68.0,67.0,2,136,0.0,70.0,68.0
3378.0,17,2,762,2,762,0.0,381.0,381.0,0,0,0.0,0.0,0.0
196898.0,17,2,180,1,90,0.0,90.0,90.0,1,90,0.0,90.0,90.0
4484.0,17,2,614,1,72,0.0,72.0,72.0,1,542,0.0,542.0,542.0
116198562.0,6,48,3168,24,1584,5052111.391304348,66.0,66.0,24,1584,5040270.565217392,66.0,66.0
26124.0,6,14,4740,7,653,4175.333333333333,249.0,93.28571428571428,7,4087,4140.666666666667,1514.0,583.8571428571429
206138.0,6,3,426,2,280,0.0,214.0,140.0,1,146,0.0,146.0,146.0
762885.0,6,14,4740,7,653,126513.83333333331,249.0,93.28571428571428,7,4087,126812.0,1514.0,583.8571428571429
13627261.0,6,20,1607,10,975,1478940.888888889,315.0,97.5,10,632,1478852.0,78.0,63.2
2462.0,17,4,344,2,150,0.0,75.0,75.0,2,194,0.0,103.0,97.0
207222.0,6,3,426,2,280,0.0,214.0,140.0,1,146,0.0,146.0,146.0
5833485.0,6,5,336,2,134,0.0,68.0,67.0,3,202,1525799.0,70.0,67.33333333333333
94954815.0,6,157,17820,79,12438,1217369.423076923,284.0,157.4430379746835,78,5382,1219632.7402597405,140.0,69.0
2309.0,17,4,344,2,150,0.0,75.0,75.0,2,194,0.0,103.0,97.0
90216241.0,6,19,1436,9,691,11247636.25,95.0,76.77777777777777,10,745,10001300.888888888,95.0,74.5
120118592.0,6,224,25328,112,7688,1074643.5855855856,140.0,68.64285714285714,112,17640,1074971.027027027,284.0,157.5
148902.0,17,2,414,1,88,0.0,88.0,88.0,1,326,0.0,326.0,326.0
143896.0,17,2,180,1,90,0.0,90.0,90.0,1,90,0.0,90.0,90.0
277297.0,17,2,180,1,90,0.0,90.0,90.0,1,90,0.0,90.0,90.0
28850.0,6,10,2032,5,524,5942.25,252.0,104.8,5,1508,6564.5,1236.0,301.6
135129408.0,17,6,1146,6,1146,27025881.6,191.0,191.0,0,0,0.0,0.0,0.0
10462439.0,6,7,478,4,272,3440933.6666666665,74.0,68.0,3,206,5161258.5,74.0,68.66666666666667
34164.0,6,14,4740,7,653,5513.5,249.0,93.28571428571428,7,4087,5559.833333333333,1514.0,583.8571428571429
107502331.0,6,28,1876,14,982,8252793.230769231,139.0,70.14285714285714,14,894,8252794.538461538,123.0,63.85714285714285
15980.999999999998,6,10,1067,5,536,3768.75,264.0,107.2,5,531,3572.25,259.0,106.2
103103.0,17,2,286,2,286,0.0,143.0,143.0,0,0,0.0,0.0,0.0
111795.0,17,2,286,2,286,0.0,143.0,143.0,0,0,0.0,0.0,0.0
243116.0,6,3,337,2,214,0.0,160.0,107.0,1,123,0.0,123.0,123.0
228345.0,17,2,180,1,90,0.0,90.0,90.0,1,90,0.0,90.0,90.0
22591.0,17,2,582,1,83,0.0,83.0,83.0,1,499,0.0,499.0,499.0
400773.0,6,3,1604,1,753,0.0,753.0,753.0,2,851,0.0,785.0,425.5
108112773.0,17,5,1005,5,1005,27028193.25,201.0,201.0,0,0,0.0,0.0,0.0
49398.0,6,14,4740,7,653,8100.333333333333,249.0,93.28571428571428,7,4087,6538.666666666667,1514.0,583.8571428571429
228428.0,17,2,180,1,90,0.0,90.0,90.0,1,90,0.0,90.0,90.0
153472.0,17,2,180,1,90,0.0,90.0,90.0,1,90,0.0,90.0,90.0
135131163.0,17,6,1146,6,1146,27026232.6,191.0,191.0,0,0,0.0,0.0,0.0
32714.0,6,14,4740,7,653,5266.333333333333,249.0,93.28571428571428,7,4087,5188.0,1514.0,583.8571428571429
120126915.0,6,14,2240,6,1224,24025383.0,204.0,204.0,8,1016,17137507.57142857,188.0,127.0
254740.00000000003,6,10,1221,6,636,50948.0,298.0,106.0,4,585,79496.0,379.0,146.25
2002.0,17,2,180,1,90,0.0,90.0,90.0,1,90,0.0,90.0,90.0
108109377.0,17,5,1005,5,1005,27027344.25,201.0,201.0,0,0,0.0,0.0,0.0
2839951.0,6,2,132,1,66,0.0,66.0,66.0,1,66,0.0,66.0,66.0
628.0,17,2,508,2,508,0.0,257.0,254.0,0,0,0.0,0.0,0.0
2790605.0,6,2,132,1,66,0.0,66.0,66.0,1,66,0.0,66.0,66.0
107384.0,17,2,286,2,286,0.0,143.0,143.0,0,0,0.0,0.0,0.0
28090.0,6,11,1133,6,602,5568.4,264.0,100.33333333333331,5,531,6467.0,259.0,106.2
118904503.0,6,34,2350,17,1225,7418030.8125,139.0,72.05882352941177,17,1125,7418031.4375,123.0,66.17647058823529
9183.0,17,2,507,1,86,0.0,86.0,86.0,1,421,0.0,421.0,421.0
312.0,17,2,174,1,79,0.0,79.0,79.0,1,95,0.0,95.0,95.0
156104.0,6,3,337,2,214,0.0,160.0,107.0,1,123,0.0,123.0,123.0
9004456.0,17,4,300,4,300,3001485.333333333,75.0,75.0,0,0,0.0,0.0,0.0
10427629.0,6,7,478,4,272,3430187.6666666665,74.0,68.0,3,206,5145187.5,74.0,68.66666666666667
5378.0,17,2,180,1,90,0.0,90.0,90.0,1,90,0.0,90.0,90.0
206964.0,6,3,426,2,280,0.0,214.0,140.0,1,146,0.0,146.0,146.0
6230.0,17,2,762,2,762,0.0,381.0,381.0,0,0,0.0,0.0,0.0
120041105.0,6,24,1829,13,1030,9999402.416666666,95.0,79.23076923076923,11,799,11999648.3,95.0,72.63636363636364
303.0,17,2,164,1,82,0.0,82.0,82.0,1,82,0.0,82.0,82.0
135129083.0,17,6,1206,6,1206,27025816.6,201.0,201.0,0,0,0.0,0.0,0.0
107282829.0,6,46,4098,27,2313,4126262.653846154,123.0,85.66666666666667,19,1785,5948068.555555556,123.0,93.94736842105264
113394624.0,6,30,1990,15,1042,8084151.357142857,139.0,69.46666666666667,15,948,8084187.0,123.0,63.2
127703174.0,6,34,2413,17,1125,7418482.125,123.0,66.17647058823529,17,1288,7357267.75,139.0,75.76470588235294
5005275.0,17,2,168,2,168,0.0,84.0,84.0,0,0,0.0,0.0,0.0
300179.0,6,6,412,4,272,100059.66666666669,74.0,68.0,2,140,0.0,74.0,70.0
232591.0,6,13,1394,7,797,38765.16666666666,253.0,113.85714285714286,6,597,42028.6,259.0,99.5
71104.0,6,10,1066,5,490,17598.5,218.0,98.0,5,576,16780.25,304.0,115.2
32760.0,6,14,4740,7,653,4934.0,249.0,93.28571428571428,7,4087,4802.333333333333,1514.0,583.8571428571429
350.0,17,2,248,1,84,0.0,84.0,84.0,1,164,0.0,164.0,164.0
125141611.0,6,37,2640,19,1392,6952311.722222222,123.0,73.26315789473684,18,1248,6760996.05882353,123.0,69.33333333333333
216760.0,6,3,426,2,280,0.0,214.0,140.0,1,146,0.0,146.0,146.0
90536036.0,6,15,2444,8,1016,12933719.42857143,188.0,127.0,7,1428,15061315.333333334,204.0,204.0
135141268.0,17,6,1146,6,1146,27028253.6,191.0,191.0,0,0,0.0,0.0,0.0
2392.0,17,4,344,2,150,0.0,75.0,75.0,2,194,0.0,103.0,97.0
300260.0,6,6,412,4,272,100086.66666666669,74.0,68.0,2,140,0.0,74.0,70.0
2425.0,17,4,344,2,150,0.0,75.0,75.0,2,194,0.0,103.0,97.0
1182885.0,6,13,3010,8,2382,168983.57142857142,1514.0,297.75,5,628,226789.25,331.0,125.6
108107130.0,17,5,1005,5,1005,27026782.5,201.0,201.0,0,0,0.0,0.0,0.0
119788.0,17,2,180,1,70,0.0,70.0,70.0,1,110,0.0,110.0,110.0
295.0,17,2,156,1,78,0.0,78.0,78.0,1,78,0.0,78.0,78.0
1304158.0,6,4,264,2,132,0.0,66.0,66.0,2,132,0.0,66.0,66.0
3196900.0,6,18,1495,9,921,358306.625,315.0,102.33333333333331,9,574,358147.875,78.0,63.77777777777778
1472450.0,17,16,1120,16,1120,98163.33333333331,70.0,70.0,0,0,0.0,0.0,0.0
5638663.0,6,5,336,2,134,0.0,68.0,67.0,3,202,1427008.0,70.0,67.33333333333333
121182.0,6,3,373,2,238,0.0,172.0,119.0,1,135,0.0,135.0,135.0
153357.0,17,2,180,1,90,0.0,90.0,90.0,1,90,0.0,90.0,90.0
120820364.0,17,14,864,7,432,16833501.5,174.0,61.71428571428572,7,432,19985602.5,174.0,61.71428571428572
128655573.0,6,35,2542,17,1194,7416884.125,123.0,70.23529411764706,18,1348,7282321.94117647,139.0,74.88888888888889
18538.0,6,10,2032,5,524,4398.0,252.0,104.8,5,1508,4070.5,1236.0,301.6
14728.0,6,20,7606,11,978,1472.8,310.0,88.9090909090909,9,6628,1488.875,1514.0,736.4444444444445
1388968.0,17,16,1120,16,1120,92597.86666666668,70.0,70.0,0,0,0.0,0.0,0.0
27797.0,6,10,2032,5,524,6533.5,252.0,104.8,5,1508,6299.25,1236.0,301.6
146349.0,6,3,337,2,214,0.0,160.0,107.0,1,123,0.0,123.0,123.0
119466376.0,6,38,2710,19,1408,6637020.888888889,139.0,74.10526315789474,19,1302,6624995.555555556,123.0,68.52631578947368
2375.0,17,4,344,2,150,0.0,75.0,75.0,2,194,0.0,103.0,97.0
119368527.0,6,34,2498,17,1194,7460505.0625,123.0,70.23529411764706,17,1304,6836407.125,139.0,76.70588235294117
147465.0,6,10,1066,5,490,36501.25,218.0,98.0,5,576,36660.5,304.0,115.2
90234642.0,6,16,1192,8,596,12854290.42857143,95.0,74.5,8,596,12859815.857142856,95.0,74.5
44452.0,6,14,4740,7,653,7201.166666666667,249.0,93.28571428571428,7,4087,7105.833333333333,1514.0,583.8571428571429
90937083.0,6,21,1585,11,840,9092971.3,95.0,76.36363636363636,10,745,10103833.777777778,95.0,74.5
5014915.0,17,4,629,2,156,0.0,78.0,78.0,2,473,0.0,268.0,236.5
502394.0,6,5,336,2,134,0.0,68.0,67.0,3,202,193131.5,70.0,67.33333333333333
108104574.0,17,5,1005,5,1005,27026143.5,201.0,201.0,0,0,0.0,0.0,0.0
108107142.0,17,5,955,5,955,27026785.5,191.0,191.0,0,0,0.0,0.0,0.0
207190.0,6,3,426,2,280,0.0,214.0,140.0,1,146,0.0,146.0,146.0
85079.0,6,12,1328,7,797,14179.833333333334,253.0,113.85714285714286,5,531,14549.5,259.0,106.2
207289.0,6,3,426,2,280,0.0,214.0,140.0,1,146,0.0,146.0,146.0
135138818.0,17,6,1146,6,1146,27027763.6,191.0,191.0,0,0,0.0,0.0,0.0
113254740.0,6,46,3036,23,1518,5135435.045454546,66.0,66.0,23,1518,5135427.590909091,66.0,66.0
135162300.0,17,6,1146,6,1146,27032460.0,191.0,191.0,0,0,0.0,0.0,0.0
14434.0,6,11,1133,6,602,2744.0,264.0,100.33333333333331,5,531,2912.25,259.0,106.2
200009.0,17,4,6056,4,6056,66669.66666666667,1514.0,1514.0,0,0,0.0,0.0,0.0
698.0,17,2,156,1,78,0.0,78.0,78.0,1,78,0.0,78.0,78.0
3489794.0,6,162,128709,91,119721,38775.48888888889,1510.0,1315.6153846153843,71,8988,45420.5,1510.0,126.59154929577464
28114.0,6,11,2098,6,590,5622.8,252.0,98.33333333333331,5,1508,6464.0,1236.0,301.6
3128.0,17,2,224,1,76,0.0,76.0,76.0,1,148,0.0,148.0,148.0
577490.0,17,2,346,1,78,0.0,78.0,78.0,1,268,0.0,268.0,268.0
4148.0,17,2,598,1,72,0.0,72.0,72.0,1,526,0.0,526.0,526.0
1179939.0,6,13,3010,8,2382,168562.7142857143,1514.0,297.75,5,628,226086.5,331.0,125.6
314.0,17,2,174,1,79,0.0,79.0,79.0,1,95,0.0,95.0,95.0
110026416.0,17,14,864,7,432,18333496.33333333,174.0,61.71428571428572,7,432,18334158.666666668,174.0,61.71428571428572
19928.0,6,10,1067,5,536,3748.25,264.0,107.2,5,531,3995.75,259.0,106.2
857635.0,6,9,1196,6,725,171527.0,387.0,120.83333333333331,3,471,291047.5,331.0,157.0
90825140.0,6,26,1884,14,1029,6969951.923076923,123.0,73.5,12,855,8237210.636363637,123.0,71.25
23458.0,6,10,2032,5,524,4879.25,252.0,104.8,5,1508,5607.75,1236.0,301.6
209381.0,17,2,180,1,90,0.0,90.0,90.0,1,90,0.0,90.0,90.0
2514.0,17,4,344,2,150,0.0,75.0,75.0,2,194,0.0,103.0,97.0
99394273.0,6,418,51414,209,37398,476821.82692307694,336.0,178.9377990430622,209,14016,476816.2211538461,140.0,67.0622009569378
34059.0,6,14,4740,7,653,5452.833333333333,249.0,93.28571428571428,7,4087,5290.666666666667,1514.0,583.8571428571429
104750817.0,6,44,2904,22,1452,4988134.142857143,66.0,66.0,22,1452,4973392.80952381,66.0,66.0
2801417.0,6,2,132,1,66,0.0,66.0,66.0,1,66,0.0,66.0,66.0
91373251.0,6,22,1680,12,935,8306318.909090909,95.0,77.91666666666667,10,745,10151831.333333334,95.0,74.5
135131774.0,17,6,1206,6,1206,27026354.8,201.0,201.0,0,0,0.0,0.0,0.0
4110.0,17,2,598,1,72,0.0,72.0,72.0,1,526,0.0,526.0,526.0
5624848.0,6,5,336,2,134,0.0,68.0,67.0,3,202,1423511.5,70.0,67.33333333333333
96926531.0,6,786,155746,395,129348,245459.83502538071,1514.0,327.4632911392405,391,26398,247977.4846153846,214.0,67.51406649616368
312088.0,17,4,1400,4,1400,104029.33333333331,350.0,350.0,0,0,0.0,0.0,0.0
15172.0,6,10,2032,5,524,3542.75,252.0,104.8,5,1508,3144.75,1236.0,301.6
280480.0,17,2,363,1,79,0.0,79.0,79.0,1,284,0.0,284.0,284.0
122353.0,6,3,373,2,238,0.0,172.0,119.0,1,135,0.0,135.0,135.0
1771961.0,6,2,132,1,66,0.0,66.0,66.0,1,66,0.0,66.0,66.0
2983.0,17,2,224,1,76,0.0,76.0,76.0,1,148,0.0,148.0,148.0
25749.0,6,14,4740,7,653,4169.166666666667,249.0,93.28571428571428,7,4087,4150.833333333333,1514.0,583.8571428571429
147986.0,17,2,180,1,90,0.0,90.0,90.0,1,90,0.0,90.0,90.0
48493.0,6,13,1479,7,882,8082.166666666667,291.0,126.0,6,597,8427.8,259.0,99.5
196902.0,17,2,180,1,90,0.0,90.0,90.0,1,90,0.0,90.0,90.0
102461.0,17,2,762,2,762,0.0,381.0,381.0,0,0,0.0,0.0,0.0
123418222.0,6,48,3168,24,1584,5095257.347826087,66.0,66.0,24,1584,5206391.347826087,66.0,66.0
119397876.0,6,225,25468,113,7754,1066052.4642857143,140.0,68.61946902654867,112,17714,1066277.009009009,284.0,158.16071428571428
847064.0,6,9,1268,6,797,169412.8,459.0,132.83333333333334,3,471,287308.5,331.0,157.0
58219.0,6,14,4740,7,653,9573.0,249.0,93.28571428571428,7,4087,8313.666666666666,1514.0,583.8571428571429
45437.0,6,14,4740,7,653,7312.5,249.0,93.28571428571428,7,4087,6891.0,1514.0,583.8571428571429
108107989.0,17,5,1005,5,1005,27026997.25,201.0,201.0,0,0,0.0,0.0,0.0
1314390.0,6,4,264,2,132,0.0,66.0,66.0,2,132,0.0,66.0,66.0
205893.0,17,2,180,1,90,0.0,90.0,90.0,1,90,0.0,90.0,90.0
49350.0,6,10,2032,5,524,7380.0,252.0,104.8,5,1508,12065.75,1236.0,301.6
146193.0,6,3,337,2,214,0.0,160.0,107.0,1,123,0.0,123.0,123.0
11401.0,17,4,823,2,163,0.0,89.0,81.5,2,660,0.0,443.0,330.0
26941.0,6,14,4740,7,653,3830.6666666666665,249.0,93.28571428571428,7,4087,4268.666666666667,1514.0,583.8571428571429
228218.0,17,2,180,1,90,0.0,90.0,90.0,1,90,0.0,90.0,90.0
10707.0,17,4,1024,2,163,0.0,89.0,81.5,2,861,0.0,443.0,430.5
90008570.0,6,168,19000,84,13308,1081846.313253012,284.0,158.42857142857142,84,5692,1081847.253012048,140.0,67.76190476190476
108103105.0,17,5,1005,5,1005,27025776.25,201.0,201.0,0,0,0.0,0.0,0.0
105296.0,17,2,700,2,700,0.0,350.0,350.0,0,0,0.0,0.0,0.0
90263245.0,6,13,2036,8,1016,12894749.285714284,188.0,127.0,5,1020,22523873.5,204.0,204.0
119438220.0,6,233,26642,117,18690,1029639.8275862068,374.0,159.74358974358975,116,7952,1029685.495652174,140.0,68.55172413793103
6829.0,17,2,582,1,83,0.0,83.0,83.0,1,499,0.0,499.0,499.0
2740.0,17,2,762,2,762,0.0,381.0,381.0,0,0,0.0,0.0,0.0
3631.0,17,2,363,1,79,0.0,79.0,79.0,1,284,0.0,284.0,284.0
250181.0,6,3,337,2,214,0.0,160.0,107.0,1,123,0.0,123.0,123.0
15021.0,17,2,180,1,90,0.0,90.0,90.0,1,90,0.0,90.0,90.0
437081.0,6,11,1021,6,444,58578.6,162.0,74.0,5,577,73157.25,349.0,115.4
1174821.0,6,13,3010,8,2382,167831.57142857142,1514.0,297.75,5,628,224794.75,331.0,125.6
335.0,17,2,174,1,79,0.0,79.0,79.0,1,95,0.0,95.0,95.0
252231.0,6,3,337,2,214,0.0,160.0,107.0,1,123,0.0,123.0,123.0
205349.0,17,4,6056,4,6056,68449.66666666667,1514.0,1514.0,0,0,0.0,0.0,0.0
114011779.0,6,48,3168,24,1584,4957033.869565218,66.0,66.0,24,1584,4945187.652173913,66.0,66.0
46220.0,6,14,4740,7,653,7456.333333333333,249.0,93.28571428571428,7,4087,7541.166666666667,1514.0,583.8571428571429
352.0,17,2,160,1,80,0.0,80.0,80.0,1,80,0.0,80.0,80.0
23735.0,6,14,4740,7,653,3339.6666666666665,249.0,93.28571428571428,7,4087,3651.0,1514.0,583.8571428571429
102957.0,17,2,286,2,286,0.0,143.0,143.0,0,0,0.0,0.0,0.0
122550500.0,6,49,3234,25,1650,5106270.833333333,66.0,66.0,24,1584,4938466.956521739,66.0,66.0
1294370.0,17,7,490,7,490,215728.3333333333,70.0,70.0,0,0,0.0,0.0,0.0
31813.0,6,14,4740,7,653,5192.5,249.0,93.28571428571428,7,4087,3946.8333333333335,1514.0,583.8571428571429
10485923.0,6,7,478,4,272,3448821.333333333,74.0,68.0,3,206,5173142.0,74.0,68.66666666666667
3566.0,17,2,352,1,72,0.0,72.0,72.0,1,280,0.0,280.0,280.0
421207.0,6,3,1604,1,753,0.0,753.0,753.0,2,851,0.0,785.0,425.5
284332.0,17,2,363,1,79,0.0,79.0,79.0,1,284,0.0,284.0,284.0
80.0,17,2,762,2,762,0.0,381.0,381.0,0,0,0.0,0.0,0.0
113858283.0,6,46,3036,23,1518,5160437.727272728,66.0,66.0,23,1518,5160508.318181818,66.0,66.0
1504.0,17,2,762,2,762,0.0,381.0,381.0,0,0,0.0,0.0,0.0
90216597.0,6,19,1436,9,691,11246131.0,95.0,76.77777777777777,10,745,10000143.666666666,95.0,74.5
33639.0,6,10,2032,5,524,8158.25,252.0,104.8,5,1508,8135.0,1236.0,301.6
304916.0,6,6,412,4,272,101638.66666666669,74.0,68.0,2,140,0.0,74.0,70.0
90259604.0,6,12,1832,8,1016,12894229.142857144,188.0,127.0,4,816,30031546.666666668,204.0,204.0
144793.0,17,2,180,1,70,0.0,70.0,70.0,1,110,0.0,110.0,110.0
47810422.0,6,8,2113,3,960,22639092.5,826.0,320.0,5,1153,11259155.75,885.0,230.6
2792864.0,6,2,132,1,66,0.0,66.0,66.0,1,66,0.0,66.0,66.0
106574.0,17,2,286,2,286,0.0,143.0,143.0,0,0,0.0,0.0,0.0
196955.0,17,2,180,1,90,0.0,90.0,90.0,1,90,0.0,90.0,90.0
311630.0,17,4,1400,4,1400,103876.66666666669,350.0,350.0,0,0,0.0,0.0,0.0
47608447.0,6,8,1940,3,887,22414198.5,753.0,295.6666666666667,5,1053,11206146.25,785.0,210.6
104307.0,17,2,762,2,762,0.0,381.0,381.0,0,0,0.0,0.0,0.0
153353.0,17,2,180,1,90,0.0,90.0,90.0,1,90,0.0,90.0,90.0
31790739.0,6,5,336,2,134,0.0,68.0,67.0,3,202,14602636.5,70.0,67.33333333333333
117164447.0,6,224,25312,112,7688,1048120.9189189188,140.0,68.64285714285714,112,17624,1048111.6486486486,284.0,157.35714285714286
718.0,17,5,550,5,550,179.5,110.0,110.0,0,0,0.0,0.0,0.0
90088579.0,6,11,1644,7,828,15014763.166666666,188.0,118.28571428571428,4,816,20022994.33333333,204.0,204.0
120047875.0,6,33,2280,17,1209,7502992.1875,123.0,71.11764705882354,16,1071,7323189.6,123.0,66.9375
115572758.0,6,214,24270,107,16912,1088279.1226415094,374.0,158.05607476635515,107,7358,1088276.7735849055,140.0,68.76635514018692
233493.0,6,3,337,2,214,0.0,160.0,107.0,1,123,0.0,123.0,123.0
153435.0,17,2,180,1,90,0.0,90.0,90.0,1,90,0.0,90.0,90.0
5826380.0,6,4,270,2,134,0.0,68.0,67.0,2,136,0.0,70.0,68.0
107302.0,17,2,286,2,286,0.0,143.0,143.0,0,0,0.0,0.0,0.0
370.0,17,2,267,1,83,0.0,83.0,83.0,1,184,0.0,184.0,184.0
403586.0,6,4,508,2,238,0.0,172.0,119.0,2,270,0.0,135.0,135.0
135138083.0,17,6,1206,6,1206,27027616.6,201.0,201.0,0,0,0.0,0.0,0.0
13441.0,6,13,1459,7,862,2114.833333333333,271.0,123.14285714285714,6,597,2301.2,259.0,99.5
104058163.0,17,13,821,7,432,17333490.0,174.0,61.71428571428572,6,389,17005810.0,174.0,64.83333333333333
108106619.0,17,5,1005,5,1005,27026654.75,201.0,201.0,0,0,0.0,0.0,0.0
46936.0,6,14,4740,7,653,7178.0,249.0,93.28571428571428,7,4087,7226.166666666667,1514.0,583.8571428571429
2368.0,17,4,344,2,150,0.0,75.0,75.0,2,194,0.0,103.0,97.0
16081.999999999998,6,10,2032,5,524,3809.0,252.0,104.8,5,1508,3718.75,1236.0,301.6
41446.0,6,14,4740,7,653,6715.833333333333,249.0,93.28571428571428,7,4087,6545.0,1514.0,583.8571428571429
37659.0,6,14,4740,7,653,5778.833333333333,249.0,93.28571428571428,7,4087,6093.666666666667,1514.0,583.8571428571429
490289.0,6,3,204,2,136,0.0,70.0,68.0,1,68,0.0,68.0,68.0
325052.0,17,4,1400,4,1400,108350.66666666669,350.0,350.0,0,0,0.0,0.0,0.0
239752.0,6,13,1386,7,789,39958.66666666666,253.0,112.71428571428572,6,597,46552.6,259.0,99.5
68227.0,6,14,4740,7,653,10563.333333333334,249.0,93.28571428571428,7,4087,10807.166666666666,1514.0,583.8571428571429
135135653.0,17,6,1206,6,1206,27027130.6,201.0,201.0,0,0,0.0,0.0,0.0
734.0,17,2,684,2,684,0.0,342.0,342.0,0,0,0.0,0.0,0.0
147996.0,17,2,180,1,90,0.0,90.0,90.0,1,90,0.0,90.0,90.0
300031.0,6,6,412,4,272,100010.33333333331,74.0,68.0,2,140,0.0,74.0,70.0
120010671.0,17,14,864,8,475,17144381.57142857,174.0,59.375,6,389,16200156.8,174.0,64.83333333333333
108104036.0,17,5,1005,5,1005,27026009.0,201.0,201.0,0,0,0.0,0.0,0.0
121326846.0,6,233,26228,117,18276,1045921.0862068966,284.0,156.2051282051282,116,7952,1037226.147826087,140.0,68.55172413793103
930728.0,6,12,1427,6,796,184169.2,271.0,132.66666666666666,6,631,184004.0,293.0,105.16666666666669
284878.0,17,2,363,1,79,0.0,79.0,79.0,1,284,0.0,284.0,284.0
81916.0,6,11,2098,6,590,16150.0,252.0,98.33333333333331,5,1508,2800.25,1236.0,301.6
0.0,17,1,55,1,55,0.0,55.0,55.0,0,0,0.0,0.0,0.0
4695.0,17,2,180,1,90,0.0,90.0,90.0,1,90,0.0,90.0,90.0
90255794.0,6,12,1832,8,1016,12893684.857142856,188.0,127.0,4,816,30025765.666666668,204.0,204.0
2982.0,17,2,224,1,76,0.0,76.0,76.0,1,148,0.0,148.0,148.0
103040122.0,6,43,2838,22,1452,4906660.666666667,66.0,66.0,21,1386,5151993.2,66.0,66.0
220579.0,17,2,180,1,90,0.0,90.0,90.0,1,90,0.0,90.0,90.0
108114104.0,17,5,1005,5,1005,27028526.0,201.0,201.0,0,0,0.0,0.0,0.0
34252.0,6,10,2032,5,524,8320.0,252.0,104.8,5,1508,7626.5,1236.0,301.6
2787980.0,6,2,132,1,66,0.0,66.0,66.0,1,66,0.0,66.0,66.0
43338.0,6,10,2032,5,524,10477.5,252.0,104.8,5,1508,10163.75,1236.0,301.6
318250.0,6,12,1373,7,714,53041.66666666666,298.0,102.0,5,659,75522.25,379.0,131.8
217737.0,6,3,426,2,280,0.0,214.0,140.0,1,146,0.0,146.0,146.0
206437.0,6,3,426,2,280,0.0,214.0,140.0,1,146,0.0,146.0,146.0
100830274.0,17,13,821,7,432,16666802.166666666,174.0,61.71428571428572,6,389,20050408.2,174.0,64.83333333333333
28951.0,6,10,2032,5,524,7014.25,252.0,104.8,5,1508,6794.0,1236.0,301.6
126001381.0,17,15,907,8,475,18000197.285714287,174.0,59.375,7,432,17667562.666666668,174.0,61.71428571428572
163779.0,6,3,337,2,214,0.0,160.0,107.0,1,123,0.0,123.0,123.0
1170039.0,6,13,3009,8,2381,167148.42857142858,1514.0,297.625,5,628,224326.5,331.0,125.6
361.0,17,2,267,1,83,0.0,83.0,83.0,1,184,0.0,184.0,184.0
8438.0,6,11,2098,6,590,1497.0,252.0,98.33333333333331,5,1508,1872.0,1236.0,301.6
241723.0,6,3,337,2,214,0.0,160.0,107.0,1,123,0.0,123.0,123.0
119744658.0,6,222,25106,111,17484,1086631.2272727273,284.0,157.51351351351352,111,7622,1086630.0636363635,140.0,68.66666666666667
15763.0,6,11,2098,6,590,2438.8,252.0,98.33333333333331,5,1508,3664.25,1236.0,301.6
146984.0,6,3,373,2,238,0.0,172.0,119.0,1,135,0.0,135.0,135.0
31248.0,6,10,2032,5,524,7039.75,252.0,104.8,5,1508,7549.25,1236.0,301.6
110550278.0,6,32,2305,16,1140,6704327.333333333,123.0,71.25,16,1165,7369930.733333333,139.0,72.8125
196903.0,17,2,180,1,90,0.0,90.0,90.0,1,90,0.0,90.0,90.0
90558404.0,6,15,2444,8,1016,12936914.857142856,188.0,127.0,7,1428,15066041.0,204.0,204.0
4053.0,17,4,344,2,150,0.0,75.0,75.0,2,194,0.0,103.0,97.0
6921.0,17,2,582,1,83,0.0,83.0,83.0,1,499,0.0,499.0,499.0
16086.0,6,11,2098,6,590,2398.4,252.0,98.33333333333331,5,1508,3770.5,1236.0,301.6
135137910.0,17,6,1206,6,1206,27027582.0,201.0,201.0,0,0,0.0,0.0,0.0
921045.0,6,12,1447,6,816,183399.2,291.0,136.0,6,631,183256.0,293.0,105.16666666666669
120693735.0,6,25,1924,12,935,10972157.727272728,95.0,77.91666666666667,13,989,7537810.833333333,95.0,76.07692307692308
386034.0,6,3,1604,1,753,0.0,753.0,753.0,2,851,0.0,785.0,425.5
257373.00000000003,6,3,337,2,214,0.0,160.0,107.0,1,123,0.0,123.0,123.0
198667.0,17,2,180,1,90,0.0,90.0,90.0,1,90,0.0,90.0,90.0
108118947.0,17,5,955,5,955,27029736.75,191.0,191.0,0,0,0.0,0.0,0.0
1283949.0,17,7,490,7,490,213991.5,70.0,70.0,0,0,0.0,0.0,0.0
208730.0,6,10,1221,6,636,41746.0,298.0,106.0,4,585,68369.0,379.0,146.25
43653.0,6,14,4740,7,653,7151.5,249.0,93.28571428571428,7,4087,7135.333333333333,1514.0,583.8571428571429
299913.0,6,6,412,4,272,99971.0,74.0,68.0,2,140,0.0,74.0,70.0
120136168.0,6,633,89646,317,21218,380177.746835443,140.0,66.93375394321767,316,68428,380619.26031746034,570.0,216.5443037974684
2050243.0,17,8,1640,4,312,683285.0,78.0,78.0,4,1328,683275.3333333333,332.0,332.0
311879.0,17,4,1400,4,1400,103959.66666666669,350.0,350.0,0,0,0.0,0.0,0.0
220001.0,6,3,426,2,280,0.0,214.0,140.0,1,146,0.0,146.0,146.0
835.0,17,4,438,2,148,0.0,74.0,74.0,2,290,0.0,147.0,145.0
955104.0,6,10,1334,6,797,191020.8,459.0,132.83333333333334,4,537,226631.0,331.0,134.25
213721.0,17,2,180,1,90,0.0,90.0,90.0,1,90,0.0,90.0,90.0
149973760.0,17,36,17126,36,17126,4284964.571428572,501.0,475.72222222222223,0,0,0.0,0.0,0.0
305341.0,6,6,412,4,272,101780.33333333331,74.0,68.0,2,140,0.0,74.0,70.0
33318.0,6,14,4740,7,653,5361.5,249.0,93.28571428571428,7,4087,5128.0,1514.0,583.8571428571429
104287.0,17,2,700,2,700,0.0,350.0,350.0,0,0,0.0,0.0,0.0
213798.0,17,2,180,1,90,0.0,90.0,90.0,1,90,0.0,90.0,90.0
104742723.0,17,14,864,7,432,17333513.166666668,174.0,61.71428571428572,7,432,17334974.333333332,174.0,61.71428571428572
2367480.0,6,3,1602,2,850,0.0,784.0,425.0,1,752,0.0,752.0,752.0
310767.0,17,4,622,4,622,103589.0,163.0,155.5,0,0,0.0,0.0,0.0
2510173.0,6,25,7573,14,3735,193090.2307692308,1514.0,266.7857142857143,11,3838,225064.0,1514.0,348.90909090909093
31033.0,6,11,1131,6,600,5855.4,262.0,100.0,5,531,7468.75,259.0,106.2
1244128.0,17,7,490,7,490,207354.66666666663,70.0,70.0,0,0,0.0,0.0,0.0
153494.0,17,2,180,1,90,0.0,90.0,90.0,1,90,0.0,90.0,90.0
216488.0,17,2,180,1,90,0.0,90.0,90.0,1,90,0.0,90.0,90.0
119810359.0,17,16,1212,8,606,17092776.14285714,174.0,75.75,8,606,17039845.57142857,174.0,75.75
148012.0,17,2,180,1,90,0.0,90.0,90.0,1,90,0.0,90.0,90.0
111569.0,17,4,1400,4,1400,37189.66666666666,350.0,350.0,0,0,0.0,0.0,0.0
81.0,17,2,762,2,762,0.0,381.0,381.0,0,0,0.0,0.0,0.0
847272.0,6,9,1118,6,586,169454.4,248.0,97.66666666666669,3,532,285821.5,392.0,177.33333333333334
208773.0,6,3,426,2,280,0.0,214.0,140.0,1,146,0.0,146.0,146.0
205978.0,6,3,426,2,280,0.0,214.0,140.0,1,146,0.0,146.0,146.0
10474963.0,6,7,478,4,272,3446293.0,74.0,68.0,3,206,5169311.5,74.0,68.66666666666667
31381.0,6,14,4740,7,653,2247.333333333333,249.0,93.28571428571428,7,4087,5065.0,1514.0,583.8571428571429
95679808.0,17,13,4454,12,4104,6793972.727272728,342.0,342.0,1,350,0.0,350.0,350.0
18900.0,6,11,1131,6,600,3518.4,262.0,100.0,5,531,4408.0,259.0,106.2
90258614.0,6,12,1832,8,1016,12894087.714285716,188.0,127.0,4,816,30031103.33333333,204.0,204.0
2036963.0,6,24,6964,12,1933,185178.45454545456,483.0,161.08333333333334,12,5031,157068.72727272726,1510.0,419.25
108113910.0,17,5,1005,5,1005,27028477.5,201.0,201.0,0,0,0.0,0.0,0.0
103263.0,17,2,286,2,286,0.0,143.0,143.0,0,0,0.0,0.0,0.0
1309958.0,6,4,264,2,132,0.0,66.0,66.0,2,132,0.0,66.0,66.0
135123889.0,17,6,1206,6,1206,27024777.8,201.0,201.0,0,0,0.0,0.0,0.0
22761.0,17,2,582,1,83,0.0,83.0,83.0,1,499,0.0,499.0,499.0
209472.0,17,2,180,1,90,0.0,90.0,90.0,1,90,0.0,90.0,90.0
66799.0,6,14,4740,7,653,10580.333333333334,249.0,93.28571428571428,7,4087,10451.666666666666,1514.0,583.8571428571429
156329.0,17,2,180,1,90,0.0,90.0,90.0,1,90,0.0,90.0,90.0
213077.0,17,2,762,2,762,0.0,381.0,381.0,0,0,0.0,0.0,0.0
90258704.0,6,13,2036,8,1016,12894100.57142857,188.0,127.0,5,1020,22523756.5,204.0,204.0
135135304.0,17,6,1206,6,1206,27027060.8,201.0,201.0,0,0,0.0,0.0,0.0
823887.0,6,6,758,3,410,404464.5,172.0,136.66666666666666,3,348,292060.5,135.0,116.0
14037.0,17,2,166,1,75,0.0,75.0,75.0,1,91,0.0,91.0,91.0
120383070.0,6,328,38042,164,11046,734899.3435582822,140.0,67.35365853658537,164,26996,738390.0122699386,284.0,164.609756097561
3044450.0,6,3,204,1,68,0.0,68.0,68.0,2,136,0.0,70.0,68.0
121281303.0,6,212,23852,106,7292,1137511.638095238,140.0,68.79245283018868,106,16560,1147241.4285714286,284.0,156.2264150943396
90259746.0,6,12,1832,8,1016,12894249.42857143,188.0,127.0,4,816,30031334.666666668,204.0,204.0
130858.0,6,2,132,1,66,0.0,66.0,66.0,1,66,0.0,66.0,66.0
29800.0,6,10,2032,5,524,7146.25,252.0,104.8,5,1508,5395.5,1236.0,301.6
82014.0,6,14,4740,7,653,10327.666666666666,249.0,93.28571428571428,7,4087,11394.166666666666,1514.0,583.8571428571429
122222046.0,6,39,2908,21,1591,6111102.3,139.0,75.76190476190476,18,1317,6589920.05882353,123.0,73.16666666666667
330486.0,6,6,412,4,272,110162.0,74.0,68.0,2,140,0.0,74.0,70.0
32265.000000000004,6,14,4740,7,653,4759.5,249.0,93.28571428571428,7,4087,5236.0,1514.0,583.8571428571429
234400.0,6,3,426,2,280,0.0,214.0,140.0,1,146,0.0,146.0,146.0
271807.0,6,10,1221,6,636,54361.4,298.0,106.0,4,585,84823.66666666667,379.0,146.25
51181.0,17,2,180,1,90,0.0,90.0,90.0,1,90,0.0,90.0,90.0
720.0,17,2,762,2,762,0.0,381.0,381.0,0,0,0.0,0.0,0.0
90062086.0,17,28,13364,28,13364,3335632.814814815,501.0,477.2857142857143,0,0,0.0,0.0,0.0
397957.0,6,3,1604,2,851,0.0,785.0,425.5,1,753,0.0,753.0,753.0
120053918.0,6,230,26062,115,7812,1046953.9122807018,140.0,67.9304347826087,115,18250,1037845.596491228,336.0,158.69565217391303
305929.0,6,6,412,4,272,101976.33333333331,74.0,68.0,2,140,0.0,74.0,70.0
143885.0,17,2,180,1,90,0.0,90.0,90.0,1,90,0.0,90.0,90.0
120777438.0,6,233,26372,117,18420,1041184.8103448276,284.0,157.43589743589743,116,7952,1038604.895652174,140.0,68.55172413793103
120082667.0,17,28,13364,28,13364,4447506.185185186,501.0,477.2857142857143,0,0,0.0,0.0,0.0
305360.0,6,6,412,4,272,101786.66666666669,74.0,68.0,2,140,0.0,74.0,70.0
17844.0,6,2,145,2,145,0.0,91.0,72.5,0,0,0.0,0.0,0.0
108120692.0,17,5,1005,5,1005,27030173.0,201.0,201.0,0,0,0.0,0.0,0.0
52105.0,6,14,4740,7,653,8256.0,249.0,93.28571428571428,7,4087,7798.333333333333,1514.0,583.8571428571429
302397.0,6,2,132,1,66,0.0,66.0,66.0,1,66,0.0,66.0,66.0
2024.0,17,4,344,2,150,0.0,75.0,75.0,2,194,0.0,103.0,97.0
2385445.0,6,49,23728,25,19797,99393.54166666669,1514.0,791.88,24,3931,93982.43478260867,1514.0,163.79166666666666
36897.0,6,14,4740,7,653,6040.5,249.0,93.28571428571428,7,4087,4507.666666666667,1514.0,583.8571428571429
22550.0,6,14,4740,7,653,3547.6666666666665,249.0,93.28571428571428,7,4087,3618.1666666666665,1514.0,583.8571428571429
120271.0,17,2,180,1,70,0.0,70.0,70.0,1,110,0.0,110.0,110.0
3131305.0,6,3,1602,2,850,0.0,784.0,425.0,1,752,0.0,752.0,752.0
14888.0,17,2,180,1,90,0.0,90.0,90.0,1,90,0.0,90.0,90.0
51110.0,17,2,180,1,90,0.0,90.0,90.0,1,90,0.0,90.0,90.0
9545.0,17,2,582,1,83,0.0,83.0,83.0,1,499,0.0,499.0,499.0
216839.0,17,2,180,1,90,0.0,90.0,90.0,1,90,0.0,90.0,90.0
201694.0,17,2,180,1,90,0.0,90.0,90.0,1,90,0.0,90.0,90.0
207214.0,6,3,426,2,280,0.0,214.0,140.0,1,146,0.0,146.0,146.0
196897.0,17,2,180,1,90,0.0,90.0,90.0,1,90,0.0,90.0,90.0
2004079.0,17,4,525,2,150,0.0,75.0,75.0,2,375,0.0,284.0,187.5
1806.0,17,2,664,1,322,0.0,322.0,322.0,1,342,0.0,342.0,342.0
2473.0,17,4,344,2,150,0.0,75.0,75.0,2,194,0.0,103.0,97.0
41636.0,6,14,4740,7,653,6654.833333333333,249.0,93.28571428571428,7,4087,5784.333333333333,1514.0,583.8571428571429
26167.0,6,14,4740,7,653,3003.6666666666665,249.0,93.28571428571428,7,4087,4224.166666666667,1514.0,583.8571428571429
16421174.0,6,27,9227,15,2193,1172941.0,408.0,146.2,12,7034,1117494.818181818,1514.0,586.1666666666666
49250.0,6,14,4740,7,653,7589.0,249.0,93.28571428571428,7,4087,7713.5,1514.0,583.8571428571429
1307053.0,6,4,264,2,132,0.0,66.0,66.0,2,132,0.0,66.0,66.0
302468.0,6,2,132,1,66,0.0,66.0,66.0,1,66,0.0,66.0,66.0
133130.0,6,2,132,1,66,0.0,66.0,66.0,1,66,0.0,66.0,66.0
219561.0,6,3,426,2,280,0.0,214.0,140.0,1,146,0.0,146.0,146.0
1385138.0,6,4,276,2,128,0.0,74.0,64.0,2,148,0.0,74.0,74.0
95631.0,6,14,4740,7,653,13169.666666666666,249.0,93.28571428571428,7,4087,15206.5,1514.0,583.8571428571429
755.0,17,4,438,2,148,0.0,74.0,74.0,2,290,0.0,147.0,145.0
27347065.0,17,5,1710,5,1710,6836766.25,342.0,342.0,0,0,0.0,0.0,0.0
31050.0,6,14,4740,7,653,4659.166666666667,249.0,93.28571428571428,7,4087,4886.166666666667,1514.0,583.8571428571429
50739.0,17,2,180,1,90,0.0,90.0,90.0,1,90,0.0,90.0,90.0
28402.0,6,10,1065,5,534,6570.25,262.0,106.8,5,531,5426.5,259.0,106.2
95242649.0,6,26,1762,13,922,7918025.25,139.0,70.92307692307692,13,840,7917871.333333333,123.0,64.61538461538461
148014.0,17,2,180,1,90,0.0,90.0,90.0,1,90,0.0,90.0,90.0
108112245.0,17,5,1005,5,1005,27028061.25,201.0,201.0,0,0,0.0,0.0,0.0
18978.0,6,14,4740,7,653,2706.5,249.0,93.28571428571428,7,4087,3016.333333333333,1514.0,583.8571428571429
178670.0,17,4,1524,4,1524,59556.66666666666,381.0,381.0,0,0,0.0,0.0,0.0
108108773.0,17,5,1005,5,1005,27027193.25,201.0,201.0,0,0,0.0,0.0,0.0
34365.0,6,14,4740,7,653,5601.166666666667,249.0,93.28571428571428,7,4087,5515.5,1514.0,583.8571428571429
45844.0,6,14,4740,7,653,6985.0,249.0,93.28571428571428,7,4087,7417.166666666667,1514.0,583.8571428571429
2592182.0,6,2,132,1,66,0.0,66.0,66.0,1,66,0.0,66.0,66.0
121405.0,6,3,337,2,214,0.0,160.0,107.0,1,123,0.0,123.0,123.0
323612.0,17,4,1400,4,1400,107870.66666666669,350.0,350.0,0,0,0.0,0.0,0.0
245501.0,6,3,337,2,214,0.0,160.0,107.0,1,123,0.0,123.0,123.0
302401.0,6,2,132,1,66,0.0,66.0,66.0,1,66,0.0,66.0,66.0
117054.0,17,4,1400,4,1400,39018.0,350.0,350.0,0,0,0.0,0.0,0.0
120375944.0,6,235,26684,118,18666,1028854.2222222222,284.0,158.1864406779661,117,8018,1028766.4655172414,140.0,68.52991452991454
827.0,17,4,438,2,148,0.0,74.0,74.0,2,290,0.0,147.0,145.0
126261082.0,17,16,1212,8,606,15281402.142857144,174.0,75.75,8,606,17352445.285714287,174.0,75.75
206097.0,6,3,426,2,280,0.0,214.0,140.0,1,146,0.0,146.0,146.0
0.0,17,1,453,1,453,0.0,453.0,453.0,0,0,0.0,0.0,0.0
51586.0,6,10,1066,5,490,10545.0,218.0,98.0,5,576,12608.5,304.0,115.2
135130258.0,17,6,1206,6,1206,27026051.6,201.0,201.0,0,0,0.0,0.0,0.0
5623195.0,6,5,336,2,134,0.0,68.0,67.0,3,202,1528817.0,70.0,67.33333333333333
329.0,17,2,208,1,72,0.0,72.0,72.0,1,136,0.0,136.0,136.0
370207.0,6,12,1373,7,714,61701.16666666666,298.0,102.0,5,659,91876.75,379.0,131.8
135129807.0,17,6,1146,6,1146,27025961.4,191.0,191.0,0,0,0.0,0.0,0.0
120122903.0,6,15,2428,9,1204,15015362.875,188.0,133.77777777777777,6,1224,18072228.2,204.0,204.0
14870.0,6,11,1132,6,556,2350.2,218.0,92.66666666666669,5,576,3503.5,304.0,115.2
4274.0,17,2,598,1,72,0.0,72.0,72.0,1,526,0.0,526.0,526.0
2812485.0,6,2,132,1,66,0.0,66.0,66.0,1,66,0.0,66.0,66.0
6622.0,17,2,582,1,83,0.0,83.0,83.0,1,499,0.0,499.0,499.0
101268.0,17,2,762,2,762,0.0,381.0,381.0,0,0,0.0,0.0,0.0
299633.0,6,6,412,4,272,99877.66666666669,74.0,68.0,2,140,0.0,74.0,70.0
38553.0,6,14,4740,7,653,4502.333333333333,249.0,93.28571428571428,7,4087,6283.833333333333,1514.0,583.8571428571429
233474.0,6,3,373,2,238,0.0,172.0,119.0,1,135,0.0,135.0,135.0
90259279.0,6,14,2240,8,1016,12894182.714285716,188.0,127.0,6,1224,18018511.0,204.0,204.0
325791.0,6,10,1221,6,636,65158.2,298.0,106.0,4,585,107465.33333333331,379.0,146.25
108100650.0,17,5,955,5,955,27025162.5,191.0,191.0,0,0,0.0,0.0,0.0
209484.0,17,2,180,1,90,0.0,90.0,90.0,1,90,0.0,90.0,90.0
112464303.0,6,46,3036,23,1518,5112002.363636363,66.0,66.0,23,1518,5112002.545454546,66.0,66.0
2422.0,17,4,344,2,150,0.0,75.0,75.0,2,194,0.0,103.0,97.0
2284.0,17,4,344,2,150,0.0,75.0,75.0,2,194,0.0,103.0,97.0
302316.0,6,6,412,4,272,100772.0,74.0,68.0,2,140,0.0,74.0,70.0
197385.0,17,2,180,1,90,0.0,90.0,90.0,1,90,0.0,90.0,90.0
48383203.0,6,8,1307,8,1307,6911886.142857143,172.0,163.375,0,0,0.0,0.0,0.0
3007483.0,6,11,2106,6,598,601316.2,252.0,99.66666666666669,5,1508,2374.25,1236.0,301.6
108335675.0,17,7,1512,6,1206,21667135.0,201.0,201.0,1,306,0.0,306.0,306.0
162340.0,17,2,180,1,90,0.0,90.0,90.0,1,90,0.0,90.0,90.0
120740450.0,6,33,2296,17,1225,7546278.125,139.0,72.05882352941177,16,1071,7370034.466666667,123.0,66.9375
90041169.0,17,28,13364,28,13364,3334858.111111111,501.0,477.2857142857143,0,0,0.0,0.0,0.0
125005507.0,17,15,1169,8,606,17857929.57142857,174.0,75.75,7,563,17500272.166666668,174.0,80.42857142857143
135131807.0,17,6,1146,6,1146,27026361.4,191.0,191.0,0,0,0.0,0.0,0.0
120146969.0,6,224,25200,112,7688,1075133.225225225,140.0,68.64285714285714,112,17512,1075131.7477477477,284.0,156.35714285714286
10488045.0,6,7,478,4,272,3450532.0,74.0,68.0,3,206,5175687.0,74.0,68.66666666666667
1298557.0,6,4,264,2,132,0.0,66.0,66.0,2,132,0.0,66.0,66.0
108104978.0,17,5,955,5,955,27026244.5,191.0,191.0,0,0,0.0,0.0,0.0
146374.0,6,3,337,2,214,0.0,160.0,107.0,1,123,0.0,123.0,123.0
9863.0,17,2,582,1,83,0.0,83.0,83.0,1,499,0.0,499.0,499.0
2459869.0,6,3,1777,2,951,0.0,885.0,475.5,1,826,0.0,826.0,826.0
247207.0,6,3,337,2,214,0.0,160.0,107.0,1,123,0.0,123.0,123.0
2971859.0,6,148,113957,82,105299,36689.61728395062,1510.0,1284.1341463414635,66,8658,40975.18461538461,1510.0,131.1818181818182
367793.0,6,10,1221,6,636,73558.6,298.0,106.0,4,585,121316.0,379.0,146.25
10462050.0,6,7,478,4,272,3442164.0,74.0,68.0,3,206,5163165.5,74.0,68.66666666666667
90097925.0,6,12,1848,5,1020,22523605.25,204.0,204.0,7,828,15015936.5,188.0,118.28571428571428
300937.0,6,6,412,4,272,100312.33333333331,74.0,68.0,2,140,0.0,74.0,70.0
108131426.0,17,5,1005,5,1005,27032856.5,201.0,201.0,0,0,0.0,0.0,0.0
313.0,17,2,174,1,79,0.0,79.0,79.0,1,95,0.0,95.0,95.0
26474.0,6,10,2032,5,524,5472.25,252.0,104.8,5,1508,6350.75,1236.0,301.6
90301883.0,6,16,1192,8,596,12893111.857142856,95.0,74.5,8,596,12899373.714285716,95.0,74.5
331645.0,6,6,412,4,272,110548.33333333331,74.0,68.0,2,140,0.0,74.0,70.0
120091240.0,17,28,13364,28,13364,4447823.703703703,501.0,477.2857142857143,0,0,0.0,0.0,0.0
196797.0,17,2,180,1,90,0.0,90.0,90.0,1,90,0.0,90.0,90.0
171548.0,17,2,180,1,90,0.0,90.0,90.0,1,90,0.0,90.0,90.0
155296.0,6,3,337,2,214,0.0,160.0,107.0,1,123,0.0,123.0,123.0
27218.0,17,2,180,1,90,0.0,90.0,90.0,1,90,0.0,90.0,90.0
16409.0,6,10,2032,5,524,3632.0,252.0,104.8,5,1508,3676.0,1236.0,301.6
307040.0,6,6,412,4,272,102346.66666666669,74.0,68.0,2,140,0.0,74.0,70.0
36645.0,6,10,2032,5,524,8322.25,252.0,104.8,5,1508,8084.0,1236.0,301.6
31493.0,6,10,2032,5,524,7638.25,252.0,104.8,5,1508,6925.5,1236.0,301.6
91259406.0,17,14,1126,7,563,15167126.0,174.0,80.42857142857143,7,563,15166801.5,174.0,80.42857142857143
223552.0,6,3,426,2,280,0.0,214.0,140.0,1,146,0.0,146.0,146.0
101924.0,17,2,762,2,762,0.0,381.0,381.0,0,0,0.0,0.0,0.0
107563.0,17,2,286,2,286,0.0,143.0,143.0,0,0,0.0,0.0,0.0
120152221.0,6,14,2240,6,1224,24030444.2,204.0,204.0,8,1016,17137435.42857143,188.0,127.0
63724.0,6,14,4740,7,653,4565.333333333333,249.0,93.28571428571428,7,4087,10267.166666666666,1514.0,583.8571428571429
280148.0,17,2,180,1,90,0.0,90.0,90.0,1,90,0.0,90.0,90.0
308266.0,6,6,412,4,272,102755.33333333331,74.0,68.0,2,140,0.0,74.0,70.0
58567.0,6,14,4740,7,653,9563.166666666666,249.0,93.28571428571428,7,4087,6759.666666666667,1514.0,583.8571428571429
90081865.0,17,28,13364,28,13364,3336365.3703703703,501.0,477.2857142857143,0,0,0.0,0.0,0.0
1320715.0,6,4,264,2,132,0.0,66.0,66.0,2,132,0.0,66.0,66.0
90563534.0,6,26,1746,13,906,7528973.583333333,123.0,69.6923076923077,13,840,7528947.166666667,123.0,64.61538461538461
841.0,17,4,438,2,148,0.0,74.0,74.0,2,290,0.0,147.0,145.0
6735.0,17,2,582,1,83,0.0,83.0,83.0,1,499,0.0,499.0,499.0
302232.0,6,6,412,4,272,100744.0,74.0,68.0,2,140,0.0,74.0,70.0
46220.0,6,14,4740,7,653,7430.0,249.0,93.28571428571428,7,4087,7132.0,1514.0,583.8571428571429
100724782.0,17,12,516,6,258,20001024.6,43.0,43.0,6,258,20000159.6,43.0,43.0
806.0,17,4,438,2,148,0.0,74.0,74.0,2,290,0.0,147.0,145.0
24924.0,6,14,4740,7,653,3265.6666666666665,249.0,93.28571428571428,7,4087,4017.6666666666665,1514.0,583.8571428571429
403961.0,6,4,508,2,238,0.0,172.0,119.0,2,270,0.0,135.0,135.0
122159.0,6,3,373,2,238,0.0,172.0,119.0,1,135,0.0,135.0,135.0
2443.0,17,4,344,2,150,0.0,75.0,75.0,2,194,0.0,103.0,97.0
225182.0,17,2,414,1,88,0.0,88.0,88.0,1,326,0.0,326.0,326.0
217913.0,6,3,426,2,280,0.0,214.0,140.0,1,146,0.0,146.0,146.0
90030702.0,17,28,13364,28,13364,3334470.4444444445,501.0,477.2857142857143,0,0,0.0,0.0,0.0
36128.0,6,14,4740,7,653,5333.333333333333,249.0,93.28571428571428,7,4087,5767.0,1514.0,583.8571428571429
112195482.0,6,32,2220,16,1149,7465293.0,123.0,71.8125,16,1071,7465303.4,123.0,66.9375
105528389.0,17,14,864,7,432,17500154.166666668,174.0,61.71428571428572,7,432,17501048.833333332,174.0,61.71428571428572
4201.0,17,2,614,1,72,0.0,72.0,72.0,1,542,0.0,542.0,542.0
314643.0,6,6,412,4,272,104881.0,74.0,68.0,2,140,0.0,74.0,70.0
206355.0,6,3,426,2,280,0.0,214.0,140.0,1,146,0.0,146.0,146.0
995.0,17,4,438,2,148,0.0,74.0,74.0,2,290,0.0,147.0,145.0
14035.0,6,10,2032,5,524,3268.0,252.0,104.8,5,1508,3267.0,1236.0,301.6
120125681.0,6,13,2020,9,1204,15015710.125,188.0,133.77777777777777,4,816,30031668.666666668,204.0,204.0
90058297.0,17,28,13364,28,13364,3335492.4814814813,501.0,477.2857142857143,0,0,0.0,0.0,0.0
28320.0,6,14,4740,7,653,4490.833333333333,249.0,93.28571428571428,7,4087,4174.0,1514.0,583.8571428571429
11870.0,17,4,823,2,163,0.0,89.0,81.5,2,660,0.0,443.0,330.0
15029765.0,17,6,2718,6,2718,3005953.0,453.0,453.0,0,0,0.0,0.0,0.0
5614445.0,6,5,336,2,134,0.0,68.0,67.0,3,202,1526463.0,70.0,67.33333333333333
3419.0,17,2,414,1,88,0.0,88.0,88.0,1,326,0.0,326.0,326.0
539262.0,17,6,2100,6,2100,107852.4,350.0,350.0,0,0,0.0,0.0,0.0
3010072.0,6,12,2172,7,664,501613.8333333333,252.0,94.85714285714286,5,1508,3116.0,1236.0,301.6
226125.0,6,3,426,2,280,0.0,214.0,140.0,1,146,0.0,146.0,146.0
306.0,17,2,168,1,76,0.0,76.0,76.0,1,92,0.0,92.0,92.0
58157.0,6,14,4740,7,653,9500.0,249.0,93.28571428571428,7,4087,9506.0,1514.0,583.8571428571429
135124567.0,17,6,1146,6,1146,27024913.4,191.0,191.0,0,0,0.0,0.0,0.0
5614629.0,6,4,270,2,134,0.0,68.0,67.0,2,136,0.0,70.0,68.0
453.0,17,2,508,2,508,0.0,257.0,254.0,0,0,0.0,0.0,0.0
246150.0,6,3,337,2,214,0.0,160.0,107.0,1,123,0.0,123.0,123.0
1101952.0,6,13,1394,7,797,183658.66666666663,253.0,113.85714285714286,6,597,217961.4,259.0,99.5
313194.0,17,4,1400,4,1400,104398.0,350.0,350.0,0,0,0.0,0.0,0.0
108109260.0,17,5,1005,5,1005,27027315.0,201.0,201.0,0,0,0.0,0.0,0.0
40210.0,6,14,4740,7,653,6459.166666666667,249.0,93.28571428571428,7,4087,6089.333333333333,1514.0,583.8571428571429
1170148.0,6,13,3001,8,2373,167164.0,1514.0,296.625,5,628,224396.25,331.0,125.6
2383.0,17,4,344,2,150,0.0,75.0,75.0,2,194,0.0,103.0,97.0
37877.0,6,14,4740,7,653,6204.0,249.0,93.28571428571428,7,4087,4540.333333333333,1514.0,583.8571428571429
47206.0,6,14,4740,7,653,7277.0,249.0,93.28571428571428,7,4087,7638.5,1514.0,583.8571428571429
2345497.0,6,49,23728,25,19797,97729.04166666669,1514.0,791.88,24,3931,92275.73913043478,1514.0,163.79166666666666
90043325.0,17,27,12943,27,12943,3463204.8076923075,501.0,479.3703703703704,0,0,0.0,0.0,0.0
9118385.0,17,3,1034,2,684,0.0,342.0,342.0,1,350,0.0,350.0,350.0
2352.0,17,4,344,2,150,0.0,75.0,75.0,2,194,0.0,103.0,97.0
27868.0,6,14,4740,7,653,4426.5,249.0,93.28571428571428,7,4087,4196.833333333333,1514.0,583.8571428571429
93983065.0,6,40,2640,20,1320,4946477.105263158,66.0,66.0,20,1320,4929920.736842105,66.0,66.0
90255088.0,6,13,2036,8,1016,12893584.0,188.0,127.0,5,1020,22522665.25,204.0,204.0
51967.0,17,2,582,1,83,0.0,83.0,83.0,1,499,0.0,499.0,499.0
103269.0,17,2,286,2,286,0.0,143.0,143.0,0,0,0.0,0.0,0.0
101726361.0,6,192,21664,96,6558,1061934.7894736845,140.0,68.3125,96,15106,1063385.0842105264,284.0,157.35416666666666
27184.0,6,14,4740,7,653,4000.1666666666665,249.0,93.28571428571428,7,4087,4009.8333333333335,1514.0,583.8571428571429
17191.0,17,2,180,1,90,0.0,90.0,90.0,1,90,0.0,90.0,90.0
90296661.0,6,14,2102,8,1016,12899523.0,188.0,127.0,6,1086,18026515.6,204.0,181.0
113069771.0,6,30,1974,15,1026,8061756.928571428,123.0,68.4,15,948,8061756.642857143,123.0,63.2
153453.0,17,2,180,1,90,0.0,90.0,90.0,1,90,0.0,90.0,90.0
298408.0,6,6,412,4,272,99469.33333333331,74.0,68.0,2,140,0.0,74.0,70.0
247185.0,17,4,6056,4,6056,82395.0,1514.0,1514.0,0,0,0.0,0.0,0.0
108101875.0,17,5,1005,5,1005,27025468.75,201.0,201.0,0,0,0.0,0.0,0.0
5634404.0,6,5,1736,3,917,1420426.5,785.0,305.6666666666667,2,819,0.0,753.0,409.5
31608.0,6,14,4740,7,653,5137.5,249.0,93.28571428571428,7,4087,5127.5,1514.0,583.8571428571429
22955.0,6,10,2032,5,524,5501.5,252.0,104.8,5,1508,5167.25,1236.0,301.6
135130284.0,17,6,1146,6,1146,27026056.8,191.0,191.0,0,0,0.0,0.0,0.0
107001310.0,17,13,821,7,432,17833551.666666668,174.0,61.71428571428572,6,389,17401321.4,174.0,64.83333333333333
326.0,17,2,166,1,75,0.0,75.0,75.0,1,91,0.0,91.0,91.0
335586.0,17,2,180,1,90,0.0,90.0,90.0,1,90,0.0,90.0,90.0
316647.0,17,4,1400,4,1400,105549.0,350.0,350.0,0,0,0.0,0.0,0.0
120236255.0,6,317,35892,159,25242,760988.9556962026,284.0,158.75471698113208,158,10650,761405.3184713376,140.0,67.40506329113924
1243958.0,6,7,499,4,301,395290.3333333333,103.0,75.25,3,198,614494.0,66.0,66.0
102313.0,17,2,286,2,286,0.0,143.0,143.0,0,0,0.0,0.0,0.0
32965.0,6,14,4740,7,653,5097.5,249.0,93.28571428571428,7,4087,5301.5,1514.0,583.8571428571429
2413.0,17,4,344,2,150,0.0,75.0,75.0,2,194,0.0,103.0,97.0
90274743.0,6,16,1192,8,596,12890634.0,95.0,74.5,8,596,12894996.0,95.0,74.5
2307.0,17,4,344,2,150,0.0,75.0,75.0,2,194,0.0,103.0,97.0
120016749.0,17,28,13364,28,13364,4445064.777777778,501.0,477.2857142857143,0,0,0.0,0.0,0.0
21183.0,6,10,1066,5,490,3516.5,218.0,98.0,5,576,4306.5,304.0,115.2
39770.0,6,10,2032,5,524,9591.25,252.0,104.8,5,1508,9479.5,1236.0,301.6
232197.0,6,3,337,2,214,0.0,160.0,107.0,1,123,0.0,123.0,123.0
135131170.0,17,6,1206,6,1206,27026234.0,201.0,201.0,0,0,0.0,0.0,0.0
138001517.0,17,15,907,8,475,19714502.42857143,174.0,59.375,7,432,19681671.33333333,174.0,61.71428571428572
50961.0,6,2,132,1,66,0.0,66.0,66.0,1,66,0.0,66.0,66.0
40220.0,6,14,4740,7,653,5954.833333333333,249.0,93.28571428571428,7,4087,6460.5,1514.0,583.8571428571429
502866.00000000006,6,5,336,2,134,0.0,68.0,67.0,3,202,176809.0,70.0,67.33333333333333
299108.0,6,6,412,4,272,99702.66666666669,74.0,68.0,2,140,0.0,74.0,70.0
33093.0,6,14,4740,7,653,5266.5,249.0,93.28571428571428,7,4087,5381.166666666667,1514.0,583.8571428571429
27990.0,6,13,1386,7,789,4362.0,253.0,112.71428571428572,6,597,4341.0,259.0,99.5
748459.0,6,2,132,1,66,0.0,66.0,66.0,1,66,0.0,66.0,66.0
90036865.0,17,28,13364,28,13364,3334698.703703704,501.0,477.2857142857143,0,0,0.0,0.0,0.0
213666.0,17,2,180,1,90,0.0,90.0,90.0,1,90,0.0,90.0,90.0
153414.0,17,2,180,1,90,0.0,90.0,90.0,1,90,0.0,90.0,90.0
245322.0,6,3,337,2,214,0.0,160.0,107.0,1,123,0.0,123.0,123.0
14638673.0,6,20,1607,10,975,1592830.4444444445,315.0,97.5,10,632,1592802.888888889,78.0,63.2
327704.0,17,4,1400,4,1400,109234.66666666669,350.0,350.0,0,0,0.0,0.0,0.0
205799.0,17,2,180,1,90,0.0,90.0,90.0,1,90,0.0,90.0,90.0
207111.0,6,3,426,2,280,0.0,214.0,140.0,1,146,0.0,146.0,146.0
2577506.0,6,5,367,3,235,1288753.0,103.0,78.33333333333333,2,132,0.0,66.0,66.0
1302558.0,6,4,264,2,132,0.0,66.0,66.0,2,132,0.0,66.0,66.0
307060.0,6,6,412,4,272,102353.33333333331,74.0,68.0,2,140,0.0,74.0,70.0
992170.0,17,5,961,3,234,495896.0,78.0,78.0,2,727,0.0,395.0,363.5
208222.0,6,4,492,2,280,0.0,214.0,140.0,2,212,0.0,146.0,106.0
96715192.0,6,62,12587,30,6551,3335006.620689655,1514.0,218.36666666666667,32,6036,3111467.451612904,1514.0,188.625
32140.000000000004,6,14,4740,7,653,4575.333333333333,249.0,93.28571428571428,7,4087,5106.666666666667,1514.0,583.8571428571429
107868513.0,6,28,1860,14,966,8297577.923076923,123.0,69.0,14,894,8280939.076923077,123.0,63.85714285714285
45996.0,6,14,4740,7,653,7430.666666666667,249.0,93.28571428571428,7,4087,6888.166666666667,1514.0,583.8571428571429
91679012.0,17,16,5472,16,5472,6111934.133333334,342.0,342.0,0,0,0.0,0.0,0.0
15729.0,6,11,1132,6,556,2247.2,218.0,92.66666666666669,5,576,3720.0,304.0,115.2
70079.0,6,11,1133,6,602,13725.0,264.0,100.33333333333331,5,531,6199.0,259.0,106.2
32484.0,6,14,4740,7,653,5288.5,249.0,93.28571428571428,7,4087,5277.0,1514.0,583.8571428571429
38488.0,6,10,2032,5,524,9386.25,252.0,104.8,5,1508,8985.75,1236.0,301.6
2322.0,17,4,344,2,150,0.0,75.0,75.0,2,194,0.0,103.0,97.0
31995.000000000004,6,14,4740,7,653,4987.666666666667,249.0,93.28571428571428,7,4087,5054.5,1514.0,583.8571428571429
12412.0,17,2,582,1,83,0.0,83.0,83.0,1,499,0.0,499.0,499.0
9337.0,6,10,1067,5,536,2076.5,264.0,107.2,5,531,1782.75,259.0,106.2
113984837.0,6,48,3168,24,1584,4955862.478260869,66.0,66.0,24,1584,4942401.652173913,66.0,66.0
2132.0,17,4,344,2,150,0.0,75.0,75.0,2,194,0.0,103.0,97.0
153459.0,17,2,180,1,90,0.0,90.0,90.0,1,90,0.0,90.0,90.0
121309.0,6,3,337,2,214,0.0,160.0,107.0,1,123,0.0,123.0,123.0
206451.0,6,3,426,2,280,0.0,214.0,140.0,1,146,0.0,146.0,146.0
3040165.0,6,3,1604,1,753,0.0,753.0,753.0,2,851,0.0,785.0,425.5
213903.0,6,10,1221,6,636,42780.6,298.0,106.0,4,585,69974.66666666667,379.0,146.25
1304041.0,17,7,490,7,490,217340.16666666663,70.0,70.0,0,0,0.0,0.0,0.0
107557.0,17,2,286,2,286,0.0,143.0,143.0,0,0,0.0,0.0,0.0
115005544.0,17,15,1169,8,606,16429363.42857143,174.0,75.75,7,563,15833468.833333334,174.0,80.42857142857143
177378.0,17,4,1400,4,1400,59126.0,350.0,350.0,0,0,0.0,0.0,0.0
151355.0,17,2,414,1,88,0.0,88.0,88.0,1,326,0.0,326.0,326.0
118179.0,6,13,1394,7,797,19696.5,253.0,113.85714285714286,6,597,22192.4,259.0,99.5
1319719.0,6,4,264,2,132,0.0,66.0,66.0,2,132,0.0,66.0,66.0
107000992.0,17,13,821,7,432,17833498.666666668,174.0,61.71428571428572,6,389,17200910.2,174.0,64.83333333333333
0.0,6,1,54,0,0,0.0,0.0,0.0,1,54,0.0,54.0,54.0
220726.0,6,4,504,3,358,110363.0,214.0,119.33333333333331,1,146,0.0,146.0,146.0
197073.0,17,2,180,1,90,0.0,90.0,90.0,1,90,0.0,90.0,90.0
33319.0,6,14,4740,7,653,5444.0,249.0,93.28571428571428,7,4087,4363.0,1514.0,583.8571428571429
215587.0,17,2,180,1,90,0.0,90.0,90.0,1,90,0.0,90.0,90.0
897713.0,6,12,2718,7,743,149618.83333333334,339.0,106.14285714285714,5,1975,155537.75,1514.0,395.0
146964.0,17,4,704,2,148,0.0,74.0,74.0,2,556,0.0,280.0,278.0
33506.0,6,10,2032,5,524,7411.75,252.0,104.8,5,1508,7961.5,1236.0,301.6
1922074.0,6,4,492,2,280,0.0,214.0,140.0,2,212,0.0,146.0,106.0
10519802.0,6,7,478,4,272,3459997.6666666665,74.0,68.0,3,206,5189889.5,74.0,68.66666666666667
209451.0,17,2,180,1,90,0.0,90.0,90.0,1,90,0.0,90.0,90.0
93620797.0,6,40,2640,20,1320,4927410.368421053,66.0,66.0,20,1320,4916033.0,66.0,66.0
56571.0,6,14,4740,7,653,8689.5,249.0,93.28571428571428,7,4087,8976.333333333334,1514.0,583.8571428571429
475.0,17,2,508,2,508,0.0,257.0,254.0,0,0,0.0,0.0,0.0
155236.0,6,3,337,2,214,0.0,160.0,107.0,1,123,0.0,123.0,123.0
22773.0,6,14,4740,7,653,3303.1666666666665,249.0,93.28571428571428,7,4087,3601.833333333333,1514.0,583.8571428571429
119958.0,17,2,180,1,70,0.0,70.0,70.0,1,110,0.0,110.0,110.0
37841.0,6,14,4740,7,653,6144.333333333333,249.0,93.28571428571428,7,4087,6009.0,1514.0,583.8571428571429
90096750.0,6,12,1848,5,1020,22523527.5,204.0,204.0,7,828,15015735.166666666,188.0,118.28571428571428
302170.0,6,6,412,4,272,100723.33333333331,74.0,68.0,2,140,0.0,74.0,70.0
362580.0,6,11,1021,6,444,48805.6,162.0,74.0,5,577,60733.0,349.0,115.4
2513.0,17,4,438,2,148,0.0,74.0,74.0,2,290,0.0,147.0,145.0
39416.0,6,14,4740,7,653,6210.333333333333,249.0,93.28571428571428,7,4087,5277.166666666667,1514.0,583.8571428571429
215420.0,17,2,180,1,90,0.0,90.0,90.0,1,90,0.0,90.0,90.0
3127.0,17,2,762,2,762,0.0,381.0,381.0,0,0,0.0,0.0,0.0
35259.0,6,10,2032,5,524,8052.0,252.0,104.8,5,1508,7272.5,1236.0,301.6
90034628.0,17,28,13364,28,13364,3334615.851851852,501.0,477.2857142857143,0,0,0.0,0.0,0.0
115923752.0,6,32,2220,16,1149,7713861.933333334,123.0,71.8125,16,1071,7713863.133333334,123.0,66.9375
19917.0,17,2,582,1,83,0.0,83.0,83.0,1,499,0.0,499.0,499.0
117413138.0,6,48,3168,24,1584,5104919.043478261,66.0,66.0,24,1584,5091701.913043479,66.0,66.0
108101179.0,17,5,1005,5,1005,27025294.75,201.0,201.0,0,0,0.0,0.0,0.0
104825044.0,6,41,3286,22,1777,4981383.238095238,139.0,80.77272727272727,19,1509,5811611.444444444,123.0,79.42105263157895
309525.0,6,3,202,2,128,0.0,74.0,64.0,1,74,0.0,74.0,74.0
387178.0,6,4,1114,2,224,0.0,158.0,112.0,2,890,0.0,824.0,445.0
76780.0,6,14,4740,7,653,12676.0,249.0,93.28571428571428,7,4087,12656.5,1514.0,583.8571428571429
210079.0,6,3,426,2,280,0.0,214.0,140.0,1,146,0.0,146.0,146.0
23192.0,17,2,582,1,83,0.0,83.0,83.0,1,499,0.0,499.0,499.0
316.0,17,2,174,1,79,0.0,79.0,79.0,1,95,0.0,95.0,95.0
496586.0,6,5,336,2,134,0.0,68.0,67.0,3,202,194021.5,70.0,67.33333333333333
100777631.0,6,28,1860,14,966,7735522.461538462,123.0,69.0,14,894,7735519.230769231,123.0,63.85714285714285
207418.0,6,3,426,2,280,0.0,214.0,140.0,1,146,0.0,146.0,146.0
41330.0,6,10,2032,5,524,9972.25,252.0,104.8,5,1508,5579.0,1236.0,301.6
297264.0,17,2,246,1,76,0.0,76.0,76.0,1,170,0.0,170.0,170.0
114832602.0,6,218,24710,109,7502,1063264.8333333333,140.0,68.8256880733945,109,17208,1061207.2777777778,284.0,157.87155963302752
141344.0,17,4,704,2,148,0.0,74.0,74.0,2,556,0.0,280.0,278.0
141055.0,6,2,132,1,66,0.0,66.0,66.0,1,66,0.0,66.0,66.0
206418.0,17,2,180,1,90,0.0,90.0,90.0,1,90,0.0,90.0,90.0
3532.0,17,2,363,1,75,0.0,75.0,75.0,1,288,0.0,288.0,288.0
153505.0,17,2,180,1,90,0.0,90.0,90.0,1,90,0.0,90.0,90.0
320978.0,17,4,704,2,148,0.0,74.0,74.0,2,556,0.0,280.0,278.0
305285.0,6,6,412,4,272,101761.66666666669,74.0,68.0,2,140,0.0,74.0,70.0
2093968.0,6,24,7544,13,2516,174497.33333333334,1034.0,193.53846153846155,11,5028,178809.6,1510.0,457.09090909090907
2114823.0,6,24,7544,12,2450,192256.63636363635,1034.0,204.16666666666663,12,5094,164405.27272727274,1510.0,424.5
204284.0,17,2,762,2,762,0.0,381.0,381.0,0,0,0.0,0.0,0.0
504163.0,6,5,336,2,134,0.0,68.0,67.0,3,202,195211.0,70.0,67.33333333333333
205776.0,17,2,180,1,90,0.0,90.0,90.0,1,90,0.0,90.0,90.0
108705777.0,6,34,2620,18,1411,6381741.882352941,139.0,78.38888888888889,16,1209,7232638.0,123.0,75.5625
108103945.0,17,5,1005,5,1005,27025986.25,201.0,201.0,0,0,0.0,0.0,0.0
210824.0,6,10,1221,6,636,42164.8,298.0,106.0,4,585,69268.33333333333,379.0,146.25
2332.0,17,4,344,2,150,0.0,75.0,75.0,2,194,0.0,103.0,97.0
238236.0,6,3,337,2,214,0.0,160.0,107.0,1,123,0.0,123.0,123.0
108106628.0,17,5,1005,5,1005,27026657.0,201.0,201.0,0,0,0.0,0.0,0.0
3169786.0,6,18,1495,9,921,358447.125,315.0,102.33333333333331,9,574,358469.25,78.0,63.77777777777778
27042.0,6,10,2032,5,524,6456.75,252.0,104.8,5,1508,6483.5,1236.0,301.6
43597.0,6,14,4740,7,653,7140.166666666667,249.0,93.28571428571428,7,4087,7127.0,1514.0,583.8571428571429
29743.0,6,14,4740,7,653,4561.333333333333,249.0,93.28571428571428,7,4087,4816.666666666667,1514.0,583.8571428571429
116728533.0,6,48,3168,24,1584,5075153.608695652,66.0,66.0,24,1584,5061908.478260869,66.0,66.0
34043.0,6,14,4740,7,653,4639.666666666667,249.0,93.28571428571428,7,4087,5223.666666666667,1514.0,583.8571428571429
90257225.0,6,12,1832,8,1016,12893889.285714284,188.0,127.0,4,816,30030761.666666668,204.0,204.0
293968.0,17,2,230,1,79,0.0,79.0,79.0,1,151,0.0,151.0,151.0
34134.0,6,14,4740,7,653,5037.166666666667,249.0,93.28571428571428,7,4087,5390.166666666667,1514.0,583.8571428571429
253014.00000000003,6,10,1221,6,636,50602.8,298.0,106.0,4,585,78978.33333333333,379.0,146.25
90258904.0,6,13,2036,8,1016,12894129.142857144,188.0,127.0,5,1020,22523270.75,204.0,204.0
1300577.0,6,4,264,2,132,0.0,66.0,66.0,2,132,0.0,66.0,66.0
153439.0,17,2,180,1,90,0.0,90.0,90.0,1,90,0.0,90.0,90.0
1702172.0,6,20,7599,11,1469,170217.2,583.0,133.54545454545453,9,6130,181530.375,1484.0,681.1111111111111
112052309.0,6,32,2236,16,1165,7455774.333333333,139.0,72.8125,16,1071,7455774.666666667,123.0,66.9375
37514.0,6,14,4740,7,653,6135.166666666667,249.0,93.28571428571428,7,4087,5648.333333333333,1514.0,583.8571428571429
120245672.0,6,23,1862,11,1009,11999547.6,223.0,91.72727272727272,12,853,10908177.181818182,95.0,71.08333333333333
303805.0,6,3,202,2,128,0.0,74.0,64.0,1,74,0.0,74.0,74.0
4444.0,17,2,614,1,72,0.0,72.0,72.0,1,542,0.0,542.0,542.0
10476408.0,6,7,478,4,272,3447050.6666666665,74.0,68.0,3,206,5170463.5,74.0,68.66666666666667
23019517.0,17,3,1034,2,684,0.0,342.0,342.0,1,350,0.0,350.0,350.0
41729.0,6,10,2032,5,524,9183.25,252.0,104.8,5,1508,10038.25,1236.0,301.6
93011714.0,6,38,2508,19,1254,5150443.277777778,66.0,66.0,19,1254,5150445.5,66.0,66.0
40044.0,6,14,4740,7,653,6505.5,249.0,93.28571428571428,7,4087,6245.166666666667,1514.0,583.8571428571429
196932.0,17,2,180,1,90,0.0,90.0,90.0,1,90,0.0,90.0,90.0
90052580.0,17,28,13364,28,13364,3335280.7407407407,501.0,477.2857142857143,0,0,0.0,0.0,0.0
108102597.0,17,5,1005,5,1005,27025649.25,201.0,201.0,0,0,0.0,0.0,0.0
697.0,17,4,438,2,148,0.0,74.0,74.0,2,290,0.0,147.0,145.0
108141697.0,17,14,864,7,432,18001815.166666668,174.0,61.71428571428572,7,432,18000200.166666668,174.0,61.71428571428572
90023039.0,17,28,13364,28,13364,3334186.6296296297,501.0,477.2857142857143,0,0,0.0,0.0,0.0
51970.0,6,14,4740,7,653,8347.5,249.0,93.28571428571428,7,4087,7579.0,1514.0,583.8571428571429
139406.0,6,2,132,1,66,0.0,66.0,66.0,1,66,0.0,66.0,66.0
190243.0,17,2,180,1,90,0.0,90.0,90.0,1,90,0.0,90.0,90.0
90531499.0,6,14,2240,8,1016,12933071.285714284,188.0,127.0,6,1224,18073580.2,204.0,204.0
90028496.0,17,28,13364,28,13364,3334388.7407407407,501.0,477.2857142857143,0,0,0.0,0.0,0.0
316975.0,17,4,1400,4,1400,105658.33333333331,350.0,350.0,0,0,0.0,0.0,0.0
1663914.0,6,23,6509,12,1529,151264.9090909091,357.0,127.41666666666669,11,4980,135860.5,1510.0,452.7272727272728
3014172.0,6,157,120517,85,111463,35883.0,1510.0,1311.3294117647058,72,9054,38016.69014084507,1510.0,125.75
121576.0,6,3,337,2,214,0.0,160.0,107.0,1,123,0.0,123.0,123.0
2494.0,17,4,344,2,150,0.0,75.0,75.0,2,194,0.0,103.0,97.0
90534656.0,6,14,2102,8,1016,12933522.285714284,188.0,127.0,6,1086,18074751.8,204.0,181.0
90735136.0,6,24,1829,13,989,7557875.333333333,95.0,76.07692307692308,11,840,9045783.6,95.0,76.36363636363636
992.0,17,4,438,2,148,0.0,74.0,74.0,2,290,0.0,147.0,145.0
206081.0,6,3,426,2,280,0.0,214.0,140.0,1,146,0.0,146.0,146.0
0.0,17,1,350,1,350,0.0,350.0,350.0,0,0,0.0,0.0,0.0
24212.0,6,10,2032,5,524,5804.25,252.0,104.8,5,1508,5754.0,1236.0,301.6
107986.0,17,2,286,2,286,0.0,143.0,143.0,0,0,0.0,0.0,0.0
153446.0,17,2,180,1,90,0.0,90.0,90.0,1,90,0.0,90.0,90.0
148792.0,17,2,414,1,88,0.0,88.0,88.0,1,326,0.0,326.0,326.0
41637.0,6,14,4740,7,653,6242.0,249.0,93.28571428571428,7,4087,6335.0,1514.0,583.8571428571429
10511.0,6,11,2098,6,590,1991.2,252.0,98.33333333333331,5,1508,2326.25,1236.0,301.6
71664.0,6,14,4740,7,653,11101.5,249.0,93.28571428571428,7,4087,11711.666666666666,1514.0,583.8571428571429
207088.0,6,10,1221,6,636,41417.6,298.0,106.0,4,585,67793.33333333333,379.0,146.25
146246.0,6,3,337,2,214,0.0,160.0,107.0,1,123,0.0,123.0,123.0
208567.0,6,10,1221,6,636,41713.4,298.0,106.0,4,585,68135.33333333333,379.0,146.25
301325.0,6,6,412,4,272,100441.66666666669,74.0,68.0,2,140,0.0,74.0,70.0
197008.0,17,2,180,1,90,0.0,90.0,90.0,1,90,0.0,90.0,90.0
45435.0,6,10,2032,5,524,10411.75,252.0,104.8,5,1508,10519.0,1236.0,301.6
32869.0,6,14,4740,7,653,5091.666666666667,249.0,93.28571428571428,7,4087,5329.333333333333,1514.0,583.8571428571429
118541510.0,6,240,27168,120,19026,994327.8907563024,300.0,158.55,120,8142,994328.151260504,140.0,67.85
83467.0,6,14,4740,7,653,13431.166666666666,249.0,93.28571428571428,7,4087,10510.833333333334,1514.0,583.8571428571429
90034437.0,17,28,13364,28,13364,3334608.777777778,501.0,477.2857142857143,0,0,0.0,0.0,0.0
39427.0,6,14,4740,7,653,6015.833333333333,249.0,93.28571428571428,7,4087,6144.5,1514.0,583.8571428571429
9544.0,17,2,539,1,86,0.0,86.0,86.0,1,453,0.0,453.0,453.0
113395032.0,6,221,24950,111,7622,1030863.9272727272,140.0,68.66666666666667,110,17328,1030815.6422018348,284.0,157.52727272727273
321880.0,17,4,1400,4,1400,107293.33333333331,350.0,350.0,0,0,0.0,0.0,0.0
10466492.0,6,7,478,4,272,3443114.333333333,74.0,68.0,3,206,5164574.0,74.0,68.66666666666667
5629596.0,6,5,336,2,134,0.0,68.0,67.0,3,202,1424053.5,70.0,67.33333333333333
123620497.0,6,49,3234,25,1650,5150854.041666667,66.0,66.0,24,1584,5050728.130434782,66.0,66.0
31119.0,6,14,4740,7,653,5062.333333333333,249.0,93.28571428571428,7,4087,5028.833333333333,1514.0,583.8571428571429
339593.0,17,4,820,2,156,0.0,78.0,78.0,2,664,0.0,332.0,332.0
90757149.0,6,15,1138,7,542,15126191.5,95.0,77.42857142857143,8,596,12922862.42857143,95.0,74.5
44460.0,6,13,1479,7,882,7410.0,291.0,126.0,6,597,5678.0,259.0,99.5
90215578.0,6,17,1287,8,596,12851692.285714284,95.0,74.5,9,691,11250036.0,95.0,76.77777777777777
2776833.0,6,3,1604,1,753,0.0,753.0,753.0,2,851,0.0,785.0,425.5
1162952.0,6,13,3010,8,2382,166136.0,1514.0,297.75,5,628,222571.0,331.0,125.6
120196182.0,6,18,1341,9,691,14997473.875,95.0,76.77777777777777,9,650,14997463.125,95.0,72.22222222222223
442294.0,17,4,360,2,140,0.0,70.0,70.0,2,220,0.0,110.0,110.0
2338.0,17,4,344,2,150,0.0,75.0,75.0,2,194,0.0,103.0,97.0
299004.0,6,6,412,4,272,99668.0,74.0,68.0,2,140,0.0,74.0,70.0
19623.0,6,20,7606,11,978,1877.6,310.0,88.9090909090909,9,6628,2318.75,1514.0,736.4444444444445
36565.0,6,14,4740,7,653,5874.666666666667,249.0,93.28571428571428,7,4087,5540.833333333333,1514.0,583.8571428571429
14490365.0,17,6,2052,6,2052,2898073.0,342.0,342.0,0,0,0.0,0.0,0.0
90019199.0,17,28,13364,28,13364,3334044.407407407,501.0,477.2857142857143,0,0,0.0,0.0,0.0
37480.0,6,10,2032,5,524,9048.0,252.0,104.8,5,1508,8357.5,1236.0,301.6
433.0,17,2,267,1,83,0.0,83.0,83.0,1,184,0.0,184.0,184.0
100049359.0,17,12,516,6,258,20000170.2,43.0,43.0,6,258,20000973.4,43.0,43.0
9521.0,6,11,2098,6,590,1904.2,252.0,98.33333333333331,5,1508,2090.75,1236.0,301.6
2019.0,17,4,344,2,150,0.0,75.0,75.0,2,194,0.0,103.0,97.0
254153.00000000003,6,3,337,2,214,0.0,160.0,107.0,1,123,0.0,123.0,123.0
144136.0,17,2,180,1,90,0.0,90.0,90.0,1,90,0.0,90.0,90.0
123452718.0,6,49,3234,25,1650,5143863.25,66.0,66.0,24,1584,4926078.043478261,66.0,66.0
38537.0,6,14,4740,7,653,5549.0,249.0,93.28571428571428,7,4087,6062.5,1514.0,583.8571428571429
153412.0,17,2,180,1,90,0.0,90.0,90.0,1,90,0.0,90.0,90.0
197077.0,17,2,180,1,90,0.0,90.0,90.0,1,90,0.0,90.0,90.0
2380.0,17,4,344,2,150,0.0,75.0,75.0,2,194,0.0,103.0,97.0
233937.0,6,3,337,2,214,0.0,160.0,107.0,1,123,0.0,123.0,123.0
162364.0,17,2,180,1,90,0.0,90.0,90.0,1,90,0.0,90.0,90.0
298333.0,6,6,412,4,272,99444.33333333331,74.0,68.0,2,140,0.0,74.0,70.0
117784596.0,6,48,3168,24,1584,5121069.391304348,66.0,66.0,24,1584,5107611.956521739,66.0,66.0
2793.0,17,4,344,2,150,0.0,75.0,75.0,2,194,0.0,103.0,97.0
90287450.0,6,15,1097,8,596,12898207.142857144,95.0,74.5,7,501,14997110.0,95.0,71.57142857142857
112876.0,17,2,286,2,286,0.0,143.0,143.0,0,0,0.0,0.0,0.0
167687.0,17,2,414,1,88,0.0,88.0,88.0,1,326,0.0,326.0,326.0
31281.000000000004,6,14,4740,7,653,4607.0,249.0,93.28571428571428,7,4087,4998.5,1514.0,583.8571428571429
123142077.0,6,31,2097,16,1149,8209471.8,123.0,71.8125,15,948,8231214.857142857,123.0,63.2
106110.0,17,2,286,2,286,0.0,143.0,143.0,0,0,0.0,0.0,0.0
317957.0,17,4,1400,4,1400,105985.66666666669,350.0,350.0,0,0,0.0,0.0,0.0
324.0,17,2,174,1,79,0.0,79.0,79.0,1,95,0.0,95.0,95.0
90045321.0,17,27,12943,27,12943,3463281.576923077,501.0,479.3703703703704,0,0,0.0,0.0,0.0
31879.0,6,10,2032,5,524,7757.75,252.0,104.8,5,1508,7016.5,1236.0,301.6
3257179.0,6,158,127832,91,119108,36190.87777777778,1510.0,1308.8791208791208,67,8724,44826.393939393936,1510.0,130.2089552238806
90016677.0,17,28,13364,28,13364,3333951.0,501.0,477.2857142857143,0,0,0.0,0.0,0.0
90050502.0,17,28,13364,28,13364,3335203.777777778,501.0,477.2857142857143,0,0,0.0,0.0,0.0
319.0,17,2,174,1,79,0.0,79.0,79.0,1,95,0.0,95.0,95.0
861695.0,6,9,1096,6,625,172339.0,287.0,104.16666666666669,3,471,294534.5,331.0,157.0
133659.0,6,2,132,1,66,0.0,66.0,66.0,1,66,0.0,66.0,66.0
94189945.0,6,40,2640,20,1320,4957365.52631579,66.0,66.0,20,1320,4941370.421052632,66.0,66.0
90283416.0,6,14,1043,7,542,15047236.0,95.0,77.42857142857143,7,501,14999350.666666666,95.0,71.57142857142857
135126128.0,17,6,1206,6,1206,27025225.6,201.0,201.0,0,0,0.0,0.0,0.0
12827.0,6,10,2032,5,524,2934.0,252.0,104.8,5,1508,2774.0,1236.0,301.6
5827171.0,6,5,336,3,202,1523623.5,70.0,67.33333333333333,2,134,0.0,68.0,67.0
90054508.0,17,28,13364,28,13364,3335352.1481481483,501.0,477.2857142857143,0,0,0.0,0.0,0.0
99079.0,17,2,762,2,762,0.0,381.0,381.0,0,0,0.0,0.0,0.0
120101648.0,6,14,2240,6,1224,24020329.6,204.0,204.0,8,1016,17133887.0,188.0,127.0
241823.0,6,3,373,2,238,0.0,172.0,119.0,1,135,0.0,135.0,135.0
50719.0,6,12,1413,6,816,8857.6,291.0,136.0,6,597,8331.2,259.0,99.5
36310.0,6,14,4740,7,653,5889.166666666667,249.0,93.28571428571428,7,4087,5807.166666666667,1514.0,583.8571428571429
108109366.0,17,5,1005,5,1005,27027341.5,201.0,201.0,0,0,0.0,0.0,0.0
119192700.0,17,34,16284,34,16284,3611900.0,501.0,478.9411764705882,0,0,0.0,0.0,0.0
65073.00000000001,6,11,2098,6,590,12319.0,252.0,98.33333333333331,5,1508,14081.25,1236.0,301.6
294608.0,17,2,224,1,76,0.0,76.0,76.0,1,148,0.0,148.0,148.0
5441.0,17,4,344,2,150,0.0,75.0,75.0,2,194,0.0,103.0,97.0
5171.0,17,2,180,1,90,0.0,90.0,90.0,1,90,0.0,90.0,90.0
345.0,17,2,166,1,75,0.0,75.0,75.0,1,91,0.0,91.0,91.0
298488.0,6,6,412,4,272,99496.0,74.0,68.0,2,140,0.0,74.0,70.0
38884.0,6,14,4740,7,653,6349.833333333333,249.0,93.28571428571428,7,4087,6340.333333333333,1514.0,583.8571428571429
139662.0,6,2,132,1,66,0.0,66.0,66.0,1,66,0.0,66.0,66.0
178697.0,6,11,1132,6,556,34704.6,218.0,92.66666666666669,5,576,42616.5,304.0,115.2
168062.0,6,3,337,2,214,0.0,160.0,107.0,1,123,0.0,123.0,123.0
120108415.0,6,346,40474,173,11714,694194.9941860465,140.0,67.71098265895954,173,28760,693522.6511627907,284.0,166.242774566474
202756.0,17,2,762,2,762,0.0,381.0,381.0,0,0,0.0,0.0,0.0
120147603.0,6,230,25866,115,7812,1046755.6403508772,140.0,67.9304347826087,115,18054,1047693.1315789474,284.0,156.9913043478261
10464161.0,6,7,478,4,272,3442436.0,74.0,68.0,3,206,5163566.5,74.0,68.66666666666667
144942.0,6,2,132,1,66,0.0,66.0,66.0,1,66,0.0,66.0,66.0
103627.0,17,2,286,2,286,0.0,143.0,143.0,0,0,0.0,0.0,0.0
100128712.0,6,30,2122,15,1105,7136629.642857143,139.0,73.66666666666667,15,1017,7136631.857142857,123.0,67.8
304945.0,6,3,202,2,128,0.0,74.0,64.0,1,74,0.0,74.0,74.0
106552.0,17,2,700,2,700,0.0,350.0,350.0,0,0,0.0,0.0,0.0
280499.0,6,10,1221,6,636,56099.8,298.0,106.0,4,585,87654.33333333333,379.0,146.25
119572576.0,6,241,27938,121,8282,996438.1333333332,140.0,68.44628099173553,120,19656,1002989.6218487396,300.0,163.8
120000008.0,6,17,1287,9,691,15000001.0,95.0,76.77777777777777,8,596,12895070.0,95.0,74.5
108119.0,17,2,286,2,286,0.0,143.0,143.0,0,0,0.0,0.0,0.0
101213.0,17,2,762,2,762,0.0,381.0,381.0,0,0,0.0,0.0,0.0
41742.0,6,14,4740,7,653,6781.5,249.0,93.28571428571428,7,4087,6310.666666666667,1514.0,583.8571428571429
107619.0,17,2,286,2,286,0.0,143.0,143.0,0,0,0.0,0.0,0.0
12422.0,6,10,2032,5,524,2784.0,252.0,104.8,5,1508,2489.75,1236.0,301.6
17048.0,17,2,180,1,90,0.0,90.0,90.0,1,90,0.0,90.0,90.0
90061004.0,17,28,13364,28,13364,3335592.7407407407,501.0,477.2857142857143,0,0,0.0,0.0,0.0
40732.0,6,11,1132,6,556,7269.6,218.0,92.66666666666669,5,576,9802.0,304.0,115.2
4546.0,17,2,598,1,72,0.0,72.0,72.0,1,526,0.0,526.0,526.0
120420127.0,6,215,24358,108,17000,1125421.7476635517,284.0,157.40740740740742,107,7358,1126203.933962264,140.0,68.76635514018692
2780219.0,6,2,132,1,66,0.0,66.0,66.0,1,66,0.0,66.0,66.0
119713681.0,17,34,16284,34,16284,3627687.303030303,501.0,478.9411764705882,0,0,0.0,0.0,0.0
0.0,17,1,44,1,44,0.0,44.0,44.0,0,0,0.0,0.0,0.0
1993949.0,6,18,6803,10,1501,221549.88888888888,408.0,150.1,8,5302,223155.57142857145,1514.0,662.75
10454472.0,6,7,478,4,272,3437989.6666666665,74.0,68.0,3,206,5156888.0,74.0,68.66666666666667
51740793.0,17,6,540,3,270,25759982.5,90.0,90.0,3,270,25758875.0,90.0,90.0
120069929.0,6,264,30074,132,9008,911170.8320610689,140.0,68.24242424242425,132,21066,910291.648854962,374.0,159.5909090909091
313027.0,17,4,1400,4,1400,104342.33333333331,350.0,350.0,0,0,0.0,0.0,0.0
236285.0,6,3,337,2,214,0.0,160.0,107.0,1,123,0.0,123.0,123.0
242891.0,6,3,337,2,214,0.0,160.0,107.0,1,123,0.0,123.0,123.0
15003.0,17,2,180,1,90,0.0,90.0,90.0,1,90,0.0,90.0,90.0
90045437.0,17,28,13364,28,13364,3335016.185185185,501.0,477.2857142857143,0,0,0.0,0.0,0.0
844.0,17,4,438,2,148,0.0,74.0,74.0,2,290,0.0,147.0,145.0
204704.0,17,2,762,2,762,0.0,381.0,381.0,0,0,0.0,0.0,0.0
101000918.0,17,13,1083,7,563,16833486.333333332,174.0,80.42857142857143,6,520,16950218.4,174.0,86.66666666666667
135026759.0,17,6,1146,6,1146,27005351.8,191.0,191.0,0,0,0.0,0.0,0.0
83587.0,17,2,286,2,286,0.0,143.0,143.0,0,0,0.0,0.0,0.0
148648.0,6,3,337,2,214,0.0,160.0,107.0,1,123,0.0,123.0,123.0
141112.0,6,2,132,1,66,0.0,66.0,66.0,1,66,0.0,66.0,66.0
110138496.0,6,27,1806,14,966,8455574.846153846,123.0,69.0,13,840,9160101.5,123.0,64.61538461538461
212962.0,6,3,426,2,280,0.0,214.0,140.0,1,146,0.0,146.0,146.0
150173.0,6,10,1066,5,490,36989.75,218.0,98.0,5,576,37336.5,304.0,115.2
30256.0,6,10,2032,5,524,6641.5,252.0,104.8,5,1508,7011.0,1236.0,301.6
120183635.0,6,887,120656,444,29600,271294.88713318284,140.0,66.66666666666667,443,91056,271398.13122171944,554.0,205.5440180586908
802838.0,6,10,2032,5,524,200482.0,252.0,104.8,5,1508,200367.0,1236.0,301.6
99505.0,17,2,286,2,286,0.0,143.0,143.0,0,0,0.0,0.0,0.0
31841.0,6,14,4740,7,653,4269.333333333333,249.0,93.28571428571428,7,4087,5170.166666666667,1514.0,583.8571428571429
55564.0,6,14,4740,7,653,7585.166666666667,249.0,93.28571428571428,7,4087,8388.333333333334,1514.0,583.8571428571429
125663268.0,17,14,864,7,432,17666866.666666668,174.0,61.71428571428572,7,432,19996062.166666668,174.0,61.71428571428572
90037655.0,17,28,13364,28,13364,3334727.962962963,501.0,477.2857142857143,0,0,0.0,0.0,0.0
2361.0,17,4,344,2,150,0.0,75.0,75.0,2,194,0.0,103.0,97.0
37701.0,6,14,4740,7,653,5927.5,249.0,93.28571428571428,7,4087,5890.333333333333,1514.0,583.8571428571429
47610004.0,6,8,1940,3,887,22592607.5,753.0,295.6666666666667,5,1053,11259500.75,785.0,210.6
146082.0,6,3,337,2,214,0.0,160.0,107.0,1,123,0.0,123.0,123.0
1420055.0,17,16,1120,16,1120,94670.33333333331,70.0,70.0,0,0,0.0,0.0,0.0
27432360.0,17,5,1710,5,1710,6858090.0,342.0,342.0,0,0,0.0,0.0,0.0
304471.0,6,6,412,4,272,101490.33333333331,74.0,68.0,2,140,0.0,74.0,70.0
107001059.0,17,13,821,7,432,17833509.833333332,174.0,61.71428571428572,6,389,17401484.6,174.0,64.83333333333333
6523.0,17,4,823,2,163,0.0,89.0,81.5,2,660,0.0,443.0,330.0
114476040.0,6,208,23536,104,16376,1109317.1359223302,284.0,157.46153846153845,104,7160,1109328.6990291262,140.0,68.84615384615384
69515.0,6,14,4740,7,653,10168.833333333334,249.0,93.28571428571428,7,4087,11217.5,1514.0,583.8571428571429
119850594.0,6,15,2306,6,1224,23969653.2,204.0,204.0,9,1082,14981078.75,188.0,120.22222222222224
90257052.0,6,12,1832,8,1016,12893864.57142857,188.0,127.0,4,816,30030366.33333333,204.0,204.0
2956487.0,6,3,1604,1,753,0.0,753.0,753.0,2,851,0.0,785.0,425.5
764.0,17,4,438,2,148,0.0,74.0,74.0,2,290,0.0,147.0,145.0
755268.0,17,8,2800,8,2800,107895.42857142857,350.0,350.0,0,0,0.0,0.0,0.0
301394.0,6,6,412,4,272,100464.66666666669,74.0,68.0,2,140,0.0,74.0,70.0
108054369.0,17,14,864,7,432,17834057.833333332,174.0,61.71428571428572,7,432,17833500.166666668,174.0,61.71428571428572
1492612.0,17,16,1120,16,1120,99507.46666666666,70.0,70.0,0,0,0.0,0.0,0.0
336.0,17,2,166,1,75,0.0,75.0,75.0,1,91,0.0,91.0,91.0
261890.0,6,10,1221,6,636,52378.0,298.0,106.0,4,585,80922.66666666667,379.0,146.25
310757.0,17,2,238,1,74,0.0,74.0,74.0,1,164,0.0,164.0,164.0
5721860.0,6,5,336,2,134,0.0,68.0,67.0,3,202,1533100.0,70.0,67.33333333333333
108101853.0,17,5,1005,5,1005,27025463.25,201.0,201.0,0,0,0.0,0.0,0.0
120117683.0,6,15,2428,9,1204,15014710.375,188.0,133.77777777777777,6,1224,18071437.6,204.0,204.0
363.0,17,2,174,1,79,0.0,79.0,79.0,1,95,0.0,95.0,95.0
1064833.0,6,13,1386,7,789,177472.16666666666,253.0,112.71428571428572,6,597,210474.6,259.0,99.5
108107158.0,17,5,955,5,955,27026789.5,191.0,191.0,0,0,0.0,0.0,0.0
90032011.0,17,28,13364,28,13364,3334518.925925926,501.0,477.2857142857143,0,0,0.0,0.0,0.0
355.0,17,2,762,2,762,0.0,381.0,381.0,0,0,0.0,0.0,0.0
332.0,17,2,166,1,75,0.0,75.0,75.0,1,91,0.0,91.0,91.0
1986.0,17,4,344,2,150,0.0,75.0,75.0,2,194,0.0,103.0,97.0
11680.0,17,4,823,2,163,0.0,89.0,81.5,2,660,0.0,443.0,330.0
228334.0,17,2,180,1,90,0.0,90.0,90.0,1,90,0.0,90.0,90.0
10861219.0,6,8,544,4,272,3575076.333333333,74.0,68.0,4,272,3575021.6666666665,74.0,68.0
910.0,17,5,550,5,550,227.5,110.0,110.0,0,0,0.0,0.0,0.0
113920721.0,6,46,3036,23,1518,5163163.409090909,66.0,66.0,23,1518,5163497.409090909,66.0,66.0
93027744.0,6,37,2442,19,1254,5168208.0,66.0,66.0,18,1188,5320260.823529412,66.0,66.0
2795366.0,6,2,132,1,66,0.0,66.0,66.0,1,66,0.0,66.0,66.0
102433.0,17,2,286,2,286,0.0,143.0,143.0,0,0,0.0,0.0,0.0
43589.0,6,14,4740,7,653,7144.5,249.0,93.28571428571428,7,4087,7126.166666666667,1514.0,583.8571428571429
108103186.0,17,5,955,5,955,27025796.5,191.0,191.0,0,0,0.0,0.0,0.0
205266.0,17,2,180,1,90,0.0,90.0,90.0,1,90,0.0,90.0,90.0
123985917.0,17,15,1169,8,606,17712273.85714286,174.0,75.75,7,563,17334941.666666668,174.0,80.42857142857143
90777442.0,6,19,1436,10,745,10080959.222222222,95.0,74.5,9,691,11345819.625,95.0,76.77777777777777
102301.0,17,2,286,2,286,0.0,143.0,143.0,0,0,0.0,0.0,0.0
82134.0,17,2,762,2,762,0.0,381.0,381.0,0,0,0.0,0.0,0.0
1453370.0,6,7,499,3,198,618245.5,66.0,66.0,4,301,484039.0,103.0,75.25
47503.0,6,14,4740,7,653,7742.833333333333,249.0,93.28571428571428,7,4087,7235.0,1514.0,583.8571428571429
8934.0,17,2,539,1,86,0.0,86.0,86.0,1,453,0.0,453.0,453.0
90877400.0,6,177,19938,89,6096,1032697.7272727272,140.0,68.49438202247191,88,13842,1034058.735632184,284.0,157.29545454545453
45505.0,6,10,2032,5,524,10533.0,252.0,104.8,5,1508,7926.5,1236.0,301.6
107972733.0,17,15,1169,8,606,15401973.857142856,174.0,75.75,7,563,17641605.666666668,174.0,80.42857142857143
90525537.0,6,14,2240,8,1016,12932219.57142857,188.0,127.0,6,1224,18069225.0,204.0,204.0
122376832.0,6,32,2220,16,1071,7492718.866666666,123.0,66.9375,16,1149,7492744.333333333,123.0,71.8125
233384.0,6,3,337,2,214,0.0,160.0,107.0,1,123,0.0,123.0,123.0
315710.0,17,4,1400,4,1400,105236.66666666669,350.0,350.0,0,0,0.0,0.0,0.0
94055696.0,6,40,2640,20,1320,4950299.7894736845,66.0,66.0,20,1320,4934447.263157895,66.0,66.0
90735919.0,6,24,1829,13,989,7557717.583333333,95.0,76.07692307692308,11,840,9045863.3,95.0,76.36363636363636
135137246.0,17,6,1206,6,1206,27027449.2,201.0,201.0,0,0,0.0,0.0,0.0
104918.0,17,2,286,2,286,0.0,143.0,143.0,0,0,0.0,0.0,0.0
120496075.0,6,223,25262,112,17714,1085550.225225225,284.0,158.16071428571428,111,7548,1085945.8545454545,140.0,68.0
2223.0,17,4,344,2,150,0.0,75.0,75.0,2,194,0.0,103.0,97.0
120130141.0,6,13,2020,9,1204,15016267.625,188.0,133.77777777777777,4,816,30036890.0,204.0,204.0
206060.0,6,3,426,2,280,0.0,214.0,140.0,1,146,0.0,146.0,146.0
113312305.0,6,48,3168,24,1584,4926621.956521739,66.0,66.0,24,1584,4920350.260869565,66.0,66.0
115497.0,6,13,1386,7,789,19249.5,253.0,112.71428571428572,6,597,21789.0,259.0,99.5
90051745.0,17,27,12943,27,12943,3463528.653846154,501.0,479.3703703703704,0,0,0.0,0.0,0.0
32782976.0,6,5,336,2,134,0.0,68.0,67.0,3,202,15051125.0,70.0,67.33333333333333
135128798.0,17,6,1206,6,1206,27025759.6,201.0,201.0,0,0,0.0,0.0,0.0
36695.0,6,14,4740,7,653,5938.166666666667,249.0,93.28571428571428,7,4087,5510.833333333333,1514.0,583.8571428571429
2534318.0,6,25,7573,14,3735,194947.53846153847,1514.0,266.7857142857143,11,3838,227196.0,1514.0,348.90909090909093
99770815.0,17,12,778,6,389,19895992.2,174.0,64.83333333333333,6,389,19922370.4,174.0,64.83333333333333
108108528.0,17,5,955,5,955,27027132.0,191.0,191.0,0,0,0.0,0.0,0.0
160168.0,17,2,180,1,90,0.0,90.0,90.0,1,90,0.0,90.0,90.0
153533.0,17,2,180,1,90,0.0,90.0,90.0,1,90,0.0,90.0,90.0
143882.0,17,2,180,1,90,0.0,90.0,90.0,1,90,0.0,90.0,90.0
104844.0,17,2,286,2,286,0.0,143.0,143.0,0,0,0.0,0.0,0.0
144794.0,17,2,180,1,70,0.0,70.0,70.0,1,110,0.0,110.0,110.0
98439966.0,17,12,778,6,389,19600193.4,174.0,64.83333333333333,6,389,19600700.2,174.0,64.83333333333333
150595.0,17,4,1524,4,1524,50198.333333333336,381.0,381.0,0,0,0.0,0.0,0.0
31530.000000000004,6,14,4740,7,653,5084.5,249.0,93.28571428571428,7,4087,4243.166666666667,1514.0,583.8571428571429
260863.0,6,3,337,2,214,0.0,160.0,107.0,1,123,0.0,123.0,123.0
296.0,17,2,174,1,79,0.0,79.0,79.0,1,95,0.0,95.0,95.0
139708.0,6,2,132,1,66,0.0,66.0,66.0,1,66,0.0,66.0,66.0
0.0,6,1,172,1,172,0.0,172.0,172.0,0,0,0.0,0.0,0.0
102079.0,17,2,286,2,286,0.0,143.0,143.0,0,0,0.0,0.0,0.0
10426937.0,6,7,478,4,272,3430300.0,74.0,68.0,3,206,5145354.5,74.0,68.66666666666667
83527681.0,17,14,4796,13,4446,6227917.25,342.0,342.0,1,350,0.0,350.0,350.0
302501.0,6,2,132,1,66,0.0,66.0,66.0,1,66,0.0,66.0,66.0
143852.0,17,2,180,1,90,0.0,90.0,90.0,1,90,0.0,90.0,90.0
90525749.0,6,15,2444,8,1016,12932249.857142856,188.0,127.0,7,1428,15060230.0,204.0,204.0
108107883.0,17,5,955,5,955,27026970.75,191.0,191.0,0,0,0.0,0.0,0.0
2032.0,17,4,344,2,150,0.0,75.0,75.0,2,194,0.0,103.0,97.0
108101362.0,17,5,1005,5,1005,27025340.5,201.0,201.0,0,0,0.0,0.0,0.0
44727.0,6,14,4740,7,653,7095.833333333333,249.0,93.28571428571428,7,4087,6715.666666666667,1514.0,583.8571428571429
27746829.0,17,5,1710,5,1710,6936707.25,342.0,342.0,0,0,0.0,0.0,0.0
321305.0,6,6,412,4,272,107101.66666666669,74.0,68.0,2,140,0.0,74.0,70.0
244970.0,6,3,373,2,238,0.0,172.0,119.0,1,135,0.0,135.0,135.0
102805.0,17,2,286,2,286,0.0,143.0,143.0,0,0,0.0,0.0,0.0
1748905.0,6,23,6509,12,1529,158991.36363636365,357.0,127.41666666666669,11,4980,143626.7,1510.0,452.7272727272728
2782.0,17,2,224,1,76,0.0,76.0,76.0,1,148,0.0,148.0,148.0
2901.0,17,2,224,1,76,0.0,76.0,76.0,1,148,0.0,148.0,148.0
558.0,17,2,508,2,508,0.0,257.0,254.0,0,0,0.0,0.0,0.0
214145.0,6,10,1221,6,636,42829.0,298.0,106.0,4,585,69774.66666666667,379.0,146.25
120107955.0,17,28,13364,28,13364,4448442.777777778,501.0,477.2857142857143,0,0,0.0,0.0,0.0
54881.0,6,14,4740,7,653,8512.833333333334,249.0,93.28571428571428,7,4087,8501.5,1514.0,583.8571428571429
229091.0,6,10,1221,6,636,45818.2,298.0,106.0,4,585,75498.33333333333,379.0,146.25
50972.0,17,2,180,1,90,0.0,90.0,90.0,1,90,0.0,90.0,90.0
137066.0,6,3,337,2,214,0.0,160.0,107.0,1,123,0.0,123.0,123.0
908.0,17,5,550,5,550,227.0,110.0,110.0,0,0,0.0,0.0,0.0
116618568.0,6,47,3102,24,1584,5070362.043478261,66.0,66.0,23,1518,5143995.318181818,66.0,66.0
310022.0,17,4,1400,4,1400,103340.66666666669,350.0,350.0,0,0,0.0,0.0,0.0
120161040.0,6,302,35102,151,24840,799639.52,554.0,164.50331125827816,151,10262,799639.6533333333,140.0,67.96026490066225
20758.0,6,14,4740,7,653,2496.5,249.0,93.28571428571428,7,4087,3324.5,1514.0,583.8571428571429
247806.0,6,3,337,2,214,0.0,160.0,107.0,1,123,0.0,123.0,123.0
508280.0,6,5,336,2,134,0.0,68.0,67.0,3,202,192731.5,70.0,67.33333333333333
197806.0,17,2,180,1,90,0.0,90.0,90.0,1,90,0.0,90.0,90.0
90031464.0,17,28,13364,28,13364,3334498.6666666665,501.0,477.2857142857143,0,0,0.0,0.0,0.0
118598199.0,6,224,25328,112,17714,1066501.8288288289,284.0,158.16071428571428,112,7614,1066501.855855856,140.0,67.98214285714286
205037.0,17,2,762,2,762,0.0,381.0,381.0,0,0,0.0,0.0,0.0
477355.0,6,2,132,1,66,0.0,66.0,66.0,1,66,0.0,66.0,66.0
424.0,17,2,410,1,78,0.0,78.0,78.0,1,332,0.0,332.0,332.0
1743053.0,6,2,132,1,66,0.0,66.0,66.0,1,66,0.0,66.0,66.0
146199.0,6,3,337,2,214,0.0,160.0,107.0,1,123,0.0,123.0,123.0
0.0,6,1,66,1,66,0.0,66.0,66.0,0,0,0.0,0.0,0.0
208168.0,6,3,426,2,280,0.0,214.0,140.0,1,146,0.0,146.0,146.0
18865.0,6,14,4740,7,653,2874.0,249.0,93.28571428571428,7,4087,3010.5,1514.0,583.8571428571429
2458.0,17,4,344,2,150,0.0,75.0,75.0,2,194,0.0,103.0,97.0
298894.0,6,6,412,4,272,99631.33333333331,74.0,68.0,2,140,0.0,74.0,70.0
298174.0,6,6,412,4,272,99391.33333333331,74.0,68.0,2,140,0.0,74.0,70.0
45235.0,6,12,1328,6,731,8427.4,253.0,121.83333333333331,6,597,8337.8,259.0,99.5
119098621.0,6,33,2280,17,1209,7443663.8125,123.0,71.11764705882354,16,1071,7259694.733333333,123.0,66.9375
59438.0,6,14,4740,7,653,9788.333333333334,249.0,93.28571428571428,7,4087,9341.0,1514.0,583.8571428571429
71477.0,6,2,132,1,66,0.0,66.0,66.0,1,66,0.0,66.0,66.0
5818246.0,6,5,336,2,134,0.0,68.0,67.0,3,202,1516794.0,70.0,67.33333333333333
301479.0,6,6,412,4,272,100493.0,74.0,68.0,2,140,0.0,74.0,70.0
219700.0,17,2,180,1,90,0.0,90.0,90.0,1,90,0.0,90.0,90.0
212204.0,6,10,1221,6,636,42440.8,298.0,106.0,4,585,69621.66666666667,379.0,146.25
308710.0,17,4,1400,4,1400,102903.33333333331,350.0,350.0,0,0,0.0,0.0,0.0
3165253.0,6,18,1495,9,921,358084.25,315.0,102.33333333333331,9,574,358054.875,78.0,63.77777777777778
2004.0,17,4,344,2,150,0.0,75.0,75.0,2,194,0.0,103.0,97.0
51040.0,17,2,180,1,90,0.0,90.0,90.0,1,90,0.0,90.0,90.0
90070546.0,17,28,13364,28,13364,3335946.1481481483,501.0,477.2857142857143,0,0,0.0,0.0,0.0
93012295.0,6,38,2508,19,1254,5150439.833333333,66.0,66.0,19,1254,5150432.277777778,66.0,66.0
614.0,17,2,508,2,508,0.0,257.0,254.0,0,0,0.0,0.0,0.0
16777.0,6,2,145,2,145,0.0,91.0,72.5,0,0,0.0,0.0,0.0
313486.0,6,13,1493,7,862,52247.66666666666,271.0,123.14285714285714,6,631,61459.0,293.0,105.16666666666669
20941069.0,17,3,1034,2,684,0.0,342.0,342.0,1,350,0.0,350.0,350.0
311183.0,17,4,1400,4,1400,103727.66666666669,350.0,350.0,0,0,0.0,0.0,0.0
158864.0,6,3,337,2,214,0.0,160.0,107.0,1,123,0.0,123.0,123.0
1060780.0,6,3,204,1,68,0.0,68.0,68.0,2,136,0.0,70.0,68.0
135132676.0,17,6,1206,6,1206,27026535.2,201.0,201.0,0,0,0.0,0.0,0.0
9443.0,17,4,823,2,163,0.0,89.0,81.5,2,660,0.0,443.0,330.0
3420.0,17,2,359,1,75,0.0,75.0,75.0,1,284,0.0,284.0,284.0
2149926.0,17,6,1039,4,312,716513.0,78.0,78.0,2,727,0.0,395.0,363.5
118580161.0,17,14,864,7,432,19666863.33333333,174.0,61.71428571428572,7,432,19667522.666666668,174.0,61.71428571428572
44644.0,6,10,2032,5,524,10902.0,252.0,104.8,5,1508,9498.75,1236.0,301.6
307728.0,6,6,412,4,272,102576.0,74.0,68.0,2,140,0.0,74.0,70.0
32240.0,6,14,4740,7,653,5061.166666666667,249.0,93.28571428571428,7,4087,5180.666666666667,1514.0,583.8571428571429
121382.0,6,3,337,2,214,0.0,160.0,107.0,1,123,0.0,123.0,123.0
942354.0,6,13,1513,7,882,156442.0,291.0,126.0,6,631,187845.2,293.0,105.16666666666669
108491251.0,6,30,1974,15,1026,7733968.928571428,123.0,68.4,15,948,7733960.857142857,123.0,63.2
27292.0,6,10,2032,5,524,6176.0,252.0,104.8,5,1508,5916.0,1236.0,301.6
258144.0,6,3,337,2,214,0.0,160.0,107.0,1,123,0.0,123.0,123.0
125299885.0,6,32,2151,16,1002,7840629.266666667,123.0,62.625,16,1149,7687551.466666667,123.0,71.8125
103265.0,17,2,700,2,700,0.0,350.0,350.0,0,0,0.0,0.0,0.0
305934.0,6,6,412,4,272,101978.0,74.0,68.0,2,140,0.0,74.0,70.0
1307072.0,6,4,264,2,132,0.0,66.0,66.0,2,132,0.0,66.0,66.0
70680.0,6,10,2032,5,524,17316.25,252.0,104.8,5,1508,17402.25,1236.0,301.6
19647.0,6,14,4740,7,653,2859.6666666666665,249.0,93.28571428571428,7,4087,3133.1666666666665,1514.0,583.8571428571429
92362418.0,17,12,778,6,389,18401450.0,174.0,64.83333333333333,6,389,18400163.0,174.0,64.83333333333333
90253738.0,6,16,2368,9,1204,11281717.25,188.0,133.77777777777777,7,1164,15015032.333333334,204.0,166.28571428571428
120040218.0,17,29,13785,29,13785,4287150.642857143,501.0,475.3448275862069,0,0,0.0,0.0,0.0
372.0,17,2,204,1,88,0.0,88.0,88.0,1,116,0.0,116.0,116.0
110984120.0,6,31,2166,16,1149,7384551.733333333,123.0,71.8125,15,1017,7912017.214285715,123.0,67.8
9887.0,6,10,1975,5,467,2238.0,195.0,93.4,5,1508,2183.0,1236.0,301.6
120123273.0,6,14,2240,6,1224,24024654.6,204.0,204.0,8,1016,17137066.714285713,188.0,127.0
135136359.0,17,6,1146,6,1146,27027271.8,191.0,191.0,0,0,0.0,0.0,0.0
19054.0,6,14,4740,7,653,2790.6666666666665,249.0,93.28571428571428,7,4087,2892.6666666666665,1514.0,583.8571428571429
5007873.0,17,4,849,2,166,0.0,83.0,83.0,2,683,0.0,499.0,341.5
156387.0,17,2,180,1,90,0.0,90.0,90.0,1,90,0.0,90.0,90.0
14615.0,6,14,4740,7,653,2212.6666666666665,249.0,93.28571428571428,7,4087,2290.6666666666665,1514.0,583.8571428571429
147946.0,17,2,180,1,90,0.0,90.0,90.0,1,90,0.0,90.0,90.0
120013968.0,17,28,13364,28,13364,4444961.777777778,501.0,477.2857142857143,0,0,0.0,0.0,0.0
107641034.0,6,44,2904,22,1452,5125763.523809524,66.0,66.0,22,1452,5111421.571428572,66.0,66.0
3328.0,17,2,398,1,88,0.0,88.0,88.0,1,310,0.0,310.0,310.0
111254.0,17,2,286,2,286,0.0,143.0,143.0,0,0,0.0,0.0,0.0
323.0,17,2,174,1,79,0.0,79.0,79.0,1,95,0.0,95.0,95.0
93195518.0,6,194,22008,97,15384,968533.3854166666,300.0,158.5979381443299,97,6624,968532.7604166666,140.0,68.28865979381443
99001110.0,17,11,735,6,389,19800222.0,174.0,64.83333333333333,5,346,19739083.5,174.0,69.2
34127.0,6,14,4740,7,653,5513.333333333333,249.0,93.28571428571428,7,4087,4473.0,1514.0,583.8571428571429
109840.0,6,2,132,1,66,0.0,66.0,66.0,1,66,0.0,66.0,66.0
135148168.0,17,6,1206,6,1206,27029633.6,201.0,201.0,0,0,0.0,0.0,0.0
93227723.0,6,40,2640,20,1320,4906722.263157895,66.0,66.0,20,1320,4890474.684210527,66.0,66.0
1314720.0,6,4,264,2,132,0.0,66.0,66.0,2,132,0.0,66.0,66.0
10053.0,6,11,2098,6,590,1809.8,252.0,98.33333333333331,5,1508,1929.5,1236.0,301.6
60556.0,6,10,2032,5,524,14445.75,252.0,104.8,5,1508,14657.75,1236.0,301.6
14647155.0,6,21,1907,11,1275,1433970.1,406.0,115.9090909090909,10,632,1593274.0,78.0,63.2
32885.0,6,14,4740,7,653,5203.0,249.0,93.28571428571428,7,4087,4822.666666666667,1514.0,583.8571428571429
268070.0,6,10,1221,6,636,53614.0,298.0,106.0,4,585,82454.66666666667,379.0,146.25
35749.0,6,14,4740,7,653,4790.833333333333,249.0,93.28571428571428,7,4087,5820.833333333333,1514.0,583.8571428571429
33932.0,6,13,1479,7,882,5655.333333333333,291.0,126.0,6,597,5970.0,259.0,99.5
223486.0,17,2,180,1,90,0.0,90.0,90.0,1,90,0.0,90.0,90.0
1865.0,17,2,664,1,322,0.0,322.0,322.0,1,342,0.0,342.0,342.0
193108.0,17,2,180,1,90,0.0,90.0,90.0,1,90,0.0,90.0,90.0
206134.0,6,3,426,2,280,0.0,214.0,140.0,1,146,0.0,146.0,146.0
118733910.0,6,34,2488,18,1348,6984347.647058823,139.0,74.88888888888889,16,1140,7235439.333333333,123.0,71.25
120035081.0,17,28,13364,28,13364,4445743.740740741,501.0,477.2857142857143,0,0,0.0,0.0,0.0
135132098.0,17,6,1146,6,1146,27026419.6,191.0,191.0,0,0,0.0,0.0,0.0
119593222.0,6,20,1490,10,745,13288135.777777778,95.0,74.5,10,745,13259825.444444444,95.0,74.5
111207752.0,6,237,26980,119,18896,942438.5762711863,284.0,158.78991596638656,118,8084,941681.3076923076,140.0,68.50847457627118
147948.0,17,2,180,1,90,0.0,90.0,90.0,1,90,0.0,90.0,90.0
207115.0,6,3,426,2,280,0.0,214.0,140.0,1,146,0.0,146.0,146.0
120122442.0,6,12,1832,8,1016,17137098.285714287,188.0,127.0,4,816,30030569.666666668,204.0,204.0
57482.0,6,10,2032,5,524,14163.25,252.0,104.8,5,1508,11965.75,1236.0,301.6
295684.0,17,2,180,1,90,0.0,90.0,90.0,1,90,0.0,90.0,90.0
26281.0,6,10,2032,5,524,6209.25,252.0,104.8,5,1508,6086.5,1236.0,301.6
203800.0,17,2,762,2,762,0.0,381.0,381.0,0,0,0.0,0.0,0.0
211306.0,17,2,762,2,762,0.0,381.0,381.0,0,0,0.0,0.0,0.0
153551.0,17,2,180,1,90,0.0,90.0,90.0,1,90,0.0,90.0,90.0
228349.0,17,2,180,1,90,0.0,90.0,90.0,1,90,0.0,90.0,90.0
317717.0,17,4,1400,4,1400,105905.66666666669,350.0,350.0,0,0,0.0,0.0,0.0
63039.0,6,14,4740,7,653,6190.0,249.0,93.28571428571428,7,4087,9626.666666666666,1514.0,583.8571428571429
31192.0,6,13,1479,7,882,5198.666666666667,291.0,126.0,6,597,5507.6,259.0,99.5
1606662.0,6,4,276,2,128,0.0,74.0,64.0,2,148,0.0,74.0,74.0
534324.0,17,6,2100,6,2100,106864.8,350.0,350.0,0,0,0.0,0.0,0.0
90033768.0,17,28,13364,28,13364,3334584.0,501.0,477.2857142857143,0,0,0.0,0.0,0.0
310999.0,17,4,1400,4,1400,103666.33333333331,350.0,350.0,0,0,0.0,0.0,0.0
3848761.0,6,5,336,2,134,0.0,68.0,67.0,3,202,1525098.0,70.0,67.33333333333333
20106.0,17,2,582,1,83,0.0,83.0,83.0,1,499,0.0,499.0,499.0
2599716.0,6,2,132,1,66,0.0,66.0,66.0,1,66,0.0,66.0,66.0
206860.0,17,2,762,2,762,0.0,381.0,381.0,0,0,0.0,0.0,0.0
578093.0,6,4,508,2,238,0.0,172.0,119.0,2,270,0.0,135.0,135.0
217848.0,6,3,426,2,280,0.0,214.0,140.0,1,146,0.0,146.0,146.0
192303.0,17,2,180,1,90,0.0,90.0,90.0,1,90,0.0,90.0,90.0
16769.0,6,13,1459,7,862,2643.6666666666665,271.0,123.14285714285714,6,597,2974.8,259.0,99.5
7574321.0,17,4,1376,3,1026,70714.5,342.0,342.0,1,350,0.0,350.0,350.0
204630.0,17,3,1143,3,1143,102315.0,381.0,381.0,0,0,0.0,0.0,0.0
93492490.0,6,727,137598,358,23998,261862.42577030807,214.0,67.03351955307262,369,113600,254015.125,1514.0,307.8590785907859
115309227.0,6,229,25800,115,7812,1011484.447368421,140.0,67.9304347826087,114,17988,1011161.0530973452,284.0,157.78947368421052
868349.0,6,9,1270,6,799,173669.8,461.0,133.16666666666666,3,471,296357.5,331.0,157.0
305259.0,6,6,412,4,272,101753.0,74.0,68.0,2,140,0.0,74.0,70.0
153416.0,17,2,180,1,90,0.0,90.0,90.0,1,90,0.0,90.0,90.0
246260.0,6,3,337,2,214,0.0,160.0,107.0,1,123,0.0,123.0,123.0
100242813.0,6,23,1854,12,894,9112983.0,95.0,74.5,11,960,9998655.8,215.0,87.27272727272727
197148.0,17,2,180,1,90,0.0,90.0,90.0,1,90,0.0,90.0,90.0
32684490.0,6,5,336,2,134,0.0,68.0,67.0,3,202,15054101.0,70.0,67.33333333333333
90258971.0,6,12,1832,8,1016,12894138.714285716,188.0,127.0,4,816,30031254.0,204.0,204.0
108101483.0,17,5,955,5,955,27025370.75,191.0,191.0,0,0,0.0,0.0,0.0
156170.0,6,11,1132,6,556,31017.8,218.0,92.66666666666669,5,576,37930.0,304.0,115.2
103816885.0,6,32,2358,17,1272,6475068.3125,123.0,74.82352941176471,15,1086,7400077.857142857,123.0,72.4
38915812.0,6,26,7627,14,3735,183956.0769230769,1514.0,266.7857142857143,12,3892,3519150.363636364,1514.0,324.3333333333333
120125196.0,6,13,2036,5,1020,30031299.0,204.0,204.0,8,1016,17136556.57142857,188.0,127.0
228687.0,17,2,180,1,90,0.0,90.0,90.0,1,90,0.0,90.0,90.0
18813.0,6,2,145,2,145,0.0,91.0,72.5,0,0,0.0,0.0,0.0
90042201.0,17,28,13364,28,13364,3334896.333333333,501.0,477.2857142857143,0,0,0.0,0.0,0.0
209455.0,17,2,180,1,90,0.0,90.0,90.0,1,90,0.0,90.0,90.0
114477248.0,6,30,1974,15,1026,8161536.428571428,123.0,68.4,15,948,8161530.928571428,123.0,63.2
23896.0,6,10,2032,5,524,4609.25,252.0,104.8,5,1508,5287.0,1236.0,301.6
119655573.0,6,222,25118,111,17484,1085821.181818182,284.0,157.51351351351352,111,7634,1085821.518181818,140.0,68.77477477477477
202570.0,17,2,762,2,762,0.0,381.0,381.0,0,0,0.0,0.0,0.0
500936.00000000006,6,5,336,2,134,0.0,68.0,67.0,3,202,192501.5,70.0,67.33333333333333
514.0,17,2,166,1,75,0.0,75.0,75.0,1,91,0.0,91.0,91.0
246646.0,6,3,337,2,214,0.0,160.0,107.0,1,123,0.0,123.0,123.0
17854.0,6,10,2032,5,524,3126.75,252.0,104.8,5,1508,4032.0,1236.0,301.6
108104101.0,17,5,1005,5,1005,27026025.25,201.0,201.0,0,0,0.0,0.0,0.0
2083269.0,6,19,6869,11,1567,208326.9,408.0,142.45454545454547,8,5302,234827.2857142857,1514.0,662.75
128016458.0,17,15,907,8,475,18288065.42857143,174.0,59.375,7,432,18000168.333333332,174.0,61.71428571428572
48260.0,6,14,4740,7,653,7349.166666666667,249.0,93.28571428571428,7,4087,7583.0,1514.0,583.8571428571429
153644.0,17,2,180,1,90,0.0,90.0,90.0,1,90,0.0,90.0,90.0
39986.0,6,14,4740,7,653,6403.166666666667,249.0,93.28571428571428,7,4087,6441.333333333333,1514.0,583.8571428571429
4584.0,17,2,618,1,72,0.0,72.0,72.0,1,546,0.0,546.0,546.0
148103.0,17,2,180,1,90,0.0,90.0,90.0,1,90,0.0,90.0,90.0
394058.0,6,10,1221,6,636,78811.6,298.0,106.0,4,585,125966.0,379.0,146.25
99948953.0,6,24,1500,12,783,9066644.363636363,123.0,65.25,12,717,9066428.181818182,123.0,59.75
355.0,17,2,160,1,80,0.0,80.0,80.0,1,80,0.0,80.0,80.0
311120.0,6,3,202,2,128,0.0,74.0,64.0,1,74,0.0,74.0,74.0
90256555.0,6,13,2036,8,1016,12893793.57142857,188.0,127.0,5,1020,22522749.0,204.0,204.0
403.0,17,2,166,1,75,0.0,75.0,75.0,1,91,0.0,91.0,91.0
825.0,17,5,550,5,550,206.25,110.0,110.0,0,0,0.0,0.0,0.0
90289872.0,6,16,1192,8,596,12892160.285714284,95.0,74.5,8,596,12897079.142857144,95.0,74.5
90028615.0,17,27,12943,27,12943,3462639.0384615385,501.0,479.3703703703704,0,0,0.0,0.0,0.0
90760414.0,6,17,1287,9,691,11339180.125,95.0,76.77777777777777,8,596,12964027.857142856,95.0,74.5
197391.0,17,2,180,1,90,0.0,90.0,90.0,1,90,0.0,90.0,90.0
108098942.0,17,5,1005,5,1005,27024735.5,201.0,201.0,0,0,0.0,0.0,0.0
42370.0,6,10,2032,5,524,10339.25,252.0,104.8,5,1508,10241.75,1236.0,301.6
104102.0,17,2,286,2,286,0.0,143.0,143.0,0,0,0.0,0.0,0.0
119014116.0,17,13,821,7,432,19835686.0,174.0,61.71428571428572,6,389,19800158.6,174.0,64.83333333333333
104105108.0,17,14,864,7,432,17333964.166666668,174.0,61.71428571428572,7,432,17333502.0,174.0,61.71428571428572
149721.0,17,2,180,1,90,0.0,90.0,90.0,1,90,0.0,90.0,90.0
0.0,6,1,54,0,0,0.0,0.0,0.0,1,54,0.0,54.0,54.0
62689.99999999999,6,14,4740,7,653,10188.0,249.0,93.28571428571428,7,4087,9711.333333333334,1514.0,583.8571428571429
233223.0,6,3,337,2,214,0.0,160.0,107.0,1,123,0.0,123.0,123.0
11789555.0,6,5,1909,2,892,0.0,826.0,446.0,3,1017,4436304.5,885.0,339.0
90522905.0,6,14,2240,8,1016,12931843.57142857,188.0,127.0,6,1224,18071851.8,204.0,204.0
212685.0,6,3,198,2,132,0.0,66.0,66.0,1,66,0.0,66.0,66.0
10473771.0,6,7,478,4,272,3445561.0,74.0,68.0,3,206,5168199.5,74.0,68.66666666666667
120130012.0,6,15,2444,7,1428,20021668.666666668,204.0,204.0,8,1016,17137238.285714287,188.0,127.0
242433.0,6,3,337,2,214,0.0,160.0,107.0,1,123,0.0,123.0,123.0
10427027.0,6,6,412,3,206,5145248.0,74.0,68.66666666666667,3,206,5145155.5,74.0,68.66666666666667
38942.0,6,14,4740,7,653,6366.0,249.0,93.28571428571428,7,4087,6087.666666666667,1514.0,583.8571428571429
15028.0,17,2,180,1,90,0.0,90.0,90.0,1,90,0.0,90.0,90.0
38024.0,6,10,2032,5,524,9152.25,252.0,104.8,5,1508,8682.5,1236.0,301.6
90257351.0,6,13,1942,8,1080,12893907.285714284,204.0,135.0,5,862,22523698.5,199.0,172.4
2476.0,17,4,344,2,150,0.0,75.0,75.0,2,194,0.0,103.0,97.0
113711226.0,6,47,3102,24,1584,4943955.260869565,66.0,66.0,23,1518,5112000.409090909,66.0,66.0
227535.0,6,3,426,2,280,0.0,214.0,140.0,1,146,0.0,146.0,146.0
27009558.0,17,5,1710,5,1710,6752389.5,342.0,342.0,0,0,0.0,0.0,0.0
1010407.0,6,6,418,3,212,505203.5,78.0,70.66666666666667,3,206,296791.0,70.0,68.66666666666667
106950.0,17,2,286,2,286,0.0,143.0,143.0,0,0,0.0,0.0,0.0
218103.0,6,3,426,2,280,0.0,214.0,140.0,1,146,0.0,146.0,146.0
1190848.0,6,13,3010,8,2382,170121.14285714287,1514.0,297.75,5,628,229521.25,331.0,125.6
8966.0,17,4,823,2,163,0.0,89.0,81.5,2,660,0.0,443.0,330.0
307638.0,6,6,412,4,272,102546.0,74.0,68.0,2,140,0.0,74.0,70.0
16876.0,17,2,180,1,90,0.0,90.0,90.0,1,90,0.0,90.0,90.0
5834420.0,6,4,270,2,134,0.0,68.0,67.0,2,136,0.0,70.0,68.0
17831.0,6,10,2032,5,524,3226.5,252.0,104.8,5,1508,4156.25,1236.0,301.6
148396.0,17,2,414,1,88,0.0,88.0,88.0,1,326,0.0,326.0,326.0
2328.0,17,4,344,2,150,0.0,75.0,75.0,2,194,0.0,103.0,97.0
2014.0,17,4,344,2,150,0.0,75.0,75.0,2,194,0.0,103.0,97.0
444.0,17,2,160,1,80,0.0,80.0,80.0,1,80,0.0,80.0,80.0
110395650.0,17,16,1212,8,606,15714427.42857143,174.0,75.75,8,606,15715235.714285716,174.0,75.75
206649.0,17,2,180,1,90,0.0,90.0,90.0,1,90,0.0,90.0,90.0
318496.0,17,4,1400,4,1400,106165.33333333331,350.0,350.0,0,0,0.0,0.0,0.0
116005025.0,17,15,1169,8,606,16572146.42857143,174.0,75.75,7,563,16000147.666666666,174.0,80.42857142857143
2422.0,17,4,344,2,150,0.0,75.0,75.0,2,194,0.0,103.0,97.0
24360.0,6,14,4740,7,653,3951.0,249.0,93.28571428571428,7,4087,3251.5,1514.0,583.8571428571429
109212787.0,17,14,864,7,432,18166826.33333333,174.0,61.71428571428572,7,432,18167393.83333333,174.0,61.71428571428572
135127888.0,17,6,1146,6,1146,27025577.6,191.0,191.0,0,0,0.0,0.0,0.0
90251099.0,6,14,1964,8,1016,12893014.142857144,188.0,127.0,6,948,18017451.0,204.0,158.0
90217064.0,6,16,1192,8,596,12853666.857142856,95.0,74.5,8,596,12858792.42857143,95.0,74.5
143950.0,17,2,180,1,90,0.0,90.0,90.0,1,90,0.0,90.0,90.0
5005575.0,17,4,849,2,166,0.0,83.0,83.0,2,683,0.0,499.0,341.5
1321457.0,6,4,264,2,132,0.0,66.0,66.0,2,132,0.0,66.0,66.0
115247780.0,6,47,3102,24,1584,5010762.0869565215,66.0,66.0,23,1518,5159999.590909091,66.0,66.0
0.0,17,1,55,1,55,0.0,55.0,55.0,0,0,0.0,0.0,0.0
59817.0,6,14,4740,7,653,9839.666666666666,249.0,93.28571428571428,7,4087,9831.5,1514.0,583.8571428571429
1306998.0,6,4,264,2,132,0.0,66.0,66.0,2,132,0.0,66.0,66.0
207189.0,6,3,426,2,280,0.0,214.0,140.0,1,146,0.0,146.0,146.0
12953.0,17,2,180,1,90,0.0,90.0,90.0,1,90,0.0,90.0,90.0
104608478.0,6,28,1860,14,966,8030216.153846154,123.0,69.0,14,894,8030216.769230769,123.0,63.85714285714285
93077371.0,17,14,4788,14,4788,7159797.769230769,342.0,342.0,0,0,0.0,0.0,0.0
443491.0,6,11,1021,6,444,59928.4,162.0,74.0,5,577,74801.5,349.0,115.4
108107381.0,17,5,955,5,955,27026845.25,191.0,191.0,0,0,0.0,0.0,0.0
48989.0,6,14,4740,7,653,7483.333333333333,249.0,93.28571428571428,7,4087,8026.666666666667,1514.0,583.8571428571429
35090.0,6,14,4740,7,653,5700.333333333333,249.0,93.28571428571428,7,4087,5556.833333333333,1514.0,583.8571428571429
16177.0,6,14,4740,7,653,2586.5,249.0,93.28571428571428,7,4087,2563.5,1514.0,583.8571428571429
442.0,17,2,410,1,78,0.0,78.0,78.0,1,332,0.0,332.0,332.0
148006.0,17,2,180,1,90,0.0,90.0,90.0,1,90,0.0,90.0,90.0
48637.0,6,10,2032,5,524,11737.25,252.0,104.8,5,1508,11881.25,1236.0,301.6
228255.0,17,2,180,1,90,0.0,90.0,90.0,1,90,0.0,90.0,90.0
305193.0,6,6,412,4,272,101731.0,74.0,68.0,2,140,0.0,74.0,70.0
220572.0,6,3,426,2,280,0.0,214.0,140.0,1,146,0.0,146.0,146.0
4628.0,17,2,180,1,90,0.0,90.0,90.0,1,90,0.0,90.0,90.0
120059789.0,17,28,13364,28,13364,4446658.851851852,501.0,477.2857142857143,0,0,0.0,0.0,0.0
108106086.0,17,5,955,5,955,27026521.5,191.0,191.0,0,0,0.0,0.0,0.0
2789774.0,6,2,132,1,66,0.0,66.0,66.0,1,66,0.0,66.0,66.0
378743.0,6,3,202,2,128,0.0,74.0,64.0,1,74,0.0,74.0,74.0
12252.0,6,11,1132,6,556,2179.8,218.0,92.66666666666669,5,576,2839.0,304.0,115.2
32215412.0,6,11,902,7,630,5334849.0,210.0,90.0,4,272,7686489.333333333,74.0,68.0
96040.0,17,2,700,2,700,0.0,350.0,350.0,0,0,0.0,0.0,0.0
121006216.0,17,15,907,8,475,17286602.285714287,174.0,59.375,7,432,16833508.833333332,174.0,61.71428571428572
108107237.0,17,5,955,5,955,27026809.25,191.0,191.0,0,0,0.0,0.0,0.0
216437.0,17,2,180,1,90,0.0,90.0,90.0,1,90,0.0,90.0,90.0
523813.0,17,6,2100,6,2100,104762.6,350.0,350.0,0,0,0.0,0.0,0.0
196949.0,17,2,180,1,90,0.0,90.0,90.0,1,90,0.0,90.0,90.0
2326.0,17,4,344,2,150,0.0,75.0,75.0,2,194,0.0,103.0,97.0
90745804.0,6,19,1436,10,745,10078018.888888888,95.0,74.5,9,691,11342471.625,95.0,76.77777777777777
116011610.0,17,15,1300,8,737,16573087.142857144,174.0,92.125,7,563,16005119.166666666,174.0,80.42857142857143
118726892.0,6,33,2290,17,1125,7420403.1875,123.0,66.17647058823529,16,1165,7249430.266666667,139.0,72.8125
2311.0,17,4,344,2,150,0.0,75.0,75.0,2,194,0.0,103.0,97.0
300689.0,6,6,412,4,272,100229.66666666669,74.0,68.0,2,140,0.0,74.0,70.0
90229735.0,6,16,1192,8,596,12853542.285714284,95.0,74.5,8,596,12859084.42857143,95.0,74.5
203130.0,17,2,762,2,762,0.0,381.0,381.0,0,0,0.0,0.0,0.0
190245.0,17,4,1400,4,1400,63415.0,350.0,350.0,0,0,0.0,0.0,0.0
18483.0,6,10,1067,5,536,3985.25,264.0,107.2,5,531,4186.75,259.0,106.2
2408403.0,6,3,1602,1,752,0.0,752.0,752.0,2,850,0.0,784.0,425.0
108106541.0,17,5,955,5,955,27026635.25,191.0,191.0,0,0,0.0,0.0,0.0
141497.0,17,4,571,2,148,0.0,74.0,74.0,2,423,0.0,280.0,211.5
120231746.0,6,22,1639,11,840,11998216.0,95.0,76.36363636363636,11,799,11997995.6,95.0,72.63636363636364
301720.0,6,6,412,4,272,100573.33333333331,74.0,68.0,2,140,0.0,74.0,70.0
219563.0,6,12,1373,7,714,36593.833333333336,298.0,102.0,5,659,53804.0,379.0,131.8
285005.0,17,2,363,1,79,0.0,79.0,79.0,1,284,0.0,284.0,284.0
319.0,17,2,168,1,76,0.0,76.0,76.0,1,92,0.0,92.0,92.0
232942.0,6,3,337,2,214,0.0,160.0,107.0,1,123,0.0,123.0,123.0
277334.0,17,2,363,1,79,0.0,79.0,79.0,1,284,0.0,284.0,284.0
104180.0,17,2,286,2,286,0.0,143.0,143.0,0,0,0.0,0.0,0.0
336.0,17,2,166,1,75,0.0,75.0,75.0,1,91,0.0,91.0,91.0
45530.0,6,14,4740,7,653,7405.5,249.0,93.28571428571428,7,4087,6379.166666666667,1514.0,583.8571428571429
114114639.0,6,32,2220,16,1149,7593205.866666666,123.0,71.8125,16,1071,7593259.8,123.0,66.9375
255394.0,6,10,1221,6,636,51078.8,298.0,106.0,4,585,79317.66666666667,379.0,146.25
37827.0,6,14,4740,7,653,5323.333333333333,249.0,93.28571428571428,7,4087,6144.833333333333,1514.0,583.8571428571429
117699351.0,6,47,3102,24,1584,5103951.478260869,66.0,66.0,23,1518,5150439.727272728,66.0,66.0
42863.0,6,14,4740,7,653,6762.833333333333,249.0,93.28571428571428,7,4087,7007.333333333333,1514.0,583.8571428571429
719422.0,6,2,132,1,66,0.0,66.0,66.0,1,66,0.0,66.0,66.0
16728.0,6,10,1065,5,534,3873.25,262.0,106.8,5,531,2771.75,259.0,106.2
207153.0,6,3,426,2,280,0.0,214.0,140.0,1,146,0.0,146.0,146.0
108101228.0,17,5,955,5,955,27025307.0,191.0,191.0,0,0,0.0,0.0,0.0
228282.0,17,2,180,1,90,0.0,90.0,90.0,1,90,0.0,90.0,90.0
109531696.0,6,31,2182,16,1165,7302113.066666666,139.0,72.8125,15,1017,7808219.642857143,123.0,67.8
41563.0,6,10,2032,5,524,8917.75,252.0,104.8,5,1508,9307.25,1236.0,301.6
26636.0,6,10,2032,5,524,6322.25,252.0,104.8,5,1508,6367.75,1236.0,301.6
34024.0,6,10,2032,5,524,8278.25,252.0,104.8,5,1508,8179.75,1236.0,301.6
146110.0,6,3,337,1,123,0.0,123.0,123.0,2,214,0.0,160.0,107.0
120120053.0,6,12,1832,8,1016,17136757.85714286,188.0,127.0,4,816,30031263.0,204.0,204.0
103812.0,17,2,286,2,286,0.0,143.0,143.0,0,0,0.0,0.0,0.0
201001.0,17,2,180,1,90,0.0,90.0,90.0,1,90,0.0,90.0,90.0
119007483.0,17,13,821,7,432,19834580.5,174.0,61.71428571428572,6,389,19800132.8,174.0,64.83333333333333
170027.0,17,4,571,2,148,0.0,74.0,74.0,2,423,0.0,276.0,211.5
8319082.999999999,17,3,1034,2,684,0.0,342.0,342.0,1,350,0.0,350.0,350.0
326.0,17,2,166,1,75,0.0,75.0,75.0,1,91,0.0,91.0,91.0
33856.0,6,10,2032,5,524,8092.5,252.0,104.8,5,1508,6582.5,1236.0,301.6
146219.0,6,3,337,2,214,0.0,160.0,107.0,1,123,0.0,123.0,123.0
9003990.0,17,4,300,4,300,3001330.0,75.0,75.0,0,0,0.0,0.0,0.0
264323.0,6,12,1373,7,714,44053.833333333336,298.0,102.0,5,659,62028.75,379.0,131.8
26689.0,6,13,4515,6,512,5155.6,230.0,85.33333333333333,7,4003,3501.6666666666665,1514.0,571.8571428571429
216972.0,6,3,426,2,280,0.0,214.0,140.0,1,146,0.0,146.0,146.0
321547.0,17,4,1400,4,1400,107182.33333333331,350.0,350.0,0,0,0.0,0.0,0.0
329.0,17,2,166,1,75,0.0,75.0,75.0,1,91,0.0,91.0,91.0
1158520.0,6,13,3010,8,2382,165502.85714285713,1514.0,297.75,5,628,221469.75,331.0,125.6
35768.0,6,14,4740,7,653,5409.333333333333,249.0,93.28571428571428,7,4087,5629.0,1514.0,583.8571428571429
90335742.0,6,12,1832,8,1016,12905106.0,188.0,127.0,4,816,30040867.0,204.0,204.0
103593.0,17,2,286,2,286,0.0,143.0,143.0,0,0,0.0,0.0,0.0
2029.0,17,4,344,2,150,0.0,75.0,75.0,2,194,0.0,103.0,97.0
6310.0,17,4,823,2,163,0.0,89.0,81.5,2,660,0.0,443.0,330.0
2099.0,17,4,344,2,150,0.0,75.0,75.0,2,194,0.0,103.0,97.0
4441.0,17,2,614,1,72,0.0,72.0,72.0,1,542,0.0,542.0,542.0
3244311.0,6,158,144833,102,136835,32121.89108910891,1510.0,1341.5196078431372,56,7998,53377.98181818182,1510.0,142.82142857142858
116099960.0,6,48,3168,24,1584,5047824.347826087,66.0,66.0,24,1584,5034304.434782608,66.0,66.0
213748.0,17,2,180,1,90,0.0,90.0,90.0,1,90,0.0,90.0,90.0
232949.0,6,3,373,2,238,0.0,172.0,119.0,1,135,0.0,135.0,135.0
90059725.0,17,28,13364,28,13364,3335545.3703703703,501.0,477.2857142857143,0,0,0.0,0.0,0.0
2389871.0,6,25,7573,14,3735,183836.2307692308,1514.0,266.7857142857143,11,3838,213084.4,1514.0,348.90909090909093
90300700.0,6,20,1531,10,786,10026962.222222222,95.0,78.6,10,745,10002936.777777778,95.0,74.5
90210524.0,6,16,1192,8,596,12851769.285714284,95.0,74.5,8,596,12856449.714285716,95.0,74.5
316540.0,17,4,1400,4,1400,105513.33333333331,350.0,350.0,0,0,0.0,0.0,0.0
302063.0,6,6,412,4,272,100687.66666666669,74.0,68.0,2,140,0.0,74.0,70.0
298283.0,6,6,412,4,272,99427.66666666669,74.0,68.0,2,140,0.0,74.0,70.0
324003.0,6,6,412,4,272,108001.0,74.0,68.0,2,140,0.0,74.0,70.0
14203.0,6,14,4740,7,653,2205.833333333333,249.0,93.28571428571428,7,4087,2229.1666666666665,1514.0,583.8571428571429
216375.0,17,2,180,1,90,0.0,90.0,90.0,1,90,0.0,90.0,90.0
306278.0,6,6,412,4,272,102092.66666666669,74.0,68.0,2,140,0.0,74.0,70.0
90528802.0,6,13,2036,8,1016,12932686.0,188.0,127.0,5,1020,22591177.75,204.0,204.0
442436.0,6,3,1604,2,851,0.0,785.0,425.5,1,753,0.0,753.0,753.0
863252.0,6,9,1196,6,725,172650.4,387.0,120.83333333333331,3,471,293834.5,331.0,157.0
108106202.0,17,5,1005,5,1005,27026550.5,201.0,201.0,0,0,0.0,0.0,0.0
101077374.0,6,209,23686,105,7152,971897.8269230768,140.0,68.11428571428571,104,16534,972327.1067961165,284.0,158.98076923076923
1000282.0,6,12,1354,6,723,199168.2,253.0,120.5,6,631,199629.6,293.0,105.16666666666669
51433.0,6,10,2032,5,524,12494.25,252.0,104.8,5,1508,11742.5,1236.0,301.6
3075716.0,6,4,270,2,134,0.0,68.0,67.0,2,136,0.0,70.0,68.0
871349.0,6,11,2644,7,743,145224.83333333334,339.0,106.14285714285714,4,1901,198519.3333333333,1514.0,475.25
206609.0,17,2,180,1,90,0.0,90.0,90.0,1,90,0.0,90.0,90.0
15164.0,6,11,1132,6,556,2981.8,218.0,92.66666666666669,5,576,2845.25,304.0,115.2
233076.0,6,3,337,2,214,0.0,160.0,107.0,1,123,0.0,123.0,123.0
54804.0,6,14,4740,7,653,7742.833333333333,249.0,93.28571428571428,7,4087,8296.166666666666,1514.0,583.8571428571429
1312313.0,6,4,264,2,132,0.0,66.0,66.0,2,132,0.0,66.0,66.0
34986.0,6,14,4740,7,653,3970.6666666666665,249.0,93.28571428571428,7,4087,5648.833333333333,1514.0,583.8571428571429
91979322.0,17,16,5472,16,5472,6131954.8,342.0,342.0,0,0,0.0,0.0,0.0
108108181.0,17,5,955,5,955,27027045.25,191.0,191.0,0,0,0.0,0.0,0.0
40880.0,6,14,4740,7,653,6537.666666666667,249.0,93.28571428571428,7,4087,6617.0,1514.0,583.8571428571429
9437.0,6,11,2098,6,590,1661.0,252.0,98.33333333333331,5,1508,2118.25,1236.0,301.6
1302505.0,6,4,264,2,132,0.0,66.0,66.0,2,132,0.0,66.0,66.0
108099877.0,17,5,1005,5,1005,27024969.25,201.0,201.0,0,0,0.0,0.0,0.0
2051.0,17,4,344,2,150,0.0,75.0,75.0,2,194,0.0,103.0,97.0
39087.0,6,10,2032,5,524,9399.75,252.0,104.8,5,1508,9504.75,1236.0,301.6
39146.0,6,14,4740,7,653,5948.333333333333,249.0,93.28571428571428,7,4087,6207.0,1514.0,583.8571428571429
9923.0,17,2,582,1,83,0.0,83.0,83.0,1,499,0.0,499.0,499.0
2018.0,17,4,344,2,150,0.0,75.0,75.0,2,194,0.0,103.0,97.0
301231.0,6,6,412,4,272,100410.33333333331,74.0,68.0,2,140,0.0,74.0,70.0
90054039.0,17,28,13364,28,13364,3335334.777777778,501.0,477.2857142857143,0,0,0.0,0.0,0.0
18554.0,6,13,1459,7,862,2985.0,271.0,123.14285714285714,6,597,3542.2,259.0,99.5
112042227.0,6,36,2596,18,1348,6590719.235294118,139.0,74.88888888888889,18,1248,6578006.0,123.0,69.33333333333333
105180441.0,17,14,864,7,432,17500823.166666668,174.0,61.71428571428572,7,432,17500211.166666668,174.0,61.71428571428572
205912.0,6,3,426,2,280,0.0,214.0,140.0,1,146,0.0,146.0,146.0
878940.0,6,10,1334,6,797,175788.0,459.0,132.83333333333334,4,537,201144.0,331.0,134.25
441717.0,6,11,1021,6,444,59463.2,162.0,74.0,5,577,74240.0,349.0,115.4
90257357.0,6,13,2036,8,1016,12893908.142857144,188.0,127.0,5,1020,22522950.25,204.0,204.0
299364.0,6,6,412,4,272,99788.0,74.0,68.0,2,140,0.0,74.0,70.0
284291.0,17,2,363,1,79,0.0,79.0,79.0,1,284,0.0,284.0,284.0
319964.0,17,4,1400,4,1400,106654.66666666669,350.0,350.0,0,0,0.0,0.0,0.0
9389.0,17,2,582,1,83,0.0,83.0,83.0,1,499,0.0,499.0,499.0
209589.0,17,2,180,1,90,0.0,90.0,90.0,1,90,0.0,90.0,90.0
155493.0,6,3,337,2,214,0.0,160.0,107.0,1,123,0.0,123.0,123.0
16947.0,6,11,1131,6,600,2930.8,262.0,100.0,5,531,3912.0,259.0,106.2
1813.0,17,2,176,1,80,0.0,80.0,80.0,1,96,0.0,96.0,96.0
90228648.0,6,17,1287,8,596,12853455.714285716,95.0,74.5,9,691,11251668.375,95.0,76.77777777777777
118504689.0,6,452,55300,226,40088,525729.6044444444,464.0,177.38053097345133,226,15212,525729.8888888889,140.0,67.30973451327434
217381.0,6,3,426,2,280,0.0,214.0,140.0,1,146,0.0,146.0,146.0
198426.0,17,4,6056,4,6056,66142.0,1514.0,1514.0,0,0,0.0,0.0,0.0
309162.0,6,6,412,4,272,103054.0,74.0,68.0,2,140,0.0,74.0,70.0
255434.0,6,3,337,2,214,0.0,160.0,107.0,1,123,0.0,123.0,123.0
158954.0,6,3,337,2,214,0.0,160.0,107.0,1,123,0.0,123.0,123.0
23377.0,6,10,2032,5,524,5536.25,252.0,104.8,5,1508,5117.25,1236.0,301.6
98336.0,17,2,286,2,286,0.0,143.0,143.0,0,0,0.0,0.0,0.0
90525074.0,6,13,2036,8,1016,12932153.42857143,188.0,127.0,5,1020,22590255.75,204.0,204.0
1207851.0,17,7,490,7,490,201308.5,70.0,70.0,0,0,0.0,0.0,0.0
1317721.0,6,4,264,2,132,0.0,66.0,66.0,2,132,0.0,66.0,66.0
90057706.0,17,28,13364,28,13364,3335470.592592593,501.0,477.2857142857143,0,0,0.0,0.0,0.0
300689.0,6,6,412,4,272,100229.66666666669,74.0,68.0,2,140,0.0,74.0,70.0
149893.0,6,3,337,2,214,0.0,160.0,107.0,1,123,0.0,123.0,123.0
40992.0,6,10,2032,5,524,8254.75,252.0,104.8,5,1508,10088.25,1236.0,301.6
43333.0,6,14,4740,7,653,5856.5,249.0,93.28571428571428,7,4087,5915.666666666667,1514.0,583.8571428571429
102001387.0,17,13,821,7,432,17000231.166666668,174.0,61.71428571428572,6,389,16401275.0,174.0,64.83333333333333
35221.0,6,10,2032,5,524,8197.0,252.0,104.8,5,1508,8222.0,1236.0,301.6
246079.0,6,3,337,2,214,0.0,160.0,107.0,1,123,0.0,123.0,123.0
123250560.0,6,49,3234,25,1650,5135440.0,66.0,66.0,24,1584,4942102.782608695,66.0,66.0
19956.0,6,20,7606,11,978,1995.6,310.0,88.9090909090909,9,6628,2166.0,1514.0,736.4444444444445
216456.0,17,2,180,1,90,0.0,90.0,90.0,1,90,0.0,90.0,90.0
31525.0,6,13,1386,7,789,5207.333333333333,253.0,112.71428571428572,6,597,5015.0,259.0,99.5
217470.0,6,3,426,2,280,0.0,214.0,140.0,1,146,0.0,146.0,146.0
47610085.0,6,8,1940,3,887,22414979.0,753.0,295.6666666666667,5,1053,11208147.75,785.0,210.6
2408.0,17,4,344,2,150,0.0,75.0,75.0,2,194,0.0,103.0,97.0
301968.0,6,3,202,2,128,0.0,74.0,64.0,1,74,0.0,74.0,74.0
135141057.0,17,6,1146,6,1146,27028211.4,191.0,191.0,0,0,0.0,0.0,0.0
120180703.0,6,238,26754,119,8150,1011506.2711864408,140.0,68.4873949579832,119,18604,1002674.754237288,284.0,156.3361344537815
448123.0,17,4,360,2,140,0.0,70.0,70.0,2,220,0.0,110.0,110.0
120083035.0,6,214,24218,107,7284,1125233.20754717,140.0,68.07476635514018,107,16934,1125083.70754717,284.0,158.26168224299064
148563.0,17,2,414,1,88,0.0,88.0,88.0,1,326,0.0,326.0,326.0
108106491.0,17,5,955,5,955,27026622.75,191.0,191.0,0,0,0.0,0.0,0.0
204974.0,17,2,180,1,90,0.0,90.0,90.0,1,90,0.0,90.0,90.0
217762.0,6,3,426,2,280,0.0,214.0,140.0,1,146,0.0,146.0,146.0
1034513.0,6,11,1134,6,558,206902.60000000003,220.0,93.0,5,576,257459.25,304.0,115.2
197064.0,17,2,180,1,90,0.0,90.0,90.0,1,90,0.0,90.0,90.0
1309662.0,6,4,264,2,132,0.0,66.0,66.0,2,132,0.0,66.0,66.0
129976718.0,6,35,2394,18,1269,7645689.294117647,123.0,70.5,17,1125,7486714.8125,123.0,66.17647058823529
306767.0,6,6,412,4,272,102255.66666666669,74.0,68.0,2,140,0.0,74.0,70.0
50963.0,6,14,4740,7,653,7847.333333333333,249.0,93.28571428571428,7,4087,8337.666666666666,1514.0,583.8571428571429
66754.0,6,10,2032,5,524,16308.0,252.0,104.8,5,1508,14312.5,1236.0,301.6
259042.0,6,3,337,2,214,0.0,160.0,107.0,1,123,0.0,123.0,123.0
10485061.0,6,6,412,3,206,5174137.5,74.0,68.66666666666667,3,206,5174003.0,74.0,68.66666666666667
20851.0,6,11,1132,6,556,3572.0,218.0,92.66666666666669,5,576,4577.25,304.0,115.2
44751.0,6,14,4740,7,653,6758.333333333333,249.0,93.28571428571428,7,4087,7314.166666666667,1514.0,583.8571428571429
47943.0,6,14,4740,7,653,7871.833333333333,249.0,93.28571428571428,7,4087,5803.833333333333,1514.0,583.8571428571429
13625704.0,6,20,1607,10,975,1478108.111111111,315.0,97.5,10,632,1477822.7777777778,78.0,63.2
10534989.0,6,7,478,4,272,3466221.333333333,74.0,68.0,3,206,5199215.5,74.0,68.66666666666667
105880215.0,6,44,2904,22,1452,5041915.0,66.0,66.0,22,1452,5027024.333333333,66.0,66.0
286695.0,17,2,363,1,79,0.0,79.0,79.0,1,284,0.0,284.0,284.0
90255724.0,6,13,2036,8,1016,12893674.857142856,188.0,127.0,5,1020,22523622.25,204.0,204.0
999.0,17,4,438,2,148,0.0,74.0,74.0,2,290,0.0,147.0,145.0
247114.0,17,2,180,1,90,0.0,90.0,90.0,1,90,0.0,90.0,90.0
90254252.0,6,12,1832,8,1016,12893464.57142857,188.0,127.0,4,816,30031068.666666668,204.0,204.0
90037454.0,17,27,12943,27,12943,3462979.0,501.0,479.3703703703704,0,0,0.0,0.0,0.0
309110.0,6,6,412,4,272,103036.66666666669,74.0,68.0,2,140,0.0,74.0,70.0
100380552.0,17,12,778,6,389,20000053.0,174.0,64.83333333333333,6,389,20000247.4,174.0,64.83333333333333
99206445.0,6,198,22314,99,15558,1010115.4285714284,284.0,157.15151515151516,99,6756,1010115.2653061224,140.0,68.24242424242425
74332.0,6,14,4740,7,653,12257.666666666666,249.0,93.28571428571428,7,4087,9416.333333333334,1514.0,583.8571428571429
108885.0,6,10,1066,5,490,26394.25,218.0,98.0,5,576,27017.75,304.0,115.2
14604.0,17,4,344,2,150,0.0,75.0,75.0,2,194,0.0,103.0,97.0
90046847.0,17,28,13364,28,13364,3335068.407407407,501.0,477.2857142857143,0,0,0.0,0.0,0.0
103213.0,17,2,286,2,286,0.0,143.0,143.0,0,0,0.0,0.0,0.0
3059555.0,6,12,2172,7,664,508880.6666666667,252.0,94.85714285714286,5,1508,4198.0,1236.0,301.6
26817399.0,17,5,1710,5,1710,6704349.75,342.0,342.0,0,0,0.0,0.0,0.0
233108.0,6,3,337,2,214,0.0,160.0,107.0,1,123,0.0,123.0,123.0
206199.0,6,3,426,2,280,0.0,214.0,140.0,1,146,0.0,146.0,146.0
2024.0,17,4,344,2,150,0.0,75.0,75.0,2,194,0.0,103.0,97.0
347.0,17,2,174,1,79,0.0,79.0,79.0,1,95,0.0,95.0,95.0
22295.0,6,14,4740,7,653,3497.833333333333,249.0,93.28571428571428,7,4087,3583.1666666666665,1514.0,583.8571428571429
90259111.0,6,12,1832,8,1016,12894158.714285716,188.0,127.0,4,816,30031846.666666668,204.0,204.0
137853.0,6,2,132,1,66,0.0,66.0,66.0,1,66,0.0,66.0,66.0
19528.0,6,11,1133,6,602,3855.0,264.0,100.33333333333331,5,531,3755.75,259.0,106.2
20385.0,6,14,4740,7,653,3060.833333333333,249.0,93.28571428571428,7,4087,3232.0,1514.0,583.8571428571429
54619.0,6,14,4740,7,653,6545.5,249.0,93.28571428571428,7,4087,8959.0,1514.0,583.8571428571429
6782.0,17,2,582,1,83,0.0,83.0,83.0,1,499,0.0,499.0,499.0
379.0,17,2,508,2,508,0.0,257.0,254.0,0,0,0.0,0.0,0.0
99534.0,17,2,762,2,762,0.0,381.0,381.0,0,0,0.0,0.0,0.0
241904.0,6,3,337,2,214,0.0,160.0,107.0,1,123,0.0,123.0,123.0
1472490.0,17,16,1120,16,1120,98166.0,70.0,70.0,0,0,0.0,0.0,0.0
3026848.0,6,3,1604,2,851,0.0,785.0,425.5,1,753,0.0,753.0,753.0
24944.0,17,2,180,1,90,0.0,90.0,90.0,1,90,0.0,90.0,90.0
243983.0,6,3,337,2,214,0.0,160.0,107.0,1,123,0.0,123.0,123.0
2009.0,17,4,344,2,150,0.0,75.0,75.0,2,194,0.0,103.0,97.0
305524.0,6,6,412,4,272,101841.33333333331,74.0,68.0,2,140,0.0,74.0,70.0
377.0,17,2,267,1,83,0.0,83.0,83.0,1,184,0.0,184.0,184.0
228479.0,17,2,180,1,90,0.0,90.0,90.0,1,90,0.0,90.0,90.0
106238662.0,6,36,2850,17,1332,6639916.375,123.0,78.3529411764706,19,1518,5335323.333333333,123.0,79.89473684210526
122486399.0,6,32,2157,16,1071,7500092.6,123.0,66.9375,16,1086,8165649.6,123.0,67.875
35425.0,6,14,4740,7,653,5681.833333333333,249.0,93.28571428571428,7,4087,5745.333333333333,1514.0,583.8571428571429
210649.0,6,3,426,2,280,0.0,214.0,140.0,1,146,0.0,146.0,146.0
861482.0,6,10,1065,5,534,214789.25,262.0,106.8,5,531,214992.25,259.0,106.2
90067305.0,17,28,13364,28,13364,3335826.111111111,501.0,477.2857142857143,0,0,0.0,0.0,0.0
319279.0,17,4,1400,4,1400,106426.33333333331,350.0,350.0,0,0,0.0,0.0,0.0
56331.0,6,14,4740,7,653,8467.666666666666,249.0,93.28571428571428,7,4087,9146.666666666666,1514.0,583.8571428571429
233119.0,6,3,337,2,214,0.0,160.0,107.0,1,123,0.0,123.0,123.0
6715.0,17,2,582,1,83,0.0,83.0,83.0,1,499,0.0,499.0,499.0
72284.0,17,2,180,1,90,0.0,90.0,90.0,1,90,0.0,90.0,90.0
135168693.0,17,6,1206,6,1206,27033738.6,201.0,201.0,0,0,0.0,0.0,0.0
249670.0,17,4,6056,4,6056,83223.33333333333,1514.0,1514.0,0,0,0.0,0.0,0.0
232131.0,6,3,337,2,214,0.0,160.0,107.0,1,123,0.0,123.0,123.0
0.0,17,1,55,1,55,0.0,55.0,55.0,0,0,0.0,0.0,0.0
20000.0,6,14,4740,7,653,2794.1666666666665,249.0,93.28571428571428,7,4087,2992.6666666666665,1514.0,583.8571428571429
321.0,17,2,174,1,79,0.0,79.0,79.0,1,95,0.0,95.0,95.0
42582.0,6,14,4740,7,653,6815.5,249.0,93.28571428571428,7,4087,6648.0,1514.0,583.8571428571429
0.0,17,1,55,1,55,0.0,55.0,55.0,0,0,0.0,0.0,0.0
90972930.0,6,166,18778,83,13078,1106801.6341463414,284.0,157.56626506024097,83,5700,1106801.4024390243,140.0,68.67469879518072
1320438.0,6,4,264,2,132,0.0,66.0,66.0,2,132,0.0,66.0,66.0
40576.0,6,14,4740,7,653,6315.0,249.0,93.28571428571428,7,4087,6401.5,1514.0,583.8571428571429
219632.0,6,10,1221,6,636,43926.4,298.0,106.0,4,585,71938.66666666667,379.0,146.25
10903702.0,6,8,544,4,272,3587891.333333333,74.0,68.0,4,272,3587817.6666666665,74.0,68.0
24822.0,6,10,2032,5,524,5975.25,252.0,104.8,5,1508,5688.25,1236.0,301.6
1156504.0,6,13,3010,8,2382,165214.85714285713,1514.0,297.75,5,628,221007.75,331.0,125.6
105001359.0,17,14,864,7,432,17500226.5,174.0,61.71428571428572,7,432,17334586.333333332,174.0,61.71428571428572
2009.0,17,4,344,2,150,0.0,75.0,75.0,2,194,0.0,103.0,97.0
15874.0,6,11,1132,6,556,2461.4,218.0,92.66666666666669,5,576,3713.75,304.0,115.2
105636.0,17,2,700,2,700,0.0,350.0,350.0,0,0,0.0,0.0,0.0
46259.0,6,10,2032,5,524,11246.75,252.0,104.8,5,1508,10163.0,1236.0,301.6
32260.0,6,14,4740,7,653,5025.166666666667,249.0,93.28571428571428,7,4087,3977.5,1514.0,583.8571428571429
34299.0,6,14,4740,7,653,5512.5,249.0,93.28571428571428,7,4087,5413.333333333333,1514.0,583.8571428571429
281657.0,17,2,363,1,79,0.0,79.0,79.0,1,284,0.0,284.0,284.0
27286747.0,17,5,1710,5,1710,6821686.75,342.0,342.0,0,0,0.0,0.0,0.0
207247.0,6,3,426,2,280,0.0,214.0,140.0,1,146,0.0,146.0,146.0
108104720.0,17,5,1005,5,1005,27026180.0,201.0,201.0,0,0,0.0,0.0,0.0
51728125.0,6,8,2113,3,960,24546358.5,826.0,320.0,5,1153,12236927.25,885.0,230.6
298712.0,6,2,132,1,66,0.0,66.0,66.0,1,66,0.0,66.0,66.0
511759.0,6,4,270,2,134,0.0,68.0,67.0,2,136,0.0,70.0,68.0
144073.0,17,2,180,1,90,0.0,90.0,90.0,1,90,0.0,90.0,90.0
108088090.0,17,5,955,5,955,27022022.5,191.0,191.0,0,0,0.0,0.0,0.0
301513.0,6,6,412,4,272,100504.33333333331,74.0,68.0,2,140,0.0,74.0,70.0
107008.0,17,2,286,2,286,0.0,143.0,143.0,0,0,0.0,0.0,0.0
2411.0,17,4,344,2,150,0.0,75.0,75.0,2,194,0.0,103.0,97.0
1058568.0,6,3,204,2,136,0.0,70.0,68.0,1,68,0.0,68.0,68.0
92144859.0,6,26,1746,13,906,7661706.75,123.0,69.6923076923077,13,840,7661708.166666667,123.0,64.61538461538461
227995.0,6,3,426,2,280,0.0,214.0,140.0,1,146,0.0,146.0,146.0
223433.0,6,3,426,2,280,0.0,214.0,140.0,1,146,0.0,146.0,146.0
24305.0,6,10,2032,5,524,4937.5,252.0,104.8,5,1508,3283.75,1236.0,301.6
148489.0,17,2,414,1,88,0.0,88.0,88.0,1,326,0.0,326.0,326.0
111743.0,17,2,286,2,286,0.0,143.0,143.0,0,0,0.0,0.0,0.0
10583012.0,6,7,478,4,272,3467426.6666666665,74.0,68.0,3,206,5201038.5,74.0,68.66666666666667
219555.0,17,2,762,2,762,0.0,381.0,381.0,0,0,0.0,0.0,0.0
103064077.0,6,44,2904,22,1452,4907813.19047619,66.0,66.0,22,1452,4899057.333333333,66.0,66.0
59953.0,6,10,2032,5,524,14072.5,252.0,104.8,5,1508,11340.0,1236.0,301.6
34928.0,6,14,4740,7,653,5649.0,249.0,93.28571428571428,7,4087,4650.166666666667,1514.0,583.8571428571429
2457712.0,6,2,132,1,66,0.0,66.0,66.0,1,66,0.0,66.0,66.0
34345.0,6,14,4740,7,653,5564.166666666667,249.0,93.28571428571428,7,4087,5456.666666666667,1514.0,583.8571428571429
120373822.0,6,237,26906,119,18822,1020117.1355932204,374.0,158.16806722689077,118,8084,1019999.3247863248,140.0,68.50847457627118
108837558.0,6,33,2296,17,1225,6788858.4375,139.0,72.05882352941177,16,1071,7241448.4,123.0,66.9375
51106.0,17,2,180,1,90,0.0,90.0,90.0,1,90,0.0,90.0,90.0
120117669.0,6,12,1832,8,1016,17136620.0,188.0,127.0,4,816,30030965.0,204.0,204.0
22729.0,6,10,2032,5,524,5408.0,252.0,104.8,5,1508,5379.75,1236.0,301.6
153487.0,17,2,180,1,90,0.0,90.0,90.0,1,90,0.0,90.0,90.0
313.0,17,2,174,1,79,0.0,79.0,79.0,1,95,0.0,95.0,95.0
10521757.0,6,7,478,4,272,3461687.6666666665,74.0,68.0,3,206,5192428.0,74.0,68.66666666666667
864388.0,6,10,1333,6,796,172877.6,458.0,132.66666666666666,4,537,197308.3333333333,331.0,134.25
135131458.0,17,6,1206,6,1206,27026291.6,201.0,201.0,0,0,0.0,0.0,0.0
300649.0,6,6,412,4,272,100216.33333333331,74.0,68.0,2,140,0.0,74.0,70.0
509172.0,6,5,336,2,134,0.0,68.0,67.0,3,202,196878.5,70.0,67.33333333333333
321.0,17,2,160,1,80,0.0,80.0,80.0,1,80,0.0,80.0,80.0
199605.0,6,13,1513,7,882,32413.166666666668,291.0,126.0,6,631,38892.4,293.0,105.16666666666669
90523660.0,6,13,2036,8,1016,12931951.42857143,188.0,127.0,5,1020,22590017.75,204.0,204.0
113618867.0,6,46,3036,23,1518,5150436.227272728,66.0,66.0,23,1518,5150436.318181818,66.0,66.0
110755788.0,6,30,2106,15,1017,7911127.714285715,123.0,67.8,15,1089,7182521.357142857,123.0,72.6
215671.0,6,12,1373,7,714,35945.166666666664,298.0,102.0,5,659,53147.75,379.0,131.8
353.0,17,2,267,1,83,0.0,83.0,83.0,1,184,0.0,184.0,184.0
21286.0,6,10,2032,5,524,4800.0,252.0,104.8,5,1508,4605.25,1236.0,301.6
100091.0,17,2,286,2,286,0.0,143.0,143.0,0,0,0.0,0.0,0.0
90038099.0,17,28,13364,28,13364,3334744.407407407,501.0,477.2857142857143,0,0,0.0,0.0,0.0
135153586.0,17,6,1206,6,1206,27030717.2,201.0,201.0,0,0,0.0,0.0,0.0
217826.0,6,3,426,2,280,0.0,214.0,140.0,1,146,0.0,146.0,146.0
217815.0,6,3,426,2,280,0.0,214.0,140.0,1,146,0.0,146.0,146.0
1031741.0,6,11,1134,6,558,206348.2,220.0,93.0,5,576,256834.25,304.0,115.2
43833.0,6,14,4740,7,653,6912.666666666667,249.0,93.28571428571428,7,4087,6997.5,1514.0,583.8571428571429
845463.0,6,9,1196,6,725,169092.6,387.0,120.83333333333331,3,471,284647.5,331.0,157.0
15969683.0,6,10,1221,6,636,3193936.6,298.0,106.0,4,585,5322173.333333333,379.0,146.25
105566.0,17,2,762,2,762,0.0,381.0,381.0,0,0,0.0,0.0,0.0
108099120.0,17,5,1005,5,1005,27024780.0,201.0,201.0,0,0,0.0,0.0,0.0
2049.0,17,4,344,2,150,0.0,75.0,75.0,2,194,0.0,103.0,97.0
90262061.0,6,13,2036,8,1016,12894580.142857144,188.0,127.0,5,1020,22523854.25,204.0,204.0
315216.0,17,4,704,2,148,0.0,74.0,74.0,2,556,0.0,280.0,278.0
47543.0,6,10,2032,5,524,11601.25,252.0,104.8,5,1508,10652.5,1236.0,301.6
34100.0,6,14,4740,7,653,5517.166666666667,249.0,93.28571428571428,7,4087,5511.666666666667,1514.0,583.8571428571429
24675.0,6,14,4740,7,653,3987.0,249.0,93.28571428571428,7,4087,3605.0,1514.0,583.8571428571429
82.0,17,2,762,2,762,0.0,381.0,381.0,0,0,0.0,0.0,0.0
9989.0,17,2,582,1,83,0.0,83.0,83.0,1,499,0.0,499.0,499.0
103296281.0,6,44,2904,22,1452,4918870.523809524,66.0,66.0,22,1452,4908577.666666667,66.0,66.0
869345.0,6,10,1221,6,636,173869.0,298.0,106.0,4,585,288587.6666666667,379.0,146.25
748810.0,6,11,1021,6,444,100271.8,162.0,74.0,5,577,125254.5,349.0,115.4
107669.0,17,2,286,2,286,0.0,143.0,143.0,0,0,0.0,0.0,0.0
2803142.0,6,2,132,1,66,0.0,66.0,66.0,1,66,0.0,66.0,66.0
120617126.0,6,36,2872,16,1278,7682352.866666666,123.0,79.875,20,1594,6348247.7894736845,139.0,79.7
15284.0,6,11,2098,6,590,2460.0,252.0,98.33333333333331,5,1508,3498.25,1236.0,301.6
90293516.0,6,15,1097,8,596,12899073.714285716,95.0,74.5,7,501,14998391.666666666,95.0,71.57142857142857
25874200.0,6,27,7681,14,3735,255354.6923076923,1514.0,266.7857142857143,13,3946,2138155.9166666665,1514.0,303.53846153846155
1306984.0,6,4,264,2,132,0.0,66.0,66.0,2,132,0.0,66.0,66.0
65229.99999999999,6,11,2098,6,590,12861.8,252.0,98.33333333333331,5,1508,13971.25,1236.0,301.6
147101.0,6,3,373,2,238,0.0,172.0,119.0,1,135,0.0,135.0,135.0
90760527.0,6,24,1829,13,989,7559764.583333333,95.0,76.07692307692308,11,840,9001139.5,95.0,76.36363636363636
108115658.0,17,5,955,5,955,27028914.5,191.0,191.0,0,0,0.0,0.0,0.0
90374847.0,6,17,1287,9,691,11290477.375,95.0,76.77777777777777,8,596,12909124.857142856,95.0,74.5
30779.0,6,14,4740,7,653,4909.166666666667,249.0,93.28571428571428,7,4087,4900.5,1514.0,583.8571428571429
2551.0,17,2,180,1,90,0.0,90.0,90.0,1,90,0.0,90.0,90.0
781.0,17,4,438,2,148,0.0,74.0,74.0,2,290,0.0,147.0,145.0
107506.0,17,2,286,2,286,0.0,143.0,143.0,0,0,0.0,0.0,0.0
143997.0,17,2,180,1,90,0.0,90.0,90.0,1,90,0.0,90.0,90.0
108103950.0,17,5,955,5,955,27025987.5,191.0,191.0,0,0,0.0,0.0,0.0
460.0,17,2,166,1,75,0.0,75.0,75.0,1,91,0.0,91.0,91.0
120167.0,17,2,180,1,70,0.0,70.0,70.0,1,110,0.0,110.0,110.0
101242676.0,17,14,864,7,432,16833500.0,174.0,61.71428571428572,7,432,16834904.666666668,174.0,61.71428571428572
471.0,17,2,508,2,508,0.0,257.0,254.0,0,0,0.0,0.0,0.0
115516005.0,6,48,3168,24,1584,5022435.0,66.0,66.0,24,1584,5009159.956521739,66.0,66.0
120396.0,17,2,762,2,762,0.0,381.0,381.0,0,0,0.0,0.0,0.0
90066781.0,17,28,13364,28,13364,3335806.703703704,501.0,477.2857142857143,0,0,0.0,0.0,0.0
263255.0,6,10,1221,6,636,52651.0,298.0,106.0,4,585,82005.33333333333,379.0,146.25
1426637.0,6,8,602,3,198,205001.0,66.0,66.0,5,404,330630.75,103.0,80.8
32992.0,6,10,2032,5,524,7956.5,252.0,104.8,5,1508,7736.5,1236.0,301.6
190216.0,17,4,6056,4,6056,63405.333333333336,1514.0,1514.0,0,0,0.0,0.0,0.0
212629.0,17,2,180,1,90,0.0,90.0,90.0,1,90,0.0,90.0,90.0
10494058.0,6,6,412,3,206,5178604.0,74.0,68.66666666666667,3,206,5178477.0,74.0,68.66666666666667
93.0,17,2,762,2,762,0.0,381.0,381.0,0,0,0.0,0.0,0.0
16312.0,17,4,823,2,163,0.0,89.0,81.5,2,660,0.0,443.0,330.0
201488.0,17,2,762,2,762,0.0,381.0,381.0,0,0,0.0,0.0,0.0
1080866.0,6,10,1067,5,536,270042.5,264.0,107.2,5,531,269187.25,259.0,106.2
232155.0,6,3,337,2,214,0.0,160.0,107.0,1,123,0.0,123.0,123.0
110091280.0,6,28,1860,14,966,8452794.615384616,123.0,69.0,14,894,8452793.76923077,123.0,63.85714285714285
786.0,17,4,438,2,148,0.0,74.0,74.0,2,290,0.0,147.0,145.0
206032.0,6,3,426,2,280,0.0,214.0,140.0,1,146,0.0,146.0,146.0
90256850.0,6,12,1832,8,1016,12893835.714285716,188.0,127.0,4,816,30030364.0,204.0,204.0
135127371.0,17,6,1146,6,1146,27025474.2,191.0,191.0,0,0,0.0,0.0,0.0
1302423.0,6,4,264,2,132,0.0,66.0,66.0,2,132,0.0,66.0,66.0
18292103.0,6,26,7627,14,3735,181231.4615384616,1514.0,266.7857142857143,12,3892,1644319.7272727273,1514.0,324.3333333333333
2359.0,17,4,344,2,150,0.0,75.0,75.0,2,194,0.0,103.0,97.0
148008.0,17,2,180,1,90,0.0,90.0,90.0,1,90,0.0,90.0,90.0
43498.0,6,10,2032,5,524,10663.5,252.0,104.8,5,1508,7260.5,1236.0,301.6
2571034.0,6,5,1736,2,819,0.0,753.0,409.5,3,917,1136561.0,785.0,305.6666666666667
2796756.0,6,2,132,1,66,0.0,66.0,66.0,1,66,0.0,66.0,66.0
37277.0,6,10,2032,5,524,7759.75,252.0,104.8,5,1508,8959.5,1236.0,301.6
319.0,17,2,174,1,79,0.0,79.0,79.0,1,95,0.0,95.0,95.0
2376.0,17,4,344,2,150,0.0,75.0,75.0,2,194,0.0,103.0,97.0
68.0,6,2,169,0,0,0.0,0.0,0.0,2,169,0.0,103.0,84.5
10023.0,17,2,571,1,86,0.0,86.0,86.0,1,485,0.0,485.0,485.0
25074.0,6,11,1133,6,602,4834.0,264.0,100.33333333333331,5,531,5352.5,259.0,106.2
35416.0,6,14,4740,7,653,5770.666666666667,249.0,93.28571428571428,7,4087,5640.333333333333,1514.0,583.8571428571429
117586184.0,17,14,864,7,432,19501650.666666668,174.0,61.71428571428572,7,432,19500179.0,174.0,61.71428571428572
29398.0,6,11,1133,6,602,5819.8,264.0,100.33333333333331,5,531,7010.0,259.0,106.2
57393.0,6,14,4740,7,653,9395.5,249.0,93.28571428571428,7,4087,8673.0,1514.0,583.8571428571429
103716673.0,6,30,2122,15,1105,7392924.428571428,139.0,73.66666666666667,15,1017,7392927.714285715,123.0,67.8
211023.0,17,2,180,1,90,0.0,90.0,90.0,1,90,0.0,90.0,90.0
114992820.0,6,31,2182,16,1165,7651797.733333333,139.0,72.8125,15,1017,8198353.142857143,123.0,67.8
144875.0,17,2,180,1,70,0.0,70.0,70.0,1,110,0.0,110.0,110.0
2635935.0,6,25,7573,14,3735,202764.2307692308,1514.0,266.7857142857143,11,3838,238074.4,1514.0,348.90909090909093
1306993.0,6,4,264,2,132,0.0,66.0,66.0,2,132,0.0,66.0,66.0
146137.0,6,3,337,2,214,0.0,160.0,107.0,1,123,0.0,123.0,123.0
14462.0,6,11,1132,6,556,2892.4,218.0,92.66666666666669,5,576,3084.25,304.0,115.2
90045703.0,17,28,13364,28,13364,3335026.037037037,501.0,477.2857142857143,0,0,0.0,0.0,0.0
90060691.0,17,27,12943,27,12943,3463872.730769231,501.0,479.3703703703704,0,0,0.0,0.0,0.0
1443.0,17,2,762,2,762,0.0,381.0,381.0,0,0,0.0,0.0,0.0
90000543.0,6,20,1490,10,745,10000060.333333334,95.0,74.5,10,745,9975882.888888888,95.0,74.5
105734070.0,6,32,2236,16,1165,7034558.666666667,139.0,72.8125,16,1071,7034559.066666666,123.0,66.9375
90286613.0,6,16,1192,8,596,12891145.42857143,95.0,74.5,8,596,12897814.42857143,95.0,74.5
14385.0,6,11,1133,6,602,2677.8,264.0,100.33333333333331,5,531,3031.0,259.0,106.2
1283779.0,17,7,490,7,490,213963.16666666663,70.0,70.0,0,0,0.0,0.0,0.0
3001.0,17,2,224,1,76,0.0,76.0,76.0,1,148,0.0,148.0,148.0
72753.0,6,14,4740,7,653,11003.333333333334,249.0,93.28571428571428,7,4087,10975.0,1514.0,583.8571428571429
29662.0,6,14,4740,7,653,4818.5,249.0,93.28571428571428,7,4087,4399.666666666667,1514.0,583.8571428571429
143862.0,17,2,180,1,90,0.0,90.0,90.0,1,90,0.0,90.0,90.0
2031.0,17,4,344,2,150,0.0,75.0,75.0,2,194,0.0,103.0,97.0
241849.0,6,3,337,2,214,0.0,160.0,107.0,1,123,0.0,123.0,123.0
108118910.0,17,5,955,5,955,27029727.5,191.0,191.0,0,0,0.0,0.0,0.0
120123631.0,6,14,2224,9,1204,15015453.875,188.0,133.77777777777777,5,1020,22522779.0,204.0,204.0
16028600.0,17,6,2052,6,2052,3205720.0,342.0,342.0,0,0,0.0,0.0,0.0
281355.0,6,10,1221,6,636,56271.0,298.0,106.0,4,585,88407.33333333333,379.0,146.25
274853.0,6,10,1221,6,636,54970.6,298.0,106.0,4,585,86263.66666666667,379.0,146.25
91785913.0,6,169,19066,85,5832,1092689.4404761903,140.0,68.61176470588235,84,13234,1093578.6506024096,284.0,157.54761904761904
5624401.0,6,5,336,2,134,0.0,68.0,67.0,3,202,1526395.5,70.0,67.33333333333333
20198.0,6,10,2032,5,524,4333.0,252.0,104.8,5,1508,4281.5,1236.0,301.6
349.0,17,2,267,1,83,0.0,83.0,83.0,1,184,0.0,184.0,184.0
10505791.0,6,7,478,4,272,3456561.6666666665,74.0,68.0,3,206,5184758.5,74.0,68.66666666666667
298189.0,6,6,412,4,272,99396.33333333331,74.0,68.0,2,140,0.0,74.0,70.0
312127.0,6,6,412,4,272,104042.33333333331,74.0,68.0,2,140,0.0,74.0,70.0
2602328.0,6,3,1604,1,753,0.0,753.0,753.0,2,851,0.0,785.0,425.5
40102.0,6,10,2032,5,524,8255.25,252.0,104.8,5,1508,9775.25,1236.0,301.6
112895764.0,6,32,2236,16,1165,7526384.266666667,139.0,72.8125,16,1071,7511935.933333334,123.0,66.9375
8039320.999999999,17,4,1376,3,1026,108282.0,342.0,342.0,1,350,0.0,350.0,350.0
5635962.0,6,4,270,2,134,0.0,68.0,67.0,2,136,0.0,70.0,68.0
2411.0,17,4,344,2,150,0.0,75.0,75.0,2,194,0.0,103.0,97.0
105228.0,17,2,700,2,700,0.0,350.0,350.0,0,0,0.0,0.0,0.0
118673194.0,6,234,26434,117,18404,1021189.551724138,284.0,157.2991452991453,117,8030,1021189.2931034482,140.0,68.63247863247864
329910.0,6,6,412,4,272,109970.0,74.0,68.0,2,140,0.0,74.0,70.0
228402.0,17,2,180,1,90,0.0,90.0,90.0,1,90,0.0,90.0,90.0
108097639.0,17,5,955,5,955,27024409.75,191.0,191.0,0,0,0.0,0.0,0.0
135127960.0,17,6,1206,6,1206,27025592.0,201.0,201.0,0,0,0.0,0.0,0.0
2161.0,17,4,344,2,150,0.0,75.0,75.0,2,194,0.0,103.0,97.0
179804.0,17,2,180,1,90,0.0,90.0,90.0,1,90,0.0,90.0,90.0
870940.0,6,10,1332,6,795,174188.0,457.0,132.5,4,537,198404.3333333333,331.0,134.25
179733.0,17,2,180,1,90,0.0,90.0,90.0,1,90,0.0,90.0,90.0
39646413.0,6,5,336,2,134,0.0,68.0,67.0,3,202,19754228.5,70.0,67.33333333333333
235629.0,6,3,337,2,214,0.0,160.0,107.0,1,123,0.0,123.0,123.0
349.0,17,2,214,1,75,0.0,75.0,75.0,1,139,0.0,139.0,139.0
108101142.0,17,5,955,5,955,27025285.5,191.0,191.0,0,0,0.0,0.0,0.0
6962.0,17,2,582,1,83,0.0,83.0,83.0,1,499,0.0,499.0,499.0
270325.0,6,10,1221,6,636,54065.0,298.0,106.0,4,585,84734.66666666667,379.0,146.25
7054.0,17,2,582,1,83,0.0,83.0,83.0,1,499,0.0,499.0,499.0
249010.0,6,3,337,2,214,0.0,160.0,107.0,1,123,0.0,123.0,123.0
147954.0,17,2,180,1,90,0.0,90.0,90.0,1,90,0.0,90.0,90.0
50934.0,17,2,180,1,90,0.0,90.0,90.0,1,90,0.0,90.0,90.0
18971.0,17,2,582,1,83,0.0,83.0,83.0,1,499,0.0,499.0,499.0
119819454.0,17,35,16705,35,16705,3524101.588235294,501.0,477.2857142857143,0,0,0.0,0.0,0.0
300794.0,6,6,412,4,272,100264.66666666669,74.0,68.0,2,140,0.0,74.0,70.0
108103263.0,17,5,1005,5,1005,27025815.75,201.0,201.0,0,0,0.0,0.0,0.0
228349.0,17,2,180,1,90,0.0,90.0,90.0,1,90,0.0,90.0,90.0
120309199.0,6,227,25758,114,18078,1064683.1769911505,284.0,158.57894736842104,113,7680,1064913.2767857143,140.0,67.96460176991151
120029028.0,17,29,13785,29,13785,4286751.0,501.0,475.3448275862069,0,0,0.0,0.0,0.0
108094887.0,17,5,955,5,955,27023721.75,191.0,191.0,0,0,0.0,0.0,0.0
120416412.0,6,551,66244,276,47798,437877.8618181818,374.0,173.18115942028984,275,18446,435651.7335766424,140.0,67.07636363636364
98228025.0,17,12,778,6,389,19600918.4,174.0,64.83333333333333,6,389,19600159.0,174.0,64.83333333333333
232221.0,6,3,337,2,214,0.0,160.0,107.0,1,123,0.0,123.0,123.0
206132.0,6,3,426,2,280,0.0,214.0,140.0,1,146,0.0,146.0,146.0
505986.00000000006,6,5,336,2,134,0.0,68.0,67.0,3,202,195088.0,70.0,67.33333333333333
2070.0,17,2,664,1,322,0.0,322.0,322.0,1,342,0.0,342.0,342.0
9320.0,17,2,582,1,83,0.0,83.0,83.0,1,499,0.0,499.0,499.0
74092.0,6,13,1394,7,797,10870.166666666666,253.0,113.85714285714286,6,597,12975.4,259.0,99.5
342.0,17,2,160,1,80,0.0,80.0,80.0,1,80,0.0,80.0,80.0
304373.0,6,6,412,4,272,101457.66666666669,74.0,68.0,2,140,0.0,74.0,70.0
112487915.0,6,35,2664,19,1455,6237345.722222222,123.0,76.57894736842105,16,1209,7484754.8,123.0,75.5625
715096.0,6,5,336,2,134,0.0,68.0,67.0,3,202,295909.5,70.0,67.33333333333333
97821624.0,6,38,3102,21,1701,4879767.3,123.0,81.0,17,1401,6099704.125,123.0,82.41176470588235
13719.0,6,10,2032,5,524,2635.0,252.0,104.8,5,1508,2907.5,1236.0,301.6
135128260.0,17,6,1146,6,1146,27025652.0,191.0,191.0,0,0,0.0,0.0,0.0
2379.0,17,4,344,2,150,0.0,75.0,75.0,2,194,0.0,103.0,97.0
2341.0,17,4,344,2,150,0.0,75.0,75.0,2,194,0.0,103.0,97.0
1182814.0,6,13,3010,8,2382,168973.42857142858,1514.0,297.75,5,628,226930.5,331.0,125.6
26299.0,6,10,2032,5,524,6259.75,252.0,104.8,5,1508,4536.25,1236.0,301.6
298730.0,17,2,246,1,76,0.0,76.0,76.0,1,170,0.0,170.0,170.0
232981.0,6,3,337,2,214,0.0,160.0,107.0,1,123,0.0,123.0,123.0
114269208.0,6,48,3168,24,1584,4968226.434782608,66.0,66.0,24,1584,4954805.173913044,66.0,66.0
9938.0,17,4,823,2,163,0.0,89.0,81.5,2,660,0.0,443.0,330.0
40393.0,6,10,2032,5,524,5841.0,252.0,104.8,5,1508,9183.75,1236.0,301.6
472.0,17,2,508,2,508,0.0,257.0,254.0,0,0,0.0,0.0,0.0
869995.0,6,9,1118,6,586,173999.0,248.0,97.66666666666669,3,532,297148.0,392.0,177.33333333333334
2596382.0,6,2,132,1,66,0.0,66.0,66.0,1,66,0.0,66.0,66.0
90051295.0,17,27,12943,27,12943,3463511.346153846,501.0,479.3703703703704,0,0,0.0,0.0,0.0
120234511.0,6,216,24296,108,7424,1118098.429906542,140.0,68.74074074074075,108,16872,1116126.7943925234,284.0,156.22222222222223
165948.0,6,13,1420,7,789,26371.166666666668,253.0,112.71428571428572,6,631,32378.0,293.0,105.16666666666669
90314302.0,6,16,1192,8,596,12894595.857142856,95.0,74.5,8,596,12900568.857142856,95.0,74.5
0.0,17,1,55,1,55,0.0,55.0,55.0,0,0,0.0,0.0,0.0
620872.0,6,4,508,2,238,0.0,172.0,119.0,2,270,0.0,135.0,135.0
62904.0,6,10,2032,5,524,14527.25,252.0,104.8,5,1508,14672.0,1236.0,301.6
116346.0,17,4,1400,4,1400,38782.0,350.0,350.0,0,0,0.0,0.0,0.0
12616.0,6,13,1459,7,862,1991.5,271.0,123.14285714285714,6,597,2170.6,259.0,99.5
90184428.0,6,16,1192,8,596,12849002.42857143,95.0,74.5,8,596,12854058.57142857,95.0,74.5
34177984.0,6,26,7627,14,3735,203679.4615384616,1514.0,266.7857142857143,12,3892,3088433.090909091,1514.0,324.3333333333333
259285.0,6,3,337,2,214,0.0,160.0,107.0,1,123,0.0,123.0,123.0
90015584.0,17,28,13364,28,13364,3333910.5185185187,501.0,477.2857142857143,0,0,0.0,0.0,0.0
44181.0,6,12,1413,6,816,7421.8,291.0,136.0,6,597,7982.8,259.0,99.5
207549.0,6,4,492,2,280,0.0,214.0,140.0,2,212,0.0,146.0,106.0
44389.0,6,10,2032,5,524,10219.75,252.0,104.8,5,1508,10423.0,1236.0,301.6
50236.0,6,14,4740,7,653,7242.666666666667,249.0,93.28571428571428,7,4087,7219.5,1514.0,583.8571428571429
0.0,17,1,342,1,342,0.0,342.0,342.0,0,0,0.0,0.0,0.0
2798346.0,6,2,132,1,66,0.0,66.0,66.0,1,66,0.0,66.0,66.0
41773.0,6,14,4740,7,653,6259.0,249.0,93.28571428571428,7,4087,6143.166666666667,1514.0,583.8571428571429
92829767.0,6,187,21048,94,6426,998169.5376344086,140.0,68.36170212765957,93,14622,997764.8152173914,284.0,157.2258064516129
15375.0,6,11,2098,6,590,2807.6,252.0,98.33333333333331,5,1508,3402.0,1236.0,301.6
108728.0,17,2,286,2,286,0.0,143.0,143.0,0,0,0.0,0.0,0.0
297737.0,6,6,412,4,272,99245.66666666669,74.0,68.0,2,140,0.0,74.0,70.0
285772.0,17,2,363,1,79,0.0,79.0,79.0,1,284,0.0,284.0,284.0
21421.0,6,14,4740,7,653,3348.833333333333,249.0,93.28571428571428,7,4087,3342.5,1514.0,583.8571428571429
120042591.0,17,29,13785,29,13785,4287235.392857143,501.0,475.3448275862069,0,0,0.0,0.0,0.0
511712.0,6,5,336,2,134,0.0,68.0,67.0,3,202,196073.5,70.0,67.33333333333333
50918.0,17,2,180,1,90,0.0,90.0,90.0,1,90,0.0,90.0,90.0
127038055.0,6,30,2037,15,948,8524884.142857144,123.0,63.2,15,1089,8360993.357142857,123.0,72.6
1024302.0,6,11,1134,6,558,204860.4,220.0,93.0,5,576,255590.0,304.0,115.2
39081.0,6,14,4740,7,653,6114.5,249.0,93.28571428571428,7,4087,6040.333333333333,1514.0,583.8571428571429
2317.0,17,4,344,2,150,0.0,75.0,75.0,2,194,0.0,103.0,97.0
108104876.0,17,5,1005,5,1005,27026219.0,201.0,201.0,0,0,0.0,0.0,0.0
90111138.0,6,10,1440,7,828,15018523.0,188.0,118.28571428571428,3,612,30029323.5,204.0,204.0
36560.0,6,14,4740,7,653,5389.333333333333,249.0,93.28571428571428,7,4087,5935.666666666667,1514.0,583.8571428571429
246761.0,6,3,337,2,214,0.0,160.0,107.0,1,123,0.0,123.0,123.0
299.0,17,2,168,1,76,0.0,76.0,76.0,1,92,0.0,92.0,92.0
41989.0,6,10,2032,5,524,10274.25,252.0,104.8,5,1508,8430.25,1236.0,301.6
2769.0,17,2,762,2,762,0.0,381.0,381.0,0,0,0.0,0.0,0.0
364046.0,6,3,204,1,68,0.0,68.0,68.0,2,136,0.0,70.0,68.0
23772.0,6,10,2032,5,524,5223.0,252.0,104.8,5,1508,5632.5,1236.0,301.6
120152283.0,6,574,77494,287,58256,419393.22027972026,336.0,202.9825783972125,287,19238,419393.0839160839,140.0,67.03135888501743
357.0,17,2,267,1,83,0.0,83.0,83.0,1,184,0.0,184.0,184.0
14641800.0,6,19,1553,9,921,1791593.375,315.0,102.33333333333331,10,632,1592608.2222222222,78.0,63.2
1861.0,17,4,344,2,150,0.0,75.0,75.0,2,194,0.0,103.0,97.0
94906219.0,6,39,3310,22,1840,4519343.761904762,139.0,83.63636363636364,17,1470,5918105.5,123.0,86.47058823529412
4205.0,17,4,344,2,150,0.0,75.0,75.0,2,194,0.0,103.0,97.0
135129856.0,17,6,1206,6,1206,27025971.2,201.0,201.0,0,0,0.0,0.0,0.0
200240.0,17,4,6056,4,6056,66746.66666666667,1514.0,1514.0,0,0,0.0,0.0,0.0
108191.0,17,2,286,2,286,0.0,143.0,143.0,0,0,0.0,0.0,0.0
1296423.0,6,4,264,2,132,0.0,66.0,66.0,2,132,0.0,66.0,66.0
48160.0,6,14,4740,7,653,7698.0,249.0,93.28571428571428,7,4087,7602.0,1514.0,583.8571428571429
3191771.0,6,163,128954,91,119901,35464.12222222222,1510.0,1317.5934065934066,72,9053,40508.57746478873,1510.0,125.73611111111111
102183566.0,6,257,30772,129,8736,798309.109375,140.0,67.72093023255815,128,22036,796446.3070866142,300.0,172.15625
3006767.0,6,12,2172,7,664,500965.8333333333,252.0,94.85714285714286,5,1508,2016.0,1236.0,301.6
16367.0,6,12,1393,6,796,3072.0,271.0,132.66666666666666,6,597,2040.0,259.0,99.5
1169361.0,6,13,3000,8,2372,167051.57142857142,1514.0,296.5,5,628,223381.25,331.0,125.6
211410.0,6,12,1373,7,714,35235.0,298.0,102.0,5,659,51695.75,379.0,131.8
197843.0,17,2,180,1,90,0.0,90.0,90.0,1,90,0.0,90.0,90.0
2417103.0,6,25,7573,14,3735,185931.0,1514.0,266.7857142857143,11,3838,216166.7,1514.0,348.90909090909093
103110.0,17,2,762,2,762,0.0,381.0,381.0,0,0,0.0,0.0,0.0
181506.0,17,2,414,1,88,0.0,88.0,88.0,1,326,0.0,326.0,326.0
240266.0,6,3,337,2,214,0.0,160.0,107.0,1,123,0.0,123.0,123.0
332.0,17,2,166,1,75,0.0,75.0,75.0,1,91,0.0,91.0,91.0
301190.0,6,6,412,4,272,100396.66666666669,74.0,68.0,2,140,0.0,74.0,70.0
96753731.0,6,760,150886,372,25070,260791.72776280323,214.0,67.39247311827957,388,125816,247937.4754521964,1514.0,324.2680412371134
432.0,17,2,250,1,93,0.0,93.0,93.0,1,157,0.0,157.0,157.0
298086.0,6,6,412,4,272,99362.0,74.0,68.0,2,140,0.0,74.0,70.0
597382.0,17,3,551,2,156,0.0,78.0,78.0,1,395,0.0,395.0,395.0
45004.0,6,10,2032,5,524,10944.25,252.0,104.8,5,1508,10748.25,1236.0,301.6
2324.0,17,4,344,2,150,0.0,75.0,75.0,2,194,0.0,103.0,97.0
1302566.0,6,4,264,2,132,0.0,66.0,66.0,2,132,0.0,66.0,66.0
2338.0,17,4,344,2,150,0.0,75.0,75.0,2,194,0.0,103.0,97.0
205992.0,17,2,762,2,762,0.0,381.0,381.0,0,0,0.0,0.0,0.0
57355.0,6,14,4740,7,653,7905.166666666667,249.0,93.28571428571428,7,4087,8288.333333333334,1514.0,583.8571428571429
44534.0,6,10,2032,5,524,9870.25,252.0,104.8,5,1508,10897.5,1236.0,301.6
229726.0,6,13,1386,7,789,38287.66666666666,253.0,112.71428571428572,6,597,44465.0,259.0,99.5
115777074.0,6,30,1974,15,1026,8254360.642857143,123.0,68.4,15,948,8254359.857142857,123.0,63.2
34665.0,6,14,4740,7,653,5652.5,249.0,93.28571428571428,7,4087,5581.833333333333,1514.0,583.8571428571429
329.0,17,2,166,1,75,0.0,75.0,75.0,1,91,0.0,91.0,91.0
237835.0,6,3,373,2,238,0.0,172.0,119.0,1,135,0.0,135.0,135.0
127007110.0,6,35,2605,17,1194,7416643.375,123.0,70.23529411764706,18,1411,6883596.588235294,139.0,78.38888888888889
315494.0,17,4,1400,4,1400,105164.66666666669,350.0,350.0,0,0,0.0,0.0,0.0
2021288.0,17,4,509,2,150,0.0,75.0,75.0,2,359,0.0,268.0,179.5
196903.0,17,2,180,1,90,0.0,90.0,90.0,1,90,0.0,90.0,90.0
215336.0,6,10,1221,6,636,43067.2,298.0,106.0,4,585,70405.0,379.0,146.25
227429.0,6,3,426,2,280,0.0,214.0,140.0,1,146,0.0,146.0,146.0
36612.0,6,14,4740,7,653,5981.333333333333,249.0,93.28571428571428,7,4087,5961.666666666667,1514.0,583.8571428571429
90258555.0,6,14,2240,8,1016,12894079.285714284,188.0,127.0,6,1224,18018679.6,204.0,204.0
1432970.0,17,16,1120,16,1120,95531.33333333331,70.0,70.0,0,0,0.0,0.0,0.0
66190.0,6,14,4740,7,653,10909.666666666666,249.0,93.28571428571428,7,4087,9137.833333333334,1514.0,583.8571428571429
5614778.0,6,5,336,2,134,0.0,68.0,67.0,3,202,1522596.5,70.0,67.33333333333333
89457.0,6,14,4740,7,653,14737.5,249.0,93.28571428571428,7,4087,11318.0,1514.0,583.8571428571429
511774.0,6,4,270,2,134,0.0,68.0,67.0,2,136,0.0,70.0,68.0
123839713.0,6,48,3168,24,1584,5045475.0869565215,66.0,66.0,24,1584,5251954.652173913,66.0,66.0
14640208.0,6,20,1607,10,975,1593041.4444444445,315.0,97.5,10,632,1593024.7777777778,78.0,63.2
19733.0,6,14,4740,7,653,3069.6666666666665,249.0,93.28571428571428,7,4087,3002.5,1514.0,583.8571428571429
17668.0,6,14,4740,7,653,2755.5,249.0,93.28571428571428,7,4087,2807.833333333333,1514.0,583.8571428571429
75489.0,6,11,2098,6,590,14211.0,252.0,98.33333333333331,5,1508,18606.0,1236.0,301.6
2018115.0,17,4,525,2,150,0.0,75.0,75.0,2,375,0.0,284.0,187.5
316054.0,17,4,1400,4,1400,105351.33333333331,350.0,350.0,0,0,0.0,0.0,0.0
83573.0,6,14,4740,7,653,13170.5,249.0,93.28571428571428,7,4087,13765.666666666666,1514.0,583.8571428571429
39640.0,6,14,4740,7,653,6170.666666666667,249.0,93.28571428571428,7,4087,6468.0,1514.0,583.8571428571429
1291413.0,17,7,490,7,490,215235.5,70.0,70.0,0,0,0.0,0.0,0.0
3009497.0,6,12,2172,7,664,501582.8333333333,252.0,94.85714285714286,5,1508,1922.25,1236.0,301.6
191643.0,6,11,1132,6,556,38328.6,218.0,92.66666666666669,5,576,45801.25,304.0,115.2
116032165.0,6,48,3168,24,1584,5044876.739130435,66.0,66.0,24,1584,5031206.521739131,66.0,66.0
310.0,17,2,174,1,79,0.0,79.0,79.0,1,95,0.0,95.0,95.0
143895.0,17,2,180,1,90,0.0,90.0,90.0,1,90,0.0,90.0,90.0
24067.0,6,14,4740,7,653,3859.8333333333335,249.0,93.28571428571428,7,4087,3870.1666666666665,1514.0,583.8571428571429
206765.0,17,2,762,2,762,0.0,381.0,381.0,0,0,0.0,0.0,0.0
26932.0,6,14,4740,7,653,4322.5,249.0,93.28571428571428,7,4087,4208.166666666667,1514.0,583.8571428571429
21612.0,17,2,582,1,83,0.0,83.0,83.0,1,499,0.0,499.0,499.0
3383.0,17,2,414,1,88,0.0,88.0,88.0,1,326,0.0,326.0,326.0
143823.0,17,2,180,1,90,0.0,90.0,90.0,1,90,0.0,90.0,90.0
2794329.0,6,2,132,1,66,0.0,66.0,66.0,1,66,0.0,66.0,66.0
209513.0,17,2,180,1,90,0.0,90.0,90.0,1,90,0.0,90.0,90.0
30269.0,6,10,2032,5,524,7222.75,252.0,104.8,5,1508,6998.0,1236.0,301.6
142272.0,17,2,363,1,75,0.0,75.0,75.0,1,288,0.0,288.0,288.0
216850.0,17,2,180,1,90,0.0,90.0,90.0,1,90,0.0,90.0,90.0
104583.0,17,4,1400,4,1400,34861.0,350.0,350.0,0,0,0.0,0.0,0.0
325317.0,6,6,412,4,272,108439.0,74.0,68.0,2,140,0.0,74.0,70.0
108107297.0,17,5,1005,5,1005,27026824.25,201.0,201.0,0,0,0.0,0.0,0.0
90020885.0,17,28,13364,28,13364,3334106.851851852,501.0,477.2857142857143,0,0,0.0,0.0,0.0
121166.0,6,3,337,2,214,0.0,160.0,107.0,1,123,0.0,123.0,123.0
243961.0,6,3,337,2,214,0.0,160.0,107.0,1,123,0.0,123.0,123.0
9324.0,17,2,507,1,86,0.0,86.0,86.0,1,421,0.0,421.0,421.0
35296.0,6,14,4740,7,653,5726.0,249.0,93.28571428571428,7,4087,5598.5,1514.0,583.8571428571429
238809.0,6,3,337,2,214,0.0,160.0,107.0,1,123,0.0,123.0,123.0
319.0,17,2,174,1,79,0.0,79.0,79.0,1,95,0.0,95.0,95.0
51268.0,6,10,2032,5,524,12489.5,252.0,104.8,5,1508,11813.5,1236.0,301.6
166690.0,17,2,180,1,90,0.0,90.0,90.0,1,90,0.0,90.0,90.0
104136.0,17,2,286,2,286,0.0,143.0,143.0,0,0,0.0,0.0,0.0
285603.0,17,2,363,1,79,0.0,79.0,79.0,1,284,0.0,284.0,284.0
1162493.0,6,13,3012,8,2384,166070.42857142858,1514.0,298.0,5,628,221807.0,331.0,125.6
120147880.0,6,973,206126,492,173788,244261.9205702648,1514.0,353.2276422764228,481,32338,249859.50416666668,214.0,67.23076923076923
41397.0,6,14,4740,7,653,6631.166666666667,249.0,93.28571428571428,7,4087,6492.5,1514.0,583.8571428571429
10503446.0,6,7,478,4,272,3455804.0,74.0,68.0,3,206,5183581.5,74.0,68.66666666666667
63243.99999999999,6,14,4740,7,653,9616.666666666666,249.0,93.28571428571428,7,4087,9889.333333333334,1514.0,583.8571428571429
702.0,17,4,438,2,148,0.0,74.0,74.0,2,290,0.0,147.0,145.0
135130871.0,17,6,1146,6,1146,27026174.2,191.0,191.0,0,0,0.0,0.0,0.0
33681.0,6,14,4740,7,653,5489.833333333333,249.0,93.28571428571428,7,4087,5475.666666666667,1514.0,583.8571428571429
33704361.0,6,5,336,2,134,0.0,68.0,67.0,3,202,15462633.5,70.0,67.33333333333333
52795.0,6,10,2032,5,524,12531.5,252.0,104.8,5,1508,10174.5,1236.0,301.6
424.0,17,2,508,2,508,0.0,257.0,254.0,0,0,0.0,0.0,0.0
228344.0,17,2,180,1,90,0.0,90.0,90.0,1,90,0.0,90.0,90.0
37401.0,6,14,4740,7,653,5204.166666666667,249.0,93.28571428571428,7,4087,6086.5,1514.0,583.8571428571429
2793976.0,6,2,132,1,66,0.0,66.0,66.0,1,66,0.0,66.0,66.0
108100032.0,17,5,1005,5,1005,27025008.0,201.0,201.0,0,0,0.0,0.0,0.0
64906.00000000001,6,14,4740,7,653,10550.666666666666,249.0,93.28571428571428,7,4087,9224.166666666666,1514.0,583.8571428571429
135134873.0,17,6,1146,6,1146,27026974.6,191.0,191.0,0,0,0.0,0.0,0.0
38944.0,6,14,4740,7,653,6363.666666666667,249.0,93.28571428571428,7,4087,6352.333333333333,1514.0,583.8571428571429
39943.0,6,14,4740,7,653,6298.333333333333,249.0,93.28571428571428,7,4087,5744.833333333333,1514.0,583.8571428571429
33751.0,6,14,4740,7,653,5042.666666666667,249.0,93.28571428571428,7,4087,5484.833333333333,1514.0,583.8571428571429
100520725.0,17,12,516,6,258,20001069.4,43.0,43.0,6,258,20000165.4,43.0,43.0
301.0,17,2,168,1,76,0.0,76.0,76.0,1,92,0.0,92.0,92.0
153441.0,17,2,180,1,90,0.0,90.0,90.0,1,90,0.0,90.0,90.0
122975171.0,6,48,3168,24,1584,5051810.869565218,66.0,66.0,24,1584,5215269.782608695,66.0,66.0
217757.0,6,3,426,2,280,0.0,214.0,140.0,1,146,0.0,146.0,146.0
153513.0,17,2,180,1,90,0.0,90.0,90.0,1,90,0.0,90.0,90.0
5003217.0,17,4,849,2,166,0.0,83.0,83.0,2,683,0.0,499.0,341.5
119989989.0,6,17,1246,9,650,14998748.625,95.0,72.22222222222223,8,596,12851608.0,95.0,74.5
107642.0,17,2,286,2,286,0.0,143.0,143.0,0,0,0.0,0.0,0.0
2795156.0,6,2,132,1,66,0.0,66.0,66.0,1,66,0.0,66.0,66.0
15085.0,17,2,180,1,90,0.0,90.0,90.0,1,90,0.0,90.0,90.0
497.00000000000006,17,2,508,2,508,0.0,257.0,254.0,0,0,0.0,0.0,0.0
731.0,17,2,762,2,762,0.0,381.0,381.0,0,0,0.0,0.0,0.0
1092148.0,6,13,1386,7,789,182024.66666666663,253.0,112.71428571428572,6,597,217597.6,259.0,99.5
90742538.0,6,19,1436,10,745,10077921.111111112,95.0,74.5,9,691,11342220.875,95.0,76.77777777777777
120438693.0,6,209,23564,105,16404,1158064.3557692308,284.0,156.22857142857143,104,7160,1149267.8155339805,140.0,68.84615384615384
0.0,17,1,44,1,44,0.0,44.0,44.0,0,0,0.0,0.0,0.0
120047111.0,6,291,33080,146,23288,827911.1103448276,374.0,159.5068493150685,145,9792,826473.9166666666,140.0,67.53103448275863
0.0,17,1,381,1,381,0.0,381.0,381.0,0,0,0.0,0.0,0.0
245675.0,6,3,337,2,214,0.0,160.0,107.0,1,123,0.0,123.0,123.0
334.0,17,2,166,1,75,0.0,75.0,75.0,1,91,0.0,91.0,91.0
102207345.0,6,30,2106,15,1089,7285920.5,123.0,72.6,15,1017,7285921.642857143,123.0,67.8
368598.0,6,10,1221,6,636,73719.6,298.0,106.0,4,585,117446.0,379.0,146.25
216576.0,6,3,426,2,280,0.0,214.0,140.0,1,146,0.0,146.0,146.0
106075739.0,6,201,22602,101,6888,1060757.39,140.0,68.1980198019802,100,15714,1060959.797979798,284.0,157.14
108105685.0,17,5,1005,5,1005,27026421.25,201.0,201.0,0,0,0.0,0.0,0.0
232540.0,6,3,373,2,238,0.0,172.0,119.0,1,135,0.0,135.0,135.0
309435.0,6,6,412,4,272,103145.0,74.0,68.0,2,140,0.0,74.0,70.0
13795574.0,17,6,2052,6,2052,2759114.8,342.0,342.0,0,0,0.0,0.0,0.0
135133814.0,17,6,1146,6,1146,27026762.8,191.0,191.0,0,0,0.0,0.0,0.0
4058.0,17,4,704,2,148,0.0,74.0,74.0,2,556,0.0,280.0,278.0
343.0,17,2,267,1,83,0.0,83.0,83.0,1,184,0.0,184.0,184.0
237698.0,17,2,180,1,90,0.0,90.0,90.0,1,90,0.0,90.0,90.0
117635800.0,6,48,3168,24,1584,5114600.0,66.0,66.0,24,1584,5105204.869565218,66.0,66.0
855393.0,6,9,1270,6,799,171078.6,461.0,133.16666666666666,3,471,291418.0,331.0,157.0
301624.0,6,6,412,4,272,100541.33333333331,74.0,68.0,2,140,0.0,74.0,70.0
50036.0,6,14,4740,7,653,7926.5,249.0,93.28571428571428,7,4087,3767.5,1514.0,583.8571428571429
4598130.0,6,5,336,2,134,0.0,68.0,67.0,3,202,1423535.5,70.0,67.33333333333333
90010151.0,17,28,13364,28,13364,3333709.296296296,501.0,477.2857142857143,0,0,0.0,0.0,0.0
14962.0,17,2,180,1,90,0.0,90.0,90.0,1,90,0.0,90.0,90.0
108101033.0,17,5,955,5,955,27025258.25,191.0,191.0,0,0,0.0,0.0,0.0
135130757.0,17,6,1206,6,1206,27026151.4,201.0,201.0,0,0,0.0,0.0,0.0
204943.0,17,2,762,2,762,0.0,381.0,381.0,0,0,0.0,0.0,0.0
244148.0,6,3,337,2,214,0.0,160.0,107.0,1,123,0.0,123.0,123.0
18266.0,6,2,145,2,145,0.0,91.0,72.5,0,0,0.0,0.0,0.0
90253728.0,6,12,1832,8,1016,12893389.714285716,188.0,127.0,4,816,30030929.33333333,204.0,204.0
48482.0,6,14,4740,7,653,7648.166666666667,249.0,93.28571428571428,7,4087,7168.666666666667,1514.0,583.8571428571429
217865.0,6,3,426,2,280,0.0,214.0,140.0,1,146,0.0,146.0,146.0
90293968.0,6,21,1585,11,840,9025099.4,95.0,76.36363636363636,10,745,10000031.777777778,95.0,74.5
145145.0,17,2,180,1,70,0.0,70.0,70.0,1,110,0.0,110.0,110.0
196924.0,17,2,180,1,90,0.0,90.0,90.0,1,90,0.0,90.0,90.0
72389.0,6,14,4740,7,653,11932.666666666666,249.0,93.28571428571428,7,4087,11926.666666666666,1514.0,583.8571428571429
125464567.0,6,36,2586,19,1392,6970253.722222222,123.0,73.26315789473684,17,1194,7204540.25,123.0,70.23529411764706
22611.0,17,2,582,1,83,0.0,83.0,83.0,1,499,0.0,499.0,499.0
48283.0,6,14,4740,7,653,7809.166666666667,249.0,93.28571428571428,7,4087,7837.833333333333,1514.0,583.8571428571429
22950.0,6,14,4740,7,653,3492.6666666666665,249.0,93.28571428571428,7,4087,3542.1666666666665,1514.0,583.8571428571429
232932.0,6,3,337,2,214,0.0,160.0,107.0,1,123,0.0,123.0,123.0
66165.0,6,10,2032,5,524,15882.25,252.0,104.8,5,1508,12269.5,1236.0,301.6
1032747.0,6,11,1134,6,558,206549.4,220.0,93.0,5,576,256852.25,304.0,115.2
90290216.0,6,16,1192,8,596,12892247.57142857,95.0,74.5,8,596,12896671.142857144,95.0,74.5
90008346.0,17,27,12943,27,12943,3461859.461538461,501.0,479.3703703703704,0,0,0.0,0.0,0.0
108316004.0,17,6,1261,5,955,27026779.75,191.0,191.0,1,306,0.0,306.0,306.0
44138.0,6,13,1394,7,797,6868.166666666667,253.0,113.85714285714286,6,597,8223.2,259.0,99.5
67237.0,6,14,4740,7,653,11081.833333333334,249.0,93.28571428571428,7,4087,8892.833333333334,1514.0,583.8571428571429
22101685.0,17,3,1034,2,684,0.0,342.0,342.0,1,350,0.0,350.0,350.0
1324900.0,17,7,490,7,490,220816.66666666663,70.0,70.0,0,0,0.0,0.0,0.0
750.0,17,4,438,2,148,0.0,74.0,74.0,2,290,0.0,147.0,145.0
90257770.0,6,13,2036,8,1016,12893967.142857144,188.0,127.0,5,1020,22522304.75,204.0,204.0
92858.0,17,2,762,2,762,0.0,381.0,381.0,0,0,0.0,0.0,0.0
36658.0,6,10,2032,5,524,8430.25,252.0,104.8,5,1508,8301.0,1236.0,301.6
205904.0,17,2,180,1,90,0.0,90.0,90.0,1,90,0.0,90.0,90.0
108101555.0,17,5,955,5,955,27025388.75,191.0,191.0,0,0,0.0,0.0,0.0
156640.0,6,3,337,2,214,0.0,160.0,107.0,1,123,0.0,123.0,123.0
28594.0,6,10,1065,5,534,6592.5,262.0,106.8,5,531,6467.0,259.0,106.2
104855925.0,17,14,4788,14,4788,8065840.384615385,342.0,342.0,0,0,0.0,0.0,0.0
57002.0,6,14,4740,7,653,9374.833333333334,249.0,93.28571428571428,7,4087,7145.666666666667,1514.0,583.8571428571429
120058212.0,6,210,23774,105,16622,1152335.9326923075,284.0,158.3047619047619,105,7152,1152336.0288461538,140.0,68.11428571428571
40960.0,6,14,4740,7,653,6606.666666666667,249.0,93.28571428571428,7,4087,6619.333333333333,1514.0,583.8571428571429
310245.0,17,4,1400,4,1400,103415.0,350.0,350.0,0,0,0.0,0.0,0.0
303641.0,6,2,132,1,66,0.0,66.0,66.0,1,66,0.0,66.0,66.0
2517046.0,6,2,819,1,753,0.0,753.0,753.0,1,66,0.0,66.0,66.0
48628.0,6,10,2032,5,524,11922.25,252.0,104.8,5,1508,11215.5,1236.0,301.6
206280.0,6,3,426,2,280,0.0,214.0,140.0,1,146,0.0,146.0,146.0
2748500.0,6,28,9195,16,3843,183233.3333333333,1514.0,240.1875,12,5352,225855.54545454544,1514.0,446.0
45221.0,6,10,2032,5,524,10538.25,252.0,104.8,5,1508,10792.0,1236.0,301.6
197592.0,17,2,180,1,90,0.0,90.0,90.0,1,90,0.0,90.0,90.0
17535.0,6,11,1133,6,602,2666.8,264.0,100.33333333333331,5,531,3943.0,259.0,106.2
18982.0,6,10,2032,5,524,4502.0,252.0,104.8,5,1508,4507.75,1236.0,301.6
232795.0,6,3,426,2,280,0.0,214.0,140.0,1,146,0.0,146.0,146.0
90300602.0,6,19,1436,10,745,10028724.888888888,95.0,74.5,9,691,11285948.625,95.0,76.77777777777777
126788897.0,17,15,1038,8,606,18112699.57142857,174.0,75.75,7,432,18000193.833333332,174.0,61.71428571428572
3495849.0,6,189,157571,109,147990,32368.972222222223,1510.0,1357.7064220183486,80,9581,39984.08860759494,1510.0,119.7625
10470916.0,6,7,478,4,272,3444977.6666666665,74.0,68.0,3,206,5167346.5,74.0,68.66666666666667
108106288.0,17,5,1005,5,1005,27026572.0,201.0,201.0,0,0,0.0,0.0,0.0
119847657.0,6,14,2102,5,1020,29961566.5,204.0,204.0,9,1082,14980799.0,188.0,120.22222222222224
1071551.0,6,3,1604,2,851,0.0,785.0,425.5,1,753,0.0,753.0,753.0
10468406.0,6,7,478,4,272,3444235.333333333,74.0,68.0,3,206,5166230.5,74.0,68.66666666666667
197864.0,17,2,180,1,90,0.0,90.0,90.0,1,90,0.0,90.0,90.0
0.0,17,1,1514,1,1514,0.0,1514.0,1514.0,0,0,0.0,0.0,0.0
18174.0,6,11,2098,6,590,3282.0,252.0,98.33333333333331,5,1508,4251.5,1236.0,301.6
30756.0,6,14,4740,7,653,4978.833333333333,249.0,93.28571428571428,7,4087,4662.0,1514.0,583.8571428571429
90264833.0,6,12,1832,8,1016,12894976.142857144,188.0,127.0,4,816,30032408.33333333,204.0,204.0
5005475.0,17,4,849,2,166,0.0,83.0,83.0,2,683,0.0,499.0,341.5
1180024.0,6,13,3010,8,2382,168574.85714285713,1514.0,297.75,5,628,226120.75,331.0,125.6
108109614.0,17,5,955,5,955,27027403.5,191.0,191.0,0,0,0.0,0.0,0.0
25733.0,6,10,2032,5,524,4564.75,252.0,104.8,5,1508,6186.0,1236.0,301.6
393172.0,6,3,204,2,136,0.0,70.0,68.0,1,68,0.0,68.0,68.0
228386.0,17,2,180,1,90,0.0,90.0,90.0,1,90,0.0,90.0,90.0
102353.0,17,2,700,2,700,0.0,350.0,350.0,0,0,0.0,0.0,0.0
98448224.0,6,33,2428,17,1288,6153014.0,139.0,75.76470588235294,16,1140,6548798.466666667,123.0,71.25
1028049.0,6,11,1134,6,558,205609.8,220.0,93.0,5,576,255729.5,304.0,115.2
118922726.0,6,36,2596,18,1348,6982747.764705882,139.0,74.88888888888889,18,1248,6982748.176470588,123.0,69.33333333333333
3867294.0,6,78,76944,24,1759,168143.21739130435,209.0,73.29166666666667,54,75185,72858.45283018867,1514.0,1392.3148148148148
157799.0,17,2,180,1,90,0.0,90.0,90.0,1,90,0.0,90.0,90.0
1013191.0,17,6,1230,3,234,506408.0,78.0,78.0,3,996,506366.0,332.0,332.0
2338644.0,6,25,7573,14,3735,179895.6923076923,1514.0,266.7857142857143,11,3838,206753.8,1514.0,348.90909090909093
1603565.0,17,2,876,2,876,0.0,438.0,438.0,0,0,0.0,0.0,0.0
120037156.0,6,241,27350,121,19134,1000309.6333333332,284.0,158.13223140495867,120,8216,1003893.3361344538,140.0,68.46666666666667
0.0,17,1,381,1,381,0.0,381.0,381.0,0,0,0.0,0.0,0.0
90297235.0,6,24,1829,13,989,7520569.416666667,95.0,76.07692307692308,11,840,9000426.1,95.0,76.36363636363636
120114246.0,6,236,26840,118,8084,1019697.1452991453,140.0,68.50847457627118,118,18756,1001986.3931623932,336.0,158.94915254237287
120353176.0,6,284,32952,142,9668,847782.7943262411,140.0,68.08450704225352,142,23284,853484.5602836879,300.0,163.9718309859155
90939336.0,6,21,1585,11,840,9093465.9,95.0,76.36363636363636,10,745,10103490.444444444,95.0,74.5
206072.0,6,3,426,2,280,0.0,214.0,140.0,1,146,0.0,146.0,146.0
123007.0,17,4,1524,4,1524,41002.333333333336,381.0,381.0,0,0,0.0,0.0,0.0
232909.0,17,2,180,1,90,0.0,90.0,90.0,1,90,0.0,90.0,90.0
6013275.0,6,6,433,3,235,1109363.0,103.0,78.33333333333333,3,198,2047266.0,66.0,66.0
2062.0,17,4,344,2,150,0.0,75.0,75.0,2,194,0.0,103.0,97.0
90468279.0,6,19,1436,10,786,10047458.111111112,95.0,78.6,9,650,11302219.625,95.0,72.22222222222223
111893692.0,6,211,24004,106,16778,1065654.2095238096,284.0,158.28301886792454,105,7226,1068931.201923077,140.0,68.81904761904762
101863.0,17,4,1400,4,1400,33954.333333333336,350.0,350.0,0,0,0.0,0.0,0.0
36716.0,6,11,2098,6,590,6352.2,252.0,98.33333333333331,5,1508,8936.0,1236.0,301.6
304625.0,6,6,412,4,272,101541.66666666669,74.0,68.0,2,140,0.0,74.0,70.0
545114.0,17,6,2100,6,2100,109022.8,350.0,350.0,0,0,0.0,0.0,0.0
108106082.0,17,5,955,5,955,27026520.5,191.0,191.0,0,0,0.0,0.0,0.0
161026.0,6,15,4806,8,719,22553.14285714286,249.0,89.875,7,4087,25880.83333333333,1514.0,583.8571428571429
242576.0,6,3,337,2,214,0.0,160.0,107.0,1,123,0.0,123.0,123.0
747000.0,6,2,132,1,66,0.0,66.0,66.0,1,66,0.0,66.0,66.0
120059417.0,17,29,13785,29,13785,4287836.321428572,501.0,475.3448275862069,0,0,0.0,0.0,0.0
71324.0,6,14,4740,7,653,11766.666666666666,249.0,93.28571428571428,7,4087,10153.833333333334,1514.0,583.8571428571429
209557.0,17,2,180,1,90,0.0,90.0,90.0,1,90,0.0,90.0,90.0
2041.0,17,4,344,2,150,0.0,75.0,75.0,2,194,0.0,103.0,97.0
61332.0,6,14,4740,7,653,9931.166666666666,249.0,93.28571428571428,7,4087,9703.0,1514.0,583.8571428571429
90095464.0,6,12,1848,5,1020,22523294.5,204.0,204.0,7,828,15015526.5,188.0,118.28571428571428
90058042.0,17,28,13364,28,13364,3335483.037037037,501.0,477.2857142857143,0,0,0.0,0.0,0.0
40143.0,6,14,4740,7,653,6180.0,249.0,93.28571428571428,7,4087,6545.166666666667,1514.0,583.8571428571429
93042626.0,17,12,778,6,389,18600623.4,174.0,64.83333333333333,6,389,18600190.0,174.0,64.83333333333333
196839.0,17,2,180,1,90,0.0,90.0,90.0,1,90,0.0,90.0,90.0
5623481.0,6,4,270,2,134,0.0,68.0,67.0,2,136,0.0,70.0,68.0
90251594.0,6,12,1832,8,1016,12893084.857142856,188.0,127.0,4,816,30029412.33333333,204.0,204.0
301794.0,6,6,412,4,272,100598.0,74.0,68.0,2,140,0.0,74.0,70.0
353.0,17,2,267,1,83,0.0,83.0,83.0,1,184,0.0,184.0,184.0
199895.0,6,10,1221,6,636,39979.0,298.0,106.0,4,585,65575.66666666667,379.0,146.25
147946.0,17,2,180,1,90,0.0,90.0,90.0,1,90,0.0,90.0,90.0
311260.0,17,4,1400,4,1400,103753.33333333331,350.0,350.0,0,0,0.0,0.0,0.0
108416913.0,6,31,2166,16,1149,7213415.666666667,123.0,71.8125,15,1017,7728658.285714285,123.0,67.8
108108069.0,17,5,955,5,955,27027017.25,191.0,191.0,0,0,0.0,0.0,0.0
3382.0,17,2,359,1,75,0.0,75.0,75.0,1,284,0.0,284.0,284.0
27858.0,6,14,4740,7,653,4189.666666666667,249.0,93.28571428571428,7,4087,3524.333333333333,1514.0,583.8571428571429
225239.0,17,2,414,1,88,0.0,88.0,88.0,1,326,0.0,326.0,326.0
102000991.0,17,13,821,7,432,17000165.166666668,174.0,61.71428571428572,6,389,16401416.8,174.0,64.83333333333333
90255242.0,6,13,2036,8,1016,12893606.0,188.0,127.0,5,1020,22523307.0,204.0,204.0
120196769.0,6,222,25090,111,7622,1092697.9,140.0,68.66666666666667,111,17468,1090655.3545454545,284.0,157.36936936936937
100493.0,6,14,4740,7,653,14114.0,249.0,93.28571428571428,7,4087,12801.333333333334,1514.0,583.8571428571429
90290504.0,6,16,1192,8,596,12892406.0,95.0,74.5,8,596,12898132.142857144,95.0,74.5
157736.0,17,4,6056,4,6056,52578.66666666666,1514.0,1514.0,0,0,0.0,0.0,0.0
14341124.0,17,6,2052,6,2052,2868224.8,342.0,342.0,0,0,0.0,0.0,0.0
19532.0,6,12,1320,6,723,3020.4,253.0,120.5,6,597,3499.2,259.0,99.5
236987.0,6,3,373,2,238,0.0,172.0,119.0,1,135,0.0,135.0,135.0
279980.0,17,2,363,1,79,0.0,79.0,79.0,1,284,0.0,284.0,284.0
145499.0,6,3,337,2,214,0.0,160.0,107.0,1,123,0.0,123.0,123.0
224036.0,6,13,1394,7,797,37339.333333333336,253.0,113.85714285714286,6,597,43108.6,259.0,99.5
334.0,17,2,166,1,75,0.0,75.0,75.0,1,91,0.0,91.0,91.0
108112955.0,17,5,955,5,955,27028238.75,191.0,191.0,0,0,0.0,0.0,0.0
147113.0,6,3,373,2,238,0.0,172.0,119.0,1,135,0.0,135.0,135.0
35725.0,6,13,4416,6,409,6954.4,127.0,68.16666666666667,7,4007,5744.166666666667,1514.0,572.4285714285714
315443.0,17,4,1400,4,1400,105147.66666666669,350.0,350.0,0,0,0.0,0.0,0.0
38399.0,6,14,4740,7,653,5927.166666666667,249.0,93.28571428571428,7,4087,6012.166666666667,1514.0,583.8571428571429
78021.0,6,10,2032,5,524,18296.5,252.0,104.8,5,1508,18575.25,1236.0,301.6
351.0,17,2,267,1,83,0.0,83.0,83.0,1,184,0.0,184.0,184.0
107989.0,17,2,286,2,286,0.0,143.0,143.0,0,0,0.0,0.0,0.0
135135879.0,17,6,1146,6,1146,27027175.8,191.0,191.0,0,0,0.0,0.0,0.0
299326.0,6,6,412,4,272,99775.33333333331,74.0,68.0,2,140,0.0,74.0,70.0
595779.0,17,2,335,1,88,0.0,88.0,88.0,1,247,0.0,247.0,247.0
54142.0,6,10,2032,5,524,13324.75,252.0,104.8,5,1508,12727.25,1236.0,301.6
2336.0,17,4,344,2,150,0.0,75.0,75.0,2,194,0.0,103.0,97.0
223707.0,6,3,426,2,280,0.0,214.0,140.0,1,146,0.0,146.0,146.0
285867.0,17,2,180,1,90,0.0,90.0,90.0,1,90,0.0,90.0,90.0
101773168.0,17,14,864,7,432,16833494.166666668,174.0,61.71428571428572,7,432,16834501.666666668,174.0,61.71428571428572
179708.0,17,4,1400,4,1400,59902.66666666666,350.0,350.0,0,0,0.0,0.0,0.0
290088.0,17,2,246,1,76,0.0,76.0,76.0,1,170,0.0,170.0,170.0
197312.0,17,2,180,1,90,0.0,90.0,90.0,1,90,0.0,90.0,90.0
296.0,17,2,164,1,82,0.0,82.0,82.0,1,82,0.0,82.0,82.0
90021887.0,17,28,13364,28,13364,3334143.962962963,501.0,477.2857142857143,0,0,0.0,0.0,0.0
209544.0,17,2,180,1,90,0.0,90.0,90.0,1,90,0.0,90.0,90.0
101000967.0,17,14,864,7,432,16833494.5,174.0,61.71428571428572,7,432,16667038.166666666,174.0,61.71428571428572
3049088.0,6,3,204,2,136,0.0,70.0,68.0,1,68,0.0,68.0,68.0
103612.0,17,2,286,2,286,0.0,143.0,143.0,0,0,0.0,0.0,0.0
45093281.0,17,9,3086,8,2736,5109040.285714285,342.0,342.0,1,350,0.0,350.0,350.0
143948.0,17,2,180,1,90,0.0,90.0,90.0,1,90,0.0,90.0,90.0
228347.0,17,2,180,1,90,0.0,90.0,90.0,1,90,0.0,90.0,90.0
27134.0,6,14,4740,7,653,3733.3333333333335,249.0,93.28571428571428,7,4087,4384.166666666667,1514.0,583.8571428571429
118119.0,6,12,1328,7,797,19686.5,253.0,113.85714285714286,5,531,28565.75,259.0,106.2
113964133.0,6,48,3168,24,1584,4954962.304347826,66.0,66.0,24,1584,4941291.434782608,66.0,66.0
303633.0,6,2,132,1,66,0.0,66.0,66.0,1,66,0.0,66.0,66.0
46729.0,6,14,4740,7,653,7267.333333333333,249.0,93.28571428571428,7,4087,7342.666666666667,1514.0,583.8571428571429
0.0,6,1,66,1,66,0.0,66.0,66.0,0,0,0.0,0.0,0.0
5006038.0,17,4,629,2,156,0.0,78.0,78.0,2,473,0.0,268.0,236.5
1275971.0,17,7,490,7,490,212661.8333333333,70.0,70.0,0,0,0.0,0.0,0.0
219069.0,6,3,426,2,280,0.0,214.0,140.0,1,146,0.0,146.0,146.0
148090.0,17,2,180,1,90,0.0,90.0,90.0,1,90,0.0,90.0,90.0
33476.0,6,11,2098,6,590,6152.2,252.0,98.33333333333331,5,1508,8073.25,1236.0,301.6
298.0,17,2,164,1,82,0.0,82.0,82.0,1,82,0.0,82.0,82.0
2440375.0,6,25,7573,14,3735,187721.15384615384,1514.0,266.7857142857143,11,3838,218732.0,1514.0,348.90909090909093
1202646.0,6,11,1134,6,558,240529.2,220.0,93.0,5,576,299489.0,304.0,115.2
4479.0,17,2,614,1,72,0.0,72.0,72.0,1,542,0.0,542.0,542.0
151408.0,17,4,6056,4,6056,50469.333333333336,1514.0,1514.0,0,0,0.0,0.0,0.0
66186.0,6,10,2032,5,524,16240.0,252.0,104.8,5,1508,14226.75,1236.0,301.6
149881015.0,17,35,16705,35,16705,4408265.147058823,501.0,477.2857142857143,0,0,0.0,0.0,0.0
5831014.0,6,5,336,2,134,0.0,68.0,67.0,3,202,1526662.0,70.0,67.33333333333333
21644.0,17,2,582,1,83,0.0,83.0,83.0,1,499,0.0,499.0,499.0
25732.0,6,10,2032,5,524,5749.5,252.0,104.8,5,1508,5869.25,1236.0,301.6
148029.0,17,2,180,1,90,0.0,90.0,90.0,1,90,0.0,90.0,90.0
144709.0,17,2,180,1,70,0.0,70.0,70.0,1,110,0.0,110.0,110.0
90254457.0,6,13,2036,8,1016,12893493.857142856,188.0,127.0,5,1020,22522517.25,204.0,204.0
216457.0,17,2,180,1,90,0.0,90.0,90.0,1,90,0.0,90.0,90.0
746753.0,6,2,132,1,66,0.0,66.0,66.0,1,66,0.0,66.0,66.0
13207.0,6,10,1975,5,467,3091.25,195.0,93.4,5,1508,3015.0,1236.0,301.6
135127886.0,17,6,1146,6,1146,27025577.2,191.0,191.0,0,0,0.0,0.0,0.0
179806.0,17,2,180,1,90,0.0,90.0,90.0,1,90,0.0,90.0,90.0
211455.0,6,10,1221,6,636,42291.0,298.0,106.0,4,585,69349.66666666667,379.0,146.25
313328.0,17,4,1400,4,1400,104442.66666666669,350.0,350.0,0,0,0.0,0.0,0.0
147921.0,17,2,180,1,90,0.0,90.0,90.0,1,90,0.0,90.0,90.0
107464.0,17,2,286,2,286,0.0,143.0,143.0,0,0,0.0,0.0,0.0
813.0,17,4,438,2,148,0.0,74.0,74.0,2,290,0.0,147.0,145.0
16709741.999999998,6,22,7083,13,1707,1392478.5,408.0,131.30769230769232,9,5376,1733788.25,1514.0,597.3333333333334
237261.0,6,3,373,2,238,0.0,172.0,119.0,1,135,0.0,135.0,135.0
120080131.0,17,28,13364,28,13364,4447412.259259259,501.0,477.2857142857143,0,0,0.0,0.0,0.0
124001100.0,17,15,907,8,475,17714442.85714286,174.0,59.375,7,432,17335225.166666668,174.0,61.71428571428572
2776830.0,6,2,132,1,66,0.0,66.0,66.0,1,66,0.0,66.0,66.0
148992.0,17,2,414,1,88,0.0,88.0,88.0,1,326,0.0,326.0,326.0
90109966.0,17,12,778,6,389,18000188.6,174.0,64.83333333333333,6,389,18000842.8,174.0,64.83333333333333
218278.0,17,2,180,1,90,0.0,90.0,90.0,1,90,0.0,90.0,90.0
90276413.0,6,17,1287,8,637,12896630.42857143,95.0,79.625,9,650,11252905.875,95.0,72.22222222222223
298558.0,6,6,412,4,272,99519.33333333331,74.0,68.0,2,140,0.0,74.0,70.0
108105974.0,17,5,955,5,955,27026493.5,191.0,191.0,0,0,0.0,0.0,0.0
3050007.0,6,4,270,3,202,1525003.5,70.0,67.33333333333333,1,68,0.0,68.0,68.0
279093.0,17,2,238,1,74,0.0,74.0,74.0,1,164,0.0,164.0,164.0
41968.0,6,14,4740,7,653,6881.5,249.0,93.28571428571428,7,4087,5939.666666666667,1514.0,583.8571428571429
22021.0,6,10,2032,5,524,3857.75,252.0,104.8,5,1508,5116.75,1236.0,301.6
108108302.0,17,5,1005,5,1005,27027075.5,201.0,201.0,0,0,0.0,0.0,0.0
3778.0,17,4,344,2,150,0.0,75.0,75.0,2,194,0.0,103.0,97.0
90286287.0,6,16,1192,8,596,12891498.857142856,95.0,74.5,8,596,12897126.857142856,95.0,74.5
3008079.0,6,12,2172,7,664,501175.6666666667,252.0,94.85714285714286,5,1508,2596.5,1236.0,301.6
5627618.0,6,5,336,2,134,0.0,68.0,67.0,3,202,1422087.5,70.0,67.33333333333333
37327.0,6,14,4740,7,653,5610.0,249.0,93.28571428571428,7,4087,5759.833333333333,1514.0,583.8571428571429
108107747.0,17,5,1005,5,1005,27026936.75,201.0,201.0,0,0,0.0,0.0,0.0
2383.0,17,4,344,2,150,0.0,75.0,75.0,2,194,0.0,103.0,97.0
108110807.0,17,5,955,5,955,27027701.75,191.0,191.0,0,0,0.0,0.0,0.0
90050911.0,17,28,13364,28,13364,3335218.925925926,501.0,477.2857142857143,0,0,0.0,0.0,0.0
2020.0,17,4,344,2,150,0.0,75.0,75.0,2,194,0.0,103.0,97.0
56461.0,6,10,2032,5,524,13841.0,252.0,104.8,5,1508,13604.5,1236.0,301.6
26829.0,6,11,1131,6,600,5154.4,262.0,100.0,5,531,6282.75,259.0,106.2
338.0,17,2,166,1,75,0.0,75.0,75.0,1,91,0.0,91.0,91.0
47614648.0,6,8,1940,3,887,22846057.0,753.0,295.6666666666667,5,1053,11207896.25,785.0,210.6
120122029.0,6,12,1832,8,1016,17137134.57142857,188.0,127.0,4,816,30031753.666666668,204.0,204.0
323.0,17,2,164,1,82,0.0,82.0,82.0,1,82,0.0,82.0,82.0
232962.0,6,3,337,2,214,0.0,160.0,107.0,1,123,0.0,123.0,123.0
153408.0,17,2,180,1,90,0.0,90.0,90.0,1,90,0.0,90.0,90.0
2591051.0,6,2,132,1,66,0.0,66.0,66.0,1,66,0.0,66.0,66.0
120925271.0,6,31,2251,17,1288,7557829.4375,139.0,75.76470588235294,14,963,8689419.846153846,123.0,68.78571428571429
120014406.0,17,29,13785,29,13785,4286228.785714285,501.0,475.3448275862069,0,0,0.0,0.0,0.0
90050992.0,17,28,13364,28,13364,3335221.925925926,501.0,477.2857142857143,0,0,0.0,0.0,0.0
82210.0,6,14,4740,7,653,13578.5,249.0,93.28571428571428,7,4087,11088.166666666666,1514.0,583.8571428571429
53853.0,6,20,7606,11,978,5385.3,310.0,88.9090909090909,9,6628,5857.0,1514.0,736.4444444444445
284481.0,17,2,363,1,79,0.0,79.0,79.0,1,284,0.0,284.0,284.0
92015864.0,6,37,2442,19,1254,5111992.444444444,66.0,66.0,18,1188,5266168.588235294,66.0,66.0
59064.0,6,14,4740,7,653,8298.166666666666,249.0,93.28571428571428,7,4087,9597.0,1514.0,583.8571428571429
108109235.0,17,5,1005,5,1005,27027308.75,201.0,201.0,0,0,0.0,0.0,0.0
33706438.0,6,5,336,2,134,0.0,68.0,67.0,3,202,15463172.0,70.0,67.33333333333333
108113117.0,17,5,955,5,955,27028279.25,191.0,191.0,0,0,0.0,0.0,0.0
311087.0,6,6,412,4,272,103695.66666666669,74.0,68.0,2,140,0.0,74.0,70.0
26397.0,6,11,2098,6,590,4909.8,252.0,98.33333333333331,5,1508,6147.75,1236.0,301.6
2357.0,17,4,344,2,150,0.0,75.0,75.0,2,194,0.0,103.0,97.0
5828395.0,6,5,336,2,134,0.0,68.0,67.0,3,202,1522861.5,70.0,67.33333333333333
91214399.0,6,21,1626,11,840,6118044.3,95.0,76.36363636363636,10,786,10133931.222222222,95.0,78.6
304988.0,6,6,412,4,272,101662.66666666669,74.0,68.0,2,140,0.0,74.0,70.0
92922085.0,6,40,2640,20,1320,4890636.052631579,66.0,66.0,20,1320,4876293.421052632,66.0,66.0
96742508.0,6,174,19666,87,5964,1115346.3604651163,140.0,68.55172413793103,87,13702,1115290.9302325582,284.0,157.49425287356323
8296.0,6,10,2032,5,524,1858.5,252.0,104.8,5,1508,1786.0,1236.0,301.6
3779551.0,6,5,336,2,134,0.0,68.0,67.0,3,202,1521875.0,70.0,67.33333333333333
207079.0,6,3,426,2,280,0.0,214.0,140.0,1,146,0.0,146.0,146.0
213638.0,17,2,180,1,90,0.0,90.0,90.0,1,90,0.0,90.0,90.0
90010521.0,17,28,13364,28,13364,3333723.0,501.0,477.2857142857143,0,0,0.0,0.0,0.0
120061962.0,17,28,13364,28,13364,4446739.333333333,501.0,477.2857142857143,0,0,0.0,0.0,0.0
143960.0,17,2,180,1,90,0.0,90.0,90.0,1,90,0.0,90.0,90.0
27211223.0,17,5,1710,5,1710,6802805.75,342.0,342.0,0,0,0.0,0.0,0.0
317438.0,17,4,1400,4,1400,105812.66666666669,350.0,350.0,0,0,0.0,0.0,0.0
115716055.0,6,47,3102,24,1584,5031121.565217392,66.0,66.0,23,1518,5159991.454545454,66.0,66.0
48664.0,6,14,4740,7,653,7978.166666666667,249.0,93.28571428571428,7,4087,6710.666666666667,1514.0,583.8571428571429
118554481.0,17,14,864,7,432,19668088.5,174.0,61.71428571428572,7,432,19666828.5,174.0,61.71428571428572
14634.0,6,11,2098,6,590,1946.6,252.0,98.33333333333331,5,1508,3369.75,1236.0,301.6
157967.0,6,3,337,2,214,0.0,160.0,107.0,1,123,0.0,123.0,123.0
206138.0,6,3,426,2,280,0.0,214.0,140.0,1,146,0.0,146.0,146.0
108105149.0,17,5,1005,5,1005,27026287.25,201.0,201.0,0,0,0.0,0.0,0.0
90033925.0,17,28,13364,28,13364,3334589.814814815,501.0,477.2857142857143,0,0,0.0,0.0,0.0
93863.0,6,15,4806,8,719,13300.57142857143,249.0,89.875,7,4087,15508.833333333334,1514.0,583.8571428571429
90264255.0,6,13,2036,8,1016,12894893.57142857,188.0,127.0,5,1020,22525330.0,204.0,204.0
47774.0,6,14,4740,7,653,7500.0,249.0,93.28571428571428,7,4087,7112.833333333333,1514.0,583.8571428571429
307010.0,6,6,412,4,272,102336.66666666669,74.0,68.0,2,140,0.0,74.0,70.0
103000952.0,17,13,1083,7,563,17166825.333333332,174.0,80.42857142857143,6,520,16601631.2,174.0,86.66666666666667
388.0,17,2,762,2,762,0.0,381.0,381.0,0,0,0.0,0.0,0.0
123839970.0,6,49,3234,25,1650,5159998.75,66.0,66.0,24,1584,5090329.478260869,66.0,66.0
116246966.0,6,30,1974,15,1026,8287862.928571428,123.0,68.4,15,948,8287915.214285715,123.0,63.2
861.0,17,4,438,2,148,0.0,74.0,74.0,2,290,0.0,147.0,145.0
108983438.0,6,32,2236,16,1165,7251173.066666666,139.0,72.8125,16,1071,7251173.333333333,123.0,66.9375
104881162.0,17,15,5130,15,5130,7491511.571428572,342.0,342.0,0,0,0.0,0.0,0.0
114920097.0,6,48,3168,24,1584,4996525.956521739,66.0,66.0,24,1584,4983106.956521739,66.0,66.0
867816.0,6,9,1196,6,725,173563.2,387.0,120.83333333333331,3,471,296083.5,331.0,157.0
54377.0,6,10,2032,5,524,13378.75,252.0,104.8,5,1508,12248.25,1236.0,301.6
300338.0,6,6,412,4,272,100112.66666666669,74.0,68.0,2,140,0.0,74.0,70.0
34738.0,6,10,2032,5,524,8174.0,252.0,104.8,5,1508,7927.25,1236.0,301.6
107836478.0,6,28,1860,14,966,8278514.692307692,123.0,69.0,14,894,8278514.538461538,123.0,63.85714285714285
122241.0,17,4,1524,4,1524,40747.0,381.0,381.0,0,0,0.0,0.0,0.0
119224091.0,17,35,16705,35,16705,3506590.911764706,501.0,477.2857142857143,0,0,0.0,0.0,0.0
10515330.0,6,7,478,4,272,3458069.333333333,74.0,68.0,3,206,5186988.0,74.0,68.66666666666667
214112.0,6,4,524,2,254,0.0,188.0,127.0,2,270,0.0,204.0,135.0
302585.0,6,6,412,4,272,100861.66666666669,74.0,68.0,2,140,0.0,74.0,70.0
5166.0,17,2,180,1,90,0.0,90.0,90.0,1,90,0.0,90.0,90.0
25025.0,6,10,2032,5,524,3815.75,252.0,104.8,5,1508,5200.75,1236.0,301.6
90290320.0,6,16,1192,8,596,12891401.142857144,95.0,74.5,8,596,12897114.142857144,95.0,74.5
2371.0,17,4,344,2,150,0.0,75.0,75.0,2,194,0.0,103.0,97.0
1175536.0,6,13,3011,8,2383,167933.7142857143,1514.0,297.875,5,628,224982.0,331.0,125.6
2786676.0,6,2,132,1,66,0.0,66.0,66.0,1,66,0.0,66.0,66.0
654393.0,6,5,650,3,358,327196.5,214.0,119.33333333333331,2,292,0.0,146.0,146.0
104040534.0,6,44,2904,22,1452,4954311.142857143,66.0,66.0,22,1452,4939614.80952381,66.0,66.0
115310261.0,6,36,2734,19,1471,6406125.611111111,139.0,77.42105263157895,17,1263,7193380.8125,123.0,74.29411764705883
103351.0,17,2,286,2,286,0.0,143.0,143.0,0,0,0.0,0.0,0.0
135132567.0,17,6,1146,6,1146,27026513.4,191.0,191.0,0,0,0.0,0.0,0.0
216981.0,6,10,1221,6,636,43396.2,298.0,106.0,4,585,70737.33333333333,379.0,146.25
41983.0,6,14,4740,7,653,6870.666666666667,249.0,93.28571428571428,7,4087,6817.333333333333,1514.0,583.8571428571429
503922.0,6,4,270,2,134,0.0,68.0,67.0,2,136,0.0,70.0,68.0
5493.0,17,2,180,1,90,0.0,90.0,90.0,1,90,0.0,90.0,90.0
264868.0,6,10,1221,6,636,52973.6,298.0,106.0,4,585,82453.33333333333,379.0,146.25
90034481.0,17,28,13364,28,13364,3334610.407407407,501.0,477.2857142857143,0,0,0.0,0.0,0.0
531329.0,17,6,2100,6,2100,106265.8,350.0,350.0,0,0,0.0,0.0,0.0
43826.0,6,14,4740,7,653,6330.333333333333,249.0,93.28571428571428,7,4087,6268.833333333333,1514.0,583.8571428571429
90041511.0,6,18,1382,9,691,7531209.25,95.0,76.77777777777777,9,691,11166218.75,95.0,76.77777777777777
280523.0,17,2,365,1,80,0.0,80.0,80.0,1,285,0.0,285.0,285.0
502212.0,6,4,270,2,134,0.0,68.0,67.0,2,136,0.0,70.0,68.0
126104869.0,6,33,2296,17,1225,7881554.3125,139.0,72.05882352941177,16,1071,7726882.666666667,123.0,66.9375
23585.0,6,10,2032,5,524,4985.0,252.0,104.8,5,1508,5031.5,1236.0,301.6
34016.0,6,14,4740,7,653,5517.666666666667,249.0,93.28571428571428,7,4087,5177.333333333333,1514.0,583.8571428571429
38185.0,6,14,4740,7,653,6153.5,249.0,93.28571428571428,7,4087,6093.166666666667,1514.0,583.8571428571429
0.0,6,1,66,1,66,0.0,66.0,66.0,0,0,0.0,0.0,0.0
51164.0,6,11,2098,6,590,10008.2,252.0,98.33333333333331,5,1508,10767.0,1236.0,301.6
196830.0,17,2,180,1,90,0.0,90.0,90.0,1,90,0.0,90.0,90.0
101778921.0,6,506,64708,253,16920,403817.123015873,140.0,66.87747035573122,253,47788,403870.376984127,464.0,188.8853754940712
2804519.0,6,3,1777,2,951,0.0,885.0,475.5,1,826,0.0,826.0,826.0
418.0,17,2,168,1,76,0.0,76.0,76.0,1,92,0.0,92.0,92.0
73872.0,6,14,4740,7,653,12190.333333333334,249.0,93.28571428571428,7,4087,11594.833333333334,1514.0,583.8571428571429
299986.0,6,6,412,4,272,99995.33333333331,74.0,68.0,2,140,0.0,74.0,70.0
43192.0,6,14,4740,7,653,7045.5,249.0,93.28571428571428,7,4087,6972.666666666667,1514.0,583.8571428571429
454011.0,17,6,1230,3,234,226817.5,78.0,78.0,3,996,226795.5,332.0,332.0
2340.0,17,4,344,2,150,0.0,75.0,75.0,2,194,0.0,103.0,97.0
146124.0,6,3,337,2,214,0.0,160.0,107.0,1,123,0.0,123.0,123.0
170634.0,6,13,1394,7,797,28439.0,253.0,113.85714285714286,6,597,32308.4,259.0,99.5
206096.0,6,3,426,2,280,0.0,214.0,140.0,1,146,0.0,146.0,146.0
100005255.0,6,774,124704,384,25714,261032.9138381201,214.0,66.96354166666667,390,98990,257056.43958868893,1514.0,253.8205128205128
102658.0,17,2,762,2,762,0.0,381.0,381.0,0,0,0.0,0.0,0.0
19627.0,6,10,2032,5,524,4695.75,252.0,104.8,5,1508,4437.0,1236.0,301.6
101389.0,6,15,5241,8,706,14484.142857142857,248.0,88.25,7,4535,14663.166666666666,1514.0,647.8571428571429
118269239.0,6,227,25616,114,7820,1046630.4336283186,140.0,68.59649122807018,113,17796,1038501.5625,284.0,157.4867256637168
26601130.0,17,5,1718,4,1368,882214.6666666666,342.0,342.0,1,350,0.0,350.0,350.0
35337.0,6,12,1413,6,816,6884.6,291.0,136.0,6,597,5159.6,259.0,99.5
2357.0,17,4,344,2,150,0.0,75.0,75.0,2,194,0.0,103.0,97.0
218003.0,6,3,426,2,280,0.0,214.0,140.0,1,146,0.0,146.0,146.0
115210877.0,6,33,2296,17,1225,7187177.375,139.0,72.05882352941177,16,1071,7666325.133333334,123.0,66.9375
114247.0,17,4,1400,4,1400,38082.333333333336,350.0,350.0,0,0,0.0,0.0,0.0
13283.0,6,10,2032,5,524,2770.5,252.0,104.8,5,1508,3063.25,1236.0,301.6
0.0,17,1,381,1,381,0.0,381.0,381.0,0,0,0.0,0.0,0.0
2234.0,17,4,344,2,150,0.0,75.0,75.0,2,194,0.0,103.0,97.0
96101850.0,17,12,778,6,389,19200859.4,174.0,64.83333333333333,6,389,19200198.4,174.0,64.83333333333333
10476898.0,6,7,478,4,272,3446909.333333333,74.0,68.0,3,206,5170294.5,74.0,68.66666666666667
135133465.0,17,6,1146,6,1146,27026693.0,191.0,191.0,0,0,0.0,0.0,0.0
70251.0,6,12,1320,7,789,11708.5,253.0,112.71428571428572,5,531,14620.5,259.0,106.2
2450067.0,6,49,23728,25,19797,102086.125,1514.0,791.88,24,3931,96380.1304347826,1514.0,163.79166666666666
2331.0,17,4,344,2,150,0.0,75.0,75.0,2,194,0.0,103.0,97.0
317826.0,17,4,1400,4,1400,105942.0,350.0,350.0,0,0,0.0,0.0,0.0
151679.0,17,2,414,1,88,0.0,88.0,88.0,1,326,0.0,326.0,326.0
10463719.0,6,7,478,4,272,3442346.6666666665,74.0,68.0,3,206,5163394.0,74.0,68.66666666666667
246212.0,6,3,337,2,214,0.0,160.0,107.0,1,123,0.0,123.0,123.0
28336.0,6,11,2098,6,590,5453.4,252.0,98.33333333333331,5,1508,6811.25,1236.0,301.6
111964976.0,6,35,2536,18,1248,6586149.647058823,123.0,69.33333333333333,17,1288,6373767.1875,139.0,75.76470588235294
43666.0,6,14,4740,7,653,7100.0,249.0,93.28571428571428,7,4087,5405.833333333333,1514.0,583.8571428571429
24752.0,6,11,1133,6,602,4332.8,264.0,100.33333333333331,5,531,5433.0,259.0,106.2
19287.0,6,14,4740,7,653,2864.5,249.0,93.28571428571428,7,4087,3083.1666666666665,1514.0,583.8571428571429
17874.0,6,10,2032,5,524,4246.0,252.0,104.8,5,1508,4159.25,1236.0,301.6
2575218.0,6,20,6935,11,1567,257521.8,408.0,142.45454545454547,9,5368,259210.75,1514.0,596.4444444444445
71121730.0,6,9,1479,9,1479,8890216.25,172.0,164.33333333333334,0,0,0.0,0.0,0.0
4645.0,17,4,438,2,148,0.0,74.0,74.0,2,290,0.0,147.0,145.0
320421.0,17,4,1400,4,1400,106807.0,350.0,350.0,0,0,0.0,0.0,0.0
42311.0,6,10,2032,5,524,10293.0,252.0,104.8,5,1508,9202.25,1236.0,301.6
90051553.0,17,28,13364,28,13364,3335242.703703704,501.0,477.2857142857143,0,0,0.0,0.0,0.0
15163.0,6,14,4740,7,653,2174.833333333333,249.0,93.28571428571428,7,4087,2394.6666666666665,1514.0,583.8571428571429
105759438.0,6,33,2428,17,1288,6609964.875,139.0,75.76470588235294,16,1140,7036165.4,123.0,71.25
310152.0,17,4,1400,4,1400,103384.0,350.0,350.0,0,0,0.0,0.0,0.0
243912.0,6,6,386,4,247,81304.0,85.0,61.75,2,139,0.0,85.0,69.5
90261810.0,6,13,2036,8,1016,12894544.285714284,188.0,127.0,5,1020,22524666.0,204.0,204.0
3804315.0,6,5,1736,2,819,0.0,753.0,409.5,3,917,1833954.0,785.0,305.6666666666667
5035.0,17,4,344,2,150,0.0,75.0,75.0,2,194,0.0,103.0,97.0
112535564.0,6,46,3036,23,1518,5105439.863636363,66.0,66.0,23,1518,5105436.863636363,66.0,66.0
248731.0,6,3,337,2,214,0.0,160.0,107.0,1,123,0.0,123.0,123.0
303217.0,6,2,138,1,68,0.0,68.0,68.0,1,70,0.0,70.0,70.0
90061280.0,17,27,12943,27,12943,3463895.3846153845,501.0,479.3703703703704,0,0,0.0,0.0,0.0
90258440.0,6,12,1832,8,1016,12894062.857142856,188.0,127.0,4,816,30030349.0,204.0,204.0
604623.0,6,4,508,2,238,0.0,172.0,119.0,2,270,0.0,135.0,135.0
43846.0,6,14,4740,7,653,6987.5,249.0,93.28571428571428,7,4087,6602.666666666667,1514.0,583.8571428571429
304265.0,6,6,412,4,272,101421.66666666669,74.0,68.0,2,140,0.0,74.0,70.0
135137785.0,17,6,1206,6,1206,27027557.0,201.0,201.0,0,0,0.0,0.0,0.0
14195.0,6,11,1132,6,556,2839.0,218.0,92.66666666666669,5,576,3058.5,304.0,115.2
2353.0,17,4,344,2,150,0.0,75.0,75.0,2,194,0.0,103.0,97.0
145399.0,6,2,132,1,66,0.0,66.0,66.0,1,66,0.0,66.0,66.0
216848.0,6,3,426,2,280,0.0,214.0,140.0,1,146,0.0,146.0,146.0
148347.0,17,2,414,1,88,0.0,88.0,88.0,1,326,0.0,326.0,326.0
116332846.0,6,201,22714,101,6962,1163328.46,140.0,68.93069306930693,100,15752,1164538.7575757576,284.0,157.52
109826280.0,6,700,91818,350,23396,313926.664756447,140.0,66.84571428571428,350,68422,314625.54154727794,480.0,195.49142857142857
235313.0,6,3,373,2,238,0.0,172.0,119.0,1,135,0.0,135.0,135.0
106546453.0,17,14,864,7,432,17667844.833333332,174.0,61.71428571428572,7,432,17666818.666666668,174.0,61.71428571428572
157029.0,17,2,180,1,90,0.0,90.0,90.0,1,90,0.0,90.0,90.0
59152.0,6,14,4740,7,653,8029.166666666667,249.0,93.28571428571428,7,4087,9599.0,1514.0,583.8571428571429
745054.0,6,2,132,1,66,0.0,66.0,66.0,1,66,0.0,66.0,66.0
32060.0,6,14,4740,7,653,4800.166666666667,249.0,93.28571428571428,7,4087,5088.5,1514.0,583.8571428571429
3578.0,17,4,571,2,148,0.0,74.0,74.0,2,423,0.0,280.0,211.5
307722.0,6,6,412,4,272,102574.0,74.0,68.0,2,140,0.0,74.0,70.0
207205.0,6,3,426,2,280,0.0,214.0,140.0,1,146,0.0,146.0,146.0
90295993.0,6,16,1192,8,596,12892705.57142857,95.0,74.5,8,596,12899068.714285716,95.0,74.5
94181874.0,17,12,778,6,389,18836374.8,174.0,64.83333333333333,6,389,18783284.2,174.0,64.83333333333333
349.0,17,2,267,1,83,0.0,83.0,83.0,1,184,0.0,184.0,184.0
327246.0,17,2,180,1,90,0.0,90.0,90.0,1,90,0.0,90.0,90.0
39925.0,6,10,2032,5,524,9746.75,252.0,104.8,5,1508,9122.5,1236.0,301.6
51041.0,6,14,4740,7,653,7441.0,249.0,93.28571428571428,7,4087,6551.0,1514.0,583.8571428571429
108248.0,17,4,1400,4,1400,36082.66666666666,350.0,350.0,0,0,0.0,0.0,0.0
197503.0,17,2,180,1,90,0.0,90.0,90.0,1,90,0.0,90.0,90.0
1822705.0,6,4,276,2,128,0.0,74.0,64.0,2,148,0.0,74.0,74.0
59105260.0,17,9,3086,8,2736,5145067.428571428,342.0,342.0,1,350,0.0,350.0,350.0
281308.0,17,2,363,1,79,0.0,79.0,79.0,1,284,0.0,284.0,284.0
135132879.0,17,6,1146,6,1146,27026575.8,191.0,191.0,0,0,0.0,0.0,0.0
124879053.0,6,32,2242,17,1225,7804940.8125,139.0,72.05882352941177,15,1017,8191298.571428572,123.0,67.8
321512.0,17,4,1400,4,1400,107170.66666666669,350.0,350.0,0,0,0.0,0.0,0.0
126001245.0,17,15,907,8,475,18000177.85714286,174.0,59.375,7,432,17667406.666666668,174.0,61.71428571428572
1302503.0,6,4,264,2,132,0.0,66.0,66.0,2,132,0.0,66.0,66.0
197359.0,17,2,180,1,90,0.0,90.0,90.0,1,90,0.0,90.0,90.0
15837.0,6,14,4740,7,653,2530.1666666666665,249.0,93.28571428571428,7,4087,2503.0,1514.0,583.8571428571429
135132435.0,17,6,1146,6,1146,27026487.0,191.0,191.0,0,0,0.0,0.0,0.0
134409.0,6,2,132,1,66,0.0,66.0,66.0,1,66,0.0,66.0,66.0
17692.0,6,10,2032,5,524,4136.25,252.0,104.8,5,1508,3505.75,1236.0,301.6
2385.0,17,4,344,2,150,0.0,75.0,75.0,2,194,0.0,103.0,97.0
60916.0,6,10,2032,5,524,14857.75,252.0,104.8,5,1508,14167.75,1236.0,301.6
37202.0,6,2,145,2,145,0.0,91.0,72.5,0,0,0.0,0.0,0.0
9936.0,17,4,823,2,163,0.0,89.0,81.5,2,660,0.0,443.0,330.0
641.0,17,2,762,2,762,0.0,381.0,381.0,0,0,0.0,0.0,0.0
102751.0,17,2,286,2,286,0.0,143.0,143.0,0,0,0.0,0.0,0.0
218091.0,6,3,426,2,280,0.0,214.0,140.0,1,146,0.0,146.0,146.0
556.0,17,2,508,2,508,0.0,257.0,254.0,0,0,0.0,0.0,0.0
103027.0,17,2,286,2,286,0.0,143.0,143.0,0,0,0.0,0.0,0.0
118495408.0,6,224,25184,112,17496,1065586.2972972973,284.0,156.21428571428572,112,7688,1065586.5765765766,140.0,68.64285714285714
300699.0,6,6,412,4,272,100233.0,74.0,68.0,2,140,0.0,74.0,70.0
1310134.0,6,4,264,2,132,0.0,66.0,66.0,2,132,0.0,66.0,66.0
90514554.0,6,13,2036,8,1016,12930650.57142857,188.0,127.0,5,1020,22588291.75,204.0,204.0
101275571.0,17,14,1126,7,563,16834354.5,174.0,80.42857142857143,7,563,16833485.166666668,174.0,80.42857142857143
90295192.0,6,16,1192,8,596,12893128.142857144,95.0,74.5,8,596,12897641.857142856,95.0,74.5
129011970.0,17,15,907,8,475,18430281.42857143,174.0,59.375,7,432,18166823.83333333,174.0,61.71428571428572
472786.0,6,14,4740,7,653,78478.0,249.0,93.28571428571428,7,4087,78451.33333333333,1514.0,583.8571428571429
311336.0,17,4,1400,4,1400,103778.66666666669,350.0,350.0,0,0,0.0,0.0,0.0
112535442.0,6,46,3036,23,1518,5105434.045454546,66.0,66.0,23,1518,5105434.181818182,66.0,66.0
103733.0,17,2,286,2,286,0.0,143.0,143.0,0,0,0.0,0.0,0.0
0.0,17,1,55,1,55,0.0,55.0,55.0,0,0,0.0,0.0,0.0
28737.0,6,14,4740,7,653,4565.5,249.0,93.28571428571428,7,4087,4653.833333333333,1514.0,583.8571428571429
2316.0,17,4,344,2,150,0.0,75.0,75.0,2,194,0.0,103.0,97.0
7171.0,17,2,582,1,83,0.0,83.0,83.0,1,499,0.0,499.0,499.0
135122295.0,17,6,1146,6,1146,27024459.0,191.0,191.0,0,0,0.0,0.0,0.0
16962.0,17,2,180,1,90,0.0,90.0,90.0,1,90,0.0,90.0,90.0
45171.0,6,14,4740,7,653,6890.833333333333,249.0,93.28571428571428,7,4087,6949.166666666667,1514.0,583.8571428571429
196987.0,17,2,180,1,90,0.0,90.0,90.0,1,90,0.0,90.0,90.0
3224.0,17,2,224,1,76,0.0,76.0,76.0,1,148,0.0,148.0,148.0
297734.0,6,6,412,4,272,99244.66666666669,74.0,68.0,2,140,0.0,74.0,70.0
3012208.0,6,11,2106,6,598,602208.0,252.0,99.66666666666669,5,1508,3023.75,1236.0,301.6
2298.0,17,4,344,2,150,0.0,75.0,75.0,2,194,0.0,103.0,97.0
105575.0,17,2,700,2,700,0.0,350.0,350.0,0,0,0.0,0.0,0.0
1249906.0,6,7,499,4,301,406793.3333333333,103.0,75.25,3,198,615836.0,66.0,66.0
416954.0,17,2,363,1,75,0.0,75.0,75.0,1,288,0.0,288.0,288.0
202887.0,17,4,6056,4,6056,67629.0,1514.0,1514.0,0,0,0.0,0.0,0.0
1488.0,17,2,762,2,762,0.0,381.0,381.0,0,0,0.0,0.0,0.0
169252.0,6,3,337,2,214,0.0,160.0,107.0,1,123,0.0,123.0,123.0
89206.0,6,14,4740,7,653,14244.5,249.0,93.28571428571428,7,4087,13884.333333333334,1514.0,583.8571428571429
41799631.0,6,26,7627,14,3735,208009.2307692308,1514.0,266.7857142857143,12,3892,3781274.272727273,1514.0,324.3333333333333
135124988.0,17,6,1146,6,1146,27024997.6,191.0,191.0,0,0,0.0,0.0,0.0
497119.0,6,5,336,2,134,0.0,68.0,67.0,3,202,192913.5,70.0,67.33333333333333
120334208.0,6,249,28132,125,19652,970437.1612903224,284.0,157.216,124,8480,970953.5447154472,140.0,68.38709677419355
213676.0,17,2,180,1,90,0.0,90.0,90.0,1,90,0.0,90.0,90.0
148765.0,17,2,366,1,88,0.0,88.0,88.0,1,278,0.0,278.0,278.0
9024.0,17,2,582,1,83,0.0,83.0,83.0,1,499,0.0,499.0,499.0
344355.0,17,4,1524,4,1524,114785.0,381.0,381.0,0,0,0.0,0.0,0.0
7632295.0,17,6,1423,3,273,3811551.0,103.0,91.0,3,1150,3811222.5,449.0,383.3333333333333
138208.0,6,2,132,1,66,0.0,66.0,66.0,1,66,0.0,66.0,66.0
2281905.0,6,3,1604,1,753,0.0,753.0,753.0,2,851,0.0,785.0,425.5
298355.0,6,6,412,4,272,99451.66666666669,74.0,68.0,2,140,0.0,74.0,70.0
37441.0,6,10,2032,5,524,9102.5,252.0,104.8,5,1508,8864.0,1236.0,301.6
90036161.0,6,15,1265,7,501,10037344.166666666,95.0,71.57142857142857,8,764,12860268.857142856,222.0,95.5
279474.0,17,4,571,2,148,0.0,74.0,74.0,2,423,0.0,280.0,211.5
95130680.0,6,40,2640,20,1320,5006877.894736842,66.0,66.0,20,1320,4995500.842105263,66.0,66.0
117001074.0,17,13,821,7,432,19500179.0,174.0,61.71428571428572,6,389,19402303.8,174.0,64.83333333333333
32924.0,6,14,4740,7,653,4234.5,249.0,93.28571428571428,7,4087,5234.5,1514.0,583.8571428571429
2802622.0,6,2,132,1,66,0.0,66.0,66.0,1,66,0.0,66.0,66.0
54743721.0,6,14,982,6,437,10948173.6,95.0,72.83333333333333,8,545,7819694.142857143,95.0,68.125
213762.0,17,2,180,1,90,0.0,90.0,90.0,1,90,0.0,90.0,90.0
500609.0,17,2,363,1,79,0.0,79.0,79.0,1,284,0.0,284.0,284.0
5031.0,17,2,762,2,762,0.0,381.0,381.0,0,0,0.0,0.0,0.0
90097039.0,6,12,1848,5,1020,22523058.0,204.0,204.0,7,828,14970315.666666666,188.0,118.28571428571428
108657667.0,6,44,2904,22,1452,5174174.619047619,66.0,66.0,22,1452,5159884.476190476,66.0,66.0
34027.0,6,14,4740,7,653,5409.833333333333,249.0,93.28571428571428,7,4087,5468.5,1514.0,583.8571428571429
146260.0,6,3,337,2,214,0.0,160.0,107.0,1,123,0.0,123.0,123.0
379.0,17,2,174,1,79,0.0,79.0,79.0,1,95,0.0,95.0,95.0
135115754.0,17,6,1146,6,1146,27023150.8,191.0,191.0,0,0,0.0,0.0,0.0
27358413.0,17,5,1710,5,1710,6839603.25,342.0,342.0,0,0,0.0,0.0,0.0
29235.0,6,14,4740,7,653,4747.333333333333,249.0,93.28571428571428,7,4087,4734.333333333333,1514.0,583.8571428571429
113520590.0,6,46,3036,23,1518,5160003.727272728,66.0,66.0,23,1518,5160015.045454546,66.0,66.0
13718759.0,17,6,2052,6,2052,2743751.8,342.0,342.0,0,0,0.0,0.0,0.0
232136.0,6,3,337,2,214,0.0,160.0,107.0,1,123,0.0,123.0,123.0
90284285.0,6,21,1585,11,840,9024060.8,95.0,76.36363636363636,10,745,10000998.111111112,95.0,74.5
54224.0,6,10,2032,5,524,12967.0,252.0,104.8,5,1508,11030.0,1236.0,301.6
146039.0,6,3,337,2,214,0.0,160.0,107.0,1,123,0.0,123.0,123.0
232340.0,6,3,337,2,214,0.0,160.0,107.0,1,123,0.0,123.0,123.0
120124750.0,6,13,2020,9,1204,15015593.75,188.0,133.77777777777777,4,816,30030892.666666668,204.0,204.0
108109362.0,17,5,1005,5,1005,27027340.5,201.0,201.0,0,0,0.0,0.0,0.0
34675.0,6,10,2032,5,524,8407.5,252.0,104.8,5,1508,8400.5,1236.0,301.6
103595.0,17,2,286,2,286,0.0,143.0,143.0,0,0,0.0,0.0,0.0
29369.0,6,10,2032,5,524,7117.5,252.0,104.8,5,1508,6921.5,1236.0,301.6
96751066.0,17,12,778,6,389,19200167.0,174.0,64.83333333333333,6,389,19201370.0,174.0,64.83333333333333
110261979.0,6,236,27936,118,8010,935397.4786324786,140.0,67.88135593220339,118,19926,942340.9572649573,284.0,168.864406779661
140859.0,17,4,1524,4,1524,46953.0,381.0,381.0,0,0,0.0,0.0,0.0
146155.0,6,3,337,2,214,0.0,160.0,107.0,1,123,0.0,123.0,123.0
135130672.0,17,6,1206,6,1206,27026134.4,201.0,201.0,0,0,0.0,0.0,0.0
28606.0,6,14,4740,7,653,4652.833333333333,249.0,93.28571428571428,7,4087,4627.833333333333,1514.0,583.8571428571429
314.0,17,2,174,1,79,0.0,79.0,79.0,1,95,0.0,95.0,95.0
985851.0,17,6,1230,3,234,492733.5,78.0,78.0,3,996,492720.5,332.0,332.0
228412.0,17,2,180,1,90,0.0,90.0,90.0,1,90,0.0,90.0,90.0
103305.0,17,2,286,2,286,0.0,143.0,143.0,0,0,0.0,0.0,0.0
316960.0,6,6,412,4,272,105653.33333333331,74.0,68.0,2,140,0.0,74.0,70.0
3394.0,17,4,571,2,148,0.0,74.0,74.0,2,423,0.0,280.0,211.5
120033887.0,17,28,13364,28,13364,4445699.518518519,501.0,477.2857142857143,0,0,0.0,0.0,0.0
108294484.0,6,192,21648,96,15090,1137677.0,284.0,157.1875,96,6558,1137675.5263157894,140.0,68.3125
156282.0,6,4,391,2,214,0.0,160.0,107.0,2,177,0.0,123.0,88.5
28782.0,6,14,4740,7,653,4122.0,249.0,93.28571428571428,7,4087,4017.8333333333335,1514.0,583.8571428571429
92548048.0,6,28,2008,14,1045,7102482.076923077,139.0,74.64285714285714,14,963,7102481.461538462,123.0,68.78571428571429
302114.0,6,6,412,4,272,100704.66666666669,74.0,68.0,2,140,0.0,74.0,70.0
123158315.0,6,34,2356,18,1285,7244606.764705882,139.0,71.38888888888889,16,1071,7531202.933333334,123.0,66.9375
5887.0,17,2,239,1,82,0.0,82.0,82.0,1,157,0.0,157.0,157.0
2050709.0,17,8,1640,4,312,683441.6666666666,78.0,78.0,4,1328,683431.3333333334,332.0,332.0
28436.0,6,10,2032,5,524,5515.25,252.0,104.8,5,1508,6526.5,1236.0,301.6
49121.0,6,14,4740,7,653,7263.333333333333,249.0,93.28571428571428,7,4087,8052.0,1514.0,583.8571428571429
120541359.0,6,465,59822,233,44214,519574.8232758621,336.0,189.7596566523605,232,15608,512922.7142857143,140.0,67.27586206896552
2333.0,17,4,344,2,150,0.0,75.0,75.0,2,194,0.0,103.0,97.0
145779.0,6,2,132,1,66,0.0,66.0,66.0,1,66,0.0,66.0,66.0
29840.0,6,14,4740,7,653,4852.5,249.0,93.28571428571428,7,4087,4617.666666666667,1514.0,583.8571428571429
5616255.0,6,5,336,2,134,0.0,68.0,67.0,3,202,1613925.0,70.0,67.33333333333333
212890.0,6,10,1221,6,636,42578.0,298.0,106.0,4,585,69579.33333333333,379.0,146.25
462688.0,6,4,508,2,238,0.0,172.0,119.0,2,270,0.0,135.0,135.0
12962.0,6,12,1393,6,796,2319.8,271.0,132.66666666666666,6,597,2383.8,259.0,99.5
252464.00000000003,17,4,1400,4,1400,84154.66666666667,350.0,350.0,0,0,0.0,0.0,0.0
32083.0,6,14,4740,7,653,5221.0,249.0,93.28571428571428,7,4087,4915.666666666667,1514.0,583.8571428571429
59060.0,6,14,4740,7,653,9377.833333333334,249.0,93.28571428571428,7,4087,8669.166666666666,1514.0,583.8571428571429
31804.0,6,14,4740,7,653,4929.166666666667,249.0,93.28571428571428,7,4087,4282.0,1514.0,583.8571428571429
307833.0,6,6,412,4,272,102611.0,74.0,68.0,2,140,0.0,74.0,70.0
113731917.0,6,46,3036,23,1518,5155446.681818182,66.0,66.0,23,1518,5155441.045454546,66.0,66.0
220475.0,6,5,301,3,162,110237.5,54.0,54.0,2,139,0.0,85.0,69.5
228301.0,17,2,180,1,90,0.0,90.0,90.0,1,90,0.0,90.0,90.0
90290320.0,6,16,1192,8,596,12891347.857142856,95.0,74.5,8,596,12898281.142857144,95.0,74.5
10513036.0,6,7,478,4,272,3457308.0,74.0,68.0,3,206,5185876.0,74.0,68.66666666666667
123839763.0,6,48,3168,24,1584,5082402.391304348,66.0,66.0,24,1584,5215032.565217392,66.0,66.0
90296886.0,6,19,1436,10,745,10028473.666666666,95.0,74.5,9,691,11285608.5,95.0,76.77777777777777
304.0,17,2,164,1,82,0.0,82.0,82.0,1,82,0.0,82.0,82.0
119661908.0,17,35,16705,35,16705,3519467.882352941,501.0,477.2857142857143,0,0,0.0,0.0,0.0
27036.0,6,14,4740,7,653,4014.3333333333335,249.0,93.28571428571428,7,4087,4305.5,1514.0,583.8571428571429
883756.0,6,12,2710,7,743,147292.66666666666,339.0,106.14285714285714,5,1967,152798.0,1514.0,393.4
84.0,17,2,762,2,762,0.0,381.0,381.0,0,0,0.0,0.0,0.0
45996.0,6,14,4740,7,653,7539.5,249.0,93.28571428571428,7,4087,7008.5,1514.0,583.8571428571429
156079.0,17,2,180,1,90,0.0,90.0,90.0,1,90,0.0,90.0,90.0
207429.0,6,3,426,2,280,0.0,214.0,140.0,1,146,0.0,146.0,146.0
1719727.0,6,22,6443,12,1529,156338.81818181818,357.0,127.41666666666669,10,4914,156865.33333333334,1510.0,491.4
108098902.0,17,5,1005,5,1005,27024725.5,201.0,201.0,0,0,0.0,0.0,0.0
317559.0,6,6,412,4,272,105853.0,74.0,68.0,2,140,0.0,74.0,70.0
350.0,17,2,267,1,83,0.0,83.0,83.0,1,184,0.0,184.0,184.0
14117862.0,17,6,2052,6,2052,2823572.4,342.0,342.0,0,0,0.0,0.0,0.0
5725690.0,6,5,336,2,134,0.0,68.0,67.0,3,202,1524092.5,70.0,67.33333333333333
2404070.0,6,3,204,2,136,0.0,70.0,68.0,1,68,0.0,68.0,68.0
13534859.0,6,7,499,4,301,3337785.6666666665,103.0,75.25,3,198,6143255.5,66.0,66.0
90258984.0,6,13,2036,8,1016,12894140.57142857,188.0,127.0,5,1020,22523273.0,204.0,204.0
108105986.0,17,5,955,5,955,27026496.5,191.0,191.0,0,0,0.0,0.0,0.0
145592.0,6,3,337,2,214,0.0,160.0,107.0,1,123,0.0,123.0,123.0
218955.0,6,12,1373,7,714,36492.5,298.0,102.0,5,659,52849.75,379.0,131.8
515521.0,17,2,374,1,73,0.0,73.0,73.0,1,301,0.0,301.0,301.0
206741.0,6,3,426,2,280,0.0,214.0,140.0,1,146,0.0,146.0,146.0
303.0,17,2,174,1,79,0.0,79.0,79.0,1,95,0.0,95.0,95.0
2327.0,17,4,344,2,150,0.0,75.0,75.0,2,194,0.0,103.0,97.0
242265.0,6,3,337,2,214,0.0,160.0,107.0,1,123,0.0,123.0,123.0
90530076.0,6,14,2240,8,1016,12932868.0,188.0,127.0,6,1224,18073302.6,204.0,204.0
209659.0,17,2,180,1,90,0.0,90.0,90.0,1,90,0.0,90.0,90.0
60921.0,6,15,4806,8,719,8604.0,249.0,89.875,7,4087,9978.5,1514.0,583.8571428571429
108099266.0,17,5,1005,5,1005,27024816.5,201.0,201.0,0,0,0.0,0.0,0.0
585313.0,6,15,4811,7,742,96728.33333333331,230.0,106.0,8,4069,83224.28571428571,1514.0,508.625
153479.0,17,2,180,1,90,0.0,90.0,90.0,1,90,0.0,90.0,90.0
100598.0,6,10,1065,5,534,24556.0,262.0,106.8,5,531,21566.5,259.0,106.2
21490.0,6,10,2032,5,524,4863.75,252.0,104.8,5,1508,4916.25,1236.0,301.6
137834.0,6,2,132,1,66,0.0,66.0,66.0,1,66,0.0,66.0,66.0
113168405.0,6,46,3036,23,1518,5144007.045454546,66.0,66.0,23,1518,5144005.681818182,66.0,66.0
165732.0,17,2,414,1,88,0.0,88.0,88.0,1,326,0.0,326.0,326.0
242057.0,6,3,337,2,214,0.0,160.0,107.0,1,123,0.0,123.0,123.0
736.0,17,4,438,2,148,0.0,74.0,74.0,2,290,0.0,147.0,145.0
43201.0,6,10,2032,5,524,10571.75,252.0,104.8,5,1508,10070.0,1236.0,301.6
121997464.0,6,33,2365,16,1140,7467524.533333333,123.0,71.25,17,1225,7624731.5,139.0,72.05882352941177
300150.0,6,6,412,4,272,100050.0,74.0,68.0,2,140,0.0,74.0,70.0
9325.0,17,2,582,1,83,0.0,83.0,83.0,1,499,0.0,499.0,499.0
102647.0,17,2,286,2,286,0.0,143.0,143.0,0,0,0.0,0.0,0.0
147882.0,17,2,180,1,90,0.0,90.0,90.0,1,90,0.0,90.0,90.0
100317473.0,17,12,778,6,389,20063494.6,174.0,64.83333333333333,6,389,20003500.0,174.0,64.83333333333333
326.0,17,2,176,1,80,0.0,80.0,80.0,1,96,0.0,96.0,96.0
305175.0,6,6,412,4,272,101725.0,74.0,68.0,2,140,0.0,74.0,70.0
2806263.0,6,2,132,1,66,0.0,66.0,66.0,1,66,0.0,66.0,66.0
103206.0,17,2,286,2,286,0.0,143.0,143.0,0,0,0.0,0.0,0.0
114124782.0,6,48,3168,24,1584,4961947.043478261,66.0,66.0,24,1584,4949969.217391305,66.0,66.0
233226.0,6,3,337,2,214,0.0,160.0,107.0,1,123,0.0,123.0,123.0
120649.0,6,3,337,2,214,0.0,160.0,107.0,1,123,0.0,123.0,123.0
96866555.0,6,425,57790,213,14280,456917.71226415096,140.0,67.04225352112677,212,43510,454170.8815165877,570.0,205.23584905660377
119983804.0,6,17,1287,9,691,14997975.5,95.0,76.77777777777777,8,596,17105306.57142857,95.0,74.5
140122.0,17,4,1400,4,1400,46707.333333333336,350.0,350.0,0,0,0.0,0.0,0.0
5625438.0,6,5,336,2,134,0.0,68.0,67.0,3,202,1472602.0,70.0,67.33333333333333
30009.0,6,10,2032,5,524,2981.25,252.0,104.8,5,1508,7144.75,1236.0,301.6
30755.0,6,10,2032,5,524,7449.0,252.0,104.8,5,1508,7362.75,1236.0,301.6
29342.0,6,14,4740,7,653,4764.0,249.0,93.28571428571428,7,4087,4037.6666666666665,1514.0,583.8571428571429
32446.000000000004,6,14,4740,7,653,4477.166666666667,249.0,93.28571428571428,7,4087,4755.166666666667,1514.0,583.8571428571429
153350.0,17,2,180,1,90,0.0,90.0,90.0,1,90,0.0,90.0,90.0
90028122.0,17,28,13364,28,13364,3334374.888888889,501.0,477.2857142857143,0,0,0.0,0.0,0.0
69828.0,17,2,620,1,75,0.0,75.0,75.0,1,545,0.0,545.0,545.0
105494.0,17,2,286,2,286,0.0,143.0,143.0,0,0,0.0,0.0,0.0
36850.0,6,10,2032,5,524,8895.5,252.0,104.8,5,1508,8983.0,1236.0,301.6
90256571.0,6,13,2036,8,1016,12893795.857142856,188.0,127.0,5,1020,22523114.25,204.0,204.0
214162.0,6,12,1373,7,714,35693.666666666664,298.0,102.0,5,659,52743.0,379.0,131.8
90302313.0,6,16,1192,8,596,12893410.57142857,95.0,74.5,8,596,12898991.42857143,95.0,74.5
322172.0,6,6,412,4,272,107390.66666666669,74.0,68.0,2,140,0.0,74.0,70.0
212021.0,6,10,1221,6,636,42404.2,298.0,106.0,4,585,69363.33333333333,379.0,146.25
17684.0,6,14,4740,7,653,2776.0,249.0,93.28571428571428,7,4087,2808.6666666666665,1514.0,583.8571428571429
2013.0,17,4,344,2,150,0.0,75.0,75.0,2,194,0.0,103.0,97.0
305778.0,6,6,412,4,272,101926.0,74.0,68.0,2,140,0.0,74.0,70.0
122530511.0,6,49,3234,25,1650,5105437.958333333,66.0,66.0,24,1584,4959472.695652174,66.0,66.0
18209.0,6,10,1066,5,490,3336.75,218.0,98.0,5,576,4355.75,304.0,115.2
54925.0,6,10,2032,5,524,11788.5,252.0,104.8,5,1508,12207.0,1236.0,301.6
2831340.0,6,2,132,1,66,0.0,66.0,66.0,1,66,0.0,66.0,66.0
106194590.0,17,13,821,7,432,17699098.333333332,174.0,61.71428571428572,6,389,17242367.4,174.0,64.83333333333333
90286355.0,6,16,1192,8,596,12892138.857142856,95.0,74.5,8,596,12897049.285714284,95.0,74.5
45334.0,6,13,1479,7,882,7555.666666666667,291.0,126.0,6,597,7677.0,259.0,99.5
310562.0,17,4,622,4,622,103520.66666666669,163.0,155.5,0,0,0.0,0.0,0.0
310835.0,17,4,622,4,622,103611.66666666669,163.0,155.5,0,0,0.0,0.0,0.0
3002020.0,6,11,2106,6,598,600211.6,252.0,99.66666666666669,5,1508,1892.75,1236.0,301.6
97000788.0,17,11,735,6,389,19400157.6,174.0,64.83333333333333,5,346,19250626.75,174.0,69.2
149700975.0,6,14,2086,10,1270,16633441.666666666,188.0,127.0,4,816,30031344.33333333,204.0,204.0
1677577.0,6,2,132,1,66,0.0,66.0,66.0,1,66,0.0,66.0,66.0
235226.0,17,4,1400,4,1400,78408.66666666667,350.0,350.0,0,0,0.0,0.0,0.0
25810.0,6,14,4740,7,653,2954.833333333333,249.0,93.28571428571428,7,4087,3921.6666666666665,1514.0,583.8571428571429
1730.0,17,2,762,2,762,0.0,381.0,381.0,0,0,0.0,0.0,0.0
6978.0,17,2,582,1,83,0.0,83.0,83.0,1,499,0.0,499.0,499.0
121109.0,6,3,373,2,238,0.0,172.0,119.0,1,135,0.0,135.0,135.0
113253082.0,6,209,23602,105,7226,1088971.9423076925,140.0,68.81904761904762,104,16376,1089489.1844660195,284.0,157.46153846153845
144087.0,6,2,132,1,66,0.0,66.0,66.0,1,66,0.0,66.0,66.0
95178249.0,17,14,1126,7,563,15834093.833333334,174.0,80.42857142857143,7,563,15833509.666666666,174.0,80.42857142857143
158845.0,6,3,337,2,214,0.0,160.0,107.0,1,123,0.0,123.0,123.0
4807530.0,6,5,336,2,134,0.0,68.0,67.0,3,202,1524834.0,70.0,67.33333333333333
103023399.0,17,14,864,7,432,17000538.0,174.0,61.71428571428572,7,432,17166835.833333332,174.0,61.71428571428572
31606.000000000004,6,10,2032,5,524,5926.5,252.0,104.8,5,1508,7539.0,1236.0,301.6
10462099.0,6,7,478,4,272,3442003.0,74.0,68.0,3,206,5162901.0,74.0,68.66666666666667
104830528.0,6,842,167188,414,27842,253782.54479418887,214.0,67.2512077294686,428,139346,244667.5831381733,1514.0,325.5747663551402
44950.0,6,10,2032,5,524,8252.0,252.0,104.8,5,1508,10702.0,1236.0,301.6
217286.0,6,3,426,2,280,0.0,214.0,140.0,1,146,0.0,146.0,146.0
2070.0,17,4,344,2,150,0.0,75.0,75.0,2,194,0.0,103.0,97.0
17910.0,6,13,1459,7,862,2794.1666666666665,271.0,123.14285714285714,6,597,3372.6,259.0,99.5
3051437.0,6,3,204,2,136,0.0,70.0,68.0,1,68,0.0,68.0,68.0
109756.0,17,2,286,2,286,0.0,143.0,143.0,0,0,0.0,0.0,0.0
228285.0,17,2,180,1,90,0.0,90.0,90.0,1,90,0.0,90.0,90.0
108109165.0,17,5,955,5,955,27027291.25,191.0,191.0,0,0,0.0,0.0,0.0
1034681.0,6,11,1134,6,558,206936.2,220.0,93.0,5,576,255595.75,304.0,115.2
90264540.0,6,12,1832,8,1016,12894934.285714284,188.0,127.0,4,816,30032015.0,204.0,204.0
90950727.0,6,21,1585,11,840,9094269.0,95.0,76.36363636363636,10,745,10104111.0,95.0,74.5
153456.0,17,2,180,1,90,0.0,90.0,90.0,1,90,0.0,90.0,90.0
118149422.0,6,30,1990,15,1042,8424607.07142857,139.0,69.46666666666667,15,948,8424641.0,123.0,63.2
120086392.0,6,357,55802,179,12270,674642.6516853933,214.0,68.54748603351955,178,43532,672645.384180791,1514.0,244.56179775280896
38622.0,6,14,4740,7,653,6327.0,249.0,93.28571428571428,7,4087,5070.0,1514.0,583.8571428571429
2324.0,17,4,344,2,150,0.0,75.0,75.0,2,194,0.0,103.0,97.0
39204.0,6,14,4740,7,653,5987.166666666667,249.0,93.28571428571428,7,4087,6296.333333333333,1514.0,583.8571428571429
298190.0,6,6,412,4,272,99396.66666666669,74.0,68.0,2,140,0.0,74.0,70.0
418.0,17,2,508,2,508,0.0,257.0,254.0,0,0,0.0,0.0,0.0
107026533.0,17,14,864,7,432,17834444.666666668,174.0,61.71428571428572,7,432,17833501.5,174.0,61.71428571428572
90250632.0,6,12,1832,8,1016,12892947.42857143,188.0,127.0,4,816,30029364.666666668,204.0,204.0
120253304.0,6,232,26216,116,7878,1029349.1217391304,140.0,67.91379310344827,116,18338,1038527.0695652174,284.0,158.08620689655172
120003224.0,17,29,13785,29,13785,4285829.428571428,501.0,475.3448275862069,0,0,0.0,0.0,0.0
5623406.0,6,5,336,2,134,0.0,68.0,67.0,3,202,1423516.5,70.0,67.33333333333333
143890.0,17,2,180,1,90,0.0,90.0,90.0,1,90,0.0,90.0,90.0
30075.0,6,10,2032,5,524,7036.0,252.0,104.8,5,1508,7245.25,1236.0,301.6
322.0,17,2,174,1,79,0.0,79.0,79.0,1,95,0.0,95.0,95.0
25406.0,6,11,1132,6,556,4105.6,218.0,92.66666666666669,5,576,6068.75,304.0,115.2
120107682.0,6,252,28574,126,8612,954347.72,140.0,68.34920634920636,126,19962,954318.112,300.0,158.42857142857142
78489.0,6,14,4740,7,653,12921.5,249.0,93.28571428571428,7,4087,11988.0,1514.0,583.8571428571429
190761.0,17,2,180,1,90,0.0,90.0,90.0,1,90,0.0,90.0,90.0
13289.0,17,4,438,2,148,0.0,74.0,74.0,2,290,0.0,147.0,145.0
135131492.0,17,6,1146,6,1146,27026298.4,191.0,191.0,0,0,0.0,0.0,0.0
9077.0,17,2,539,1,86,0.0,86.0,86.0,1,453,0.0,453.0,453.0
23567.0,17,2,582,1,83,0.0,83.0,83.0,1,499,0.0,499.0,499.0
298155.0,6,6,412,4,272,99385.0,74.0,68.0,2,140,0.0,74.0,70.0
228329.0,17,2,180,1,90,0.0,90.0,90.0,1,90,0.0,90.0,90.0
96804968.0,6,40,2640,20,1320,5094998.315789473,66.0,66.0,20,1320,5078710.105263158,66.0,66.0
107924.0,17,2,286,2,286,0.0,143.0,143.0,0,0,0.0,0.0,0.0
2408.0,17,4,344,2,150,0.0,75.0,75.0,2,194,0.0,103.0,97.0
215519.0,17,2,180,1,90,0.0,90.0,90.0,1,90,0.0,90.0,90.0
157816.0,6,3,337,2,214,0.0,160.0,107.0,1,123,0.0,123.0,123.0
118340535.0,6,229,25838,115,7886,1038074.8684210526,140.0,68.57391304347826,114,17952,1038500.5840707964,284.0,157.47368421052633
90281408.0,6,16,1192,8,596,12891240.285714284,95.0,74.5,8,596,12896013.0,95.0,74.5
3594.0,17,4,344,2,150,0.0,75.0,75.0,2,194,0.0,103.0,97.0
135130307.0,17,6,1146,6,1146,27026061.4,191.0,191.0,0,0,0.0,0.0,0.0
218012.0,17,2,180,1,90,0.0,90.0,90.0,1,90,0.0,90.0,90.0
108126887.0,17,5,955,5,955,27031721.75,191.0,191.0,0,0,0.0,0.0,0.0
120009150.0,17,29,13785,29,13785,4286041.071428572,501.0,475.3448275862069,0,0,0.0,0.0,0.0
2331.0,17,4,344,2,150,0.0,75.0,75.0,2,194,0.0,103.0,97.0
42783.0,6,10,2032,5,524,9632.25,252.0,104.8,5,1508,9602.5,1236.0,301.6
102419.0,17,2,286,2,286,0.0,143.0,143.0,0,0,0.0,0.0,0.0
153449.0,17,2,180,1,90,0.0,90.0,90.0,1,90,0.0,90.0,90.0
1309922.0,6,4,264,2,132,0.0,66.0,66.0,2,132,0.0,66.0,66.0
131006635.0,17,15,907,8,475,18715233.57142857,174.0,59.375,7,432,18462846.83333333,174.0,61.71428571428572
1838541.0,6,21,6970,12,3153,167140.0909090909,1514.0,262.75,9,3817,203072.125,1514.0,424.1111111111111
4250.0,17,2,614,1,72,0.0,72.0,72.0,1,542,0.0,542.0,542.0
313665.0,17,4,1400,4,1400,104555.0,350.0,350.0,0,0,0.0,0.0,0.0
2021.0,17,4,344,2,150,0.0,75.0,75.0,2,194,0.0,103.0,97.0
23777.0,6,10,2032,5,524,5726.25,252.0,104.8,5,1508,5390.0,1236.0,301.6
119967284.0,17,35,16705,35,16705,3528449.529411765,501.0,477.2857142857143,0,0,0.0,0.0,0.0
284408.0,17,2,363,1,79,0.0,79.0,79.0,1,284,0.0,284.0,284.0
1439.0,17,5,550,5,550,359.75,110.0,110.0,0,0,0.0,0.0,0.0
148047.0,17,2,180,1,90,0.0,90.0,90.0,1,90,0.0,90.0,90.0
871070.0,6,10,1333,6,796,174214.0,458.0,132.66666666666666,4,537,198437.3333333333,331.0,134.25
27325.0,6,14,4740,7,653,3678.6666666666665,249.0,93.28571428571428,7,4087,4235.833333333333,1514.0,583.8571428571429
109387798.0,6,44,2904,22,1452,5208942.761904762,66.0,66.0,22,1452,5193972.0,66.0,66.0
135137254.0,17,6,1146,6,1146,27027450.8,191.0,191.0,0,0,0.0,0.0,0.0
20882.0,6,10,1949,5,441,4970.75,169.0,88.2,5,1508,3040.5,1236.0,301.6
16015850.0,17,2,684,2,684,0.0,342.0,342.0,0,0,0.0,0.0,0.0
301818.0,6,6,412,4,272,100606.0,74.0,68.0,2,140,0.0,74.0,70.0
2349.0,17,4,344,2,150,0.0,75.0,75.0,2,194,0.0,103.0,97.0
11374858.0,6,7,462,4,264,3791531.0,66.0,66.0,3,198,5159800.5,66.0,66.0
122005707.0,17,15,1169,8,606,17429386.714285713,174.0,75.75,7,563,17000154.5,174.0,80.42857142857143
5623206.0,6,5,336,2,134,0.0,68.0,67.0,3,202,1526259.0,70.0,67.33333333333333
2028.0,17,4,344,2,150,0.0,75.0,75.0,2,194,0.0,103.0,97.0
120156750.0,6,47,3102,23,1518,5159999.318181818,66.0,66.0,24,1584,5224192.826086956,66.0,66.0
64766.00000000001,6,14,4740,7,653,9090.333333333334,249.0,93.28571428571428,7,4087,9408.666666666666,1514.0,583.8571428571429
307156.0,6,6,412,4,272,102385.33333333331,74.0,68.0,2,140,0.0,74.0,70.0
24573.0,17,2,582,1,83,0.0,83.0,83.0,1,499,0.0,499.0,499.0
120371484.0,6,227,25578,114,17898,1065234.371681416,284.0,157.0,113,7680,1065248.1607142857,140.0,67.96460176991151
10522974.0,6,7,478,4,272,3462173.0,74.0,68.0,3,206,5193147.0,74.0,68.66666666666667
102947.0,17,2,762,2,762,0.0,381.0,381.0,0,0,0.0,0.0,0.0
18347.0,6,14,4740,7,653,2947.0,249.0,93.28571428571428,7,4087,2920.833333333333,1514.0,583.8571428571429
508855.0,6,5,336,2,134,0.0,68.0,67.0,3,202,193980.0,70.0,67.33333333333333
163646.0,6,11,1132,6,556,32729.2,218.0,92.66666666666669,5,576,35664.75,304.0,115.2
6063.0,17,2,180,1,90,0.0,90.0,90.0,1,90,0.0,90.0,90.0
856330.0,6,9,1268,6,797,171266.0,459.0,132.83333333333334,3,471,291931.5,331.0,157.0
197029.0,17,2,180,1,90,0.0,90.0,90.0,1,90,0.0,90.0,90.0
113168592.0,6,46,3036,23,1518,5144004.590909091,66.0,66.0,23,1518,5144015.590909091,66.0,66.0
205677.0,17,2,180,1,90,0.0,90.0,90.0,1,90,0.0,90.0,90.0
310571.0,6,6,412,4,272,103523.66666666669,74.0,68.0,2,140,0.0,74.0,70.0
767.0,17,5,550,5,550,191.75,110.0,110.0,0,0,0.0,0.0,0.0
108108020.0,17,5,955,5,955,27027005.0,191.0,191.0,0,0,0.0,0.0,0.0
217808.0,6,3,426,2,280,0.0,214.0,140.0,1,146,0.0,146.0,146.0
120117043.0,6,12,1832,8,1016,17136329.285714287,188.0,127.0,4,816,30029577.666666668,204.0,204.0
42591.0,6,13,1386,7,789,6231.0,253.0,112.71428571428572,6,597,8301.4,259.0,99.5
108097833.0,17,5,955,5,955,27024458.25,191.0,191.0,0,0,0.0,0.0,0.0
219251.0,6,3,426,2,280,0.0,214.0,140.0,1,146,0.0,146.0,146.0
5828206.0,6,4,270,2,134,0.0,68.0,67.0,2,136,0.0,70.0,68.0
2341.0,17,4,344,2,150,0.0,75.0,75.0,2,194,0.0,103.0,97.0
199612.0,17,2,180,1,90,0.0,90.0,90.0,1,90,0.0,90.0,90.0
119623076.0,6,224,25344,112,17730,1075746.7567567567,284.0,158.30357142857142,112,7614,1075746.855855856,140.0,67.98214285714286
10461480.0,6,7,478,4,272,3441750.333333333,74.0,68.0,3,206,5162520.5,74.0,68.66666666666667
344.0,17,2,267,1,83,0.0,83.0,83.0,1,184,0.0,184.0,184.0
36108.0,6,10,2032,5,524,8785.75,252.0,104.8,5,1508,8734.5,1236.0,301.6
98739.0,17,2,762,2,762,0.0,381.0,381.0,0,0,0.0,0.0,0.0
108104470.0,17,5,955,5,955,27026117.5,191.0,191.0,0,0,0.0,0.0,0.0
10871628.0,6,7,478,3,206,5367641.5,74.0,68.66666666666667,4,272,3578359.6666666665,74.0,68.0
242459.0,17,4,1400,4,1400,80819.66666666667,350.0,350.0,0,0,0.0,0.0,0.0
26287280.0,17,5,1718,4,1368,749503.6666666666,342.0,342.0,1,350,0.0,350.0,350.0
169913.0,17,2,180,1,90,0.0,90.0,90.0,1,90,0.0,90.0,90.0
90257221.0,6,13,2036,8,1016,12893888.714285716,188.0,127.0,5,1020,22522548.75,204.0,204.0
39292.0,6,14,4740,7,653,5446.333333333333,249.0,93.28571428571428,7,4087,5904.5,1514.0,583.8571428571429
205777.0,17,2,180,1,90,0.0,90.0,90.0,1,90,0.0,90.0,90.0
43763.0,6,14,4740,7,653,7173.833333333333,249.0,93.28571428571428,7,4087,5828.666666666667,1514.0,583.8571428571429
219611.0,6,10,1221,6,636,43922.2,298.0,106.0,4,585,71874.66666666667,379.0,146.25
299390.0,6,6,412,4,272,99796.66666666669,74.0,68.0,2,140,0.0,74.0,70.0
15402.0,17,2,180,1,90,0.0,90.0,90.0,1,90,0.0,90.0,90.0
33690.0,6,10,2032,5,524,8173.25,252.0,104.8,5,1508,8161.25,1236.0,301.6
117536283.0,6,210,23790,105,16638,1128087.7115384615,284.0,158.45714285714286,105,7152,1128088.451923077,140.0,68.11428571428571
206037.0,6,3,426,2,280,0.0,214.0,140.0,1,146,0.0,146.0,146.0
43397.0,6,14,4740,7,653,6499.5,249.0,93.28571428571428,7,4087,6699.5,1514.0,583.8571428571429
306256.0,6,12,1373,7,714,51042.66666666666,298.0,102.0,5,659,72335.0,379.0,131.8
975349.0,6,10,1336,6,799,195069.8,461.0,133.16666666666666,4,537,233159.3333333333,331.0,134.25
29596.0,6,14,4740,7,653,4550.666666666667,249.0,93.28571428571428,7,4087,4729.833333333333,1514.0,583.8571428571429
302197.0,6,6,412,4,272,100732.33333333331,74.0,68.0,2,140,0.0,74.0,70.0
0.0,17,1,453,1,453,0.0,453.0,453.0,0,0,0.0,0.0,0.0
35733.0,6,13,1386,7,789,5955.5,253.0,112.71428571428572,6,597,5454.4,259.0,99.5
299818.0,6,6,412,4,272,99939.33333333331,74.0,68.0,2,140,0.0,74.0,70.0
22313.0,6,2,145,2,145,0.0,91.0,72.5,0,0,0.0,0.0,0.0
90257804.0,6,13,2036,8,1016,12893972.0,188.0,127.0,5,1020,22522533.75,204.0,204.0
120051913.0,17,28,13364,28,13364,4446367.148148148,501.0,477.2857142857143,0,0,0.0,0.0,0.0
1946.0,17,4,344,2,150,0.0,75.0,75.0,2,194,0.0,103.0,97.0
108116054.0,17,5,955,5,955,27029013.5,191.0,191.0,0,0,0.0,0.0,0.0
27225109.0,17,5,1710,5,1710,6806277.25,342.0,342.0,0,0,0.0,0.0,0.0
120049101.0,17,29,13785,29,13785,4287467.892857143,501.0,475.3448275862069,0,0,0.0,0.0,0.0
135134555.0,17,6,1206,6,1206,27026911.0,201.0,201.0,0,0,0.0,0.0,0.0
12624.0,6,10,1067,5,536,2991.0,264.0,107.2,5,531,2260.25,259.0,106.2
161152.0,6,2,128,1,74,0.0,74.0,74.0,1,54,0.0,54.0,54.0
111583796.0,6,45,3774,26,2127,4454719.88,123.0,81.8076923076923,19,1647,6187106.388888889,123.0,86.6842105263158
90251882.0,6,13,2036,8,1016,12893126.0,188.0,127.0,5,1020,22522426.5,204.0,204.0
355812.0,6,3,204,1,68,0.0,68.0,68.0,2,136,0.0,70.0,68.0
206745.0,6,3,426,2,280,0.0,214.0,140.0,1,146,0.0,146.0,146.0
39219.0,6,10,2032,5,524,8842.0,252.0,104.8,5,1508,9522.75,1236.0,301.6
232230.0,6,3,337,2,214,0.0,160.0,107.0,1,123,0.0,123.0,123.0
2574789.0,6,2,132,1,66,0.0,66.0,66.0,1,66,0.0,66.0,66.0
14646168.0,6,20,1607,10,975,1593598.0,315.0,97.5,10,632,1593572.2222222222,78.0,63.2
27661.0,6,14,4740,7,653,3605.3333333333335,249.0,93.28571428571428,7,4087,4477.333333333333,1514.0,583.8571428571429
11840.0,17,2,582,1,83,0.0,83.0,83.0,1,499,0.0,499.0,499.0
30778.0,6,14,4740,7,653,5004.666666666667,249.0,93.28571428571428,7,4087,5001.5,1514.0,583.8571428571429
32014.0,6,14,4740,7,653,5078.666666666667,249.0,93.28571428571428,7,4087,5197.166666666667,1514.0,583.8571428571429
16088.000000000002,17,2,180,1,90,0.0,90.0,90.0,1,90,0.0,90.0,90.0
33802.0,6,14,4740,7,653,5506.833333333333,249.0,93.28571428571428,7,4087,4688.5,1514.0,583.8571428571429
216911.0,6,10,1221,6,636,43382.2,298.0,106.0,4,585,71240.33333333333,379.0,146.25
207978.0,17,2,762,2,762,0.0,381.0,381.0,0,0,0.0,0.0,0.0
299015.0,6,6,412,4,272,99671.66666666669,74.0,68.0,2,140,0.0,74.0,70.0
4154.0,17,2,598,1,72,0.0,72.0,72.0,1,526,0.0,526.0,526.0
326339.0,17,4,1400,4,1400,108779.66666666669,350.0,350.0,0,0,0.0,0.0,0.0
25404.0,6,10,2032,5,524,5623.25,252.0,104.8,5,1508,6105.75,1236.0,301.6
10423098.0,6,6,412,3,206,5143128.0,74.0,68.66666666666667,3,206,5142981.5,74.0,68.66666666666667
149610.0,17,2,180,1,90,0.0,90.0,90.0,1,90,0.0,90.0,90.0
32832.0,6,10,2032,5,524,6854.75,252.0,104.8,5,1508,7802.25,1236.0,301.6
123250574.0,6,49,3234,25,1650,5135440.583333333,66.0,66.0,24,1584,4965431.173913044,66.0,66.0
96704266.0,6,180,20332,90,6162,1077233.865168539,140.0,68.46666666666667,90,14170,1077292.0898876404,284.0,157.44444444444446
121590.0,6,3,337,2,214,0.0,160.0,107.0,1,123,0.0,123.0,123.0
168706.0,17,2,414,1,88,0.0,88.0,88.0,1,326,0.0,326.0,326.0
2347.0,17,4,344,2,150,0.0,75.0,75.0,2,194,0.0,103.0,97.0
2672150.0,6,25,7573,14,3735,205550.0,1514.0,266.7857142857143,11,3838,242476.2,1514.0,348.90909090909093
146932.0,6,3,373,2,238,0.0,172.0,119.0,1,135,0.0,135.0,135.0
55225.0,6,14,4740,7,653,8530.333333333334,249.0,93.28571428571428,7,4087,8538.833333333334,1514.0,583.8571428571429
234211.0,6,3,337,2,214,0.0,160.0,107.0,1,123,0.0,123.0,123.0
356.0,17,2,267,1,83,0.0,83.0,83.0,1,184,0.0,184.0,184.0
103167515.0,17,14,864,7,432,17167494.5,174.0,61.71428571428572,7,432,17166861.166666668,174.0,61.71428571428572
2813539.0,6,11,2106,6,598,562458.6,252.0,99.66666666666669,5,1508,1738.25,1236.0,301.6
105054599.0,6,387,48108,194,13026,544324.3471502591,140.0,67.14432989690722,193,35082,541741.4895833334,554.0,181.7720207253886
121096225.0,17,15,1038,8,606,17299460.714285713,174.0,75.75,7,432,17166835.333333332,174.0,61.71428571428572
105736052.0,6,28,1860,14,966,8116949.0,123.0,69.0,14,894,8116948.692307692,123.0,63.85714285714285
307912.0,6,6,412,4,272,102637.33333333331,74.0,68.0,2,140,0.0,74.0,70.0
310341.0,17,4,571,2,148,0.0,74.0,74.0,2,423,0.0,276.0,211.5
305832.0,6,6,412,4,272,101944.0,74.0,68.0,2,140,0.0,74.0,70.0
318848.0,6,6,412,4,272,106282.66666666669,74.0,68.0,2,140,0.0,74.0,70.0
120123301.0,6,14,2224,9,1204,15015412.625,188.0,133.77777777777777,5,1020,22591253.0,204.0,204.0
205740.0,17,2,180,1,90,0.0,90.0,90.0,1,90,0.0,90.0,90.0
143960.0,17,2,180,1,90,0.0,90.0,90.0,1,90,0.0,90.0,90.0
23294.0,6,10,2032,5,524,4879.5,252.0,104.8,5,1508,5113.75,1236.0,301.6
298111.0,6,6,412,4,272,99370.33333333331,74.0,68.0,2,140,0.0,74.0,70.0
130207.0,6,3,337,2,214,0.0,160.0,107.0,1,123,0.0,123.0,123.0
44947.0,6,14,4740,7,653,6664.166666666667,249.0,93.28571428571428,7,4087,7019.0,1514.0,583.8571428571429
336.0,17,2,174,1,79,0.0,79.0,79.0,1,95,0.0,95.0,95.0
112966089.0,6,48,3168,24,1584,4911569.0869565215,66.0,66.0,24,1584,4902181.782608695,66.0,66.0
246377.0,6,3,373,2,238,0.0,172.0,119.0,1,135,0.0,135.0,135.0
120027.0,17,2,180,1,70,0.0,70.0,70.0,1,110,0.0,110.0,110.0
108373950.0,6,31,2166,16,1149,7210550.666666667,123.0,71.8125,15,1017,7725588.928571428,123.0,67.8
145001.0,17,2,180,1,70,0.0,70.0,70.0,1,110,0.0,110.0,110.0
120397688.0,6,223,25262,112,17640,1084663.855855856,284.0,157.5,111,7622,1085075.472727273,140.0,68.66666666666667
123656424.0,17,14,1126,7,563,17333533.666666668,174.0,80.42857142857143,7,563,17479346.0,174.0,80.42857142857143
31417.0,6,14,4740,7,653,5102.333333333333,249.0,93.28571428571428,7,4087,4699.833333333333,1514.0,583.8571428571429
122239.0,6,3,373,2,238,0.0,172.0,119.0,1,135,0.0,135.0,135.0
148024.0,6,3,337,2,214,0.0,160.0,107.0,1,123,0.0,123.0,123.0
1288573.0,6,4,264,2,132,0.0,66.0,66.0,2,132,0.0,66.0,66.0
51687.0,6,10,1066,5,490,9696.75,218.0,98.0,5,576,12631.0,304.0,115.2
2635957.0,6,3,1777,2,951,0.0,885.0,475.5,1,826,0.0,826.0,826.0
3004420.0,6,12,2172,7,664,500673.1666666667,252.0,94.85714285714286,5,1508,1800.25,1236.0,301.6
101301300.0,17,14,1126,7,563,16834323.833333332,174.0,80.42857142857143,7,563,16833483.333333332,174.0,80.42857142857143
143821.0,17,2,180,1,90,0.0,90.0,90.0,1,90,0.0,90.0,90.0
143851.0,17,2,180,1,90,0.0,90.0,90.0,1,90,0.0,90.0,90.0
14445.0,6,14,4740,7,653,2241.0,249.0,93.28571428571428,7,4087,2275.833333333333,1514.0,583.8571428571429
108106032.0,17,5,1005,5,1005,27026508.0,201.0,201.0,0,0,0.0,0.0,0.0
129820747.0,6,34,2350,17,1125,7489719.875,123.0,66.17647058823529,17,1225,7888472.0,139.0,72.05882352941177
90092375.0,17,28,13364,28,13364,3336754.6296296297,501.0,477.2857142857143,0,0,0.0,0.0,0.0
37319.0,6,14,4740,7,653,6098.833333333333,249.0,93.28571428571428,7,4087,6084.166666666667,1514.0,583.8571428571429
108118444.0,17,5,1005,5,1005,27029611.0,201.0,201.0,0,0,0.0,0.0,0.0
90019993.0,17,28,13364,28,13364,3334073.814814815,501.0,477.2857142857143,0,0,0.0,0.0,0.0
47610347.0,6,8,1940,3,887,22420864.0,753.0,295.6666666666667,5,1053,11259532.25,785.0,210.6
20234.0,6,11,2098,6,590,3221.8,252.0,98.33333333333331,5,1508,4493.25,1236.0,301.6
112681288.0,6,34,2466,17,1272,7042580.5,123.0,74.82352941176471,17,1194,7029050.5,123.0,70.23529411764706
5623109.0,6,4,270,2,134,0.0,68.0,67.0,2,136,0.0,70.0,68.0
98182361.0,6,26,1762,13,922,8163890.333333333,139.0,70.92307692307692,13,840,8163888.166666667,123.0,64.61538461538461
90015659.0,17,28,13364,28,13364,3333913.296296296,501.0,477.2857142857143,0,0,0.0,0.0,0.0
0.0,17,1,381,1,381,0.0,381.0,381.0,0,0,0.0,0.0,0.0
68725.0,6,14,4740,7,653,11344.833333333334,249.0,93.28571428571428,7,4087,11322.333333333334,1514.0,583.8571428571429
143962.0,17,2,180,1,90,0.0,90.0,90.0,1,90,0.0,90.0,90.0
122688033.0,6,49,3234,25,1650,5112001.375,66.0,66.0,24,1584,5064949.521739131,66.0,66.0
322165.0,17,4,1400,4,1400,107388.33333333331,350.0,350.0,0,0,0.0,0.0,0.0
52599252.0,17,4,360,2,180,0.0,90.0,90.0,2,180,0.0,90.0,90.0
90029741.0,17,28,13364,28,13364,3334434.851851852,501.0,477.2857142857143,0,0,0.0,0.0,0.0
726.0,17,4,438,2,148,0.0,74.0,74.0,2,290,0.0,147.0,145.0
50784.0,6,14,4740,7,653,8182.833333333333,249.0,93.28571428571428,7,4087,7579.666666666667,1514.0,583.8571428571429
210117.0,6,10,1221,6,636,42023.4,298.0,106.0,4,585,68688.0,379.0,146.25
111300682.0,6,32,2236,16,1165,7405652.733333333,139.0,72.8125,16,1071,7405655.733333333,123.0,66.9375
814.0,17,5,550,5,550,203.5,110.0,110.0,0,0,0.0,0.0,0.0
90276940.0,6,14,1043,7,542,15046156.666666666,95.0,77.42857142857143,7,501,14997309.0,95.0,71.57142857142857
2453348.0,6,3,1604,1,753,0.0,753.0,753.0,2,851,0.0,785.0,425.5
120120635.0,6,16,2494,9,1204,15015079.375,188.0,133.77777777777777,7,1290,15020756.0,204.0,184.28571428571428
36445.0,6,10,2032,5,524,8879.5,252.0,104.8,5,1508,8779.75,1236.0,301.6
148015.0,17,2,180,1,90,0.0,90.0,90.0,1,90,0.0,90.0,90.0
37671.0,6,14,4740,7,653,5055.666666666667,249.0,93.28571428571428,7,4087,5726.666666666667,1514.0,583.8571428571429
90258191.0,6,13,2036,8,1016,12894027.285714284,188.0,127.0,5,1020,22523534.0,204.0,204.0
120052935.0,17,29,13785,29,13785,4287604.821428572,501.0,475.3448275862069,0,0,0.0,0.0,0.0
40773.0,6,14,4740,7,653,6482.833333333333,249.0,93.28571428571428,7,4087,6190.5,1514.0,583.8571428571429
15322.0,6,14,4740,7,653,2275.833333333333,249.0,93.28571428571428,7,4087,2414.5,1514.0,583.8571428571429
309462.0,6,6,412,4,272,103154.0,74.0,68.0,2,140,0.0,74.0,70.0
704.0,17,4,438,2,148,0.0,74.0,74.0,2,290,0.0,147.0,145.0
547.0,17,2,174,1,79,0.0,79.0,79.0,1,95,0.0,95.0,95.0
205803.0,6,3,426,2,280,0.0,214.0,140.0,1,146,0.0,146.0,146.0
112980104.0,6,45,2970,23,1518,5135459.2727272725,66.0,66.0,22,1452,5120511.285714285,66.0,66.0
90039857.0,17,27,12943,27,12943,3463071.423076923,501.0,479.3703703703704,0,0,0.0,0.0,0.0
238035.0,6,10,1221,6,636,47607.0,298.0,106.0,4,585,78248.66666666667,379.0,146.25
68693.0,6,10,2032,5,524,16957.75,252.0,104.8,5,1508,16407.25,1236.0,301.6
299005.0,6,6,412,4,272,99668.33333333331,74.0,68.0,2,140,0.0,74.0,70.0
1306783.0,6,4,264,2,132,0.0,66.0,66.0,2,132,0.0,66.0,66.0
142425.0,6,2,132,1,66,0.0,66.0,66.0,1,66,0.0,66.0,66.0
164989.0,17,4,1400,4,1400,54996.333333333336,350.0,350.0,0,0,0.0,0.0,0.0
50435.0,6,14,4740,7,653,8230.166666666666,249.0,93.28571428571428,7,4087,8228.166666666666,1514.0,583.8571428571429
375.0,17,2,160,1,80,0.0,80.0,80.0,1,80,0.0,80.0,80.0
340266.0,6,2,132,1,66,0.0,66.0,66.0,1,66,0.0,66.0,66.0
207488.0,6,3,426,2,280,0.0,214.0,140.0,1,146,0.0,146.0,146.0
153471.0,17,2,180,1,90,0.0,90.0,90.0,1,90,0.0,90.0,90.0
135132574.0,17,6,1206,6,1206,27026514.8,201.0,201.0,0,0,0.0,0.0,0.0
257310.0,6,3,373,2,238,0.0,172.0,119.0,1,135,0.0,135.0,135.0
223485.0,6,3,426,2,280,0.0,214.0,140.0,1,146,0.0,146.0,146.0
12859.0,17,4,823,2,163,0.0,89.0,81.5,2,660,0.0,443.0,330.0
35654.0,6,14,4740,7,653,5833.166666666667,249.0,93.28571428571428,7,4087,5755.166666666667,1514.0,583.8571428571429
197085.0,17,2,180,1,90,0.0,90.0,90.0,1,90,0.0,90.0,90.0
1330278.0,6,4,276,2,128,0.0,74.0,64.0,2,148,0.0,74.0,74.0
31411.0,6,10,1065,5,534,6736.5,262.0,106.8,5,531,7107.5,259.0,106.2
13807.0,6,12,1393,6,796,2615.4,271.0,132.66666666666666,6,597,2426.4,259.0,99.5
0.0,6,1,172,1,172,0.0,172.0,172.0,0,0,0.0,0.0,0.0
9942.0,6,10,1975,5,467,2276.75,195.0,93.4,5,1508,1836.25,1236.0,301.6
24500175.0,17,4,1376,3,1026,1250967.5,342.0,342.0,1,350,0.0,350.0,350.0
120044169.0,6,22,1639,12,894,10908162.818181818,95.0,74.5,10,745,13332561.888888888,95.0,74.5
34354219.0,6,26,7627,14,3735,196749.7692307692,1514.0,266.7857142857143,12,3892,3104504.090909091,1514.0,324.3333333333333
23050049.0,17,3,1034,2,684,0.0,342.0,342.0,1,350,0.0,350.0,350.0
90257331.0,6,14,1964,8,1016,12893904.42857143,188.0,127.0,6,948,18017246.0,204.0,158.0
164642.0,6,10,1102,5,570,40872.5,298.0,114.0,5,532,40814.0,260.0,106.4
1011.0,17,4,820,2,156,0.0,78.0,78.0,2,664,0.0,332.0,332.0
37470.0,6,14,4740,7,653,5258.333333333333,249.0,93.28571428571428,7,4087,5273.5,1514.0,583.8571428571429
205222.0,17,2,762,2,762,0.0,381.0,381.0,0,0,0.0,0.0,0.0
302764.0,17,4,1400,4,1400,100921.33333333331,350.0,350.0,0,0,0.0,0.0,0.0
317173.0,17,4,1400,4,1400,105724.33333333331,350.0,350.0,0,0,0.0,0.0,0.0
90064289.0,17,28,13364,28,13364,3335714.407407407,501.0,477.2857142857143,0,0,0.0,0.0,0.0
811.0,17,4,438,2,148,0.0,74.0,74.0,2,290,0.0,147.0,145.0
2363.0,17,4,344,2,150,0.0,75.0,75.0,2,194,0.0,103.0,97.0
3299613.0,6,3,1777,1,826,0.0,826.0,826.0,2,951,0.0,885.0,475.5
246389.0,6,3,337,2,214,0.0,160.0,107.0,1,123,0.0,123.0,123.0
206894.0,6,3,426,2,280,0.0,214.0,140.0,1,146,0.0,146.0,146.0
340.0,17,2,174,1,79,0.0,79.0,79.0,1,95,0.0,95.0,95.0
211239.0,6,3,426,2,280,0.0,214.0,140.0,1,146,0.0,146.0,146.0
333310.0,17,4,704,2,148,0.0,74.0,74.0,2,556,0.0,280.0,278.0
50099.0,6,14,4740,7,653,8218.833333333334,249.0,93.28571428571428,7,4087,7823.333333333333,1514.0,583.8571428571429
16573.0,6,14,4740,7,653,2478.1666666666665,249.0,93.28571428571428,7,4087,2512.1666666666665,1514.0,583.8571428571429
55314.0,6,14,4740,7,653,9086.5,249.0,93.28571428571428,7,4087,7631.666666666667,1514.0,583.8571428571429
43254.0,6,14,4740,7,653,6560.833333333333,249.0,93.28571428571428,7,4087,5982.166666666667,1514.0,583.8571428571429
90221108.0,6,16,1192,8,596,12852990.57142857,95.0,74.5,8,596,12857946.42857143,95.0,74.5
2413.0,17,4,344,2,150,0.0,75.0,75.0,2,194,0.0,103.0,97.0
9704.0,17,4,823,2,163,0.0,89.0,81.5,2,660,0.0,443.0,330.0
205196.0,17,2,762,2,762,0.0,381.0,381.0,0,0,0.0,0.0,0.0
100757.0,17,2,286,2,286,0.0,143.0,143.0,0,0,0.0,0.0,0.0
89217130.0,17,14,4788,14,4788,6862856.153846154,342.0,342.0,0,0,0.0,0.0,0.0
508126.0,6,3,1604,1,753,0.0,753.0,753.0,2,851,0.0,785.0,425.5
19236.0,6,14,4740,7,653,2919.5,249.0,93.28571428571428,7,4087,3023.333333333333,1514.0,583.8571428571429
2294.0,17,4,344,2,150,0.0,75.0,75.0,2,194,0.0,103.0,97.0
57244.0,6,14,4740,7,653,9216.333333333334,249.0,93.28571428571428,7,4087,7828.833333333333,1514.0,583.8571428571429
120120701.0,6,15,2444,7,1428,20020116.83333333,204.0,204.0,8,1016,17097324.57142857,188.0,127.0
37896.0,6,14,4740,7,653,6186.5,249.0,93.28571428571428,7,4087,6084.5,1514.0,583.8571428571429
100163075.0,6,199,22560,100,6822,1011748.2323232325,140.0,68.22,99,15738,1011553.4897959183,284.0,158.96969696969697
228300.0,17,2,180,1,90,0.0,90.0,90.0,1,90,0.0,90.0,90.0
81231.0,6,14,4740,7,653,12365.166666666666,249.0,93.28571428571428,7,4087,12881.666666666666,1514.0,583.8571428571429
2803811.0,6,2,132,1,66,0.0,66.0,66.0,1,66,0.0,66.0,66.0
28226.0,6,19,7540,10,912,3052.0,310.0,91.2,9,6628,3356.25,1514.0,736.4444444444445
108100498.0,17,5,1005,5,1005,27025124.5,201.0,201.0,0,0,0.0,0.0,0.0
303869.0,6,6,412,4,272,101289.66666666669,74.0,68.0,2,140,0.0,74.0,70.0
106402.0,17,2,700,2,700,0.0,350.0,350.0,0,0,0.0,0.0,0.0
103149.0,17,2,286,2,286,0.0,143.0,143.0,0,0,0.0,0.0,0.0
479.0,17,2,508,2,508,0.0,257.0,254.0,0,0,0.0,0.0,0.0
15609.0,6,10,1810,5,358,3665.25,130.0,71.6,5,1452,3656.5,1224.0,290.4
385973.0,6,3,204,2,136,0.0,70.0,68.0,1,68,0.0,68.0,68.0
4303747.0,6,45,15815,26,10939,172149.88,1514.0,420.7307692307692,19,4876,224729.38888888888,1514.0,256.63157894736844
14460602.0,17,6,2052,6,2052,2892120.4,342.0,342.0,0,0,0.0,0.0,0.0
247362.0,6,10,1221,6,636,49472.4,298.0,106.0,4,585,76883.66666666667,379.0,146.25
108104540.0,17,5,955,5,955,27026135.0,191.0,191.0,0,0,0.0,0.0,0.0
0.0,6,1,66,0,0,0.0,0.0,0.0,1,66,0.0,66.0,66.0
22415.0,6,11,1133,6,602,3781.2,264.0,100.33333333333331,5,531,4008.75,259.0,106.2
30510.0,6,14,4740,7,653,4381.0,249.0,93.28571428571428,7,4087,4498.5,1514.0,583.8571428571429
53758.0,6,14,4740,7,653,8562.0,249.0,93.28571428571428,7,4087,8819.5,1514.0,583.8571428571429
120185314.0,6,450,55788,225,15146,533887.9241071428,140.0,67.31555555555556,225,40642,532837.8928571428,480.0,180.63111111111112
196375.0,17,4,1524,4,1524,65458.333333333336,381.0,381.0,0,0,0.0,0.0,0.0
28643.0,6,14,4740,7,653,3743.5,249.0,93.28571428571428,7,4087,4636.5,1514.0,583.8571428571429
10488237.0,6,6,412,3,206,5175482.5,74.0,68.66666666666667,3,206,5175396.0,74.0,68.66666666666667
114117377.0,6,35,2526,18,1332,6712786.882352941,123.0,74.0,17,1194,7118810.4375,123.0,70.23529411764706
2590799.0,6,2,132,1,66,0.0,66.0,66.0,1,66,0.0,66.0,66.0
39263.0,6,10,2032,5,524,9479.5,252.0,104.8,5,1508,9567.75,1236.0,301.6
228187.0,17,2,180,1,90,0.0,90.0,90.0,1,90,0.0,90.0,90.0
76303.0,6,14,4740,7,653,10583.166666666666,249.0,93.28571428571428,7,4087,11520.333333333334,1514.0,583.8571428571429
43435.0,6,14,4740,7,653,5166.666666666667,249.0,93.28571428571428,7,4087,7001.666666666667,1514.0,583.8571428571429
130801.0,6,3,337,2,214,0.0,160.0,107.0,1,123,0.0,123.0,123.0
2636.0,17,4,344,2,150,0.0,75.0,75.0,2,194,0.0,103.0,97.0
116744021.0,17,18,1560,9,780,14593002.625,174.0,86.66666666666667,9,780,14525232.125,174.0,86.66666666666667
114283458.0,6,48,3168,24,1584,4968846.0,66.0,66.0,24,1584,4956836.0,66.0,66.0
41192.0,6,10,2032,5,524,8965.25,252.0,104.8,5,1508,10013.75,1236.0,301.6
66032.0,17,2,180,1,90,0.0,90.0,90.0,1,90,0.0,90.0,90.0
0.0,17,1,438,1,438,0.0,438.0,438.0,0,0,0.0,0.0,0.0
120121974.0,6,14,2240,6,1224,24024394.8,204.0,204.0,8,1016,17136688.714285713,188.0,127.0
29314.0,6,13,1459,7,862,4593.833333333333,271.0,123.14285714285714,6,597,2705.4,259.0,99.5
58153.0,6,14,4740,7,653,9244.166666666666,249.0,93.28571428571428,7,4087,8858.333333333334,1514.0,583.8571428571429
228377.0,17,2,180,1,90,0.0,90.0,90.0,1,90,0.0,90.0,90.0
40755.0,6,14,4740,7,653,6638.166666666667,249.0,93.28571428571428,7,4087,6313.333333333333,1514.0,583.8571428571429
153480.0,17,2,180,1,90,0.0,90.0,90.0,1,90,0.0,90.0,90.0
863577.0,6,9,1269,6,798,172715.4,460.0,133.0,3,471,294033.0,331.0,157.0
307186.0,6,6,412,4,272,102395.33333333331,74.0,68.0,2,140,0.0,74.0,70.0
306335.0,6,6,412,4,272,102111.66666666669,74.0,68.0,2,140,0.0,74.0,70.0
3480.0,17,4,344,2,150,0.0,75.0,75.0,2,194,0.0,103.0,97.0
36519.0,6,14,4740,7,653,5880.333333333333,249.0,93.28571428571428,7,4087,5493.333333333333,1514.0,583.8571428571429
121226.0,6,3,337,2,214,0.0,160.0,107.0,1,123,0.0,123.0,123.0
135137405.0,17,6,1206,6,1206,27027481.0,201.0,201.0,0,0,0.0,0.0,0.0
28746.0,6,12,1320,7,789,4791.0,253.0,112.71428571428572,5,531,6282.75,259.0,106.2
318.0,17,2,174,1,79,0.0,79.0,79.0,1,95,0.0,95.0,95.0
205876.0,6,3,426,2,280,0.0,214.0,140.0,1,146,0.0,146.0,146.0
8517441.0,17,3,1034,2,684,0.0,342.0,342.0,1,350,0.0,350.0,350.0
206845.0,6,3,426,2,280,0.0,214.0,140.0,1,146,0.0,146.0,146.0
45301.0,6,14,4740,7,653,7166.5,249.0,93.28571428571428,7,4087,7327.166666666667,1514.0,583.8571428571429
228207.0,17,2,180,1,90,0.0,90.0,90.0,1,90,0.0,90.0,90.0
53644.0,6,14,4740,7,653,8819.166666666666,249.0,93.28571428571428,7,4087,8754.5,1514.0,583.8571428571429
298409.0,6,6,412,4,272,99469.66666666669,74.0,68.0,2,140,0.0,74.0,70.0
414092.0,6,3,1604,2,851,0.0,785.0,425.5,1,753,0.0,753.0,753.0
24688665.0,17,5,1718,4,1368,982277.6666666666,342.0,342.0,1,350,0.0,350.0,350.0
90039861.0,17,28,13364,28,13364,3334809.6666666665,501.0,477.2857142857143,0,0,0.0,0.0,0.0
90755934.0,6,19,1436,10,745,10079483.333333334,95.0,74.5,9,691,11343490.5,95.0,76.77777777777777
123839632.0,6,48,3168,24,1584,5092365.391304348,66.0,66.0,24,1584,5209599.043478261,66.0,66.0
2876.0,17,4,344,2,150,0.0,75.0,75.0,2,194,0.0,103.0,97.0
176902.0,17,2,414,1,88,0.0,88.0,88.0,1,326,0.0,326.0,326.0
233756.0,17,4,1400,4,1400,77918.66666666667,350.0,350.0,0,0,0.0,0.0,0.0
391.0,17,2,267,1,83,0.0,83.0,83.0,1,184,0.0,184.0,184.0
5619697.0,6,5,336,2,134,0.0,68.0,67.0,3,202,1421506.5,70.0,67.33333333333333
247865.0,17,4,6056,4,6056,82621.66666666667,1514.0,1514.0,0,0,0.0,0.0,0.0
1468.0,6,2,177,1,123,0.0,123.0,123.0,1,54,0.0,54.0,54.0
103099056.0,17,14,1126,7,563,17156347.833333332,174.0,80.42857142857143,7,563,17156347.833333332,174.0,80.42857142857143
305971.0,6,6,412,4,272,101990.33333333331,74.0,68.0,2,140,0.0,74.0,70.0
575054.0,6,3,198,2,132,0.0,66.0,66.0,1,66,0.0,66.0,66.0
119537721.0,6,25,1883,14,1084,9191141.692307692,95.0,77.42857142857143,11,799,11949619.4,95.0,72.63636363636364
2356.0,17,4,344,2,150,0.0,75.0,75.0,2,194,0.0,103.0,97.0
112480275.0,6,46,3036,23,1518,5112726.363636363,66.0,66.0,23,1518,5112728.818181818,66.0,66.0
217322.0,17,2,762,2,762,0.0,381.0,381.0,0,0,0.0,0.0,0.0
2021909.0,17,4,525,2,150,0.0,75.0,75.0,2,375,0.0,284.0,187.5
279156.0,17,2,363,1,79,0.0,79.0,79.0,1,284,0.0,284.0,284.0
306613.0,6,13,1386,7,789,51102.16666666666,253.0,112.71428571428572,6,597,55489.2,259.0,99.5
384582.0,6,3,204,2,136,0.0,70.0,68.0,1,68,0.0,68.0,68.0
100699573.0,6,30,3200,14,1546,7746121.0,335.0,110.42857142857144,16,1654,6698794.266666667,427.0,103.375
1058647.0,6,11,1134,6,558,211729.4,220.0,93.0,5,576,258586.0,304.0,115.2
112078.0,17,4,1400,4,1400,37359.333333333336,350.0,350.0,0,0,0.0,0.0,0.0
102561950.0,6,43,2838,22,1452,4883890.523809524,66.0,66.0,21,1386,5111999.05,66.0,66.0
105134.0,17,2,700,2,700,0.0,350.0,350.0,0,0,0.0,0.0,0.0
205602.0,17,2,180,1,90,0.0,90.0,90.0,1,90,0.0,90.0,90.0
1425736.0,17,16,1120,16,1120,95049.06666666668,70.0,70.0,0,0,0.0,0.0,0.0
53217.0,6,14,4740,7,653,8208.666666666666,249.0,93.28571428571428,7,4087,8516.666666666666,1514.0,583.8571428571429
90258894.0,6,14,2240,8,1016,12894127.714285716,188.0,127.0,6,1224,18018645.0,204.0,204.0
120212251.0,6,18,1341,9,691,14999616.25,95.0,76.77777777777777,9,650,14999601.75,95.0,72.22222222222223
286186.0,17,2,363,1,79,0.0,79.0,79.0,1,284,0.0,284.0,284.0
60893.0,6,14,4740,7,653,8780.333333333334,249.0,93.28571428571428,7,4087,9535.0,1514.0,583.8571428571429
606036.0,6,4,508,2,238,0.0,172.0,119.0,2,270,0.0,135.0,135.0
316228.0,17,4,1400,4,1400,105409.33333333331,350.0,350.0,0,0,0.0,0.0,0.0
99493508.0,6,177,19954,89,6096,1130608.0454545454,140.0,68.49438202247191,88,13858,1136670.0,284.0,157.47727272727272
108110555.0,17,5,1005,5,1005,27027638.75,201.0,201.0,0,0,0.0,0.0,0.0
518.0,17,2,410,1,78,0.0,78.0,78.0,1,332,0.0,332.0,332.0
534725.0,6,5,336,2,134,0.0,68.0,67.0,3,202,207401.5,70.0,67.33333333333333
2592657.0,6,2,132,1,66,0.0,66.0,66.0,1,66,0.0,66.0,66.0
1652526.0,6,8,602,3,198,203498.0,66.0,66.0,5,404,389156.0,103.0,80.8
4240.0,17,2,582,1,83,0.0,83.0,83.0,1,499,0.0,499.0,499.0
90494615.0,6,13,1910,8,1016,12912013.714285716,188.0,127.0,5,894,15116693.75,204.0,178.8
146099.0,6,3,337,2,214,0.0,160.0,107.0,1,123,0.0,123.0,123.0
108103761.0,17,5,955,5,955,27025940.25,191.0,191.0,0,0,0.0,0.0,0.0
143971.0,17,2,180,1,90,0.0,90.0,90.0,1,90,0.0,90.0,90.0
32980.0,6,14,4740,7,653,5327.666666666667,249.0,93.28571428571428,7,4087,5065.666666666667,1514.0,583.8571428571429
106781.0,17,2,286,2,286,0.0,143.0,143.0,0,0,0.0,0.0,0.0
92880395.0,6,38,2508,19,1254,5160003.555555556,66.0,66.0,19,1254,5160007.833333333,66.0,66.0
0.0,6,1,66,1,66,0.0,66.0,66.0,0,0,0.0,0.0,0.0
119843326.0,6,16,2510,7,1428,19972771.166666668,204.0,204.0,9,1082,14976933.375,188.0,120.22222222222224
314335.0,6,3,202,2,128,0.0,74.0,64.0,1,74,0.0,74.0,74.0
90050200.0,17,28,13364,28,13364,3335192.592592593,501.0,477.2857142857143,0,0,0.0,0.0,0.0
308694.0,17,2,246,1,76,0.0,76.0,76.0,1,170,0.0,170.0,170.0
110976616.0,6,40,2956,20,1531,5829187.578947368,139.0,76.55,20,1425,5829188.947368421,123.0,71.25
308533.0,6,3,202,2,128,0.0,74.0,64.0,1,74,0.0,74.0,74.0
113033454.0,6,34,2350,17,1225,7051100.0625,139.0,72.05882352941177,17,1125,7051110.75,123.0,66.17647058823529
2418.0,17,4,344,2,150,0.0,75.0,75.0,2,194,0.0,103.0,97.0
135125869.0,17,6,1206,6,1206,27025173.8,201.0,201.0,0,0,0.0,0.0,0.0
351.0,17,2,267,1,83,0.0,83.0,83.0,1,184,0.0,184.0,184.0
135151857.0,17,6,1146,6,1146,27030371.4,191.0,191.0,0,0,0.0,0.0,0.0
94015760.0,6,26,1831,13,909,7834646.666666667,123.0,69.92307692307692,13,922,7816637.25,139.0,70.92307692307692
135135207.0,17,6,1146,6,1146,27027041.4,191.0,191.0,0,0,0.0,0.0,0.0
103753.0,17,2,700,2,700,0.0,350.0,350.0,0,0,0.0,0.0,0.0
52382.0,6,12,1413,6,816,10070.4,291.0,136.0,6,597,9708.4,259.0,99.5
1347.0,17,4,438,2,148,0.0,74.0,74.0,2,290,0.0,147.0,145.0
91433944.0,6,24,1829,13,989,7619243.75,95.0,76.07692307692308,11,840,9142666.2,95.0,76.36363636363636
298168.0,6,6,412,4,272,99389.33333333331,74.0,68.0,2,140,0.0,74.0,70.0
6439.0,17,4,823,2,163,0.0,89.0,81.5,2,660,0.0,443.0,330.0
106122.0,17,2,286,2,286,0.0,143.0,143.0,0,0,0.0,0.0,0.0
37895.0,6,14,4740,7,653,5990.0,249.0,93.28571428571428,7,4087,6073.333333333333,1514.0,583.8571428571429
48901.0,6,14,4740,7,653,7038.5,249.0,93.28571428571428,7,4087,8014.833333333333,1514.0,583.8571428571429
6426.0,17,2,180,1,90,0.0,90.0,90.0,1,90,0.0,90.0,90.0
111093483.0,6,34,2350,17,1225,6943342.6875,139.0,72.05882352941177,17,1125,6929825.4375,123.0,66.17647058823529
514.0,17,2,508,2,508,0.0,257.0,254.0,0,0,0.0,0.0,0.0
206619.0,6,3,426,2,280,0.0,214.0,140.0,1,146,0.0,146.0,146.0
44361.0,6,13,1386,7,789,7393.5,253.0,112.71428571428572,6,597,8127.6,259.0,99.5
51422.0,6,10,2032,5,524,11913.25,252.0,104.8,5,1508,11290.5,1236.0,301.6
90647463.0,6,15,2302,9,1204,11315367.75,188.0,133.77777777777777,6,1098,18097566.8,204.0,183.0
106161714.0,6,42,3468,24,1944,4605886.608695652,123.0,81.0,18,1524,6231495.411764706,123.0,84.66666666666667
3034708.0,6,3,1777,2,951,0.0,885.0,475.5,1,826,0.0,826.0,826.0
121360.0,6,3,337,2,214,0.0,160.0,107.0,1,123,0.0,123.0,123.0
90225788.0,6,16,1192,8,596,12853233.142857144,95.0,74.5,8,596,12858496.857142856,95.0,74.5
92531428.0,17,14,1126,7,563,15333463.666666666,174.0,80.42857142857143,7,563,15334489.5,174.0,80.42857142857143
311.0,17,2,164,1,82,0.0,82.0,82.0,1,82,0.0,82.0,82.0
108690627.0,6,33,2428,17,1288,6793164.1875,139.0,75.76470588235294,16,1140,7231634.2,123.0,71.25
120041234.0,6,18,1341,9,691,14999503.5,95.0,76.77777777777777,9,650,14999514.875,95.0,72.22222222222223
109512.0,6,10,2032,5,524,27154.25,252.0,104.8,5,1508,25779.0,1236.0,301.6
228314.0,17,2,180,1,90,0.0,90.0,90.0,1,90,0.0,90.0,90.0
119832357.0,6,753,100870,377,75832,318703.0771276596,516.0,201.1458885941645,376,25038,318939.392,140.0,66.59042553191489
36817.0,6,14,4740,7,653,5598.0,249.0,93.28571428571428,7,4087,5867.0,1514.0,583.8571428571429
508.0,17,2,410,1,78,0.0,78.0,78.0,1,332,0.0,332.0,332.0
10471394.0,6,7,478,4,272,3445023.0,74.0,68.0,3,206,5167415.5,74.0,68.66666666666667
1453345.0,6,4,276,2,128,0.0,74.0,64.0,2,148,0.0,74.0,74.0
90018068.0,17,28,13364,28,13364,3334002.5185185187,501.0,477.2857142857143,0,0,0.0,0.0,0.0
108104458.0,17,5,1005,5,1005,27026114.5,201.0,201.0,0,0,0.0,0.0,0.0
45589.0,6,12,1413,7,882,7598.166666666667,291.0,126.0,5,531,9427.0,259.0,106.2
34841.0,6,14,4740,7,653,5687.0,249.0,93.28571428571428,7,4087,5605.333333333333,1514.0,583.8571428571429
303652.0,6,2,132,1,66,0.0,66.0,66.0,1,66,0.0,66.0,66.0
118383.0,17,4,1524,4,1524,39461.0,381.0,381.0,0,0,0.0,0.0,0.0
119564461.0,6,8077,7720968,5227,7532276,22869.294489093,1514.0,1441.0323321216758,2850,188692,41951.19375219375,214.0,66.20771929824562
110934981.0,6,34,2350,17,1225,6919955.25,139.0,72.05882352941177,17,1125,6919947.75,123.0,66.17647058823529
120030067.0,17,29,13785,29,13785,4286788.107142857,501.0,475.3448275862069,0,0,0.0,0.0,0.0
719.0,17,4,438,2,148,0.0,74.0,74.0,2,290,0.0,147.0,145.0
146188.0,6,3,337,2,214,0.0,160.0,107.0,1,123,0.0,123.0,123.0
89522.0,6,14,4740,7,653,13639.833333333334,249.0,93.28571428571428,7,4087,14631.833333333334,1514.0,583.8571428571429
113495409.0,6,218,24858,109,17442,1048834.3333333333,464.0,160.0183486238532,109,7416,1048831.0185185184,140.0,68.03669724770643
213700.0,17,2,180,1,90,0.0,90.0,90.0,1,90,0.0,90.0,90.0
113160.0,6,13,1386,7,789,18860.0,253.0,112.71428571428572,6,597,21715.2,259.0,99.5
518994.0,6,3,204,2,136,0.0,70.0,68.0,1,68,0.0,68.0,68.0
13174.0,17,4,344,2,150,0.0,75.0,75.0,2,194,0.0,103.0,97.0
123455742.0,6,49,3234,25,1650,5143989.25,66.0,66.0,24,1584,5048876.913043479,66.0,66.0
442209.0,17,2,363,1,79,0.0,79.0,79.0,1,284,0.0,284.0,284.0
108105335.0,17,5,1005,5,1005,27026333.75,201.0,201.0,0,0,0.0,0.0,0.0
5637000.0,6,5,336,2,134,0.0,68.0,67.0,3,202,1528633.0,70.0,67.33333333333333
55671.0,6,14,4740,7,653,9114.333333333334,249.0,93.28571428571428,7,4087,8667.666666666666,1514.0,583.8571428571429
49642.0,6,10,2032,5,524,11958.0,252.0,104.8,5,1508,8472.5,1236.0,301.6
865834.0,6,9,1269,6,798,173166.8,460.0,133.0,3,471,294674.0,331.0,157.0
90562559.0,6,15,2168,8,1016,12937508.42857143,188.0,127.0,7,1152,15064761.833333334,204.0,164.57142857142858
39124.0,6,14,4740,7,653,6369.333333333333,249.0,93.28571428571428,7,4087,6367.333333333333,1514.0,583.8571428571429
90259953.0,6,14,1964,8,1016,12894279.0,188.0,127.0,6,948,18018683.2,204.0,158.0
38462.0,6,14,4740,7,653,5993.333333333333,249.0,93.28571428571428,7,4087,6105.0,1514.0,583.8571428571429
46181.0,6,14,4740,7,653,7451.833333333333,249.0,93.28571428571428,7,4087,7361.166666666667,1514.0,583.8571428571429
2452.0,17,4,344,2,150,0.0,75.0,75.0,2,194,0.0,103.0,97.0
302302.0,6,6,412,4,272,100767.33333333331,74.0,68.0,2,140,0.0,74.0,70.0
320707.0,6,6,412,4,272,106902.33333333331,74.0,68.0,2,140,0.0,74.0,70.0
372.0,17,2,160,1,80,0.0,80.0,80.0,1,80,0.0,80.0,80.0
114269416.0,6,42,3346,23,1837,5184250.5,139.0,79.8695652173913,19,1509,6336308.277777778,123.0,79.42105263157895
53154.0,6,14,4740,7,653,8731.833333333334,249.0,93.28571428571428,7,4087,7748.333333333333,1514.0,583.8571428571429
120286124.0,6,212,23980,106,7292,1138761.419047619,140.0,68.79245283018868,106,16688,1137686.3714285714,284.0,157.43396226415095
185169.0,17,4,1400,4,1400,61723.0,350.0,350.0,0,0,0.0,0.0,0.0
134909.0,6,2,132,1,66,0.0,66.0,66.0,1,66,0.0,66.0,66.0
130174.0,6,3,337,2,214,0.0,160.0,107.0,1,123,0.0,123.0,123.0
146146.0,6,3,337,2,214,0.0,160.0,107.0,1,123,0.0,123.0,123.0
90282132.0,6,20,1490,11,840,9024168.4,95.0,76.36363636363636,9,650,11285002.0,95.0,72.22222222222223
90530958.0,6,13,2036,8,1016,12932994.0,188.0,127.0,5,1020,22591525.75,204.0,204.0
44112.0,6,14,4740,7,653,7225.666666666667,249.0,93.28571428571428,7,4087,7182.333333333333,1514.0,583.8571428571429
209505.0,17,2,180,1,90,0.0,90.0,90.0,1,90,0.0,90.0,90.0
12349.0,6,2,177,1,123,0.0,123.0,123.0,1,54,0.0,54.0,54.0
2444.0,17,4,344,2,150,0.0,75.0,75.0,2,194,0.0,103.0,97.0
37828676.0,6,5,336,2,134,0.0,68.0,67.0,3,202,17515225.5,70.0,67.33333333333333
2865.0,17,2,224,1,76,0.0,76.0,76.0,1,148,0.0,148.0,148.0
223114.0,6,3,426,2,280,0.0,214.0,140.0,1,146,0.0,146.0,146.0
24289.0,6,20,7606,11,978,2428.9,310.0,88.9090909090909,9,6628,2515.125,1514.0,736.4444444444445
37580.0,6,14,4740,7,653,6095.5,249.0,93.28571428571428,7,4087,5326.5,1514.0,583.8571428571429
55871.0,6,12,1413,7,882,9311.833333333334,291.0,126.0,5,531,10211.75,259.0,106.2
446161.0,17,2,363,1,79,0.0,79.0,79.0,1,284,0.0,284.0,284.0
106807.0,17,2,286,2,286,0.0,143.0,143.0,0,0,0.0,0.0,0.0
56666.0,6,14,4740,7,653,9321.333333333334,249.0,93.28571428571428,7,4087,7778.833333333333,1514.0,583.8571428571429
90059188.0,17,28,13364,28,13364,3335525.4814814813,501.0,477.2857142857143,0,0,0.0,0.0,0.0
41739.0,6,11,1131,6,600,8262.2,262.0,100.0,5,531,2475.25,259.0,106.2
2382.0,17,4,344,2,150,0.0,75.0,75.0,2,194,0.0,103.0,97.0
196693.0,17,2,180,1,90,0.0,90.0,90.0,1,90,0.0,90.0,90.0
27858.0,6,14,4740,7,653,4521.833333333333,249.0,93.28571428571428,7,4087,4163.5,1514.0,583.8571428571429
10426.0,6,10,1067,5,536,2359.75,264.0,107.2,5,531,2152.75,259.0,106.2
216486.0,17,2,180,1,90,0.0,90.0,90.0,1,90,0.0,90.0,90.0
2800409.0,6,2,132,1,66,0.0,66.0,66.0,1,66,0.0,66.0,66.0
1306978.0,6,4,264,2,132,0.0,66.0,66.0,2,132,0.0,66.0,66.0
314127.0,6,3,1604,2,851,0.0,785.0,425.5,1,753,0.0,753.0,753.0
2330.0,17,4,344,2,150,0.0,75.0,75.0,2,194,0.0,103.0,97.0
243775.0,6,3,337,2,214,0.0,160.0,107.0,1,123,0.0,123.0,123.0
108104952.0,17,5,955,5,955,27026238.0,191.0,191.0,0,0,0.0,0.0,0.0
122975107.0,6,48,3168,24,1584,5034373.217391305,66.0,66.0,24,1584,5232708.217391305,66.0,66.0
1553.0,17,5,550,5,550,388.25,110.0,110.0,0,0,0.0,0.0,0.0
2043817.0,6,26,12030,14,4295,157216.6923076923,1510.0,306.7857142857143,12,7735,157948.45454545456,1510.0,644.5833333333334
101044800.0,17,14,864,7,432,16833529.166666668,174.0,61.71428571428572,7,432,16834349.666666668,174.0,61.71428571428572
90749491.0,6,22,1680,12,935,8245278.636363637,95.0,77.91666666666667,10,745,10003462.111111112,95.0,74.5
145278.0,6,3,373,2,238,0.0,172.0,119.0,1,135,0.0,135.0,135.0
90019998.0,17,28,13364,28,13364,3334074.0,501.0,477.2857142857143,0,0,0.0,0.0,0.0
108109137.0,17,5,955,5,955,27027284.25,191.0,191.0,0,0,0.0,0.0,0.0
300116.0,6,10,1221,6,636,60023.2,298.0,106.0,4,585,99133.66666666669,379.0,146.25
204668.0,17,2,762,2,762,0.0,381.0,381.0,0,0,0.0,0.0,0.0
92169633.0,17,12,778,6,389,18400347.0,174.0,64.83333333333333,6,389,18400160.6,174.0,64.83333333333333
207088.0,6,3,426,2,280,0.0,214.0,140.0,1,146,0.0,146.0,146.0
120000040.0,6,17,1287,9,691,15000005.0,95.0,76.77777777777777,8,596,17104994.14285714,95.0,74.5
209524.0,17,2,180,1,90,0.0,90.0,90.0,1,90,0.0,90.0,90.0
307490.0,6,6,412,4,272,102496.66666666669,74.0,68.0,2,140,0.0,74.0,70.0
113133448.0,17,16,1212,8,606,16144118.142857144,174.0,75.75,8,606,16143067.0,174.0,75.75
2022399.0,17,4,525,2,150,0.0,75.0,75.0,2,375,0.0,284.0,187.5
551896.0,6,2,132,1,66,0.0,66.0,66.0,1,66,0.0,66.0,66.0
218238.0,17,2,180,1,90,0.0,90.0,90.0,1,90,0.0,90.0,90.0
135130075.0,17,6,1146,6,1146,27026015.0,191.0,191.0,0,0,0.0,0.0,0.0
253128.00000000003,6,3,373,2,238,0.0,172.0,119.0,1,135,0.0,135.0,135.0
293273.0,17,2,363,1,79,0.0,79.0,79.0,1,284,0.0,284.0,284.0
3004325.0,6,11,2106,6,598,600675.4,252.0,99.66666666666669,5,1508,1786.25,1236.0,301.6
25216.0,6,10,2032,5,524,4861.5,252.0,104.8,5,1508,5658.75,1236.0,301.6
135132607.0,17,6,1146,6,1146,27026521.4,191.0,191.0,0,0,0.0,0.0,0.0
37853.0,6,14,4740,7,653,6139.833333333333,249.0,93.28571428571428,7,4087,5594.0,1514.0,583.8571428571429
117112355.0,6,48,3168,24,1584,5091841.521739131,66.0,66.0,24,1584,5078757.173913044,66.0,66.0
38211.0,6,14,4740,7,653,5643.666666666667,249.0,93.28571428571428,7,4087,6230.833333333333,1514.0,583.8571428571429
61274.0,6,14,4740,7,653,10081.0,249.0,93.28571428571428,7,4087,10071.166666666666,1514.0,583.8571428571429
298450.0,6,6,412,4,272,99483.33333333331,74.0,68.0,2,140,0.0,74.0,70.0
2776677.0,6,2,132,1,66,0.0,66.0,66.0,1,66,0.0,66.0,66.0
146152.0,6,3,337,2,214,0.0,160.0,107.0,1,123,0.0,123.0,123.0
34858.0,6,14,4740,7,653,5615.5,249.0,93.28571428571428,7,4087,5216.166666666667,1514.0,583.8571428571429
108103552.0,17,5,1005,5,1005,27025888.0,201.0,201.0,0,0,0.0,0.0,0.0
29470.0,6,14,4740,7,653,4734.166666666667,249.0,93.28571428571428,7,4087,4457.0,1514.0,583.8571428571429
26912195.0,17,5,1718,4,1368,947015.3333333334,342.0,342.0,1,350,0.0,350.0,350.0
2913237.0,6,2,132,1,66,0.0,66.0,66.0,1,66,0.0,66.0,66.0
90095613.0,6,11,1644,4,816,30031108.0,204.0,204.0,7,828,15015560.666666666,188.0,118.28571428571428
106869844.0,6,206,23330,103,7020,1039804.1568627452,140.0,68.15533980582525,103,16310,1039664.1862745098,284.0,158.3495145631068
213626.0,17,2,180,1,90,0.0,90.0,90.0,1,90,0.0,90.0,90.0
306866.0,6,6,412,4,272,102288.66666666669,74.0,68.0,2,140,0.0,74.0,70.0
306992.0,6,6,412,4,272,102330.66666666669,74.0,68.0,2,140,0.0,74.0,70.0
317422.0,17,4,1400,4,1400,105807.33333333331,350.0,350.0,0,0,0.0,0.0,0.0
2988747.0,6,2,132,1,66,0.0,66.0,66.0,1,66,0.0,66.0,66.0
113168395.0,6,46,3036,23,1518,5144005.681818182,66.0,66.0,23,1518,5144006.681818182,66.0,66.0
42494.0,6,10,2032,5,524,9862.0,252.0,104.8,5,1508,10427.75,1236.0,301.6
90529735.0,6,15,2444,8,1016,12932819.285714284,188.0,127.0,7,1428,15061211.333333334,204.0,204.0
153506.0,17,2,180,1,90,0.0,90.0,90.0,1,90,0.0,90.0,90.0
2596909.0,6,2,132,1,66,0.0,66.0,66.0,1,66,0.0,66.0,66.0
3012141.0,6,3,1604,1,753,0.0,753.0,753.0,2,851,0.0,785.0,425.5
1149070.0,6,13,3010,8,2382,164152.85714285713,1514.0,297.75,5,628,219087.0,331.0,125.6
120004054.0,17,29,13785,29,13785,4285859.071428572,501.0,475.3448275862069,0,0,0.0,0.0,0.0
32563.0,6,10,2032,5,524,7926.5,252.0,104.8,5,1508,7905.0,1236.0,301.6
190918.0,17,2,180,1,90,0.0,90.0,90.0,1,90,0.0,90.0,90.0
99579755.0,6,69,13114,34,6831,3017568.333333333,1514.0,200.91176470588235,35,6283,2921266.0588235296,1514.0,179.5142857142857
32559.0,6,14,4740,7,653,4419.166666666667,249.0,93.28571428571428,7,4087,5216.0,1514.0,583.8571428571429
304872.0,6,10,1221,6,636,60974.4,298.0,106.0,4,585,95234.0,379.0,146.25
298028.0,6,6,412,4,272,99342.66666666669,74.0,68.0,2,140,0.0,74.0,70.0
34014.0,6,14,4740,7,653,5546.833333333333,249.0,93.28571428571428,7,4087,5494.833333333333,1514.0,583.8571428571429
63901.0,6,14,4740,7,653,10308.166666666666,249.0,93.28571428571428,7,4087,8617.333333333334,1514.0,583.8571428571429
135131957.0,17,6,1206,6,1206,27026391.4,201.0,201.0,0,0,0.0,0.0,0.0
52978.0,6,14,4740,7,653,8653.166666666666,249.0,93.28571428571428,7,4087,8170.5,1514.0,583.8571428571429
1067851.0,6,3,204,1,68,0.0,68.0,68.0,2,136,0.0,70.0,68.0
308483.0,6,6,412,4,272,102827.66666666669,74.0,68.0,2,140,0.0,74.0,70.0
238294.0,6,3,337,2,214,0.0,160.0,107.0,1,123,0.0,123.0,123.0
63373.0,6,14,4740,7,653,10403.833333333334,249.0,93.28571428571428,7,4087,8474.0,1514.0,583.8571428571429
90256951.0,6,13,2036,8,1016,12893850.142857144,188.0,127.0,5,1020,22523165.75,204.0,204.0
148369.0,17,2,414,1,88,0.0,88.0,88.0,1,326,0.0,326.0,326.0
119829500.0,17,35,16705,35,16705,3524397.0588235296,501.0,477.2857142857143,0,0,0.0,0.0,0.0
13647109.0,6,20,1607,10,975,1479093.7777777778,315.0,97.5,10,632,1480089.888888889,78.0,63.2
116997520.0,6,30,1974,15,1026,8341544.0,123.0,68.4,15,948,8341546.071428572,123.0,63.2
113950897.0,6,48,3168,24,1584,4954386.826086956,66.0,66.0,24,1584,4940928.521739131,66.0,66.0
120002545.0,6,26,2989,13,1408,9999996.25,424.0,108.3076923076923,13,1581,9999774.0,362.0,121.6153846153846
302279.0,6,6,412,4,272,100759.66666666669,74.0,68.0,2,140,0.0,74.0,70.0
90261077.0,6,12,1832,8,1016,12894439.57142857,188.0,127.0,4,816,30030483.666666668,204.0,204.0
99788.0,17,2,762,2,762,0.0,381.0,381.0,0,0,0.0,0.0,0.0
1291419.0,6,4,492,2,280,0.0,214.0,140.0,2,212,0.0,146.0,106.0
302811.0,6,6,412,4,272,100937.0,74.0,68.0,2,140,0.0,74.0,70.0
56827.0,6,14,4740,7,653,9288.0,249.0,93.28571428571428,7,4087,9209.333333333334,1514.0,583.8571428571429
90283677.0,6,16,1192,8,596,12891092.857142856,95.0,74.5,8,596,12896728.142857144,95.0,74.5
90036721.0,17,28,13364,28,13364,3334693.3703703703,501.0,477.2857142857143,0,0,0.0,0.0,0.0
108441.0,17,2,286,2,286,0.0,143.0,143.0,0,0,0.0,0.0,0.0
80789.0,6,14,4740,7,653,11768.666666666666,249.0,93.28571428571428,7,4087,13260.666666666666,1514.0,583.8571428571429
99204266.0,17,14,1126,7,563,16500132.833333334,174.0,80.42857142857143,7,563,16501085.5,174.0,80.42857142857143
205922.0,6,3,426,2,280,0.0,214.0,140.0,1,146,0.0,146.0,146.0
90768194.0,6,17,1287,9,691,11339196.5,95.0,76.77777777777777,8,596,12966467.857142856,95.0,74.5
56280.0,6,14,4740,7,653,9159.5,249.0,93.28571428571428,7,4087,8949.333333333334,1514.0,583.8571428571429
147154.0,6,3,337,2,214,0.0,160.0,107.0,1,123,0.0,123.0,123.0
106483729.0,6,33,2428,17,1288,6655233.0625,139.0,75.76470588235294,16,1140,7085206.866666666,123.0,71.25
10471243.0,6,7,478,4,272,3444823.0,74.0,68.0,3,206,5167136.0,74.0,68.66666666666667
303097.0,6,2,132,1,66,0.0,66.0,66.0,1,66,0.0,66.0,66.0
37337.0,6,14,4740,7,653,5653.333333333333,249.0,93.28571428571428,7,4087,5918.0,1514.0,583.8571428571429
2299.0,17,4,344,2,150,0.0,75.0,75.0,2,194,0.0,103.0,97.0
2290.0,17,4,344,2,150,0.0,75.0,75.0,2,194,0.0,103.0,97.0
135128629.0,17,6,1206,6,1206,27025725.8,201.0,201.0,0,0,0.0,0.0,0.0
58827317.0,17,9,3086,8,2736,5107131.428571428,342.0,342.0,1,350,0.0,350.0,350.0
16136.000000000002,6,10,2032,5,524,3769.25,252.0,104.8,5,1508,3755.5,1236.0,301.6
2364.0,17,4,344,2,150,0.0,75.0,75.0,2,194,0.0,103.0,97.0
123711950.0,6,49,3234,25,1650,5154664.583333333,66.0,66.0,24,1584,5151097.347826087,66.0,66.0
5618792.0,6,5,336,2,134,0.0,68.0,67.0,3,202,1422937.0,70.0,67.33333333333333
90089862.0,6,10,1440,7,828,15014977.0,188.0,118.28571428571428,3,612,30030983.0,204.0,204.0
108106606.0,17,5,955,5,955,27026651.5,191.0,191.0,0,0,0.0,0.0,0.0
120247133.0,6,23,1734,11,840,11999633.1,95.0,76.36363636363636,12,894,10909088.363636363,95.0,74.5
203121.0,17,2,180,1,90,0.0,90.0,90.0,1,90,0.0,90.0,90.0
313.0,17,2,164,1,82,0.0,82.0,82.0,1,82,0.0,82.0,82.0
90574932.0,6,26,1746,13,906,7530874.416666667,123.0,69.6923076923077,13,840,7530874.916666667,123.0,64.61538461538461
2257.0,17,4,344,2,150,0.0,75.0,75.0,2,194,0.0,103.0,97.0
2233.0,17,4,344,2,150,0.0,75.0,75.0,2,194,0.0,103.0,97.0
19696.0,6,14,4740,7,653,3168.1666666666665,249.0,93.28571428571428,7,4087,3137.833333333333,1514.0,583.8571428571429
2436.0,17,4,344,2,150,0.0,75.0,75.0,2,194,0.0,103.0,97.0
92592232.0,6,38,2508,19,1254,5143993.0,66.0,66.0,19,1254,5143997.777777778,66.0,66.0
11655.0,6,11,2098,6,590,2221.6,252.0,98.33333333333331,5,1508,2677.75,1236.0,301.6
2049086.0,17,8,1640,4,312,682883.0,78.0,78.0,4,1328,682892.6666666666,332.0,332.0
10422944.0,6,7,478,4,272,3428951.0,74.0,68.0,3,206,5143326.5,74.0,68.66666666666667
50771.0,6,14,4740,7,653,8335.666666666666,249.0,93.28571428571428,7,4087,8271.0,1514.0,583.8571428571429
120124566.0,6,15,2152,9,1204,15015570.75,188.0,133.77777777777777,6,948,18018426.2,204.0,158.0
44733297.0,6,5,1911,2,894,0.0,826.0,447.0,3,1017,20992396.5,885.0,339.0
90071112.0,17,28,13364,28,13364,3335967.111111111,501.0,477.2857142857143,0,0,0.0,0.0,0.0
85.0,17,2,762,2,762,0.0,381.0,381.0,0,0,0.0,0.0,0.0
47810348.0,6,8,1940,3,887,22703484.0,753.0,295.6666666666667,5,1053,11258595.5,785.0,210.6
503060.0,6,6,758,3,410,215945.5,172.0,136.66666666666666,3,348,179318.5,135.0,116.0
5620667.0,6,5,336,2,134,0.0,68.0,67.0,3,202,1422210.5,70.0,67.33333333333333
305057.0,6,6,412,4,272,101685.66666666669,74.0,68.0,2,140,0.0,74.0,70.0
207368.0,6,3,426,2,280,0.0,214.0,140.0,1,146,0.0,146.0,146.0
16934.0,6,14,4740,7,653,2710.6666666666665,249.0,93.28571428571428,7,4087,2646.5,1514.0,583.8571428571429
105047385.0,6,29,1999,15,1017,7503384.642857143,123.0,67.8,14,982,8063720.692307692,139.0,70.14285714285714
94986421.0,6,163,18474,82,12906,1172671.8641975308,284.0,157.390243902439,81,5568,1174408.0625,140.0,68.74074074074075
90255737.0,6,14,2240,8,1016,12893676.714285716,188.0,127.0,6,1224,18014403.8,204.0,204.0
108119011.0,17,5,955,5,955,27029752.75,191.0,191.0,0,0,0.0,0.0,0.0
2799127.0,6,2,132,1,66,0.0,66.0,66.0,1,66,0.0,66.0,66.0
2415.0,17,4,344,2,150,0.0,75.0,75.0,2,194,0.0,103.0,97.0
39676.0,6,14,4740,7,653,6442.166666666667,249.0,93.28571428571428,7,4087,6246.666666666667,1514.0,583.8571428571429
25989.0,6,10,2032,5,524,5430.75,252.0,104.8,5,1508,6187.0,1236.0,301.6
224840.0,6,14,4740,7,653,28462.166666666668,249.0,93.28571428571428,7,4087,28248.5,1514.0,583.8571428571429
1051173.0,6,3,1604,1,753,0.0,753.0,753.0,2,851,0.0,785.0,425.5
103199974.0,6,41,2706,21,1386,5159998.7,66.0,66.0,20,1320,5112746.7894736845,66.0,66.0
3050026.0,6,4,270,3,202,1525013.0,70.0,67.33333333333333,1,68,0.0,68.0,68.0
3002288.0,6,12,2172,7,664,500319.0,252.0,94.85714285714286,5,1508,2158.25,1236.0,301.6
146167.0,6,3,337,2,214,0.0,160.0,107.0,1,123,0.0,123.0,123.0
247683.0,6,3,337,2,214,0.0,160.0,107.0,1,123,0.0,123.0,123.0
234555.0,6,3,373,2,238,0.0,172.0,119.0,1,135,0.0,135.0,135.0
267083.0,6,10,1221,6,636,53416.6,298.0,106.0,4,585,88163.66666666667,379.0,146.25
90289709.0,6,16,1192,8,596,12891987.857142856,95.0,74.5,8,596,12897303.57142857,95.0,74.5
6105881.0,17,6,2100,6,2100,1221176.2,350.0,350.0,0,0,0.0,0.0,0.0
90298497.0,6,16,1192,8,596,12892432.0,95.0,74.5,8,596,12898499.57142857,95.0,74.5
1904.0,17,2,192,1,88,0.0,88.0,88.0,1,104,0.0,104.0,104.0
2321.0,17,4,344,2,150,0.0,75.0,75.0,2,194,0.0,103.0,97.0
450947.0,6,2,145,2,145,0.0,91.0,72.5,0,0,0.0,0.0,0.0
64535.99999999999,6,14,4740,7,653,10634.666666666666,249.0,93.28571428571428,7,4087,8019.5,1514.0,583.8571428571429
309988.0,6,6,412,4,272,103329.33333333331,74.0,68.0,2,140,0.0,74.0,70.0
205880.0,17,2,180,1,90,0.0,90.0,90.0,1,90,0.0,90.0,90.0
90034574.0,17,28,13364,28,13364,3334613.851851852,501.0,477.2857142857143,0,0,0.0,0.0,0.0
44270.0,6,10,2032,5,524,8376.5,252.0,104.8,5,1508,10802.25,1236.0,301.6
4309.0,17,2,598,1,72,0.0,72.0,72.0,1,526,0.0,526.0,526.0
35046.0,6,10,2032,5,524,6484.25,252.0,104.8,5,1508,8472.25,1236.0,301.6
108106455.0,17,5,1005,5,1005,27026613.75,201.0,201.0,0,0,0.0,0.0,0.0
13068.0,6,10,1067,5,536,2857.5,264.0,107.2,5,531,2555.5,259.0,106.2
108110388.0,17,5,955,5,955,27027597.0,191.0,191.0,0,0,0.0,0.0,0.0
120005592.0,6,17,1287,9,691,15000699.0,95.0,76.77777777777777,8,596,12858361.0,95.0,74.5
39547.0,6,14,4740,7,653,6315.5,249.0,93.28571428571428,7,4087,6436.5,1514.0,583.8571428571429
111494584.0,6,30,1974,15,1026,7948467.857142857,123.0,68.4,15,948,7948469.071428572,123.0,63.2
490487.0,6,3,1604,2,851,0.0,785.0,425.5,1,753,0.0,753.0,753.0
113366983.0,6,233,26832,117,7944,977301.5775862068,140.0,67.8974358974359,116,18888,984005.8608695652,284.0,162.82758620689654
5625671.0,6,5,336,2,134,0.0,68.0,67.0,3,202,1524662.5,70.0,67.33333333333333
287032.0,6,10,1221,6,636,57406.4,298.0,106.0,4,585,90254.0,379.0,146.25
17417.0,6,14,4740,7,653,2685.0,249.0,93.28571428571428,7,4087,2675.5,1514.0,583.8571428571429
27348242.0,17,5,1710,5,1710,6837060.5,342.0,342.0,0,0,0.0,0.0,0.0
198945.0,17,4,6056,4,6056,66315.0,1514.0,1514.0,0,0,0.0,0.0,0.0
16465.0,6,14,4740,7,653,2250.333333333333,249.0,93.28571428571428,7,4087,2534.0,1514.0,583.8571428571429
90246645.0,6,17,1287,9,691,11274481.625,95.0,76.77777777777777,8,596,12891322.0,95.0,74.5
18683.0,6,11,1133,6,602,2894.0,264.0,100.33333333333331,5,531,4402.25,259.0,106.2
90092333.0,6,11,1644,4,816,30029985.666666668,204.0,204.0,7,828,15015153.333333334,188.0,118.28571428571428
282520.0,17,2,363,1,79,0.0,79.0,79.0,1,284,0.0,284.0,284.0
109375213.0,17,14,864,7,432,18167827.166666668,174.0,61.71428571428572,7,432,18166822.666666668,174.0,61.71428571428572
306237.0,6,3,202,2,128,0.0,74.0,64.0,1,74,0.0,74.0,74.0
90052584.0,17,28,13364,28,13364,3335280.888888889,501.0,477.2857142857143,0,0,0.0,0.0,0.0
119811721.0,17,34,16284,34,16284,3630658.212121212,501.0,478.9411764705882,0,0,0.0,0.0,0.0
232913.0,6,4,439,2,238,0.0,172.0,119.0,2,201,0.0,135.0,100.5
135132603.0,17,6,1206,6,1206,27026520.6,201.0,201.0,0,0,0.0,0.0,0.0
103370.0,17,2,286,2,286,0.0,143.0,143.0,0,0,0.0,0.0,0.0
300013.0,6,6,412,4,272,100004.33333333331,74.0,68.0,2,140,0.0,74.0,70.0
108106981.0,17,5,955,5,955,27026745.25,191.0,191.0,0,0,0.0,0.0,0.0
10470438.0,6,7,478,4,272,3444543.6666666665,74.0,68.0,3,206,5166711.5,74.0,68.66666666666667
1283978.0,17,7,490,7,490,213996.3333333333,70.0,70.0,0,0,0.0,0.0,0.0
140155.0,6,2,132,1,66,0.0,66.0,66.0,1,66,0.0,66.0,66.0
453.0,17,2,160,1,80,0.0,80.0,80.0,1,80,0.0,80.0,80.0
304671.0,6,6,412,4,272,101557.0,74.0,68.0,2,140,0.0,74.0,70.0
31864.000000000004,6,12,1413,7,882,5310.666666666667,291.0,126.0,5,531,5988.5,259.0,106.2
94308037.0,6,40,2640,20,1320,4963580.894736842,66.0,66.0,20,1320,4949075.736842105,66.0,66.0
90004152.0,17,28,13364,28,13364,3333487.111111111,501.0,477.2857142857143,0,0,0.0,0.0,0.0
245182.0,6,3,337,2,214,0.0,160.0,107.0,1,123,0.0,123.0,123.0
107072.0,17,2,762,2,762,0.0,381.0,381.0,0,0,0.0,0.0,0.0
90093221.0,6,12,1848,5,1020,22522877.5,204.0,204.0,7,828,14969802.0,188.0,118.28571428571428
3045239.0,6,3,204,1,68,0.0,68.0,68.0,2,136,0.0,70.0,68.0
2374341.0,6,25,7573,14,3735,182641.6153846153,1514.0,266.7857142857143,11,3838,212688.9,1514.0,348.90909090909093
113734011.0,6,46,3036,23,1518,5155446.5,66.0,66.0,23,1518,5155454.318181818,66.0,66.0
220670.0,17,4,1400,4,1400,73556.66666666667,350.0,350.0,0,0,0.0,0.0,0.0
207739.0,6,3,426,2,280,0.0,214.0,140.0,1,146,0.0,146.0,146.0
2795760.0,6,2,132,1,66,0.0,66.0,66.0,1,66,0.0,66.0,66.0
33759.0,6,14,4740,7,653,5516.5,249.0,93.28571428571428,7,4087,4702.666666666667,1514.0,583.8571428571429
1803840.0,6,21,6377,11,1463,180384.0,357.0,133.0,10,4914,165104.22222222222,1510.0,491.4
216699.0,17,2,180,1,90,0.0,90.0,90.0,1,90,0.0,90.0,90.0
48848.0,6,14,4740,7,653,7591.0,249.0,93.28571428571428,7,4087,7793.0,1514.0,583.8571428571429
9139.0,17,2,498,1,80,0.0,80.0,80.0,1,418,0.0,418.0,418.0
213859.0,6,3,426,2,280,0.0,214.0,140.0,1,146,0.0,146.0,146.0
2435.0,17,4,344,2,150,0.0,75.0,75.0,2,194,0.0,103.0,97.0
10515008.0,6,7,478,4,272,3459830.333333333,74.0,68.0,3,206,5189638.5,74.0,68.66666666666667
36992.0,6,14,4740,7,653,5986.166666666667,249.0,93.28571428571428,7,4087,5795.5,1514.0,583.8571428571429
108108186.0,17,5,955,5,955,27027046.5,191.0,191.0,0,0,0.0,0.0,0.0
90802507.0,6,19,1436,10,745,10082296.444444444,95.0,74.5,9,691,11349540.375,95.0,76.77777777777777
153488.0,17,2,180,1,90,0.0,90.0,90.0,1,90,0.0,90.0,90.0
128000839.0,17,15,907,8,475,18285834.14285714,174.0,59.375,7,432,18002457.0,174.0,61.71428571428572
90741307.0,6,19,1436,10,745,10077635.777777778,95.0,74.5,9,691,11341666.75,95.0,76.77777777777777
48074.0,6,10,2032,5,524,11795.0,252.0,104.8,5,1508,11403.5,1236.0,301.6
37536.0,6,10,2032,5,524,9138.75,252.0,104.8,5,1508,9002.75,1236.0,301.6
229337.0,6,13,1386,7,789,38222.833333333336,253.0,112.71428571428572,6,597,43902.4,259.0,99.5
102387.0,17,2,762,2,762,0.0,381.0,381.0,0,0,0.0,0.0,0.0
352.0,17,2,156,1,78,0.0,78.0,78.0,1,78,0.0,78.0,78.0
313241.0,17,4,1400,4,1400,104413.66666666669,350.0,350.0,0,0,0.0,0.0,0.0
144818.0,17,2,180,1,70,0.0,70.0,70.0,1,110,0.0,110.0,110.0
39999.0,6,12,1320,6,723,7569.2,253.0,120.5,6,597,5802.8,259.0,99.5
56001.0,6,14,4740,7,653,7912.333333333333,249.0,93.28571428571428,7,4087,8323.166666666666,1514.0,583.8571428571429
14647686.0,6,20,1607,10,975,1593602.3333333333,315.0,97.5,10,632,1593566.2222222222,78.0,63.2
19385.0,6,11,2098,6,590,3167.2,252.0,98.33333333333331,5,1508,3801.5,1236.0,301.6
4674.0,17,2,582,1,83,0.0,83.0,83.0,1,499,0.0,499.0,499.0
2361456.0,6,25,7573,14,3735,181650.4615384616,1514.0,266.7857142857143,11,3838,210854.6,1514.0,348.90909090909093
270018.0,17,4,1524,4,1524,90006.0,381.0,381.0,0,0,0.0,0.0,0.0
113617983.0,6,46,3036,23,1518,5150434.454545454,66.0,66.0,23,1518,5150435.863636363,66.0,66.0
123458996.0,17,14,864,7,432,17333535.333333332,174.0,61.71428571428572,7,432,17334796.666666668,174.0,61.71428571428572
24860.0,6,10,2032,5,524,5558.25,252.0,104.8,5,1508,5962.5,1236.0,301.6
21555.0,6,10,2032,5,524,4879.75,252.0,104.8,5,1508,4809.5,1236.0,301.6
110546002.0,6,31,2166,16,1149,7355332.4,123.0,71.8125,15,1017,7880712.857142857,123.0,67.8
817.0,17,4,438,2,148,0.0,74.0,74.0,2,290,0.0,147.0,145.0
163434.0,6,3,337,2,214,0.0,160.0,107.0,1,123,0.0,123.0,123.0
51088.0,6,2,145,2,145,0.0,91.0,72.5,0,0,0.0,0.0,0.0
146103.0,6,3,337,2,214,0.0,160.0,107.0,1,123,0.0,123.0,123.0
233347.0,6,3,337,2,214,0.0,160.0,107.0,1,123,0.0,123.0,123.0
444715.0,6,4,270,2,134,0.0,68.0,67.0,2,136,0.0,70.0,68.0
108102981.0,17,5,1005,5,1005,27025745.25,201.0,201.0,0,0,0.0,0.0,0.0
2060.0,17,4,344,2,150,0.0,75.0,75.0,2,194,0.0,103.0,97.0
228228.0,17,2,180,1,90,0.0,90.0,90.0,1,90,0.0,90.0,90.0
147204.0,6,3,373,2,238,0.0,172.0,119.0,1,135,0.0,135.0,135.0
90281756.0,6,16,1192,8,596,12891331.142857144,95.0,74.5,8,596,12896156.857142856,95.0,74.5
13146.0,6,10,1066,5,490,2514.0,218.0,98.0,5,576,2910.0,304.0,115.2
90529831.0,6,13,1910,8,1016,12911016.42857143,188.0,127.0,5,894,15126133.0,204.0,178.8
508421.0,6,4,270,2,134,0.0,68.0,67.0,2,136,0.0,70.0,68.0
3599733.0,6,5,367,2,132,0.0,66.0,66.0,3,235,1799866.5,103.0,78.33333333333333
13799.0,6,2,145,2,145,0.0,91.0,72.5,0,0,0.0,0.0,0.0
31983.0,6,14,4740,7,653,5053.833333333333,249.0,93.28571428571428,7,4087,5190.5,1514.0,583.8571428571429
90028055.0,17,27,12943,27,12943,3462617.5,501.0,479.3703703703704,0,0,0.0,0.0,0.0
43897.0,6,14,4740,7,653,7195.333333333333,249.0,93.28571428571428,7,4087,6427.5,1514.0,583.8571428571429
553400.0,6,2,132,1,66,0.0,66.0,66.0,1,66,0.0,66.0,66.0
16400884.000000002,6,26,9161,14,2127,1261606.4615384615,408.0,151.92857142857142,12,7034,1116335.4545454546,1514.0,586.1666666666666
120217724.0,17,14,864,7,432,20036287.33333333,174.0,61.71428571428572,7,432,19940573.33333333,174.0,61.71428571428572
47171.0,6,14,4740,7,653,7358.333333333333,249.0,93.28571428571428,7,4087,7721.166666666667,1514.0,583.8571428571429
2417.0,17,4,344,2,150,0.0,75.0,75.0,2,194,0.0,103.0,97.0
2339.0,17,4,344,2,150,0.0,75.0,75.0,2,194,0.0,103.0,97.0
216776.0,6,3,426,2,280,0.0,214.0,140.0,1,146,0.0,146.0,146.0
206045.0,17,2,180,1,90,0.0,90.0,90.0,1,90,0.0,90.0,90.0
301500.0,17,4,1524,4,1524,100500.0,381.0,381.0,0,0,0.0,0.0,0.0
5595.0,17,4,823,2,163,0.0,89.0,81.5,2,660,0.0,443.0,330.0
3324408.0,6,149,125179,89,116918,37777.36363636364,1510.0,1313.685393258427,60,8261,51073.86440677966,1510.0,137.68333333333334
90094043.0,6,12,1848,5,1020,22522930.75,204.0,204.0,7,828,14969689.166666666,188.0,118.28571428571428
90715971.0,6,25,1702,13,840,7559664.25,123.0,64.61538461538461,12,862,7319548.636363637,139.0,71.83333333333333
144093.0,17,2,180,1,90,0.0,90.0,90.0,1,90,0.0,90.0,90.0
1468331.0,17,16,1120,16,1120,97888.73333333334,70.0,70.0,0,0,0.0,0.0,0.0
12861.0,6,11,2041,6,533,2453.0,195.0,88.83333333333333,5,1508,2949.0,1236.0,301.6
754787.0,6,6,758,3,410,354892.0,172.0,136.66666666666666,3,348,255462.5,135.0,116.0
3209934.0,6,15,2360,8,1069,458562.0,581.0,133.625,7,1291,500298.0,732.0,184.42857142857144
153559.0,17,2,180,1,90,0.0,90.0,90.0,1,90,0.0,90.0,90.0
19201.0,6,10,2032,5,524,4184.5,252.0,104.8,5,1508,4443.75,1236.0,301.6
216482.0,6,3,426,2,280,0.0,214.0,140.0,1,146,0.0,146.0,146.0
811.0,17,5,550,5,550,202.75,110.0,110.0,0,0,0.0,0.0,0.0
153428.0,17,2,180,1,90,0.0,90.0,90.0,1,90,0.0,90.0,90.0
10474317.0,6,7,478,4,272,3445919.6666666665,74.0,68.0,3,206,5168761.5,74.0,68.66666666666667
108101875.0,17,5,955,5,955,27025468.75,191.0,191.0,0,0,0.0,0.0,0.0
32084.0,6,13,1386,7,789,5004.5,253.0,112.71428571428572,6,597,5948.4,259.0,99.5
90847637.0,6,26,1746,13,906,7552634.833333333,123.0,69.6923076923077,13,840,7552637.083333333,123.0,64.61538461538461
148975.0,6,3,373,2,238,0.0,172.0,119.0,1,135,0.0,135.0,135.0
43906.0,6,14,4740,7,653,6773.5,249.0,93.28571428571428,7,4087,6858.0,1514.0,583.8571428571429
4259.0,17,2,626,1,72,0.0,72.0,72.0,1,554,0.0,554.0,554.0
27575.0,6,14,4740,7,653,4482.666666666667,249.0,93.28571428571428,7,4087,3937.6666666666665,1514.0,583.8571428571429
120000137.0,6,22,1680,12,935,10909103.363636363,95.0,77.91666666666667,10,745,10105051.0,95.0,74.5
50721.0,17,2,180,1,90,0.0,90.0,90.0,1,90,0.0,90.0,90.0
95682095.0,6,40,2640,20,1320,5035899.736842105,66.0,66.0,20,1320,5021564.7894736845,66.0,66.0
137501.0,17,4,1400,4,1400,45833.66666666666,350.0,350.0,0,0,0.0,0.0,0.0
27793.0,6,14,4740,7,653,4509.0,249.0,93.28571428571428,7,4087,4417.333333333333,1514.0,583.8571428571429
135132730.0,17,6,1146,6,1146,27026546.0,191.0,191.0,0,0,0.0,0.0,0.0
1115.0,17,5,550,5,550,278.75,110.0,110.0,0,0,0.0,0.0,0.0
90021457.0,17,27,12943,27,12943,3462363.730769231,501.0,479.3703703703704,0,0,0.0,0.0,0.0
274743.0,6,10,1221,6,636,54948.6,298.0,106.0,4,585,84063.66666666667,379.0,146.25
19816.0,6,14,4740,7,653,3187.333333333333,249.0,93.28571428571428,7,4087,3117.5,1514.0,583.8571428571429
47813604.0,6,8,1938,3,886,22706936.5,752.0,295.3333333333333,5,1052,11256599.75,784.0,210.4
204818.0,17,2,762,2,762,0.0,381.0,381.0,0,0,0.0,0.0,0.0
553728.0,17,2,363,1,79,0.0,79.0,79.0,1,284,0.0,284.0,284.0
144794.0,17,2,180,1,70,0.0,70.0,70.0,1,110,0.0,110.0,110.0
2323.0,17,4,344,2,150,0.0,75.0,75.0,2,194,0.0,103.0,97.0
90091663.0,6,11,1766,7,950,15015277.166666666,188.0,135.71428571428572,4,816,20109154.33333333,204.0,204.0
101084187.0,6,302,36786,151,26598,672522.1733333333,390.0,176.1456953642384,151,10188,672521.9466666667,140.0,67.47019867549669
280643.0,17,2,363,1,79,0.0,79.0,79.0,1,284,0.0,284.0,284.0
2584.0,17,4,344,2,150,0.0,75.0,75.0,2,194,0.0,103.0,97.0
517231.0,17,6,1230,3,234,258428.00000000003,78.0,78.0,3,996,258410.0,332.0,332.0
5623959.0,6,5,336,2,134,0.0,68.0,67.0,3,202,1424721.0,70.0,67.33333333333333
119690825.0,6,224,25216,112,17602,1076356.2882882883,284.0,157.16071428571428,112,7614,1076355.8828828828,140.0,67.98214285714286
232669.0,6,4,439,2,238,0.0,172.0,119.0,2,201,0.0,135.0,100.5
98909.0,17,2,762,2,762,0.0,381.0,381.0,0,0,0.0,0.0,0.0
98102.0,6,2,132,1,66,0.0,66.0,66.0,1,66,0.0,66.0,66.0
103707156.0,6,202,22938,101,6888,1028862.67,140.0,68.1980198019802,101,16050,1030210.42,336.0,158.9108910891089
106928320.0,6,21,1712,10,913,11853142.666666666,222.0,91.3,11,799,10671244.3,95.0,72.63636363636364
105216137.0,6,183,20616,92,6306,1156221.2857142857,140.0,68.54347826086956,91,14310,1157673.2333333334,284.0,157.25274725274724
90020507.0,17,27,12943,27,12943,3462327.1923076925,501.0,479.3703703703704,0,0,0.0,0.0,0.0
23083.0,6,10,2032,5,524,5312.25,252.0,104.8,5,1508,4748.5,1236.0,301.6
197219.0,17,2,180,1,90,0.0,90.0,90.0,1,90,0.0,90.0,90.0
216536.0,17,2,180,1,90,0.0,90.0,90.0,1,90,0.0,90.0,90.0
318735.0,17,4,1400,4,1400,106245.0,350.0,350.0,0,0,0.0,0.0,0.0
2448.0,17,4,344,2,150,0.0,75.0,75.0,2,194,0.0,103.0,97.0
12118.0,6,12,1393,6,796,2290.6,271.0,132.66666666666666,6,597,2140.6,259.0,99.5
3007131.0,6,11,2106,6,598,601234.0,252.0,99.66666666666669,5,1508,1808.75,1236.0,301.6
260111.0,6,3,337,2,214,0.0,160.0,107.0,1,123,0.0,123.0,123.0
135754.0,6,13,1386,7,789,22625.666666666668,253.0,112.71428571428572,6,597,24469.0,259.0,99.5
608710.0,17,2,346,1,78,0.0,78.0,78.0,1,268,0.0,268.0,268.0
47351.0,6,14,4740,7,653,6711.5,249.0,93.28571428571428,7,4087,7686.666666666667,1514.0,583.8571428571429
32118.0,6,10,2032,5,524,7811.75,252.0,104.8,5,1508,7782.25,1236.0,301.6
101471808.0,6,32,2289,16,1140,6764759.266666667,123.0,71.25,16,1149,6764757.8,123.0,71.8125
739.0,17,2,762,2,762,0.0,381.0,381.0,0,0,0.0,0.0,0.0
47605556.0,6,8,1940,3,887,22764152.0,753.0,295.6666666666667,5,1053,11258223.75,785.0,210.6
104468068.0,6,31,2182,16,1165,6950153.466666667,139.0,72.8125,15,1017,7446591.5,123.0,67.8
103542.0,17,2,286,2,286,0.0,143.0,143.0,0,0,0.0,0.0,0.0
299.0,17,2,168,1,76,0.0,76.0,76.0,1,92,0.0,92.0,92.0
122900585.0,6,34,2488,18,1348,7229446.176470588,139.0,74.88888888888889,16,1140,7513219.4,123.0,71.25
120046742.0,17,28,13364,28,13364,4446175.62962963,501.0,477.2857142857143,0,0,0.0,0.0,0.0
20164889.0,17,4,172,2,86,0.0,43.0,43.0,2,86,0.0,43.0,43.0
1320896.0,6,4,276,2,128,0.0,74.0,64.0,2,148,0.0,74.0,74.0
216669.0,6,3,426,2,280,0.0,214.0,140.0,1,146,0.0,146.0,146.0
106314301.0,6,30,1990,15,1042,7578431.5,139.0,69.46666666666667,15,948,7578437.0,123.0,63.2
153476.0,17,2,180,1,90,0.0,90.0,90.0,1,90,0.0,90.0,90.0
2382.0,17,4,344,2,150,0.0,75.0,75.0,2,194,0.0,103.0,97.0
2444994.0,6,25,7573,14,3735,188076.4615384616,1514.0,266.7857142857143,11,3838,219420.5,1514.0,348.90909090909093
644.0,17,2,508,2,508,0.0,257.0,254.0,0,0,0.0,0.0,0.0
3539.0,17,4,344,2,150,0.0,75.0,75.0,2,194,0.0,103.0,97.0
105217368.0,17,15,5130,15,5130,7515526.285714285,342.0,342.0,0,0,0.0,0.0,0.0
144760.0,17,2,180,1,70,0.0,70.0,70.0,1,110,0.0,110.0,110.0
2009630.0,17,4,525,2,150,0.0,75.0,75.0,2,375,0.0,284.0,187.5
2360352.0,6,2,132,1,66,0.0,66.0,66.0,1,66,0.0,66.0,66.0
1030122.0,6,7,3298,3,1584,343473.0,753.0,528.0,4,1714,343374.0,785.0,428.5
680.0,17,2,508,2,508,0.0,257.0,254.0,0,0,0.0,0.0,0.0
304917.0,6,3,202,2,128,0.0,74.0,64.0,1,74,0.0,74.0,74.0
115336498.0,6,34,2350,17,1225,7208531.125,139.0,72.05882352941177,17,1125,7195025.6875,123.0,66.17647058823529
5626801.0,6,5,336,2,134,0.0,68.0,67.0,3,202,1525506.0,70.0,67.33333333333333
6277.0,17,4,344,2,150,0.0,75.0,75.0,2,194,0.0,103.0,97.0
67400.0,6,11,1132,6,556,9082.2,218.0,92.66666666666669,5,576,16583.75,304.0,115.2
903040.0,6,10,1336,6,799,180608.0,461.0,133.16666666666666,4,537,210185.66666666663,331.0,134.25
47663.0,6,14,4740,7,653,7821.333333333333,249.0,93.28571428571428,7,4087,7763.666666666667,1514.0,583.8571428571429
207139.0,6,3,426,2,280,0.0,214.0,140.0,1,146,0.0,146.0,146.0
90020325.0,17,27,12943,27,12943,3462320.1923076925,501.0,479.3703703703704,0,0,0.0,0.0,0.0
324.0,17,2,174,1,79,0.0,79.0,79.0,1,95,0.0,95.0,95.0
975233.0,6,12,1354,6,723,194017.2,253.0,120.5,6,631,194819.6,293.0,105.16666666666669
40085.0,6,13,1479,7,882,6680.833333333333,291.0,126.0,6,597,6279.6,259.0,99.5
874343.0,6,9,1096,6,625,174868.6,287.0,104.16666666666669,3,471,299304.0,331.0,157.0
153417.0,17,2,180,1,90,0.0,90.0,90.0,1,90,0.0,90.0,90.0
143868.0,17,2,180,1,90,0.0,90.0,90.0,1,90,0.0,90.0,90.0
135356958.0,17,8,1713,7,1407,22559493.0,201.0,201.0,1,306,0.0,306.0,306.0
100045811.0,6,179,20250,90,14154,1124110.2359550565,284.0,157.26666666666668,89,6096,1124983.2045454546,140.0,68.49438202247191
144708.0,17,2,180,1,70,0.0,70.0,70.0,1,110,0.0,110.0,110.0
21931103.0,17,3,1034,2,684,0.0,342.0,342.0,1,350,0.0,350.0,350.0
7096.0,17,2,582,1,83,0.0,83.0,83.0,1,499,0.0,499.0,499.0
282209.0,17,2,363,1,79,0.0,79.0,79.0,1,284,0.0,284.0,284.0
0.0,6,1,66,1,66,0.0,66.0,66.0,0,0,0.0,0.0,0.0
328.0,17,2,166,1,75,0.0,75.0,75.0,1,91,0.0,91.0,91.0
304033.0,6,3,202,2,128,0.0,74.0,64.0,1,74,0.0,74.0,74.0
78172.0,6,14,4740,7,653,12597.333333333334,249.0,93.28571428571428,7,4087,12890.0,1514.0,583.8571428571429
502917.0,6,5,336,2,134,0.0,68.0,67.0,3,202,194767.0,70.0,67.33333333333333
232557.0,6,3,337,2,214,0.0,160.0,107.0,1,123,0.0,123.0,123.0
114649751.0,6,47,3102,24,1584,4984760.434782608,66.0,66.0,23,1518,5159999.681818182,66.0,66.0
166.0,17,2,3028,2,3028,0.0,1514.0,1514.0,0,0,0.0,0.0,0.0
135130707.0,17,6,1206,6,1206,27026141.4,201.0,201.0,0,0,0.0,0.0,0.0
143895.0,17,2,180,1,90,0.0,90.0,90.0,1,90,0.0,90.0,90.0
2703512.0,6,2,132,1,66,0.0,66.0,66.0,1,66,0.0,66.0,66.0
14019871.0,17,6,2052,6,2052,2803974.2,342.0,342.0,0,0,0.0,0.0,0.0
32136.0,6,10,2032,5,524,7498.75,252.0,104.8,5,1508,7121.0,1236.0,301.6
857338.0,6,9,1196,6,725,171467.6,387.0,120.83333333333331,3,471,292385.5,331.0,157.0
105672668.0,17,14,864,7,432,17500192.0,174.0,61.71428571428572,7,432,17500966.0,174.0,61.71428571428572
17964.0,6,14,4740,7,653,2506.5,249.0,93.28571428571428,7,4087,2667.333333333333,1514.0,583.8571428571429
12242.0,6,11,2098,6,590,2237.8,252.0,98.33333333333331,5,1508,2489.0,1236.0,301.6
227015.0,6,13,1394,7,797,37835.833333333336,253.0,113.85714285714286,6,597,43003.6,259.0,99.5
115654583.0,6,881,199400,429,29054,269856.22897196264,214.0,67.72494172494173,452,170346,254881.57649667407,1514.0,376.8716814159292
377.0,17,2,267,1,83,0.0,83.0,83.0,1,184,0.0,184.0,184.0
228576.0,17,2,180,1,90,0.0,90.0,90.0,1,90,0.0,90.0,90.0
114025845.0,6,48,3168,24,1584,4957645.434782608,66.0,66.0,24,1584,4944429.521739131,66.0,66.0
113618918.0,6,46,3036,23,1518,5150439.954545454,66.0,66.0,23,1518,5150435.636363637,66.0,66.0
216814.0,6,3,426,2,280,0.0,214.0,140.0,1,146,0.0,146.0,146.0
506410.0,6,5,336,2,134,0.0,68.0,67.0,3,202,193437.0,70.0,67.33333333333333
119456488.0,6,223,25262,112,17640,1076184.5765765766,284.0,157.5,111,7622,1057794.1454545455,140.0,68.66666666666667
500.0,17,2,508,2,508,0.0,257.0,254.0,0,0,0.0,0.0,0.0
145606.0,6,3,337,2,214,0.0,160.0,107.0,1,123,0.0,123.0,123.0
357986.0,6,3,204,2,136,0.0,70.0,68.0,1,68,0.0,68.0,68.0
120000137.0,6,17,1287,9,691,15000017.125,95.0,76.77777777777777,8,596,12899922.0,95.0,74.5
112682548.0,6,32,2220,16,1149,7497789.2,123.0,71.8125,16,1071,7497788.333333333,123.0,66.9375
108107068.0,17,5,1005,5,1005,27026767.0,201.0,201.0,0,0,0.0,0.0,0.0
120447180.0,6,287,32594,144,22860,842287.972027972,300.0,158.75,143,9734,841128.5070422535,140.0,68.06993006993007
2368.0,17,4,344,2,150,0.0,75.0,75.0,2,194,0.0,103.0,97.0
93179695.0,6,18,1501,9,851,11640993.25,255.0,94.55555555555556,9,650,11646787.25,95.0,72.22222222222223
707715.0,17,6,1230,3,234,353664.5,78.0,78.0,3,996,353650.0,332.0,332.0
90318630.0,6,17,1287,9,691,11283154.375,95.0,76.77777777777777,8,596,12832049.57142857,95.0,74.5
2338.0,17,4,344,2,150,0.0,75.0,75.0,2,194,0.0,103.0,97.0
20252.0,6,10,2032,5,524,4750.75,252.0,104.8,5,1508,4789.25,1236.0,301.6
40951.0,6,14,4740,7,653,6300.0,249.0,93.28571428571428,7,4087,6330.166666666667,1514.0,583.8571428571429
230725.0,17,2,180,1,90,0.0,90.0,90.0,1,90,0.0,90.0,90.0
232840.0,6,3,337,2,214,0.0,160.0,107.0,1,123,0.0,123.0,123.0
1173765.0,6,13,3010,8,2382,167680.7142857143,1514.0,297.75,5,628,225278.0,331.0,125.6
188087.0,17,2,180,1,90,0.0,90.0,90.0,1,90,0.0,90.0,90.0
241946.0,6,3,337,2,214,0.0,160.0,107.0,1,123,0.0,123.0,123.0
270349.0,6,12,1373,7,714,45058.16666666666,298.0,102.0,5,659,63272.0,379.0,131.8
219951.0,6,3,426,2,280,0.0,214.0,140.0,1,146,0.0,146.0,146.0
138070.0,6,2,132,1,66,0.0,66.0,66.0,1,66,0.0,66.0,66.0
1683840.0,17,18,1260,18,1260,99049.41176470587,70.0,70.0,0,0,0.0,0.0,0.0
546.0,17,2,508,2,508,0.0,257.0,254.0,0,0,0.0,0.0,0.0
531934.0,17,6,2100,6,2100,106386.8,350.0,350.0,0,0,0.0,0.0,0.0
131285.0,6,3,337,2,214,0.0,160.0,107.0,1,123,0.0,123.0,123.0
13993.0,6,10,2032,5,524,3179.0,252.0,104.8,5,1508,3253.75,1236.0,301.6
90241314.0,6,16,1192,8,596,12884404.714285716,95.0,74.5,8,596,12888416.57142857,95.0,74.5
31185.0,6,14,4740,7,653,5046.833333333333,249.0,93.28571428571428,7,4087,5022.333333333333,1514.0,583.8571428571429
4960441.0,6,179,162527,113,153869,44289.65178571428,1510.0,1361.6725663716811,66,8658,70242.89230769231,1510.0,131.1818181818182
109301980.0,6,408,49854,204,13686,538425.1083743842,140.0,67.08823529411765,204,36168,534605.3990147783,336.0,177.2941176470588
114856757.0,17,13,821,7,432,19116305.83333333,174.0,61.71428571428572,6,389,18976418.4,174.0,64.83333333333333
21844.0,6,10,2032,5,524,5200.25,252.0,104.8,5,1508,5008.75,1236.0,301.6
17237.0,6,20,7606,11,978,1723.7,310.0,88.9090909090909,9,6628,1819.625,1514.0,736.4444444444445
120049413.0,17,28,13364,28,13364,4446274.555555556,501.0,477.2857142857143,0,0,0.0,0.0,0.0
95344727.0,6,30,2106,15,1089,6810337.642857143,123.0,72.6,15,1017,6794879.357142857,123.0,67.8
90213493.0,6,27,2073,12,935,8179101.181818182,95.0,77.91666666666667,15,1138,6429129.285714285,95.0,75.86666666666666
115618408.0,6,48,3168,24,1584,5026887.304347826,66.0,66.0,24,1584,5013464.695652174,66.0,66.0
5647687.0,6,5,1909,2,892,0.0,826.0,446.0,3,1017,1523617.5,885.0,339.0
1477518.0,6,7,499,3,198,727478.0,66.0,66.0,4,301,413314.6666666667,103.0,75.25
313510.0,6,3,202,2,128,0.0,74.0,64.0,1,74,0.0,74.0,74.0
539174.0,17,6,2100,6,2100,107834.8,350.0,350.0,0,0,0.0,0.0,0.0
1309310.0,6,4,264,2,132,0.0,66.0,66.0,2,132,0.0,66.0,66.0
41590.0,6,14,4740,7,653,6369.333333333333,249.0,93.28571428571428,7,4087,6666.166666666667,1514.0,583.8571428571429
14643426.0,6,20,1689,10,1057,1592632.6666666667,315.0,105.7,10,632,1592611.2222222222,78.0,63.2
5631735.0,6,5,336,2,134,0.0,68.0,67.0,3,202,1524272.5,70.0,67.33333333333333
115150891.0,6,48,3168,24,1584,5006560.478260869,66.0,66.0,24,1584,4992975.347826087,66.0,66.0
105336572.0,17,15,1431,8,737,15048081.714285716,174.0,92.125,7,694,15662246.833333334,174.0,99.14285714285714
307200.0,6,6,412,4,272,102400.0,74.0,68.0,2,140,0.0,74.0,70.0
78047.0,6,13,1386,7,789,12659.833333333334,253.0,112.71428571428572,6,597,12581.6,259.0,99.5
315.0,17,2,174,1,79,0.0,79.0,79.0,1,95,0.0,95.0,95.0
117101220.0,17,16,1212,8,606,16714439.0,174.0,75.75,8,606,16715700.0,174.0,75.75
2468.0,17,4,344,2,150,0.0,75.0,75.0,2,194,0.0,103.0,97.0
1306997.0,6,4,264,2,132,0.0,66.0,66.0,2,132,0.0,66.0,66.0
309874.0,17,4,704,2,148,0.0,74.0,74.0,2,556,0.0,280.0,278.0
47710.0,6,14,4740,7,653,7558.166666666667,249.0,93.28571428571428,7,4087,7127.5,1514.0,583.8571428571429
305476.0,6,10,1221,6,636,61095.2,298.0,106.0,4,585,97563.66666666669,379.0,146.25
153468.0,17,2,180,1,90,0.0,90.0,90.0,1,90,0.0,90.0,90.0
115387884.0,17,44,15400,44,15400,2683439.162790697,350.0,350.0,0,0,0.0,0.0,0.0
22787.0,6,10,2032,5,524,5493.25,252.0,104.8,5,1508,3000.5,1236.0,301.6
621578.0,17,3,551,2,156,0.0,78.0,78.0,1,395,0.0,395.0,395.0
300032.0,6,6,412,4,272,100010.66666666669,74.0,68.0,2,140,0.0,74.0,70.0
32038.0,6,13,1386,7,789,5165.666666666667,253.0,112.71428571428572,6,597,5490.2,259.0,99.5
147999.0,17,2,180,1,90,0.0,90.0,90.0,1,90,0.0,90.0,90.0
401920.0,6,3,1604,2,851,0.0,785.0,425.5,1,753,0.0,753.0,753.0
242415.0,6,3,337,2,214,0.0,160.0,107.0,1,123,0.0,123.0,123.0
120028002.0,6,19,1395,10,745,13332001.0,95.0,74.5,9,650,14997982.5,95.0,72.22222222222223
113214423.0,6,32,2374,17,1288,7062410.6875,139.0,75.76470588235294,15,1086,8071324.642857143,123.0,72.4
111028532.0,6,32,2236,16,1165,7387499.466666667,139.0,72.8125,16,1071,7387502.0,123.0,66.9375
299064.0,6,6,412,4,272,99688.0,74.0,68.0,2,140,0.0,74.0,70.0
103410.0,17,2,286,2,286,0.0,143.0,143.0,0,0,0.0,0.0,0.0
120199361.0,6,736,143838,370,119090,325743.52574525744,1514.0,321.86486486486484,366,24748,326446.1205479452,214.0,67.61748633879782
261534.0,6,10,1221,6,636,52306.8,298.0,106.0,4,585,81760.66666666667,379.0,146.25
144104.0,17,2,180,1,90,0.0,90.0,90.0,1,90,0.0,90.0,90.0
140292.0,6,3,337,2,214,0.0,160.0,107.0,1,123,0.0,123.0,123.0
146149.0,6,3,337,2,214,0.0,160.0,107.0,1,123,0.0,123.0,123.0
100295.0,17,2,286,2,286,0.0,143.0,143.0,0,0,0.0,0.0,0.0
97037158.0,17,12,778,6,389,19401011.0,174.0,64.83333333333333,6,389,19400158.6,174.0,64.83333333333333
4366.0,17,2,602,1,72,0.0,72.0,72.0,1,530,0.0,530.0,530.0
0.0,17,1,55,1,55,0.0,55.0,55.0,0,0,0.0,0.0,0.0
54344.0,6,12,1320,7,789,9057.333333333334,253.0,112.71428571428572,5,531,11697.25,259.0,106.2
21994540.0,17,3,1034,2,684,0.0,342.0,342.0,1,350,0.0,350.0,350.0
317038.0,6,3,337,2,214,0.0,160.0,107.0,1,123,0.0,123.0,123.0
638874.0,6,2,132,1,66,0.0,66.0,66.0,1,66,0.0,66.0,66.0
49724.0,6,10,2032,5,524,12183.0,252.0,104.8,5,1508,11922.25,1236.0,301.6
197370.0,17,4,1524,4,1524,65790.0,381.0,381.0,0,0,0.0,0.0,0.0
856552.0,6,9,1268,6,797,171310.4,459.0,132.83333333333334,3,471,290501.5,331.0,157.0
246095.0,6,3,337,2,214,0.0,160.0,107.0,1,123,0.0,123.0,123.0
438971.0,17,2,363,1,79,0.0,79.0,79.0,1,284,0.0,284.0,284.0
207608.0,17,2,762,2,762,0.0,381.0,381.0,0,0,0.0,0.0,0.0
103001128.0,17,13,821,7,432,17166854.666666668,174.0,61.71428571428572,6,389,16600695.0,174.0,64.83333333333333
306735.0,6,6,412,4,272,102245.0,74.0,68.0,2,140,0.0,74.0,70.0
211242.0,17,2,180,1,90,0.0,90.0,90.0,1,90,0.0,90.0,90.0
2070003.0,6,19,6869,11,1567,207000.3,408.0,142.45454545454547,8,5302,233616.57142857145,1514.0,662.75
0.0,6,1,66,1,66,0.0,66.0,66.0,0,0,0.0,0.0,0.0
120000984.0,6,23,1734,13,989,10000082.0,95.0,76.07692307692308,10,745,13254589.666666666,95.0,74.5
15879.0,6,14,4740,7,653,2478.0,249.0,93.28571428571428,7,4087,2502.333333333333,1514.0,583.8571428571429
217124.0,6,10,1221,6,636,43424.8,298.0,106.0,4,585,71389.33333333333,379.0,146.25
314.0,17,2,174,1,79,0.0,79.0,79.0,1,95,0.0,95.0,95.0
49546.0,6,13,1386,7,789,7551.666666666667,253.0,112.71428571428572,6,597,9190.8,259.0,99.5
135366120.0,17,8,1713,7,1407,22561020.0,201.0,201.0,1,306,0.0,306.0,306.0
242850.0,6,3,373,2,238,0.0,172.0,119.0,1,135,0.0,135.0,135.0
16785.0,6,11,1132,6,556,3310.4,218.0,92.66666666666669,5,576,2736.0,304.0,115.2
102001142.0,17,13,821,7,432,17000190.333333332,174.0,61.71428571428572,6,389,16400421.4,174.0,64.83333333333333
710.0,17,4,438,2,148,0.0,74.0,74.0,2,290,0.0,147.0,145.0
100000946.0,17,11,735,6,389,20000189.2,174.0,64.83333333333333,5,346,20000720.0,174.0,69.2
34842.0,6,10,2032,5,524,8474.75,252.0,104.8,5,1508,8275.0,1236.0,301.6
2365.0,17,4,344,2,150,0.0,75.0,75.0,2,194,0.0,103.0,97.0
101254.0,17,2,700,2,700,0.0,350.0,350.0,0,0,0.0,0.0,0.0
22680.0,6,10,2032,5,524,5436.0,252.0,104.8,5,1508,4597.5,1236.0,301.6
108107294.0,17,5,955,5,955,27026823.5,191.0,191.0,0,0,0.0,0.0,0.0
318.0,17,2,174,1,79,0.0,79.0,79.0,1,95,0.0,95.0,95.0
40648.0,6,14,4740,7,653,6651.666666666667,249.0,93.28571428571428,7,4087,6634.833333333333,1514.0,583.8571428571429
120021290.0,17,28,13364,28,13364,4445232.962962963,501.0,477.2857142857143,0,0,0.0,0.0,0.0
107574.0,17,2,286,2,286,0.0,143.0,143.0,0,0,0.0,0.0,0.0
38768.0,17,2,582,1,83,0.0,83.0,83.0,1,499,0.0,499.0,499.0
220445.0,6,10,1221,6,636,44089.0,298.0,106.0,4,585,70716.33333333333,379.0,146.25
120014228.0,6,239,26964,120,18888,1006704.6890756304,284.0,157.4,119,8076,1010518.1016949152,140.0,67.8655462184874
407.0,17,2,410,1,78,0.0,78.0,78.0,1,332,0.0,332.0,332.0
108427894.0,6,32,2352,16,1140,7228526.266666667,123.0,71.25,16,1212,6701530.066666666,123.0,75.75
1169072.0,6,13,3000,8,2372,167010.2857142857,1514.0,296.5,5,628,224118.0,331.0,125.6
217092.0,6,3,426,2,280,0.0,214.0,140.0,1,146,0.0,146.0,146.0
299604.0,6,6,412,4,272,99868.0,74.0,68.0,2,140,0.0,74.0,70.0
318833.0,17,4,1400,4,1400,106277.66666666669,350.0,350.0,0,0,0.0,0.0,0.0
245767.0,6,3,337,2,214,0.0,160.0,107.0,1,123,0.0,123.0,123.0
361090.0,17,2,180,1,90,0.0,90.0,90.0,1,90,0.0,90.0,90.0
162309.0,17,2,180,1,90,0.0,90.0,90.0,1,90,0.0,90.0,90.0
2099.0,17,4,344,2,150,0.0,75.0,75.0,2,194,0.0,103.0,97.0
228365.0,17,2,180,1,90,0.0,90.0,90.0,1,90,0.0,90.0,90.0
90005511.0,17,28,13364,28,13364,3333537.4444444445,501.0,477.2857142857143,0,0,0.0,0.0,0.0
828749.0,6,9,1118,6,586,165749.8,248.0,97.66666666666669,3,532,277915.0,392.0,177.33333333333334
56747.0,6,14,4740,7,653,8983.833333333334,249.0,93.28571428571428,7,4087,8246.5,1514.0,583.8571428571429
403.0,17,2,267,1,83,0.0,83.0,83.0,1,184,0.0,184.0,184.0
251475.0,6,3,373,2,238,0.0,172.0,119.0,1,135,0.0,135.0,135.0
84721.0,6,10,2032,5,524,20866.5,252.0,104.8,5,1508,20856.25,1236.0,301.6
47726312.0,6,8,2113,3,960,22431222.5,826.0,320.0,5,1153,11261924.5,885.0,230.6
104786.0,17,2,286,2,286,0.0,143.0,143.0,0,0,0.0,0.0,0.0
23043.0,6,10,2032,5,524,5470.75,252.0,104.8,5,1508,5113.25,1236.0,301.6
120012540.0,6,19,1436,10,786,13333319.666666666,95.0,78.6,9,650,15000483.5,95.0,72.22222222222223
2518553.0,6,3,1777,1,826,0.0,826.0,826.0,2,951,0.0,885.0,475.5
309054.0,17,2,238,1,74,0.0,74.0,74.0,1,164,0.0,164.0,164.0
120121624.0,6,18,2622,10,1392,13346847.111111112,188.0,139.2,8,1230,12930983.0,204.0,153.75
4990337.0,17,4,849,2,166,0.0,83.0,83.0,2,683,0.0,499.0,341.5
108692246.0,6,35,2674,18,1411,6393661.529411765,139.0,78.38888888888889,17,1263,6780462.6875,123.0,74.29411764705883
228279.0,17,2,180,1,90,0.0,90.0,90.0,1,90,0.0,90.0,90.0
108104708.0,17,5,1005,5,1005,27026177.0,201.0,201.0,0,0,0.0,0.0,0.0
45436.0,6,14,4740,7,653,7451.166666666667,249.0,93.28571428571428,7,4087,7016.666666666667,1514.0,583.8571428571429
120789189.0,6,230,25994,115,7812,1048560.596491228,140.0,67.9304347826087,115,18182,1052356.0,284.0,158.10434782608695
147877.0,17,2,180,1,90,0.0,90.0,90.0,1,90,0.0,90.0,90.0
196822.0,17,2,180,1,90,0.0,90.0,90.0,1,90,0.0,90.0,90.0
2329.0,17,4,344,2,150,0.0,75.0,75.0,2,194,0.0,103.0,97.0
311939.0,6,6,412,4,272,103979.66666666669,74.0,68.0,2,140,0.0,74.0,70.0
111022.0,17,2,286,2,286,0.0,143.0,143.0,0,0,0.0,0.0,0.0
2370.0,17,4,344,2,150,0.0,75.0,75.0,2,194,0.0,103.0,97.0
47962.0,6,10,2032,5,524,8210.5,252.0,104.8,5,1508,11645.5,1236.0,301.6
124880027.0,17,14,864,7,432,17500186.5,174.0,61.71428571428572,7,432,17501143.333333332,174.0,61.71428571428572
27856752.0,17,5,1718,4,1368,981187.3333333334,342.0,342.0,1,350,0.0,350.0,350.0
120205084.0,6,21,1585,10,786,13332193.333333334,95.0,78.6,11,799,11998979.4,95.0,72.63636363636364
197084.0,17,2,180,1,90,0.0,90.0,90.0,1,90,0.0,90.0,90.0
3173271.0,6,18,1495,9,921,358394.125,315.0,102.33333333333331,9,574,358362.875,78.0,63.77777777777778
287139.0,17,2,331,1,75,0.0,75.0,75.0,1,256,0.0,256.0,256.0
108114329.0,17,5,1005,5,1005,27028582.25,201.0,201.0,0,0,0.0,0.0,0.0
90018460.0,17,28,13364,28,13364,3334017.037037037,501.0,477.2857142857143,0,0,0.0,0.0,0.0
26896.0,6,14,4740,7,653,3922.3333333333335,249.0,93.28571428571428,7,4087,3725.8333333333335,1514.0,583.8571428571429
1770775.0,6,2,132,1,66,0.0,66.0,66.0,1,66,0.0,66.0,66.0
51839.0,6,13,1459,7,862,6608.666666666667,271.0,123.14285714285714,6,597,10168.4,259.0,99.5
108979.0,17,4,1400,4,1400,36326.333333333336,350.0,350.0,0,0,0.0,0.0,0.0
29495.0,6,14,4740,7,653,4703.333333333333,249.0,93.28571428571428,7,4087,3999.5,1514.0,583.8571428571429
118279224.0,6,221,24934,111,7622,1075265.6727272726,140.0,68.66666666666667,110,17312,1075613.0733944955,284.0,157.38181818181818
205082.0,17,2,762,2,762,0.0,381.0,381.0,0,0,0.0,0.0,0.0
9021965.0,6,11,2106,6,598,1804170.0,252.0,99.66666666666669,5,1508,2750.25,1236.0,301.6
9701.0,17,2,539,1,86,0.0,86.0,86.0,1,453,0.0,453.0,453.0
121477.0,6,3,337,2,214,0.0,160.0,107.0,1,123,0.0,123.0,123.0
1303163.0,6,4,264,2,132,0.0,66.0,66.0,2,132,0.0,66.0,66.0
135140775.0,17,6,1146,6,1146,27028155.0,191.0,191.0,0,0,0.0,0.0,0.0
108351.0,17,2,286,2,286,0.0,143.0,143.0,0,0,0.0,0.0,0.0
32882.0,6,14,4740,7,653,5232.833333333333,249.0,93.28571428571428,7,4087,4877.666666666667,1514.0,583.8571428571429
40746.0,6,10,2032,5,524,9616.0,252.0,104.8,5,1508,9193.5,1236.0,301.6
331770.0,6,6,412,4,272,110590.0,74.0,68.0,2,140,0.0,74.0,70.0
147157.0,6,3,337,2,214,0.0,160.0,107.0,1,123,0.0,123.0,123.0
290.0,17,2,156,1,78,0.0,78.0,78.0,1,78,0.0,78.0,78.0
120231779.0,6,26,1978,12,935,10908376.909090908,95.0,77.91666666666667,14,1043,9229998.23076923,95.0,74.5
55441.0,6,14,4740,7,653,9123.5,249.0,93.28571428571428,7,4087,7670.166666666667,1514.0,583.8571428571429
44147.0,6,10,2032,5,524,10727.0,252.0,104.8,5,1508,10157.5,1236.0,301.6
90013746.0,17,28,13364,28,13364,3333842.4444444445,501.0,477.2857142857143,0,0,0.0,0.0,0.0
101417169.0,6,856,196870,432,168146,235306.656612529,1514.0,389.2268518518519,424,28724,239208.36406619384,214.0,67.74528301886792
104768988.0,17,15,5130,15,5130,7483499.142857143,342.0,342.0,0,0,0.0,0.0,0.0
2428.0,17,4,344,2,150,0.0,75.0,75.0,2,194,0.0,103.0,97.0
0.0,17,1,44,1,44,0.0,44.0,44.0,0,0,0.0,0.0,0.0
298248.0,6,6,412,4,272,99416.0,74.0,68.0,2,140,0.0,74.0,70.0
3147453.0,6,3,1777,2,951,0.0,885.0,475.5,1,826,0.0,826.0,826.0
323247.0,17,4,1400,4,1400,107749.0,350.0,350.0,0,0,0.0,0.0,0.0
108100622.0,17,5,1005,5,1005,27025155.5,201.0,201.0,0,0,0.0,0.0,0.0
120199092.0,6,23,1734,11,840,11999443.8,95.0,76.36363636363636,12,894,10908585.545454543,95.0,74.5
10754.0,17,4,344,2,150,0.0,75.0,75.0,2,194,0.0,103.0,97.0
231151.0,6,10,1221,6,636,46230.2,298.0,106.0,4,585,75755.33333333333,379.0,146.25
211357.0,17,2,180,1,90,0.0,90.0,90.0,1,90,0.0,90.0,90.0
42431.0,6,10,2032,5,524,10355.75,252.0,104.8,5,1508,9676.5,1236.0,301.6
107469.0,17,2,286,2,286,0.0,143.0,143.0,0,0,0.0,0.0,0.0
204935.0,17,2,762,2,762,0.0,381.0,381.0,0,0,0.0,0.0,0.0
99087.0,17,2,762,2,762,0.0,381.0,381.0,0,0,0.0,0.0,0.0
1317655.0,6,4,264,2,132,0.0,66.0,66.0,2,132,0.0,66.0,66.0
540017.0,17,6,2100,6,2100,108003.4,350.0,350.0,0,0,0.0,0.0,0.0
235357.0,6,3,337,2,214,0.0,160.0,107.0,1,123,0.0,123.0,123.0
309213.0,6,6,412,4,272,103071.0,74.0,68.0,2,140,0.0,74.0,70.0
240529.0,6,13,1394,7,797,40088.16666666666,253.0,113.85714285714286,6,597,46143.4,259.0,99.5
227544.0,6,10,1221,6,636,45508.8,298.0,106.0,4,585,68399.33333333333,379.0,146.25
245232.0,6,3,373,2,238,0.0,172.0,119.0,1,135,0.0,135.0,135.0
0.0,17,1,72,1,72,0.0,72.0,72.0,0,0,0.0,0.0,0.0
171786.0,17,2,180,1,90,0.0,90.0,90.0,1,90,0.0,90.0,90.0
3053483.0,6,116,96409,70,89071,44253.3768115942,1510.0,1272.442857142857,46,7338,60907.64444444444,1510.0,159.52173913043478
2000.0,17,4,344,2,150,0.0,75.0,75.0,2,194,0.0,103.0,97.0
90044359.0,17,27,12943,27,12943,3463244.576923077,501.0,479.3703703703704,0,0,0.0,0.0,0.0
120056008.0,17,28,13364,28,13364,4446518.814814814,501.0,477.2857142857143,0,0,0.0,0.0,0.0
90045480.0,17,27,12943,27,12943,3463287.6923076925,501.0,479.3703703703704,0,0,0.0,0.0,0.0
140679.0,6,2,132,1,66,0.0,66.0,66.0,1,66,0.0,66.0,66.0
40740.0,6,14,4740,7,653,6551.666666666667,249.0,93.28571428571428,7,4087,5952.0,1514.0,583.8571428571429
48784.0,6,14,4740,7,653,7507.333333333333,249.0,93.28571428571428,7,4087,7852.333333333333,1514.0,583.8571428571429
78.0,17,2,762,2,762,0.0,381.0,381.0,0,0,0.0,0.0,0.0
308853.0,6,6,412,4,272,102951.0,74.0,68.0,2,140,0.0,74.0,70.0
301203.0,6,6,412,4,272,100401.0,74.0,68.0,2,140,0.0,74.0,70.0
2359.0,17,4,344,2,150,0.0,75.0,75.0,2,194,0.0,103.0,97.0
732.0,17,4,438,2,148,0.0,74.0,74.0,2,290,0.0,147.0,145.0
13529.0,6,11,1131,6,600,2415.6,262.0,100.0,5,531,3159.0,259.0,106.2
2713.0,17,4,344,2,150,0.0,75.0,75.0,2,194,0.0,103.0,97.0
234032.0,6,3,337,2,214,0.0,160.0,107.0,1,123,0.0,123.0,123.0
135062586.0,17,6,1206,6,1206,27012517.2,201.0,201.0,0,0,0.0,0.0,0.0
20420.0,6,10,1065,5,534,4780.75,262.0,106.8,5,531,2775.5,259.0,106.2
326.0,17,2,174,1,79,0.0,79.0,79.0,1,95,0.0,95.0,95.0
313314.0,6,6,412,4,272,104438.0,74.0,68.0,2,140,0.0,74.0,70.0
160270.0,6,2,128,1,74,0.0,74.0,74.0,1,54,0.0,54.0,54.0
135136211.0,17,6,1206,6,1206,27027242.2,201.0,201.0,0,0,0.0,0.0,0.0
90528092.0,6,15,2444,8,1016,12932584.57142857,188.0,127.0,7,1428,15060716.5,204.0,204.0
42001.0,6,14,4740,7,653,6619.333333333333,249.0,93.28571428571428,7,4087,6743.333333333333,1514.0,583.8571428571429
15383.0,6,14,4740,7,653,2312.833333333333,249.0,93.28571428571428,7,4087,2427.833333333333,1514.0,583.8571428571429
4335.0,17,2,598,1,72,0.0,72.0,72.0,1,526,0.0,526.0,526.0
213742.0,6,10,1221,6,636,42748.4,298.0,106.0,4,585,69882.0,379.0,146.25
18659.0,6,14,4740,7,653,2852.0,249.0,93.28571428571428,7,4087,2975.6666666666665,1514.0,583.8571428571429
304718.0,6,3,202,2,128,0.0,74.0,64.0,1,74,0.0,74.0,74.0
26501.0,6,14,4740,7,653,4227.5,249.0,93.28571428571428,7,4087,4271.666666666667,1514.0,583.8571428571429
871821.0,6,5,1742,3,921,435910.5,785.0,307.0,2,821,0.0,753.0,410.5
146198.0,6,3,337,2,214,0.0,160.0,107.0,1,123,0.0,123.0,123.0
103633902.0,6,28,1876,14,982,7955220.923076923,139.0,70.14285714285714,14,894,7954861.076923077,123.0,63.85714285714285
112101425.0,6,41,3132,21,1638,5594267.35,123.0,78.0,20,1494,5888704.368421053,123.0,74.7
2592054.0,6,2,132,1,66,0.0,66.0,66.0,1,66,0.0,66.0,66.0
10586671.0,6,7,478,4,272,3468425.0,74.0,68.0,3,206,5202545.0,74.0,68.66666666666667
108107289.0,17,5,955,5,955,27026822.25,191.0,191.0,0,0,0.0,0.0,0.0
34837.0,6,14,4740,7,653,5626.833333333333,249.0,93.28571428571428,7,4087,4218.166666666667,1514.0,583.8571428571429
101466228.0,17,14,864,7,432,16834582.166666668,174.0,61.71428571428572,7,432,16833636.5,174.0,61.71428571428572
522.0,17,2,267,1,83,0.0,83.0,83.0,1,184,0.0,184.0,184.0
501025.00000000006,6,5,336,2,134,0.0,68.0,67.0,3,202,192204.5,70.0,67.33333333333333
562.0,17,2,166,1,75,0.0,75.0,75.0,1,91,0.0,91.0,91.0
317650.0,6,6,412,4,272,105883.33333333331,74.0,68.0,2,140,0.0,74.0,70.0
5744.0,17,4,823,2,163,0.0,89.0,81.5,2,660,0.0,443.0,330.0
233462.0,6,3,337,2,214,0.0,160.0,107.0,1,123,0.0,123.0,123.0
123456233.0,6,49,3234,25,1650,5144009.708333333,66.0,66.0,24,1584,4932844.478260869,66.0,66.0
257112.0,6,3,337,2,214,0.0,160.0,107.0,1,123,0.0,123.0,123.0
14336139.0,6,20,1607,10,975,1558478.888888889,315.0,97.5,10,632,1558443.6666666667,78.0,63.2
115528997.0,6,48,3168,24,1584,5022999.869565218,66.0,66.0,24,1584,5009576.0869565215,66.0,66.0
44965.0,6,14,4740,7,653,7371.833333333333,249.0,93.28571428571428,7,4087,6839.333333333333,1514.0,583.8571428571429
227070.0,17,2,180,1,90,0.0,90.0,90.0,1,90,0.0,90.0,90.0
107313.0,17,2,286,2,286,0.0,143.0,143.0,0,0,0.0,0.0,0.0
321.0,17,2,174,1,79,0.0,79.0,79.0,1,95,0.0,95.0,95.0
305228.0,6,6,412,4,272,101742.66666666669,74.0,68.0,2,140,0.0,74.0,70.0
9041.0,17,4,823,2,163,0.0,89.0,81.5,2,660,0.0,443.0,330.0
119704880.0,17,35,16705,35,16705,3520731.7647058824,501.0,477.2857142857143,0,0,0.0,0.0,0.0
28053.0,6,14,4740,7,653,4548.0,249.0,93.28571428571428,7,4087,4456.0,1514.0,583.8571428571429
90261713.0,6,13,2036,8,1016,12894530.42857143,188.0,127.0,5,1020,22524008.0,204.0,204.0
20587.0,6,14,4740,7,653,3260.1666666666665,249.0,93.28571428571428,7,4087,3287.5,1514.0,583.8571428571429
299659.0,6,6,412,4,272,99886.33333333331,74.0,68.0,2,140,0.0,74.0,70.0
316005.0,6,6,412,4,272,105335.0,74.0,68.0,2,140,0.0,74.0,70.0
10529288.0,6,7,478,4,272,3462505.333333333,74.0,68.0,3,206,5193656.0,74.0,68.66666666666667
120007172.0,6,18,1341,9,691,14999997.875,95.0,76.77777777777777,9,650,14999991.25,95.0,72.22222222222223
197019.0,17,2,180,1,90,0.0,90.0,90.0,1,90,0.0,90.0,90.0
234363.0,6,3,337,2,214,0.0,160.0,107.0,1,123,0.0,123.0,123.0
284676.0,17,2,363,1,79,0.0,79.0,79.0,1,284,0.0,284.0,284.0
46791449.0,6,8,1940,3,887,22191741.0,753.0,295.6666666666667,5,1053,11003150.0,785.0,210.6
113649957.0,6,46,3036,23,1518,5165894.954545454,66.0,66.0,23,1518,5165895.181818182,66.0,66.0
143874.0,17,2,180,1,90,0.0,90.0,90.0,1,90,0.0,90.0,90.0
54789.0,6,14,4740,7,653,8927.5,249.0,93.28571428571428,7,4087,7514.833333333333,1514.0,583.8571428571429
136012231.0,17,17,1517,9,780,17001528.875,174.0,86.66666666666667,8,737,16369242.0,174.0,92.125
300226.0,6,6,412,4,272,100075.33333333331,74.0,68.0,2,140,0.0,74.0,70.0
40012.0,6,14,4740,7,653,6153.666666666667,249.0,93.28571428571428,7,4087,6049.833333333333,1514.0,583.8571428571429
0.0,17,1,55,1,55,0.0,55.0,55.0,0,0,0.0,0.0,0.0
108104544.0,17,5,1005,5,1005,27026136.0,201.0,201.0,0,0,0.0,0.0,0.0
2086118.0,6,19,6869,10,1501,231790.88888888888,408.0,150.1,9,5368,211860.625,1514.0,596.4444444444445
120004183.0,6,24,1829,13,989,10000348.583333334,95.0,76.07692307692308,11,840,11975558.1,95.0,76.36363636363636
142875.0,17,2,192,1,88,0.0,88.0,88.0,1,104,0.0,104.0,104.0
35063.0,6,14,4740,7,653,5710.166666666667,249.0,93.28571428571428,7,4087,5540.666666666667,1514.0,583.8571428571429
143873.0,17,2,180,1,90,0.0,90.0,90.0,1,90,0.0,90.0,90.0
38368.0,6,10,2032,5,524,8290.0,252.0,104.8,5,1508,8668.75,1236.0,301.6
7109519.0,17,4,604,2,143,0.0,75.0,71.5,2,461,0.0,234.0,230.5
1302323.0,6,4,264,2,132,0.0,66.0,66.0,2,132,0.0,66.0,66.0
24998.0,17,2,180,1,90,0.0,90.0,90.0,1,90,0.0,90.0,90.0
214830.0,6,3,426,2,280,0.0,214.0,140.0,1,146,0.0,146.0,146.0
367044.0,17,2,363,1,75,0.0,75.0,75.0,1,288,0.0,288.0,288.0
204879.0,17,2,180,1,90,0.0,90.0,90.0,1,90,0.0,90.0,90.0
120146626.0,6,15,2290,9,1204,15018328.25,188.0,133.77777777777777,6,1086,18019550.4,204.0,181.0
35315.0,6,14,4740,7,653,5715.0,249.0,93.28571428571428,7,4087,5509.166666666667,1514.0,583.8571428571429
161017.0,17,2,180,1,90,0.0,90.0,90.0,1,90,0.0,90.0,90.0
120007823.0,6,24,1829,11,840,12000782.3,95.0,76.36363636363636,13,989,9978859.916666666,95.0,76.07692307692308
135129024.0,17,6,1146,6,1146,27025804.8,191.0,191.0,0,0,0.0,0.0,0.0
19039.0,6,10,2032,5,524,3905.5,252.0,104.8,5,1508,2981.25,1236.0,301.6
135140334.0,17,6,1146,6,1146,27028066.8,191.0,191.0,0,0,0.0,0.0,0.0
153455.0,17,2,180,1,90,0.0,90.0,90.0,1,90,0.0,90.0,90.0
33909.0,6,14,4740,7,653,5526.166666666667,249.0,93.28571428571428,7,4087,5515.166666666667,1514.0,583.8571428571429
210128.0,17,2,359,1,75,0.0,75.0,75.0,1,284,0.0,284.0,284.0
110006291.0,17,13,821,7,432,18334381.83333333,174.0,61.71428571428572,6,389,18000156.0,174.0,64.83333333333333
90041712.0,17,28,13364,28,13364,3334878.222222222,501.0,477.2857142857143,0,0,0.0,0.0,0.0
100000963.0,17,11,473,6,258,20000192.6,43.0,43.0,5,215,20000579.5,43.0,43.0
108095147.0,17,5,955,5,955,27023786.75,191.0,191.0,0,0,0.0,0.0,0.0
302356.0,6,6,412,4,272,100785.33333333331,74.0,68.0,2,140,0.0,74.0,70.0
153435.0,17,2,180,1,90,0.0,90.0,90.0,1,90,0.0,90.0,90.0
14833.0,6,14,4740,7,653,2262.833333333333,249.0,93.28571428571428,7,4087,2328.6666666666665,1514.0,583.8571428571429
216457.0,17,2,180,1,90,0.0,90.0,90.0,1,90,0.0,90.0,90.0
41954.0,6,14,4740,7,653,6609.166666666667,249.0,93.28571428571428,7,4087,6104.666666666667,1514.0,583.8571428571429
205869.0,17,2,180,1,90,0.0,90.0,90.0,1,90,0.0,90.0,90.0
108708956.0,6,33,2428,17,1288,6780808.1875,139.0,75.76470588235294,16,1140,7232862.866666666,123.0,71.25
139864.0,6,11,1132,6,556,27972.8,218.0,92.66666666666669,5,576,34442.75,304.0,115.2
3193.0,17,2,224,1,76,0.0,76.0,76.0,1,148,0.0,148.0,148.0
122314543.0,6,48,3168,24,1584,5124569.695652174,66.0,66.0,24,1584,5083182.956521739,66.0,66.0
1307996.0,17,7,490,7,490,217999.3333333333,70.0,70.0,0,0,0.0,0.0,0.0
10487737.0,6,7,478,4,272,3448834.6666666665,74.0,68.0,3,206,5173129.5,74.0,68.66666666666667
841255.0,6,9,1196,6,725,168251.0,387.0,120.83333333333331,3,471,283601.0,331.0,157.0
201632.0,17,4,6056,4,6056,67210.66666666667,1514.0,1514.0,0,0,0.0,0.0,0.0
933486.0,6,12,1447,6,816,184441.6,291.0,136.0,6,631,184685.4,293.0,105.16666666666669
90256386.0,6,16,2140,8,1080,12893769.42857143,204.0,135.0,8,1060,12870395.857142856,199.0,132.5
111112611.0,17,14,864,7,432,18505902.83333333,174.0,61.71428571428572,7,432,18500204.33333333,174.0,61.71428571428572
56010.0,6,14,4740,7,653,8296.666666666666,249.0,93.28571428571428,7,4087,9160.333333333334,1514.0,583.8571428571429
120013046.0,17,29,13785,29,13785,4286180.214285715,501.0,475.3448275862069,0,0,0.0,0.0,0.0
0.0,17,1,90,1,90,0.0,90.0,90.0,0,0,0.0,0.0,0.0
108102600.0,17,5,955,5,955,27025650.0,191.0,191.0,0,0,0.0,0.0,0.0
15027031.0,17,6,2718,6,2718,3005406.2,453.0,453.0,0,0,0.0,0.0,0.0
343.0,17,2,174,1,79,0.0,79.0,79.0,1,95,0.0,95.0,95.0
246418.0,6,3,373,2,238,0.0,172.0,119.0,1,135,0.0,135.0,135.0
198936.0,17,2,180,1,90,0.0,90.0,90.0,1,90,0.0,90.0,90.0
90178084.0,6,27,3322,13,1453,7497780.333333333,359.0,111.76923076923076,14,1869,6921034.923076923,423.0,133.5
0.0,6,1,172,1,172,0.0,172.0,172.0,0,0,0.0,0.0,0.0
28114.0,6,10,2032,5,524,6589.5,252.0,104.8,5,1508,6622.5,1236.0,301.6
129229114.0,17,15,907,7,432,18333500.5,174.0,61.71428571428572,8,475,18429984.285714287,174.0,59.375
20249402.0,6,388,369875,106,7153,192851.44761904763,203.0,67.48113207547169,282,362722,72035.46263345196,1514.0,1286.2482269503546
228303.0,17,2,180,1,90,0.0,90.0,90.0,1,90,0.0,90.0,90.0
865669.0,6,10,1333,6,796,173133.8,458.0,132.66666666666666,4,537,197695.66666666663,331.0,134.25
5624073.0,6,5,336,2,134,0.0,68.0,67.0,3,202,1523877.0,70.0,67.33333333333333
4173.0,17,4,344,2,150,0.0,75.0,75.0,2,194,0.0,103.0,97.0
121859.0,6,3,373,2,238,0.0,172.0,119.0,1,135,0.0,135.0,135.0
2038.0,17,4,344,2,150,0.0,75.0,75.0,2,194,0.0,103.0,97.0
298382.0,6,6,412,4,272,99460.66666666669,74.0,68.0,2,140,0.0,74.0,70.0
106604.0,17,2,286,2,286,0.0,143.0,143.0,0,0,0.0,0.0,0.0
1897.0,17,2,691,1,349,0.0,349.0,349.0,1,342,0.0,342.0,342.0
216528.0,17,2,180,1,90,0.0,90.0,90.0,1,90,0.0,90.0,90.0
512765.0,6,5,336,2,134,0.0,68.0,67.0,3,202,195222.5,70.0,67.33333333333333
199970.0,17,2,762,2,762,0.0,381.0,381.0,0,0,0.0,0.0,0.0
14629306.0,6,20,1607,10,975,1592134.5555555555,315.0,97.5,10,632,1592102.7777777778,78.0,63.2
2412.0,17,4,344,2,150,0.0,75.0,75.0,2,194,0.0,103.0,97.0
222162.0,6,10,1221,6,636,44432.4,298.0,106.0,4,585,71805.33333333333,379.0,146.25
297929.0,6,6,412,4,272,99309.66666666669,74.0,68.0,2,140,0.0,74.0,70.0
20583.0,6,13,1459,7,862,2862.833333333333,271.0,123.14285714285714,6,597,3791.2,259.0,99.5
316916.0,17,4,1400,4,1400,105638.66666666669,350.0,350.0,0,0,0.0,0.0,0.0
166617.0,17,2,180,1,90,0.0,90.0,90.0,1,90,0.0,90.0,90.0
107889.0,17,2,286,2,286,0.0,143.0,143.0,0,0,0.0,0.0,0.0
96527254.0,6,28,2061,15,1152,6894803.857142857,123.0,76.8,13,909,8003950.333333333,123.0,69.92307692307692
114630160.0,6,47,3102,24,1584,4970550.652173913,66.0,66.0,23,1518,5150438.0,66.0,66.0
35177.0,6,13,1479,7,882,5862.833333333333,291.0,126.0,6,597,5028.4,259.0,99.5
116576876.0,6,216,24440,108,17090,1087492.2803738315,284.0,158.24074074074073,108,7350,1087492.3644859814,140.0,68.05555555555556
3743.0,17,2,414,1,88,0.0,88.0,88.0,1,326,0.0,326.0,326.0
112979928.0,6,45,2970,23,1518,5135451.2727272725,66.0,66.0,22,1452,5196850.476190476,66.0,66.0
3434.0,17,2,346,1,78,0.0,78.0,78.0,1,268,0.0,268.0,268.0
110746.0,17,4,1400,4,1400,36915.333333333336,350.0,350.0,0,0,0.0,0.0,0.0
46205.0,6,10,2032,5,524,11345.25,252.0,104.8,5,1508,10183.25,1236.0,301.6
302574.0,6,6,412,4,272,100858.0,74.0,68.0,2,140,0.0,74.0,70.0
23253.0,6,14,4740,7,653,2269.1666666666665,249.0,93.28571428571428,7,4087,3709.6666666666665,1514.0,583.8571428571429
343.0,17,2,160,1,80,0.0,80.0,80.0,1,80,0.0,80.0,80.0
218470.0,6,3,426,2,280,0.0,214.0,140.0,1,146,0.0,146.0,146.0
28989.0,6,14,4740,7,653,4406.666666666667,249.0,93.28571428571428,7,4087,4693.0,1514.0,583.8571428571429
45003.0,6,14,4740,7,653,7273.833333333333,249.0,93.28571428571428,7,4087,6735.833333333333,1514.0,583.8571428571429
5040.0,17,4,344,2,150,0.0,75.0,75.0,2,194,0.0,103.0,97.0
37691.0,6,14,4740,7,653,5994.166666666667,249.0,93.28571428571428,7,4087,5964.0,1514.0,583.8571428571429
0.0,17,1,381,1,381,0.0,381.0,381.0,0,0,0.0,0.0,0.0
319.0,17,2,174,1,79,0.0,79.0,79.0,1,95,0.0,95.0,95.0
4347.0,17,2,614,1,72,0.0,72.0,72.0,1,542,0.0,542.0,542.0
305456.0,6,6,412,4,272,101818.66666666669,74.0,68.0,2,140,0.0,74.0,70.0
187045.0,17,4,704,2,148,0.0,74.0,74.0,2,556,0.0,280.0,278.0
123839725.0,6,48,3168,24,1584,5032015.913043479,66.0,66.0,24,1584,5265370.695652174,66.0,66.0
10457548.0,6,7,478,4,272,3440480.0,74.0,68.0,3,206,5160598.5,74.0,68.66666666666667
120000005.0,6,21,1626,12,935,10909091.363636363,95.0,77.91666666666667,9,691,11341737.5,95.0,76.77777777777777
209503.0,17,2,180,1,90,0.0,90.0,90.0,1,90,0.0,90.0,90.0
57087.0,6,14,4740,7,653,8498.833333333334,249.0,93.28571428571428,7,4087,9188.666666666666,1514.0,583.8571428571429
331555.0,6,6,412,4,272,110518.33333333331,74.0,68.0,2,140,0.0,74.0,70.0
105000917.0,17,13,821,7,432,17500152.833333332,174.0,61.71428571428572,6,389,17001442.0,174.0,64.83333333333333
57284.0,6,14,4740,7,653,9260.166666666666,249.0,93.28571428571428,7,4087,8908.833333333334,1514.0,583.8571428571429
1983.0,17,4,344,2,150,0.0,75.0,75.0,2,194,0.0,103.0,97.0
48342.0,6,10,2032,5,524,10181.75,252.0,104.8,5,1508,11802.25,1236.0,301.6
813.0,17,4,438,2,148,0.0,74.0,74.0,2,290,0.0,147.0,145.0
105866.0,17,2,700,2,700,0.0,350.0,350.0,0,0,0.0,0.0,0.0
100613465.0,17,14,1126,7,563,16666958.333333334,174.0,80.42857142857143,7,563,16666797.0,174.0,80.42857142857143
90053222.0,17,28,13364,28,13364,3335304.5185185187,501.0,477.2857142857143,0,0,0.0,0.0,0.0
107206048.0,6,38,3049,18,1455,6306238.117647059,123.0,80.83333333333333,20,1594,5630842.421052632,139.0,79.7
53707.0,6,14,4740,7,653,8833.833333333334,249.0,93.28571428571428,7,4087,7408.333333333333,1514.0,583.8571428571429
36872314.0,6,5,336,2,134,0.0,68.0,67.0,3,202,18321127.0,70.0,67.33333333333333
108105654.0,17,5,1005,5,1005,27026413.5,201.0,201.0,0,0,0.0,0.0,0.0
167977.0,17,4,1400,4,1400,55992.333333333336,350.0,350.0,0,0,0.0,0.0,0.0
120123680.0,6,15,2428,9,1204,15015460.0,188.0,133.77777777777777,6,1224,18031975.2,204.0,204.0
101887966.0,6,33,2428,17,1288,6354509.5,139.0,75.76470588235294,16,1140,6778138.333333333,123.0,71.25
312218.0,6,6,412,4,272,104072.66666666669,74.0,68.0,2,140,0.0,74.0,70.0
1075881.0,6,13,1386,7,789,179313.5,253.0,112.71428571428572,6,597,212398.0,259.0,99.5
373962.0,6,10,1221,6,636,74792.4,298.0,106.0,4,585,123459.0,379.0,146.25
110451968.0,17,14,864,7,432,18333532.0,174.0,61.71428571428572,7,432,18335169.166666668,174.0,61.71428571428572
90060543.0,17,28,13364,28,13364,3335575.6666666665,501.0,477.2857142857143,0,0,0.0,0.0,0.0
120000022.0,6,25,1924,14,1084,9230770.923076924,95.0,77.42857142857143,11,840,9142873.6,95.0,76.36363636363636
92787194.0,17,12,778,6,389,18400156.8,174.0,64.83333333333333,6,389,18402034.4,174.0,64.83333333333333
108113697.0,17,5,955,5,955,27028424.25,191.0,191.0,0,0,0.0,0.0,0.0
90003726.0,17,28,13364,28,13364,3333471.333333333,501.0,477.2857142857143,0,0,0.0,0.0,0.0
4561.0,17,2,614,1,72,0.0,72.0,72.0,1,542,0.0,542.0,542.0
120131513.0,6,14,2240,6,1224,24026302.6,204.0,204.0,8,1016,17136853.0,188.0,127.0
153494.0,17,2,180,1,90,0.0,90.0,90.0,1,90,0.0,90.0,90.0
324.0,17,2,166,1,75,0.0,75.0,75.0,1,91,0.0,91.0,91.0
106446950.0,6,28,1860,14,966,8171623.307692308,123.0,69.0,14,894,8171625.692307692,123.0,63.85714285714285
13935.0,6,11,2098,6,590,2625.0,252.0,98.33333333333331,5,1508,3208.0,1236.0,301.6
44557.0,6,14,4740,7,653,7254.166666666667,249.0,93.28571428571428,7,4087,6703.0,1514.0,583.8571428571429
232934.0,6,3,337,2,214,0.0,160.0,107.0,1,123,0.0,123.0,123.0
393.0,17,2,508,2,508,0.0,257.0,254.0,0,0,0.0,0.0,0.0
228304.0,17,2,180,1,90,0.0,90.0,90.0,1,90,0.0,90.0,90.0
44641.0,6,14,4740,7,653,6398.5,249.0,93.28571428571428,7,4087,6820.833333333333,1514.0,583.8571428571429
5587.0,17,4,823,2,163,0.0,89.0,81.5,2,660,0.0,443.0,330.0
90508.0,6,10,2032,5,524,22387.25,252.0,104.8,5,1508,21472.75,1236.0,301.6
90255435.0,6,12,1832,8,1016,12893633.57142857,188.0,127.0,4,816,30030518.666666668,204.0,204.0
107994.0,17,2,286,2,286,0.0,143.0,143.0,0,0,0.0,0.0,0.0
108081010.0,17,5,955,5,955,27020252.5,191.0,191.0,0,0,0.0,0.0,0.0
295251.0,6,6,412,4,272,98417.0,74.0,68.0,2,140,0.0,74.0,70.0
103358.0,17,2,286,2,286,0.0,143.0,143.0,0,0,0.0,0.0,0.0
108104266.0,17,5,1005,5,1005,27026066.5,201.0,201.0,0,0,0.0,0.0,0.0
4440.0,17,2,602,1,72,0.0,72.0,72.0,1,530,0.0,530.0,530.0
79012.0,6,14,4740,7,653,10737.5,249.0,93.28571428571428,7,4087,12810.666666666666,1514.0,583.8571428571429
311287.0,17,4,1400,4,1400,103762.33333333331,350.0,350.0,0,0,0.0,0.0,0.0
90271598.0,6,16,2368,9,1204,11283949.75,188.0,133.77777777777777,7,1164,15018131.333333334,204.0,166.28571428571428
100980254.0,6,391,62398,196,49158,517847.4564102564,1514.0,250.8061224489796,195,13240,519287.3917525773,214.0,67.8974358974359
34832.0,6,10,2032,5,524,8283.25,252.0,104.8,5,1508,7777.75,1236.0,301.6
43027.0,6,14,4740,7,653,7022.166666666667,249.0,93.28571428571428,7,4087,6356.833333333333,1514.0,583.8571428571429
2019.0,17,4,344,2,150,0.0,75.0,75.0,2,194,0.0,103.0,97.0
2767250.0,6,3,1604,2,851,0.0,785.0,425.5,1,753,0.0,753.0,753.0
341.0,17,2,267,1,83,0.0,83.0,83.0,1,184,0.0,184.0,184.0
2325.0,17,4,344,2,150,0.0,75.0,75.0,2,194,0.0,103.0,97.0
830836.0,6,5,1742,3,921,415418.0,785.0,307.0,2,821,0.0,753.0,410.5
206285.0,6,3,426,2,280,0.0,214.0,140.0,1,146,0.0,146.0,146.0
153297.0,17,2,180,1,90,0.0,90.0,90.0,1,90,0.0,90.0,90.0
90278446.0,6,34,2736,16,1278,6018532.6,123.0,79.875,18,1458,5083784.705882353,123.0,81.0
36534.0,6,14,4740,7,653,5962.666666666667,249.0,93.28571428571428,7,4087,5916.666666666667,1514.0,583.8571428571429
246952.0,17,4,1524,4,1524,82317.33333333333,381.0,381.0,0,0,0.0,0.0,0.0
312477.0,17,4,1400,4,1400,104159.0,350.0,350.0,0,0,0.0,0.0,0.0
40206.0,6,14,4740,7,653,4784.5,249.0,93.28571428571428,7,4087,6569.333333333333,1514.0,583.8571428571429
2052574.0,17,6,1230,3,234,1026100.5,78.0,78.0,3,996,1026051.0,332.0,332.0
10456616.0,6,7,478,4,272,3440423.0,74.0,68.0,3,206,5160530.5,74.0,68.66666666666667
2593932.0,6,2,132,1,66,0.0,66.0,66.0,1,66,0.0,66.0,66.0
108775955.0,6,28,1860,14,966,8350789.923076923,123.0,69.0,14,894,8350786.384615385,123.0,63.85714285714285
190769.0,17,2,180,1,90,0.0,90.0,90.0,1,90,0.0,90.0,90.0
135126130.0,17,6,1146,6,1146,27025226.0,191.0,191.0,0,0,0.0,0.0,0.0
156350.0,17,2,180,1,90,0.0,90.0,90.0,1,90,0.0,90.0,90.0
2378.0,17,4,344,2,150,0.0,75.0,75.0,2,194,0.0,103.0,97.0
10475.0,17,4,823,2,163,0.0,89.0,81.5,2,660,0.0,443.0,330.0
218007.0,6,3,426,2,280,0.0,214.0,140.0,1,146,0.0,146.0,146.0
10515054.0,6,7,478,4,272,3459392.0,74.0,68.0,3,206,5188970.0,74.0,68.66666666666667
107524.0,17,2,286,2,286,0.0,143.0,143.0,0,0,0.0,0.0,0.0
146103.0,6,3,337,2,214,0.0,160.0,107.0,1,123,0.0,123.0,123.0
2463.0,17,4,344,2,150,0.0,75.0,75.0,2,194,0.0,103.0,97.0
90291947.0,6,18,1341,9,691,11286493.375,95.0,76.77777777777777,9,650,11249954.0,95.0,72.22222222222223
317994.0,6,6,412,4,272,105998.0,74.0,68.0,2,140,0.0,74.0,70.0
90098821.0,6,11,1644,4,816,30032170.666666668,204.0,204.0,7,828,15016069.0,188.0,118.28571428571428
111530.0,17,2,286,2,286,0.0,143.0,143.0,0,0,0.0,0.0,0.0
5610.0,17,5,550,5,550,1402.5,110.0,110.0,0,0,0.0,0.0,0.0
190966.0,17,2,180,1,90,0.0,90.0,90.0,1,90,0.0,90.0,90.0
1310188.0,17,7,490,7,490,218364.66666666663,70.0,70.0,0,0,0.0,0.0,0.0
153481.0,17,2,180,1,90,0.0,90.0,90.0,1,90,0.0,90.0,90.0
69529.0,6,10,2032,5,524,17156.75,252.0,104.8,5,1508,10103.5,1236.0,301.6
141084.0,6,2,132,1,66,0.0,66.0,66.0,1,66,0.0,66.0,66.0
209669.0,6,10,1221,6,636,41933.8,298.0,106.0,4,585,68035.33333333333,379.0,146.25
90528881.0,6,17,2572,9,1204,11316110.125,188.0,133.77777777777777,8,1368,12909522.57142857,204.0,171.0
1347825.0,6,22,6856,12,2989,122529.54545454546,1514.0,249.0833333333333,10,3867,125185.55555555556,1514.0,386.7
216477.0,17,2,180,1,90,0.0,90.0,90.0,1,90,0.0,90.0,90.0
10926934.0,6,8,544,4,272,3596750.6666666665,74.0,68.0,4,272,3596677.0,74.0,68.0
90331925.0,6,17,1287,9,691,11285002.5,95.0,76.77777777777777,8,596,12902824.57142857,95.0,74.5
31454.000000000004,6,14,4740,7,653,5104.833333333333,249.0,93.28571428571428,7,4087,5105.666666666667,1514.0,583.8571428571429
31499.0,6,13,1386,7,789,5249.833333333333,253.0,112.71428571428572,6,597,5588.2,259.0,99.5
833851.0,6,9,1118,6,586,166770.2,248.0,97.66666666666669,3,532,280641.5,392.0,177.33333333333334
306665.0,6,6,412,4,272,102221.66666666669,74.0,68.0,2,140,0.0,74.0,70.0
14425.0,6,11,1132,6,556,2485.8,218.0,92.66666666666669,5,576,3154.5,304.0,115.2
108106625.0,17,5,955,5,955,27026656.25,191.0,191.0,0,0,0.0,0.0,0.0
120127952.0,6,212,23996,106,7218,1136618.0952380951,140.0,68.09433962264151,106,16778,1136210.561904762,284.0,158.28301886792454
48362.0,6,14,4740,7,653,6970.333333333333,249.0,93.28571428571428,7,4087,7691.833333333333,1514.0,583.8571428571429
33601.0,6,10,2032,5,524,8194.0,252.0,104.8,5,1508,8051.75,1236.0,301.6
25891.0,6,13,1479,7,882,4315.166666666667,291.0,126.0,6,597,4608.6,259.0,99.5
320582.0,6,6,412,4,272,106860.66666666669,74.0,68.0,2,140,0.0,74.0,70.0
263901.0,6,3,337,2,214,0.0,160.0,107.0,1,123,0.0,123.0,123.0
90355499.0,6,11,1644,7,828,15059249.833333334,188.0,118.28571428571428,4,816,20110956.0,204.0,204.0
90739234.0,6,20,1531,11,840,9069783.6,95.0,76.36363636363636,9,691,11284267.625,95.0,76.77777777777777
34363.0,6,10,2032,5,524,8384.75,252.0,104.8,5,1508,8310.75,1236.0,301.6
2321.0,17,4,344,2,150,0.0,75.0,75.0,2,194,0.0,103.0,97.0
750.0,17,4,438,2,148,0.0,74.0,74.0,2,290,0.0,147.0,145.0
11334.0,6,10,1975,5,467,2488.25,195.0,93.4,5,1508,2360.5,1236.0,301.6
27879.0,6,14,4740,7,653,4336.833333333333,249.0,93.28571428571428,7,4087,3806.0,1514.0,583.8571428571429
310369.0,17,4,1400,4,1400,103456.33333333331,350.0,350.0,0,0,0.0,0.0,0.0
215264.0,17,2,180,1,90,0.0,90.0,90.0,1,90,0.0,90.0,90.0
46856.0,6,10,2032,5,524,11475.0,252.0,104.8,5,1508,11127.25,1236.0,301.6
40159.0,6,14,4740,7,653,6570.0,249.0,93.28571428571428,7,4087,6193.833333333333,1514.0,583.8571428571429
44845.0,6,14,4740,7,653,7352.5,249.0,93.28571428571428,7,4087,6001.666666666667,1514.0,583.8571428571429
108099145.0,17,5,1005,5,1005,27024786.25,201.0,201.0,0,0,0.0,0.0,0.0
269138.0,6,12,1373,7,714,44856.333333333336,298.0,102.0,5,659,62831.25,379.0,131.8
90025137.0,17,28,13364,28,13364,3334264.333333333,501.0,477.2857142857143,0,0,0.0,0.0,0.0
35160.0,6,14,4740,7,653,5378.833333333333,249.0,93.28571428571428,7,4087,5700.166666666667,1514.0,583.8571428571429
217278.0,6,10,1221,6,636,43455.6,298.0,106.0,4,585,71064.0,379.0,146.25
354.0,17,2,267,1,83,0.0,83.0,83.0,1,184,0.0,184.0,184.0
369.0,17,2,267,1,83,0.0,83.0,83.0,1,184,0.0,184.0,184.0
36598.0,6,10,1066,5,490,6237.5,218.0,98.0,5,576,8693.25,304.0,115.2
5624230.0,6,4,270,2,134,0.0,68.0,67.0,2,136,0.0,70.0,68.0
91155951.0,17,15,5130,15,5130,6511139.357142857,342.0,342.0,0,0,0.0,0.0,0.0
103670.0,17,2,762,2,762,0.0,381.0,381.0,0,0,0.0,0.0,0.0
2356.0,17,4,344,2,150,0.0,75.0,75.0,2,194,0.0,103.0,97.0
311086.0,6,6,412,4,272,103695.33333333331,74.0,68.0,2,140,0.0,74.0,70.0
146120.0,6,3,337,2,214,0.0,160.0,107.0,1,123,0.0,123.0,123.0
207144.0,17,2,762,2,762,0.0,381.0,381.0,0,0,0.0,0.0,0.0
90274740.0,6,13,2036,8,1016,12896391.42857143,188.0,127.0,5,1020,22527095.25,204.0,204.0
12822.0,6,10,2032,5,524,2944.0,252.0,104.8,5,1508,2899.5,1236.0,301.6
108068483.0,6,30,1990,15,1042,7703732.428571428,139.0,69.46666666666667,15,948,7703735.214285715,123.0,63.2
188013.0,6,10,1065,5,534,46768.75,262.0,106.8,5,531,2190.25,259.0,106.2
67021.0,6,14,4740,7,653,10290.166666666666,249.0,93.28571428571428,7,4087,10047.5,1514.0,583.8571428571429
49541.0,6,14,4740,7,653,7741.666666666667,249.0,93.28571428571428,7,4087,7990.0,1514.0,583.8571428571429
309773.0,6,7,478,4,272,103257.66666666669,74.0,68.0,3,206,78800.0,74.0,68.66666666666667
105043510.0,17,14,4788,14,4788,8080270.0,342.0,342.0,0,0,0.0,0.0,0.0
3888.0,17,2,762,2,762,0.0,381.0,381.0,0,0,0.0,0.0,0.0
123840034.0,6,49,3234,25,1650,5160001.416666667,66.0,66.0,24,1584,4952295.347826087,66.0,66.0
191168.0,17,2,180,1,90,0.0,90.0,90.0,1,90,0.0,90.0,90.0
121158657.0,6,47,3102,23,1518,5105434.590909091,66.0,66.0,24,1584,5258384.478260869,66.0,66.0
47137.0,6,13,1386,7,789,7856.166666666667,253.0,112.71428571428572,6,597,7268.8,259.0,99.5
2294.0,17,4,344,2,150,0.0,75.0,75.0,2,194,0.0,103.0,97.0
135142680.0,17,6,1146,6,1146,27028536.0,191.0,191.0,0,0,0.0,0.0,0.0
8007.999999999999,17,2,582,1,83,0.0,83.0,83.0,1,499,0.0,499.0,499.0
5625353.0,6,5,336,2,134,0.0,68.0,67.0,3,202,1423822.5,70.0,67.33333333333333
102896462.0,6,42,2772,21,1386,5144809.3,66.0,66.0,21,1386,5144808.65,66.0,66.0
205573.0,17,2,180,1,90,0.0,90.0,90.0,1,90,0.0,90.0,90.0
90013486.0,17,28,13364,28,13364,3333832.814814815,501.0,477.2857142857143,0,0,0.0,0.0,0.0
2334.0,17,4,344,2,150,0.0,75.0,75.0,2,194,0.0,103.0,97.0
109635192.0,6,42,3484,24,1960,4757367.608695652,139.0,81.66666666666667,18,1524,6436436.882352941,123.0,84.66666666666667
108098493.0,17,5,955,5,955,27024623.25,191.0,191.0,0,0,0.0,0.0,0.0
107717.0,17,2,286,2,286,0.0,143.0,143.0,0,0,0.0,0.0,0.0
14665390.0,6,20,1607,10,975,1592478.111111111,315.0,97.5,10,632,1592347.111111111,78.0,63.2
18363.0,6,14,4740,7,653,2842.833333333333,249.0,93.28571428571428,7,4087,2922.0,1514.0,583.8571428571429
233531.0,6,3,337,2,214,0.0,160.0,107.0,1,123,0.0,123.0,123.0
15037.0,6,11,1132,6,556,2952.8,218.0,92.66666666666669,5,576,3243.5,304.0,115.2
101000909.0,17,13,821,7,432,16833484.833333332,174.0,61.71428571428572,6,389,16200691.8,174.0,64.83333333333333
115725956.0,6,34,2350,17,1225,7219391.75,139.0,72.05882352941177,17,1125,7219207.3125,123.0,66.17647058823529
196883.0,17,2,180,1,90,0.0,90.0,90.0,1,90,0.0,90.0,90.0
1748444.0,6,23,6509,12,1529,158949.45454545456,357.0,127.41666666666669,11,4980,143824.9,1510.0,452.7272727272728
5725870.0,6,5,336,2,134,0.0,68.0,67.0,3,202,1472611.5,70.0,67.33333333333333
120026929.0,17,29,13785,29,13785,4286676.035714285,501.0,475.3448275862069,0,0,0.0,0.0,0.0
3859.0,17,4,344,2,150,0.0,75.0,75.0,2,194,0.0,103.0,97.0
113168228.0,6,46,3036,23,1518,5143998.681818182,66.0,66.0,23,1518,5143998.954545454,66.0,66.0
3557035.0,6,5,1736,2,819,0.0,753.0,409.5,3,917,1700903.5,785.0,305.6666666666667
2154.0,17,4,344,2,150,0.0,75.0,75.0,2,194,0.0,103.0,97.0
35118.0,6,10,2032,5,524,8415.25,252.0,104.8,5,1508,7897.75,1236.0,301.6
100568694.0,6,27,1885,14,963,7736053.384615385,123.0,68.78571428571429,13,922,8362610.833333333,139.0,70.92307692307692
143873.0,17,2,180,1,90,0.0,90.0,90.0,1,90,0.0,90.0,90.0
45911.0,6,10,2032,5,524,11235.25,252.0,104.8,5,1508,10177.5,1236.0,301.6
34330.0,6,14,4740,7,653,5546.833333333333,249.0,93.28571428571428,7,4087,4874.666666666667,1514.0,583.8571428571429
207188.0,6,3,426,2,280,0.0,214.0,140.0,1,146,0.0,146.0,146.0
327.0,17,2,208,1,72,0.0,72.0,72.0,1,136,0.0,136.0,136.0
90216788.0,6,19,1436,9,691,11246107.375,95.0,76.77777777777777,10,745,10000168.777777778,95.0,74.5
32168.000000000004,6,14,4740,7,653,3763.5,249.0,93.28571428571428,7,4087,5014.0,1514.0,583.8571428571429
1208290.0,17,7,490,7,490,201381.66666666663,70.0,70.0,0,0,0.0,0.0,0.0
228311.0,17,2,180,1,90,0.0,90.0,90.0,1,90,0.0,90.0,90.0
117105984.0,6,48,3168,24,1584,5091564.521739131,66.0,66.0,24,1584,5079713.739130435,66.0,66.0
96158855.0,6,56,11648,28,5909,3561439.074074074,1514.0,211.03571428571428,28,5739,3551736.851851852,1514.0,204.9642857142857
306613.0,6,6,412,4,272,102204.33333333331,74.0,68.0,2,140,0.0,74.0,70.0
104058405.0,17,10,900,5,450,25978636.25,90.0,90.0,5,450,25978605.75,90.0,90.0
110533225.0,6,31,2166,16,1149,7368881.666666667,123.0,71.8125,15,1017,7879644.214285715,123.0,67.8
113910379.0,6,29,1930,15,948,8136455.642857143,123.0,63.2,14,982,7977651.769230769,139.0,70.14285714285714
1298105.0,6,4,264,2,132,0.0,66.0,66.0,2,132,0.0,66.0,66.0
5623436.0,6,5,336,2,134,0.0,68.0,67.0,3,202,1420481.0,70.0,67.33333333333333
38621289.0,6,5,336,2,134,0.0,68.0,67.0,3,202,19240892.5,70.0,67.33333333333333
216773.0,6,3,426,2,280,0.0,214.0,140.0,1,146,0.0,146.0,146.0
106930.0,6,13,1420,7,789,17370.166666666668,253.0,112.71428571428572,6,631,20825.4,293.0,105.16666666666669
2340.0,17,2,762,2,762,0.0,381.0,381.0,0,0,0.0,0.0,0.0
1445689.0,17,16,1120,16,1120,96379.26666666666,70.0,70.0,0,0,0.0,0.0,0.0
95170051.0,6,174,19650,87,13686,1104127.511627907,284.0,157.31034482758622,87,5964,1104126.6860465116,140.0,68.55172413793103
30078.0,6,14,4740,7,653,3987.5,249.0,93.28571428571428,7,4087,4268.5,1514.0,583.8571428571429
143891.0,17,2,180,1,90,0.0,90.0,90.0,1,90,0.0,90.0,90.0
125700694.0,6,32,2220,16,1071,7714317.533333333,123.0,66.9375,16,1149,7714331.933333334,123.0,71.8125
108107516.0,17,5,955,5,955,27026879.0,191.0,191.0,0,0,0.0,0.0,0.0
2095.0,17,4,344,2,150,0.0,75.0,75.0,2,194,0.0,103.0,97.0
216357.0,17,2,180,1,90,0.0,90.0,90.0,1,90,0.0,90.0,90.0
17436056.0,6,24,8675,14,1785,1341235.076923077,408.0,127.5,10,6890,1479844.0,1514.0,689.0
0.0,17,1,90,1,90,0.0,90.0,90.0,0,0,0.0,0.0,0.0
90261226.0,6,13,1898,8,1016,12894460.857142856,188.0,127.0,5,882,22524983.75,204.0,176.4
51539.0,6,14,4740,7,653,8211.0,249.0,93.28571428571428,7,4087,7823.666666666667,1514.0,583.8571428571429
71500.0,6,19,7540,11,978,7150.0,310.0,88.9090909090909,8,6562,2561.8571428571427,1514.0,820.25
91434283.0,6,28,2008,14,1045,7033406.384615385,139.0,74.64285714285714,14,963,7016754.923076923,123.0,68.78571428571429
319245.0,6,6,412,4,272,106415.0,74.0,68.0,2,140,0.0,74.0,70.0
1303928.0,6,4,264,2,132,0.0,66.0,66.0,2,132,0.0,66.0,66.0
300140.0,17,4,1400,4,1400,100046.66666666669,350.0,350.0,0,0,0.0,0.0,0.0
344.0,17,2,250,1,93,0.0,93.0,93.0,1,157,0.0,157.0,157.0
207612.0,6,3,426,2,280,0.0,214.0,140.0,1,146,0.0,146.0,146.0
608603.0,6,4,508,2,238,0.0,172.0,119.0,2,270,0.0,135.0,135.0
22714.0,6,10,2032,5,524,5308.25,252.0,104.8,5,1508,5421.25,1236.0,301.6
78597.0,6,14,4740,7,653,12973.0,249.0,93.28571428571428,7,4087,12576.5,1514.0,583.8571428571429
137942.0,6,2,132,1,66,0.0,66.0,66.0,1,66,0.0,66.0,66.0
9620.0,17,2,582,1,83,0.0,83.0,83.0,1,499,0.0,499.0,499.0
1296057.0,17,7,490,7,490,216009.5,70.0,70.0,0,0,0.0,0.0,0.0
147441.0,6,10,1066,5,490,35792.25,218.0,98.0,5,576,36660.0,304.0,115.2
196966.0,17,2,180,1,90,0.0,90.0,90.0,1,90,0.0,90.0,90.0
29114.0,6,14,4740,7,653,3670.1666666666665,249.0,93.28571428571428,7,4087,4609.666666666667,1514.0,583.8571428571429
108105294.0,17,5,1005,5,1005,27026323.5,201.0,201.0,0,0,0.0,0.0,0.0
217879.0,6,3,426,2,280,0.0,214.0,140.0,1,146,0.0,146.0,146.0
5005216.0,17,4,629,2,156,0.0,78.0,78.0,2,473,0.0,268.0,236.5
144100.0,17,2,180,1,90,0.0,90.0,90.0,1,90,0.0,90.0,90.0
197113.0,17,2,180,1,90,0.0,90.0,90.0,1,90,0.0,90.0,90.0
308143.0,6,6,412,4,272,102714.33333333331,74.0,68.0,2,140,0.0,74.0,70.0
105313.0,17,4,1400,4,1400,35104.333333333336,350.0,350.0,0,0,0.0,0.0,0.0
90979535.0,6,23,1734,13,989,7577848.666666667,95.0,76.07692307692308,10,745,10104169.333333334,95.0,74.5
103692.0,17,2,286,2,286,0.0,143.0,143.0,0,0,0.0,0.0,0.0
4239.0,17,2,626,1,72,0.0,72.0,72.0,1,554,0.0,554.0,554.0
23813.0,6,10,2032,5,524,5557.5,252.0,104.8,5,1508,5690.75,1236.0,301.6
10436587.0,6,6,412,3,206,5150091.5,74.0,68.66666666666667,3,206,5149997.5,74.0,68.66666666666667
92288513.0,17,16,5472,16,5472,6152567.533333333,342.0,342.0,0,0,0.0,0.0,0.0
108108445.0,17,5,1005,5,1005,27027111.25,201.0,201.0,0,0,0.0,0.0,0.0
193052.0,17,2,180,1,90,0.0,90.0,90.0,1,90,0.0,90.0,90.0
90087318.0,6,10,1440,7,828,15014553.0,188.0,118.28571428571428,3,612,30030535.5,204.0,204.0
233068.0,6,3,337,2,214,0.0,160.0,107.0,1,123,0.0,123.0,123.0
1044778.0,6,11,1134,6,558,208955.6,220.0,93.0,5,576,256756.0,304.0,115.2
90756266.0,6,19,1436,10,745,10079456.444444444,95.0,74.5,9,691,11344074.625,95.0,76.77777777777777
2438.0,17,4,344,2,150,0.0,75.0,75.0,2,194,0.0,103.0,97.0
169823.0,17,4,1524,4,1524,56607.66666666666,381.0,381.0,0,0,0.0,0.0,0.0
90047358.0,17,28,13364,28,13364,3335087.333333333,501.0,477.2857142857143,0,0,0.0,0.0,0.0
300077.0,6,6,412,4,272,100025.66666666669,74.0,68.0,2,140,0.0,74.0,70.0
135131379.0,17,6,1146,6,1146,27026275.8,191.0,191.0,0,0,0.0,0.0,0.0
0.0,17,1,55,1,55,0.0,55.0,55.0,0,0,0.0,0.0,0.0
28960.0,6,10,2032,5,524,7023.0,252.0,104.8,5,1508,5015.5,1236.0,301.6
92592001.0,6,38,2508,19,1254,5143985.611111111,66.0,66.0,19,1254,5143986.388888889,66.0,66.0
4239.0,17,2,614,1,72,0.0,72.0,72.0,1,542,0.0,542.0,542.0
10521951.0,6,7,478,4,272,3461368.0,74.0,68.0,3,206,5191924.5,74.0,68.66666666666667
29727.0,6,14,4740,7,653,4173.166666666667,249.0,93.28571428571428,7,4087,4735.666666666667,1514.0,583.8571428571429
260144.0,6,10,1221,6,636,52028.8,298.0,106.0,4,585,81337.33333333333,379.0,146.25
34154.0,6,14,4740,7,653,5445.5,249.0,93.28571428571428,7,4087,5504.5,1514.0,583.8571428571429
4603474.0,6,5,336,2,134,0.0,68.0,67.0,3,202,1526080.0,70.0,67.33333333333333
104419.0,17,2,286,2,286,0.0,143.0,143.0,0,0,0.0,0.0,0.0
135128614.0,17,6,1146,6,1146,27025722.8,191.0,191.0,0,0,0.0,0.0,0.0
90305388.0,6,19,1436,10,745,10028768.444444444,95.0,74.5,9,691,11286474.75,95.0,76.77777777777777
43025.0,6,14,4740,7,653,7050.0,249.0,93.28571428571428,7,4087,6995.0,1514.0,583.8571428571429
304740.0,6,6,412,4,272,101580.0,74.0,68.0,2,140,0.0,74.0,70.0
121338.0,6,3,337,2,214,0.0,160.0,107.0,1,123,0.0,123.0,123.0
206468.0,6,3,426,2,280,0.0,214.0,140.0,1,146,0.0,146.0,146.0
204634.0,17,2,762,2,762,0.0,381.0,381.0,0,0,0.0,0.0,0.0
232938.0,6,3,337,2,214,0.0,160.0,107.0,1,123,0.0,123.0,123.0
149052604.0,6,24,1829,14,1084,11465584.923076924,95.0,77.42857142857143,10,745,13260141.222222222,95.0,74.5
43084.0,6,14,4740,7,653,6717.0,249.0,93.28571428571428,7,4087,6817.0,1514.0,583.8571428571429
97825407.0,17,14,4796,13,4446,6227893.25,342.0,342.0,1,350,0.0,350.0,350.0
317331.0,17,4,1400,4,1400,105777.0,350.0,350.0,0,0,0.0,0.0,0.0
406551.0,17,2,363,1,75,0.0,75.0,75.0,1,288,0.0,288.0,288.0
216388.0,6,3,426,2,280,0.0,214.0,140.0,1,146,0.0,146.0,146.0
212690.0,17,2,180,1,90,0.0,90.0,90.0,1,90,0.0,90.0,90.0
331.0,17,2,166,1,75,0.0,75.0,75.0,1,91,0.0,91.0,91.0
2477435.0,6,3,1602,2,850,0.0,784.0,425.0,1,752,0.0,752.0,752.0
115855496.0,6,35,2542,18,1348,6815029.176470588,139.0,74.88888888888889,17,1194,7227441.5,123.0,70.23529411764706
1024558.0,6,11,1134,6,558,204911.60000000003,220.0,93.0,5,576,254725.25,304.0,115.2
113393963.0,6,574,108276,292,89208,388930.1718213058,1514.0,305.5068493150685,282,19068,402771.1992882562,214.0,67.61702127659575
93917868.0,6,187,21064,94,6352,1009869.5483870968,140.0,67.57446808510639,93,14712,1009692.0434782607,284.0,158.19354838709677
90007927.0,6,23,1734,13,989,7500660.583333333,95.0,76.07692307692308,10,745,9948068.777777778,95.0,74.5
90806766.0,6,175,19806,88,13842,1043755.9310344828,284.0,157.29545454545453,87,5964,1043857.046511628,140.0,68.55172413793103
1021758.0,6,13,1428,7,797,169418.16666666666,253.0,113.85714285714286,6,631,203401.6,293.0,105.16666666666669
90045891.0,17,28,13364,28,13364,3335033.0,501.0,477.2857142857143,0,0,0.0,0.0,0.0
4727.0,17,2,598,1,72,0.0,72.0,72.0,1,526,0.0,526.0,526.0
33918.0,6,10,2032,5,524,8007.0,252.0,104.8,5,1508,8044.0,1236.0,301.6
120039264.0,17,29,13785,29,13785,4287116.571428572,501.0,475.3448275862069,0,0,0.0,0.0,0.0
60218.0,6,14,4740,7,653,8908.666666666666,249.0,93.28571428571428,7,4087,9078.666666666666,1514.0,583.8571428571429
124456430.0,6,32,2226,17,1209,7778526.875,123.0,71.11764705882354,15,1017,8161063.785714285,123.0,67.8
15796.999999999998,6,11,2098,6,590,3159.4,252.0,98.33333333333331,5,1508,3324.5,1236.0,301.6
108120486.0,17,5,1005,5,1005,27030121.5,201.0,201.0,0,0,0.0,0.0,0.0
1303585.0,6,4,264,2,132,0.0,66.0,66.0,2,132,0.0,66.0,66.0
297851.0,6,6,412,4,272,99283.66666666669,74.0,68.0,2,140,0.0,74.0,70.0
120119160.0,6,2425,2141090,739,48774,162456.38482384823,66.0,66.0,1686,2092316,70852.12462908012,1514.0,1240.994068801898
120036232.0,17,28,13364,28,13364,4445786.37037037,501.0,477.2857142857143,0,0,0.0,0.0,0.0
233794.0,6,3,373,2,238,0.0,172.0,119.0,1,135,0.0,135.0,135.0
153462.0,17,2,180,1,90,0.0,90.0,90.0,1,90,0.0,90.0,90.0
97474202.0,6,295,37236,148,27300,663089.8095238095,480.0,184.45945945945945,147,9936,664427.801369863,140.0,67.59183673469387
146305.0,6,3,337,2,214,0.0,160.0,107.0,1,123,0.0,123.0,123.0
80919.0,6,14,4740,7,653,12508.666666666666,249.0,93.28571428571428,7,4087,13079.666666666666,1514.0,583.8571428571429
10461735.0,6,6,412,3,206,5162678.5,74.0,68.66666666666667,3,206,5162563.5,74.0,68.66666666666667
120446427.0,6,223,25134,112,17586,1085102.945945946,284.0,157.01785714285714,111,7548,1086617.2545454546,140.0,68.0
63376.0,6,14,4740,7,653,8234.333333333334,249.0,93.28571428571428,7,4087,9873.0,1514.0,583.8571428571429
1315737.0,6,4,264,2,132,0.0,66.0,66.0,2,132,0.0,66.0,66.0
155576.0,6,3,337,2,214,0.0,160.0,107.0,1,123,0.0,123.0,123.0
228446.0,17,2,180,1,90,0.0,90.0,90.0,1,90,0.0,90.0,90.0
107388.0,17,2,286,2,286,0.0,143.0,143.0,0,0,0.0,0.0,0.0
300450.0,6,6,412,4,272,100150.0,74.0,68.0,2,140,0.0,74.0,70.0
313467.0,6,3,202,2,128,0.0,74.0,64.0,1,74,0.0,74.0,74.0
3012141.0,6,12,2172,7,664,499555.3333333333,252.0,94.85714285714286,5,1508,5432.0,1236.0,301.6
436.0,17,2,508,2,508,0.0,257.0,254.0,0,0,0.0,0.0,0.0
505493.0,6,5,336,2,134,0.0,68.0,67.0,3,202,195478.5,70.0,67.33333333333333
2842600.0,6,12,2172,7,664,473753.5,252.0,94.85714285714286,5,1508,2031.5,1236.0,301.6
90255846.0,6,12,1832,8,1016,12893692.285714284,188.0,127.0,4,816,30029901.666666668,204.0,204.0
115727308.0,6,48,3168,24,1584,5031622.0869565215,66.0,66.0,24,1584,5017951.130434782,66.0,66.0
114680203.0,6,30,1974,15,1026,8176023.142857143,123.0,68.4,15,948,8176029.357142857,123.0,63.2
114693471.0,17,16,1212,8,606,16143499.142857144,174.0,75.75,8,606,16143025.142857144,174.0,75.75
51638.0,6,10,2032,5,524,12667.0,252.0,104.8,5,1508,12445.0,1236.0,301.6
107921.0,17,2,286,2,286,0.0,143.0,143.0,0,0,0.0,0.0,0.0
90288689.0,6,16,1192,8,596,12891981.57142857,95.0,74.5,8,596,12896558.142857144,95.0,74.5
40697.0,6,14,4740,7,653,6668.166666666667,249.0,93.28571428571428,7,4087,5451.166666666667,1514.0,583.8571428571429
44481.0,6,14,4740,7,653,6710.0,249.0,93.28571428571428,7,4087,6837.333333333333,1514.0,583.8571428571429
5004828.0,17,4,849,2,166,0.0,83.0,83.0,2,683,0.0,499.0,341.5
1419025.0,6,4,492,2,280,0.0,214.0,140.0,2,212,0.0,146.0,106.0
28356.0,6,14,4740,7,653,4571.166666666667,249.0,93.28571428571428,7,4087,3642.1666666666665,1514.0,583.8571428571429
215738.0,6,3,426,2,280,0.0,214.0,140.0,1,146,0.0,146.0,146.0
90255620.0,6,16,2368,9,1204,11281952.5,188.0,133.77777777777777,7,1164,15015229.166666666,204.0,166.28571428571428
197073.0,17,2,180,1,90,0.0,90.0,90.0,1,90,0.0,90.0,90.0
135144070.0,17,6,1206,6,1206,27028814.0,201.0,201.0,0,0,0.0,0.0,0.0
352.0,17,2,267,1,83,0.0,83.0,83.0,1,184,0.0,184.0,184.0
6395.0,17,4,823,2,163,0.0,89.0,81.5,2,660,0.0,443.0,330.0
233371.0,6,3,337,2,214,0.0,160.0,107.0,1,123,0.0,123.0,123.0
135124605.0,17,6,1146,6,1146,27024921.0,191.0,191.0,0,0,0.0,0.0,0.0
509381.0,6,5,336,2,134,0.0,68.0,67.0,3,202,192173.5,70.0,67.33333333333333
53595.0,6,14,4740,7,653,8761.333333333334,249.0,93.28571428571428,7,4087,8681.333333333334,1514.0,583.8571428571429
9955.0,17,4,823,2,163,0.0,89.0,81.5,2,660,0.0,443.0,330.0
3347437.0,6,2,132,1,66,0.0,66.0,66.0,1,66,0.0,66.0,66.0
146130.0,6,3,337,2,214,0.0,160.0,107.0,1,123,0.0,123.0,123.0
3004042.0,6,11,2106,6,598,600629.0,252.0,99.66666666666669,5,1508,3976.25,1236.0,301.6
298506.0,6,6,412,4,272,99502.0,74.0,68.0,2,140,0.0,74.0,70.0
10066.0,6,10,1975,5,467,2204.5,195.0,93.4,5,1508,1936.25,1236.0,301.6
1097987.0,6,13,1386,7,789,182997.8333333333,253.0,112.71428571428572,6,597,216311.2,259.0,99.5
56781.0,6,14,4740,7,653,9331.666666666666,249.0,93.28571428571428,7,4087,8865.333333333334,1514.0,583.8571428571429
135133676.0,17,6,1146,6,1146,27026735.2,191.0,191.0,0,0,0.0,0.0,0.0
120122268.0,6,13,2020,9,1204,15015283.5,188.0,133.77777777777777,4,816,30030764.666666668,204.0,204.0
90035519.0,17,28,13364,28,13364,3334648.851851852,501.0,477.2857142857143,0,0,0.0,0.0,0.0
120001121.0,17,15,1169,8,606,17143017.285714287,174.0,75.75,7,563,16667537.666666666,174.0,80.42857142857143
124865.0,17,4,1524,4,1524,41621.66666666666,381.0,381.0,0,0,0.0,0.0,0.0
1031616.0,6,11,1134,6,558,206323.2,220.0,93.0,5,576,256996.25,304.0,115.2
260982.0,6,4,492,2,280,0.0,214.0,140.0,2,212,0.0,146.0,106.0
316.0,17,2,168,1,76,0.0,76.0,76.0,1,92,0.0,92.0,92.0
3007481.0,6,12,2172,7,664,501108.0,252.0,94.85714285714286,5,1508,1936.5,1236.0,301.6
104170.0,17,2,286,2,286,0.0,143.0,143.0,0,0,0.0,0.0,0.0
3254590.0,6,5,336,2,134,0.0,68.0,67.0,3,202,1524452.5,70.0,67.33333333333333
217530.0,6,3,426,2,280,0.0,214.0,140.0,1,146,0.0,146.0,146.0
14651173.0,6,20,1607,10,975,1592834.111111111,315.0,97.5,10,632,1592780.111111111,78.0,63.2
90038828.0,17,28,13364,28,13364,3334771.407407407,501.0,477.2857142857143,0,0,0.0,0.0,0.0
2348969.0,6,49,23728,25,19797,97873.70833333331,1514.0,791.88,24,3931,92431.30434782608,1514.0,163.79166666666666
108108603.0,17,5,1005,5,1005,27027150.75,201.0,201.0,0,0,0.0,0.0,0.0
10441326.0,6,6,412,3,206,5150122.5,74.0,68.66666666666667,3,206,5150017.5,74.0,68.66666666666667
322063.0,17,4,1400,4,1400,107354.33333333331,350.0,350.0,0,0,0.0,0.0,0.0
299575.0,6,6,412,4,272,99858.33333333331,74.0,68.0,2,140,0.0,74.0,70.0
108106172.0,17,5,1005,5,1005,27026543.0,201.0,201.0,0,0,0.0,0.0,0.0
120113999.0,6,256,29546,128,8744,939282.7165354332,140.0,68.3125,128,20802,940181.4251968504,284.0,162.515625
322.0,17,2,174,1,79,0.0,79.0,79.0,1,95,0.0,95.0,95.0
91651607.0,6,24,1829,11,840,9165160.7,95.0,76.36363636363636,13,989,7616032.666666667,95.0,76.07692307692308
259186.00000000003,6,3,337,2,214,0.0,160.0,107.0,1,123,0.0,123.0,123.0
123610482.0,6,49,3234,25,1650,5150436.75,66.0,66.0,24,1584,5164109.826086956,66.0,66.0
105258021.0,17,15,1169,8,606,15000641.714285716,174.0,75.75,7,563,17500155.666666668,174.0,80.42857142857143
207125.0,6,3,426,2,280,0.0,214.0,140.0,1,146,0.0,146.0,146.0
26909.0,6,10,1067,5,536,6366.25,264.0,107.2,5,531,4828.75,259.0,106.2
1303092.0,6,4,264,2,132,0.0,66.0,66.0,2,132,0.0,66.0,66.0
143968.0,17,2,180,1,90,0.0,90.0,90.0,1,90,0.0,90.0,90.0
90421.0,17,2,762,2,762,0.0,381.0,381.0,0,0,0.0,0.0,0.0
203402.0,17,2,762,2,762,0.0,381.0,381.0,0,0,0.0,0.0,0.0
2609.0,17,4,344,2,150,0.0,75.0,75.0,2,194,0.0,103.0,97.0
1170782.0,6,13,3010,8,2382,167254.57142857142,1514.0,297.75,5,628,223781.75,331.0,125.6
1329.0,17,4,438,2,148,0.0,74.0,74.0,2,290,0.0,147.0,145.0
42918.0,6,14,4740,7,653,6988.166666666667,249.0,93.28571428571428,7,4087,6515.333333333333,1514.0,583.8571428571429
111007.0,17,2,286,2,286,0.0,143.0,143.0,0,0,0.0,0.0,0.0
2080474.0,6,18,6803,10,1501,231163.7777777777,408.0,150.1,8,5302,234936.57142857145,1514.0,662.75
30439.0,6,14,4740,7,653,4942.5,249.0,93.28571428571428,7,4087,4902.166666666667,1514.0,583.8571428571429
14131887.0,6,20,1607,10,975,1536010.111111111,315.0,97.5,10,632,1535982.2222222222,78.0,63.2
138746.0,6,2,132,1,66,0.0,66.0,66.0,1,66,0.0,66.0,66.0
320.0,17,2,160,1,80,0.0,80.0,80.0,1,80,0.0,80.0,80.0
122687722.0,6,48,3168,24,1584,5027966.0,66.0,66.0,24,1584,5180359.695652174,66.0,66.0
227309.0,6,10,1221,6,636,45461.8,298.0,106.0,4,585,74933.66666666667,379.0,146.25
314.0,17,2,174,1,79,0.0,79.0,79.0,1,95,0.0,95.0,95.0
305386.0,17,4,1400,4,1400,101795.33333333331,350.0,350.0,0,0,0.0,0.0,0.0
209468.0,17,2,180,1,90,0.0,90.0,90.0,1,90,0.0,90.0,90.0
305.0,17,2,168,1,76,0.0,76.0,76.0,1,92,0.0,92.0,92.0
14641325.0,6,19,1553,9,921,1791744.375,315.0,102.33333333333331,10,632,1592643.6666666667,78.0,63.2
129448029.0,6,35,2479,17,1194,7466461.3125,123.0,70.23529411764706,18,1285,7614410.882352941,139.0,71.38888888888889
29127.0,6,14,4740,7,653,4728.666666666667,249.0,93.28571428571428,7,4087,4714.166666666667,1514.0,583.8571428571429
90095377.0,6,11,1644,4,816,30030981.0,204.0,204.0,7,828,15015503.333333334,188.0,118.28571428571428
103434.0,17,2,286,2,286,0.0,143.0,143.0,0,0,0.0,0.0,0.0
143881.0,17,2,180,1,90,0.0,90.0,90.0,1,90,0.0,90.0,90.0
38226.0,6,10,2032,5,524,9334.25,252.0,104.8,5,1508,9193.0,1236.0,301.6
2117.0,17,4,344,2,150,0.0,75.0,75.0,2,194,0.0,103.0,97.0
298612.0,6,6,412,4,272,99537.33333333331,74.0,68.0,2,140,0.0,74.0,70.0
65609.0,6,10,2032,5,524,15630.25,252.0,104.8,5,1508,2796.25,1236.0,301.6
117506854.0,6,240,26960,120,18744,985643.0336134454,284.0,156.2,120,8216,985643.9411764706,140.0,68.46666666666667
207150.0,17,2,762,2,762,0.0,381.0,381.0,0,0,0.0,0.0,0.0
135131701.0,17,6,1206,6,1206,27026340.2,201.0,201.0,0,0,0.0,0.0,0.0
29776.0,6,14,4740,7,653,4840.666666666667,249.0,93.28571428571428,7,4087,4825.666666666667,1514.0,583.8571428571429
2754.0,17,4,344,2,150,0.0,75.0,75.0,2,194,0.0,103.0,97.0
508.0,17,2,166,1,75,0.0,75.0,75.0,1,91,0.0,91.0,91.0
326.0,17,2,174,1,79,0.0,79.0,79.0,1,95,0.0,95.0,95.0
314241.0,17,4,1400,4,1400,104747.0,350.0,350.0,0,0,0.0,0.0,0.0
51041.0,6,14,4740,7,653,8327.333333333334,249.0,93.28571428571428,7,4087,8001.0,1514.0,583.8571428571429
90257048.0,6,12,1832,8,1016,12893864.0,188.0,127.0,4,816,30027417.666666668,204.0,204.0
29069.0,6,10,2032,5,524,6549.5,252.0,104.8,5,1508,6051.25,1236.0,301.6
178116.0,17,2,180,1,90,0.0,90.0,90.0,1,90,0.0,90.0,90.0
321280.0,6,6,412,4,272,107093.33333333331,74.0,68.0,2,140,0.0,74.0,70.0
1980000.0,6,27,12410,14,4490,152307.6923076923,1510.0,320.7142857142857,13,7920,139729.08333333334,1510.0,609.2307692307693
148023.0,17,2,180,1,90,0.0,90.0,90.0,1,90,0.0,90.0,90.0
147972.0,17,2,180,1,90,0.0,90.0,90.0,1,90,0.0,90.0,90.0
106246.0,17,2,700,2,700,0.0,350.0,350.0,0,0,0.0,0.0,0.0
228300.0,17,2,180,1,90,0.0,90.0,90.0,1,90,0.0,90.0,90.0
2604682.0,6,2,132,1,66,0.0,66.0,66.0,1,66,0.0,66.0,66.0
115973184.0,6,248,28352,124,19872,941122.2926829268,284.0,160.25806451612902,124,8480,941122.5203252032,140.0,68.38709677419355
111172.0,17,2,286,2,286,0.0,143.0,143.0,0,0,0.0,0.0,0.0
413.0,17,2,410,1,78,0.0,78.0,78.0,1,332,0.0,332.0,332.0
9243.0,17,2,539,1,86,0.0,86.0,86.0,1,453,0.0,453.0,453.0
347093.0,17,2,582,1,83,0.0,83.0,83.0,1,499,0.0,499.0,499.0
214471.0,6,10,1221,6,636,42894.2,298.0,106.0,4,585,70260.33333333333,379.0,146.25
107286.0,17,2,700,2,700,0.0,350.0,350.0,0,0,0.0,0.0,0.0
16956.0,6,14,4740,7,653,2677.0,249.0,93.28571428571428,7,4087,2636.1666666666665,1514.0,583.8571428571429
207264.0,6,3,426,2,280,0.0,214.0,140.0,1,146,0.0,146.0,146.0
122975163.0,6,48,3168,24,1584,5052140.913043479,66.0,66.0,24,1584,5214931.434782608,66.0,66.0
149199.0,17,2,414,1,88,0.0,88.0,88.0,1,326,0.0,326.0,326.0
14642852.0,6,20,1607,10,975,1593073.4444444445,315.0,97.5,10,632,1593039.7777777778,78.0,63.2
21468.0,6,20,7606,11,978,2146.8,310.0,88.9090909090909,9,6628,2453.5,1514.0,736.4444444444445
120066.0,17,2,180,1,70,0.0,70.0,70.0,1,110,0.0,110.0,110.0
106872.0,17,2,286,2,286,0.0,143.0,143.0,0,0,0.0,0.0,0.0
88958.0,6,14,4740,7,653,14332.166666666666,249.0,93.28571428571428,7,4087,14011.333333333334,1514.0,583.8571428571429
90033185.0,17,28,13364,28,13364,3334562.407407407,501.0,477.2857142857143,0,0,0.0,0.0,0.0
90092139.0,6,12,1848,5,1020,22522465.5,204.0,204.0,7,828,14969488.833333334,188.0,118.28571428571428
19532.0,6,10,2032,5,524,4165.0,252.0,104.8,5,1508,4546.5,1236.0,301.6
2839722.0,6,11,2106,6,598,567646.4,252.0,99.66666666666669,5,1508,2034.25,1236.0,301.6
135129471.0,17,6,1206,6,1206,27025894.2,201.0,201.0,0,0,0.0,0.0,0.0
2494741.0,6,3,204,2,136,0.0,70.0,68.0,1,68,0.0,68.0,68.0
90288393.0,6,16,1192,8,596,12892072.142857144,95.0,74.5,8,596,12896380.0,95.0,74.5
90288923.0,6,16,1192,8,596,12890722.0,95.0,74.5,8,596,12897097.285714284,95.0,74.5
108110968.0,17,5,1005,5,1005,27027742.0,201.0,201.0,0,0,0.0,0.0,0.0
119519824.0,6,225,25394,113,7680,1067141.2857142857,140.0,67.96460176991151,112,17714,1067427.4774774774,284.0,158.16071428571428
90018444.0,17,28,13364,28,13364,3334016.4444444445,501.0,477.2857142857143,0,0,0.0,0.0,0.0
24684.0,6,20,7606,11,978,2468.4,310.0,88.9090909090909,9,6628,2687.875,1514.0,736.4444444444445
120421886.0,6,285,33530,143,23862,848041.4507042253,284.0,166.86713286713288,142,9668,846736.2553191489,140.0,68.08450704225352
52833.0,6,14,4740,7,653,7919.666666666667,249.0,93.28571428571428,7,4087,7579.0,1514.0,583.8571428571429
106999.0,17,2,700,2,700,0.0,350.0,350.0,0,0,0.0,0.0,0.0
61940.0,6,10,2032,5,524,15209.0,252.0,104.8,5,1508,14175.0,1236.0,301.6
34425.0,6,10,2032,5,524,7878.0,252.0,104.8,5,1508,8374.75,1236.0,301.6
819.0,17,4,438,2,148,0.0,74.0,74.0,2,290,0.0,147.0,145.0
3277435.0,6,129,121998,87,114924,38109.70930232558,1510.0,1320.9655172413793,42,7074,72573.0487804878,1510.0,168.42857142857142
121772.0,6,4,439,2,238,0.0,172.0,119.0,2,201,0.0,135.0,100.5
18312.0,6,14,4740,7,653,2939.833333333333,249.0,93.28571428571428,7,4087,2916.1666666666665,1514.0,583.8571428571429
95005790.0,17,11,735,6,389,19001158.0,174.0,64.83333333333333,5,346,18750179.5,174.0,69.2
116594626.0,17,14,864,7,432,19334295.166666668,174.0,61.71428571428572,7,432,19333493.5,174.0,61.71428571428572
90545669.0,6,14,2240,8,1016,12935095.57142857,188.0,127.0,6,1224,18076027.2,204.0,204.0
40004.0,6,14,4740,7,653,6544.166666666667,249.0,93.28571428571428,7,4087,5701.666666666667,1514.0,583.8571428571429
228283.0,17,2,180,1,90,0.0,90.0,90.0,1,90,0.0,90.0,90.0
219156.0,17,4,6056,4,6056,73052.0,1514.0,1514.0,0,0,0.0,0.0,0.0
48842.0,6,14,4740,7,653,6768.0,249.0,93.28571428571428,7,4087,7938.0,1514.0,583.8571428571429
52675.0,6,14,4740,7,653,8652.0,249.0,93.28571428571428,7,4087,8584.333333333334,1514.0,583.8571428571429
110980765.0,6,30,1974,15,1026,7912591.785714285,123.0,68.4,15,948,7912590.285714285,123.0,63.2
0.0,17,1,90,1,90,0.0,90.0,90.0,0,0,0.0,0.0,0.0
103091.0,17,2,286,2,286,0.0,143.0,143.0,0,0,0.0,0.0,0.0
240656.0,6,14,4740,7,653,32222.166666666668,249.0,93.28571428571428,7,4087,34633.0,1514.0,583.8571428571429
0.0,17,1,381,1,381,0.0,381.0,381.0,0,0,0.0,0.0,0.0
228209.0,17,2,180,1,90,0.0,90.0,90.0,1,90,0.0,90.0,90.0
304.0,17,2,164,1,82,0.0,82.0,82.0,1,82,0.0,82.0,82.0
148023.0,17,2,180,1,90,0.0,90.0,90.0,1,90,0.0,90.0,90.0
10871728.0,6,8,544,4,272,3578499.333333333,74.0,68.0,4,272,3578318.333333333,74.0,68.0
250497.00000000003,6,3,337,2,214,0.0,160.0,107.0,1,123,0.0,123.0,123.0
1316174.0,6,4,264,2,132,0.0,66.0,66.0,2,132,0.0,66.0,66.0
2595392.0,6,2,132,1,66,0.0,66.0,66.0,1,66,0.0,66.0,66.0
838785.0,6,9,1149,6,624,167757.0,286.0,104.0,3,525,283089.0,385.0,175.0
1320581.0,6,4,264,2,132,0.0,66.0,66.0,2,132,0.0,66.0,66.0
121345.0,6,3,337,2,214,0.0,160.0,107.0,1,123,0.0,123.0,123.0
13096.0,6,11,1131,6,600,2379.6,262.0,100.0,5,531,2950.25,259.0,106.2
1480714.0,17,6,1230,3,234,740172.0,78.0,78.0,3,996,740135.0,332.0,332.0
52898.0,6,14,4740,7,653,8194.333333333334,249.0,93.28571428571428,7,4087,6662.5,1514.0,583.8571428571429
2040472.0,6,37,15535,19,10912,113359.55555555556,1514.0,574.3157894736842,18,4623,107422.76470588236,1514.0,256.8333333333333
90027712.0,17,28,13364,28,13364,3334359.703703704,501.0,477.2857142857143,0,0,0.0,0.0,0.0
296838.0,17,2,246,1,76,0.0,76.0,76.0,1,170,0.0,170.0,170.0
102880466.0,6,43,2838,22,1452,4899057.619047619,66.0,66.0,21,1386,5144010.6,66.0,66.0
97008805.0,17,13,1083,7,563,16168134.166666666,174.0,80.42857142857143,6,520,15400152.2,174.0,86.66666666666667
34507.0,6,14,4740,7,653,5088.5,249.0,93.28571428571428,7,4087,5452.833333333333,1514.0,583.8571428571429
74799.0,6,13,1513,7,882,11803.833333333334,291.0,126.0,6,631,14173.8,293.0,105.16666666666669
108106838.0,17,5,955,5,955,27026709.5,191.0,191.0,0,0,0.0,0.0,0.0
90018554.0,17,28,13364,28,13364,3334020.5185185187,501.0,477.2857142857143,0,0,0.0,0.0,0.0
108106031.0,17,5,1005,5,1005,27026507.75,201.0,201.0,0,0,0.0,0.0,0.0
118490.0,6,14,4740,7,653,16963.333333333332,249.0,93.28571428571428,7,4087,18307.166666666668,1514.0,583.8571428571429
3179974.0,6,18,1495,9,921,358155.375,315.0,102.33333333333331,9,574,358124.25,78.0,63.77777777777778
135125778.0,17,6,1146,6,1146,27025155.6,191.0,191.0,0,0,0.0,0.0,0.0
0.0,6,1,66,1,66,0.0,66.0,66.0,0,0,0.0,0.0,0.0
112357.0,17,2,700,2,700,0.0,350.0,350.0,0,0,0.0,0.0,0.0
116390678.0,6,48,3168,24,1584,5060464.260869565,66.0,66.0,24,1584,5046789.0869565215,66.0,66.0
16487.0,6,10,2032,5,524,2787.5,252.0,104.8,5,1508,3762.0,1236.0,301.6
298178.0,17,4,1524,4,1524,99392.66666666669,381.0,381.0,0,0,0.0,0.0,0.0
120289212.0,6,216,24578,108,7424,1116421.2803738315,140.0,68.74074074074075,108,17154,1116517.8785046728,300.0,158.83333333333334
126310010.0,6,37,2656,19,1408,7017222.777777778,139.0,74.10526315789474,18,1248,6830005.176470588,123.0,69.33333333333333
40799.0,6,14,4740,7,653,6425.5,249.0,93.28571428571428,7,4087,5852.5,1514.0,583.8571428571429
28955.0,6,10,2032,5,524,6992.0,252.0,104.8,5,1508,6915.75,1236.0,301.6
18040.0,6,20,7606,11,978,1804.0,310.0,88.9090909090909,9,6628,1821.0,1514.0,736.4444444444445
5623177.0,6,4,270,2,134,0.0,68.0,67.0,2,136,0.0,70.0,68.0
121239.0,6,3,337,2,214,0.0,160.0,107.0,1,123,0.0,123.0,123.0
247116.0,17,2,180,1,90,0.0,90.0,90.0,1,90,0.0,90.0,90.0
90033776.0,17,28,13364,28,13364,3334584.296296296,501.0,477.2857142857143,0,0,0.0,0.0,0.0
750010.0,6,2,132,1,66,0.0,66.0,66.0,1,66,0.0,66.0,66.0
23626.0,6,14,4740,7,653,3630.0,249.0,93.28571428571428,7,4087,3034.6666666666665,1514.0,583.8571428571429
83.0,17,2,762,2,762,0.0,381.0,381.0,0,0,0.0,0.0,0.0
22117.0,6,14,4740,7,653,3447.6666666666665,249.0,93.28571428571428,7,4087,3547.333333333333,1514.0,583.8571428571429
108121692.0,17,5,955,5,955,27030423.0,191.0,191.0,0,0,0.0,0.0,0.0
242203.0,6,3,337,2,214,0.0,160.0,107.0,1,123,0.0,123.0,123.0
3738.0,17,2,493,1,88,0.0,88.0,88.0,1,405,0.0,405.0,405.0
93153443.0,6,27,1938,14,1029,7149033.461538462,123.0,73.5,13,909,7744785.5,123.0,69.92307692307692
90794542.0,17,17,5814,17,5814,5674658.875,342.0,342.0,0,0,0.0,0.0,0.0
103108875.0,6,41,2706,21,1386,5155443.75,66.0,66.0,20,1320,5283490.631578947,66.0,66.0
228115.0,17,2,180,1,90,0.0,90.0,90.0,1,90,0.0,90.0,90.0
1173299.0,6,13,3018,8,2390,167614.14285714287,1514.0,298.75,5,628,225182.25,331.0,125.6
207709.0,6,10,1221,6,636,41541.8,298.0,106.0,4,585,67911.33333333333,379.0,146.25
320541.0,17,4,1400,4,1400,106847.0,350.0,350.0,0,0,0.0,0.0,0.0
232388.0,17,2,180,1,90,0.0,90.0,90.0,1,90,0.0,90.0,90.0
706.0,17,4,438,2,148,0.0,74.0,74.0,2,290,0.0,147.0,145.0
1740597.0,6,23,6509,12,1529,158236.0909090909,357.0,127.41666666666669,11,4980,143377.7,1510.0,452.7272727272728
90009015.0,17,28,13364,28,13364,3333667.222222222,501.0,477.2857142857143,0,0,0.0,0.0,0.0
107532162.0,6,34,2350,17,1225,6707275.0,139.0,72.05882352941177,17,1125,6707274.375,123.0,66.17647058823529
121256.0,6,3,337,2,214,0.0,160.0,107.0,1,123,0.0,123.0,123.0
119881351.0,6,33,2280,17,1209,7479071.25,123.0,71.11764705882354,16,1071,7977703.0,123.0,66.9375
90300743.0,6,16,1192,8,596,12893563.285714284,95.0,74.5,8,596,12899378.714285716,95.0,74.5
3180162.0,6,18,1495,9,921,358358.375,315.0,102.33333333333331,9,574,358306.625,78.0,63.77777777777778
34995.0,6,10,2032,5,524,6327.5,252.0,104.8,5,1508,7831.0,1236.0,301.6
27304589.0,17,5,1710,5,1710,6826147.25,342.0,342.0,0,0,0.0,0.0,0.0
120188376.0,6,224,25328,112,7688,1076555.5585585586,140.0,68.64285714285714,112,17640,1082716.189189189,284.0,157.5
135128342.0,17,6,1206,6,1206,27025668.4,201.0,201.0,0,0,0.0,0.0,0.0
249341.0,17,4,6056,4,6056,83113.66666666667,1514.0,1514.0,0,0,0.0,0.0,0.0
120076271.0,17,29,13785,29,13785,4288438.25,501.0,475.3448275862069,0,0,0.0,0.0,0.0
92778529.0,6,159,17956,80,5428,1174411.759493671,140.0,67.85,79,12528,1176117.2948717948,284.0,158.58227848101265
127444793.0,17,15,907,7,432,17980683.666666668,174.0,61.71428571428572,8,475,18144117.285714287,174.0,59.375
143989.0,17,2,180,1,90,0.0,90.0,90.0,1,90,0.0,90.0,90.0
300365.0,6,6,412,4,272,100121.66666666669,74.0,68.0,2,140,0.0,74.0,70.0
24769.0,6,14,4740,7,653,3946.5,249.0,93.28571428571428,7,4087,3996.0,1514.0,583.8571428571429
10441038.0,6,7,478,4,272,3435289.6666666665,74.0,68.0,3,206,5152833.5,74.0,68.66666666666667
152344.0,17,4,6056,4,6056,50781.333333333336,1514.0,1514.0,0,0,0.0,0.0,0.0
1066367.0,6,13,1386,7,789,177727.83333333334,253.0,112.71428571428572,6,597,211612.0,259.0,99.5
93928792.0,6,27,1932,14,963,7225259.692307692,123.0,68.78571428571429,13,969,6995345.833333333,123.0,74.53846153846153
113561569.0,6,208,23424,104,16264,1100449.0582524273,284.0,156.3846153846154,104,7160,1100449.349514563,140.0,68.84615384615384
34995.0,6,14,4740,7,653,5043.166666666667,249.0,93.28571428571428,7,4087,5486.166666666667,1514.0,583.8571428571429
38269.0,6,10,2032,5,524,8827.25,252.0,104.8,5,1508,9054.25,1236.0,301.6
110988237.0,6,31,2166,16,1149,7384837.133333334,123.0,71.8125,15,1017,7912326.357142857,123.0,67.8
220524.0,6,3,426,2,280,0.0,214.0,140.0,1,146,0.0,146.0,146.0
18173.0,6,11,1133,6,602,2374.2,264.0,100.33333333333331,5,531,4026.0,259.0,106.2
25470.0,6,10,2032,5,524,5506.75,252.0,104.8,5,1508,5785.75,1236.0,301.6
28345.0,6,11,2098,6,590,3880.8,252.0,98.33333333333331,5,1508,6754.25,1236.0,301.6
327918.0,17,2,176,1,80,0.0,80.0,80.0,1,96,0.0,96.0,96.0
53600.0,6,10,2032,5,524,12429.75,252.0,104.8,5,1508,12400.0,1236.0,301.6
108107367.0,17,5,1005,5,1005,27026841.75,201.0,201.0,0,0,0.0,0.0,0.0
216522.0,17,2,180,1,90,0.0,90.0,90.0,1,90,0.0,90.0,90.0
120070297.0,6,808,190936,403,27412,298682.3308457711,214.0,68.0198511166253,405,163524,296553.00247524754,1514.0,403.7629629629629
147137.0,6,3,373,2,238,0.0,172.0,119.0,1,135,0.0,135.0,135.0
2426.0,17,4,344,2,150,0.0,75.0,75.0,2,194,0.0,103.0,97.0
37224.0,6,14,4740,7,653,5245.333333333333,249.0,93.28571428571428,7,4087,6065.333333333333,1514.0,583.8571428571429
207983.0,17,2,762,2,762,0.0,381.0,381.0,0,0,0.0,0.0,0.0
1027097.0,6,11,1134,6,558,205419.4,220.0,93.0,5,576,255348.5,304.0,115.2
294432.0,17,2,180,1,90,0.0,90.0,90.0,1,90,0.0,90.0,90.0
6867.0,17,2,582,1,83,0.0,83.0,83.0,1,499,0.0,499.0,499.0
90766678.0,6,20,1531,11,840,9071557.7,95.0,76.36363636363636,9,691,11342630.75,95.0,76.77777777777777
234020.0,6,3,373,2,238,0.0,172.0,119.0,1,135,0.0,135.0,135.0
9089.0,17,2,498,1,80,0.0,80.0,80.0,1,418,0.0,418.0,418.0
90285788.0,6,14,1043,7,542,15047631.333333334,95.0,77.42857142857143,7,501,14998347.0,95.0,71.57142857142857
135124461.0,17,6,1206,6,1206,27024892.2,201.0,201.0,0,0,0.0,0.0,0.0
35541838.0,6,5,336,2,134,0.0,68.0,67.0,3,202,17704737.5,70.0,67.33333333333333
108109538.0,17,5,955,5,955,27027384.5,191.0,191.0,0,0,0.0,0.0,0.0
130075.0,6,2,132,1,66,0.0,66.0,66.0,1,66,0.0,66.0,66.0
120671778.0,17,12,647,6,389,20143180.8,174.0,64.83333333333333,6,258,20000974.6,43.0,43.0
511332.0,6,5,336,2,134,0.0,68.0,67.0,3,202,196584.5,70.0,67.33333333333333
216819.0,6,3,426,2,280,0.0,214.0,140.0,1,146,0.0,146.0,146.0
2251.0,17,4,344,2,150,0.0,75.0,75.0,2,194,0.0,103.0,97.0
16985.0,6,10,1067,5,536,4081.75,264.0,107.2,5,531,3081.0,259.0,106.2
23400.0,6,10,2032,5,524,4650.75,252.0,104.8,5,1508,5571.5,1236.0,301.6
90296666.0,6,19,1436,10,745,10028033.111111112,95.0,74.5,9,691,11285721.5,95.0,76.77777777777777
117826215.0,6,29,1920,15,1026,8416158.214285715,123.0,68.4,14,894,8278836.923076923,123.0,63.85714285714285
153460.0,17,2,180,1,90,0.0,90.0,90.0,1,90,0.0,90.0,90.0
209594.0,17,2,180,1,90,0.0,90.0,90.0,1,90,0.0,90.0,90.0
2869291.0,6,3,204,2,134,0.0,68.0,67.0,1,70,0.0,70.0,70.0
1199609.0,17,7,490,7,490,199934.8333333333,70.0,70.0,0,0,0.0,0.0,0.0
120210630.0,6,266,31414,133,9074,906952.9772727272,140.0,68.22556390977444,133,22340,904390.5378787878,284.0,167.9699248120301
5928589.0,6,5,336,2,134,0.0,68.0,67.0,3,202,1575893.0,70.0,67.33333333333333
90258489.0,6,13,2036,8,1016,12894069.857142856,188.0,127.0,5,1020,22522931.0,204.0,204.0
90259001.0,6,14,1964,8,1016,12894143.0,188.0,127.0,6,948,18019064.0,204.0,158.0
124421967.0,6,32,2226,17,1209,7776372.9375,123.0,71.11764705882354,15,1017,8158528.071428572,123.0,67.8
120125900.0,6,18,2622,10,1392,13347322.222222222,188.0,139.2,8,1230,12873055.285714284,204.0,153.75
206349.0,6,3,426,2,280,0.0,214.0,140.0,1,146,0.0,146.0,146.0
90044818.0,17,28,13364,28,13364,3334993.25925926,501.0,477.2857142857143,0,0,0.0,0.0,0.0
92373.0,6,14,4740,7,653,15154.833333333334,249.0,93.28571428571428,7,4087,13760.166666666666,1514.0,583.8571428571429
34731310.0,6,5,336,2,134,0.0,68.0,67.0,3,202,17295604.5,70.0,67.33333333333333
1506927.0,6,20,6434,12,1921,136993.36363636365,620.0,160.08333333333334,8,4513,176464.0,1514.0,564.125
19594.0,17,2,180,1,90,0.0,90.0,90.0,1,90,0.0,90.0,90.0
104846.0,17,2,700,2,700,0.0,350.0,350.0,0,0,0.0,0.0,0.0
108098025.0,17,5,1005,5,1005,27024506.25,201.0,201.0,0,0,0.0,0.0,0.0
89059.0,6,14,4740,7,653,14730.5,249.0,93.28571428571428,7,4087,14136.833333333334,1514.0,583.8571428571429
108103949.0,17,5,1005,5,1005,27025987.25,201.0,201.0,0,0,0.0,0.0,0.0
120279198.0,17,14,864,7,432,20046533.0,174.0,61.71428571428572,7,432,19951123.83333333,174.0,61.71428571428572
108107675.0,17,5,955,5,955,27026918.75,191.0,191.0,0,0,0.0,0.0,0.0
297990.0,6,6,412,4,272,99330.0,74.0,68.0,2,140,0.0,74.0,70.0
227549.0,17,2,180,1,90,0.0,90.0,90.0,1,90,0.0,90.0,90.0
311759.0,17,4,704,2,148,0.0,74.0,74.0,2,556,0.0,280.0,278.0
2624490.0,6,25,7573,14,3735,201883.84615384616,1514.0,266.7857142857143,11,3838,237581.2,1514.0,348.90909090909093
325584.0,17,4,622,4,622,108528.0,163.0,155.5,0,0,0.0,0.0,0.0
155653.0,6,3,337,2,214,0.0,160.0,107.0,1,123,0.0,123.0,123.0
90093880.0,6,13,2052,6,1224,18018327.4,204.0,204.0,7,828,15014866.333333334,188.0,118.28571428571428
35432779.0,6,5,336,2,134,0.0,68.0,67.0,3,202,17506771.0,70.0,67.33333333333333
16557.0,6,10,2032,5,524,3848.5,252.0,104.8,5,1508,3509.75,1236.0,301.6
5623891.0,6,4,270,2,134,0.0,68.0,67.0,2,136,0.0,70.0,68.0
51311.0,6,10,2032,5,524,12614.5,252.0,104.8,5,1508,11557.75,1236.0,301.6
56223.0,6,14,4740,7,653,9134.333333333334,249.0,93.28571428571428,7,4087,8858.666666666666,1514.0,583.8571428571429
135114593.0,17,6,1206,6,1206,27022918.6,201.0,201.0,0,0,0.0,0.0,0.0
90365399.0,6,13,2052,6,1224,18072760.4,204.0,204.0,7,828,15060511.166666666,188.0,118.28571428571428
108107540.0,17,5,955,5,955,27026885.0,191.0,191.0,0,0,0.0,0.0,0.0
26753.0,6,10,2032,5,524,6405.0,252.0,104.8,5,1508,6391.5,1236.0,301.6
118789574.0,17,16,1474,8,737,16947116.85714286,174.0,92.125,8,737,16938304.285714287,174.0,92.125
206047.0,6,3,426,2,280,0.0,214.0,140.0,1,146,0.0,146.0,146.0
2595026.0,6,2,132,1,66,0.0,66.0,66.0,1,66,0.0,66.0,66.0
120122615.0,6,17,2556,10,1392,13346957.222222222,188.0,139.2,7,1164,15015373.833333334,204.0,166.28571428571428
90361118.0,6,12,1848,7,828,15060186.333333334,188.0,118.28571428571428,5,1020,15082076.25,204.0,204.0
206501.0,17,2,180,1,90,0.0,90.0,90.0,1,90,0.0,90.0,90.0
119180431.0,17,35,16705,35,16705,3505306.794117647,501.0,477.2857142857143,0,0,0.0,0.0,0.0
2408.0,17,4,344,2,150,0.0,75.0,75.0,2,194,0.0,103.0,97.0
104014.0,17,2,286,2,286,0.0,143.0,143.0,0,0,0.0,0.0,0.0
132188.0,6,13,1394,7,797,22031.33333333333,253.0,113.85714285714286,6,597,24702.0,259.0,99.5
13809.0,6,13,1459,7,862,2027.1666666666667,271.0,123.14285714285714,6,597,2590.6,259.0,99.5
142452.0,17,4,344,2,150,0.0,75.0,75.0,2,194,0.0,103.0,97.0
120000362.0,6,21,1585,10,745,13333373.555555556,95.0,74.5,11,840,11975553.4,95.0,76.36363636363636
17235.0,6,11,2098,6,590,3277.6,252.0,98.33333333333331,5,1508,3837.25,1236.0,301.6
23073.0,6,10,2032,5,524,5475.0,252.0,104.8,5,1508,5529.5,1236.0,301.6
135134502.0,17,6,1146,6,1146,27026900.4,191.0,191.0,0,0,0.0,0.0,0.0
196955.0,17,2,180,1,90,0.0,90.0,90.0,1,90,0.0,90.0,90.0
90063054.0,17,27,12943,27,12943,3463963.6153846155,501.0,479.3703703703704,0,0,0.0,0.0,0.0
421791.0,6,3,204,1,68,0.0,68.0,68.0,2,136,0.0,70.0,68.0
53510.0,6,10,2032,5,524,12040.75,252.0,104.8,5,1508,13015.75,1236.0,301.6
2824410.0,6,3,1604,2,851,0.0,785.0,425.5,1,753,0.0,753.0,753.0
143959.0,17,2,180,1,90,0.0,90.0,90.0,1,90,0.0,90.0,90.0
106876.0,17,2,286,2,286,0.0,143.0,143.0,0,0,0.0,0.0,0.0
2329.0,17,4,344,2,150,0.0,75.0,75.0,2,194,0.0,103.0,97.0
95009782.0,6,40,2640,20,1320,5000514.842105263,66.0,66.0,20,1320,4989138.052631579,66.0,66.0
57981.0,6,14,4740,7,653,9418.333333333334,249.0,93.28571428571428,7,4087,9217.166666666666,1514.0,583.8571428571429
3007665.0,6,11,2106,6,598,601352.2,252.0,99.66666666666669,5,1508,1719.5,1236.0,301.6
120114896.0,6,228,25756,114,7820,1055853.274336283,140.0,68.59649122807018,114,17936,1055859.389380531,284.0,157.33333333333334
108565519.0,6,31,2182,16,1165,7223298.0,139.0,72.8125,15,1017,7739231.214285715,123.0,67.8
312002.0,17,4,1400,4,1400,104000.66666666669,350.0,350.0,0,0,0.0,0.0,0.0
108103440.0,17,5,1005,5,1005,27025860.0,201.0,201.0,0,0,0.0,0.0,0.0
217338.0,6,3,426,2,280,0.0,214.0,140.0,1,146,0.0,146.0,146.0
252684.00000000003,6,3,337,2,214,0.0,160.0,107.0,1,123,0.0,123.0,123.0
108115523.0,17,5,1005,5,1005,27028880.75,201.0,201.0,0,0,0.0,0.0,0.0
122342.0,6,3,373,2,238,0.0,172.0,119.0,1,135,0.0,135.0,135.0
1485.0,17,2,762,2,762,0.0,381.0,381.0,0,0,0.0,0.0,0.0
33734.0,6,14,4740,7,653,5453.166666666667,249.0,93.28571428571428,7,4087,5435.0,1514.0,583.8571428571429
757.0,17,2,684,2,684,0.0,342.0,342.0,0,0,0.0,0.0,0.0
190901.0,17,2,180,1,90,0.0,90.0,90.0,1,90,0.0,90.0,90.0
33366.0,6,11,2098,6,590,6297.4,252.0,98.33333333333331,5,1508,6467.25,1236.0,301.6
108115690.0,17,5,955,5,955,27028922.5,191.0,191.0,0,0,0.0,0.0,0.0
112535483.0,6,46,3036,23,1518,5105437.818181818,66.0,66.0,23,1518,5105435.863636363,66.0,66.0
96029580.0,17,12,778,6,389,19200166.8,174.0,64.83333333333333,6,389,19201091.4,174.0,64.83333333333333
243771.0,6,3,337,2,214,0.0,160.0,107.0,1,123,0.0,123.0,123.0
1339889.0,17,16,1120,16,1120,89325.93333333333,70.0,70.0,0,0,0.0,0.0,0.0
228269.0,17,2,180,1,90,0.0,90.0,90.0,1,90,0.0,90.0,90.0
31503.000000000004,6,14,4740,7,653,4672.333333333333,249.0,93.28571428571428,7,4087,4701.0,1514.0,583.8571428571429
436413.0,6,10,1221,6,636,87282.6,298.0,106.0,4,585,139329.0,379.0,146.25
6064.0,17,2,180,1,90,0.0,90.0,90.0,1,90,0.0,90.0,90.0
2350.0,17,4,344,2,150,0.0,75.0,75.0,2,194,0.0,103.0,97.0
211827.0,17,2,180,1,90,0.0,90.0,90.0,1,90,0.0,90.0,90.0
2393382.0,6,49,23728,25,19797,99724.25,1514.0,791.88,24,3931,94335.52173913045,1514.0,163.79166666666666
303684.0,6,2,132,1,66,0.0,66.0,66.0,1,66,0.0,66.0,66.0
26030.0,6,14,4740,7,653,4205.666666666667,249.0,93.28571428571428,7,4087,4200.666666666667,1514.0,583.8571428571429
209082.0,6,3,426,2,280,0.0,214.0,140.0,1,146,0.0,146.0,146.0
21421.0,6,11,2098,6,590,3485.4,252.0,98.33333333333331,5,1508,4929.25,1236.0,301.6
321018.0,6,3,1604,1,753,0.0,753.0,753.0,2,851,0.0,785.0,425.5
309841.0,6,6,412,4,272,103280.33333333331,74.0,68.0,2,140,0.0,74.0,70.0
90023131.0,17,27,12943,27,12943,3462428.1153846155,501.0,479.3703703703704,0,0,0.0,0.0,0.0
384520.0,6,3,204,2,136,0.0,70.0,68.0,1,68,0.0,68.0,68.0
0.0,17,1,55,1,55,0.0,55.0,55.0,0,0,0.0,0.0,0.0
120545323.0,6,31,2034,16,1086,8036354.866666666,123.0,67.875,15,948,7881733.571428572,123.0,63.2
108114261.0,17,5,1005,5,1005,27028565.25,201.0,201.0,0,0,0.0,0.0,0.0
216011.0,6,2,114,1,60,0.0,60.0,60.0,1,54,0.0,54.0,54.0
23917.0,6,14,4740,7,653,3831.5,249.0,93.28571428571428,7,4087,3310.833333333333,1514.0,583.8571428571429
114032295.0,17,14,864,7,432,19000980.33333333,174.0,61.71428571428572,7,432,19000247.5,174.0,61.71428571428572
6622.0,17,2,582,1,83,0.0,83.0,83.0,1,499,0.0,499.0,499.0
90258632.0,6,12,1832,8,1016,12894090.285714284,188.0,127.0,4,816,30031309.33333333,204.0,204.0
108115058.0,17,5,1005,5,1005,27028764.5,201.0,201.0,0,0,0.0,0.0,0.0
54339.0,6,14,4740,7,653,8933.0,249.0,93.28571428571428,7,4087,8366.333333333334,1514.0,583.8571428571429
53902.0,6,14,4740,7,653,8850.166666666666,249.0,93.28571428571428,7,4087,8401.166666666666,1514.0,583.8571428571429
2940259.0,6,151,122723,85,114522,31305.14285714286,1510.0,1347.3176470588237,66,8201,40453.8,1510.0,124.25757575757576
26005.0,6,11,1133,6,602,4957.2,264.0,100.33333333333331,5,531,4314.5,259.0,106.2
77864.0,6,12,1413,7,882,12977.333333333334,291.0,126.0,5,531,17850.5,259.0,106.2
1036662.0,6,11,1134,6,558,207332.4,220.0,93.0,5,576,256696.75,304.0,115.2
221535.0,6,3,426,2,280,0.0,214.0,140.0,1,146,0.0,146.0,146.0
551.0,17,2,508,2,508,0.0,257.0,254.0,0,0,0.0,0.0,0.0
319.0,17,2,174,1,79,0.0,79.0,79.0,1,95,0.0,95.0,95.0
153437.0,17,2,180,1,90,0.0,90.0,90.0,1,90,0.0,90.0,90.0
2074.0,17,4,344,2,150,0.0,75.0,75.0,2,194,0.0,103.0,97.0
1178637.0,6,13,3010,8,2382,168376.7142857143,1514.0,297.75,5,628,226501.5,331.0,125.6
246206.0,6,3,337,2,214,0.0,160.0,107.0,1,123,0.0,123.0,123.0
135136433.0,17,6,1206,6,1206,27027286.6,201.0,201.0,0,0,0.0,0.0,0.0
40621.0,6,14,4740,7,653,5967.833333333333,249.0,93.28571428571428,7,4087,6634.666666666667,1514.0,583.8571428571429
232196.0,6,3,426,2,280,0.0,214.0,140.0,1,146,0.0,146.0,146.0
1216.0,17,2,762,2,762,0.0,381.0,381.0,0,0,0.0,0.0,0.0
90259353.0,6,13,2036,8,1016,12894193.285714284,188.0,127.0,5,1020,22523721.75,204.0,204.0
90282599.0,6,16,1192,8,596,12891600.57142857,95.0,74.5,8,596,12896032.0,95.0,74.5
110976883.0,6,32,2236,16,1165,7384071.733333333,139.0,72.8125,16,1071,7384069.866666666,123.0,66.9375
881108.0,6,10,1336,6,799,176221.6,461.0,133.16666666666666,4,537,201796.3333333333,331.0,134.25
304851.0,6,6,412,4,272,101617.0,74.0,68.0,2,140,0.0,74.0,70.0
90304370.0,6,16,1192,8,596,12893917.0,95.0,74.5,8,596,12898860.142857144,95.0,74.5
24182.0,6,14,4740,7,653,3508.5,249.0,93.28571428571428,7,4087,3893.6666666666665,1514.0,583.8571428571429
120127791.0,6,13,2020,9,1204,15015973.875,188.0,133.77777777777777,4,816,30031325.33333333,204.0,204.0
103079.0,17,2,286,2,286,0.0,143.0,143.0,0,0,0.0,0.0,0.0
2640831.0,6,25,7573,14,3735,203140.84615384616,1514.0,266.7857142857143,11,3838,238350.2,1514.0,348.90909090909093
59262.0,6,14,4740,7,653,9752.0,249.0,93.28571428571428,7,4087,9724.0,1514.0,583.8571428571429
114624944.0,6,48,3168,24,1584,4983693.217391305,66.0,66.0,24,1584,4971704.608695652,66.0,66.0
135132678.0,17,6,1206,6,1206,27026535.6,201.0,201.0,0,0,0.0,0.0,0.0
281122.0,6,10,1221,6,636,56224.4,298.0,106.0,4,585,92596.33333333331,379.0,146.25
264098.0,6,3,337,2,214,0.0,160.0,107.0,1,123,0.0,123.0,123.0
297.0,17,2,164,1,82,0.0,82.0,82.0,1,82,0.0,82.0,82.0
208191.0,6,3,426,2,280,0.0,214.0,140.0,1,146,0.0,146.0,146.0
2323.0,17,4,344,2,150,0.0,75.0,75.0,2,194,0.0,103.0,97.0
112401812.0,6,32,2220,16,1149,7479063.4,123.0,71.8125,16,1071,7479065.466666667,123.0,66.9375
6425.0,17,2,582,1,83,0.0,83.0,83.0,1,499,0.0,499.0,499.0
38074.0,6,14,4740,7,653,5528.333333333333,249.0,93.28571428571428,7,4087,6123.333333333333,1514.0,583.8571428571429
143602.0,6,2,132,1,66,0.0,66.0,66.0,1,66,0.0,66.0,66.0
95499523.0,17,12,778,6,389,19067712.8,174.0,64.83333333333333,6,389,19096003.8,174.0,64.83333333333333
238616.0,6,3,337,2,214,0.0,160.0,107.0,1,123,0.0,123.0,123.0
120045998.0,17,28,13364,28,13364,4446148.074074074,501.0,477.2857142857143,0,0,0.0,0.0,0.0
14060.0,6,10,2032,5,524,3307.25,252.0,104.8,5,1508,2981.5,1236.0,301.6
10428007.0,6,6,412,3,206,5145938.5,74.0,68.66666666666667,3,206,5145822.0,74.0,68.66666666666667
104230716.0,6,197,22286,99,6756,1063578.7346938776,140.0,68.24242424242425,98,15530,1064007.2783505155,284.0,158.46938775510205
108102241.0,17,5,955,5,955,27025560.25,191.0,191.0,0,0,0.0,0.0,0.0
2414.0,17,2,762,2,762,0.0,381.0,381.0,0,0,0.0,0.0,0.0
33811.0,6,14,4740,7,653,5292.333333333333,249.0,93.28571428571428,7,4087,5161.666666666667,1514.0,583.8571428571429
868.0,17,4,438,2,148,0.0,74.0,74.0,2,290,0.0,147.0,145.0
217616.0,6,3,426,2,280,0.0,214.0,140.0,1,146,0.0,146.0,146.0
97790.0,17,2,762,2,762,0.0,381.0,381.0,0,0,0.0,0.0,0.0
206120.0,6,3,426,2,280,0.0,214.0,140.0,1,146,0.0,146.0,146.0
430548.0,6,3,1604,2,851,0.0,785.0,425.5,1,753,0.0,753.0,753.0
90259374.0,6,14,2240,8,1016,12894196.285714284,188.0,127.0,6,1224,18018996.6,204.0,204.0
2666268.0,6,3,1777,2,951,0.0,885.0,475.5,1,826,0.0,826.0,826.0
2082.0,17,4,344,2,150,0.0,75.0,75.0,2,194,0.0,103.0,97.0
113937396.0,6,46,3036,23,1518,5164074.363636363,66.0,66.0,23,1518,5163996.318181818,66.0,66.0
260332.0,6,3,337,2,214,0.0,160.0,107.0,1,123,0.0,123.0,123.0
90528134.0,6,14,2240,8,1016,12932590.57142857,188.0,127.0,6,1224,18072756.0,204.0,204.0
103272.0,17,2,286,2,286,0.0,143.0,143.0,0,0,0.0,0.0,0.0
5622691.0,6,4,270,2,134,0.0,68.0,67.0,2,136,0.0,70.0,68.0
148070.0,17,2,180,1,90,0.0,90.0,90.0,1,90,0.0,90.0,90.0
1243898.0,17,7,490,7,490,207316.3333333333,70.0,70.0,0,0,0.0,0.0,0.0
31361.0,6,10,2032,5,524,7614.75,252.0,104.8,5,1508,6903.75,1236.0,301.6
2350.0,17,4,344,2,150,0.0,75.0,75.0,2,194,0.0,103.0,97.0
205717.0,17,2,180,1,90,0.0,90.0,90.0,1,90,0.0,90.0,90.0
0.0,17,1,381,1,381,0.0,381.0,381.0,0,0,0.0,0.0,0.0
298564.0,6,12,1373,7,714,49760.66666666666,298.0,102.0,5,659,74002.5,379.0,131.8
90027997.0,17,28,13364,28,13364,3334370.25925926,501.0,477.2857142857143,0,0,0.0,0.0,0.0
233138.0,6,3,373,2,238,0.0,172.0,119.0,1,135,0.0,135.0,135.0
1185222.0,6,13,3014,8,2386,169317.42857142858,1514.0,298.25,5,628,227348.75,331.0,125.6
297603.0,6,6,412,4,272,99201.0,74.0,68.0,2,140,0.0,74.0,70.0
202711.0,6,10,1221,6,636,40542.2,298.0,106.0,4,585,66635.33333333333,379.0,146.25
197165.0,17,2,180,1,90,0.0,90.0,90.0,1,90,0.0,90.0,90.0
25677.0,6,14,4740,7,653,4115.166666666667,249.0,93.28571428571428,7,4087,4049.8333333333335,1514.0,583.8571428571429
29809.0,6,14,4740,7,653,4578.0,249.0,93.28571428571428,7,4087,4830.166666666667,1514.0,583.8571428571429
4113306.0,6,212,164541,112,153639,37056.81081081081,1510.0,1371.7767857142858,100,10902,37519.40404040404,1510.0,109.02
98133497.0,6,274,32614,137,23350,719986.1397058824,300.0,170.43795620437956,137,9264,719986.25,140.0,67.62043795620438
204819.0,17,2,762,2,762,0.0,381.0,381.0,0,0,0.0,0.0,0.0
252385.00000000003,6,3,337,2,214,0.0,160.0,107.0,1,123,0.0,123.0,123.0
245882.0,6,3,373,2,238,0.0,172.0,119.0,1,135,0.0,135.0,135.0
41556.0,6,14,4740,7,653,6450.5,249.0,93.28571428571428,7,4087,6756.333333333333,1514.0,583.8571428571429
845488.0,6,9,1196,6,725,169097.6,387.0,120.83333333333331,3,471,286418.0,331.0,157.0
107880.0,17,2,286,2,286,0.0,143.0,143.0,0,0,0.0,0.0,0.0
107488.0,17,2,286,2,286,0.0,143.0,143.0,0,0,0.0,0.0,0.0
235484.0,6,3,337,2,214,0.0,160.0,107.0,1,123,0.0,123.0,123.0
57605.0,6,14,4740,7,653,9477.166666666666,249.0,93.28571428571428,7,4087,7531.0,1514.0,583.8571428571429
0.0,6,1,66,1,66,0.0,66.0,66.0,0,0,0.0,0.0,0.0
247847.0,17,4,1524,4,1524,82615.66666666667,381.0,381.0,0,0,0.0,0.0,0.0
510510.0,6,5,336,2,134,0.0,68.0,67.0,3,202,196342.5,70.0,67.33333333333333
561745.0,6,3,198,2,132,0.0,66.0,66.0,1,66,0.0,66.0,66.0
1053357.0,6,11,1134,6,558,210671.4,220.0,93.0,5,576,260998.25,304.0,115.2
0.0,17,1,55,1,55,0.0,55.0,55.0,0,0,0.0,0.0,0.0
239457.0,17,2,180,1,90,0.0,90.0,90.0,1,90,0.0,90.0,90.0
791360.0,6,5,1742,3,921,395680.0,785.0,307.0,2,821,0.0,753.0,410.5
76099.0,6,14,4740,7,653,12554.666666666666,249.0,93.28571428571428,7,4087,11430.833333333334,1514.0,583.8571428571429
156041.0,6,3,337,2,214,0.0,160.0,107.0,1,123,0.0,123.0,123.0
105545.0,17,2,700,2,700,0.0,350.0,350.0,0,0,0.0,0.0,0.0
9182.0,17,2,539,1,86,0.0,86.0,86.0,1,453,0.0,453.0,453.0
2807641.0,6,2,132,1,66,0.0,66.0,66.0,1,66,0.0,66.0,66.0
252440.0,6,3,337,2,214,0.0,160.0,107.0,1,123,0.0,123.0,123.0
205916.0,17,2,180,1,90,0.0,90.0,90.0,1,90,0.0,90.0,90.0
112001323.0,17,14,864,7,432,18666887.166666668,174.0,61.71428571428572,7,432,18500923.83333333,174.0,61.71428571428572
711856.0,17,2,876,2,876,0.0,438.0,438.0,0,0,0.0,0.0,0.0
214987.0,17,2,359,1,75,0.0,75.0,75.0,1,284,0.0,284.0,284.0
31120.0,6,14,4740,7,653,5029.833333333333,249.0,93.28571428571428,7,4087,4126.166666666667,1514.0,583.8571428571429
33925.0,6,14,4740,7,653,5426.0,249.0,93.28571428571428,7,4087,5093.833333333333,1514.0,583.8571428571429
33516.0,6,10,2032,5,524,7854.5,252.0,104.8,5,1508,7774.75,1236.0,301.6
142.0,17,3,1050,3,1050,71.0,350.0,350.0,0,0,0.0,0.0,0.0
108086661.0,17,5,955,5,955,27021665.25,191.0,191.0,0,0,0.0,0.0,0.0
102453.0,17,2,286,2,286,0.0,143.0,143.0,0,0,0.0,0.0,0.0
15500.0,6,14,4740,7,653,2413.0,249.0,93.28571428571428,7,4087,2450.333333333333,1514.0,583.8571428571429
3164584.0,6,18,1495,9,921,358329.375,315.0,102.33333333333331,9,574,358289.5,78.0,63.77777777777778
28885.0,6,14,4740,7,653,4557.0,249.0,93.28571428571428,7,4087,4456.0,1514.0,583.8571428571429
1008998.0,6,13,1513,7,882,167285.16666666666,291.0,126.0,6,631,200999.0,293.0,105.16666666666669
442237.0,6,3,1604,1,753,0.0,753.0,753.0,2,851,0.0,785.0,425.5
30650.0,6,10,1065,5,534,7482.75,262.0,106.8,5,531,7158.75,259.0,106.2
768.0,17,4,438,2,148,0.0,74.0,74.0,2,290,0.0,147.0,145.0
132532143.0,17,15,1169,8,606,18933163.285714287,174.0,75.75,7,563,18764878.5,174.0,80.42857142857143
118255450.0,6,47,3102,24,1584,5141530.217391305,66.0,66.0,23,1518,5160049.227272728,66.0,66.0
117247485.0,6,241,27334,121,8282,977062.375,140.0,68.44628099173553,120,19052,976746.613445378,284.0,158.76666666666668
107321.0,17,2,286,2,286,0.0,143.0,143.0,0,0,0.0,0.0,0.0
320.0,17,2,166,1,75,0.0,75.0,75.0,1,91,0.0,91.0,91.0
120004288.0,6,22,1680,12,894,10909480.727272728,95.0,74.5,10,786,13305229.555555556,95.0,78.6
0.0,6,1,66,1,66,0.0,66.0,66.0,0,0,0.0,0.0,0.0
36029.0,6,14,4740,7,653,5877.5,249.0,93.28571428571428,7,4087,5870.333333333333,1514.0,583.8571428571429
120125453.0,6,13,2020,9,1204,15015681.625,188.0,133.77777777777777,4,816,30031064.0,204.0,204.0
120011504.0,17,28,13364,28,13364,4444870.518518519,501.0,477.2857142857143,0,0,0.0,0.0,0.0
103247.0,17,2,286,2,286,0.0,143.0,143.0,0,0,0.0,0.0,0.0
46347.0,6,14,4740,7,653,6840.0,249.0,93.28571428571428,7,4087,5658.166666666667,1514.0,583.8571428571429
104617.0,17,2,700,2,700,0.0,350.0,350.0,0,0,0.0,0.0,0.0
26963.0,6,14,4740,7,653,3963.6666666666665,249.0,93.28571428571428,7,4087,4325.666666666667,1514.0,583.8571428571429
123839847.0,6,49,3234,25,1650,5159993.625,66.0,66.0,24,1584,5047214.913043479,66.0,66.0
135134152.0,17,6,1206,6,1206,27026830.4,201.0,201.0,0,0,0.0,0.0,0.0
90012797.0,17,28,13364,28,13364,3333807.296296296,501.0,477.2857142857143,0,0,0.0,0.0,0.0
5596730.0,6,5,336,2,134,0.0,68.0,67.0,3,202,1425188.0,70.0,67.33333333333333
206141.0,6,3,426,2,280,0.0,214.0,140.0,1,146,0.0,146.0,146.0
120012176.0,17,29,13785,29,13785,4286149.142857143,501.0,475.3448275862069,0,0,0.0,0.0,0.0
319891.0,17,4,1400,4,1400,106630.33333333331,350.0,350.0,0,0,0.0,0.0,0.0
4381.0,17,2,602,1,72,0.0,72.0,72.0,1,530,0.0,530.0,530.0
106819446.0,6,30,2106,15,1089,7614544.571428572,123.0,72.6,15,1017,7614534.428571428,123.0,67.8
196823.0,17,2,180,1,90,0.0,90.0,90.0,1,90,0.0,90.0,90.0
205820.0,6,3,426,2,280,0.0,214.0,140.0,1,146,0.0,146.0,146.0
14103.0,6,13,1459,7,862,2155.5,271.0,123.14285714285714,6,597,2525.0,259.0,99.5
14672729.0,6,19,1553,9,921,1792609.625,315.0,102.33333333333331,10,632,1593403.3333333333,78.0,63.2
2423.0,17,4,344,2,150,0.0,75.0,75.0,2,194,0.0,103.0,97.0
26335.0,6,10,1065,5,534,4547.0,262.0,106.8,5,531,5792.0,259.0,106.2
90046537.0,17,28,13364,28,13364,3335056.925925926,501.0,477.2857142857143,0,0,0.0,0.0,0.0
1029782.0,6,11,1134,6,558,205956.4,220.0,93.0,5,576,256022.0,304.0,115.2
10476040.0,6,7,478,4,272,3446624.6666666665,74.0,68.0,3,206,5169801.5,74.0,68.66666666666667
10439030.0,6,7,478,4,272,3434094.333333333,74.0,68.0,3,206,5151039.0,74.0,68.66666666666667
21406.0,6,10,2032,5,524,5078.25,252.0,104.8,5,1508,4303.75,1236.0,301.6
2594524.0,6,2,132,1,66,0.0,66.0,66.0,1,66,0.0,66.0,66.0
90351826.0,6,16,1192,8,596,12901689.714285716,95.0,74.5,8,596,12905659.714285716,95.0,74.5
107550910.0,17,14,864,7,432,17833504.166666668,174.0,61.71428571428572,7,432,17834274.666666668,174.0,61.71428571428572
2276.0,17,4,344,2,150,0.0,75.0,75.0,2,194,0.0,103.0,97.0
5958.0,17,4,344,2,150,0.0,75.0,75.0,2,194,0.0,103.0,97.0
105391735.0,6,43,2838,22,1452,5004307.952380952,66.0,66.0,21,1386,5150450.2,66.0,66.0
2417.0,17,4,344,2,150,0.0,75.0,75.0,2,194,0.0,103.0,97.0
120005131.0,6,24,1949,12,853,10909557.363636363,95.0,71.08333333333333,12,1096,10886450.909090908,256.0,91.33333333333331
207748.0,6,3,426,2,280,0.0,214.0,140.0,1,146,0.0,146.0,146.0
108099162.0,17,5,955,5,955,27024790.5,191.0,191.0,0,0,0.0,0.0,0.0
43189745.0,6,28,7763,15,3809,380412.4285714286,1514.0,253.9333333333333,13,3954,3581115.333333333,1514.0,304.15384615384613
143947.0,17,2,180,1,90,0.0,90.0,90.0,1,90,0.0,90.0,90.0
356.0,17,2,166,1,75,0.0,75.0,75.0,1,91,0.0,91.0,91.0
217966.0,6,3,426,2,280,0.0,214.0,140.0,1,146,0.0,146.0,146.0
1670224.0,6,22,6443,11,1463,167022.4,357.0,133.0,11,4980,136924.0,1510.0,452.7272727272728
145048.0,17,2,180,1,70,0.0,70.0,70.0,1,110,0.0,110.0,110.0
235263.0,6,3,337,2,214,0.0,160.0,107.0,1,123,0.0,123.0,123.0
39527.0,6,14,4740,7,653,5749.666666666667,249.0,93.28571428571428,7,4087,5057.833333333333,1514.0,583.8571428571429
94005853.0,6,182,20538,91,14310,1041687.6666666666,284.0,157.25274725274724,91,6228,1042119.3555555556,140.0,68.43956043956044
42740.0,6,14,4740,7,653,6954.0,249.0,93.28571428571428,7,4087,6516.333333333333,1514.0,583.8571428571429
109679809.0,6,33,2428,17,1288,6841500.625,139.0,75.76470588235294,16,1140,7297598.266666667,123.0,71.25
3051160.0,6,3,204,1,68,0.0,68.0,68.0,2,136,0.0,70.0,68.0
106191259.0,17,14,864,7,432,17666843.5,174.0,61.71428571428572,7,432,17667723.333333332,174.0,61.71428571428572
643325.0,17,2,166,1,75,0.0,75.0,75.0,1,91,0.0,91.0,91.0
190922.0,17,2,180,1,90,0.0,90.0,90.0,1,90,0.0,90.0,90.0
108099853.0,17,5,1005,5,1005,27024963.25,201.0,201.0,0,0,0.0,0.0,0.0
135130169.0,17,6,1146,6,1146,27026033.8,191.0,191.0,0,0,0.0,0.0,0.0
26280.0,6,20,7606,11,978,2628.0,310.0,88.9090909090909,9,6628,1994.875,1514.0,736.4444444444445
75088483.0,6,9,842,9,842,9386060.375,97.0,93.55555555555556,0,0,0.0,0.0,0.0
148092.0,6,3,337,2,214,0.0,160.0,107.0,1,123,0.0,123.0,123.0
228496.0,17,2,180,1,90,0.0,90.0,90.0,1,90,0.0,90.0,90.0
3383.0,17,4,571,2,148,0.0,74.0,74.0,2,423,0.0,280.0,211.5
209566.0,17,2,180,1,90,0.0,90.0,90.0,1,90,0.0,90.0,90.0
205977.0,6,3,426,2,280,0.0,214.0,140.0,1,146,0.0,146.0,146.0
120124201.0,6,13,2036,5,1020,30031050.25,204.0,204.0,8,1016,17137239.0,188.0,127.0
902146.0,6,12,2710,7,743,150357.66666666666,339.0,106.14285714285714,5,1967,156575.25,1514.0,393.4
159950.0,6,2,128,1,74,0.0,74.0,74.0,1,54,0.0,54.0,54.0
309140.0,6,3,202,2,128,0.0,74.0,64.0,1,74,0.0,74.0,74.0
10910086.0,6,8,544,4,272,3591259.0,74.0,68.0,4,272,3591186.6666666665,74.0,68.0
54845.0,6,14,4740,7,653,7432.5,249.0,93.28571428571428,7,4087,8046.333333333333,1514.0,583.8571428571429
173928.0,17,2,614,1,72,0.0,72.0,72.0,1,542,0.0,542.0,542.0
90046177.0,17,28,13364,28,13364,3335043.592592593,501.0,477.2857142857143,0,0,0.0,0.0,0.0
14304.0,6,11,1131,6,600,2688.4,262.0,100.0,5,531,3359.5,259.0,106.2
308832.0,6,6,412,4,272,102944.0,74.0,68.0,2,140,0.0,74.0,70.0
191041.0,17,2,180,1,90,0.0,90.0,90.0,1,90,0.0,90.0,90.0
136911.0,6,2,132,1,66,0.0,66.0,66.0,1,66,0.0,66.0,66.0
294533.0,17,2,620,1,75,0.0,75.0,75.0,1,545,0.0,545.0,545.0
404.0,17,2,410,1,78,0.0,78.0,78.0,1,332,0.0,332.0,332.0
1314584.0,6,4,264,2,132,0.0,66.0,66.0,2,132,0.0,66.0,66.0
100228899.0,6,29,2068,15,1105,7159207.071428572,139.0,73.66666666666667,14,963,7693264.0,123.0,68.78571428571429
118705710.0,6,31,2160,16,1071,7913684.866666666,123.0,66.9375,15,1089,7765592.857142857,123.0,72.6
783.0,17,4,438,2,148,0.0,74.0,74.0,2,290,0.0,147.0,145.0
90064603.0,17,28,13364,28,13364,3335726.037037037,501.0,477.2857142857143,0,0,0.0,0.0,0.0
813.0,17,4,438,2,148,0.0,74.0,74.0,2,290,0.0,147.0,145.0
112284546.0,6,31,2166,16,1149,7471255.266666667,123.0,71.8125,15,1017,8004916.642857143,123.0,67.8
2526.0,17,2,762,2,762,0.0,381.0,381.0,0,0,0.0,0.0,0.0
59408.0,6,12,1328,7,797,9901.333333333334,253.0,113.85714285714286,5,531,12325.0,259.0,106.2
1035492.0,6,11,1134,6,558,207098.4,220.0,93.0,5,576,257657.5,304.0,115.2
90919503.0,6,21,1585,11,840,9091718.0,95.0,76.36363636363636,10,745,10100478.555555556,95.0,74.5
90049575.0,17,28,13364,28,13364,3335169.4444444445,501.0,477.2857142857143,0,0,0.0,0.0,0.0
2508228.0,6,51,23848,26,19851,100329.12,1514.0,763.5,25,3997,95908.20833333331,1514.0,159.88
209674.0,6,3,426,2,280,0.0,214.0,140.0,1,146,0.0,146.0,146.0
3236.0,17,2,224,1,76,0.0,76.0,76.0,1,148,0.0,148.0,148.0
770.0,17,4,438,2,148,0.0,74.0,74.0,2,290,0.0,147.0,145.0
90308864.0,6,21,1585,11,840,9025917.3,95.0,76.36363636363636,10,745,9950117.333333334,95.0,74.5
120292147.0,6,216,24542,108,7436,1116581.5607476635,140.0,68.85185185185185,108,17106,1116560.3457943923,374.0,158.38888888888889
184841.0,17,2,180,1,90,0.0,90.0,90.0,1,90,0.0,90.0,90.0
208416.0,6,10,1221,6,636,41683.2,298.0,106.0,4,585,68246.66666666667,379.0,146.25
82125.0,6,10,2032,5,524,17266.0,252.0,104.8,5,1508,19705.5,1236.0,301.6
50920.0,6,10,2032,5,524,12454.25,252.0,104.8,5,1508,12126.75,1236.0,301.6
17514.0,17,2,180,1,90,0.0,90.0,90.0,1,90,0.0,90.0,90.0
2520102.0,6,3,1604,2,851,0.0,785.0,425.5,1,753,0.0,753.0,753.0
304134.0,6,6,412,4,272,101378.0,74.0,68.0,2,140,0.0,74.0,70.0
467.0,17,2,166,1,75,0.0,75.0,75.0,1,91,0.0,91.0,91.0
1023292.0,6,11,1134,6,558,204658.4,220.0,93.0,5,576,254842.25,304.0,115.2
5624872.0,6,5,336,2,134,0.0,68.0,67.0,3,202,1526865.0,70.0,67.33333333333333
49714.0,6,10,2032,5,524,12209.0,252.0,104.8,5,1508,11631.75,1236.0,301.6
228768.0,17,2,180,1,90,0.0,90.0,90.0,1,90,0.0,90.0,90.0
2604303.0,6,2,132,1,66,0.0,66.0,66.0,1,66,0.0,66.0,66.0
0.0,17,1,55,1,55,0.0,55.0,55.0,0,0,0.0,0.0,0.0
9835.0,17,2,582,1,83,0.0,83.0,83.0,1,499,0.0,499.0,499.0
216734.0,6,3,426,2,280,0.0,214.0,140.0,1,146,0.0,146.0,146.0
12310.0,6,10,2032,5,524,2234.25,252.0,104.8,5,1508,2756.5,1236.0,301.6
2483.0,17,4,344,2,150,0.0,75.0,75.0,2,194,0.0,103.0,97.0
208657.0,17,2,180,1,90,0.0,90.0,90.0,1,90,0.0,90.0,90.0
38554.0,6,14,4740,7,653,6274.666666666667,249.0,93.28571428571428,7,4087,5938.166666666667,1514.0,583.8571428571429
3223302.0,6,188,166095,115,156975,28274.57894736842,1510.0,1365.0,73,9120,40498.069444444445,1510.0,124.93150684931508
302381.0,6,2,132,1,66,0.0,66.0,66.0,1,66,0.0,66.0,66.0
120179261.0,6,18,1341,9,691,14996840.5,95.0,76.77777777777777,9,650,14996841.5,95.0,72.22222222222223
334579.0,6,6,412,4,272,111526.33333333331,74.0,68.0,2,140,0.0,74.0,70.0
24151.0,6,14,4740,7,653,3894.0,249.0,93.28571428571428,7,4087,3888.5,1514.0,583.8571428571429
135132874.0,17,6,1146,6,1146,27026574.8,191.0,191.0,0,0,0.0,0.0,0.0
24000.0,6,14,4740,7,653,3520.1666666666665,249.0,93.28571428571428,7,4087,3501.333333333333,1514.0,583.8571428571429
165610.0,6,11,1132,6,556,33122.0,218.0,92.66666666666669,5,576,40360.0,304.0,115.2
119888449.0,17,35,16705,35,16705,3526130.8529411764,501.0,477.2857142857143,0,0,0.0,0.0,0.0
43955.0,6,10,2032,5,524,10395.25,252.0,104.8,5,1508,8524.5,1236.0,301.6
297329.0,6,6,412,4,272,99109.66666666669,74.0,68.0,2,140,0.0,74.0,70.0
285.0,17,2,164,1,82,0.0,82.0,82.0,1,82,0.0,82.0,82.0
119449452.0,6,242,27310,121,19028,993702.2083333334,284.0,157.25619834710744,121,8282,993707.3583333332,140.0,68.44628099173553
144037.0,17,2,180,1,90,0.0,90.0,90.0,1,90,0.0,90.0,90.0
461145.0,6,3,204,1,68,0.0,68.0,68.0,2,136,0.0,70.0,68.0
