flow_duration,protocol,TotPackets,TotBytes,tot_fwd_pkts,totlen_fwd_pkts,fwd_iat_mean,fwd_pkt_len_max,fwd_pkt_len_mean,tot_bwd_pkts,totlen_bwd_pkts,bwd_iat_mean,bwd_pkt_len_max,bwd_pkt_len_mean
0.02,17,2,144,1,36,0,36,64,1,52,0,52,80
202.219,17,3,1008,3,308,101109,308,1008,0,0,0,0,0
1772.166,6,180,15480,120,69,14892,69,8940,60,69,30033,69,6540
0.065,17,2,152,1,48,0,48,76,1,48,0,48,76
2.414,17,4,1564,4,363,804,363,1564,0,0,0,0,0
0.17,6,2,104,1,0,0,0,52,1,0,0,0,52
114.645,17,4,352,2,60,114644,60,176,2,60,114644,60,176
1740.428,17,30,7050,30,207,60014,207,7050,0,0,0,0,0
1.639,6,30,10405,18,367,96,833,1825,12,1012,140,1420,8580
3.113,6,4,240,1,0,0,0,60,3,0,1499,0,180
155.439,17,4,352,2,60,155438,60,176,2,60,155438,60,176
1788.768,6,377,26257,216,98,8319,469,15332,161,69,11179,69,10925
1.89,6,5,280,3,0,945,0,160,2,0,1009,0,120
0.028,6,18,6108,10,88,3,88,556,8,1305,3,1880,5552
1767.881,6,136,8308,72,26,24899,26,4362,64,26,28060,26,3946
1785.198,17,87,3648,86,14,21002,14,3612,1,8,0,8,36
0.449,6,94,86266,55,199,8,253,3892,39,2231,11,8448,82374
1782.864,6,104,8376,68,65,26609,65,4930,36,59,50936,59,3446
1786.61,17,87,3648,86,14,21018,14,3612,1,8,0,8,36
1.292,6,49,19058,27,877,49,1440,13402,22,433,53,1440,5656
1.37,6,49,19370,27,900,52,1460,13714,22,476,56,2615,5656
0.287,17,2,152,1,48,0,48,76,1,48,0,48,76
5.746,17,8,1672,4,46,1113,46,296,4,316,1885,484,1376
3.082,6,27,6858,14,350,236,1420,2316,13,574,256,1420,4542
1741.669,17,29,6815,29,207,62202,207,6815,0,0,0,0,0
1794.523,6,361,23727,210,81,8586,469,13478,151,69,11960,69,10249
30.491,6,31,5402,17,210,1904,210,1594,14,616,2342,904,3808
54.522,6,22,4882,8,308,7788,722,1656,14,310,4178,1408,3226
1.47,6,48,20912,28,945,54,1360,15336,20,433,66,1360,5576
0.02,17,8,2446,8,277,2,316,2446,0,0,0,0,0
1748.494,6,95,7203,63,38,28201,205,4476,32,33,56392,98,2727
34.119,6,37,7678,18,154,2007,721,2062,19,462,1885,1408,5616
31.809,6,6,360,0,0,0,0,0,6,0,0,0,360
3.356,17,6,501,3,39,919,39,201,3,72,0,72,300
25.276,17,30,4528,15,48,1804,48,1140,15,197,1804,308,3388
35.526,6,31,5113,16,136,2368,722,1918,15,399,2524,1402,3195
87.77,6,750,373893,418,835,210,1152,355104,332,423,264,1179,18789
1.139,17,24,11122,12,673,101,1350,8423,12,196,100,1350,2699
1772.146,6,180,15480,120,69,14891,69,8940,60,69,30032,69,6540
26.913,6,24,4581,9,241,3364,722,1428,15,293,1901,1448,3153
11.818,6,1638,1560882,1077,1374,10,1408,1527034,561,776,20,1408,33848
497.77,17,6,1984,6,302,99554,308,1984,0,0,0,0,0
1773.391,6,180,15480,120,69,14902,69,8940,60,69,30050,69,6540
1009.951,6,66,9584,38,99,20405,502,3222,28,209,37402,1420,6362
0.004,6,3,3040,2,1448,2,1448,3000,1,0,0,0,40
1745.584,6,97,7307,63,38,28154,205,4476,34,33,52887,98,2831
0.044,17,2,251,1,36,0,36,64,1,159,0,159,187
24.391,6,11,684,3,106,12190,106,234,8,90,3482,90,450
1781.846,6,363,24814,212,94,8444,469,14427,151,69,11878,69,10387
1746.293,6,95,7203,63,38,28166,205,4476,32,33,56321,98,2727
10.777,6,20,4442,11,275,1077,275,998,9,768,758,1440,3444
28.857,17,16,1408,8,48,4120,48,608,8,72,4120,72,800
1.145,6,25,8080,12,164,88,267,1312,13,869,81,1408,6768
34.73,17,33,16155,14,495,2668,1350,7327,19,436,1927,1350,8828
1778.296,17,142,11360,71,48,25404,48,5396,71,56,25404,56,5964
0.123,17,2,390,1,46,0,46,74,1,288,0,288,316
65.971,6,561,475505,241,227,274,356,15027,320,1404,206,2816,460478
12.258,6,92,27362,47,548,266,1152,21080,45,447,272,1179,6282
1681.906,17,14,1036,7,30,280304,30,406,7,62,280315,62,630
1786.624,6,104,8376,68,65,26666,65,4930,36,59,51042,59,3446
1795.784,17,142,11360,71,48,25653,48,5396,71,56,25653,56,5964
1794.656,1,339,28476,339,56,5309,56,28476,0,0,0,0,0
6.167,6,42,7405,22,218,293,314,3503,20,516,311,1179,3902
10.666,6,89,26149,45,532,242,1152,19907,44,447,241,1179,6242
1787.363,6,103,8395,68,65,26677,65,4930,35,59,52564,59,3465
1688.769,1,7,392,7,28,281461,28,392,0,0,0,0,0
36.393,6,56,19239,29,991,488,1360,13128,27,386,1393,2720,6111
1769.532,6,192,18381,113,86,15799,205,10544,79,47,22682,98,7837
1.823,17,4,377,2,33,1798,37,123,2,99,1796,136,254
0.02,17,2,680,2,312,20,318,680,0,0,0,0,0
4.133,17,29,16200,14,479,315,1350,7103,15,578,292,1350,9097
1790.917,6,126,12589,77,62,23564,722,6403,49,88,37302,1448,6186
602.074,6,99,16298,50,86,12283,721,4521,49,392,12539,1414,11777
1682.782,17,14,1036,7,30,280454,30,406,7,62,280455,62,630
2.399,6,5,284,3,0,1107,0,164,2,0,2216,0,120
168.118,17,4,1344,4,308,56039,308,1344,0,0,0,0,0
287.27,6,28,8834,10,181,20,267,1128,18,537,16897,1400,7706
11.537,6,1913,1745906,1199,1377,9,1408,1704114,714,931,15,2801,41792
1790.254,17,142,11360,71,48,25574,48,5396,71,56,25574,56,5964
0.044,6,2,104,2,24,44,24,104,0,0,0,0,0
1740.579,17,30,7050,30,207,60019,207,7050,0,0,0,0,0
0.594,17,2,144,1,36,0,36,64,1,52,0,52,80
240.207,6,54,18286,29,819,8578,1418,15445,25,191,10008,580,2841
0.526,6,7,295,4,0,175,0,164,3,7,161,7,131
0.031,17,2,439,1,33,0,33,61,1,350,0,350,378
1780.264,6,302,26250,179,75,10001,267,12086,123,133,14592,1420,14164
6.542,6,816,639787,428,1398,14,1448,611151,388,776,16,1448,28636
38.914,17,22,1936,11,48,3890,48,836,11,72,3890,72,1100
240.167,6,54,17961,29,783,8577,1408,14843,25,226,10006,580,3118
24.072,17,44,13861,20,344,1265,1350,7445,24,239,1045,1350,6416
20.459,17,15,7451,7,504,3404,1350,3728,8,437,2918,1350,3723
279.042,1,4,326,4,53,93014,78,326,0,0,0,0,0
0.01,17,2,182,1,39,0,39,67,1,87,0,87,115
1695.584,17,16,1265,8,30,242224,37,471,8,71,242224,136,794
880.099,17,98,38024,98,360,9073,360,38024,0,0,0,0,0
1787.452,6,102,8296,68,65,26678,65,4930,34,59,54162,59,3366
1.417,6,284,225592,141,343,10,343,9482,143,1512,9,2816,216110
22.082,6,3084,2904502,2011,1366,10,1408,2844042,1073,931,20,2816,60460
307.504,17,7,2328,7,304,51250,308,2328,0,0,0,0,0
0.95,17,4,592,2,64,796,64,184,2,176,949,192,408
4.903,6,35,17885,20,844,258,1368,5257,15,1315,345,2534,12628
0.046,17,2,549,1,30,0,30,58,1,463,0,463,491
1785.848,6,363,25421,210,100,8544,469,14816,153,69,11748,69,10605
33.65,6,32,5146,15,154,2403,722,1859,17,299,2090,1440,3287
1.98,6,9,527,5,43,495,43,311,4,0,624,0,216
1789.247,6,367,25581,213,99,8439,469,15005,154,69,11694,69,10576
191.084,6,10,554,4,106,63692,106,274,6,0,38213,0,280
34.125,17,10,760,10,48,3791,48,760,0,0,0,0,0
219.686,17,6,2000,6,305,43937,308,2000,0,0,0,0,0
35.127,17,4,240,2,32,35126,32,120,2,32,35126,32,120
1622.758,1,7,742,7,78,270459,78,742,0,0,0,0,0
24.872,6,37,22746,17,244,1554,347,1859,20,1167,1308,1408,20887
1739.337,1,15,840,15,28,124238,28,840,0,0,0,0,0
0.165,17,3,3140,3,1018,82,1438,3140,0,0,0,0,0
63.942,6,36,23941,19,840,38,1360,5835,17,1741,3988,6800,18106
3.843,17,4,1564,4,363,1281,363,1564,0,0,0,0,0
366.411,6,25,1651,17,177,22900,177,1117,8,110,9160,110,534
332.098,6,2908,1516685,1655,848,200,1152,1452392,1253,345,265,373,64293
1620.925,17,27,6345,27,207,62343,207,6345,0,0,0,0,0
0.032,17,2,383,1,33,0,33,61,1,294,0,294,322
15.239,6,14,1025,7,222,2538,222,506,7,231,2538,231,519
0.141,6,9,1002,5,213,35,213,417,4,421,41,421,585
1783.723,17,82,3438,81,14,22296,14,3402,1,8,0,8,36
1.284,6,50,19269,27,890,49,1360,13573,23,433,50,1360,5696
1796.171,17,142,11360,71,48,25659,48,5396,71,56,25659,56,5964
0.388,6,13,1693,7,288,59,288,588,6,426,45,434,1105
183.267,17,4,352,2,60,183266,60,176,2,60,183266,60,176
2.331,6,58,22597,29,966,83,1440,16661,29,433,76,1440,5936
1.78,17,12,6310,6,615,356,1350,3860,6,380,332,1350,2450
31.322,6,23,8897,11,525,128,1237,2060,12,906,2831,1591,6837
10.036,17,4,386,2,43,10029,43,142,2,94,10029,94,244
0.305,6,23,7307,12,318,27,600,1906,11,964,29,1471,5401
0.329,17,2,152,1,48,0,48,76,1,48,0,48,76
643.011,6,49,4084,25,65,24945,65,1910,24,60,27951,90,2174
134.215,6,230,180096,142,1310,951,1408,164622,88,680,1407,3847,15474
108.544,6,76,50337,46,1201,2412,1408,42044,30,960,2123,3847,8293
1795.438,17,80,3354,79,14,23018,14,3318,1,8,0,8,36
0.063,17,4,1116,2,32,58,32,120,2,470,58,470,996
1744.669,2,11,352,11,8,174466,8,352,0,0,0,0,0
1792.503,17,87,3648,86,14,21088,14,3612,1,8,0,8,36
0.049,17,2,152,1,48,0,48,76,1,48,0,48,76
1460.101,17,147,9408,147,36,10000,36,9408,0,0,0,0,0
1783.62,6,184,33065,121,302,14863,302,24714,63,83,28767,83,8351
7.864,17,6,528,3,48,3925,48,228,3,72,3925,72,300
0.386,6,13,1693,7,288,62,288,588,6,426,42,434,1105
1734.771,1,56,4704,0,0,0,0,0,56,56,31541,56,4704
3.528,6,996,954625,348,328,10,328,27300,648,1398,5,2876,927325
280.51,6,31,7472,13,158,23375,267,1317,18,603,16494,2076,6155
1.115,6,24,8004,12,164,86,267,1288,12,1014,86,2816,6716
42.534,17,12,912,12,48,3866,48,912,0,0,0,0,0
1740.941,6,87,6322,58,31,30542,31,3915,29,31,62176,31,2407
240.303,6,39,5265,19,235,13348,751,2646,20,196,12644,671,2619
45.178,17,4,580,2,40,45034,40,136,2,194,45024,194,444
1799.547,6,369,25730,216,99,8369,469,15125,153,69,11838,69,10605
0.084,17,2,572,1,39,0,39,67,1,477,0,477,505
0.036,6,17,6068,10,88,3,88,556,7,1740,5,1880,5512
0.337,6,22,7342,12,335,29,668,1974,10,1210,36,1866,5368
1741.064,6,92,6668,60,31,29509,31,4062,32,31,56163,31,2606
10.652,6,1666,1461518,1020,1379,10,1420,1431445,646,467,16,1883,30073
0.528,17,8,2750,8,315,75,354,2750,0,0,0,0,0
5.174,6,11,1843,5,549,1293,549,753,6,421,1031,421,1090
1.309,6,38,8252,19,320,72,1162,2716,19,433,63,1460,5536
100.262,6,600,282509,313,835,321,1152,269069,287,488,349,1179,13440
0.517,17,3,451,2,39,115,39,134,1,289,0,289,317
158.15,6,32,8952,14,158,12165,267,1357,18,624,9291,1300,7595
33.567,6,33,7624,14,152,2582,267,1484,19,413,1857,1460,6140
300.543,6,25,8471,13,364,25045,858,2141,12,712,5582,1448,6330
1756.598,17,154,28972,154,160,11481,422,28972,0,0,0,0,0
404.181,1,10,560,10,28,44909,28,560,0,0,0,0,0
3.93,17,4,268,4,39,1310,39,268,0,0,0,0,0
72.201,6,587,274076,309,832,234,1152,257110,278,389,259,1152,16966
254.891,17,4,244,2,33,254890,33,122,2,33,254890,33,122
0.465,17,3,451,2,39,221,39,134,1,289,0,289,317
5.824,6,42,7389,22,201,277,314,3503,20,513,293,1179,3886
127.442,6,9,522,2,106,127431,106,194,7,0,21237,0,328
0.044,6,3,164,2,0,44,0,100,1,0,0,0,64
240.25,6,58,20523,32,842,7749,1418,17688,26,184,9609,580,2835
1797.038,17,448,39896,403,35,4470,288,25676,45,288,40016,288,14220
1744.469,6,94,7151,62,38,28597,205,4424,32,33,56261,98,2727
0.6,6,24,7480,14,273,46,663,2104,10,967,62,1471,5376
0.055,17,2,184,1,32,0,32,60,1,96,0,96,124
1747.16,6,92,6680,54,33,32965,33,3783,38,31,47215,31,2897
1.291,6,32,11105,18,562,75,1360,4137,14,799,85,3494,6968
1792.349,6,131,13271,73,68,24893,722,6256,58,79,27626,2330,7015
64.088,6,27,7177,13,155,5340,267,1306,14,530,4929,3417,5871
1741.054,6,87,6322,58,31,30544,31,3915,29,31,62176,31,2407
1.388,17,14,7389,7,665,231,1350,4852,7,334,222,1350,2537
0.048,17,2,192,1,60,0,60,88,1,76,0,76,104
0.291,6,10,1379,6,145,58,145,389,4,826,48,826,990
1.777,6,20,3833,11,234,177,564,1504,9,463,197,1343,2329
0.372,6,13,1693,7,288,60,288,588,6,426,40,434,1105
1787.733,1,78,4368,78,28,23217,28,4368,0,0,0,0,0
280.031,6,26,7272,12,158,25457,267,1277,14,775,21537,3445,5995
1745.877,6,94,7151,62,38,28620,205,4424,32,33,56309,98,2727
280.206,6,29,7392,14,158,21554,267,1357,15,678,20011,3536,6035
4.159,6,40,7309,20,218,218,314,3423,20,440,205,1152,3886
125.551,2,2,64,2,8,125551,8,64,0,0,0,0,0
4.175,6,39,7269,20,218,219,314,3423,19,440,217,1152,3846
12.869,6,2192,2055435,1419,1371,8,1408,2010575,773,931,16,2816,44860
46.56,6,10,909,6,302,9312,302,610,4,83,15017,83,299
15.304,6,969,828876,601,1304,25,1368,805076,368,776,41,2736,23800
1744.679,2,17,544,17,8,109042,8,544,0,0,0,0,0
40.092,17,12,1764,6,48,8016,48,456,6,190,8016,308,1308
0.089,17,2,362,1,46,0,46,74,1,260,0,260,288
0.998,17,2,677,1,300,0,300,328,1,321,0,321,349
0.275,17,2,154,1,33,0,33,61,1,65,0,65,93
0.359,6,10,968,5,256,88,256,460,5,304,87,304,508
0.226,6,27,7296,14,155,17,267,1341,13,678,18,3436,5955
185.56,6,68,11462,31,198,6185,1189,3629,37,302,5150,1917,7833
5.024,17,3,208,2,36,5004,36,128,1,52,0,52,80
93.432,6,57,8100,34,180,2831,180,3576,23,166,4246,206,4524
1.768,17,20,5190,20,231,93,389,5190,0,0,0,0,0
1.749,6,6,436,0,0,0,0,0,6,31,349,31,436
1781.758,6,361,22858,210,69,8525,69,12678,151,69,11878,69,10180
0.058,17,2,136,1,32,0,32,60,1,48,0,48,76
174.126,17,8,2688,8,308,24875,308,2688,0,0,0,0,0
3.019,17,2,178,1,29,0,29,57,1,93,0,93,121
1787.375,6,379,28751,220,126,8161,469,17630,159,69,11310,69,11121
1789.956,17,142,11360,71,48,25570,48,5396,71,56,25570,56,5964
1787.111,6,105,8481,69,65,26281,65,5035,36,59,51056,59,3446
280.469,6,29,7392,13,158,23372,267,1317,16,603,18695,2036,6075
160.636,17,4722,5652316,615,62,261,1350,55819,4107,1334,39,1350,5596497
60.998,6,10,826,5,180,15249,180,448,5,110,15197,110,378
1793.506,6,368,23345,213,69,8459,69,12936,155,69,11644,69,10409
5.19,6,848,722454,509,1379,10,1420,704673,339,467,15,1883,17781
1620.389,1,7,742,7,78,270064,78,742,0,0,0,0,0
183.242,17,4,352,2,60,183241,60,176,2,60,183240,60,176
10.983,6,83,24541,42,550,267,1152,18760,41,459,267,1179,5781
0.047,6,10,1510,5,657,11,657,925,5,317,11,317,585
601.621,2,6,192,6,8,120324,8,192,0,0,0,0,0
1743.128,6,95,7234,62,38,28575,205,4424,33,33,54463,98,2810
1040.055,6,176,27765,72,238,14648,686,12577,104,215,10097,857,15188
1456.37,1,48,4032,0,0,0,0,0,48,56,30986,56,4032
4.971,17,4,542,2,36,4967,36,128,2,179,4966,187,414
300.802,6,42,12834,23,784,13672,1360,7241,19,370,477,1360,5593
1784.809,6,369,23385,212,69,8458,69,12965,157,69,11441,69,10420
1.735,6,14,2351,8,188,247,245,700,6,703,290,1152,1651
31.965,6,355,346318,122,126,264,301,6723,233,1423,137,2836,339595
10.77,6,16,4735,9,290,1346,517,1057,7,1102,1750,1448,3678
33.11,6,297,129756,155,787,215,1152,119626,142,444,232,1179,10130
6.015,17,4,406,2,46,6004,46,148,2,101,6007,101,258
0.002,6,2,100,1,0,0,0,60,1,0,0,0,40
1.907,17,25,6283,10,260,211,1350,2888,15,198,115,1350,3395
1744.646,2,25,800,25,8,72693,8,800,0,0,0,0,0
115.958,6,27,8995,9,267,291,502,1166,18,473,6815,1420,7829
23.905,6,28,4862,15,176,1707,517,2035,13,428,1991,499,2827
1797.596,17,447,39580,403,35,4471,288,25676,44,288,40946,288,13904
161.768,17,4,352,2,60,161767,60,176,2,60,161767,60,176
0.103,17,2,2382,2,1163,103,1163,2382,0,0,0,0,0
245.218,17,4,352,2,60,245217,60,176,2,60,245217,60,176
64.326,6,44,15360,23,974,412,1360,9718,21,399,3207,1360,5642
1700.447,17,12,498,11,14,170044,14,462,1,8,0,8,36
0.136,17,2,347,1,29,0,29,57,1,262,0,262,290
50.403,6,14,3167,8,49,7200,92,523,6,1164,10044,1408,2644
6.0,6,7,4703,7,619,1000,718,4703,0,0,0,0,0
0.456,6,13,1693,6,288,90,288,548,7,426,42,434,1145
0.004,17,2,548,2,246,4,246,548,0,0,0,0,0
11.947,6,1959,1647073,1161,1363,10,1380,1610911,798,383,14,1380,36162
1767.303,17,270,54554,270,174,6569,379,54554,0,0,0,0,0
148.229,6,25,7094,11,181,14822,267,1168,14,595,11401,1400,5926
0.011,17,2,339,1,33,0,33,61,1,250,0,250,278
14.894,6,27,4865,13,154,1215,722,1766,14,394,1131,1448,3099
209.257,2,4,128,4,8,69752,8,128,0,0,0,0,0
1790.819,6,365,24494,212,87,8487,469,14096,153,69,11781,69,10398
20.12,6,21,6046,12,147,1829,318,1233,9,1084,2513,1668,4813
1791.172,1,173,9688,173,28,10413,28,9688,0,0,0,0,0
1787.906,6,382,26595,217,97,8277,469,15579,165,69,10901,69,11016
306.011,6,47,8047,21,159,15300,517,2052,26,384,12225,1418,5995
4.998,17,4,558,2,36,4994,36,128,2,187,4994,187,430
1.962,6,27,7887,16,282,130,578,1490,11,992,178,1452,6397
14.011,6,23,4574,12,275,1273,275,1042,11,768,924,1440,3532
1776.435,17,140,11200,70,48,25745,48,5320,70,56,25745,56,5880
28.477,6,17,5942,10,308,3164,722,1796,7,941,2410,2026,4146
0.082,1,10,280,10,0,0,0,280,0,0,0,0,0
0.118,6,12,3705,6,171,23,171,491,6,964,23,1448,3214
5.668,6,2,1175,1,0,0,0,40,1,1095,0,1095,1135
1.396,6,48,19233,27,893,53,1460,13617,21,476,61,2615,5616
1.15,6,10,1687,7,100,191,100,384,3,1179,455,1179,1303
1.639,17,22,9055,11,349,160,1350,4153,11,417,160,1350,4902
378.88,2,3,96,3,8,189440,8,96,0,0,0,0,0
1794.992,17,140,11200,70,48,26014,48,5320,70,56,26014,56,5880
1.339,6,21,7281,12,334,121,663,1969,9,967,166,1471,5312
0.033,17,4,368,2,32,18,32,120,2,96,15,96,248
158.737,2,6,192,6,8,31747,8,192,0,0,0,0,0
1.419,6,50,19870,28,870,52,1360,14214,22,476,58,2715,5656
857.319,6,87,7551,54,69,14755,69,4023,33,69,26790,69,3528
0.037,17,4,284,2,32,19,32,120,2,54,26,60,164
191.024,6,29,8832,13,158,15918,267,1317,16,763,12727,1781,7515
0.197,17,2,154,1,33,0,33,61,1,65,0,65,93
1.271,6,10,1687,7,100,211,100,384,3,1179,502,1179,1303
0.436,6,28,8995,14,231,33,563,1660,14,824,32,1448,7335
300.785,6,40,25546,22,724,14316,1360,6034,18,1707,17685,5437,19512
1.386,6,50,19309,27,892,53,1360,13613,23,433,54,1360,5696
82.472,6,32,7722,13,155,6872,267,1306,19,403,4581,4837,6416
1651.027,1,7,392,7,28,275171,28,392,0,0,0,0,0
11.14,6,21,7602,7,401,1856,721,1489,14,616,776,2007,6113
1798.418,6,368,25690,215,99,8403,469,15085,153,69,11828,69,10605
10.485,17,2,778,2,361,10485,361,778,0,0,0,0,0
1.351,6,51,19226,28,947,50,1460,13485,23,400,53,1460,5741
1564.178,2,14,448,14,8,120321,8,448,0,0,0,0,0
1.106,17,4,288,2,36,1063,36,128,2,52,1059,52,160
1794.603,6,365,23225,213,69,8465,69,12798,152,69,11882,69,10427
4.298,6,40,7309,20,218,226,314,3423,20,513,213,1179,3886
17.95,6,7,308,7,0,0,0,308,0,0,0,0,0
0.025,17,4,284,2,32,13,32,120,2,54,17,60,164
1.624,6,29,10388,17,373,101,851,1803,12,1012,139,1420,8585
240.645,6,46,8552,22,449,11457,1418,5648,24,206,10461,580,2904
280.312,6,29,7392,14,158,21562,267,1357,15,678,20018,3436,6035
0.346,17,3,394,2,32,315,32,120,1,246,0,246,274
1776.675,17,73,3060,72,14,25023,14,3024,1,8,0,8,36
1773.502,6,180,15480,120,69,14903,69,8940,60,69,30055,69,6540
66.15,6,46,8944,22,401,807,889,2200,24,444,2870,2128,6744
297.315,6,28,6786,11,220,6486,516,1325,17,341,18576,1452,5461
0.027,17,2,472,1,60,0,60,88,1,356,0,356,384
1745.672,6,95,7203,63,38,28156,205,4476,32,33,56303,98,2727
1785.529,1,222,12432,222,28,8079,28,12432,0,0,0,0,0
0.458,6,51,21602,30,1016,15,1380,16487,21,387,21,1923,5115
300.759,6,15,2033,8,195,42941,195,547,7,398,50098,419,1486
0.493,6,9,1002,5,213,123,213,417,4,421,162,421,585
1503.986,2,11,352,11,8,150398,8,352,0,0,0,0,0
1799.355,17,449,39928,404,35,4464,288,25708,45,288,40019,288,14220
1775.12,17,139,11116,70,48,25726,48,5320,69,56,26104,56,5796
5.643,17,2,136,1,32,0,32,60,1,48,0,48,76
1781.644,6,424,37288,189,67,9476,681,14016,235,87,7613,2720,23272
1.315,6,49,21444,28,978,48,1460,15828,21,433,57,1460,5616
151.522,6,21,8230,11,511,87,1194,2041,10,962,16815,2720,6189
1786.51,6,105,8416,68,65,26664,65,4930,37,59,49622,59,3486
0.188,6,12,963,6,181,37,181,489,6,77,32,133,474
10.937,6,18,5610,10,275,1215,275,958,8,1440,847,1440,4652
15.475,6,12,820,5,92,3868,92,348,7,92,2533,92,472
279.094,1,4,224,4,28,93031,28,224,0,0,0,0,0
1741.02,1,15,840,15,28,124358,28,840,0,0,0,0,0
1.672,6,27,6215,13,108,138,147,959,14,669,128,1608,5256
1786.195,6,104,8444,68,66,26659,66,4964,36,60,51031,60,3480
0.081,6,11,819,6,186,16,186,506,5,45,18,45,313
1777.74,17,73,3060,72,14,25038,14,3024,1,8,0,8,36
1790.078,1,339,28476,339,56,5296,56,28476,0,0,0,0,0
369.516,6,20,1404,15,226,26394,226,1026,5,110,15166,110,378
0.499,17,3,451,2,39,293,39,134,1,289,0,289,317
0.33,6,10,4865,5,517,82,517,773,5,1912,72,2816,4092
1795.336,6,372,24043,214,75,8428,469,13514,158,69,11433,69,10529
3.361,17,5,290,5,30,840,30,290,0,0,0,0,0
1680.506,17,13,534,11,14,168031,14,462,2,8,168032,8,72
33.42,6,28,4939,14,180,2570,722,1808,14,399,2556,1448,3131
5.436,6,17,3324,6,92,1087,92,400,11,387,514,1408,2924
0.035,17,2,497,1,46,0,46,74,1,395,0,395,423
1777.878,6,182,15629,121,69,14815,69,9049,61,69,29627,69,6580
0.941,6,30,13194,17,522,58,1360,3334,13,1036,64,2720,9860
1787.516,17,87,3648,86,14,21029,14,3612,1,8,0,8,36
0.015,17,2,308,1,34,0,34,62,1,218,0,218,246
1773.054,6,181,15589,120,69,14899,69,8940,61,69,29547,69,6649
1783.46,17,86,3606,85,14,21231,14,3570,1,8,0,8,36
227.517,6,128,98505,82,1268,2808,1408,87991,46,811,2366,3847,10514
165.627,6,23,9218,11,406,90,908,1691,12,1172,15041,2601,7527
4.655,6,31,7472,13,158,387,267,1317,18,543,271,1380,6155
280.542,6,29,7392,13,158,23378,267,1317,16,678,18700,2760,6075
1747.573,1,77,4312,77,28,22994,28,4312,0,0,0,0,0
10.067,6,14,2243,8,210,1432,210,844,6,545,2012,905,1399
0.012,17,2,398,1,37,0,37,65,1,305,0,305,333
26.325,6,41,8510,21,175,1316,722,2249,20,681,1373,1380,6261
130.318,6,29,6651,10,235,219,514,1344,19,324,7234,1452,5307
1764.009,2,15,480,15,8,126000,8,480,0,0,0,0,0
76.391,6,34,7733,13,155,6365,267,1306,21,348,3817,1460,6427
227.766,17,4,240,2,32,227765,32,120,2,32,227765,32,120
464.456,6,128,27518,61,501,7740,1418,19779,67,149,7018,580,7739
1762.583,1,176,9856,176,28,10071,28,9856,0,0,0,0,0
132.657,6,21,8858,8,272,4338,516,1140,13,897,11046,1452,7718
1787.065,6,102,8296,68,65,26672,65,4930,34,59,54149,59,3366
281.276,6,34,8274,15,158,20091,267,1397,19,509,15625,1400,6877
1783.428,17,75,3141,73,13,24769,14,3061,2,12,776230,16,80
280.254,6,28,7352,13,158,23354,267,1317,15,603,20016,1400,6035
240.151,6,129,83215,74,216,3289,681,5527,55,1662,4447,4224,77688
142.982,6,1248,646297,717,837,199,1152,619925,531,394,269,1152,26372
5.281,17,3,208,2,36,5005,36,128,1,52,0,52,80
1784.349,6,370,23425,213,69,8416,69,13005,157,69,11438,69,10420
145.33,6,56,10430,26,224,3719,1189,3291,30,370,5011,1420,7139
2.018,17,2,279,1,36,0,36,64,1,187,0,187,215
19.943,17,4,824,2,48,19930,48,152,2,308,19931,308,672
1796.551,17,449,39928,404,35,4457,288,25708,45,288,40017,288,14220
70.606,6,27,7134,9,133,694,267,901,18,458,4152,4837,6233
0.482,17,3,451,2,39,195,39,134,1,289,0,289,317
34.613,6,6,328,4,0,11537,0,216,2,0,34603,0,112
1763.017,1,50,2800,50,28,35979,28,2800,0,0,0,0,0
33.695,6,32,5146,15,154,2406,722,1859,17,299,2093,1448,3287
0.007,17,2,588,1,39,0,39,67,1,493,0,493,521
1263.361,2,11,352,11,8,126336,8,352,0,0,0,0,0
300.578,6,38,8566,19,315,16698,882,2053,19,441,469,1440,6513
7.14,6,1556,1405140,963,1380,7,1408,1369640,593,931,11,2801,35500
280.216,6,28,7352,13,158,23351,267,1317,15,678,20011,3536,6035
1034.643,17,48,2016,48,14,22013,14,2016,0,0,0,0,0
1.318,6,48,19864,27,938,50,1460,14248,21,433,57,1460,5616
0.489,17,2,384,1,39,0,39,67,1,289,0,289,317
1.05,2,2,80,2,16,1050,16,80,0,0,0,0,0
1788.571,6,121,14476,79,84,22930,498,6386,42,160,43621,1420,8090
1.07,6,24,9513,14,350,82,1042,1993,10,1184,97,2370,7520
280.447,6,31,7472,13,158,23370,267,1317,18,603,16494,2760,6155
60.005,1,15,1560,0,0,0,0,0,15,76,4286,76,1560
0.385,6,27,8914,13,231,32,563,1608,14,938,28,1438,7306
1795.159,17,449,39928,404,35,4454,288,25708,45,288,40022,288,14220
15.146,17,18,10838,9,631,1889,1350,5933,9,517,1889,1350,4905
1777.113,17,79,3312,78,14,23079,14,3276,1,8,0,8,36
0.607,6,6,3716,4,869,197,869,3636,2,0,436,0,80
2.264,17,24,6696,10,232,251,1350,2601,14,264,128,1350,4095
1782.367,17,83,3480,82,14,22004,14,3444,1,8,0,8,36
0.394,6,27,9098,13,261,32,683,1728,14,829,28,1448,7370
1795.252,17,80,3354,79,14,23016,14,3318,1,8,0,8,36
1787.007,6,104,8444,68,66,26671,66,4964,36,60,51054,60,3480
94.296,6,24,10375,13,713,140,1309,3405,11,931,9412,1591,6970
35.252,6,33,5198,16,154,2350,722,1911,17,299,2169,1448,3287
1.414,6,47,18602,26,916,56,1460,12986,21,433,61,1460,5616
1781.393,6,1092,458521,510,219,3499,1460,84756,582,1134,3065,4380,373765
1733.676,17,27,8919,27,302,66679,1438,8919,0,0,0,0,0
2.794,6,3,410,0,0,0,0,0,3,96,1397,145,410
1.598,6,48,19838,28,874,59,1360,14262,20,476,73,2715,5576
0.293,6,25,6014,12,164,26,453,1442,13,555,23,1448,4572
1740.747,1,15,840,15,28,124339,28,840,0,0,0,0,0
152.873,6,26,9372,14,542,95,1287,2254,12,946,13877,4080,7118
0.107,6,12,3462,6,75,21,75,395,6,1373,21,1448,3067
0.054,17,4,284,2,32,46,32,120,2,54,46,60,164
11.626,6,24,9520,13,275,968,275,1078,11,1331,847,1420,8442
1772.294,6,180,15480,120,69,14893,69,8940,60,69,30032,69,6540
1.462,6,50,20490,27,977,56,1440,14794,23,433,58,1440,5696
3.325,6,38,20015,19,706,184,1460,5750,19,1226,170,1460,14265
0.064,17,4,284,2,32,0,32,120,2,54,1,60,164
1.308,6,25,6081,13,108,109,147,959,12,773,105,1608,5122
1797.973,6,356,22520,208,69,8685,69,12460,148,69,12230,69,10060
0.31,6,20,7238,13,335,25,668,2026,7,1210,50,1906,5212
1796.387,17,448,39896,403,35,4468,288,25676,45,288,40019,288,14220
241.463,6,56,15679,28,409,8942,1418,6409,28,592,8942,1418,9270
0.081,6,9,1347,5,145,20,145,349,4,834,24,834,998
0.275,17,2,154,1,33,0,33,61,1,65,0,65,93
0.374,6,10,968,5,256,91,256,460,5,304,91,304,508
5.358,6,5,280,2,0,5358,0,100,3,0,1518,0,180
1786.241,6,102,8228,68,64,26660,64,4896,34,58,54125,58,3332
1757.374,6,3517,3308677,1223,151,1438,908,72427,2294,1404,766,2836,3236250
10.001,17,3,2906,3,940,5000,1451,2906,0,0,0,0,0
280.274,6,29,7392,13,158,23356,267,1317,16,603,18679,2036,6075
1785.871,6,364,25392,212,100,8463,469,14896,152,69,11826,69,10496
1787.669,6,356,22520,208,69,8636,69,12460,148,69,12157,69,10060
1.147,6,28,8609,15,236,68,625,2049,13,1004,78,1791,6560
110.926,6,947,486236,544,833,204,1152,464968,403,428,275,1179,21268
0.017,6,3,120,1,0,0,0,40,2,0,17,0,80
1741.384,17,30,7050,30,207,60047,207,7050,0,0,0,0,0
1799.721,17,455,40952,406,35,4443,288,25856,49,280,37364,308,15096
0.047,6,10,860,6,181,9,181,489,4,77,4,134,371
14.887,6,2482,2413782,1694,1352,8,1368,2368142,788,931,18,2841,45640
45.379,17,7,2824,7,375,7563,548,2824,0,0,0,0,0
3.271,6,12,507,7,0,545,0,288,5,7,772,7,219
1.028,17,3,372,2,64,996,64,184,1,160,0,160,188
0.178,6,17,3016,9,282,22,531,1606,8,493,23,828,1410
66.477,6,36,8261,18,345,523,720,1787,18,478,3900,2720,6474
1355.945,6,300,18327,157,69,8691,69,9454,143,42,9548,69,8873
2.135,17,47,30260,25,733,88,1350,19041,22,481,100,1350,11219
1797.941,17,448,39896,403,35,4472,288,25676,45,288,40023,288,14220
170.587,6,30,11994,16,528,875,690,4393,14,702,13110,1360,7601
2.208,6,49,18835,28,921,81,1460,13174,21,437,94,2615,5661
305.59,6,9,546,6,31,61118,31,333,3,31,152786,31,213
102.918,17,4,352,2,60,102917,60,176,2,60,102917,60,176
0.961,1,5,420,5,56,240,56,420,0,0,0,0,0
240.323,6,44,9005,21,523,12015,1418,5827,23,197,10923,617,3178
1796.531,17,449,39928,404,35,4457,288,25708,45,288,40023,288,14220
377.94,2,3,96,3,8,188970,8,96,0,0,0,0,0
1747.863,6,94,7151,62,38,28653,205,4424,32,33,56375,98,2727
1739.287,6,87,6322,58,31,30513,31,3915,29,31,62116,31,2407
0.035,17,2,198,1,39,0,39,67,1,103,0,103,131
180.231,17,10,3360,10,308,20025,308,3360,0,0,0,0,0
0.073,1,2,112,2,28,73,28,112,0,0,0,0,0
280.492,6,30,7432,13,158,23374,267,1317,17,603,17523,2760,6115
69.781,17,16,1216,16,48,4652,48,1216,0,0,0,0,0
315.931,6,107,21387,52,280,6194,1360,10625,55,237,5848,3289,10762
1786.878,6,107,10014,70,100,25896,1257,6301,37,63,49631,193,3713
282.057,6,29,7392,13,158,23504,267,1317,16,603,18781,2036,6075
144.832,6,32,8952,14,158,11140,267,1357,18,624,8515,1400,7595
0.551,6,226,418552,144,194,3,230,8275,82,5075,5,18226,410277
1773.661,6,181,15589,121,69,14780,69,9049,60,69,30057,69,6540
848.84,1,8,448,8,28,121262,28,448,0,0,0,0,0
13.252,6,19,6745,10,275,1472,275,958,9,1353,1345,1440,5787
0.032,17,2,144,1,36,0,36,64,1,52,0,52,80
335.515,6,21,1526,10,31,26788,31,675,11,31,33533,31,851
0.376,6,49,21239,28,1000,13,1380,16157,21,421,17,1923,5082
1791.988,6,262,24719,159,75,11341,267,11286,103,134,17568,1997,13433
324.409,17,6,528,3,60,162204,60,264,3,60,162204,60,264
1.907,17,5,1166,3,30,951,30,174,2,468,20,468,992
1797.652,17,450,39960,405,35,4449,288,25740,45,288,40022,288,14220
0.108,17,2,263,1,36,0,36,64,1,171,0,171,199
0.815,6,28,12024,14,476,62,1360,2499,14,994,50,2720,9525
1743.055,1,56,4704,0,0,0,0,0,56,56,31691,56,4704
0.01,17,2,563,1,55,0,55,83,1,452,0,452,480
15.282,17,19,11893,11,860,1524,1350,9776,8,236,2177,1350,2117
0.73,17,19,8178,8,600,101,1350,5031,11,258,70,1350,3147
16.189,17,23,14481,13,910,1343,1350,12206,10,199,1791,1350,2275
1775.797,17,142,11464,71,49,25368,136,5484,71,56,25368,72,5980
1783.29,6,183,16138,122,75,14737,469,9489,61,69,29717,69,6649
17.343,17,4,304,4,48,5781,48,304,0,0,0,0,0
1794.103,17,87,3648,86,14,21107,14,3612,1,8,0,8,36
32.863,17,18,1584,9,48,4106,48,684,9,72,4106,72,900
1.446,6,50,20135,28,888,53,1360,14479,22,433,59,1360,5656
300.539,6,20,1391,10,177,33374,177,765,10,110,33374,110,626
1790.97,6,435,26298,216,69,8330,69,12918,219,36,8215,69,13380
0.009,17,2,550,2,247,9,247,550,0,0,0,0,0
0.187,6,27,7296,14,155,14,267,1341,13,678,14,3436,5955
1764.148,1,110,6160,110,28,16184,28,6160,0,0,0,0,0
0.99,6,23,6615,9,156,123,267,838,14,520,65,1420,5777
0.003,6,4,196,3,0,1,0,156,1,0,0,0,40
1785.854,6,363,23007,211,69,8504,69,12787,152,69,11826,69,10220
19.072,6,14,2245,8,211,2693,211,846,6,545,3782,904,1399
240.291,6,42,8944,21,523,12014,1408,5810,21,226,12014,618,3134
0.579,6,27,9018,13,248,48,633,1678,14,941,41,1368,7340
490.981,6,31,2530,20,57,25841,205,1546,11,37,49076,98,984
300.71,6,45,36962,24,483,13074,1370,3201,21,2041,3085,6511,33761
61.838,6,73,48725,44,1193,1438,1408,40483,29,960,2200,3847,8242
295.939,6,35,7084,17,262,18493,517,1680,18,744,17405,1418,5404
1.702,6,13,2311,8,188,243,245,700,5,1407,360,1407,1611
5.004,17,4,558,2,36,4999,36,128,2,187,5000,187,430
70.262,6,40,25046,22,884,27,1360,6229,18,1644,4125,4416,18817
45.029,6,23,6677,11,181,4502,267,1172,12,836,4090,2800,5505
1.419,6,39,9888,21,440,70,1360,4392,18,529,71,4075,5496
240.161,6,50,11753,25,209,10006,833,2819,25,586,10006,1408,8934
1783.631,6,362,22898,210,69,8534,69,12678,152,69,11809,69,10220
1798.143,6,365,25570,213,99,8481,469,15005,152,69,11906,69,10565
0.008,17,2,570,1,30,0,30,58,1,484,0,484,512
0.012,6,12,3646,6,100,2,100,420,6,968,2,1448,3226
2.938,6,29,7494,14,161,226,267,1535,15,765,196,1420,5959
3.365,6,12,3423,6,188,673,245,620,6,1279,608,1407,2803
97.064,6,35,7911,13,155,8088,267,1306,22,336,4621,1997,6605
11.241,6,27,11355,13,275,936,275,1078,14,1078,829,1414,10277
20.146,6,17,2316,10,189,2238,517,1298,7,323,3354,499,1018
0.448,2,2,112,2,32,448,32,112,0,0,0,0,0
0.017,6,3,151,1,0,0,0,40,2,31,0,31,111
1798.521,17,449,39928,404,35,4462,288,25708,45,288,40017,288,14220
0.978,6,25,9534,13,500,81,1190,2065,12,872,72,1360,7469
0.509,17,2,476,1,39,0,39,67,1,381,0,381,409
370.831,6,18,1242,14,180,28525,180,916,4,110,20064,110,326
96.995,17,4,352,2,60,96993,60,176,2,60,96994,60,176
1263.291,2,10,320,10,8,140365,8,320,0,0,0,0,0
7.926,6,18,6045,9,186,989,267,741,9,1234,989,3417,5304
1794.41,17,140,11200,70,48,26005,48,5320,70,56,26005,56,5880
1783.569,6,396,34517,225,118,7962,1189,17529,171,133,10491,1420,16988
0.898,6,48,18440,25,860,37,1188,13342,23,354,35,524,5098
104.344,6,25,9757,12,523,61,1460,2605,13,945,8683,1460,7152
240.206,6,56,20439,30,842,8282,1418,17579,26,187,9607,580,2860
1781.464,17,215,45183,215,182,8324,422,45183,0,0,0,0,0
1766.159,1,74,6216,74,56,24193,56,6216,0,0,0,0,0
103.41,6,24,11594,12,408,94,916,1749,12,1169,9385,2568,9845
1740.343,6,87,6322,58,31,30532,31,3915,29,31,62153,31,2407
39.352,17,11,836,11,48,3935,48,836,0,0,0,0,0
1796.498,1,58,4872,58,56,31517,56,4872,0,0,0,0,0
1725.299,1,8,448,8,28,246471,28,448,0,0,0,0,0
1784.998,6,107,8555,68,65,26641,65,4930,39,59,46971,59,3625
1797.158,17,448,39896,403,35,4470,288,25676,45,288,40019,288,14220
34.066,17,20,1760,10,48,3784,48,760,10,72,3784,72,1000
317.451,6,70,19235,35,364,9336,1360,9808,35,364,9332,1360,9427
131.468,6,24,10290,13,579,69,1360,2871,11,1161,13129,2574,7419
0.099,6,16,4036,10,101,10,101,629,6,1029,19,1500,3407
1784.748,6,286,38285,117,160,15384,1360,18964,169,149,10622,4662,19321
1799.113,17,448,39896,403,35,4475,288,25676,45,288,40020,288,14220
1799.303,1,345,28980,345,56,5230,56,28980,0,0,0,0,0
0.44,6,10,5532,2,106,440,106,186,8,718,40,1420,5346
1785.965,6,102,8296,68,65,26656,65,4930,34,59,54117,59,3366
0.008,6,2,205,1,125,0,125,165,1,0,0,0,40
7.068,17,4,488,4,94,2356,94,488,0,0,0,0,0
6.162,6,44,16033,23,225,276,561,2389,21,913,299,1631,13644
15.749,6,2353,2203808,1484,1406,10,1448,2153956,869,776,17,1448,49852
51.717,1,4,224,4,28,17239,28,224,0,0,0,0,0
327.287,6,35,2987,22,69,15584,69,1708,13,69,27273,69,1279
0.565,1,6,432,0,0,0,0,0,6,44,113,44,432
11.73,6,1913,1614359,1138,1363,10,1380,1579117,775,421,15,1923,35242
4.398,6,42,41383,9,329,549,329,809,33,1438,136,1438,40574
37.78,17,22,1936,11,48,3777,48,836,11,72,3777,72,1100
280.269,6,29,7392,13,158,23355,267,1317,16,543,18683,1400,6075
1787.494,6,356,22520,208,69,8635,69,12460,148,69,12158,69,10060
1685.425,17,13,534,11,14,168524,14,462,2,8,1685230,8,72
1798.527,1,208,22048,208,78,8688,78,22048,0,0,0,0,0
1728.268,1,8,448,8,28,246895,28,448,0,0,0,0,0
1775.899,17,142,11360,71,48,25369,48,5396,71,56,25369,56,5964
127.481,6,9,522,2,106,127470,106,194,7,0,21245,0,328
0.044,6,10,1370,5,125,10,125,393,5,356,10,380,977
11.457,6,3,2655,1,0,0,0,40,2,1267,4133,1440,2615
1787.87,6,356,22658,206,69,8721,69,12380,150,69,11996,69,10278
1786.81,6,106,8515,69,65,26276,65,4970,37,59,49630,59,3545
149.203,6,23,9938,12,345,77,727,1560,11,1132,14906,3928,8378
0.087,6,19,3291,10,459,9,804,1919,9,224,10,694,1372
20.596,17,41,23167,21,617,1028,1350,13552,20,452,1082,1350,9615
1733.248,1,35,4222,35,92,50977,105,4222,0,0,0,0,0
455.025,17,6,2448,6,380,91005,548,2448,0,0,0,0,0
1.545,6,10,1687,7,100,257,100,384,3,1179,643,1179,1303
0.47,17,2,449,1,48,0,48,76,1,345,0,345,373
1.246,6,48,18978,27,875,47,1360,13362,21,476,53,2715,5616
1796.292,17,142,11360,71,48,25661,48,5396,71,56,25661,56,5964
481.337,2,3,96,3,8,240668,8,96,0,0,0,0,0
679.387,6,75,8808,38,93,18361,722,3753,37,115,18866,1448,5055
326.006,6,24,1713,15,31,23285,31,1028,9,31,40750,31,685
0.041,17,4,284,2,32,23,32,120,2,54,23,60,164
1198.49,6,89,8085,49,65,24093,65,3650,40,83,30728,208,4435
1.408,6,2,228,2,62,1408,93,228,0,0,0,0,0
34.337,6,33,8992,15,158,2452,267,1397,18,624,2015,1400,7595
1772.705,6,181,15589,120,69,14896,69,8940,61,69,29541,69,6649
146.003,6,23,11278,12,433,62,990,1823,11,1286,14587,3928,9455
399.302,1,18,1008,18,28,23488,28,1008,0,0,0,0,0
56.261,6,31,7725,11,155,9,267,1226,20,355,2960,3417,6499
34.365,6,49,13942,24,990,676,1460,7985,25,290,1424,1460,5957
1310.921,17,32,23716,32,713,42287,1449,23716,0,0,0,0,0
0.014,17,2,427,1,39,0,39,67,1,332,0,332,360
12.455,17,3,984,3,300,6227,300,984,0,0,0,0,0
8.32,6,1784,1475006,962,1433,8,1448,1418682,822,776,9,1448,56324
4.163,6,15,4103,9,49,520,92,575,6,1070,790,1448,3528
9.684,6,85,24589,43,549,230,1152,18768,42,413,230,1152,5821
3.984,17,4,928,4,204,1328,204,928,0,0,0,0,0
79.843,6,37,5418,21,154,3992,722,2183,16,342,1152,1448,3235
242.74,17,4,352,2,60,242738,60,176,2,60,242739,60,176
1244.953,17,100,8000,50,48,25407,48,3800,50,56,25407,56,4200
0.39,17,3,1167,3,361,195,361,1167,0,0,0,0,0
57.772,6,24,3409,13,180,4814,595,1764,11,266,5756,580,1645
14.179,6,22,3685,11,194,1417,293,1418,11,363,1393,1179,2267
1685.869,17,13,534,11,14,168569,14,462,2,8,1685694,8,72
240.236,6,54,19448,29,836,8579,1418,16571,25,196,10009,580,2877
4.95,6,55,20026,27,925,190,1440,14070,28,433,176,1440,5956
1775.485,17,73,3060,72,14,25006,14,3024,1,8,0,8,36
1797.11,1,220,23320,220,78,8205,78,23320,0,0,0,0,0
1798.057,17,449,39928,404,35,4461,288,25708,45,288,40022,288,14220
1797.184,1,342,28728,342,56,5270,56,28728,0,0,0,0,0
0.017,6,3,120,1,0,0,0,40,2,0,12,0,80
1740.012,6,87,6322,58,31,30526,31,3915,29,31,62143,31,2407
596.204,6,61,9099,29,106,16572,519,2763,32,219,19229,1420,6336
1790.036,6,359,22640,208,69,8647,69,12460,151,69,11933,69,10180
33.557,6,30,5243,15,154,2396,722,1859,15,433,2384,2026,3384
1796.79,17,449,39928,404,35,4458,288,25708,45,288,40018,288,14220
0.012,17,4,350,2,34,7,34,124,2,85,8,91,226
1729.209,6,62,4504,40,33,44338,33,2740,22,31,82334,31,1764
1780.802,17,142,11360,71,48,25439,48,5396,71,56,25439,56,5964
10.13,6,16,6619,7,275,1688,275,563,9,1420,1065,1420,6056
1770.777,6,102,9462,66,66,27242,66,5610,36,60,50590,60,3852
1745.359,6,98,7390,63,38,28150,205,4476,35,33,51322,98,2914
0.222,17,2,157,1,31,0,31,59,1,70,0,70,98
0.37,17,8,2758,8,316,52,355,2758,0,0,0,0,0
1756.214,6,97,5668,54,26,33135,26,3120,43,26,41813,26,2548
0.503,6,23,7397,13,334,41,663,2021,10,967,52,1946,5376
1772.413,6,180,15480,120,69,14894,69,8940,60,69,30038,69,6540
71.086,6,31,7475,13,155,5923,267,1306,18,418,4181,1997,6169
0.314,6,19,7177,12,334,28,663,1969,7,1612,51,3314,5208
1746.784,6,92,6711,60,33,29606,96,4115,32,31,56338,33,2596
3.607,6,15,3632,8,150,515,174,624,7,681,587,1452,3008
0.895,6,24,6488,13,320,74,942,2128,11,783,88,1360,4360
17.192,6,6,328,4,0,5730,0,216,2,0,16296,0,112
1130.021,17,220,16720,220,48,5159,48,16720,0,0,0,0,0
31.92,6,348,341226,115,130,280,314,6372,233,1409,137,2836,334854
17.465,6,17,5164,9,150,2183,174,664,8,835,2480,1452,4500
840.803,17,8,2168,4,30,280241,30,232,4,456,280264,463,1936
151.514,6,23,6027,9,275,12668,275,647,14,600,11633,1440,5380
3.652,6,16,3248,9,49,456,92,563,7,463,38,1448,2685
1.256,6,47,17149,26,804,50,1360,11533,21,433,53,1360,5616
1741.044,17,30,7050,30,207,60036,207,7050,0,0,0,0,0
280.47,6,31,7472,13,158,23372,267,1317,18,603,16494,2076,6155
2.91,17,4,240,4,32,970,32,240,0,0,0,0,0
0.409,17,13,5656,6,491,81,1350,3116,7,334,35,1350,2540
0.006,6,2,80,1,0,0,0,40,1,0,0,0,40
5.084,6,34,6185,18,206,299,314,2784,16,551,320,1179,3401
1773.317,6,181,15589,120,69,14901,69,8940,61,69,29546,69,6649
2.264,6,42,10163,21,440,113,1360,4392,21,409,102,1360,5771
1.356,6,47,19221,27,895,52,1460,13645,20,433,60,1460,5576
1770.855,6,137,19381,82,202,21862,810,12760,55,89,32791,222,6621
597.117,1,6,336,6,28,119423,28,336,0,0,0,0,0
7.226,2,4,160,4,16,2408,16,160,0,0,0,0,0
1789.663,17,141,11268,72,48,25206,48,5472,69,56,26318,56,5796
0.093,6,10,1327,5,299,19,299,567,5,246,18,459,760
1796.435,17,447,39296,404,35,4457,288,25708,43,288,41917,288,13588
0.234,17,2,384,1,39,0,39,67,1,289,0,289,317
26.624,6,47,13045,21,199,1331,722,2438,26,683,1051,1380,10607
10.767,6,18,5610,10,275,1196,275,958,8,1440,851,1440,4652
2.494,17,4,1556,4,361,831,361,1556,0,0,0,0,0
194.934,6,19,1309,12,50,17705,208,936,7,31,32454,31,373
1798.552,6,367,25650,214,99,8443,469,15045,153,69,11831,69,10605
1749.485,6,95,7203,63,38,28217,205,4476,32,33,56428,98,2727
280.43,6,30,7432,13,158,23369,267,1317,17,603,17525,2076,6115
1.046,17,4,300,2,39,1045,39,134,2,55,1045,55,166
1783.815,6,382,26926,218,103,8220,469,15950,164,69,10943,69,10976
69.34,6,33,7693,13,155,5778,267,1306,20,348,3640,1420,6387
1.698,6,13,2311,8,188,242,245,700,5,1407,359,1407,1611
0.396,6,19,7099,13,318,33,600,1958,6,1607,72,3299,5141
3.729,17,5,588,4,64,1238,64,368,1,192,0,192,220
0.591,6,14,1745,7,288,68,288,600,7,426,68,434,1145
0.187,17,2,2382,2,1163,187,1163,2382,0,0,0,0,0
96.317,6,69,44893,43,1152,2293,1408,36807,26,960,2464,3847,8086
1791.618,1,58,4872,0,0,0,0,0,58,56,31431,56,4872
379.858,6,24,1563,15,177,27132,177,977,9,110,10097,110,586
1790.662,6,279,34923,116,148,15569,1360,17604,163,134,11052,3302,17319
1.964,17,2,672,2,308,1964,308,672,0,0,0,0,0
3.069,6,25,5989,13,154,255,267,1604,12,780,273,1420,4385
28.19,17,8,1648,4,48,9294,48,304,4,308,9391,308,1344
313.859,6,82,14938,41,337,7846,1111,6999,41,251,7846,1303,7939
1743.056,17,42,14112,42,308,42513,308,14112,0,0,0,0,0
267.251,17,4,240,2,32,267250,32,120,2,32,267250,32,120
253.673,6,31,8912,14,158,19513,267,1357,17,687,15854,1781,7555
1701.67,2,24,768,24,8,73985,8,768,0,0,0,0,0
8.645,6,23,4678,14,216,665,501,1430,9,480,1069,1420,3248
63.742,6,25,11358,12,433,105,990,1823,13,1000,5299,1360,9535
1680.636,17,12,498,11,14,168063,14,462,1,8,0,8,36
15.542,17,20,6458,9,335,1938,1350,3273,11,261,1551,1350,3185
0.846,17,3,1170,3,362,423,362,1170,0,0,0,0,0
2.632,6,28,9001,17,371,164,846,1798,11,965,230,1452,7203
26.374,17,4,352,2,60,26373,60,176,2,60,26372,60,176
134.384,2,4,128,4,8,44794,8,128,0,0,0,0,0
1799.105,1,246,13776,246,28,7343,28,13776,0,0,0,0,0
18.02,6,11,640,4,0,6006,0,220,7,0,2598,0,420
1772.306,6,180,15480,120,69,14893,69,8940,60,69,30035,69,6540
31.6,6,7,308,1,0,0,0,44,6,0,6304,0,264
1755.878,6,104,6218,60,27,29759,27,3525,44,27,40833,27,2693
2.017,17,4,610,3,39,833,39,201,1,381,0,381,409
0.597,17,4,940,2,30,583,30,116,2,384,570,384,824
1740.574,17,30,7050,30,207,60019,207,7050,0,0,0,0,0
0.503,17,2,152,1,48,0,48,76,1,48,0,48,76
75.354,6,45,10209,22,533,744,910,3083,23,364,3418,2128,7126
121.299,6,26,7272,12,158,11027,267,1277,14,775,9327,3445,5995
0.482,6,19,7177,13,334,40,663,2021,6,1612,88,3314,5156
1.361,6,50,19527,27,908,52,1440,13831,23,433,52,1440,5696
15.479,17,18,12805,11,931,1544,1350,10559,7,292,2574,1350,2246
12.519,17,3,1002,3,306,6259,306,1002,0,0,0,0,0
114.5,6,31,7682,10,141,4846,267,1255,21,348,5724,1452,6427
1763.54,2,12,384,12,8,160321,8,384,0,0,0,0,0
1788.706,6,103,8404,68,66,26697,66,4964,35,60,52606,60,3440
70.995,17,4,352,2,60,70994,60,176,2,60,70994,60,176
1786.663,6,104,8376,68,65,26666,65,4930,36,59,51044,59,3446
0.084,1,2,112,2,28,84,28,112,0,0,0,0,0
1.75,6,24,8729,14,286,134,590,1422,10,986,175,1420,7307
4.056,17,27,10093,12,450,368,1350,5741,15,262,255,1350,4352
2.013,17,4,314,2,31,1998,31,118,2,70,2000,70,196
9.833,6,17,2425,9,211,1228,211,922,8,545,1403,904,1503
1777.248,17,79,3312,78,14,23081,14,3276,1,8,0,8,36
340.803,6,86,62384,56,1244,6196,1408,52688,30,738,2524,2439,9696
0.0,6,1,44,1,0,0,0,44,0,0,0,0,0
0.053,6,13,1028,8,181,7,181,605,5,77,12,134,423
67.252,6,640,306384,339,839,198,1152,288839,301,423,223,1179,17545
197.203,6,34,8746,11,246,19719,469,2170,23,332,8963,1460,6576
24.134,6,14,3144,5,92,6033,92,348,9,387,2993,1408,2796
1798.119,17,448,39896,403,35,4472,288,25676,45,288,40019,288,14220
3.892,6,26,6150,14,181,299,537,1630,12,648,336,1448,4520
0.013,17,3,208,2,36,6,36,128,1,52,0,52,80
36.916,17,40,5880,20,48,1942,48,1520,20,190,1942,308,4360
1772.29,6,180,15480,120,69,14893,69,8940,60,69,30035,69,6540
295.472,6,30,9042,11,181,29547,267,1168,19,507,16413,2036,7874
181.377,17,4,240,2,32,181376,32,120,2,32,181375,32,120
1742.23,1,15,840,15,28,124445,28,840,0,0,0,0,0
1.358,17,5,1497,5,271,339,316,1497,0,0,0,0,0
300.321,17,4,1623,1,548,0,548,576,3,321,149661,321,1047
858.383,17,165,12540,165,48,5234,48,12540,0,0,0,0,0
70.874,6,643,297882,340,820,209,1152,280241,303,424,233,1179,17641
159.254,17,4,352,2,60,159253,60,176,2,60,159252,60,176
128.62,6,22,6816,5,154,32155,267,672,17,454,8012,1997,6144
1798.54,17,90,7200,45,48,40875,48,3420,45,56,40875,56,3780
0.1,2,3,96,3,8,50,8,96,0,0,0,0,0
60.514,6,29,7257,14,155,4654,267,1346,15,482,4321,1997,5911
1787.356,6,102,8364,68,66,26676,66,4964,34,60,54151,60,3400
122.329,17,4,352,2,60,122328,60,176,2,60,122327,60,176
1750.63,17,12,498,11,14,175063,14,462,1,8,0,8,36
4.995,17,3,433,2,37,4981,37,130,1,275,0,275,303
1661.926,1,7,392,7,28,276987,28,392,0,0,0,0,0
96.829,6,38,8429,11,146,9682,267,1470,27,293,3723,1420,6959
265.696,17,4,352,2,60,265694,60,176,2,60,265695,60,176
0.384,1,2,112,2,28,384,28,112,0,0,0,0,0
1.364,6,40,11338,22,547,64,1360,5842,18,476,69,2715,5496
1.729,6,13,2311,8,188,247,245,700,5,1407,367,1407,1611
0.487,17,2,154,1,33,0,33,61,1,65,0,65,93
0.311,6,10,767,5,186,76,186,454,5,45,77,45,313
1764.086,2,15,480,15,8,126006,8,480,0,0,0,0,0
1787.905,6,368,25828,213,99,8433,469,15005,155,69,11609,69,10823
17.558,17,23,6636,9,275,2190,1350,2729,14,251,1348,1350,3907
240.205,6,54,17537,29,775,8578,1402,14691,25,192,10008,580,2846
453.0,6,278,252364,97,219,4718,865,7031,181,1456,2516,2804,245333
3.215,6,36,9331,20,126,169,267,1946,16,842,209,1420,7385
1754.626,1,108,9072,0,0,0,0,0,108,56,16398,56,9072
0.121,6,3,128,2,0,121,0,84,1,0,0,0,44
33.883,6,30,5042,15,154,2420,722,1859,15,399,2406,1440,3183
1770.511,6,101,9278,66,64,27238,64,5544,35,58,52071,58,3734
1255.741,2,8,256,8,8,179391,8,256,0,0,0,0,0
199.093,17,4,272,2,40,199091,47,136,2,40,199092,47,136
1332.728,6,261,17064,145,69,9255,69,8767,116,69,11588,69,8297
0.802,6,24,5755,13,158,66,370,1315,11,799,79,1420,4440
1699.531,17,12,498,11,14,169953,14,462,1,8,0,8,36
1773.843,1,58,4872,0,0,0,0,0,58,56,31120,56,4872
1.248,17,4,368,2,32,1220,32,120,2,96,1225,96,248
1744.605,2,24,768,24,8,75852,8,768,0,0,0,0,0
0.627,6,2,111,1,0,0,0,40,1,31,0,31,71
1794.213,17,144,11520,72,48,25270,48,5472,72,56,25270,56,6048
1741.384,2,25,800,25,8,72557,8,800,0,0,0,0,0
8.278,6,20,8169,10,275,919,275,683,10,1414,819,1414,7486
1798.55,6,123,7860,72,47,25331,208,4890,51,31,35966,31,2970
40.077,17,4,377,2,33,40055,37,123,2,99,40059,136,254
1400.964,17,12,3294,6,30,280192,30,348,6,463,280191,463,2946
280.47,6,29,7392,13,158,23372,267,1317,16,678,18694,3456,6075
53.169,6,27,6852,9,154,6646,267,832,18,378,3126,1420,6020
0.017,17,2,461,1,34,0,34,62,1,371,0,371,399
187.043,17,9,3024,9,308,23380,308,3024,0,0,0,0,0
0.006,17,2,144,1,36,0,36,64,1,52,0,52,80
0.819,17,3,1170,3,362,409,362,1170,0,0,0,0,0
1788.595,6,105,8416,68,65,26695,65,4930,37,59,49680,59,3486
1009.128,17,40,5880,20,48,53111,48,1520,20,190,53111,308,4360
0.009,17,2,515,1,137,0,137,165,1,322,0,322,350
1794.163,17,155,34411,155,194,11650,422,34411,0,0,0,0,0
1787.406,17,87,3648,86,14,21028,14,3612,1,8,0,8,36
1680.725,17,13,534,11,14,168054,14,462,2,8,1680545,8,72
38.779,6,9,608,0,0,0,0,0,9,31,4847,31,608
25.01,6,20,7322,9,275,3126,275,918,11,992,2445,1440,6404
1789.203,17,142,11360,71,48,25559,48,5396,71,56,25559,56,5964
1772.508,6,202,22256,130,75,13740,267,10063,72,136,24958,3417,12193
280.277,6,32,7773,14,175,21559,267,1618,18,543,16483,1400,6155
565.815,6,96,20739,45,581,12858,1368,15183,51,160,11315,1096,5556
0.964,6,22,5960,12,108,87,147,919,10,1159,106,2600,5041
1732.029,17,19,3541,19,158,96223,166,3541,0,0,0,0,0
37.949,17,22,1936,11,48,3794,48,836,11,72,3793,72,1100
1771.294,1,60,5040,60,56,30021,56,5040,0,0,0,0,0
1.056,17,15,8469,8,706,150,1350,5873,7,342,166,1350,2596
0.33,17,3,1167,3,361,165,361,1167,0,0,0,0,0
0.026,6,13,3514,7,75,4,75,447,6,1373,5,1448,3067
35.423,6,20,7013,7,154,5903,267,752,13,716,2947,2760,6261
1786.522,6,104,8444,68,66,26664,66,4964,36,60,51040,60,3480
1.067,17,4,560,2,64,809,64,184,2,160,681,160,376
1795.307,17,448,39612,404,35,4454,288,25708,44,288,40949,288,13904
782.073,2,9,288,9,8,97759,8,288,0,0,0,0,0
1.209,6,10,1687,7,100,201,100,384,3,1179,476,1179,1303
1.456,17,20,12102,9,421,182,1350,4046,11,704,135,1350,8056
1454.522,6,18,1092,12,31,132229,31,666,6,31,290864,31,426
1748.537,6,109,10312,65,67,27320,161,5621,44,58,40661,59,4691
92.319,6,64,15791,31,396,3077,1189,7980,33,270,2880,1420,7811
1770.137,6,210,16368,78,71,22987,330,7860,132,48,13512,78,8508
1745.833,1,16,2277,16,114,116388,207,2277,0,0,0,0,0
62.26,17,4,240,2,32,62258,32,120,2,32,62258,32,120
150.479,17,4,352,2,60,150478,60,176,2,60,150478,60,176
0.022,17,4,368,2,32,19,32,120,2,96,10,96,248
240.236,6,53,18282,28,812,8897,1408,15283,25,211,10009,580,2999
0.187,17,2,2754,2,1349,187,1349,2754,0,0,0,0,0
88.728,1,4,224,4,28,29576,28,224,0,0,0,0,0
0.858,6,8,1607,5,100,214,100,304,3,1179,306,1179,1303
0.01,17,2,503,1,40,0,40,68,1,407,0,407,435
5.012,17,4,288,2,36,4997,36,128,2,52,4995,52,160
0.205,6,9,1339,5,145,51,145,349,4,826,43,826,990
1789.008,6,417,25029,208,69,8642,69,12460,209,34,8600,69,12569
0.021,6,3,151,1,0,0,0,40,2,31,1,31,111
17.371,6,15,1216,7,283,2865,283,663,8,105,2456,105,553
1756.533,6,185,18085,95,69,18686,721,8015,90,179,19732,2840,10070
303.983,6,33,13683,18,510,17871,1360,3837,15,923,21701,1360,9846
1786.627,6,154,19574,92,302,19633,302,13852,62,83,29288,83,5722
1681.425,17,14,3827,7,30,280235,30,406,7,460,280235,463,3421
211.335,6,24,4947,9,220,7966,516,1245,15,258,15089,1452,3702
0.819,17,15,8314,8,705,117,1350,5870,7,321,127,1350,2444
1796.836,17,449,39928,404,35,4458,288,25708,45,288,40017,288,14220
158.544,6,117,81346,68,1291,2366,1448,70696,49,674,1730,1448,10650
1.664,6,20,3833,11,234,166,564,1504,9,463,183,1343,2329
1795.481,1,58,4872,58,56,31499,56,4872,0,0,0,0,0
24.848,6,32,8952,14,158,1911,267,1357,18,624,1457,1400,7595
1772.17,6,205,14180,75,46,23940,46,5990,130,46,13737,46,8190
3.697,17,17,5810,7,316,616,1350,2413,10,311,401,1350,3397
24.562,1,4,424,4,78,8187,78,424,0,0,0,0,0
0.274,6,27,6118,13,164,22,453,1494,14,486,20,1408,4624
282.661,6,46,15749,25,907,11770,1440,10107,21,399,14124,1440,5642
1744.717,2,26,832,26,8,69788,8,832,0,0,0,0,0
1775.397,6,128,7817,69,27,26108,27,4161,59,27,30609,27,3656
1798.642,17,448,39896,403,35,4474,288,25676,45,288,40017,288,14220
1786.512,6,107,8564,68,66,26664,66,4964,39,60,47011,60,3600
1683.389,17,14,1036,7,30,280556,30,406,7,62,280555,62,630
1069.932,6,104,9054,64,69,14830,69,4768,40,68,27430,69,4286
850.437,6,54,4488,35,66,25012,66,2588,19,60,47241,60,1900
1278.509,1,18,1008,18,28,75206,28,1008,0,0,0,0,0
368.45,6,23,1535,16,177,24563,177,1053,7,110,10374,110,482
0.836,6,11,1727,7,100,139,100,384,4,589,187,1152,1343
1791.331,1,271,15176,271,28,6634,28,15176,0,0,0,0,0
1681.554,17,16,1265,8,30,240215,37,471,8,71,240215,136,794
1.26,6,40,9928,21,440,63,1360,4392,19,433,60,1360,5536
74.983,17,4,240,2,32,74982,32,120,2,32,74982,32,120
0.371,6,12,1653,6,288,72,288,548,6,426,42,434,1105
1749.463,6,94,7151,62,38,28679,205,4424,32,33,56420,98,2727
29.931,1,35,3640,0,0,0,0,0,35,76,880,76,3640
4.285,6,37,7205,19,218,238,314,3383,18,516,236,1179,3822
1793.677,17,265,55311,265,180,6794,373,55311,0,0,0,0,0
0.836,6,20,5948,11,281,83,544,1288,9,716,93,1420,4660
215.155,6,7375,6557915,4507,1366,47,1368,6384045,2868,749,74,1368,173870
0.048,17,2,238,1,44,0,44,72,1,138,0,138,166
366.458,6,46,10135,29,266,13087,1360,4653,17,435,543,2667,5482
0.093,17,3,196,2,32,13,32,120,1,48,0,48,76
5.845,6,24,2330,12,127,531,214,1066,12,152,518,152,1264
1760.561,6,94,7151,62,38,28861,205,4424,32,33,56783,98,2727
1.348,6,48,18818,26,930,53,1440,13162,22,433,55,1440,5656
0.059,17,4,624,2,36,54,36,128,2,220,54,292,496
366.096,6,19,1315,13,177,30508,177,885,6,110,12846,110,430
0.264,6,28,7336,13,155,22,267,1301,15,543,17,1400,6035
1.394,17,4,240,2,32,1393,32,120,2,32,1393,32,120
52.093,6,16,4535,8,325,7441,722,1712,8,1189,7416,2328,2823
0.254,17,2,154,1,33,0,33,61,1,65,0,65,93
0.73,6,2,87,1,0,0,0,40,1,7,0,7,47
0.057,17,4,284,2,32,53,32,120,2,54,48,60,164
0.03,17,4,668,2,32,20,32,120,2,246,20,246,548
111.707,6,22,1398,10,46,12411,46,642,12,46,10142,46,756
1.54,6,12,1671,6,279,308,279,587,6,191,230,272,1084
1795.049,17,449,39928,404,35,4454,288,25708,45,288,40017,288,14220
35.927,6,29,8832,14,158,2763,267,1357,15,858,2554,2800,7475
1.092,6,28,8631,15,236,65,625,2049,13,1008,74,1791,6582
0.035,17,2,172,1,50,0,50,78,1,66,0,66,94
1745.298,6,98,7359,63,38,28149,205,4476,35,33,51326,98,2883
0.071,17,2,146,1,37,0,37,65,1,53,0,53,81
31.853,6,45,17978,24,1134,389,1440,12336,21,435,1583,2587,5642
1796.739,1,59,4956,59,56,30978,56,4956,0,0,0,0,0
165.755,6,24,10049,12,531,61,1360,2637,12,1153,15056,2574,7412
0.135,6,44,20165,26,1011,5,1420,15224,18,467,7,1883,4941
0.046,6,3,280,2,136,0,136,240,1,0,0,0,40
1795.903,17,272,60873,272,195,6626,422,60873,0,0,0,0,0
1.946,6,24,6045,13,108,162,147,959,11,927,164,1608,5086
1766.902,1,107,5992,107,28,16668,28,5992,0,0,0,0,0
8.782,6,9,396,4,0,2927,0,176,5,0,1454,0,220
0.745,6,152,100778,80,1309,9,1420,93607,72,475,10,1883,7171
0.212,17,12,6358,6,615,42,1350,3860,6,388,30,1350,2498
10.792,17,15,17682,15,1150,770,1451,17682,0,0,0,0,0
35.484,6,12,4941,4,171,11827,171,387,8,1030,5068,1448,4554
1785.563,6,104,8444,68,66,26650,66,4964,36,60,51013,60,3480
173.429,17,4,352,2,60,173428,60,176,2,60,173428,60,176
1776.366,17,73,3060,72,14,25019,14,3024,1,8,0,8,36
1.369,6,52,20761,30,918,47,1360,15060,22,400,56,1360,5701
280.205,6,29,7392,13,158,23350,267,1317,16,603,18678,1400,6075
1740.716,17,30,7050,30,207,60024,207,7050,0,0,0,0,0
1744.69,2,21,672,21,8,87234,8,672,0,0,0,0,0
0.877,6,10,1687,7,100,146,100,384,3,1179,314,1179,1303
4.538,6,37,7189,19,218,252,314,3383,18,513,250,1179,3806
1771.089,6,99,9240,66,65,27247,65,5577,33,59,55344,59,3663
7.187,6,1278,1126670,775,1374,9,1408,1095850,503,931,13,2816,30820
61.909,6,64,44344,41,1181,1547,1368,36412,23,747,2802,1368,7932
33.477,6,26,4832,13,180,2789,722,1754,13,479,2773,1402,3078
0.009,6,13,3987,8,114,1,114,454,5,1660,2,2920,3533
1.447,6,51,21737,28,992,53,1460,16041,23,433,57,1460,5696
240.177,6,11,608,5,0,58716,0,308,6,0,48035,0,300
1758.398,1,63,7270,63,87,28361,125,7270,0,0,0,0,0
87.261,6,16,6266,2,112,220,112,200,14,458,6710,1460,6066
280.253,6,25,7094,11,181,28025,267,1168,14,595,21556,1400,5926
0.023,17,2,198,1,37,0,37,65,1,105,0,105,133
1790.608,6,106,8524,68,66,26725,66,4964,38,60,48391,60,3560
1781.192,6,354,22440,207,69,8646,69,12420,147,69,12199,69,10020
365.033,1,4,240,4,32,121677,32,240,0,0,0,0,0
287.815,6,250,194776,152,1342,1906,1448,177091,98,541,1904,1448,17685
1777.857,1,120,6720,120,28,14939,28,6720,0,0,0,0,0
4.241,6,40,7325,20,218,223,314,3423,20,516,210,1179,3902
0.416,6,59,26710,32,1063,13,1380,19453,27,511,14,1923,7257
1792.721,17,142,11360,71,48,25609,48,5396,71,56,25608,56,5964
1389.298,6,87,11707,56,94,20706,498,4710,31,198,46306,1420,6997
40.248,6,33,8148,16,333,1948,685,1684,17,481,2507,3488,6464
2.903,17,6,1706,3,32,1449,32,180,3,480,1449,486,1526
4.116,6,44,13600,23,225,179,561,2389,21,796,197,1440,11211
241.001,6,32,8952,14,158,18538,267,1357,18,624,14173,1400,7595
1771.129,6,100,9292,66,65,27248,65,5577,34,59,53667,59,3715
1786.424,6,102,8364,68,66,26663,66,4964,34,60,54131,60,3400
0.948,17,28,15288,14,857,70,1350,12398,14,178,70,1350,2890
2.913,6,2,87,1,0,0,0,40,1,7,0,7,47
13.074,1,9,756,9,56,1634,56,756,0,0,0,0,0
1789.954,6,372,25988,213,98,8443,469,15143,159,69,11328,69,10845
1685.52,17,12,498,11,14,168552,14,462,1,8,0,8,36
329.945,17,6,360,3,32,164972,32,180,3,32,164972,32,180
1737.136,1,58,4872,58,56,30476,56,4872,0,0,0,0,0
7.205,2,2,64,2,8,7205,8,64,0,0,0,0,0
1681.849,17,14,1036,7,30,280304,30,406,7,62,280304,62,630
1797.816,17,448,39896,403,35,4472,288,25676,45,288,40015,288,14220
3.379,6,2,88,2,0,0,0,88,0,0,0,0,0
195.982,17,6,528,3,48,97838,48,228,3,72,97942,72,300
0.121,17,4,284,2,32,99,32,120,2,54,101,60,164
1.047,17,4,288,2,36,1015,36,128,2,52,1016,52,160
86.511,6,63,14970,27,374,1308,1189,7453,36,357,2465,1917,7517
0.165,17,2,602,1,46,0,46,74,1,500,0,500,528
11.837,6,25,8473,13,275,986,275,1078,12,986,856,1440,7395
1796.601,17,771,46482,771,32,2333,37,46482,0,0,0,0,0
5.304,6,40,7309,21,218,265,314,3463,19,513,281,1179,3846
150.513,6,23,11398,12,397,83,884,1717,11,1318,15036,3928,9681
186.617,6,39,10961,20,390,9813,1246,3782,19,476,10358,1368,7179
293.272,17,4,352,2,60,293271,60,176,2,60,293271,60,176
9.275,6,9,527,5,43,2318,43,311,4,0,3090,0,216
59.899,17,4,240,2,32,59896,32,120,2,32,59898,32,120
1771.921,6,99,9240,66,65,27260,65,5577,33,59,55369,59,3663
154.898,6,18,4486,8,524,157,1308,1924,10,716,17190,999,2562
18.072,17,6,528,3,48,9032,48,228,3,72,9031,72,300
951.578,6,180,11935,100,71,9611,138,6277,80,68,12045,69,5658
0.042,17,4,624,2,36,1,36,128,2,220,2,292,496
0.914,6,10,1687,7,100,152,100,384,3,1179,326,1179,1303
1160.851,1,6,336,6,28,232170,28,336,0,0,0,0,0
1.761,17,20,5190,20,231,92,389,5190,0,0,0,0,0
1798.027,17,144,11520,72,48,25324,48,5472,72,56,25324,56,6048
4.212,17,3,2906,3,940,2106,1451,2906,0,0,0,0,0
3.586,6,2,88,2,0,0,0,88,0,0,0,0,0
85.379,1,3,284,3,66,42689,93,284,0,0,0,0,0
0.377,6,10,968,5,256,90,256,460,5,304,90,304,508
0.129,6,13,1997,7,329,21,500,1030,6,323,25,500,967
0.62,6,3,144,2,0,1,0,92,1,0,0,0,52
8.791,6,68,20302,35,543,258,1152,15539,33,491,266,1179,4763
1770.952,6,99,9240,66,65,27245,65,5577,33,59,55339,59,3663
133.551,6,20,8239,11,525,72,1237,2048,9,1163,16674,3151,6191
3.439,6,70,26669,37,949,95,1440,15855,33,499,101,1440,10814
1683.049,1,15,840,15,28,120217,28,840,0,0,0,0,0
37.516,17,22,1936,11,48,3750,48,836,11,72,3750,72,1100
1612.712,6,143,15011,77,67,21219,721,5856,66,158,24808,2840,9155
601.627,2,4,128,4,8,200542,8,128,0,0,0,0,0
1786.996,17,87,3648,86,14,21023,14,3612,1,8,0,8,36
1787.346,6,144,22216,88,272,20544,1302,15523,56,101,32495,268,6693
1.79,6,446,373782,197,152,9,290,10884,249,1428,6,1438,362898
0.006,6,2,1253,1,0,0,0,40,1,1173,0,1173,1213
1741.321,17,29,30624,29,1028,62190,1028,30624,0,0,0,0,0
1771.61,6,99,9240,66,65,27255,65,5577,33,59,55359,59,3663
374.654,6,18,1242,14,180,28819,180,916,4,110,20057,110,326
1.049,6,28,6000,14,161,80,267,1535,14,650,57,1420,4465
1.242,6,3,168,1,0,0,0,52,2,0,1242,0,116
1.905,6,29,9173,15,257,134,669,1818,14,945,145,1438,7355
1798.363,17,450,39960,405,35,4451,288,25740,45,288,40020,288,14220
42.01,17,4,304,2,48,41993,48,152,2,48,41994,48,152
3.21,17,2,154,1,33,0,33,61,1,65,0,65,93
1793.164,6,356,22520,208,69,8662,69,12460,148,69,12198,69,10060
305.515,6,167,132573,109,1270,2828,1408,120046,58,731,2662,3847,12527
8.097,6,17,5331,9,275,1012,275,643,8,1089,662,1420,4688
1250.537,17,540,32580,540,32,2320,37,32580,0,0,0,0,0
4.497,6,38,7245,19,218,249,314,3383,19,516,235,1179,3862
1794.478,17,81,3390,79,14,23003,14,3318,2,8,1794285,8,72
1645.25,1,7,392,7,28,274208,28,392,0,0,0,0,0
0.938,17,4,668,2,32,934,32,120,2,246,933,246,548
1776.588,1,113,6328,113,28,15862,28,6328,0,0,0,0,0
369.624,6,14,1034,10,180,41069,180,708,4,110,20067,110,326
19.375,6,19,2927,11,148,1937,293,1333,8,635,2591,1179,1594
139.722,6,31,7114,19,182,7762,502,2040,12,573,12692,1420,5074
299.979,6,6,364,4,31,99993,31,222,2,31,299887,31,142
1763.937,2,13,416,13,8,146994,8,416,0,0,0,0,0
1390.733,6,52,5663,41,91,34768,138,4469,11,68,32073,69,1194
1772.886,6,180,15480,120,69,14898,69,8940,60,69,30043,69,6540
177.971,6,30,7432,13,158,14830,267,1317,17,603,11120,2076,6115
58.085,6,29,7257,14,155,4468,267,1346,15,482,4148,2840,5911
0.046,6,14,4020,8,88,6,88,428,6,1670,9,1880,3592
0.01,6,10,1544,5,505,2,505,773,5,503,2,503,771
0.687,6,12,1653,6,288,133,288,548,6,426,64,434,1105
4.339,6,2,88,2,0,0,0,88,0,0,0,0,0
1.42,6,18,5255,9,150,177,174,664,9,704,164,1452,4591
40.303,6,2838,3479820,1015,196,39,437,53562,1823,1832,22,15488,3426258
1778.902,17,142,11360,71,48,25412,48,5396,71,56,25412,56,5964
0.32,17,2,586,1,46,0,46,74,1,484,0,484,512
0.033,17,2,500,1,60,0,60,88,1,384,0,384,412
604.598,17,8,480,4,32,201532,32,240,4,32,201531,32,240
8.393,6,22,9422,11,275,839,275,723,11,1178,549,1440,8699
249.906,17,4,352,2,60,249905,60,176,2,60,249905,60,176
991.838,6,64,4950,36,66,24766,66,2562,28,50,36731,60,2388
365.766,6,18,1242,14,180,28135,180,916,4,110,20055,110,326
1680.098,1,8,448,8,28,240014,28,448,0,0,0,0,0
4.443,6,5,260,5,0,0,0,260,0,0,0,0,0
1787.376,6,102,8296,68,65,26677,65,4930,34,59,54158,59,3366
0.643,6,10,400,4,0,146,0,160,6,0,113,0,240
0.089,17,4,368,2,32,57,32,120,2,96,58,96,248
31.714,6,84,73744,30,128,1093,308,1946,54,1379,597,2836,71798
11.856,6,1904,1631686,1150,1363,10,1380,1596892,754,421,15,1923,34794
0.011,17,2,554,1,30,0,30,58,1,468,0,468,496
0.05,17,2,198,1,39,0,39,67,1,103,0,103,131
0.401,6,10,1992,5,288,92,288,508,5,424,56,434,1484
7.343,6,1686,1528739,1047,1381,6,1408,1490847,639,776,11,1408,37892
79.09,17,4,352,2,60,79089,60,176,2,60,79089,60,176
0.361,17,2,184,1,32,0,32,60,1,96,0,96,124
1786.505,6,104,8444,68,66,26664,66,4964,36,60,51040,60,3480
1792.006,6,356,22727,205,69,8784,69,12340,151,69,11946,69,10387
1505.525,6,119,11830,71,67,21507,722,5871,48,92,32028,1448,5959
229.772,6,20,6566,6,154,38980,267,712,14,527,17673,1452,5854
0.523,6,23,7394,13,335,43,668,2026,10,968,55,1946,5368
281.228,6,57,9747,28,112,10415,267,2586,29,272,10037,1460,7161
1795.252,1,58,4872,0,0,0,0,0,58,56,31495,56,4872
0.043,17,2,401,1,37,0,37,65,1,308,0,308,336
1786.735,6,104,8444,68,66,26667,66,4964,36,60,51046,60,3480
1681.186,17,14,3755,7,30,280196,30,406,7,450,280196,463,3349
294.364,17,4,352,2,60,294363,60,176,2,60,294363,60,176
126.414,6,20,8154,11,511,83,1194,2005,9,1155,15779,3151,6149
0.927,6,23,6398,13,310,76,892,2078,10,979,102,1731,4320
1779.097,1,67,5628,67,56,26956,56,5628,0,0,0,0,0
1.219,6,39,10474,21,513,60,1360,4978,18,433,62,1360,5496
61.549,6,37,15887,22,795,2930,1440,9109,15,665,4376,1440,6778
0.096,17,2,410,1,46,0,46,74,1,308,0,308,336
1790.011,6,364,23116,210,69,8564,69,12747,154,69,11699,69,10369
1743.419,6,98,7404,63,38,28119,205,4488,35,33,51265,98,2916
1681.215,1,15,840,15,28,120086,28,840,0,0,0,0,0
1772.357,6,180,15480,120,69,14893,69,8940,60,69,30033,69,6540
6.861,6,26,13054,16,840,457,1368,6726,10,966,743,1368,6328
1747.507,17,342,54666,342,131,5124,376,54666,0,0,0,0,0
1740.418,1,16,896,16,28,116027,28,896,0,0,0,0,0
240.225,6,55,20095,30,856,8283,1418,16992,25,224,10008,580,3103
10.763,6,20,5694,11,275,1076,275,998,9,1440,718,1440,4696
0.052,17,2,338,1,33,0,33,61,1,249,0,249,277
1787.822,6,102,8228,68,64,26683,64,4896,34,58,54173,58,3332
5.075,17,4,288,2,36,5005,36,128,2,52,5027,52,160
0.219,6,19,9933,11,125,21,125,705,8,2201,31,5792,9228
1795.271,17,449,39928,404,35,4454,288,25708,45,288,40022,288,14220
0.308,6,20,7229,12,334,27,663,1969,8,1209,42,2816,5260
7.769,6,736,645690,456,1337,16,1368,624282,280,776,27,2736,21408
2.271,17,4,1560,4,362,757,362,1560,0,0,0,0,0
1764.746,2,16,512,16,8,117649,8,512,0,0,0,0,0
21.26,6,128,41382,63,595,342,1152,32877,65,453,328,1179,8505
1784.566,17,328,53445,328,134,5457,391,53445,0,0,0,0,0
0.275,17,2,384,1,39,0,39,67,1,289,0,289,317
300.845,6,26,8009,15,173,21488,385,1483,11,991,24078,2736,6526
1.656,6,56,24078,32,998,53,1460,18297,24,400,61,1460,5781
4.701,6,32,8952,14,158,361,267,1357,18,624,274,1400,7595
570.067,1,6,336,6,28,114013,28,336,0,0,0,0,0
0.28,17,2,362,1,46,0,46,74,1,260,0,260,288
1769.998,6,99,9240,66,65,27230,65,5577,33,59,55308,59,3663
0.065,6,12,3462,6,75,13,75,395,6,1373,12,1448,3067
0.447,6,95,68125,60,1278,7,1420,62504,35,467,12,2840,5621
1749.661,6,95,7203,63,38,28220,205,4476,32,33,56426,98,2727
57.054,17,10,760,10,48,6339,48,760,0,0,0,0,0
1798.672,17,450,39960,405,35,4452,288,25740,45,288,40021,288,14220
136.295,6,525,241625,265,841,499,1152,228555,260,444,525,1179,13070
0.632,17,4,368,2,32,600,32,120,2,96,34,96,248
371.184,6,27,1767,18,177,21834,177,1181,9,110,8776,110,586
153.054,6,22,8584,11,556,99,1329,2140,11,998,15286,1791,6444
0.288,6,26,9063,13,262,24,690,1735,13,949,23,2816,7328
1792.006,6,364,25392,212,100,8492,469,14896,152,69,11867,69,10496
21.689,6,20,3130,12,183,1971,517,1561,8,381,3097,499,1569
1.247,6,23,7952,13,164,89,267,1340,10,1216,119,3819,6612
1780.08,6,357,22629,208,69,8599,69,12529,149,69,12027,69,10100
63.13,6,14,768,6,0,12626,0,328,8,0,8945,0,440
118.022,17,6,528,3,60,59010,60,264,3,60,59010,60,264
1.999,6,2,149,0,0,0,0,0,2,69,1999,69,149
0.939,6,10,1687,7,100,156,100,384,3,1179,345,1179,1303
0.029,6,13,1028,8,181,4,181,605,5,77,5,134,423
367.353,6,25,1651,17,177,22959,177,1117,8,110,9168,110,534
203.293,17,4,240,2,32,203292,32,120,2,32,203292,32,120
1794.492,6,249,36473,154,302,11728,302,26450,95,83,19090,83,10023
12.797,6,98,30279,49,566,266,1152,23480,49,439,261,1179,6799
61.42,6,11,851,11,31,6142,31,851,0,0,0,0,0
9.902,17,6,8236,6,1344,1980,1348,8236,0,0,0,0,0
1770.03,6,125,12596,73,63,24583,721,6100,52,88,32516,1448,6496
2.51,17,2,384,1,36,0,36,64,1,292,0,292,320
0.003,6,2,119,1,0,0,0,40,1,27,0,27,79
75.168,6,36,8481,12,155,375,267,1266,24,312,3267,1460,7215
62.328,6,74,54630,49,1190,1298,1368,46594,25,841,2586,2736,8036
0.038,6,10,2046,6,739,7,1322,1723,4,159,12,159,323
434.375,6,79,14395,42,473,10594,1418,10264,37,146,12065,580,4131
1799.996,17,449,39928,404,35,4466,288,25708,45,288,40021,288,14220
1796.011,6,422,25293,211,69,8552,69,12580,211,34,8552,64,12713
371.139,6,51,3671,20,61,19526,295,1724,31,47,12366,78,1947
106.127,2,2,64,2,8,106127,8,64,0,0,0,0,0
1746.497,6,95,7203,63,38,28169,205,4476,32,33,56332,98,2727
323.189,6,32,7263,13,143,26932,159,1413,19,811,17954,1669,5850
1773.569,6,181,15589,120,69,14903,69,8940,61,69,29557,69,6649
287.016,1,3,168,3,28,143508,28,168,0,0,0,0,0
58.725,6,31,8912,15,158,4194,267,1397,16,763,3911,3436,7515
0.182,6,43,18008,24,1003,7,1420,13027,19,467,9,1883,4981
362.238,2,4,128,4,8,120746,8,128,0,0,0,0,0
0.687,17,4,352,2,60,685,60,176,2,60,684,60,176
4.082,17,3,183,3,33,2041,33,183,0,0,0,0,0
2.744,6,2384,2224823,1321,215,2,230,73047,1063,1975,2,11264,2151776
1795.723,17,448,39896,403,35,4466,288,25676,45,288,40020,288,14220
280.317,6,31,7472,14,158,21562,267,1357,17,543,17514,1400,6115
1789.496,1,196,10976,196,28,9176,28,10976,0,0,0,0,0
1782.01,6,448,73364,204,231,8777,1360,45186,244,178,7332,2720,28178
27.456,6,48,13202,23,200,1248,721,2726,25,676,1136,1440,10476
0.878,6,23,6174,13,266,69,668,1854,10,979,93,1771,4320
1781.124,6,358,22738,209,69,8563,69,12638,149,69,12034,69,10100
0.064,6,12,3589,6,126,12,126,446,6,1411,12,1448,3143
0.112,17,2,672,2,308,112,308,672,0,0,0,0,0
59.129,6,37,9483,15,272,910,721,3055,22,504,2807,1440,6428
0.509,17,4,240,2,32,508,32,120,2,32,508,32,120
240.529,6,44,6319,21,266,12025,1056,3511,23,197,10930,580,2808
1684.511,2,27,864,27,8,64788,8,864,0,0,0,0,0
1792.956,17,66,2766,65,14,28014,14,2730,1,8,0,8,36
14.015,17,4,3355,4,810,4671,1438,3355,0,0,0,0,0
12.982,6,8,506,8,31,1854,31,506,0,0,0,0,0
232.75,17,4,352,2,60,232749,60,176,2,60,232749,60,176
127.513,6,19,4068,2,92,323,92,204,17,198,7958,1408,3864
6.784,6,53,14128,27,499,260,1152,10077,26,429,260,1179,4051
1772.468,6,180,15480,120,69,14894,69,8940,60,69,30040,69,6540
15.488,17,16,5404,8,373,2207,1350,3212,8,246,2207,1350,2192
1789.314,6,365,25032,213,94,8440,469,14536,152,69,11849,69,10496
169.888,6,79,58244,52,1215,3331,1368,50106,27,747,2379,1368,8138
254.477,17,6,528,3,60,127238,60,264,3,60,127238,60,264
1788.375,6,129,14907,79,84,22927,498,6386,50,155,36495,1414,8521
158.401,17,4,352,2,60,158400,60,176,2,60,158400,60,176
50.52,17,42,24777,18,903,2970,1350,16767,24,305,2195,1350,8010
64.39,6,9,372,4,0,4142,0,164,5,0,16094,0,208
0.946,6,10,1687,7,100,157,100,384,3,1179,339,1179,1303
1333.424,6,76,6078,45,48,28052,205,3463,31,33,44441,98,2615
12.133,17,10,2240,5,46,3029,46,370,5,346,3030,346,1870
3.271,6,23,7380,10,357,363,721,1475,13,597,245,1440,5905
1795.124,6,362,22898,210,69,8589,69,12678,152,69,11888,69,10220
1744.618,2,15,480,15,8,124615,8,480,0,0,0,0,0
1772.835,6,128,7766,68,26,26459,26,4092,60,26,30047,26,3674
1799.999,1,16,896,16,28,119999,28,896,0,0,0,0,0
1752.443,17,30,10048,30,306,60429,308,10048,0,0,0,0,0
262.665,6,82,55927,52,1241,5150,1448,46171,30,682,2780,2359,9756
1.803,6,58,18034,28,707,66,1360,8925,30,438,61,1360,9109
1211.904,1,66,3696,66,28,18644,28,3696,0,0,0,0,0
241.159,6,356,403177,148,784,1640,1402,23062,208,1985,1164,7010,380115
0.032,17,2,376,1,41,0,41,69,1,279,0,279,307
1795.984,17,991,68053,991,40,1814,41,68053,0,0,0,0,0
7.025,6,65,20438,35,554,206,1152,15811,30,427,233,1152,4627
1.659,6,82,54924,45,1277,37,1440,47071,37,842,41,1440,7853
973.498,1,36,2016,36,28,27814,28,2016,0,0,0,0,0
3.976,17,4,240,2,32,3975,32,120,2,32,3974,32,120
1794.266,17,80,3354,79,14,23003,14,3318,1,8,0,8,36
1682.784,17,16,1265,8,30,240389,37,471,8,71,240391,136,794
764.613,17,458,147370,225,541,3413,1350,128147,233,54,3295,1350,19223
0.367,6,26,8913,13,242,30,610,1655,13,939,30,1408,7258
214.267,17,6,528,3,60,107132,60,264,3,60,107133,60,264
0.017,17,4,1116,2,32,9,32,120,2,470,8,470,996
1703.997,6,175,15211,112,70,15351,138,8482,63,69,27483,69,6729
24.223,17,12,1056,6,48,4809,48,456,6,72,4820,72,600
756.645,2,6,192,6,8,151329,8,192,0,0,0,0,0
300.926,6,41,12359,22,840,14329,1460,6797,19,399,483,1460,5562
267.808,6,31,6809,14,189,8361,516,1512,17,329,16731,1452,5297
1772.507,6,180,15480,120,69,14895,69,8940,60,69,30041,69,6540
0.013,17,2,392,1,36,0,36,64,1,300,0,300,328
0.369,6,27,9098,13,261,30,683,1728,14,829,27,1438,7370
3.294,6,63,24774,32,897,106,1380,19253,31,467,108,1923,5521
15.726,6,26,4996,13,256,1310,722,1764,13,283,1293,1408,3232
281.483,6,30,7432,14,158,21652,267,1357,16,603,18747,2036,6075
1747.985,6,100,7866,66,45,26892,205,4902,34,35,52956,98,2964
127.226,6,8,474,2,106,127220,106,194,6,0,25443,0,280
10.913,6,2022,1899205,1305,1378,8,1408,1857257,717,931,14,2816,41948
1740.407,17,30,20190,30,645,60014,645,20190,0,0,0,0,0
0.12,6,9,1339,5,145,30,145,349,4,826,31,826,990
109.574,6,31,13276,15,488,341,1440,3075,16,954,7295,1440,10201
61.608,6,13,532,7,0,10268,0,284,6,0,12268,0,248
42.008,17,48,7056,24,48,1826,48,1824,24,190,1825,308,5232
1795.001,17,140,11200,70,48,26014,48,5320,70,56,26014,56,5880
1772.078,6,180,15480,120,69,14891,69,8940,60,69,30031,69,6540
1786.453,17,87,3648,86,14,21017,14,3612,1,8,0,8,36
1789.494,17,142,11360,71,48,25564,48,5396,71,56,25564,56,5964
1771.005,6,99,9306,66,66,27246,66,5610,33,60,55330,60,3696
0.085,6,9,1340,5,145,21,145,349,4,827,26,827,991
3.19,17,5,738,4,32,1058,32,240,1,470,0,470,498
0.005,17,2,554,1,30,0,30,58,1,468,0,468,496
1.038,6,10,1687,7,100,173,100,384,3,1179,385,1179,1303
177.671,2,3,96,3,8,88835,8,96,0,0,0,0,0
0.002,6,2,80,0,0,0,0,0,2,0,0,0,80
15.278,6,7,770,3,304,7636,304,460,4,102,5090,102,310
2.0,17,6,1748,3,40,996,41,206,3,486,996,505,1542
3.3,17,2,396,1,39,0,39,67,1,301,0,301,329
1744.272,6,95,7203,63,38,28133,205,4476,32,33,56255,98,2727
2.283,6,13,2311,8,188,326,245,700,5,1407,505,1407,1611
354.513,6,35,12220,10,142,39389,267,1261,25,497,14770,1420,10959
0.079,17,2,362,1,32,0,32,60,1,274,0,274,302
2.445,17,4,580,2,40,2069,40,136,2,194,2101,194,444
1799.761,17,448,39896,403,35,4477,288,25676,45,288,40010,288,14220
13.192,17,6,8230,6,1343,2638,1347,8230,0,0,0,0,0
1800.0,6,215,16883,79,72,22692,337,8066,136,49,13333,143,8817
0.334,6,11,1864,7,262,55,517,896,4,752,106,752,968
0.316,17,2,180,1,30,0,30,58,1,94,0,94,122
1783.807,6,367,25581,214,99,8374,469,15045,153,69,11735,69,10536
234.838,1,4,224,4,28,78279,28,224,0,0,0,0,0
0.129,6,9,1343,5,145,32,145,349,4,830,31,830,994
112.762,6,21,9086,12,304,84,597,1425,9,1457,14072,4441,7661
29.448,17,17,2437,17,115,1840,357,2437,0,0,0,0,0
1680.804,1,15,870,15,30,120057,30,870,0,0,0,0,0
1787.405,6,102,8296,68,65,26677,65,4930,34,59,54160,59,3366
0.416,17,2,152,1,48,0,48,76,1,48,0,48,76
164.227,17,4,352,2,60,164225,60,176,2,60,164225,60,176
1.354,6,51,19489,29,898,48,1460,13788,22,400,55,1460,5701
1773.71,1,81,4536,81,28,22171,28,4536,0,0,0,0,0
240.287,6,43,9138,21,524,12013,1418,5818,22,240,11441,617,3320
5.019,17,4,288,2,36,5003,36,128,2,52,5000,52,160
1799.949,6,367,25181,213,93,8490,469,14605,154,69,11764,69,10576
1.363,6,54,19908,29,920,48,1460,14087,25,400,48,1460,5821
1798.766,1,67,5628,67,56,27254,56,5628,0,0,0,0,0
7.706,6,34,8870,17,340,481,722,2729,17,778,468,1380,6141
1720.668,17,13,534,11,14,172046,14,462,2,8,1720476,8,72
3.988,6,32,6089,17,206,249,314,2744,15,548,266,1179,3345
1.291,17,4,624,2,64,962,64,184,2,192,1070,192,440
73.728,6,5,355,0,0,0,0,0,5,31,18432,31,355
0.378,6,10,968,5,256,91,256,460,5,304,91,304,508
1799.332,17,449,39928,404,35,4464,288,25708,45,288,40021,288,14220
1777.115,17,79,3312,78,14,23079,14,3276,1,8,0,8,36
3.773,17,2,152,2,48,3773,48,152,0,0,0,0,0
0.255,17,2,2752,2,1348,255,1348,2752,0,0,0,0,0
1789.933,17,87,3648,86,14,21058,14,3612,1,8,0,8,36
165.244,6,25,1020,10,0,6121,0,404,15,0,11802,0,616
1791.203,6,364,23047,211,69,8529,69,12787,153,69,11783,69,10260
1796.855,17,80,3354,79,14,23036,14,3318,1,8,0,8,36
0.059,6,11,911,6,181,11,181,489,5,77,5,133,422
0.008,17,2,382,1,37,0,37,65,1,289,0,289,317
2.099,17,3,174,3,30,1049,30,174,0,0,0,0,0
0.235,6,2,80,1,0,0,0,40,1,0,0,0,40
3.796,17,5,295,5,31,949,31,295,0,0,0,0,0
1782.429,17,279,54508,279,167,6411,373,54508,0,0,0,0,0
30.101,6,37,8435,16,175,2006,721,2049,21,554,1494,2840,6386
4.21,6,24,6534,12,268,378,517,1437,12,744,378,1418,5097
1740.927,6,96,7286,63,38,28079,205,4476,33,33,54395,98,2810
0.014,17,2,1844,2,894,14,1447,1844,0,0,0,0,0
1740.614,17,28,29568,28,1028,64467,1028,29568,0,0,0,0,0
1791.088,6,102,12034,48,149,38106,517,3400,54,645,33792,1368,8634
0.008,17,2,337,1,36,0,36,64,1,245,0,245,273
119.408,6,72,48115,45,1175,2713,1408,39978,27,747,2371,1408,8137
5.599,6,4,176,4,0,0,0,176,0,0,0,0,0
97.074,6,28,7217,13,155,8089,267,1306,15,482,6933,2840,5911
1.459,17,20,8693,9,348,173,1350,3387,11,454,137,1350,5306
1795.757,17,142,11360,71,48,25653,48,5396,71,56,25653,56,5964
116.496,17,4,240,2,32,116495,32,120,2,32,116494,32,120
300.623,6,46,8984,22,286,14315,766,2116,24,327,550,1460,6868
31.737,6,7,420,1,0,0,0,60,6,0,6313,0,360
0.463,6,13,1693,6,288,89,288,548,7,426,43,434,1145
0.292,6,25,6014,12,164,26,453,1442,13,648,23,1408,4572
1771.06,6,99,9240,66,65,27247,65,5577,33,59,55343,59,3663
1774.048,6,180,15480,120,69,14907,69,8940,60,69,30064,69,6540
1705.452,1,8,448,8,28,243636,28,448,0,0,0,0,0
27.54,6,1923,1799351,1181,1441,23,1448,1753831,742,776,36,1448,45520
0.271,6,26,9041,13,252,22,646,1694,13,951,21,2804,7347
1771.138,6,99,9306,66,66,27248,66,5610,33,60,55345,60,3696
8.453,6,1369,1171266,813,1390,10,1420,1144793,556,467,15,1883,26473
0.504,6,13,1693,6,288,97,288,548,7,426,48,434,1145
0.883,6,28,6109,13,154,73,267,1604,15,780,57,1460,4505
1.99,6,31,8912,14,158,153,267,1357,17,763,118,2076,7555
1788.908,6,422,25570,239,69,7516,69,13838,183,47,9829,69,11732
1790.538,1,232,12992,232,28,7751,28,12992,0,0,0,0,0
5.349,6,40,7309,20,218,281,314,3423,20,513,268,1179,3886
0.087,17,2,2382,2,1163,87,1163,2382,0,0,0,0,0
0.369,17,2,166,1,39,0,39,67,1,71,0,71,99
1787.149,6,115,13684,75,81,24150,505,5921,40,162,45822,1452,7763
1795.631,17,449,39928,404,35,4455,288,25708,45,288,40022,288,14220
64.311,6,24,10054,12,532,69,1360,2642,12,1153,5832,2574,7412
0.273,17,2,152,1,48,0,48,76,1,48,0,48,76
0.189,6,9,1340,5,145,47,145,349,4,827,36,827,991
6.028,6,903,822628,585,1362,10,1432,805617,318,427,18,1432,17011
0.691,6,25,8045,12,186,62,367,1378,13,995,55,1368,6667
2.521,17,2,136,1,32,0,32,60,1,48,0,48,76
1720.635,17,13,534,11,14,172045,14,462,2,8,1720455,8,72
0.23,6,46,22747,27,1111,8,1420,17766,19,467,12,1883,4981
191.572,1,14,1456,0,0,0,0,0,14,76,14736,76,1456
0.188,6,34,18291,16,173,12,319,1532,18,1317,10,1588,16759
1681.333,17,14,3815,7,30,280220,30,406,7,459,280220,463,3409
1771.668,6,101,9344,66,65,27256,65,5577,35,59,52104,59,3767
0.343,17,8,2774,8,318,49,357,2774,0,0,0,0,0
1.603,6,681,825839,132,536,12,1396,9017,549,1449,2,5584,816822
73.282,17,4,352,2,60,73281,60,176,2,60,73281,60,176
164.601,6,29,7392,13,158,13716,267,1317,16,603,10972,1400,6075
96.622,6,26,10770,14,874,7432,1448,4235,12,843,6005,1448,6535
4.915,6,38,7229,20,218,258,314,3423,18,513,273,1179,3806
280.218,6,27,7312,12,158,25474,267,1277,15,678,20013,2045,6035
115.535,6,193,147206,118,1289,987,1408,133793,75,731,1456,3847,13413
0.016,17,4,424,2,46,0,46,148,2,110,0,110,276
1786.5,6,109,9119,70,71,25891,295,5305,39,64,47009,248,3814
148.505,6,30,7432,13,158,12375,267,1317,17,543,9275,1400,6115
40.908,6,4588,4240596,2968,1349,13,1408,4151692,1620,931,25,2801,88904
619.051,17,25,9566,25,354,25793,548,9566,0,0,0,0,0
4.975,17,4,390,2,44,4928,44,144,2,95,4927,95,246
0.02,17,2,152,1,48,0,48,76,1,48,0,48,76
89.626,6,23,4436,9,296,11203,722,1353,14,261,6878,1408,3083
0.046,17,2,220,1,33,0,33,61,1,131,0,131,159
30.214,6,45,8836,21,345,772,720,1967,24,327,1308,1460,6869
0.021,17,2,138,1,33,0,33,61,1,49,0,49,77
240.488,6,66,24820,34,534,7287,1418,6588,32,871,7757,1418,18232
240.286,6,48,10600,24,202,10447,833,2897,24,585,10447,2816,7703
46.443,6,36,10336,15,450,138,1189,3764,21,440,2321,1420,6572
1.566,6,51,19827,29,920,55,1460,14126,22,437,63,2615,5701
1776.46,6,182,15698,120,69,14928,69,8940,62,69,29118,69,6758
1236.746,6,165,19178,93,79,13442,267,7404,72,141,17416,4837,11774
25.163,6,26,7010,14,187,1935,477,1512,12,695,1831,1402,5498
0.57,6,23,6395,13,310,47,889,2075,10,979,62,1731,4320
1787.907,6,357,22629,209,69,8595,69,12569,148,69,12162,69,10060
0.079,6,2,80,1,0,0,0,40,1,0,0,0,40
6.052,6,44,8369,22,227,288,314,4062,22,489,276,1179,4307
93.647,6,107,42574,50,750,1906,1152,35775,57,410,1668,1179,6799
1771.714,6,99,9306,66,66,27257,66,5610,33,60,55363,60,3696
1571.8,6,91,6871,56,39,28578,205,3988,35,33,43650,98,2883
87.511,6,20,8154,11,511,87,1194,2005,9,1155,10917,3151,6149
52.294,6,762,393481,440,1019,119,1360,353109,322,132,162,4027,40372
1.268,6,25,8056,12,164,97,267,1288,13,869,90,1448,6768
0.144,6,9,1002,5,213,36,213,417,4,421,37,421,585
31.454,17,4,352,2,60,31453,60,176,2,60,31453,60,176
1763.78,6,181,32814,121,302,14698,302,24714,60,83,29894,83,8100
240.31,6,56,29686,25,177,10012,517,2371,31,1284,8008,4254,27315
360.996,2,5,160,5,8,90249,8,160,0,0,0,0,0
4.864,6,57,36560,34,1203,147,1360,29079,23,935,212,3620,7481
599.524,6,9,546,6,31,119904,31,333,3,31,299679,31,213
1781.155,6,120,11259,70,65,25813,65,5980,50,59,36347,59,5279
1796.099,17,447,39864,402,35,4479,288,25644,45,288,40016,288,14220
0.222,17,2,152,1,48,0,48,76,1,48,0,48,76
1.677,6,36,12394,16,219,111,705,2194,20,828,85,1438,10200
1788.803,17,87,3648,86,14,21044,14,3612,1,8,0,8,36
1.34,17,2,148,2,46,1340,46,148,0,0,0,0,0
2.682,6,26,10804,16,612,178,1360,3734,10,1331,282,4428,7070
1792.088,6,419,37182,186,68,9686,681,13852,233,86,7723,2720,23330
0.075,17,2,334,1,32,0,32,60,1,246,0,246,274
32.901,6,44,10817,22,830,439,1360,5090,22,371,1558,1360,5727
212.454,17,4,240,2,32,212452,32,120,2,32,212452,32,120
40.366,17,3,228,3,48,20183,48,228,0,0,0,0,0
1.243,6,22,8038,13,334,103,663,2045,9,919,150,1946,5993
121.008,6,15,1622,7,330,20168,330,1020,8,83,17284,83,602
374.833,6,18,1239,14,177,28833,177,913,4,110,20994,110,326
1787.186,6,376,23320,208,69,8633,69,12460,168,51,10701,69,10860
1719.267,1,8,448,8,28,245609,28,448,0,0,0,0,0
1783.764,6,361,24196,211,88,8494,469,13918,150,69,11968,69,10278
280.22,6,28,7352,12,158,25474,267,1277,16,603,18678,1400,6075
0.016,17,2,206,1,44,0,44,72,1,106,0,106,134
5.487,6,40,7325,21,218,274,314,3463,19,516,289,1179,3862
1790.457,1,248,26288,248,78,7248,78,26288,0,0,0,0,0
0.19,17,2,180,1,30,0,30,58,1,94,0,94,122
1742.845,6,95,7203,63,38,28110,205,4476,32,33,56206,98,2727
192.644,17,4,240,2,32,192643,32,120,2,32,192643,32,120
96.298,6,45,22903,25,248,4012,683,2303,20,1396,5066,2896,20600
1783.009,6,232,20804,88,89,20492,369,9884,144,70,12467,1062,10920
1681.285,17,16,1274,8,30,240180,37,471,8,72,240180,136,803
15.116,17,14,5171,6,399,3017,1350,2563,8,298,2154,1350,2608
42.292,17,48,7056,24,48,1838,48,1824,24,190,1838,308,5232
0.376,17,2,152,1,48,0,48,76,1,48,0,48,76
0.807,17,11,3957,11,331,80,361,3957,0,0,0,0,0
1653.198,1,7,392,7,28,275533,28,392,0,0,0,0,0
1770.496,6,106,9987,68,70,26425,234,5948,38,60,47847,83,4039
0.017,17,2,384,1,39,0,39,67,1,289,0,289,317
6.156,6,39,7285,21,218,307,314,3463,18,516,346,1179,3822
1.439,6,40,9928,21,440,71,1360,4392,19,476,68,2715,5536
25.134,17,8,608,8,48,3590,48,608,0,0,0,0,0
1.006,17,4,368,2,64,1004,64,184,2,64,1005,64,184
280.367,6,28,7352,13,158,23363,267,1317,15,775,20023,2760,6035
1787.32,6,102,8228,68,64,26676,64,4896,34,58,54158,58,3332
400.045,1,22,6816,22,281,19049,527,6816,0,0,0,0,0
32.075,6,9,396,2,0,3482,0,88,7,0,5330,0,308
161.22,6,223,177296,141,1289,1151,1408,162132,82,680,1987,3847,15164
1.438,6,37,9808,20,502,75,1460,4352,17,476,75,2615,5456
777.247,6,79,8953,46,83,17272,722,4231,33,125,24268,1448,4722
0.013,17,2,238,1,45,0,45,73,1,137,0,137,165
1.295,6,21,2812,11,345,129,767,1519,10,176,124,374,1293
1383.683,2,10,320,10,8,153742,8,320,0,0,0,0,0
49.343,17,44,8444,20,215,2595,1350,4875,24,120,2144,1350,3569
240.203,6,53,17679,29,737,8578,1402,14797,24,203,10443,580,2882
295.798,6,38,8760,18,326,17397,517,2261,20,778,15565,1418,6499
36.27,6,226,205288,82,162,447,368,5090,144,1396,248,1418,200198
300.599,6,41,8758,22,308,14314,889,2183,19,414,468,2128,6575
0.324,6,26,9060,13,271,27,726,1771,13,1100,26,2816,7289
300.804,6,37,14679,19,609,16708,1368,4653,18,826,17691,1368,10026
127.114,6,6,378,3,106,63557,106,234,3,0,1520,0,144
369.578,6,18,1288,14,226,28429,226,962,4,110,20059,110,326
1.65,6,14,2351,8,188,235,245,700,6,703,281,1152,1651
1797.214,17,335,25460,335,48,5380,48,25460,0,0,0,0,0
10.377,17,2,152,2,48,10377,48,152,0,0,0,0,0
504.051,2,4,128,4,8,168017,8,128,0,0,0,0,0
240.282,6,54,18160,29,808,8581,1402,15253,25,199,10011,580,2907
1795.305,17,449,39928,404,35,4454,288,25708,45,288,40019,288,14220
4.637,1,6,336,6,28,927,28,336,0,0,0,0,0
330.09,17,9,3024,9,308,41261,308,3024,0,0,0,0,0
0.101,6,15,4860,9,290,12,517,1045,6,1165,16,1497,3815
141.451,17,4,352,2,60,141450,60,176,2,60,141450,60,176
0.65,6,10,1840,5,901,162,901,1169,5,403,162,403,671
1797.45,17,448,39896,403,35,4471,288,25676,45,288,40021,288,14220
0.532,6,4,172,2,0,532,0,92,2,0,319,0,80
0.18,17,2,152,2,48,180,48,152,0,0,0,0,0
283.74,17,4,352,2,60,283739,60,176,2,60,283739,60,176
1779.724,6,354,22440,207,69,8639,69,12420,147,69,12189,69,10020
748.373,17,15,4936,15,301,53455,308,4936,0,0,0,0,0
1.75,6,20,7151,12,318,159,600,1906,8,964,206,1471,5245
1.718,6,13,2311,8,188,245,245,700,5,1407,365,1407,1611
8.716,6,8,460,3,0,4358,0,160,5,0,1855,0,300
105.549,17,4,1544,4,358,35183,548,1544,0,0,0,0,0
1750.938,17,12,498,11,14,175093,14,462,1,8,0,8,36
1780.024,6,103,8268,68,64,26567,64,4896,35,58,52351,58,3372
1795.386,6,384,27213,220,102,8198,469,16168,164,69,11013,69,11045
3.235,17,5,290,5,30,808,30,290,0,0,0,0,0
90.685,17,18,1584,9,48,11334,48,684,9,72,11334,72,900
33.549,1,12,1248,0,0,0,0,0,12,76,3049,76,1248
1797.478,6,359,22709,209,69,8641,69,12569,150,69,12063,69,10140
1781.344,6,184,15847,123,69,14601,69,9267,61,69,29682,69,6580
0.615,6,12,2084,6,288,87,288,560,6,424,86,434,1524
8.559,17,6,528,3,48,4275,48,228,3,72,4274,72,300
63.602,6,53,27472,25,567,2650,1130,3019,28,1044,1986,1448,24453
93.283,6,21,860,9,0,6122,0,364,12,0,8478,0,496
1794.786,6,361,22996,208,69,8670,69,12529,153,69,11807,69,10467
1.632,6,49,19760,29,923,58,1360,14139,20,437,74,2715,5621
0.786,6,27,5927,13,156,65,267,1462,14,650,55,1452,4465
0.001,17,2,586,1,137,0,137,165,1,393,0,393,421
1.015,6,10,1687,7,100,169,100,384,3,1179,370,1179,1303
3.88,17,4,296,4,46,1293,46,296,0,0,0,0,0
840.844,17,10,2610,5,31,210208,37,297,5,434,210208,463,2313
1.822,6,48,10434,25,440,75,1360,4588,23,351,73,1360,5846
282.878,6,31,7563,14,147,21759,267,1448,17,603,17672,2076,6115
1771.218,6,99,9240,66,65,27249,65,5577,33,59,55347,59,3663
1560.193,6,112,11537,66,68,24002,722,5631,46,97,34653,2329,5906
98.134,17,4,352,2,60,98133,60,176,2,60,98133,60,176
240.243,6,66,18790,33,768,7507,1408,15569,33,166,7507,580,3221
3.378,17,5,360,5,44,844,44,360,0,0,0,0,0
1790.719,1,59,4956,59,56,30874,56,4956,0,0,0,0,0
1754.926,6,183,11234,93,48,19075,208,6704,90,31,19711,31,4530
378.67,2,3,96,3,8,189335,8,96,0,0,0,0,0
0.051,17,7,2102,7,272,8,316,2102,0,0,0,0,0
1793.483,17,261,49599,261,162,6898,422,49599,0,0,0,0,0
1758.505,1,59,4956,0,0,0,0,0,59,56,30319,56,4956
1797.145,1,308,32648,308,78,5853,78,32648,0,0,0,0,0
0.575,6,14,1110,8,181,82,181,593,6,49,108,134,517
10.74,6,1745,1487246,1050,1362,10,1380,1455192,695,421,15,1923,32054
7.987,6,19,8221,9,275,998,275,643,10,1194,863,1414,7578
0.028,17,2,184,1,64,0,64,92,1,64,0,64,92
28.14,17,8,608,8,48,4020,48,608,0,0,0,0,0
1795.028,17,449,39928,404,35,4454,288,25708,45,288,40016,288,14220
25.711,6,34,8218,17,175,1606,721,2085,17,778,1594,2840,6133
5.042,17,6,1404,6,206,1008,206,1404,0,0,0,0,0
0.355,6,9,527,5,43,88,43,311,4,0,81,0,216
0.022,6,10,1327,5,299,4,299,567,5,246,3,459,760
2.23,6,31,6221,15,161,159,267,1571,16,572,144,1420,4650
1744.63,2,15,480,15,8,124616,8,480,0,0,0,0,0
0.055,6,2,111,1,0,0,0,40,1,31,0,31,71
11.782,6,20,8205,10,275,1309,275,958,10,1367,1195,1420,7247
240.242,6,57,19997,31,820,8007,1418,17205,26,179,9609,580,2792
1770.13,6,417,99797,181,204,9833,1360,33677,236,510,7532,2720,66120
0.107,6,2,80,1,0,0,0,40,1,0,0,0,40
164.102,6,20,9181,11,514,81,1236,2014,9,1359,20490,3639,7167
10.983,6,22,8554,11,275,1098,275,998,11,1420,968,1420,7556
3.476,17,10,2447,5,40,866,40,340,5,393,865,423,2107
11.499,6,21,4442,12,275,1045,275,1038,9,758,780,1420,3404
1186.679,17,13,1271,13,69,98889,355,1271,0,0,0,0,0
1789.835,6,356,22520,208,69,8646,69,12460,148,69,12174,69,10060
294.792,1,4,224,4,28,98264,28,224,0,0,0,0,0
5.644,6,41,7349,21,218,282,314,3463,20,440,283,1152,3886
1779.897,1,236,13216,236,28,7574,28,13216,0,0,0,0,0
15.748,17,10,880,5,48,3933,48,380,5,72,3933,72,500
1786.668,6,113,11786,72,132,25164,1302,7658,41,69,44664,241,4128
20.215,6,20,5365,12,107,1837,159,1074,8,966,2885,1658,4291
3.334,17,29,18790,16,983,220,1350,16189,13,172,275,1350,2601
0.134,6,9,1343,5,145,33,145,349,4,830,37,830,994
0.25,6,10,766,5,185,54,185,453,5,45,49,45,313
16.305,17,15,6502,7,535,2712,1350,3941,8,292,2324,1350,2561
35.386,6,31,5093,15,154,2527,722,1859,16,342,2328,1448,3234
367.098,6,18,1239,14,177,28238,177,913,4,110,20056,110,326
12.018,17,10,2105,5,47,3002,47,375,5,318,3002,318,1730
14.079,6,26,4705,13,204,1132,722,1708,13,463,1131,1448,2997
4.174,6,39,7269,19,218,231,314,3383,20,440,206,1152,3886
14.959,17,4,1344,4,308,4986,308,1344,0,0,0,0,0
0.348,6,35,8185,18,297,20,517,1929,17,505,21,1420,6256
0.615,6,27,10461,14,552,47,1348,2272,13,850,40,2720,8189
183.622,17,4,352,2,60,183621,60,176,2,60,183621,60,176
280.177,6,26,7272,12,158,25470,267,1277,14,775,21549,3445,5995
240.528,6,41,8684,20,566,12658,1418,5581,21,250,12025,651,3103
1760.668,17,168,14138,156,30,11359,37,9090,12,392,154629,463,5048
28.047,6,141,97806,82,1280,102,1360,90415,59,386,480,2720,7391
141.29,17,4,352,2,60,141289,60,176,2,60,141289,60,176
1793.692,17,29,9512,29,300,64060,300,9512,0,0,0,0,0
25.934,6,3852,3593691,2482,1369,10,1408,3517775,1370,931,18,2816,75916
0.278,6,21,7281,12,334,24,663,1969,9,967,33,1912,5312
1799.083,6,382,26595,219,97,8252,469,15590,163,69,11105,69,11005
1782.254,17,67,2808,66,14,27419,14,2772,1,8,0,8,36
1787.79,6,104,8424,68,64,26683,64,4896,36,58,51077,58,3528
0.43,6,49,20204,27,930,16,1380,15070,22,421,19,1923,5134
33.588,6,33,5209,16,154,2227,722,1922,17,342,2088,1440,3287
1775.348,1,58,4872,58,56,31146,56,4872,0,0,0,0,0
1087.405,17,68,17276,34,39,32951,43,2281,34,413,32951,462,14995
0.015,17,4,352,2,60,14,60,176,2,60,12,60,176
1799.91,6,356,22520,208,69,8695,69,12460,148,69,12244,69,10060
1758.311,17,352,58809,352,139,5009,363,58809,0,0,0,0,0
4.988,6,56,20345,30,608,172,1360,6791,26,781,192,1896,13554
0.995,6,27,8456,14,266,65,540,1960,13,994,66,2720,6496
1794.504,1,58,4872,0,0,0,0,0,58,56,31482,56,4872
22.614,6,9,504,3,0,10853,0,172,6,0,4522,0,332
1696.443,1,8,448,8,28,242349,28,448,0,0,0,0,0
4.092,17,14,15411,4,1036,1364,1350,4259,10,1087,230,1350,11152
7.448,6,43,8345,21,227,372,314,4022,22,491,342,1179,4323
68.974,17,4,352,2,60,68973,60,176,2,60,68973,60,176
1046.595,6,88,9356,47,73,22752,722,4062,41,98,26160,1408,5294
26.656,6,14,2242,8,210,3802,210,844,6,545,5324,904,1398
1789.228,6,298,20338,178,69,10108,69,11329,120,69,15035,69,9009
54.808,17,6,2016,6,308,10961,308,2016,0,0,0,0,0
23.27,6,7,476,0,0,0,0,0,7,31,3878,31,476
0.855,6,2,1194,1,0,0,0,40,1,1114,0,1114,1154
1796.522,1,205,11480,205,28,8806,28,11480,0,0,0,0,0
673.413,17,56,5425,50,30,13743,37,2921,6,389,124151,463,2504
37.843,6,28,6452,16,117,2522,159,1441,12,873,3436,1709,5011
1787.347,6,104,8308,68,64,26676,64,4896,36,58,51063,58,3412
6.56,6,5,232,2,0,6560,0,88,3,0,1510,0,144
0.526,17,3,543,2,39,55,39,134,1,381,0,381,409
1792.744,6,367,25650,214,99,8416,469,15045,153,69,11791,69,10605
1792.197,1,202,11312,202,28,8916,28,11312,0,0,0,0,0
123.387,17,4,352,2,48,123376,48,152,2,72,123377,72,200
1785.55,1,188,10528,188,28,9548,28,10528,0,0,0,0,0
10.282,17,5,1160,5,204,2570,204,1160,0,0,0,0,0
661.53,6,71,8538,38,98,17874,722,3753,33,139,20666,2330,4785
2.375,17,2,152,1,48,0,48,76,1,48,0,48,76
23.086,1,10,1060,10,78,2565,78,1060,0,0,0,0,0
1770.003,6,102,9396,66,65,27230,65,5577,36,59,50569,59,3819
90.843,6,35,7911,19,449,5046,1402,5480,16,227,6026,580,2431
11.347,6,26,9913,13,275,945,275,1078,13,1037,787,1420,8835
2.844,6,43,14937,22,225,135,561,2337,21,979,133,1631,12600
1791.922,1,342,28728,342,56,5254,56,28728,0,0,0,0,0
1795.549,17,449,39928,404,35,4455,288,25708,45,288,40019,288,14220
300.255,6,32,11864,17,588,18765,1438,4437,15,948,17162,1488,7427
310.611,6,87,63409,34,517,9412,943,3497,53,1329,5973,1440,59912
290.696,17,4,352,2,60,290695,60,176,2,60,290695,60,176
1771.6,1,58,4872,0,0,0,0,0,58,56,31080,56,4872
3.019,17,8,1718,4,37,1002,37,260,4,336,1002,348,1458
7.186,6,1924,1893083,1289,1394,5,1408,1855375,635,776,11,1408,37708
21.233,6,23,6179,14,117,1633,159,1337,9,873,2652,1674,4842
268.051,17,4,240,2,32,268050,32,120,2,32,268050,32,120
8.195,6,24,3484,12,152,745,267,1400,12,320,719,1152,2084
1798.277,17,449,39928,404,35,4462,288,25708,45,288,40023,288,14220
9.348,6,23,3180,12,137,849,267,1037,11,338,892,1152,2143
1792.746,1,234,24804,234,78,7694,78,24804,0,0,0,0,0
1789.897,17,136,10880,68,48,26714,48,5168,68,56,26714,56,5712
639.037,6,96,9052,37,80,16917,301,3738,59,98,11017,1062,5314
400.942,6,21,2001,17,288,25058,327,1277,4,276,96197,276,724
140.723,6,22,8693,12,281,58,537,1357,10,1384,15622,4417,7336
1691.011,17,12,498,11,14,169101,14,462,1,8,0,8,36
1479.77,6,203,15089,101,69,14797,69,7490,102,34,14651,48,7599
0.664,6,10,861,5,222,163,222,426,5,231,162,231,435
61.501,6,16,652,8,0,7649,0,324,8,0,8783,0,328
868.46,6,186,22225,81,109,10855,442,8570,105,154,8342,1440,13655
227.327,6,23,7014,11,181,22732,267,1168,12,766,20664,3436,5846
1786.26,6,356,22520,208,69,8629,69,12460,148,69,12151,69,10060
20.709,17,23,7415,10,393,2297,1350,4215,13,218,1722,1350,3200
8.205,6,18,6767,9,275,1025,275,643,9,1150,717,1414,6124
1763.622,6,98,7421,65,38,27556,205,4611,33,33,55106,98,2810
5.082,17,4,530,2,36,5029,36,128,2,173,5068,187,402
148.717,6,23,1664,17,43,9294,43,1304,6,0,29091,0,360
88.522,6,41,26443,24,745,34,1360,4022,17,1810,5524,4080,22421
11.608,6,1847,1597721,1119,1372,10,1420,1564180,728,467,15,2840,33541
271.928,6,59,9837,31,107,9064,267,2854,28,292,10070,1460,6983
6.974,6,606,498202,359,1320,18,1368,480694,247,776,27,1473,17508
0.011,17,2,633,2,288,11,293,633,0,0,0,0,0
3.936,17,4,352,4,60,1312,60,352,0,0,0,0,0
1794.498,6,328,27497,191,75,9444,267,12635,137,133,13194,1997,14862
0.0,1,1,56,1,28,0,28,56,0,0,0,0,0
0.013,17,2,672,2,308,13,308,672,0,0,0,0,0
4.479,6,25,5642,13,223,373,564,1802,12,639,367,1343,3840
0.035,17,4,768,2,39,21,39,134,2,289,21,289,634
1786.045,6,104,8376,68,65,26657,65,4930,36,59,51026,59,3446
18.92,17,28,6877,14,278,1452,1350,4293,14,156,1452,1350,2584
0.0,1,2,112,2,28,0,28,112,0,0,0,0,0
1794.116,17,144,11520,72,48,25269,48,5472,72,56,25269,56,6048
630.887,2,5,160,5,8,157721,8,160,0,0,0,0,0
240.277,6,53,18005,28,795,8898,1418,14984,25,214,10011,580,3021
5.114,6,40,7325,20,218,269,314,3423,20,516,256,1179,3902
11.97,6,90,26253,46,550,266,1152,20011,44,447,271,1179,6242
1798.892,17,449,39928,404,35,4463,288,25708,45,288,40020,288,14220
1799.685,17,4464,214272,2232,20,806,20,107136,2232,20,806,20,107136
240.305,6,43,9094,21,524,12014,1418,5817,22,236,11442,639,3277
1796.338,17,448,39896,403,35,4468,288,25676,45,288,40021,288,14220
1731.289,6,70,5079,45,33,39347,33,3123,25,31,72125,31,1956
202.357,6,29,7451,10,199,231,293,1602,19,391,11228,1179,5849
155.977,6,23,8198,12,211,53,290,1147,11,942,15584,2720,7051
5.109,6,43,8329,22,227,243,314,4062,21,489,241,1179,4267
1791.279,6,385,25267,210,69,8569,69,12954,175,69,10292,69,12313
2.528,6,13,2311,8,188,361,245,700,5,1407,570,1407,1611
1.353,6,47,18600,26,916,54,1440,12984,21,433,58,1440,5616
0.0,1,3,291,3,69,0,69,291,0,0,0,0,0
1685.577,1,8,448,8,28,240796,28,448,0,0,0,0,0
35.191,6,44,10438,24,136,1530,159,2517,20,686,1840,1658,7921
1.389,6,49,19126,27,882,53,1360,13470,22,476,57,2720,5656
1797.52,6,370,25370,215,93,8399,469,14754,155,69,11670,69,10616
0.349,6,10,968,5,256,85,256,460,5,304,85,304,508
1681.198,17,14,3843,7,30,280199,30,406,7,463,280198,463,3437
0.871,6,53,13941,26,556,34,1429,4952,27,464,32,2920,8989
61.339,6,37,15935,22,800,2920,1448,9157,15,665,4363,1448,6778
1798.223,6,380,26584,218,97,8286,469,15481,162,69,11166,69,11103
0.656,6,10,924,5,283,108,283,551,5,105,112,105,373
3.882,17,4,352,2,48,3871,48,152,2,72,3872,72,200
2.444,17,2,212,1,46,0,46,74,1,110,0,110,138
1786.831,6,128,16124,80,192,22618,1294,10894,48,82,38015,268,5230
280.378,6,30,7432,13,158,23364,267,1317,17,543,17519,1300,6115
1592.939,1,55,3080,55,28,29498,28,3080,0,0,0,0,0
1.362,6,48,19293,27,897,52,1440,13677,21,433,56,1440,5616
1.389,6,39,11298,22,547,66,1360,5842,17,476,75,2715,5456
4.35,17,4,824,2,48,4297,48,152,2,308,4333,308,672
1678.946,1,8,448,8,28,239849,28,448,0,0,0,0,0
1779.394,6,236,20496,93,81,19339,337,9616,143,70,12529,1062,10880
1783.142,17,83,3480,82,14,22014,14,3444,1,8,0,8,36
1783.844,17,221,52476,221,209,8108,422,52476,0,0,0,0,0
28.693,6,4004,3754253,2597,1367,10,1408,3676413,1407,931,20,2816,77840
1787.168,6,359,22847,208,69,8633,69,12460,151,69,11913,69,10387
1775.26,6,180,15480,120,69,14918,69,8940,60,69,30083,69,6540
1.57,6,199,94893,102,342,15,342,7914,97,871,16,1460,86979
38.776,6,4851,4525186,3067,1395,12,1448,4427742,1784,776,21,1448,97444
0.0,17,2,136,1,32,0,32,60,1,48,0,48,76
661.749,2,5,160,5,8,165437,8,160,0,0,0,0,0
602.288,6,64,4030,36,45,17203,208,2569,28,31,22300,31,1461
1.648,6,19,3781,10,234,183,564,1452,9,463,181,1343,2329
10.771,6,20,7050,11,275,1077,275,998,9,1420,748,1420,6052
1780.159,17,138,11040,69,48,26178,48,5244,69,56,26178,56,5796
1.96,17,22,5709,22,231,93,389,5709,0,0,0,0,0
236.347,2,2,64,2,8,236347,8,64,0,0,0,0,0
3.619,6,36,6249,19,206,201,314,2824,17,456,211,1152,3425
0.062,17,4,284,2,32,50,32,120,2,54,13,60,164
124.42,6,9,522,2,106,124406,106,194,7,0,20734,0,328
5.841,6,39,7269,21,218,292,314,3463,18,513,327,1179,3806
6.886,6,32,7584,13,155,573,267,1306,19,367,382,1420,6278
1.258,17,3,1170,3,362,629,362,1170,0,0,0,0,0
1.358,6,48,20041,27,950,52,1440,14425,21,433,58,1440,5616
1785.008,6,102,8364,68,66,26641,66,4964,34,60,54088,60,3400
1773.523,6,180,15480,120,69,14903,69,8940,60,69,30053,69,6540
0.027,17,2,167,1,39,0,39,67,1,72,0,72,100
18.004,6,26,5140,9,179,2250,722,1538,17,298,1113,1408,3602
300.796,6,49,13197,25,884,12533,1460,7280,24,290,637,1460,5917
354.516,17,12,4032,12,308,32228,308,4032,0,0,0,0,0
1764.902,2,12,384,12,8,160445,8,384,0,0,0,0,0
1789.114,6,374,23240,208,69,8643,69,12460,166,53,10842,69,10780
0.529,6,10,924,5,283,88,283,551,5,105,89,105,373
1.943,17,3,468,3,128,971,128,468,0,0,0,0,0
368.304,6,25,1654,17,180,23019,180,1120,8,110,9323,110,534
3.456,6,10,2941,5,92,864,92,348,5,1164,683,1448,2593
192.286,17,7,6492,7,899,32047,1445,6492,0,0,0,0,0
3.343,6,14,3148,5,92,835,92,348,9,464,361,1408,2800
1744.174,6,97,7338,62,38,28593,205,4424,35,33,51291,98,2914
1.224,6,45,18084,26,882,48,1360,12548,19,476,58,2715,5536
1737.547,1,16,896,16,28,115836,28,896,0,0,0,0,0
48.561,17,4,1824,4,428,16187,548,1824,0,0,0,0,0
1745.651,6,95,7203,63,38,28155,205,4476,32,33,56304,98,2727
1.306,6,38,9848,20,502,68,1460,4352,18,433,64,1460,5496
1123.957,17,220,16720,220,48,5132,48,16720,0,0,0,0,0
183.507,17,4,302,2,39,183496,47,135,2,55,183495,63,167
92.86,6,48,20169,26,1117,364,1360,14487,22,399,4412,1360,5682
0.503,6,10,968,5,256,116,256,460,5,304,120,304,508
1700.228,1,8,448,8,28,242889,28,448,0,0,0,0,0
0.872,17,3,1164,3,360,436,360,1164,0,0,0,0,0
0.089,6,9,902,5,201,22,201,405,4,333,26,333,497
93.352,6,23,9966,12,304,95,610,1436,11,1154,9316,3931,8530
1790.392,17,29,9512,29,300,63942,300,9512,0,0,0,0,0
3.432,2,2,64,2,8,3432,8,64,0,0,0,0,0
1679.536,17,12,498,11,14,167953,14,462,1,8,0,8,36
0.426,6,12,3702,6,170,70,170,490,6,964,81,1448,3212
902.408,2,8,256,8,8,128915,8,256,0,0,0,0,0
160.083,2,4,128,4,8,53361,8,128,0,0,0,0,0
15.097,6,16,3268,5,92,3774,92,348,11,579,1473,1408,2920
1764.654,2,19,608,19,8,98036,8,608,0,0,0,0,0
4.265,6,31,8383,15,133,304,267,1404,16,703,283,1400,6979
119.319,17,4,240,2,32,119318,32,120,2,32,119318,32,120
1740.554,17,29,30624,29,1028,62162,1028,30624,0,0,0,0,0
0.048,17,2,144,1,36,0,36,64,1,52,0,52,80
269.336,17,4,352,2,60,269334,60,176,2,60,269335,60,176
77.698,6,144,103065,90,961,196,1360,22915,54,1813,1463,8196,80150
1559.393,6,98,7797,62,66,25563,66,4526,36,59,44542,60,3271
0.032,6,10,1800,6,616,5,1073,1477,4,159,9,159,323
200.465,17,4,352,2,60,200464,60,176,2,60,200464,60,176
0.933,6,29,8610,15,229,57,583,2031,14,858,58,1360,6579
1763.519,2,15,480,15,8,125965,8,480,0,0,0,0,0
7.897,6,809,738469,507,1383,15,1448,718101,302,776,25,1448,20368
0.057,6,7,423,4,43,5,43,259,3,0,27,0,164
3.006,6,14,3582,7,75,500,75,455,7,1373,501,1448,3127
15.202,6,18,6433,5,189,3800,189,409,13,549,561,1360,6024
24.806,17,40,13522,16,255,1651,1350,4538,24,346,1077,1350,8984
1776.569,17,73,3060,72,14,25022,14,3024,1,8,0,8,36
2.784,17,16,12347,8,749,397,1350,6218,8,738,393,1350,6129
2.664,6,4,222,1,31,0,31,71,3,31,1332,31,151
9.315,6,1932,1786441,1228,1376,7,1408,1745169,704,931,13,2816,41272
12.016,6,1924,1657470,1171,1362,10,1380,1621173,753,558,15,1923,36297
4.565,17,29,7973,14,314,348,1350,4789,15,184,323,1350,3184
5.73,6,582,542294,387,1338,14,1368,527404,195,950,28,2736,14890
1787.197,6,141,15877,82,79,22064,519,6703,59,138,30812,1420,9174
1759.255,1,70,5880,70,56,25496,56,5880,0,0,0,0,0
84.417,6,24,11438,12,397,73,884,1717,12,1153,7662,2720,9721
0.121,17,8,2446,8,277,17,316,2446,0,0,0,0,0
0.838,6,20,5966,11,287,83,562,1306,9,716,93,1420,4660
0.588,17,2,178,1,29,0,29,57,1,93,0,93,121
73.031,17,4,352,2,60,73030,60,176,2,60,73030,60,176
1.137,6,52,13874,25,549,47,1429,4876,27,465,42,3446,8998
300.011,17,4,1344,4,308,100003,308,1344,0,0,0,0,0
8.054,6,73,22270,37,556,223,1152,17062,36,470,222,1179,5208
9.479,6,26,12357,15,657,677,994,3419,11,1393,942,2736,8938
65.621,6,9,468,9,0,0,0,468,0,0,0,0,0
1538.256,6,280,49489,180,302,7168,302,36878,100,83,15536,83,12611
15.11,17,15,4921,7,360,2513,1350,2716,8,247,2154,1350,2205
11.712,17,2,152,2,48,11712,48,152,0,0,0,0,0
1.754,6,28,10325,16,367,116,833,1745,12,1012,151,1420,8580
1773.506,6,207,24059,131,89,13642,981,11078,76,137,23644,2006,12981
0.172,6,43,19663,25,1054,7,1420,14722,18,467,9,1883,4941
245.624,6,61,8965,27,300,9446,1056,4478,34,169,7442,582,4487
778.595,17,215,26514,97,157,7492,1350,18039,118,43,6654,1350,8475
0.997,17,4,566,2,31,268,31,118,2,196,0,196,448
1771.286,1,58,4872,58,56,31075,56,4872,0,0,0,0,0
1743.277,6,95,7203,63,38,28117,205,4476,32,33,56225,98,2727
0.384,6,10,1185,6,279,76,279,587,4,191,65,272,598
6.587,6,39,7269,19,218,365,314,3383,20,513,331,1179,3886
1793.553,17,140,11200,70,48,25993,48,5320,70,56,25993,56,5880
0.157,6,42,19587,24,1051,6,1420,14646,18,467,8,1883,4941
1.535,6,39,9936,21,440,76,1360,4440,18,529,78,4075,5496
370.847,6,18,1242,14,180,28526,180,916,4,110,20061,110,326
69.045,6,15,3202,6,92,13809,92,400,9,2330,8607,2330,2802
0.01,17,3,618,2,32,0,32,120,1,470,0,470,498
1789.718,17,349,46646,178,177,10111,1350,36566,171,30,10527,60,10080
13.537,6,13,2193,7,211,2256,211,794,6,545,2707,904,1399
0.232,17,11,5119,5,468,58,1350,2481,6,411,32,1350,2638
1770.104,6,99,9240,66,65,27232,65,5577,33,59,55312,59,3663
1788.18,17,140,11200,70,48,25915,48,5320,70,56,25915,56,5880
7.166,6,67,20166,33,562,223,1152,15379,34,489,209,1179,4787
11.278,6,64,21491,31,787,375,1440,10796,33,518,346,1440,10695
0.011,17,2,394,1,50,0,50,78,1,288,0,288,316
1.797,17,4,1022,2,40,1786,40,136,2,415,1783,423,886
0.027,6,9,1348,5,145,6,145,349,4,835,7,835,999
0.022,6,12,965,7,182,3,182,542,5,77,4,134,423
1791.636,1,250,14000,250,28,7195,28,14000,0,0,0,0,0
0.155,6,46,22176,27,1073,5,1420,17195,19,467,8,1883,4981
20.089,17,5,380,5,48,5022,48,380,0,0,0,0,0
280.494,6,30,7432,13,158,23374,267,1317,17,543,17528,1400,6115
0.81,6,51,21677,28,1023,30,1380,16503,23,421,34,1923,5174
1682.772,17,18,1494,9,31,210330,37,536,9,78,210341,136,958
301.104,1,6,336,6,28,60220,28,336,0,0,0,0,0
1796.548,6,356,22520,208,69,8678,69,12460,148,69,12221,69,10060
1785.178,6,102,8296,68,65,26644,65,4930,34,59,54093,59,3366
6.017,17,6,1263,3,47,3003,47,225,3,318,3004,318,1038
33.165,6,4597,4357489,3010,1369,10,1408,4270301,1587,931,20,2816,87188
4.007,17,4,560,2,64,3990,64,184,2,160,3986,160,376
1755.143,1,74,6216,0,0,0,0,0,74,56,24043,56,6216
1786.814,6,3565,3186362,1526,129,1171,349,88291,2039,1518,876,4224,3098071
1775.944,17,73,3060,72,14,25013,14,3024,1,8,0,8,36
364.484,6,18,1242,14,180,28037,180,916,4,110,20062,110,326
1793.174,6,356,22520,208,69,8662,69,12460,148,69,12197,69,10060
52.911,6,10,648,10,31,5879,31,648,0,0,0,0,0
0.419,6,10,1671,6,552,83,948,1348,4,159,139,159,323
1084.272,6,279,25959,151,120,7228,1189,12692,128,173,8536,1917,13267
1.163,6,34,19901,18,1165,68,1460,11255,16,888,63,1460,8646
319.55,17,732,35136,387,20,827,20,18576,345,20,824,20,16560
6.416,6,39,7269,19,218,356,314,3383,20,440,315,1152,3886
0.013,17,2,366,1,63,0,63,91,1,247,0,247,275
1406.189,6,188,16500,73,83,19528,348,7520,115,74,12334,1062,8980
1781.028,17,142,11360,71,48,25443,48,5396,71,56,25443,56,5964
565.573,6,36,2804,18,65,25481,65,1305,18,45,33263,59,1499
21.189,6,2553,2401845,1623,1402,13,1408,2348821,930,931,21,2801,53024
4.721,6,40,7309,20,218,248,314,3423,20,513,233,1179,3886
1799.225,1,345,28980,345,56,5230,56,28980,0,0,0,0,0
281.204,17,4,240,2,32,281203,32,120,2,32,281203,32,120
0.281,6,2,80,1,0,0,0,40,1,0,0,0,40
0.485,6,49,20382,27,1010,18,1380,15260,22,421,20,1923,5122
12.112,6,1898,1661452,1156,1382,10,1420,1627551,742,467,16,1883,33901
60.087,6,25,7103,12,156,5462,267,1272,13,589,5006,3426,5831
4.242,6,39,7269,20,218,223,314,3423,19,440,221,1152,3846
1737.852,2,25,800,25,8,72410,8,800,0,0,0,0,0
8.036,6,82,25034,43,550,191,1152,19333,39,459,205,1179,5701
1764.769,2,14,448,14,8,135751,8,448,0,0,0,0,0
147.236,17,12,4016,12,306,13385,308,4016,0,0,0,0,0
0.389,17,2,144,1,36,0,36,64,1,52,0,52,80
302.528,6,53,11625,29,299,10804,852,2483,24,453,435,1928,9142
0.11,17,2,152,2,48,110,48,152,0,0,0,0,0
38.492,6,51,10213,24,450,680,766,2865,27,312,1475,1460,7348
0.875,6,31,13362,17,511,54,1360,3279,14,1056,54,2561,10083
1771.535,1,60,5040,0,0,0,0,0,60,56,30026,56,5040
0.025,17,4,420,2,33,0,33,122,2,121,0,145,298
11.657,6,1822,1609983,1137,1363,10,1380,1578353,685,421,16,1923,31630
1.118,6,10,1687,7,100,186,100,384,3,1179,433,1179,1303
0.016,6,11,3285,6,80,3,80,400,5,872,3,1448,2885
1410.392,6,176,19430,92,79,15497,721,8282,84,228,16990,1414,11148
0.561,6,51,21520,28,951,20,1380,16367,23,467,23,1923,5153
2.79,17,3,468,3,128,1395,128,468,0,0,0,0,0
1741.009,6,105,7602,66,31,26784,31,4503,39,31,45815,31,3099
1792.409,17,180,14040,180,50,10013,50,14040,0,0,0,0,0
1765.518,17,227,89332,227,365,7812,376,89332,0,0,0,0,0
1786.552,6,102,8228,68,64,26664,64,4896,34,58,54135,58,3332
280.436,6,29,7392,13,158,23369,267,1317,16,678,18692,3456,6075
8.015,6,17,1446,9,275,1001,275,918,8,96,888,96,528
0.214,6,9,1002,5,213,53,213,417,4,421,52,421,585
11.95,6,14,2355,6,188,2390,245,620,8,703,1669,1152,1735
60.002,6,39,14834,18,214,3529,214,1890,21,1338,2601,1642,12944
226.498,17,4,352,2,60,226497,60,176,2,60,226496,60,176
0.04,17,4,284,2,32,0,32,120,2,54,36,60,164
0.833,6,25,5847,13,156,69,267,1462,12,780,69,1460,4385
0.131,17,2,390,1,48,0,48,76,1,286,0,286,314
7.072,17,39,12642,11,352,706,1350,4183,28,274,260,1350,8459
0.255,6,2,92,1,0,0,0,40,1,0,0,0,52
1770.576,6,99,9174,66,64,27239,64,5544,33,58,55327,58,3630
609.288,17,38,5703,38,122,16467,352,5703,0,0,0,0,0
0.152,6,9,1340,5,145,38,145,349,4,827,45,827,991
86.887,17,4,824,2,48,86879,48,152,2,308,86880,308,672
3.875,17,4,304,4,48,1291,48,304,0,0,0,0,0
35.548,6,32,5869,16,225,2369,722,2633,16,342,2341,1448,3236
0.297,6,27,7296,13,155,24,267,1301,14,603,20,2036,5995
61.221,6,13,1079,12,43,5565,43,1019,1,0,0,0,60
2.609,17,4,610,3,39,543,39,201,1,381,0,381,409
0.032,6,9,1928,5,666,7,666,934,4,778,10,778,994
23.349,6,27,7177,13,155,1945,267,1306,14,530,1795,3417,5871
0.123,17,2,298,1,40,0,40,68,1,202,0,202,230
31.924,17,4,352,2,60,31923,60,176,2,60,31923,60,176
1778.723,1,342,28728,342,56,5216,56,28728,0,0,0,0,0
1799.441,6,356,22520,208,69,8692,69,12460,148,69,12240,69,10060
0.004,6,4,520,3,162,2,293,480,1,0,0,0,40
1772.651,6,180,15480,120,69,14896,69,8940,60,69,30041,69,6540
0.309,6,26,9062,13,262,25,690,1759,13,1103,24,2816,7303
0.707,6,10,924,5,283,132,283,551,5,105,132,105,373
156.066,6,27,9412,14,542,82,1287,2254,13,828,12990,1791,7158
38.547,17,22,1936,11,48,3853,48,836,11,72,3853,72,1100
1741.389,6,87,6322,58,31,30550,31,3915,29,31,62190,31,2407
1799.711,17,142,11360,71,48,25710,48,5396,71,56,25710,56,5964
1.328,6,40,11338,21,616,66,1440,5802,19,433,64,1440,5536
1.701,6,15,3685,8,126,243,126,558,7,1373,283,1448,3127
2.444,17,10,3616,10,333,271,361,3616,0,0,0,0,0
1721.251,17,12,498,11,14,172125,14,462,1,8,0,8,36
33.812,6,32,5346,15,154,2415,722,1860,17,324,2101,1402,3486
1783.117,17,83,3480,82,14,22011,14,3444,1,8,0,8,36
3.818,17,3,264,3,60,1909,60,264,0,0,0,0,0
1.656,6,27,10173,16,284,110,584,1496,11,1029,148,1420,8677
8.976,6,3,180,3,0,0,0,180,0,0,0,0,0
0.326,6,27,8920,13,227,27,547,1592,14,941,23,1408,7328
0.037,17,2,554,1,30,0,30,58,1,468,0,468,496
15.548,6,2646,2482497,1713,1371,8,1408,2429317,933,931,16,2801,53180
1.414,6,24,6635,13,350,117,1088,2275,11,783,140,1420,4360
0.331,6,27,8914,13,231,27,563,1608,14,938,24,1438,7306
1795.517,6,357,22629,208,69,8673,69,12460,149,69,12131,69,10169
0.903,6,10,1687,7,100,150,100,384,3,1179,321,1179,1303
4.72,6,38,7229,20,218,248,314,3423,18,513,261,1179,3806
1710.487,17,12,498,11,14,171048,14,462,1,8,0,8,36
59.746,6,30,9196,7,155,913,267,1066,23,399,2715,1420,8130
12.572,6,1971,1739600,1223,1366,10,1380,1702466,748,468,16,3303,37134
1790.014,17,83,3480,82,14,22098,14,3444,1,8,0,8,36
0.054,17,2,230,1,40,0,40,68,1,134,0,134,162
5.061,6,23,6721,11,248,498,517,1587,12,750,452,2451,5134
0.115,6,9,1002,5,213,28,213,417,4,421,34,421,585
5.012,17,2,2166,2,1055,5012,1055,2166,0,0,0,0,0
12.367,17,9,739,5,47,3091,47,375,4,63,3089,63,364
280.392,6,29,7392,13,158,23366,267,1317,16,603,18682,1400,6075
110.069,17,4,352,2,48,110061,48,152,2,72,110061,72,200
1782.726,6,114,12137,75,80,24090,517,5900,39,126,46911,1420,6237
1780.306,17,140,11200,70,48,25801,48,5320,70,56,25801,56,5880
298.573,17,4,240,2,32,298572,32,120,2,32,298571,32,120
0.366,6,39,25287,21,292,18,392,2563,18,1361,20,2804,22724
0.328,17,4,820,2,36,323,36,128,2,318,323,318,692
281.689,6,30,7432,13,158,23474,267,1317,17,543,17581,1400,6115
0.958,6,10,1687,7,100,159,100,384,3,1179,349,1179,1303
3.95,17,3,222,3,46,1975,46,222,0,0,0,0,0
240.201,6,56,19786,30,802,8282,1402,16824,26,200,9607,580,2962
1768.614,1,67,5628,67,56,26797,56,5628,0,0,0,0,0
119.382,17,4,352,2,60,119381,60,176,2,60,119381,60,176
452.467,6,559,481105,363,1338,1249,1408,450034,196,508,2284,3847,31071
1793.641,6,357,22629,209,69,8623,69,12569,148,69,12201,69,10060
1796.42,6,332,26209,164,323,10920,515,11175,168,39,10757,76,15034
1.677,6,56,13922,27,533,64,1301,4844,29,416,59,1460,9078
1799.176,17,4602,220896,2301,20,782,20,110448,2301,20,782,20,110448
198.084,17,8,1856,8,204,28297,204,1856,0,0,0,0,0
0.85,6,21,5999,12,274,77,523,1307,9,721,94,1452,4692
126.774,17,4,352,2,60,126773,60,176,2,60,126773,60,176
140.208,6,48,10744,23,208,6373,876,3689,25,442,5841,1408,7055
1.227,6,25,8056,12,164,95,267,1288,13,869,84,1448,6768
27.303,1,32,3328,0,0,0,0,0,32,76,880,76,3328
8.05,6,1488,1354293,906,1415,8,1448,1319365,582,776,13,1448,34928
300.241,6,43,13280,23,840,13639,1360,7678,20,399,15793,1360,5602
70.243,17,4,352,2,60,70242,60,176,2,60,70242,60,176
0.009,17,2,144,1,36,0,36,64,1,52,0,52,80
1750.752,17,13,534,11,14,175056,14,462,2,8,1750525,8,72
1793.732,1,274,29044,274,78,6570,78,29044,0,0,0,0,0
1780.022,6,424,25501,211,69,8476,69,12649,213,34,8396,48,12852
190.42,6,8,466,4,106,63473,106,274,4,0,2358,0,192
0.003,17,2,167,1,39,0,39,67,1,72,0,72,100
0.002,6,2,80,1,0,0,0,40,1,0,0,0,40
0.158,17,4,288,2,36,129,36,128,2,52,130,52,160
34.657,17,22,1672,22,48,1650,48,1672,0,0,0,0,0
1.406,17,44,57437,43,1306,33,1472,57397,1,12,0,12,40
1.519,6,22,6935,9,141,189,275,646,13,720,90,1380,6289
0.223,6,23,5080,11,137,22,267,1132,12,577,19,1400,3948
1.116,6,25,8080,12,164,86,267,1312,13,869,79,1408,6768
0.903,17,4,368,2,64,901,64,184,2,64,902,64,184
1799.92,1,57,4788,57,56,32141,56,4788,0,0,0,0,0
1780.5,17,142,11360,71,48,25435,48,5396,71,56,25435,56,5964
0.0,17,4,352,2,37,0,37,130,2,83,0,89,222
12.72,6,1962,1751774,1216,1386,10,1432,1716078,746,389,16,1432,35696
1.26,6,50,19284,27,891,48,1460,13588,23,433,49,1460,5696
1785.125,17,142,11360,71,48,25501,48,5396,71,56,25501,56,5964
1786.524,6,102,8364,68,66,26664,66,4964,34,60,54134,60,3400
30.91,6,9,392,8,0,4415,0,348,1,0,0,0,44
0.055,17,4,308,2,38,0,38,132,2,60,15,66,176
29.181,6,44,8920,22,199,1389,722,2483,22,616,1379,1380,6437
280.323,6,29,7392,13,158,23360,267,1317,16,603,18682,1400,6075
1771.322,6,106,9604,66,65,27251,65,5577,40,59,45416,59,4027
1.339,6,14,4944,7,125,222,125,497,7,1018,221,1448,4447
1741.046,6,87,6322,58,31,30544,31,3915,29,31,62179,31,2407
8.711,6,34,8352,18,402,512,891,1958,16,522,568,3488,6394
1790.465,1,162,17172,162,78,11120,78,17172,0,0,0,0,0
0.005,17,2,479,1,41,0,41,69,1,382,0,382,410
1764.458,2,14,448,14,8,135727,8,448,0,0,0,0,0
3.136,6,14,3148,4,92,1045,92,296,10,387,324,1408,2852
1797.346,1,339,28476,339,56,5317,56,28476,0,0,0,0,0
251.615,6,30,7432,13,158,20967,267,1317,17,543,15723,1400,6115
1796.43,17,449,39928,404,35,4457,288,25708,45,288,40020,288,14220
1796.233,6,258,19152,155,69,11663,69,10409,103,69,17609,69,8743
0.473,17,15,7103,7,604,77,1350,4428,8,306,62,1350,2675
180.931,17,4,352,2,60,180930,60,176,2,60,180930,60,176
300.962,6,45,8896,24,278,13085,734,2141,21,393,448,1460,6755
1.641,6,14,2351,8,188,234,245,700,6,703,278,1152,1651
6.506,6,41,7349,21,218,325,314,3463,20,513,325,1179,3886
125.84,2,2,64,2,8,125840,8,64,0,0,0,0,0
365.713,6,18,1242,14,180,28131,180,916,4,110,20062,110,326
0.008,6,2,80,1,0,0,0,40,1,0,0,0,40
240.219,6,54,17988,29,798,8579,1408,15087,25,199,10008,580,2901
1781.268,17,142,11360,71,48,25446,48,5396,71,56,25446,56,5964
1773.828,1,59,4956,59,56,30583,56,4956,0,0,0,0,0
25.904,6,45,12975,22,186,1233,721,2559,23,791,1168,2840,10416
1776.553,1,164,9184,164,28,10899,28,9184,0,0,0,0,0
0.078,17,3,1552,3,489,39,517,1552,0,0,0,0,0
104.681,6,23,10242,12,433,94,990,1823,11,1138,10451,2568,8419
2.902,17,4,232,4,30,967,30,232,0,0,0,0,0
1.156,6,27,8120,15,222,70,540,1964,12,1132,89,3051,6156
240.305,6,47,9077,25,522,10012,1408,6024,22,190,11442,619,3053
265.034,17,4,240,2,32,265033,32,120,2,32,265033,32,120
31.549,6,7,308,1,0,0,0,44,6,0,6291,0,264
1.683,6,13,2311,8,188,240,245,700,5,1407,359,1407,1611
166.704,6,21,8782,11,333,66,692,1485,10,1147,18507,2568,7297
1788.09,6,353,22469,203,69,8851,69,12329,150,69,12000,69,10140
305.798,17,3,225,3,47,152899,47,225,0,0,0,0,0
280.191,6,25,7094,11,181,28019,267,1168,14,595,21551,1400,5926
7.522,6,46,8465,24,227,327,314,4142,22,491,345,1179,4323
0.057,17,2,216,1,34,0,34,62,1,126,0,126,154
21.808,17,4,240,2,32,21807,32,120,2,32,21807,32,120
0.562,6,3,180,2,0,497,0,128,1,0,0,0,52
0.268,17,24,7860,12,389,24,1350,5007,12,209,19,1350,2853
0.311,17,8,2774,8,318,44,357,2774,0,0,0,0,0
142.348,6,36,7994,12,155,32,267,1266,24,303,6188,1420,6728
38.778,6,43,8859,20,367,773,787,2030,23,346,1756,2720,6829
1743.952,1,7,392,7,28,290658,28,392,0,0,0,0,0
21.437,17,22,3116,11,48,2142,48,836,11,179,2142,308,2280
1787.207,17,87,3648,86,14,21025,14,3612,1,8,0,8,36
4.248,6,40,7309,21,218,212,314,3463,19,513,222,1179,3846
7.647,6,65,20086,33,562,238,1152,15379,32,489,238,1179,4707
1.374,6,50,20553,27,981,52,1460,14857,23,433,53,1460,5696
1773.83,6,188,18352,124,100,14421,469,11376,64,69,28149,69,6976
38.145,6,37,14606,21,480,1907,928,4283,16,805,2533,1360,10323
158.42,6,41,9687,22,542,7543,1368,7128,19,223,8798,580,2559
1789.145,6,356,22520,208,69,8643,69,12460,148,69,12171,69,10060
1744.587,6,140,8695,77,45,22955,208,5276,63,31,28135,31,3419
0.003,6,10,13540,1,0,0,0,40,9,1448,0,1448,13500
300.558,6,18,1227,5,177,75096,177,445,13,110,25031,110,782
1789.851,17,87,3648,86,14,21057,14,3612,1,8,0,8,36
1793.125,6,355,22480,207,69,8704,69,12420,148,69,12195,69,10060
1.547,6,54,18804,29,841,55,1360,12983,25,400,56,1360,5821
96.78,6,870,440006,489,839,198,1152,419975,381,435,253,1179,20031
18.627,17,4,352,2,60,18625,60,176,2,60,18625,60,176
1749.285,1,67,5628,0,0,0,0,0,67,56,26504,56,5628
0.201,17,2,152,1,48,0,48,76,1,48,0,48,76
4.961,6,37,7189,19,218,275,314,3383,18,513,274,1179,3806
3.984,6,14,3144,8,49,569,92,511,6,579,67,1448,2633
14.56,6,16,1327,8,222,2077,222,768,8,231,2077,231,559
277.804,6,571,736641,422,212,659,221,26660,149,4910,1876,15488,709981
2.952,17,4,624,4,128,984,128,624,0,0,0,0,0
18.327,17,4,240,2,32,18327,32,120,2,32,18326,32,120
1787.554,6,2054,2257855,908,129,1970,344,59976,1146,1992,1561,12762,2197879
5.0,17,4,288,2,36,5000,36,128,2,52,5000,52,160
1770.836,6,106,9760,69,64,26041,64,5840,37,58,49187,58,3920
37.469,17,22,1936,11,48,3745,48,836,11,72,3745,72,1100
352.496,6,20,7807,3,106,535,106,234,17,459,22025,1460,7573
1786.639,6,320,21287,189,69,9503,69,11907,131,69,13743,69,9380
31.016,6,40,9772,21,642,456,1360,4165,19,402,1712,2667,5607
61.808,6,76,52947,47,1207,1343,1448,44709,29,746,2199,1448,8238
1779.717,17,73,3060,72,14,25066,14,3024,1,8,0,8,36
1777.231,1,217,12152,217,28,8227,28,12152,0,0,0,0,0
280.442,6,29,7392,13,158,23370,267,1317,16,603,18693,2760,6075
240.246,6,53,18261,28,817,8897,1418,15360,25,199,10009,580,2901
1772.539,6,180,15480,120,69,14895,69,8940,60,69,30038,69,6540
0.424,6,12,1653,6,288,81,288,548,6,426,49,434,1105
5.681,6,41,7349,21,218,284,314,3463,20,513,284,1179,3886
8.031,1,12,1248,0,0,0,0,0,12,76,730,76,1248
58.634,1,4,224,4,28,19544,28,224,0,0,0,0,0
4.638,6,42,7389,21,218,231,314,3463,21,440,219,1152,3926
30.775,6,47,26817,22,771,1465,1460,6334,25,1145,1276,1460,20483
1799.353,17,449,39928,404,35,4464,288,25708,45,288,40017,288,14220
0.941,6,10,1687,7,100,156,100,384,3,1179,340,1179,1303
280.565,6,30,7432,13,158,23380,267,1317,17,543,17532,1400,6115
23.779,6,19,2041,11,65,2377,65,697,8,888,3265,888,1344
240.234,6,54,17981,29,794,8579,1418,15026,25,205,10009,580,2955
98.11,6,31,8912,14,158,7546,267,1357,17,687,6128,1781,7555
745.754,6,56,7623,28,111,16727,501,2575,28,156,27617,1420,5048
280.203,6,27,7312,13,158,23350,267,1317,14,775,21550,4836,5995
1754.614,17,12,498,11,14,175461,14,462,1,8,0,8,36
0.236,6,47,20939,26,1056,9,1420,15878,21,420,11,1420,5061
0.796,6,33,17698,16,708,53,1360,4214,17,1162,39,2167,13484
26.02,6,39,8438,18,171,1530,722,2094,21,550,1290,2760,6344
1775.11,1,105,5880,105,28,17068,28,5880,0,0,0,0,0
37.736,6,5047,4866622,3381,1363,11,1408,4775302,1666,776,22,1408,91320
15.759,6,37,7668,18,350,927,1152,4575,19,387,861,1152,3093
0.257,17,2,440,1,39,0,39,67,1,345,0,345,373
7.536,6,1130,1027919,731,1360,10,1432,1007635,399,428,18,1871,20284
5.095,6,12,3082,6,92,1019,92,412,6,2330,981,2330,2670
2.87,6,20,6464,9,141,358,275,646,11,767,110,1414,5818
366.429,6,25,1651,17,177,22901,177,1117,8,110,9160,110,534
1744.541,6,138,14960,84,67,21018,722,7039,54,116,32906,2026,7921
0.528,6,121,76748,63,1299,8,1432,70125,58,475,8,1871,6623
145.545,6,27,6849,15,181,10396,267,1344,12,836,2118,2045,5505
142.469,6,21,8134,11,520,86,1223,2034,10,948,15810,1631,6100
1790.645,1,342,28728,342,56,5251,56,28728,0,0,0,0,0
82.088,6,11,452,4,0,4047,0,164,7,0,13677,0,288
3.379,6,3,168,1,0,0,0,40,2,0,25,0,128
157.091,6,31,16897,15,651,50,1360,3248,16,1299,10464,2720,13649
380.192,1,10,560,10,28,42243,28,560,0,0,0,0,0
7.538,6,41,7642,22,224,358,314,3796,19,513,403,1179,3846
1761.81,6,102,15053,49,143,36704,517,3934,53,554,33879,2407,11119
0.242,6,4,1037,2,0,229,0,104,2,853,23,853,933
280.499,6,29,7392,13,158,23374,267,1317,16,603,18695,1400,6075
299.556,6,6,364,4,31,99852,31,222,2,31,299535,31,142
280.605,6,31,7563,13,158,23383,267,1317,18,502,16503,1400,6246
70.39,6,29,7395,13,155,5865,267,1306,16,453,4692,3417,6089
0.024,17,2,122,1,33,0,33,61,1,33,0,33,61
0.112,6,23,11089,13,150,9,288,1436,10,1520,11,2816,9653
2.358,6,5,288,2,0,2194,0,112,3,0,1097,0,176
1796.901,1,345,28980,345,56,5223,56,28980,0,0,0,0,0
1796.465,17,448,39896,403,35,4468,288,25676,45,288,40013,288,14220
1795.389,6,114,9150,74,66,24594,66,5270,40,60,46033,60,3880
0.029,17,2,672,2,308,29,308,672,0,0,0,0,0
1695.002,1,120,6720,120,28,14243,28,6720,0,0,0,0,0
241.023,6,78,56950,51,1214,4820,1368,48810,27,841,2379,2519,8140
1788.654,6,125,12404,79,62,22931,722,6510,46,92,39743,2026,5894
0.0,17,1,1396,1,1368,0,1368,1396,0,0,0,0,0
17.443,6,18,2450,8,210,2491,210,844,10,545,1933,904,1606
1793.674,17,144,11520,72,48,25262,48,5472,72,56,25262,56,6048
6.982,6,47,8489,25,227,290,314,4182,22,489,320,1179,4307
281.428,17,4,352,2,60,281427,60,176,2,60,281427,60,176
1787.338,6,104,8376,68,65,26676,65,4930,36,59,51064,59,3446
1.16,6,53,13982,25,553,48,1429,4944,28,439,42,1986,9038
1740.957,6,87,6322,58,31,30543,31,3915,29,31,62176,31,2407
135.351,6,31,7102,17,259,8459,593,2189,14,523,10411,1408,4913
3.985,17,8,1248,4,64,1324,64,368,4,192,1324,192,880
0.327,6,27,7296,13,155,27,267,1301,14,603,22,2036,5995
1773.318,6,180,15480,120,69,14901,69,8940,60,69,30048,69,6540
40.673,6,919,773000,537,1358,75,1368,745154,382,838,106,1368,27846
1680.408,1,14,812,14,30,129262,30,812,0,0,0,0,0
382.975,1,10,560,10,28,42552,28,560,0,0,0,0,0
89.138,6,23,9302,11,514,100,1237,2015,12,970,8086,1360,7287
28.176,6,32,7717,12,155,2561,267,1266,20,352,1482,1997,6451
13.58,6,24,6993,13,275,1131,275,1078,11,910,857,1440,5915
0.5,17,3,451,2,39,192,39,134,1,289,0,289,317
1682.869,17,14,1036,7,30,280469,30,406,7,62,280470,62,630
3.001,6,2,88,2,0,0,0,88,0,0,0,0,0
300.782,6,44,10171,22,590,14322,1440,4489,22,399,513,1440,5682
1680.861,1,15,840,15,28,120061,28,840,0,0,0,0,0
506.944,6,111,8880,64,126,8046,437,4959,47,92,11020,405,3921
13.239,6,8,440,5,0,3309,0,268,3,0,6275,0,172
9.039,2,3,96,3,8,4519,8,96,0,0,0,0,0
4.771,6,39,7269,20,218,251,314,3423,19,513,250,1179,3846
280.559,6,30,7432,13,158,23379,267,1317,17,543,17530,1400,6115
1769.848,6,99,9240,66,65,27228,65,5577,33,59,55304,59,3663
0.33,17,4,624,2,64,214,64,184,2,192,200,192,440
1743.014,6,99,7411,63,38,28113,205,4476,36,33,49793,98,2935
2.894,17,4,624,4,128,964,128,624,0,0,0,0,0
381.123,6,18,1242,14,180,29317,180,916,4,110,20061,110,326
65.13,6,44,13270,21,181,3256,267,2300,23,836,2959,2800,10970
1746.453,17,318,65602,318,178,5509,422,65602,0,0,0,0,0
1347.505,6,114,7221,59,50,23117,208,4215,55,31,24953,31,3006
0.01,17,2,200,1,42,0,42,70,1,102,0,102,130
0.063,17,2,588,1,39,0,39,67,1,493,0,493,521
1786.988,6,104,8444,68,66,26671,66,4964,36,60,51052,60,3480
1787.853,6,356,22520,208,69,8636,69,12460,148,69,12162,69,10060
1774.24,6,180,15480,120,69,14909,69,8940,60,69,30065,69,6540
1751.879,6,103,7755,67,38,26543,205,4715,36,33,50003,98,3040
1794.437,6,104,8441,69,65,26388,65,5035,35,59,52774,59,3406
0.377,6,14,1733,7,288,58,288,588,7,284,35,434,1145
0.242,17,2,212,1,46,0,46,74,1,110,0,110,138
110.411,6,14122,13310853,9259,1358,11,1408,13053289,4863,931,22,2801,257564
2.313,17,3,1170,3,362,1156,362,1170,0,0,0,0,0
1772.933,6,184,15916,120,69,14898,69,8940,64,69,28139,69,6976
1780.339,17,44,14784,44,308,41403,308,14784,0,0,0,0,0
280.283,6,29,7392,13,158,23356,267,1317,16,603,18682,2036,6075
9.385,6,2001,1890605,1267,1415,7,1448,1847773,734,776,12,1448,42832
198.01,6,34,4525,17,304,12375,304,3020,17,83,12002,83,1505
42.476,17,6,1236,3,48,21232,48,228,3,308,21228,308,1008
0.037,17,2,389,1,34,0,34,62,1,299,0,299,327
1789.233,17,83,3480,82,14,22089,14,3444,1,8,0,8,36
29.28,6,9,376,6,0,5856,0,244,3,0,1565,0,132
1795.491,1,230,12880,230,28,7840,28,12880,0,0,0,0,0
0.24,17,2,152,1,48,0,48,76,1,48,0,48,76
768.005,6,10,1435,10,103,85333,138,1435,0,0,0,0,0
1799.24,6,356,22520,208,69,8691,69,12460,148,69,12239,69,10060
126.249,6,21,10132,11,433,78,990,1783,10,1322,14012,2568,8349
1798.703,1,136,14416,136,78,13323,78,14416,0,0,0,0,0
1771.354,6,101,9344,66,65,27251,65,5577,35,59,52096,59,3767
192.28,6,22,6456,7,154,32046,267,752,15,566,13731,1452,5704
0.113,6,9,1002,5,213,28,213,417,4,421,30,421,585
3.545,6,2,88,2,0,0,0,88,0,0,0,0,0
638.365,17,47,3740,26,48,25534,48,1976,21,56,26783,56,1764
1.01,6,3,160,2,0,942,0,120,1,0,0,0,40
257.348,6,28,6961,13,229,161,498,1672,15,390,18375,1420,5289
0.079,17,2,138,1,33,0,33,61,1,49,0,49,77
0.212,6,46,22453,27,1091,8,1420,17472,19,467,11,1883,4981
0.145,6,9,1002,5,213,36,213,417,4,421,45,421,585
6.672,6,2,104,2,0,0,0,104,0,0,0,0,0
8.989,6,76,24245,39,550,236,1152,18624,37,459,241,1179,5621
11.692,6,1943,1630283,1147,1363,10,1380,1592249,796,383,14,1380,38034
930.81,17,10,821,5,31,232698,37,297,5,76,232698,136,524
5.34,6,41,7349,21,218,267,314,3463,20,440,266,1152,3886
0.659,6,104,87479,58,131,11,232,2849,46,2019,14,6800,84630
0.129,17,4,1379,4,316,43,355,1379,0,0,0,0,0
1.303,6,53,21653,29,920,46,1360,15917,24,433,48,1360,5736
8.503,6,30,7914,14,209,654,721,1821,16,681,553,2840,6093
394.336,6,78,11651,38,309,10657,1111,6016,40,197,10111,1132,5635
5.038,17,4,488,4,94,1679,94,488,0,0,0,0,0
1794.975,1,60,5040,60,56,30423,56,5040,0,0,0,0,0
0.069,1,2,163,2,53,69,78,163,0,0,0,0,0
0.151,6,46,21137,26,1075,6,1420,16116,20,467,7,1883,5021
1769.625,6,122,7352,66,26,27224,26,3936,56,26,32174,26,3416
7.311,6,68,20558,34,554,221,1152,15771,34,427,213,1152,4787
1784.681,6,102,8228,68,64,26637,64,4896,34,58,54078,58,3332
0.494,6,7,295,4,0,164,0,164,3,7,111,7,131
1682.749,1,88,4928,88,28,19341,28,4928,0,0,0,0,0
5.172,17,3,208,2,36,4998,36,128,1,52,0,52,80
59.081,1,5,520,0,0,0,0,0,5,76,14770,76,520
82.535,17,4,240,2,32,82534,32,120,2,32,82534,32,120
1799.092,1,182,10192,182,28,9939,28,10192,0,0,0,0,0
184.365,6,9,514,3,106,92176,106,234,6,0,36870,0,280
0.558,6,14,1733,7,288,89,288,588,7,284,48,434,1145
277.2,6,55,9699,26,105,11088,267,2309,29,248,9894,1452,7390
11.789,6,2125,1979005,1362,1377,8,1408,1934665,763,931,15,2801,44340
64.047,6,63,35678,34,666,1939,1368,6538,29,1381,2284,4133,29140
0.758,6,24,5569,12,140,68,267,1184,12,650,63,1420,4385
140.856,6,78,56763,50,1237,2874,1448,48402,28,963,2458,2896,8361
2.211,17,27,12908,13,677,184,1350,9170,14,239,121,1350,3738
0.053,17,4,352,2,37,0,37,130,2,83,9,89,222
0.004,6,2,87,1,0,0,0,40,1,7,0,7,47
3.98,17,8,1294,4,64,1323,64,368,4,203,1323,238,926
282.199,6,32,7853,14,158,21707,267,1357,18,524,16588,1400,6496
1763.727,2,15,480,15,8,125980,8,480,0,0,0,0,0
34.335,17,20,1520,20,48,1807,48,1520,0,0,0,0,0
280.243,6,29,7392,13,158,23353,267,1317,16,603,18680,1400,6075
0.499,17,21,14938,12,1000,45,1350,12341,9,260,57,1350,2597
49.715,6,481,218940,250,812,199,1152,204179,231,424,215,1179,14761
0.108,17,4,820,2,36,98,36,128,2,318,97,318,692
240.344,6,43,8892,21,517,12016,1418,5758,22,220,11444,640,3134
0.746,6,13,6266,7,142,94,142,426,6,1399,113,1420,5840
1787.621,6,102,8364,68,66,26680,66,4964,34,60,54166,60,3400
1773.029,6,183,15669,121,69,14775,69,9049,62,69,29061,69,6620
1786.753,17,87,3648,86,14,21020,14,3612,1,8,0,8,36
1783.571,17,83,3480,82,14,22019,14,3444,1,8,0,8,36
0.013,17,2,251,1,31,0,31,59,1,164,0,164,192
53.586,6,13,1079,12,43,4871,43,1019,1,0,0,0,60
1798.949,6,356,22520,208,69,8690,69,12460,148,69,12237,69,10060
142.275,6,123,87106,71,1315,2032,1448,76060,52,630,1417,1448,11046
1794.294,17,83,3480,82,14,22151,14,3444,1,8,0,8,36
33.886,6,32,5156,16,154,2245,721,1922,16,399,2245,1368,3234
93.545,6,23,6743,6,223,18709,417,941,17,365,1419,1460,5802
1783.131,17,83,3480,82,14,22013,14,3444,1,8,0,8,36
1787.08,17,140,11200,70,48,25899,48,5320,70,56,25899,56,5880
10.388,6,1312,1161237,788,1421,13,1432,1132973,524,389,19,1432,28264
511.651,17,6,528,3,60,255825,60,264,3,60,255825,60,264
82.835,6,102,75602,64,1268,1314,1408,65488,38,677,2233,1408,10114
299.49,6,15,848,8,31,42784,31,413,7,31,49912,31,435
180.461,2,2,64,2,8,180461,8,64,0,0,0,0,0
1796.691,17,448,39896,403,35,4469,288,25676,45,288,40024,288,14220
0.025,17,2,322,1,36,0,36,64,1,230,0,230,258
5.022,6,38,7229,20,218,264,314,3423,18,513,278,1179,3806
1770.694,6,79,4198,40,26,45400,26,2132,39,26,46595,26,2066
0.096,17,2,152,1,48,0,48,76,1,48,0,48,76
280.455,6,28,7352,13,158,23371,267,1317,15,775,20030,4836,6035
11.953,6,1747,1627055,1148,1365,10,1432,1598804,599,475,19,1871,28251
31.149,6,30,7432,13,158,2595,267,1317,17,603,1943,2760,6115
1739.637,6,125,7971,71,47,24851,208,4850,54,31,32818,31,3121
36.467,17,20,1760,10,48,4050,48,760,10,72,4050,72,1000
12.334,6,1992,1704943,1204,1362,10,1380,1667258,788,558,15,1923,37685
15.439,17,13,6673,7,613,2567,1350,4488,6,336,3081,1350,2185
1108.285,6,150,17265,84,112,13351,722,8881,66,89,17047,2328,8384
216.176,17,4,240,2,32,216175,32,120,2,32,216175,32,120
187.751,17,4,352,2,60,187750,60,176,2,60,187750,60,176
0.314,6,21,5000,10,137,34,267,1092,11,692,30,1467,3908
0.21,17,4,859,2,37,200,37,130,2,336,200,348,729
19.509,6,21,4553,10,264,2167,722,1572,11,793,1907,1448,2981
0.02,6,13,3980,7,88,3,88,388,6,1670,4,2920,3592
228.867,17,12,1056,6,48,45771,48,456,6,72,45771,72,600
0.064,17,2,192,1,60,0,60,88,1,76,0,76,104
5.004,17,4,288,2,36,5004,36,128,2,52,5003,52,160
186.261,6,80,55647,50,1209,3801,1368,47351,30,841,2137,2519,8296
9.076,17,4,3100,4,747,3025,1451,3100,0,0,0,0,0
315.967,6,111,21762,50,290,6448,1360,10559,61,203,5263,2720,11203
1781.425,17,142,11360,71,48,25448,48,5396,71,56,25448,56,5964
280.127,17,4,240,2,32,280126,32,120,2,32,280126,32,120
0.2,17,2,679,2,311,200,331,679,0,0,0,0,0
1750.953,17,12,498,11,14,175095,14,462,1,8,0,8,36
309.286,6,27,5492,14,298,23791,1382,2353,13,373,25772,1414,3139
0.669,17,2,195,1,44,0,44,72,1,95,0,95,123
1778.098,17,79,3312,78,14,23092,14,3276,1,8,0,8,36
1772.334,6,181,15589,120,69,14893,69,8940,61,69,29531,69,6649
1685.412,1,7,392,7,28,280902,28,392,0,0,0,0,0
1739.068,6,87,6322,58,31,30509,31,3915,29,31,62108,31,2407
755.856,2,7,224,7,8,125976,8,224,0,0,0,0,0
1740.621,6,87,6322,58,31,30537,31,3915,29,31,62164,31,2407
1793.824,1,58,4872,58,56,31470,56,4872,0,0,0,0,0
12.65,6,10,636,4,106,4216,106,274,6,90,2499,90,362
1775.16,6,180,15480,120,69,14917,69,8940,60,69,30080,69,6540
30.41,17,4,352,2,60,30408,60,176,2,60,30409,60,176
1795.312,17,447,39864,402,35,4477,288,25644,45,288,40017,288,14220
1740.919,6,87,6322,58,31,30542,31,3915,29,31,62175,31,2407
0.367,6,12,1653,6,288,68,288,548,6,426,42,434,1105
11.792,6,1745,1616531,1141,1364,10,1432,1588068,604,427,19,1432,28463
12.731,6,2094,1958876,1321,1404,9,1448,1914016,773,776,16,1448,44860
1797.706,1,58,4872,58,56,31538,56,4872,0,0,0,0,0
1.793,6,13,2311,8,188,256,245,700,5,1407,385,1407,1611
134.612,6,22,8512,11,314,68,634,1415,11,949,13448,1440,7097
1783.386,17,142,11360,71,48,25476,48,5396,71,56,25476,56,5964
9.818,6,1751,1627311,1076,1432,8,1448,1587091,675,776,14,1448,40220
0.056,6,7,423,4,43,4,43,259,3,0,26,0,164
64.381,6,15,612,7,0,8001,0,284,8,0,9195,0,328
0.037,17,2,152,1,48,0,48,76,1,48,0,48,76
0.198,6,3,160,2,0,198,0,100,1,0,0,0,60
97.509,17,4,352,2,60,97507,60,176,2,60,97508,60,176
9.657,6,14,2257,7,211,1608,211,806,7,545,1600,904,1451
0.157,6,9,1340,5,145,39,145,349,4,827,50,827,991
1764.637,2,14,448,14,8,135741,8,448,0,0,0,0,0
1264.146,6,120,15706,68,304,18867,304,10820,52,83,24787,83,4886
1.191,6,24,8004,12,164,92,267,1288,12,1014,92,2804,6716
0.089,17,2,136,1,32,0,32,60,1,48,0,48,76
0.7,17,8,2750,8,315,100,354,2750,0,0,0,0,0
1777.499,6,106,8446,68,64,26529,64,4896,38,58,48038,58,3550
0.025,17,2,116,1,30,0,30,58,1,30,0,30,58
0.655,6,22,5960,12,108,59,147,919,10,1159,64,2600,5041
296.875,1,12,1272,12,78,26988,78,1272,0,0,0,0,0
0.047,17,2,317,1,43,0,43,71,1,218,0,218,246
0.483,6,12,1653,6,288,92,288,548,6,426,55,434,1105
20.27,6,23,5534,13,107,1689,159,1126,10,967,2247,1709,4408
38.387,17,22,1936,11,48,3831,48,836,11,72,3835,72,1100
11.884,6,1738,1622119,1145,1365,10,1432,1594108,593,475,20,1871,28011
1.465,6,2,80,1,0,0,0,40,1,0,0,0,40
299.543,6,6,364,4,31,99847,31,222,2,31,299523,31,142
1797.53,1,345,28980,345,56,5225,56,28980,0,0,0,0,0
1777.951,17,140,11200,70,48,25767,48,5320,70,56,25767,56,5880
55.243,17,3,228,3,48,27621,48,228,0,0,0,0,0
4.165,6,34,6169,17,206,260,314,2744,17,548,242,1179,3425
546.983,1,3,168,3,28,273491,28,168,0,0,0,0,0
4.384,6,33,6129,18,206,257,314,2784,15,548,293,1179,3345
1786.576,17,87,3648,86,14,21018,14,3612,1,8,0,8,36
5.016,17,4,288,2,36,5002,36,128,2,52,5001,52,160
1781.76,6,363,24883,211,94,8457,469,14387,152,69,11799,69,10496
4.626,6,40,7309,20,218,243,314,3423,20,440,230,1152,3886
0.079,6,9,1340,5,145,19,145,349,4,827,19,827,991
240.2,6,53,17351,28,768,8896,1408,14526,25,189,10008,580,2825
0.66,6,24,8189,13,150,54,374,1275,11,1078,65,2828,6914
1789.963,6,378,23952,216,69,8325,69,13332,162,69,11117,69,10620
1739.802,6,87,6322,58,31,30522,31,3915,29,31,62135,31,2407
140.013,17,8,2688,8,308,20001,308,2688,0,0,0,0,0
0.126,6,12,3702,6,170,18,170,490,6,964,24,1448,3212
39.58,6,5161,4887307,3393,1362,11,1408,4790695,1768,931,22,2816,96612
139.838,17,6,528,3,60,69918,60,264,3,60,69918,60,264
12.199,6,45,9804,24,450,530,766,2805,21,384,499,1360,6999
14.953,6,807,737781,516,1356,28,1368,716093,291,776,50,1473,21688
16.019,6,28,10959,15,751,1144,1360,3661,13,966,1324,1723,7298
0.073,17,2,167,1,39,0,39,67,1,72,0,72,100
1773.95,6,180,15480,120,69,14907,69,8940,60,69,30060,69,6540
167.74,6,36,8354,14,158,12903,267,1357,22,509,7977,1400,6997
1784.614,17,112,37632,112,308,16077,308,37632,0,0,0,0,0
1793.965,17,86,3606,85,14,21356,14,3570,1,8,0,8,36
68.411,17,6,360,3,32,34205,32,180,3,32,34205,32,180
217.193,6,18,5839,10,784,24132,1360,3538,8,247,30990,272,2301
8.602,6,17,2422,9,210,1075,210,920,8,545,1228,904,1502
1774.626,6,180,15480,120,69,14912,69,8940,60,69,30075,69,6540
6.767,6,9,4218,4,183,2156,267,531,5,1161,1627,1179,3687
1773.335,6,180,15480,120,69,14901,69,8940,60,69,30053,69,6540
20.395,6,20,2631,11,189,2039,517,1362,9,264,2548,499,1269
280.513,6,29,7392,13,158,23376,267,1317,16,543,18698,1380,6075
1785.85,6,364,25392,212,100,8463,469,14896,152,69,11826,69,10496
1798.982,1,57,4788,57,56,32124,56,4788,0,0,0,0,0
280.184,6,26,7272,12,158,25471,267,1277,14,775,21550,3445,5995
1791.446,6,360,22818,210,69,8571,69,12678,150,69,12022,69,10140
1798.095,17,448,39896,403,35,4472,288,25676,45,288,40018,288,14220
1799.556,6,124,8254,70,56,26077,208,5164,54,31,33950,31,3090
1.868,6,2,100,1,0,0,0,60,1,0,0,0,40
1780.805,17,142,11360,71,48,25439,48,5396,71,56,25439,56,5964
1.446,6,40,11339,21,616,72,1460,5803,19,433,70,1460,5536
0.033,17,2,158,1,34,0,34,62,1,68,0,68,96
0.014,17,2,330,1,30,0,30,58,1,244,0,244,272
1.292,6,41,10025,23,440,58,1360,4484,18,480,65,4075,5541
59.831,6,14,1847,7,100,9971,100,384,7,1179,9928,1179,1463
2.211,17,2,154,1,33,0,33,61,1,65,0,65,93
9.011,6,1592,1353301,882,1438,9,1448,1303021,710,776,12,1448,50280
3.663,6,168,72319,84,340,44,340,6772,84,764,43,1368,65547
1684.515,2,20,640,20,8,88658,8,640,0,0,0,0,0
755.751,2,6,192,6,8,151150,8,192,0,0,0,0,0
25.141,1,6,336,6,28,5028,28,336,0,0,0,0,0
1.882,17,3,174,3,30,941,30,174,0,0,0,0,0
1772.331,6,180,15480,120,69,14893,69,8940,60,69,30036,69,6540
1.891,17,6,936,3,64,937,64,276,3,192,938,192,660
882.476,6,73,11274,46,97,19610,502,3702,27,270,33937,1420,7572
8.148,6,1850,1698596,1164,1380,6,1408,1658260,686,931,11,2801,40336
291.023,17,4,240,2,32,291022,32,120,2,32,291021,32,120
313.359,17,9,3024,9,308,39169,308,3024,0,0,0,0,0
0.545,6,27,8998,13,248,45,631,1688,14,939,38,1368,7310
1792.925,1,339,28476,339,56,5304,56,28476,0,0,0,0,0
28.988,6,44,8916,20,410,467,882,2110,24,364,1254,1440,6806
41.541,17,22,1672,22,48,1978,48,1672,0,0,0,0,0
52.942,17,9,684,9,48,6617,48,684,0,0,0,0,0
1513.96,1,56,3136,56,28,27526,28,3136,0,0,0,0,0
233.107,6,59,10094,30,124,8038,267,3071,29,308,8317,1917,7023
1780.191,6,310,26777,180,75,9945,267,12264,130,136,13799,2006,14513
4.272,6,571,583993,301,329,14,338,18332,270,2113,15,8208,565661
227.221,17,4,352,2,60,227220,60,176,2,60,227220,60,176
1.897,6,9,527,5,43,474,43,311,4,0,597,0,216
409.242,1,44,4576,0,0,0,0,0,44,76,9517,76,4576
1781.213,17,142,11360,71,48,25445,48,5396,71,56,25445,56,5964
0.059,17,2,904,1,300,0,300,328,1,548,0,548,576
0.168,6,47,21803,27,1043,6,1420,16782,20,420,8,1420,5021
1.501,6,41,10061,23,440,68,1360,4520,18,437,75,2715,5541
79.328,6,41,8576,20,367,615,787,1982,21,522,3960,2720,6594
0.058,1,2,112,2,28,58,28,112,0,0,0,0,0
1775.504,6,179,15371,119,69,15046,69,8831,60,69,29579,69,6540
8.232,6,77,24285,40,550,211,1152,18664,37,459,221,1179,5621
1.371,6,50,18767,27,854,52,1360,13071,23,433,54,1360,5696
1787.511,6,102,8296,68,65,26679,65,4930,34,59,54163,59,3366
280.056,6,31,7472,14,158,21542,267,1357,17,543,17499,1400,6115
861.103,6,563,100592,367,304,2352,304,75380,196,83,4412,83,25212
2.994,6,3,180,3,0,0,0,180,0,0,0,0,0
1796.568,6,373,26428,216,104,8356,469,15663,157,69,11513,69,10765
0.273,6,20,7183,11,271,26,517,1666,9,1008,33,1691,5517
252.864,2,3,96,3,8,126432,8,96,0,0,0,0,0
23.683,6,15,2042,8,192,3383,192,556,7,398,3913,419,1486
95.528,6,48,11807,17,263,5970,1189,2799,31,323,3183,1420,9008
27.874,17,890,1040772,140,79,200,1350,15119,750,1339,37,1350,1025653
167.076,6,28,15243,15,648,43,1360,3224,13,1641,13912,3582,12019
1.474,6,33,11174,17,412,92,1440,3598,16,989,86,1440,7576
21.988,6,9,527,5,43,5497,43,311,4,0,7293,0,216
0.235,17,2,152,1,48,0,48,76,1,48,0,48,76
63.912,6,14,1067,7,177,10652,177,585,7,110,10364,110,482
1798.706,6,292,36523,120,150,15114,1360,18527,172,132,10517,1360,17996
240.361,6,46,8551,24,449,10450,1402,5752,22,205,11445,580,2799
7.476,6,32,8098,16,191,498,721,1985,16,607,393,1414,6113
1472.847,6,150,12900,100,69,14877,69,7450,50,69,30048,69,5450
1796.967,17,448,39896,403,35,4470,288,25676,45,288,40019,288,14220
1744.804,6,112,8433,68,38,26041,205,4829,44,32,40570,98,3604
0.033,17,3,244,2,32,9,32,120,1,96,0,96,124
180.248,6,23,8902,11,549,215,1360,2657,12,958,16371,1360,6245
1787.455,17,87,3648,86,14,21028,14,3612,1,8,0,8,36
888.484,1,30,2520,0,0,0,0,0,30,56,30637,56,2520
0.089,17,2,602,1,46,0,46,74,1,500,0,500,528
2.219,6,13,2311,8,188,317,245,700,5,1407,491,1407,1611
10.083,6,1672,1586774,1083,1389,9,1408,1551458,589,776,16,1408,35316
1314.109,17,116,10351,106,30,12515,37,6183,10,388,139486,463,4168
1794.981,17,288,50531,288,147,6254,385,50531,0,0,0,0,0
159.836,17,4,240,2,32,159834,32,120,2,32,159831,32,120
258.389,17,4,352,2,60,258387,60,176,2,60,258388,60,176
161.358,6,41,8607,15,123,11524,267,1593,26,298,6453,1420,7014
1776.227,17,140,11200,70,48,25742,48,5320,70,56,25742,56,5880
5.529,6,40,7309,21,218,276,314,3463,19,513,293,1179,3846
1.042,2,2,64,2,8,1042,8,64,0,0,0,0,0
126.193,6,25,6288,10,272,105,516,1220,15,372,9006,1452,5068
104.973,6,47,10198,19,290,1901,1189,2812,28,297,3887,1460,7386
0.004,6,2,104,2,0,0,0,104,0,0,0,0,0
16.702,17,13,1664,9,71,2087,288,896,4,164,562,288,768
1770.209,6,214,17130,79,77,22692,354,8399,135,49,13210,143,8731
0.031,17,4,284,2,32,13,32,120,2,54,20,60,164
131.74,6,184,147749,85,89,1568,517,6757,99,1509,1343,2736,140992
1741.058,6,87,6322,58,31,30544,31,3915,29,31,62179,31,2407
11.821,6,25,8473,13,275,985,275,1078,12,986,864,1440,7395
0.061,17,2,912,1,308,0,308,336,1,548,0,548,576
280.543,6,27,7312,13,158,23378,267,1317,14,678,21570,2800,5995
1786.721,6,102,8296,68,65,26667,65,4930,34,59,54140,59,3366
1775.768,1,68,5712,68,56,26504,56,5712,0,0,0,0,0
1779.638,1,78,6552,78,56,23112,56,6552,0,0,0,0,0
0.17,17,4,284,2,32,82,32,120,2,54,158,60,164
13.542,6,28,8552,9,146,1427,267,1098,19,557,751,1452,7454
8.985,6,36,8275,18,346,528,731,1791,18,442,515,1460,6484
0.602,6,20,7196,13,325,50,626,1984,7,1210,94,1946,5212
1784.58,6,366,25679,212,99,8457,469,15034,154,69,11663,69,10645
121.425,17,8,2688,8,308,17346,308,2688,0,0,0,0,0
174.631,6,17,2471,6,188,559,245,620,11,1407,17438,1407,1851
1795.72,17,140,11200,70,48,26024,48,5320,70,56,26024,56,5880
7.398,6,16,2649,7,152,248,267,742,9,257,892,1152,1907
294.747,1,4,224,4,28,98249,28,224,0,0,0,0,0
0.205,17,8,2758,8,316,29,355,2758,0,0,0,0,0
2.0,17,3,468,3,128,1000,128,468,0,0,0,0,0
0.132,17,4,284,2,32,0,32,120,2,54,84,60,164
1779.934,6,354,22440,207,69,8640,69,12420,147,69,12191,69,10020
38.751,17,11,836,11,48,3875,48,836,0,0,0,0,0
58.98,6,11,1727,5,100,600,100,304,6,1179,11744,1179,1423
6.237,17,28,10506,12,480,567,1350,6106,16,247,223,1350,4400
0.292,6,26,6066,13,164,24,453,1494,13,555,23,1542,4572
1796.426,17,448,39896,403,35,4468,288,25676,45,288,40014,288,14220
840.692,17,8,2196,4,30,280227,30,232,4,463,280226,463,1964
1751.818,1,8,448,8,28,250259,28,448,0,0,0,0,0
0.187,6,29,7376,15,155,13,267,1381,14,603,13,2036,5995
0.562,6,2,421,1,0,0,0,40,1,341,0,341,381
1.07,6,6,340,3,0,535,0,160,3,0,386,0,180
1680.514,17,12,498,11,14,168051,14,462,1,8,0,8,36
31.466,6,2167,1872639,1309,1373,24,1380,1827421,858,515,36,1923,45218
42.346,17,4,824,2,48,42326,48,152,2,308,42332,308,672
1773.947,1,58,4872,58,56,31121,56,4872,0,0,0,0,0
1729.751,17,21,8535,21,378,86487,1451,8535,0,0,0,0,0
4.909,6,39,14699,20,546,258,1440,4166,19,886,252,1440,10533
5.804,6,28,6135,15,338,414,1314,2294,13,414,482,1420,3841
0.104,6,10,1671,6,552,20,948,1348,4,159,34,159,323
280.482,6,28,7352,13,158,23373,267,1317,15,678,20031,3456,6035
5.646,6,38,7229,20,218,297,314,3423,18,513,316,1179,3806
11.881,6,1886,1642050,1143,1382,10,1420,1608097,743,467,16,1883,33953
0.777,6,24,6208,13,264,64,662,1848,11,979,76,1737,4360
1745.354,6,94,7151,62,38,28612,205,4424,32,33,56290,98,2727
32.81,17,18,1584,9,48,4099,48,684,9,72,4099,72,900
0.051,17,4,352,2,37,1,37,130,2,83,9,89,222
1797.204,17,448,39896,403,35,4470,288,25676,45,288,40017,288,14220
1741.712,6,87,6322,58,31,30556,31,3915,29,31,62203,31,2407
246.173,6,44,6303,20,128,12947,722,2331,24,195,10695,1408,3972
29.767,17,4,240,2,32,29766,32,120,2,32,29766,32,120
470.465,17,121,13301,53,147,8970,1350,9304,68,30,7017,60,3997
0.108,6,9,1346,5,145,27,145,349,4,833,31,833,997
227.368,1,6,336,6,28,45473,28,336,0,0,0,0,0
54.575,6,36,8031,18,449,3209,1418,5440,18,205,3209,580,2591
0.5,6,2,80,0,0,0,0,0,2,0,0,0,80
100.26,6,30,7555,9,155,465,267,1146,21,347,5012,1460,6409
997.98,1,25,2832,25,85,41582,320,2832,0,0,0,0,0
29.333,6,4376,4118047,2849,1367,10,1408,4033979,1527,931,19,2816,84068
300.349,6,31,11820,18,592,17667,1402,4497,13,948,20024,2804,7323
58.197,6,19,5977,12,166,5290,504,1480,7,842,137,1420,4497
0.067,17,4,284,2,32,55,32,120,2,54,15,60,164
240.177,6,46,9406,23,209,10916,834,2692,23,500,10916,1408,6714
240.305,6,43,8907,21,524,12014,1418,5819,22,215,11442,618,3088
6.319,6,44,8369,21,227,315,314,4022,23,489,257,1179,4347
1.683,6,49,19228,29,883,60,1360,13607,20,437,77,2715,5621
1.065,17,4,396,2,39,1064,39,134,2,103,1052,103,262
9.811,6,15,4203,6,272,1962,516,1060,9,555,1204,1452,3143
264.217,6,20,4594,8,272,469,516,1140,12,330,23981,1452,3454
1780.555,6,104,8332,68,64,26575,65,4908,36,58,50870,59,3424
280.352,6,28,7352,12,158,25486,267,1277,16,603,18684,1400,6075
0.611,17,2,144,1,36,0,36,64,1,52,0,52,80
0.0,6,2,80,1,0,0,0,40,1,0,0,0,40
9.013,17,2,152,2,48,9013,48,152,0,0,0,0,0
9.028,6,10,2946,5,92,2257,92,348,5,2330,2210,2330,2598
1774.186,6,180,15480,120,69,14909,69,8940,60,69,30065,69,6540
20.138,6,21,5418,12,107,1830,159,1074,9,773,2516,1418,4344
1758.03,1,177,9912,177,28,9988,28,9912,0,0,0,0,0
21.528,17,34,14747,16,657,1434,1350,10965,18,182,1264,1350,3782
11.546,17,6,528,3,60,5772,60,264,3,60,5772,60,264
202.58,6,60,12699,27,239,7791,469,4684,33,257,6330,1460,8015
2.151,6,13,2311,8,188,307,245,700,5,1407,467,1407,1611
0.168,6,10,1510,5,657,42,657,925,5,317,41,317,585
99.349,17,4,352,2,60,99347,60,176,2,60,99348,60,176
280.364,6,30,7432,13,158,23363,267,1317,17,543,17521,1400,6115
0.938,6,10,1687,7,100,156,100,384,3,1179,340,1179,1303
3.263,17,3,204,3,40,1631,40,204,0,0,0,0,0
1667.134,1,7,392,7,28,277855,28,392,0,0,0,0,0
1791.421,17,1209,842847,382,234,4701,1350,100397,827,869,2168,1350,742450
1740.616,17,29,6815,29,207,62164,207,6815,0,0,0,0,0
0.024,17,4,284,2,32,18,32,120,2,54,14,60,164
11.409,6,1802,1576788,1091,1391,10,1420,1544127,711,526,16,3303,32661
1782.234,6,374,23723,214,69,8367,69,13183,160,69,11208,69,10540
0.946,17,22,13880,13,849,78,1350,11409,9,246,114,1350,2471
4.574,6,39,7285,19,218,254,314,3383,20,516,226,1179,3902
1621.812,1,18,1581,18,59,95400,88,1581,0,0,0,0,0
189.864,6,31,7472,14,158,14604,267,1357,17,543,11864,1400,6115
1794.781,1,272,28832,272,78,6622,78,28832,0,0,0,0,0
1738.382,6,87,6322,58,31,30497,31,3915,29,31,62084,31,2407
212.128,6,51,9109,26,111,8485,267,2384,25,317,8836,1420,6725
0.158,6,44,20115,26,1008,6,1420,15174,18,467,8,1883,4941
0.288,17,2,1358,2,651,288,651,1358,0,0,0,0,0
1596.762,17,399,35488,359,35,4460,288,22848,40,288,40015,288,12640
54.588,17,4,240,2,32,54587,32,120,2,32,54587,32,120
76.073,6,34,6505,17,286,4754,1314,2405,17,284,591,1460,4100
5.015,17,4,288,2,36,5003,36,128,2,52,5006,52,160
1.97,6,12,1840,7,279,328,279,918,5,218,428,272,922
41.672,6,45,8881,21,360,755,766,2013,24,327,1806,1460,6868
93.668,17,8,640,8,52,13381,52,640,0,0,0,0,0
0.558,6,24,7461,14,334,42,663,2085,10,967,55,1946,5376
240.201,6,55,18020,29,802,8578,1418,15158,26,187,9607,580,2862
38.059,1,44,4576,0,0,0,0,0,44,76,885,76,4576
280.178,6,31,7472,14,158,21552,267,1357,17,543,17509,1400,6115
141.126,6,4647,4065822,2796,1365,50,1368,3953230,1851,776,76,1473,112592
6.56,6,39,7285,20,218,345,314,3423,19,516,350,1179,3862
0.291,6,25,8965,13,257,24,669,1714,12,1103,25,2804,7251
18.166,17,6,528,3,48,9079,48,228,3,72,9078,72,300
0.44,6,6,324,4,0,146,0,216,2,0,241,0,108
1795.861,6,356,22520,208,69,8675,69,12460,148,69,12216,69,10060
0.038,17,8,2454,8,278,5,317,2454,0,0,0,0,0
1139.131,17,25,2231,25,61,47463,355,2231,0,0,0,0,0
259.351,6,5,293,4,31,86450,31,222,1,31,0,31,71
0.035,17,4,284,2,32,30,32,120,2,54,30,60,164
0.573,6,23,7428,14,273,44,663,2104,9,1209,62,1946,5324
1771.046,1,8,448,8,28,253006,28,448,0,0,0,0,0
0.773,6,28,5967,14,156,59,267,1502,14,650,54,1420,4465
0.369,6,22,7288,12,270,33,797,1712,10,1009,37,2382,5576
2.937,17,4,624,4,128,979,128,624,0,0,0,0,0
240.37,6,43,8786,21,523,12017,1418,5814,22,202,11445,618,2972
0.809,17,3,1170,3,362,404,362,1170,0,0,0,0,0
608.005,6,37,6683,19,250,33778,1314,2516,18,286,35763,1460,4167
1779.982,17,142,11360,71,48,25427,48,5396,71,56,25427,56,5964
0.16,17,2,230,1,40,0,40,68,1,134,0,134,162
0.261,17,2,339,1,33,0,33,61,1,250,0,250,278
50.336,6,48,26731,22,213,2396,431,2291,26,1213,2006,1408,24440
1729.109,17,47,15768,47,307,37589,308,15768,0,0,0,0,0
3.13,17,2,780,2,362,3130,362,780,0,0,0,0,0
0.01,6,9,1556,5,515,2,515,783,4,557,3,557,773
114.13,6,20,7074,10,713,12681,999,4680,10,498,12650,508,2394
10.404,6,882,741876,528,1329,19,1368,718804,354,931,28,2736,23072
1.434,6,4,1726,1,126,0,126,166,3,1440,717,1440,1560
7.486,17,3,228,3,48,3743,48,228,0,0,0,0,0
45.797,6,41,13663,23,666,2081,1418,11197,18,217,2693,580,2466
668.579,17,20,6720,20,308,35188,308,6720,0,0,0,0,0
372.182,6,22,1459,14,177,28629,177,925,8,110,9230,110,534
280.211,6,25,7232,12,158,25473,267,1277,13,905,23349,4845,5955
1702.993,1,8,448,8,28,243284,28,448,0,0,0,0,0
133.919,17,4,352,2,60,133917,60,176,2,60,133918,60,176
1792.98,17,32,10496,32,300,57838,300,10496,0,0,0,0,0
1781.74,6,354,22440,207,69,8649,69,12420,147,69,12203,69,10020
1793.203,6,357,22629,208,69,8662,69,12460,149,69,12116,69,10169
0.363,6,26,8868,13,227,30,547,1592,13,941,29,1438,7276
280.386,6,29,7392,13,158,23365,267,1317,16,603,18686,2036,6075
15.52,17,2,672,2,308,15520,308,672,0,0,0,0,0
11.378,6,2000,1816892,1245,1378,9,1408,1772870,755,950,14,2816,44022
21.968,6,3369,3248993,2193,1403,9,1440,3183153,1176,776,18,1440,65840
11.58,6,24,8413,13,275,965,275,1078,11,1147,827,2840,7335
37.026,2,2,64,2,8,37026,8,64,0,0,0,0,0
124.068,6,43,9870,22,635,745,1360,4135,21,348,6194,2720,5735
3.655,6,32,10548,18,244,215,583,1701,14,920,266,1420,8847
1794.586,6,245,35856,152,302,11884,302,26032,93,83,19506,83,9824
1774.344,6,180,15480,120,69,14910,69,8940,60,69,30069,69,6540
1.565,6,48,18870,26,934,62,1460,13214,22,433,64,1460,5656
51.148,6,36,8360,18,378,508,786,1886,18,478,3001,2720,6474
0.012,6,2,1175,1,0,0,0,40,1,1095,0,1095,1135
0.427,6,12,1653,6,288,82,288,548,6,426,53,434,1105
1682.044,17,14,1036,7,30,280335,30,406,7,62,280335,62,630
67.275,6,576,262709,303,818,222,1152,246276,273,392,246,1152,16433
1775.284,6,180,15480,120,69,14918,69,8940,60,69,30080,69,6540
716.401,6,71,8122,36,86,20464,722,3348,35,118,21065,1408,4774
1135.0,2,10,320,10,8,126111,8,320,0,0,0,0,0
1792.828,6,131,8959,76,60,23904,208,5767,55,31,33195,31,3192
1742.96,6,95,7234,62,38,28573,205,4424,33,33,54458,98,2810
1782.23,17,79,3312,78,14,23145,14,3276,1,8,0,8,36
19.107,17,22,11743,12,767,1727,1350,9546,10,191,2111,1350,2197
3.608,17,5,290,5,30,902,30,290,0,0,0,0,0
0.571,6,25,7439,15,300,40,677,2705,10,721,62,1420,4734
1723.866,17,57,19112,57,307,30783,308,19112,0,0,0,0,0
376.337,6,20,1355,15,177,26881,177,977,5,110,15172,110,378
0.237,6,10,859,6,181,47,181,489,4,77,54,133,370
0.008,17,2,376,1,39,0,39,67,1,281,0,281,309
0.013,17,2,194,1,61,0,61,89,1,77,0,77,105
0.483,6,2,100,1,0,0,0,60,1,0,0,0,40
1786.788,6,104,8376,68,65,26668,65,4930,36,59,51048,59,3446
352.509,6,17,6133,2,106,500,106,194,15,410,25178,1420,5939
1.241,2,2,64,2,8,1241,8,64,0,0,0,0,0
1799.83,1,254,14224,254,28,7113,28,14224,0,0,0,0,0
1792.863,17,180,14040,180,50,10015,50,14040,0,0,0,0,0
1653.327,1,7,742,7,78,275554,78,742,0,0,0,0,0
184.041,6,40,11043,21,345,9195,734,3863,19,476,10217,1448,7180
0.406,6,54,23870,31,965,13,1380,16785,23,558,16,1923,7085
1781.766,6,355,22480,207,69,8649,69,12420,148,69,12120,69,10060
24.334,17,22,8118,10,437,2699,1350,4659,12,260,2208,1350,3459
1.913,6,25,5795,14,158,146,370,1355,11,999,190,1737,4440
35.195,6,32,5146,16,154,2346,722,1910,16,342,2312,1448,3236
10.071,6,15,3766,4,92,3357,92,308,11,320,985,1440,3458
1777.068,17,73,3060,72,14,25029,14,3024,1,8,0,8,36
0.104,17,8,2446,8,277,14,316,2446,0,0,0,0,0
37.4,17,4,352,2,60,37399,60,176,2,60,37399,60,176
1779.008,17,140,11200,70,48,25782,48,5320,70,56,25782,56,5880
1620.079,1,7,392,7,28,270013,28,392,0,0,0,0,0
123.129,6,30,6880,14,274,9468,517,1568,16,744,8205,1418,5312
0.017,17,4,668,2,32,13,32,120,2,246,12,246,548
15.636,17,6,528,3,48,7814,48,228,3,72,7813,72,300
0.442,6,6,324,4,0,147,0,216,2,0,212,0,108
1771.278,6,101,9344,66,65,27250,65,5577,35,59,52093,59,3767
98.015,6,72,47016,44,1177,2279,1408,38828,28,747,2279,1408,8188
34.786,17,40,5880,20,48,1830,48,1520,20,190,1830,308,4360
281.037,6,32,7853,14,158,21618,267,1357,18,524,16529,1400,6496
3.034,6,2,88,2,0,0,0,88,0,0,0,0,0
0.155,6,12,1938,7,209,25,209,581,5,544,33,891,1357
1.183,6,25,8056,12,164,92,267,1288,13,869,84,1440,6768
0.411,6,21,5000,10,137,45,267,1092,11,692,38,1467,3908
212.749,6,30,6610,18,164,12514,499,1712,12,490,19332,1420,4898
1770.499,6,101,9410,66,66,27238,66,5610,35,60,52070,60,3800
0.24,6,23,6012,12,181,21,537,1526,11,781,23,2224,4486
1776.248,17,73,3060,72,14,25017,14,3024,1,8,0,8,36
3.976,6,34,6185,17,206,248,314,2744,17,551,231,1179,3441
0.192,6,25,7216,12,155,17,267,1261,13,678,15,2045,5955
1740.449,1,56,4704,56,56,31644,56,4704,0,0,0,0,0
1681.756,17,14,3843,7,30,280291,30,406,7,463,280290,463,3437
131.531,17,4,352,2,60,131530,60,176,2,60,131530,60,176
1787.903,6,363,25421,211,99,8513,469,14925,152,69,11840,69,10496
1.018,6,29,10195,14,257,78,669,1778,15,953,71,1438,8417
24.58,6,33,8849,14,340,1890,722,2605,19,608,1343,1380,6244
11.446,6,6,328,4,0,3815,0,216,2,0,11320,0,112
11.787,17,8,608,8,48,1683,48,608,0,0,0,0,0
0.64,6,23,6566,13,344,52,1059,2246,10,979,70,1731,4320
0.942,6,11,1727,7,100,157,100,384,4,589,225,1152,1343
0.481,6,5,260,2,0,447,0,104,3,0,230,0,156
259.527,6,25,6619,10,156,28836,267,878,15,639,18536,1460,5741
1779.583,17,314,73294,314,205,5685,422,73294,0,0,0,0,0
16.351,6,21,3930,12,210,1482,210,1286,9,545,2042,904,2644
0.94,6,10,1687,7,100,156,100,384,3,1179,336,1179,1303
0.626,17,4,288,2,36,609,36,128,2,52,604,52,160
0.666,6,119,88106,54,131,12,232,2689,65,1403,9,2760,85417
300.985,6,47,25896,27,807,11576,1408,8693,20,1346,3261,4224,17203
789.397,17,40,3200,20,48,41546,48,1520,20,56,41546,56,1680
1775.076,1,53,4452,0,0,0,0,0,53,56,34136,56,4452
69.521,6,28,7286,13,155,5793,267,1306,15,488,4965,3417,5980
1782.416,1,58,4872,0,0,0,0,0,58,56,31270,56,4872
15.649,17,26,14489,15,774,1115,1350,12041,11,194,1561,1350,2448
1764.448,2,14,448,14,8,135726,8,448,0,0,0,0,0
3.61,6,518,974002,96,550,38,1396,7214,422,2260,8,8376,966788
286.657,1,4,224,4,28,95552,28,224,0,0,0,0,0
1776.601,1,264,27984,264,78,6755,78,27984,0,0,0,0,0
1786.283,6,104,8376,68,65,26660,65,4930,36,59,51034,59,3446
0.111,17,2,2754,2,1349,111,1349,2754,0,0,0,0,0
0.186,6,46,22565,27,1098,7,1420,17584,19,467,9,1883,4981
1.248,6,225,176294,133,1335,9,1420,168323,92,475,13,1883,7971
31.496,6,8,348,2,0,24,0,84,6,0,6296,0,264
1745.507,6,112,8981,73,45,24243,205,5357,39,40,45924,108,3624
58.43,17,2,122,2,33,58430,33,122,0,0,0,0,0
21.096,17,30,7159,15,266,1503,1350,4416,15,154,1503,1350,2743
3.722,17,8,736,4,32,1240,32,240,4,96,1236,96,496
240.133,6,41,5454,21,247,12006,834,2845,20,173,12638,669,2609
92.486,17,4,352,2,60,92485,60,176,2,60,92484,60,176
1740.997,6,92,6668,60,31,29508,31,4062,32,31,56160,31,2606
165.657,17,9,3016,9,307,20707,308,3016,0,0,0,0,0
0.205,6,27,7296,13,155,17,267,1301,14,603,14,2036,5995
237.687,6,29,7392,14,158,18283,267,1357,15,678,16974,3436,6035
1681.722,17,16,1265,8,30,240239,37,471,8,71,240239,136,794
1798.455,17,449,39928,404,35,4462,288,25708,45,288,40021,288,14220
75.693,6,24,988,12,0,4465,0,488,12,0,6878,0,500
12.853,6,54,11435,28,305,476,1164,5440,26,409,506,1360,5995
1666.98,1,7,392,7,28,277830,28,392,0,0,0,0,0
4.274,6,39,7269,20,218,224,314,3423,19,513,222,1179,3846
1756.129,1,56,4704,56,56,31929,56,4704,0,0,0,0,0
11.375,6,1729,1565385,1107,1362,10,1420,1536142,622,475,18,1883,29243
0.22,6,10,1671,6,552,44,948,1348,4,159,73,159,323
35.406,17,4,240,2,32,35405,32,120,2,32,35405,32,120
4.503,17,2,668,2,306,4503,306,668,0,0,0,0,0
3.929,17,16,9892,8,706,561,1350,5873,8,474,553,1350,4019
21.067,17,33,9465,14,265,1618,1350,4107,19,254,1168,1350,5358
1797.86,6,377,32521,213,104,8480,469,15722,164,132,11029,1452,16799
0.293,6,27,9085,13,257,24,667,1715,14,947,22,1408,7370
377.965,2,4,128,4,8,125988,8,128,0,0,0,0,0
1.306,6,45,10779,23,514,59,1460,5078,22,400,53,1460,5701
8.081,6,17,5132,9,150,1010,174,664,8,828,1141,1420,4468
0.071,17,2,642,1,300,0,300,328,1,286,0,286,314
11.816,6,1749,1611932,1138,1364,10,1432,1583177,611,475,19,1871,28755
0.028,17,2,574,1,32,0,32,60,1,486,0,486,514
115.498,17,4,352,2,60,115497,60,176,2,60,115496,60,176
4.106,1,5,420,5,56,1026,56,420,0,0,0,0,0
1793.078,1,58,4872,58,56,31457,56,4872,0,0,0,0,0
9.282,6,3,120,3,0,0,0,120,0,0,0,0,0
280.424,6,28,7352,12,158,25493,267,1277,16,678,18692,2085,6075
45.698,6,30,7432,13,158,3808,267,1317,17,543,2853,1400,6115
1.639,6,38,9848,21,440,81,1360,4392,17,476,86,2715,5456
199.272,17,4,240,2,32,199271,32,120,2,32,199271,32,120
14.398,6,24,6993,13,275,1199,275,1078,11,910,938,1440,5915
0.008,6,3,120,2,0,8,0,80,1,0,0,0,40
1786.804,6,108,8664,69,66,26276,66,5004,39,60,47012,60,3660
0.835,17,23,9587,11,385,80,1350,4553,12,391,73,1350,5034
1786.541,6,98,7952,64,66,28357,66,4672,34,60,54134,60,3280
5.122,17,31,14140,14,685,394,1350,9989,17,216,202,1350,4151
1794.533,6,371,23534,213,69,8464,69,13074,158,69,11429,69,10460
1.263,17,25,6341,11,269,123,1350,3268,14,191,94,1350,3073
545.266,6,109,7534,46,46,12002,46,3036,63,46,8794,46,4498
1727.424,17,12,498,11,14,172742,14,462,1,8,0,8,36
0.011,17,4,420,2,33,6,33,122,2,121,6,145,298
82.979,17,4,352,2,60,82978,60,176,2,60,82978,60,176
1794.75,1,24,1344,24,28,78032,28,1344,0,0,0,0,0
0.356,6,47,19442,26,1023,14,1380,14372,21,383,15,1380,5070
300.656,6,46,8907,23,266,13666,720,2078,23,327,585,1460,6829
900.592,2,12,384,12,8,81872,8,384,0,0,0,0,0
18.409,17,4,352,2,48,18397,48,152,2,72,18398,72,200
16.478,6,7,435,0,0,0,0,0,7,31,2746,31,435
1790.975,17,176,37797,176,186,10234,422,37797,0,0,0,0,0
1.312,6,4,212,2,0,1312,0,100,2,0,0,0,112
171.09,6,27,14092,14,265,71,485,1423,13,1517,14245,3950,12669
1.091,6,24,6635,13,350,90,1088,2275,11,783,108,1420,4360
1739.961,6,87,6322,58,31,30525,31,3915,29,31,62141,31,2407
195.703,17,4,240,2,32,195702,32,120,2,32,195698,32,120
1799.367,17,450,39960,405,35,4453,288,25740,45,288,40020,288,14220
1776.47,17,142,11360,71,48,25377,48,5396,71,56,25377,56,5964
0.293,17,4,360,2,30,0,30,116,2,94,0,94,244
1795.143,6,356,22520,208,69,8672,69,12460,148,69,12211,69,10060
252.004,2,2,64,2,8,252004,8,64,0,0,0,0,0
61.668,6,60,39023,37,1165,1713,1448,31075,23,749,2793,1448,7948
0.628,17,2,925,1,548,0,548,576,1,321,0,321,349
0.112,17,2,396,1,39,0,39,67,1,301,0,301,329
7.957,1,12,1248,0,0,0,0,0,12,76,723,76,1248
0.624,6,36,11358,21,627,31,1188,7363,15,356,38,1048,3995
18.225,6,16,4191,7,49,3037,92,471,9,1624,2254,2328,3720
1776.06,17,73,3060,72,14,25014,14,3024,1,8,0,8,36
374.469,6,22,6644,5,112,93617,112,320,17,375,23398,1452,6324
0.166,6,44,20953,26,1068,6,1420,16012,18,467,9,1883,4941
255.896,6,76,22817,35,820,7526,1418,16682,41,265,6397,658,6135
1.135,6,10,1687,7,100,189,100,384,3,1179,436,1179,1303
517.162,6,43,7505,21,262,25855,517,1888,22,744,24624,1418,5617
50.006,6,612,520133,364,1353,137,1368,500624,248,780,201,1473,19509
1796.825,17,142,11360,71,48,25668,48,5396,71,56,25668,56,5964
10.004,6,89,27578,44,574,232,1152,21280,45,449,221,1179,6298
1798.493,17,448,39896,403,35,4473,288,25676,45,288,40018,288,14220
11.287,6,6,690,0,0,0,0,0,6,90,2257,90,690
1795.548,1,246,13776,246,28,7328,28,13776,0,0,0,0,0
0.012,17,4,420,2,33,5,33,122,2,121,4,145,298
1789.461,17,89,3737,87,14,20807,15,3655,2,13,216248,18,82
1797.328,17,449,39928,404,35,4459,288,25708,45,288,40021,288,14220
240.197,6,53,18062,28,810,8895,1402,15243,25,188,10007,580,2819
7.917,6,78,24677,40,561,203,1152,19016,38,459,207,1179,5661
1792.786,6,336,31944,166,421,10865,841,11578,170,70,10604,1408,20366
882.298,2,5,160,5,8,220574,8,160,0,0,0,0,0
0.198,17,4,588,2,48,186,48,152,2,190,185,308,436
201.865,1,7,588,0,0,0,0,0,7,56,33644,56,588
0.013,6,2,80,1,0,0,0,40,1,0,0,0,40
1.616,6,51,19176,27,935,62,1460,13285,24,409,62,1460,5891
1789.537,1,253,14168,253,28,7101,28,14168,0,0,0,0,0
1774.961,6,180,15480,120,69,14915,69,8940,60,69,30076,69,6540
371.34,6,25,1651,17,177,23208,177,1117,8,110,9235,110,534
1775.76,6,271,33092,110,137,16290,1360,15901,161,134,11097,3302,17191
255.48,6,9,522,3,106,127740,106,234,6,0,6287,0,288
1681.305,2,17,544,17,8,105081,8,544,0,0,0,0,0
1798.637,6,277,33871,113,136,16058,1360,16423,164,135,11033,4662,17448
20.142,6,20,5995,12,147,1831,318,1233,8,1084,2876,1675,4762
1683.575,17,16,1265,8,30,240507,37,471,8,71,240507,136,794
379.863,6,18,1242,14,180,29220,180,916,4,110,20059,110,326
3.789,17,32,11481,14,362,291,1350,5465,18,306,198,1350,6016
1.098,6,10,767,5,186,273,186,454,5,45,273,45,313
1.354,6,38,8252,19,320,75,1162,2716,19,433,65,1460,5536
113.941,2,3,96,3,8,56970,8,96,0,0,0,0,0
1.0,6,54,23059,29,1038,35,1380,17805,25,421,37,1923,5254
247.351,6,39,6147,22,304,11778,304,4484,17,83,15459,83,1663
1783.316,17,79,3312,78,14,23159,14,3276,1,8,0,8,36
11.047,6,26,11333,13,275,920,275,1078,13,1215,881,2840,10255
0.443,6,20,7151,11,318,42,600,1854,9,964,52,1471,5297
0.423,17,2,179,1,43,0,43,71,1,80,0,80,108
113.085,6,28,5129,15,139,8077,722,1903,13,502,1933,1448,3226
370.515,6,48,6578,22,119,12381,721,2466,26,183,14813,1448,4112
5.864,6,178,135732,84,953,70,1460,13883,94,1422,61,1607,121849
321.526,6,26,6293,11,139,32152,159,1150,15,873,22965,1669,5143
1795.982,1,58,4872,58,56,31508,56,4872,0,0,0,0,0
1.112,6,20,9046,12,304,101,597,1425,8,1457,125,4441,7621
56.196,17,2336,1502358,2324,618,23,1472,1501878,12,12,5000,12,480
1782.202,17,83,3480,82,14,22002,14,3444,1,8,0,8,36
16.63,6,8,368,3,0,8315,0,128,5,0,3849,0,240
0.01,17,2,408,1,39,0,39,67,1,313,0,313,341
225.864,17,4,1312,4,300,75288,308,1312,0,0,0,0,0
29.112,17,18,1584,9,48,3631,48,684,9,72,3629,72,900
1798.598,6,367,23236,212,69,8524,69,12896,155,69,11679,69,10340
0.118,17,2,742,2,343,118,354,742,0,0,0,0,0
1745.932,6,95,7203,63,38,28160,205,4476,32,33,56313,98,2727
0.999,6,24,7992,12,164,90,267,1276,12,869,73,1408,6716
0.403,6,12,1653,6,288,73,288,548,6,426,44,434,1105
0.917,17,4,314,2,31,883,31,118,2,70,871,70,196
0.199,6,46,21090,26,1072,7,1420,16069,20,467,10,1883,5021
1787.64,6,102,8296,68,65,26681,65,4930,34,59,54167,59,3366
6.911,6,67,20662,35,559,203,1152,15955,32,427,214,1152,4707
1786.586,6,106,8524,68,66,26665,66,4964,38,60,48283,60,3560
1739.033,1,15,840,15,28,124216,28,840,0,0,0,0,0
370.854,6,18,1242,14,180,28527,180,916,4,110,20060,110,326
0.665,6,10,766,5,185,146,185,453,5,45,140,45,313
1.836,6,27,10214,16,290,122,604,1516,11,1031,166,1420,8698
20.849,6,37,8357,19,363,1158,775,1883,18,478,510,2720,6474
240.635,2,5,160,5,8,60158,8,160,0,0,0,0,0
43.578,17,24,1824,24,48,1894,48,1824,0,0,0,0,0
1748.843,1,82,6888,82,56,21590,56,6888,0,0,0,0,0
1.67,6,25,8765,15,285,119,588,1460,10,985,166,1420,7305
0.209,6,5,373,3,36,104,38,229,2,40,0,40,144
1786.479,6,102,8364,68,66,26663,66,4964,34,60,54133,60,3400
644.983,1,18,2308,18,100,37940,173,2308,0,0,0,0,0
1797.386,17,92,8618,46,33,39941,37,2822,46,98,39941,155,5796
1680.475,1,15,840,15,28,120033,28,840,0,0,0,0,0
1771.612,6,99,9306,66,66,27255,66,5610,33,60,55360,60,3696
0.004,17,2,309,1,40,0,40,68,1,213,0,213,241
11.939,6,2058,1951086,1304,1417,9,1448,1906918,754,776,15,1448,44168
0.039,17,4,308,2,38,0,38,132,2,60,2,66,176
0.172,6,12,3704,6,171,34,171,491,6,964,33,1448,3213
4.729,6,67,21946,33,755,147,1440,11262,34,515,137,1440,10684
0.485,6,6,248,4,0,161,0,164,2,0,226,0,84
1787.631,6,104,8376,68,65,26681,65,4930,36,59,51072,59,3446
6.064,6,1636,1534789,1047,1389,5,1408,1499497,589,931,10,2816,35292
0.0,6,1,129,0,0,0,0,0,1,89,0,89,129
58.82,6,7682,7382494,5144,1358,11,1408,7245854,2538,931,23,2801,136640
11.493,6,1818,1589276,1108,1380,10,1420,1556451,710,467,16,1883,32825
117.845,2,2,64,2,8,117845,8,64,0,0,0,0,0
0.005,6,3,450,1,0,0,0,40,2,165,0,261,410
1771.686,6,99,9306,66,66,27256,66,5610,33,60,55362,60,3696
1689.754,1,9,504,9,28,211219,28,504,0,0,0,0,0
0.653,17,2,144,1,36,0,36,64,1,52,0,52,80
1786.963,6,103,8470,69,66,26278,66,5070,34,60,54147,60,3400
1773.776,6,180,15480,120,69,14905,69,8940,60,69,30062,69,6540
0.105,6,12,1587,6,507,21,507,779,6,556,21,556,808
5.054,17,4,288,2,36,5006,36,128,2,52,4995,52,160
1103.202,17,216,16416,216,48,5131,48,16416,0,0,0,0,0
7.996,6,1561,1459132,977,1415,8,1448,1424100,584,776,13,1448,35032
219.601,6,13,986,4,31,73200,31,270,9,31,13444,31,716
9.09,6,84,26317,42,559,221,1152,20155,42,407,215,1152,6162
60.114,6,20,4462,9,341,7514,722,1488,11,342,5967,1448,2974
280.535,6,28,7352,13,158,23377,267,1317,15,678,20032,3456,6035
1751.226,17,12,498,11,14,175122,14,462,1,8,0,8,36
1740.564,17,28,6580,28,207,64465,207,6580,0,0,0,0,0
0.088,17,2,322,1,33,0,33,61,1,233,0,233,261
0.534,6,21,7290,13,335,44,668,2026,8,968,68,1946,5264
300.808,6,44,8679,23,271,13673,739,2086,21,521,706,3488,6593
1796.015,1,250,14000,250,28,7212,28,14000,0,0,0,0,0
0.451,17,13,9101,7,630,75,1350,4607,6,721,44,1350,4494
33.747,6,30,5042,15,154,2410,722,1859,15,399,2396,1440,3183
1451.725,17,60,2514,59,14,25029,14,2478,1,8,0,8,36
280.313,6,28,7352,13,158,23359,267,1317,15,678,20021,4200,6035
1.343,6,49,20097,28,888,49,1360,14481,21,476,56,2720,5616
2.188,6,24,8004,12,164,166,267,1288,12,1014,169,2331,6716
1.029,6,25,8718,14,254,79,658,1609,11,951,83,1460,7109
516.691,1,18,1008,18,28,30393,28,1008,0,0,0,0,0
31.678,6,3488,3252899,2138,1436,14,1448,3172273,1350,792,23,1448,80626
1799.961,17,449,39928,404,35,4466,288,25708,45,288,40018,288,14220
369.547,6,18,1242,14,180,28426,180,916,4,110,20067,110,326
301.006,6,28,15785,15,195,21487,431,1568,13,1354,25068,6665,14217
588.56,17,20,6560,20,300,30976,300,6560,0,0,0,0,0
116.601,6,23,4799,10,189,8448,516,1352,13,417,9688,2642,3447
0.12,17,2,198,1,39,0,39,67,1,103,0,103,131
5.017,17,4,558,2,36,5003,36,128,2,187,4992,187,430
365.757,6,22,2313,16,195,24383,195,867,6,398,4634,419,1446
661.78,2,8,256,8,8,94540,8,256,0,0,0,0,0
280.333,6,30,7432,13,158,23361,267,1317,17,543,17520,1400,6115
0.006,6,3,151,1,0,0,0,40,2,7,0,7,111
240.214,6,54,18527,29,788,8578,1402,15705,25,189,10008,580,2822
0.078,17,2,212,1,46,0,46,74,1,110,0,110,138
0.04,6,3,182,2,31,40,31,111,1,31,0,31,71
1.578,6,55,20053,30,915,54,1460,14077,25,381,58,1460,5976
1772.372,6,180,15480,120,69,14893,69,8940,60,69,30035,69,6540
17.218,6,28,7452,10,133,1913,267,949,18,480,999,1452,6503
0.214,6,9,1344,5,145,53,145,349,4,831,23,831,995
0.432,6,6,324,4,0,144,0,216,2,0,234,0,108
1798.796,6,367,25650,214,99,8445,469,15045,153,69,11831,69,10605
1743.255,1,58,4872,0,0,0,0,0,58,56,30583,56,4872
1791.712,6,355,22480,207,69,8697,69,12420,148,69,12188,69,10060
0.423,6,26,8890,13,232,35,569,1614,13,941,33,1438,7276
1798.001,17,448,39896,403,35,4472,288,25676,45,288,40016,288,14220
371.567,6,27,1767,18,177,21856,177,1181,9,110,8824,110,586
11.737,6,1864,1624762,1105,1415,10,1432,1590157,759,420,15,1432,34605
0.336,6,26,9017,13,261,28,683,1728,13,943,26,1448,7289
601.621,2,7,224,7,8,100270,8,224,0,0,0,0,0
0.116,6,9,1339,5,145,29,145,349,4,826,30,826,990
4.811,17,5,320,5,36,1202,36,320,0,0,0,0,0
15.505,17,19,13105,11,960,1544,1350,10871,8,251,2204,1350,2234
0.172,6,46,20230,26,1010,6,1420,15209,20,467,8,1883,5021
1772.186,6,180,15480,120,69,14892,69,8940,60,69,30031,69,6540
240.189,6,59,18274,31,755,8006,1402,15224,28,198,8895,580,3050
240.431,6,52,17442,28,778,8901,1418,14696,24,212,10451,580,2746
423.313,1,42,2352,42,28,10324,28,2352,0,0,0,0,0
1788.642,6,4732,4630946,1678,127,1066,342,100472,3054,1467,585,4206,4530474
0.019,17,2,144,1,36,0,36,64,1,52,0,52,80
1785.86,17,155,13578,142,30,12665,37,8285,13,379,143847,463,5293
300.666,6,36,8261,21,258,15033,688,1907,15,574,604,4848,6354
368.291,6,129,20122,72,304,5187,304,14208,57,83,6576,83,5914
1799.19,6,356,22520,208,69,8691,69,12460,148,69,12239,69,10060
1783.691,6,354,22440,207,69,8658,69,12420,147,69,12216,69,10020
30.69,17,16,1408,8,48,4382,48,608,8,72,4382,72,800
0.364,6,10,1671,6,552,72,948,1348,4,159,121,159,323
82.459,17,4,240,2,32,82458,32,120,2,32,82458,32,120
6.537,17,4,240,2,32,6535,32,120,2,32,6535,32,120
2.138,17,4,734,3,46,1002,46,222,1,484,0,484,512
126.881,6,37,9437,12,155,5019,267,1274,25,376,5286,1420,8163
0.019,17,2,231,1,34,0,34,62,1,141,0,141,169
1799.64,17,317,71321,317,196,5695,422,71321,0,0,0,0,0
0.253,17,3,451,2,39,136,39,134,1,289,0,289,317
1743.281,6,94,7151,62,38,28578,205,4424,32,33,56224,98,2727
3.633,17,16,6554,7,509,605,1350,3764,9,282,445,1350,2790
712.152,6,67,8310,37,98,19782,722,3702,30,138,24549,1408,4608
1682.378,17,14,1036,7,30,280388,30,406,7,62,280389,62,630
2.433,6,13,2311,8,188,347,245,700,5,1407,546,1407,1611
0.153,17,4,284,2,32,88,32,120,2,54,69,60,164
1793.962,6,119,13997,77,83,23604,516,6078,42,163,43749,1452,7919
2.778,6,2,88,2,0,0,0,88,0,0,0,0,0
61.659,6,57,36743,36,1126,1761,1448,28921,21,746,3071,1448,7822
86.551,6,23,10009,12,531,67,1360,2637,11,1384,8640,3934,7372
0.924,6,11,1727,7,100,154,100,384,4,589,223,1152,1343
183.373,6,225,181393,145,1332,1273,1448,163435,80,574,2136,1448,17958
0.549,17,2,167,1,39,0,39,67,1,72,0,72,100
4.974,17,4,558,2,36,4965,36,128,2,187,4964,187,430
61.234,6,13,1079,12,43,5566,43,1019,1,0,0,0,60
85.107,6,47,13327,24,912,660,1360,7450,23,329,3860,4027,5877
0.039,1,4,416,0,0,0,0,0,4,76,13,76,416
10.146,6,79,24349,41,549,253,1152,18688,38,459,266,1179,5661
62.086,17,3,228,3,48,31043,48,228,0,0,0,0,0
67.52,6,35,9639,13,327,409,1189,2495,22,446,3214,1420,7144
1790.705,6,358,22669,209,69,8609,69,12569,149,69,12099,69,10100
11.18,6,17,2425,9,211,1397,211,922,8,545,1596,904,1503
0.723,17,15,8560,8,705,103,1350,5871,7,356,110,1350,2689
14.799,6,24,6993,13,275,1233,275,1078,11,910,979,1440,5915
1795.828,17,448,39896,403,35,4467,288,25676,45,288,40014,288,14220
1797.18,6,367,25650,214,99,8437,469,15045,153,69,11823,69,10605
14.706,6,2510,2335968,1612,1372,9,1402,2284596,898,776,16,2804,51372
3.867,17,2,144,1,36,0,36,64,1,52,0,52,80
0.038,6,9,1002,5,213,9,213,417,4,421,10,421,585
697.524,6,131,17469,56,86,12682,616,5841,75,200,9423,4658,11628
630.657,2,5,160,5,8,157664,8,160,0,0,0,0,0
3.796,17,10,2355,5,40,946,40,340,5,375,946,407,2015
1699.448,17,12,498,11,14,169944,14,462,1,8,0,8,36
1.726,17,28,13786,14,689,132,1350,10040,14,239,121,1350,3746
137.89,6,19,2805,9,483,17236,483,1925,10,83,15316,83,880
1794.105,17,80,3354,79,14,23001,14,3318,1,8,0,8,36
1243.275,6,106,10993,57,74,19955,722,4990,49,90,25898,1408,6003
1799.005,6,376,26217,217,98,8328,469,15372,159,69,11384,69,10845
0.063,17,2,192,1,60,0,60,88,1,76,0,76,104
1796.634,17,80,3354,79,14,23033,14,3318,1,8,0,8,36
1364.212,6,109,13443,60,86,23119,721,5171,49,203,28417,2840,8272
946.213,6,26838,21565169,11923,340,79,342,758986,14915,1358,63,2736,20806183
2.786,17,3,473,2,33,2778,33,122,1,323,0,323,351
230.01,6,220,35916,127,304,1825,304,25604,93,83,2499,83,10312
240.211,6,57,19430,30,824,8282,1418,16402,27,202,9238,580,3028
11.804,6,21,6825,12,275,1073,275,1038,9,1353,848,1440,5787
1772.465,6,180,15480,120,69,14894,69,8940,60,69,30036,69,6540
568.291,6,67,4088,33,46,17759,208,2387,34,31,17213,31,1701
1740.105,6,87,6322,58,31,30528,31,3915,29,31,62146,31,2407
0.412,17,2,148,1,32,0,32,60,1,60,0,60,88
225.997,17,4,272,2,40,225996,47,136,2,40,225996,47,136
0.01,17,3,1007,1,137,0,137,165,2,393,0,393,842
5.019,17,4,558,2,36,5007,36,128,2,187,5007,187,430
0.05,17,2,904,1,300,0,300,328,1,548,0,548,576
0.792,6,20,5959,11,274,79,523,1267,9,721,89,1452,4692
1788.833,17,83,3480,82,14,22084,14,3444,1,8,0,8,36
107.73,17,2,672,2,308,107730,308,672,0,0,0,0,0
2.546,6,22,6463,10,280,277,517,1370,12,744,227,1408,5093
0.016,6,2,1251,1,1159,0,1159,1211,1,0,0,0,40
1744.647,2,29,928,29,8,62308,8,928,0,0,0,0,0
2.113,17,4,580,2,40,2076,40,136,2,194,2080,194,444
75.208,6,15,620,7,0,4034,0,284,8,0,10743,0,336
371.247,6,27,1767,18,177,21838,177,1181,9,110,8609,110,586
1791.011,6,356,22520,208,69,8652,69,12460,148,69,12183,69,10060
32.045,6,427,405627,154,101,209,291,10164,273,1422,117,2836,395463
46.604,6,49,19934,22,199,2213,214,2188,27,1383,1787,1642,17746
9.496,6,22,10289,10,281,1055,545,1249,12,950,855,1420,9040
1790.008,6,359,22709,209,69,8605,69,12569,150,69,12013,69,10140
299.522,6,6,364,4,31,99840,31,222,2,31,299509,31,142
99.725,6,26,3714,15,139,7123,326,1247,11,465,7686,1408,2467
5.759,6,38,7245,20,218,303,314,3423,18,516,323,1179,3822
1681.645,17,14,1036,7,30,280271,30,406,7,62,280271,62,630
244.658,17,30,35412,30,1152,8436,1449,35412,0,0,0,0,0
0.86,6,10,1687,7,100,143,100,384,3,1179,309,1179,1303
0.515,17,2,384,1,39,0,39,67,1,289,0,289,317
0.482,6,24,5999,12,164,43,453,1442,12,782,40,2231,4557
0.268,17,2,304,1,60,0,60,88,1,188,0,188,216
0.815,17,2,178,1,29,0,29,57,1,93,0,93,121
0.1,6,12,2849,7,616,16,690,1604,5,488,23,958,1245
0.069,17,4,288,2,36,37,36,128,2,52,18,52,160
1.148,6,24,8004,11,164,97,267,1236,13,869,81,1440,6768
0.914,17,4,360,2,30,882,30,116,2,94,878,94,244
0.152,6,10,1514,5,503,38,503,771,5,475,38,475,743
0.114,6,18,7400,10,321,12,517,1384,8,947,13,1452,6016
1680.503,1,15,870,15,30,120035,30,870,0,0,0,0,0
77.428,6,26,6358,9,272,110,516,1180,17,345,4833,1452,5178
862.469,1,32,1792,32,28,27821,28,1792,0,0,0,0,0
1795.14,17,80,3354,79,14,23014,14,3318,1,8,0,8,36
0.155,6,24,7176,12,155,14,267,1261,12,775,13,3445,5915
1773.391,6,117,13815,76,87,23645,474,7207,41,120,44332,1448,6608
0.986,17,19,8195,10,536,109,1350,5649,9,254,107,1350,2546
3.299,17,5,738,4,32,1094,32,240,1,470,0,470,498
4.588,6,39,7269,19,218,254,314,3383,20,440,227,1152,3886
1786.51,6,104,8444,68,66,26664,66,4964,36,60,51040,60,3480
1779.574,17,69,2886,67,14,26963,14,2814,2,8,25011,8,72
108.03,6,31,13734,15,514,132,1236,2222,16,987,7169,1460,11512
236.358,17,4,240,2,32,236357,32,120,2,32,236356,32,120
14.565,6,16,2293,9,322,1820,581,1121,7,396,2422,580,1172
1795.425,6,367,25650,214,99,8429,469,15045,153,69,11811,69,10605
10.863,6,18,5610,10,275,1207,275,958,8,1440,829,1440,4652
0.476,17,21,10401,9,484,59,1350,4613,12,454,39,1350,5788
0.314,17,2,266,1,41,0,41,69,1,169,0,169,197
33.696,6,31,5094,15,154,2406,722,1859,16,342,2232,1448,3235
203.423,17,4,352,2,60,203422,60,176,2,60,203422,60,176
107.047,6,54,20150,31,122,3568,186,2952,23,940,4863,1718,17198
1778.049,1,179,10024,179,28,9989,28,10024,0,0,0,0,0
1772.568,6,180,15480,120,69,14895,69,8940,60,69,30039,69,6540
0.389,6,54,23459,30,1002,13,1380,16334,24,511,15,1923,7125
1787.069,6,105,8475,68,65,26672,65,4930,37,59,49637,59,3545
1741.487,17,30,31680,30,1028,60051,1028,31680,0,0,0,0,0
1742.89,6,100,7256,64,31,27664,31,4356,36,31,49796,31,2900
1.216,17,4,496,3,64,540,64,276,1,192,0,192,220
0.048,6,19,9933,11,125,4,125,705,8,2201,6,3012,9228
420.926,6,45,3870,30,69,14514,69,2235,15,69,30053,69,1635
1785.967,6,104,8564,68,66,26656,66,4964,36,60,51025,60,3600
1791.157,1,342,28728,342,56,5252,56,28728,0,0,0,0,0
1680.25,1,15,840,15,28,120017,28,840,0,0,0,0,0
225.145,6,25,2844,15,302,16081,302,1984,10,83,25015,83,860
1769.987,6,99,9240,66,65,27230,65,5577,33,59,55309,59,3663
0.476,6,12,1653,6,288,91,288,548,6,426,56,434,1105
241.653,6,59,13994,27,656,9290,1418,10602,32,143,7791,580,3392
377.929,2,4,128,4,8,125976,8,128,0,0,0,0,0
5.782,6,479,414555,299,1322,18,1368,400531,180,931,31,2736,14024
3.893,6,34,6169,17,206,243,314,2744,17,548,227,1179,3425
1786.997,6,104,8376,68,65,26671,65,4930,36,59,51054,59,3446
32.413,6,461,469514,142,130,229,313,7775,319,1413,101,1418,461739
300.868,6,49,10486,25,433,12536,910,3258,24,329,568,2720,7228
1796.762,6,357,23112,201,69,8983,69,12180,156,69,11589,69,10932
0.014,17,2,427,1,39,0,39,67,1,332,0,332,360
471.713,6,143,59437,70,960,6836,1460,38520,73,461,6549,1638,20917
1784.884,6,106,8388,68,64,26640,64,4896,38,58,48237,58,3492
0.923,17,2,312,2,128,923,128,312,0,0,0,0,0
0.205,17,2,144,1,36,0,36,64,1,52,0,52,80
0.04,17,4,368,2,32,4,32,120,2,96,0,96,248
0.005,6,3,2946,1,0,0,0,40,2,1413,5,1413,2906
1772.317,6,180,15480,120,69,14893,69,8940,60,69,30035,69,6540
397.704,6,18,1242,14,180,30592,180,916,4,110,20076,110,326
1790.02,17,173,25777,173,121,10407,121,25777,0,0,0,0,0
2.919,17,4,1564,4,363,973,363,1564,0,0,0,0,0
0.017,17,6,471,3,31,0,31,177,3,70,1,70,294
1.327,6,49,19872,28,872,49,1360,14256,21,433,57,1360,5616
1794.922,6,359,22709,209,69,8629,69,12569,150,69,12046,69,10140
289.765,17,4,240,2,32,289764,32,120,2,32,289764,32,120
3.664,17,5,340,5,40,916,40,340,0,0,0,0,0
6.612,6,38,7245,18,218,388,314,3343,20,516,334,1179,3902
21.119,6,24,6220,15,117,1508,159,1377,9,873,2638,1675,4843
9.283,6,23,2286,11,222,927,222,1332,12,231,842,231,954
188.54,6,9,528,3,112,94270,112,240,6,0,6288,0,288
300.899,6,42,13568,23,881,13677,1460,8006,19,399,484,1460,5562
0.126,17,2,672,2,308,126,308,672,0,0,0,0,0
49.34,17,3,1152,3,356,24670,356,1152,0,0,0,0,0
33.758,6,30,5078,15,154,2411,722,1895,15,399,2397,1408,3183
0.484,6,22,4442,11,165,48,456,1394,11,493,44,888,3048
90.691,17,18,1584,9,48,11335,48,684,9,72,11335,72,900
0.946,6,28,8460,15,222,56,540,1964,13,994,64,1791,6496
0.044,6,9,1339,5,145,11,145,349,4,826,12,826,990
0.43,6,20,7165,13,318,35,599,1957,7,1209,69,1874,5208
1650.855,1,8,448,8,28,235836,28,448,0,0,0,0,0
1784.178,6,102,8364,68,66,26629,66,4964,34,60,54062,60,3400
0.234,6,5,248,3,0,68,0,156,2,0,234,0,92
0.712,6,24,5980,12,164,64,453,1442,12,651,56,1448,4538
379.755,6,18,1242,14,180,29211,180,916,4,110,20066,110,326
1764.541,2,14,448,14,8,135733,8,448,0,0,0,0,0
20.159,6,21,5418,12,107,1832,159,1074,9,967,2518,1669,4344
1795.345,17,445,39232,401,35,4488,288,25328,44,288,40941,288,13904
0.654,17,10,5859,5,557,163,1350,2927,5,558,155,1350,2932
56.499,6,8,575,2,27,1,27,119,6,24,11298,24,456
1791.053,17,1922,146025,1046,40,1713,41,71825,876,56,2046,57,74200
1770.896,6,101,9410,66,66,27244,66,5610,35,60,52082,60,3800
1764.028,2,13,416,13,8,147002,8,416,0,0,0,0,0
0.627,17,2,237,1,72,0,72,100,1,109,0,109,137
1778.696,1,58,4872,0,0,0,0,0,58,56,31205,56,4872
1799.554,6,356,22520,208,69,8693,69,12460,148,69,12241,69,10060
61.646,6,57,37331,36,1150,1761,1448,29485,21,843,3071,2359,7846
12.11,6,1875,1660926,1173,1363,10,1380,1628604,702,421,17,1923,32322
0.009,17,4,970,2,52,1,52,160,2,377,0,425,810
1707.256,1,8,448,8,28,243893,28,448,0,0,0,0,0
240.171,6,125,102515,66,214,3694,605,5232,59,1744,4140,5632,97283
87.429,17,5,1920,5,356,21857,548,1920,0,0,0,0,0
720.433,6,91,10197,51,91,14408,722,4837,40,124,18467,1408,5360
128.901,6,38,10158,11,207,3347,469,1695,27,320,4957,1460,8463
0.11,17,2,373,1,34,0,34,62,1,283,0,283,311
1799.969,1,57,4788,0,0,0,0,0,57,56,32142,56,4788
1774.758,6,140,8592,74,26,24311,26,4504,66,26,27303,26,4088
0.396,6,27,8944,13,237,33,589,1634,14,939,28,1438,7310
0.135,6,9,1340,5,145,33,145,349,4,827,38,827,991
0.016,17,2,409,1,36,0,36,64,1,317,0,317,345
10.764,6,20,4442,11,275,1076,275,998,9,768,744,1440,3444
0.19,17,2,272,1,60,0,60,88,1,156,0,156,184
2.676,17,2,144,1,36,0,36,64,1,52,0,52,80
2.15,17,3,1173,3,363,1075,363,1173,0,0,0,0,0
295.108,6,52,8534,25,158,12294,517,2463,27,357,11348,1418,6071
1763.867,2,17,544,17,8,110241,8,544,0,0,0,0,0
130.172,1,2,232,2,88,130172,88,232,0,0,0,0,0
7.174,6,1439,1300415,893,1378,7,1408,1267359,546,931,12,2816,33056
299.32,6,125,86079,70,1299,4337,1448,76442,55,451,992,1448,9637
1727.83,1,104,5824,104,28,16775,28,5824,0,0,0,0,0
1798.543,17,448,39896,403,35,4473,288,25676,45,288,40021,288,14220
20.132,17,2,152,2,48,20132,48,152,0,0,0,0,0
0.089,6,10,767,5,186,20,186,454,5,45,18,45,313
69.357,6,70,46610,44,1167,1612,1408,38523,26,747,2463,1408,8087
367.367,6,22,1459,14,177,28259,177,925,8,110,9189,110,534
4.759,6,40,7309,21,218,237,314,3463,19,513,251,1179,3846
360.139,6,55,11527,33,338,11254,1360,5814,22,401,624,2667,5713
8.173,6,615,551913,400,1314,19,1368,536069,215,776,37,1473,15844
5.794,6,41,7349,21,218,289,314,3463,20,513,290,1179,3886
0.007,17,2,350,1,33,0,33,61,1,261,0,261,289
66.516,6,25,10208,13,549,67,1360,2749,12,995,6030,1360,7459
1.308,6,48,18204,26,882,52,1360,12548,22,433,53,1360,5656
1790.074,6,320,82272,192,714,9372,723,55704,128,155,14094,269,26568
300.104,6,44,16366,24,977,13040,1360,10764,20,479,15786,4027,5602
2.621,17,6,450,3,39,1309,39,201,3,55,1310,55,249
0.244,6,24,5980,12,164,22,453,1442,12,781,21,2224,4538
276.681,17,6,360,3,32,138340,32,180,3,32,138340,32,180
1791.671,17,142,11360,71,48,25595,48,5396,71,56,25595,56,5964
172.071,6,40,5901,17,148,4715,722,2080,23,201,7812,1408,3821
1.658,6,27,10127,16,276,110,561,1473,11,1026,148,1420,8654
1681.683,17,12,498,11,14,168168,14,462,1,8,0,8,36
1.414,6,39,9888,20,502,74,1440,4352,19,433,68,1440,5536
119.08,6,65,46626,38,610,36,1258,3815,27,1881,4579,7064,42811
22.425,6,17,4320,9,263,2803,722,1519,8,793,3156,1448,2801
1700.439,17,12,498,11,14,170043,14,462,1,8,0,8,36
6.032,17,31,14413,15,665,430,1350,10408,16,222,213,1350,4005
1786.583,6,102,8296,68,65,26665,65,4930,34,59,54135,59,3366
4.306,1,8,832,0,0,0,0,0,8,76,615,76,832
7.278,6,1634,1570763,1076,1385,6,1408,1537083,558,931,12,2816,33680
84.937,6,37,9597,14,327,38,1189,2535,23,341,3860,1917,7062
1.673,6,14,2351,8,188,239,245,700,6,703,283,1152,1651
1780.226,6,103,8268,68,64,26570,64,4896,35,58,52357,58,3372
288.573,6,28,6613,10,220,6232,516,1285,18,306,16969,1452,5328
0.852,6,11,1727,7,100,142,100,384,4,589,197,1152,1343
39.463,17,20,1520,20,48,2077,48,1520,0,0,0,0,0
147.421,17,4,240,2,32,147420,32,120,2,32,147419,32,120
4.956,6,46,8449,22,227,236,314,4062,24,427,204,1152,4387
1798.105,17,448,39896,403,35,4472,288,25676,45,288,40015,288,14220
0.386,6,27,9071,13,247,32,624,1672,14,832,28,1448,7399
0.081,1,2,112,2,28,81,28,112,0,0,0,0,0
1.511,6,38,9848,20,502,79,1460,4352,18,433,77,1460,5496
13.313,6,68,20286,34,543,403,1152,15499,34,489,395,1179,4787
1681.609,17,14,1036,7,30,280265,30,406,7,62,280266,62,630
6.01,17,12,864,6,33,1201,33,366,6,55,1201,61,498
1788.669,6,278,34339,115,141,15688,1360,16931,163,135,11040,4662,17408
1787.133,6,102,8228,68,64,26673,64,4896,34,58,54148,58,3332
0.021,17,2,433,1,34,0,34,62,1,343,0,343,371
300.423,6,27,11585,15,589,21456,1368,4327,12,948,27306,2736,7258
0.56,6,12,1653,6,288,107,288,548,6,426,77,434,1105
0.189,17,2,144,1,36,0,36,64,1,52,0,52,80
299.942,6,46,13072,24,783,13040,1360,7297,22,325,725,1360,5775
1760.857,6,164,10111,84,47,21215,208,5950,80,31,22285,31,4161
7.056,6,24,6922,9,154,882,267,832,15,498,503,3417,6090
0.389,6,12,1653,6,288,70,288,548,6,426,45,434,1105
4.358,6,40,7309,20,218,229,314,3423,20,440,215,1152,3886
1797.259,17,449,39928,404,35,4459,288,25708,45,288,40017,288,14220
1739.336,6,90,6521,59,31,29988,31,3998,31,31,57977,31,2523
136.645,6,20,8207,11,514,88,1237,2016,9,1163,17056,2720,6191
1.563,6,48,20679,28,930,57,1360,15103,20,476,72,2715,5576
0.032,6,13,3987,8,114,4,114,454,5,1660,2,1861,3533
158.557,6,73,47992,45,1170,3603,1408,39803,28,960,2281,3847,8189
1793.096,1,81,6804,81,56,22413,56,6804,0,0,0,0,0
3.09,17,4,610,3,39,787,39,201,1,381,0,381,409
2.892,6,21,5190,12,351,262,1382,2242,9,430,359,1460,2948
301.309,6,70,57202,32,195,9719,431,2452,38,1507,1783,4104,54750
21.66,6,3276,3104370,2093,1404,10,1448,3038190,1183,776,18,1448,66180
1786.593,17,87,3648,86,14,21018,14,3612,1,8,0,8,36
59.201,6,27,7177,13,155,4933,267,1306,14,530,4553,3417,5871
240.282,6,43,9148,21,519,12013,1402,5775,22,246,11441,618,3373
280.523,6,30,7432,13,158,23376,267,1317,17,543,17529,1300,6115
316.549,6,80,13748,36,130,9044,658,4127,44,261,7357,1629,9621
307.273,1,10,560,10,28,34141,28,560,0,0,0,0,0
0.023,17,2,382,1,47,0,47,75,1,279,0,279,307
267.354,6,55,3511,32,69,8613,69,1901,23,69,12135,69,1610
0.266,17,2,180,1,30,0,30,58,1,94,0,94,122
1795.521,17,86,3606,85,14,21375,14,3570,1,8,0,8,36
0.413,6,10,968,5,256,101,256,460,5,304,100,304,508
72.622,6,19,780,9,0,6019,0,364,10,0,8067,0,416
1687.202,17,16,3136,16,168,112480,168,3136,0,0,0,0,0
280.263,6,29,7392,13,158,23355,267,1317,16,603,18679,2036,6075
3.299,17,8,736,4,32,1089,32,240,4,96,1089,96,496
1787.023,1,186,10416,186,28,9659,28,10416,0,0,0,0,0
4.183,17,5,340,5,40,1045,40,340,0,0,0,0,0
1786.877,6,102,8276,68,64,26669,65,4920,34,58,54143,59,3356
240.011,6,31,6806,13,189,9055,516,1470,18,307,14113,1452,5336
3.198,6,12,507,7,0,533,0,288,5,7,750,7,219
0.345,17,8,2750,8,315,49,354,2750,0,0,0,0,0
11.039,6,20,5616,11,275,1103,275,998,9,1414,780,1414,4618
7.628,6,73,23011,37,562,211,1152,17803,36,470,210,1179,5208
4.22,17,5,295,5,31,1055,31,295,0,0,0,0,0
3.428,17,5,295,5,31,857,31,295,0,0,0,0,0
1799.043,2,25,800,25,8,74960,8,800,0,0,0,0,0
0.517,17,2,152,1,48,0,48,76,1,48,0,48,76
10.772,6,20,4442,11,275,1077,275,998,9,768,774,1440,3444
65.896,17,2,152,2,48,65896,48,152,0,0,0,0,0
6.866,6,710,619930,442,1332,15,1368,601330,268,776,24,1473,18600
485.015,6,96,6117,54,69,9151,69,3333,42,69,11829,69,2784
1785.01,6,358,22669,209,69,8581,69,12569,149,69,12060,69,10100
0.048,6,7,423,4,43,4,43,259,3,0,23,0,164
4.153,17,17,7457,8,540,593,1350,4549,9,295,502,1350,2908
1784.709,6,104,8504,69,66,26245,66,5004,35,60,52488,60,3500
412.582,6,149,41306,67,763,6251,1418,34035,82,90,5090,580,7271
16.475,17,23,9209,11,495,1644,1350,5763,12,259,1495,1350,3446
1782.12,6,365,23087,211,69,8486,69,12787,154,69,11647,69,10300
1755.858,6,4771,4243632,1970,127,891,351,119068,2801,1459,627,4224,4124564
1772.813,6,180,15480,120,69,14897,69,8940,60,69,30043,69,6540
109.143,6,64,39606,39,1135,2872,1408,31565,25,748,2560,1408,8041
4.758,6,40,7325,22,218,226,314,3503,18,516,263,1179,3822
1.314,6,13,5845,4,186,434,267,541,9,822,162,1420,5304
7.39,6,1358,1264669,857,1398,8,1408,1233105,501,931,14,2801,31564
1.881,6,1347,2181134,182,618,10,1396,13197,1165,1819,1,8376,2167937
112.747,17,4,447,2,35,112667,40,127,2,132,112629,194,320
0.886,6,10,1687,7,100,147,100,384,3,1179,315,1179,1303
1799.018,6,356,22520,208,69,8690,69,12460,148,69,12238,69,10060
1772.473,6,177,15222,118,69,15149,69,8791,59,69,30554,69,6431
1785.974,1,58,4872,58,56,31332,56,4872,0,0,0,0,0
1774.236,6,180,15480,120,69,14909,69,8940,60,69,30069,69,6540
0.874,6,306,278578,178,194,4,230,10055,128,2094,5,5608,268523
1.363,6,37,8214,19,321,75,1164,2718,18,476,70,2715,5496
0.372,6,10,968,5,256,89,256,460,5,304,89,304,508
0.574,6,10,924,5,283,96,283,551,5,105,96,105,373
1681.618,17,14,1036,7,30,280266,30,406,7,62,280267,62,630
0.124,17,2,212,1,46,0,46,74,1,110,0,110,138
1.459,6,47,19546,27,918,56,1360,13970,20,529,66,4075,5576
1.454,17,4,304,3,32,716,32,180,1,96,0,96,124
1681.523,1,8,448,8,28,240217,28,448,0,0,0,0,0
0.718,6,154,101258,81,1296,8,1420,94047,73,427,9,1420,7211
0.075,17,4,420,2,33,36,33,122,2,121,40,145,298
4.13,6,38,7229,19,218,229,314,3383,19,513,215,1179,3846
33.811,6,13,1370,6,275,6445,275,794,7,96,3955,96,576
0.451,17,2,152,1,48,0,48,76,1,48,0,48,76
0.028,17,2,144,1,36,0,36,64,1,52,0,52,80
281.471,6,30,7432,14,158,21651,267,1357,16,603,18751,2036,6075
1791.205,17,179,13962,179,50,10062,50,13962,0,0,0,0,0
454.777,6,85,5764,36,46,12861,46,2458,49,46,9474,46,3306
2.329,17,3,174,3,30,1164,30,174,0,0,0,0,0
1791.723,1,58,4872,58,56,31433,56,4872,0,0,0,0,0
0.466,17,4,368,2,32,14,32,120,2,96,1,96,248
5.868,17,24,7778,9,252,733,1350,2525,15,322,226,1350,5253
1785.856,6,359,22778,209,69,8585,69,12500,150,69,11985,69,10278
11.68,6,1863,1614349,1129,1375,10,1420,1580768,734,420,15,1420,33581
1789.403,1,194,10864,194,28,9271,28,10864,0,0,0,0,0
356.253,6,52,15820,33,523,11132,1360,10258,19,399,475,1360,5562
0.078,17,2,136,1,32,0,32,60,1,48,0,48,76
63.196,6,613,287806,320,831,198,1152,270581,293,423,215,1179,17225
300.559,6,41,8779,19,286,16697,766,1960,22,348,872,2720,6819
6.466,1,6,504,6,56,1293,56,504,0,0,0,0,0
1795.114,17,80,3354,79,14,23014,14,3318,1,8,0,8,36
11.059,17,12,14598,12,1188,1005,1449,14598,0,0,0,0,0
0.039,17,2,136,1,32,0,32,60,1,48,0,48,76
0.245,6,10,1671,6,552,49,948,1348,4,159,81,159,323
1790.354,1,271,15176,271,28,6630,28,15176,0,0,0,0,0
8.998,6,2,120,2,0,0,0,120,0,0,0,0,0
0.05,17,2,150,1,47,0,47,75,1,47,0,47,75
3.461,17,5,588,4,64,1147,64,368,1,192,0,192,220
1788.241,17,87,3648,86,14,21038,14,3612,1,8,0,8,36
140.156,17,4,352,2,60,140155,60,176,2,60,140153,60,176
11.894,6,1740,1622119,1145,1365,10,1432,1594028,595,475,19,1871,28091
0.603,6,23,5972,12,108,54,147,919,11,921,57,1581,5053
1777.814,17,148,11840,74,48,24350,48,5624,74,56,24353,56,6216
1615.662,1,8,448,8,28,230808,28,448,0,0,0,0,0
0.531,17,2,152,1,48,0,48,76,1,48,0,48,76
4.24,17,23,11739,10,515,471,1350,5438,13,456,293,1350,6301
0.36,17,2,152,2,48,360,48,152,0,0,0,0,0
10.12,17,3,216,2,44,10094,44,144,1,44,0,44,72
0.082,17,4,284,2,32,45,32,120,2,54,38,60,164
28.382,6,21,2910,9,152,3547,267,822,12,400,2535,1179,2088
1771.74,6,99,9306,66,66,27257,66,5610,33,60,55364,60,3696
46.693,6,28,7223,13,156,3891,267,1312,15,482,3334,1997,5911
244.428,17,6,456,6,48,48885,48,456,0,0,0,0,0
0.013,6,10,1514,5,503,3,503,771,5,475,3,475,743
33.673,6,30,5041,15,154,2405,721,1858,15,399,2392,2026,3183
0.351,17,2,152,1,48,0,48,76,1,48,0,48,76
68.771,6,30,7883,13,155,5730,267,1306,17,453,4296,1420,6577
1763.928,2,15,480,15,8,125994,8,480,0,0,0,0,0
0.631,6,12,2084,6,288,115,288,560,6,424,92,434,1524
10.763,6,20,4442,11,275,1076,275,998,9,768,743,1440,3444
1786.284,17,87,3648,86,14,21015,14,3612,1,8,0,8,36
1772.561,6,180,15480,120,69,14895,69,8940,60,69,30035,69,6540
1772.312,6,180,15480,120,69,14893,69,8940,60,69,30038,69,6540
28.778,6,44,13867,22,289,1370,721,3491,22,862,1321,2840,10376
181.792,17,4,244,2,33,181791,33,122,2,33,181790,33,122
902.391,2,7,224,7,8,150398,8,224,0,0,0,0,0
0.03,17,2,212,1,46,0,46,74,1,110,0,110,138
1743.875,6,95,7203,63,38,28127,205,4476,32,33,56246,98,2727
0.018,17,2,116,1,30,0,30,58,1,30,0,30,58
240.314,6,46,9313,24,524,10447,1418,5976,22,242,11443,638,3337
72.97,6,25,7166,10,155,8107,267,1186,15,488,5201,3417,5980
63.326,6,42,25867,19,840,38,1460,5847,23,1193,2872,1460,20020
19.865,17,40,7372,17,161,1239,1350,3216,23,152,901,1350,4156
1.421,6,24,8004,12,164,107,267,1288,12,1014,110,2736,6716
1.689,6,25,8701,15,274,120,556,1428,10,981,168,1420,7273
0.072,17,4,284,2,32,1,32,120,2,54,0,60,164
0.434,6,6,324,4,0,144,0,216,2,0,251,0,108
0.0,17,5,1757,5,323,0,354,1757,0,0,0,0,0
11.085,6,12,1355,7,284,1847,517,940,5,147,2770,147,415
420.116,17,4,605,4,123,140038,355,605,0,0,0,0,0
0.232,6,2,87,1,0,0,0,40,1,7,0,7,47
1322.14,1,12,672,12,28,120194,28,672,0,0,0,0,0
1.724,6,20,3833,11,234,172,564,1504,9,463,192,1343,2329
1742.188,6,95,7203,63,38,28099,205,4476,32,33,56186,98,2727
301.569,2,3,96,3,8,150784,8,96,0,0,0,0,0
280.234,6,29,7392,13,158,23352,267,1317,16,603,18678,2800,6075
697.838,6,90,7640,52,69,13683,69,3943,38,65,18609,69,3697
729.973,1,16,896,16,28,48664,28,896,0,0,0,0,0
8.281,6,20,6851,10,275,920,275,683,10,1150,829,1414,6168
1772.326,6,180,15480,120,69,14893,69,8940,60,69,30036,69,6540
0.496,17,3,451,2,39,47,39,134,1,289,0,289,317
11.065,6,25,11918,12,275,1005,275,1038,13,1293,804,1414,10880
1789.281,17,142,11360,71,48,25561,48,5396,71,56,25561,56,5964
1750.255,6,203,23941,104,84,16992,721,9575,99,247,17857,1414,14366
0.101,17,2,159,1,33,0,33,61,1,70,0,70,98
1740.854,6,87,6322,58,31,30541,31,3915,29,31,62173,31,2407
0.534,17,16,6711,8,484,76,1350,4099,8,298,57,1350,2612
0.796,6,26,6000,14,150,61,267,1615,12,780,65,1460,4385
1498.454,6,156,9751,78,51,19460,208,5825,78,31,19441,31,3926
300.931,6,53,12652,28,779,11145,1440,6681,25,291,642,1440,5971
782.074,2,6,192,6,8,156414,8,192,0,0,0,0,0
11.257,6,1772,1555213,1079,1388,10,1420,1523272,693,467,16,1883,31941
69.105,6,30,7297,14,155,5315,267,1346,16,441,4606,1420,5951
0.405,17,2,144,1,36,0,36,64,1,52,0,52,80
1.262,6,31,6467,15,164,90,267,1922,16,650,75,1452,4545
218.785,6,42,8674,20,120,11514,267,2138,22,332,10417,1460,6536
1757.07,6,5291,4495692,2400,148,732,941,146065,2891,1489,607,7040,4349627
10.754,6,20,4442,11,275,1075,275,998,9,768,749,1440,3444
1.304,6,52,21750,29,928,46,1360,16054,23,433,51,1360,5696
4.161,6,39,7269,19,218,231,314,3383,20,440,205,1152,3886
504.596,1,12,1395,12,88,45872,119,1395,0,0,0,0,0
0.164,6,9,1002,5,213,41,213,417,4,421,41,421,585
0.011,6,10,1512,5,503,2,503,771,5,473,2,473,741
1789.571,6,183,11296,91,48,19882,208,6624,92,31,19663,31,4672
1.313,6,31,6467,16,164,87,267,1962,15,650,82,1452,4505
1.982,17,3,132,3,16,991,16,132,0,0,0,0,0
0.288,17,2,198,1,39,0,39,67,1,103,0,103,131
1779.817,6,352,22360,205,69,8724,69,12340,147,69,12190,69,10020
0.087,1,2,163,2,53,87,78,163,0,0,0,0,0
1.382,6,19,3781,10,234,153,564,1452,9,463,150,1343,2329
98.73,6,170,131648,105,1302,949,1448,118773,65,632,1539,1448,12875
1786.993,1,59,4956,59,56,30810,56,4956,0,0,0,0,0
1794.287,6,359,22778,210,69,8585,69,12609,149,69,12122,69,10169
171.511,6,31,7472,14,158,13193,267,1357,17,543,10716,1400,6115
0.36,6,11,1008,6,256,71,256,500,5,304,88,304,508
942.26,1,19,1064,19,28,52347,28,1064,0,0,0,0,0
0.014,17,2,575,1,40,0,40,68,1,479,0,479,507
368.305,6,23,1538,16,180,24553,180,1056,7,110,10403,110,482
1778.823,6,278,26778,117,65,15333,659,10500,161,121,11116,1460,16278
1750.057,17,12,498,11,14,175005,14,462,1,8,0,8,36
3.567,6,10,1687,5,100,178,100,304,5,1179,831,1179,1383
10.628,6,18,5610,10,275,1180,275,958,8,1440,801,1440,4652
101.412,6,29,7907,8,155,718,267,1106,21,372,5068,1420,6801
0.51,17,3,451,2,39,195,39,134,1,289,0,289,317
27.472,17,3,228,3,48,13736,48,228,0,0,0,0,0
1.174,17,2,778,2,361,1174,361,778,0,0,0,0,0
284.714,17,4,352,2,60,284713,60,176,2,60,284713,60,176
122.228,6,9,515,5,43,30557,43,299,4,0,40739,0,216
1.392,6,38,8266,19,321,77,1164,2730,19,433,66,1360,5536
0.85,6,20,5948,11,281,85,544,1288,9,716,94,1420,4660
0.241,6,5,200,2,0,241,0,80,3,0,67,0,120
70.143,6,33,7805,11,155,30,267,1226,22,316,3339,1420,6579
93.836,6,49,9273,25,414,624,928,2360,24,371,4074,4848,6913
349.34,6,77,15831,38,143,9437,721,4547,39,441,9188,1414,11284
230.609,6,28,7352,12,158,20964,267,1277,16,775,15369,2760,6075
1792.05,6,352,22360,206,69,8741,69,12380,146,69,12358,69,9980
127.451,6,74,24836,33,560,220,1152,17025,41,411,3179,1179,7811
1754.108,1,63,5292,63,56,28292,56,5292,0,0,0,0,0
11.78,6,1288,1017717,672,1417,17,1448,977533,616,776,18,1448,40184
83.769,6,24,10677,13,746,53,1360,3537,11,1337,8364,4428,7140
1796.194,17,698,58736,404,35,4457,288,25708,294,84,6028,308,33028
1785.344,6,356,22520,208,69,8624,69,12460,148,69,12145,69,10060
89.291,6,774,364320,406,831,220,1152,343754,368,417,242,1179,20566
32.14,6,377,336806,158,130,204,314,8728,219,1472,147,2816,328078
1799.904,17,450,39960,405,35,4455,288,25740,45,288,40022,288,14220
191.274,6,8,376,2,0,191274,0,88,6,0,6322,0,288
13.381,6,2225,2063965,1419,1376,9,1408,2017389,806,776,16,1408,46576
369.573,6,18,1242,14,180,28428,180,916,4,110,20061,110,326
61.679,6,48,29888,31,1086,2055,1408,22258,17,962,3841,3847,7630
240.326,6,43,9222,21,524,12015,1418,5818,22,250,11443,618,3404
1.218,6,58,18018,28,706,45,1360,8909,30,438,41,1360,9109
1755.052,1,177,9912,177,28,9971,28,9912,0,0,0,0,0
0.09,6,12,3462,6,75,17,75,395,6,1373,18,1448,3067
48.66,6,27,7241,9,165,6082,267,1029,18,391,2853,1420,6212
0.64,6,33,23799,19,840,35,1360,5835,14,2174,35,5406,17964
1797.838,6,1806,2115624,739,145,2436,894,49645,1067,2020,1686,9814,2065979
1743.104,6,95,7203,63,38,28114,205,4476,32,33,56220,98,2727
3.777,17,5,290,5,30,944,30,290,0,0,0,0,0
5.781,6,52,14240,26,354,231,1440,3957,26,543,223,1440,10283
9.281,6,2,1175,1,0,0,0,40,1,1095,0,1095,1135
18.881,17,43,17831,22,514,897,1350,11934,21,252,942,1350,5897
61.324,6,37,15935,22,800,2920,1440,9157,15,665,4361,1440,6778
13.645,6,855,734246,535,1298,25,1368,712002,320,776,42,1473,22244
21.543,6,25,2917,16,211,1433,211,1354,9,545,2393,904,1563
0.019,17,2,235,1,39,0,39,67,1,140,0,140,168
0.011,17,2,2756,2,1350,11,1350,2756,0,0,0,0,0
1747.219,6,97,7307,63,38,28180,205,4476,34,33,52933,98,2831
1798.2,6,356,22520,208,69,8686,69,12460,148,69,12231,69,10060
0.57,6,10,1386,6,145,114,145,389,4,833,184,833,997
18.449,6,30,12838,14,467,1419,721,3833,16,1044,1008,1420,9005
0.021,17,4,912,2,60,11,60,176,2,340,9,340,736
1775.161,17,142,11360,71,48,25359,48,5396,71,56,25359,56,5964
5.533,6,39,7285,21,218,276,314,3463,18,516,310,1179,3822
1798.652,17,142,11360,71,48,25694,48,5396,71,56,25694,56,5964
1786.248,6,104,8376,68,65,26660,65,4930,36,59,51032,59,3446
1796.499,17,448,39612,404,35,4457,288,25708,44,288,40951,288,13904
102.453,17,4,1344,4,308,34151,308,1344,0,0,0,0,0
1792.584,17,87,3648,86,14,21089,14,3612,1,8,0,8,36
1782.435,6,131,8010,71,26,25462,26,4270,60,26,30210,26,3740
523.72,17,14,1232,7,48,87285,48,532,7,72,87285,72,700
1783.823,6,460,26680,252,69,7106,69,14220,208,34,8617,64,12460
1.353,6,50,19498,27,906,52,1440,13802,23,433,53,1440,5696
126.072,2,2,64,2,8,126072,8,64,0,0,0,0,0
375.975,6,18,1242,14,180,28921,180,916,4,110,20065,110,326
1797.653,17,426,36920,385,34,4681,288,23964,41,288,44021,288,12956
244.412,17,15,1140,15,48,17458,48,1140,0,0,0,0,0
104.886,6,22,8961,11,514,89,1236,2014,11,927,10470,1460,6947
0.49,17,4,950,2,40,480,40,136,2,379,476,379,814
0.9,6,10,1687,7,100,150,100,384,3,1179,320,1179,1303
1680.578,1,14,812,14,30,129275,30,812,0,0,0,0,0
1797.191,17,83,3480,82,14,22187,14,3444,1,8,0,8,36
1.214,6,4,224,2,0,1087,0,120,2,0,1087,0,104
4.543,17,17,7519,8,540,649,1350,4549,9,302,399,1350,2970
161.767,6,9,515,5,43,40441,43,299,4,0,53920,0,216
0.558,6,10,1673,6,553,111,949,1350,4,159,185,159,323
1.697,17,6,471,3,31,653,31,177,3,70,0,70,294
0.024,17,4,304,2,37,0,37,130,2,59,0,65,174
0.018,17,3,1555,3,490,9,518,1555,0,0,0,0,0
62.992,6,25,9086,12,661,92,1360,3180,13,767,5234,1360,5906
0.197,17,2,290,1,40,0,40,68,1,194,0,194,222
272.204,17,4,352,2,60,272202,60,176,2,60,272203,60,176
91.616,6,38,13096,15,555,6544,841,3586,23,482,4157,1551,9510
13.685,6,14,2242,8,210,1954,210,844,6,545,2736,904,1398
1431.804,1,14,784,14,28,110138,28,784,0,0,0,0,0
1792.776,6,365,23087,211,69,8537,69,12787,154,69,11715,69,10300
240.229,6,56,17586,31,728,8007,1408,14731,25,193,10009,580,2855
0.067,6,11,1971,6,451,13,500,1222,5,481,16,481,749
39.816,17,22,1936,11,48,3981,48,836,11,72,3980,72,1100
756.381,2,8,256,8,8,108054,8,256,0,0,0,0,0
7.98,6,68,20558,35,554,234,1152,15811,33,427,241,1152,4747
0.008,17,3,215,2,33,0,33,122,1,65,0,65,93
286.758,17,4,352,2,60,286757,60,176,2,60,286757,60,176
0.429,1,10,280,10,0,0,0,280,0,0,0,0,0
0.444,17,6,6312,6,1024,88,1024,6312,0,0,0,0,0
240.21,6,57,21502,31,854,8006,1408,18719,26,177,9608,580,2783
1774.004,6,209,22806,131,75,13646,267,10097,78,129,23034,1460,12709
0.481,6,26,8884,13,236,40,585,1630,13,938,38,1438,7254
1772.801,6,180,15480,120,69,14897,69,8940,60,69,30042,69,6540
1.284,6,8,342,4,0,428,0,164,4,7,271,7,178
173.115,6,20834,20087321,13997,1357,12,1408,19727121,6837,776,25,1408,360200
34.115,6,6,395,3,46,8337,62,213,3,31,14735,31,182
0.077,17,2,157,1,31,0,31,59,1,70,0,70,98
10.903,17,4,352,2,48,10885,48,152,2,72,10882,72,200
1777.988,6,102,8228,68,64,26537,64,4896,34,58,53875,58,3332
1.208,6,28,5760,14,121,92,267,1295,14,650,87,1420,4465
140.313,6,105,27248,51,684,2806,1418,21884,54,103,2628,580,5364
1786.376,6,102,8296,68,65,26662,65,4930,34,59,54129,59,3366
1796.331,6,356,22520,208,69,8677,69,12460,148,69,12219,69,10060
1.476,6,51,21415,28,971,54,1460,15719,23,433,58,1460,5696
1769.997,6,99,9306,66,66,27230,66,5610,33,60,55309,60,3696
19.975,6,2014,1812502,1270,1374,15,1380,1772604,744,324,26,1024,39898
1799.903,6,376,26355,216,98,8371,469,15263,160,69,11318,69,11092
1.105,6,28,8609,15,236,65,625,2049,13,1004,75,2720,6560
21.318,6,9,577,0,0,0,0,0,9,31,2664,31,577
98.527,1,18,1008,18,28,5795,28,1008,0,0,0,0,0
1321.424,17,61,2562,61,14,22023,14,2562,0,0,0,0,0
1788.052,1,68,5712,68,56,26687,56,5712,0,0,0,0,0
1772.52,6,180,15480,120,69,14895,69,8940,60,69,30036,69,6540
9.021,6,66,20142,33,562,281,1152,15395,33,489,263,1179,4747
1799.447,1,151,16006,151,78,11996,78,16006,0,0,0,0,0
233.798,1,8,848,8,78,33399,78,848,0,0,0,0,0
12.157,6,25,8473,13,275,1013,275,1078,12,986,923,1440,7395
0.178,6,44,20691,26,1049,7,1420,15750,18,467,9,1883,4941
1795.217,6,362,23105,208,69,8672,69,12529,154,69,11733,69,10576
0.09,17,2,672,2,308,90,308,672,0,0,0,0,0
1782.232,17,330,54592,330,137,5417,391,54592,0,0,0,0,0
63.28,6,18,3282,11,393,6328,597,2157,7,190,10386,346,1125
0.049,6,12,1843,7,138,8,138,510,5,532,4,891,1333
45.011,6,3,133,2,0,45011,0,92,1,1,0,1,41
368.969,6,23,1535,16,177,24597,177,1053,7,110,10372,110,482
280.328,6,30,7432,13,158,23360,267,1317,17,543,17514,1400,6115
127.756,6,37,5419,22,180,6083,722,2236,15,299,1103,1448,3183
1772.04,1,58,4872,58,56,31088,56,4872,0,0,0,0,0
0.106,6,9,1343,5,145,26,145,349,4,830,27,830,994
1163.057,1,6,636,6,78,232611,78,636,0,0,0,0,0
285.099,6,21,1509,11,330,28509,330,910,10,83,31676,83,599
1790.894,17,87,3648,86,14,21069,14,3612,1,8,0,8,36
476.775,1,3,365,3,93,238387,117,365,0,0,0,0,0
2.055,6,14,2351,8,188,293,245,700,6,703,357,1152,1651
1786.442,6,111,8904,72,65,25161,65,5220,39,59,47007,59,3684
240.248,6,53,17972,28,801,8897,1408,15094,25,224,10010,580,2878
5.329,6,39,8399,18,188,313,722,2044,21,423,254,1380,6355
9.696,6,16,2738,9,164,1212,293,1184,7,635,1324,1179,1554
136.072,6,29,6814,14,270,10463,517,1554,15,744,9716,1418,5260
1772.514,6,204,22330,131,75,13634,267,10097,73,134,24613,2840,12233
1785.856,6,368,23276,212,69,8463,69,12896,156,69,11521,69,10380
1793.959,17,66,2766,65,14,28030,14,2730,1,8,0,8,36
11.564,6,1796,1581414,1039,1431,10,1448,1531110,757,776,15,1448,50304
0.635,17,2,152,2,48,635,48,152,0,0,0,0,0
0.26,6,23,5994,13,181,21,537,1578,10,555,26,1542,4416
1775.906,17,140,11200,70,48,25737,48,5320,70,56,25737,56,5880
3.395,6,2,88,2,0,0,0,88,0,0,0,0,0
1684.579,2,23,736,23,8,76571,8,736,0,0,0,0,0
1783.811,6,372,25919,215,99,8335,469,15154,157,69,11434,69,10765
0.016,17,2,372,1,34,0,34,62,1,282,0,282,310
194.35,17,4,240,2,32,194349,32,120,2,32,194349,32,120
34.061,6,36,8465,18,401,538,889,1992,18,521,1995,2720,6473
1791.498,1,262,14672,262,28,6863,28,14672,0,0,0,0,0
3.423,17,5,290,5,30,855,30,290,0,0,0,0,0
1795.098,6,367,25650,214,99,8427,469,15045,153,69,11807,69,10605
64.51,6,22,10183,10,153,7167,267,1327,12,1046,801,1917,8856
6.372,2,2,64,2,8,6372,8,64,0,0,0,0,0
1681.343,17,14,3799,7,30,280222,30,406,7,456,280222,463,3393
11.862,6,1854,1622886,1149,1362,10,1380,1587084,705,630,16,3303,35802
89.798,6,42,8731,20,410,617,882,2098,22,441,4269,1360,6633
1782.854,6,356,22520,208,69,8612,69,12460,148,69,12128,69,10060
486.662,17,56,20538,56,338,8848,361,20538,0,0,0,0,0
98.957,6,25,6318,9,272,97,516,1180,16,345,6591,1452,5138
541.419,2,4,128,4,8,180473,8,128,0,0,0,0,0
174.792,6,30,8872,14,158,13445,267,1357,16,763,11652,3436,7515
1785.334,6,418,25048,209,69,8583,69,12500,209,34,8583,48,12548
39.061,17,22,1936,11,48,3904,48,836,11,72,3904,72,1100
302.342,6,33,6397,17,286,18896,1314,2405,16,334,20155,1420,3992
137.596,6,40,8430,15,130,4334,267,1524,25,280,5732,1460,6906
1790.966,17,142,11360,71,48,25584,48,5396,71,56,25584,56,5964
3.243,6,7,376,4,0,1081,0,220,3,0,1521,0,156
0.182,17,2,144,1,36,0,36,64,1,52,0,52,80
3.991,17,8,1248,4,64,1326,64,368,4,192,1327,192,880
377.746,2,3,96,3,8,188873,8,96,0,0,0,0,0
149.854,6,88,55893,50,1204,3058,1448,47164,38,749,1666,1448,8729
9.991,6,15,2307,8,210,1427,210,856,7,545,1662,905,1451
1.69,17,23,6712,9,252,211,1350,2527,14,270,122,1350,4185
1756.049,6,102,7722,66,38,27016,205,4663,36,32,50165,98,3059
1797.527,6,345,21666,201,69,8987,69,11973,144,69,12570,69,9693
222.361,17,4,244,2,33,222360,33,122,2,33,222360,33,122
0.632,6,5,248,3,0,4,0,156,2,0,632,0,92
1740.87,6,87,6322,58,31,30541,31,3915,29,31,62173,31,2407
1767.934,1,11,1196,11,80,176793,88,1196,0,0,0,0,0
35.123,6,16,3265,6,92,7024,92,400,10,463,3871,1440,2865
0.198,6,10,1669,6,551,39,947,1346,4,159,65,159,323
1785.859,6,360,22749,207,69,8669,69,12558,153,69,11749,69,10191
0.046,6,7,7192,1,0,0,0,40,6,1368,8,1368,7152
0.417,6,10,1992,5,288,98,288,508,5,424,59,434,1484
1788.863,6,355,22480,207,69,8683,69,12420,148,69,12169,69,10060
47.106,6,2,142,0,0,0,0,0,2,31,47106,31,142
0.261,17,2,238,1,44,0,44,72,1,138,0,138,166
0.037,17,6,460,3,40,2,41,206,3,56,7,57,254
1599.253,1,8,448,8,28,228464,28,448,0,0,0,0,0
0.017,17,4,288,2,33,0,33,122,2,55,4,61,166
10.14,6,97,32931,49,613,211,1152,26513,48,408,210,1152,6418
367.041,6,18,1242,14,180,28233,180,916,4,110,20056,110,326
154.738,17,4,240,2,32,154736,32,120,2,32,154737,32,120
1744.736,2,25,800,25,8,72697,8,800,0,0,0,0,0
300.824,6,37,8411,20,283,15832,787,1977,17,478,539,2128,6434
1158.508,17,52,17806,52,314,22715,548,17806,0,0,0,0,0
87.112,17,16,1216,16,48,5807,48,1216,0,0,0,0,0
0.493,17,3,451,2,39,250,39,134,1,289,0,289,317
0.455,6,21,7203,12,318,39,600,1906,9,964,54,1471,5297
280.335,6,28,7352,12,158,25485,267,1277,16,603,18682,1400,6075
93.101,6,19,780,8,0,4363,0,324,11,0,9301,0,456
1790.704,17,317,51474,317,134,5666,385,51474,0,0,0,0,0
280.261,6,30,7432,13,158,23355,267,1317,17,543,17511,1400,6115
1792.466,6,356,22520,208,69,8659,69,12460,148,69,12193,69,10060
1711.222,1,8,848,8,78,244460,78,848,0,0,0,0,0
0.083,17,2,204,1,34,0,34,62,1,114,0,114,142
1798.608,17,448,39896,403,35,4474,288,25676,45,288,40023,288,14220
1786.06,6,106,8584,69,66,26265,66,5004,37,60,49610,60,3580
638.874,6,1088,1066896,349,221,1835,1002,22268,739,1395,865,1418,1044628
0.398,17,2,412,1,34,0,34,62,1,322,0,322,350
1744.666,2,19,608,19,8,96925,8,608,0,0,0,0,0
0.62,6,17,7110,10,321,68,517,1159,7,1394,72,2425,5951
300.748,6,44,10614,24,660,13076,1360,4967,20,402,451,2667,5647
1.876,6,24,6208,13,264,155,662,1848,11,783,186,1420,4360
0.082,6,10,859,6,181,16,181,489,4,77,23,133,370
240.192,6,56,18242,29,760,8578,1402,15198,27,233,9237,580,3044
138.601,6,33,18709,18,702,46,1360,4967,15,1313,9891,3527,13742
1781.763,6,356,22589,207,69,8649,69,12420,149,69,12038,69,10169
13.455,6,24,6993,13,275,1121,275,1078,11,910,834,1440,5915
5.086,6,39,7269,19,218,282,314,3383,20,513,251,1179,3886
3.022,17,25,6313,10,257,335,1350,2854,15,202,112,1350,3459
10.764,6,18,5610,10,275,1196,275,958,8,1440,809,1440,4652
2.705,17,20,5190,20,231,142,389,5190,0,0,0,0,0
1.359,6,50,19095,27,876,52,1360,13399,23,433,53,1360,5696
300.601,6,53,29980,24,190,13069,444,2053,29,1148,8646,1461,27927
112.007,17,4,1344,4,308,37335,308,1344,0,0,0,0,0
0.048,17,2,334,1,39,0,39,67,1,239,0,239,267
2.905,17,3,468,3,128,1452,128,468,0,0,0,0,0
1765.428,17,168,14018,156,30,11389,37,9090,12,382,154890,463,4928
300.641,6,30,8638,17,272,18790,750,2030,13,658,15707,2539,6608
0.042,17,2,198,1,39,0,39,67,1,103,0,103,131
364.665,6,51,8305,38,143,9855,267,2756,13,836,30387,3436,5549
366.942,6,25,1651,17,177,22933,177,1117,8,110,9172,110,534
280.014,6,30,7432,13,158,23334,267,1317,17,543,17496,1400,6115
296.864,1,4,224,4,28,98954,28,224,0,0,0,0,0
231.171,6,35,3056,25,85,9631,138,2449,10,69,25685,69,607
1775.488,17,140,11200,70,48,25731,48,5320,70,56,25731,56,5880
1765.4,6,119,11957,74,62,24183,722,6177,45,90,40116,1408,5780
240.46,6,62,18712,29,778,8587,1418,15532,33,182,7512,580,3180
0.955,17,2,572,1,39,0,39,67,1,477,0,477,505
1744.646,2,23,736,23,8,79302,8,736,0,0,0,0,0
1741.014,6,87,6322,58,31,30544,31,3915,29,31,62178,31,2407
1794.396,17,343,56472,343,136,5246,366,56472,0,0,0,0,0
0.091,17,2,586,1,46,0,46,74,1,484,0,484,512
0.011,17,2,309,1,45,0,45,73,1,208,0,208,236
3.145,6,25,8056,12,164,247,267,1288,13,869,220,1448,6768
4.0,17,4,296,4,46,1333,46,296,0,0,0,0,0
340.009,6,86,30167,44,594,7907,1418,11216,42,761,8292,1418,18951
496.145,6,835,174250,421,264,1041,1360,109878,414,451,1201,2720,64372
1799.78,17,446,39832,401,35,4499,288,25612,45,288,40020,288,14220
1740.144,17,30,1710,30,29,60004,29,1710,0,0,0,0,0
36.842,6,25,7097,12,155,3349,267,1266,13,589,3069,3426,5831
1742.322,6,95,7203,63,38,28101,205,4476,32,33,56195,98,2727
1750.529,17,12,498,11,14,175052,14,462,1,8,0,8,36
11.477,6,90,26973,45,555,260,1152,20691,45,407,255,1152,6282
0.162,17,4,304,2,37,1,37,130,2,59,122,65,174
1.609,6,49,19308,27,895,61,1360,13652,22,529,66,4075,5656
240.154,6,38,4804,18,181,14126,517,2035,20,215,12639,851,2769
0.962,6,54,13970,25,551,40,1429,4892,29,416,33,1460,9078
248.508,6,452,404218,158,538,1582,1418,14776,294,1350,848,1418,389442
0.855,6,54,13933,26,549,34,1429,4904,28,438,31,1460,9029
0.907,6,6,248,4,0,302,0,164,2,0,197,0,84
2.254,6,15,2391,9,188,281,245,740,6,703,401,1152,1651
0.014,17,2,337,1,36,0,36,64,1,245,0,245,273
14.132,6,23,2773,13,211,1177,211,1158,10,545,1211,904,1615
59.689,17,4,240,2,32,59688,32,120,2,32,59688,32,120
280.463,6,30,7432,13,158,23371,267,1317,17,603,17523,2076,6115
1777.704,17,79,3312,78,14,23087,14,3276,1,8,0,8,36
1793.072,6,359,22709,209,69,8620,69,12569,150,69,12031,69,10140
504.355,2,5,160,5,8,126088,8,160,0,0,0,0,0
1137.001,1,112,11872,112,78,10243,78,11872,0,0,0,0,0
0.026,6,3,168,1,0,0,0,52,2,0,11,0,116
300.699,6,26,8009,14,173,23130,385,1431,12,849,21861,1368,6578
165.707,17,16,1408,8,48,23671,48,608,8,72,23670,72,800
126.79,6,24,6343,9,220,6897,516,1246,15,374,9047,1452,5097
0.119,6,15,4864,9,290,14,517,1045,6,1166,19,1501,3819
1769.386,6,100,9357,67,65,26808,65,5694,33,59,55289,59,3663
300.661,6,38,8548,20,299,15824,852,2043,18,444,498,2128,6505
15.996,17,6,528,3,48,7993,48,228,3,72,7992,72,300
0.17,6,3,160,2,0,170,0,100,1,0,0,0,60
132.683,6,8,435,3,0,66341,0,152,5,7,33095,7,283
281.286,6,31,7679,13,143,23440,267,1386,18,506,16522,1400,6293
1798.379,1,345,28980,345,56,5227,56,28980,0,0,0,0,0
1581.202,6,184,12650,68,46,23600,46,5342,116,46,13749,46,7308
13.777,6,27,4902,14,154,1042,722,1855,13,473,1133,2026,3047
1771.187,6,111,10224,70,66,25669,66,5920,41,60,44276,60,4304
125.445,6,14,870,10,31,13938,31,648,4,31,40115,31,222
0.009,6,4,212,2,0,4,0,112,2,0,7,0,100
283.12,6,30,7436,14,158,21778,267,1361,16,603,18699,1400,6075
6.765,6,18,3580,11,211,645,211,1225,7,665,1126,904,2355
1791.548,6,356,22520,208,69,8654,69,12460,148,69,12187,69,10060
255.133,17,4,352,2,60,255132,60,176,2,60,255132,60,176
1260.604,2,16,512,16,8,84040,8,512,0,0,0,0,0
1797.277,17,449,39928,404,35,4459,288,25708,45,288,40021,288,14220
31.629,6,7,336,1,0,0,0,48,6,0,6323,0,288
974.128,6,123,9610,46,73,21644,375,4644,77,49,12815,143,4966
0.083,17,2,348,1,39,0,39,67,1,253,0,253,281
0.721,6,7,1567,5,100,180,100,304,2,1179,260,1179,1263
0.026,17,2,586,1,46,0,46,74,1,484,0,484,512
2.895,6,21,3253,12,180,263,595,1712,9,266,360,580,1541
1790.513,6,359,22709,209,69,8608,69,12569,150,69,12016,69,10140
20.16,6,21,5418,12,107,1832,159,1074,9,773,2516,1418,4344
1.929,17,2,428,1,34,0,34,62,1,338,0,338,366
1772.65,6,180,15480,120,69,14896,69,8940,60,69,30038,69,6540
0.045,17,4,368,2,32,28,32,120,2,96,0,96,248
0.927,6,10,1687,7,100,154,100,384,3,1179,330,1179,1303
1714.586,17,29,20393,29,675,61235,1451,20393,0,0,0,0,0
1744.619,2,14,448,14,8,134201,8,448,0,0,0,0,0
62.19,6,41,17382,23,828,2826,1408,10327,18,677,3645,3847,7055
280.505,6,30,7432,13,158,23375,267,1317,17,603,17525,2760,6115
64.808,6,44,8856,19,360,3600,734,1886,25,297,2686,1440,6970
339.348,2,6,192,6,8,67869,8,192,0,0,0,0,0
1.192,6,25,8056,12,164,92,267,1288,13,869,84,1402,6768
1796.639,17,448,39896,403,35,4469,288,25676,45,288,40022,288,14220
11.953,17,2,680,2,312,11953,318,680,0,0,0,0,0
290.113,17,4,352,2,60,290111,60,176,2,60,290112,60,176
4.175,6,38,7229,19,218,231,314,3383,19,513,217,1179,3846
0.484,17,3,451,2,39,172,39,134,1,289,0,289,317
1787.911,6,358,22669,209,69,8595,69,12500,149,69,12080,69,10169
3.68,6,34,8135,16,188,245,721,1962,18,605,200,1420,6173
86.578,17,4,352,2,60,86577,60,176,2,60,86577,60,176
0.394,6,69,57142,28,198,14,250,2256,41,1352,8,1440,54886
0.073,17,6,816,3,60,0,60,264,3,156,0,156,552
0.339,6,10,968,5,256,83,256,460,5,304,83,304,508
1743.793,6,96,7255,62,38,28586,205,4424,34,33,52832,98,2831
1754.042,6,185,14197,96,88,18463,208,9738,89,31,19929,31,4459
7.697,6,8,4730,4,142,2565,142,306,4,1420,2504,1420,4424
1796.349,6,244,35804,152,302,11896,302,26032,92,83,19740,83,9772
0.405,6,10,1060,5,517,101,517,785,5,7,101,7,275
3.484,6,22,6657,10,248,376,517,1523,12,643,310,1368,5134
1791.612,6,324,52237,206,302,8739,302,38516,118,83,15312,83,13721
1789.27,6,356,22520,208,69,8643,69,12460,148,69,12171,69,10060
1681.105,17,13,534,11,14,168091,14,462,2,8,1680928,8,72
280.247,6,29,7733,12,158,25477,267,1277,17,577,17514,1400,6456
1738.808,6,132,8667,75,54,23497,208,5488,57,31,31044,31,3179
0.853,6,4,220,2,0,853,0,100,2,0,305,0,120
60.332,6,4,168,3,0,30166,0,124,1,0,0,0,44
1.217,6,41,10591,21,517,60,1360,5015,20,433,55,1360,5576
11.505,6,25,8473,13,275,958,275,1078,12,986,742,1440,7395
26.498,6,12,2556,4,844,8830,1094,1916,8,212,3784,212,640
0.113,6,131,114020,77,199,1,255,4971,54,2042,2,7040,109049
0.011,17,4,352,2,37,1,37,130,2,83,0,89,222
11.785,6,100,31190,51,597,235,1152,24748,49,447,240,1179,6442
1.097,17,2,204,1,34,0,34,62,1,114,0,114,142
7.578,6,27,7578,14,138,582,267,1552,13,1326,613,2519,6026
1.167,6,23,6572,13,345,95,1065,2252,10,979,127,1691,4320
1779.576,1,9,969,9,79,222447,93,969,0,0,0,0,0
2.422,6,54,20648,27,977,93,1440,14792,27,433,86,1440,5856
1795.079,17,80,3354,79,14,23013,14,3318,1,8,0,8,36
0.123,6,10,1677,6,555,21,951,1354,4,159,32,159,323
0.031,17,2,235,1,36,0,36,64,1,143,0,143,171
1766.68,6,124,12285,76,62,23555,721,6287,48,87,37583,1448,5998
1792.779,17,176,11264,176,36,10244,36,11264,0,0,0,0,0
1.325,6,49,18951,26,937,53,1460,13255,23,433,51,1460,5696
38.927,17,44,6468,22,48,1850,48,1672,22,190,1850,308,4796
14.666,6,16,2307,9,329,1833,595,1135,7,396,2289,580,1172
0.003,6,2,357,2,138,3,143,357,0,0,0,0,0
1799.05,17,449,39928,404,35,4464,288,25708,45,288,40020,288,14220
7.628,6,25,5075,13,243,635,597,2131,12,383,676,1408,2944
9.056,6,92,28855,46,574,201,1152,22517,46,449,195,1179,6338
661.753,2,6,192,6,8,132350,8,192,0,0,0,0,0
1789.035,1,339,28476,339,56,5293,56,28476,0,0,0,0,0
0.18,17,2,2380,2,1162,180,1162,2380,0,0,0,0,0
1744.681,2,28,896,28,8,64617,8,896,0,0,0,0,0
1.37,6,9,492,5,0,342,0,268,4,0,223,0,224
1.015,6,10,1687,7,100,169,100,384,3,1179,377,1179,1303
1779.777,1,307,25788,307,56,5816,56,25788,0,0,0,0,0
4.167,17,16,16856,5,836,1041,1350,4323,11,1111,409,1350,12533
1771.081,6,99,9240,66,65,27247,65,5577,33,59,55344,59,3663
1.011,6,23,6513,13,333,83,1007,2193,10,979,111,1699,4320
535.554,1,18,1008,18,28,31503,28,1008,0,0,0,0,0
240.265,6,57,18280,31,813,8008,1402,15454,26,162,9610,580,2826
29.566,6,53,13461,25,164,1231,721,2814,28,634,1087,1440,10647
295.076,1,4,224,4,28,98358,28,224,0,0,0,0,0
384.888,6,25,1654,17,180,24055,180,1120,8,110,9228,110,534
0.055,6,12,3462,6,75,10,75,395,6,1373,10,1448,3067
0.02,6,5,260,2,0,10,0,104,3,0,9,0,156
1638.334,2,13,416,13,8,136527,8,416,0,0,0,0,0
3.589,6,2,1494,1,0,0,0,40,1,1414,0,1414,1454
1782.287,17,306,65798,306,187,5843,422,65798,0,0,0,0,0
1680.936,17,12,498,11,14,168093,14,462,1,8,0,8,36
230.164,6,35,17828,19,795,12786,1408,8938,16,1148,15343,2251,8890
0.068,17,2,338,1,33,0,33,61,1,249,0,249,277
6.538,6,653,615916,439,1339,14,1368,600124,214,931,29,2841,15792
251.474,2,2,64,2,8,251474,8,64,0,0,0,0,0
3.002,17,4,1128,2,41,2984,41,138,2,467,2990,489,990
151.927,6,22,9696,11,380,73,832,1613,11,1090,15179,1440,8083
0.222,17,3,3140,3,1018,111,1438,3140,0,0,0,0,0
1743.233,6,95,7203,63,38,28116,205,4476,32,33,56221,98,2727
543.971,2,4,128,4,8,181323,8,128,0,0,0,0,0
1771.07,6,99,9306,66,66,27247,66,5610,33,60,55343,60,3696
1726.014,17,12,498,11,14,172601,14,462,1,8,0,8,36
300.781,6,48,10357,24,564,13077,1460,4440,24,290,637,1460,5917
0.129,6,2,116,1,0,0,0,64,1,0,0,0,52
2.275,17,3,3161,3,1025,1137,1438,3161,0,0,0,0,0
423.439,2,3,96,3,8,211719,8,96,0,0,0,0,0
732.07,6,1653,1529082,596,180,1230,936,36534,1057,1397,693,1478,1492548
0.131,17,2,152,1,48,0,48,76,1,48,0,48,76
1.369,6,53,21632,29,919,48,1360,15896,24,433,51,1360,5736
0.455,6,12,1653,6,288,86,288,548,6,426,54,434,1105
280.484,6,27,7312,12,158,25498,267,1277,15,775,20025,3465,6035
1740.91,6,94,6815,61,31,29015,31,4126,33,31,54403,31,2689
1770.52,17,232,57797,232,221,7664,422,57797,0,0,0,0,0
1792.85,17,142,11360,71,48,25611,48,5396,71,56,25611,56,5964
864.708,1,8,448,8,28,123529,28,448,0,0,0,0,0
2.471,6,52,19430,29,893,88,1460,13722,23,433,101,1460,5708
373.435,6,16,1138,12,180,33948,180,812,4,110,20057,110,326
327.662,1,6,336,6,28,65532,28,336,0,0,0,0,0
1784.654,6,102,8296,68,65,26636,65,4930,34,59,54077,59,3366
1769.159,6,213,27496,115,304,15518,304,18608,98,83,18232,83,8888
1785.239,17,87,3648,86,14,21002,14,3612,1,8,0,8,36
293.786,6,30,7432,13,158,24482,267,1317,17,543,18359,1400,6115
1785.857,6,357,22560,208,69,8627,69,12460,149,69,12066,69,10100
24.764,6,22,3222,13,183,2063,517,1601,9,381,3094,499,1621
17.82,1,4,224,4,28,5940,28,224,0,0,0,0,0
1799.572,17,449,39928,404,35,4465,288,25708,45,288,40022,288,14220
0.08,6,2,402,1,0,0,0,40,1,322,0,322,362
1.013,6,10,1687,7,100,168,100,384,3,1179,377,1179,1303
1776.997,1,112,6272,112,28,16008,28,6272,0,0,0,0,0
11.822,6,20,4442,10,275,1313,275,958,10,768,1205,1440,3484
4.622,6,13,3122,6,92,924,92,400,7,1165,731,1408,2722
0.387,6,27,9076,13,252,32,647,1692,14,831,28,1448,7384
0.934,17,4,1108,2,30,924,30,116,2,468,921,468,992
10.765,6,19,4350,10,275,1196,275,958,9,755,744,1414,3392
132.212,6,14,3144,7,92,22035,92,452,7,464,21810,1448,2692
4.116,6,34,6169,17,206,257,314,2744,17,548,238,1179,3425
0.0,6,3,120,0,0,0,0,0,3,0,0,0,120
0.601,6,14,1745,7,288,70,288,600,7,426,71,434,1145
1681.918,17,14,1036,7,30,280312,30,406,7,62,280311,62,630
289.764,6,233,36527,128,304,2281,304,25448,105,83,2786,83,11079
1784.97,17,82,3438,81,14,22312,14,3402,1,8,0,8,36
296.164,6,43,3156,18,66,17413,334,1587,25,47,12334,78,1569
11.291,6,1785,1559766,1085,1384,10,1420,1527545,700,467,16,1883,32221
370.892,6,23,1538,16,180,24726,180,1056,7,110,10381,110,482
1792.549,6,356,22520,208,69,8659,69,12460,148,69,12191,69,10060
176.979,6,312,289082,111,208,1608,425,6594,201,1402,884,1418,282488
1744.568,2,30,960,30,8,60157,8,960,0,0,0,0,0
11.027,6,22,4526,12,275,1002,275,1038,10,768,694,1440,3488
5.019,17,6,1398,6,205,1003,205,1398,0,0,0,0,0
0.036,6,11,3653,6,171,6,171,491,5,1447,8,2676,3162
1668.239,1,8,448,8,28,238319,28,448,0,0,0,0,0
336.471,6,9,1708,6,298,67294,413,1135,3,151,168147,269,573
282.542,17,2,2187,2,1065,282542,1444,2187,0,0,0,0,0
734.951,6,325,120439,167,741,2510,1460,95868,158,249,4680,1638,24571
67.047,6,6,252,3,0,33523,0,124,3,0,33418,0,128
0.315,6,26,9033,13,257,26,667,1715,13,947,25,1408,7318
1794.209,17,144,11520,72,48,25270,48,5472,72,56,25270,56,6048
1771.096,6,107,9869,69,65,26045,65,5769,38,59,47864,59,4100
63.873,6,4,574,4,103,21291,138,574,0,0,0,0,0
0.446,6,14,1733,7,288,70,288,588,7,426,41,434,1145
2.876,17,4,624,4,128,958,128,624,0,0,0,0,0
1.121,6,25,8056,12,164,86,267,1288,13,869,79,1408,6768
1773.152,6,180,15480,120,69,14900,69,8940,60,69,30047,69,6540
31.458,6,7,308,1,0,0,0,44,6,0,6274,0,264
0.005,17,2,453,1,46,0,46,74,1,351,0,351,379
1787.85,17,140,11200,70,48,25910,48,5320,70,56,25910,56,5880
1793.638,17,72,3018,71,14,25623,14,2982,1,8,0,8,36
59.346,6,6,4560,2,0,59346,0,80,4,1440,19136,1440,4480
1.289,6,41,11068,21,577,64,1360,5492,20,476,58,2715,5576
301.215,6,412,328404,249,1374,1214,1448,301709,163,517,1745,1448,26695
61.728,6,52,31506,32,1101,1991,1440,23711,20,749,3236,1440,7795
5.015,6,42,7389,22,218,238,314,3503,20,440,250,1152,3886
128.815,6,23,10128,13,549,54,1360,2749,10,1393,14297,3934,7379
103.062,6,21,9086,12,304,78,597,1425,9,1457,12860,4441,7661
0.545,17,2,925,1,548,0,548,576,1,321,0,321,349
1786.967,6,104,8376,68,65,26671,65,4930,36,59,51052,59,3446
1600.906,1,8,448,8,28,228700,28,448,0,0,0,0,0
97.467,6,21,10198,11,304,106,597,1385,10,1400,10801,2881,8813
1782.481,1,52,2912,52,28,34950,28,2912,0,0,0,0,0
298.689,1,4,224,4,28,99563,28,224,0,0,0,0,0
1.137,6,17,5164,9,150,142,174,664,8,835,135,1452,4500
103.863,6,8,475,3,31,51931,31,151,5,31,25956,31,324
2.092,17,18,7437,9,496,261,1350,4717,9,274,253,1350,2720
6.173,6,1841,1695438,1155,1389,5,1408,1655102,686,931,8,2801,40336
0.586,6,12,1653,6,288,115,288,548,6,426,60,434,1105
841.631,17,8,1568,8,168,120233,168,1568,0,0,0,0,0
221.39,17,4,240,2,32,221389,32,120,2,32,221389,32,120
0.372,17,2,198,1,37,0,37,65,1,105,0,105,133
0.404,6,2,1520,1,0,0,0,40,1,1440,0,1440,1480
18.832,17,4,585,4,118,6277,335,585,0,0,0,0,0
1783.577,17,185,40562,185,191,9693,356,40562,0,0,0,0,0
0.019,17,4,352,2,37,10,37,130,2,83,12,89,222
4.507,6,23,6464,11,262,446,517,1368,12,744,405,1418,5096
0.665,6,26,8995,13,252,55,647,1692,13,945,49,1448,7303
0.901,6,10,1687,7,100,150,100,384,3,1179,325,1179,1303
1797.582,17,449,39928,404,35,4460,288,25708,45,288,40021,288,14220
1.51,17,2,778,2,361,1510,361,778,0,0,0,0,0
88.66,17,4,304,2,48,88659,64,152,2,48,88659,64,152
51.748,6,1149,1019599,711,1356,72,1368,990297,438,899,117,1473,29302
1798.65,17,449,39928,404,35,4463,288,25708,45,288,40022,288,14220
0.097,6,9,1050,5,261,24,261,465,4,421,26,421,585
32.686,6,49,10300,24,533,860,910,3187,25,435,1356,2720,7113
29.083,17,96,65259,42,387,708,1350,17470,54,856,548,1350,47789
23.744,6,15,2245,9,324,2968,585,1125,6,396,4746,580,1120
3.32,6,23,6595,12,350,301,1088,2235,11,783,331,1420,4360
31.021,17,4,352,2,60,31020,60,176,2,60,31020,60,176
1740.663,17,30,31771,30,1031,60022,1064,31771,0,0,0,0,0
0.925,17,4,368,2,32,627,32,120,2,96,560,96,248
0.025,1,4,416,0,0,0,0,0,4,76,8,76,416
98.48,6,38,8169,16,140,6565,267,1633,22,353,4682,1917,6536
0.144,17,2,152,1,48,0,48,76,1,48,0,48,76
1795.008,17,447,39864,402,35,4476,288,25644,45,288,40019,288,14220
8.087,17,4,352,2,48,8078,48,152,2,72,8077,72,200
1737.458,1,56,4704,0,0,0,0,0,56,56,31590,56,4704
0.03,6,11,1686,6,131,6,131,451,5,967,7,967,1235
1796.584,17,142,11360,71,48,25665,48,5396,71,56,25665,56,5964
1.296,6,45,18670,27,861,49,1360,13174,18,529,65,4075,5496
0.155,17,2,128,1,36,0,36,64,1,36,0,36,64
1787.412,6,104,8376,68,65,26677,65,4930,36,59,51064,59,3446
0.014,6,2,116,2,0,0,0,116,0,0,0,0,0
317.285,6,73,18492,37,311,8813,1460,9287,36,337,9059,1629,9205
1799.384,1,58,4872,58,56,31568,56,4872,0,0,0,0,0
0.38,6,27,9076,13,252,31,647,1692,14,831,28,1408,7384
1.023,6,28,4739,13,222,84,584,2243,15,242,72,580,2496
1247.847,1,40,2240,40,28,31996,28,2240,0,0,0,0,0
1.114,6,25,8056,12,164,86,267,1288,13,869,78,1408,6768
61.056,17,4,240,2,32,61054,32,120,2,32,61055,32,120
240.624,6,297,380505,151,461,1604,1402,11551,146,2716,1659,11216,368954
248.085,17,4,352,2,60,248084,60,176,2,60,248083,60,176
0.885,6,11,1727,7,100,147,100,384,4,589,210,1152,1343
1772.08,6,180,15480,120,69,14891,69,8940,60,69,30034,69,6540
1787.442,6,103,8404,68,66,26678,66,4964,35,60,52568,60,3440
0.452,6,48,16381,26,844,18,1420,11214,22,355,20,1420,5167
1798.84,6,365,25032,213,94,8485,469,14536,152,69,11911,69,10496
4.738,17,4,854,2,39,4733,39,134,2,332,4733,332,720
0.175,17,2,2752,2,1348,175,1348,2752,0,0,0,0,0
121.491,6,31,5713,10,165,2204,722,1686,21,225,6066,1448,4027
1121.204,17,10,740,5,30,280297,30,290,5,62,280295,62,450
1767.074,1,65,5460,0,0,0,0,0,65,56,27610,56,5460
82.655,6,24,8675,12,633,86,1460,3045,12,856,7496,1547,5630
0.0,6,1,52,0,0,0,0,0,1,0,0,0,52
0.023,17,5,1000,3,60,8,60,264,2,340,11,340,736
25.027,6,15,2245,9,324,3128,585,1125,6,396,4998,580,1120
1773.437,1,58,4872,58,56,31112,56,4872,0,0,0,0,0
0.052,6,10,767,5,186,12,186,454,5,45,13,45,313
2.028,17,3,366,3,94,1014,94,366,0,0,0,0,0
1799.657,1,162,9072,162,28,11177,28,9072,0,0,0,0,0
17.842,17,30,12853,14,611,1369,1350,8950,16,215,1187,1350,3903
413.682,6,43,8453,21,172,20680,517,1960,22,669,19696,1368,6493
76.18,6,15,2379,7,327,118,717,1283,8,382,10863,612,1096
1758.45,6,190,11607,95,47,18706,208,6877,95,31,18704,31,4730
1.14,6,23,7952,12,164,88,267,1288,11,1216,97,3819,6664
4.165,17,5,295,5,31,1041,31,295,0,0,0,0,0
1791.53,17,180,14040,180,50,10008,50,14040,0,0,0,0,0
93.633,6,28,7355,13,152,7802,267,1444,15,530,6687,3417,5911
1786.071,6,102,8296,68,65,26657,65,4930,34,59,54120,59,3366
0.035,6,17,6068,10,88,3,88,556,7,1740,5,1880,5512
1681.364,17,14,1036,7,30,280226,30,406,7,62,280225,62,630
1773.787,6,181,15589,121,69,14781,69,9049,60,69,30061,69,6540
3.026,17,2,144,2,44,3026,44,144,0,0,0,0,0
386.253,6,18,1242,14,180,29711,180,916,4,110,20070,110,326
1.958,6,4,191,2,31,1958,31,111,2,0,1,0,80
125.295,6,34,7935,12,155,28,267,1266,22,340,5966,3417,6669
1784.778,6,102,8364,68,66,26638,66,4964,34,60,54081,60,3400
1795.518,17,447,39296,404,35,4455,288,25708,43,288,40973,288,13588
1747.04,6,147,9608,78,54,22688,208,5577,69,31,25685,31,4031
1680.723,1,15,840,15,28,120051,28,840,0,0,0,0,0
137.668,6,35,8018,14,162,10589,267,1543,21,401,6882,4837,6475
1643.431,6,127,16352,78,87,21343,267,6873,49,170,18951,1460,9479
2.902,17,26,13928,12,442,263,1350,5640,14,564,218,1350,8288
298.988,1,4,224,4,28,99662,28,224,0,0,0,0,0
15.127,6,5,706,3,46,7563,46,166,2,460,14915,460,540
1792.165,17,180,14040,180,50,10012,50,14040,0,0,0,0,0
280.19,6,31,7472,14,158,21553,267,1357,17,543,17509,1400,6115
0.537,6,22,7342,13,335,44,668,2026,9,1210,62,1946,5316
1786.306,17,87,3648,86,14,21015,14,3612,1,8,0,8,36
0.025,17,2,198,1,39,0,39,67,1,103,0,103,131
0.201,6,2,100,1,0,0,0,60,1,0,0,0,40
14.145,6,21,6825,12,275,1285,275,1038,9,1353,1138,1440,5787
7.788,6,19,9539,9,275,973,275,643,10,1414,801,1414,8896
300.736,6,38,8372,20,266,15828,721,1899,18,441,501,1460,6473
2.036,6,20,3833,11,234,203,564,1504,9,463,233,1343,2329
280.302,6,29,7392,13,158,23358,267,1317,16,603,18681,2036,6075
3.118,17,2,148,2,46,3118,46,148,0,0,0,0,0
1782.518,17,83,3480,82,14,22006,14,3444,1,8,0,8,36
210.499,6,20,3813,7,79,4148,92,689,13,293,17526,1408,3124
0.192,6,4,232,2,0,4,0,104,2,0,192,0,128
18.096,17,6,1236,3,48,9043,48,228,3,308,9041,308,1008
1786.553,6,111,8910,71,66,25522,66,5150,40,60,45806,60,3760
1792.682,17,144,11520,72,48,25248,48,5472,72,56,25247,56,6048
3.954,17,8,736,4,32,1315,32,240,4,96,1310,96,496
0.514,6,27,7296,13,155,42,267,1301,14,603,37,1400,5995
0.084,6,21,6619,11,506,8,922,2099,10,665,8,1408,4520
3.356,6,4,1600,2,0,3023,0,80,2,1440,1583,1440,1520
1784.794,6,129,9448,68,26,26638,26,4080,61,106,29745,427,5368
0.554,6,20,7229,13,334,46,663,2021,7,1209,83,1946,5208
0.028,17,2,259,1,53,0,53,81,1,150,0,150,178
764.577,6,49,3786,31,65,25485,65,2150,18,57,44969,59,1636
10.29,6,1507,1397966,988,1364,10,1432,1372915,519,534,19,3303,25051
0.327,17,2,136,1,32,0,32,60,1,48,0,48,76
0.941,6,22,6633,10,181,81,267,1128,12,717,74,2036,5505
195.244,1,4,762,4,162,65081,351,762,0,0,0,0,0
0.382,6,7,383,4,0,127,0,216,3,7,103,7,167
3.605,17,5,290,5,30,901,30,290,0,0,0,0,0
35.538,6,32,8952,14,158,2733,267,1357,18,687,2084,2760,7595
251.442,2,3,96,3,8,125721,8,96,0,0,0,0,0
5.515,6,40,7309,20,218,290,314,3423,20,513,276,1179,3886
1745.634,6,109,8172,69,38,25671,205,4850,40,32,44750,98,3322
148.586,6,32,17653,18,708,32,1360,4306,14,1419,11420,4416,13347
13.853,6,1522,1361158,926,1389,14,1448,1325502,596,776,22,1448,35656
1777.524,6,108,8784,69,66,26140,66,5004,39,60,46774,60,3780
1770.868,6,110,9966,70,63,25664,64,5820,40,57,45404,58,4146
0.04,17,4,284,2,32,0,32,120,2,54,11,60,164
216.805,6,8,2017,5,355,54201,413,1267,3,210,108298,269,750
0.544,6,23,7420,13,337,45,674,2032,10,969,55,1483,5388
76.258,17,8,704,4,48,25416,48,304,4,72,25416,72,400
0.045,17,4,680,2,33,0,33,122,2,251,36,323,558
801.848,6,78,9895,38,82,21669,517,3062,40,335,20558,2412,6833
1668.468,1,7,392,7,28,278078,28,392,0,0,0,0,0
0.004,17,2,322,1,33,0,33,61,1,233,0,233,261
8.826,6,17,5331,9,275,1103,275,643,8,1089,1122,1420,4688
1.892,6,2,1253,1,0,0,0,40,1,1173,0,1173,1213
5.016,17,3,208,2,36,5000,36,128,1,52,0,52,80
21.358,6,161,60429,83,682,260,1152,52470,78,439,273,1179,7959
0.268,17,4,304,2,48,129,48,152,2,48,140,48,152
42.621,17,24,2112,12,48,3870,48,912,12,72,3868,72,1200
43.007,17,24,2112,12,48,3903,48,912,12,72,3904,72,1200
0.133,17,2,144,1,36,0,36,64,1,52,0,52,80
1791.755,17,144,11520,72,48,25235,48,5472,72,56,25235,56,6048
1772.506,6,180,15480,120,69,14895,69,8940,60,69,30035,69,6540
4.687,6,38,7245,19,218,260,314,3383,19,516,245,1179,3862
1778.438,1,83,8798,83,78,21688,78,8798,0,0,0,0,0
21.154,17,55,21547,26,529,845,1350,14499,29,215,754,1350,7048
1799.479,17,448,39896,403,35,4476,288,25676,45,288,40015,288,14220
282.133,6,28,7352,13,158,23511,267,1317,15,603,20128,2036,6035
66.019,6,27,7177,13,155,5501,267,1306,14,530,5077,2840,5871
1787.364,6,104,8376,68,65,26677,65,4930,36,59,51065,59,3446
0.063,17,2,152,1,48,0,48,76,1,48,0,48,76
1770.632,1,58,4872,58,56,31063,56,4872,0,0,0,0,0
5.187,17,4,240,2,32,5186,32,120,2,32,5186,32,120
4.274,17,25,24010,9,772,534,1350,7207,16,1022,273,1350,16803
71.11,6,21,860,10,0,6118,0,408,11,0,7109,0,452
14.961,6,18,6930,4,112,4983,112,280,14,674,1150,1420,6650
216.679,17,4,240,2,32,216678,32,120,2,32,216678,32,120
89.686,17,5,1672,5,306,22421,308,1672,0,0,0,0,0
2.435,17,2,685,1,308,0,308,336,1,321,0,321,349
5.022,17,4,558,2,36,5013,36,128,2,187,5011,187,430
0.507,17,3,451,2,39,54,39,134,1,289,0,289,317
1.992,17,2,672,2,308,1992,308,672,0,0,0,0,0
8.971,6,71,20678,36,554,256,1152,15851,35,427,256,1152,4827
2.968,17,3,468,3,128,1484,128,468,0,0,0,0,0
1.594,17,6,540,3,30,653,30,174,3,94,0,94,366
0.08,17,3,422,2,32,29,32,120,1,274,0,274,302
61.84,6,75,49192,44,1204,1438,1448,40850,31,746,2053,1448,8342
959.998,6,12,1038,12,46,87272,62,1038,0,0,0,0,0
701.909,17,10,2562,5,31,175474,37,297,5,425,175474,463,2265
200.471,17,4,352,2,60,200470,60,176,2,60,200470,60,176
33.858,6,30,5041,15,154,2418,721,1858,15,399,2402,1368,3183
0.648,6,10,861,5,222,156,222,426,5,231,158,231,435
0.004,17,2,428,1,40,0,40,68,1,332,0,332,360
1798.11,17,450,39960,405,35,4450,288,25740,45,288,40022,288,14220
0.078,6,6,312,0,0,0,0,0,6,0,0,0,312
0.069,17,4,384,2,60,68,60,176,2,76,68,76,208
1786.83,6,104,8504,69,66,26276,66,5004,35,60,52549,60,3500
0.048,17,4,284,2,32,28,32,120,2,54,23,60,164
1797.126,17,448,39100,404,34,4459,288,25444,44,282,40953,288,13656
4.988,6,62,42390,31,262,165,262,1882,31,1388,165,1444,40508
1.895,6,17,6104,6,186,377,267,621,11,629,188,1420,5483
1795.776,6,184,17079,122,83,14841,965,9985,62,74,29434,405,7094
27.45,6,18,788,8,0,3921,0,348,10,0,2450,0,440
1.612,17,12,6498,6,615,322,1350,3860,6,411,124,1350,2638
1743.692,1,15,840,15,28,124549,28,840,0,0,0,0,0
0.064,17,2,172,1,50,0,50,78,1,66,0,66,94
0.647,6,10,766,5,185,133,185,453,5,45,110,45,313
1.346,6,10,1687,7,100,224,100,384,3,1179,548,1179,1303
16.482,17,608,528632,224,59,73,1350,19641,384,1297,43,1350,508991
1798.612,6,419,25082,210,69,8605,69,12540,209,34,8647,69,12542
238.777,6,30,7432,13,158,19898,267,1317,17,543,14921,1400,6115
4.982,17,6,1398,6,205,996,205,1398,0,0,0,0,0
9.928,17,2,150,2,47,9928,47,150,0,0,0,0,0
9.386,6,78,24325,39,550,247,1152,18624,39,459,238,1179,5701
5.444,6,780,674673,479,1336,10,1368,654357,301,931,17,2736,20316
6.308,1,4,224,4,28,2102,28,224,0,0,0,0,0
0.562,17,4,880,2,39,548,39,134,2,345,26,345,746
1787.206,6,129,14498,81,81,22340,503,6257,48,143,38023,1420,8241
1772.71,6,181,15589,120,69,14896,69,8940,61,69,29539,69,6649
85.067,6,25,11421,14,579,6543,1440,4215,11,1104,8489,1440,7206
4.264,2,2,64,2,8,4264,8,64,0,0,0,0,0
1.186,6,24,8004,13,164,85,267,1340,11,1216,102,3819,6664
280.187,6,28,7352,12,158,25471,267,1277,16,603,18676,1400,6075
66.299,6,32,18487,17,708,50,1360,4310,15,1356,4725,3510,14177
301.261,2,3,96,3,8,150630,8,96,0,0,0,0,0
1796.789,6,373,26097,216,98,8357,469,15263,157,69,11515,69,10834
340.444,2,6,296,6,25,68088,32,296,0,0,0,0,0
35.718,6,31,5092,15,154,2551,722,1858,16,342,2343,1448,3234
1799.837,1,56,4704,0,0,0,0,0,56,56,32724,56,4704
5.89,6,617,540060,384,1338,14,1368,523280,233,776,24,1473,16780
1.235,6,50,19290,27,891,47,1360,13594,23,433,48,1360,5696
835.028,1,32,1792,32,28,26936,28,1792,0,0,0,0,0
280.3,6,30,7432,14,158,21561,267,1357,16,603,18679,2800,6075
340.916,6,37,7265,16,152,15525,502,1710,21,313,17041,1420,5555
5.161,6,37,7477,19,231,286,314,3314,18,491,257,1179,4163
1682.671,17,14,1036,7,30,280435,30,406,7,62,280434,62,630
1740.528,1,15,840,15,28,124323,28,840,0,0,0,0,0
0.014,6,2,80,1,0,0,0,40,1,0,0,0,40
7.515,6,22,6636,7,154,1252,267,752,15,527,533,1420,5884
1570.808,6,122,19268,74,295,21517,1283,13891,48,93,33419,241,5377
1772.091,6,177,15222,118,69,15146,69,8791,59,69,30550,69,6431
1745.572,6,96,7255,63,38,28154,205,4476,33,33,54542,98,2779
9.411,6,87,26325,44,555,218,1152,20107,43,449,217,1179,6218
1777.058,17,73,3060,72,14,25028,14,3024,1,8,0,8,36
6.798,6,5,456,3,0,3399,0,168,2,92,6540,92,288
0.029,17,2,444,1,34,0,34,62,1,354,0,354,382
0.511,6,29,7088,17,244,31,656,2394,12,701,39,1728,4694
33.525,6,27,4887,14,180,2578,722,1807,13,480,2778,2026,3080
1.749,6,53,22316,29,961,62,1440,16580,24,433,66,1440,5736
1.301,6,47,19043,26,950,52,1460,13427,21,433,56,1460,5616
1789.957,6,364,25392,212,100,8483,469,14896,152,69,11854,69,10496
1785.822,6,249,24997,102,67,17680,616,9429,147,127,12230,1440,15568
1768.261,1,58,4872,0,0,0,0,0,58,56,31022,56,4872
170.95,1,12,672,12,28,15540,28,672,0,0,0,0,0
0.225,6,44,17211,25,861,9,1420,12218,19,467,11,1883,4993
0.24,17,2,136,1,32,0,32,60,1,48,0,48,76
1790.13,6,224,15472,83,46,21830,46,6382,141,46,12786,46,9090
107.925,6,862,416795,465,830,232,1152,397147,397,418,271,1152,19648
8.093,6,21,6597,6,138,1618,267,803,15,518,576,1452,5794
16.076,1,5,280,5,28,4019,28,280,0,0,0,0,0
1796.065,17,763,46018,763,32,2357,37,46018,0,0,0,0,0
9.538,17,40,7572,12,220,866,1350,2984,28,135,352,1350,4588
1797.711,17,142,11360,71,48,25681,48,5396,71,56,25681,56,5964
53.816,6,27,7312,13,158,4484,267,1317,14,775,4135,4836,5995
0.074,17,2,390,1,46,0,46,74,1,288,0,288,316
1740.67,1,15,840,15,28,124333,28,840,0,0,0,0,0
90.955,17,4,240,2,32,90954,32,120,2,32,90954,32,120
821.816,17,66,5280,33,48,25681,48,2508,33,56,25672,56,2772
0.387,6,86,60224,54,1281,7,1420,54723,32,467,12,1883,5501
1786.54,6,124,14309,76,166,23820,1302,9360,48,79,38009,268,4949
0.034,17,2,358,1,30,0,30,58,1,272,0,272,300
241.069,6,68,25125,36,910,6887,1418,21925,32,169,7776,580,3200
300.907,6,414,361295,216,230,1399,517,13019,198,1751,1527,7040,348276
118.893,17,4,352,2,60,118891,60,176,2,60,118892,60,176
1788.557,1,206,21836,206,78,8724,78,21836,0,0,0,0,0
0.339,17,2,152,1,48,0,48,76,1,48,0,48,76
491.373,6,424,362657,278,1315,1773,1368,339512,146,558,2066,1368,23145
0.134,17,2,208,1,36,0,36,64,1,116,0,116,144
1796.009,17,447,39296,404,35,4456,288,25708,43,288,41917,288,13588
170.223,17,13,15208,13,1141,14185,1451,15208,0,0,0,0,0
4.951,17,6,1392,6,204,990,204,1392,0,0,0,0,0
1783.362,17,83,3480,82,14,22016,14,3444,1,8,0,8,36
1774.389,6,181,15589,120,69,14910,69,8940,61,69,29570,69,6649
20.974,17,4,352,2,60,20973,60,176,2,60,20973,60,176
160.761,17,12,4737,12,366,14614,373,4737,0,0,0,0,0
1791.029,1,342,28728,342,56,5252,56,28728,0,0,0,0,0
270.524,6,24,6200,9,267,99,502,1166,15,369,19317,1420,5034
762.73,17,62,4960,31,48,25424,48,2356,31,56,25424,56,2604
300.714,6,37,8284,20,254,15827,671,1850,17,522,536,4080,6434
1799.234,17,762,45939,762,32,2364,37,45939,0,0,0,0,0
0.398,6,36,8262,19,350,22,1414,2516,17,506,24,1491,5746
228.359,17,7,2352,7,308,38059,308,2352,0,0,0,0,0
0.275,17,2,167,1,39,0,39,67,1,72,0,72,100
817.303,6,57,3561,31,27,27242,27,1876,26,26,32690,27,1685
439.052,17,3,579,3,165,219526,165,579,0,0,0,0,0
179.946,6,25,9968,12,549,66,1440,2709,13,961,14983,1440,7259
21.351,17,2,904,1,300,0,300,328,1,548,0,548,576
11.949,6,1829,1673364,1174,1372,10,1432,1641648,655,389,18,1432,31716
0.195,17,2,152,1,48,0,48,76,1,48,0,48,76
43.897,6,22,5736,13,267,3658,501,1325,9,674,5463,1420,4411
1794.251,17,144,11520,72,48,25271,48,5472,72,56,25271,56,6048
1771.265,6,99,9240,66,65,27250,65,5577,33,59,55348,59,3663
96.562,6,46,7640,20,218,320,314,3423,26,453,3852,1179,4217
1790.836,17,179,13962,179,50,10060,50,13962,0,0,0,0,0
1777.065,17,142,11360,71,48,25386,48,5396,71,56,25386,56,5964
5.029,17,3,208,2,36,5003,36,128,1,52,0,52,80
1.236,6,25,8056,12,164,96,267,1288,13,869,88,1448,6768
2.41,6,2,142,1,0,0,0,40,1,62,0,62,102
35.55,6,8,448,4,0,11850,0,216,4,0,11801,0,232
1745.519,6,95,7203,63,38,28153,205,4476,32,33,56294,98,2727
240.147,6,95,79779,36,206,6861,615,3322,59,1497,4140,2804,76457
1796.368,17,142,11360,71,48,25662,48,5396,71,56,25662,56,5964
0.954,6,112,87324,48,131,20,232,2449,64,1395,14,2755,84875
1681.293,17,14,1045,7,30,280212,30,406,7,63,280212,71,639
0.031,17,2,152,1,48,0,48,76,1,48,0,48,76
0.456,6,10,968,5,256,111,256,460,5,304,111,304,508
4.126,17,5,290,5,30,1031,30,290,0,0,0,0,0
244.727,6,83,21892,40,520,6274,1402,13542,43,339,5826,1402,8350
5.021,17,3,208,2,36,5003,36,128,1,52,0,52,80
56.51,6,9,520,3,112,28250,112,240,6,0,11300,0,280
1.269,6,11,1727,7,100,211,100,384,4,589,341,1152,1343
14.145,6,21,3558,11,210,1413,210,1048,10,664,1571,904,2510
6.085,17,12,852,6,32,1215,32,360,6,54,1215,60,492
4.213,17,5,290,5,30,1053,30,290,0,0,0,0,0
1797.619,17,448,39896,403,35,4471,288,25676,45,288,40019,288,14220
1784.933,6,356,22520,208,69,8622,69,12460,148,69,12139,69,10060
248.317,6,12,724,4,106,82769,106,274,8,90,35472,90,450
540.556,17,29,9744,29,308,19305,308,9744,0,0,0,0,0
1.14,17,29,15751,12,480,101,1350,6099,17,539,69,1350,9652
128.022,6,5,200,5,0,0,0,200,0,0,0,0,0
1792.616,17,88,3684,86,14,21087,14,3612,2,8,1792438,8,72
245.603,17,4,352,2,60,245602,60,176,2,60,245602,60,176
1796.132,17,449,39928,404,35,4456,288,25708,45,288,40018,288,14220
339.506,1,6,636,6,78,67901,78,636,0,0,0,0,0
0.02,17,4,352,2,37,16,37,130,2,83,15,89,222
290.226,6,36,3654,18,323,17071,582,1650,18,153,17071,580,2004
31.573,6,9,588,4,106,10524,106,274,5,90,7848,90,314
1.27,6,47,19586,27,920,48,1360,14010,20,529,57,4075,5576
1.321,6,16,6056,9,70,164,133,504,7,1756,218,2440,5552
296.421,1,4,224,4,28,98807,28,224,0,0,0,0,0
10.957,6,18,4266,10,275,1217,275,958,8,992,884,1440,3308
4.161,6,23,4785,13,209,346,529,1720,10,507,396,1440,3065
1795.292,17,469,157584,469,308,3836,308,157584,0,0,0,0,0
1774.784,17,140,11200,70,48,25721,48,5320,70,56,25721,56,5880
0.258,6,9,1050,5,261,64,261,465,4,421,67,421,585
51.08,17,10,1352,5,48,12767,48,380,5,166,12767,308,972
0.418,6,13,1096,7,256,68,256,544,6,304,81,304,552
370.86,6,18,1242,14,180,28527,180,916,4,110,20061,110,326
1772.199,6,180,15480,120,69,14892,69,8940,60,69,30035,69,6540
1770.426,6,99,9240,66,65,27237,65,5577,33,59,55322,59,3663
1780.548,17,142,11360,71,48,25436,48,5396,71,56,25436,56,5964
1743.25,6,100,7494,63,38,28116,205,4476,37,33,48416,98,3018
59.642,17,4,352,2,60,59641,60,176,2,60,59640,60,176
352.499,17,12,2472,6,48,70498,48,456,6,308,70497,308,2016
0.018,17,3,451,2,39,12,39,134,1,289,0,289,317
125.24,6,31,8912,14,158,9633,267,1357,17,687,7825,2036,7555
5.001,17,4,558,2,36,4995,36,128,2,187,4996,187,430
6.683,6,45,8425,24,227,290,314,4142,21,491,320,1179,4283
0.216,6,3,120,1,0,0,0,40,2,0,216,0,80
301.698,6,46,10053,26,424,12067,888,3291,20,425,508,3388,6762
140.026,17,42,2347,18,25,8236,29,954,24,30,6079,41,1393
0.177,17,2,672,2,308,177,308,672,0,0,0,0,0
116.919,6,32,5478,16,332,7794,1056,3164,16,210,7781,580,2314
751.245,6,78,6708,52,69,14730,69,3874,26,69,30046,69,2834
66.686,6,40,27037,17,746,48,1460,3697,23,1318,3025,1605,23340
1780.201,1,67,5628,0,0,0,0,0,67,56,26972,56,5628
3.304,17,8,2750,8,315,472,354,2750,0,0,0,0,0
0.04,6,2,100,1,0,0,0,40,1,0,0,0,60
0.012,17,2,376,1,43,0,43,71,1,277,0,277,305
0.048,17,5,369,3,33,8,33,183,2,65,0,65,186
1772.513,1,58,4872,58,56,31096,56,4872,0,0,0,0,0
1787.266,6,102,8296,68,65,26675,65,4930,34,59,54156,59,3366
283.56,6,57,11853,23,336,12889,1189,4299,34,341,2671,1997,7554
240.278,6,42,9050,20,523,12646,1408,5759,22,237,11441,618,3291
0.753,17,15,5512,7,392,125,1350,2946,8,292,74,1350,2566
240.207,6,54,18072,29,816,8578,1408,15400,25,170,10008,580,2672
16.052,6,25,7026,6,154,3210,267,712,19,396,886,1420,6314
0.374,17,14,7750,7,747,62,1350,5425,7,304,52,1350,2325
334.594,6,83,12064,33,107,10455,267,3270,50,169,6828,1460,8794
555.143,6,7,364,7,0,0,0,364,0,0,0,0,0
2.24,6,3,120,2,0,2240,0,80,1,0,0,0,40
0.858,6,21,9222,11,514,85,1237,2015,10,970,70,1360,7207
87.161,6,31,15395,14,630,59,1440,3113,17,1053,5439,1440,12282
197.55,1,5,280,5,28,49387,28,280,0,0,0,0,0
6.49,17,40,7323,18,176,379,1350,3685,22,137,307,1350,3638
113.334,17,4,352,2,60,113333,60,176,2,60,113333,60,176
17.474,17,16,2352,8,48,2494,48,608,8,190,2494,308,1744
1771.537,6,101,9344,66,65,27254,65,5577,35,59,52101,59,3767
86.835,6,17,2428,10,302,9648,302,1724,7,83,14469,83,704
6.032,6,42,7489,21,209,301,314,3563,21,513,287,1179,3926
15.326,2,5,224,5,20,3831,32,224,0,0,0,0,0
384.983,1,6,617,6,74,76996,142,617,0,0,0,0,0
1.004,6,26,8380,14,266,63,540,1924,12,1192,75,3151,6456
280.922,6,28,7352,13,158,23410,267,1317,15,603,20058,2036,6035
0.992,17,2,685,1,308,0,308,336,1,321,0,321,349
1749.603,17,12,498,11,14,174960,14,462,1,8,0,8,36
0.027,6,13,3514,7,75,4,75,447,6,1373,5,1448,3067
3.525,6,19,2104,10,256,388,256,1432,9,304,438,304,672
123.926,6,12,1422,7,302,20652,302,976,5,83,30979,83,446
37.271,17,44,6468,22,48,1774,48,1672,22,190,1774,308,4796
5.194,17,31,8101,15,313,368,1350,5129,16,157,343,1350,2972
357.594,17,21,7338,21,321,17879,382,7338,0,0,0,0,0
1770.157,6,454,156419,215,715,8269,1440,129647,239,180,7437,1440,26772
0.04,17,5,696,3,60,5,60,264,2,188,22,188,432
260.388,17,2,1084,2,514,260388,514,1084,0,0,0,0,0
0.864,6,2,1175,1,0,0,0,40,1,1095,0,1095,1135
4.013,6,39,7269,20,218,211,314,3423,19,513,209,1179,3846
0.183,6,26,7256,13,155,15,267,1301,13,678,14,2800,5955
1.355,6,55,24079,32,998,43,1460,18338,23,437,53,2615,5741
1.95,6,14,2351,8,188,278,245,700,6,703,339,1152,1651
1797.826,6,211,27680,114,304,15909,304,18840,97,83,18727,83,8840
15.125,17,12,5170,6,490,3018,1350,3109,6,315,3018,1350,2061
19.147,6,1919,1850664,1220,1437,15,1448,1808092,699,776,27,1448,42572
0.104,6,9,1340,5,145,26,145,349,4,827,22,827,991
1597.764,6,108,14622,64,98,25361,721,6981,44,345,8982,1440,7641
1793.868,6,194,17920,126,83,14350,981,10299,68,75,26772,485,7621
1793.991,6,298,23638,145,246,12453,515,10074,153,39,11797,76,13564
0.032,17,2,179,1,43,0,43,71,1,80,0,80,108
1746.09,6,94,7151,62,38,28624,205,4424,32,33,56315,98,2727
280.3,6,29,7392,13,158,23358,267,1317,16,603,18684,2036,6075
1782.344,17,83,3480,82,14,22004,14,3444,1,8,0,8,36
62.703,17,5,1672,5,306,15675,308,1672,0,0,0,0,0
10.807,6,91,27946,46,550,240,1152,21664,45,447,239,1179,6282
0.265,17,3,451,2,39,116,39,134,1,289,0,289,317
1680.644,17,12,498,11,14,168064,14,462,1,8,0,8,36
1774.538,6,183,15807,120,69,14912,69,8940,63,69,28616,69,6867
1786.153,17,87,3648,86,14,21013,14,3612,1,8,0,8,36
12.016,6,23,9480,13,275,1001,275,1078,10,1598,1132,2840,8402
1773.18,6,180,15480,120,69,14900,69,8940,60,69,30050,69,6540
0.898,1,5,420,5,56,224,56,420,0,0,0,0,0
12.6,17,4,352,2,60,12599,60,176,2,60,12599,60,176
355.69,1,11,616,11,28,35569,28,616,0,0,0,0,0
1684.57,6,175,22332,94,89,18111,721,8748,81,258,21054,1414,13584
3.934,17,5,290,5,30,983,30,290,0,0,0,0,0
1740.416,6,87,6322,58,31,30533,31,3915,29,31,62157,31,2407
125.508,6,34,18749,18,702,47,1360,4967,16,1193,8358,2720,13782
638.136,6,40,2874,21,31,31899,31,1402,19,31,35442,31,1472
363.499,1,4,240,4,32,121166,32,240,0,0,0,0,0
0.912,17,16,9469,9,746,114,1350,6973,7,328,131,1350,2496
1771.963,6,180,15480,120,69,14890,69,8940,60,69,30032,69,6540
0.199,6,4,208,2,0,196,0,104,2,0,184,0,104
0.267,17,2,440,1,39,0,39,67,1,345,0,345,373
20.178,6,2085,1991343,1310,1439,15,1448,1942775,775,776,25,1448,48568
0.311,17,4,420,2,33,0,33,122,2,121,1,145,298
2.438,6,14,2351,8,188,348,245,700,6,703,433,1152,1651
0.181,6,25,7216,12,155,16,267,1261,13,678,13,2045,5955
1790.236,17,445,53522,202,165,8886,1350,39033,243,31,7397,60,14489
0.0,6,1,786,1,746,0,746,786,0,0,0,0,0
1768.367,6,124,7570,68,27,26392,27,4097,56,27,32151,27,3473
3.381,6,63,15369,32,553,109,1429,5773,31,397,100,1986,9596
0.098,6,9,1339,5,145,24,145,349,4,826,29,826,990
1.299,6,48,19133,27,886,49,1440,13517,21,433,56,1440,5616
14.779,6,23,4574,11,275,1477,275,1002,12,768,1254,1440,3572
1.201,6,24,8004,12,164,92,267,1288,12,1014,92,2331,6716
369.526,6,25,1651,17,177,23095,177,1117,8,110,9219,110,534
1777.401,17,140,11200,70,48,25759,48,5320,70,56,25759,56,5880
1.713,6,27,10183,16,285,114,589,1501,11,1029,150,1420,8682
1790.947,6,363,23007,211,69,8528,69,12787,152,69,11860,69,10220
1784.105,6,149,9365,78,45,23168,208,5378,71,31,25484,31,3987
18.854,6,15,1386,9,483,2356,483,967,6,83,3768,83,419
0.477,17,3,451,2,39,176,39,134,1,289,0,289,317
0.495,6,12,1653,6,288,94,288,548,6,426,48,434,1105
1791.812,6,356,22520,208,69,8656,69,12460,148,69,12189,69,10060
120.4,6,166,129458,107,1264,1135,1408,116881,59,730,1633,3847,12577
300.784,2,3,96,3,8,150392,8,96,0,0,0,0,0
1633.624,6,219,19526,83,87,19922,375,9018,136,71,12099,1062,10508
1796.965,1,345,28980,345,56,5223,56,28980,0,0,0,0,0
20.596,17,29,13546,14,508,1581,1350,7516,15,374,1468,1350,6030
0.258,6,26,6041,12,164,23,453,1442,14,551,19,1402,4599
179.939,6,27,5687,10,133,19992,159,939,17,967,11245,1669,4748
1682.561,17,14,1036,7,30,280421,30,406,7,62,280421,62,630
0.217,6,26,7256,13,155,18,267,1301,13,603,17,2800,5955
1790.815,17,318,64201,318,173,5649,422,64201,0,0,0,0,0
605.948,6,137,22441,79,304,7768,304,15764,58,83,10615,83,6677
0.369,6,20,7151,12,318,33,600,1906,8,964,50,1471,5245
359.158,2,4,128,4,8,119719,8,128,0,0,0,0,0
1066.086,1,46,2576,46,28,23690,28,2576,0,0,0,0,0
1745.424,6,83,6331,55,39,32322,205,3936,28,33,64637,98,2395
0.147,17,2,180,1,30,0,30,58,1,94,0,94,122
1795.028,6,356,22520,208,69,8671,69,12460,148,69,12210,69,10060
0.02,17,4,668,2,32,14,32,120,2,246,15,246,548
10.909,6,20,4442,11,275,1090,275,998,9,768,767,1440,3444
1.452,6,118,87860,51,131,29,232,2569,67,1354,21,1420,85291
59.139,6,184,103202,99,1312,134,1460,90649,85,182,702,1460,12553
4.176,6,33,6129,17,206,261,314,2744,16,548,261,1179,3385
0.064,6,10,1514,5,503,16,503,771,5,475,15,475,743
8.151,6,45,8516,23,227,370,314,4102,22,441,375,1179,4414
5.865,6,23,2504,11,222,585,222,1554,12,231,532,231,950
1.702,6,14,2351,8,188,243,245,700,6,703,288,1152,1651
0.904,6,23,9025,13,290,75,802,1713,10,1380,81,3930,7312
240.13,6,42,5607,21,247,12006,834,2845,21,184,12006,572,2762
1794.855,1,69,5796,0,0,0,0,0,69,56,26394,56,5796
8.604,6,425,350770,259,1290,32,1368,337474,166,931,50,2736,13296
1787.53,6,104,8376,68,65,26679,65,4930,36,59,51070,59,3446
1771.784,6,99,9240,66,65,27258,65,5577,33,59,55365,59,3663
1787.324,6,104,8376,68,65,26676,65,4930,36,59,51063,59,3446
1134.481,2,8,256,8,8,162068,8,256,0,0,0,0,0
22.338,6,20,3130,12,183,2030,517,1561,8,381,3189,499,1569
11.915,6,1878,1646781,1149,1379,10,1420,1613388,729,420,16,1420,33393
245.178,6,58,10956,30,209,8454,833,3103,28,425,9080,2341,7853
2.58,17,22,7797,11,431,254,1350,5056,11,221,254,1350,2741
1719.849,1,94,5264,94,28,18493,28,5264,0,0,0,0,0
1795.58,6,116,12603,76,82,23941,516,6104,40,128,46035,2642,6499
0.538,17,2,152,1,48,0,48,76,1,48,0,48,76
1772.453,6,180,15480,120,69,14894,69,8940,60,69,30036,69,6540
1680.572,17,12,498,11,14,168057,14,462,1,8,0,8,36
1794.567,1,58,4872,58,56,31483,56,4872,0,0,0,0,0
1783.48,6,195,21164,127,109,14154,965,12088,68,93,26614,485,9076
1729.547,6,62,4549,41,33,43234,33,2825,21,31,86469,31,1724
0.126,17,2,376,1,39,0,39,67,1,281,0,281,309
1783.646,6,102,8364,68,66,26621,66,4964,34,60,54047,60,3400
0.253,6,20,7229,12,334,22,663,1969,8,1209,34,1906,5260
280.026,6,25,7232,12,158,25456,267,1277,13,905,23333,4845,5955
1770.607,6,99,9240,66,65,27240,65,5577,33,59,55327,59,3663
0.005,17,2,904,2,424,5,548,904,0,0,0,0,0
0.127,6,27,27898,17,180,7,250,1434,10,3242,11,9856,26464
0.244,6,16,5217,8,75,34,75,586,8,1398,34,1448,4631
280.223,6,27,7312,12,158,25474,267,1277,15,678,20012,2045,6035
7.937,6,39,7285,20,218,417,314,3423,19,516,426,1179,3862
2.427,2,2,64,2,8,2427,8,64,0,0,0,0,0
1787.789,1,192,10752,192,28,9360,28,10752,0,0,0,0,0
0.437,6,14,1733,7,288,69,288,588,7,426,39,434,1145
13.819,6,14,2245,8,211,1973,211,846,6,545,2751,904,1399
0.005,17,2,554,1,30,0,30,58,1,468,0,468,496
28.021,6,2249,2060651,1349,1441,20,1448,2004703,900,776,30,1448,55948
2.071,6,5,269,1,0,0,0,40,4,7,582,7,229
0.046,17,2,251,1,36,0,36,64,1,159,0,159,187
1772.366,6,180,15480,120,69,14893,69,8940,60,69,30035,69,6540
1740.12,6,87,6322,58,31,30528,31,3915,29,31,62146,31,2407
472.613,6,88,30118,42,582,11526,1402,10925,46,763,10502,2804,19193
1763.847,2,17,544,17,8,110240,8,544,0,0,0,0,0
12.246,17,20,1720,10,47,1360,47,750,10,69,1360,75,970
1796.373,6,321,22873,185,69,9762,69,12230,136,58,13306,69,10643
240.246,6,59,18168,28,789,8897,1408,14888,31,207,8008,580,3280
79.697,6,9190,8729965,5908,1397,13,1448,8553809,3282,776,24,1448,176156
1.019,6,11,612,6,0,203,0,328,5,0,252,0,284
1.244,6,25,8056,12,164,96,267,1288,13,869,88,1440,6768
0.02,17,2,664,1,308,0,308,336,1,300,0,300,328
779.473,1,17,1428,17,56,48717,56,1428,0,0,0,0,0
123.254,6,138,105772,85,1310,1467,1448,94854,53,815,2014,3807,10918
318.52,6,8,474,3,106,159260,106,234,5,0,3830,0,240
1795.444,17,142,11360,71,48,25648,48,5396,71,56,25648,56,5964
1.006,17,2,685,1,308,0,308,336,1,321,0,321,349
0.044,6,4,239,2,0,42,0,104,2,31,0,31,135
392.623,17,6,360,3,32,196310,32,180,3,32,196311,32,180
1744.661,6,102,7970,66,45,26840,205,4902,36,35,49842,98,3068
280.479,6,27,7312,12,158,25498,267,1277,15,678,20030,2085,6035
1779.5,17,138,11040,69,48,26168,48,5244,69,56,26168,56,5796
193.65,17,4,352,2,60,193649,60,176,2,60,193649,60,176
481.305,2,6,192,6,8,96261,8,192,0,0,0,0,0
0.489,17,3,451,2,39,341,39,134,1,289,0,289,317
0.001,6,2,438,2,179,1,267,438,0,0,0,0,0
300.68,6,42,8661,22,266,14318,720,2014,20,389,819,2720,6647
0.12,6,3,120,0,0,0,0,0,3,0,0,0,120
1795.268,6,357,22629,208,69,8672,69,12460,149,69,12130,69,10169
12.115,6,25,8453,13,275,1009,275,1078,12,983,953,1420,7375
1795.492,17,444,39200,400,35,4499,288,25296,44,288,40947,288,13904
5.821,6,40,7309,20,218,306,314,3423,20,513,291,1179,3886
1794.603,6,369,25799,215,99,8385,469,15085,154,69,11726,69,10714
1140.081,17,164,12464,164,48,6994,48,12464,0,0,0,0,0
599.321,6,9,546,6,31,119864,31,333,3,31,299650,31,213
48.761,6,16,4257,10,271,5417,515,1219,6,698,789,1452,3038
300.867,6,253,268901,104,162,2920,230,6226,149,1770,2032,6840,262675
1744.649,2,25,800,25,8,72693,8,800,0,0,0,0,0
1791.658,6,270,32613,110,133,16436,1360,15506,160,133,11267,1942,17107
15.342,6,2557,2463622,1702,1372,8,1408,2414498,855,776,17,1408,49124
1796.87,17,447,39864,402,35,4480,288,25644,45,288,40014,288,14220
1788.725,6,264,36622,109,178,16561,1360,20280,155,133,11614,2720,16342
0.119,6,10,1326,5,299,25,299,567,5,245,24,458,759
1.407,6,32,11110,18,563,82,1360,4142,14,799,94,3494,6968
18.036,6,15,2309,8,211,2575,211,858,7,545,2991,904,1451
6.025,17,12,2595,6,47,1202,47,450,6,329,1203,341,2145
11.74,6,1872,1623730,1135,1376,10,1420,1590029,737,467,15,1883,33701
240.325,6,56,9847,26,118,9604,722,2819,30,388,8279,1380,7028
0.014,17,4,865,2,47,0,47,150,2,329,2,341,715
300.588,6,32,8785,18,272,17681,750,2094,14,595,14375,2527,6691
1786.665,6,102,8364,68,66,26666,66,4964,34,60,54138,60,3400
12.336,6,2114,1966618,1355,1373,8,1408,1922486,759,931,16,2801,44132
1789.057,6,359,22709,209,69,8601,69,12569,150,69,12007,69,10140
0.041,17,4,304,2,37,0,37,130,2,59,36,65,174
240.174,6,57,20124,31,818,8005,1408,17173,26,198,9606,580,2951
0.06,17,4,284,2,32,53,32,120,2,54,53,60,164
2.93,17,2,156,2,50,2930,67,156,0,0,0,0,0
127.079,17,8,11004,8,1347,18154,1350,11004,0,0,0,0,0
1.626,6,29,10365,17,367,101,833,1785,12,1012,139,1420,8580
0.218,17,2,152,2,48,218,48,152,0,0,0,0,0
1503.973,2,15,480,15,8,107426,8,480,0,0,0,0,0
1787.479,17,87,3648,86,14,21029,14,3612,1,8,0,8,36
1793.879,17,144,11520,72,48,25265,48,5472,72,56,25265,56,6048
48.972,6,5840,5577136,3890,1356,12,1408,5471072,1950,776,25,1408,106064
195.98,17,4,352,2,60,195979,60,176,2,60,195979,60,176
0.132,17,2,245,1,32,0,32,60,1,157,0,157,185
1794.114,17,80,3354,79,14,23001,14,3318,1,8,0,8,36
1.973,17,2,672,2,308,1973,308,672,0,0,0,0,0
1797.113,6,378,23682,218,69,8281,69,12929,160,62,11302,69,10753
23.608,6,22,7316,13,640,1967,1253,2604,9,706,2928,1368,4712
0.392,17,2,152,1,48,0,48,76,1,48,0,48,76
11.619,6,25,8473,13,275,968,275,1078,12,986,772,1440,7395
0.485,6,25,6044,12,164,44,453,1442,13,651,36,2194,4602
1.869,6,53,21268,30,952,64,1460,15527,23,400,74,1460,5741
34.069,17,20,1760,10,48,3784,48,760,10,72,3784,72,1000
1787.779,6,3674,3628156,1166,127,1534,333,67234,2508,1409,713,4254,3560922
0.0,17,1,313,1,285,0,285,313,0,0,0,0,0
1796.982,17,393,111134,393,254,4584,422,111134,0,0,0,0,0
1798.451,1,136,7616,136,28,13321,28,7616,0,0,0,0,0
0.004,17,2,152,1,48,0,48,76,1,48,0,48,76
3.444,17,6,1557,3,40,1715,40,204,3,423,1714,423,1353
1796.007,6,366,25817,207,99,8718,469,14834,159,69,11364,69,10983
0.031,17,2,196,1,62,0,62,90,1,78,0,78,106
280.466,6,29,7392,13,158,23372,267,1317,16,678,18693,2085,6075
0.336,17,7,2383,7,312,56,353,2383,0,0,0,0,0
1682.776,17,14,1036,7,30,280456,30,406,7,62,280453,62,630
0.005,17,2,584,1,39,0,39,67,1,489,0,489,517
0.328,6,21,7290,13,335,27,668,2026,8,968,45,1475,5264
0.923,6,11,1727,7,100,153,100,384,4,589,218,1152,1343
36.891,17,240,39655,118,154,314,1209,21482,122,120,304,1252,18173
1796.196,17,142,11360,71,48,25659,48,5396,71,56,25659,56,5964
0.279,17,2,218,1,65,0,65,93,1,97,0,97,125
215.849,17,4,240,2,32,215848,32,120,2,32,215848,32,120
107.4,6,22,892,9,0,6565,0,364,13,0,8949,0,528
1793.815,1,97,5432,97,28,18685,28,5432,0,0,0,0,0
23.846,6,37,8370,17,175,1490,721,2086,20,548,1229,1420,6284
1763.774,17,183,52959,183,261,9691,422,52959,0,0,0,0,0
1786.543,6,367,25581,213,99,8427,469,15005,154,69,11676,69,10576
1770.349,6,104,9500,66,65,27236,65,5577,38,59,47843,59,3923
11.721,6,1861,1619684,1127,1383,10,1420,1586103,734,467,15,1883,33581
0.121,2,2,64,2,8,121,8,64,0,0,0,0,0
1772.613,6,180,15480,120,69,14895,69,8940,60,69,30037,69,6540
0.219,17,2,158,1,34,0,34,62,1,68,0,68,96
11.675,6,17,3330,9,49,1459,92,587,8,387,1585,1408,2743
0.035,6,14,4895,7,134,5,137,641,7,973,5,1448,4254
300.103,6,40,10149,21,619,14996,1440,4587,19,399,16662,1440,5562
156.58,6,14,1031,5,177,39145,177,445,9,110,19540,110,586
240.336,6,42,8333,21,449,12016,1418,5596,21,233,12016,580,2737
0.522,17,3,543,2,39,409,39,134,1,381,0,381,409
379.124,6,23,1535,16,177,25274,177,1053,7,110,10418,110,482
4.902,6,41,7349,22,218,233,314,3503,19,440,258,1152,3846
33.772,6,35,5315,17,154,2099,722,1975,18,300,1976,1440,3340
1018.319,17,12,969,6,31,203660,37,355,6,74,203660,136,614
126.481,6,10,1687,4,100,186,100,264,6,1179,25243,1179,1423
1238.465,1,16,896,16,28,82564,28,896,0,0,0,0,0
1.246,6,50,19491,29,901,44,1360,13830,21,437,54,2715,5661
0.68,6,6,328,4,0,226,0,216,2,0,640,0,112
1.289,6,25,8056,12,164,99,267,1288,13,869,91,1448,6768
33.11,17,33,12725,15,531,2362,1350,8388,18,212,1945,1350,4337
23.522,6,31,8736,15,339,1680,721,2643,16,681,1554,2840,6093
0.087,17,4,284,2,32,0,32,120,2,54,29,60,164
226.405,1,26,1456,26,28,9056,28,1456,0,0,0,0,0
2.87,17,6,540,3,30,1434,30,174,3,94,1434,94,366
300.256,6,37,12282,20,593,15802,1408,4658,17,673,15120,1578,7624
0.302,17,8,2758,8,316,43,355,2758,0,0,0,0,0
218.623,6,31,8912,14,158,16817,267,1357,17,763,13654,2076,7555
1799.079,17,142,11360,71,48,25701,48,5396,71,56,25701,56,5964
1792.062,1,58,4872,58,56,31439,56,4872,0,0,0,0,0
0.771,6,8,521,4,31,257,31,270,4,31,144,31,251
0.525,6,12,1653,6,288,99,288,548,6,426,56,434,1105
67.994,6,6,268,1,0,0,0,40,5,7,16969,7,228
1787.007,6,119,13943,75,82,24148,502,5984,44,163,41556,1420,7959
168.172,17,9,378,9,14,21021,14,378,0,0,0,0,0
105.148,17,4,240,2,32,105146,32,120,2,32,105147,32,120
8.619,6,20,6466,6,154,1723,267,712,14,518,654,1460,5754
124.969,17,26,17342,26,639,4998,639,17342,0,0,0,0,0
0.078,17,2,251,1,36,0,36,64,1,159,0,159,187
7.503,17,4,314,2,31,7489,31,118,2,70,7488,70,196
1.304,6,50,18772,27,854,50,1360,13076,23,433,51,1360,5696
1773.632,6,182,15629,121,69,14780,69,9049,61,69,29557,69,6580
1763.495,2,15,480,15,8,125963,8,480,0,0,0,0,0
4.591,6,38,7229,20,218,241,314,3423,18,513,254,1179,3806
1744.666,2,27,864,27,8,67102,8,864,0,0,0,0,0
1792.986,6,373,23614,214,69,8417,69,13114,159,69,11347,69,10500
0.209,6,9,1343,5,145,52,145,349,4,830,30,830,994
12.804,6,25,7097,12,155,1164,267,1266,13,589,1066,3426,5831
1796.591,17,1137,792486,368,232,4895,1350,95758,769,878,2339,1350,696728
240.22,6,53,17769,28,787,8896,1408,14854,25,200,10008,580,2915
0.245,17,3,451,2,39,201,39,134,1,289,0,289,317
784.174,6,99,6720,38,46,21193,46,2900,61,46,13067,46,3820
147.05,6,27,12574,13,512,79,1228,2101,14,990,11300,1460,10473
316.983,6,63,18589,36,339,9056,1360,9620,27,525,12186,4649,8969
168.858,6,29,8832,13,158,14071,267,1317,16,763,11254,2045,7515
0.274,6,16,4552,8,88,39,88,460,8,1253,39,1880,4092
1772.513,6,203,22359,130,75,13740,267,10057,73,135,24611,2840,12302
10.193,6,16,4704,9,333,1274,516,1696,7,681,1633,1452,3008
280.313,6,30,7432,13,158,23359,267,1317,17,543,17511,1400,6115
17.707,6,15,2306,9,210,2213,210,908,6,545,3540,904,1398
1779.692,6,354,22509,207,69,8639,69,12420,147,69,12189,69,10089
1681.93,17,14,1036,7,30,280318,30,406,7,62,280318,62,630
217.092,17,4,304,2,48,217090,64,152,2,48,217090,64,152
4.372,6,38,7229,19,218,242,314,3383,19,440,228,1152,3846
1775.075,6,180,15480,120,69,14916,69,8940,60,69,30078,69,6540
366.913,6,18,1239,14,177,28224,177,913,4,110,20056,110,326
1681.754,17,14,1036,7,30,280289,30,406,7,62,280289,62,630
0.396,6,19,7093,10,215,44,517,1185,9,1086,30,1402,5908
1744.28,6,134,8362,74,46,23894,208,5063,60,31,29558,31,3299
1797.929,17,142,11360,71,48,25684,48,5396,71,56,25684,56,5964
7.423,6,1545,1409285,965,1382,7,1408,1374461,580,776,12,1408,34824
94.594,6,76,53480,49,1188,1970,1368,45340,27,841,2376,2736,8140
0.933,6,28,8263,15,225,55,561,1985,13,957,62,1631,6278
1786.51,6,102,8364,68,66,26664,66,4964,34,60,54134,60,3400
0.022,17,2,154,1,33,0,33,61,1,65,0,65,93
198.88,17,4,240,2,32,198879,32,120,2,32,198879,32,120
1744.644,2,27,864,27,8,67101,8,864,0,0,0,0,0
2.869,6,2,88,2,0,0,0,88,0,0,0,0,0
0.085,6,9,1340,5,145,21,145,349,4,827,25,827,991
1.065,6,34,8461,18,277,62,517,1863,16,495,69,1883,6598
1791.263,1,339,28476,339,56,5299,56,28476,0,0,0,0,0
280.399,6,27,7312,12,158,25490,267,1277,15,678,20026,2045,6035
0.611,6,11,975,6,304,122,304,624,5,83,140,83,351
1787.392,6,4365,4109453,1579,126,1132,332,99491,2786,1425,641,4254,4009962
1772.512,6,204,22399,130,75,13740,267,10057,74,133,24280,1997,12342
1.393,6,54,23927,30,997,48,1460,18191,24,433,52,1460,5736
240.235,6,58,16732,32,707,7749,1402,13711,26,184,9609,580,3021
240.222,6,61,29151,30,194,8281,517,2747,31,1180,8006,2407,26404
36.154,17,4,304,4,48,12051,48,304,0,0,0,0,0
0.192,17,2,206,1,47,0,47,75,1,103,0,103,131
10.169,17,3,3283,3,1066,5084,1072,3283,0,0,0,0,0
1794.324,17,144,11520,72,48,25272,48,5472,72,56,25272,56,6048
0.062,17,2,2752,2,1348,62,1348,2752,0,0,0,0,0
1793.759,17,66,2766,65,14,28027,14,2730,1,8,0,8,36
0.38,6,10,968,5,256,91,256,460,5,304,91,304,508
0.559,6,10,924,5,283,94,283,551,5,105,92,105,373
1778.786,6,294,47543,126,243,14229,1360,30162,168,133,10650,1938,17381
1785.76,6,3655,3912160,1225,130,1458,351,73625,2430,1574,735,4206,3838535
1799.238,6,192,18719,126,99,14393,469,11525,66,69,27679,69,7194
34.354,17,20,1760,10,48,3816,48,760,10,72,3815,72,1000
0.147,17,2,152,1,48,0,48,76,1,48,0,48,76
19.334,17,18,6515,9,432,2413,1350,4146,9,235,2412,1350,2369
280.444,6,30,7432,14,158,21572,267,1357,16,678,18691,3456,6075
1740.815,17,29,6815,29,207,62171,207,6815,0,0,0,0,0
168.023,17,4,352,2,60,168022,60,176,2,60,168021,60,176
240.415,6,44,8448,22,449,11447,1418,5648,22,206,11447,580,2800
0.837,6,59,26308,33,1081,26,1380,17678,26,582,30,3303,8630
0.255,6,10,1669,6,551,50,947,1346,4,159,84,159,323
21.348,6,13,2133,8,324,3049,585,1073,5,396,5196,580,1060
379.697,6,20,1355,15,177,27121,177,977,5,110,15166,110,378
1064.642,6,68,10227,43,104,19391,498,3812,25,235,44356,1420,6415
1.071,6,30,13379,17,522,66,1360,3334,13,1057,74,2561,10045
504.21,2,4,128,4,8,168070,8,128,0,0,0,0,0
1787.874,17,140,11200,70,48,25911,48,5320,70,56,25911,56,5880
0.276,6,7,466,5,43,57,43,354,2,0,274,0,112
297.5,1,4,224,4,28,99166,28,224,0,0,0,0,0
1786.547,6,104,8444,68,66,26664,66,4964,36,60,51040,60,3480
1765.597,6,79,4108,40,0,45266,0,2080,39,0,46462,0,2028
300.448,6,55,30241,31,190,10014,444,2493,24,1471,10452,2816,27748
1.072,6,12,1305,7,279,178,279,647,5,191,221,272,658
150.456,6,23,10009,12,531,60,1360,2637,11,1384,15031,3934,7372
0.037,6,2,1235,1,0,0,0,40,1,1155,0,1155,1195
240.223,6,55,18053,31,753,8007,1402,15186,24,201,10444,580,2867
139.096,6,18,2393,10,324,15455,585,1177,8,396,19867,580,1216
1790.741,1,258,14448,258,28,6967,28,14448,0,0,0,0,0
1741.923,1,54,4536,54,56,32866,56,4536,0,0,0,0,0
1782.586,1,205,21730,205,78,8738,78,21730,0,0,0,0,0
1787.898,17,202,45296,202,196,8895,356,45296,0,0,0,0,0
300.241,6,26,6931,13,158,25020,267,1317,13,848,25012,3465,5614
1799.391,17,450,39960,405,35,4453,288,25740,45,288,40019,288,14220
1786.125,6,104,8376,68,65,26658,65,4930,36,59,51029,59,3446
280.391,6,30,7432,13,158,23365,267,1317,17,603,17522,2760,6115
1740.187,1,56,4704,0,0,0,0,0,56,56,31639,56,4704
1743.697,6,140,8841,76,49,23220,208,5382,64,31,27676,31,3459
1786.304,6,369,27404,214,117,8386,1189,16165,155,75,11598,485,11239
3.042,17,2,154,1,33,0,33,61,1,65,0,65,93
47.422,17,4,240,2,32,47421,32,120,2,32,47421,32,120
1.055,6,116,88438,50,131,21,232,2529,66,1365,15,1612,85909
1193.654,6,31,3517,27,96,45909,138,3288,4,69,13653,69,229
280.481,6,30,7432,13,158,23373,267,1317,17,543,17517,1400,6115
313.184,17,22,1744,13,48,26098,48,988,9,56,26038,56,756
61.979,6,81,58203,51,1211,1239,1368,49907,30,841,2129,2736,8296
1792.678,1,58,4872,0,0,0,0,0,58,56,31450,56,4872
1.767,6,13,2311,8,188,252,245,700,5,1407,375,1407,1611
240.619,2,3,96,3,8,120309,8,96,0,0,0,0,0
3.398,17,4,240,4,32,1132,32,240,0,0,0,0,0
0.531,6,25,7887,16,364,35,1125,3193,9,721,64,1420,4694
65.353,6,28,8937,15,322,4668,796,2076,13,772,5047,1408,6861
1797.976,17,448,39896,403,35,4472,288,25676,45,288,40020,288,14220
0.032,17,2,220,1,34,0,34,62,1,130,0,130,158
1699.544,17,12,498,11,14,169954,14,462,1,8,0,8,36
1779.484,6,148,14793,89,72,20221,722,7627,59,80,30675,1408,7166
109.298,17,6,534,3,32,54640,37,181,3,89,54638,136,353
11.027,6,20,4390,11,275,1102,275,998,9,755,775,1414,3392
1792.854,6,168,13357,90,91,20144,208,8561,78,40,23279,112,4796
0.171,6,3,213,2,46,113,62,173,1,0,0,0,40
0.972,6,54,14430,25,551,40,1429,4892,29,440,34,1460,9538
280.196,6,29,7392,14,158,21553,267,1357,15,678,20011,3436,6035
1.489,6,38,8254,19,321,82,1164,2718,19,433,72,1460,5536
1787.579,1,216,22896,216,78,8314,78,22896,0,0,0,0,0
1.454,6,59,18086,29,707,51,1360,8977,30,438,49,1360,9109
589.943,1,6,336,6,28,117988,28,336,0,0,0,0,0
1795.192,17,80,3354,79,14,23015,14,3318,1,8,0,8,36
0.266,17,2,376,1,39,0,39,67,1,281,0,281,309
1719.83,6,118,9828,75,47,23240,205,5496,43,51,40943,184,4332
0.689,17,4,768,2,39,684,39,134,2,289,143,289,634
4.562,6,37,7189,19,218,253,314,3383,18,513,252,1179,3806
664.722,17,8,901,8,84,94960,355,901,0,0,0,0,0
1793.442,6,357,22629,209,69,8622,69,12569,148,69,12199,69,10060
1794.053,17,142,11360,71,48,25629,48,5396,71,56,25629,56,5964
3.665,6,6,309,4,69,1221,69,229,2,0,2,0,80
0.593,17,15,8559,8,705,84,1350,5869,7,356,88,1350,2690
0.007,17,4,248,2,34,5,34,124,2,34,6,34,124
1789.963,1,119,6664,119,28,15169,28,6664,0,0,0,0,0
74.775,6,13,3109,5,92,354,92,360,8,2329,10642,2329,2749
0.016,6,11,912,6,182,3,182,490,5,77,3,133,422
7.163,6,14,1029,7,222,1191,222,506,7,231,1192,231,523
0.025,17,2,120,1,32,0,32,60,1,32,0,32,60
280.229,6,28,7352,13,158,23352,267,1317,15,603,20015,2036,6035
1.124,6,26,8545,15,175,80,362,1690,11,896,87,1408,6855
0.084,17,4,368,2,32,68,32,120,2,96,66,96,248
268.127,17,2,908,2,426,268127,687,908,0,0,0,0,0
0.116,1,2,112,2,28,116,28,112,0,0,0,0,0
840.648,17,10,2578,5,31,210159,37,297,5,428,210157,463,2281
3.077,1,8,672,8,56,439,56,672,0,0,0,0,0
1783.523,17,142,11360,71,48,25478,48,5396,71,56,25478,56,5964
70.856,6,9,515,5,43,17714,43,299,4,0,23615,0,216
48.986,6,35,9933,17,619,1018,1360,3190,18,500,2871,3502,6743
11.443,17,8,704,4,48,3811,48,304,4,72,3811,72,400
109.259,17,4,304,2,48,109258,64,152,2,48,109257,64,152
283.011,6,34,8412,14,143,21770,267,1426,20,475,14888,1400,6986
1205.954,17,236,17936,236,48,5131,48,17936,0,0,0,0,0
280.489,6,31,7472,13,158,23374,267,1317,18,543,16496,1380,6155
0.181,6,7,555,6,275,28,275,515,1,0,0,0,40
1619.802,6,135,10444,73,65,19020,65,5455,62,58,26552,59,4989
1771.863,6,103,9382,66,64,27259,64,5544,37,58,49215,58,3838
0.026,17,2,170,1,37,0,37,65,1,77,0,77,105
280.188,6,29,7392,14,158,21552,267,1357,15,678,20011,3536,6035
166.098,2,4,128,4,8,55366,8,128,0,0,0,0,0
0.016,1,2,112,2,28,16,28,112,0,0,0,0,0
0.27,17,2,152,1,48,0,48,76,1,48,0,48,76
0.997,6,28,6027,15,142,71,267,1602,13,650,76,1420,4425
2.206,6,14,2351,8,188,315,245,700,6,703,389,1152,1651
0.002,6,2,287,2,103,2,138,287,0,0,0,0,0
1786.298,17,87,3648,86,14,21015,14,3612,1,8,0,8,36
1775.039,17,138,11040,69,48,26103,48,5244,69,56,26103,56,5796
27.319,1,4,224,4,28,9106,28,224,0,0,0,0,0
1770.271,6,134,8246,72,27,24932,27,4368,62,27,29020,27,3878
168.353,17,5,1888,5,349,42088,548,1888,0,0,0,0,0
171.272,17,2,460,2,202,171272,355,460,0,0,0,0,0
1788.367,6,201,16803,129,69,13971,69,9576,72,69,25187,69,7227
9.357,6,36,8307,18,360,550,765,1833,18,441,533,1460,6474
1775.407,17,140,11200,70,48,25730,48,5320,70,56,25730,56,5880
4.505,6,39,7269,19,218,250,314,3383,20,513,223,1179,3886
43.116,17,6,456,6,48,8623,48,456,0,0,0,0,0
879.537,6,108,14212,61,83,14658,267,4951,47,179,19120,1452,9261
280.228,6,27,7312,12,158,25475,267,1277,15,678,20012,2800,6035
0.008,6,3,478,2,179,1,267,438,1,0,0,0,40
0.015,17,2,437,1,40,0,40,68,1,341,0,341,369
2.039,6,13,2311,8,188,291,245,700,5,1407,448,1407,1611
0.449,6,13,1693,7,288,74,288,588,6,426,49,434,1105
0.028,6,14,4044,8,88,3,88,452,6,1670,5,1880,3592
52.744,17,4,352,2,60,52743,60,176,2,60,52742,60,176
1789.883,1,140,14840,140,78,12876,78,14840,0,0,0,0,0
36.821,17,14,1064,14,48,2832,48,1064,0,0,0,0,0
242.483,6,54,10990,26,202,9699,834,3038,28,462,8980,2816,7952
276.878,17,4,352,2,60,276876,60,176,2,60,276877,60,176
1.681,6,10,1514,5,503,420,503,771,5,475,420,475,743
0.22,17,2,180,1,30,0,30,58,1,94,0,94,122
0.015,17,2,128,1,28,0,28,56,1,44,0,44,72
0.075,17,2,251,1,36,0,36,64,1,159,0,159,187
69.523,6,69,47808,45,1170,1580,1408,39826,24,747,2678,1408,7982
1.363,6,47,19226,27,895,52,1360,13650,20,476,61,2715,5576
8.223,17,3,228,3,48,4111,48,228,0,0,0,0,0
0.021,17,2,550,2,247,21,247,550,0,0,0,0,0
1743.464,6,98,7359,62,38,28581,205,4424,36,33,49804,98,2935
97.078,6,28,13952,13,549,69,1460,2761,15,1175,6924,1460,11191
0.649,6,25,6560,12,137,59,267,1172,13,694,53,1400,5388
1686.503,17,14,1036,7,30,281076,30,406,7,62,281075,62,630
1788.732,17,561,188400,561,307,3194,308,188400,0,0,0,0,0
1687.401,17,16,1184,8,30,241050,30,464,8,62,241050,62,720
1681.281,17,14,1036,7,30,280209,30,406,7,62,280209,62,630
1798.179,6,359,22709,209,69,8645,69,12569,150,69,12066,69,10140
4.673,6,24,6515,11,262,461,517,1368,13,744,384,1418,5147
1.523,17,11,5066,5,468,380,1350,2482,6,402,156,1350,2584
430.302,17,8,2656,8,304,61471,308,2656,0,0,0,0,0
1784.144,17,142,11360,71,48,25487,48,5396,71,56,25487,56,5964
3.816,17,10,2322,5,30,950,30,290,5,378,951,468,2032
1785.921,17,83,3480,82,14,22048,14,3444,1,8,0,8,36
1798.8,6,141,13665,85,64,21414,722,7087,56,83,32698,1440,6578
1.573,6,2,92,1,0,0,0,40,1,0,0,0,52
1797.007,6,127,7874,73,43,24958,208,4753,54,31,33897,31,3121
1766.645,1,58,4872,58,56,30993,56,4872,0,0,0,0,0
1786.585,6,150,19350,90,302,20073,302,13740,60,83,30280,83,5610
2.031,17,3,201,3,39,1015,39,201,0,0,0,0,0
1786.992,6,104,8308,68,64,26671,64,4896,36,58,51053,58,3412
240.255,6,54,18518,30,778,8284,1402,15589,24,209,10445,580,2929
300.887,6,41,8757,21,286,15044,797,2112,20,416,513,3488,6645
1331.733,6,62,17333,35,365,39168,1440,6596,27,507,51213,1440,10737
38.75,1,4,224,4,28,12916,28,224,0,0,0,0,0
0.428,17,2,144,1,36,0,36,64,1,52,0,52,80
4.048,17,5,295,5,31,1012,31,295,0,0,0,0,0
97.955,17,6,2016,6,308,19591,308,2016,0,0,0,0,0
2.612,17,31,14542,15,564,183,1350,8880,16,325,171,1350,5662
3.249,6,2,88,2,0,0,0,88,0,0,0,0,0
3.013,17,4,272,2,32,3010,32,120,2,48,3007,48,152
62.096,6,26,7137,12,155,5645,267,1266,14,530,4775,2006,5871
0.201,6,9,1340,5,145,50,145,349,4,827,36,827,991
2.264,6,38,8299,19,321,125,1164,2718,19,437,114,2715,5581
1745.702,6,97,7307,63,38,28156,205,4476,34,33,52887,98,2831
9.286,6,93,30446,48,585,197,1152,24164,45,447,205,1179,6282
300.807,6,41,9755,23,537,13673,1360,4188,18,402,507,2720,5567
1795.227,17,114,9120,57,48,32057,48,4332,57,56,32057,56,4788
1741.337,6,87,6322,58,31,30549,31,3915,29,31,62189,31,2407
248.163,17,4,352,2,60,248162,60,176,2,60,248162,60,176
0.111,6,9,1340,5,145,27,145,349,4,827,25,827,991
80.203,17,7,2352,7,308,13367,308,2352,0,0,0,0,0
1773.292,6,180,15480,120,69,14901,69,8940,60,69,30049,69,6540
1.347,6,24,8004,12,164,103,267,1288,12,1014,103,2736,6716
0.398,6,29,7088,17,244,24,656,2394,12,601,35,1420,4694
10.85,17,3,211,2,37,10014,37,130,1,53,0,53,81
0.422,6,28,7336,13,155,35,267,1301,15,775,27,4836,6035
251.435,2,2,64,2,8,251435,8,64,0,0,0,0,0
472.472,2,5,160,5,8,118118,8,160,0,0,0,0,0
0.167,6,16,2993,9,282,20,531,1606,7,338,24,777,1387
1.31,6,10,1687,7,100,218,100,384,3,1179,526,1179,1303
1787.693,6,102,8228,68,64,26681,64,4896,34,58,54170,58,3332
1.695,17,35,23392,19,752,94,1350,14825,16,507,100,1350,8567
5.223,6,39,7269,20,218,274,314,3423,19,513,276,1179,3846
1.588,6,51,19447,29,895,56,1360,13746,22,400,65,1360,5701
1782.191,17,83,3480,82,14,22002,14,3444,1,8,0,8,36
0.324,6,26,8990,13,247,27,624,1672,13,1105,24,2816,7318
15.284,6,6,288,1,0,0,0,48,5,0,3818,0,240
1783.575,6,102,8296,68,65,26620,65,4930,34,59,54045,59,3366
5.451,6,2,111,2,31,5451,31,111,0,0,0,0,0
280.308,6,30,7432,13,158,23359,267,1317,17,543,17514,1400,6115
0.597,6,10,1379,5,145,149,145,349,5,826,84,826,1030
0.988,1,2,112,2,28,988,28,112,0,0,0,0,0
280.805,6,30,7432,14,158,21600,267,1357,16,603,18712,2760,6075
1797.819,17,448,39384,403,35,4472,288,25412,45,282,40020,288,13972
1799.034,17,449,39928,404,35,4464,288,25708,45,288,40021,288,14220
1.31,6,46,19196,27,896,50,1360,13660,19,476,63,2715,5536
164.889,17,4,352,2,60,164888,60,176,2,60,164888,60,176
64.049,6,29,7392,13,158,5337,267,1317,16,603,4267,2036,6075
1756.064,6,105,6270,60,27,29762,27,3525,45,27,39908,27,2745
273.171,17,4,352,2,60,273170,60,176,2,60,273170,60,176
300.793,2,3,96,3,8,150396,8,96,0,0,0,0,0
1786.611,6,104,8376,68,65,26665,65,4930,36,59,51043,59,3446
1634.273,1,7,392,7,28,272378,28,392,0,0,0,0,0
1774.114,1,176,9856,176,28,10137,28,9856,0,0,0,0,0
1794.547,17,83,3480,82,14,22154,14,3444,1,8,0,8,36
246.682,17,4,352,2,60,246681,60,176,2,60,246680,60,176
1750.924,17,13,534,11,14,175073,14,462,2,8,1750739,8,72
11.749,6,1857,1623248,1131,1381,10,1420,1589987,726,467,16,1883,33261
21.536,17,2,152,2,48,21536,48,152,0,0,0,0,0
130.871,17,4,240,2,32,130870,32,120,2,32,130870,32,120
281.416,6,34,8002,15,158,20101,267,1397,19,486,15632,1400,6605
0.012,6,10,1060,5,517,2,517,785,5,7,3,7,275
1771.354,6,104,9580,68,64,26438,64,5724,36,58,50607,58,3856
1602.478,6,159,16360,79,73,19327,722,6413,80,143,20281,1380,9947
32.811,6,48,9136,23,401,687,889,2228,25,327,1362,1360,6908
0.179,17,2,180,1,30,0,30,58,1,94,0,94,122
15.532,17,22,15042,12,823,1409,1350,10214,10,454,1722,1350,4828
1746.63,6,97,7307,63,38,28171,205,4476,34,33,52920,98,2831
35.627,17,10,760,10,48,3958,48,760,0,0,0,0,0
0.059,6,9,1339,5,145,14,145,349,4,826,14,826,990
240.213,6,51,14001,28,622,8896,1402,11425,23,171,10918,580,2576
43.465,1,36,3744,0,0,0,0,0,36,76,1241,76,3744
1740.5,17,30,31680,30,1028,60017,1028,31680,0,0,0,0,0
0.24,6,14,4877,7,75,39,75,459,7,1348,40,1448,4418
1792.594,1,254,26924,254,78,7085,78,26924,0,0,0,0,0
0.926,17,3,174,3,30,463,30,174,0,0,0,0,0
0.493,17,3,451,2,39,457,39,134,1,289,0,289,317
290.011,1,2,768,2,356,290011,376,768,0,0,0,0,0
1763.394,2,14,448,14,8,135645,8,448,0,0,0,0,0
300.963,6,28,8051,13,204,25065,467,1500,15,525,21485,2688,6551
39.846,6,31,8912,15,158,2846,267,1397,16,858,2648,3456,7515
2.461,6,31,6255,16,338,164,1314,2334,15,331,174,1414,3921
0.814,6,20,5948,11,281,81,544,1288,9,716,91,1420,4660
1776.836,17,141,11276,71,48,25382,48,5396,70,56,25750,56,5880
34.068,17,20,1520,20,48,1793,48,1520,0,0,0,0,0
300.38,6,37,22046,23,1081,13653,1440,16342,14,828,2322,1440,5704
0.177,6,26,7256,13,155,14,267,1301,13,678,13,2045,5955
65.858,6,31,17876,18,1129,3874,1448,12239,13,707,5474,1448,5637
11.615,6,25,8473,13,275,967,275,1078,12,986,765,1440,7395
1.432,6,50,19655,27,917,55,1460,13959,23,476,55,2920,5696
4.142,6,39,7269,19,218,230,314,3383,20,440,204,1152,3886
1798.211,1,345,28980,345,56,5227,56,28980,0,0,0,0,0
0.493,17,3,451,2,39,98,39,134,1,289,0,289,317
0.209,6,38,29035,22,243,9,444,1906,16,2190,13,4224,27129
28.524,6,48,13189,23,162,1296,721,2713,25,676,1179,1440,10476
1.268,6,49,19617,27,917,48,1360,13961,22,476,52,2715,5656
0.202,17,2,290,1,40,0,40,68,1,194,0,194,222
280.186,6,29,7392,13,158,23348,267,1317,16,603,18677,2036,6075
1.411,6,47,19333,27,903,54,1360,13757,20,476,64,2715,5576
1.503,6,11,1727,7,100,250,100,384,4,589,418,1152,1343
1138.45,2,10,320,10,8,126494,8,320,0,0,0,0,0
1781.338,6,127,11614,77,66,23438,66,6518,50,60,36350,60,5096
200.451,6,11,2079,2,0,268,0,84,9,233,25024,233,1995
9.403,6,81,24765,42,560,229,1152,19048,39,461,240,1179,5717
0.119,6,9,1147,5,145,29,145,349,4,634,36,634,798
1795.948,17,449,39928,404,35,4456,288,25708,45,288,40020,288,14220
0.088,17,2,334,1,32,0,32,60,1,246,0,246,274
5.254,17,3,3258,3,1058,2627,1058,3258,0,0,0,0,0
3.443,17,8,1248,4,64,1067,64,368,4,192,1040,192,880
463.319,17,16,3804,8,33,66186,37,492,8,386,66186,463,3312
169.631,17,4,352,2,60,169630,60,176,2,60,169630,60,176
1792.87,17,84,3522,83,14,21864,14,3486,1,8,0,8,36
5.376,6,41,7349,22,218,256,314,3503,19,513,284,1179,3846
0.199,17,2,193,1,46,0,46,74,1,91,0,91,119
293.917,17,4,352,2,60,293916,60,176,2,60,293916,60,176
2.91,17,15,6504,8,481,415,1350,4074,7,319,221,1350,2430
1405.258,6,305,27927,165,119,8568,1189,13076,140,146,10109,1917,14851
1742.582,6,96,7286,63,38,28106,205,4476,33,33,54448,98,2810
0.183,17,2,157,1,31,0,31,59,1,70,0,70,98
68.166,6,19,1865,8,177,129,177,955,11,110,6800,110,910
81.179,6,19,780,8,0,6999,0,324,11,0,8116,0,456
52.127,1,6,336,6,28,10425,28,336,0,0,0,0,0
133.356,6,19,5619,6,152,1997,267,702,13,548,11091,1179,4917
2.904,17,2,152,2,48,2904,48,152,0,0,0,0,0
1.336,6,47,18161,26,882,53,1360,12545,21,433,57,1360,5616
173.608,6,23,9002,11,514,102,1237,2015,12,927,15765,1460,6987
17.792,6,7,380,4,0,5930,0,216,3,0,8890,0,164
1797.74,6,367,25650,214,99,8440,469,15045,153,69,11824,69,10605
14.171,6,2,1175,1,0,0,0,40,1,1095,0,1095,1135
53.739,17,4,240,2,32,53738,32,120,2,32,53738,32,120
1799.683,17,761,45888,761,32,2368,37,45888,0,0,0,0,0
317.106,6,58,18597,33,415,9909,1360,10076,25,441,1491,4649,8521
289.803,17,4,352,2,60,289802,60,176,2,60,289802,60,176
12.001,6,2,88,2,0,0,0,88,0,0,0,0,0
0.798,6,32,18652,18,702,46,1360,4967,14,1311,48,3510,13685
4.199,17,10,1383,5,31,1025,31,295,5,189,1047,196,1088
1763.543,6,100,7866,66,45,27131,205,4902,34,35,53429,98,2964
491.536,6,55,7055,28,100,18198,722,2871,27,174,18898,1408,4184
0.021,17,2,554,1,30,0,30,58,1,468,0,468,496
120.031,17,4,352,2,60,120030,60,176,2,60,120030,60,176
59.192,6,34,9930,12,155,28,267,1266,22,432,2818,3417,8664
280.468,6,30,7432,13,158,23372,267,1317,17,678,17526,4140,6115
8.009,6,1738,1611745,1108,1377,7,1408,1574321,630,931,12,2816,37424
5.41,6,28,10104,16,762,360,1360,6044,12,713,475,1360,4060
6.878,6,14,2242,8,210,982,210,844,6,545,1350,904,1398
132.648,17,4,352,2,60,132647,60,176,2,60,132646,60,176
1.264,6,13,1182,7,146,209,146,430,6,254,251,506,752
156.05,6,48,10360,18,263,4533,1189,2833,30,287,5380,1420,7527
167.841,6,24,7484,13,858,94,1360,5701,11,266,16767,625,1783
1780.78,6,375,23970,215,69,8321,69,13016,160,69,11193,69,10954
0.647,6,366,346862,209,194,3,230,11963,157,2107,3,5632,334899
0.412,17,2,776,2,360,412,360,776,0,0,0,0,0
0.276,6,20,4960,10,137,30,267,1092,10,692,29,1467,3868
204.688,6,223,175786,136,1343,1516,1440,160279,87,609,1971,1440,15507
0.836,6,34,8231,19,271,46,738,1877,15,574,50,4848,6354
0.014,17,2,344,1,31,0,31,59,1,257,0,257,285
69.956,6,11,1346,6,302,13991,302,912,5,83,17476,83,434
1755.171,6,193,12143,96,52,18475,208,7333,97,31,18280,31,4810
1774.004,6,209,22944,129,75,13859,267,10017,80,127,22454,1452,12927
1.398,6,24,8004,12,164,107,267,1288,12,1014,108,2491,6716
0.005,6,3,120,1,0,0,0,40,2,0,2,0,80
1793.54,6,356,22520,208,69,8664,69,12460,148,69,12200,69,10060
1782.282,6,356,25674,201,107,8911,469,14925,155,68,11573,69,10749
0.75,17,2,204,1,34,0,34,62,1,114,0,114,142
30.827,17,16,1216,16,48,2055,48,1216,0,0,0,0,0
1770.315,1,58,4872,58,56,31058,56,4872,0,0,0,0,0
1796.276,17,448,39896,403,35,4468,288,25676,45,288,40017,288,14220
0.182,1,2,112,2,28,182,28,112,0,0,0,0,0
0.355,17,2,180,1,30,0,30,58,1,94,0,94,122
300.747,6,37,8431,20,291,15828,786,1997,17,478,533,2720,6434
300.829,6,45,10240,23,433,13674,910,3154,22,364,720,2128,7086
1780.035,17,140,11200,70,48,25797,48,5320,70,56,25797,56,5880
1795.111,1,278,15568,278,28,6480,28,15568,0,0,0,0,0
0.006,17,3,1007,1,137,0,137,165,2,393,4,393,842
1795.187,17,80,3354,79,14,23015,14,3318,1,8,0,8,36
9.958,17,4,5488,4,1344,3319,1349,5488,0,0,0,0,0
1794.371,1,254,14224,254,28,7092,28,14224,0,0,0,0,0
1738.677,6,87,6322,58,31,30503,31,3915,29,31,62095,31,2407
8.075,6,1801,1680486,1149,1385,6,1408,1641918,652,931,12,2801,38568
1788.185,17,141,11276,71,48,25545,48,5396,70,56,25915,56,5880
1.148,6,200,153142,117,1350,9,1432,145146,83,389,13,1432,7996
174.972,17,6,528,3,60,87485,60,264,3,60,87485,60,264
1.167,6,24,8004,13,164,82,267,1340,11,1216,99,3819,6664
50.96,2,8,352,8,20,7280,32,352,0,0,0,0,0
0.904,6,13,1392,6,256,177,256,500,7,304,148,304,892
21.633,17,41,7678,18,149,1270,1350,3187,23,167,981,1350,4491
74.867,6,46,11440,22,429,3556,1368,4215,24,373,3247,2736,7225
1790.468,6,362,22898,210,69,8566,69,12678,152,69,11854,69,10220
1793.84,17,180,11520,180,36,10021,36,11520,0,0,0,0,0
15.471,17,26,6239,11,238,1544,1350,2932,15,192,1102,1350,3307
24.65,17,4,1344,4,308,8216,308,1344,0,0,0,0,0
234.272,1,6,336,6,28,46854,28,336,0,0,0,0,0
0.016,17,2,176,1,48,0,48,76,1,72,0,72,100
1.584,6,46,19099,27,889,60,1360,13563,19,476,76,2720,5536
159.722,17,4,352,2,60,159721,60,176,2,60,159721,60,176
0.082,17,4,284,2,32,1,32,120,2,54,1,60,164
31.048,6,6,360,0,0,0,0,0,6,0,0,0,360
10.56,6,20,4442,11,275,1056,275,998,9,768,724,1440,3444
1.322,6,39,9889,20,503,69,1440,4353,19,433,63,1440,5536
85.186,17,4,352,2,60,85185,60,176,2,60,85185,60,176
3.283,17,4,610,3,39,861,39,201,1,381,0,381,409
142.327,17,4,240,2,32,142326,32,120,2,32,142326,32,120
0.905,6,55,14454,27,549,34,1429,4956,28,464,32,2920,9498
1787.665,6,116,13792,75,81,24157,506,5955,41,162,44689,1452,7837
1791.662,1,58,4872,0,0,0,0,0,58,56,31432,56,4872
3.33,17,10,1030,5,44,817,44,360,5,106,824,106,670
0.0,17,1,76,1,48,0,48,76,0,0,0,0,0
1772.857,6,180,15480,120,69,14897,69,8940,60,69,30043,69,6540
1.366,6,11,1727,7,100,227,100,384,4,589,370,1152,1343
1786.768,6,102,8296,68,65,26668,65,4930,34,59,54141,59,3366
1786.98,6,254,29554,133,104,13537,469,12522,121,105,14890,1452,17032
1.221,6,10,1687,7,100,203,100,384,3,1179,477,1179,1303
42.093,17,4,288,2,36,42062,36,128,2,52,42062,52,160
9.255,6,78,24890,40,568,237,1152,19229,38,459,243,1179,5661
12.346,6,1842,1693570,1195,1364,10,1420,1663363,647,427,19,1420,30207
1416.002,6,175,13292,66,69,21322,294,6303,109,48,13111,78,6989
0.114,17,2,154,1,33,0,33,61,1,65,0,65,93
20.423,6,29,7808,18,129,1201,159,1863,11,766,2041,1675,5945
1739.282,6,89,6426,58,31,30513,31,3915,31,31,57975,31,2511
13.761,6,23,5822,13,275,1146,275,1082,10,1440,972,1440,4740
1789.001,17,83,3480,82,14,22086,14,3444,1,8,0,8,36
1787.848,17,48,16128,48,308,38039,308,16128,0,0,0,0,0
0.102,6,2,80,1,0,0,0,40,1,0,0,0,40
0.424,6,128,88064,60,131,7,232,2929,68,1329,6,1420,85135
329.3,6,52,6591,28,304,12196,304,4540,24,83,14316,83,2051
3.175,6,14,2351,8,188,453,245,700,6,1407,583,1407,1651
0.111,6,7,423,4,43,25,43,259,3,0,24,0,164
0.091,17,4,336,2,34,1,34,124,2,78,42,84,212
1784.202,17,136,10880,68,48,26629,48,5168,68,56,26629,56,5712
3.221,6,2,88,2,0,0,0,88,0,0,0,0,0
15.091,17,6,5216,6,841,3018,1451,5216,0,0,0,0,0
1025.139,6,130,10132,48,72,21808,375,4828,82,49,12656,143,5304
1787.493,17,87,3648,86,14,21029,14,3612,1,8,0,8,36
0.211,6,9,1340,5,145,52,145,349,4,827,34,827,991
0.299,6,21,5000,10,137,33,267,1092,11,577,28,1400,3908
0.087,2,2,64,2,8,87,8,64,0,0,0,0,0
0.199,17,8,2758,8,316,28,355,2758,0,0,0,0,0
1729.181,6,62,4504,40,33,44337,33,2740,22,31,82331,31,1764
11.699,6,6,328,4,0,3899,0,216,2,0,11467,0,112
0.241,6,25,7216,12,155,21,267,1261,13,678,19,2045,5955
1.74,17,24,14552,13,906,142,1350,12146,11,190,171,1350,2406
8.583,6,3,302,0,0,0,0,0,3,91,4291,91,302
1442.737,6,146,12533,96,69,15186,69,7221,50,69,29443,69,5312
1738.962,6,87,6322,58,31,30508,31,3915,29,31,62105,31,2407
0.006,17,4,352,2,60,4,60,176,2,60,5,60,176
0.323,6,27,8920,13,227,26,547,1592,14,941,22,1408,7328
1795.668,6,125,7940,72,47,25291,208,4890,53,31,34521,31,3050
2.913,17,8,1132,4,31,968,31,236,4,196,967,196,896
0.59,6,23,7342,14,318,45,600,2022,9,807,71,1471,5320
1795.375,17,448,39896,403,35,4466,288,25676,45,288,40017,288,14220
10.261,6,2,1175,1,0,0,0,40,1,1095,0,1095,1135
1799.716,17,448,39896,403,35,4476,288,25676,45,288,40020,288,14220
3.888,17,25,10897,12,556,353,1350,7019,13,270,248,1350,3878
300.85,6,42,13645,23,891,13675,1360,8083,19,399,480,1360,5562
15.247,6,2350,2193719,1516,1371,9,1408,2145687,834,931,18,2801,48032
300.836,6,37,8549,20,308,15833,888,2115,17,522,543,3388,6434
92.132,6,8,559,5,31,23033,31,310,3,31,46057,31,249
0.281,17,8,2750,8,315,40,354,2750,0,0,0,0,0
0.033,6,3,120,3,0,0,0,120,0,0,0,0,0
1143.635,1,12,672,12,28,103966,28,672,0,0,0,0,0
15.033,6,2561,2416858,1648,1388,9,1408,2364682,913,776,16,1408,52176
1747.626,6,92,6985,61,38,29127,205,4341,31,33,58243,98,2644
1779.514,6,353,22400,206,69,8680,69,12380,147,69,12187,69,10020
240.237,6,54,18189,29,762,8579,1402,15251,25,203,10009,580,2938
289.172,17,6,360,3,32,144585,32,180,3,32,144585,32,180
0.001,6,2,80,1,0,0,0,40,1,0,0,0,40
159.172,6,27,6494,11,220,6295,516,1326,16,348,10605,1452,5168
120.997,17,4,240,2,32,120996,32,120,2,32,120996,32,120
128.617,6,22,9889,11,433,75,990,1771,11,1095,12848,2920,8118
397.204,17,59,4484,59,48,6848,48,4484,0,0,0,0,0
11.99,6,2215,2050418,1405,1381,8,1408,2003634,810,931,14,2801,46784
1794.501,17,140,11200,70,48,26007,48,5320,70,56,26007,56,5880
30.717,6,6,360,0,0,0,0,0,6,0,0,0,360
1777.57,17,73,3060,72,14,25036,14,3024,1,8,0,8,36
0.101,6,12,1980,6,130,20,130,402,6,1326,20,1326,1578
1793.69,17,171,10944,171,36,10551,36,10944,0,0,0,0,0
8.686,6,38,10613,20,359,457,764,1923,18,612,500,3488,8690
69.558,6,75,49010,45,1190,1580,1408,39307,30,903,2124,2816,9703
1769.953,6,99,9306,66,66,27230,66,5610,33,60,55308,60,3696
1680.091,1,7,392,7,28,280015,28,392,0,0,0,0,0
0.313,17,4,288,2,36,281,36,128,2,52,281,52,160
56.284,6,46,11021,22,819,1019,1360,5104,24,309,2439,2720,5917
702.271,6,37,3444,24,324,30533,584,1904,13,282,20070,580,1540
0.597,6,32,8267,15,401,42,888,1835,17,441,26,1460,6432
170.207,6,61,11044,26,224,4918,1189,3291,35,288,5005,1420,7753
1771.206,6,99,9240,66,65,27249,65,5577,33,59,55347,59,3663
1796.533,17,449,39928,404,35,4457,288,25708,45,288,40019,288,14220
0.386,6,13,1693,7,288,64,288,588,6,284,36,434,1105
109.491,6,30,13426,15,534,60,1288,2246,15,1056,7807,1709,11180
1375.195,2,10,320,10,8,152799,8,320,0,0,0,0,0
1784.927,6,104,8376,68,65,26640,65,4930,36,59,50995,59,3446
12.296,6,25,8453,13,275,1024,275,1078,12,983,1019,1420,7375
212.036,1,2,120,2,32,212036,32,120,0,0,0,0,0
38.203,17,22,1672,22,48,1819,48,1672,0,0,0,0,0
372.343,6,22,2379,16,183,24822,183,855,6,424,4653,434,1524
0.356,6,39,22265,23,307,16,640,2197,16,1602,22,4524,20068
300.815,6,120,85734,66,1343,4627,1448,77348,54,696,502,1448,8386
1787.232,6,372,23781,213,69,8430,69,12867,159,69,11311,69,10914
1789.331,1,228,12768,228,28,7882,28,12768,0,0,0,0,0
1723.144,1,130,13780,130,78,13357,78,13780,0,0,0,0,0
503.968,2,5,160,5,8,125992,8,160,0,0,0,0,0
1798.603,17,449,39928,404,35,4463,288,25708,45,288,40015,288,14220
17.393,6,19,3398,8,92,2484,92,504,11,567,1716,1408,2894
0.677,17,12,6304,6,615,135,1350,3860,6,379,70,1350,2444
0.005,17,2,160,2,52,5,52,160,0,0,0,0,0
7.071,6,1286,1177478,808,1380,8,1408,1147958,478,776,14,1408,29520
29.442,6,2,142,2,31,29442,31,142,0,0,0,0,0
18.138,17,4,824,2,48,18130,48,152,2,308,18128,308,672
22.394,6,10,436,4,0,7464,0,172,6,0,4309,0,264
280.312,6,28,7352,13,158,23359,267,1317,15,678,20020,2045,6035
1783.207,17,142,11360,71,48,25473,48,5396,71,56,25473,56,5964
125.658,2,2,64,2,8,125658,8,64,0,0,0,0,0
289.438,17,4,352,2,60,289437,60,176,2,60,289437,60,176
0.241,6,22,5040,11,137,24,267,1132,11,577,23,1400,3908
3.134,17,6,1012,4,32,1019,32,240,2,358,133,470,772
1.077,6,29,5933,13,123,89,267,1388,16,650,64,1452,4545
2.992,17,3,1167,3,361,1496,361,1167,0,0,0,0,0
85.092,6,84,39370,46,949,1890,1440,36036,38,201,2296,754,3334
12.762,17,3,984,3,300,6381,300,984,0,0,0,0,0
8.21,6,24,6642,8,154,1172,267,800,16,518,539,1420,5842
0.384,6,10,1992,5,288,92,288,508,5,424,54,434,1484
554.11,6,50,8362,26,117,19878,516,2454,24,247,24087,1452,5908
75.67,6,30,7754,9,155,9458,267,1146,21,338,3774,1917,6608
1574.194,1,79,4424,79,28,20181,28,4424,0,0,0,0,0
1744.597,2,28,896,28,8,64614,8,896,0,0,0,0,0
0.984,6,28,8582,15,229,66,583,2043,13,1001,66,2720,6539
1016.613,6,203,12812,117,69,8763,69,7026,86,69,11959,69,5786
0.021,17,2,198,1,39,0,39,67,1,103,0,103,131
0.43,6,27,9069,14,257,33,669,1766,13,945,33,1438,7303
1770.942,6,101,9410,66,66,27245,66,5610,35,60,52083,60,3800
310.076,6,85,14470,57,515,721,1282,7442,28,295,11481,1452,7028
1747.756,6,99,7411,63,38,28189,205,4476,36,33,49930,98,2935
0.361,1,10,280,10,0,0,0,280,0,0,0,0,0
269.783,6,34,3279,21,98,13489,205,1979,13,48,22450,98,1300
5.093,17,4,304,4,48,1697,48,304,0,0,0,0,0
1082.357,6,110,9437,73,69,15032,69,5473,37,69,30064,69,3964
11.811,6,1880,1622585,1145,1363,10,1380,1588931,735,421,16,1923,33654
31.577,6,6,360,0,0,0,0,0,6,0,0,0,360
19.699,6,9,570,6,43,3939,43,406,3,0,9846,0,164
1.643,17,23,9749,12,368,146,1350,4756,11,425,160,1350,4993
4.4,6,23,6478,11,268,435,517,1385,12,744,395,1418,5093
0.642,6,20,7238,13,335,53,668,2026,7,1210,100,1946,5212
3.992,6,12,507,6,0,798,0,248,6,7,593,7,259
1118.186,17,215,16340,215,48,5225,48,16340,0,0,0,0,0
0.916,17,2,602,1,46,0,46,74,1,500,0,500,528
744.258,17,60,4800,30,48,25663,48,2280,30,56,25663,56,2520
0.321,17,14,5934,6,395,64,1350,2538,8,396,29,1350,3396
8.262,6,35,8025,20,204,432,517,2080,15,533,586,1380,5945
11.175,6,22,6817,12,275,1015,275,1038,10,1073,685,1420,5779
1771.962,6,99,9240,66,65,27260,65,5577,33,59,55371,59,3663
1783.258,17,142,11360,71,48,25474,48,5396,71,56,25474,56,5964
1796.404,2,24,768,24,8,78104,8,768,0,0,0,0,0
1003.039,1,18,1008,18,28,59002,28,1008,0,0,0,0,0
1799.329,6,83,5326,41,36,44981,36,2240,42,445,43884,445,3086
152.067,17,4,352,2,60,152066,60,176,2,60,152066,60,176
0.359,17,8,2750,8,315,51,354,2750,0,0,0,0,0
2.703,6,11,975,6,304,540,304,624,5,83,664,83,351
95.181,6,41,8767,17,371,2112,766,1837,24,331,4132,3488,6930
300.912,6,41,13617,23,892,13677,1360,8095,18,435,513,2667,5522
15.28,6,15,6152,4,222,5051,222,402,11,1059,1515,4080,5750
18.997,6,26,5001,14,170,1461,722,1926,12,611,1694,2329,3075
0.053,17,2,491,1,29,0,29,57,1,406,0,406,434
1099.651,17,763,53550,690,40,1596,41,47375,73,56,676,57,6175
262.572,17,4,352,2,60,262571,60,176,2,60,262571,60,176
60.146,2,2,64,2,8,60146,8,64,0,0,0,0,0
154.136,6,18,732,7,0,6101,0,284,11,0,15412,0,448
1605.672,1,18,2243,18,96,94451,173,2243,0,0,0,0,0
280.258,6,30,7432,13,158,23354,267,1317,17,543,17509,1400,6115
5.465,6,42,7405,22,218,260,314,3503,20,442,274,1152,3902
0.144,17,2,157,1,31,0,31,59,1,70,0,70,98
312.112,6,28,6670,12,139,28373,159,1214,16,771,20807,1669,5456
0.076,17,2,136,1,32,0,32,60,1,48,0,48,76
11.266,6,27,11373,13,275,938,275,1078,14,1080,835,1420,10295
0.494,17,3,451,2,39,28,39,134,1,289,0,289,317
198.941,17,4,240,2,32,198940,32,120,2,32,198940,32,120
1.761,17,20,5180,20,231,92,388,5180,0,0,0,0,0
1.203,6,46,18124,26,882,48,1360,12548,20,433,54,1360,5576
280.201,6,28,7352,13,158,23350,267,1317,15,678,20012,2800,6035
1783.814,6,360,22818,209,69,8576,69,12638,151,69,11892,69,10180
1.103,17,6,432,3,32,548,32,180,3,56,548,60,252
388.745,6,23,1538,16,180,25916,180,1056,7,110,10377,110,482
1.296,6,49,18770,28,918,48,1460,13109,21,400,55,1460,5661
1665.714,1,7,392,7,28,277619,28,392,0,0,0,0,0
110.562,17,4,300,2,47,110561,47,150,2,47,110561,47,150
1788.561,1,238,13328,238,28,7546,28,13328,0,0,0,0,0
0.013,17,3,1007,1,137,0,137,165,2,393,12,393,842
0.264,6,4,1037,2,0,243,0,104,2,853,29,853,933
142.253,6,127,102256,85,1268,1693,1368,91944,42,738,2581,2519,10312
1738.114,1,56,4704,56,56,31602,56,4704,0,0,0,0,0
0.215,1,2,112,2,28,215,28,112,0,0,0,0,0
1767.978,1,56,4704,56,56,32145,56,4704,0,0,0,0,0
1787.609,6,113,12288,74,82,24487,507,5949,39,129,47037,1452,6339
0.184,17,4,588,2,48,163,48,152,2,190,165,308,436
15.383,17,16,6591,8,479,2188,1350,4058,8,288,2187,1350,2533
0.684,17,2,780,2,362,684,362,780,0,0,0,0,0
986.152,6,125,9699,47,72,21434,337,4693,78,49,12805,143,5006
0.004,17,2,308,1,34,0,34,62,1,218,0,218,246
1669.886,6,228,17252,121,122,13915,469,10221,107,45,8904,69,7031
1776.511,17,140,11200,70,48,25746,48,5320,70,56,25746,56,5880
1788.411,17,87,3648,86,14,21040,14,3612,1,8,0,8,36
4.264,6,38,7229,19,218,236,314,3383,19,513,222,1179,3846
12.624,6,14,2245,8,211,1803,211,846,6,545,2495,904,1399
212.641,17,4,352,2,60,212640,60,176,2,60,212640,60,176
0.452,6,86,54187,49,1255,9,1432,48416,37,427,12,1432,5771
653.501,6,27,1392,14,0,50264,0,728,13,0,54452,0,664
1799.357,6,355,22480,207,69,8734,69,12420,148,69,12240,69,10060
0.514,17,19,13492,11,1007,41,1350,11395,8,234,58,1350,2097
0.176,6,2,111,1,31,0,31,71,1,0,0,0,40
1786.014,17,87,3648,86,14,21011,14,3612,1,8,0,8,36
8.003,6,14,3145,8,49,1143,92,511,6,579,42,1408,2634
866.23,6,51,4148,34,65,26249,65,2465,17,59,54133,59,1683
77.693,6,59,38626,38,1152,2099,1408,30792,21,841,3072,2439,7834
35.159,6,31,5107,15,180,2511,722,1871,16,342,2291,1408,3236
175.179,17,2,72,1,8,0,8,36,1,8,0,8,36
7.859,6,18,6767,9,275,982,275,643,9,1150,624,1414,6124
7.648,6,1178,1052964,747,1360,10,1420,1031397,431,427,17,1420,21567
0.147,17,2,172,1,50,0,50,78,1,66,0,66,94
0.473,17,4,580,2,40,405,40,136,2,194,441,194,444
475.463,17,6,528,3,60,237731,60,264,3,60,237731,60,264
60.392,6,27,7029,14,150,4645,174,864,13,512,3076,1420,6165
1.277,6,84,32681,50,558,26,1360,23258,34,536,35,4649,9423
0.069,17,2,279,1,36,0,36,64,1,187,0,187,215
2.764,6,24,6636,13,350,229,1089,2276,11,783,275,1420,4360
1740.682,17,28,6580,28,207,64469,207,6580,0,0,0,0,0
2.09,17,2,685,1,308,0,308,336,1,321,0,321,349
0.488,6,52,22635,28,1081,18,1380,17433,24,421,19,2760,5202
1772.783,6,180,15480,120,69,14897,69,8940,60,69,30045,69,6540
362.627,2,4,128,4,8,120875,8,128,0,0,0,0,0
1749.01,6,96,7255,62,38,28672,205,4424,34,33,52990,98,2831
123.541,6,24,2822,11,302,12354,302,1474,13,83,10294,83,1348
10.221,6,65,20582,34,559,309,1152,15915,31,489,331,1179,4667
0.006,17,3,1007,1,137,0,137,165,2,393,0,393,842
1673.919,1,8,448,8,28,239131,28,448,0,0,0,0,0
0.349,6,28,7336,13,155,29,267,1301,15,543,23,1400,6035
1796.041,6,374,29294,217,119,8315,965,16461,157,94,11512,549,12833
1778.963,17,206,20848,206,73,8677,346,20848,0,0,0,0,0
240.624,6,146,187534,63,239,3880,562,4719,83,2586,2934,7010,182815
1787.299,6,184,32664,108,352,16703,1294,23362,76,118,23828,268,9302
292.782,1,4,224,4,28,97594,28,224,0,0,0,0,0
945.187,6,124,8504,47,46,20546,46,3584,77,46,12436,46,4920
3.017,17,8,1718,4,37,1001,37,260,4,336,999,348,1458
0.403,6,17,6337,9,141,50,275,646,8,894,27,1440,5691
105.596,17,3,365,2,114,105596,156,284,1,53,0,53,81
132.279,6,25,12059,12,410,65,922,1754,13,1085,11012,1460,10305
1687.269,17,16,1265,8,30,241033,37,471,8,71,241033,136,794
1797.794,17,446,39832,401,35,4494,288,25612,45,288,40016,288,14220
18.462,6,20,17057,5,196,2637,196,436,15,1231,1305,1360,16621
0.508,6,21,5000,11,137,50,267,1132,10,692,54,1467,3868
503.979,2,3,96,3,8,251989,8,96,0,0,0,0,0
31.584,6,7,336,1,0,0,0,48,6,0,6314,0,288
5.122,6,38,8439,19,175,284,721,2164,19,551,273,2840,6275
289.965,17,4,352,2,60,289964,60,176,2,60,289964,60,176
300.797,6,45,12064,23,558,13672,1448,4613,22,370,690,1448,7451
286.079,6,33,3365,16,324,19071,585,1525,17,192,17879,580,1840
231.638,17,4,288,2,36,231594,36,128,2,52,231590,52,160
0.536,6,20,7238,13,335,44,668,2026,7,1210,81,1946,5212
301.028,6,59,23679,34,1089,9122,1360,17801,25,374,448,2667,5878
0.354,17,2,180,1,30,0,30,58,1,94,0,94,122
6.814,6,66,20478,34,554,206,1152,15771,32,427,211,1152,4707
1786.332,6,102,8228,68,64,26661,64,4896,34,58,54128,58,3332
8.291,6,17,6751,9,275,1036,275,643,8,1444,1079,2840,6108
1786.225,17,87,3648,86,14,21014,14,3612,1,8,0,8,36
93.592,6,23,10009,12,531,64,1360,2637,11,1384,9343,3934,7372
1780.257,17,142,11360,71,48,25432,48,5396,71,56,25432,56,5964
11.774,6,1828,1618104,1143,1363,10,1380,1586462,685,421,17,1923,31642
1.397,6,50,19330,27,894,53,1460,13634,23,433,55,1460,5696
177.23,6,42,11599,14,181,13633,267,1288,28,399,6553,1400,10311
1792.537,6,390,34240,202,108,8918,469,15820,188,117,9585,1460,18420
240.298,6,52,18215,27,811,9241,1418,15210,25,212,10011,580,3005
1.367,6,24,8004,12,164,105,267,1288,12,1014,105,2491,6716
1.419,17,25,17378,11,549,141,1350,6356,14,759,106,1350,11022
0.252,17,3,196,2,32,252,32,120,1,48,0,48,76
1732.911,1,108,6048,108,28,16195,28,6048,0,0,0,0,0
61.319,6,35,15984,22,815,2919,1408,9310,13,855,5089,3847,6674
1797.845,17,446,149868,446,308,4040,320,149868,0,0,0,0,0
0.493,6,52,21299,29,1061,17,1380,16092,23,387,20,1923,5207
120.25,6,52,16684,20,506,643,1440,6468,32,445,3874,1440,10216
1595.235,1,8,448,8,28,227890,28,448,0,0,0,0,0
1786.458,6,140,23753,86,324,21017,1303,17375,54,98,33705,242,6378
0.192,6,46,21526,27,1029,7,1420,16545,19,467,10,1883,4981
240.31,6,45,9121,23,523,10922,1418,5918,22,227,11442,618,3203
1.532,17,2,776,2,360,1532,360,776,0,0,0,0,0
256.497,6,420,283402,196,531,1315,1418,26623,224,1310,1150,1418,256779
138.985,17,25,1900,25,48,5791,48,1900,0,0,0,0,0
180.516,6,34,6369,18,240,10614,517,1942,16,539,12025,1611,4427
1770.625,6,108,9856,68,65,26427,65,5758,40,59,45397,59,4098
0.611,6,23,7420,13,337,50,674,2044,10,969,64,1483,5376
0.029,17,8,2750,8,315,4,354,2750,0,0,0,0,0
99.951,6,60,42647,36,1227,2855,1448,22750,24,1035,4342,1448,19897
315.201,6,23,5479,9,133,39399,159,887,14,967,24245,1669,4592
1174.233,17,16,5376,16,308,78282,308,5376,0,0,0,0,0
1795.38,17,442,39136,398,35,4522,288,25232,44,288,40025,288,13904
0.022,6,2,80,1,0,0,0,40,1,0,0,0,40
124.335,17,4,352,2,60,124334,60,176,2,60,124334,60,176
11.38,6,1923,1755201,1155,1434,9,1448,1707197,768,776,14,1448,48004
1796.085,1,58,4872,0,0,0,0,0,58,56,31510,56,4872
1787.405,6,102,8228,68,64,26677,64,4896,34,58,54161,58,3332
1787.407,6,115,12377,76,83,23832,516,6038,39,129,47034,1452,6339
1798.729,6,356,22520,208,69,8689,69,12460,148,69,12236,69,10060
2.089,6,12,2271,7,188,348,245,660,5,1407,458,1407,1611
146.19,17,4,1344,4,308,48730,308,1344,0,0,0,0,0
1764.85,2,13,416,13,8,147070,8,416,0,0,0,0,0
1743.314,6,95,7203,63,38,28117,205,4476,32,33,56222,98,2727
300.557,6,69,54861,45,1319,6830,1448,47226,24,911,1304,1448,7635
15.132,17,12,5295,6,490,3018,1350,3110,6,336,3017,1350,2185
75.072,6,13,540,6,0,2403,0,244,7,0,12510,0,296
113.717,6,31,7911,8,142,4777,267,1181,23,305,5168,1460,6730
2.335,6,13,2311,8,188,333,245,700,5,1407,519,1407,1611
1797.492,17,448,39612,404,35,4460,288,25708,44,288,40950,288,13904
145.928,6,34,7781,12,155,36,267,1266,22,331,6948,1420,6515
300.634,6,40,8608,21,291,15031,786,2049,19,413,472,1440,6559
1764.047,2,15,480,15,8,126003,8,480,0,0,0,0,0
1260.268,2,11,352,11,8,126026,8,352,0,0,0,0,0
1786.077,6,236,61109,129,652,13953,1303,47550,107,144,16848,242,13559
1.289,6,51,20297,28,896,47,1360,14601,23,476,50,2715,5696
186.158,6,158,126311,105,1291,1789,1408,112626,53,642,2510,2439,13685
1772.283,6,180,15480,120,69,14893,69,8940,60,69,30032,69,6540
1762.011,17,169,14115,157,30,11294,37,9155,12,385,154742,463,4960
14.134,6,16,1327,8,222,2018,222,768,8,231,2018,231,559
168.159,6,45,6519,16,152,11198,722,2061,29,147,5999,1408,4458
368.222,6,18,1242,14,180,28324,180,916,4,110,20057,110,326
126.524,6,72,51910,47,1218,2750,1448,43879,25,747,2566,1448,8031
0.755,17,8,2750,8,315,107,354,2750,0,0,0,0,0
1172.611,6,120,7315,64,43,18610,208,4424,56,31,21317,31,2891
1799.806,17,77,3228,76,14,23997,14,3192,1,8,0,8,36
1773.133,6,180,15480,120,69,14900,69,8940,60,69,30046,69,6540
0.105,6,17,5018,11,140,10,140,720,6,1326,21,2478,4298
101.177,6,22,9126,12,304,82,597,1425,10,1214,11223,3081,7701
280.477,6,30,7432,13,158,23373,267,1317,17,543,17523,1400,6115
1783.038,6,379,30158,210,75,8531,267,13464,169,125,10612,1460,16694
0.087,17,4,336,2,34,0,34,124,2,78,82,84,212
1.011,6,8,342,4,0,337,0,164,4,7,264,7,178
0.871,6,10,1687,7,100,145,100,384,3,1179,312,1179,1303
0.489,6,26,9081,13,273,40,733,1778,13,945,38,1368,7303
137.733,17,4,240,2,32,137732,32,120,2,32,137732,32,120
4.388,6,38,7229,19,218,243,314,3383,19,440,229,1152,3846
0.065,17,2,251,1,36,0,36,64,1,159,0,159,187
0.006,17,2,572,1,39,0,39,67,1,477,0,477,505
1572.201,6,183,12610,67,46,23821,46,5302,116,46,13671,46,7308
11.318,6,16,4732,9,290,1414,517,1057,7,1101,1858,1448,3675
0.164,17,2,194,1,61,0,61,89,1,77,0,77,105
1386.64,2,10,320,10,8,154071,8,320,0,0,0,0,0
0.868,17,17,6869,8,485,124,1350,4107,9,278,92,1350,2762
60.25,6,35,23155,18,126,3544,126,1448,17,1486,3763,4344,21707
0.165,6,43,18270,23,1025,7,1432,13249,20,420,8,1432,5021
1097.913,17,216,16416,216,48,5106,48,16416,0,0,0,0,0
1771.303,6,101,9344,66,65,27250,65,5577,35,59,52094,59,3767
0.189,6,27,7296,13,155,15,267,1301,14,543,13,1400,5995
0.512,17,3,451,2,39,195,39,134,1,289,0,289,317
29.822,6,21,3840,12,215,2711,517,1720,9,411,3726,499,2120
0.063,6,9,1342,5,145,15,145,349,4,829,16,829,993
1792.769,17,180,11520,180,36,10015,36,11520,0,0,0,0,0
9.847,6,31,8912,14,158,757,267,1357,17,763,608,2760,7555
61.774,6,70,48247,44,1183,1436,1448,40165,26,746,2461,1448,8082
1.163,6,31,6044,16,111,77,267,1539,15,650,73,1452,4505
1.046,6,9,1369,5,259,261,259,989,4,110,40,110,380
0.881,6,11,1727,7,100,146,100,384,4,589,208,1152,1343
1792.239,1,212,22472,212,78,8494,78,22472,0,0,0,0,0
399.217,6,25,1654,17,180,24951,180,1120,8,110,9549,110,534
1773.317,6,181,15589,120,69,14901,69,8940,61,69,29553,69,6649
316.983,6,123,37044,59,503,5465,1360,25041,64,241,5029,2720,12003
363.608,6,25,1651,17,177,22725,177,1117,8,110,9152,110,534
0.173,1,2,112,2,28,173,28,112,0,0,0,0,0
168.966,1,24,1344,24,28,7346,28,1344,0,0,0,0,0
1743.077,6,97,7307,63,38,28114,205,4476,34,33,52810,98,2831
1762.878,17,46,15424,46,307,39175,308,15424,0,0,0,0,0
9.043,6,44,8567,21,227,452,314,4022,23,402,399,1179,4545
2.201,6,1389,1915075,325,618,6,1396,20633,1064,1736,2,6980,1894442
18.397,6,13,2133,8,324,2628,585,1073,5,396,4464,580,1060
0.849,6,10,968,5,256,165,256,460,5,304,170,304,508
11.759,6,1863,1626776,1149,1363,10,1380,1593974,714,421,16,1923,32802
1786.821,6,106,8584,69,66,26276,66,5004,37,60,49629,60,3580
3.498,17,4,368,4,64,1166,64,368,0,0,0,0,0
3.894,17,4,304,4,48,1298,48,304,0,0,0,0,0
5.562,6,533,459242,327,1338,16,1368,443866,206,931,26,2736,15376
38.665,17,22,1936,11,48,3865,48,836,11,72,3865,72,1100
280.042,6,30,7432,14,158,21541,267,1357,16,603,18667,2036,6075
0.162,6,2,92,1,0,0,0,52,1,0,0,0,40
1786.937,6,102,8296,68,65,26670,65,4930,34,59,54146,59,3366
1.026,6,27,5689,13,140,85,267,1224,14,650,72,1420,4465
25.45,17,3,1152,3,356,12725,356,1152,0,0,0,0,0
1.76,6,11,2663,6,558,352,1100,1361,5,551,264,897,1302
1751.454,6,95,7203,63,38,28249,205,4476,32,33,56490,98,2727
0.738,6,23,5715,13,158,61,370,1315,10,999,81,1731,4400
1796.663,17,461,154848,461,307,3905,308,154848,0,0,0,0,0
132.462,1,6,336,6,28,26492,28,336,0,0,0,0,0
0.025,6,14,5052,7,99,3,99,483,7,1049,4,1448,4569
0.088,17,3,436,2,46,2,46,148,1,260,0,260,288
1699.418,17,12,498,11,14,169941,14,462,1,8,0,8,36
1653.468,1,7,392,7,28,275578,28,392,0,0,0,0,0
5.017,17,4,288,2,36,4985,36,128,2,52,4986,52,160
6.952,6,1483,1386882,928,1417,7,1440,1353346,555,776,12,1440,33536
2.067,17,4,580,2,40,2034,40,136,2,194,2035,194,444
1.261,6,48,19367,27,902,48,1360,13751,21,476,54,2715,5616
13.678,6,25,4785,13,154,1121,721,1790,12,591,1227,2118,2995
0.063,17,2,144,1,36,0,36,64,1,52,0,52,80
0.731,6,31,8259,16,411,48,888,1907,15,521,42,2720,6352
0.529,6,22,7376,13,273,44,663,2052,9,1209,58,1946,5324
1772.016,17,333,70992,333,185,5337,422,70992,0,0,0,0,0
13.3,6,16,6162,6,152,2660,267,702,10,722,1396,1179,5460
0.015,6,10,1888,5,130,3,130,350,5,1326,2,1326,1538
0.082,17,2,672,2,308,82,308,672,0,0,0,0,0
167.38,6,33,7736,11,155,16738,267,1226,22,330,7961,1460,6510
114.741,17,4,1344,4,308,38247,308,1344,0,0,0,0,0
118.054,6,21,8853,7,272,19675,516,1100,14,897,9045,1452,7753
278.803,17,4,352,2,60,278802,60,176,2,60,278801,60,176
238.785,6,10,622,6,43,47757,43,394,4,0,79593,0,228
1787.686,17,87,3648,86,14,21031,14,3612,1,8,0,8,36
0.034,17,2,225,1,37,0,37,65,1,132,0,132,160
140.75,17,4,352,2,60,140749,60,176,2,60,140749,60,176
76.534,6,27,10270,13,523,92,1440,2657,14,880,5876,1440,7613
4.206,17,5,295,5,31,1051,31,295,0,0,0,0,0
0.007,6,4,160,2,0,3,0,80,2,0,7,0,80
20.15,6,18,2368,10,189,2238,517,1298,8,323,2877,499,1070
0.288,17,2,154,1,33,0,33,61,1,65,0,65,93
219.898,17,4,352,2,60,219896,60,176,2,60,219897,60,176
2.437,17,6,1230,3,36,1216,36,192,3,318,1216,318,1038
124.399,6,34,7797,12,155,29,267,1266,22,331,5923,1420,6531
243.628,6,10,600,10,0,0,0,600,0,0,0,0,0
280.04,6,34,7688,15,158,20002,267,1397,19,460,15555,1400,6291
22.229,17,46,11583,19,218,1232,1350,4680,27,227,853,1350,6903
1.454,6,39,11298,21,616,72,1460,5802,18,433,74,1460,5496
136.266,17,8,2688,8,308,19466,308,2688,0,0,0,0,0
1771.905,6,99,9306,66,66,27260,66,5610,33,60,55367,60,3696
11.796,6,1802,1626950,1110,1413,10,1432,1595049,692,420,17,1432,31901
1134.346,2,8,256,8,8,162049,8,256,0,0,0,0,0
300.634,6,37,8408,19,286,16701,797,1936,18,441,498,1360,6472
4.131,6,2,88,2,0,0,0,88,0,0,0,0,0
1.996,6,3,144,2,0,1996,0,92,1,0,0,0,52
2.922,17,10,3616,10,333,324,361,3616,0,0,0,0,0
281.446,6,30,7432,13,158,23453,267,1317,17,603,17588,2760,6115
270.299,6,1259,1143501,850,1329,317,1360,1118811,409,189,662,2667,24690
0.169,6,31,17475,16,129,11,129,969,15,1309,11,1479,16506
1738.326,1,56,4704,56,56,31605,56,4704,0,0,0,0,0
0.038,17,2,144,1,36,0,36,64,1,52,0,52,80
31.576,6,7,336,1,0,0,0,48,6,0,6312,0,288
280.168,6,27,7312,13,158,23347,267,1317,14,775,21550,2800,5995
1777.804,17,73,3060,72,14,25039,14,3024,1,8,0,8,36
572.929,6,27,3476,15,195,40910,1440,2542,12,31,52067,31,934
674.839,17,134,28414,134,184,5073,364,28414,0,0,0,0,0
0.728,1,10,280,10,0,0,0,280,0,0,0,0,0
0.017,17,4,668,2,32,12,32,120,2,246,12,246,548
2.439,6,5,284,3,0,1129,0,164,2,0,2257,0,120
1779.79,17,140,11200,70,48,25793,48,5320,70,56,25793,56,5880
4.008,6,20,6225,11,128,400,128,724,9,1252,500,1472,5501
1787.099,6,104,8376,68,65,26673,65,4930,36,59,51056,59,3446
4.102,6,16,3254,8,49,586,92,511,8,387,557,1448,2743
18.358,6,2817,2611700,1803,1370,10,1408,2554308,1014,931,17,2801,57392
311.678,6,35,7066,15,169,11713,516,1618,20,309,16398,1452,5448
1422.339,17,612,53630,586,40,2431,41,40232,26,487,7626,505,13398
0.413,6,6,324,4,0,137,0,216,2,0,219,0,108
45.96,2,4,128,4,8,15320,8,128,0,0,0,0,0
5.026,17,4,288,2,36,5024,36,128,2,52,5024,52,160
78.864,17,4,244,2,33,78863,33,122,2,33,78863,33,122
1.771,17,4,524,2,39,1740,39,134,2,167,1739,167,390
62.799,2,2,64,2,8,62799,8,64,0,0,0,0,0
721.443,6,119,16572,48,94,15349,659,5288,71,200,10304,1360,11284
1776.738,6,280,33355,117,134,15315,1460,16406,163,127,10966,1642,16949
260.817,17,4,240,2,32,260815,32,120,2,32,260816,32,120
13.5,6,24,5982,13,275,1125,275,1078,11,890,1233,1420,4904
240.434,6,46,9183,24,197,10451,751,2637,22,539,11447,2378,6546
236.581,6,199,152136,126,1299,1891,1360,144140,73,337,3283,1360,7996
0.075,17,2,230,1,40,0,40,68,1,134,0,134,162
0.031,17,4,857,2,34,18,34,124,2,338,20,350,733
0.314,17,2,166,1,39,0,39,67,1,71,0,71,99
1.134,6,58,18030,28,706,42,1360,8921,30,438,38,1360,9109
1793.353,6,365,25501,212,100,8499,469,14896,153,69,11797,69,10605
4.709,6,40,7309,20,218,247,314,3423,20,440,234,1152,3886
9.49,6,28,9966,13,242,776,275,1009,15,759,665,1420,8957
1771.019,6,101,9278,66,64,27246,64,5544,35,58,52086,58,3734
0.013,17,3,634,2,32,8,32,120,1,486,0,486,514
300.155,6,32,11672,17,130,18759,288,1699,15,918,21439,1872,9973
1769.663,17,427,84168,427,169,4154,391,84168,0,0,0,0,0
1790.231,1,47,3948,0,0,0,0,0,47,56,38918,56,3948
225.3,17,4,352,2,60,225299,60,176,2,60,225298,60,176
0.642,6,15,2638,8,288,77,288,640,7,568,78,853,1998
1.656,6,14,2351,8,188,236,245,700,6,703,280,1152,1651
24.183,1,3,168,3,28,12091,28,168,0,0,0,0,0
1775.031,6,181,15589,121,69,14791,69,9049,60,69,30077,69,6540
15.414,17,17,6300,8,483,2192,1350,4095,9,217,1914,1350,2205
33.135,17,4,1344,4,308,11045,308,1344,0,0,0,0,0
1638.78,1,10,560,10,28,182086,28,560,0,0,0,0,0
9.246,6,9,488,5,0,2311,0,280,4,0,2339,0,208
288.562,6,54,8638,26,128,11540,517,2543,28,418,10685,1418,6095
1783.809,6,363,23007,211,69,8494,69,12787,152,69,11813,69,10220
38.675,17,44,6468,22,48,1841,48,1672,22,190,1836,308,4796
124.189,6,25,9968,12,549,64,1440,2709,13,961,10337,1440,7259
0.965,17,5,1176,3,32,479,32,180,2,470,6,470,996
0.75,6,26,14421,13,626,62,1360,3059,13,1353,50,3928,11362
1786.29,6,106,8584,69,66,26268,66,5004,37,60,49615,60,3580
74.701,17,4,1374,4,315,24900,329,1374,0,0,0,0,0
0.745,6,28,5967,14,156,57,267,1502,14,650,52,1420,4465
1777.025,17,73,3060,72,14,25028,14,3024,1,8,0,8,36
1774.187,17,142,11360,71,48,25345,48,5396,71,56,25345,56,5964
95.048,6,39,10689,19,158,5280,267,1561,20,756,4999,2045,9128
0.05,17,4,624,2,64,7,64,184,2,192,0,192,440
48.893,6,48,13114,24,882,630,1360,7228,24,327,2118,2667,5886
0.401,17,2,152,1,48,0,48,76,1,48,0,48,76
4.279,6,39,7285,20,218,225,314,3423,19,516,223,1179,3862
1.415,6,25,8056,12,164,109,267,1288,13,869,99,1448,6768
1444.137,6,182,13843,69,68,21234,294,6524,113,49,12894,78,7319
1.016,6,31,12122,17,525,63,1360,3350,14,820,61,1379,8772
504.617,2,5,160,5,8,126154,8,160,0,0,0,0,0
0.472,6,12,1653,6,288,90,288,548,6,426,52,434,1105
1780.664,17,86,3606,85,14,21198,14,3570,1,8,0,8,36
2.13,17,6,1230,3,36,1061,36,192,3,318,1062,318,1038
0.127,17,4,336,2,34,0,34,124,2,78,123,84,212
7.064,6,70,21702,36,540,201,1152,16574,34,470,206,1179,5128
60.548,6,37,9394,15,327,1250,1189,2575,22,395,2882,1420,6819
1779.3,6,410,25250,219,69,8161,69,13038,191,44,9360,69,12212
0.992,6,32,12924,16,529,66,1460,3330,16,812,54,1460,9594
161.908,6,36,8455,18,410,9524,882,1982,18,441,500,1440,6473
281.403,17,4,296,2,30,281139,30,116,2,62,281201,62,180
0.391,6,10,1992,5,288,97,288,508,5,424,53,434,1484
125.809,2,2,64,2,8,125809,8,64,0,0,0,0,0
1.524,6,27,9832,14,351,117,700,2351,13,868,106,1460,7481
280.193,6,29,7392,13,158,23349,267,1317,16,603,18677,2800,6075
1773.484,6,80,4212,40,26,45472,26,2106,40,26,45472,26,2106
10.488,6,95,30111,48,564,223,1152,23392,47,439,222,1179,6719
0.039,17,2,263,1,36,0,36,64,1,171,0,171,199
0.027,17,4,360,2,30,0,30,116,2,94,0,94,244
1775.017,6,180,15480,120,69,14916,69,8940,60,69,30077,69,6540
1.587,6,12,1036,6,283,283,283,603,6,105,283,105,433
1676.762,1,8,448,8,28,239537,28,448,0,0,0,0,0
1.084,17,22,9922,9,471,135,1350,4494,13,389,87,1350,5428
1773.139,6,180,15480,120,69,14900,69,8940,60,69,30045,69,6540
0.316,17,2,167,1,39,0,39,67,1,72,0,72,100
51.888,17,4,240,2,32,51886,32,120,2,32,51887,32,120
0.674,6,6,300,4,0,0,0,208,2,0,674,0,92
1798.234,17,447,39864,402,35,4484,288,25644,45,288,40021,288,14220
1788.566,6,413,35521,233,117,7709,1189,18104,180,130,9991,1460,17417
62.059,6,74,51539,46,1204,1379,1368,43347,28,841,2289,2519,8192
1787.498,6,102,8296,68,65,26679,65,4930,34,59,54163,59,3366
1334.016,6,170,13288,64,74,20861,337,6454,106,49,12704,143,6834
0.344,6,26,8903,13,234,28,575,1620,13,942,27,1448,7283
17.439,17,21,7055,10,399,1934,1350,4272,11,225,1740,1350,2783
1.134,6,25,8056,12,164,87,267,1288,13,869,80,1408,6768
1772.141,6,180,15480,120,69,14891,69,8940,60,69,30033,69,6540
0.755,17,2,782,2,363,755,363,782,0,0,0,0,0
0.058,17,2,144,1,36,0,36,64,1,52,0,52,80
0.393,17,2,204,1,34,0,34,62,1,114,0,114,142
7.504,6,10,580,4,0,2501,0,220,6,0,1456,0,360
11.077,6,107,38182,56,639,201,1152,31660,51,447,216,1179,6522
244.927,17,41,3116,41,48,6123,48,3116,0,0,0,0,0
0.816,6,21,5988,12,281,74,544,1328,9,716,91,1420,4660
290.332,1,4,326,4,53,96777,78,326,0,0,0,0,0
319.821,1,6,336,6,28,63964,28,336,0,0,0,0,0
1.81,6,54,19933,27,926,69,1440,14077,27,433,62,1440,5856
1745.884,6,96,7286,63,38,28159,205,4476,33,33,54544,98,2810
280.487,6,29,7392,13,158,23373,267,1317,16,603,18694,2076,6075
0.249,6,21,5000,10,137,27,267,1092,11,577,24,1400,3908
1744.938,6,97,7307,63,38,28144,205,4476,34,33,52870,98,2831
5.008,17,4,288,2,36,4994,36,128,2,52,4993,52,160
592.292,6,82,9862,41,118,14802,722,4385,41,115,14802,1408,5477
2.027,17,3,174,3,30,1013,30,174,0,0,0,0,0
0.849,6,5,212,3,0,424,0,132,2,0,518,0,80
1772.396,6,180,15480,120,69,14894,69,8940,60,69,30033,69,6540
6.028,6,39,7285,20,218,317,314,3423,19,516,319,1179,3862
3.794,17,5,290,5,30,948,30,290,0,0,0,0,0
0.036,17,4,350,2,34,2,34,124,2,85,0,91,226
1786.601,6,104,8444,68,66,26665,66,4964,36,60,51043,60,3480
1.408,6,37,8214,19,321,78,1164,2718,18,476,72,2715,5496
1774.864,17,138,11040,69,48,26100,48,5244,69,56,26100,56,5796
0.248,6,20,4960,10,137,27,267,1092,10,692,25,1467,3868
0.294,6,12,3702,6,170,45,170,490,6,964,43,1448,3212
3.205,17,5,290,5,30,801,30,290,0,0,0,0,0
10.469,6,83,24541,41,550,261,1152,18720,42,459,247,1179,5821
3.773,17,5,295,5,31,943,31,295,0,0,0,0,0
1685.694,17,12,498,11,14,168569,14,462,1,8,0,8,36
1792.71,6,376,28631,218,126,8261,469,17481,158,69,11418,69,11150
49.241,6,39,6122,20,162,2591,722,2531,19,236,2718,1408,3591
240.205,6,57,18025,31,800,8006,1408,15236,26,158,9608,580,2789
1793.176,1,262,14672,262,28,6870,28,14672,0,0,0,0,0
25.941,17,4,352,2,60,25940,60,176,2,60,25940,60,176
1.418,6,48,19404,27,905,54,1460,13788,21,433,61,1460,5616
0.017,17,2,574,1,32,0,32,60,1,486,0,486,514
51.797,17,4,1344,4,308,17265,308,1344,0,0,0,0,0
1756.97,6,122,9592,77,64,23118,64,5704,45,58,39720,58,3888
1795.074,17,80,3354,79,14,23013,14,3318,1,8,0,8,36
252.248,6,14,1000,4,173,87,173,389,10,83,28012,83,611
0.008,17,2,415,1,34,0,34,62,1,325,0,325,353
1795.339,17,80,3354,79,14,23017,14,3318,1,8,0,8,36
1680.464,17,16,4257,8,30,240065,37,471,8,445,240065,463,3786
1739.472,1,56,4704,0,0,0,0,0,56,56,31626,56,4704
0.328,17,2,154,1,33,0,33,61,1,65,0,65,93
21.118,6,24,6232,14,117,1624,159,1337,10,727,2345,1418,4895
503.97,2,4,128,4,8,167990,8,128,0,0,0,0,0
1797.196,1,155,8680,155,28,11670,28,8680,0,0,0,0,0
125.991,6,51,11771,21,366,3848,1189,4142,30,377,4343,1420,7629
240.344,2,2,64,2,8,240344,8,64,0,0,0,0,0
1741.699,6,87,6322,58,31,30556,31,3915,29,31,62203,31,2407
64.645,6,69,16632,35,410,615,882,4044,34,487,1955,1460,12588
5.013,17,4,288,2,36,5003,36,128,2,52,5005,52,160
0.019,6,3,120,2,0,19,0,80,1,0,0,0,40
6.052,6,22,3305,12,180,550,595,1712,10,266,670,580,1593
281.258,6,32,8194,13,158,23438,267,1317,19,509,15621,1400,6877
0.08,17,2,214,1,39,0,39,67,1,119,0,119,147
1.413,6,55,21638,31,910,47,1360,15857,24,400,52,1360,5781
240.176,6,53,17637,28,786,8895,1408,14829,25,187,10007,580,2808
1789.995,17,142,11360,71,48,25571,48,5396,71,56,25571,56,5964
219.232,17,4,240,2,32,219231,32,120,2,32,219230,32,120
1772.237,6,180,15480,120,69,14892,69,8940,60,69,30031,69,6540
0.606,6,15,1785,8,288,64,288,640,7,426,71,434,1145
1744.539,6,95,7203,63,38,28137,205,4476,32,33,56266,98,2727
0.378,6,10,967,5,256,92,256,460,5,303,92,303,507
0.843,6,25,6456,13,299,70,838,2019,12,790,75,1420,4437
61.718,17,4,240,2,32,61717,32,120,2,32,61717,32,120
5.023,17,4,288,2,36,5005,36,128,2,52,4989,52,160
95.174,6,32,8053,12,156,8651,267,1740,20,367,5008,1420,6313
0.015,6,9,1930,5,666,3,666,934,4,780,5,780,996
0.054,17,2,912,1,308,0,308,336,1,548,0,548,576
22.944,6,34,8136,16,188,1529,721,1963,18,605,1337,1420,6173
268.264,1,4,326,4,53,89421,78,326,0,0,0,0,0
1215.822,6,698,836040,241,155,5065,873,17230,457,1953,2666,12618,818810
135.471,6,23,10323,12,308,86,615,1448,11,1203,13532,2368,8875
1.773,17,4,518,3,39,629,39,201,1,289,0,289,317
0.036,17,2,452,2,198,36,348,452,0,0,0,0,0
240.181,6,54,18104,29,802,8577,1402,15161,25,204,10007,580,2943
1786.872,6,102,8228,68,64,26669,64,4896,34,58,54144,58,3332
0.122,6,14,4589,8,290,17,517,1005,6,1088,23,1408,3584
1773.53,6,180,15480,120,69,14903,69,8940,60,69,30051,69,6540
1782.484,17,83,3480,82,14,22005,14,3444,1,8,0,8,36
0.09,17,4,588,2,48,81,48,152,2,190,79,308,436
0.849,6,19,5926,11,287,84,562,1306,8,859,108,2642,4620
1680.851,1,7,392,7,28,280141,28,392,0,0,0,0,0
0.064,6,11,818,6,185,12,185,505,5,45,15,45,313
10.91,6,1748,1511487,1062,1370,10,1420,1479805,686,421,15,1883,31682
1.409,6,25,8056,12,164,110,267,1288,13,1014,100,2736,6768
0.005,17,2,512,1,40,0,40,68,1,416,0,416,444
12.265,6,8,440,5,0,3066,0,268,3,0,5460,0,172
300.678,6,36,8500,19,318,16704,928,2067,17,478,533,1928,6433
1798.349,17,400,56315,190,194,9515,1350,42319,210,38,8603,1350,13996
1.355,6,49,19971,26,943,54,1440,14275,23,433,53,1440,5696
1797.435,17,29,9512,29,300,64194,300,9512,0,0,0,0,0
1.382,6,50,20316,27,964,53,1460,14620,23,433,53,1460,5696
402.329,1,5,280,5,28,100582,28,280,0,0,0,0,0
1771.157,6,99,9174,66,64,27248,64,5544,33,58,55346,58,3630
8.025,1,9,756,0,0,0,0,0,9,56,1003,56,756
90.265,6,9,472,5,0,22566,0,256,4,0,30087,0,216
0.918,6,25,9018,14,254,70,658,1609,11,1391,75,3930,7409
0.171,6,27,7296,13,155,14,267,1301,14,603,12,2036,5995
1787.059,6,104,8366,69,64,26280,64,4936,35,58,52558,58,3430
0.255,6,20,4960,10,137,28,267,1092,10,692,26,1467,3868
15.176,17,12,5204,6,490,3029,1350,3109,6,321,3029,1350,2095
1766.762,6,143,8786,75,26,23874,26,4568,68,26,26369,26,4218
129.652,6,1135,551751,607,840,213,1152,525840,528,398,245,1152,25911
0.153,6,46,21913,27,1055,5,1420,16932,19,467,8,1883,4981
381.353,17,31,35929,31,1131,12711,1452,35929,0,0,0,0,0
0.05,17,4,352,2,60,49,60,176,2,60,43,60,176
9.707,17,3,216,2,44,9673,44,144,1,44,0,44,72
245.049,6,52,8920,24,223,10653,584,2890,28,351,9075,898,6030
21.441,17,12,1056,6,48,4285,48,456,6,72,4286,72,600
102.573,17,4,352,2,60,102572,60,176,2,60,102572,60,176
1758.755,1,187,19822,187,78,9455,78,19822,0,0,0,0,0
1795.326,17,449,39928,404,35,4454,288,25708,45,288,40023,288,14220
5.365,6,39,7269,20,218,282,314,3423,19,513,280,1179,3846
1796.713,6,224,22240,113,87,16042,721,11236,111,163,16331,1440,11004
398.582,6,9,577,9,31,49822,31,577,0,0,0,0,0
1787.225,6,102,8296,68,65,26675,65,4930,34,59,54154,59,3366
227.569,17,8,2688,8,308,32509,308,2688,0,0,0,0,0
104.023,17,4,352,2,60,104022,60,176,2,60,104022,60,176
37.821,17,4,352,2,60,37820,60,176,2,60,37817,60,176
8.832,6,44,7505,22,218,420,314,3511,22,442,408,1152,3994
340.001,6,17,1190,13,180,28333,180,864,4,110,20056,110,326
5.607,6,39,7269,20,218,295,314,3423,19,513,297,1179,3846
1.139,6,24,8004,11,164,96,267,1236,13,869,80,1448,6768
1.264,6,45,18084,26,882,50,1360,12548,19,476,60,2715,5536
0.889,6,10,1687,7,100,148,100,384,3,1179,321,1179,1303
0.97,6,10,1687,7,100,161,100,384,3,1179,362,1179,1303
1798.242,17,142,11360,71,48,25689,48,5396,71,56,25689,56,5964
1785.332,6,103,8395,68,65,26646,65,4930,35,59,52506,59,3465
208.945,6,196,155568,124,1293,1698,1368,142235,72,684,2250,2519,13333
55.906,6,39,8517,19,333,560,685,1840,20,418,2935,4848,6677
421.107,2,6,192,6,8,84221,8,192,0,0,0,0,0
1782.958,6,475,27349,265,69,6753,69,14809,210,34,8530,64,12540
1744.754,2,24,768,24,8,75858,8,768,0,0,0,0,0
132.559,6,23,10009,12,531,64,1360,2637,11,1384,13241,3934,7372
0.021,17,2,904,1,300,0,300,328,1,548,0,548,576
14.739,1,4,224,4,28,4913,28,224,0,0,0,0,0
1782.876,17,142,11360,71,48,25469,48,5396,71,56,25468,56,5964
126.144,2,2,64,2,8,126144,8,64,0,0,0,0,0
57.488,6,30,7297,14,155,4422,267,1346,16,441,3831,1420,5951
1680.431,6,194,19251,101,79,16802,721,8966,93,168,18263,1414,10285
2.381,17,4,734,3,46,1000,46,222,1,484,0,484,512
299.254,1,4,224,4,28,99751,28,224,0,0,0,0,0
1680.363,1,15,840,15,28,120025,28,840,0,0,0,0,0
20.993,17,4,240,2,32,20992,32,120,2,32,20992,32,120
70.106,6,16,652,7,0,7925,0,284,9,0,8761,0,368
280.522,6,28,7352,12,158,25502,267,1277,16,603,18697,1400,6075
0.324,17,8,2750,8,315,46,354,2750,0,0,0,0,0
5.084,17,3,208,2,36,5043,36,128,1,52,0,52,80
280.237,6,29,7392,13,158,23353,267,1317,16,603,18680,1400,6075
1772.75,6,180,15480,120,69,14897,69,8940,60,69,30045,69,6540
3.797,6,43,15407,25,680,158,1408,12869,18,227,223,580,2538
1743.078,6,95,7203,63,38,28114,205,4476,32,33,56220,98,2727
193.961,6,38,8302,14,130,14920,267,1484,24,292,8432,1460,6818
944.587,17,185,14060,185,48,5133,48,14060,0,0,0,0,0
196.713,17,4,352,2,60,196712,60,176,2,60,196712,60,176
0.018,17,2,168,1,48,0,48,76,1,64,0,64,92
1762.602,6,122,7427,67,27,26705,27,4018,55,27,32639,27,3409
1.325,6,49,19267,27,892,50,1440,13611,22,433,54,1440,5656
1772.213,6,180,15480,120,69,14892,69,8940,60,69,30033,69,6540
1788.763,6,356,22520,208,69,8641,69,12460,148,69,12167,69,10060
5.624,6,41,7349,21,218,281,314,3463,20,513,280,1179,3886
1743.595,6,99,7814,65,45,27243,205,4850,34,35,52827,98,2964
1142.999,2,13,416,13,8,95249,8,416,0,0,0,0,0
1786.072,6,160,20357,94,304,19205,304,14332,66,83,27477,83,6025
280.482,6,30,7432,13,158,23373,267,1317,17,543,17527,1400,6115
11.686,6,1848,1601546,1130,1363,10,1380,1568584,718,421,16,1923,32962
1169.419,6,65,7544,36,64,26239,64,2592,29,130,41762,278,4952
0.21,17,2,2752,2,1348,210,1348,2752,0,0,0,0,0
1781.001,17,141,11276,71,48,25442,48,5396,70,56,25811,56,5880
0.675,17,3,451,2,39,316,39,134,1,289,0,289,317
255.49,6,9,515,5,43,63872,43,299,4,0,85118,0,216
12.41,6,52,10287,25,233,517,314,4741,27,446,467,1179,5546
261.832,1,9,756,9,56,32729,56,756,0,0,0,0,0
55.588,17,4,352,2,48,55580,48,152,2,72,55578,72,200
71.913,6,22,2588,10,189,7989,517,1322,12,323,6537,499,1266
86.23,6,21,6119,10,220,9581,516,1286,11,548,8612,1452,4833
1.588,6,13,2311,8,188,226,245,700,5,1407,332,1407,1611
252.207,17,4,240,2,32,252206,32,120,2,32,252206,32,120
1797.408,17,449,39928,404,35,4460,288,25708,45,288,40018,288,14220
175.824,6,25,9817,12,523,61,1440,2605,13,954,14640,1440,7212
1772.648,6,180,15480,120,69,14896,69,8940,60,69,30041,69,6540
5.644,6,55,13920,26,502,225,1460,4664,29,404,158,1460,9256
240.216,6,52,17576,27,780,9238,1402,14681,25,198,10008,580,2895
300.346,6,41,23213,25,1047,12514,1440,15978,16,913,3250,1440,7235
0.036,6,11,1805,6,126,7,126,446,5,545,7,990,1359
1793.197,6,367,25650,214,99,8418,469,15045,153,69,11795,69,10605
300.434,6,41,13880,21,760,15021,1408,7258,20,464,1698,1491,6622
1795.892,6,430,26023,214,69,8431,69,12907,216,35,8352,69,13116
408.0,6,27,5137,11,185,10865,500,1370,16,240,27194,1420,3767
9.01,6,14,2245,8,211,1286,211,846,6,545,1801,904,1399
4.372,6,23,4478,12,213,397,597,1689,11,441,417,1402,2789
0.044,6,7,423,4,43,2,43,259,3,0,21,0,164
37.884,17,22,1672,22,48,1804,48,1672,0,0,0,0,0
281.556,6,31,7476,14,158,21658,267,1357,17,603,17592,2760,6119
1.632,6,24,6636,13,350,135,1089,2276,11,783,162,1420,4360
0.017,17,2,378,1,30,0,30,58,1,292,0,292,320
128.56,6,29,10648,6,154,25712,267,712,23,500,5840,1452,9936
3.247,6,2,88,2,0,0,0,88,0,0,0,0,0
1795.398,17,448,39896,403,35,4466,288,25676,45,288,40026,288,14220
0.16,17,2,152,1,48,0,48,76,1,48,0,48,76
1.223,17,4,424,2,46,988,46,148,2,110,0,110,276
4.089,17,14,14097,5,836,1022,1350,4323,9,1058,308,1350,9774
1.203,6,25,8056,12,164,92,267,1288,13,869,85,1402,6768
0.241,17,8,2750,8,315,34,354,2750,0,0,0,0,0
581.144,1,6,336,6,28,116228,28,336,0,0,0,0,0
4.834,17,4,824,2,48,4820,48,152,2,308,4820,308,672
0.512,6,10,861,5,222,124,222,426,5,231,124,231,435
1795.305,17,80,3354,79,14,23016,14,3318,1,8,0,8,36
96.814,6,15,1086,4,180,118,180,396,11,110,9663,110,690
1786.661,6,106,8515,69,65,26274,65,4970,37,59,49626,59,3545
280.633,6,31,7541,13,158,23386,267,1317,18,500,16502,1400,6224
0.071,6,10,1634,5,131,17,131,399,5,967,17,967,1235
126.566,6,7,296,2,0,3279,0,84,5,0,31580,0,212
0.429,6,5,248,3,0,214,0,144,2,0,426,0,104
0.255,17,2,384,1,39,0,39,67,1,289,0,289,317
2.348,17,6,1230,3,36,1172,36,192,3,318,1171,318,1038
22.25,6,46,13880,21,315,1089,721,3367,25,633,919,1420,10513
1797.724,17,386,129656,386,307,4669,308,129656,0,0,0,0,0
2.06,17,2,122,2,33,2060,33,122,0,0,0,0,0
1323.579,2,14,448,14,8,101813,8,448,0,0,0,0,0
1743.763,6,96,7255,62,38,28586,205,4424,34,33,52835,98,2831
185.539,17,4,240,2,32,185538,32,120,2,32,185538,32,120
1794.738,6,216,27956,116,304,15606,304,18952,100,83,18128,83,9004
81.701,6,17,8138,7,174,13616,174,462,10,1452,5477,1452,7676
282.055,6,33,7621,15,143,20146,267,1466,18,603,16588,2760,6155
1778.737,17,142,11360,71,48,25410,48,5396,71,56,25410,56,5964
4.01,17,4,244,4,33,1336,33,244,0,0,0,0,0
5.188,6,10,1687,7,100,864,100,384,3,1179,2461,1179,1303
24.993,6,32,8131,16,199,1666,721,2038,16,778,1654,2840,6093
0.828,17,4,368,2,32,530,32,120,2,96,445,96,248
33.76,6,10,580,3,0,16880,0,160,7,0,5258,0,420
1791.188,1,284,15904,284,28,6329,28,15904,0,0,0,0,0
0.302,6,23,7394,12,335,26,668,1974,11,968,29,1475,5420
106.292,6,39,9827,16,159,7086,267,1762,23,419,4830,2840,8065
196.546,17,4,550,4,109,65515,300,550,0,0,0,0,0
729.95,6,120,15215,56,88,13232,267,4719,64,139,11586,1420,10496
1782.053,6,356,22520,208,69,8608,69,12460,148,69,12122,69,10060
38.642,17,5,1672,5,306,9660,308,1672,0,0,0,0,0
1789.024,1,339,28476,339,56,5292,56,28476,0,0,0,0,0
1797.508,17,142,11360,71,48,25678,48,5396,71,56,25678,56,5964
1695.729,1,8,448,8,28,242247,28,448,0,0,0,0,0
192.765,17,4,352,2,60,192764,60,176,2,60,192764,60,176
1795.669,17,142,11360,71,48,25652,48,5396,71,56,25652,56,5964
12.214,6,1937,1676232,1182,1363,10,1380,1641802,755,421,16,1923,34430
14.304,17,4,1370,2,308,14304,308,672,2,321,1011,321,698
1782.708,6,356,22520,208,69,8612,69,12460,148,69,12127,69,10060
0.31,17,8,2766,8,317,44,356,2766,0,0,0,0,0
280.427,6,30,7432,13,158,23368,267,1317,17,603,17524,2076,6115
1775.318,17,142,11360,71,48,25361,48,5396,71,56,25361,56,5964
280.337,6,29,7392,13,158,23361,267,1317,16,603,18686,2036,6075
240.224,6,54,18558,29,793,8579,1418,15791,25,182,10008,580,2767
300.632,6,27,8620,14,405,23125,1066,2382,13,617,2621,1408,6238
44.48,6,3,182,0,0,0,0,0,3,31,22240,31,182
0.239,6,10,1188,6,145,47,145,389,4,635,65,635,799
0.156,6,38,14540,22,877,7,1420,9679,16,467,9,1883,4861
190.016,17,4,352,2,60,190015,60,176,2,60,190014,60,176
298.291,2,3,96,3,8,149145,8,96,0,0,0,0,0
338.267,1,10,560,10,28,37585,28,560,0,0,0,0,0
0.012,17,4,496,3,64,1,64,276,1,192,0,192,220
1007.606,2,7,224,7,8,167934,8,224,0,0,0,0,0
98.211,6,22,6108,12,220,8928,516,1366,10,619,10900,1452,4742
1760.748,1,64,5376,64,56,27948,56,5376,0,0,0,0,0
0.028,17,6,1658,6,248,5,373,1658,0,0,0,0,0
1740.49,17,27,6345,27,207,66941,207,6345,0,0,0,0,0
286.232,6,33,3365,16,324,19081,585,1525,17,192,17888,580,1840
5.162,6,825,704592,495,1381,10,1420,687159,330,467,15,1883,17433
0.128,17,4,566,2,31,123,31,118,2,196,123,196,448
1772.219,6,180,15480,120,69,14892,69,8940,60,69,30035,69,6540
233.747,6,32,6856,13,186,9174,502,1458,19,289,12981,1420,5398
9.388,6,3,120,2,0,144,0,80,1,0,0,0,40
1772.341,6,180,15480,120,69,14893,69,8940,60,69,30034,69,6540
296.211,6,45,9144,21,141,14802,721,2399,24,412,12871,2840,6745
1.41,6,47,18647,26,919,56,1440,13031,21,433,60,1440,5616
1750.348,6,98,7519,65,38,27349,205,4642,33,35,54689,98,2877
0.882,6,11,1727,7,100,147,100,384,4,589,208,1152,1343
5.013,17,4,558,2,36,5006,36,128,2,187,5008,187,430
12.396,6,86,26093,42,550,302,1152,19851,44,447,281,1179,6242
0.435,6,12,1653,6,288,84,288,548,6,426,46,434,1105
59.926,17,27,8764,12,464,5447,1350,5914,15,162,4165,1350,2850
248.205,6,21,11220,4,112,49,112,280,17,683,15512,1420,10940
4.275,6,2,88,2,0,0,0,88,0,0,0,0,0
1681.307,17,20,4993,10,32,186810,37,601,10,411,186810,463,4392
0.576,1,2,112,2,28,576,28,112,0,0,0,0,0
1743.977,6,141,8912,78,49,22649,208,5493,63,31,28123,31,3419
1683.53,17,54,2262,53,14,32375,14,2226,1,8,0,8,36
11.684,17,16,2352,8,48,1667,48,608,8,190,1667,308,1744
0.003,1,2,112,2,28,3,28,112,0,0,0,0,0
1681.366,17,14,1036,7,30,280224,30,406,7,62,280224,62,630
0.437,17,2,152,1,48,0,48,76,1,48,0,48,76
1786.192,6,102,8364,68,66,26659,66,4964,34,60,54124,60,3400
1794.202,17,80,3354,79,14,23002,14,3318,1,8,0,8,36
264.39,17,4,352,2,60,264388,60,176,2,60,264389,60,176
1785.693,6,365,23087,211,69,8503,69,12787,154,69,11669,69,10300
115.726,6,42,8638,21,371,801,766,2045,21,574,5779,4848,6593
1782.394,17,83,3480,82,14,22004,14,3444,1,8,0,8,36
9.264,6,69,20550,36,552,264,1152,15803,33,489,281,1179,4747
0.045,17,2,152,1,48,0,48,76,1,48,0,48,76
1.417,6,38,8252,19,320,78,1162,2716,19,433,65,1360,5536
0.324,17,2,144,1,36,0,36,64,1,52,0,52,80
0.082,6,20,7510,11,290,8,517,1149,9,980,7,1438,6361
5.067,6,40,7309,20,218,266,314,3423,20,440,252,1152,3886
0.315,6,53,24732,28,1104,11,1414,18919,25,399,12,1889,5813
1786.161,6,106,8524,68,66,26659,66,4964,38,60,48272,60,3560
24.174,6,31,8736,14,339,1859,721,2603,17,605,1497,1440,6133
8.803,6,16,4038,8,275,1257,275,878,8,1414,1115,1414,3160
121.654,6,19,4553,11,220,12165,516,1325,8,484,7984,1452,3228
0.024,6,3,151,1,0,0,0,40,2,31,7,31,111
251.924,2,3,96,3,8,125962,8,96,0,0,0,0,0
32.02,6,9,396,2,0,3484,0,88,7,0,5322,0,308
5.456,6,39,7269,21,218,272,314,3463,18,513,305,1179,3806
64.944,1,4,224,4,28,21648,28,224,0,0,0,0,0
0.904,6,10,1687,7,100,150,100,384,3,1179,325,1179,1303
0.0,6,1,40,1,0,0,0,40,0,0,0,0,0
0.269,17,2,586,1,46,0,46,74,1,484,0,484,512
5.437,6,591,549196,391,1341,13,1368,534132,200,776,26,1473,15064
1794.769,6,266,32477,107,135,16930,1360,15410,159,133,11358,1942,17067
0.889,6,3,1567,1,0,0,0,40,2,723,37,1440,1527
0.105,17,2,245,1,32,0,32,60,1,157,0,157,185
1.134,6,24,6408,13,297,94,830,2011,11,790,112,1420,4397
13.791,6,17,3328,6,92,2758,92,400,11,464,1351,1408,2928
1798.056,17,448,39896,403,35,4472,288,25676,45,288,40021,288,14220
240.194,6,55,18314,29,812,8578,1402,15323,26,203,9607,580,2991
1773.465,6,184,15916,120,69,14903,69,8940,64,69,28143,69,6976
0.027,17,2,218,1,65,0,65,93,1,97,0,97,125
15.4,6,7,2786,4,92,5133,92,296,3,2330,7503,2330,2490
0.061,17,2,2732,2,1338,61,1338,2732,0,0,0,0,0
62.369,6,41,14401,25,451,2598,1297,4968,16,781,4142,2736,9433
1.43,6,49,19570,27,914,55,1460,13914,22,433,59,1460,5656
15.256,17,14,5424,7,423,2537,1350,3162,7,295,2537,1350,2262
192.235,17,4,352,2,60,192234,60,176,2,60,192234,60,176
1.397,6,52,22491,29,975,49,1440,16795,23,433,54,1440,5696
589.426,1,3,168,3,28,294713,28,168,0,0,0,0,0
1.267,6,48,19127,26,953,50,1460,13471,22,433,52,1460,5656
0.477,6,26,8869,13,232,39,567,1612,13,939,38,1448,7257
0.111,6,9,1340,5,145,27,145,349,4,827,29,827,991
0.278,17,2,384,1,39,0,39,67,1,289,0,289,317
1763.516,17,168,14050,156,30,11377,37,9090,12,385,154881,463,4960
240.157,6,53,17160,28,758,8894,1408,14359,25,186,10006,580,2801
1797.899,17,449,39928,404,35,4461,288,25708,45,288,40016,288,14220
232.435,17,4,352,2,60,232433,60,176,2,60,232434,60,176
33.862,6,32,5145,15,154,2418,721,1859,17,342,2101,1368,3286
190.376,6,64,43120,41,1180,4759,1408,35186,23,747,2795,1408,7934
0.614,6,23,11344,13,534,51,1360,2690,10,1648,54,4432,8654
104.683,6,10,576,4,0,34892,0,208,6,56,20935,56,368
302.254,6,27,5494,14,298,23250,1382,2353,13,373,25186,1420,3141
280.216,6,29,7392,13,158,23351,267,1317,16,603,18678,2036,6075
32.865,6,38,8695,15,401,42,889,1836,23,348,1487,4080,6859
4.049,6,32,6105,17,206,253,314,2744,15,551,270,1179,3361
256.236,6,518,462937,352,1327,729,1360,449663,166,236,1551,1360,13274
1681.943,17,14,1036,7,30,280318,30,406,7,62,280318,62,630
169.34,6,29,7392,13,158,14111,267,1317,16,678,11280,2760,6075
0.393,6,6,324,4,0,131,0,216,2,0,196,0,108
3.711,17,3,1167,3,361,1855,361,1167,0,0,0,0,0
20.586,17,4,824,2,48,20573,48,152,2,308,20573,308,672
2.975,17,4,624,4,128,991,128,624,0,0,0,0,0
13.993,6,2285,2169973,1501,1369,9,1408,2124541,784,776,17,1408,45432
1789.357,17,87,3648,86,14,21051,14,3612,1,8,0,8,36
1.29,6,50,18866,27,861,49,1360,13170,23,433,49,1360,5696
0.006,17,2,348,1,39,0,39,67,1,253,0,253,281
1795.088,6,356,22520,208,69,8671,69,12460,148,69,12211,69,10060
0.289,6,10,1838,5,899,72,899,1167,5,403,72,403,671
1780.032,17,140,11200,70,48,25797,48,5320,70,56,25797,56,5880
301.62,6,47,13028,26,345,12064,799,3166,21,643,450,3488,9862
0.302,17,4,660,2,30,291,30,116,2,244,292,244,544
1799.021,17,448,39896,403,35,4475,288,25676,45,288,40021,288,14220
0.53,17,3,543,2,39,438,39,134,1,381,0,381,409
7.969,17,40,14474,13,516,663,1350,7083,27,245,305,1350,7391
1.102,2,3,128,3,18,551,24,128,0,0,0,0,0
280.215,6,29,7392,13,158,23351,267,1317,16,543,18679,1400,6075
2.974,17,2,154,1,33,0,33,61,1,65,0,65,93
16.029,6,16,1327,8,222,2288,222,768,8,231,2288,231,559
1772.52,6,180,15480,120,69,14895,69,8940,60,69,30035,69,6540
4.828,6,39,7269,19,218,268,314,3383,20,513,238,1179,3886
12.409,6,2089,1886076,1248,1425,9,1448,1833872,841,776,14,1448,52204
1741.228,1,73,6132,0,0,0,0,0,73,56,24183,56,6132
1.804,6,13,2311,8,188,257,245,700,5,1407,385,1407,1611
251.223,6,235,36923,131,304,1932,304,25592,104,83,2427,83,11331
1798.838,6,2652,2625018,895,145,2012,864,56101,1757,1473,1024,7010,2568917
19.762,17,8,1176,4,48,6584,48,304,4,190,6581,308,872
1.172,17,4,1108,2,30,1161,30,116,2,468,1157,468,992
1728.953,1,66,3696,66,28,26599,28,3696,0,0,0,0,0
1795.936,1,60,5040,0,0,0,0,0,60,56,30439,56,5040
341.473,6,93,33969,50,842,6968,1418,29586,43,152,8130,580,4383
12.198,17,10,690,5,33,3048,33,305,5,49,3047,49,385
0.127,6,6,312,0,0,0,0,0,6,0,0,0,312
25.398,6,3284,3044272,2056,1400,12,1448,2975716,1228,776,20,1448,68556
3.18,17,2,322,1,33,0,33,61,1,233,0,233,261
548.849,1,9,504,9,28,68606,28,504,0,0,0,0,0
3.891,17,4,244,4,33,1297,33,244,0,0,0,0,0
0.074,17,2,410,1,46,0,46,74,1,308,0,308,336
349.381,6,38,8419,17,124,21835,267,1811,21,360,17468,4837,6608
1779.18,17,140,11200,70,48,25785,48,5320,70,56,25785,56,5880
0.102,6,14,5639,8,134,14,134,474,6,2456,20,2920,5165
1788.744,17,87,3648,86,14,21044,14,3612,1,8,0,8,36
59.087,6,27,7177,13,155,4923,267,1306,14,530,4544,3417,5871
1798.35,17,448,39896,403,35,4473,288,25676,45,288,40019,288,14220
0.014,17,2,491,1,29,0,29,57,1,406,0,406,434
116.594,17,4,1344,4,308,38864,308,1344,0,0,0,0,0
1781.13,6,106,8453,69,65,26193,65,4905,37,57,49472,59,3548
1789.955,6,353,22331,205,69,8774,69,12271,148,69,12176,69,10060
1799.256,17,449,39928,404,35,4464,288,25708,45,288,40023,288,14220
6.975,6,1278,1007138,662,1423,10,1448,966542,616,776,11,1448,40596
0.004,17,2,334,1,39,0,39,67,1,239,0,239,267
10.679,6,43,9679,20,149,562,267,1706,23,586,482,1400,7973
79.473,17,6,456,6,48,15894,48,456,0,0,0,0,0
1663.821,1,7,742,7,78,277303,78,742,0,0,0,0,0
0.489,6,14,1136,8,256,69,256,584,6,304,88,304,552
15.614,6,171,249450,142,264,110,517,7021,29,9279,557,48280,242429
2.979,17,8,1596,4,36,991,36,256,4,307,991,318,1340
1768.817,1,58,4872,58,56,31031,56,4872,0,0,0,0,0
2.028,17,6,540,3,30,958,30,174,3,94,0,94,366
5.583,6,57,14933,28,490,206,1429,5578,29,409,195,1460,9355
293.43,17,4,409,2,45,293426,46,147,2,103,293425,115,262
0.249,6,17,2952,9,266,31,517,1542,8,493,30,828,1410
1797.046,17,144,11520,72,48,25310,48,5472,72,56,25310,56,6048
0.255,17,2,440,1,39,0,39,67,1,345,0,345,373
0.139,17,2,180,1,30,0,30,58,1,94,0,94,122
1751.537,6,95,7203,63,38,28250,205,4476,32,33,56493,98,2727
13.739,17,4,352,2,60,13738,60,176,2,60,13737,60,176
1789.695,6,356,22520,208,69,8645,69,12460,148,69,12172,69,10060
4.783,6,40,7309,20,218,251,314,3423,20,513,237,1179,3886
1799.058,17,450,39960,405,35,4453,288,25740,45,288,40020,288,14220
639.802,6,56,3679,32,47,20638,208,2316,24,31,27807,31,1363
33.703,6,33,5230,16,154,2246,722,1934,17,301,2095,2026,3296
1783.251,6,712,279109,352,792,5080,1460,243227,360,172,4966,3098,35882
106.079,6,43,9634,18,290,2761,1189,2764,25,390,4419,1420,6870
0.141,17,2,904,2,424,141,548,904,0,0,0,0,0
1.916,17,6,360,3,32,957,32,180,3,32,957,32,180
1750.69,6,186,11385,93,47,19029,208,6766,93,31,19026,31,4619
4.8,6,9,727,4,186,1600,186,414,5,45,595,45,313
1796.673,6,284,35693,116,137,15622,1360,16521,168,144,10757,1360,19172
240.582,6,123,80957,47,555,5229,1402,6922,76,1130,3207,2804,74035
1796.299,6,356,22520,208,69,8677,69,12460,148,69,12219,69,10060
1785.957,6,107,8555,68,65,26656,65,4930,39,59,46996,59,3625
1787.906,6,367,25650,212,99,8473,469,14965,155,69,11609,69,10685
0.028,6,10,1568,5,121,7,121,389,5,911,6,911,1179
251.865,2,3,96,3,8,125932,8,96,0,0,0,0,0
105.594,6,24,5040,10,220,11732,516,1286,14,289,8114,1452,3754
1645.93,1,8,448,8,28,235132,28,448,0,0,0,0,0
281.659,6,33,7552,14,158,21666,267,1357,19,543,15647,1400,6195
0.085,17,4,608,2,60,9,60,176,2,188,5,188,432
0.49,6,8,834,3,304,242,304,472,5,102,121,102,362
152.206,17,4,1344,4,308,50735,308,1344,0,0,0,0,0
1.73,6,25,8763,15,285,123,587,1459,10,985,172,1420,7304
40.844,17,42,6056,21,48,2041,48,1596,21,184,2041,308,4460
1790.781,17,467,156912,467,308,3842,308,156912,0,0,0,0,0
0.486,6,3,354,2,210,251,210,314,1,0,0,0,40
1797.758,6,356,22520,208,69,8684,69,12460,148,69,12229,69,10060
0.408,6,12,1653,6,288,75,288,548,6,426,49,434,1105
1737.429,1,56,4704,56,56,31589,56,4704,0,0,0,0,0
107.515,6,72,16384,36,414,1385,1284,7246,36,295,3069,1414,9138
0.135,17,2,410,1,46,0,46,74,1,308,0,308,336
26.574,6,11,612,6,0,5314,0,328,5,0,6633,0,284
289.802,1,4,224,4,28,96600,28,224,0,0,0,0,0
1771.477,6,99,9240,66,65,27253,65,5577,33,59,55355,59,3663
1.38,6,50,19907,28,873,51,1360,14251,22,433,56,1360,5656
0.859,6,21,5988,12,281,78,544,1328,9,716,96,1420,4660
61.115,17,7,532,7,48,10185,48,532,0,0,0,0,0
1799.727,17,80,3354,79,14,23073,14,3318,1,8,0,8,36
2.827,17,3,1167,3,361,1413,361,1167,0,0,0,0,0
1637.855,2,14,448,14,8,125988,8,448,0,0,0,0,0
0.819,6,23,5974,12,108,74,147,919,11,922,78,1581,5055
38.837,1,44,4576,0,0,0,0,0,44,76,903,76,4576
439.475,17,10,3264,10,298,48830,300,3264,0,0,0,0,0
300.754,6,41,8743,22,315,14321,882,2185,19,413,476,1440,6558
898.042,2,8,256,8,8,128291,8,256,0,0,0,0,0
87.728,6,115,86991,74,1235,1201,1368,76733,41,738,2187,2519,10258
0.153,17,3,962,3,292,76,316,962,0,0,0,0,0
1771.984,6,180,15480,120,69,14890,69,8940,60,69,30031,69,6540
0.01,1,2,112,2,28,10,28,112,0,0,0,0,0
1786.836,17,87,3648,86,14,21021,14,3612,1,8,0,8,36
1776.065,17,142,11360,71,48,25371,48,5396,71,56,25371,56,5964
1795.64,17,355,71727,355,174,5072,422,71727,0,0,0,0,0
2.086,6,29,10365,17,367,130,833,1785,12,1012,181,1420,8580
23.764,6,30,8698,15,340,1697,721,2645,15,778,1682,2840,6053
0.071,17,3,305,2,32,51,32,120,1,157,0,157,185
1790.114,6,369,23385,213,69,8443,69,13005,156,69,11548,69,10380
238.985,6,66,44251,42,1175,5828,1408,36272,24,960,2673,3847,7979
1791.479,6,356,22520,208,69,8654,69,12460,148,69,12186,69,10060
3.303,17,8,736,4,32,1090,32,240,4,96,1086,96,496
1217.531,6,96,12433,49,91,22771,501,4065,47,150,26466,1420,8368
379.182,17,21,879,20,13,19956,14,835,1,16,0,16,44
23.331,6,17,2486,7,666,3882,1110,1616,10,231,2590,231,870
127.729,17,32,3302,28,30,4730,37,1638,4,388,22641,463,1664
0.065,17,2,283,1,31,0,31,59,1,196,0,196,224
1780.012,1,342,28728,342,56,5219,56,28728,0,0,0,0,0
0.074,17,4,288,2,33,1,33,122,2,55,69,61,166
60.4,6,9,820,5,226,15100,226,494,4,110,20058,110,326
1777.946,17,142,11360,71,48,25398,48,5396,71,56,25398,56,5964
111.248,6,22,9317,11,524,85,1236,2070,11,970,11106,1360,7247
0.314,6,24,5980,12,164,28,453,1442,12,651,26,1440,4538
0.356,6,15,6364,8,126,49,126,550,7,1360,54,2381,5814
0.148,6,9,1340,5,145,37,145,349,4,827,47,827,991
2.406,6,14,2351,8,188,343,245,700,6,703,430,1152,1651
18.863,17,12,912,12,48,1714,48,912,0,0,0,0,0
1786.213,6,150,19350,90,302,20069,302,13740,60,83,30274,83,5610
0.964,6,3,120,2,0,900,0,80,1,0,0,0,40
1792.919,17,66,2766,65,14,28014,14,2730,1,8,0,8,36
127.703,6,19,4247,4,92,42567,92,296,15,243,9086,1408,3951
67.04,6,17,696,8,0,7013,0,324,9,0,8378,0,372
1679.717,17,13,534,11,14,167952,14,462,2,8,1679522,8,72
1773.018,6,180,15480,120,69,14899,69,8940,60,69,30050,69,6540
1795.049,17,448,39896,403,35,4465,288,25676,45,288,40018,288,14220
76.577,1,4,224,4,28,25525,28,224,0,0,0,0,0
27.318,1,4,224,4,28,9106,28,224,0,0,0,0,0
0.115,6,3,151,2,31,1,31,111,1,0,0,0,40
1739.952,1,15,840,15,28,124282,28,840,0,0,0,0,0
0.069,17,4,304,2,37,63,37,130,2,59,62,65,174
1774.183,1,60,5040,0,0,0,0,0,60,56,30070,56,5040
1.255,6,48,18200,26,882,50,1460,12544,22,433,51,1460,5656
1772.626,6,182,15629,121,69,14771,69,8980,61,69,29542,69,6649
33.667,17,20,1520,20,48,1771,48,1520,0,0,0,0,0
1772.553,6,180,15480,120,69,14895,69,8940,60,69,30040,69,6540
2.128,6,13,2311,8,188,304,245,700,5,1407,469,1407,1611
3.429,6,6,340,3,0,1714,0,160,3,0,1001,0,180
1.466,17,3,1176,3,364,733,364,1176,0,0,0,0,0
0.005,17,2,354,1,46,0,46,74,1,252,0,252,280
0.009,17,2,358,1,30,0,30,58,1,272,0,272,300
0.582,6,53,23246,29,1053,20,1380,18044,24,383,23,1380,5202
4.167,17,5,290,5,30,1041,30,290,0,0,0,0,0
0.109,6,9,1343,5,145,27,145,349,4,830,29,830,994
11.763,6,1862,1625167,1128,1386,10,1420,1591574,734,467,16,1883,33593
750.751,17,18,1584,9,48,93842,48,684,9,72,93842,72,900
1765.757,6,102,7895,65,40,27589,205,4674,37,37,49038,170,3221
0.347,17,8,2774,8,318,49,357,2774,0,0,0,0,0
5.954,2,2,64,2,8,5954,8,64,0,0,0,0,0
1763.87,6,97,7369,64,38,27997,205,4559,33,33,55110,98,2810
0.017,17,2,180,1,54,0,54,82,1,70,0,70,98
1.634,6,50,18728,27,851,62,1360,13032,23,433,64,1360,5696
0.0,6,1,180,1,128,0,128,180,0,0,0,0,0
1792.644,1,59,4956,59,56,30907,56,4956,0,0,0,0,0
0.407,6,26,7256,13,155,33,267,1301,13,678,30,2045,5955
1.626,6,16,2297,8,324,232,585,1061,8,396,115,580,1236
0.003,6,3,189,1,0,0,0,40,2,69,1,69,149
1.681,6,38,8252,19,320,93,1162,2716,19,433,81,1360,5536
87.254,6,19,1243,10,69,9693,69,676,9,69,10904,69,567
7.414,6,1445,1361433,939,1375,7,1408,1330457,506,931,14,2816,30976
1799.584,1,339,28476,339,56,5324,56,28476,0,0,0,0,0
81.837,6,17,972,8,0,11691,0,448,9,0,10002,0,524
23.851,6,30,8698,14,340,1834,721,2605,16,681,1576,1414,6093
0.079,6,12,1843,7,138,13,138,510,5,532,18,891,1333
1780.309,6,103,8395,68,65,26571,65,4930,35,59,52358,59,3465
1740.687,17,30,7050,30,207,60023,207,7050,0,0,0,0,0
1798.159,17,406,136416,406,308,4439,308,136416,0,0,0,0,0
6.34,6,65,20438,33,554,198,1152,15731,32,427,196,1152,4707
93.595,1,8,448,8,28,13370,28,448,0,0,0,0,0
300.822,6,39,9638,21,540,15041,1360,4116,18,399,508,1360,5522
4.196,17,5,340,5,40,1049,40,340,0,0,0,0,0
44.285,17,20,12073,10,662,4920,1350,6908,10,488,1692,1350,5165
1680.591,1,15,840,15,28,120042,28,840,0,0,0,0,0
60.672,6,9,771,5,177,15168,177,445,4,110,20102,110,326
280.466,6,30,7432,13,158,23372,267,1317,17,603,17526,2760,6115
237.258,6,30,7432,14,158,18250,267,1357,16,603,15816,2800,6075
119.768,6,27,3482,10,183,13306,517,1457,17,381,7485,499,2025
11.414,6,1820,1659499,1144,1373,9,1408,1619683,676,931,16,2816,39816
29.597,6,48,13157,23,173,1345,721,2655,25,730,1190,1414,10502
1797.676,1,268,15008,268,28,6732,28,15008,0,0,0,0,0
0.075,17,2,394,1,46,0,46,74,1,292,0,292,320
1.416,6,54,23933,30,997,48,1460,18197,24,433,53,1460,5736
280.173,6,27,7312,13,158,23347,267,1317,14,775,21550,3445,5995
1772.516,6,180,15480,120,69,14895,69,8940,60,69,30036,69,6540
1093.656,6,54,4335,36,49,31247,205,2693,18,39,56660,108,1642
280.548,6,30,7432,14,158,21580,267,1357,16,678,18696,3456,6075
0.013,17,2,322,1,33,0,33,61,1,233,0,233,261
4.125,6,18,2417,10,304,458,304,1732,8,83,567,83,685
1682.245,1,15,840,15,28,120160,28,840,0,0,0,0,0
5.832,6,57,22010,23,1030,265,1440,15403,34,305,171,1440,6607
2.39,6,29,10278,17,368,149,837,1789,12,1000,208,1452,8489
0.594,6,12,3045,6,92,118,92,412,6,579,41,1408,2633
1794.378,6,33,5681,22,272,85446,413,3875,11,124,179419,269,1806
1745.255,6,97,7307,63,38,28149,205,4476,34,33,52879,98,2831
0.445,6,13,1749,7,253,74,500,878,6,275,89,500,871
19.134,6,20,3506,11,210,1912,210,1048,9,664,2391,904,2458
1798.316,6,365,25032,213,94,8482,469,14536,152,69,11908,69,10496
0.991,6,11,1727,7,100,165,100,384,4,589,242,1152,1343
240.231,6,60,20825,30,843,8283,1418,17598,30,207,8283,580,3227
67.215,6,119,131647,57,430,1200,647,4298,62,2139,1098,8448,127349
0.018,6,4,4300,3,1368,0,1368,4260,1,0,0,0,40
1770.223,6,99,9306,66,66,27234,66,5610,33,60,55315,60,3696
0.161,6,9,527,5,43,40,43,311,4,0,51,0,216
6.314,1,4,224,4,28,2104,28,224,0,0,0,0,0
1789.577,6,383,28647,222,109,8097,965,15888,161,86,11184,405,12759
6.786,6,1485,1359969,929,1386,7,1408,1326393,556,776,11,1408,33576
72.367,6,43,8881,20,401,547,889,2084,23,366,3283,2720,6797
9.023,6,205,143712,111,1134,82,1460,46474,94,1335,95,1607,97238
1795.459,17,133,8512,133,36,13601,36,8512,0,0,0,0,0
487.408,6,32,2616,20,64,25653,64,1440,12,58,44301,58,1176
1770.169,6,100,9226,66,64,27233,64,5544,34,58,53638,58,3682
105.697,6,23,11278,12,433,76,990,1823,11,1286,10555,3928,9455
1783.809,6,356,22520,208,69,8617,69,12460,148,69,12134,69,10060
0.953,6,23,6460,13,323,78,954,2140,10,979,104,1731,4320
1776.577,17,73,3060,72,14,25022,14,3024,1,8,0,8,36
1786.341,6,106,8524,68,66,26661,66,4964,38,60,48277,60,3560
13.661,6,30,8872,14,158,1050,267,1357,16,763,908,1781,7515
1680.085,1,15,840,15,28,120006,28,840,0,0,0,0,0
1741.294,6,87,6322,58,31,30549,31,3915,29,31,62187,31,2407
1743.201,6,95,7203,63,38,28116,205,4476,32,33,56220,98,2727
773.707,6,72,8109,40,78,19838,722,3588,32,135,24951,1408,4521
210.125,17,4,558,2,36,210113,36,128,2,187,210119,187,430
0.012,6,10,1542,5,505,3,505,773,5,501,3,501,769
300.127,6,40,10231,21,632,14997,1440,4669,19,399,16664,1440,5562
0.388,6,6,324,4,0,129,0,216,2,0,203,0,108
1789.741,1,238,13328,238,28,7551,28,13328,0,0,0,0,0
4.328,17,30,13073,14,611,332,1350,8949,16,229,218,1350,4124
1796.041,17,449,39928,404,35,4456,288,25708,45,288,40021,288,14220
1779.528,17,142,11360,71,48,25421,48,5396,71,56,25421,56,5964
1.548,6,41,8431,21,321,77,1164,2810,20,400,71,1460,5621
0.996,17,2,685,1,308,0,308,336,1,321,0,321,349
0.486,6,10,968,5,256,119,256,460,5,304,119,304,508
61.84,6,66,45412,42,1174,1508,1448,37435,24,746,2678,1448,7977
6.763,6,29,7464,12,155,614,267,1266,17,423,422,3417,6198
1681.147,17,14,3843,7,30,280190,30,406,7,463,280190,463,3437
262.439,17,4,352,2,60,262437,60,176,2,60,262438,60,176
593.509,6,136,34365,63,528,1529,1460,22692,73,218,8241,1629,11673
11.229,6,17,2746,8,152,1604,267,782,9,400,1368,1179,1964
10.993,6,20,4442,11,275,1099,275,998,9,768,776,1440,3444
365.167,6,21,1780,16,226,24344,226,1292,5,110,15211,110,488
0.271,17,3,451,2,39,8,39,134,1,289,0,289,317
0.234,17,2,144,1,36,0,36,64,1,52,0,52,80
0.061,17,2,632,1,288,0,288,316,1,288,0,288,316
5.949,6,38,7229,20,218,313,314,3423,18,513,332,1179,3806
611.212,6,94,10927,36,104,17463,722,3781,58,85,10719,2118,7146
1.173,6,24,6547,13,332,97,1001,2187,11,979,116,1731,4360
1681.031,1,15,840,15,28,120073,28,840,0,0,0,0,0
374.146,6,23,1535,16,177,24943,177,1053,7,110,10397,110,482
1739.931,1,16,896,16,28,115995,28,896,0,0,0,0,0
0.193,17,4,288,2,36,161,36,128,2,52,34,52,160
158.012,17,4,352,2,60,158010,60,176,2,60,158010,60,176
4.069,17,2,120,2,32,4069,32,120,0,0,0,0,0
90.379,6,38,6670,16,206,375,314,2704,22,513,4292,1179,3966
0.289,17,8,2750,8,315,41,354,2750,0,0,0,0,0
280.453,6,30,7432,13,158,23371,267,1317,17,603,17521,2760,6115
300.273,6,48,29672,29,190,10724,444,2325,19,2027,13360,6557,27347
1783.807,6,416,24920,208,69,8617,69,12460,208,34,8617,64,12460
280.522,6,27,7312,12,158,25502,267,1277,15,775,20028,3465,6035
369.702,6,9,13140,0,0,0,0,0,9,1420,46212,1420,13140
74.172,6,9,360,9,0,0,0,360,0,0,0,0,0
1773.059,6,184,15778,122,69,14653,69,9158,62,69,29058,69,6620
540.816,6,57,4902,36,69,15451,69,2751,21,69,27040,69,2151
0.01,6,3,327,2,103,9,138,287,1,0,0,0,40
8.603,6,3,258,1,0,0,0,40,2,69,8453,69,218
269.117,6,8,1655,8,177,38445,177,1655,0,0,0,0,0
329.811,6,120,94126,79,1265,4228,1408,83871,41,811,2073,3847,10255
1795.475,17,251,70251,251,251,7181,422,70251,0,0,0,0,0
208.366,1,14,784,14,28,16028,28,784,0,0,0,0,0
57.027,6,27,7177,13,155,4752,267,1306,14,530,4386,3417,5871
240.274,6,41,5169,21,235,12011,751,2750,20,171,12644,530,2419
5.645,6,14,2162,8,666,806,666,1098,6,728,1128,728,1064
1783.594,17,83,3480,82,14,22019,14,3444,1,8,0,8,36
1786.223,6,154,19574,92,302,19628,302,13852,62,83,29282,83,5722
0.367,6,13,1693,7,288,56,288,588,6,426,40,434,1105
0.017,17,2,445,1,34,0,34,62,1,355,0,355,383
1799.644,6,356,22520,208,69,8693,69,12460,148,69,12242,69,10060
281.336,6,32,7516,14,158,21641,267,1357,18,543,16547,1400,6159
6.001,6,4,176,3,0,3000,0,132,1,0,0,0,44
44.254,6,373,170709,197,804,225,1152,159187,176,447,250,1179,11522
1700.67,17,13,534,11,14,170048,14,462,2,8,1700492,8,72
1.278,6,37,8212,19,320,71,1162,2716,18,476,64,2720,5496
4.007,6,43,24664,23,773,182,1360,6427,20,1452,194,2720,18237
1772.903,6,181,15589,120,69,14898,69,8940,61,69,29541,69,6649
0.008,17,2,443,1,36,0,36,64,1,351,0,351,379
1687.23,17,14,1036,7,30,281200,30,406,7,62,281196,62,630
0.03,6,9,1928,5,666,7,666,934,4,778,9,778,994
7.425,6,5,284,1,0,0,0,60,4,0,2416,0,224
1774.648,1,56,4704,56,56,32266,56,4704,0,0,0,0,0
15.915,6,13,2133,8,324,2273,585,1073,5,396,3969,580,1060
240.378,6,66,18874,33,763,7511,1418,15482,33,185,7511,580,3392
131.157,17,15,1140,15,48,9368,48,1140,0,0,0,0,0
4.117,17,3,201,3,39,2058,39,201,0,0,0,0,0
368.52,6,9,604,5,106,92127,106,420,4,0,122836,0,184
1773.161,6,120,7311,66,27,27278,27,3939,54,27,33455,27,3372
157.268,6,431,306864,213,797,13,1360,15037,218,1348,724,4080,291827
300.851,2,5,160,5,8,75212,8,160,0,0,0,0,0
0.005,17,2,503,1,40,0,40,68,1,407,0,407,435
0.365,17,2,586,1,46,0,46,74,1,484,0,484,512
0.721,6,218,223074,149,266,4,517,9423,69,3334,9,21120,213651
66.74,6,631,298121,336,831,199,1152,280475,295,389,226,1152,17646
1793.449,6,283,42213,166,316,10869,316,30204,117,83,15460,102,12009
0.357,6,21,7290,13,335,29,668,2026,8,968,49,1475,5264
1680.614,1,15,840,15,28,120043,28,840,0,0,0,0,0
2.519,17,3,451,2,39,984,39,134,1,289,0,289,317
152.172,17,11,2552,11,204,15217,204,2552,0,0,0,0,0
1791.013,1,73,4088,73,28,24875,28,4088,0,0,0,0,0
2.999,17,3,1021,2,308,2000,308,672,1,321,0,321,349
1740.495,6,87,6322,58,31,30535,31,3915,29,31,62160,31,2407
1.631,6,25,8779,15,287,116,595,1467,10,986,162,1420,7312
943.351,17,44,1845,43,13,22460,14,1801,1,16,0,16,44
1777.937,1,59,4956,59,56,30654,56,4956,0,0,0,0,0
6.055,17,6,498,3,47,3024,47,225,3,63,3023,63,273
2.493,17,2,685,1,308,0,308,336,1,321,0,321,349
0.009,6,2,1544,0,0,0,0,0,2,1440,9,1440,1544
1681.888,1,15,870,15,30,120134,30,870,0,0,0,0,0
1744.72,2,29,928,29,8,62311,8,928,0,0,0,0,0
1789.101,6,172,15323,93,121,19446,208,11233,79,31,22933,31,4090
278.453,6,50,9409,21,105,13922,267,2115,29,255,9944,1452,7294
369.591,6,20,1416,14,226,28430,226,986,6,110,12241,110,430
48.963,6,28,8259,15,461,3492,1258,2646,13,705,4076,1571,5613
1.439,6,14,1640,7,256,237,256,1052,7,304,237,304,588
1771.317,6,103,9514,66,66,27251,66,5610,37,60,49200,60,3904
1766.99,6,216,20748,106,80,16826,721,9925,110,164,16209,1440,10823
1796.795,17,448,39896,403,35,4469,288,25676,45,288,40021,288,14220
0.02,17,2,326,1,64,0,64,92,1,206,0,206,234
29.073,17,9,684,9,48,3634,48,684,0,0,0,0,0
3.743,6,34,6169,17,206,233,314,2744,17,548,218,1179,3425
1759.156,6,5027,5047288,1571,150,1120,912,89224,3456,1412,509,2836,4958064
1.285,6,51,18756,29,846,45,1360,13055,22,437,52,2715,5701
15.726,1,21,2184,0,0,0,0,0,21,76,786,76,2184
4.612,6,38,7229,19,218,256,314,3383,19,513,242,1179,3846
3.028,6,26,11009,12,158,273,370,1275,14,1146,231,1691,9734
1.598,6,50,19388,29,894,57,1360,13727,21,400,69,1360,5661
1799.81,17,6048,290304,3024,20,595,20,145152,3024,20,595,20,145152
1.423,6,41,8443,21,321,71,1164,2822,20,400,62,1360,5621
3.068,17,8,1730,4,47,1018,47,300,4,329,1019,341,1430
1786.909,6,102,8296,68,65,26670,65,4930,34,59,54144,59,3366
1792.344,6,360,22818,209,69,8617,69,12569,151,69,11948,69,10249
0.004,17,2,220,1,36,0,36,64,1,128,0,128,156
35.585,6,43,8924,21,401,706,889,2136,22,368,1688,3488,6788
252.141,17,4,558,2,36,252134,36,128,2,187,252137,187,430
124.758,6,16,3961,5,188,1194,245,580,11,419,12452,1407,3381
280.318,6,29,7392,13,158,23359,267,1317,16,603,18685,2036,6075
0.344,17,8,2758,8,316,49,355,2758,0,0,0,0,0
11.908,6,1901,1645505,1162,1363,10,1380,1611715,739,421,16,1923,33790
1770.431,6,103,9448,66,65,27237,65,5577,37,59,49175,59,3871
1.919,17,4,518,3,39,701,39,201,1,289,0,289,317
1784.505,6,360,22818,209,69,8579,69,12569,151,69,11895,69,10249
280.56,6,30,7432,13,158,23380,267,1317,17,603,17532,2076,6115
1775.618,6,181,15589,120,69,14921,69,8940,61,69,29589,69,6649
893.502,6,176,19122,81,116,11168,1189,7216,95,158,6512,1926,11906
4.256,6,22,4426,12,213,386,597,1689,10,552,453,1767,2737
9.038,6,15,1087,8,275,1291,275,603,7,96,1341,96,484
1751.822,6,185,11314,93,47,19041,208,6735,92,31,19248,31,4579
1.055,17,4,860,2,39,526,39,134,2,335,529,381,726
1692.995,1,8,448,8,28,241856,28,448,0,0,0,0,0
251.593,2,2,64,2,8,251593,8,64,0,0,0,0,0
0.219,6,4,160,2,0,170,0,80,2,0,218,0,80
39.938,17,3,228,3,48,19969,48,228,0,0,0,0,0
240.185,6,52,17750,28,787,8895,1408,14844,24,235,10442,580,2906
98.527,6,35,9942,12,290,3276,1189,2524,23,360,4478,1420,7418
240.175,6,53,17548,27,784,9237,1402,14753,26,179,9606,580,2795
61.327,6,37,15936,22,800,2920,1448,9158,15,665,4362,1448,6778
1797.209,6,82,4756,41,36,44928,36,2168,41,456,44928,456,2588
0.32,6,29,7087,17,244,20,655,2393,12,601,28,1414,4694
11.802,6,1852,1620019,1144,1363,10,1380,1587457,708,421,16,1923,32562
1783.613,1,80,4480,80,28,22577,28,4480,0,0,0,0,0
5.711,6,39,7269,20,218,300,314,3423,19,513,302,1179,3846
9.739,6,70,20638,37,533,270,1152,15891,33,427,296,1152,4747
281.138,6,29,7392,13,158,23428,267,1317,16,603,18732,2236,6075
1790.964,6,356,22520,208,69,8652,69,12460,148,69,12183,69,10060
131.604,6,15,856,5,0,32857,0,284,10,0,14603,0,572
104.275,17,2940,3417030,460,69,227,1350,45061,2480,1331,42,1350,3371969
1789.957,6,359,22709,209,69,8605,69,12569,150,69,12013,69,10140
0.115,6,10,873,6,182,23,182,502,4,77,16,134,371
0.378,6,26,9026,13,263,31,691,1736,13,943,29,1438,7290
280.35,6,30,7432,13,158,23362,267,1317,17,543,17512,1400,6115
0.318,17,2,304,1,60,0,60,88,1,188,0,188,216
3.99,6,38,7229,19,218,221,314,3383,19,513,208,1179,3846
83.015,6,28,13949,14,831,70,1460,5578,14,1114,6372,1460,8371
1789.799,17,134,10720,67,48,27118,48,5092,67,56,27118,56,5628
0.033,6,5,307,3,43,15,43,207,2,0,7,0,100
4.204,17,5,290,5,30,1051,30,290,0,0,0,0,0
1796.319,17,449,39928,404,35,4457,288,25708,45,288,40022,288,14220
179.761,1,4,224,4,28,59920,28,224,0,0,0,0,0
1785.533,6,359,22709,209,69,8584,69,12569,150,69,11983,69,10140
0.019,17,2,912,1,308,0,308,336,1,548,0,548,576
4.992,17,4,288,2,36,4991,36,128,2,52,4992,52,160
176.121,17,6,362,3,32,88060,33,181,3,32,88060,33,181
279.381,6,36,3115,14,284,21490,517,1320,22,75,13295,156,1795
1772.429,6,180,15480,120,69,14894,69,8940,60,69,30036,69,6540
1798.222,17,446,39264,403,35,4473,288,25676,43,288,41926,288,13588
0.432,6,6,324,4,0,144,0,216,2,0,227,0,108
0.476,6,131,89871,61,131,7,232,2969,70,1314,6,1420,86902
108.396,17,4,352,2,60,108395,60,176,2,60,108395,60,176
0.068,6,2,100,1,0,0,0,60,1,0,0,0,40
1.78,6,50,18341,28,882,65,1460,12640,22,437,68,2615,5701
0.002,6,3,1492,1,0,0,0,40,2,1348,0,1348,1452
0.142,6,9,1002,5,213,35,213,417,4,421,35,421,585
0.848,17,2,144,1,36,0,36,64,1,52,0,52,80
1749.608,17,12,498,11,14,174960,14,462,1,8,0,8,36
1744.717,2,23,736,23,8,79305,8,736,0,0,0,0,0
0.397,6,6,248,4,0,132,0,164,2,0,192,0,84
3.715,6,14,3137,7,92,619,92,452,7,463,36,1448,2685
2.761,6,6,458,4,105,917,105,374,2,0,2753,0,84
33.655,6,33,5409,16,180,2230,721,1923,17,371,2091,2026,3486
32.132,6,9,396,2,0,3483,0,88,7,0,5343,0,308
1789.578,17,142,11360,71,48,25565,48,5396,71,56,25565,56,5964
2.633,17,4,240,2,32,2632,32,120,2,32,2631,32,120
3.006,6,25,8082,11,326,296,517,1897,14,778,227,1418,6185
0.076,6,7,423,4,43,11,43,259,3,0,36,0,164
1258.486,17,14,1117,7,31,209745,37,413,7,72,209745,136,704
300.279,6,38,29073,22,190,14299,444,1913,16,2392,16013,5197,27160
1.357,6,24,8004,12,164,104,267,1288,12,1014,105,2491,6716
12.19,17,20,2070,10,50,1354,50,780,10,101,1353,107,1290
49.5,6,37,8373,18,369,517,792,1860,19,441,2742,1460,6513
146.572,1,20,1680,20,56,7714,56,1680,0,0,0,0,0
1689.754,1,8,448,8,28,241393,28,448,0,0,0,0,0
1.024,17,8,840,4,33,340,33,244,4,121,340,145,596
1787.087,6,104,8376,68,65,26672,65,4930,36,59,51056,59,3446
0.272,6,23,5080,11,137,27,267,1132,12,577,24,1400,3948
252.872,2,2,64,2,8,252872,8,64,0,0,0,0,0
1796.8,17,448,39896,403,35,4469,288,25676,45,288,40022,288,14220
2.35,6,13,2311,8,188,335,245,700,5,1407,521,1407,1611
117.293,6,21,8712,11,314,55,634,1415,10,1147,13019,2720,7297
220.519,6,1953,1054184,1150,853,191,1152,1015180,803,344,274,373,39004
1775.012,6,180,15480,120,69,14916,69,8940,60,69,30077,69,6540
0.822,6,2,1520,1,0,0,0,40,1,1440,0,1440,1480
300.582,6,11,912,6,226,60078,226,546,5,110,75097,110,366
5.495,6,36,8302,17,175,343,721,2089,19,681,294,1440,6213
1787.904,6,376,26548,217,104,8277,469,15772,159,69,11315,69,10776
1792.173,6,356,22520,208,69,8657,69,12460,148,69,12191,69,10060
3.007,6,4,1600,2,0,3007,0,80,2,1440,1572,1440,1520
1796.545,17,449,39928,404,35,4457,288,25708,45,288,40014,288,14220
0.422,6,12,1653,6,288,79,288,548,6,426,48,434,1105
1739.971,6,87,6322,58,31,30525,31,3915,29,31,62141,31,2407
0.017,17,2,322,1,36,0,36,64,1,230,0,230,258
280.25,6,29,7392,13,158,23354,267,1317,16,603,18681,2036,6075
1787.394,6,104,8376,68,65,26677,65,4930,36,59,51066,59,3446
0.421,6,7,295,4,0,140,0,164,3,7,108,7,131
28.676,6,26,6044,15,275,2048,275,1158,11,886,2848,1414,4886
1796.714,17,142,11360,71,48,25667,48,5396,71,56,25667,56,5964
1024.988,6,106,14090,61,304,17083,304,9880,45,83,23295,83,4210
0.001,17,8,2750,8,315,0,354,2750,0,0,0,0,0
1786.512,6,104,8444,68,66,26664,66,4964,36,60,51040,60,3480
5.356,17,3,208,2,36,5007,36,128,1,52,0,52,80
15.866,6,2735,2552394,1757,1374,8,1408,2496874,978,931,16,2816,55520
0.533,17,3,451,2,39,273,39,134,1,289,0,289,317
0.283,17,8,2742,8,314,40,353,2742,0,0,0,0,0
1763.559,2,12,384,12,8,160323,8,384,0,0,0,0,0
45.206,6,55,20850,27,788,1738,1402,17953,28,204,1673,580,2897
10.926,6,82,24805,41,560,273,1152,19008,41,461,266,1179,5797
1772.509,6,180,15480,120,69,14895,69,8940,60,69,30042,69,6540
1.947,17,3,468,3,128,973,128,468,0,0,0,0,0
373.86,6,25,1651,17,177,23366,177,1117,8,110,9256,110,534
1772.936,6,180,15480,120,69,14898,69,8940,60,69,30049,69,6540
1798.319,1,345,28980,345,56,5227,56,28980,0,0,0,0,0
108.942,17,3,1008,3,308,54471,308,1008,0,0,0,0,0
1797.735,17,344,26144,344,48,5241,48,26144,0,0,0,0,0
240.202,6,52,17756,27,800,9238,1418,15023,25,178,10008,580,2733
0.998,6,26,5700,13,125,83,267,1275,13,650,75,1380,4425
1.566,6,14,2351,8,188,223,245,700,6,703,260,1152,1651
0.165,17,2,2752,2,1348,165,1348,2752,0,0,0,0,0
1796.409,17,448,39896,403,35,4468,288,25676,45,288,40019,288,14220
47.475,2,2,64,2,8,47475,8,64,0,0,0,0,0
11.171,6,27,11355,13,275,930,275,1078,14,1078,827,1414,10277
83.427,17,22,1672,22,48,3972,48,1672,0,0,0,0,0
2.982,17,8,688,4,47,991,47,300,4,69,991,75,388
251.795,2,2,64,2,8,251795,8,64,0,0,0,0,0
97.078,17,4,352,2,60,97077,60,176,2,60,97077,60,176
1030.248,6,90,11514,48,90,20188,516,4105,42,168,25125,1452,7409
1.682,6,44,16332,25,677,70,1408,8765,19,505,84,2688,7567
47.448,6,31,8805,11,149,124,267,1343,20,554,2496,1420,7462
180.169,6,31,7754,16,245,12010,538,1886,15,525,12868,1460,5868
2.842,6,41,25086,25,884,118,1360,6349,16,2009,180,7459,18737
1772.469,6,180,15480,120,69,14894,69,8940,60,69,30036,69,6540
1798.5,17,441,37684,403,35,4473,288,25676,38,288,47592,288,12008
448.573,6,9,546,6,31,89714,31,333,3,31,224276,31,213
5.739,6,11,467,6,0,1147,0,248,5,7,687,7,219
1786.745,6,104,8444,68,66,26667,66,4964,36,60,51047,60,3480
0.137,17,2,378,1,42,0,42,70,1,280,0,280,308
26.414,17,47,26631,23,595,1200,1350,14344,24,483,1144,1350,12287
82.754,6,22,8343,11,525,82,1237,2072,11,831,8258,1360,6271
0.369,6,10,968,5,256,90,256,460,5,304,89,304,508
0.085,17,2,362,1,46,0,46,74,1,260,0,260,288
0.985,17,4,314,2,31,952,31,118,2,70,865,70,196
1741.065,6,135,8464,75,46,23527,208,5134,60,31,29505,31,3330
1794.03,17,66,2766,65,14,28031,14,2730,1,8,0,8,36
315.988,6,103,21188,51,279,6319,1360,10529,52,244,6192,4649,10659
1770.505,6,101,9344,66,65,27238,65,5577,35,59,52070,59,3767
37.051,17,11,836,11,48,3705,48,836,0,0,0,0,0
1746.085,6,95,7203,63,38,28162,205,4476,32,33,56312,98,2727
70.319,6,16,652,7,0,7993,0,284,9,0,8788,0,368
172.012,17,4,352,2,60,172011,60,176,2,60,172011,60,176
15.708,17,20,14082,12,960,1422,1350,11862,8,249,2232,1350,2220
1.621,6,18,6394,9,150,202,174,664,9,894,191,1420,5730
9.556,17,4,1824,2,308,9556,308,672,2,548,14,548,1152
1775.695,1,67,5628,67,56,26904,56,5628,0,0,0,0,0
147.311,6,33,10392,15,158,10522,267,1397,18,751,8663,1781,8995
7.489,6,52,9605,26,233,299,314,4781,26,472,289,1179,4824
5.865,6,43,7429,22,201,279,314,3503,21,440,280,1152,3926
15.115,17,11,4809,5,505,3770,1350,2666,6,329,3016,1350,2143
1798.452,6,370,25977,214,99,8443,469,15114,156,69,11601,69,10863
87.738,17,4,1344,4,308,29246,308,1344,0,0,0,0,0
1776.75,17,140,11200,70,48,25749,48,5320,70,56,25749,56,5880
264.165,17,4,288,2,36,264164,36,128,2,52,264165,52,160
0.024,17,4,304,3,32,7,32,180,1,96,0,96,124
20.106,6,18,2368,10,189,2234,517,1298,8,323,2869,499,1070
240.31,6,44,8447,22,449,11443,1402,5648,22,205,11443,580,2799
0.027,17,2,702,2,323,27,329,702,0,0,0,0,0
0.829,6,20,9046,12,304,75,597,1425,8,1457,86,4441,7621
0.252,17,8,2774,8,318,36,357,2774,0,0,0,0,0
1.423,6,49,18687,27,912,54,1440,12986,22,400,58,1440,5701
1794.456,1,59,4956,0,0,0,0,0,59,56,30938,56,4956
15.177,6,18,6657,5,221,3794,221,441,13,568,916,3488,6216
1794.937,1,160,8960,160,28,11288,28,8960,0,0,0,0,0
1757.593,6,128,12715,70,64,25471,517,4820,58,231,30834,1418,7895
1783.977,6,362,22898,210,69,8535,69,12678,152,69,11814,69,10220
4.108,6,40,7309,20,218,216,314,3423,20,440,203,1152,3886
0.009,6,4,232,2,0,4,0,128,2,0,2,0,104
1040.335,6,22,20760,2,174,16904,174,258,20,1405,54749,1420,20502
0.158,17,2,338,1,33,0,33,61,1,249,0,249,277
216.765,6,28,8792,13,158,18063,267,1317,15,858,15474,2800,7475
71.091,6,30,7435,13,155,5924,267,1306,17,453,4442,3417,6129
1147.963,6,140,19485,74,79,15725,721,6718,66,306,16729,1414,12767
154.479,6,27,11973,15,828,91,1360,4775,12,1117,14023,2720,7198
88.711,17,4,352,2,60,88710,60,176,2,60,88710,60,176
756.35,2,7,224,7,8,126058,8,224,0,0,0,0,0
290.822,17,4,352,2,60,290821,60,176,2,60,290821,60,176
0.876,17,2,122,2,33,876,33,122,0,0,0,0,0
373.618,6,25,1651,17,177,23351,177,1117,8,110,9255,110,534
0.086,6,9,1339,5,145,21,145,349,4,826,25,826,990
280.384,6,30,7432,13,158,23365,267,1317,17,603,17521,2076,6115
253.829,17,2,306,2,125,253829,125,306,0,0,0,0,0
1621.805,1,20,1120,20,28,85358,28,1120,0,0,0,0,0
1751.226,6,97,7307,63,38,28245,205,4476,34,33,53057,98,2831
1786.849,6,102,8364,68,66,26669,66,4964,34,60,54144,60,3400
296.772,6,128,47427,63,699,4783,1440,21562,65,540,4634,1440,25865
65.354,6,24,4805,13,185,5446,722,1798,11,607,6513,1408,3007
767.9,1,10,1402,10,112,85322,351,1402,0,0,0,0,0
14.005,6,9,685,0,0,0,0,0,9,31,1750,31,685
59.978,6,25,7097,12,155,5452,267,1266,13,589,4997,3426,5831
53.594,17,6,528,3,48,26793,48,228,3,72,26792,72,300
1745.771,6,97,7307,63,38,28157,205,4476,34,33,52891,98,2831
1744.249,6,95,7203,63,38,28133,205,4476,32,33,56253,98,2727
1770.216,6,101,9278,66,64,27234,64,5544,35,58,52062,58,3734
1773.124,6,180,15480,120,69,14900,69,8940,60,69,30045,69,6540
1761.171,6,135,13490,74,75,24124,517,5380,61,213,29352,1418,8110
1203.217,2,12,384,12,8,109383,8,384,0,0,0,0,0
0.314,6,25,8938,13,247,26,624,1672,12,1105,27,2816,7266
443.873,6,153,45526,72,784,6251,1418,38287,81,90,5546,580,7239
1797.759,6,1144,128844,412,111,4374,311,58550,732,110,2459,220,70294
35.337,6,31,5095,15,154,2524,722,1859,16,342,2342,1408,3236
1.374,6,50,19042,27,873,52,1360,13346,23,433,54,1360,5696
0.631,6,8,478,4,31,210,31,227,4,31,106,31,251
1764.18,2,14,448,14,8,135706,8,448,0,0,0,0,0
7.23,17,4,352,2,60,7229,60,176,2,60,7229,60,176
1681.579,17,14,1036,7,30,280261,30,406,7,62,280261,62,630
36.99,17,22,1672,22,48,1761,48,1672,0,0,0,0,0
0.856,6,10,1687,7,100,142,100,384,3,1179,303,1179,1303
1797.96,1,58,4872,58,56,31543,56,4872,0,0,0,0,0
0.032,6,4,196,2,0,2,0,104,2,0,32,0,92
0.392,6,9,1346,5,145,98,145,349,4,833,113,833,997
1.674,6,14,2351,8,188,239,245,700,6,703,284,1152,1651
0.026,6,11,1112,6,517,5,517,837,5,7,6,7,275
126.257,17,4,352,2,60,126256,60,176,2,60,126255,60,176
5.955,6,30,8755,15,236,421,625,2093,15,864,410,1360,6662
7.071,17,4,240,2,32,7070,32,120,2,32,7070,32,120
26.844,17,4,240,2,32,26843,32,120,2,32,26842,32,120
1.787,6,50,18854,28,922,66,1460,13153,22,400,75,1460,5701
1495.316,1,7,392,7,28,249219,28,392,0,0,0,0,0
1.915,6,12,3710,7,170,315,170,550,5,1446,129,2675,3160
190.463,17,4,352,2,60,190462,60,176,2,60,190461,60,176
1794.903,17,142,11360,71,48,25641,48,5396,71,56,25641,56,5964
1771.497,1,58,4872,58,56,31078,56,4872,0,0,0,0,0
1745.388,6,95,7203,63,38,28151,205,4476,32,33,56291,98,2727
1773.427,6,204,22399,130,75,13747,267,10057,74,133,24287,1917,12342
3.788,17,5,295,5,31,947,31,295,0,0,0,0,0
1564.155,2,14,448,14,8,120319,8,448,0,0,0,0,0
1774.755,6,276,33819,114,134,15704,1360,16451,162,134,11022,3302,17368
3.018,17,4,324,2,34,3010,34,124,2,72,3009,72,200
5.795,6,45,8409,23,227,263,314,4102,22,489,264,1179,4307
0.0,6,1,134,1,94,0,94,134,0,0,0,0,0
0.487,6,113,74920,62,1295,7,1432,68589,51,427,9,1432,6331
0.407,6,28,9095,14,252,31,647,1744,14,945,30,1408,7351
1783.807,6,360,24156,210,88,8534,469,13878,150,69,11971,69,10278
0.288,17,2,180,1,30,0,30,58,1,94,0,94,122
27.965,6,18,788,8,0,3995,0,348,10,0,2457,0,440
3.137,6,57,38964,37,687,87,1360,6337,20,2651,157,8289,32627
4.101,6,544,459224,320,1409,12,1432,445500,224,389,17,1432,13724
74.357,6,30,7432,13,158,6196,267,1317,17,543,4645,1400,6115
1730.12,6,64,4665,42,33,42198,33,2889,22,31,82378,31,1776
1783.809,6,354,22440,206,69,8701,69,12380,148,69,12134,69,10060
176.787,6,20,9096,11,499,88,1193,1971,9,1350,22074,3639,7125
1705.244,1,8,448,8,28,243606,28,448,0,0,0,0,0
150.772,6,33,14770,16,488,315,1360,3127,17,995,9415,1360,11643
1797.263,6,126,7896,72,43,25313,208,4682,54,31,33902,31,3214
0.02,17,2,256,1,49,0,49,77,1,151,0,151,179
1760.876,6,76,3952,38,0,47589,0,1976,38,0,47586,0,1976
11.859,6,1783,1605575,1135,1365,10,1380,1572617,648,475,18,1923,32958
37.198,17,22,1936,11,48,3714,48,836,11,72,3712,72,1100
125.46,6,18,6377,9,275,15682,275,639,9,767,15656,2840,5738
1.627,6,25,8056,12,164,128,267,1288,13,869,117,1368,6768
1787.356,6,102,8228,68,64,26676,64,4896,34,58,54158,58,3332
1782.598,17,301,60666,301,173,5941,422,60666,0,0,0,0,0
15.177,6,5,752,3,46,7588,46,166,2,506,14970,506,586
1.454,6,50,20848,28,936,53,1360,15192,22,433,61,1360,5656
295.513,2,3,96,3,8,147756,8,96,0,0,0,0,0
8.009,1,9,756,0,0,0,0,0,9,56,1001,56,756
0.013,17,3,993,3,303,6,332,993,0,0,0,0,0
280.226,6,30,7432,13,158,23352,267,1317,17,543,17509,1400,6115
1.329,6,47,18160,26,882,53,1460,12544,21,433,57,1460,5616
0.213,17,2,2382,2,1163,213,1163,2382,0,0,0,0,0
1.246,6,16,6056,9,70,154,133,504,7,1756,206,2440,5552
240.207,6,55,17554,30,736,8282,1408,14819,25,178,10008,580,2735
1784.014,17,83,3480,82,14,22024,14,3444,1,8,0,8,36
150.476,6,70,51413,47,1206,3271,1408,43482,23,961,2801,3847,7931
49.097,6,12,5538,4,106,16365,106,274,8,822,6933,1452,5264
1798.353,6,356,22520,208,69,8687,69,12460,148,69,12233,69,10060
104.182,2,2,64,2,8,104182,8,64,0,0,0,0,0
356.108,6,458,380206,280,1380,1276,1448,354220,178,572,1574,2359,25986
1775.256,6,180,15480,120,69,14918,69,8940,60,69,30080,69,6540
0.02,6,14,6312,8,126,2,126,550,6,1814,3,3829,5762
1455.309,6,296,21154,170,108,8611,469,12526,126,69,11642,69,8628
1789.027,6,356,22520,208,69,8642,69,12460,148,69,12169,69,10060
0.177,1,2,112,2,28,177,28,112,0,0,0,0,0
1.253,6,49,19254,27,891,48,1360,13598,22,476,51,2720,5656
1786.032,6,104,8444,68,66,26657,66,4964,36,60,51027,60,3480
1.244,6,47,19004,27,879,47,1360,13428,20,476,56,2715,5576
92.694,6,15,1132,4,226,110,226,442,11,110,9252,110,690
1786.643,6,108,8536,68,65,26666,65,4930,40,59,45809,59,3606
131.548,1,5,1631,5,298,32887,327,1631,0,0,0,0,0
1799.96,6,370,25908,214,99,8450,469,15114,156,69,11612,69,10794
2.946,17,2,1430,2,687,2946,687,1430,0,0,0,0,0
0.391,6,27,9069,13,257,32,669,1714,14,945,28,1438,7355
16.057,17,23,8828,10,356,1780,1350,3845,13,355,1335,1350,4983
154.906,6,15,612,5,0,6043,0,204,10,0,17210,0,408
0.182,1,2,112,2,28,182,28,112,0,0,0,0,0
0.174,6,10,1866,6,649,34,1142,1543,4,159,56,159,323
1769.122,1,62,6572,62,78,29002,78,6572,0,0,0,0,0
8.181,6,2086,1771487,1154,1439,6,1448,1709663,932,776,8,1448,61824
154.196,6,44,14038,22,591,7342,1360,5089,22,619,7334,1360,8949
1772.968,6,180,15480,120,69,14898,69,8940,60,69,30035,69,6540
68.564,6,32,9057,15,149,4897,267,1502,17,687,4277,1781,7555
14.544,6,52,9540,25,164,606,721,2821,27,511,518,1414,6719
21.301,6,3498,3300398,2283,1368,9,1408,3232554,1215,931,17,2801,67844
1793.319,17,180,11520,180,36,10018,36,11520,0,0,0,0,0
0.503,17,3,451,2,39,184,39,134,1,289,0,289,317
1792.065,6,356,22589,207,69,8699,69,12420,149,69,12107,69,10169
1740.682,6,93,6763,60,31,29503,31,4074,33,31,54394,31,2689
0.001,17,2,124,1,34,0,34,62,1,34,0,34,62
1782.314,17,83,3480,82,14,22003,14,3444,1,8,0,8,36
65.786,6,22,8019,11,525,88,1237,2048,11,919,6560,1591,5971
1685.93,17,12,498,11,14,168593,14,462,1,8,0,8,36
0.013,6,12,3940,7,88,2,88,388,5,3340,3,3340,3552
700.363,6,78,11893,39,135,18430,722,5033,39,301,18425,2026,6860
0.395,6,52,21697,29,958,14,1380,16523,23,421,16,1923,5174
1.214,17,2,144,1,36,0,36,64,1,52,0,52,80
72.632,6,23,10128,12,549,61,1360,2709,11,1393,7249,3934,7419
56.194,6,483,213236,247,806,228,1152,198632,236,396,238,1152,14604
1661.011,1,7,392,7,28,276835,28,392,0,0,0,0,0
1.764,17,20,5180,20,231,92,388,5180,0,0,0,0,0
0.442,6,22,7255,12,318,38,600,1906,10,803,46,1448,5349
5.043,17,4,288,2,36,4992,36,128,2,52,5026,52,160
1789.841,6,359,22709,209,69,8605,69,12569,150,69,12012,69,10140
21.273,6,2676,2468076,1670,1397,12,1448,2411076,1006,776,20,1448,57000
24.6,17,4,1344,4,308,8200,308,1344,0,0,0,0,0
0.602,6,15,1785,8,288,60,288,640,7,426,71,434,1145
11.075,6,18,4266,10,275,1230,275,958,8,992,888,1440,3308
152.386,17,8,2888,8,333,21769,548,2888,0,0,0,0,0
11.721,6,1728,1613842,1139,1365,10,1432,1585991,589,427,19,1432,27851
230.797,6,58,13507,30,364,7958,1302,5946,28,378,8544,1452,7561
57.945,6,15,2391,7,188,9657,245,660,8,1407,8240,1407,1731
0.523,17,3,451,2,39,396,39,134,1,289,0,289,317
0.491,6,99,63400,55,1252,9,1432,57349,44,427,10,1432,6051
1787.017,6,106,8504,70,64,25898,64,4976,36,58,51055,58,3528
0.264,6,43,29327,24,243,11,444,2042,19,1752,13,4975,27285
0.844,6,20,5952,11,282,84,548,1292,9,716,95,1420,4660
1788.152,1,232,12992,232,28,7740,28,12992,0,0,0,0,0
1796.917,6,252,25528,103,67,17616,659,9546,149,135,12139,2720,15982
285.716,17,4,240,2,32,285715,32,120,2,32,285715,32,120
1770.968,6,100,9358,66,66,27245,66,5610,34,60,53662,60,3748
2.945,6,67,26937,36,1048,84,1460,20385,31,350,89,1460,6552
100.463,6,21,4393,10,241,11162,722,1480,11,465,10018,1408,2913
71.955,6,23,8267,12,234,50,391,1216,11,942,7183,2720,7051
1770.93,6,99,9240,66,65,27245,65,5577,33,59,55338,59,3663
10.827,6,1717,1496554,1039,1387,10,1420,1465213,678,467,15,1883,31341
1.573,6,50,19436,29,895,56,1360,13775,21,437,67,2715,5661
36.746,1,8,848,8,78,5249,78,848,0,0,0,0,0
2.582,17,20,13581,11,973,258,1350,11020,9,256,193,1350,2561
1786.456,6,102,8296,68,65,26663,65,4930,34,59,54132,59,3366
2.565,6,25,8056,12,164,196,267,1288,13,869,180,1448,6768
300.228,6,29,11715,17,592,18764,1408,4444,12,1327,21835,4224,7271
301.385,6,43,8799,22,218,14351,619,2028,21,394,453,1440,6771
1780.131,17,138,11040,69,48,26178,48,5244,69,56,26178,56,5796
0.015,17,2,554,1,30,0,30,58,1,468,0,468,496
1773.246,6,180,15480,120,69,14901,69,8940,60,69,30046,69,6540
265.14,6,331,267539,202,1352,1319,1448,247218,129,566,2069,1448,20321
1778.168,6,126,12421,78,62,23093,722,6423,48,87,37827,1408,5998
4.301,6,40,7309,19,218,238,314,3383,21,440,202,1152,3926
1797.787,6,195,19046,126,99,14382,469,11525,69,69,26433,69,7521
1796.94,17,449,39928,404,35,4458,288,25708,45,288,40024,288,14220
18.671,17,35,11045,17,401,1165,1350,7305,18,179,1096,1350,3740
1771.858,17,208,52833,208,226,8559,422,52833,0,0,0,0,0
0.06,6,12,3462,6,75,12,75,395,6,1373,12,1448,3067
20.471,17,34,21717,13,549,1703,1350,7511,21,648,1022,1350,14206
1787.199,6,102,8228,68,64,26674,64,4896,34,58,54155,58,3332
0.013,17,2,184,1,32,0,32,60,1,96,0,96,124
277.003,1,2,112,2,28,277003,28,112,0,0,0,0,0
1781.318,1,204,21624,204,78,8774,78,21624,0,0,0,0,0
164.905,6,30,8872,14,158,12685,267,1357,16,763,10989,2045,7515
0.012,17,4,352,2,60,11,60,176,2,60,9,60,176
225.218,17,10,585,10,30,25024,31,585,0,0,0,0,0
1786.452,6,363,23007,210,69,8547,69,12678,153,69,11751,69,10329
1740.892,17,22,23188,22,1026,82899,1026,23188,0,0,0,0,0
0.398,17,2,166,1,39,0,39,67,1,71,0,71,99
34.918,17,20,1760,10,48,3878,48,760,10,72,3878,72,1000
280.221,6,28,7352,13,158,23351,267,1317,15,678,20011,3436,6035
596.544,6,36,2926,23,52,23035,205,1776,13,36,49696,98,1150
1.135,17,23,8096,11,451,112,1350,5272,12,207,99,1350,2824
254.38,6,13,762,5,112,63592,112,320,8,90,36338,90,442
1620.519,1,14,784,14,28,124655,28,784,0,0,0,0,0
344.529,1,4,224,4,28,114843,28,224,0,0,0,0,0
1787.342,6,102,8364,68,66,26676,66,4964,34,60,54158,60,3400
0.782,17,2,136,1,32,0,32,60,1,48,0,48,76
1799.257,17,141,11284,70,48,25714,48,5320,71,56,25703,56,5964
0.007,6,3,127,1,0,0,0,40,2,7,0,7,87
1.043,6,30,13320,17,511,65,1360,3279,13,1056,70,2720,10041
1772.823,6,180,15480,120,69,14897,69,8940,60,69,30040,69,6540
216.889,17,4,352,2,60,216888,60,176,2,60,216888,60,176
1564.195,2,17,544,17,8,97762,8,544,0,0,0,0,0
1783.986,6,416,24920,208,69,8618,69,12460,208,34,8618,48,12460
33.73,6,28,4879,14,170,2594,722,1748,14,399,2581,1408,3131
1791.446,17,142,11360,71,48,25591,48,5396,71,56,25591,56,5964
1796.036,17,763,46018,763,32,2357,37,46018,0,0,0,0,0
0.452,6,27,8955,13,234,37,575,1620,14,942,34,1408,7335
1.38,6,25,9552,14,350,106,1041,1992,11,1015,112,1460,7560
5.042,6,12,2271,7,188,840,245,660,5,1407,1196,1407,1611
1770.509,6,99,9174,66,64,27238,64,5544,33,58,55325,58,3630
13.972,6,5,260,5,0,0,0,260,0,0,0,0,0
200.172,6,68,26027,40,398,5132,1448,9278,28,763,1425,1448,16749
0.121,6,10,1671,6,552,24,948,1348,4,159,40,159,323
3.133,6,41,22674,24,776,136,1360,6513,17,1933,186,7482,16161
1.167,6,52,16954,32,366,37,1360,9001,20,793,51,4649,7953
0.365,6,23,7291,12,257,33,745,1660,11,841,35,1418,5631
0.522,17,3,451,2,39,393,39,134,1,289,0,289,317
0.331,6,27,9069,13,261,27,683,1728,14,943,25,1408,7341
1742.616,17,236,55747,236,208,7415,462,55747,0,0,0,0,0
1772.469,6,180,15480,120,69,14894,69,8940,60,69,30040,69,6540
1786.489,6,171,25640,100,254,18045,1294,16726,71,121,25519,362,8914
69.543,6,31,7406,14,155,5349,267,1346,17,413,4345,1420,6060
17.11,6,2943,2721239,1876,1371,9,1408,2661091,1067,776,15,1408,60148
85.151,6,24,10016,12,665,75,1360,3174,12,1058,7725,2235,6842
14.683,6,2462,2312101,1595,1372,9,1408,2262353,867,776,16,1408,49748
1.151,6,25,8056,12,164,89,267,1288,13,869,81,1448,6768
4.021,17,5,337,4,33,1333,33,244,1,65,0,65,93
31.076,6,2,120,2,0,0,0,120,0,0,0,0,0
296.637,17,15,4976,15,303,21188,308,4976,0,0,0,0,0
61.327,6,37,15881,22,795,2920,1448,9103,15,665,4362,1448,6778
1633.539,1,8,448,8,28,233362,28,448,0,0,0,0,0
563.047,1,4,506,4,98,187682,105,506,0,0,0,0,0
198.225,17,4,352,2,60,198224,60,176,2,60,198223,60,176
280.436,6,29,7392,13,158,23369,267,1317,16,603,18690,1400,6075
1772.141,6,180,15480,120,69,14891,69,8940,60,69,30034,69,6540
1799.325,1,345,28980,345,56,5230,56,28980,0,0,0,0,0
3.473,17,5,295,5,31,868,31,295,0,0,0,0,0
251.96,2,2,64,2,8,251960,8,64,0,0,0,0,0
0.626,6,10,1116,6,180,125,180,680,4,110,148,110,436
1.377,6,39,9888,21,440,68,1360,4392,18,529,68,4075,5496
14.283,6,30,7432,13,158,1190,267,1317,17,603,889,2076,6115
1797.465,6,367,25650,214,99,8438,469,15045,153,69,11823,69,10605
0.479,6,20,7165,12,318,43,599,1905,8,1209,67,1906,5260
1773.722,1,58,4872,0,0,0,0,0,58,56,31117,56,4872
11.91,6,1882,1646038,1142,1387,10,1420,1612193,740,467,16,1883,33845
69.576,6,36,8479,18,410,518,882,2006,18,478,4083,2128,6473
23.577,6,12,1157,4,517,7856,517,745,8,0,3367,0,412
5.067,6,9,527,5,43,1266,43,311,4,0,1686,0,216
71.757,1,4,224,4,28,23919,28,224,0,0,0,0,0
0.026,6,2,92,1,0,0,0,40,1,0,0,0,52
280.553,6,30,7432,13,158,23379,267,1317,17,543,17532,1400,6115
25.746,6,2039,1923074,1262,1441,20,1448,1874388,777,899,32,1448,48686
796.186,6,11,657,8,31,113740,31,444,3,31,299559,31,213
301.164,6,30,7432,13,158,25097,267,1317,17,543,18820,1400,6115
1471.159,6,174,11974,64,46,23351,46,5044,110,46,13496,46,6930
0.005,17,2,631,1,34,0,34,62,1,541,0,541,569
0.032,17,2,144,1,36,0,36,64,1,52,0,52,80
0.566,6,26,7256,13,155,47,267,1301,13,678,26,3436,5955
0.354,6,30,16938,15,129,25,129,917,15,1269,25,1448,16021
5.387,6,9,1359,4,290,1795,722,1068,5,7,1291,7,291
0.039,17,4,624,2,36,29,36,128,2,220,31,292,496
33.558,6,30,5100,15,180,2397,722,1871,15,349,2382,2026,3229
1786.678,6,104,8444,68,66,26666,66,4964,36,60,51045,60,3480
1752.497,1,73,6132,0,0,0,0,0,73,56,24340,56,6132
1793.132,6,100,7525,65,38,28017,205,4611,35,33,52730,98,2914
1795.724,6,376,26217,217,98,8313,469,15372,159,69,11363,69,10845
60.528,6,33,10272,19,138,3362,174,1316,14,839,2753,1452,8956
149.76,6,33,2075,12,69,11186,69,687,21,42,7488,64,1388
1783.813,6,372,23574,213,69,8414,69,13005,159,69,11289,69,10569
108.799,6,47,10807,23,773,922,1360,4890,24,309,4722,2667,5917
368.84,6,18,1239,14,177,28372,177,913,4,110,20057,110,326
34.646,17,4,240,2,32,34645,32,120,2,32,34645,32,120
122.577,6,25,10089,12,531,55,1360,2637,13,988,10203,1360,7452
240.197,6,54,18925,29,807,8578,1402,16058,25,194,10007,580,2867
0.242,17,2,2754,2,1349,242,1349,2754,0,0,0,0,0
920.288,6,106,7276,39,46,24218,46,3078,67,46,13940,46,4198
1772.524,6,180,15480,120,69,14895,69,8940,60,69,30034,69,6540
0.51,17,3,451,2,39,437,39,134,1,289,0,289,317
1770.372,6,103,9514,66,66,27236,66,5610,37,60,49174,60,3904
0.012,17,2,912,1,308,0,308,336,1,548,0,548,576
1682.715,17,14,1036,7,30,280445,30,406,7,62,280439,62,630
1790.445,6,366,23196,212,69,8485,69,12896,154,69,11702,69,10300
1794.355,6,356,22520,208,69,8668,69,12460,148,69,12206,69,10060
31.494,6,7,336,1,0,0,0,48,6,0,6297,0,288
1794.265,17,66,2766,65,14,28035,14,2730,1,8,0,8,36
1.851,2,3,96,3,8,925,8,96,0,0,0,0,0
388.768,6,18,1242,14,180,29905,180,916,4,110,20075,110,326
1787.202,6,365,25432,213,100,8430,469,14936,152,69,11832,69,10496
1613.141,6,24,3624,16,241,107542,241,2568,8,92,230389,92,1056
73.327,17,20,1760,10,48,8146,48,760,10,72,8146,72,1000
50.242,6,505,231308,261,815,193,1152,216043,244,423,205,1179,15265
1786.89,6,102,8364,68,66,26670,66,4964,34,60,54145,60,3400
0.195,6,2,96,1,0,0,0,40,1,16,0,16,56
6.998,17,3,433,2,37,5006,37,130,1,275,0,275,303
1764.185,1,58,4872,58,56,30950,56,4872,0,0,0,0,0
712.206,6,63,7587,36,88,20343,721,3379,27,174,27385,1448,4208
251.742,2,3,96,3,8,125871,8,96,0,0,0,0,0
1.371,6,49,20078,27,950,52,1440,14422,22,433,56,1440,5656
1743.338,6,95,7203,63,38,28118,205,4476,32,33,56223,98,2727
1.224,6,212,160146,122,1327,10,1432,152243,90,427,13,1432,7903
0.007,17,2,197,1,33,0,33,61,1,108,0,108,136
0.098,17,4,420,2,33,1,33,122,2,121,48,145,298
1071.521,17,210,15960,210,48,5126,48,15960,0,0,0,0,0
0.145,17,4,588,2,48,124,48,152,2,190,127,308,436
280.435,6,27,7312,12,158,25494,267,1277,15,775,20027,3465,6035
1791.886,17,48,16128,48,308,38125,308,16128,0,0,0,0,0
0.409,6,6,324,4,0,136,0,216,2,0,229,0,108
1740.444,17,29,6815,29,207,62158,207,6815,0,0,0,0,0
1788.978,17,315,80100,315,226,5697,422,80100,0,0,0,0,0
121.226,6,14,3503,7,125,20204,245,660,7,1279,20161,1407,2843
0.367,1,2,112,2,28,367,28,112,0,0,0,0,0
178.589,17,4,240,2,32,178588,32,120,2,32,178588,32,120
621.074,6,134,16462,59,145,8120,1189,5706,75,180,8392,1420,10756
280.436,6,30,7432,13,158,23369,267,1317,17,543,17517,1400,6115
2.094,6,11,892,7,182,349,182,542,4,134,610,134,350
2.626,6,38,11774,17,207,157,561,2209,21,867,122,1440,9565
0.0,6,1,109,1,69,0,69,109,0,0,0,0,0
0.014,6,2,1532,1,1452,0,1452,1492,1,0,0,0,40
1643.745,1,8,448,8,28,234820,28,448,0,0,0,0,0
121.941,17,3,192,3,36,60970,36,192,0,0,0,0,0
300.21,6,43,13279,23,840,13638,1360,7677,20,399,15791,1360,5602
1.378,6,53,21119,30,942,47,1460,15378,23,400,54,1460,5741
1785.835,6,104,8494,68,65,26654,65,4930,36,59,51021,59,3564
1799.585,6,369,25799,216,99,8370,469,15194,153,69,11839,69,10605
296.083,6,36,8086,13,158,24673,267,1317,23,365,13457,1400,6769
3.42,17,5,295,5,31,855,31,295,0,0,0,0,0
300.811,2,5,160,5,8,75202,8,160,0,0,0,0,0
1789.354,17,144,11520,72,48,25201,48,5472,72,56,25201,56,6048
0.028,6,3,120,2,0,28,0,80,1,0,0,0,40
300.586,6,38,8566,20,315,15820,882,2093,18,441,496,1460,6473
9.968,6,82,24837,40,561,255,1152,19016,42,413,237,1152,5821
1.378,6,39,8298,19,321,76,1168,2722,20,433,63,1440,5576
0.488,6,25,4635,12,165,44,456,1446,13,415,37,888,3189
45.39,6,49,9949,26,395,1815,872,2331,23,393,465,1928,7618
372.098,6,21,1422,15,180,26578,180,992,6,110,12271,110,430
1797.286,17,448,39896,403,35,4470,288,25676,45,288,40017,288,14220
20.652,6,21,3182,12,183,1877,517,1561,9,381,2580,499,1621
126.433,6,19,7213,9,357,15804,721,1435,10,895,14003,2840,5778
1773.423,6,180,15480,120,69,14902,69,8940,60,69,30051,69,6540
1786.735,17,87,3648,86,14,21020,14,3612,1,8,0,8,36
1790.242,1,296,31376,296,78,6068,78,31376,0,0,0,0,0
0.732,6,156,101076,81,1292,9,1420,93761,75,427,9,1420,7315
1782.675,6,356,22520,208,69,8611,69,12460,148,69,12126,69,10060
244.923,6,24,7054,11,181,24492,267,1168,13,670,20409,2036,5886
0.065,6,14,4044,8,88,9,88,452,6,1670,12,1880,3592
0.395,17,2,152,1,48,0,48,76,1,48,0,48,76
297.565,1,4,224,4,28,99188,28,224,0,0,0,0,0
0.141,17,2,167,1,39,0,39,67,1,72,0,72,100
6.194,6,22,4426,12,213,563,597,1689,10,552,667,1767,2737
0.043,17,4,240,2,32,42,32,120,2,32,42,32,120
2.239,6,17,4511,10,327,247,634,1836,7,767,370,1328,2675
37.923,1,43,4472,0,0,0,0,0,43,76,902,76,4472
1777.007,17,73,3060,72,14,25028,14,3024,1,8,0,8,36
5.005,17,4,288,2,36,5005,36,128,2,52,4907,52,160
49.489,17,48,12152,22,226,2355,1350,5602,26,223,1978,1350,6550
10.624,6,2125,1961683,1346,1379,7,1408,1916511,779,931,13,2801,45172
361.946,6,18,1242,14,180,27842,180,916,4,110,20053,110,326
1783.676,17,142,11360,71,48,25480,48,5396,71,56,25480,56,5964
2.519,17,4,518,3,39,506,39,201,1,289,0,289,317
117.073,6,36,23931,19,840,40,1360,5835,17,1740,7309,5418,18096
1680.692,1,15,870,15,30,120049,30,870,0,0,0,0,0
1.309,6,52,21325,29,902,46,1360,15629,23,476,51,2715,5696
299.646,17,6,528,3,60,149822,60,264,3,60,149822,60,264
0.82,17,2,136,1,32,0,32,60,1,48,0,48,76
1786.502,6,102,8296,68,65,26664,65,4930,34,59,54133,59,3366
1782.624,6,366,23541,208,69,8611,69,12667,158,69,11351,69,10874
1799.71,1,212,11872,212,28,8529,28,11872,0,0,0,0,0
71.219,6,44,9008,22,412,665,889,2220,22,393,3384,4848,6788
1786.884,6,105,8464,69,64,26277,64,4936,36,58,51051,58,3528
10.043,17,4,328,2,46,10038,46,148,2,62,10038,62,180
15.122,17,23,12077,12,742,1371,1350,9242,11,229,1509,1350,2835
481.248,2,6,192,6,8,96249,8,192,0,0,0,0,0
24.492,6,36,8455,18,410,511,882,1982,18,478,1432,2720,6473
86.188,6,26,6066,11,272,79,516,1260,15,350,6149,1452,4806
0.969,17,2,312,2,128,969,128,312,0,0,0,0,0
1.541,17,2,778,2,361,1541,361,778,0,0,0,0,0
1773.291,6,203,22290,130,75,13746,267,10057,73,134,24627,1917,12233
9.976,17,4,4328,4,1054,3325,1072,4328,0,0,0,0,0
1746.773,6,144,17502,82,73,21565,876,7634,62,172,28634,2736,9868
1735.138,6,558,79267,262,201,6647,1440,56624,296,104,5881,1061,22643
1797.022,17,356,56966,356,132,5062,366,56966,0,0,0,0,0
300.606,6,39,8523,20,291,15821,786,2009,19,441,491,1360,6514
1764.178,2,15,480,15,8,126012,8,480,0,0,0,0,0
1797.409,17,350,55433,350,130,5150,391,55433,0,0,0,0,0
280.461,6,28,7352,13,158,23371,267,1317,15,678,20028,3456,6035
1789.233,17,394,48111,176,170,10224,1350,35022,218,32,8244,60,13089
1783.807,17,83,3480,82,14,22022,14,3444,1,8,0,8,36
125.891,2,2,64,2,8,125891,8,64,0,0,0,0,0
0.486,17,4,240,2,32,485,32,120,2,32,485,32,120
0.269,6,21,7290,13,335,21,668,2026,8,1210,37,1906,5264
4.799,6,40,7309,20,218,252,314,3423,20,440,239,1152,3886
0.66,6,27,8920,13,227,55,547,1592,14,941,31,1408,7328
1798.726,6,358,22738,209,69,8647,69,12569,149,69,12153,69,10169
67.173,17,6,2016,6,308,13434,308,2016,0,0,0,0,0
0.106,6,3,127,1,0,0,0,40,2,7,1,7,87
6.411,6,12,1767,6,100,1282,100,344,6,1179,1231,1179,1423
240.607,2,3,96,3,8,120303,8,96,0,0,0,0,0
700.647,6,32,2119,21,332,35032,332,1456,11,83,24046,83,663
1663.194,6,32,5482,22,241,79199,241,4254,10,92,184217,92,1228
34.167,17,10,760,10,48,3796,48,760,0,0,0,0,0
705.342,6,45,2640,26,26,28210,26,1508,19,26,39180,26,1132
18.01,6,2974,2842237,1916,1405,9,1440,2782557,1058,776,16,1440,59680
59.779,6,25,7097,12,155,5434,267,1266,13,589,4980,3426,5831
2.024,17,2,466,1,33,0,33,61,1,377,0,377,405
1683.561,1,15,870,15,30,120254,30,870,0,0,0,0,0
14.705,1,8,448,8,28,2100,28,448,0,0,0,0,0
0.281,17,2,184,1,32,0,32,60,1,96,0,96,124
16.217,6,16,1327,8,222,2314,222,768,8,231,2314,231,559
0.272,17,3,1008,3,308,136,308,1008,0,0,0,0,0
0.486,6,57,25143,33,1010,15,1380,16605,24,630,19,3303,8538
1795.075,6,142,8779,75,27,24257,27,4575,67,27,27197,27,4204
125.974,2,2,64,2,8,125974,8,64,0,0,0,0,0
1786.678,6,106,8456,68,65,26666,65,4930,38,59,48285,59,3526
16.346,17,24,6163,10,257,1804,1350,2851,14,208,1251,1350,3312
61.804,6,75,48916,44,1196,1437,1408,40572,31,960,2052,3847,8344
1746.676,17,122,41020,122,308,14435,322,41020,0,0,0,0,0
3.081,17,6,870,3,40,1524,40,204,3,194,1525,194,666
382.918,17,12,912,12,48,34810,48,912,0,0,0,0,0
8.967,6,15,1287,8,222,1281,222,768,7,231,1492,231,519
1797.728,17,180,14040,180,50,10043,50,14040,0,0,0,0,0
381.103,6,18,1242,14,180,29315,180,916,4,110,20071,110,326
0.136,17,2,312,1,64,0,64,92,1,192,0,192,220
0.012,17,2,154,1,33,0,33,61,1,65,0,65,93
1788.622,6,261,35533,132,142,13651,722,18363,129,272,13971,2760,17170
1.072,6,15,5064,8,290,153,517,1005,7,1226,169,1697,4059
1681.229,1,15,870,15,30,120087,30,870,0,0,0,0,0
5.018,17,4,558,2,36,5005,36,128,2,187,5004,187,430
8.356,6,17,8175,8,275,1193,275,603,9,1440,691,1440,7572
1785.669,6,106,8524,68,66,26651,66,4964,38,60,48258,60,3560
18.882,17,22,12802,13,788,1570,1350,10613,9,215,2356,1350,2189
12.132,17,8,1176,4,48,4036,48,304,4,190,4037,308,872
19.182,17,4,352,2,48,19174,48,152,2,72,19173,72,200
1788.573,6,362,22967,209,69,8598,69,12638,153,69,11766,69,10329
146.211,6,55,10619,25,213,6092,721,3570,30,389,4963,2840,7049
0.256,6,24,6064,12,181,23,537,1526,12,781,22,2224,4538
1.282,6,47,18619,27,852,49,1360,13043,20,476,58,2715,5576
0.024,17,4,398,2,46,17,46,148,2,97,14,103,250
1.539,6,46,19574,27,923,59,1360,14038,19,476,74,2715,5536
5.313,17,2,684,2,314,5313,320,684,0,0,0,0,0
21.742,6,27,7046,16,124,1449,159,1600,11,695,2173,1418,5446
0.537,6,26,8991,13,247,44,624,1672,13,947,36,1438,7319
1798.432,6,374,26537,216,104,8364,469,15663,158,69,11452,69,10874
56.765,17,4,352,2,60,56764,60,176,2,60,56764,60,176
0.162,6,27,7296,13,155,13,267,1301,14,603,11,1400,5995
0.0,17,1,1068,1,1040,0,1040,1068,0,0,0,0,0
1775.18,6,202,22250,129,75,13868,267,10017,73,134,24649,1460,12233
122.292,6,1501,1317702,779,852,157,1390,45928,722,1723,169,6980,1271774
1710.27,17,120,26124,120,189,14372,422,26124,0,0,0,0,0
4.012,17,8,848,4,46,1333,46,296,4,110,1333,110,552
4.989,17,4,288,2,36,4970,36,128,2,52,4971,52,160
1786.617,6,106,8584,69,66,26273,66,5004,37,60,49625,60,3580
6.965,6,14,1029,7,222,1159,222,506,7,231,1159,231,523
1774.86,6,180,15480,120,69,14914,69,8940,60,69,30078,69,6540
0.032,17,4,352,2,37,0,37,130,2,83,0,89,222
52.131,6,39,8661,19,410,683,882,2046,20,414,2736,2720,6615
1.287,6,38,8278,19,321,71,1164,2742,19,433,62,1360,5536
0.393,6,13,1693,7,288,61,288,588,6,426,41,434,1105
1747.306,6,102,7970,66,45,26881,205,4902,36,35,49912,98,3068
1778.458,6,227,23862,86,152,20922,1360,14709,141,50,12703,143,9153
5.654,17,26,7284,10,229,628,1350,2578,16,266,214,1350,4706
26.794,6,43,8884,19,402,611,891,2046,24,345,1158,1460,6838
1.396,6,48,20037,28,887,51,1360,14461,20,476,63,2715,5576
290.702,17,2,128,2,36,290702,36,128,0,0,0,0,0
0.086,1,2,112,2,28,86,28,112,0,0,0,0,0
1.373,6,48,18886,27,868,52,1360,13270,21,476,59,2715,5616
0.903,6,10,1687,7,100,150,100,384,3,1179,330,1179,1303
0.889,6,10,1687,7,100,148,100,384,3,1179,316,1179,1303
1782.465,17,83,3480,82,14,22005,14,3444,1,8,0,8,36
48.595,6,6503,6309974,4358,1371,11,1408,6193746,2145,931,22,2816,116228
0.403,6,26,8870,13,232,33,567,1612,13,939,32,1448,7258
0.035,17,2,456,1,60,0,60,88,1,340,0,340,368
0.166,6,27,7296,13,155,13,267,1301,14,603,11,2036,5995
1798.253,17,760,45844,760,32,2369,37,45844,0,0,0,0,0
240.198,6,54,17670,29,775,8578,1418,14694,25,208,10007,580,2976
1772.757,6,180,15480,120,69,14897,69,8940,60,69,30042,69,6540
1795.812,17,447,39864,402,35,4478,288,25644,45,288,40020,288,14220
0.226,6,23,5994,12,181,20,537,1526,11,777,20,2206,4468
12.432,6,1810,1648928,1160,1369,10,1380,1617598,650,421,19,1923,31330
24.824,17,37,9335,16,263,1653,1350,4656,21,194,1239,1350,4679
661.816,2,8,256,8,8,94545,8,256,0,0,0,0,0
15.186,17,17,10866,10,838,1681,1350,8660,7,287,2524,1350,2206
11.582,6,20,6053,10,290,1286,517,1109,10,1102,1283,1418,4944
0.2,17,2,412,1,33,0,33,61,1,323,0,323,351
1765.55,6,344,25754,170,153,10426,515,10098,174,39,10205,240,15656
15.27,6,11,5579,4,106,5090,106,274,7,1003,2517,1917,5305
1770.772,6,134,11871,83,73,21594,205,7198,51,43,35408,98,4673
410.615,6,58,11200,23,222,18663,1189,3378,35,278,12076,1420,7822
6.384,6,39,7269,20,218,336,314,3423,19,440,340,1152,3846
11.639,17,8,704,4,48,3874,48,304,4,72,3873,72,400
1684.434,2,19,608,19,8,93579,8,608,0,0,0,0,0
9.855,6,1532,1361212,926,1419,10,1432,1332751,606,467,16,1871,28461
1.302,6,53,22040,29,944,46,1360,16304,24,433,49,1360,5736
0.013,6,11,3285,6,80,2,80,400,5,872,3,1448,2885
1774.119,6,124,7556,68,26,26478,27,4075,56,26,32256,27,3481
1784.168,6,102,8296,68,65,26629,65,4930,34,59,54062,59,3366
18.083,17,4,352,2,48,18073,48,152,2,72,18068,72,200
23.118,6,11,2150,5,222,5779,222,442,6,728,4588,1360,1708
302.994,6,8,506,8,31,43284,31,506,0,0,0,0,0
1786.741,6,104,8376,68,65,26667,65,4930,36,59,51047,59,3446
1788.228,6,360,22887,210,69,8556,69,12747,150,69,12001,69,10140
0.007,17,2,611,1,46,0,46,74,1,509,0,509,537
541.612,1,3,168,3,28,270806,28,168,0,0,0,0,0
7.57,6,1291,1157981,790,1387,9,1408,1127241,501,931,14,2816,30740
0.017,6,10,1729,5,102,4,102,370,5,545,4,990,1359
0.06,6,9,1002,5,213,15,213,417,4,421,14,421,585
300.71,6,36,8368,19,286,16706,797,1936,17,521,532,3488,6432
82.466,6,33,7762,13,155,6872,267,1306,20,376,4339,3417,6456
11.061,6,19,4186,10,275,1229,275,958,9,952,780,1380,3228
1782.618,6,353,22400,206,69,8695,69,12380,147,69,12209,69,10020
1.539,17,2,292,1,53,0,53,81,1,183,0,183,211
32.493,6,631,717330,299,254,109,398,21174,332,2069,97,14080,696156
1.608,6,23,5482,13,125,133,212,1026,10,810,177,2840,4456
1748.116,6,95,7203,63,38,28195,205,4476,32,33,56380,98,2727
1756.267,6,4720,4511987,1651,153,1064,956,105023,3069,1418,572,5672,4406964
7.425,6,5,220,1,0,0,0,44,4,0,2387,0,176
1796.121,1,122,6832,122,28,14843,28,6832,0,0,0,0,0
0.042,17,4,368,2,32,19,32,120,2,96,0,96,248
661.413,17,50,3984,27,48,25438,48,2052,23,56,25452,56,1932
1765.167,2,15,480,15,8,126083,8,480,0,0,0,0,0
1.024,6,118,86774,51,131,20,232,2569,67,1405,13,2840,84205
173.059,17,4,240,2,32,173058,32,120,2,32,173058,32,120
1.577,6,25,8771,15,286,112,591,1463,10,986,155,1420,7308
0.012,17,2,337,1,40,0,40,68,1,241,0,241,269
0.012,17,2,279,1,36,0,36,64,1,187,0,187,215
2.723,6,13,2311,8,188,389,245,700,5,1407,565,1407,1611
481.306,2,5,160,5,8,120326,8,160,0,0,0,0,0
1797.906,17,447,39580,403,35,4472,288,25676,44,288,40950,288,13904
228.437,6,22,1545,16,43,15229,43,1185,6,0,45029,0,360
1.712,6,29,5964,16,111,114,267,1539,13,780,125,1460,4425
1.468,6,38,8252,19,320,81,1162,2716,19,476,70,2720,5536
0.183,17,2,1922,2,933,183,933,1922,0,0,0,0,0
0.705,6,18,6907,9,138,88,138,752,9,1134,88,1448,6155
0.412,6,50,21279,27,1071,15,1380,16117,23,383,16,1380,5162
230.263,6,6114,5674157,3702,743,62,1396,217399,2412,2219,66,8376,5456758
0.581,17,4,288,2,36,533,36,128,2,52,537,52,160
300.66,6,37,8655,20,336,15824,999,2190,17,481,530,2720,6465
22.994,6,30,7425,16,411,1532,411,1263,14,897,1703,1448,6162
3.231,17,5,295,5,31,807,31,295,0,0,0,0,0
50.233,6,97,62943,55,187,930,517,4018,42,1575,1224,2736,58925
0.028,17,4,288,2,33,21,33,122,2,55,18,61,166
1770.148,6,207,14306,76,46,23600,46,6030,131,46,13616,46,8276
5.008,17,4,558,2,36,5004,36,128,2,187,5001,187,430
33.51,6,10,580,3,0,16755,0,160,7,0,5409,0,420
0.051,17,2,144,1,36,0,36,64,1,52,0,52,80
2.036,6,14,2351,8,188,290,245,700,6,703,354,1152,1651
0.414,6,26,8869,13,232,34,567,1612,13,939,32,1448,7257
1789.474,6,355,22549,207,69,8686,69,12420,148,69,12173,69,10129
1111.558,17,220,16720,220,48,5075,48,16720,0,0,0,0,0
96.945,6,79,56382,51,1198,1938,1368,48189,28,841,2334,2519,8193
2.77,17,27,11673,12,557,251,1350,7027,15,281,123,1350,4646
50.565,6,14,1159,6,332,10113,332,652,8,83,7201,83,507
1797.514,17,448,39896,403,35,4471,288,25676,45,288,40022,288,14220
2.855,6,10,1102,6,483,571,483,803,4,83,949,83,299
58.803,6,11,851,11,31,5880,31,851,0,0,0,0,0
186.597,6,70,11828,32,199,6019,1189,3884,38,305,5041,2077,7944
0.246,17,2,2380,2,1162,246,1162,2380,0,0,0,0,0
1772.283,6,180,15480,120,69,14893,69,8940,60,69,30037,69,6540
161.976,6,37,15512,18,894,79,1460,6141,19,716,8988,1460,9371
240.536,6,26,3568,10,181,26725,595,1618,16,269,16035,580,1950
633.416,6,74545,74357984,25714,488,24,516,1381765,48831,1442,8,2880,72976219
12.756,17,3,984,3,300,6378,300,984,0,0,0,0,0
1.169,6,23,7952,12,164,90,267,1288,11,1216,99,3819,6664
1764.563,2,15,480,15,8,126040,8,480,0,0,0,0,0
1.317,6,9,382,4,0,439,0,164,5,7,241,7,218
123.961,17,4,352,2,60,123960,60,176,2,60,123959,60,176
1799.997,6,212,16732,79,74,23076,362,8138,133,48,13636,78,8594
0.086,17,4,336,2,34,0,34,124,2,78,42,84,212
4.815,6,23,2504,11,222,480,222,1554,12,231,436,231,950
1740.628,17,29,30624,29,1028,62165,1028,30624,0,0,0,0,0
12.165,17,4,352,2,48,12149,48,152,2,72,12149,72,200
0.011,17,2,390,1,46,0,46,74,1,288,0,288,316
37.558,17,42,6292,21,48,1877,48,1596,21,195,1877,308,4696
1744.716,2,30,960,30,8,60162,8,960,0,0,0,0,0
1786.902,6,105,8610,69,66,26277,66,5070,36,60,51051,60,3540
123.259,17,28,5532,14,48,9480,48,1064,14,291,9480,308,4468
194.976,17,4,352,2,60,194975,60,176,2,60,194975,60,176
80.007,6,790,372801,413,834,194,1152,351859,377,418,212,1179,20942
1773.032,17,283,58270,283,177,6287,422,58270,0,0,0,0,0
31.371,6,8,348,2,0,13,0,84,6,0,6272,0,264
1740.768,6,87,6322,58,31,30539,31,3915,29,31,62170,31,2407
11.918,17,3,984,3,300,5959,300,984,0,0,0,0,0
2.791,6,31,18668,19,763,155,1360,6151,12,2004,242,5294,12517
31.581,6,7,308,1,0,0,0,44,6,0,6293,0,264
0.056,17,2,602,1,46,0,46,74,1,500,0,500,528
1715.15,17,113,23707,113,181,15313,422,23707,0,0,0,0,0
123.504,6,36,13778,20,695,108,1360,5036,16,897,8224,2167,8742
1794.653,1,66,5544,66,56,27610,56,5544,0,0,0,0,0
1782.315,17,83,3480,82,14,22003,14,3444,1,8,0,8,36
0.222,6,6,328,4,0,74,0,216,2,0,217,0,112
3.868,6,14,3145,8,49,552,92,511,6,579,46,1408,2634
14.322,6,2624,2469156,1700,1375,8,1408,2416444,924,931,15,2816,52712
1681.178,17,14,3843,7,30,280195,30,406,7,463,280195,463,3437
1782.761,17,142,11464,71,49,25467,136,5484,71,56,25467,72,5980
1.947,17,4,314,2,31,1933,31,118,2,70,1934,70,196
9.7,6,78,24341,39,550,255,1152,18640,39,459,247,1179,5701
8.88,6,11,766,4,106,2960,106,274,7,90,1445,90,492
3.107,6,20,6924,10,185,345,275,961,10,694,237,1414,5963
0.348,6,27,9098,13,261,29,683,1728,14,947,24,2816,7370
1789.953,6,388,27304,220,102,8173,469,16168,168,69,10718,69,11136
5.242,6,42,7389,23,201,238,314,3543,19,513,276,1179,3846
1.231,6,10,1687,7,100,205,100,384,3,1179,487,1179,1303
0.01,6,12,3462,6,75,2,75,395,6,1373,2,1448,3067
278.822,17,6,2016,6,308,55764,308,2016,0,0,0,0,0
1797.077,17,384,47635,180,168,10039,1350,35305,204,32,8852,60,12330
300.644,6,41,8655,21,286,15032,766,2040,20,386,445,1360,6615
1774.258,6,180,15480,120,69,14909,69,8940,60,69,30066,69,6540
1763.686,2,19,608,19,8,97982,8,608,0,0,0,0,0
240.307,6,52,17875,28,795,8899,1418,14985,24,233,10447,580,2890
1741.556,6,87,6322,58,31,30553,31,3915,29,31,62198,31,2407
152.595,17,4,352,2,60,152594,60,176,2,60,152594,60,176
196.976,6,40,8616,14,119,7154,267,1644,26,296,7878,1420,6972
1771.745,1,16,896,16,28,118116,28,896,0,0,0,0,0
0.483,6,24,7489,14,274,37,668,2109,10,968,49,1946,5380
13.491,6,82,26409,41,609,337,1152,21758,41,429,331,1179,4651
0.002,6,4,4510,1,0,0,0,40,3,1438,0,1438,4470
2.943,6,56,14131,27,551,113,1429,4984,29,398,95,1460,9147
0.931,6,51,13813,24,549,40,1429,4824,27,438,35,1460,8989
10.024,6,561,481301,358,1274,27,1368,466081,203,776,48,1473,15220
448.88,17,10,3360,10,308,49875,308,3360,0,0,0,0,0
1796.085,17,447,39864,402,35,4479,288,25644,45,288,40018,288,14220
16.513,2,3,96,3,8,8256,8,96,0,0,0,0,0
239.949,17,4,352,2,60,239948,60,176,2,60,239948,60,176
378.921,6,23,1499,14,177,29147,177,913,9,110,9904,110,586
148.757,6,25,6339,9,272,231,516,1180,16,347,9910,1452,5159
173.161,17,4,1344,4,308,57720,308,1344,0,0,0,0,0
0.19,6,10,1379,5,145,47,145,349,5,826,35,826,1030
0.718,6,81,58542,40,211,18,305,2959,41,1370,14,2880,55583
0.609,6,3,168,1,0,0,0,52,2,0,609,0,116
0.422,6,10,968,5,256,101,256,460,5,304,95,304,508
57.06,1,41,4264,0,0,0,0,0,41,76,1426,76,4264
3.331,17,5,295,5,31,832,31,295,0,0,0,0,0
1798.755,17,772,46624,772,32,2333,37,46624,0,0,0,0,0
1.056,6,42,16068,24,768,45,1188,11232,18,648,57,1346,4836
280.313,6,28,7352,12,158,25483,267,1277,16,603,18679,1400,6075
0.736,6,24,7416,13,325,61,626,1984,11,968,69,1946,5432
169.873,6,41,7515,19,390,9437,1056,4522,22,227,8084,580,2993
1792.937,17,144,11520,72,48,25252,48,5472,72,56,25252,56,6048
240.364,6,59,17987,31,781,8012,1408,14909,28,201,8902,580,3078
1740.482,17,27,6345,27,207,66941,207,6345,0,0,0,0,0
108.887,6,30,7175,16,155,7259,267,1586,14,717,8375,2036,5589
0.037,17,4,352,2,60,36,60,176,2,60,35,60,176
5.841,6,40,7325,20,218,307,314,3423,20,516,293,1179,3902
0.928,6,10,1687,7,100,154,100,384,3,1179,329,1179,1303
89.147,6,10,586,6,31,17795,31,364,4,31,15278,31,222
8.614,6,17,1442,9,275,1076,275,918,8,96,1089,96,524
5.376,6,42,7389,22,218,256,314,3503,20,440,269,1152,3886
1620.044,2,14,448,14,8,124618,8,448,0,0,0,0,0
0.394,6,10,968,5,256,97,256,460,5,304,97,304,508
300.656,6,38,8391,20,271,15824,739,1918,18,478,500,2128,6473
323.374,17,21,7056,21,308,16168,308,7056,0,0,0,0,0
1775.961,17,140,11200,70,48,25738,48,5320,70,56,25737,56,5880
18.636,6,17,4268,8,267,2662,501,1125,9,555,2281,1420,3143
1799.989,6,228,19780,85,77,21428,337,8991,143,70,12674,1062,10789
1774.569,6,180,15480,120,69,14912,69,8940,60,69,30073,69,6540
169.783,6,30,7432,13,158,14148,267,1317,17,543,10605,1400,6115
1.009,17,2,925,1,548,0,548,576,1,321,0,321,349
1788.763,6,272,32430,111,133,16260,1460,15683,161,128,11178,1642,16747
1787.434,6,104,8435,69,65,26285,65,4970,35,59,52567,59,3465
2.0,17,8,688,4,47,664,47,300,4,69,663,75,388
3.682,17,4,1568,4,364,1227,364,1568,0,0,0,0,0
6.308,6,30,8848,13,155,525,267,1306,17,527,393,3417,7542
5.753,6,40,7309,20,218,302,314,3423,20,513,288,1179,3886
0.311,6,22,7354,13,335,25,668,2038,9,968,38,2816,5316
1738.665,1,127,7112,127,28,13798,28,7112,0,0,0,0,0
6.049,6,1547,1438562,982,1388,5,1408,1404518,565,931,10,2801,34044
143.111,17,5,380,5,48,35777,48,380,0,0,0,0,0
31.694,6,7,308,1,0,0,0,44,6,0,6319,0,264
0.172,17,10,3700,10,342,19,360,3700,0,0,0,0,0
0.112,6,9,1339,5,145,28,145,349,4,826,35,826,990
0.408,17,2,193,1,43,0,43,71,1,94,0,94,122
300.673,6,38,8534,20,307,15824,882,2061,18,441,501,1460,6473
7.5,17,6,528,3,48,3740,48,228,3,72,3738,72,300
1743.564,6,95,7203,63,38,28122,205,4476,32,33,56233,98,2727
7.979,6,18,6767,9,275,997,275,643,9,1150,658,1414,6124
8.414,6,32,8952,14,158,647,267,1357,18,624,491,1400,7595
1.566,17,4,928,2,60,1018,60,176,2,348,0,356,752
1.224,6,25,8056,12,164,94,267,1288,13,869,86,1440,6768
1780.719,17,142,11360,71,48,25438,48,5396,71,56,25438,56,5964
1796.747,17,448,39896,403,35,4469,288,25676,45,288,40022,288,14220
0.187,1,2,112,2,28,187,28,112,0,0,0,0,0
5.44,6,39,7269,21,218,272,314,3463,18,513,304,1179,3806
1684.498,2,26,832,26,8,67379,8,832,0,0,0,0,0
1.484,6,38,8346,19,336,82,1256,2810,19,433,71,1360,5536
0.483,6,58,25058,33,1026,15,1380,17848,25,515,18,1923,7210
22.884,17,44,8212,19,132,1269,1350,3054,25,178,952,1350,5158
1799.409,17,449,39928,404,35,4465,288,25708,45,288,40024,288,14220
239.372,6,211,168155,136,1304,1773,1408,151931,75,615,3022,2816,16224
1.696,6,13,2311,8,188,242,245,700,5,1407,358,1407,1611
0.003,6,2,583,1,0,0,0,40,1,503,0,503,543
1685.528,17,12,498,11,14,168552,14,462,1,8,0,8,36
161.103,17,4,558,2,36,161099,36,128,2,187,161099,187,430
0.0,17,1,1312,1,1284,0,1284,1312,0,0,0,0,0
1743.298,6,95,7203,63,38,28117,205,4476,32,33,56224,98,2727
1741.11,6,87,6322,58,31,30545,31,3915,29,31,62182,31,2407
481.323,2,6,192,6,8,96264,8,192,0,0,0,0,0
2.244,1,2,705,2,324,2244,327,705,0,0,0,0,0
1795.696,6,124,8077,73,52,24940,208,5107,51,31,35909,31,2970
105.485,17,4,352,2,60,105484,60,176,2,60,105483,60,176
20.187,17,36,17119,17,585,1259,1350,10425,19,324,1119,1350,6694
300.395,6,31,11819,17,590,18774,1368,4445,14,948,18496,2736,7374
7.985,6,93,63466,53,1234,153,1368,55876,40,770,199,1368,7590
22.831,6,17,2353,9,326,2853,589,1129,8,396,3258,580,1224
1.344,1,2,112,2,28,1344,28,112,0,0,0,0,0
1740.638,17,30,31170,30,1011,60022,1011,31170,0,0,0,0,0
172.721,2,2,64,2,8,172721,8,64,0,0,0,0,0
0.422,6,28,7048,17,244,26,656,2394,11,701,41,1728,4654
240.218,6,53,17975,28,807,8896,1418,15192,25,184,10008,580,2783
300.802,6,37,8231,20,241,15831,619,1797,17,478,540,2920,6434
1786.231,17,140,11200,70,48,25887,48,5320,70,56,25887,56,5880
0.239,6,5,284,1,0,0,0,52,4,0,79,0,232
1786.392,6,105,8544,68,66,26662,66,4964,37,60,49619,60,3580
8.584,6,1758,1637857,1124,1380,7,1408,1600225,634,931,13,2816,37632
0.747,6,37,8374,19,277,41,763,1901,18,441,36,1360,6473
0.278,6,28,7336,13,155,23,267,1301,15,543,19,1400,6035
0.281,6,26,9038,13,262,23,690,1735,13,1103,22,2816,7303
0.01,17,2,425,1,48,0,48,76,1,321,0,321,349
69.527,6,29,7326,13,155,5793,267,1306,16,447,4634,2840,6020
365.178,6,24,2125,17,177,22823,177,1423,7,110,10214,110,702
1799.719,17,140,11200,70,48,26082,48,5320,70,56,26082,56,5880
1779.337,1,65,5460,65,56,27802,56,5460,0,0,0,0,0
1799.275,6,127,8405,73,56,24989,208,5284,54,31,33941,31,3121
1670.353,1,7,392,7,28,278392,28,392,0,0,0,0,0
4.08,6,39,7285,20,218,214,314,3423,19,516,213,1179,3862
478.954,6,25,1288,13,0,39905,0,676,12,0,43534,0,612
0.421,6,50,22239,27,1064,16,1380,17077,23,421,16,2760,5162
1794.001,17,144,11520,72,48,25267,48,5472,72,56,25267,56,6048
1797.13,1,284,15904,284,28,6350,28,15904,0,0,0,0,0
1795.148,17,447,39864,402,35,4476,288,25644,45,288,40017,288,14220
1762.424,17,412,113909,412,248,4288,422,113909,0,0,0,0,0
86.672,6,21,8530,11,333,71,692,1473,10,1107,9614,2408,7057
280.247,6,28,7352,13,158,23353,267,1317,15,678,20010,3436,6035
0.374,6,8,335,4,0,124,0,164,4,7,60,7,171
8.1,17,3,228,3,48,4050,48,228,0,0,0,0,0
1.539,6,12,1304,6,256,305,256,756,6,304,305,304,548
11.228,6,27,11355,13,275,935,275,1078,14,1078,833,1414,10277
5.248,17,4,352,2,60,5247,60,176,2,60,5247,60,176
1787.021,6,106,8456,68,65,26671,65,4930,38,59,48294,59,3526
8.634,6,16,6055,5,186,2152,267,581,11,718,862,1420,5474
0.341,17,2,213,1,44,0,44,72,1,113,0,113,141
1767.438,17,44,14784,44,308,41103,308,14784,0,0,0,0,0
410.356,17,8,2688,8,308,58622,308,2688,0,0,0,0,0
24.197,6,38,8535,18,410,509,882,1982,20,441,1266,1440,6553
1683.571,17,114,9120,57,48,30063,48,4332,57,56,30063,56,4788
9.046,17,65,53048,27,529,347,1350,15049,38,971,204,1350,37999
1700.641,17,12,498,11,14,170064,14,462,1,8,0,8,36
43.534,6,30,7432,13,158,3627,267,1317,17,543,2714,1400,6115
0.824,6,25,5847,13,156,68,267,1462,12,780,68,1460,4385
0.005,17,2,321,1,40,0,40,68,1,225,0,225,253
270.847,17,4,352,2,60,270846,60,176,2,60,270846,60,176
1699.191,1,8,848,8,78,242741,78,848,0,0,0,0,0
1797.967,17,750,45439,750,32,2400,37,45439,0,0,0,0,0
0.869,17,2,167,1,39,0,39,67,1,72,0,72,100
61.65,6,56,35616,35,1128,1813,1448,27773,21,842,3070,2359,7843
0.108,6,9,1346,5,145,27,145,349,4,833,30,833,997
0.012,17,2,384,1,32,0,32,60,1,296,0,296,324
3.758,6,2,88,2,0,0,0,88,0,0,0,0,0
1749.246,6,186,11385,93,47,19013,208,6766,93,31,19010,31,4619
1797.53,17,448,39896,403,35,4471,288,25676,45,288,40024,288,14220
1792.185,17,180,14040,180,50,10012,50,14040,0,0,0,0,0
0.049,17,2,164,1,46,0,46,74,1,62,0,62,90
1789.354,6,164,20995,96,302,18835,302,14688,68,83,26706,83,6307
1771.186,6,107,9932,68,66,26435,66,5792,39,60,46607,60,4140
1.344,6,37,8214,19,321,74,1164,2718,18,476,67,2715,5496
125.67,6,34,7935,12,155,28,267,1266,22,340,5983,3417,6669
1775.978,6,181,15589,120,69,14924,69,8940,61,69,29593,69,6649
300.971,6,43,9783,23,366,13680,766,2808,20,410,461,3488,6975
1786.751,6,102,8364,68,66,26667,66,4964,34,60,54140,60,3400
1772.176,6,180,15480,120,69,14892,69,8940,60,69,30036,69,6540
1638.669,1,8,448,8,28,234095,28,448,0,0,0,0,0
353.689,1,5,280,5,28,88422,28,280,0,0,0,0,0
4.217,17,5,290,5,30,1054,30,290,0,0,0,0,0
421.079,6,29,2385,17,177,26317,177,1423,12,110,11082,110,962
0.392,17,2,778,2,361,392,361,778,0,0,0,0,0
1798.227,17,449,39928,404,35,4462,288,25708,45,288,40016,288,14220
231.224,6,764,653839,506,1312,457,1360,635969,258,215,95,2667,17870
0.674,6,115,87372,51,131,13,232,2569,64,1393,10,2860,84803
1.453,6,3,168,1,0,0,0,52,2,0,1103,0,116
11.016,6,20,4402,11,275,1101,275,998,9,758,814,1420,3404
280.401,6,28,7352,13,158,23366,267,1317,15,603,20025,2236,6035
0.019,6,10,1794,6,613,3,1070,1471,4,159,6,159,323
18.258,1,18,1872,0,0,0,0,0,18,76,1074,76,1872
504.344,2,5,160,5,8,126086,8,160,0,0,0,0,0
8.066,6,29,12059,14,275,620,275,1114,15,861,392,1440,10945
9.041,6,17,6655,9,275,1130,275,643,8,1420,1258,1420,6012
1745.386,6,97,7307,63,38,28151,205,4476,34,33,52882,98,2831
1799.875,17,450,39960,405,35,4455,288,25740,45,288,40015,288,14220
23.791,6,283,234228,168,1338,141,1368,222851,115,780,206,2736,11377
3.671,17,2,204,1,34,0,34,62,1,114,0,114,142
1786.951,6,108,8724,70,66,25897,66,5044,38,60,48291,60,3680
25.259,6,3811,3460457,2268,1434,11,1448,3362193,1543,776,16,1448,98264
1796.954,17,449,39928,404,35,4458,288,25708,45,288,40021,288,14220
1744.645,2,25,800,25,8,72693,8,800,0,0,0,0,0
11.743,6,1736,1613053,1142,1363,10,1380,1585051,594,421,19,1923,28002
1776.795,6,366,80077,167,379,10702,1360,56062,199,176,8973,1360,24015
10.732,6,1711,1483504,1032,1384,10,1420,1452123,679,526,15,3303,31381
1781.319,6,363,24414,211,88,8482,469,13987,152,69,11796,69,10427
1.375,6,53,22045,30,1004,47,1440,16304,23,400,54,1440,5741
0.294,17,4,352,2,60,293,60,176,2,60,293,60,176
1788.898,17,87,3648,86,14,21045,14,3612,1,8,0,8,36
3.365,17,5,340,5,40,841,40,340,0,0,0,0,0
2.388,6,22,3473,12,162,217,293,1458,10,537,235,1179,2015
1583.002,6,210,18392,79,82,19910,339,8369,131,72,12176,1062,10023
17.984,17,36,11218,15,274,1282,1350,4535,21,290,897,1350,6683
1.161,17,2,176,1,36,0,36,64,1,84,0,84,112
0.308,17,2,198,1,39,0,39,67,1,103,0,103,131
0.482,6,10,968,5,256,117,256,460,5,304,117,304,508
1798.018,17,448,39896,403,35,4472,288,25676,45,288,40018,288,14220
29.894,6,23,4619,11,204,2989,722,1591,12,400,2677,1408,3028
15.126,6,2471,2300529,1592,1366,9,1408,2250157,879,776,17,1408,50372
1792.59,17,87,3648,86,14,21089,14,3612,1,8,0,8,36
290.851,6,38,8662,14,168,12614,516,1575,24,360,12641,1452,7087
15.53,17,18,7720,9,548,1928,1350,5191,9,253,1932,1350,2529
4.084,6,52,18873,23,886,185,1440,12511,29,321,139,1440,6362
29.51,6,26,14450,10,134,3278,147,808,16,999,1958,1581,13642
1788.29,6,103,6843,64,51,28385,208,4322,39,31,47049,31,2521
14.225,6,1458,1279744,869,1390,16,1448,1243744,589,776,23,1448,36000
0.354,6,27,9085,13,257,29,667,1715,14,947,25,1408,7370
1771.738,6,99,9240,66,65,27257,65,5577,33,59,55363,59,3663
75.718,17,2,148,2,46,75718,46,148,0,0,0,0,0
81.965,6,18,748,8,0,3604,0,328,10,0,9105,0,420
0.502,6,12,1653,6,288,95,288,548,6,426,55,434,1105
1624.364,2,13,416,13,8,135363,8,416,0,0,0,0,0
3.459,6,20,2744,9,256,431,256,1388,11,304,344,304,1356
12.06,6,578,466487,339,1303,35,1368,449243,239,776,49,2736,17244
1796.498,17,366,58563,366,132,4921,366,58563,0,0,0,0,0
61.329,6,37,15861,22,793,2920,1408,9082,15,665,4362,1408,6779
1789.701,17,140,11200,70,48,25937,48,5320,70,56,25937,56,5880
0.121,1,2,112,2,28,121,28,112,0,0,0,0,0
6.627,6,563,509288,366,1327,17,1368,494380,197,776,32,2736,14908
280.444,6,27,7312,13,158,23370,267,1317,14,775,21569,4836,5995
156.326,17,6,528,3,60,78162,60,264,3,60,78162,60,264
36.484,17,20,1760,10,48,4052,48,760,10,72,4052,72,1000
694.887,6,1774,978974,890,1030,781,1408,847057,884,236,786,1671,131917
1737.124,1,52,4368,52,56,34061,56,4368,0,0,0,0,0
210.097,6,284,62658,169,370,1250,1408,30672,115,242,1842,1328,31986
1795.6,17,760,45844,760,32,2365,37,45844,0,0,0,0,0
153.09,17,4,352,2,60,153089,60,176,2,60,153089,60,176
1786.754,6,329,25626,163,259,11025,515,10665,166,39,10821,76,14961
1740.689,17,29,30624,29,1028,62167,1028,30624,0,0,0,0,0
1798.298,1,53,4452,53,56,34582,56,4452,0,0,0,0,0
27.597,6,751,647725,452,1355,60,1368,624025,299,753,91,1368,23700
280.314,6,28,7352,12,158,25483,267,1277,16,603,18684,1400,6075
1776.416,1,58,4872,0,0,0,0,0,58,56,31165,56,4872
5.761,2,2,64,2,8,5761,8,64,0,0,0,0,0
1795.134,17,144,11520,72,48,25283,48,5472,72,56,25283,56,6048
380.032,6,44,11232,19,142,15562,516,1905,25,361,15830,1452,9327
240.196,6,52,17904,27,806,9237,1418,15121,25,184,10007,580,2783
0.02,6,5,310,3,31,10,31,175,2,31,0,31,135
1786.126,6,106,8388,68,64,26658,64,4896,38,58,48270,58,3492
1598.891,1,52,4368,0,0,0,0,0,52,56,31350,56,4368
1775.77,6,182,15698,121,69,14798,69,9049,61,69,29595,69,6649
187.219,17,4,352,2,60,187218,60,176,2,60,187218,60,176
2.449,17,4,574,3,39,965,39,201,1,345,0,345,373
63.866,6,31,7475,14,141,4912,267,1415,17,413,3978,1452,6060
2.912,17,2,176,2,60,2912,60,176,0,0,0,0,0
1790.775,17,271,84113,271,282,6632,422,84113,0,0,0,0,0
105.782,17,4,352,2,60,105780,60,176,2,60,105781,60,176
4.377,6,38,7245,19,218,243,314,3383,19,516,228,1179,3862
28.472,6,73,25511,35,916,837,1440,14345,38,499,762,1440,11166
1.221,6,41,11378,22,547,58,1360,5842,19,433,56,1360,5536
1.734,6,49,19659,27,920,66,1460,14003,22,433,60,1460,5656
157.448,17,4,352,2,60,157447,60,176,2,60,157447,60,176
311.404,6,27,7798,12,216,5098,500,1348,15,487,22237,1420,6450
0.299,6,27,9042,13,247,24,624,1672,14,947,22,1408,7370
8.747,6,79,24381,39,550,230,1152,18640,40,459,217,1179,5741
4.343,6,38,7245,19,218,241,314,3383,19,516,227,1179,3862
1.693,17,3,1173,3,363,846,363,1173,0,0,0,0,0
1781.945,1,146,8176,146,28,12289,28,8176,0,0,0,0,0
0.143,6,10,1669,6,551,28,947,1346,4,159,47,159,323
2.186,17,3,174,3,30,1093,30,174,0,0,0,0,0
1799.264,6,376,23803,215,69,8407,69,13223,161,69,11245,69,10580
1795.416,17,447,39580,403,35,4466,288,25676,44,288,40019,288,13904
42.302,17,48,7056,24,48,1838,48,1824,24,190,1838,308,5232
0.062,17,3,228,3,48,31,48,228,0,0,0,0,0
1.428,6,24,8004,12,164,109,267,1288,12,1014,110,2736,6716
452.394,6,45,12971,23,577,20563,1360,5020,22,504,21533,1360,7951
0.568,6,14,1745,7,288,65,288,600,7,426,65,434,1145
1775.412,1,92,5152,92,28,19510,28,5152,0,0,0,0,0
2.853,6,59,14251,29,551,101,1429,5064,30,398,89,1460,9187
0.064,17,2,189,1,39,0,39,67,1,94,0,94,122
11.809,6,1859,1617473,1142,1362,10,1380,1582628,717,558,16,1923,34845
70.2,6,20,8678,11,316,68,640,1421,9,1377,8757,3928,7257
1.103,6,27,9624,13,164,78,267,1396,14,936,72,1408,8228
1772.637,6,180,15480,120,69,14896,69,8940,60,69,30036,69,6540
1783.814,6,461,29336,244,100,7340,469,16176,217,34,8258,64,13160
2.951,6,24,6807,11,257,290,517,1621,13,643,242,1418,5186
149.201,6,590,455852,349,1377,428,1460,438155,241,196,121,1460,17697
0.485,6,12,3704,6,171,96,171,491,6,964,83,1448,3213
1795.186,17,448,39896,403,35,4465,288,25676,45,288,40018,288,14220
0.188,6,26,7256,14,155,14,267,1341,12,678,15,3436,5915
0.009,6,3,327,2,103,0,138,287,1,0,0,0,40
11.52,6,6,328,4,0,3840,0,216,2,0,11434,0,112
1740.316,6,128,16163,77,78,22898,877,7037,51,161,34805,2007,9126
1740.581,17,28,29568,28,1028,64465,1028,29568,0,0,0,0,0
0.064,1,2,112,2,28,64,28,112,0,0,0,0,0
0.312,17,7,2375,7,311,52,355,2375,0,0,0,0,0
1799.927,17,142,11360,71,48,25713,48,5396,71,56,25713,56,5964
1686.542,17,12,498,11,14,168654,14,462,1,8,0,8,36
0.479,6,234,188817,133,221,3,517,8199,101,1826,4,9856,180618
1681.558,17,14,1036,7,30,280257,30,406,7,62,280257,62,630
1789.128,6,4186,3972139,1464,132,1222,349,85779,2722,1412,657,2836,3886360
1756.768,1,174,18444,174,78,10154,78,18444,0,0,0,0,0
1796.097,6,369,26765,199,99,9070,469,14514,170,69,10627,69,12251
8.177,6,18,6791,9,275,1022,275,643,9,1155,926,1420,6148
120.28,17,4,1344,4,308,40093,308,1344,0,0,0,0,0
240.226,6,61,21090,34,858,7279,1418,18101,27,175,9239,580,2989
0.012,17,2,152,2,48,12,48,152,0,0,0,0,0
1.368,6,7,295,4,0,456,0,164,3,7,202,7,131
0.124,17,2,362,1,46,0,46,74,1,260,0,260,288
1.677,6,30,10754,17,517,104,1360,3325,13,766,118,2561,7429
121.991,1,6,336,6,28,24398,28,336,0,0,0,0,0
153.536,6,23,9545,12,306,83,612,1443,11,1092,15335,3926,8102
240.557,6,63,18578,30,765,8293,1418,15346,33,188,7514,580,3232
1785.578,6,358,22669,209,69,8584,69,12569,149,69,12064,69,10100
443.355,1,3,180,3,32,221677,32,180,0,0,0,0,0
0.209,17,2,152,1,48,0,48,76,1,48,0,48,76
195.665,6,32,6846,13,189,6077,516,1470,19,307,10865,1452,5376
0.089,17,2,167,1,39,0,39,67,1,72,0,72,100
1633.546,1,8,448,8,28,233363,28,448,0,0,0,0,0
61.307,6,36,16102,22,821,2919,1408,9376,14,748,4696,2439,6726
1.583,6,39,8294,19,321,87,1164,2718,20,433,72,1360,5576
0.059,17,2,198,1,39,0,39,67,1,103,0,103,131
14.378,6,1645,1572158,1044,1429,13,1448,1536400,601,899,23,1448,35758
0.166,17,4,588,2,48,157,48,152,2,190,155,308,436
0.121,6,2,116,1,0,0,0,64,1,0,0,0,52
2.71,6,22,6400,10,262,296,517,1316,12,744,242,1418,5084
220.702,17,4,240,2,32,220701,32,120,2,32,220701,32,120
1744.687,2,30,960,30,8,60161,8,960,0,0,0,0,0
272.502,17,2,908,2,426,272502,687,908,0,0,0,0,0
1.488,6,37,8214,19,321,82,1164,2718,18,529,76,4075,5496
1796.577,17,449,39928,404,35,4458,288,25708,45,288,40019,288,14220
0.758,17,5,750,3,30,373,30,174,2,260,746,276,576
225.706,6,16,1204,4,31,16815,31,270,12,31,20502,31,934
302.352,6,68,31230,36,1028,8638,1360,22103,32,460,327,1360,9127
1680.545,17,12,498,11,14,168054,14,462,1,8,0,8,36
369.676,6,18,1239,14,177,28436,177,913,4,110,20060,110,326
0.063,6,40,32114,27,181,2,253,1967,13,2678,4,7040,30147
0.736,6,22,7342,13,335,61,668,2026,9,1210,85,1946,5316
280.421,6,28,7352,13,158,23368,267,1317,15,678,20027,2085,6035
31.726,6,26,4225,13,234,2629,564,1664,13,463,2629,1343,2561
5.222,6,29,6081,15,161,373,267,1575,14,657,371,1459,4506
103.845,6,15,1132,4,226,139,226,442,11,110,10366,110,690
7.874,6,18,8085,9,275,984,275,643,9,1414,689,1414,7442
0.053,6,9,1340,5,145,13,145,349,4,827,13,827,991
1798.428,17,441,37684,403,35,4473,288,25676,38,288,47595,288,12008
1773.295,6,180,15480,120,69,14901,69,8940,60,69,30050,69,6540
3.637,17,5,295,5,31,909,31,295,0,0,0,0,0
0.408,6,8,335,4,0,136,0,164,4,7,63,7,171
1795.504,6,469,29730,251,99,7182,469,16525,218,34,8274,64,13205
1673.479,1,8,448,8,28,239068,28,448,0,0,0,0,0
11.063,6,19,3442,10,210,1228,210,984,9,664,1381,904,2458
35.771,6,27,7177,13,155,2980,267,1306,14,530,2751,3417,5871
1772.364,6,180,15480,120,69,14893,69,8940,60,69,30038,69,6540
1794.53,6,356,22520,208,69,8669,69,12460,148,69,12207,69,10060
4.127,6,39,7269,20,218,217,314,3423,19,440,215,1152,3846
31.575,6,4,192,1,0,0,0,48,3,0,12092,0,144
0.047,17,4,352,2,60,46,60,176,2,60,46,60,176
0.628,17,2,152,1,48,0,48,76,1,48,0,48,76
105.062,17,4,558,2,36,105057,36,128,2,187,105058,187,430
1799.082,17,449,39416,404,34,4464,288,25444,45,282,40021,288,13972
1786.583,6,104,8504,69,66,26273,66,5004,35,60,52543,60,3500
6.997,6,545,528510,376,1346,18,1368,515058,169,776,40,2736,13452
1798.856,17,445,38664,404,35,4463,288,25708,41,288,42966,288,12956
4.847,6,33,9655,13,327,89,1189,2495,20,397,254,1420,7160
0.103,6,12,1697,7,253,17,500,878,5,551,25,551,819
280.217,6,30,7432,13,158,23351,267,1317,17,543,17509,1400,6115
1799.795,6,81,4302,41,26,44993,26,2170,40,26,46147,26,2132
50.6,17,4,240,2,32,50598,32,120,2,32,50599,32,120
0.41,6,8,335,4,0,136,0,164,4,7,74,7,171
1.123,17,4,316,2,34,1000,34,124,2,68,860,68,192
7.379,6,1584,1459819,1002,1379,7,1408,1424891,582,931,12,2801,34928
0.007,17,2,318,1,39,0,39,67,1,223,0,223,251
1644.874,6,54,13795,31,387,54829,1460,6312,23,409,74758,1460,7483
106.451,6,29,7392,14,158,8188,267,1357,15,678,7600,3436,6035
0.269,6,24,5980,12,164,24,453,1442,12,651,23,1408,4538
132.945,17,4,240,2,32,132943,32,120,2,32,132944,32,120
3.973,17,2,244,2,94,3973,94,244,0,0,0,0,0
5.168,6,33,10263,18,614,279,1460,3874,15,641,124,1460,6389
13.962,6,20,4406,12,275,1269,275,1042,8,1010,892,2840,3364
372.017,6,27,1767,18,177,21883,177,1181,9,110,8640,110,586
15.74,6,14,3716,3,92,7870,92,256,11,320,1548,1448,3460
0.567,6,10,924,5,283,95,283,551,5,105,95,105,373
103.29,6,42,8742,20,360,796,766,1985,22,366,4911,2128,6757
53.097,17,4,352,2,60,53096,60,176,2,60,53096,60,176
0.038,17,2,570,1,30,0,30,58,1,484,0,484,512
0.445,6,14,1733,7,288,68,288,588,7,284,44,434,1145
1798.044,17,448,39896,403,35,4472,288,25676,45,288,40019,288,14220
415.486,17,10,3328,10,304,46165,308,3328,0,0,0,0,0
1747.884,6,95,7203,63,38,28191,205,4476,32,33,56374,98,2727
0.132,17,2,290,1,40,0,40,68,1,194,0,194,222
1771.565,6,99,9240,66,65,27254,65,5577,33,59,55358,59,3663
240.254,6,55,19420,30,820,8284,1408,16341,25,221,10010,580,3079
1770.786,6,99,9306,66,66,27242,66,5610,33,60,55333,60,3696
1739.436,17,159,26964,159,141,11009,389,26964,0,0,0,0,0
60.139,2,2,64,2,8,60139,8,64,0,0,0,0,0
1796.516,1,276,15456,276,28,6532,28,15456,0,0,0,0,0
0.057,6,10,1514,5,503,14,503,771,5,475,14,475,743
0.041,17,2,344,1,41,0,41,69,1,247,0,247,275
5.728,6,15,2391,9,125,716,245,740,6,1407,1092,1407,1651
116.712,6,939,473664,533,826,219,1152,452633,406,435,287,1179,21031
1780.044,6,370,42284,186,168,9620,239,33932,184,31,9726,31,8352
0.188,17,2,152,1,48,0,48,76,1,48,0,48,76
1.592,6,48,19333,27,900,61,1360,13717,21,433,69,1360,5616
6.646,6,31,8912,14,158,511,267,1357,17,687,403,1781,7555
60.722,6,38,9567,19,642,488,1360,4005,19,399,3363,1360,5562
75.425,6,1557,1320078,912,1361,82,1368,1278642,645,776,116,2736,41436
361.952,6,40,7627,18,143,13565,516,1870,22,270,17231,1452,5757
4.288,6,35,11077,20,489,225,1418,4966,15,591,304,1418,6111
1798.724,1,333,27972,333,56,5417,56,27972,0,0,0,0,0
1788.249,17,87,3648,86,14,21038,14,3612,1,8,0,8,36
1.007,17,19,6873,9,471,124,1350,4496,10,209,107,1350,2377
5.093,6,38,7229,19,218,282,314,3383,19,513,266,1179,3846
1798.927,6,356,22520,208,69,8690,69,12460,148,69,12237,69,10060
264.203,6,172,77101,86,795,278,1152,67096,86,385,3105,1179,10005
3.758,6,32,6089,17,206,234,314,2744,15,548,249,1179,3345
217.869,17,3,228,3,48,108934,48,228,0,0,0,0,0
0.34,6,21,5000,10,137,37,267,1092,11,692,28,1467,3908
1781.19,17,81,3396,80,14,22546,14,3360,1,8,0,8,36
0.222,17,2,588,1,39,0,39,67,1,493,0,493,521
132.301,6,21,7979,11,525,87,1237,2048,10,919,14680,1591,5931
13.234,6,22,2898,10,304,1470,304,1744,12,83,1160,83,1154
0.258,6,23,5928,12,164,23,453,1442,11,781,24,2224,4486
1797.389,6,356,22520,208,69,8683,69,12460,148,69,12223,69,10060
429.63,6,89,15540,46,130,9543,721,5120,43,434,10225,1414,10420
1795.291,6,356,22520,208,69,8672,69,12460,148,69,12212,69,10060
1771.886,6,101,9344,66,65,27259,65,5577,35,59,52111,59,3767
33.484,6,28,4938,14,180,2575,722,1807,14,399,2560,1448,3131
97.389,17,4,352,2,60,97388,60,176,2,60,97388,60,176
0.006,17,2,472,1,39,0,39,67,1,377,0,377,405
1795.514,1,58,4872,58,56,31500,56,4872,0,0,0,0,0
1795.071,6,356,22520,208,69,8671,69,12460,148,69,12211,69,10060
1782.989,17,73,3060,72,14,25112,14,3024,1,8,0,8,36
0.046,17,4,352,2,37,0,37,130,2,83,9,89,222
0.34,6,26,8868,13,227,28,547,1592,13,941,25,1448,7276
0.03,17,3,244,2,32,18,32,120,1,96,0,96,124
211.28,17,4,352,2,60,211279,60,176,2,60,211279,60,176
3.372,17,8,480,4,32,1123,32,240,4,32,1123,32,240
1755.818,17,392,84514,392,187,4490,422,84514,0,0,0,0,0
1122.617,17,10,740,5,30,280642,30,290,5,62,280648,62,450
240.546,6,416,382917,148,460,1636,1418,11385,268,1402,900,4254,371532
104.777,6,121,94059,79,1264,1343,1408,83752,42,811,1927,3847,10307
5.616,6,18,2474,10,210,624,210,972,8,545,799,904,1502
1.695,6,14,2351,8,188,242,245,700,6,703,288,1152,1651
300.104,6,40,9913,21,579,14996,1440,4351,19,399,16663,1440,5562
6.833,6,42,6551,23,132,310,267,1870,19,780,370,1460,4681
0.017,17,2,383,1,33,0,33,61,1,294,0,294,322
5.13,6,38,7229,20,218,270,314,3423,18,513,285,1179,3806
0.251,17,12,4365,12,335,22,358,4365,0,0,0,0,0
4.999,17,4,288,2,36,4998,36,128,2,52,4998,52,160
3.037,17,3,180,3,32,1518,32,180,0,0,0,0,0
727.414,1,20,1120,20,28,38284,28,1120,0,0,0,0,0
240.329,17,4,382,2,31,240312,34,119,2,103,240314,114,263
4.181,6,39,7269,19,218,232,314,3383,20,440,207,1152,3886
0.023,6,6,715,3,304,11,304,468,3,83,3,83,247
147.262,6,16,3253,6,92,29452,92,400,10,1164,16343,1408,2853
15.941,6,22,11868,7,124,2656,124,568,15,1186,966,1360,11300
0.114,1,2,112,2,28,114,28,112,0,0,0,0,0
241.541,2,4,128,4,8,80513,8,128,0,0,0,0,0
1.041,6,27,8444,14,266,70,540,1948,13,994,71,1791,6496
1769.222,1,58,4872,0,0,0,0,0,58,56,31038,56,4872
0.972,17,25,9703,12,332,85,1350,4321,13,386,78,1350,5382
105.463,6,32,8952,14,158,8112,267,1357,18,624,6200,1400,7595
1787.52,17,87,3648,86,14,21029,14,3612,1,8,0,8,36
39.021,17,44,6468,22,48,1857,48,1672,22,190,1857,308,4796
0.0,17,1,1067,1,1039,0,1039,1067,0,0,0,0,0
10.989,6,1738,1519113,1056,1385,10,1420,1487612,682,467,16,1883,31501
0.183,17,3,543,2,39,178,39,134,1,381,0,381,409
1772.781,6,180,15480,120,69,14897,69,8940,60,69,30044,69,6540
350.335,17,10,880,5,48,87580,48,380,5,72,87580,72,500
0.583,17,14,9104,8,822,83,1350,6803,6,355,98,1350,2301
0.965,6,29,12011,16,525,64,1360,3298,13,909,66,1379,8713
0.01,17,4,352,2,37,0,37,130,2,83,2,89,222
69.47,6,7634,7241945,4733,1444,14,1448,7071605,2901,776,23,1448,170340
3.347,6,55,31563,31,722,111,1408,5940,24,1624,145,5632,25623
1740.49,17,30,7050,30,207,60016,207,7050,0,0,0,0,0
15.501,6,7,388,4,0,5167,0,216,3,0,7735,0,172
97.511,17,8,2656,8,304,13930,308,2656,0,0,0,0,0
1757.978,6,5377,5070416,1922,150,915,968,110736,3455,1413,508,2836,4959680
0.576,17,4,352,2,60,575,60,176,2,60,575,60,176
0.176,17,2,572,1,39,0,39,67,1,477,0,477,505
24.973,6,41,19219,19,415,1386,1114,2718,22,960,1188,1408,16501
1.459,6,12,1304,6,256,288,256,756,6,304,289,304,548
1744.608,2,15,480,15,8,124614,8,480,0,0,0,0,0
1793.712,1,228,24168,228,78,7901,78,24168,0,0,0,0,0
18.517,6,2790,2603975,1804,1365,10,1408,2548039,986,931,18,2816,55936
1681.55,17,16,1265,8,30,240216,37,471,8,71,240216,136,794
280.431,6,29,7392,13,158,23369,267,1317,16,603,18688,1400,6075
0.438,6,25,7711,16,339,29,949,3017,9,721,52,1420,4694
1764.158,2,15,480,15,8,126011,8,480,0,0,0,0,0
0.067,6,2,126,1,0,0,0,40,1,46,0,46,86
125.378,6,15,3919,8,407,17911,722,1226,7,581,20865,2026,2693
1772.16,6,180,15480,120,69,14892,69,8940,60,69,30035,69,6540
38.095,17,11,836,11,48,3809,48,836,0,0,0,0,0
0.932,6,10,1687,7,100,155,100,384,3,1179,332,1179,1303
0.168,6,12,3462,6,75,33,75,395,6,1373,33,1448,3067
1.667,6,25,8763,15,285,119,587,1459,10,985,166,1420,7304
0.379,6,106,83701,59,209,6,253,4269,47,1710,7,5632,79432
241.434,6,50,14232,23,472,10973,1418,5508,27,562,9285,1418,8724
1786.869,6,104,8308,68,64,26669,64,4896,36,58,51051,58,3412
0.378,17,2,136,1,32,0,32,60,1,48,0,48,76
1799.961,1,241,13496,241,28,7499,28,13496,0,0,0,0,0
0.03,6,11,912,7,181,5,181,541,4,77,7,134,371
305.457,6,67,17699,31,229,10181,757,3035,36,489,386,1928,14664
1744.936,17,29,30624,29,1028,62319,1028,30624,0,0,0,0,0
11.162,6,35,8362,18,213,656,721,2221,17,778,683,1440,6141
1.361,6,45,16299,25,807,56,1360,10723,20,476,61,2715,5576
0.342,17,8,2742,8,314,48,353,2742,0,0,0,0,0
240.354,6,42,8818,21,524,12017,1418,5816,21,237,12017,618,3002
38.066,17,5,1816,5,335,9516,382,1816,0,0,0,0,0
1797.55,17,180,14040,180,50,10042,50,14040,0,0,0,0,0
0.496,17,3,451,2,39,433,39,134,1,289,0,289,317
4.049,6,38,7229,19,218,224,314,3383,19,513,211,1179,3846
4.0,17,2,148,2,46,4000,46,148,0,0,0,0,0
299.547,6,6,364,4,31,99849,31,222,2,31,299526,31,142
7.291,6,1720,1628005,1107,1394,6,1408,1591453,613,931,11,2801,36552
1.622,6,48,19082,27,882,62,1360,13466,21,433,69,1360,5616
553.539,1,6,336,6,28,110707,28,336,0,0,0,0,0
1797.74,1,276,15456,276,28,6537,28,15456,0,0,0,0,0
1.288,6,49,18789,27,858,49,1360,13133,22,476,53,2715,5656
0.89,6,28,8582,15,229,54,583,2043,13,1001,60,2720,6539
0.4,6,9,1339,5,145,100,145,349,4,826,120,826,990
1740.101,6,87,6322,58,31,30528,31,3915,29,31,62146,31,2407
5.409,6,40,7309,21,218,270,314,3463,19,513,286,1179,3846
1798.615,17,447,39296,404,35,4463,288,25708,43,288,41921,288,13588
1791.377,17,144,11520,72,48,25230,48,5472,72,56,25230,56,6048
1740.454,17,29,30624,29,1028,62159,1028,30624,0,0,0,0,0
1785.594,6,104,8252,68,63,26650,64,4868,36,57,51014,58,3384
12.965,6,28,9502,15,445,926,1091,3446,13,1072,1063,2519,6056
1.435,6,10,419,5,0,358,0,204,5,7,305,7,215
3.198,17,2,154,1,33,0,33,61,1,65,0,65,93
1800.0,6,266,50105,109,317,16388,1460,33248,157,139,11538,1460,16857
1786.31,6,115,13715,75,81,24139,501,5950,40,162,45800,1420,7765
1795.134,17,87,3648,86,14,21119,14,3612,1,8,0,8,36
5.227,6,41,7349,21,201,261,314,3463,20,513,262,1179,3886
125.981,2,2,64,2,8,125981,8,64,0,0,0,0,0
1750.702,17,12,498,11,14,175070,14,462,1,8,0,8,36
20.152,6,24,5847,13,107,1679,159,1138,11,688,2014,1408,4709
11.339,6,1792,1566128,1086,1388,10,1420,1533667,706,467,16,1883,32461
1773.349,6,203,22290,130,75,13746,267,10057,73,134,24625,1917,12233
1772.749,6,180,15480,120,69,14897,69,8940,60,69,30039,69,6540
1.779,6,11,624,5,112,439,112,344,6,0,352,0,280
0.177,6,41,16600,23,974,8,1420,11659,18,420,9,1420,4941
2.162,17,30,14623,14,743,166,1350,10806,16,210,105,1350,3817
1773.033,6,180,15480,120,69,14899,69,8940,60,69,30049,69,6540
4.111,17,4,248,4,34,1370,34,248,0,0,0,0,0
170.68,6,1488,763832,840,848,203,1152,729274,648,392,263,1179,34558
5.763,6,43,8329,22,227,274,314,4062,21,489,274,1179,4267
1797.259,6,356,22520,208,69,8682,69,12460,148,69,12225,69,10060
359.526,6,31,9734,22,105,17120,597,2073,9,1214,67,3081,7661
0.439,17,2,193,1,43,0,43,71,1,94,0,94,122
0.173,6,10,584,5,44,43,44,312,5,0,41,0,272
74.509,6,114,88833,75,1246,1006,1408,78681,39,811,1955,3847,10152
0.047,17,2,290,1,47,0,47,75,1,187,0,187,215
4.969,17,2,130,2,37,4969,37,130,0,0,0,0,0
46.061,6,45,10241,22,541,743,910,3115,23,364,2087,2128,7126
1740.752,17,30,31680,30,1028,60025,1028,31680,0,0,0,0,0
2.036,1,3,252,3,56,1018,56,252,0,0,0,0,0
0.117,6,9,1338,5,549,29,549,753,4,421,32,421,585
258.672,17,4,352,2,60,258671,60,176,2,60,258671,60,176
280.275,6,30,7432,13,158,23356,267,1317,17,543,17510,1400,6115
0.08,6,13,4282,7,111,13,111,483,6,1159,15,2896,3799
0.795,6,23,5715,13,158,65,370,1315,10,999,87,1731,4400
1797.55,6,354,22440,206,69,8768,69,12380,148,69,12228,69,10060
3.622,6,2,88,2,0,0,0,88,0,0,0,0,0
1.42,6,39,9888,21,440,71,1360,4392,18,476,71,2715,5496
235.005,17,4,240,2,32,235004,32,120,2,32,235004,32,120
1785.863,6,362,24774,211,94,8504,469,14387,151,69,11905,69,10387
191.758,6,20,8310,7,96,31959,106,576,13,720,452,1420,7734
963.569,17,26,10221,26,365,38542,548,10221,0,0,0,0,0
1777.113,17,73,3060,72,14,25029,14,3024,1,8,0,8,36
20.147,17,3,228,3,48,10073,48,228,0,0,0,0,0
0.286,6,24,4571,12,165,26,456,1446,12,415,24,888,3125
1791.578,6,380,26515,219,97,8218,469,15590,161,69,11197,69,10925
64.997,17,14,14994,14,1043,4999,1043,14994,0,0,0,0,0
1789.004,1,210,11760,210,28,8559,28,11760,0,0,0,0,0
44.228,17,19,10692,10,662,4914,1350,6908,9,392,1897,1350,3784
6.299,1,4,224,4,28,2099,28,224,0,0,0,0,0
51.699,17,16,18211,16,1110,3446,1451,18211,0,0,0,0,0
0.234,17,4,1148,2,32,220,32,120,2,486,26,486,1028
61.814,6,34,9049,17,239,3862,556,2329,17,448,3853,1719,6720
1.626,6,13,1713,7,288,267,288,608,6,426,76,434,1105
0.445,6,12,3704,6,171,78,171,491,6,964,80,1448,3213
1786.199,6,104,8376,68,65,26659,65,4930,36,59,51031,59,3446
14.98,6,962,834237,601,1314,24,1368,810801,361,776,41,1473,23436
7.088,6,1336,1237418,850,1379,8,1408,1207482,486,931,14,2816,29936
1793.03,6,362,24902,210,90,8579,981,13990,152,75,11871,485,10912
94.02,17,238,45384,7,88,2294,288,812,231,164,408,308,44572
134.764,6,63,41595,40,1168,3455,1448,33647,23,843,2791,2359,7948
56.273,2,2,64,2,8,56273,8,64,0,0,0,0,0
1134.487,17,56,2346,55,14,21009,14,2310,1,8,0,8,36
1720.464,1,8,848,8,78,245780,78,848,0,0,0,0,0
27.457,6,14,2185,8,324,3922,585,1073,6,396,5488,580,1112
83.854,6,23,8774,12,295,77,579,1399,11,1153,8371,3057,7375
2.695,17,4,1560,4,362,898,362,1560,0,0,0,0,0
63.16,17,4,288,2,36,63123,36,128,2,52,63127,52,160
9.92,6,11,856,3,106,4960,106,234,8,90,1388,90,622
448.982,1,20,2120,20,78,23630,78,2120,0,0,0,0,0
1787.902,6,355,22480,207,69,8679,69,12420,148,69,12162,69,10060
0.128,17,2,245,1,32,0,32,60,1,157,0,157,185
2.821,17,4,566,2,31,2811,31,118,2,196,2810,196,448
1788.464,1,67,5628,67,56,27097,56,5628,0,0,0,0,0
0.108,17,2,268,1,54,0,54,82,1,158,0,158,186
1789.613,17,83,3480,82,14,22093,14,3444,1,8,0,8,36
238.089,17,4,240,2,32,238088,32,120,2,32,238088,32,120
0.6,6,10,1671,6,552,120,948,1348,4,159,200,159,323
280.52,6,29,7392,13,158,23376,267,1317,16,603,18695,1400,6075
129.292,6,42,25983,19,840,41,1460,5847,23,1200,5870,1460,20136
275.773,17,4,352,2,60,275772,60,176,2,60,275771,60,176
61.718,6,35,8039,16,146,4114,267,1968,19,530,3427,3417,6071
0.894,17,4,314,2,31,862,31,118,2,70,848,70,196
6.547,6,45,8425,24,227,284,314,4142,21,491,314,1179,4283
0.156,6,7,423,4,43,38,43,259,3,0,26,0,164
1729.252,6,60,4400,40,33,44339,33,2740,20,31,91000,31,1660
18.499,6,8,460,3,0,9249,0,160,5,0,3947,0,300
1793.447,17,468,66280,220,194,8189,1350,48855,248,42,7260,1350,17425
5.23,6,18,6933,6,275,1046,275,794,12,628,431,2760,6139
4.594,6,34,6169,18,206,270,314,2784,16,548,289,1179,3385
301.636,6,31,8826,17,202,18852,490,1533,14,840,5107,1460,7293
5.006,17,4,558,2,36,5002,36,128,2,187,5001,187,430
1788.835,1,342,28728,342,56,5245,56,28728,0,0,0,0,0
0.22,6,46,21156,26,1076,8,1420,16135,20,467,11,1883,5021
115.989,6,25,10058,12,571,67,1440,2799,13,961,9653,1440,7259
1786.736,6,104,8510,69,66,26275,66,5070,35,60,52547,60,3440
15.24,6,820,725040,534,1288,28,1368,705504,286,776,52,2736,19536
13.227,6,24,6993,13,275,1102,275,1078,11,910,821,1440,5915
1692.143,6,427,62216,171,221,9952,779,35915,256,128,6635,1058,26301
1772.313,6,180,15480,120,69,14893,69,8940,60,69,30033,69,6540
0.541,6,12,1653,6,288,104,288,548,6,426,60,434,1105
18.671,17,38,26205,19,762,1035,1350,15022,19,560,1035,1350,11183
300.674,6,36,8522,19,315,16704,882,2089,17,478,533,1968,6433
1520.348,6,102,6082,57,26,27148,26,3366,45,26,34552,26,2716
0.222,17,2,152,2,48,222,48,152,0,0,0,0,0
1.417,6,10,1687,7,100,236,100,384,3,1179,575,1179,1303
0.046,17,2,172,1,50,0,50,78,1,66,0,66,94
1780.658,6,110,8714,69,63,26186,63,4965,41,57,44514,57,3749
125.452,6,18,4099,9,407,15681,722,1302,9,387,15654,1408,2797
725.391,6,70,4863,36,69,20719,208,3038,34,31,21975,31,1825
0.238,17,3,451,2,39,129,39,134,1,289,0,289,317
58.125,2,4,128,4,8,19375,8,128,0,0,0,0,0
156.569,1,23,3792,23,136,7116,293,3792,0,0,0,0,0
280.363,6,30,7432,13,158,23363,267,1317,17,543,17516,1400,6115
1794.283,17,80,3354,79,14,23003,14,3318,1,8,0,8,36
75.625,6,48,10415,23,533,704,910,3147,25,329,3145,2720,7268
241.74,6,34,9988,12,300,21975,725,2133,22,557,11511,1502,7855
1771.286,6,99,9174,66,64,27250,64,5544,33,58,55349,58,3630
1772.376,6,180,15480,120,69,14893,69,8940,60,69,30038,69,6540
0.499,17,4,644,2,36,490,36,128,2,230,489,230,516
1720.433,17,12,498,11,14,172043,14,462,1,8,0,8,36
1771.495,6,331,30364,145,68,12301,659,11750,186,102,9573,1638,18614
1745.573,6,97,7307,63,38,28154,205,4476,34,33,52887,98,2831
0.06,6,10,767,5,186,13,186,454,5,45,13,45,313
7.484,6,52,14829,24,487,325,1440,4454,28,543,269,1440,10375
1776.282,17,269,43160,269,132,6627,389,43160,0,0,0,0,0
1797.362,6,189,12322,94,55,19194,208,7368,95,36,19119,112,4954
1782.388,6,354,22440,207,69,8652,69,12420,147,69,12208,69,10020
120.488,6,14609,14053942,9804,1356,12,1408,13799394,4805,776,25,1408,254548
1772.713,6,180,15480,120,69,14896,69,8940,60,69,30040,69,6540
0.005,17,3,660,2,46,1,46,148,1,484,0,484,512
32.538,6,44,16094,23,1055,404,1440,10452,21,399,1617,1440,5642
1777.637,17,138,11040,69,48,26141,48,5244,69,56,26141,56,5796
1768.423,1,58,4872,58,56,31024,56,4872,0,0,0,0,0
282.028,6,28,7352,12,158,25638,267,1277,16,603,18781,1400,6075
1.328,6,30,6160,15,150,94,267,1655,15,650,84,1452,4505
1783.406,6,216,18963,129,67,13932,96,10078,87,54,20733,98,8885
601.593,2,7,224,7,8,100265,8,224,0,0,0,0,0
47.539,6,36,8455,18,410,517,882,1982,18,478,2787,2720,6473
1772.189,6,180,15480,120,69,14892,69,8940,60,69,30034,69,6540
1779.014,1,58,4872,58,56,31210,56,4872,0,0,0,0,0
2.9,6,37,14177,21,458,145,1460,3644,16,823,171,1460,10533
74.158,6,29,8738,16,434,4943,659,2202,13,731,5921,4096,6536
11.74,17,4,352,2,48,11713,48,152,2,72,11723,72,200
1786.599,6,104,8444,68,66,26665,66,4964,36,60,51043,60,3480
23.243,6,16,1327,8,222,3319,222,768,8,231,3319,231,559
1795.767,17,448,39896,403,35,4467,288,25676,45,288,40021,288,14220
1.569,17,4,768,2,39,1539,39,134,2,289,1274,289,634
1.293,6,47,18188,26,882,51,1360,12572,21,433,54,1360,5616
0.815,6,23,5715,13,158,65,370,1315,10,999,88,1691,4400
291.31,17,4,240,2,32,291309,32,120,2,32,291309,32,120
107.218,17,4,240,2,32,107217,32,120,2,32,107217,32,120
1771.862,6,180,15480,120,69,14889,69,8940,60,69,30030,69,6540
0.196,17,2,165,1,36,0,36,64,1,73,0,73,101
5.042,17,3,257,2,37,5005,37,130,1,99,0,99,127
8.933,6,28,5791,16,208,595,314,2518,12,557,763,1179,3273
60.408,6,13,772,4,106,20133,106,274,9,90,7549,90,498
1744.34,6,95,7203,63,38,28134,205,4476,32,33,56258,98,2727
4.702,6,38,7245,20,218,247,314,3423,18,516,261,1179,3822
1786.185,17,87,3648,86,14,21013,14,3612,1,8,0,8,36
372.193,6,18,1242,14,180,28630,180,916,4,110,20060,110,326
246.289,6,32,3579,14,193,18945,585,1532,18,137,14486,580,2047
4.411,6,38,7229,19,218,245,314,3383,19,513,231,1179,3846
0.017,6,32,7991,17,131,1,131,1023,15,475,1,1000,6968
2.256,6,6,464,3,0,1128,0,144,3,82,910,82,320
280.192,6,28,7352,13,158,23349,267,1317,15,678,20010,2045,6035
280.052,6,29,7392,13,158,23337,267,1317,16,603,18666,1400,6075
2.876,6,32,19314,19,772,159,1360,6196,13,1798,228,5294,13118
83.708,6,13,2874,2,245,4480,245,329,11,299,8345,299,2545
21.5,6,26,5123,14,211,1653,211,1417,12,617,1954,904,3706
0.262,17,2,631,2,287,262,292,631,0,0,0,0,0
0.259,17,2,152,1,48,0,48,76,1,48,0,48,76
17.642,6,8,874,4,304,5880,304,500,4,83,5410,83,374
37.8,17,44,6468,22,48,1799,48,1672,22,190,1799,308,4796
0.059,17,2,206,1,44,0,44,72,1,106,0,106,134
0.115,6,13,4362,7,127,12,127,499,6,1181,20,1930,3863
1771.759,6,142,9591,75,27,23941,27,4575,67,60,26844,427,5016
12.598,6,95,29215,48,565,268,1152,22837,47,449,268,1179,6378
0.548,17,4,5456,4,1336,182,1336,5456,0,0,0,0,0
1794.017,6,356,22520,208,69,8666,69,12460,148,69,12203,69,10060
0.937,6,33,10707,18,294,55,1305,3134,15,773,57,2720,7573
0.43,6,9,1338,5,549,107,549,753,4,421,122,421,585
1785.717,6,265,22384,161,103,11160,469,13670,104,69,17336,69,8714
1799.891,6,136,8889,75,54,24322,208,5488,61,31,29392,31,3401
417.052,6,45,8010,17,153,13613,516,1760,28,222,15443,1452,6250
160.157,6,70,46588,44,1167,3724,1408,38501,26,961,2464,3847,8087
0.5,6,22,7278,14,318,38,600,2010,8,968,69,1851,5268
0.692,17,2,1389,2,666,692,671,1389,0,0,0,0,0
31.637,6,7,336,1,0,0,0,48,6,0,6324,0,288
0.458,6,6,324,4,0,152,0,216,2,0,242,0,108
3.889,1,2,212,2,78,3889,78,212,0,0,0,0,0
1680.546,1,15,840,15,28,120039,28,840,0,0,0,0,0
0.332,17,2,152,1,48,0,48,76,1,48,0,48,76
5.406,6,12,945,6,222,1077,222,466,6,231,1077,231,479
1787.363,1,58,4872,0,0,0,0,0,58,56,31357,56,4872
1799.447,17,446,39264,403,35,4476,288,25676,43,288,41923,288,13588
31.745,17,4,352,2,60,31743,60,176,2,60,31744,60,176
1.697,6,17,7280,10,290,188,517,1097,7,1452,281,2804,6183
1.203,6,24,8004,12,164,93,267,1288,12,1014,92,2411,6716
377.684,6,18,1288,12,226,34334,226,858,6,110,13027,110,430
5.066,6,42,8305,20,227,266,314,3982,22,491,228,1179,4323
1775.659,6,282,33981,116,133,15439,1360,16453,166,134,10760,3302,17528
1786.245,17,87,3648,86,14,21014,14,3612,1,8,0,8,36
1.304,6,48,19035,27,879,50,1360,13419,21,433,55,1360,5616
3.885,17,6,1356,6,198,777,207,1356,0,0,0,0,0
170.703,6,20644,19999110,13924,1359,12,1408,19645018,6720,931,25,2801,354092
69.503,6,102,37691,49,727,1444,1440,19457,53,519,1333,1440,18234
418.756,2,4,128,4,8,139585,8,128,0,0,0,0,0
369.539,6,18,1242,14,180,28426,180,916,4,110,20064,110,326
99.676,6,50,16323,26,939,3980,1460,10499,24,346,4326,1460,5824
280.233,6,30,7432,14,158,21556,267,1357,16,603,18680,1400,6075
271.302,17,4,352,2,60,271301,60,176,2,60,271301,60,176
5.034,17,4,288,2,36,5003,36,128,2,52,5002,52,160
14.67,6,9,588,4,106,4890,106,274,5,90,3634,90,314
40.645,6,27,7177,13,155,3387,267,1306,14,530,3125,3417,5871
1.075,17,20,9266,9,309,134,1350,3040,11,538,99,1350,6226
1798.219,17,29,9512,29,300,64222,300,9512,0,0,0,0,0
280.28,6,29,7392,13,158,23356,267,1317,16,603,18683,2036,6075
1791.154,1,37,4468,37,92,49754,173,4468,0,0,0,0,0
13.029,6,23,8345,13,275,1085,275,1078,10,1371,908,1440,7267
8.461,6,77,24589,40,560,216,1152,18968,37,459,227,1179,5621
1753.289,6,184,11097,93,45,19057,208,6527,91,31,19478,31,4570
1794.02,17,144,11520,72,48,25267,48,5472,72,56,25267,56,6048
11.234,6,87,25037,46,561,249,1152,19256,41,413,273,1152,5781
11.695,6,90,26525,46,541,259,1152,20267,44,449,265,1179,6258
1770.189,6,101,9410,66,66,27233,66,5610,35,60,52060,60,3800
1773.425,6,180,15480,120,69,14902,69,8940,60,69,30054,69,6540
264.16,17,4,558,2,36,264155,36,128,2,187,264155,187,430
0.5,17,3,1164,3,360,250,360,1164,0,0,0,0,0
248.787,6,64,25480,34,806,7539,1408,21925,30,165,8578,580,3555
1775.076,1,53,4452,53,56,34136,56,4452,0,0,0,0,0
1786.09,6,157,20189,92,304,19627,304,14216,65,83,27907,83,5973
11.109,6,30,13311,17,736,694,1408,3897,13,1247,923,3573,9414
1.413,6,46,18908,26,943,56,1460,13332,20,476,64,2615,5576
1790.255,17,130,10400,65,48,27972,48,4940,65,56,27972,56,5460
13.141,17,3,3595,3,1170,6570,1451,3595,0,0,0,0,0
2.235,6,61,29355,35,998,65,1360,23395,26,476,80,2715,5960
10.87,6,2027,1731961,1135,1430,9,1448,1672325,892,776,11,1448,59636
33.052,6,47,10387,22,533,643,910,3119,25,329,1371,2128,7268
252.174,2,2,64,2,8,252174,8,64,0,0,0,0,0
158.142,17,4,240,2,32,158141,32,120,2,32,158141,32,120
1798.198,17,426,36352,386,33,4670,288,23712,40,288,45148,288,12640
334.322,6,299,222078,135,684,2494,1418,12497,164,1358,2050,1418,209581
1.398,6,51,20748,28,926,51,1440,15052,23,433,54,1440,5696
0.108,17,2,279,1,36,0,36,64,1,187,0,187,215
11.807,6,86,25066,43,535,281,1152,18864,43,447,275,1179,6202
1748.02,6,95,7203,63,38,28193,205,4476,32,33,56378,98,2727
122.445,6,45,24044,23,131,5563,232,1449,22,1356,5824,2760,22595
275.909,17,6,2016,6,308,55181,308,2016,0,0,0,0,0
1.569,6,47,19439,27,910,60,1360,13863,20,476,71,2715,5576
1.292,17,3,1170,3,362,646,362,1170,0,0,0,0,0
0.083,6,9,1346,5,145,20,145,349,4,833,21,833,997
1797.312,1,345,28980,345,56,5224,56,28980,0,0,0,0,0
9.895,6,23,5272,12,351,899,1382,2242,11,431,987,1460,3030
0.234,6,21,5824,12,164,21,453,1442,9,651,27,1402,4382
229.464,6,92,21433,42,352,4330,1360,11233,50,303,4680,4662,10200
1782.349,1,7,742,7,78,297058,78,742,0,0,0,0,0
0.893,6,33,12144,18,518,52,1360,3366,15,742,52,1360,8778
11.45,6,14,2242,8,210,1635,210,844,6,545,2289,904,1398
1794.23,17,80,3354,79,14,23002,14,3318,1,8,0,8,36
1795.918,17,448,39896,403,35,4467,288,25676,45,288,40019,288,14220
350.194,6,41,3789,21,240,17509,593,1845,20,282,18430,580,1944
0.125,17,2,180,1,30,0,30,58,1,94,0,94,122
1.021,6,30,10120,15,232,71,569,1730,15,950,71,1438,8390
2.925,17,3,222,3,46,1462,46,222,0,0,0,0,0
280.088,6,30,7432,13,158,23340,267,1317,17,543,17500,1400,6115
2.972,17,2,412,1,33,0,33,61,1,323,0,323,351
19.768,6,28,4790,15,275,1412,275,1170,13,768,1249,1440,3620
118.051,6,52,10637,21,226,3157,1189,3113,31,313,3934,1917,7524
11.978,6,5,240,5,0,0,0,240,0,0,0,0,0
365.328,6,1221,618067,667,854,187,1152,587408,554,369,660,1179,30659
280.203,6,27,7312,13,158,23350,267,1317,14,775,21550,3445,5995
13.517,6,75,56281,34,778,409,1258,6609,41,1357,311,1440,49672
127.823,6,30,7432,13,158,10651,267,1317,17,543,7986,1400,6115
280.169,6,29,7392,13,158,23347,267,1317,16,603,18677,2036,6075
208.174,6,15,1127,9,65,26021,65,620,6,53,41614,59,507
0.1,17,3,1088,3,334,50,355,1088,0,0,0,0,0
0.713,6,3,144,3,0,0,0,144,0,0,0,0,0
9.944,6,84,25498,43,579,236,1152,19701,41,461,242,1179,5797
1.403,6,50,21119,28,954,51,1440,15463,22,433,58,1440,5656
91.609,6,112,81607,69,1252,1347,1368,71245,43,738,2175,2519,10362
11.674,6,34,8777,17,221,729,721,2452,17,564,716,2840,6325
183.138,6,10,632,3,92,91480,92,256,7,0,30493,0,376
0.591,6,2,87,1,0,0,0,40,1,7,0,7,47
45.075,17,6,528,3,48,22533,48,228,3,72,22534,72,300
1739.553,1,15,870,15,30,124253,30,870,0,0,0,0,0
0.901,6,24,6616,13,339,75,1037,2219,11,988,87,1691,4397
1744.634,6,95,7203,63,38,28139,205,4476,32,33,56272,98,2727
4.006,6,11,467,6,0,801,0,248,5,7,743,7,219
0.094,17,8,2454,8,278,13,317,2454,0,0,0,0,0
0.118,17,4,1379,4,316,39,355,1379,0,0,0,0,0
1162.986,6,85,11117,53,90,22365,501,4290,32,197,37512,1420,6827
1797.762,6,370,33167,180,332,10043,841,12568,190,58,9502,1418,20599
0.177,6,10,1187,6,145,35,145,389,4,634,52,634,798
30.321,17,5,380,5,48,7580,48,380,0,0,0,0,0
0.819,17,15,8388,8,705,117,1350,5871,7,331,127,1350,2517
1602.844,1,42,2352,42,28,39093,28,2352,0,0,0,0,0
2.039,17,17,6760,8,480,291,1350,4065,9,271,196,1350,2695
9.969,6,1494,1319303,931,1366,10,1380,1291553,563,421,17,1923,27750
2.456,17,2,685,1,308,0,308,336,1,321,0,321,349
0.248,6,21,5000,10,137,27,267,1092,11,692,24,1467,3908
1683.637,1,8,448,8,28,240519,28,448,0,0,0,0,0
60.334,6,6,364,4,31,20111,31,222,2,31,60320,31,142
0.087,17,2,154,1,33,0,33,61,1,65,0,65,93
0.455,6,49,19999,27,983,17,1380,14877,22,421,19,1923,5122
1786.685,6,121,15177,78,81,23203,501,6070,43,189,42537,1420,9107
1745.172,6,103,6666,63,47,28147,208,4074,40,31,44739,31,2592
133.95,6,21,8224,11,549,86,1309,2120,10,948,14863,1591,6104
1757.135,1,59,4956,59,56,30295,56,4956,0,0,0,0,0
422.804,6,364,313161,243,1341,1747,1408,288959,121,559,3215,2816,24202
301.286,6,89,57411,52,396,5907,986,4297,37,1550,894,4104,53114
876.238,17,18,6093,18,310,51543,342,6093,0,0,0,0,0
0.755,6,17,5132,9,150,94,174,664,8,828,95,1420,4468
1772.837,6,180,15480,120,69,14897,69,8940,60,69,30039,69,6540
4.954,17,5,738,4,32,1328,32,240,1,470,0,470,498
46.027,17,4,542,2,36,46022,36,128,2,179,46023,187,414
1779.831,1,342,28728,342,56,5219,56,28728,0,0,0,0,0
0.134,17,4,364,2,52,0,52,160,2,74,86,80,204
0.364,6,10,1840,5,901,91,901,1169,5,403,90,403,671
7.584,6,422,318400,202,337,37,337,13255,220,1359,34,1368,305145
0.896,6,28,8496,15,222,55,540,2000,13,994,60,2720,6496
280.173,6,24,7054,11,181,28017,267,1168,13,670,23346,2036,5886
0.403,6,13,1096,7,256,65,256,544,6,304,78,304,552
1786.948,6,105,8610,70,66,25897,66,5110,35,60,52553,60,3500
1772.825,6,180,15480,120,69,14897,69,8940,60,69,30047,69,6540
21.105,1,40,7960,0,0,0,0,0,40,171,541,548,7960
3.865,17,4,352,2,48,3854,48,152,2,72,3854,72,200
293.649,1,4,326,4,53,97883,78,326,0,0,0,0,0
12.963,17,5,5443,5,1060,3240,1451,5443,0,0,0,0,0
0.232,17,2,1920,2,932,232,932,1920,0,0,0,0,0
11.026,6,20,4442,11,275,1102,275,998,9,768,776,1440,3444
1.263,6,50,20234,28,895,46,1360,14578,22,433,51,1360,5656
1792.19,6,388,39781,222,187,8109,789,21423,166,150,10860,645,18358
293.561,17,4,240,2,32,293560,32,120,2,32,293560,32,120
869.626,6,36,2616,24,31,37809,31,1620,12,31,79055,31,996
1797.733,6,356,22520,208,69,8684,69,12460,148,69,12229,69,10060
840.577,17,8,2196,4,30,280190,30,232,4,463,280189,463,1964
59.822,17,6,360,3,32,29910,32,180,3,32,29910,32,180
366.777,6,23,1535,16,177,24451,177,1053,7,110,10359,110,482
0.472,17,4,820,2,36,468,36,128,2,318,467,318,692
240.123,6,42,5388,21,235,12005,752,2763,21,169,12005,657,2625
0.428,6,56,24344,32,986,13,1380,17174,24,515,16,1923,7170
0.404,6,10,968,5,256,97,256,460,5,304,97,304,508
1775.983,17,73,3060,72,14,25013,14,3024,1,8,0,8,36
1786.223,17,87,3648,86,14,21014,14,3612,1,8,0,8,36
1735.987,1,72,6048,0,0,0,0,0,72,56,24450,56,6048
136.733,6,42,8398,20,117,7196,267,1862,22,332,6510,1452,6536
2.031,17,2,672,2,308,2031,308,672,0,0,0,0,0
11.165,6,1623,1458204,990,1417,11,1432,1426221,633,427,17,1432,31983
26.705,6,20,1670,9,275,3338,275,922,11,96,1553,96,748
35.788,17,20,1760,10,48,3975,48,760,10,72,3974,72,1000
1796.828,1,345,28980,345,56,5223,56,28980,0,0,0,0,0
1679.981,1,8,848,8,78,239997,78,848,0,0,0,0,0
10.848,6,20,4442,11,275,1084,275,998,9,768,763,1440,3444
3.399,6,2,88,2,0,0,0,88,0,0,0,0,0
1770.772,6,101,9344,66,65,27242,65,5577,35,59,52078,59,3767
1789.46,17,142,11360,71,48,25563,48,5396,71,56,25563,56,5964
1740.372,17,30,20190,30,645,60012,645,20190,0,0,0,0,0
1773.912,6,180,15480,120,69,14906,69,8940,60,69,30057,69,6540
97.229,6,31,14071,15,859,84,1360,5801,16,952,6470,1360,8270
150.999,17,4,240,2,32,150998,32,120,2,32,150998,32,120
300.677,6,69,51688,46,1264,6681,1408,45396,23,636,2798,1491,6292
1793.505,17,180,11520,180,36,10019,36,11520,0,0,0,0,0
0.636,6,17,4523,10,327,64,634,1836,7,575,100,1328,2687
1.413,6,47,18742,26,927,56,1460,13126,21,433,61,1460,5616
1785.284,1,59,4956,59,56,30780,56,4956,0,0,0,0,0
81.448,6,18,740,8,0,4470,0,324,10,0,9048,0,416
1798.988,1,345,28980,345,56,5229,56,28980,0,0,0,0,0
1788.878,6,130,11282,82,65,22084,205,6806,48,41,38055,98,4476
287.362,6,29,1987,14,344,22104,344,1128,15,83,20525,83,859
722.564,2,4,128,4,8,240854,8,128,0,0,0,0,0
1588.753,1,8,448,8,28,226964,28,448,0,0,0,0,0
0.043,17,6,912,3,60,14,60,264,3,188,11,188,648
0.077,17,2,549,1,30,0,30,58,1,463,0,463,491
1740.475,17,30,6930,30,203,60016,203,6930,0,0,0,0,0
2.066,17,3,174,3,30,1033,30,174,0,0,0,0,0
0.425,6,20,7196,12,325,38,626,1932,8,1210,59,1906,5264
1772.948,6,180,15480,120,69,14898,69,8940,60,69,30041,69,6540
1280.396,6,110,15569,63,128,20651,721,7532,47,236,27830,2840,8037
0.593,6,189,257903,92,183,6,230,5341,97,2605,4,5608,252562
841.724,6,167,13027,93,133,8547,469,7859,74,69,11530,69,5168
4.276,6,38,7245,20,218,225,314,3423,18,516,236,1179,3822
1781.765,6,363,24345,211,88,8484,469,13987,152,69,11799,69,10358
88.031,6,97,70888,62,1261,1443,1448,59994,35,697,2464,1448,10894
9.78,6,10,795,6,176,1956,176,496,4,83,3245,83,299
37.859,6,50,10507,23,533,714,910,3159,27,312,1451,1360,7348
16.086,2,2,64,2,8,16086,8,64,0,0,0,0,0
1778.61,17,140,11200,70,48,25776,48,5320,70,56,25776,56,5880
1745.155,6,146,16316,89,121,19831,205,11525,57,32,31159,33,4791
1.002,17,19,8637,9,594,125,1350,5605,10,275,106,1350,3032
280.229,6,26,7272,12,158,25475,267,1277,14,775,21552,3445,5995
31.124,1,36,3744,0,0,0,0,0,36,76,889,76,3744
0.348,17,6,2047,6,313,69,354,2047,0,0,0,0,0
4.269,17,5,295,5,31,1067,31,295,0,0,0,0,0
0.073,17,4,304,2,37,0,37,130,2,59,42,65,174
0.301,17,2,152,1,48,0,48,76,1,48,0,48,76
3.083,6,49,32826,30,965,106,1360,11848,19,2525,164,5440,20978
1799.327,17,140,11200,70,48,26077,48,5320,70,56,26077,56,5880
299.978,1,4,224,4,28,99992,28,224,0,0,0,0,0
7.762,6,1406,1120280,734,1424,10,1448,1073964,672,776,11,1448,46316
1796.442,6,169,13475,91,94,19960,208,9425,78,31,23324,31,4050
16.817,17,24,10107,12,558,1523,1350,7042,12,227,1520,1350,3065
9.984,6,87,26661,44,549,232,1152,20459,43,447,230,1179,6202
1799.055,17,144,11520,72,48,25338,48,5472,72,56,25338,56,6048
5.038,17,4,288,2,36,5007,36,128,2,52,5006,52,160
12.921,6,25,5330,14,233,981,613,1901,11,569,1274,1440,3429
300.589,6,73,53877,48,1246,6395,1368,47398,25,738,1327,1571,6479
0.118,6,13,1749,7,253,19,500,878,6,275,23,500,871
300.549,6,42,8762,22,286,14311,766,2116,20,388,441,2720,6646
13.48,17,4,352,2,60,13479,60,176,2,60,13479,60,176
1741.61,1,15,840,15,28,124400,28,840,0,0,0,0,0
0.024,17,2,672,2,308,24,308,672,0,0,0,0,0
1772.18,6,180,15480,120,69,14892,69,8940,60,69,30031,69,6540
3.805,17,10,2459,5,40,948,40,340,5,395,948,423,2119
2.106,6,13,2311,8,188,300,245,700,5,1407,463,1407,1611
25.065,6,2379,2232065,1486,1423,16,1448,2180917,893,776,27,1448,51148
1.26,6,48,18963,27,873,48,1360,13347,21,476,54,2715,5616
0.088,17,2,586,1,46,0,46,74,1,484,0,484,512
5.584,6,40,7309,20,218,293,314,3423,20,513,280,1179,3886
276.08,17,4,240,2,32,276079,32,120,2,32,276079,32,120
1786.597,17,87,3648,86,14,21018,14,3612,1,8,0,8,36
75.868,6,32,7653,13,155,6322,267,1306,19,398,4214,3417,6347
5.909,6,47,8489,24,227,256,314,4142,23,427,257,1152,4347
445.404,6,85,12781,44,123,10358,721,5462,41,378,11106,1440,7319
31.8,6,8,348,2,0,5,0,84,6,0,6359,0,264
1729.433,6,65,4748,42,33,42181,33,2889,23,31,78602,31,1859
0.75,17,16,6313,7,425,125,1350,3171,9,321,50,1350,3142
40.267,6,26,6336,15,117,2876,159,1389,11,873,4024,1669,4947
280.237,6,30,7432,13,158,23353,267,1317,17,543,17512,1300,6115
166.686,6,30,14326,15,433,88,990,1991,15,1065,11897,1360,12335
1.269,6,29,7572,14,150,97,267,1615,15,764,84,1452,5957
323.613,1,4,464,4,88,107871,88,464,0,0,0,0,0
10.837,17,7,7693,7,1071,1806,1449,7693,0,0,0,0,0
280.532,6,27,7312,12,158,25502,267,1277,15,678,20035,2045,6035
71.744,6,21,8794,11,333,76,692,1497,10,1147,7956,2720,7297
1776.345,17,73,3060,72,14,25018,14,3024,1,8,0,8,36
10.597,6,2120,2023469,1346,1426,7,1448,1978545,774,776,13,1448,44924
1.066,6,24,8004,12,164,82,267,1288,12,1014,82,2804,6716
1771.211,6,407,27398,188,46,9438,46,11600,219,46,8124,46,15798
29.55,6,22,3107,6,331,5908,599,1007,16,212,1969,212,2100
370.871,6,18,1242,14,180,28528,180,916,4,110,20071,110,326
1771.631,6,99,9306,66,66,27255,66,5610,33,60,55360,60,3696
11.695,17,3,984,3,300,5847,300,984,0,0,0,0,0
280.246,6,28,7352,12,158,25476,267,1277,16,603,18678,1400,6075
902.376,2,6,192,6,8,180475,8,192,0,0,0,0,0
1797.528,6,369,25799,215,99,8399,469,15085,154,69,11747,69,10714
251.558,2,3,96,3,8,125779,8,96,0,0,0,0,0
1786.806,17,140,11200,70,48,25895,48,5320,70,56,25895,56,5880
0.341,6,27,8922,13,232,28,567,1612,14,939,25,1438,7310
0.509,17,3,451,2,39,204,39,134,1,289,0,289,317
0.041,6,3,120,1,0,0,0,40,2,0,0,0,80
10.762,6,18,4214,10,275,1195,275,958,8,974,849,1414,3256
129.27,17,4,244,2,33,129269,33,122,2,33,129269,33,122
1793.905,6,201,26642,110,304,16457,304,18292,91,83,19932,83,8350
1796.847,1,345,28980,345,56,5223,56,28980,0,0,0,0,0
1797.989,17,448,39896,403,35,4472,288,25676,45,288,40017,288,14220
280.215,6,29,7392,13,158,23351,267,1317,16,603,18679,1400,6075
2.238,17,2,204,1,34,0,34,62,1,114,0,114,142
0.592,1,10,280,10,0,0,0,280,0,0,0,0,0
1761.48,17,167,13976,155,30,11438,37,9032,12,384,154708,463,4944
1794.143,17,180,11520,180,36,10023,36,11520,0,0,0,0,0
599.432,6,9,546,6,31,119886,31,333,3,31,299694,31,213
1782.321,1,238,13328,238,28,7520,28,13328,0,0,0,0,0
31.962,6,7,396,1,0,0,0,60,6,0,6322,0,336
94.067,6,619,586689,222,172,425,703,13640,397,1416,237,2804,573049
33.451,6,27,4886,14,180,2573,722,1806,13,480,2770,2026,3080
33.502,6,32,5348,16,154,2233,722,1912,16,371,2221,2026,3436
1797.852,1,58,4872,0,0,0,0,0,58,56,31541,56,4872
1771.19,6,99,9174,66,64,27249,64,5544,33,58,55347,58,3630
289.368,1,4,224,4,28,96456,28,224,0,0,0,0,0
1773.58,6,180,15480,120,69,14904,69,8940,60,69,30054,69,6540
1740.46,17,30,31620,30,1026,60015,1026,31620,0,0,0,0,0
0.015,17,4,768,2,39,9,39,134,2,289,11,289,634
265.561,6,29,7392,13,158,22130,267,1317,16,603,17701,2036,6075
1798.495,6,355,22480,207,69,8730,69,12420,148,69,12234,69,10060
1.414,6,45,16793,24,848,61,1460,11177,21,476,61,2615,5616
0.18,6,26,7256,13,155,15,267,1301,13,678,14,3436,5955
0.038,6,2,84,1,0,0,0,44,1,0,0,0,40
1740.202,6,87,6322,58,31,30529,31,3915,29,31,62149,31,2407
31.1,17,2,462,2,203,31100,360,462,0,0,0,0,0
35.259,6,9,529,5,45,8814,45,313,4,0,11750,0,216
98.005,17,7,3312,3,308,49002,308,1008,4,548,30054,548,2304
131.252,17,4,1344,4,308,43750,308,1344,0,0,0,0,0
1754.221,6,174,10604,89,45,19934,208,6305,85,31,20880,31,4299
0.289,17,2,268,1,54,0,54,82,1,158,0,158,186
1664.771,1,8,448,8,28,237824,28,448,0,0,0,0,0
123.738,6,32,7723,12,156,29,267,1272,20,376,6512,3417,6451
1790.988,6,280,33151,113,132,15989,1460,15983,167,126,10787,1460,17168
0.561,6,12,2084,6,288,78,288,560,6,424,78,434,1524
0.645,6,7,295,4,0,215,0,164,3,7,202,7,131
1.933,17,2,672,2,308,1933,308,672,0,0,0,0,0
1785.438,17,142,11360,71,48,25506,48,5396,71,56,25506,56,5964
304.118,6,28,5296,12,168,14949,516,1495,16,242,20268,1452,3801
74.845,6,22,896,10,0,5948,0,404,12,0,6802,0,492
0.376,6,10,968,5,256,90,256,460,5,304,90,304,508
1.349,6,36,11965,19,633,74,1360,4607,17,606,72,1360,7358
0.033,17,2,347,1,29,0,29,57,1,262,0,262,290
3.943,17,5,290,5,30,985,30,290,0,0,0,0,0
372.458,6,68,15325,32,605,12014,1408,10149,36,218,10641,580,5176
226.914,6,31,7472,13,158,18909,267,1317,18,543,13344,1380,6155
61.338,6,37,15983,22,805,2920,1408,9205,15,665,4362,1408,6778
96.944,6,852,424477,471,840,206,1152,403050,381,412,254,1179,21427
0.014,17,2,393,1,58,0,58,86,1,279,0,279,307
98.122,6,15,1083,4,177,124,177,393,11,110,9794,110,690
0.009,17,2,214,1,47,0,47,75,1,111,0,111,139
7.973,6,22,11317,8,275,1139,275,874,14,898,443,1440,10443
0.241,17,2,152,1,48,0,48,76,1,48,0,48,76
214.634,6,78,55498,50,1208,4380,1368,47306,28,841,2288,2519,8192
240.355,17,4,956,2,33,240330,34,123,2,388,240341,427,833
140.653,17,3,365,2,114,140653,156,284,1,53,0,53,81
300.58,6,17,1175,6,177,60079,177,497,11,110,30040,110,678
5.429,6,652,557175,395,1340,13,1368,539147,257,931,20,2736,18028
41.614,6,11,480,8,0,5944,0,348,3,0,15017,0,132
0.517,6,205,189598,78,262,6,517,5900,127,1439,3,2896,183698
1786.582,6,102,8364,68,66,26665,66,4964,34,60,54135,60,3400
1785.858,6,367,25112,213,94,8423,469,14536,154,69,11672,69,10576
1797.42,17,180,14040,180,50,10041,50,14040,0,0,0,0,0
1771.117,6,99,9240,66,65,27247,65,5577,33,59,55343,59,3663
0.025,17,2,120,1,32,0,32,60,1,32,0,32,60
1787.113,6,356,22520,208,69,8633,69,12460,148,69,12156,69,10060
1.064,6,658,671189,218,194,4,230,12123,440,1452,2,2896,659066
0.17,6,27,7296,13,155,14,267,1301,14,603,12,2800,5995
280.085,6,30,7432,13,158,23340,267,1317,17,543,17500,1400,6115
104.637,6,38,26503,17,512,18,1018,2428,21,1435,5231,6858,24075
0.594,17,4,624,2,64,593,64,184,2,192,480,192,440
5.0,17,37,15993,17,484,312,1350,8719,20,335,212,1350,7274
1.672,6,10,1687,7,100,278,100,384,3,1179,703,1179,1303
0.47,6,7,388,4,0,156,0,216,3,0,231,0,172
1797.076,6,208,22628,133,75,13614,267,10246,75,137,24284,4837,12382
176.852,6,14,5624,6,112,35370,112,360,8,822,25211,1460,5264
1782.382,17,220,54119,220,217,8138,422,54119,0,0,0,0,0
1786.767,17,19,6612,19,320,99264,1437,6612,0,0,0,0,0
0.492,6,10,1669,6,551,98,947,1346,4,159,163,159,323
299.539,6,6,364,4,31,99846,31,222,2,31,299515,31,142
1683.333,17,14,1036,7,30,280549,30,406,7,62,280542,62,630
240.278,6,55,18058,29,763,8580,1418,15250,26,206,9610,580,2808
54.493,6,16,1163,8,39,7784,39,455,8,48,7784,63,708
300.974,6,51,26921,27,816,11575,1402,8785,24,1125,1518,2874,18136
1740.386,6,91,6604,59,31,30006,31,3998,32,31,56141,31,2606
180.026,6,22,8517,11,316,69,639,1420,11,949,17989,1440,7097
92.152,6,22,7994,11,511,88,1194,2005,11,791,9197,1440,5989
1245.308,6,72,5856,48,65,26495,65,3480,24,59,54140,59,2376
3.123,17,3,1176,3,364,1561,364,1176,0,0,0,0,0
2.274,6,27,7438,15,333,162,1007,2273,12,780,206,1731,5165
0.094,17,4,284,2,32,55,32,120,2,54,61,60,164
11.493,6,6,328,4,0,3831,0,216,2,0,11293,0,112
0.014,17,2,312,1,32,0,32,60,1,224,0,224,252
1772.489,6,177,15222,118,69,15149,69,8791,59,69,30554,69,6431
0.128,6,16,4036,10,101,14,101,629,6,771,25,1500,3407
0.468,6,57,24554,33,997,14,1380,17384,24,515,18,1923,7170
1798.024,17,447,39580,403,35,4472,288,25676,44,288,40948,288,13904
0.742,6,26,5680,14,121,57,267,1295,12,650,61,1420,4385
1.419,6,25,8056,12,164,110,267,1288,13,1014,101,2491,6768
0.157,6,10,1514,5,503,39,503,771,5,475,39,475,743
26.443,6,19,2050,9,165,3305,722,1448,10,27,2910,45,602
4.981,17,4,288,2,36,4979,36,128,2,52,4980,52,160
10.4,6,6,328,4,0,3466,0,216,2,0,10380,0,112
0.189,17,2,198,1,63,0,63,91,1,79,0,79,107
10.204,6,67,20646,33,559,318,1152,15859,34,489,301,1179,4787
793.141,6,89,6136,32,46,25585,46,2568,57,46,14160,46,3568
16.6,17,26,5833,13,238,1380,1350,3468,13,153,1380,1350,2365
1791.366,1,188,10528,188,28,9579,28,10528,0,0,0,0,0
0.008,17,4,352,2,60,6,60,176,2,60,2,60,176
1771.015,6,113,10400,71,66,25300,66,6092,42,60,43192,60,4308
155.721,17,4,240,2,32,155719,32,120,2,32,155720,32,120
1788.354,6,356,22520,208,69,8639,69,12460,148,69,12165,69,10060
1680.411,1,15,840,15,28,120029,28,840,0,0,0,0,0
2.114,17,2,201,1,35,0,35,63,1,110,0,110,138
1.1,6,26,9564,14,164,71,267,1440,12,1070,84,2816,8124
367.381,6,25,1651,17,177,22961,177,1117,8,110,9200,110,534
1752.175,17,104,6656,104,36,17011,36,6656,0,0,0,0,0
1791.171,17,144,11520,72,48,25227,48,5472,72,56,25227,56,6048
5.156,17,4,1560,4,362,1718,548,1560,0,0,0,0,0
94.304,6,22,8961,11,514,83,1236,2014,11,927,9412,1460,6947
931.507,1,22,1232,22,28,44357,28,1232,0,0,0,0,0
69.109,6,56,20108,30,641,2377,1360,12154,26,690,2757,3494,7954
0.584,6,14,1745,7,288,69,288,600,7,426,69,434,1145
14.592,6,29,5801,14,180,1105,722,1832,15,398,1029,1408,3969
298.091,2,2,64,2,8,298091,8,64,0,0,0,0,0
241.287,6,139,123766,65,575,3770,1402,7988,74,1805,3305,4206,115778
1791.277,1,74,7844,74,78,24538,78,7844,0,0,0,0,0
300.719,6,45,9079,23,316,13669,888,2290,22,368,715,3488,6789
56.551,6,30,7303,14,156,4350,267,1352,16,441,3769,1420,5951
917.467,6,78,10844,43,104,19381,498,3812,35,187,26981,1420,7032
109.065,17,4,240,2,32,109064,32,120,2,32,109064,32,120
0.035,17,2,167,1,39,0,39,67,1,72,0,72,100
0.056,6,10,1514,5,503,13,503,771,5,475,14,475,743
0.323,17,2,290,1,40,0,40,68,1,194,0,194,222
0.057,1,2,163,2,53,57,78,163,0,0,0,0,0
0.042,17,4,304,2,37,0,37,130,2,59,5,65,174
185.236,17,4,352,2,60,185235,60,176,2,60,185235,60,176
3.406,6,218,186462,135,1305,23,1408,181957,83,94,41,158,4505
142.831,6,30,7432,13,158,11902,267,1317,17,543,8924,1400,6115
1.374,6,3,1560,1,0,0,0,40,2,1440,326,1440,1520
316.954,6,105,35812,55,562,5869,1360,24737,50,302,6465,1360,11075
0.094,17,2,144,1,36,0,36,64,1,52,0,52,80
1792.158,1,342,28728,342,56,5255,56,28728,0,0,0,0,0
0.211,6,9,1340,5,145,52,145,349,4,827,39,827,991
722.269,6,34,2636,25,36,30094,93,1920,9,31,71732,31,716
20.296,6,20,2484,10,189,2255,517,1298,10,323,2250,499,1186
1.522,6,19,3781,10,234,169,564,1452,9,463,166,1343,2329
0.049,17,2,152,1,48,0,48,76,1,48,0,48,76
1792.137,6,192,25269,106,304,17067,304,17452,86,83,21083,83,7817
0.045,17,2,657,2,300,45,301,657,0,0,0,0,0
0.282,6,7,466,5,43,60,43,354,2,0,279,0,112
11.911,6,88,26557,44,545,277,1152,20315,44,447,271,1179,6242
0.327,17,2,152,1,48,0,48,76,1,48,0,48,76
14.425,6,6,690,0,0,0,0,0,6,90,2885,90,690
1656.514,1,8,448,8,28,236644,28,448,0,0,0,0,0
3.847,17,2,176,2,60,3847,60,176,0,0,0,0,0
0.026,1,4,416,0,0,0,0,0,4,76,8,76,416
0.428,6,13,1693,7,288,71,288,588,6,284,44,434,1105
1636.713,1,7,392,7,28,272785,28,392,0,0,0,0,0
4.376,6,38,7229,19,218,243,314,3383,19,513,228,1179,3846
38.133,6,42,10130,20,706,466,1360,4386,22,346,1807,1360,5744
1788.43,17,87,3648,86,14,21040,14,3612,1,8,0,8,36
0.512,17,15,8575,8,729,70,1350,6059,7,331,72,1350,2516
14.136,17,39,11742,12,447,1284,1350,5705,27,195,542,1350,6037
0.585,6,10,968,5,256,142,256,460,5,304,142,304,508
0.226,17,8,2758,8,316,32,355,2758,0,0,0,0,0
1791.337,17,179,13962,179,50,10063,50,13962,0,0,0,0,0
1.084,6,23,7952,12,164,84,267,1288,11,1216,92,3819,6664
1745.691,1,9,504,9,28,218211,28,504,0,0,0,0,0
1793.651,17,265,53119,265,172,6794,358,53119,0,0,0,0,0
0.337,17,8,2758,8,316,48,355,2758,0,0,0,0,0
0.263,6,46,20414,26,1023,10,1420,15393,20,467,13,1883,5021
4.06,17,5,295,5,31,1015,31,295,0,0,0,0,0
6.279,6,13,1815,6,100,1255,100,344,7,1179,1001,1179,1471
1771.26,1,60,5040,60,56,30021,56,5040,0,0,0,0,0
1793.799,17,144,11520,72,48,25264,48,5472,72,56,25264,56,6048
15.608,17,12,5935,6,584,3115,1350,3674,6,348,3115,1350,2261
1750.167,17,12,498,11,14,175016,14,462,1,8,0,8,36
0.199,6,27,7296,13,155,16,267,1301,14,543,14,1400,5995
1800.0,6,199,13894,71,46,25714,46,5830,128,46,14172,46,8064
0.352,17,2,204,1,34,0,34,62,1,114,0,114,142
0.007,17,2,359,1,44,0,44,72,1,259,0,259,287
55.49,6,31,8912,14,158,4268,267,1357,17,763,3455,2076,7555
58.183,6,51,15278,25,1023,645,1460,9281,26,290,2320,1460,5997
8.582,6,80,24709,39,559,225,1152,18912,41,461,207,1179,5797
0.054,6,12,963,7,181,9,181,541,5,77,12,133,422
280.563,6,29,7392,13,158,23380,267,1317,16,603,18697,2036,6075
1694.922,1,7,392,7,28,282487,28,392,0,0,0,0,0
39.757,17,22,1936,11,48,3974,48,836,11,72,3974,72,1100
0.001,17,2,312,1,64,0,64,92,1,192,0,192,220
0.014,17,2,227,1,31,0,31,59,1,140,0,140,168
0.251,6,27,6202,13,181,20,537,1578,14,486,18,1408,4624
1177.203,6,208,27881,106,174,11211,721,17653,102,211,11653,1420,10228
1.007,6,23,6395,13,310,83,889,2075,10,979,111,1731,4320
16.953,17,29,12466,16,595,1127,1350,9976,13,163,1409,1350,2490
10.111,17,4,1312,4,300,3370,300,1312,0,0,0,0,0
115.507,6,164,125724,103,1281,1132,1408,113044,61,730,1765,3847,12680
94.553,17,4,1344,4,308,31517,308,1344,0,0,0,0,0
628.608,1,14,784,14,28,48354,28,784,0,0,0,0,0
1709.494,1,8,448,8,28,244213,28,448,0,0,0,0,0
260.371,17,6,2304,6,356,52074,356,2304,0,0,0,0,0
2.421,17,2,685,1,308,0,308,336,1,321,0,321,349
0.036,17,4,284,2,32,24,32,120,2,54,19,60,164
12.626,6,1903,1687514,1187,1367,10,1380,1652676,716,468,17,3303,34838
1.679,6,14,2351,8,188,239,245,700,6,703,286,1152,1651
1.739,6,25,8754,15,283,124,582,1454,10,985,172,1420,7300
0.788,6,26,9039,13,266,65,705,1750,13,943,64,1438,7289
4.314,6,4,1600,2,0,4314,0,80,2,1440,1660,1440,1520
1773.241,6,180,15480,120,69,14901,69,8940,60,69,30050,69,6540
1.311,6,47,21036,27,956,50,1360,15460,20,476,58,2720,5576
1772.217,6,180,15480,120,69,14892,69,8940,60,69,30031,69,6540
1772.884,6,180,15480,120,69,14898,69,8940,60,69,30041,69,6540
1704.373,17,30,2562,15,31,121739,37,898,15,82,121739,136,1664
1102.718,1,53,2968,53,28,21206,28,2968,0,0,0,0,0
0.067,17,2,245,1,32,0,32,60,1,157,0,157,185
1772.422,6,180,15480,120,69,14894,69,8940,60,69,30040,69,6540
1798.835,6,359,25816,206,97,8774,965,14310,153,81,11831,485,11506
0.23,6,23,6673,10,181,19,267,1128,13,627,18,1400,5545
32.628,6,10,648,1,0,0,0,40,9,31,3447,31,608
1.236,6,138,80978,94,845,13,1360,74785,44,631,24,2744,6193
1771.936,6,101,9344,66,65,27260,65,5577,35,59,52113,59,3767
1619.321,1,7,742,7,78,269886,78,742,0,0,0,0,0
1.404,6,24,6636,13,350,116,1089,2276,11,783,139,1420,4360
244.343,6,33,11994,16,717,16289,1408,4447,17,948,15221,1578,7547
217.004,6,31,8912,14,158,16692,267,1357,17,687,13559,1781,7555
1772.392,6,180,15480,120,69,14894,69,8940,60,69,30033,69,6540
1795.167,17,324,77603,324,211,5557,371,77603,0,0,0,0,0
300.838,6,49,13761,25,844,12534,1460,7844,24,290,651,1460,5917
70.039,6,30,7505,11,166,7003,267,1115,19,374,3890,3417,6390
5.582,6,24,2088,15,256,398,256,1408,9,304,696,304,680
3.832,6,32,6526,18,133,225,267,2061,14,650,289,1420,4465
18.507,6,22,5092,11,402,1850,721,2189,11,387,1504,1448,2903
1681.433,17,12,498,11,14,168143,14,462,1,8,0,8,36
1773.304,6,180,15480,120,69,14901,69,8940,60,69,30047,69,6540
1799.6,17,448,39896,403,35,4476,288,25676,45,288,40022,288,14220
144.02,17,8,2688,8,308,20574,308,2688,0,0,0,0,0
280.348,6,29,7392,13,158,23362,267,1317,16,603,18685,1400,6075
36.903,17,4,352,2,48,36894,48,152,2,72,36894,72,200
20.85,6,9,931,2,91,20850,91,171,7,96,3449,160,760
227.004,6,321,255731,199,1303,1146,1368,237088,122,614,1603,2519,18643
1684.335,17,14,3652,7,31,280721,37,413,7,434,280721,463,3239
1770.541,6,99,9240,66,65,27239,65,5577,33,59,55325,59,3663
118.516,6,10,2215,4,908,787,908,1080,6,298,23703,422,1135
1772.501,6,180,15480,120,69,14894,69,8940,60,69,30036,69,6540
1798.347,17,448,39896,403,35,4473,288,25676,45,288,40018,288,14220
76.243,6,36,10115,12,162,635,267,1463,24,452,3314,1460,8652
0.012,17,2,144,1,36,0,36,64,1,52,0,52,80
0.523,6,23,7397,13,334,43,663,2021,10,1209,54,2736,5376
5.106,17,4,558,2,36,5097,36,128,2,187,5096,187,430
0.01,17,2,366,1,37,0,37,65,1,273,0,273,301
4.146,17,5,295,5,31,1036,31,295,0,0,0,0,0
0.177,6,46,20818,26,1052,7,1420,15797,20,467,8,1883,5021
364.341,6,18,1239,14,177,28026,177,913,4,110,20062,110,326
0.227,6,2,364,1,0,0,0,40,1,272,0,272,324
3.021,17,2,176,2,60,3021,60,176,0,0,0,0,0
301.257,6,44,13367,22,720,14337,1360,7394,22,338,14337,2667,5973
280.269,6,29,7392,14,158,21559,267,1357,15,678,20013,3436,6035
22.719,6,31,9903,12,131,2065,214,929,19,683,1232,1702,8974
0.154,6,27,7296,13,155,12,267,1301,14,603,11,2800,5995
0.67,6,10,924,5,283,113,283,551,5,105,112,105,373
280.032,6,32,7512,15,158,20002,267,1397,17,543,17499,1400,6115
1747.004,6,96,7286,63,38,28177,205,4476,33,33,54584,98,2810
300.917,6,44,10200,23,433,13678,910,3154,21,387,763,2720,7046
0.019,6,32,7991,17,131,1,131,1023,15,475,1,578,6968
0.369,6,27,9086,13,257,30,667,1715,14,947,28,1408,7371
280.103,6,29,7392,14,158,21546,267,1357,15,678,20000,3436,6035
61.669,6,60,41862,39,1185,1622,1408,34038,21,960,3071,3847,7824
1770.429,6,112,10354,71,66,25291,66,6038,41,60,44258,60,4316
1778.24,6,107,8718,68,64,26540,64,4896,39,58,46793,58,3822
554.41,6,20,1431,13,31,46200,31,850,7,31,92382,31,581
442.637,6,29,5353,11,189,11008,516,1390,18,215,26032,1452,3963
1776.306,6,181,15589,120,69,14926,69,8940,61,69,29603,69,6649
1772.78,6,180,15480,120,69,14897,69,8940,60,69,30040,69,6540
1754.416,1,119,6664,119,28,14867,28,6664,0,0,0,0,0
584.465,1,6,336,6,28,116893,28,336,0,0,0,0,0
17.477,6,18,2477,11,211,1747,211,1018,7,545,2137,904,1459
1793.571,17,144,11520,72,48,25261,48,5472,72,56,25261,56,6048
1788.482,1,268,15008,268,28,6698,28,15008,0,0,0,0,0
1.38,6,41,9968,21,440,69,1360,4392,20,476,62,2715,5576
1.109,6,14,1978,8,127,158,127,559,6,545,11,990,1419
0.306,6,26,9041,13,261,25,683,1752,13,1100,23,2816,7289
230.743,17,4,352,2,60,230742,60,176,2,60,230741,60,176
372.085,6,18,1242,14,180,28621,180,916,4,110,20066,110,326
7.624,6,16,2431,9,125,953,245,740,7,703,1180,1152,1691
8.066,6,1650,1531443,1050,1381,7,1408,1495579,600,931,13,2816,35864
3.001,6,11,2231,7,188,500,245,660,4,1407,172,1407,1571
26.468,17,41,16362,18,506,1554,1350,9615,23,265,1201,1350,6747
0.028,6,10,1634,5,131,6,131,399,5,967,6,967,1235
0.426,6,14,1733,7,288,68,288,588,7,426,40,434,1145
8.908,6,1612,1482123,1018,1378,8,1408,1446571,594,776,14,1408,35552
240.176,6,53,17631,28,779,8895,1408,14710,25,201,10007,580,2921
1702.433,1,8,448,8,28,243204,28,448,0,0,0,0,0
36.7,17,44,6468,22,48,1744,48,1672,22,190,1744,308,4796
5.908,17,3,1008,3,308,2954,308,1008,0,0,0,0,0
66.74,6,28,7352,13,158,5561,267,1317,15,678,4763,3436,6035
1799.573,17,450,39448,405,34,4454,288,25476,45,282,40021,288,13972
1782.84,6,241,24492,98,67,18378,659,9254,143,133,12554,4558,15238
1793.158,6,770,52318,385,31,4669,31,26311,385,31,4669,31,26007
280.391,6,23,7014,10,181,31154,267,1128,13,670,23363,1400,5886
228.265,17,4,352,2,60,228264,60,176,2,60,228264,60,176
1.068,6,29,8500,15,222,64,540,1964,14,852,68,1360,6536
16.675,17,16,5298,7,360,2766,1350,2716,9,258,2073,1350,2582
0.187,6,46,21511,26,1102,7,1420,16490,20,467,9,1883,5021
1774.385,6,185,16025,120,69,14910,69,8940,65,69,27722,69,7085
0.018,17,4,632,3,60,6,60,264,1,340,0,340,368
1.382,6,39,9888,21,440,69,1360,4392,18,476,70,2715,5496
1495.75,6,251,17062,107,46,14110,46,7162,144,46,10458,46,9900
1793.363,6,361,22996,209,69,8621,69,12500,152,69,11876,69,10496
4.617,6,40,7325,20,218,243,314,3423,20,516,229,1179,3902
11.712,6,1794,1615801,1097,1420,10,1432,1583700,697,420,16,1432,32101
10.984,6,18,4266,10,275,1220,275,958,8,992,887,1440,3308
35.894,6,6,328,4,0,11964,0,216,2,0,35873,0,112
14.874,6,23,4856,10,309,1652,722,1752,13,342,1217,1408,3104
1781.765,6,361,24734,211,94,8484,469,14387,150,69,11958,69,10347
1775.583,6,194,34517,124,304,14435,304,25612,70,83,25733,83,8905
1741.394,6,87,6322,58,31,30550,31,3915,29,31,62192,31,2407
1795.044,17,448,39896,403,35,4465,288,25676,45,288,40016,288,14220
2.845,6,22,7004,12,185,258,275,1041,10,694,263,1380,5963
70.641,6,25,9908,12,549,59,1460,2709,13,952,5875,1460,7199
1765.496,17,48,16080,48,307,37563,308,16080,0,0,0,0,0
1788.411,1,194,10864,194,28,9266,28,10864,0,0,0,0,0
7.0,17,3,2145,3,687,3500,687,2145,0,0,0,0,0
1771.8,6,99,9306,66,66,27258,66,5610,33,60,55365,60,3696
1.367,6,41,10025,22,502,65,1460,4444,19,437,64,2615,5581
1117.26,6,92,6000,48,53,23771,208,3589,44,31,25959,31,2411
0.116,6,11,1971,6,451,23,500,1222,5,481,28,481,749
0.159,17,2,1920,2,932,159,932,1920,0,0,0,0,0
4.769,6,15,2391,9,125,596,245,740,6,1407,903,1407,1651
280.698,6,31,7472,14,158,21592,267,1357,17,543,17539,1400,6115
60.449,6,9,820,5,226,15112,226,494,4,110,20067,110,326
1799.811,17,144,11520,72,48,25349,48,5472,72,56,25349,56,6048
755.961,2,6,192,6,8,151192,8,192,0,0,0,0,0
1796.02,1,58,4872,0,0,0,0,0,58,56,31509,56,4872
3.06,6,71,16891,36,508,87,1429,6143,35,405,80,1986,10748
1771.917,6,180,15480,120,69,14890,69,8940,60,69,30032,69,6540
0.026,17,4,764,3,60,5,60,264,1,472,0,472,500
456.97,6,78,15602,38,361,3545,819,8487,40,193,11715,2301,7115
1742.604,6,97,7307,63,38,28106,205,4476,34,33,52800,98,2831
4.857,6,41,7349,22,218,231,314,3503,19,513,255,1179,3846
0.036,17,2,348,1,39,0,39,67,1,253,0,253,281
149.695,6,73,51865,47,1215,3254,1408,43777,26,841,2467,2439,8088
0.091,17,4,284,2,32,87,32,120,2,54,87,60,164
369.727,6,27,1767,18,177,21748,177,1181,9,110,8835,110,586
23.006,6,34,8218,16,175,1533,722,2045,18,778,1341,2760,6173
0.83,17,4,368,2,32,815,32,120,2,96,816,96,248
1788.417,17,87,3648,86,14,21040,14,3612,1,8,0,8,36
120.382,2,3,96,3,8,60191,8,96,0,0,0,0,0
35.463,17,20,1520,20,48,1866,48,1520,0,0,0,0,0
68.555,6,25,7097,12,155,6232,267,1266,13,589,5710,3426,5831
9.711,6,710,655310,472,1322,20,1368,638270,238,776,40,1473,17040
1799.263,17,449,39928,404,35,4464,288,25708,45,288,40021,288,14220
0.01,6,13,4282,7,111,1,111,483,6,1159,2,1863,3799
11.465,6,1852,1584273,1097,1389,10,1420,1549828,755,467,15,1883,34445
0.177,6,3,144,2,0,74,0,104,1,0,0,0,40
0.013,17,3,544,2,60,1,60,176,1,340,0,340,368
0.927,17,4,368,2,32,926,32,120,2,96,822,96,248
1740.704,17,30,6930,30,203,60024,203,6930,0,0,0,0,0
240.29,6,46,9208,24,523,10447,1408,5966,22,232,11442,618,3242
0.889,6,11,1008,6,256,176,256,500,5,304,219,304,508
13.951,6,28,4917,13,154,1142,721,1766,15,394,981,1368,3151
1739.941,6,87,6322,58,31,30525,31,3915,29,31,62140,31,2407
11.834,6,1725,1627354,1154,1362,10,1380,1600272,571,383,20,1380,27082
14.597,6,14,2245,8,211,2080,211,846,6,545,2909,904,1399
1681.24,17,14,3843,7,30,280205,30,406,7,463,280205,463,3437
16.239,17,34,17710,17,728,1012,1350,12862,17,257,1012,1350,4848
1795.172,17,465,41572,406,36,4432,288,26100,59,234,30749,288,15472
287.323,6,31,3137,16,324,19154,585,1497,15,282,20522,580,1640
0.8,6,10,1687,7,100,133,100,384,3,1179,268,1179,1303
1.419,6,48,19024,26,945,56,1460,13368,22,433,58,1460,5656
4.938,6,39,7269,20,218,259,314,3423,19,513,260,1179,3846
1777.387,17,73,3060,72,14,25033,14,3024,1,8,0,8,36
9.201,6,14,2245,8,211,1309,211,846,6,545,1839,904,1399
1772.049,1,58,4872,0,0,0,0,0,58,56,31088,56,4872
1682.846,17,14,1036,7,30,280467,30,406,7,62,280465,62,630
1792.001,6,356,22520,208,69,8656,69,12460,148,69,12190,69,10060
1.334,6,10,1687,7,100,222,100,384,3,1179,533,1179,1303
243.33,6,491,399506,201,690,1216,1408,22928,290,1353,841,2816,376578
2.81,6,2,88,2,0,0,0,88,0,0,0,0,0
0.323,6,10,1380,5,145,80,145,349,5,827,76,827,1031
1763.948,2,13,416,13,8,146995,8,416,0,0,0,0,0
0.184,17,2,194,1,61,0,61,89,1,77,0,77,105
0.257,17,3,507,2,39,30,39,134,1,345,0,345,373
0.382,17,6,2078,6,318,76,354,2078,0,0,0,0,0
2.945,17,2,1430,2,687,2945,687,1430,0,0,0,0,0
1742.072,6,95,7203,63,38,28097,205,4476,32,33,56187,98,2727
3.887,17,4,244,4,33,1295,33,244,0,0,0,0,0
1789.84,6,202,22250,130,75,13874,267,10126,72,135,25203,1460,12124
1781.762,6,362,22898,210,69,8525,69,12678,152,69,11799,69,10220
11.205,6,6,328,4,0,3735,0,216,2,0,11145,0,112
1798.494,17,449,39928,404,35,4462,288,25708,45,288,40017,288,14220
1.385,6,50,19602,27,913,53,1460,13906,23,433,53,1460,5696
390.698,17,6,528,3,60,195348,60,264,3,60,195348,60,264
136.072,6,27,11428,14,624,58,1360,3714,13,1197,11326,2720,7714
1515.415,17,120,9600,60,48,25684,48,4560,60,56,25684,56,5040
0.932,6,10,968,5,256,229,256,460,5,304,229,304,508
1.66,6,31,8956,16,319,100,561,2598,15,820,106,1440,6358
17.065,6,44,9054,21,419,853,944,2227,23,346,591,1928,6827
34.012,17,20,1760,10,48,3778,48,760,10,72,3778,72,1000
280.26,6,25,7232,12,158,25478,267,1277,13,905,23353,4845,5955
1787.359,6,106,8388,68,64,26677,64,4896,38,58,48304,58,3492
1751.313,17,58,2430,57,14,31273,14,2394,1,8,0,8,36
1797.389,17,448,39896,403,35,4471,288,25676,45,288,40024,288,14220
5.174,1,9,936,0,0,0,0,0,9,76,646,76,936
1794.36,17,144,11520,72,48,25272,48,5472,72,56,25272,56,6048
37.749,6,21,6786,4,156,3020,267,638,17,420,2358,1420,6148
1784.482,6,354,22440,206,69,8704,69,12380,148,69,12139,69,10060
10.296,6,71,21259,36,554,294,1152,16416,35,491,295,1179,4843
280.349,6,28,7352,12,158,25486,267,1277,16,603,18680,1400,6075
35.927,17,20,1760,10,48,3991,48,760,10,72,3990,72,1000
202.412,6,20,6558,3,106,29,106,234,17,375,12650,1420,6324
0.046,17,2,166,1,39,0,39,67,1,71,0,71,99
1744.692,2,28,896,28,8,64618,8,896,0,0,0,0,0
10.203,6,30,8872,14,158,784,267,1357,16,763,675,2036,7515
1787.383,6,102,8364,68,66,26677,66,4964,34,60,54152,60,3400
1786.726,6,104,8444,68,66,26667,66,4964,36,60,51046,60,3480
1796.447,6,367,25650,214,99,8434,469,15045,153,69,11818,69,10605
1793.695,6,86,5484,43,31,42643,36,2334,43,304,42707,445,3150
1771.045,6,101,9410,66,66,27246,66,5610,35,60,52087,60,3800
1.022,17,3,286,2,46,997,46,148,1,110,0,110,138
279.99,6,30,7432,13,158,23332,267,1317,17,543,17497,1400,6115
0.544,6,50,21433,28,947,20,1380,16311,22,468,23,3303,5122
123.564,2,4,128,4,8,41188,8,128,0,0,0,0,0
1773.376,6,180,15480,120,69,14902,69,8940,60,69,30050,69,6540
1.237,17,4,464,3,64,610,64,276,1,160,0,160,188
1795.256,6,415,24880,207,69,8714,69,12420,208,34,8672,64,12460
1795.539,17,189,45651,189,213,9550,422,45651,0,0,0,0,0
0.45,6,26,7751,16,339,30,949,3017,10,721,47,1460,4734
195.24,6,27,7312,12,158,17749,267,1277,15,678,13942,2045,6035
240.449,6,52,20130,26,1059,9617,1408,17261,26,167,9617,580,2869
1.353,6,43,11188,23,575,61,1360,5567,20,437,62,2715,5621
661.767,2,7,224,7,8,110294,8,224,0,0,0,0,0
240.525,6,54,17412,29,765,8587,1418,14533,25,196,10018,580,2879
65.098,6,29,14889,15,510,4649,1440,4370,14,1087,4973,1440,10519
0.001,6,2,80,0,0,0,0,0,2,0,0,0,80
1652.705,1,7,392,7,28,275450,28,392,0,0,0,0,0
1.622,6,29,10365,17,367,101,833,1785,12,1012,139,1420,8580
19.23,17,32,22405,17,637,1199,1350,11307,15,711,1371,1350,11098
1740.47,17,30,31680,30,1028,60016,1028,31680,0,0,0,0,0
1773.512,6,205,22508,131,75,13642,267,10097,74,134,24288,3417,12411
61.299,6,35,15821,22,799,2919,1408,9147,13,855,5087,3847,6674
2.826,17,4,524,2,39,2782,39,134,2,167,2768,167,390
0.864,6,10,1687,7,100,144,100,384,3,1179,307,1179,1303
1789.913,6,356,22520,208,69,8646,69,12460,148,69,12174,69,10060
1777.464,1,58,7711,58,104,31183,320,7711,0,0,0,0,0
1781.779,6,362,22898,210,69,8525,69,12678,152,69,11799,69,10220
40.084,1,46,4784,0,0,0,0,0,46,76,890,76,4784
4.833,6,40,7325,21,218,241,314,3463,19,516,254,1179,3862
275.413,17,4,352,2,60,275412,60,176,2,60,275411,60,176
122.471,17,8,6911,8,835,17495,1451,6911,0,0,0,0,0
31.878,6,7,308,1,0,0,0,44,6,0,6324,0,264
7.342,6,1387,1288038,880,1387,8,1408,1256998,507,931,14,2816,31040
0.033,17,2,672,2,308,33,308,672,0,0,0,0,0
1750.209,6,95,7203,63,38,28229,205,4476,32,33,56442,98,2727
126.495,6,29,6578,14,166,9730,501,1560,15,490,9028,1420,5018
1791.518,17,142,11360,71,48,25593,48,5396,71,56,25593,56,5964
1744.411,6,96,7255,62,38,28596,205,4424,34,33,52852,98,2831
2.401,6,35,8420,19,308,133,888,2026,16,522,150,3488,6394
1799.998,6,217,15008,81,46,22076,46,6256,136,46,13333,46,8752
251.956,2,3,96,3,8,125978,8,96,0,0,0,0,0
9.509,6,49,17461,25,273,395,561,3301,24,942,405,1440,14160
274.961,6,27,5268,17,137,17185,267,1400,10,692,32,1467,3868
0.038,17,3,1007,1,137,0,137,165,2,393,37,393,842
300.834,6,42,13681,23,892,13674,1360,8119,19,399,480,1360,5562
1.47,6,45,17657,26,849,58,1360,12121,19,476,70,2715,5536
0.092,17,2,558,1,32,0,32,60,1,470,0,470,498
1789.601,17,87,3648,86,14,21054,14,3612,1,8,0,8,36
0.02,17,2,152,2,48,20,48,152,0,0,0,0,0
0.644,6,14,1745,7,288,79,288,600,7,426,78,434,1145
34.617,1,40,4160,0,0,0,0,0,40,76,887,76,4160
0.105,6,10,1495,5,507,26,507,727,5,556,26,556,768
353.725,6,49,9261,26,120,14149,766,2401,23,329,924,1928,6860
1771.158,6,99,9240,66,65,27248,65,5577,33,59,55346,59,3663
1799.598,1,275,15400,275,28,6567,28,15400,0,0,0,0,0
152.293,17,4,352,2,60,152292,60,176,2,60,152292,60,176
0.003,17,2,204,1,34,0,34,62,1,114,0,114,142
0.575,17,2,672,2,308,575,308,672,0,0,0,0,0
2.141,6,11,975,6,304,428,304,624,5,83,529,83,351
252.473,2,2,64,2,8,252473,8,64,0,0,0,0,0
1657.182,1,8,448,8,28,236740,28,448,0,0,0,0,0
10.093,6,78,24341,39,550,265,1152,18640,39,459,257,1179,5701
1764.199,2,14,448,14,8,135707,8,448,0,0,0,0,0
280.361,6,30,7432,13,158,23363,267,1317,17,543,17512,1400,6115
5.759,6,23,6515,11,280,568,517,1422,12,744,516,1368,5093
1663.481,6,275,20797,166,107,10081,469,13194,109,69,11624,69,7603
280.455,6,29,7392,13,158,23371,267,1317,16,603,18692,1400,6075
1.3,6,52,19831,29,920,46,1360,14090,23,400,50,1360,5741
0.228,6,28,7336,13,155,19,267,1301,15,543,15,1300,6035
0.052,17,2,2070,2,1007,52,1007,2070,0,0,0,0,0
1.045,6,31,12098,17,522,65,1360,3338,14,818,66,1373,8760
1799.944,17,142,11360,71,48,25713,48,5396,71,56,25713,56,5964
1779.864,6,354,22440,207,69,8640,69,12420,147,69,12190,69,10020
300.815,2,4,128,4,8,100271,8,128,0,0,0,0,0
741.325,17,84,7017,78,30,9627,37,4545,6,384,136319,463,2472
1783.808,6,373,26635,211,105,8494,469,15394,162,69,11079,69,11241
1792.747,17,87,3648,86,14,21091,14,3612,1,8,0,8,36
3.983,17,3,699,3,205,1991,205,699,0,0,0,0,0
0.037,17,4,368,2,32,30,32,120,2,96,26,96,248
0.05,17,2,441,1,36,0,36,64,1,349,0,349,377
179.94,2,3,96,3,8,89970,8,96,0,0,0,0,0
1740.246,6,210,20382,103,81,17061,721,9741,107,171,16415,1440,10641
8.587,17,3,228,3,48,4293,48,228,0,0,0,0,0
33.245,6,4857,4433532,2953,1414,11,1448,4320752,1904,776,17,1448,112780
1.022,6,12,1048,6,256,202,256,500,6,304,202,304,548
11.754,6,1890,1619150,1142,1363,10,1380,1584976,748,383,15,1380,34174
1313.523,6,158,17702,86,90,15451,721,8580,72,194,18497,1414,9122
66.625,6,72,48060,45,1174,1514,1448,39927,27,746,2368,1448,8133
1772.842,6,180,15480,120,69,14897,69,8940,60,69,30041,69,6540
0.165,1,6,624,0,0,0,0,0,6,76,33,76,624
57.122,17,52,7880,26,48,2284,48,1976,26,199,2284,308,5904
5.187,6,13,6919,4,416,1729,416,596,9,1190,616,1440,6323
300.852,6,62,30517,33,190,9401,444,2557,29,1149,8723,2816,27960
8.105,17,21,6066,8,274,1157,1350,2416,13,252,510,1350,3650
1438.653,17,115,9196,58,48,25239,48,4408,57,56,25688,56,4788
1.415,6,24,8004,12,164,110,267,1288,12,1014,108,2491,6716
280.287,6,29,7392,13,158,23357,267,1317,16,603,18682,1400,6075
25.946,6,31,8912,14,158,1995,267,1357,17,687,1617,1400,7555
1782.485,6,114,9282,72,66,25105,66,5322,42,60,43471,60,3960
36.892,17,40,5880,20,48,1941,48,1520,20,190,1940,308,4360
1772.595,6,180,15480,120,69,14895,69,8940,60,69,30035,69,6540
1.071,6,30,10223,18,356,63,802,1794,12,993,89,1452,8429
1.333,6,53,19432,29,889,47,1360,13651,24,437,50,2715,5781
4.984,17,4,306,2,36,4967,36,128,2,61,4969,70,178
0.461,6,48,21188,27,1071,17,1380,16106,21,468,21,3303,5082
0.07,17,2,1920,2,932,70,932,1920,0,0,0,0,0
173.207,6,173,134213,106,1330,1649,1448,121230,67,632,1936,1448,12983
4.733,17,26,7416,10,230,525,1350,2581,16,274,214,1350,4835
1787.914,6,357,22629,208,69,8637,69,12460,149,69,12080,69,10169
1787.113,6,104,8308,68,64,26673,64,4896,36,58,51058,58,3412
1.209,6,50,18906,27,864,46,1360,13210,23,433,47,1360,5696
1790.37,6,358,22738,209,69,8607,69,12569,149,69,12096,69,10169
5.47,6,13,2311,8,188,781,245,700,5,1407,1300,1407,1611
0.163,6,46,21614,27,1035,6,1420,16633,19,467,8,1883,4981
125.45,6,13,3115,7,92,20908,92,476,6,580,25042,2026,2639
1786.157,17,87,3648,86,14,21013,14,3612,1,8,0,8,36
0.009,6,2,133,1,0,0,0,40,1,53,0,53,93
274.674,6,12,764,8,92,39239,92,516,4,0,1541,0,248
1744.667,2,16,512,16,8,116311,8,512,0,0,0,0,0
3.385,17,5,295,5,31,846,31,295,0,0,0,0,0
1679.693,2,16,512,16,8,111979,8,512,0,0,0,0,0
79.242,6,21,9925,11,380,69,832,1613,10,1316,8789,3928,8312
0.204,6,49,22484,28,1016,7,1420,17411,21,467,9,1883,5073
1.124,6,11,1727,7,100,187,100,384,4,589,290,1152,1343
319.26,6,10,750,7,106,53210,106,606,3,0,1511,0,144
0.931,6,10,1687,7,100,155,100,384,3,1179,336,1179,1303
1719.437,17,12,498,11,14,171943,14,462,1,8,0,8,36
33.719,6,6,328,4,0,11239,0,216,2,0,33449,0,112
1790.775,1,342,28728,342,56,5251,56,28728,0,0,0,0,0
59.607,6,22,6907,4,154,11010,267,632,18,426,3505,1997,6275
1.879,6,34,9353,17,145,117,267,1848,17,974,111,1460,7505
1788.587,1,58,4872,0,0,0,0,0,58,56,31378,56,4872
2.261,6,17,5215,8,150,323,174,624,9,704,264,1452,4591
1.377,6,36,8172,19,320,76,1162,2716,17,476,75,2715,5456
240.211,6,53,17829,28,794,8896,1408,14973,25,193,10008,580,2856
1746.711,6,95,7203,63,38,28172,205,4476,32,33,56333,98,2727
0.021,17,2,243,1,63,0,63,91,1,124,0,124,152
0.084,17,2,2382,2,1163,84,1163,2382,0,0,0,0,0
4.09,6,3,239,1,0,0,0,40,2,83,703,83,199
10.944,6,18,5610,10,275,1216,275,958,8,1440,853,1440,4652
182.155,6,18,5839,10,784,20239,1360,3538,8,247,25990,272,2301
246.591,6,43,15414,18,1021,14504,1418,12187,25,208,10274,580,3227
1784.558,6,102,8296,68,65,26635,65,4930,34,59,54074,59,3366
1797.761,17,121,47069,121,361,14981,361,47069,0,0,0,0,0
1720.693,17,13,534,11,14,172051,14,462,2,8,1720516,8,72
15.575,6,1186,1105135,728,1438,21,1448,1074775,458,776,33,1448,30360
1785.858,6,356,22520,208,69,8627,69,12460,148,69,12148,69,10060
31.374,17,4,352,2,60,31372,60,176,2,60,31372,60,176
0.092,17,2,144,1,36,0,36,64,1,52,0,52,80
1747.019,6,107,8025,69,38,25691,205,4850,38,32,47208,98,3175
180.529,2,3,96,3,8,90264,8,96,0,0,0,0,0
1770.468,6,99,9240,66,65,27237,65,5577,33,59,55324,59,3663
5.007,17,4,514,2,36,5002,36,128,2,165,5001,187,386
240.205,6,54,18396,29,783,8578,1402,15623,25,183,10008,580,2773
122.812,6,30,7573,9,155,458,267,1146,21,348,6140,1420,6427
0.853,6,21,5988,12,281,77,544,1328,9,716,95,1420,4660
381.462,6,24,1551,14,177,29343,177,913,10,110,10495,110,638
44.948,6,46,10249,22,533,723,910,3083,24,344,1948,1360,7166
0.431,6,24,5987,12,164,39,453,1442,12,652,38,1408,4545
5.028,6,16,3082,6,288,970,288,560,10,422,539,434,2522
1779.955,17,140,11200,70,48,25796,48,5320,70,56,25796,56,5880
0.011,17,2,180,1,30,0,30,58,1,94,0,94,122
1770.763,6,109,10133,71,65,25296,65,6056,38,59,47856,59,4077
1783.848,1,73,6132,73,56,24775,56,6132,0,0,0,0,0
18.129,17,28,10654,12,338,1645,1350,4399,16,362,1206,1350,6255
154.741,6,1043,539921,590,850,262,1152,517010,453,435,341,1179,22911
1.571,6,38,8254,19,321,87,1164,2718,19,433,77,1360,5536
0.884,6,13,3939,7,171,133,171,714,6,964,175,1448,3225
108.495,6,24,8933,12,703,73,1460,3324,12,852,9847,1553,5609
1794.239,17,180,14040,180,50,10023,50,14040,0,0,0,0,0
0.287,17,2,172,1,50,0,50,78,1,66,0,66,94
0.162,17,2,180,1,30,0,30,58,1,94,0,94,122
1789.144,6,365,23087,211,69,8519,69,12787,154,69,11691,69,10300
1741.342,17,30,31680,30,1028,60046,1028,31680,0,0,0,0,0
3.297,6,26,11637,14,284,253,584,1416,12,1081,282,1420,10221
0.008,17,2,359,1,44,0,44,72,1,259,0,259,287
349.967,6,95,13163,46,160,6733,1189,4574,49,254,7290,1420,8589
103.916,6,25,10716,13,746,63,1360,3536,12,1114,9434,3068,7180
128.992,6,31,8912,14,158,9922,267,1357,17,687,8053,2036,7555
1791.604,1,162,9072,162,28,11127,28,9072,0,0,0,0,0
1799.332,17,82,3435,80,13,22774,14,3355,2,12,1799153,16,80
1740.854,17,157,33247,157,183,11159,422,33247,0,0,0,0,0
1783.81,6,358,22669,209,69,8575,69,12500,149,69,12052,69,10169
1798.089,1,345,28980,345,56,5227,56,28980,0,0,0,0,0
11.906,6,1623,1527725,1058,1370,11,1408,1493681,565,931,20,2801,34044
1770.964,6,99,9240,66,65,27245,65,5577,33,59,55339,59,3663
287.697,17,4,352,2,60,287696,60,176,2,60,287696,60,176
1793.934,1,58,4872,0,0,0,0,0,58,56,31472,56,4872
6.736,6,40,7698,20,218,354,314,3423,20,433,340,1152,4275
13.418,6,16,2297,9,324,1677,585,1125,7,396,2143,580,1172
1797.397,6,366,25610,213,99,8478,469,15005,153,69,11822,69,10605
9.569,6,52,37019,34,1157,289,1368,30715,18,1072,548,2519,6304
1772.285,6,180,15480,120,69,14893,69,8940,60,69,30033,69,6540
0.157,6,24,7176,12,155,14,267,1261,12,775,13,3445,5915
216.305,17,4,352,2,60,216304,60,176,2,60,216304,60,176
127.09,6,7,426,2,106,127080,106,194,5,0,31770,0,232
5.015,17,4,288,2,36,5001,36,128,2,52,5004,52,160
3.893,17,4,304,4,48,1297,48,304,0,0,0,0,0
11.475,6,1814,1585382,1103,1384,10,1420,1552721,711,467,16,1883,32661
70.027,6,36,8161,18,311,526,619,1687,18,478,4109,2128,6474
31.754,6,6,360,0,0,0,0,0,6,0,0,0,360
0.205,17,7,1532,4,64,66,64,368,3,360,100,360,1164
0.116,6,10,767,5,186,28,186,454,5,45,12,45,313
12.857,17,4,352,2,60,12856,60,176,2,60,12856,60,176
0.123,17,4,284,2,32,119,32,120,2,54,116,60,164
138.42,17,6,2016,6,308,27684,308,2016,0,0,0,0,0
45.217,6,13,2133,8,324,6459,585,1073,5,396,11281,580,1060
1.54,6,21,7203,13,318,128,600,1958,8,964,187,1471,5245
0.01,6,3,478,2,179,0,267,438,1,0,0,0,40
1788.864,6,356,22520,208,69,8641,69,12460,148,69,12169,69,10060
98.019,6,25,7770,8,272,257,516,1140,17,424,6120,1452,6630
1.101,6,31,12092,17,518,68,1360,3318,14,820,70,1380,8774
1775.019,17,138,11040,69,48,26102,48,5244,69,56,26103,56,5796
65.075,6,36,23935,19,840,39,1360,5835,17,1740,4057,4080,18100
755.953,2,5,160,5,8,188988,8,160,0,0,0,0,0
44.206,17,4,352,2,60,44205,60,176,2,60,44205,60,176
1798.169,17,449,39928,404,35,4461,288,25708,45,288,40019,288,14220
5.002,17,4,304,4,48,1667,48,304,0,0,0,0,0
4.134,6,5,248,4,0,1378,0,208,1,0,0,0,40
1790.504,1,50,2800,50,28,36540,28,2800,0,0,0,0,0
1798.843,17,447,39580,403,35,4474,288,25676,44,288,40951,288,13904
202.605,17,6,528,3,60,101302,60,264,3,60,101302,60,264
368.484,6,27,1767,18,177,21675,177,1181,9,110,8919,110,586
154.583,6,22,10160,11,433,52,990,1771,11,1133,15446,2568,8389
0.114,17,4,334,2,39,69,39,134,2,72,1,72,200
253.163,17,32,3302,28,30,9376,37,1638,4,388,64510,463,1664
8.917,6,1321,1240372,848,1413,10,1432,1214026,473,559,18,1871,26346
1.015,1,10,840,10,56,112,56,840,0,0,0,0,0
1789.763,6,370,26253,209,98,8604,469,14983,161,69,11185,69,11270
27.751,6,18,1407,9,222,3467,222,808,9,231,3466,231,599
363.989,17,6,528,3,60,181994,60,264,3,60,181994,60,264
125.333,6,34,7935,12,155,30,267,1266,22,340,5967,3417,6669
0.903,6,27,8506,15,229,53,583,2007,12,1201,66,3151,6499
0.04,6,4,160,2,0,40,0,80,2,0,2,0,80
4.225,17,5,295,5,31,1056,31,295,0,0,0,0,0
13.222,6,24,6993,13,275,1101,275,1078,11,910,821,1440,5915
103.879,6,28,7352,12,158,9443,267,1277,16,543,6922,1400,6075
1782.866,6,104,8424,68,64,26609,64,4896,36,58,50936,58,3528
840.555,17,43,1803,42,13,20501,14,1759,1,16,0,16,44
1.761,6,25,6082,13,108,146,147,959,12,773,137,1608,5123
176.24,2,2,64,2,8,176240,8,64,0,0,0,0,0
1.244,6,10,1687,7,100,207,100,384,3,1179,486,1179,1303
0.014,17,2,454,1,37,0,37,65,1,361,0,361,389
15.297,17,16,5076,7,355,2543,1350,2683,9,237,1907,1350,2393
0.458,6,21,7203,12,318,39,600,1906,9,964,55,1471,5297
0.899,6,30,9155,17,448,56,1460,3401,13,746,58,1547,5754
2.493,17,6,761,3,31,1232,31,177,3,166,1241,196,584
1585.363,1,172,9632,172,28,9271,28,9632,0,0,0,0,0
2.221,17,4,610,3,39,846,39,201,1,381,0,381,409
0.431,6,12,1653,6,288,79,288,548,6,426,47,434,1105
47.605,17,4,352,2,60,47604,60,176,2,60,47604,60,176
1792.513,17,140,11200,70,48,25978,48,5320,70,56,25978,56,5880
1756.372,6,183,11234,92,47,19300,208,6695,91,31,19512,31,4539
1745.504,6,96,7286,63,38,28153,205,4476,33,33,54538,98,2810
2.333,6,13,3151,7,145,388,145,429,6,826,256,826,2722
0.012,17,3,1167,3,361,6,371,1167,0,0,0,0,0
1795.786,1,168,9408,168,28,10753,28,9408,0,0,0,0,0
1779.297,6,225,19990,84,85,21435,375,9268,141,70,12708,1062,10722
1786.04,6,364,23047,211,69,8504,69,12718,153,69,11750,69,10329
2.141,17,5,1272,3,40,1070,41,206,2,505,912,505,1066
282.731,1,4,224,4,28,94243,28,224,0,0,0,0,0
1796.436,6,362,22967,210,69,8595,69,12678,152,69,11893,69,10289
1795.281,17,80,3354,79,14,23016,14,3318,1,8,0,8,36
760.776,1,26,3212,26,95,30431,320,3212,0,0,0,0,0
26.125,6,35,9211,17,321,1632,722,2936,18,616,1476,2760,6275
54.519,6,13,2311,5,188,13629,245,580,8,1407,7748,1407,1731
2.999,17,3,264,3,60,1499,60,264,0,0,0,0,0
0.635,17,8,2750,8,315,90,354,2750,0,0,0,0,0
1678.547,1,15,840,15,28,119896,28,840,0,0,0,0,0
1751.76,1,138,14628,138,78,12786,78,14628,0,0,0,0,0
1.383,6,51,21492,29,915,49,1360,15836,22,476,57,2715,5656
1.067,1,10,840,10,56,118,56,840,0,0,0,0,0
1787.315,6,356,22520,208,69,8634,69,12460,148,69,12157,69,10060
5.734,6,45,8409,22,227,273,314,4062,23,427,248,1152,4347
5.812,6,45,8409,23,227,264,314,4102,22,427,264,1152,4307
0.005,17,2,427,1,39,0,39,67,1,332,0,332,360
1748.541,6,183,21720,95,72,18601,721,7695,88,233,20094,1414,14025
0.055,6,11,913,6,182,11,182,490,5,77,3,134,423
1.376,6,45,18643,26,925,55,1460,13107,19,476,65,2615,5536
1.373,6,51,19863,29,925,49,1360,14162,22,437,56,2720,5701
1798.112,17,443,38884,400,35,4506,288,25296,43,288,41870,288,13588
13.291,17,4,352,2,48,13281,48,152,2,72,13281,72,200
1745.282,1,56,4704,56,56,31732,56,4704,0,0,0,0,0
0.297,6,20,5908,11,281,28,517,1705,9,745,35,1448,4203
15.669,17,16,6421,8,484,2233,1350,4098,8,262,2233,1350,2323
280.861,6,33,9597,15,158,20061,267,1397,18,679,16517,2036,8200
1741.028,6,87,6322,58,31,30544,31,3915,29,31,62178,31,2407
297.172,17,4,240,2,32,297171,32,120,2,32,297171,32,120
932.904,6,95,8147,62,71,15293,138,4688,33,69,29152,69,3459
0.243,6,10,1669,6,551,48,947,1346,4,159,81,159,323
103.309,17,10,800,5,48,25825,48,380,5,56,25825,56,420
261.808,1,7,764,7,81,43634,88,764,0,0,0,0,0
1786.825,6,102,8296,68,65,26669,65,4930,34,59,54143,59,3366
0.263,17,2,266,1,41,0,41,69,1,169,0,169,197
0.941,17,4,368,2,64,938,64,184,2,64,940,64,184
24.603,6,118,48973,67,691,372,1360,36595,51,491,489,1360,12378
0.002,6,2,635,1,0,0,0,40,1,555,0,555,595
26.186,1,4,224,4,28,8728,28,224,0,0,0,0,0
1.732,6,49,19650,27,920,66,1360,13994,22,433,72,1360,5656
280.571,6,27,7312,12,158,25506,267,1277,15,775,20032,2760,6035
171.526,6,38,2417,21,69,8568,69,1323,17,69,10720,69,1094
1779.133,17,140,11200,70,48,25784,48,5320,70,56,25784,56,5880
0.345,17,2,136,1,32,0,32,60,1,48,0,48,76
1702.698,1,8,448,8,28,243242,28,448,0,0,0,0,0
4.186,17,4,268,4,39,1395,39,268,0,0,0,0,0
4.33,6,37,7189,19,218,240,314,3383,18,513,239,1179,3806
11.046,6,9,488,5,0,2761,0,280,4,0,2321,0,208
1.299,6,11,1727,7,100,216,100,384,4,589,348,1152,1343
1750.991,6,94,7151,62,38,28704,205,4424,32,33,56471,98,2727
33.539,6,29,4990,14,180,2579,722,1807,15,342,2382,2026,3183
19.36,6,26,7137,12,155,1760,267,1266,14,530,1488,2006,5871
1744.685,2,27,864,27,8,67103,8,864,0,0,0,0,0
6.47,6,1186,937715,616,1423,10,1448,899239,570,776,10,1448,38476
4.651,17,25,6601,10,220,516,1350,2483,15,246,225,1350,4118
1790.574,1,58,4872,58,56,31413,56,4872,0,0,0,0,0
1740.943,1,15,840,15,28,124353,28,840,0,0,0,0,0
7.186,17,35,8182,10,252,798,1350,2805,25,187,298,1350,5377
0.179,6,5,272,0,0,0,0,0,5,0,0,0,272
1.366,6,47,18160,26,882,54,1440,12544,21,433,59,1440,5616
2.879,17,4,324,2,34,2872,34,124,2,72,2871,72,200
372.38,6,23,1499,14,177,28644,177,913,9,110,9805,110,586
1798.948,17,449,39928,404,35,4463,288,25708,45,288,40019,288,14220
1.601,6,78,55900,46,1274,35,1440,48295,32,842,45,1440,7605
20.95,6,20,3130,12,183,1904,517,1561,8,381,2991,499,1569
1779.757,6,354,22440,207,69,8639,69,12420,147,69,12189,69,10020
0.48,17,2,152,1,48,0,48,76,1,48,0,48,76
240.375,6,53,18276,27,875,9244,1418,15425,26,186,9614,580,2851
0.413,6,17,4511,10,327,45,634,1836,7,575,67,1328,2675
240.484,6,9,528,2,112,240470,112,200,7,0,40078,0,328
1791.599,17,179,13962,179,50,10065,50,13962,0,0,0,0,0
378.276,2,4,128,4,8,126092,8,128,0,0,0,0,0
1789.089,17,367,62600,367,142,4888,366,62600,0,0,0,0,0
0.022,6,11,3650,6,170,3,170,490,5,1446,4,2675,3160
1771.261,6,102,9711,68,69,26436,233,5914,34,59,53671,82,3797
3.37,6,6,340,3,0,1685,0,160,3,0,1011,0,180
1788.727,17,87,3648,86,14,21043,14,3612,1,8,0,8,36
1.309,6,51,19359,29,889,46,1460,13658,22,400,54,1460,5701
1786.656,6,356,22520,208,69,8631,69,12460,148,69,12154,69,10060
240.145,6,53,16844,28,743,8894,1408,14107,25,178,10005,580,2737
2.082,6,30,10405,18,367,122,833,1825,12,1012,181,1420,8580
1.486,6,38,8252,19,320,82,1162,2716,19,433,62,1460,5536
630.56,2,5,160,5,8,157640,8,160,0,0,0,0,0
1134.9,2,7,224,7,8,189150,8,224,0,0,0,0,0
0.246,6,22,4442,11,165,24,456,1394,11,493,24,888,3048
12.709,6,13,2133,8,324,1815,585,1073,5,396,3164,580,1060
32.009,6,4,434,1,267,0,267,307,3,7,16000,7,127
370.506,6,16,1418,11,226,37050,226,1036,5,110,15491,110,382
1797.097,1,292,30952,292,78,6175,78,30952,0,0,0,0,0
3.184,17,5,290,5,30,796,30,290,0,0,0,0,0
50.604,6,27,7177,13,155,4217,267,1306,14,530,3891,2840,5871
1.535,17,2,144,1,36,0,36,64,1,52,0,52,80
1699.476,17,12,498,11,14,169947,14,462,1,8,0,8,36
1741.562,2,22,704,22,8,82931,8,704,0,0,0,0,0
240.208,6,53,17590,28,781,8896,1418,14743,25,192,10008,580,2847
61.799,6,54,32920,33,1111,1931,1448,25073,21,749,3076,1448,7847
0.855,6,26,5887,13,156,71,267,1462,13,650,65,1414,4425
0.036,17,2,374,1,47,0,47,75,1,271,0,271,299
7.326,6,29,7464,12,155,666,267,1266,17,423,457,2840,6198
1797.012,6,360,22956,208,69,8681,69,12460,152,69,11900,69,10496
300.951,6,24,9072,13,393,25065,1236,2125,11,927,30078,1460,6947
408.903,6,25,2202,18,180,24053,180,1492,7,110,12141,110,710
1.548,17,15,7156,7,476,246,1350,3529,8,425,209,1350,3627
48.217,17,10,13740,10,1346,5357,1348,13740,0,0,0,0,0
372.189,6,18,1242,14,180,28629,180,916,4,110,20065,110,326
282.834,6,30,7432,13,158,23569,267,1317,17,603,17674,2076,6115
1682.743,17,14,1036,7,30,280451,30,406,7,62,280450,62,630
1750.658,17,12,498,11,14,175065,14,462,1,8,0,8,36
1783.292,17,290,60104,290,179,6170,422,60104,0,0,0,0,0
43.242,17,25,12190,11,467,4316,1350,5452,14,453,3320,1350,6738
0.151,17,4,284,2,32,139,32,120,2,54,15,60,164
1784.98,17,83,3480,82,14,22036,14,3444,1,8,0,8,36
0.032,17,2,290,1,40,0,40,68,1,194,0,194,222
158.637,1,4,224,4,28,52879,28,224,0,0,0,0,0
474.303,6,49,10357,26,209,18972,1189,3567,23,390,2937,1460,6790
0.438,17,2,152,1,48,0,48,76,1,48,0,48,76
1789.958,6,360,24156,210,88,8564,469,13878,150,69,12013,69,10278
8.941,6,1318,1216463,862,1364,10,1420,1193932,456,427,19,1420,22531
1793.109,6,387,24069,214,69,8418,69,12769,173,51,10424,69,11300
1793.99,1,229,12824,229,28,7868,28,12824,0,0,0,0,0
1622.019,1,8,448,8,28,231717,28,448,0,0,0,0,0
0.991,6,10,1687,7,100,165,100,384,3,1179,366,1179,1303
1777.987,6,130,15732,74,86,24355,721,7627,56,292,13799,2007,8105
1785.547,6,103,8404,68,66,26649,66,4964,35,60,52513,60,3440
4.996,17,2,656,2,300,4996,300,656,0,0,0,0,0
0.145,17,2,2386,2,1165,145,1165,2386,0,0,0,0,0
1792.301,1,240,25440,240,78,7499,78,25440,0,0,0,0,0
28.68,6,51,13267,25,172,1195,721,2731,26,678,1140,2840,10536
0.085,17,4,368,2,32,29,32,120,2,96,31,96,248
10.75,6,20,4442,11,275,1075,275,998,9,768,745,1440,3444
1764.735,6,214,20744,108,80,16492,721,10033,106,174,16804,1440,10711
0.384,6,7,295,4,0,128,0,164,3,7,95,7,131
1786.684,6,104,8376,68,65,26666,65,4930,36,59,51045,59,3446
118.775,6,963,476818,527,840,225,1152,452850,436,407,272,1179,23968
106.246,6,121,89164,75,1267,1435,1448,78661,46,675,2284,1448,10503
30.863,6,27,7045,8,133,1224,267,861,19,416,1714,1420,6184
2.592,17,3,1173,3,363,1296,363,1173,0,0,0,0,0
11.042,17,4,240,2,32,11042,32,120,2,32,11041,32,120
1787.377,6,102,8296,68,65,26677,65,4930,34,59,54158,59,3366
1798.369,6,368,25759,214,99,8443,469,15045,154,69,11752,69,10714
606.366,17,6,1968,6,300,121273,300,1968,0,0,0,0,0
300.217,6,36,12177,19,592,16678,1402,4585,17,670,15071,1402,7592
0.305,17,2,167,1,39,0,39,67,1,72,0,72,100
1786.216,17,87,3648,86,14,21014,14,3612,1,8,0,8,36
11.016,6,20,4442,11,275,1101,275,998,9,768,798,1440,3444
1148.547,1,18,1008,18,28,67561,28,1008,0,0,0,0,0
1.1,6,3,120,1,0,0,0,40,2,0,853,0,80
5.979,17,177,59028,177,305,33,1108,59028,0,0,0,0,0
252.066,6,29,5053,12,134,4236,174,1288,17,280,15748,1452,3765
1772.312,6,180,15480,120,69,14893,69,8940,60,69,30037,69,6540
0.022,17,2,330,1,30,0,30,58,1,244,0,244,272
1.218,6,4,212,2,0,1218,0,100,2,0,0,0,112
1718.459,1,134,14204,134,78,12920,78,14204,0,0,0,0,0
36.395,17,6,528,3,48,18192,48,228,3,72,18192,72,300
33.641,6,30,5041,15,154,2402,721,1858,15,399,2389,2026,3183
1782.23,17,83,3480,82,14,22002,14,3444,1,8,0,8,36
1.007,17,2,925,1,548,0,548,576,1,321,0,321,349
0.173,17,2,2754,2,1349,173,1349,2754,0,0,0,0,0
0.106,17,2,136,1,32,0,32,60,1,48,0,48,76
302.402,6,84,56595,50,1228,6171,1448,48072,34,843,1866,2359,8523
251.583,2,2,64,2,8,251583,8,64,0,0,0,0,0
341.108,17,28,7316,14,39,26238,40,944,14,427,26238,506,6372
1791.612,6,415,24880,207,69,8697,69,12420,208,34,8655,48,12460
1790.571,17,349,59105,349,141,5145,389,59105,0,0,0,0,0
0.22,6,9,1340,5,145,55,145,349,4,827,28,827,991
388.898,6,18,1242,14,180,29915,180,916,4,110,20082,110,326
0.001,17,2,160,1,44,0,44,72,1,60,0,60,88
371.299,6,20,1355,15,177,26521,177,977,5,110,15166,110,378
1.358,6,11,1727,7,100,226,100,384,4,589,369,1152,1343
1764.208,2,14,448,14,8,135708,8,448,0,0,0,0,0
1785.397,17,142,11360,71,48,25505,48,5396,71,56,25504,56,5964
1798.955,1,16,896,16,28,119930,28,896,0,0,0,0,0
0.284,17,2,152,2,48,284,48,152,0,0,0,0,0
0.263,6,26,6150,13,181,21,537,1578,13,555,21,1542,4572
0.066,17,2,334,1,39,0,39,67,1,239,0,239,267
1798.808,17,449,39928,404,35,4463,288,25708,45,288,40019,288,14220
1712.914,1,8,448,8,28,244702,28,448,0,0,0,0,0
1203.148,2,12,384,12,8,109377,8,384,0,0,0,0,0
299.55,6,6,364,4,31,99850,31,222,2,31,299538,31,142
1785.182,17,124,9920,62,48,29265,48,4712,62,56,29265,56,5208
403.584,6,756,620202,325,234,1245,986,21587,431,1375,938,1418,598615
75.792,6,31,7613,12,155,28,267,1266,19,398,4210,3417,6347
1.65,6,25,8791,15,289,117,601,1473,10,987,164,1420,7318
25.213,6,9,529,5,45,6303,45,313,4,0,8402,0,216
61.328,6,38,17477,23,803,2787,1408,9291,15,822,4362,2816,8186
1793.934,17,144,11520,72,48,25266,48,5472,72,56,25266,56,6048
1750.174,6,105,8201,69,42,25737,205,4984,36,37,49996,108,3217
1799.624,1,60,5040,0,0,0,0,0,60,56,30502,56,5040
1799.445,17,745,44918,745,32,2418,37,44918,0,0,0,0,0
372.153,6,18,1242,14,180,28627,180,916,4,110,20066,110,326
0.239,17,2,152,1,48,0,48,76,1,48,0,48,76
0.366,17,2,247,1,36,0,36,64,1,155,0,155,183
1799.999,6,213,16800,78,73,22987,375,8023,135,49,13432,143,8777
0.482,6,20,7151,13,318,40,600,1958,7,1205,75,1851,5193
0.438,6,13,1693,7,288,68,288,588,6,426,49,434,1105
0.345,17,2,154,1,33,0,33,61,1,65,0,65,93
1791.805,6,371,23465,213,69,8451,69,13005,158,69,11410,69,10460
1794.806,17,422,110557,422,233,4263,422,110557,0,0,0,0,0
0.033,17,2,317,1,43,0,43,71,1,218,0,218,246
0.062,17,2,378,1,50,0,50,78,1,272,0,272,300
12.949,6,2386,2316774,1599,1374,8,1408,2271186,787,776,16,1408,45588
470.687,6,43,13799,28,377,17432,1360,6818,15,707,33541,3497,6981
0.159,6,45,21938,26,1059,6,1420,16957,19,467,8,1883,4981
0.345,6,20,7151,11,318,33,600,1854,9,964,42,1471,5297
272.609,17,4,240,2,32,272608,32,120,2,32,272607,32,120
1746.844,6,99,7411,63,38,28174,205,4476,36,33,49903,98,2935
20.999,17,26,11535,13,540,1746,1350,7388,13,291,1747,1350,4147
1799.254,17,449,39928,404,35,4464,288,25708,45,288,40018,288,14220
3.911,6,11,467,6,0,782,0,248,5,7,724,7,219
0.656,6,10,924,5,283,122,283,551,5,105,122,105,373
36.402,17,6,528,3,48,18197,48,228,3,72,18197,72,300
21.997,17,40,15267,21,544,1098,1350,12018,19,143,1220,1350,3249
1785.716,6,246,25206,99,67,18220,681,9362,147,136,12230,3298,15844
0.0,1,1,60,1,32,0,32,60,0,0,0,0,0
6.904,6,497,432380,313,1317,21,1368,418148,184,776,36,1473,14232
1786.778,1,339,28476,339,56,5286,56,28476,0,0,0,0,0
1792.82,6,363,23007,210,69,8578,69,12678,153,69,11794,69,10329
0.016,17,2,375,1,29,0,29,57,1,290,0,290,318
0.434,17,2,194,1,61,0,61,89,1,77,0,77,105
300.542,6,18,1275,9,177,37545,177,701,9,110,37547,110,574
0.015,17,3,688,2,64,12,64,184,1,476,0,476,504
0.268,17,2,172,1,50,0,50,78,1,66,0,66,94
223.581,6,30,8872,14,158,17198,267,1357,16,763,14901,3436,7515
240.161,6,53,17942,28,804,8894,1408,15133,25,187,10006,580,2809
64.492,6,11,452,5,0,6133,0,204,6,0,12895,0,248
0.02,17,2,656,1,300,0,300,328,1,300,0,300,328
81.421,6,20,6428,4,106,27140,106,274,16,422,5425,1420,6154
129.138,6,34,11459,11,305,12912,1189,2889,23,424,5869,1917,8570
1740.45,17,29,30624,29,1028,62158,1028,30624,0,0,0,0,0
764.995,6,8,1148,8,103,109285,138,1148,0,0,0,0,0
0.826,17,2,144,1,36,0,36,64,1,52,0,52,80
1.436,6,7,295,4,0,478,0,164,3,7,155,7,131
1793.503,6,128,12725,78,62,23292,722,6422,50,92,36595,1408,6303
11.145,6,2,1175,1,0,0,0,40,1,1095,0,1095,1135
160.486,6,32,7085,17,217,10027,517,1796,15,564,11460,1408,5289
5.038,17,4,288,2,36,5006,36,128,2,52,4996,52,160
0.175,6,28,7336,14,155,13,267,1341,14,543,12,1400,5995
235.781,2,2,64,2,8,235781,8,64,0,0,0,0,0
0.04,17,2,235,1,36,0,36,64,1,143,0,143,171
1799.973,17,140,11200,70,48,26085,48,5320,70,56,26086,56,5880
388.856,6,18,1242,14,180,29912,180,916,4,110,20064,110,326
617.025,6,97,20980,46,284,13711,1460,10393,51,243,12337,1629,10587
6.686,6,1685,1386666,901,1438,7,1448,1332858,784,776,8,1448,53808
0.308,17,2,180,1,30,0,30,58,1,94,0,94,122
132.417,6,57,38908,38,1168,3578,1408,31188,19,960,3412,3847,7720
1775.168,17,140,11200,70,48,25727,48,5320,70,56,25726,56,5880
1740.397,6,87,6322,58,31,30533,31,3915,29,31,62156,31,2407
15.557,17,24,7297,11,358,1552,1350,4255,13,206,1293,1350,3042
7.984,6,19,8251,9,275,998,275,643,10,1199,841,1420,7608
240.308,6,46,9110,24,523,10447,1418,5971,22,220,11442,618,3139
14.104,6,32,6169,16,214,940,314,2784,16,548,923,1179,3385
1.55,6,46,19552,27,921,59,1360,14016,19,529,74,4075,5536
1745.46,6,105,7890,67,38,26446,205,4715,38,32,47162,98,3175
1770.618,6,103,9514,66,66,27240,66,5610,37,60,49181,60,3904
0.008,17,2,394,1,33,0,33,61,1,305,0,305,333
251.574,2,2,64,2,8,251574,8,64,0,0,0,0,0
1763.938,6,27,4077,18,241,103761,241,2889,9,92,220467,92,1188
0.793,6,17,5132,9,150,99,174,664,8,828,98,1420,4468
1740.332,6,127,16110,76,78,23204,876,6984,51,161,34806,1408,9126
280.25,6,26,7272,12,158,25477,267,1277,14,775,21554,3445,5995
1564.196,2,14,448,14,8,120322,8,448,0,0,0,0,0
1425.073,17,139,11637,129,30,11132,37,7517,10,384,151597,463,4120
160.55,6,22,8524,11,310,66,619,1402,11,952,16041,1460,7122
368.532,6,18,1239,14,177,28348,177,913,4,110,20058,110,326
0.021,6,9,1612,5,636,5,636,904,4,492,6,492,708
33.797,6,68,27284,31,775,867,1440,15231,37,555,933,1440,12053
1796.354,6,356,22520,208,69,8678,69,12460,148,69,12220,69,10060
17.505,17,31,14121,15,665,1248,1350,10409,16,204,1164,1350,3712
0.243,6,21,5000,10,137,27,267,1092,11,692,21,1467,3908
0.692,6,114,87630,55,131,12,232,2729,59,1557,11,4140,84901
12.576,6,93,28138,46,553,279,1152,21776,47,447,267,1179,6362
280.044,6,29,7392,13,158,23337,267,1317,16,603,18667,2036,6075
297.28,1,4,224,4,28,99093,28,224,0,0,0,0,0
1.348,6,24,8004,13,164,95,267,1340,11,1014,116,2736,6664
15.643,17,15,5026,7,354,2595,1350,2679,8,265,2219,1350,2347
159.945,6,23,11278,12,433,68,990,1823,11,1286,15981,3928,9455
60.117,2,2,64,2,8,60117,8,64,0,0,0,0,0
1777.127,17,73,3060,72,14,25029,14,3024,1,8,0,8,36
2.073,6,53,21489,30,966,71,1460,15748,23,400,82,1460,5741
2.249,17,2,136,1,32,0,32,60,1,48,0,48,76
31.002,1,2,112,2,28,31002,28,112,0,0,0,0,0
164.826,6,23,10009,12,531,65,1360,2637,11,1384,16468,3934,7372
0.209,1,2,112,2,28,209,28,112,0,0,0,0,0
1786.579,6,104,8308,68,64,26665,64,4896,36,58,51042,58,3412
100.457,6,26,7417,10,207,11161,722,1555,16,552,6683,1408,5862
292.548,1,4,224,4,28,97516,28,224,0,0,0,0,0
148.068,6,22,10814,11,410,66,922,1702,11,1237,14793,1460,9112
1795.172,17,142,11360,71,48,25645,48,5396,71,56,25645,56,5964
2.491,6,13,2311,8,188,355,245,700,5,1407,558,1407,1611
240.237,6,57,18138,30,758,8283,1418,15212,27,189,9239,580,2926
0.547,6,14,1745,7,288,64,288,600,7,426,62,434,1145
1667.172,6,216,18136,82,72,20580,301,7982,134,70,12535,1062,10154
269.87,17,4,352,2,60,269869,60,176,2,60,269869,60,176
0.957,17,2,925,1,548,0,548,576,1,321,0,321,349
3.7,17,2,152,2,48,3700,48,152,0,0,0,0,0
1739.008,1,15,840,15,28,124214,28,840,0,0,0,0,0
0.802,17,2,780,2,362,802,362,780,0,0,0,0,0
312.722,6,27,5846,9,139,39089,159,1046,18,773,18395,1408,4800
0.052,6,10,1327,5,299,12,299,567,5,246,10,459,760
13.69,6,30,8532,12,147,1139,267,1521,18,483,804,1452,7011
962.486,2,10,320,10,8,106942,8,320,0,0,0,0,0
1776.401,17,64,2688,64,14,28196,14,2688,0,0,0,0,0
240.256,6,55,18340,28,816,8898,1402,15336,27,199,9240,580,3004
1758.939,6,4807,4630615,1617,152,1088,967,91428,3190,1403,551,2836,4539187
2.051,17,3,174,3,30,1025,30,174,0,0,0,0,0
331.317,1,6,336,6,28,66263,28,336,0,0,0,0,0
0.241,6,25,4623,12,165,21,456,1446,13,415,18,888,3177
0.096,17,2,152,1,48,0,48,76,1,48,0,48,76
369.591,6,21,1422,15,180,26399,180,992,6,110,12250,110,430
38.903,17,2,152,2,48,38903,48,152,0,0,0,0,0
240.226,6,44,8148,23,457,10919,1408,4860,21,243,12011,647,3288
0.237,17,2,384,1,39,0,39,67,1,289,0,289,317
1740.493,1,15,840,15,28,124320,28,840,0,0,0,0,0
5.314,6,10,2030,7,241,885,241,1726,3,92,98,92,304
204.903,17,4,352,2,60,204902,60,176,2,60,204902,60,176
1.631,17,3,238,2,30,1307,30,116,1,94,0,94,122
36.985,6,18,748,10,0,4107,0,408,8,0,5279,0,340
0.111,6,10,1671,6,552,22,948,1348,4,159,35,159,323
3.242,6,6,324,4,0,1080,0,216,2,0,2989,0,108
9.162,6,1802,1629187,1116,1380,8,1408,1588851,686,931,13,2816,40336
3.784,17,6,522,3,37,1889,37,195,3,81,1888,89,327
315.953,6,93,20672,46,316,7021,1360,10489,47,276,6865,2720,10183
280.295,6,29,7392,14,158,21561,267,1357,15,678,20013,3436,6035
23.24,6,35,8185,17,188,1452,721,2008,18,681,1355,1440,6177
240.242,6,52,15092,27,676,9239,1418,12237,25,193,10009,580,2855
360.926,2,5,160,5,8,90231,8,160,0,0,0,0,0
0.149,6,9,1002,5,213,37,213,417,4,421,44,421,585
0.618,6,21,7686,11,318,60,600,1854,10,884,67,1471,5832
1719.436,17,12,498,11,14,171943,14,462,1,8,0,8,36
1720.082,17,14,587,12,14,156371,15,505,2,13,29248,18,82
0.335,17,8,2758,8,316,47,355,2758,0,0,0,0,0
8.921,6,50,14109,23,289,405,721,3533,27,632,335,1420,10576
0.544,6,10,968,5,256,118,256,460,5,304,115,304,508
97.419,1,4,224,4,28,32473,28,224,0,0,0,0,0
1784.154,6,356,22520,208,69,8619,69,12460,148,69,12137,69,10060
0.11,17,7,3461,4,418,36,1350,1787,3,530,22,1350,1674
0.006,17,2,326,1,32,0,32,60,1,238,0,238,266
1797.668,1,177,9912,177,28,10214,28,9912,0,0,0,0,0
0.728,6,23,5529,12,140,66,267,1184,11,650,66,1420,4345
300.24,6,39,12359,22,582,14297,1408,4705,17,676,15233,2816,7654
0.159,6,26,7256,13,155,13,267,1301,13,678,12,4200,5955
1.355,6,49,20109,27,952,52,1460,14453,22,433,54,1460,5656
1782.376,6,368,25690,213,99,8407,469,15005,155,69,11571,69,10685
1795.509,17,376,52444,186,184,9705,1350,39476,190,40,9499,1350,12968
1784.11,6,102,8296,68,65,26628,65,4930,34,59,54061,59,3366
1783.591,17,222,20958,111,33,16214,37,6823,111,99,16214,155,14135
22.472,6,13,1198,3,106,11236,106,234,10,90,2488,90,964
440.903,17,32,2560,16,48,29392,48,1216,16,56,29392,56,1344
64.498,17,4,352,2,60,64497,60,176,2,60,64497,60,176
3.04,17,3,180,3,32,1520,32,180,0,0,0,0,0
1681.143,1,14,784,14,28,129318,28,784,0,0,0,0,0
299.619,1,4,224,4,28,99873,28,224,0,0,0,0,0
0.011,17,2,376,1,43,0,43,71,1,277,0,277,305
0.868,6,126,87572,59,131,14,232,2889,67,1322,10,1420,84683
511.222,1,65,7198,65,82,7987,85,7198,0,0,0,0,0
1799.442,17,448,39896,403,35,4476,288,25676,45,288,40017,288,14220
36.927,6,36,8455,18,410,510,882,1982,18,478,2163,2720,6473
0.136,17,2,279,1,36,0,36,64,1,187,0,187,215
13.191,1,2,704,2,324,13191,324,704,0,0,0,0,0
6.759,6,66,20206,35,543,198,1152,15539,31,489,216,1179,4667
278.186,17,4,352,2,60,278185,60,176,2,60,278185,60,176
1799.163,6,371,25410,216,93,8368,469,14725,155,69,11682,69,10685
256.113,6,139,50826,73,670,3557,1360,37159,66,305,3937,1360,13667
1785.98,6,278,34084,113,145,15945,1360,16641,165,128,10889,1360,17443
1782.71,6,273,33107,113,132,15915,1360,15767,160,136,11211,2720,17340
44.645,17,1196,1268985,280,56,160,1350,23520,916,1331,48,1350,1245465
188.683,6,76,53305,48,1217,4014,1368,45114,28,840,2288,2736,8191
1711.937,6,103,8237,61,66,26151,66,4420,42,54,41752,60,3817
1750.026,6,120,9212,72,44,24648,205,5338,48,34,37226,98,3874
4.234,6,37,7189,19,218,235,314,3383,18,513,234,1179,3806
1786.27,17,87,3648,86,14,21014,14,3612,1,8,0,8,36
1795.183,6,356,22520,208,69,8672,69,12460,148,69,12212,69,10060
0.329,6,23,7382,14,318,24,600,2022,9,976,40,1891,5360
126.044,2,6,192,6,8,25208,8,192,0,0,0,0,0
61.338,6,36,15730,22,785,2920,1408,9004,14,748,4698,2439,6726
0.555,17,2,168,1,48,0,48,76,1,64,0,64,92
1787.176,17,83,3480,82,14,22063,14,3444,1,8,0,8,36
1786.787,6,102,8364,68,66,26668,66,4964,34,60,54142,60,3400
20.151,17,4,824,2,48,20141,48,152,2,308,20138,308,672
280.698,6,30,7432,13,158,23391,267,1317,17,543,17537,1400,6115
161.515,6,60,39729,39,1148,4250,1408,31897,21,961,3070,3847,7832
1799.003,17,358,58013,358,134,5039,366,58013,0,0,0,0,0
418.292,6,49,8032,24,129,18184,517,2165,25,457,17426,1418,5867
0.683,17,20,13673,11,980,68,1350,11088,9,259,64,1350,2585
1680.379,1,15,840,15,28,120027,28,840,0,0,0,0,0
85.601,6,12,3627,12,273,7781,362,3627,0,0,0,0,0
0.72,6,26,4699,13,165,60,456,1510,13,415,55,888,3189
1.025,17,2,116,2,30,1025,30,116,0,0,0,0,0
35.813,6,27,7183,13,156,2984,267,1312,14,530,2754,3417,5871
33.658,6,33,5212,16,154,2232,722,1924,17,342,2092,1448,3288
108.742,1,4,1669,4,389,36247,527,1669,0,0,0,0,0
1741.263,17,29,30624,29,1028,62187,1028,30624,0,0,0,0,0
0.355,6,27,8973,13,237,29,589,1634,14,825,26,1402,7339
1.33,6,41,9980,21,440,66,1360,4404,20,433,60,1360,5576
2.754,6,11,467,6,0,550,0,248,5,7,640,7,219
0.018,6,13,3980,7,88,2,88,388,6,1670,3,1880,3592
0.049,6,6,897,3,483,15,483,639,3,102,10,102,258
11.616,6,25,8473,13,275,968,275,1078,12,986,761,1440,7395
364.396,6,18,1242,14,180,28030,180,916,4,110,20064,110,326
0.829,6,11,1727,7,100,138,100,384,4,589,186,1152,1343
0.022,17,2,219,1,50,0,50,78,1,113,0,113,141
1789.311,6,356,22520,208,69,8644,69,12460,148,69,12172,69,10060
440.533,17,7,2344,7,306,73422,308,2344,0,0,0,0,0
80.888,2,2,64,2,8,80888,8,64,0,0,0,0,0
5.283,17,3,208,2,36,5002,36,128,1,52,0,52,80
226.786,17,6,528,3,60,113392,60,264,3,60,113392,60,264
0.529,17,2,154,1,33,0,33,61,1,65,0,65,93
4.144,17,4,240,2,32,4142,32,120,2,32,4143,32,120
1.281,6,52,21595,29,919,45,1360,15899,23,476,50,2715,5696
2.396,17,21,12482,12,825,213,1350,10242,9,220,295,1350,2240
141.578,17,9,684,9,48,17697,48,684,0,0,0,0,0
0.24,17,12,4413,12,339,21,362,4413,0,0,0,0,0
0.357,17,2,157,1,31,0,31,59,1,70,0,70,98
32.317,6,2604,2336333,1574,1399,20,1448,2274603,1030,792,31,1448,61730
20.285,6,25,5668,14,92,1560,159,1209,11,773,2023,1368,4459
71.482,6,24,8962,12,467,91,1064,1927,12,934,6483,1791,7035
4.711,6,12,3462,6,75,942,75,395,6,1373,942,1448,3067
66.938,6,122,131366,78,430,869,647,5414,44,3016,1538,9856,125952
364.323,6,28,1819,18,177,21430,177,1181,10,110,8249,110,638
6.969,6,528,461834,334,1318,20,1368,447082,194,776,35,1473,14752
5.26,17,6,1214,3,30,2625,30,174,3,318,2624,468,1040
147.164,17,4,352,2,60,147163,60,176,2,60,147163,60,176
4.562,6,27,5466,13,241,380,564,2362,14,388,322,1343,3104
10.99,6,22,4526,12,275,999,275,1038,10,768,702,1440,3488
3.58,6,30,5930,15,135,255,267,1421,15,780,240,1459,4509
216.139,6,230,61843,137,441,1589,1440,28325,93,337,2349,1328,33518
372.011,6,27,1767,18,177,21883,177,1181,9,110,8621,110,586
292.079,2,2,64,2,8,292079,8,64,0,0,0,0,0
0.424,6,27,8944,13,237,35,589,1634,14,939,31,1438,7310
1753.136,6,158,9778,83,47,21379,208,5879,75,31,23687,31,3899
1770.922,6,207,36799,129,316,13835,316,27280,78,83,22998,83,9519
0.405,6,8,335,4,0,135,0,164,4,7,73,7,171
120.251,17,4,352,2,60,120250,60,176,2,60,120250,60,176
240.163,6,57,20250,31,787,8005,1408,17371,26,189,9606,580,2879
1681.15,17,14,3843,7,30,280190,30,406,7,463,280190,463,3437
2.982,17,3,222,3,46,1491,46,222,0,0,0,0,0
1.405,6,49,19041,27,876,54,1360,13385,22,433,57,1360,5656
315.903,6,119,36591,66,502,4860,1360,25350,53,284,6072,3289,11241
4.02,6,2,88,2,0,0,0,88,0,0,0,0,0
0.512,17,3,451,2,39,115,39,134,1,289,0,289,317
51.239,6,281,210664,178,1383,113,1460,198127,103,195,500,1460,12537
0.096,17,4,588,2,48,87,48,152,2,190,82,308,436
0.693,6,23,10706,14,610,53,1360,3646,9,1337,65,4428,7060
1798.596,17,463,66388,215,186,8404,1350,46208,248,53,7281,1350,20180
0.06,17,2,904,1,300,0,300,328,1,548,0,548,576
1787.903,6,359,22778,210,69,8554,69,12609,149,69,12080,69,10169
0.029,6,9,1930,5,666,7,666,934,4,780,9,780,996
0.25,6,21,4415,12,165,22,456,1446,9,415,29,888,2969
192.027,6,39,11850,14,285,14770,1189,2848,25,444,8000,1420,9002
1797.215,17,448,39896,403,35,4470,288,25676,45,288,40017,288,14220
1.603,6,42,11418,22,547,76,1360,5842,20,433,72,1360,5576
1.788,6,13,938,7,185,297,185,565,6,45,340,45,373
22.866,17,4,352,2,48,22646,48,152,2,72,22848,72,200
615.807,6,122,23093,57,273,10996,1360,11454,65,209,9571,3289,11639
1775.649,6,180,15480,120,69,14921,69,8940,60,69,30086,69,6540
300.396,6,28,7943,16,348,20026,826,2269,12,630,3011,1491,5674
1111.439,17,220,16720,220,48,5075,48,16720,0,0,0,0,0
300.097,6,40,10129,22,615,14282,1360,4607,18,435,17643,2667,5522
1778.125,1,57,4788,57,56,31752,56,4788,0,0,0,0,0
15.174,17,15,8424,6,570,3028,1350,3593,9,508,1892,1350,4831
755.47,2,4,128,4,8,251823,8,128,0,0,0,0,0
1794.183,6,356,22520,208,69,8667,69,12460,148,69,12205,69,10060
1.449,17,4,420,2,33,1,33,122,2,121,0,145,298
0.495,17,4,768,2,39,490,39,134,2,289,10,289,634
0.219,17,2,154,1,33,0,33,61,1,65,0,65,93
0.245,6,10,1378,5,145,61,145,349,5,825,35,825,1029
17.503,17,2,152,2,48,17503,48,152,0,0,0,0,0
2.017,17,4,644,2,33,1980,33,122,2,233,0,233,522
31.164,17,4,352,2,60,31163,60,176,2,60,31163,60,176
112.075,6,25,9963,12,563,60,1460,2764,13,952,9328,1460,7199
1789.377,17,142,11360,71,48,25562,48,5396,71,56,25562,56,5964
365.792,6,21,1422,15,180,26128,180,992,6,110,12263,110,430
1740.44,17,30,7050,30,207,60015,207,7050,0,0,0,0,0
0.019,6,10,2046,6,739,3,1322,1723,4,159,6,159,323
0.106,17,2,198,1,39,0,39,67,1,103,0,103,131
201.156,6,15,9298,3,185,440,245,495,12,1039,18265,1152,8803
1774.973,6,180,15480,120,69,14915,69,8940,60,69,30079,69,6540
1770.709,6,100,9292,66,65,27241,65,5577,34,59,53654,59,3715
1.515,6,52,18840,28,915,56,1460,13059,24,400,55,1460,5781
1784.684,17,138,11040,69,48,26245,48,5244,69,56,26245,56,5796
124.225,6,7,1295,4,327,41408,413,814,3,180,62017,269,481
1770.82,6,105,9552,66,65,27243,65,5577,39,59,46598,59,3975
1740.74,6,87,6322,58,31,30539,31,3915,29,31,62168,31,2407
1792.458,6,373,23614,214,69,8415,69,13114,159,69,11344,69,10500
0.243,17,2,154,1,33,0,33,61,1,65,0,65,93
3.4,6,15,1815,7,304,566,304,1272,8,83,474,83,543
41.821,2,4,128,4,8,13940,8,128,0,0,0,0,0
199.62,6,47,13390,21,181,9981,267,2300,26,669,7981,1400,11090
0.432,6,6,324,4,0,144,0,216,2,0,237,0,108
8.557,6,18,2527,12,188,777,245,876,6,703,458,1152,1651
2.922,17,24,9920,11,521,292,1350,6045,13,270,149,1350,3875
1.323,6,53,19560,29,898,47,1360,13779,24,400,50,1360,5781
3.81,17,5,290,5,30,952,30,290,0,0,0,0,0
481.298,2,6,192,6,8,96259,8,192,0,0,0,0,0
0.936,6,29,12011,16,525,62,1360,3298,13,909,61,1380,8713
1681.301,17,14,3755,7,30,280215,30,406,7,450,280215,463,3349
1772.443,6,180,15480,120,69,14894,69,8940,60,69,30039,69,6540
1.194,6,30,7416,13,155,99,267,1301,17,543,72,1300,6115
0.382,6,14,6093,7,128,63,128,500,7,1305,63,1448,5593
11.143,6,26,11958,13,275,928,275,1078,13,1293,891,1414,10880
1.006,6,28,8263,15,225,63,561,1985,13,957,69,1631,6278
4.769,6,14,2351,8,125,681,245,700,6,703,251,1152,1651
0.238,6,25,6044,13,164,19,453,1506,12,651,20,1408,4538
31.728,6,7,420,1,0,0,0,60,6,0,6344,0,360
1700.594,17,13,534,11,14,170041,14,462,2,8,1700401,8,72
240.185,6,53,17729,28,790,8895,1408,14897,25,190,10007,580,2832
0.532,6,188,171687,115,194,4,230,6947,73,2266,5,5632,164740
1796.929,6,184,17079,122,83,14850,965,9985,62,74,29456,405,7094
203.629,6,18,2325,14,240,15663,240,976,4,1133,20022,1133,1349
31.577,6,3,144,1,0,0,0,48,2,0,16128,0,96
66.26,6,26,7137,12,155,6023,267,1266,14,530,5096,2840,5871
0.502,6,127,88248,60,131,8,232,2929,67,1332,7,1430,85319
1796.478,17,449,39928,404,35,4457,288,25708,45,288,40021,288,14220
0.008,17,2,488,1,60,0,60,88,1,372,0,372,400
8.882,6,25,3615,14,143,683,267,1571,11,400,858,1179,2044
0.096,17,2,2730,2,1337,96,1337,2730,0,0,0,0,0
1792.901,17,175,11200,175,36,10304,36,11200,0,0,0,0,0
1793.601,17,180,14040,180,50,10020,50,14040,0,0,0,0,0
7.366,6,948,786009,544,1363,13,1408,760337,404,776,17,1408,25672
0.363,17,2,198,1,39,0,39,67,1,103,0,103,131
1777.789,6,288,37178,118,155,15193,1460,18282,170,138,10518,1460,18896
0.478,6,2,149,1,0,0,0,40,1,69,0,69,109
118.994,6,36,7821,16,130,7932,267,1564,20,388,6253,1460,6257
721.894,2,5,160,5,8,180473,8,160,0,0,0,0,0
30.431,1,8,448,8,28,4347,28,448,0,0,0,0,0
320.097,6,29,7100,13,298,26674,1382,2313,16,414,21338,1460,4787
1793.35,6,240,35580,150,302,12035,302,25920,90,83,20149,83,9660
0.704,6,10,923,6,304,140,304,624,4,83,218,83,299
1772.209,6,180,15480,120,69,14892,69,8940,60,69,30031,69,6540
217.653,6,22,4340,8,407,31093,722,1250,14,235,16728,1408,3090
256.242,17,4,240,2,32,256241,32,120,2,32,256241,32,120
1.055,6,23,6510,13,333,86,1004,2190,10,979,115,1699,4320
728.967,17,58,4640,29,48,26034,48,2204,29,56,26034,56,2436
1.353,6,26,8581,14,219,104,531,1613,12,1056,97,1448,6968
300.725,6,38,8575,20,308,15827,888,2103,18,478,502,1928,6472
280.209,6,29,7392,13,158,23350,267,1317,16,603,18676,2800,6075
1792.815,6,723,46016,360,23,4993,23,22930,363,23,4952,23,23086
0.157,17,2,2380,2,1162,157,1162,2380,0,0,0,0,0
292.417,17,4,352,2,60,292416,60,176,2,60,292416,60,176
5.042,6,40,7309,20,218,265,314,3423,20,513,250,1179,3886
1725.342,17,12,498,11,14,172534,14,462,1,8,0,8,36
240.251,6,54,19038,29,823,8580,1408,16339,25,173,10010,580,2699
1745.907,6,97,7307,63,38,28159,205,4476,34,33,52898,98,2831
10.899,6,90,27085,45,558,247,1152,20803,45,407,241,1152,6282
1.295,6,10,1687,7,100,215,100,384,3,1179,512,1179,1303
1772.123,6,180,15480,120,69,14891,69,8940,60,69,30033,69,6540
9.881,6,41,9550,24,97,429,335,1963,17,689,336,2720,7587
280.039,6,28,7352,13,158,23336,267,1317,15,678,20000,2045,6035
240.317,6,55,17640,30,775,8286,1408,14763,25,196,10013,580,2877
24.886,17,7,7558,7,1051,4147,1072,7558,0,0,0,0,0
115.772,17,2,142,2,43,115772,43,142,0,0,0,0,0
0.002,17,2,212,1,46,0,46,74,1,110,0,110,138
0.965,17,19,12781,11,919,96,1350,10420,8,267,133,1350,2361
7.493,6,28,7859,13,256,624,721,1806,15,605,519,2840,6053
0.648,17,4,368,2,32,313,32,120,2,96,310,96,248
3.743,6,34,6169,17,206,233,314,2744,17,456,218,1152,3425
1790.427,17,142,11360,71,48,25576,48,5396,71,56,25576,56,5964
207.603,6,23,6676,7,154,34600,267,752,16,479,13838,1460,5924
218.894,17,4,1312,4,300,72964,300,1312,0,0,0,0,0
705.168,6,89,6716,34,69,21363,365,3225,55,47,13055,78,3491
1697.798,1,52,5512,52,78,33290,78,5512,0,0,0,0,0
5.016,17,4,558,2,36,5004,36,128,2,187,5002,187,430
1.537,6,42,11418,22,547,73,1360,5842,20,433,70,1360,5576
0.183,6,46,20381,26,1021,7,1420,15360,20,467,9,1883,5021
1786.486,6,104,8444,68,66,26663,66,4964,36,60,51040,60,3480
280.066,1,6,336,6,28,56013,28,336,0,0,0,0,0
2.94,6,27,9142,13,263,245,688,1760,14,947,223,1368,7382
1799.133,17,80,3354,79,14,23065,14,3318,1,8,0,8,36
1675.023,1,8,448,8,28,239289,28,448,0,0,0,0,0
0.119,17,2,247,1,36,0,36,64,1,155,0,155,183
1799.054,6,369,24792,214,87,8446,469,14245,155,69,11681,69,10547
282.552,6,31,7733,14,175,21734,267,1618,17,603,17650,2076,6115
1.966,17,24,12493,12,562,178,1350,7089,12,422,128,1350,5404
1.005,6,24,6555,13,334,83,1009,2195,11,783,99,1420,4360
0.248,17,2,230,1,40,0,40,68,1,134,0,134,162
8.1,6,791,1245740,536,1055,15,1360,42842,255,4948,31,40800,1202898
1792.56,1,270,15120,270,28,6663,28,15120,0,0,0,0,0
8.201,17,2,672,2,308,8201,308,672,0,0,0,0,0
1742.702,6,125,11558,71,97,24895,205,7511,54,31,32873,33,4047
0.017,17,2,136,1,32,0,32,60,1,48,0,48,76
7.143,6,1873,1738388,1185,1389,5,1408,1697948,688,931,10,2816,40440
2.107,6,2,1520,1,0,0,0,40,1,1440,0,1440,1480
0.066,17,2,218,1,65,0,65,93,1,97,0,97,125
12.515,6,27,5514,15,203,879,613,2009,12,712,1120,1767,3505
0.491,6,12,1653,6,288,91,288,548,6,426,58,434,1105
10.972,6,20,4442,11,275,1097,275,998,9,768,780,1440,3444
52.419,6,46,8953,21,371,757,766,2045,25,327,2178,1460,6908
137.922,6,51,10608,24,222,5996,721,3859,27,514,5045,1440,6749
280.424,6,30,7432,13,158,23368,267,1317,17,678,17523,3456,6115
1794.641,6,356,22520,208,69,8669,69,12460,148,69,12205,69,10060
1785.865,6,353,22400,205,69,8754,69,12340,148,69,12148,69,10060
1795.658,17,449,39928,404,35,4455,288,25708,45,288,40021,288,14220
1583.059,1,16,896,16,28,105537,28,896,0,0,0,0,0
1793.382,1,245,13720,245,28,7349,28,13720,0,0,0,0,0
0.107,17,2,180,1,30,0,30,58,1,94,0,94,122
2.988,17,4,624,4,128,996,128,624,0,0,0,0,0
1.495,6,33,13141,20,692,78,1360,5690,13,768,107,2720,7451
171.138,6,29,7392,13,158,14261,267,1317,16,603,11406,2076,6075
4.052,6,39,7269,20,218,213,314,3423,19,440,211,1152,3846
78.595,6,22,8105,12,418,64,953,1804,10,981,8715,4080,6301
4.061,6,23,6465,11,262,401,517,1368,12,744,365,1418,5097
954.702,2,8,256,8,8,136386,8,256,0,0,0,0,0
161.434,6,29,7392,13,158,13452,267,1317,16,603,10760,2036,6075
1788.89,17,73,3060,72,14,25195,14,3024,1,8,0,8,36
1774.852,6,182,15629,121,69,14790,69,9049,61,69,29580,69,6580
1745.614,6,95,7203,63,38,28155,205,4476,32,33,56298,98,2727
1742.781,6,95,7203,63,38,28109,205,4476,32,33,56207,98,2727
128.79,6,14,5806,4,106,42930,106,274,10,730,14288,1997,5532
1793.344,6,357,22698,209,69,8621,69,12638,148,69,12199,69,10060
31.404,6,11,476,4,0,204,0,168,7,0,5230,0,308
0.161,6,5,610,0,0,0,0,0,5,205,40,341,610
1.176,6,24,8004,12,164,90,267,1288,12,1014,90,2411,6716
1754.503,1,116,12296,116,78,15256,78,12296,0,0,0,0,0
33.605,1,12,1248,0,0,0,0,0,12,76,3055,76,1248
0.034,17,2,230,1,40,0,40,68,1,134,0,134,162
0.122,17,2,128,1,28,0,28,56,1,44,0,44,72
14.882,6,7,625,0,0,0,0,0,7,69,2480,69,625
1.094,6,24,8004,12,164,84,267,1288,12,1014,84,2423,6716
4.942,17,4,542,2,36,4937,36,128,2,179,4937,187,414
1787.347,17,82,3438,81,14,22341,14,3402,1,8,0,8,36
1.245,6,58,28165,34,1024,37,1380,22939,24,421,52,1923,5226
1781.326,1,76,6384,0,0,0,0,0,76,56,23751,56,6384
1761.947,17,172,14798,158,30,11222,37,9220,14,370,130934,463,5578
0.637,6,23,6205,13,269,52,685,1871,10,982,69,1737,4334
1749.561,17,12,498,11,14,174956,14,462,1,8,0,8,36
70.753,17,3,365,2,114,70753,156,284,1,53,0,53,81
1798.816,6,287,20726,165,69,10968,69,10878,122,69,14866,69,9848
240.241,6,54,17737,29,748,8579,1418,14996,25,179,10009,580,2741
1744.674,2,17,544,17,8,109042,8,544,0,0,0,0,0
280.412,6,29,7392,13,158,23367,267,1317,16,603,18692,2076,6075
1680.604,1,15,840,15,28,120043,28,840,0,0,0,0,0
1772.509,6,180,15480,120,69,14895,69,8940,60,69,30039,69,6540
1567.042,6,75,5404,45,33,35610,33,3114,30,31,54030,31,2290
1.215,6,24,8004,12,164,94,267,1288,12,1014,94,2423,6716
0.005,17,8,576,4,36,1,36,256,4,52,1,52,320
1692.512,1,8,448,8,28,241787,28,448,0,0,0,0,0
0.185,17,2,157,1,31,0,31,59,1,70,0,70,98
280.079,6,28,7352,13,158,23339,267,1317,15,678,20000,2045,6035
292.721,17,4,240,2,32,292720,32,120,2,32,292719,32,120
1784.822,1,255,14280,255,28,7026,28,14280,0,0,0,0,0
1740.597,6,87,6322,58,31,30536,31,3915,29,31,62162,31,2407
280.508,6,28,7352,13,158,23375,267,1317,15,678,20032,3456,6035
0.047,17,2,251,1,36,0,36,64,1,159,0,159,187
0.022,6,13,3980,7,88,3,88,388,6,1670,4,2920,3592
589.472,17,7,532,7,48,98245,48,532,0,0,0,0,0
1.359,6,46,16816,25,847,56,1360,11200,21,476,58,2715,5616
0.025,6,3,151,1,0,0,0,40,2,31,0,31,111
3.69,6,33,6129,17,206,230,314,2744,16,548,228,1179,3385
18.522,6,157,66445,86,732,217,1152,59123,71,447,260,1179,7322
99.446,6,896,445395,495,839,201,1152,424223,401,427,247,1179,21172
36.137,17,20,1760,10,48,4013,48,760,10,72,4013,72,1000
4.18,6,10,923,6,304,836,304,624,4,83,1360,83,299
65.04,6,37,9539,16,327,145,1189,2615,21,467,3251,1420,6924
364.635,6,25,1651,17,177,22789,177,1117,8,110,9182,110,534
0.018,2,2,64,2,8,18,8,64,0,0,0,0,0
1799.617,17,614,223440,614,335,2935,376,223440,0,0,0,0,0
49.455,17,4,240,2,32,49454,32,120,2,32,49454,32,120
0.292,6,15,6145,8,128,41,128,552,7,1305,48,1472,5593
0.004,17,2,586,1,46,0,46,74,1,484,0,484,512
1789.978,6,358,22600,208,69,8647,69,12460,150,69,12013,69,10140
3.992,17,3,222,3,46,1996,46,222,0,0,0,0,0
27.653,6,50,13427,23,188,1256,722,2811,27,680,1055,1380,10616
2.467,17,3,1176,3,364,1233,364,1176,0,0,0,0,0
1785.177,17,142,11360,71,48,25501,48,5396,71,56,25501,56,5964
1745.734,6,95,7234,62,38,28618,205,4424,33,33,54546,98,2810
37.925,2,2,64,2,8,37925,8,64,0,0,0,0,0
33.887,6,33,5525,16,180,2259,722,1947,17,298,2101,1448,3578
1.906,6,15,2391,9,125,238,245,740,6,1407,333,1407,1651
6.121,17,6,507,3,34,3057,34,186,3,79,3057,79,321
1773.84,6,183,15738,121,69,14782,69,8980,62,69,29077,69,6758
300.635,6,37,8607,20,335,15822,994,2173,17,478,531,2128,6434
1794.24,6,416,27865,222,98,8118,469,15572,194,43,9295,69,12293
6.059,17,4,304,2,48,6058,64,152,2,48,6057,64,152
911.68,6,146,23750,81,304,11396,304,16756,65,83,14229,83,6994
42.836,6,45,10203,22,677,536,1360,4357,23,327,1939,2667,5846
1794.706,17,66,2766,65,14,28042,14,2730,1,8,0,8,36
14.027,6,22,4398,12,275,1275,275,1042,10,978,1028,1420,3356
1785.186,17,87,3648,86,14,21002,14,3612,1,8,0,8,36
0.115,17,2,152,2,48,115,48,152,0,0,0,0,0
142.044,6,144,114718,94,1302,1527,1408,102580,50,680,2774,2439,12138
0.137,17,3,2906,3,940,68,1451,2906,0,0,0,0,0
1786.552,17,87,3648,86,14,21018,14,3612,1,8,0,8,36
1788.686,17,73,3060,72,14,25192,14,3024,1,8,0,8,36
69.737,6,31,3986,18,304,4102,304,2772,13,83,5727,83,1214
0.494,17,3,451,2,39,363,39,134,1,289,0,289,317
300.883,6,41,13051,21,814,15036,1360,7387,20,373,15827,2667,5664
1780.197,6,34,5654,23,241,80918,241,4294,11,92,178001,92,1360
333.29,6,22,1643,14,64,25637,64,944,8,54,47601,58,699
0.418,6,8,335,4,0,139,0,164,4,7,63,7,171
0.847,6,11,1727,7,100,141,100,384,4,589,199,1152,1343
0.045,17,2,152,1,48,0,48,76,1,48,0,48,76
117.725,6,31,8912,14,158,9055,267,1357,17,687,7352,1781,7555
33.854,6,31,5092,15,154,2418,721,1858,16,342,2243,1368,3234
1786.624,6,102,8296,68,65,26666,65,4930,34,59,54136,59,3366
2.291,17,402,433586,83,180,27,1350,17272,319,1277,6,1350,416314
25.628,6,47,10518,22,410,719,882,2250,25,381,1062,1360,8268
12.78,6,2018,1765678,1227,1384,10,1420,1729817,791,467,16,1883,35861
2.159,17,3,174,3,30,1079,30,174,0,0,0,0,0
0.335,6,27,7296,13,155,27,267,1301,14,603,24,2036,5995
6.782,6,36,18298,20,890,356,1360,9764,16,1120,441,1360,8534
286.614,17,17,1292,17,48,17913,48,1292,0,0,0,0,0
10.769,6,20,4402,11,275,1076,275,998,9,758,755,1420,3404
1780.962,6,104,8444,68,66,26581,66,4964,36,60,50881,60,3480
1793.057,6,223,38672,108,933,16757,1402,28013,115,51,15728,65,10659
9.54,1,8,832,0,0,0,0,0,8,76,1362,76,832
1692.162,6,209,16144,80,71,21418,328,7863,129,48,13218,78,8281
1787.905,6,378,26297,217,97,8277,469,15441,161,69,11174,69,10856
1789.027,17,142,11360,71,48,25557,48,5396,71,56,25557,56,5964
32.673,17,78,35672,42,714,796,1350,31186,36,96,931,1350,4486
120.234,2,3,96,3,8,60117,8,96,0,0,0,0,0
1786.77,6,102,8364,68,66,26668,66,4964,34,60,54141,60,3400
0.49,6,4,220,2,0,490,0,100,2,0,302,0,120
1794.529,17,87,3648,86,14,21112,14,3612,1,8,0,8,36
1779.909,1,342,28728,342,56,5219,56,28728,0,0,0,0,0
0.395,6,19,7099,11,318,36,600,1854,8,1205,53,1851,5245
4.187,6,31,8912,14,158,322,267,1357,17,687,258,2036,7555
760.213,6,60,8868,38,102,20546,501,3170,22,253,36196,1420,5698
66.527,6,34,10633,10,310,7391,1189,2582,24,393,2891,1420,8051
122.696,6,67,46659,44,1175,2853,1408,38729,23,960,2800,3847,7930
1653.157,1,7,392,7,28,275526,28,392,0,0,0,0,0
41.4,17,24,2112,12,48,3756,48,912,12,72,3758,72,1200
1767.432,1,58,4872,58,56,31007,56,4872,0,0,0,0,0
242.188,6,42,8268,20,167,12746,517,2098,22,557,11532,2685,6170
0.32,17,2,180,1,30,0,30,58,1,94,0,94,122
22.507,6,27,7177,13,155,1875,267,1306,14,530,1730,3417,5871
1743.162,6,96,7286,63,38,28115,205,4476,33,33,54464,98,2810
1.119,6,24,8004,12,164,87,267,1288,12,1014,87,2816,6716
3.649,6,20,3833,11,234,364,564,1504,9,463,433,1343,2329
12.437,6,16,4732,9,290,1554,517,1057,7,1101,2028,1448,3675
0.527,6,3,212,1,46,0,46,86,2,46,527,46,126
1773.817,6,180,15480,120,69,14906,69,8940,60,69,30055,69,6540
3.795,17,5,290,5,30,948,30,290,0,0,0,0,0
0.039,17,4,368,2,32,9,32,120,2,96,0,96,248
33.419,17,6,528,3,48,16703,48,228,3,72,16696,72,300
95.405,6,32,7285,13,230,158,502,1676,19,302,5295,1452,5609
16.27,6,2422,2315186,1545,1419,10,1448,2264918,877,776,18,1448,50268
142.52,6,17,1404,3,106,71260,106,234,14,80,10951,90,1170
0.089,17,4,364,2,52,0,52,160,2,74,47,80,204
1784.7,6,225,23377,140,75,12839,267,10526,85,131,21246,1460,12851
0.052,17,4,284,2,32,37,32,120,2,54,30,60,164
1784.22,6,364,23116,210,69,8536,69,12678,154,69,11661,69,10438
0.289,6,10,1383,5,145,72,145,349,5,830,69,830,1034
0.084,17,2,170,1,37,0,37,65,1,77,0,77,105
1788.598,17,83,3480,82,14,22081,14,3444,1,8,0,8,36
0.04,17,2,263,1,36,0,36,64,1,171,0,171,199
19.03,17,30,6047,15,210,1356,1350,3570,15,137,1356,1350,2477
1.182,6,24,8004,12,164,92,267,1288,12,1014,92,2804,6716
1680.438,1,15,840,15,28,120031,28,840,0,0,0,0,0
1768.966,1,58,4872,58,56,31034,56,4872,0,0,0,0,0
153.2,17,4,352,2,60,153199,60,176,2,60,153199,60,176
128.41,17,4,352,2,60,128409,60,176,2,60,128409,60,176
262.778,17,4,304,4,48,87592,48,304,0,0,0,0,0
0.841,6,2,1235,1,0,0,0,40,1,1155,0,1155,1195
1682.798,17,14,1036,7,30,280457,30,406,7,62,280455,62,630
1751.854,17,302,64368,302,185,5820,364,64368,0,0,0,0,0
15.232,17,370,390244,77,118,199,1350,11284,293,1265,51,1350,378960
2.763,17,3,1167,3,361,1381,361,1167,0,0,0,0,0
280.36,6,29,7392,13,158,23363,267,1317,16,603,18682,2036,6075
11.586,6,25,8473,13,275,965,275,1078,12,986,758,1440,7395
1798.258,17,142,11360,71,48,25689,48,5396,71,56,25689,56,5964
1.208,6,45,18467,27,847,46,1360,12971,18,529,61,4075,5496
1799.037,17,136,10880,68,48,26851,48,5168,68,56,26851,56,5712
52.545,17,6,528,3,48,26268,48,228,3,72,26267,72,300
280.297,6,28,7352,12,158,25481,267,1277,16,603,18680,1400,6075
0.052,6,10,1495,5,507,12,507,727,5,556,12,556,768
0.13,17,4,284,2,32,0,32,120,2,54,126,60,164
1.16,17,2,237,1,72,0,72,100,1,109,0,109,137
0.139,17,2,2380,2,1162,139,1162,2380,0,0,0,0,0
1785.862,6,370,25301,214,93,8384,469,14714,156,69,11521,69,10587
0.013,17,2,304,1,31,0,31,59,1,217,0,217,245
38.9,17,22,1672,22,48,1852,48,1672,0,0,0,0,0
0.424,6,3,144,2,0,424,0,92,1,0,0,0,52
7.971,6,16,2654,10,275,885,275,958,6,1440,1220,1440,1696
47.189,2,2,64,2,8,47189,8,64,0,0,0,0,0
5.084,17,3,208,2,36,5062,36,128,1,52,0,52,80
62.171,6,74,55631,49,1217,1295,1368,47596,25,840,2580,2519,8035
200.0,6,26,4601,13,328,16666,593,1377,13,506,16665,580,3224
240.299,6,43,8843,21,519,12014,1402,5775,22,212,11442,619,3068
15.049,6,2362,2178194,1509,1365,9,1408,2129174,853,931,17,2816,49020
1.08,17,6,360,3,32,539,32,180,3,32,539,32,180
1784.318,6,103,8332,69,64,26239,64,5000,34,58,54066,58,3332
1791.235,6,356,22520,208,69,8653,69,12460,148,69,12185,69,10060
890.035,17,26,8736,26,308,35601,308,8736,0,0,0,0,0
0.34,6,27,9085,13,257,28,667,1715,14,947,23,1408,7370
1797.749,1,345,28980,345,56,5226,56,28980,0,0,0,0,0
1798.909,6,356,22520,208,69,8690,69,12460,148,69,12234,69,10060
0.019,6,3,171,0,0,0,0,0,3,51,9,51,171
37.455,17,22,1936,11,48,3744,48,836,11,72,3744,72,1100
1205.732,6,74,9204,37,293,33490,517,2811,37,893,33490,2448,6393
316.49,6,6,256,5,0,79122,0,208,1,0,0,0,48
0.033,6,13,3980,7,88,5,88,388,6,1670,6,2920,3592
1.277,6,10,579,5,43,319,43,311,5,0,180,0,268
19.637,17,4,352,2,48,19628,48,152,2,72,19626,72,200
2.757,6,13,2315,7,188,459,245,660,6,1407,499,1407,1655
21.702,17,17,8199,8,540,3096,1350,4545,9,378,2709,1350,3654
155.491,6,24,9849,14,285,11960,800,1744,10,1282,17262,2568,8105
3.848,17,4,352,4,60,1282,60,352,0,0,0,0,0
28.337,6,10,628,4,106,9443,106,274,6,90,5665,90,354
387.975,17,13,4368,13,308,32331,308,4368,0,0,0,0,0
1785.152,6,356,22520,208,69,8623,69,12460,148,69,12143,69,10060
1722.941,1,8,848,8,78,246134,78,848,0,0,0,0,0
0.007,17,2,202,1,32,0,32,60,1,114,0,114,142
1799.868,1,257,14392,257,28,7030,28,14392,0,0,0,0,0
4.998,17,4,288,2,36,4996,36,128,2,52,4998,52,160
1793.221,1,58,4872,0,0,0,0,0,58,56,31460,56,4872
1680.597,17,12,498,11,14,168059,14,462,1,8,0,8,36
299.535,6,6,364,4,31,99845,31,222,2,31,299514,31,142
1797.296,17,449,39928,404,35,4459,288,25708,45,288,40016,288,14220
1795.997,1,125,7000,125,28,14483,28,7000,0,0,0,0,0
566.45,6,61,7596,32,93,18272,721,3076,29,150,17005,1448,4520
1798.555,1,284,30104,284,78,6355,78,30104,0,0,0,0,0
20.272,6,24,5586,13,107,1689,159,1126,11,967,2023,1709,4460
1758.885,6,132,12933,80,61,22264,722,6495,52,88,34481,1440,6438
1770.333,6,101,9410,66,66,27235,66,5610,35,60,52066,60,3800
0.949,6,28,8460,15,222,55,540,1964,13,994,64,1791,6496
1718.799,1,104,5824,104,28,16687,28,5824,0,0,0,0,0
0.238,17,2,136,1,32,0,32,60,1,48,0,48,76
300.16,6,43,14196,23,955,13635,1460,8594,20,399,15788,1460,5602
1792.349,1,200,11200,200,28,9006,28,11200,0,0,0,0,0
1.657,6,25,8709,15,276,118,560,1432,10,981,165,1420,7277
0.011,17,8,2446,8,277,1,316,2446,0,0,0,0,0
281.971,6,54,19936,23,420,12805,1460,5164,31,676,9385,1934,14772
10.968,6,18,5610,10,275,1218,275,958,8,1440,865,1440,4652
1.278,6,18,3257,10,99,122,182,924,8,477,158,1343,2333
1331.508,17,96,31488,96,300,14015,300,31488,0,0,0,0,0
0.914,6,10,1687,7,100,152,100,384,3,1179,325,1179,1303
0.598,6,3,120,2,0,598,0,80,1,0,0,0,40
19.192,6,22,4655,11,184,1919,722,1676,11,793,1891,1448,2979
6.274,1,4,424,4,78,2091,78,424,0,0,0,0,0
0.13,17,2,245,1,32,0,32,60,1,157,0,157,185
280.257,6,25,7094,11,181,28025,267,1168,14,595,21554,1400,5926
1740.466,17,26,6110,26,207,69618,207,6110,0,0,0,0,0
1.654,6,9,527,5,43,413,43,311,4,0,548,0,216
1787.907,6,356,22520,208,69,8637,69,12460,148,69,12162,69,10060
0.44,6,5,1564,3,413,220,413,946,2,269,199,269,618
1.066,6,24,6630,13,349,88,1083,2270,11,783,105,1420,4360
280.213,6,28,7352,13,158,23351,267,1317,15,678,20012,2800,6035
24.353,17,4,304,2,48,24353,64,152,2,48,24352,64,152
1786.777,17,87,3648,86,14,21020,14,3612,1,8,0,8,36
0.005,17,2,246,1,47,0,47,75,1,143,0,143,171
2.341,6,18,3257,10,99,239,182,924,8,477,307,1343,2333
1797.968,17,449,39928,404,35,4461,288,25708,45,288,40024,288,14220
1783.566,1,166,9296,166,28,10809,28,9296,0,0,0,0,0
0.524,17,14,7690,7,716,87,1350,5214,7,325,78,1350,2476
1785.879,1,26,1456,26,28,71435,28,1456,0,0,0,0,0
0.249,17,2,180,1,30,0,30,58,1,94,0,94,122
117.99,6,72,49129,45,1206,2681,1408,40992,27,747,2373,1408,8137
1786.98,6,102,8228,68,64,26671,64,4896,34,58,54148,58,3332
1779.104,6,104,8376,68,65,26553,65,4930,36,59,50828,59,3446
150.038,6,28,6562,11,220,5498,516,1325,17,325,9371,1452,5237
39.125,17,61,32195,27,435,1503,1350,12515,34,550,1184,1350,19680
0.15,6,9,1340,5,145,37,145,349,4,827,45,827,991
0.298,17,2,192,1,60,0,60,88,1,76,0,76,104
1680.503,17,12,498,11,14,168050,14,462,1,8,0,8,36
0.022,6,5,310,3,31,11,31,175,2,31,1,31,135
0.28,6,7,466,5,43,60,43,354,2,0,278,0,112
1786.808,6,116,13869,76,83,23824,516,6038,40,163,45812,1452,7831
0.021,6,12,3705,6,171,2,171,491,6,964,4,1448,3214
536.338,17,40,3184,22,48,25539,48,1672,18,56,25504,56,1512
30.339,17,8,704,4,48,10110,48,304,4,72,10109,72,400
1787.03,6,103,6786,65,50,27922,208,4255,38,33,46642,112,2531
462.971,17,6,528,3,60,231485,60,264,3,60,231485,60,264
1799.47,17,450,39960,405,35,4454,288,25740,45,288,40022,288,14220
13.824,6,30,7432,13,158,1152,267,1317,17,543,860,1400,6115
1786.632,17,332,74908,332,197,5397,422,74908,0,0,0,0,0
0.025,17,2,357,1,41,0,41,69,1,260,0,260,288
100.731,6,53,20330,29,1110,556,1360,14568,24,479,4372,4027,5762
1121.09,17,10,740,5,30,280269,30,290,5,62,280268,62,450
137.194,6,17,3308,8,92,19599,92,504,9,333,17123,1408,2804
1.19,6,48,19195,27,890,45,1360,13579,21,476,51,2715,5616
237.832,17,6,525,3,32,118891,37,181,3,86,118908,136,344
1.634,6,10,1514,5,503,408,503,771,5,475,408,475,743
378.086,2,3,96,3,8,189043,8,96,0,0,0,0,0
0.635,17,2,154,1,33,0,33,61,1,65,0,65,93
3.545,17,10,2399,5,40,883,40,340,5,383,882,423,2059
0.13,17,2,280,1,64,0,64,92,1,160,0,160,188
300.829,6,50,10495,25,433,12534,910,3258,25,327,527,1460,7237
92.228,6,22,7972,11,511,85,1194,2005,11,919,9205,1631,5967
1.661,6,13,2311,8,188,237,245,700,5,1407,352,1407,1611
149.197,17,4,352,2,60,149196,60,176,2,60,149196,60,176
1776.315,6,184,15916,120,69,14927,69,8940,64,69,28187,69,6976
1783.392,6,114,12253,74,81,24430,504,5880,40,128,45725,2642,6373
1.845,2,2,64,2,8,1845,8,64,0,0,0,0,0
1742.918,6,87,6322,58,31,30577,31,3915,29,31,62246,31,2407
0.031,6,6,374,3,31,15,31,187,3,31,12,31,187
3.765,17,11,12585,5,1098,941,1350,5631,6,1131,459,1350,6954
180.777,17,4,332,2,31,180754,33,118,2,79,180736,93,214
0.021,17,2,202,1,43,0,43,71,1,103,0,103,131
1745.777,6,142,9337,78,56,22672,208,5878,64,31,27706,31,3459
0.326,6,23,5935,12,164,29,453,1442,11,782,31,2231,4493
842.539,17,223,28179,105,159,8101,1350,19719,118,43,7198,1350,8460
4.338,6,39,7285,20,218,228,314,3423,19,516,226,1179,3862
0.044,17,2,362,1,46,0,46,74,1,260,0,260,288
20.835,6,8,506,0,0,0,0,0,8,31,2976,31,506
11.633,6,1861,1607779,1128,1371,10,1420,1574238,733,467,15,1883,33541
0.818,17,2,148,1,32,0,32,60,1,60,0,60,88
280.996,6,31,7813,13,158,23416,267,1317,18,524,16509,1400,6496
0.611,6,126,88386,58,131,10,232,2849,68,1335,8,1420,85537
6.758,6,35,6816,18,211,397,314,3050,17,513,397,1179,3766
15.503,17,23,14582,14,861,1190,1350,12455,9,208,1933,1350,2127
2.228,6,47,17866,26,855,89,1460,12199,21,401,101,2615,5667
2.918,6,17,3627,8,92,416,92,540,9,373,338,1448,3087
153.864,17,14,1120,7,48,25642,48,532,7,56,25641,56,588
1772.145,6,180,15480,120,69,14891,69,8940,60,69,30035,69,6540
1787.908,6,373,23545,212,69,8473,69,12896,161,69,11174,69,10649
597.106,6,11,657,8,31,85300,31,444,3,31,264354,31,213
91.247,17,4,352,2,60,91246,60,176,2,60,91246,60,176
1772.614,6,213,14838,78,46,23018,46,6126,135,46,13228,46,8712
450.96,1,9,504,9,28,56370,28,504,0,0,0,0,0
0.1,17,2,572,1,39,0,39,67,1,477,0,477,505
55.097,6,4986,4459579,2993,1402,18,1448,4342327,1993,776,27,1448,117252
453.662,17,281,65308,281,204,1620,220,65308,0,0,0,0,0
0.118,1,2,163,2,53,118,78,163,0,0,0,0,0
176.936,6,25,9017,13,468,92,1067,1982,12,934,16068,3151,7035
1799.827,17,769,46450,769,32,2343,37,46450,0,0,0,0,0
187.856,6,8,416,8,0,0,0,416,0,0,0,0,0
136.989,17,4,352,2,60,136987,60,176,2,60,136988,60,176
1796.463,1,290,30740,290,78,6216,78,30740,0,0,0,0,0
85.787,6,24,4909,9,235,261,515,1305,15,300,6120,1452,3604
4.265,17,2,1430,2,687,4265,687,1430,0,0,0,0,0
1799.691,17,448,39896,403,35,4476,288,25676,45,288,40019,288,14220
300.948,6,50,20423,28,1045,11146,1460,14741,22,399,419,1460,5682
0.29,6,28,9124,13,252,24,647,1692,15,830,20,1408,7432
4.898,17,2,656,2,300,4898,300,656,0,0,0,0,0
229.513,17,4,240,2,32,229512,32,120,2,32,229512,32,120
1792.239,6,356,22520,208,69,8658,69,12460,148,69,12191,69,10060
1772.988,6,180,15480,120,69,14899,69,8940,60,69,30049,69,6540
1798.662,17,449,39928,404,35,4463,288,25708,45,288,40017,288,14220
1789.818,6,414,24840,207,69,8688,69,12420,207,34,8688,64,12420
2.001,17,3,222,3,46,1000,46,222,0,0,0,0,0
91.498,6,35,8262,9,162,177,267,1343,26,293,3659,1420,6919
1772.532,6,180,15480,120,69,14895,69,8940,60,69,30037,69,6540
293.355,1,4,326,4,53,97785,78,326,0,0,0,0,0
4.006,17,8,1304,4,33,1331,33,244,4,237,1330,249,1060
1510.845,17,384,76961,384,172,3944,391,76961,0,0,0,0,0
17.263,17,23,12582,12,772,1566,1350,9604,11,242,1723,1350,2978
0.705,6,7,371,4,0,235,0,204,3,7,197,7,167
1.366,6,48,18881,26,934,54,1440,13225,22,433,56,1440,5656
0.039,17,2,912,1,308,0,308,336,1,548,0,548,576
300.828,6,38,9612,20,651,15833,1440,4090,18,399,509,1440,5522
0.217,17,2,176,1,48,0,48,76,1,72,0,72,100
478.262,1,5,280,5,28,119565,28,280,0,0,0,0,0
182.407,17,4,304,2,48,182400,48,152,2,48,182399,48,152
1.524,17,3,1164,3,360,762,360,1164,0,0,0,0,0
1745.673,17,278,58107,278,181,6302,422,58107,0,0,0,0,0
1787.298,6,372,25988,216,99,8313,469,15194,156,69,11530,69,10794
1776.27,1,74,4144,74,28,24332,28,4144,0,0,0,0,0
1799.322,17,4196,201408,2098,20,858,20,100704,2098,20,858,20,100704
280.213,6,28,7352,13,158,23351,267,1317,15,678,20013,3436,6035
5.206,6,3087,2842656,1486,219,3,230,82037,1601,1674,3,8448,2760619
1719.695,17,13,534,11,14,171949,14,462,2,8,1719504,8,72
25.038,17,5,5392,5,1050,6259,1072,5392,0,0,0,0,0
3.938,17,10,2447,5,40,981,40,340,5,393,982,423,2107
340.391,17,6,2000,6,305,68078,308,2000,0,0,0,0,0
0.247,6,22,5040,10,137,27,267,1092,12,577,21,1400,3948
1774.376,6,182,15698,122,69,14664,69,9158,60,69,30065,69,6540
165.004,6,11,4863,5,352,41251,722,1325,6,1070,5023,1448,3538
598.578,6,9,546,6,31,119715,31,333,3,31,299279,31,213
112.234,6,9,522,2,106,112222,106,194,7,0,18703,0,328
240.325,6,43,8869,21,524,12015,1418,5818,22,211,11443,619,3051
1785.906,17,87,3648,86,14,21010,14,3612,1,8,0,8,36
240.286,6,41,8781,20,523,12646,1408,5760,21,213,12014,617,3021
1751.677,6,95,7203,63,38,28252,205,4476,32,33,56493,98,2727
1770.966,6,99,9306,66,66,27245,66,5610,33,60,55339,60,3696
23.839,6,37,8357,18,171,1402,721,2093,19,611,1312,2840,6264
7.121,17,6,528,3,48,3533,48,228,3,72,3523,72,300
300.87,6,42,10550,22,658,14327,1360,4886,20,346,454,1360,5664
6.01,17,4,532,2,41,6006,41,138,2,169,6003,169,394
1.102,6,3,144,2,0,1102,0,92,1,0,0,0,52
0.453,6,53,22730,30,956,15,1380,15645,23,558,18,1923,7085
0.006,17,2,570,1,30,0,30,58,1,484,0,484,512
61.852,6,67,48304,44,1190,1438,1448,40377,23,747,2800,1448,7927
1786.829,6,356,22520,208,69,8632,69,12460,148,69,12155,69,10060
240.23,6,53,17913,28,795,8896,1418,14979,25,203,10008,580,2934
0.149,6,10,1677,6,555,29,951,1354,4,159,30,159,323
1651.751,1,8,448,8,28,235964,28,448,0,0,0,0,0
20.127,6,19,2949,10,255,2236,517,1815,9,323,2514,499,1134
93.466,6,7,396,3,0,46642,0,164,4,0,31094,0,232
1744.719,2,23,736,23,8,79305,8,736,0,0,0,0,0
0.14,6,12,3462,6,75,28,75,395,6,1373,27,1448,3067
19.909,2,2,64,2,8,19909,8,64,0,0,0,0,0
300.243,6,31,11813,17,589,18765,1438,4438,14,948,18481,1488,7375
0.763,6,15,4635,9,290,95,517,1045,6,1631,148,2682,3590
11.622,6,94,29767,49,565,242,1152,23469,45,449,258,1179,6298
1787.93,6,382,26871,217,98,8277,469,15303,165,69,10901,69,11568
1783.485,6,197,12073,97,46,18577,208,7019,100,31,18007,31,5054
43.525,6,41,10340,17,172,2720,388,2095,24,382,1878,1440,8245
0.16,17,8,2750,8,315,22,354,2750,0,0,0,0,0
68.68,6,70,42814,40,1200,1761,1448,34499,30,749,2119,1448,8315
0.13,17,2,154,1,33,0,33,61,1,65,0,65,93
3.6,17,3,228,2,48,3049,48,152,1,48,0,48,76
1796.15,17,448,39896,403,35,4468,288,25676,45,288,40023,288,14220
1764.905,2,15,480,15,8,126064,8,480,0,0,0,0,0
1747.635,6,97,7307,63,38,28187,205,4476,34,33,52949,98,2831
1795.04,1,58,4872,58,56,31491,56,4872,0,0,0,0,0
1798.195,17,448,39896,403,35,4473,288,25676,45,288,40021,288,14220
0.879,17,2,778,2,361,879,361,778,0,0,0,0,0
1798.823,17,187,44004,187,207,9671,356,44004,0,0,0,0,0
520.035,1,16,896,16,28,34669,28,896,0,0,0,0,0
27.132,6,46,13070,22,194,1292,721,2634,24,728,1148,1440,10436
13.718,6,2076,1834440,1216,1423,11,1448,1783332,860,776,15,1448,51108
30.047,6,12,1313,7,185,5007,185,557,5,244,7501,476,756
20.176,6,24,5857,13,107,1681,159,1138,11,689,2016,1402,4719
3.828,6,2,1235,1,0,0,0,40,1,1155,0,1155,1195
18.719,6,140,80885,72,339,263,339,5337,68,1142,278,2736,75548
205.413,1,3,489,3,135,102706,142,489,0,0,0,0,0
93.799,6,21,8224,11,549,84,1309,2120,10,948,10402,1591,6104
0.272,17,3,507,2,39,174,39,134,1,345,0,345,373
4.081,6,38,7229,19,218,226,314,3383,19,513,212,1179,3846
1083.053,6,66,5185,36,66,25055,66,2628,30,52,37343,60,2557
1751.306,6,95,7203,63,38,28246,205,4476,32,33,56482,98,2727
280.035,6,29,7392,13,158,23336,267,1317,16,603,18666,2036,6075
256.21,17,10,580,10,30,28467,30,580,0,0,0,0,0
1.249,6,11,1727,7,100,208,100,384,4,589,331,1152,1343
170.536,6,48,11228,24,461,7414,1418,5914,24,368,7413,799,5314
1793.268,1,266,14896,266,28,6767,28,14896,0,0,0,0,0
14.97,6,1973,1778384,1242,1374,12,1380,1740386,731,383,20,1380,37998
7.306,6,1530,1383017,926,1413,7,1448,1346945,604,776,11,1448,36072
124.657,6,5,293,4,31,41552,31,222,1,31,0,31,71
1772.088,6,180,15480,120,69,14891,69,8940,60,69,30033,69,6540
11.805,6,1873,1631798,1132,1387,10,1420,1597937,741,467,15,1883,33861
0.263,6,3,182,2,31,263,31,111,1,31,0,31,71
14.263,6,2353,2184346,1514,1365,9,1408,2136054,839,931,16,2816,48292
0.186,6,12,1867,7,125,30,125,497,5,367,46,500,1370
74.86,6,93,68444,59,1259,1290,1448,58513,34,679,2261,1448,9931
0.364,17,2,154,1,33,0,33,61,1,65,0,65,93
1.088,6,27,8996,13,243,90,611,1656,14,941,79,1368,7340
0.458,6,50,20853,28,1037,16,1380,15686,22,387,18,1923,5167
0.472,6,3,120,1,0,0,0,40,2,0,472,0,80
1.618,1,30,840,30,0,0,0,840,0,0,0,0,0
1798.139,17,448,39896,403,35,4472,288,25676,45,288,40017,288,14220
369.368,6,21,1419,15,177,26383,177,989,6,110,12239,110,430
252.141,17,4,558,2,36,252136,36,128,2,187,252137,187,430
12.404,6,11,676,5,106,3101,106,314,6,90,2474,90,362
1763.341,2,14,448,14,8,135641,8,448,0,0,0,0,0
0.093,6,19,9933,10,125,10,125,653,9,1467,11,1564,9280
64.006,6,24,6536,10,154,7111,267,872,14,566,4922,1420,5664
1785.482,6,356,22520,208,69,8625,69,12460,148,69,12146,69,10060
300.572,6,36,8391,20,291,15819,786,1997,16,522,561,2720,6394
0.842,6,57,21515,29,934,30,1380,16141,28,421,29,1923,5374
369.086,6,61,10464,26,104,14763,267,2516,35,218,10855,1460,7948
1318.792,1,13,1642,13,98,109899,125,1642,0,0,0,0,0
17.056,17,30,16537,15,691,1216,1350,10786,15,355,1216,1350,5751
1717.649,17,331,52468,331,130,5204,363,52468,0,0,0,0,0
7.359,6,70,22038,35,572,216,1152,16870,35,470,208,1179,5168
1.992,17,2,120,2,32,1992,32,120,0,0,0,0,0
1.417,6,51,19823,27,926,54,1460,14087,24,433,53,1460,5736
0.166,6,2,269,1,177,0,177,229,1,0,0,0,40
2.978,17,3,468,3,128,1489,128,468,0,0,0,0,0
1772.999,6,180,15480,120,69,14899,69,8940,60,69,30042,69,6540
1.682,6,25,8755,15,283,120,583,1455,10,985,166,1420,7300
0.133,6,16,6172,8,103,19,103,527,8,1044,19,1448,5645
0.389,6,15,4589,8,290,55,517,993,7,1074,38,1418,3596
71.582,6,23,8922,12,467,88,1064,1927,11,934,7141,1791,6995
0.47,17,3,451,2,39,458,39,134,1,289,0,289,317
5.011,17,4,558,2,36,5004,36,128,2,187,5007,187,430
2.016,6,9,527,5,43,504,43,311,4,0,620,0,216
0.01,17,2,323,1,33,0,33,61,1,234,0,234,262
4.608,6,7,1168,3,564,2304,564,708,4,126,801,221,460
0.274,6,22,7333,12,334,24,663,1969,10,806,29,1408,5364
144.534,17,12,2000,6,48,28905,48,456,6,229,28905,308,1544
0.419,6,12,1653,6,288,79,288,548,6,426,48,434,1105
5.946,6,1389,1263753,862,1388,6,1408,1231685,527,931,10,2816,32068
6.997,17,37,9094,11,301,699,1350,3620,26,182,278,1350,5474
630.006,2,4,128,4,8,210002,8,128,0,0,0,0,0
79.762,17,3,195,3,37,39881,47,195,0,0,0,0,0
0.346,6,2,149,1,0,0,0,40,1,69,0,69,109
1.272,6,24,8004,11,164,108,267,1236,13,869,88,1448,6768
11.71,6,14,1247,7,222,1950,222,728,7,231,1950,231,519
1746.803,6,95,7203,63,38,28174,205,4476,32,33,56339,98,2727
1743.464,6,95,7203,63,38,28120,205,4476,32,33,56226,98,2727
10.967,6,18,5610,10,275,1218,275,958,8,1440,849,1440,4652
1.009,6,24,8004,12,164,91,267,1288,12,869,73,1448,6716
2.442,6,113,86952,49,131,50,232,2489,64,1388,34,2755,84463
1793.346,6,238,35476,150,302,12035,302,25920,88,83,20613,83,9556
86.96,1,2,112,2,28,86960,28,112,0,0,0,0,0
0.121,6,10,1669,6,551,24,947,1346,4,159,40,159,323
0.242,6,25,6116,12,181,22,537,1526,13,651,19,1402,4590
3.563,6,47,15829,25,231,140,561,3189,22,903,160,1440,12640
0.047,17,4,336,2,34,1,34,124,2,78,3,84,212
0.283,6,2,80,1,0,0,0,40,1,0,0,0,40
0.391,6,6,324,4,0,130,0,216,2,0,206,0,108
1792.837,6,357,22629,208,69,8661,69,12460,149,69,12113,69,10169
10.641,6,1692,1471200,1022,1385,10,1420,1440179,670,467,15,1883,31021
1779.687,17,140,11200,70,48,25792,48,5320,70,56,25792,56,5880
1786.643,6,102,8296,68,65,26666,65,4930,34,59,54137,59,3366
0.057,6,2,336,1,0,0,0,40,1,256,0,256,296
0.382,6,10,968,5,256,93,256,460,5,304,92,304,508
4.825,6,41,7349,22,218,229,314,3503,19,440,253,1152,3846
63.456,6,12,732,3,106,31720,106,234,9,90,7929,90,498
0.843,6,26,8113,15,314,60,663,2673,11,1209,80,1946,5440
421.145,2,5,160,5,8,105286,8,160,0,0,0,0,0
2.119,17,2,136,1,32,0,32,60,1,48,0,48,76
1785.828,6,102,8296,68,65,26654,65,4930,34,59,54112,59,3366
0.395,6,27,9078,13,263,32,691,1736,14,943,28,1438,7342
7.07,6,507,461526,332,1328,20,1368,447762,175,931,39,2736,13764
1773.458,17,65,2724,64,14,28150,14,2688,1,8,0,8,36
1785.968,1,342,28728,342,56,5237,56,28728,0,0,0,0,0
8.3,6,78,24677,40,561,212,1152,19016,38,413,217,1152,5661
59.27,6,16,1166,8,39,8466,39,455,8,49,8467,63,711
1790.915,6,413,24800,208,69,8651,69,12460,205,35,8778,69,12340
1748.328,6,99,7814,65,45,27317,205,4850,34,35,52969,98,2964
17.906,6,25,9468,14,372,1377,808,1708,11,1044,1751,1696,7760
1.348,6,50,19690,27,920,51,1440,13994,23,433,53,1440,5696
795.588,17,28,9408,28,308,29466,308,9408,0,0,0,0,0
1769.195,1,58,4872,0,0,0,0,0,58,56,31038,56,4872
1778.918,17,140,11200,70,48,25781,48,5320,70,56,25781,56,5880
2.348,6,27,8827,16,282,156,578,1490,11,984,216,1452,7337
217.888,17,3,228,3,48,108944,48,228,0,0,0,0,0
1776.243,6,204,22405,130,75,13769,267,10063,74,133,24326,1917,12342
0.811,6,24,4546,12,165,73,456,1446,12,493,65,888,3100
96.037,6,748,354463,399,827,241,1152,335323,349,431,275,1179,19140
100.28,6,23,6479,9,220,8044,516,1246,14,389,7706,1452,5233
1796.527,17,142,11360,71,48,25664,48,5396,71,56,25664,56,5964
1.284,6,46,18991,26,949,51,1460,13415,20,433,58,1460,5576
0.371,6,10,1634,5,131,92,131,399,5,967,92,967,1235
6.971,17,39,11847,12,447,633,1350,5705,27,199,266,1350,6142
4.124,6,17,2718,10,466,458,826,1927,7,139,344,236,791
1773.178,6,181,15589,120,69,14900,69,8940,61,69,29547,69,6649
10.015,6,16,3911,9,275,1251,275,643,7,992,873,1440,3268
3.914,17,5,290,5,30,978,30,290,0,0,0,0,0
481.757,2,3,96,3,8,240878,8,96,0,0,0,0,0
0.011,17,2,346,1,60,0,60,88,1,230,0,230,258
6.765,6,43,9968,23,164,301,401,2429,20,517,348,1440,7539
0.298,17,2,152,1,48,0,48,76,1,48,0,48,76
31.801,17,4,352,2,48,31793,48,152,2,72,31792,72,200
1763.679,2,15,480,15,8,125977,8,480,0,0,0,0,0
0.098,17,2,157,1,31,0,31,59,1,70,0,70,98
1.086,17,2,144,1,36,0,36,64,1,52,0,52,80
1781.767,6,366,25541,213,100,8404,469,14936,153,69,11722,69,10605
9.843,17,6,1392,6,204,1968,204,1392,0,0,0,0,0
3.777,17,4,352,2,48,3769,48,152,2,72,3769,72,200
21.365,17,2,904,1,300,0,300,328,1,548,0,548,576
6.247,6,12,6233,4,275,2082,275,439,8,911,839,2059,5794
1682.116,17,14,1036,7,30,280350,30,406,7,62,280350,62,630
13.627,6,14,2186,9,325,1703,586,1126,5,396,3362,580,1060
111.182,6,20,8946,5,275,27795,275,479,15,604,7742,2840,8467
36.195,6,4684,4303400,2812,1441,12,1448,4190556,1872,776,19,1448,112844
0.113,17,2,2386,2,1165,113,1165,2386,0,0,0,0,0
319.344,6,8,506,8,31,45620,31,506,0,0,0,0,0
0.163,6,24,7176,12,155,14,267,1261,12,775,14,3445,5915
675.573,6,72,9666,36,145,19302,721,5203,36,199,19297,1408,4463
0.013,17,4,420,2,33,1,33,122,2,121,1,145,298
12.589,17,4,352,2,60,12586,60,176,2,60,12588,60,176
0.781,6,10,1102,6,483,156,483,803,4,83,258,83,299
1793.17,1,54,4536,0,0,0,0,0,54,56,33833,56,4536
19.402,6,6,436,0,0,0,0,0,6,31,3880,31,436
1776.75,17,73,3060,72,14,25024,14,3024,1,8,0,8,36
0.075,6,26,14051,14,520,2,956,1912,12,1278,6,2816,12139
1789.558,6,355,22699,197,73,9130,138,12572,158,46,9744,69,10127
1740.327,6,87,6322,58,31,30532,31,3915,29,31,62153,31,2407
1707.913,1,32,3715,32,88,55093,105,3715,0,0,0,0,0
1770.545,6,104,9648,68,65,26426,65,5758,36,59,50584,59,3890
1784.742,1,264,14784,264,28,6786,28,14784,0,0,0,0,0
1.15,17,2,2386,2,1165,1150,1165,2386,0,0,0,0,0
38.958,17,22,1672,22,48,1855,48,1672,0,0,0,0,0
2.106,17,3,174,3,30,1053,30,174,0,0,0,0,0
0.765,6,27,5927,13,156,63,267,1462,14,650,54,1420,4465
242.533,6,37,4082,17,160,15157,585,1719,20,217,12764,580,2363
0.058,17,4,352,2,37,49,37,130,2,83,50,89,222
1785.99,6,102,8296,68,65,26656,65,4930,34,59,54118,59,3366
1195.142,6,238,15109,139,69,8660,69,8389,99,69,12195,69,6720
15.722,17,27,11764,14,621,1206,1350,9097,13,177,1306,1350,2667
0.036,17,2,166,1,47,0,47,75,1,63,0,63,91
1785.777,6,102,8364,68,66,26653,66,4964,34,60,54111,60,3400
1.836,17,4,240,2,32,1835,32,120,2,32,1835,32,120
0.765,17,15,7875,7,656,126,1350,4794,8,357,104,1350,3081
167.239,6,21,8321,11,532,85,1257,2068,10,973,18562,1791,6253
1.363,6,48,19979,28,883,50,1360,14403,20,476,61,2715,5576
2.056,17,21,12752,12,855,184,1350,10598,9,211,253,1350,2154
0.633,6,10,968,5,256,156,256,460,5,304,156,304,508
118.596,6,112,86390,73,1248,1647,1408,76242,39,811,3115,3847,10148
92.632,6,42,9801,15,327,1694,1189,2575,27,341,3561,1917,7226
0.938,17,4,368,2,64,937,64,184,2,64,936,64,184
1770.225,6,101,9410,66,66,27234,66,5610,35,60,52061,60,3800
0.745,6,7,450,3,31,372,31,218,4,0,133,0,232
314.526,6,27,5687,9,133,39315,159,887,18,773,18501,1408,4800
117.375,6,900,445469,500,825,235,1152,424678,400,435,293,1179,20791
0.06,17,4,952,2,64,55,64,184,2,356,53,356,768
0.91,17,4,368,2,64,909,64,184,2,64,909,64,184
1780.12,17,142,11360,71,48,25430,48,5396,71,56,25430,56,5964
4.644,6,41,7349,21,218,232,314,3463,20,440,231,1152,3886
325.233,6,27,6494,11,220,5484,516,1326,16,348,21675,1452,5168
301.581,6,53,21903,31,981,10052,1360,15992,22,386,448,2667,5911
1.175,6,10,924,5,283,248,283,551,5,105,248,105,373
245.12,6,85,21995,39,520,6450,1418,13490,46,339,5445,1418,8505
1770.456,6,99,9174,66,64,27237,64,5544,33,58,55323,58,3630
282.74,17,4,240,2,32,282739,32,120,2,32,282739,32,120
0.007,17,4,352,2,37,3,37,130,2,83,2,89,222
82.311,6,19,772,8,0,6837,0,324,11,0,8230,0,448
0.875,6,16,6056,9,70,108,133,504,7,1756,144,2828,5552
1772.334,6,180,15480,120,69,14893,69,8940,60,69,30034,69,6540
87.054,6,59,26786,32,713,92,1460,10594,27,838,3343,1460,16192
50.728,6,6707,6520821,4597,1343,10,1368,6406413,2110,776,23,1473,114408
0.338,6,10,1669,6,551,67,947,1346,4,159,112,159,323
0.654,6,21,7853,12,533,59,1050,2233,9,857,79,1491,5620
1.562,17,7,480,4,32,426,32,240,3,52,621,60,240
419.467,6,81,15584,36,774,11984,1408,10481,45,83,9533,580,5103
0.195,6,3,189,1,0,0,0,40,2,69,174,69,149
1790.429,1,252,14112,252,28,7133,28,14112,0,0,0,0,0
0.085,6,5,260,0,0,0,0,0,5,0,0,0,260
0.639,6,23,7352,13,325,53,626,1984,10,1210,65,3314,5368
0.025,17,2,362,1,32,0,32,60,1,274,0,274,302
228.785,6,289,217893,170,1294,1353,1368,200461,119,641,1694,2736,17432
1739.354,1,55,4620,0,0,0,0,0,55,56,32210,56,4620
3.891,17,4,352,2,48,3883,48,152,2,72,3881,72,200
214.978,6,30,7432,13,158,17914,267,1317,17,603,13433,2076,6115
5.028,17,4,288,2,36,5007,36,128,2,52,5012,52,160
10.082,6,83,25090,43,568,240,1152,19349,40,413,251,1152,5741
1786.128,17,87,3648,86,14,21013,14,3612,1,8,0,8,36
1786.249,6,102,8296,68,65,26660,65,4930,34,59,54125,59,3366
176.215,6,15,820,9,0,22026,0,484,6,0,34682,0,336
205.048,6,17,1323,10,332,22783,332,860,7,83,34043,83,463
1772.322,6,180,15480,120,69,14893,69,8940,60,69,30035,69,6540
1794.219,17,27,9315,27,317,69008,317,9315,0,0,0,0,0
0.879,6,35,8294,19,277,48,763,1901,16,521,49,3488,6393
0.189,17,2,237,1,72,0,72,100,1,109,0,109,137
1776.913,17,73,3060,72,14,25026,14,3024,1,8,0,8,36
107.056,17,4,454,2,32,107033,32,120,2,139,107034,139,334
0.266,2,2,64,2,8,266,8,64,0,0,0,0,0
1742.834,6,95,7203,63,38,28110,205,4476,32,33,56213,98,2727
1.5,6,19,3781,10,234,166,564,1452,9,463,162,1343,2329
1785.303,6,103,8395,68,65,26646,65,4930,35,59,52506,59,3465
10.844,6,18,3943,10,275,1204,275,683,8,974,859,1414,3260
1745.445,6,90,6540,60,31,29583,31,4050,30,31,60179,31,2490
1.114,6,25,8794,12,427,100,1076,2192,13,868,92,1420,6602
20.843,17,5,5500,5,1072,5210,1072,5500,0,0,0,0,0
1796.103,17,448,39896,403,35,4467,288,25676,45,288,40020,288,14220
4.086,17,15,16789,3,932,2043,1350,2881,12,1131,286,1350,13908
98.629,1,3,405,3,107,49314,173,405,0,0,0,0,0
299.574,6,6,364,4,31,99858,31,222,2,31,299535,31,142
1556.74,6,160,13783,105,69,14968,69,7788,55,69,28828,69,5995
15.427,6,22,4156,10,211,1714,293,1671,12,285,1054,1179,2485
0.078,17,2,157,1,31,0,31,59,1,70,0,70,98
1787.086,6,161,20835,95,302,19011,302,14640,66,83,27493,83,6195
1783.816,6,364,25392,212,100,8454,469,14896,152,69,11813,69,10496
1791.776,1,227,12712,227,28,7928,28,12712,0,0,0,0,0
61.787,6,70,47695,44,1156,1436,1408,38202,26,903,2463,2816,9493
1.503,6,19,3781,10,234,167,564,1452,9,463,163,1343,2329
3.31,6,25,6642,14,677,254,1360,5333,11,281,314,541,1309
6.804,6,16,10568,6,156,1360,156,448,10,1386,562,2134,10120
0.185,6,3,132,2,0,0,0,92,1,0,0,0,40
1782.05,6,328,39480,141,139,12726,1460,19127,187,133,9580,1642,20353
2.765,6,10,775,4,186,920,186,402,6,45,552,45,373
403.287,6,73,12934,37,102,9215,267,3222,36,284,11522,1460,9712
204.345,6,135,100197,83,1269,2492,1408,89354,52,739,2005,2816,10843
0.272,17,2,198,1,63,0,63,91,1,79,0,79,107
0.647,6,134,96299,80,1294,8,1420,89918,54,467,12,1883,6381
3.326,17,5,290,5,30,831,30,290,0,0,0,0,0
1786.662,6,102,8228,68,64,26666,64,4896,34,58,54138,58,3332
0.337,6,26,8990,13,247,28,624,1672,13,947,25,1408,7318
35.487,17,3,228,3,48,17743,48,228,0,0,0,0,0
1711.94,17,132,10544,68,48,25551,48,5168,64,56,25562,56,5376
0.408,6,51,23806,29,1030,14,1380,18693,22,467,17,1923,5113
11.005,6,20,4442,11,275,1100,275,998,9,768,768,1440,3444
1770.299,6,101,9278,66,64,27235,64,5544,35,58,52065,58,3734
1799.412,1,57,4788,57,56,32132,56,4788,0,0,0,0,0
1.477,6,51,19295,28,953,54,1460,13554,23,400,58,1460,5741
2.945,17,3,228,2,48,2902,48,152,1,48,0,48,76
1.815,6,27,10179,16,285,121,587,1499,11,1029,164,1420,8680
1.718,6,11,1727,7,100,286,100,384,4,1179,460,1179,1343
39.132,17,22,1672,22,48,1863,48,1672,0,0,0,0,0
0.251,6,368,382031,111,201,2,486,6585,257,1431,0,2876,375446
1730.866,6,84,14288,53,105,33285,1440,5429,31,288,57689,1440,8859
0.231,17,2,152,1,48,0,48,76,1,48,0,48,76
176.39,17,6,366,3,33,88194,33,183,3,33,88194,33,183
2.615,17,25,13394,12,557,237,1350,7030,13,461,144,1350,6364
1792.001,6,357,23029,208,75,8656,469,12860,149,69,12108,69,10169
3.51,17,5,340,5,40,877,40,340,0,0,0,0,0
1788.078,6,356,22520,208,69,8638,69,12460,148,69,12163,69,10060
8.754,6,36,8299,18,333,514,685,1764,18,446,505,3488,6535
0.415,6,51,21980,28,1042,15,1380,16818,23,421,17,1923,5162
1797.322,1,67,5628,67,56,27232,56,5628,0,0,0,0,0
1.965,1,3,252,3,56,982,56,252,0,0,0,0,0
0.337,6,28,9128,13,252,28,647,1692,15,831,23,1408,7436
1782.866,6,102,8296,68,65,26609,65,4930,34,59,54023,59,3366
243.924,6,15,1477,5,187,12,187,455,10,247,27100,462,1022
292.839,6,34,7032,16,262,19519,517,1628,18,744,17223,1418,5404
0.448,6,18,7047,11,318,42,600,1854,7,1607,72,3299,5193
1741.043,6,87,6322,58,31,30544,31,3915,29,31,62178,31,2407
280.033,6,26,7272,12,158,25457,267,1277,14,775,21538,3445,5995
0.062,6,11,912,6,181,12,181,489,5,77,4,134,423
0.511,17,3,543,2,39,372,39,134,1,381,0,381,409
0.017,17,2,672,2,308,17,308,672,0,0,0,0,0
1796.733,17,448,39896,403,35,4469,288,25676,45,288,40022,288,14220
180.608,17,16,5376,16,308,12040,308,5376,0,0,0,0,0
5.054,6,38,7229,20,218,266,314,3423,18,513,281,1179,3806
0.016,17,5,824,3,32,5,32,180,2,294,11,294,644
1788.153,6,365,24963,212,94,8474,469,14496,153,69,11761,69,10467
1745.515,6,177,15222,118,69,14918,69,8791,59,69,30088,69,6431
1786.125,6,214,25548,137,105,13133,469,12879,77,134,23498,4837,12669
1.333,6,39,8292,19,320,74,1162,2716,20,433,60,1460,5576
1795.201,17,447,39864,402,35,4476,288,25644,45,288,40022,288,14220
89.389,17,44,10714,18,388,1815,1350,7501,26,95,3574,1350,3213
60.238,6,8,432,5,0,15059,0,268,3,0,30011,0,164
1762.173,6,196,12325,97,51,18355,208,7404,99,31,17978,31,4921
71.733,6,37,8156,14,154,5517,267,1649,23,371,3253,2760,6507
0.575,6,37,9474,20,110,30,322,1714,17,642,26,1360,7760
281.82,6,26,7272,12,158,25620,267,1277,14,775,21655,4200,5995
132.414,17,4,240,2,32,132413,32,120,2,32,132413,32,120
319.13,1,6,336,6,28,63826,28,336,0,0,0,0,0
474.26,17,24,8040,24,307,20620,308,8040,0,0,0,0,0
0.375,6,26,8990,13,247,31,624,1672,13,947,28,1438,7318
1.944,6,66,24425,34,888,58,1440,13902,32,543,56,1440,10523
0.028,6,10,1512,5,503,6,503,771,5,473,7,473,741
1785.963,6,104,8504,69,66,26264,66,5004,35,60,52525,60,3500
1799.951,6,242,23144,120,137,15125,208,17148,122,31,14365,31,5996
780.16,6,91,6262,34,46,23641,46,2694,57,46,13928,46,3568
11.472,6,2191,2073049,1385,1418,8,1448,2026461,806,776,14,1448,46588
0.425,6,105,66277,59,1252,7,1420,59988,46,526,9,3303,6289
87.17,6,7,10500,7,1448,14528,1448,10500,0,0,0,0,0
1797.085,17,448,39896,403,35,4470,288,25676,45,288,40017,288,14220
17.55,17,35,9426,17,325,1094,1350,6010,18,161,1029,1350,3416
1787.387,6,354,22440,207,69,8676,69,12420,147,69,12242,69,10020
1777.551,17,45,15112,45,307,40398,308,15112,0,0,0,0,0
0.48,6,62,27501,35,1017,14,1380,18831,27,582,17,3303,8670
31.535,6,7,308,1,0,0,0,44,6,0,6286,0,264
109.473,1,3,394,3,103,54736,117,394,0,0,0,0,0
10.669,6,20,4442,11,275,1066,275,998,9,768,749,1440,3444
224.026,6,215,175468,141,1288,1600,1408,160724,74,680,2173,3847,14744
1787.258,6,104,8504,69,66,26283,66,5004,35,60,52563,60,3500
1346.07,1,16,896,16,28,89738,28,896,0,0,0,0,0
1772.299,6,180,15480,120,69,14893,69,8940,60,69,30037,69,6540
0.307,6,24,6064,12,181,27,537,1526,12,651,25,1408,4538
1.669,6,48,18823,26,930,66,1460,13167,22,433,69,1460,5656
601.607,2,6,192,6,8,120321,8,192,0,0,0,0,0
1794.011,17,144,11520,72,48,25267,48,5472,72,56,25267,56,6048
1729.899,6,76,13765,49,112,36039,1368,5134,27,300,66526,2523,8631
5.034,17,4,288,2,36,5003,36,128,2,52,5003,52,160
299.513,6,6,364,4,31,99837,31,222,2,31,299505,31,142
0.445,6,12,1653,6,288,81,288,548,6,426,53,434,1105
280.326,6,30,7432,13,158,23360,267,1317,17,543,17511,1400,6115
109.053,17,4,240,2,32,109052,32,120,2,32,109052,32,120
0.193,6,47,22839,27,1114,7,1432,17818,20,420,9,1432,5021
1783.24,17,83,3480,82,14,22015,14,3444,1,8,0,8,36
69.009,6,10,754,10,26,7667,26,754,0,0,0,0,0
1323.564,2,13,416,13,8,110297,8,416,0,0,0,0,0
47.395,6,11,596,6,0,9479,0,320,5,0,11836,0,276
1650.656,1,8,448,8,28,235808,28,448,0,0,0,0,0
1797.848,17,450,39448,405,34,4450,288,25476,45,282,40020,288,13972
1789.326,17,142,11360,71,48,25561,48,5396,71,56,25561,56,5964
0.031,6,19,4192,10,101,3,101,629,9,441,3,500,3563
136.084,17,2,672,2,308,136084,308,672,0,0,0,0,0
30.386,6,14,5633,4,106,10124,106,274,10,823,3375,1420,5359
16.23,17,23,13281,13,812,1346,1350,10930,10,207,1792,1350,2351
1798.877,1,53,5618,53,78,34593,78,5618,0,0,0,0,0
3.936,17,4,240,4,32,1312,32,240,0,0,0,0,0
28.645,6,13,2133,8,324,4092,585,1073,5,396,7145,580,1060
1751.702,1,54,4536,54,56,33050,56,4536,0,0,0,0,0
1.726,6,14,2351,8,188,246,245,700,6,703,292,1152,1651
6.48,6,23,4478,12,213,589,597,1689,11,441,630,1448,2789
0.393,6,2,133,1,0,0,0,40,1,53,0,53,93
1799.835,17,140,11200,70,48,26084,48,5320,70,56,26083,56,5880
1797.811,1,345,28980,345,56,5226,56,28980,0,0,0,0,0
10.993,6,18,5610,10,275,1221,275,958,8,1440,849,1440,4652
38.088,6,30,7432,13,158,3174,267,1317,17,543,2378,1400,6115
80.66,6,23,10009,12,531,64,1360,2637,11,1384,8051,3934,7372
0.122,6,9,1338,5,549,30,549,753,4,421,29,421,585
1783.803,6,367,24643,212,87,8454,469,14096,155,69,11583,69,10547
280.372,6,30,7432,13,158,23364,267,1317,17,543,17520,1400,6115
1789.265,1,61,5124,0,0,0,0,0,61,56,29821,56,5124
1.338,6,48,20108,28,892,49,1360,14532,20,433,61,1360,5576
6.314,6,920,799063,553,1367,11,1408,775315,367,931,16,2816,23748
307.152,6,22,3199,10,221,34127,517,1426,12,381,27922,499,1773
0.028,17,4,865,2,47,0,47,150,2,329,1,341,715
31.435,6,7,336,1,0,0,0,48,6,0,6283,0,288
300.78,6,30,8198,14,204,23136,467,1552,16,446,7140,1402,6646
0.938,6,10,1687,7,100,156,100,384,3,1179,343,1179,1303
3.382,17,2,656,2,300,3382,300,656,0,0,0,0,0
1797.083,17,448,39896,403,35,4470,288,25676,45,288,40019,288,14220
0.272,6,11,771,6,32,28,35,409,5,34,68,38,362
1786.388,17,87,3648,86,14,21016,14,3612,1,8,0,8,36
1777.372,17,79,3312,78,14,23082,14,3276,1,8,0,8,36
0.115,6,12,3462,6,75,22,75,395,6,1373,22,1448,3067
238.313,6,254,203865,163,1292,1471,1408,186847,91,646,2043,3847,17018
381.122,1,35,3640,0,0,0,0,0,35,76,11209,76,3640
4.856,17,27,21075,12,701,441,1350,8756,15,793,343,1350,12319
21.705,17,4,824,2,48,21691,48,152,2,308,21690,308,672
0.249,17,2,164,1,46,0,46,74,1,62,0,62,90
1779.107,17,142,11360,71,48,25415,48,5396,71,56,25415,56,5964
251.725,6,105277,111506709,34653,648,7,652,1904645,70624,1500,3,8688,109602064
138.231,17,4,352,2,60,138230,60,176,2,60,138230,60,176
5.333,6,13,3120,6,92,1066,92,400,7,1164,847,1448,2720
15.882,6,35,8185,19,333,882,685,1792,16,521,591,3488,6393
300.883,2,4,128,4,8,100294,8,128,0,0,0,0,0
111.743,6,23,10009,13,531,50,1360,2677,10,1384,12402,3934,7332
0.067,17,2,154,1,33,0,33,61,1,65,0,65,93
1.409,6,38,8252,19,320,78,1162,2716,19,476,67,2715,5536
1744.664,2,27,864,27,8,67102,8,864,0,0,0,0,0
1.654,6,11,1727,7,100,275,100,384,4,1179,466,1179,1343
26.765,6,37,9289,17,321,1672,721,2934,20,504,1355,1440,6355
60.29,17,28,2339,26,30,2408,37,1515,2,384,450,463,824
0.011,17,2,340,1,34,0,34,62,1,250,0,250,278
1730.154,6,77,13816,49,112,36044,1448,5133,28,288,64067,1448,8683
1458.429,17,48,16248,48,310,31030,320,16248,0,0,0,0,0
1799.571,17,449,39928,404,35,4465,288,25708,45,288,40017,288,14220
0.83,6,10,924,5,283,152,283,551,5,105,160,105,373
16.928,17,6,528,3,48,8460,48,228,3,72,8459,72,300
0.331,6,20,7151,12,318,30,600,1906,8,964,45,1471,5245
1778.032,1,339,28476,339,56,5260,56,28476,0,0,0,0,0
300.276,6,26,10139,14,425,23098,1114,2438,12,883,4163,1448,7701
2.371,6,20,3833,11,234,237,564,1504,9,463,273,1343,2329
193.578,17,4,352,2,60,193576,60,176,2,60,193577,60,176
80.801,2,3,96,3,8,40400,8,96,0,0,0,0,0
242.238,6,79,40315,30,711,8352,1418,10871,49,994,5046,1418,29444
1.677,6,51,21598,29,921,59,1360,15942,22,433,70,1360,5656
126.028,6,22,9696,11,380,251,832,1613,11,1090,12588,1440,8083
125.409,6,15,3197,7,92,20901,92,452,8,387,17887,1408,2745
1776.399,17,140,11200,70,48,25744,48,5320,70,56,25744,56,5880
10.001,6,10,10787,10,1038,1111,1460,10787,0,0,0,0,0
1769.253,6,102,9779,68,70,26406,234,5948,34,60,53609,83,3831
243.354,6,47,5530,24,181,10580,517,2395,23,175,11061,880,3135
1798.215,1,345,28980,345,56,5227,56,28980,0,0,0,0,0
1.536,6,14,2351,8,188,219,245,700,6,703,253,1152,1651
1.755,6,30,12500,15,196,125,438,1573,15,1126,122,1440,10927
1.277,6,23,5976,12,108,116,147,919,11,922,126,1581,5057
280.374,6,29,7392,13,158,23364,267,1317,16,603,18682,1400,6075
1681.321,1,15,840,15,28,120094,28,840,0,0,0,0,0
0.781,17,2,677,1,300,0,300,328,1,321,0,321,349
1740.927,6,91,6604,59,31,30015,31,3998,32,31,56158,31,2606
300.64,6,28,12309,17,715,18790,1408,5898,11,1166,18044,3935,6411
1771.63,6,99,9240,66,65,27255,65,5577,33,59,55360,59,3663
1772.47,6,180,15480,120,69,14894,69,8940,60,69,30037,69,6540
1691.22,1,7,742,7,78,281870,78,742,0,0,0,0,0
1748.142,6,95,7234,62,38,28658,205,4424,33,33,54622,98,2810
1771.106,6,99,9306,66,66,27247,66,5610,33,60,55344,60,3696
1781.763,6,359,22709,209,69,8566,69,12569,150,69,11958,69,10140
75.832,6,70,40582,33,746,91,1338,4722,37,1094,2105,2896,35860
384.944,6,44,10492,20,134,14894,516,2010,24,358,16732,1452,8482
1.158,6,26,7495,16,302,77,693,2761,10,721,127,1420,4734
1792.392,17,142,11360,71,48,25605,48,5396,71,56,25605,56,5964
1796.101,6,356,22520,208,69,8676,69,12460,148,69,12217,69,10060
1743.012,1,19,2048,19,79,96834,88,2048,0,0,0,0,0
5.52,6,40,7325,20,218,290,314,3423,20,516,275,1179,3902
1781.473,6,355,22549,207,69,8647,69,12420,148,69,12118,69,10129
1.695,6,11,1727,7,100,282,100,384,4,1179,478,1179,1343
1.695,6,38,9904,19,510,94,1440,4368,19,433,82,1440,5536
0.007,17,2,419,1,29,0,29,57,1,334,0,334,362
39.955,17,22,1672,22,48,1902,48,1672,0,0,0,0,0
1111.787,17,220,16720,220,48,5076,48,16720,0,0,0,0,0
0.523,6,21,7281,13,334,43,663,2021,8,967,67,1471,5260
0.125,17,2,602,1,46,0,46,74,1,500,0,500,528
15.577,17,10,880,5,48,3891,48,380,5,72,3890,72,500
94.268,6,23,1699,17,43,5891,43,1339,6,0,18852,0,360
3.352,17,5,295,5,31,838,31,295,0,0,0,0,0
280.178,6,28,7352,13,158,23348,267,1317,15,678,20010,3436,6035
372.292,6,27,1767,18,177,21899,177,1181,9,110,8915,110,586
1.687,6,14,5792,7,135,281,135,507,7,1228,281,1448,5285
1792.986,17,169,10816,169,36,10672,36,10816,0,0,0,0,0
280.018,6,30,7432,13,158,23334,267,1317,17,543,17499,1400,6115
1250.011,6,194,31337,72,73,17183,337,6464,122,277,10330,1440,24873
30.222,6,8,440,5,0,7555,0,268,3,0,15094,0,172
524.633,6,107,14376,51,150,10492,1189,5050,56,221,9538,1917,9326
44.197,17,152,11620,77,40,581,41,5279,75,56,583,57,6341
0.175,6,34,8145,17,297,10,517,1889,17,505,10,1420,6256
232.105,17,4,352,2,60,232104,60,176,2,60,232104,60,176
3.061,6,2,88,2,0,0,0,88,0,0,0,0,0
11.322,6,609,531787,374,1353,29,1368,513439,235,776,47,2736,18348
240.221,6,54,18144,29,802,8579,1408,15158,25,209,10009,580,2986
1685.667,6,97,7820,64,65,26756,65,4640,33,58,52674,59,3180
0.883,17,16,6819,8,539,116,1350,4540,8,256,115,1350,2279
0.023,17,4,360,3,46,0,46,222,1,110,0,110,138
1773.476,6,180,15480,120,69,14903,69,8940,60,69,30054,69,6540
437.21,17,20,840,20,14,23011,14,840,0,0,0,0,0
393.561,6,604,531813,230,241,1718,922,14871,374,1378,1055,1418,516942
1786.658,6,117,9402,75,66,24144,66,5442,42,60,43574,60,3960
0.407,17,4,560,2,64,406,64,184,2,160,289,160,376
1740.483,2,25,800,25,8,72520,8,800,0,0,0,0,0
1778.972,17,142,11360,71,48,25413,48,5396,71,56,25413,56,5964
1787.184,6,360,22818,210,69,8551,69,12678,150,69,11994,69,10140
1742.699,6,95,7203,63,38,28108,205,4476,32,33,56203,98,2727
0.865,6,14,1733,7,288,141,288,588,7,284,111,434,1145
0.498,6,23,7428,14,273,38,663,2104,9,1209,56,1946,5324
1772.55,6,204,22330,130,75,13740,267,10057,74,132,24277,1420,12273
0.918,6,27,5740,13,125,76,267,1275,14,780,64,1460,4465
0.012,6,5,678,2,316,7,316,420,3,102,3,102,258
182.426,6,136,105328,87,1269,2121,1368,94651,49,738,1486,2736,10677
247.441,6,44,13731,27,387,9516,1360,6573,17,587,15454,1360,7158
0.005,17,2,410,1,36,0,36,64,1,318,0,318,346
0.043,17,2,198,1,37,0,37,65,1,105,0,105,133
2.24,17,4,1556,4,361,746,361,1556,0,0,0,0,0
0.013,17,2,415,1,65,0,65,93,1,294,0,294,322
0.887,6,52,13885,24,553,38,1429,4856,28,438,32,1460,9029
1696.208,1,8,448,8,28,242315,28,448,0,0,0,0,0
1780.139,6,354,22440,207,69,8641,69,12420,147,69,12192,69,10020
317.037,6,78,19745,42,324,7732,1360,10140,36,370,9054,4649,9605
0.115,17,2,572,1,39,0,39,67,1,477,0,477,505
10.77,6,1412,1113263,739,1408,14,1448,1069651,673,931,15,2896,43612
0.01,17,2,306,1,33,0,33,61,1,217,0,217,245
3.86,6,64,20347,32,743,124,1440,9573,32,499,117,1440,10774
295.47,6,35,7081,17,262,18464,517,1680,18,744,17377,1418,5401
300.793,6,47,10135,23,641,13672,1460,4218,24,290,637,1460,5917
252.534,2,3,96,3,8,126267,8,96,0,0,0,0,0
537.437,1,5,300,5,32,134359,32,300,0,0,0,0,0
1786.614,6,102,8228,68,64,26665,64,4896,34,58,54137,58,3332
1788.911,17,87,3648,86,14,21046,14,3612,1,8,0,8,36
6.076,6,1555,1456894,994,1389,5,1408,1423058,561,931,10,2801,33836
0.013,6,2,1494,1,0,0,0,40,1,1414,0,1414,1454
1773.149,6,180,15480,120,69,14900,69,8940,60,69,30049,69,6540
91.562,6,22,11569,11,433,85,990,1791,11,1332,9144,3928,9778
1775.695,6,140,8872,77,49,23364,208,5453,63,31,28635,31,3419
1781.207,17,140,11200,70,48,25814,48,5320,70,56,25814,56,5880
4.67,6,40,7309,19,218,259,314,3383,21,440,220,1152,3926
0.011,17,2,378,1,50,0,50,78,1,272,0,272,300
0.869,6,24,9756,12,660,79,1440,3154,12,872,58,1440,6602
1796.696,6,378,28780,220,126,8204,469,17630,158,69,11441,69,11150
67.823,6,74,47437,44,1188,1577,1448,39146,30,747,2125,1448,8291
1.011,17,2,312,2,128,1011,128,312,0,0,0,0,0
1780.993,17,126,10080,63,48,28725,48,4788,63,56,28725,56,5292
0.166,6,2,104,1,0,0,0,52,1,0,0,0,52
1771.696,6,99,9306,66,66,27256,66,5610,33,60,55362,60,3696
0.115,17,2,358,1,48,0,48,76,1,254,0,254,282
14.806,6,2686,2534451,1688,1421,8,1448,2476855,998,776,14,1448,57596
10.036,17,2,298,2,121,10036,121,298,0,0,0,0,0
0.192,6,20,5772,12,164,17,453,1442,8,781,26,2224,4330
1797.357,6,364,24054,212,81,8518,469,13696,152,69,11901,69,10358
6.062,6,23,4478,12,213,551,597,1689,11,441,588,1440,2789
915.927,6,154,19969,63,107,14773,658,5952,91,157,10175,1360,14017
1790.638,6,356,22520,208,69,8650,69,12460,148,69,12181,69,10060
1787.297,6,102,8228,68,64,26676,64,4896,34,58,54157,58,3332
61.805,6,62,44279,41,1183,1545,1408,36454,21,960,3075,3847,7825
1799.722,6,355,22480,207,69,8736,69,12420,148,69,12242,69,10060
10.451,6,20,6462,11,275,1045,275,723,9,1073,678,1420,5739
3.377,17,32,9916,16,252,222,1350,4480,16,311,222,1350,5436
6.056,6,45,8409,22,227,288,314,4062,23,427,263,1152,4347
0.752,6,10,924,5,283,143,283,551,5,105,142,105,373
1795.212,17,448,39896,403,35,4465,288,25676,45,288,40017,288,14220
372.171,6,18,1242,14,180,28628,180,916,4,110,20069,110,326
66.957,17,4,352,2,60,66955,60,176,2,60,66956,60,176
0.922,17,2,778,2,361,922,361,778,0,0,0,0,0
1797.665,2,22,704,22,8,85603,8,704,0,0,0,0,0
120.367,6,1081,560407,623,838,193,1152,537296,458,435,262,1179,23111
6.37,6,1028,882950,616,1386,10,1420,862249,412,467,15,1883,20701
1773.046,6,180,15480,120,69,14899,69,8940,60,69,30045,69,6540
10.972,6,20,4390,11,275,1097,275,998,9,755,780,1414,3392
104.946,6,25,11118,12,433,75,990,1823,13,973,8734,1440,9295
1800.0,6,224,19119,83,74,21585,301,8467,141,69,12857,1062,10652
12.501,6,14,5625,4,106,4163,106,274,10,706,1387,1460,5351
1787.912,6,472,27298,261,69,6876,69,14718,211,34,8513,64,12580
1790.153,17,70,2931,68,13,26718,14,2851,2,12,1452417,16,80
1786.152,6,102,8364,68,66,26658,66,4964,34,60,54122,60,3400
0.512,17,3,451,2,39,214,39,134,1,289,0,289,317
4.03,17,4,244,4,33,1343,33,244,0,0,0,0,0
1797.397,17,449,39416,404,34,4460,288,25444,45,282,40019,288,13972
1777.005,1,240,13440,240,28,7435,28,13440,0,0,0,0,0
115.783,6,85,21375,48,155,2463,287,6107,37,556,3216,1408,15268
9.818,17,4,240,2,32,9817,32,120,2,32,9817,32,120
0.094,6,9,1346,5,145,23,145,349,4,833,22,833,997
60.803,17,13,988,13,48,5066,48,988,0,0,0,0,0
1680.59,1,15,870,15,30,120042,30,870,0,0,0,0,0
1770.184,6,99,9306,66,66,27233,66,5610,33,60,55315,60,3696
1796.571,6,356,22520,208,69,8679,69,12460,148,69,12221,69,10060
1.649,6,53,19318,29,880,58,1360,13537,24,400,62,1360,5781
1.5,6,46,18959,26,947,60,1460,13383,20,476,68,2615,5576
1.019,6,10,1687,7,100,169,100,384,3,1179,374,1179,1303
602.702,6,127,8254,70,75,8734,138,4525,57,69,10761,69,3729
11.309,6,81,24765,41,560,282,1152,19008,40,461,283,1179,5757
1743.032,6,97,7307,63,38,28113,205,4476,34,33,52812,98,2831
220.956,6,28,7352,13,158,18413,267,1317,15,678,15779,3900,6035
1.456,6,38,8258,19,321,80,1168,2722,19,476,70,2615,5536
1684.507,2,15,480,15,8,120321,8,480,0,0,0,0,0
0.01,17,2,544,1,128,0,128,156,1,360,0,360,388
11.603,6,1817,1589525,1104,1385,10,1420,1556784,713,467,16,1883,32741
1786.112,17,87,3648,86,14,21013,14,3612,1,8,0,8,36
2.09,17,22,9804,11,291,205,1350,3518,11,543,205,1350,6286
1786.461,6,104,8444,68,66,26663,66,4964,36,60,51039,60,3480
15.757,6,25,11594,8,138,2251,267,883,17,771,981,1997,10711
0.346,17,8,2766,8,317,49,356,2766,0,0,0,0,0
280.616,6,30,7432,13,158,23384,267,1317,17,543,17533,1400,6115
0.827,17,2,122,2,33,827,33,122,0,0,0,0,0
34.615,6,34,6077,16,154,2307,722,1923,18,357,2025,2026,4154
12.332,6,28,4818,13,204,1013,722,1707,15,332,868,1408,3111
1787.244,1,8,448,8,28,255320,28,448,0,0,0,0,0
81.755,6,31,8981,13,158,6812,267,1317,18,630,4799,1400,7664
1782.907,6,106,8574,68,65,26610,65,4930,38,59,48183,59,3644
2.908,1,3,168,3,28,1454,28,168,0,0,0,0,0
0.971,6,4,852,3,322,483,322,812,1,0,0,0,40
0.022,6,10,1677,6,555,4,951,1354,4,159,6,159,323
300.332,6,40,29177,21,190,15016,444,1861,19,1754,13541,4206,27316
9.284,6,36,6931,20,213,488,314,3157,16,521,588,1179,3774
119.086,6,41,8710,20,371,576,766,1993,21,391,5947,2720,6717
15.033,6,5,300,5,0,0,0,300,0,0,0,0,0
25.161,6,36,8384,17,165,1572,721,2171,19,681,1386,1440,6213
0.009,17,2,394,1,37,0,37,65,1,301,0,301,329
21.253,17,2,672,2,308,21253,308,672,0,0,0,0,0
280.044,6,26,7272,12,158,25458,267,1277,14,775,21538,2800,5995
1767.238,6,115,7301,66,45,27188,208,4318,49,31,36807,31,2983
4.075,17,10,1255,5,31,1016,31,295,5,164,1015,164,960
4.867,17,26,14822,14,732,374,1350,10640,12,320,259,1350,4182
0.028,6,12,3705,6,171,2,171,491,6,964,5,1448,3214
4.694,6,6,395,0,0,0,0,0,6,31,938,31,395
1752.786,6,95,7203,63,38,28270,205,4476,32,33,56526,98,2727
0.029,6,2,144,1,0,0,0,40,1,64,0,64,104
169.86,17,4,240,2,32,169859,32,120,2,32,169859,32,120
240.182,6,61,20787,34,795,7278,1408,17692,27,187,9237,580,3095
180.926,6,181,132648,104,1241,668,1360,72447,77,1215,2378,2720,60201
280.438,6,29,7392,13,158,23369,267,1317,16,678,18694,2760,6075
0.606,6,10,924,5,283,97,283,551,5,105,102,105,373
0.002,6,3,168,1,0,0,0,40,2,24,0,24,128
0.406,17,2,204,1,34,0,34,62,1,114,0,114,142
1799.903,17,87,3648,86,14,21175,14,3612,1,8,0,8,36
0.025,6,4,208,2,0,18,0,104,2,0,20,0,104
35.831,17,22,1672,22,48,1706,48,1672,0,0,0,0,0
570.419,1,46,2576,46,28,12675,28,2576,0,0,0,0,0
0.0,1,1,264,1,236,0,236,264,0,0,0,0,0
1684.508,2,25,800,25,8,70187,8,800,0,0,0,0,0
1772.807,6,180,15480,120,69,14897,69,8940,60,69,30042,69,6540
104.311,6,22,9783,12,410,57,922,1742,10,1271,11574,4416,8041
171.081,6,28,8792,14,158,13160,267,1357,14,981,13157,3445,7435
1792.214,6,361,22858,210,69,8575,69,12678,151,69,11946,69,10180
1740.589,17,30,7050,30,207,60020,207,7050,0,0,0,0,0
6.998,17,3,2145,3,687,3499,687,2145,0,0,0,0,0
1799.917,17,501,51303,220,130,8174,1350,34785,281,30,6428,87,16518
1799.887,6,188,11673,95,50,19135,208,7054,93,31,19133,31,4619
372.974,6,108,22098,40,303,8106,1360,10155,68,180,5564,1360,11943
317.263,6,95,18569,46,277,7050,1460,8569,49,243,6606,1638,10000
14.333,6,37,8768,18,269,843,722,2345,19,627,783,2760,6423
1653.188,1,8,448,8,28,236169,28,448,0,0,0,0,0
0.007,6,2,92,1,0,0,0,52,1,0,0,0,40
0.835,6,18,5172,10,150,92,174,704,8,828,105,1420,4468
300.728,6,42,8661,22,266,14320,720,2014,20,389,448,2128,6647
5.083,17,10,1962,5,36,1269,36,320,5,300,1269,318,1642
1799.848,17,438,36736,403,35,4477,288,25676,35,288,50610,288,11060
0.134,17,2,368,1,37,0,37,65,1,275,0,275,303
0.084,17,4,284,2,32,0,32,120,2,54,5,60,164
0.651,6,12,1069,6,186,127,186,692,6,45,129,45,377
286.94,6,35,3536,17,324,17933,584,1588,18,169,16878,580,1948
300.596,6,341,305357,208,162,1452,230,12270,133,2218,2277,7040,293087
5.001,17,4,288,2,36,5000,36,128,2,52,4949,52,160
60.073,6,21,5941,12,272,5461,516,1300,9,712,7487,1452,4641
0.057,17,2,245,1,32,0,32,60,1,157,0,157,185
1760.712,6,184,11305,92,47,19348,208,6695,92,31,19345,31,4610
370.828,6,20,1358,15,180,26487,180,980,5,110,15165,110,378
8.579,6,36,21175,24,992,373,1368,15147,12,1340,761,3887,6028
1798.827,6,355,22480,207,69,8732,69,12420,148,69,12236,69,10060
0.342,6,27,9098,13,257,28,669,1714,14,831,25,1402,7384
81.994,6,49,27007,30,1040,2827,1440,19264,19,749,3406,1440,7743
1785.58,6,104,8376,68,65,26650,65,4930,36,59,51014,59,3446
43.841,6,42,8807,19,389,840,854,2009,23,345,1986,1460,6798
1776.332,17,73,3060,72,14,25018,14,3024,1,8,0,8,36
0.788,6,7,371,3,0,394,0,152,4,7,149,7,219
242.164,17,4,288,2,36,242164,36,128,2,52,242163,52,160
33.439,6,47,13165,24,890,691,1360,7288,23,329,1512,4027,5877
1797.052,6,356,22520,208,69,8681,69,12460,148,69,12224,69,10060
0.489,17,2,204,1,34,0,34,62,1,114,0,114,142
280.375,6,30,7432,14,158,21567,267,1357,16,678,18688,3436,6075
4.299,6,38,7229,19,218,238,314,3383,19,440,224,1152,3846
0.015,17,2,378,1,50,0,50,78,1,272,0,272,300
0.288,6,10,1379,5,145,72,145,349,5,826,69,826,1030
1789.657,6,373,26097,216,98,8323,469,15263,157,69,11354,69,10834
1499.13,6,83,6324,54,40,28285,205,3810,29,35,51398,98,2514
8.976,6,64,20318,34,551,272,1152,15691,30,489,297,1179,4627
244.41,6,60,19242,32,716,7882,1368,16006,28,212,9051,580,3236
1797.158,1,266,14896,266,28,6781,28,14896,0,0,0,0,0
0.509,17,3,451,2,39,128,39,134,1,289,0,289,317
240.212,6,53,15786,28,678,8896,1402,12992,25,185,10008,580,2794
1773.156,6,182,15698,120,69,14900,69,8940,62,69,29064,69,6758
192.757,6,26,6563,12,154,17523,267,960,14,628,14808,1460,5603
0.431,6,10,1992,5,288,102,288,508,5,424,59,434,1484
56.357,1,4,224,4,28,18785,28,224,0,0,0,0,0
23.838,6,42,14266,21,327,1191,667,1854,21,722,446,1569,12412
12.708,6,162,116581,72,111,178,232,3440,90,1369,140,1430,113141
1.184,6,24,8016,12,164,91,267,1300,12,1014,91,2411,6716
0.021,6,13,3876,7,124,3,124,496,6,1530,4,1612,3380
1785.731,17,102,8160,51,48,35714,48,3876,51,56,35714,56,4284
83.868,6,15,620,7,0,13978,0,284,8,0,11636,0,336
2.045,6,54,14120,26,501,81,1429,5082,28,439,70,1986,9038
16.298,6,2506,2245008,1485,1425,10,1448,2184432,1021,776,15,1448,60576
1796.989,17,448,39896,403,35,4470,288,25676,45,288,40014,288,14220
1785.013,6,102,8296,68,65,26641,65,4930,34,59,54088,59,3366
0.039,17,2,152,1,48,0,48,76,1,48,0,48,76
1782.303,17,84,3516,82,14,22001,14,3444,2,8,1782121,8,72
371.052,6,27,1767,18,177,21826,177,1181,9,110,8840,110,586
172.74,17,4,352,2,60,172739,60,176,2,60,172739,60,176
1781.227,17,142,11360,71,48,25445,48,5396,71,56,25445,56,5964
138.236,17,6,1236,3,48,69113,48,228,3,308,69114,308,1008
1771.178,6,99,9240,66,65,27248,65,5577,33,59,55346,59,3663
76.482,6,36,8436,17,372,3554,802,1829,19,416,4241,3488,6607
1791.141,17,89,3729,87,13,20825,14,3649,2,12,1790964,16,80
180.465,2,2,64,2,8,180465,8,64,0,0,0,0,0
250.701,17,4,352,2,60,250700,60,176,2,60,250700,60,176
283.686,6,34,9637,15,158,20263,267,1397,19,623,15754,1400,8240
240.228,6,53,17639,28,782,8897,1418,14760,25,196,10009,580,2879
69.546,6,26,7206,12,155,6322,267,1266,14,537,5348,3426,5940
240.276,6,43,9012,21,523,12013,1408,5811,22,227,11441,639,3201
320.682,6,28,7306,5,154,80170,267,672,23,317,14563,1460,6634
3.828,6,2,88,2,0,0,0,88,0,0,0,0,0
377.913,2,4,128,4,8,125971,8,128,0,0,0,0,0
1795.228,17,449,39928,404,35,4454,288,25708,45,288,40021,288,14220
165.754,17,4,240,2,32,165753,32,120,2,32,165753,32,120
0.734,6,34,8359,18,401,43,888,1967,16,478,39,2128,6392
384.47,6,33,9648,18,140,22615,267,2415,15,662,1188,1460,7233
20.108,6,21,5418,12,107,1828,159,1074,9,967,2512,2816,4344
0.217,6,7,782,3,316,106,316,472,4,102,71,102,310
10.966,17,3,3568,3,1161,5483,1451,3568,0,0,0,0,0
0.019,17,3,392,2,60,1,60,176,1,188,0,188,216
1.611,6,24,8004,12,164,127,267,1288,12,1014,123,2896,6716
10.306,6,16,3911,9,275,1288,275,643,7,992,904,1440,3268
211.742,6,65,43606,41,1195,5293,1448,35606,24,749,2682,1448,8000
1794.382,1,60,5040,60,56,30413,56,5040,0,0,0,0,0
8.643,6,6,252,4,0,2881,0,164,2,0,1095,0,88
0.418,17,2,170,1,37,0,37,65,1,77,0,77,105
1783.823,6,381,26886,218,103,8220,469,15950,163,69,11011,69,10936
373.56,6,60,11487,27,181,14367,1189,3814,33,288,11673,1420,7673
270.156,17,4,706,2,33,270151,33,122,2,264,270148,294,584
2.977,17,3,222,3,46,1488,46,222,0,0,0,0,0
0.084,17,2,144,1,36,0,36,64,1,52,0,52,80
73.613,17,9,3024,9,308,9201,308,3024,0,0,0,0,0
0.018,17,4,284,2,32,12,32,120,2,54,7,60,164
1787.382,6,102,8228,68,64,26677,64,4896,34,58,54159,58,3332
1.598,6,19,3781,10,234,177,564,1452,9,463,177,1343,2329
0.093,17,2,148,2,46,93,46,148,0,0,0,0,0
61.176,17,28,2355,26,30,2446,37,1515,2,392,342,463,840
1796.722,6,275,33787,113,139,16040,1360,16419,162,135,11158,4662,17368
0.003,17,2,810,2,377,3,377,810,0,0,0,0,0
1775.548,1,8,448,8,28,253649,28,448,0,0,0,0,0
15.226,6,7,388,4,0,5075,0,216,3,0,7601,0,172
1772.309,6,180,15480,120,69,14893,69,8940,60,69,30033,69,6540
0.049,6,6,716,3,302,16,302,458,3,102,16,102,258
177.146,17,4,240,2,32,177145,32,120,2,32,177145,32,120
1787.903,6,362,24774,211,94,8513,469,14387,151,69,11919,69,10387
3.062,17,4,304,2,48,3049,48,152,2,48,3048,48,152
17.734,17,33,11484,15,340,1264,1350,5525,18,303,1040,1350,5959
1.494,17,20,6962,8,303,213,1350,2650,12,331,70,1350,4312
11.925,17,8,704,4,48,3971,48,304,4,72,3971,72,400
0.035,6,10,1609,5,106,8,106,374,5,967,8,967,1235
0.004,17,2,144,1,36,0,36,64,1,52,0,52,80
360.973,2,3,96,3,8,180486,8,96,0,0,0,0,0
828.22,6,98,6726,36,46,23663,46,2820,62,46,13577,46,3906
1784.581,6,359,22709,209,69,8579,69,12569,150,69,11975,69,10140
1057.28,6,92,12569,58,95,18548,516,4328,34,229,29505,1452,8241
240.261,6,54,18144,28,822,8897,1418,15439,26,168,9609,580,2705
1799.584,1,16,896,16,28,119972,28,896,0,0,0,0,0
0.038,17,2,672,2,308,38,308,672,0,0,0,0,0
15.114,17,17,11394,10,892,1676,1350,9201,7,285,2514,1350,2193
0.134,17,4,344,2,47,0,47,150,2,69,127,75,194
1789.669,6,362,22898,210,69,8563,69,12678,152,69,11849,69,10220
1796.136,1,177,9912,177,28,10205,28,9912,0,0,0,0,0
0.2,6,9,1002,5,213,50,213,417,4,421,58,421,585
1772.308,6,180,15480,120,69,14893,69,8940,60,69,30035,69,6540
0.41,2,2,80,2,16,410,16,80,0,0,0,0,0
280.492,6,27,7312,13,158,23374,267,1317,14,775,21573,4836,5995
0.338,6,14,3578,7,75,56,75,459,7,1373,56,1448,3119
629.583,2,5,160,5,8,157395,8,160,0,0,0,0,0
4.195,17,10,2339,5,40,1045,40,340,5,371,1046,407,1999
1745.618,6,95,7203,63,38,28155,205,4476,32,33,56297,98,2727
13.696,6,14,4659,5,188,3424,245,580,9,1237,1272,1407,4079
1789.071,17,142,11360,71,48,25558,48,5396,71,56,25558,56,5964
2.509,6,13,2311,8,188,358,245,700,5,1407,562,1407,1611
10.164,6,6,328,4,0,3388,0,216,2,0,10147,0,112
2.08,17,4,314,2,31,2047,31,118,2,70,2048,70,196
1783.216,17,83,3480,82,14,22015,14,3444,1,8,0,8,36
0.829,6,11,1727,7,100,138,100,384,4,589,185,1152,1343
11.846,6,1747,1626714,1149,1366,10,1432,1596632,598,559,19,1871,30082
200.11,17,4,352,2,60,200109,60,176,2,60,200109,60,176
184.872,6,30,7432,13,158,15406,267,1317,17,543,11553,1400,6115
1780.086,1,220,12320,220,28,8128,28,12320,0,0,0,0,0
2.56,17,21,5784,8,224,365,1350,2019,13,261,136,1350,3765
1795.97,17,83,3480,82,14,22172,14,3444,1,8,0,8,36
2.983,17,4,308,2,33,2980,33,122,2,65,2980,65,186
3.996,17,6,462,3,33,1997,33,183,3,65,1997,65,279
3.986,17,6,1350,6,197,797,206,1350,0,0,0,0,0
1786.675,6,102,8364,68,66,26666,66,4964,34,60,54138,60,3400
180.062,2,3,96,3,8,90031,8,96,0,0,0,0,0
300.531,6,11,863,6,177,60072,177,497,5,110,75090,110,366
0.177,17,4,284,2,32,91,32,120,2,54,88,60,164
62.155,17,4,240,2,32,62154,32,120,2,32,62154,32,120
0.768,6,17,5132,9,150,96,174,664,8,828,96,1420,4468
8.401,6,14,2242,8,210,1199,210,844,6,545,1679,904,1398
1789.031,1,282,29892,282,78,6366,78,29892,0,0,0,0,0
1772.064,6,180,15480,120,69,14891,69,8940,60,69,30031,69,6540
1771.896,1,58,4872,58,56,31085,56,4872,0,0,0,0,0
1794.678,17,144,11520,72,48,25276,48,5472,72,56,25277,56,6048
1.25,6,48,18731,27,857,48,1360,13115,21,476,54,2720,5616
1797.51,6,220,27612,140,115,12931,981,13560,80,142,22749,2920,14052
1741.862,6,87,6322,58,31,30558,31,3915,29,31,62209,31,2407
300.654,6,14,1798,8,327,42930,327,994,6,276,60102,276,804
0.027,6,16,6004,8,88,3,88,452,8,1305,3,1880,5552
0.4,17,16,10515,8,987,52,1350,8125,8,270,52,1350,2390
280.409,6,30,7432,13,158,23367,267,1317,17,543,17524,1400,6115
11.79,1,4,224,4,28,3930,28,224,0,0,0,0,0
2.642,6,24,6640,13,350,219,1089,2276,11,979,263,1731,4364
1796.05,17,386,129696,386,308,4665,308,129696,0,0,0,0,0
286.23,6,40,7845,18,158,16837,267,1517,22,418,13628,1536,6328
35.67,17,40,5880,20,48,1876,48,1520,20,190,1876,308,4360
1786.802,6,107,8744,70,66,25895,66,5044,37,60,49630,60,3700
0.46,6,12,1653,6,288,92,288,548,6,426,51,434,1105
0.04,6,14,3448,8,106,5,106,530,6,866,7,1448,2918
0.071,17,2,376,1,39,0,39,67,1,281,0,281,309
0.689,6,10,924,5,283,114,283,551,5,105,117,105,373
366.381,6,58,10390,36,483,10468,483,8159,22,83,17446,83,2231
280.228,6,30,7432,13,158,23352,267,1317,17,543,17510,1300,6115
1790.87,1,58,4872,0,0,0,0,0,58,56,31418,56,4872
0.005,17,2,288,1,59,0,59,87,1,173,0,173,201
125.723,1,4,224,4,28,41907,28,224,0,0,0,0,0
2.79,6,5,520,3,0,1395,0,120,2,160,2592,160,400
0.028,6,11,1805,6,126,5,126,446,5,545,1,990,1359
1793.4,1,58,4872,58,56,31463,56,4872,0,0,0,0,0
483.08,17,26,8736,26,308,19323,308,8736,0,0,0,0,0
1777.642,17,73,3060,72,14,25037,14,3024,1,8,0,8,36
0.018,17,2,237,1,72,0,72,100,1,109,0,109,137
4.133,17,8,668,4,39,1058,39,268,4,72,0,72,400
0.022,6,11,3652,6,171,3,171,491,5,1446,4,2675,3161
1110.808,17,220,16720,220,48,5072,48,16720,0,0,0,0,0
1799.795,1,86,4816,86,28,21174,28,4816,0,0,0,0,0
12.215,17,20,3900,10,32,1355,32,600,10,302,1355,308,3300
10.944,6,20,4442,11,275,1094,275,998,9,768,791,1440,3444
1785.451,6,356,22520,208,69,8625,69,12460,148,69,12145,69,10060
1769.185,6,125,12532,70,64,25639,517,4812,55,242,32761,2413,7720
0.631,6,6,240,2,0,148,0,80,4,0,210,0,160
0.05,17,4,284,2,32,24,32,120,2,54,27,60,164
3.768,17,4,420,2,33,3761,33,122,2,121,3760,145,298
1791.681,17,29,9512,29,300,63988,300,9512,0,0,0,0,0
0.906,6,10,1687,7,100,151,100,384,3,1179,324,1179,1303
1799.083,17,449,39928,404,35,4464,288,25708,45,288,40017,288,14220
1727.642,17,12,498,11,14,172764,14,462,1,8,0,8,36
2.382,6,54,19874,27,921,91,1440,14018,27,433,84,1440,5856
11.589,6,24,8413,13,275,965,275,1078,11,1147,834,2840,7335
48.396,6,29,7257,13,155,4033,267,1306,16,441,3225,1420,5951
222.9,6,88,28121,41,577,5572,1152,19531,47,447,4731,1179,8590
244.956,17,42,3192,42,48,5974,48,3192,0,0,0,0,0
52.885,6,476,213954,243,821,218,1152,199470,233,396,226,1152,14484
724.433,1,8,806,8,72,103490,173,806,0,0,0,0,0
1789.955,6,353,22400,205,69,8774,69,12340,148,69,12176,69,10060
300.572,6,55,17813,27,860,11550,1360,11445,28,261,11125,2667,6368
1684.536,2,20,640,20,8,88659,8,640,0,0,0,0,0
0.343,6,21,5000,10,137,38,267,1092,11,692,33,1467,3908
1786.769,6,106,8388,68,64,26668,64,4896,38,58,48288,58,3492
1.973,6,38,10450,20,199,100,561,2266,18,825,105,1631,8184
1.427,6,6,328,4,0,475,0,216,2,0,1406,0,112
1793.723,1,58,4872,58,56,31468,56,4872,0,0,0,0,0
0.84,6,2,92,1,0,0,0,40,1,0,0,0,52
79.637,6,24,10869,12,380,67,832,1665,12,1089,7228,2720,9204
34.501,17,22,1936,11,48,3443,48,836,11,72,3448,72,1100
70.956,6,27,2896,14,189,5457,517,1578,13,323,5912,499,1318
19.873,17,2,152,2,48,19873,48,152,0,0,0,0,0
1751.565,6,94,7151,62,38,28714,205,4424,32,33,56493,98,2727
0.351,6,10,767,5,186,87,186,454,5,45,85,45,313
1799.994,1,103,10918,103,78,17647,78,10918,0,0,0,0,0
1797.513,17,448,39896,403,35,4471,288,25676,45,288,40016,288,14220
289.758,6,245,38510,134,304,2178,304,27000,111,83,2632,83,11510
1.844,6,47,9217,24,334,80,1164,3371,23,351,74,1460,5846
0.029,6,2,80,1,0,0,0,40,1,0,0,0,40
16.728,6,51,13660,18,379,972,731,3398,33,357,516,1360,10262
1.107,17,6,804,3,54,505,54,246,3,158,527,158,558
28.953,6,37,8600,19,410,488,882,2082,18,482,1693,3488,6518
0.005,6,2,92,1,0,0,0,52,1,0,0,0,40
1782.491,17,285,56844,285,171,6276,358,56844,0,0,0,0,0
1.283,6,50,20167,28,890,47,1360,14511,22,433,52,1360,5656
2.171,17,3,174,3,30,1085,30,174,0,0,0,0,0
300.671,6,41,9117,21,390,15033,1216,2470,20,389,796,2128,6647
14.539,6,32,7341,15,154,1020,721,1906,17,568,895,2026,5435
1511.824,2,13,416,13,8,125985,8,416,0,0,0,0,0
1790.012,6,356,22520,208,69,8647,69,12460,148,69,12176,69,10060
297.872,1,4,224,4,28,99290,28,224,0,0,0,0,0
2.957,17,4,624,4,128,985,128,624,0,0,0,0,0
1651.081,1,8,448,8,28,235868,28,448,0,0,0,0,0
0.409,6,24,6071,12,181,37,537,1526,12,782,31,2231,4545
54.826,6,29,7257,14,155,4217,267,1346,15,482,3915,2840,5911
0.23,6,9,1339,5,145,57,145,349,4,826,53,826,990
62.712,6,21,9034,11,301,85,595,1376,10,1207,6953,2568,7658
1797.446,6,376,26217,217,98,8321,469,15372,159,69,11376,69,10845
1786.245,1,166,9296,166,28,10825,28,9296,0,0,0,0,0
1669.901,1,8,448,8,28,238557,28,448,0,0,0,0,0
15.365,17,10,760,10,48,1707,48,760,0,0,0,0,0
400.818,6,18,1460,16,33,26721,33,1294,2,31,91001,31,166
0.01,17,2,384,1,39,0,39,67,1,289,0,289,317
4.455,6,38,7229,19,218,247,314,3383,19,440,233,1152,3846
23.237,6,551,392348,311,1107,74,1440,153176,240,1311,96,1687,239172
1204.204,6,117,15262,66,304,18526,304,10420,51,83,24066,83,4842
0.631,17,4,368,2,64,629,64,184,2,64,629,64,184
1.934,6,11,975,6,304,386,304,624,5,83,473,83,351
300.758,6,39,8642,21,315,15037,882,2169,18,441,502,1360,6473
140.596,6,41,8512,15,131,8727,267,1670,26,304,5623,1460,6842
0.386,6,10,1992,5,288,94,288,508,5,424,53,434,1484
0.249,17,3,2906,3,940,124,1451,2906,0,0,0,0,0
1738.46,17,16,3620,16,198,115897,682,3620,0,0,0,0,0
1786.533,17,87,3648,86,14,21018,14,3612,1,8,0,8,36
1739.199,6,87,6322,58,31,30512,31,3915,29,31,62113,31,2407
1780.224,1,342,28728,342,56,5220,56,28728,0,0,0,0,0
1792.724,6,378,23952,214,69,8416,69,13183,164,69,10997,69,10769
1770.909,6,101,9410,66,66,27244,66,5610,35,60,52082,60,3800
11.771,6,1862,1626507,1128,1388,10,1420,1592914,734,467,16,1883,33593
0.0,17,1,60,1,32,0,32,60,0,0,0,0,0
0.624,6,14,1745,7,288,72,288,600,7,426,71,434,1145
0.008,17,4,678,3,32,0,32,180,1,470,0,470,498
1782.46,17,83,3480,82,14,22005,14,3444,1,8,0,8,36
1775.078,6,180,15480,120,69,14916,69,8940,60,69,30080,69,6540
0.0,17,2,180,1,30,0,30,58,1,94,0,94,122
61.566,17,4,1344,4,308,20522,308,1344,0,0,0,0,0
15.497,17,16,6360,8,484,2208,1350,4097,8,254,2208,1350,2263
1797.092,17,449,39928,404,35,4459,288,25708,45,288,40021,288,14220
60.497,6,39,20411,19,131,3360,134,1520,20,991,3181,1448,18891
0.43,6,6,324,4,0,143,0,216,2,0,236,0,108
112.804,6,48,14552,24,970,519,1360,8790,24,399,4897,1360,5762
64.18,17,10,585,10,30,7131,31,585,0,0,0,0,0
0.929,6,11,1727,7,100,154,100,384,4,589,221,1152,1343
8.121,17,6,456,6,48,1624,48,456,0,0,0,0,0
154.455,17,16,5376,16,308,10297,308,5376,0,0,0,0,0
0.147,6,2,303,1,211,0,211,263,1,0,0,0,40
1743.224,6,95,7203,63,38,28116,205,4476,32,33,56222,98,2727
3.436,6,2,88,2,0,0,0,88,0,0,0,0,0
1795.027,17,448,39896,403,35,4465,288,25676,45,288,40018,288,14220
33.969,17,10,880,5,48,8489,48,380,5,72,8489,72,500
1769.637,6,126,7701,68,27,26412,27,4097,58,27,31045,27,3604
1771.557,6,79,4198,40,26,45423,26,2132,39,26,46618,26,2066
280.669,17,4,240,2,32,280668,32,120,2,32,280668,32,120
1.292,17,4,352,2,60,1291,60,176,2,60,1291,60,176
0.219,6,2,80,1,0,0,0,40,1,0,0,0,40
5.066,17,4,396,2,37,5021,37,130,2,105,5008,105,266
1741.995,6,87,6322,58,31,30561,31,3915,29,31,62213,31,2407
1.582,6,25,6081,13,108,131,147,959,12,773,143,1608,5122
1797.489,6,356,22520,208,69,8683,69,12460,148,69,12227,69,10060
0.007,17,2,214,1,39,0,39,67,1,119,0,119,147
1.008,17,2,312,2,128,1008,128,312,0,0,0,0,0
68.302,1,3,180,3,32,34151,32,180,0,0,0,0,0
1.404,6,9,379,5,0,351,0,204,4,7,401,7,175
300.567,6,39,8508,20,284,15819,792,1995,19,441,469,1360,6513
1787.256,6,104,8376,68,65,26675,65,4930,36,59,51058,59,3446
1.393,6,48,19345,27,901,53,1460,13729,21,433,60,1460,5616
6.446,6,17,6625,5,275,1611,275,479,12,566,474,1420,6146
315.874,6,106,21161,55,280,5849,1360,10772,51,260,6314,4649,10389
280.434,6,29,7392,13,158,23369,267,1317,16,543,18693,1380,6075
1.6,6,38,8254,19,321,88,1164,2718,19,433,76,1460,5536
0.865,6,16,4459,9,327,107,634,1784,7,767,142,1328,2675
280.397,6,28,7352,13,158,23366,267,1317,15,678,20025,2085,6035
1796.086,17,447,39296,404,35,4456,288,25708,43,288,41928,288,13588
1.738,6,47,19312,27,901,66,1460,13736,20,433,71,1460,5576
267.533,1,14,784,14,28,20579,28,784,0,0,0,0,0
129.738,6,47,10823,19,327,7199,1408,3312,28,318,4799,1408,7511
27.166,6,12,659,4,0,9055,0,216,8,7,3855,7,443
1750.757,17,13,534,11,14,175057,14,462,2,8,1750570,8,72
240.161,6,54,18067,29,798,8577,1408,15096,25,207,10006,580,2971
1741.414,17,27,6345,27,207,66977,207,6345,0,0,0,0,0
15.115,17,11,4353,5,410,3771,1350,2194,6,331,3017,1350,2159
0.704,17,2,144,1,36,0,36,64,1,52,0,52,80
300.915,6,38,9639,21,547,15045,1360,4157,17,435,541,2667,5482
7.995,6,5,984,5,196,1998,196,984,0,0,0,0,0
1786.727,6,104,8308,68,64,26667,64,4896,36,58,51046,58,3412
1740.459,17,30,31620,30,1026,60015,1026,31620,0,0,0,0,0
1.68,6,25,8706,15,275,120,558,1430,10,981,167,1420,7276
0.078,17,2,650,1,308,0,308,336,1,286,0,286,314
145.111,6,28,8792,14,158,11162,267,1357,14,981,11157,4836,7435
25.061,6,8,440,5,0,6265,0,268,3,0,12260,0,172
1.241,6,46,17362,26,521,49,1360,9409,20,649,57,1929,7953
1.185,17,4,288,2,36,1133,36,128,2,52,1137,52,160
0.011,6,10,1508,5,503,2,503,771,5,469,2,469,737
0.932,6,31,8912,15,158,66,267,1397,16,763,60,2800,7515
15.703,17,22,14069,12,942,1421,1350,11651,10,213,1736,1350,2418
570.053,1,6,336,6,28,114010,28,336,0,0,0,0,0
0.791,17,3,451,2,39,12,39,134,1,289,0,289,317
1775.109,17,142,11360,71,48,25358,48,5396,71,56,25358,56,5964
0.066,17,2,2730,2,1337,66,1337,2730,0,0,0,0,0
1780.2,6,104,8376,68,65,26570,65,4930,36,59,50860,59,3446
51.18,6,27,7067,8,154,7311,267,792,19,393,2830,1452,6275
63.66,6,8,376,2,0,63660,0,88,6,0,6323,0,288
721.901,2,8,256,8,8,103128,8,256,0,0,0,0,0
723.169,6,148,9646,82,74,8928,138,5281,66,69,11125,69,4365
2.079,17,3,358,2,40,2032,40,136,1,194,0,194,222
5.021,17,4,288,2,36,4977,36,128,2,52,4973,52,160
0.394,6,13,1693,7,288,62,288,588,6,426,46,434,1105
3.315,17,5,340,5,40,828,40,340,0,0,0,0,0
1.202,6,21,8390,12,312,109,623,1448,9,1095,121,2720,6942
144.361,1,6,336,6,28,28872,28,336,0,0,0,0,0
173.845,6,29,14054,15,519,77,884,2721,14,1076,13360,2720,11333
1793.452,6,118,7536,70,49,25992,208,4717,48,31,38153,31,2819
7.151,6,1576,1419664,949,1415,7,1448,1382396,627,776,11,1448,37268
1784.068,6,106,8584,69,66,26236,66,5004,37,60,49551,60,3580
1771.535,6,99,9240,66,65,27254,65,5577,33,59,55357,59,3663
236.275,17,4,240,2,32,236274,32,120,2,32,236274,32,120
15.698,17,24,5833,11,234,1566,1350,2889,13,198,1305,1350,2944
243.399,6,74,23015,34,770,7375,1418,18716,40,184,6240,580,4299
1782.251,17,83,3480,82,14,22003,14,3444,1,8,0,8,36
71.412,6,13,1079,12,43,6492,43,1019,1,0,0,0,60
1.592,6,38,8254,19,321,88,1164,2718,19,433,76,1360,5536
1.984,17,3,3140,3,1018,992,1438,3140,0,0,0,0,0
1752.191,1,74,6216,0,0,0,0,0,74,56,24002,56,6216
7.329,6,9,392,4,0,2443,0,172,5,0,1127,0,220
373.512,6,18,1242,14,180,28731,180,916,4,110,20070,110,326
0.061,17,2,234,1,33,0,33,61,1,145,0,145,173
1786.712,6,102,8364,68,66,26667,66,4964,34,60,54139,60,3400
1744.709,2,24,768,24,8,75856,8,768,0,0,0,0,0
120.107,17,2,1270,2,607,120107,687,1270,0,0,0,0,0
0.205,6,3,160,2,0,205,0,100,1,0,0,0,60
34.611,6,27,7177,13,155,2884,267,1306,14,530,2661,3417,5871
1138.552,2,12,384,12,8,103504,8,384,0,0,0,0,0
0.098,1,2,112,2,28,98,28,112,0,0,0,0,0
58.893,6,30,7297,14,155,4530,267,1346,16,441,3924,1420,5951
268.362,17,3,968,3,294,134181,300,968,0,0,0,0,0
112.056,6,23,10242,12,433,95,990,1823,11,1138,11189,2568,8419
14.131,6,544,485335,342,1351,40,1368,469187,202,776,69,1473,16148
1740.411,17,28,6580,28,207,64459,207,6580,0,0,0,0,0
1.35,6,50,19793,27,927,51,1460,14097,23,433,53,1460,5696
242.595,6,30,7432,13,158,20216,267,1317,17,543,15160,1400,6115
126.036,6,36,8015,12,155,33,267,1266,24,304,5479,1460,6749
1789.639,17,364,46509,167,179,10780,1350,34592,197,32,9128,60,11917
1788.829,17,84,3516,82,14,22081,14,3444,2,8,1788634,8,72
8.379,6,28,7954,13,196,698,721,1901,15,681,555,2840,6053
39.541,17,11,836,11,48,3954,48,836,0,0,0,0,0
1682.754,17,14,1036,7,30,280448,30,406,7,62,280450,62,630
247.996,6,56,8833,27,139,9538,346,2330,29,311,8856,1408,6503
1789.419,17,140,11200,70,48,25933,48,5320,70,56,25933,56,5880
62.97,2,2,64,2,8,62970,8,64,0,0,0,0,0
6.17,6,1495,1389343,951,1384,6,1408,1356391,544,931,11,2816,32952
1730.188,6,60,4384,38,33,46761,33,2627,22,31,82381,31,1757
1797.554,6,367,25650,214,99,8439,469,15045,153,69,11824,69,10605
13.818,6,23,10994,13,427,1151,533,2381,10,1010,1530,2728,8613
0.001,17,6,1656,6,248,0,370,1656,0,0,0,0,0
0.015,17,2,582,1,100,0,100,128,1,426,0,426,454
13.002,6,21,3774,11,181,1275,293,1711,10,553,1416,1179,2063
1741.403,6,92,6668,60,31,29515,31,4062,32,31,56173,31,2606
0.395,17,2,144,1,36,0,36,64,1,52,0,52,80
4.868,6,40,7309,21,218,243,314,3463,19,513,255,1179,3846
301.699,6,39,13603,19,584,16761,1448,3976,20,612,3638,1448,9627
0.941,6,8,1607,5,100,235,100,304,3,1179,342,1179,1303
2.381,6,13,2311,8,188,340,245,700,5,1407,527,1407,1611
1.435,6,54,23942,30,998,49,1360,18206,24,476,54,2715,5736
0.783,17,2,204,1,34,0,34,62,1,114,0,114,142
18.13,6,25,4919,12,231,1648,722,1815,13,400,1494,2118,3104
29.502,6,12,1313,7,185,4917,185,557,5,244,7339,476,756
41.361,17,24,2112,12,48,3753,48,912,12,72,3753,72,1200
1.593,6,49,21129,28,957,59,1360,15513,21,433,67,1360,5616
1680.615,17,12,498,11,14,168061,14,462,1,8,0,8,36
0.471,6,21,7281,13,334,39,663,2021,8,967,60,1471,5260
240.302,6,45,13747,22,220,11442,517,2732,23,981,10922,2988,11015
124.054,6,80,46533,39,131,3264,232,2089,41,1188,3100,1497,44444
99.505,17,3,228,3,48,49752,48,228,0,0,0,0,0
1392.371,6,253,39723,139,304,10089,304,27820,114,83,12314,83,11903
721.931,2,6,192,6,8,144386,8,192,0,0,0,0,0
9.219,6,14,2245,8,211,1317,211,846,6,545,1837,904,1399
4.639,6,38,7245,19,218,257,314,3383,19,516,243,1179,3862
1772.276,6,182,15629,121,69,14768,69,8980,61,69,29531,69,6649
1202.395,17,52,17456,52,307,23576,308,17456,0,0,0,0,0
1799.86,1,73,4088,73,28,24998,28,4088,0,0,0,0,0
1680.606,1,15,840,15,28,120043,28,840,0,0,0,0,0
1784.334,6,104,8308,68,64,26631,64,4896,36,58,50978,58,3412
1.106,6,30,8689,15,236,65,625,2049,15,861,64,1360,6640
0.246,17,2,178,1,29,0,29,57,1,93,0,93,121
15.17,17,22,15365,12,830,1376,1350,10306,10,477,1681,1350,5059
1782.743,6,106,8574,68,65,26608,65,4930,38,59,48179,59,3644
1791.726,6,139,13685,83,66,21850,722,6983,56,80,32569,1408,6702
114.57,6,32,8952,14,158,8813,267,1357,18,624,6735,1400,7595
1683.17,17,14,1036,7,30,280524,30,406,7,62,280526,62,630
12.703,17,4,824,2,48,12686,48,152,2,308,12683,308,672
108.34,17,8,704,4,48,36110,48,304,4,72,36110,72,400
1.215,6,23,7952,12,164,93,267,1288,11,1216,103,3819,6664
58.626,1,6,336,6,28,11725,28,336,0,0,0,0,0
1.177,2,2,64,2,8,1177,8,64,0,0,0,0,0
31.965,6,9,396,2,0,3482,0,88,7,0,5312,0,308
0.014,17,2,474,1,45,0,45,73,1,373,0,373,401
240.228,6,53,17854,28,799,8896,1418,15050,25,187,10009,580,2804
0.886,6,10,1687,7,100,147,100,384,3,1179,320,1179,1303
18.818,6,17,3471,7,521,3135,1420,2370,10,231,2090,231,1101
1782.415,17,81,3396,80,14,22562,14,3360,1,8,0,8,36
1747.955,6,94,7151,62,38,28655,205,4424,32,33,56373,98,2727
3.119,2,3,96,3,8,1559,8,96,0,0,0,0,0
1788.298,17,87,3648,86,14,21038,14,3612,1,8,0,8,36
23.097,17,14,1064,14,48,1776,48,1064,0,0,0,0,0
0.85,17,2,122,2,33,850,33,122,0,0,0,0,0
5.005,17,4,558,2,36,4996,36,128,2,187,4996,187,430
11.362,6,1849,1574556,1111,1364,10,1380,1540794,738,421,15,1923,33762
328.487,6,33,6977,16,262,21896,517,1628,17,744,20527,1418,5349
0.338,17,2,172,1,50,0,50,78,1,66,0,66,94
0.068,6,10,1514,5,503,17,503,771,5,475,17,475,743
5.407,17,30,13767,14,658,415,1350,9606,16,232,214,1350,4161
0.015,6,10,1510,5,657,3,657,925,5,317,3,317,585
0.048,17,2,912,1,308,0,308,336,1,548,0,548,576
67.417,6,21,9086,12,304,73,597,1425,9,1457,8405,4441,7661
31.058,17,15,1140,15,48,2218,48,1140,0,0,0,0,0
0.816,6,116,88096,62,131,13,232,3009,54,1727,15,5372,85087
0.103,6,10,1569,5,627,25,627,895,5,406,25,406,674
300.019,6,33,6969,20,132,15790,501,1995,13,494,24272,1420,4974
0.626,17,2,167,1,39,0,39,67,1,72,0,72,100
57.648,6,26,7922,14,426,4434,517,3307,12,986,5231,1368,4615
67.324,6,45,13949,20,315,1447,721,3329,25,641,2797,2840,10620
975.096,1,66,6996,66,78,15001,78,6996,0,0,0,0,0
19.69,17,12,1056,6,48,3935,48,456,6,72,3935,72,600
0.116,6,9,1340,5,145,29,145,349,4,827,30,827,991
1784.165,6,370,25770,215,99,8337,469,15154,155,69,11585,69,10616
1120.954,17,12,3143,6,31,224188,37,355,6,436,224188,463,2788
280.567,6,28,7352,13,158,23380,267,1317,15,775,20036,3465,6035
10.094,6,2030,1890314,1298,1378,7,1408,1847586,732,931,13,2801,42728
0.212,17,8,2750,8,315,30,354,2750,0,0,0,0,0
1622.429,1,8,448,8,28,231775,28,448,0,0,0,0,0
1781.765,6,358,22738,209,69,8566,69,12638,149,69,12038,69,10100
205.12,17,4,240,2,32,205119,32,120,2,32,205119,32,120
1.589,6,43,15036,24,773,69,1360,9500,19,433,76,1360,5536
0.077,17,2,245,1,32,0,32,60,1,157,0,157,185
2.922,17,4,240,4,32,974,32,240,0,0,0,0,0
22.834,17,4,304,4,48,7611,48,304,0,0,0,0,0
1786.46,6,102,8296,68,65,26663,65,4930,34,59,54132,59,3366
78.975,17,4,352,2,60,78974,60,176,2,60,78973,60,176
905.495,6,180,11409,104,69,8791,69,6299,76,69,12071,69,5110
274.83,1,2,120,2,32,274830,32,120,0,0,0,0,0
1795.866,17,448,39896,403,35,4467,288,25676,45,288,40021,288,14220
0.449,6,12,1653,6,288,83,288,548,6,426,51,434,1105
1323.292,6,72,5077,41,31,30882,31,2752,31,31,44103,31,2325
1787.629,6,354,22440,207,69,8677,69,12420,147,69,12243,69,10020
1781.762,6,364,24454,212,88,8444,469,14027,152,69,11799,69,10427
4.015,17,4,240,4,32,1338,32,240,0,0,0,0,0
75.126,6,21,860,10,0,5317,0,404,11,0,7511,0,456
301.584,6,2636,3207789,1108,326,272,326,58286,1528,2013,197,10944,3149503
160.326,6,1411,722802,803,836,199,1152,691954,608,407,263,1179,30848
0.74,6,17,5164,9,150,92,174,664,8,835,93,1452,4500
1787.468,6,104,8356,68,64,26678,65,4920,36,58,51067,59,3436
4.43,6,37,7189,19,218,246,314,3383,18,513,244,1179,3806
550.61,2,10,320,10,8,61178,8,320,0,0,0,0,0
32.009,6,41,10188,20,723,798,1360,4484,21,373,1591,2720,5704
0.32,17,2,144,1,36,0,36,64,1,52,0,52,80
240.206,6,56,20251,30,832,8282,1418,17388,26,187,9607,580,2863
0.1,17,4,350,2,34,58,34,124,2,85,90,91,226
175.032,17,4,352,2,60,175031,60,176,2,60,175031,60,176
487.751,6,44,7899,28,115,18064,501,2510,16,338,32509,1420,5389
3.005,6,107,70838,62,1315,49,1432,64333,45,396,60,1871,6505
12.973,6,15,5444,7,124,2161,124,504,8,1502,1853,1612,4940
0.058,17,2,912,1,308,0,308,336,1,548,0,548,576
40.074,6,29,7257,13,155,3339,267,1306,16,441,2671,1420,5951
4.014,6,32,6089,17,206,250,314,2744,15,548,265,1179,3345
1791.481,17,180,14040,180,50,10008,50,14040,0,0,0,0,0
1.112,6,116,118962,52,263,21,517,4318,64,1886,16,6840,114644
29.282,6,44,13771,21,289,1464,721,3451,23,783,1284,1420,10320
116.639,6,21,2493,6,242,23,517,1059,15,323,8331,499,1434
10.692,6,6,328,4,0,3564,0,216,2,0,10330,0,112
38.721,17,4,240,2,32,38720,32,120,2,32,38720,32,120
1788.639,6,362,22898,210,69,8558,69,12678,152,69,11843,69,10220
0.057,6,12,3705,6,171,11,171,491,6,964,10,1448,3214
240.556,6,46,9171,24,519,10458,1402,5931,22,232,11454,617,3240
20.418,17,55,43561,23,443,926,1350,10847,32,994,657,1350,32714
7.766,6,40,10594,16,312,22,469,3771,24,292,337,1420,6823
1798.76,17,405,36248,364,35,4955,288,23292,41,288,44021,288,12956
1740.982,6,87,6322,58,31,30543,31,3915,29,31,62177,31,2407
1772.921,6,180,15480,120,69,14898,69,8940,60,69,30045,69,6540
1770.746,6,101,9278,66,64,27242,64,5544,35,58,52076,58,3734
11.641,6,1850,1607686,1122,1377,10,1420,1574345,728,467,16,1883,33341
1769.813,6,105,9759,68,65,26415,65,5758,37,59,49158,59,4001
1780.311,6,354,22440,207,69,8642,69,12420,147,69,12193,69,10020
0.022,17,2,423,1,37,0,37,65,1,330,0,330,358
1786.189,17,87,3648,86,14,21013,14,3612,1,8,0,8,36
300.818,6,47,10332,24,433,13079,910,3206,23,364,418,2128,7126
1742.377,6,95,7203,63,38,28102,205,4476,32,33,56196,98,2727
0.005,17,4,424,2,46,3,46,148,2,110,3,110,276
881.336,6,187,20585,93,143,9579,1189,9023,94,181,9476,1420,11562
1746.822,6,100,7463,62,38,28636,205,4424,38,33,47201,98,3039
0.92,6,10,1687,7,100,153,100,384,3,1179,336,1179,1303
5.626,6,13,2315,7,188,937,245,660,6,1407,1075,1407,1655
1772.149,6,205,22370,131,75,13631,267,10097,74,132,24275,1420,12273
1772.365,6,180,15480,120,69,14893,69,8940,60,69,30036,69,6540
734.981,6,48,3780,26,65,25976,65,1885,22,48,34995,59,1895
23.02,17,26,3704,13,48,1917,48,988,13,180,1917,308,2716
1749.545,6,188,18702,96,79,18414,721,8508,92,162,19223,4260,10194
350.598,6,53,6750,27,109,13475,721,2724,26,167,14014,1448,4026
1798.808,6,357,23098,209,75,8648,469,12969,148,69,12234,69,10129
0.601,6,33,8336,17,308,37,885,1944,16,521,30,3488,6392
0.063,17,2,120,1,32,0,32,60,1,32,0,32,60
90.216,6,86,69044,34,962,107,1460,7167,52,1328,1766,1460,61877
11.794,6,1856,1635269,1155,1363,10,1380,1603008,701,467,16,1923,32261
1786.641,6,109,8688,71,64,25523,64,5080,38,58,48285,58,3608
0.161,6,3,132,2,0,33,0,92,1,0,0,0,40
116.601,17,14,1232,7,48,19432,48,532,7,72,19432,72,700
1772.143,6,180,15480,120,69,14891,69,8940,60,69,30035,69,6540
8.621,17,6,528,3,48,4302,48,228,3,72,4300,72,300
1798.211,6,2069,2264496,762,150,2362,861,50951,1307,1735,1376,11216,2213545
1.212,6,25,8056,12,164,93,267,1288,13,869,85,1440,6768
0.003,6,3,189,1,0,0,0,40,2,69,0,69,149
232.663,6,24,2713,13,324,19388,585,1333,11,396,23091,580,1380
0.093,17,2,367,1,33,0,33,61,1,278,0,278,306
0.824,6,11,1727,7,100,137,100,384,4,589,184,1152,1343
0.05,6,3,120,0,0,0,0,0,3,0,0,0,120
9.194,17,16,1152,8,33,1312,33,488,8,55,1312,61,664
0.311,6,10,1368,5,133,77,133,401,5,351,77,380,967
1772.585,6,183,15807,120,69,14895,69,8940,63,69,28588,69,6867
233.79,2,4,128,4,8,77930,8,128,0,0,0,0,0
1715.259,1,98,5488,98,28,17683,28,5488,0,0,0,0,0
244.248,6,12,1324,5,190,20,190,458,7,247,40705,462,866
240.315,6,42,9051,21,523,12015,1408,5811,21,237,12015,617,3240
1798.742,1,345,28980,345,56,5228,56,28980,0,0,0,0,0
1798.736,6,2364,2160972,933,150,1929,885,61850,1431,1496,1257,5672,2099122
134.37,17,4,352,2,60,134369,60,176,2,60,134369,60,176
1389.962,17,353,47019,165,173,8475,1350,33177,188,45,7427,1350,13842
16.81,6,19,2465,10,322,1867,581,1181,9,396,2043,580,1284
1680.63,1,15,840,15,28,120045,28,840,0,0,0,0,0
1795.718,17,441,37400,404,35,4455,288,25708,37,288,48902,288,11692
0.364,6,6,324,4,0,121,0,216,2,0,191,0,108
12.744,17,4,352,2,48,12729,48,152,2,72,12730,72,200
76.943,17,9,684,9,48,9617,48,684,0,0,0,0,0
300.591,6,20,1391,10,177,33379,177,765,10,110,33378,110,626
0.051,17,2,167,1,39,0,39,67,1,72,0,72,100
1.001,6,23,6397,13,310,83,891,2077,10,979,110,1731,4320
0.053,6,13,3514,7,75,8,75,447,6,1373,10,1448,3067
1771.076,6,102,9779,68,70,26433,234,5948,34,60,53666,83,3831
6.281,1,4,224,4,28,2093,28,224,0,0,0,0,0
3.629,6,2,88,2,0,0,0,88,0,0,0,0,0
3.896,1,5,420,5,56,974,56,420,0,0,0,0,0
1794.4,6,356,22520,208,69,8668,69,12460,148,69,12206,69,10060
1771.352,6,99,9240,66,65,27251,65,5577,33,59,55352,59,3663
350.381,17,6,456,6,48,70076,48,456,0,0,0,0,0
1.275,6,49,20128,28,890,47,1360,14512,21,433,54,1360,5616
37.405,6,49,10240,25,638,514,1360,4309,24,309,1618,2667,5931
1.545,6,2,92,1,0,0,0,52,1,0,0,0,40
0.298,17,2,157,1,31,0,31,59,1,70,0,70,98
1760.284,1,56,4704,56,56,32005,56,4704,0,0,0,0,0
186.197,6,69,47494,44,1198,4330,1408,39462,25,960,2565,3847,8032
0.015,17,2,368,1,32,0,32,60,1,280,0,280,308
0.012,17,2,554,1,30,0,30,58,1,468,0,468,496
239.216,6,353,300314,232,1314,1035,1368,280328,121,595,1358,2736,19986
240.227,6,54,16154,28,683,8896,1418,13084,26,244,9608,580,3070
1793.28,17,66,2766,65,14,28020,14,2730,1,8,0,8,36
0.185,6,45,20811,26,1055,7,1420,15830,19,467,9,1883,4981
0.01,17,2,399,1,39,0,39,67,1,304,0,304,332
38.253,17,22,1672,22,48,1821,48,1672,0,0,0,0,0
1.85,6,2,1175,1,0,0,0,40,1,1095,0,1095,1135
1706.168,17,182,47462,182,232,9426,422,47462,0,0,0,0,0
10.924,6,82,24853,43,561,260,1152,19136,39,461,280,1179,5717
297.368,1,4,326,4,53,99122,78,326,0,0,0,0,0
1764.892,2,15,480,15,8,126063,8,480,0,0,0,0,0
0.011,17,2,491,1,39,0,39,67,1,396,0,396,424
1744.618,2,28,896,28,8,64615,8,896,0,0,0,0,0
283.082,6,31,7739,14,176,21775,267,1624,17,603,17689,1400,6115
333.166,6,145,112551,92,1307,3661,1448,100223,53,637,1933,1448,12328
0.315,17,8,2766,8,317,45,356,2766,0,0,0,0,0
49.874,17,42,16281,22,490,2373,1350,11412,20,215,2623,1350,4869
0.556,17,2,152,2,48,556,48,152,0,0,0,0,0
153.05,6,29,12105,15,500,441,690,3634,14,789,11762,1360,8471
0.954,17,2,312,2,128,954,128,312,0,0,0,0,0
50.313,6,29,7257,13,155,4192,267,1306,16,441,3353,1420,5951
357.656,2,3,96,3,8,178828,8,96,0,0,0,0,0
291.954,6,59,7391,27,112,11229,722,2744,32,135,9402,1408,4647
9.15,6,87,27610,45,577,207,1152,21448,42,447,217,1179,6162
0.107,17,2,602,1,46,0,46,74,1,500,0,500,528
1789.767,6,354,22509,205,69,8773,69,12340,149,69,12092,69,10169
0.418,17,15,9128,8,822,59,1350,6803,7,304,52,1350,2325
15.223,6,1648,1569468,1050,1418,14,1448,1533672,598,776,25,1448,35796
0.473,6,12,3704,6,171,49,171,491,6,964,81,1448,3213
4.198,17,21,6115,9,305,524,1350,3003,12,231,375,1350,3112
1797.13,17,447,39580,403,35,4470,288,25676,44,288,40952,288,13904
0.574,6,10,924,5,283,99,283,551,5,105,96,105,373
0.025,17,2,382,1,36,0,36,64,1,290,0,290,318
421.117,2,5,160,5,8,105279,8,160,0,0,0,0,0
1745.233,6,95,7203,63,38,28148,205,4476,32,33,56288,98,2727
1.503,6,48,19963,27,945,57,1460,14347,21,433,64,1460,5616
14.473,6,2467,2372689,1641,1371,8,1408,2325073,826,931,17,2801,47616
1782.096,6,105,8259,69,42,26207,205,4980,36,39,50904,170,3279
5.836,6,36,6249,19,206,324,314,2824,17,548,346,1179,3425
150.13,17,4,720,2,31,150121,34,119,2,272,150120,283,601
1782.158,17,142,11360,71,48,25459,48,5396,71,56,25459,56,5964
280.33,6,30,7432,13,158,23360,267,1317,17,543,17517,1400,6115
12.38,6,25,6756,8,154,1768,267,792,17,479,755,1420,5964
562.205,17,6,444,3,30,281045,30,174,3,62,280982,62,270
104.649,6,33,23825,19,840,33,1360,5835,14,1935,8040,5440,17990
8.781,2,2,64,2,8,8781,8,64,0,0,0,0,0
1740.764,6,87,6322,58,31,30539,31,3915,29,31,62169,31,2407
20.227,6,9,1145,5,174,5056,174,434,4,251,6738,476,711
65.385,6,29,7392,13,158,5448,267,1317,16,603,4356,2036,6075
18.073,6,27,4898,14,154,1390,721,1818,13,600,1488,2318,3080
10.104,6,31,8912,14,158,777,267,1357,17,687,627,1400,7555
11.822,6,27,7177,13,155,985,267,1306,14,530,908,3417,5871
0.491,17,14,6926,7,614,74,1350,4495,7,319,69,1350,2431
1.344,6,47,18752,27,860,51,1360,13176,20,476,61,2720,5576
73.286,6,68,12466,34,174,2220,876,4737,34,297,2219,2804,7729
1.071,6,28,8160,15,222,63,540,1964,13,1132,74,3051,6196
1796.574,17,448,39612,404,35,4458,288,25708,44,288,40951,288,13904
3.564,17,8,736,4,32,1182,32,240,4,96,1179,96,496
1795.909,17,449,39928,404,35,4456,288,25708,45,288,40018,288,14220
2.743,17,3,1173,3,363,1371,363,1173,0,0,0,0,0
1786.434,6,105,8348,68,64,26663,64,4896,37,58,49620,58,3452
0.081,17,2,245,1,32,0,32,60,1,157,0,157,185
1.073,6,44,22247,28,1062,39,1360,17105,16,561,59,2744,5142
3.147,1,3,168,3,28,1573,28,168,0,0,0,0,0
1704.966,17,12,498,11,14,170496,14,462,1,8,0,8,36
0.019,17,2,904,1,300,0,300,328,1,548,0,548,576
1740.034,17,30,1710,30,29,60001,29,1710,0,0,0,0,0
87.378,17,4,352,2,60,87377,60,176,2,60,87377,60,176
1789.95,6,109,7083,66,50,27537,208,4464,43,31,42608,31,2619
0.444,6,13,1705,7,288,70,288,600,6,426,50,434,1105
12.33,17,3,984,3,300,6165,300,984,0,0,0,0,0
1.178,17,6,2149,6,330,235,361,2149,0,0,0,0,0
1776.452,1,61,5124,61,56,29607,56,5124,0,0,0,0,0
11.846,6,1874,1638979,1144,1379,10,1420,1605546,730,467,16,1883,33433
1.307,6,47,18771,27,863,50,1360,13195,20,476,59,2715,5576
7.139,6,30,8848,13,155,594,267,1306,17,527,444,3417,7542
842.234,2,5,160,5,8,210558,8,160,0,0,0,0,0
0.296,17,2,152,1,48,0,48,76,1,48,0,48,76
8.203,1,8,672,8,56,1171,56,672,0,0,0,0,0
0.073,17,2,190,1,59,0,59,87,1,75,0,75,103
300.624,6,38,8566,20,315,15822,882,2093,18,441,498,1460,6473
181.381,6,29,7392,13,158,15115,267,1317,16,603,12090,1400,6075
1784.963,6,416,24920,208,69,8623,69,12460,208,34,8623,48,12460
1754.124,6,95,7203,63,38,28292,205,4476,32,33,56571,98,2727
1.297,6,25,8056,12,164,100,267,1288,13,869,91,1408,6768
2.545,6,20,3833,11,234,254,564,1504,9,463,287,1343,2329
696.884,2,6,192,6,8,139376,8,192,0,0,0,0,0
1788.423,17,87,3648,86,14,21040,14,3612,1,8,0,8,36
1.283,6,46,18905,27,875,49,1360,13369,19,529,61,4075,5536
18.486,6,6,1545,3,126,8079,126,246,3,1179,9243,1179,1299
0.06,6,12,3462,6,75,11,75,395,6,1373,11,1448,3067
64.915,6,12,500,6,0,2606,0,248,6,0,12981,0,252
0.854,6,28,5780,14,125,65,267,1315,14,650,60,1420,4465
216.925,6,28,8792,13,158,18077,267,1317,15,858,15490,2085,7475
3.048,6,4,220,3,0,1513,0,180,1,0,0,0,40
1784.471,6,452,27308,223,69,8038,69,13336,229,35,7826,48,13972
0.118,17,2,136,1,32,0,32,60,1,48,0,48,76
3.154,17,4,1552,4,360,1051,360,1552,0,0,0,0,0
11.66,6,35,15878,15,265,832,764,1935,20,1074,613,2371,13943
0.004,17,2,368,1,49,0,49,77,1,263,0,263,291
1787.42,6,102,8228,68,64,26677,64,4896,34,58,54161,58,3332
1771.174,6,104,9648,68,65,26435,65,5758,36,59,50601,59,3890
1742.258,6,95,7203,63,38,28100,205,4476,32,33,56192,98,2727
1783.853,6,416,24920,208,69,8617,69,12460,208,34,8617,48,12460
1749.235,6,169,17191,93,69,19013,721,7728,76,160,19963,1414,9463
1.766,6,17,6552,8,150,252,174,624,9,927,210,1420,5928
280.31,6,28,7352,13,158,23359,267,1317,15,678,20017,2045,6035
1799.55,17,146,11680,73,48,24993,48,5548,73,56,24993,56,6132
1787.435,17,87,3648,86,14,21028,14,3612,1,8,0,8,36
3.193,17,5,290,5,30,798,30,290,0,0,0,0,0
1742.817,1,55,4620,55,56,32274,56,4620,0,0,0,0,0
1786.601,6,364,23047,211,69,8507,69,12787,153,69,11753,69,10260
0.387,6,21,5000,11,137,38,267,1132,10,692,41,1467,3868
1794.032,1,70,3920,70,28,26000,28,3920,0,0,0,0,0
18.011,6,2846,2636150,1818,1371,9,1408,2578018,1028,931,17,2816,58132
10.495,6,6,328,4,0,3498,0,216,2,0,10360,0,112
85.557,17,6,528,3,60,42778,60,264,3,60,42778,60,264
0.018,17,2,235,1,39,0,39,67,1,140,0,140,168
0.15,17,2,433,1,34,0,34,62,1,343,0,343,371
0.184,6,14,3952,8,124,26,124,572,6,1530,36,1612,3380
72.852,17,33,6604,22,40,3469,41,1509,11,435,7110,505,5095
125.068,17,6,252,6,14,25013,14,252,0,0,0,0,0
0.427,17,8,2750,8,315,61,354,2750,0,0,0,0,0
3.464,17,34,6868,15,207,244,1350,3532,19,147,190,1350,3336
256.57,6,14,5890,5,96,64142,106,496,9,837,4071,1917,5394
1794.109,17,80,3354,79,14,23001,14,3318,1,8,0,8,36
74.064,17,4,352,2,60,74063,60,176,2,60,74063,60,176
280.215,6,28,7352,12,158,25474,267,1277,16,603,18678,1400,6075
280.641,6,31,7813,14,158,21587,267,1357,17,577,17538,2036,6456
25.64,6,15,2294,9,210,3203,210,896,6,545,5127,904,1398
0.157,6,46,22394,27,1087,6,1420,17413,19,467,8,1883,4981
120.262,2,2,64,2,8,120262,8,64,0,0,0,0,0
1740.502,17,30,31752,30,1030,60017,1064,31752,0,0,0,0,0
2.123,1,2,728,2,336,2123,336,728,0,0,0,0,0
1784.277,6,367,25112,213,93,8416,469,14605,154,69,11660,69,10507
1773.656,1,58,4872,0,0,0,0,0,58,56,31116,56,4872
140.296,6,37,8815,16,269,9350,517,2212,21,610,7012,1418,6603
0.835,17,2,167,1,39,0,39,67,1,72,0,72,100
1782.799,6,354,22440,207,69,8654,69,12420,147,69,12210,69,10020
1.326,6,48,19828,27,935,51,1460,14212,21,433,57,1460,5616
11.384,17,4,240,2,32,11384,32,120,2,32,11383,32,120
2.244,17,2,677,1,300,0,300,328,1,321,0,321,349
1.103,6,23,7952,12,164,86,267,1288,11,1216,94,3819,6664
1799.362,6,362,22967,210,69,8609,69,12609,152,69,11916,69,10358
300.344,6,36,18317,21,975,15017,1448,12805,15,785,4378,1448,5512
2.137,17,2,685,1,308,0,308,336,1,321,0,321,349
349.086,6,34,7050,15,168,11649,516,1615,19,291,19388,1452,5435
0.359,6,12,1653,6,288,68,288,548,6,426,39,434,1105
21.417,17,31,7772,14,267,1645,1350,4139,17,185,1336,1350,3633
0.736,6,30,7560,17,306,46,1087,2826,13,601,60,1420,4734
3.567,6,28,5402,15,286,254,975,2894,13,496,275,1179,2508
15.82,17,20,2940,10,48,1756,48,760,10,190,1756,308,2180
4.312,6,22,4426,12,213,392,597,1689,10,441,459,1440,2737
1787.207,6,103,8470,69,66,26282,66,5070,34,60,54154,60,3400
95.751,6,39,6353,22,180,4559,722,2247,17,321,1017,2026,4106
673.95,6,38,3032,21,66,24353,66,1566,17,49,42102,60,1466
240.29,6,57,17969,30,741,8285,1418,14921,27,181,9241,580,3048
1.637,6,13,2311,8,188,233,245,700,5,1407,346,1407,1611
2.539,6,13,2311,8,188,362,245,700,5,1407,569,1407,1611
151.201,6,23,9288,11,428,78,951,1758,12,879,13732,1440,7530
301.226,6,52,19831,29,976,10758,1440,13880,23,358,411,1440,5951
0.067,17,7,2172,7,282,11,316,2172,0,0,0,0,0
1680.747,17,13,534,11,14,168056,14,462,2,8,1680561,8,72
1649.978,1,7,742,7,78,274996,78,742,0,0,0,0,0
31.779,6,7,396,1,0,0,0,60,6,0,6317,0,336
1797.887,1,268,15008,268,28,6733,28,15008,0,0,0,0,0
136.895,17,4,352,2,60,136894,60,176,2,60,136894,60,176
1.067,17,3,174,3,30,533,30,174,0,0,0,0,0
1.19,6,8,440,5,0,297,0,268,3,0,575,0,172
655.036,1,5,726,5,117,163759,176,726,0,0,0,0,0
295.705,1,4,326,4,53,98568,78,326,0,0,0,0,0
2.187,17,14,5083,14,335,168,361,5083,0,0,0,0,0
0.09,17,2,144,1,36,0,36,64,1,52,0,52,80
0.394,17,2,164,1,46,0,46,74,1,62,0,62,90
1787.537,6,371,32445,212,108,8471,469,16289,159,128,11313,2840,16156
0.004,17,4,368,2,64,3,64,184,2,64,4,64,184
143.855,17,4,240,2,32,143854,32,120,2,32,143854,32,120
0.053,17,2,118,1,31,0,31,59,1,31,0,31,59
484.358,6,51,4455,30,69,14541,69,2235,21,69,24213,69,2220
0.858,6,37,8351,19,271,47,739,1878,18,441,42,1440,6473
1786.865,6,104,8376,68,65,26669,65,4930,36,59,51050,59,3446
3.366,6,25,6080,13,108,279,147,959,12,772,304,1608,5121
2.191,17,6,1438,3,30,1089,30,174,3,393,1090,468,1264
0.175,6,10,767,5,186,43,186,454,5,45,43,45,313
1.316,17,2,136,1,32,0,32,60,1,48,0,48,76
10.779,6,18,4226,10,275,1197,275,958,8,978,856,1420,3268
0.375,6,10,968,5,256,91,256,460,5,304,91,304,508
281.473,6,30,7432,13,158,23456,267,1317,17,603,17589,2036,6115
0.394,6,55,23734,32,1015,12,1380,16616,23,475,15,1923,7118
1796.878,6,369,25799,214,99,8436,469,15045,155,69,11667,69,10754
219.436,17,4,352,2,60,219435,60,176,2,60,219435,60,176
1779.172,6,102,8228,68,64,26554,64,4896,34,58,53911,58,3332
1772.266,6,180,15480,120,69,14892,69,8940,60,69,30034,69,6540
1734.765,17,144,24138,144,139,12131,373,24138,0,0,0,0,0
1777.622,1,146,8176,146,28,12259,28,8176,0,0,0,0,0
0.962,6,19,5904,10,280,106,540,1244,9,716,109,1420,4660
64.291,6,23,6149,10,186,22,318,1098,13,873,5354,2736,5051
75.305,17,4,352,2,60,75304,60,176,2,60,75304,60,176
571.756,17,46,3680,23,48,25988,48,1748,23,56,25988,56,1932
3.737,17,2,1712,2,828,3737,1315,1712,0,0,0,0,0
15.978,17,13,4624,6,363,3154,1350,2347,7,297,2639,1350,2277
20.272,6,22,5482,12,107,1842,159,1074,10,967,2246,1709,4408
1790.185,17,47,17407,47,342,38917,548,17407,0,0,0,0,0
7.359,17,16,15539,6,922,1471,1350,5701,10,955,556,1350,9838
1795.767,6,232,18197,89,74,20404,336,8930,143,49,12645,143,9267
1776.902,6,194,13556,68,46,26520,46,5618,126,46,14214,46,7938
421.109,2,4,128,4,8,140369,8,128,0,0,0,0,0
20.155,6,22,5470,12,107,1832,159,1074,10,773,2236,1418,4396
11.637,17,8,704,4,48,3874,48,304,4,72,3867,72,400
7.475,6,9,596,3,106,3737,106,234,6,90,1446,90,362
1769.768,17,232,41815,232,152,7661,389,41815,0,0,0,0,0
0.152,17,2,241,1,36,0,36,64,1,149,0,149,177
33.374,6,31,5095,15,180,2383,722,1860,16,299,2212,1440,3235
280.223,6,27,7312,12,158,25474,267,1277,15,678,20013,2045,6035
12.303,6,80,24421,40,550,315,1152,18680,40,459,308,1179,5741
1.311,6,51,20075,28,880,48,1360,14379,23,433,51,1360,5696
166.749,6,19818,19151013,13355,1357,12,1408,18810273,6463,776,25,1408,340740
6.743,6,2,1175,1,0,0,0,40,1,1095,0,1095,1135
0.249,6,27,7296,13,155,20,267,1301,14,603,18,2036,5995
1749.542,6,95,7203,63,38,28218,205,4476,32,33,56430,98,2727
9.0,6,646,583358,422,1316,20,1368,567046,224,776,39,1473,16312
233.019,6,31,8912,14,158,17924,267,1357,17,687,14558,2800,7555
74.454,6,65,42469,41,1155,1861,1408,34488,24,960,2677,3847,7981
0.019,6,14,4334,7,111,3,111,483,7,869,3,1448,3851
40.163,6,25,7097,12,155,3651,267,1266,13,589,3346,3426,5831
240.331,6,42,9041,21,523,12016,1408,5809,21,236,12016,618,3232
1168.859,6,239,16487,139,97,8469,469,9658,100,69,11806,69,6829
1.183,6,4,224,2,0,1012,0,120,2,0,1006,0,104
17.763,17,28,7809,12,330,1612,1350,4306,16,190,1182,1350,3503
181.147,6,17,2471,7,188,30191,245,660,10,703,20098,1152,1811
300.305,6,302,311005,191,147,1580,283,10579,111,2779,2216,9814,300426
1.408,6,46,18718,27,862,54,1360,13182,19,476,68,2715,5536
1782.976,6,102,8296,68,65,26611,65,4930,34,59,54026,59,3366
204.596,17,6,2016,6,308,40919,308,2016,0,0,0,0,0
3.224,6,23,7380,10,357,358,721,1475,13,597,253,1414,5905
0.013,17,2,136,1,32,0,32,60,1,48,0,48,76
1.679,6,51,19860,29,922,59,1360,14159,22,437,69,2715,5701
0.313,6,26,9013,13,257,26,669,1714,13,1102,25,2804,7299
250.461,6,60,18657,30,809,8636,1418,15347,30,192,8636,580,3310
600.689,2,8,256,8,8,85812,8,256,0,0,0,0,0
1770.905,6,101,9410,66,66,27244,66,5610,35,60,52082,60,3800
0.017,17,2,154,1,41,0,41,69,1,57,0,57,85
9.906,6,1467,1349203,954,1365,10,1432,1324380,513,427,19,1432,24823
1786.788,6,104,8308,68,64,26668,64,4896,36,58,51047,58,3412
150.298,17,4,1344,4,308,50099,308,1344,0,0,0,0,0
51.835,6,26,7835,11,311,5183,517,1839,15,519,3699,1408,5996
108.438,6,43,8881,20,401,620,889,2084,23,345,4923,1360,6797
2.061,17,2,170,1,37,0,37,65,1,77,0,77,105
1772.451,6,180,15480,120,69,14894,69,8940,60,69,30038,69,6540
6.938,6,4,240,4,0,0,0,240,0,0,0,0,0
4.932,6,44,8369,22,227,234,314,4062,22,489,223,1179,4307
1789.957,6,379,24268,217,69,8286,69,13234,162,69,11117,69,11034
0.013,6,11,924,7,181,2,181,553,4,77,3,134,371
0.005,17,4,942,2,45,0,45,146,2,370,1,418,796
1.136,17,4,288,2,36,1105,36,128,2,52,1104,52,160
280.523,17,4,296,2,30,280464,30,116,2,62,280470,62,180
0.082,6,15,3992,8,124,11,124,560,7,1530,13,1612,3432
147.538,17,42,10878,42,231,3598,388,10878,0,0,0,0,0
1681.487,17,14,1036,7,30,280245,30,406,7,62,280245,62,630
0.089,17,2,279,1,36,0,36,64,1,187,0,187,215
258.354,17,10,880,5,48,64586,48,380,5,72,64586,72,500
1793.164,6,355,22480,207,69,8704,69,12420,148,69,12195,69,10060
0.167,17,2,214,1,39,0,39,67,1,119,0,119,147
1791.613,17,179,13962,179,50,10065,50,13962,0,0,0,0,0
0.354,6,26,8995,13,252,29,647,1692,13,945,28,1438,7303
1781.763,6,376,26617,216,104,8287,469,15732,160,69,11206,69,10885
138.417,6,18,4386,9,691,99,1360,3158,9,214,17281,354,1228
0.008,6,2,214,1,134,0,134,174,1,0,0,0,40
5.013,17,4,558,2,36,5003,36,128,2,187,4999,187,430
1786.889,6,384,29020,223,125,8049,469,17819,161,69,11167,69,11201
35.559,6,31,5096,15,154,2539,722,1860,16,342,2335,1448,3236
125.616,6,40,8998,14,174,181,267,1613,26,301,5024,1460,7385
1.025,6,10,1687,7,100,170,100,384,3,1179,386,1179,1303
1799.249,17,161,14732,81,68,22490,952,7852,80,58,22775,72,6880
0.012,17,2,316,1,31,0,31,59,1,229,0,229,257
0.007,17,4,352,2,60,6,60,176,2,60,6,60,176
373.897,6,25,1651,17,177,23368,177,1117,8,110,9229,110,534
2.064,6,20,3833,11,234,206,564,1504,9,463,229,1343,2329
0.061,17,2,157,1,31,0,31,59,1,70,0,70,98
1785.121,6,374,23432,215,69,8341,69,12740,159,61,11298,69,10692
282.615,17,4,240,2,32,282614,32,120,2,32,282614,32,120
1786.654,6,102,8296,68,65,26666,65,4930,34,59,54138,59,3366
0.024,17,6,912,3,60,4,60,264,3,188,5,188,648
273.584,6,24,1296,10,0,30397,0,536,14,0,21044,0,760
662.658,6,62,23099,31,449,22088,1360,5806,31,641,22081,3494,17293
243.254,6,94,34861,44,673,2293,1460,20006,50,558,4960,1460,14855
0.159,6,27,7296,13,155,13,267,1301,14,603,11,2036,5995
9.047,6,17,6735,9,275,1130,275,643,8,1440,1125,1440,6092
7.665,17,611,513805,412,1134,18,1350,478796,199,147,38,1350,35009
368.559,6,25,1651,17,177,23034,177,1117,8,110,9199,110,534
139.298,6,15,1272,8,177,19874,177,802,7,110,23186,110,470
1794.726,17,87,3648,86,14,21114,14,3612,1,8,0,8,36
0.937,6,28,9286,15,203,66,458,1470,13,910,63,2566,7816
1.508,6,38,8254,19,321,83,1164,2718,19,433,73,1460,5536
4.177,6,37,7189,19,218,232,314,3383,18,513,230,1179,3806
6.061,6,44,8369,22,227,288,314,4062,22,489,276,1179,4307
0.375,17,8,2750,8,315,53,354,2750,0,0,0,0,0
1797.263,6,392,24296,211,69,8558,69,12580,181,48,9984,69,11716
9.014,6,15,1087,8,275,1287,275,603,7,96,1337,96,484
0.179,6,3,132,2,0,3,0,92,1,0,0,0,40
0.051,17,4,588,2,48,46,48,152,2,190,44,308,436
21.625,6,3,616,3,248,10812,248,616,0,0,0,0,0
0.304,17,2,198,1,63,0,63,91,1,79,0,79,107
0.164,6,40,16861,23,1001,7,1420,11960,17,467,9,1883,4901
409.391,6,57,8980,30,100,14116,501,2915,27,276,15366,1420,6065
60.419,17,8,1648,4,48,20132,48,304,4,308,20060,308,1344
1771.765,6,99,9240,66,65,27257,65,5577,33,59,55364,59,3663
1755.854,6,97,7307,63,38,28320,205,4476,34,33,53198,98,2831
1772.294,6,180,15480,120,69,14893,69,8940,60,69,30033,69,6540
4.108,6,38,7229,19,218,228,314,3383,19,440,214,1152,3846
2.686,6,23,7373,11,357,268,721,1515,12,767,227,1440,5858
300.851,6,42,13568,23,881,13675,1460,8006,19,435,481,2567,5562
0.171,17,2,152,2,48,171,48,152,0,0,0,0,0
1763.97,2,15,480,15,8,125997,8,480,0,0,0,0,0
688.498,1,14,784,14,28,52961,28,784,0,0,0,0,0
1791.814,17,140,11200,70,48,25968,48,5320,70,56,25968,56,5880
8.725,6,207,144052,119,1065,73,1440,54899,88,1297,98,1671,89153
16.435,17,21,9455,11,603,1640,1350,6951,10,222,1822,1350,2504
12.367,6,97,28106,50,548,252,1152,21744,47,447,263,1179,6362
21.83,6,25,6757,12,181,1984,267,1212,13,717,1814,2036,5545
0.725,6,3,1567,1,0,0,0,40,2,723,190,1440,1527
374.018,6,25,1651,17,177,23376,177,1117,8,110,9229,110,534
0.77,6,41,24150,24,840,33,1360,6035,17,1583,37,2720,18115
0.209,17,2,152,2,48,209,48,152,0,0,0,0,0
1772.757,6,180,15480,120,69,14897,69,8940,60,69,30040,69,6540
0.038,17,2,152,1,40,0,40,68,1,56,0,56,84
2.446,17,2,178,1,29,0,29,57,1,93,0,93,121
7.107,6,184,199318,126,133,56,201,5607,58,3544,121,16968,193711
1.268,6,47,18815,26,932,50,1460,13199,21,433,54,1460,5616
1.271,6,36,8174,19,321,70,1164,2718,17,476,69,2715,5456
0.058,6,7,423,4,43,5,43,259,3,0,28,0,164
3.248,6,176,129230,102,1359,32,1432,116991,74,506,41,1432,12239
116.688,17,4,352,2,60,116687,60,176,2,60,116687,60,176
1680.739,1,15,840,15,28,120052,28,840,0,0,0,0,0
1770.515,6,99,9174,66,64,27238,64,5544,33,58,55325,58,3630
0.319,17,4,232,2,30,290,30,116,2,30,292,30,116
5.922,6,39,7269,21,218,296,314,3463,18,513,331,1179,3806
1620.577,1,8,448,8,28,231511,28,448,0,0,0,0,0
0.646,6,10,924,5,283,114,283,551,5,105,114,105,373
57.067,17,20,1760,10,48,6339,48,760,10,72,6339,72,1000
0.309,6,23,7394,13,335,25,668,2026,10,1210,33,1906,5368
86.966,6,34,9953,13,503,25,938,2219,21,414,4347,1605,7734
5.247,6,38,7229,19,218,291,314,3383,19,513,277,1179,3846
0.14,1,2,112,2,28,140,28,112,0,0,0,0,0
39.395,17,11,836,11,48,3939,48,836,0,0,0,0,0
1789.478,17,142,11360,71,48,25563,48,5396,71,56,25563,56,5964
0.86,6,20,5984,11,282,86,548,1292,9,721,96,1452,4692
7.341,6,1864,1742943,1192,1385,6,1408,1703335,672,776,10,1408,39608
53.011,17,16,18199,16,1109,3534,1451,18199,0,0,0,0,0
1792.661,17,141,9024,141,36,12804,36,9024,0,0,0,0,0
6.294,1,4,224,4,28,2098,28,224,0,0,0,0,0
240.308,6,43,9104,21,523,12014,1418,5815,22,237,11442,617,3289
0.163,6,9,1002,5,213,40,213,417,4,421,42,421,585
36.541,6,13,3953,6,290,7306,517,901,7,1342,6089,1408,3052
0.052,6,10,861,6,182,10,182,490,4,77,15,134,371
1783.353,17,72,3018,71,14,25476,14,2982,1,8,0,8,36
1792.868,17,160,10240,160,36,11275,36,10240,0,0,0,0,0
0.285,6,21,6593,10,181,24,267,1128,11,836,26,2045,5465
1.659,6,25,8711,15,276,118,561,1433,10,982,165,1420,7278
1772.04,6,180,15480,120,69,14891,69,8940,60,69,30031,69,6540
280.04,6,28,7352,13,158,23336,267,1317,15,678,19999,3436,6035
397.459,6,3492,2868088,2112,1413,188,1460,2786256,1380,130,77,1460,81832
1772.778,6,180,15480,120,69,14897,69,8940,60,69,30046,69,6540
249.077,1,23,2392,0,0,0,0,0,23,76,11321,76,2392
280.433,6,31,7472,13,158,23369,267,1317,18,543,16493,1380,6155
0.491,6,23,7397,13,334,40,663,2021,10,967,51,1471,5376
0.013,17,2,418,1,37,0,37,65,1,325,0,325,353
0.446,6,6,324,4,0,148,0,216,2,0,216,0,108
0.039,6,17,6068,10,88,4,88,556,7,1740,6,1880,5512
1.066,6,25,6448,13,297,88,830,2011,12,790,96,1420,4437
31.78,6,2,96,1,0,0,0,48,1,0,0,0,48
5.943,17,2,740,2,342,5943,342,740,0,0,0,0,0
1401.126,17,12,3250,6,30,280222,30,348,6,455,280223,463,2902
0.327,6,4,196,4,0,0,0,196,0,0,0,0,0
177.249,6,33,23814,19,840,34,1360,5835,14,2486,13624,6781,17979
1741.363,17,27,6345,27,207,66975,207,6345,0,0,0,0,0
1740.461,17,30,20190,30,645,60015,645,20190,0,0,0,0,0
259.49,17,4,240,2,32,259488,32,120,2,32,259489,32,120
167.223,6,22,8319,11,525,108,1237,2048,11,831,16702,1360,6271
1788.057,17,87,3648,86,14,21035,14,3612,1,8,0,8,36
254.54,6,6,272,3,0,127270,0,128,3,0,1523,0,144
868.289,1,16,896,16,28,57885,28,896,0,0,0,0,0
1796.661,17,140,11200,70,48,26038,48,5320,70,56,26038,56,5880
3.027,6,5,232,2,0,3027,0,88,3,0,1509,0,144
0.245,17,2,384,1,39,0,39,67,1,289,0,289,317
10.503,1,4,224,4,28,3501,28,224,0,0,0,0,0
1768.932,6,99,9240,66,65,27214,65,5577,33,59,55274,59,3663
300.328,6,52,27312,32,393,9688,1018,3305,20,1530,1609,5632,24007
73.39,6,24,10290,12,579,60,1360,2831,12,1161,6659,2574,7459
1781.908,6,134,8246,72,27,25097,27,4368,62,27,29131,27,3878
7.969,6,17,4020,9,290,996,517,1057,8,632,1124,1380,2963
240.127,6,32,3891,16,181,16007,595,1930,16,224,16007,580,1961
0.893,17,4,240,2,32,891,32,120,2,32,892,32,120
1.45,6,55,24081,32,998,46,1460,18340,23,437,56,2615,5741
502.172,6,104,13525,42,96,12247,267,3906,62,139,8232,1460,9619
1738.48,1,53,4452,53,56,33432,56,4452,0,0,0,0,0
127.283,6,9,522,3,106,63641,106,234,6,0,6305,0,288
0.005,17,2,588,1,39,0,39,67,1,493,0,493,521
5.02,17,4,558,2,36,5006,36,128,2,187,5006,187,430
70.01,1,2,232,2,88,70010,88,232,0,0,0,0,0
240.226,6,57,20538,31,837,8007,1418,17532,26,205,9608,580,3006
240.254,6,54,19795,29,854,8580,1408,16898,25,198,10010,580,2897
7.036,6,41,7349,21,218,351,314,3463,20,513,355,1179,3886
1788.189,1,192,10752,192,28,9362,28,10752,0,0,0,0,0
78.442,6,32,15790,16,585,46,1360,3609,16,1152,5221,2720,12181
707.435,6,44,3403,27,65,27209,65,1925,17,57,44208,59,1478
1799.254,6,156,16128,85,70,21419,721,6714,71,149,25697,2840,9414
4.888,6,39,7269,19,218,271,314,3383,20,513,243,1179,3886
315.782,17,11,3696,11,308,31578,308,3696,0,0,0,0,0
10.772,6,20,7050,11,275,1077,275,998,9,1420,748,1420,6052
1773.591,6,180,15480,120,69,14904,69,8940,60,69,30056,69,6540
1778.185,1,200,11200,200,28,8935,28,11200,0,0,0,0,0
50.483,6,9,484,5,0,12620,0,268,4,0,16823,0,216
4.373,17,32,24687,19,935,242,1350,18311,13,462,334,1350,6376
1.952,17,2,672,2,308,1952,308,672,0,0,0,0,0
0.16,17,2,194,1,61,0,61,89,1,77,0,77,105
1.126,6,20,7049,12,164,102,267,1124,8,1833,149,3819,5925
154.174,6,19,772,7,0,8131,0,284,12,0,14014,0,488
300.61,6,39,8599,20,286,15821,766,2024,19,414,468,2128,6575
3.342,17,5,290,5,30,835,30,290,0,0,0,0,0
542.331,1,10,560,10,28,60259,28,560,0,0,0,0,0
0.114,17,14,11529,9,1041,14,1350,9623,5,353,23,1350,1906
1190.173,17,14,1117,7,31,198348,37,413,7,72,198348,136,704
0.46,6,22,7345,13,334,38,663,2021,9,1209,51,1946,5324
0.125,17,4,368,2,32,49,32,120,2,96,52,96,248
36.969,17,58,11224,26,192,1477,1350,5732,32,143,1191,1350,5492
104.96,6,3,808,3,326,52480,326,808,0,0,0,0,0
1745.466,6,97,7338,64,38,27705,205,4528,33,33,54537,98,2810
11.804,6,1824,1628424,1151,1363,10,1380,1597271,673,467,17,1923,31153
15.939,6,20,5786,10,275,1334,275,958,10,1104,1739,1440,4828
0.286,6,23,7339,12,271,25,517,1718,11,1008,27,1691,5621
317.064,6,80,17198,41,265,7926,1460,7782,39,313,8339,1638,9416
5.205,6,30,10405,15,423,371,1408,2483,15,791,371,1408,7922
87.767,17,36,2472,36,40,2507,41,2472,0,0,0,0,0
0.231,17,3,1167,3,361,115,361,1167,0,0,0,0,0
0.134,6,3,151,2,31,0,31,111,1,0,0,0,40
0.02,17,2,475,1,40,0,40,68,1,379,0,379,407
1796.905,1,345,28980,345,56,5223,56,28980,0,0,0,0,0
320.471,1,5,280,5,28,80117,28,280,0,0,0,0,0
0.119,17,5,1000,3,60,57,60,264,2,340,108,340,736
1793.545,6,356,22520,208,69,8664,69,12460,148,69,12200,69,10060
0.212,17,2,2730,2,1337,212,1337,2730,0,0,0,0,0
2.434,6,29,6175,15,338,173,1314,2294,14,368,186,1420,3881
0.037,6,10,2046,6,739,7,1322,1723,4,159,11,159,323
1744.796,6,95,7203,63,38,28141,205,4476,32,33,56272,98,2727
1793.552,6,356,22520,208,69,8664,69,12460,148,69,12200,69,10060
4.226,17,5,295,5,31,1056,31,295,0,0,0,0,0
280.317,6,29,7392,13,158,23359,267,1317,16,603,18679,2036,6075
237.647,17,4,352,2,60,237645,60,176,2,60,237646,60,176
61.359,6,37,15983,22,805,2921,1408,9205,15,665,4363,1408,6778
0.088,6,2,1116,1,0,0,0,40,1,1024,0,1024,1076
1792.124,6,356,22520,208,69,8657,69,12460,148,69,12191,69,10060
1770.273,1,59,4956,59,56,30521,56,4956,0,0,0,0,0
1.808,17,20,5180,20,231,95,388,5180,0,0,0,0,0
8.578,6,67,20166,34,562,259,1152,15419,33,489,258,1179,4747
0.279,6,19,4920,10,137,31,267,1092,9,866,33,2867,3828
1783.827,6,374,26206,215,99,8335,469,15154,159,69,11290,69,11052
0.004,6,4,232,3,0,1,0,192,1,0,0,0,40
0.499,6,5,453,3,245,129,245,369,2,0,258,0,84
31.044,6,7,308,1,0,0,0,44,6,0,6207,0,264
0.462,6,51,21937,28,1041,17,1380,16775,23,383,18,1380,5162
251.87,2,2,64,2,8,251870,8,64,0,0,0,0,0
1786.966,6,104,8444,68,66,26671,66,4964,36,60,51053,60,3480
1.335,6,51,19502,27,903,51,1440,13766,24,433,50,1440,5736
1790.743,6,184,17095,122,83,14799,981,10001,62,74,29350,405,7094
1.909,17,2,312,2,128,1909,128,312,0,0,0,0,0
1781.765,6,355,22480,207,69,8649,69,12420,148,69,12120,69,10060
0.055,6,6,897,3,483,18,483,639,3,102,12,102,258
1789.019,17,142,11360,71,48,25557,48,5396,71,56,25557,56,5964
325.712,6,67,10571,33,102,10178,267,2865,34,234,9865,1452,7706
2.102,17,6,849,3,31,1046,31,177,3,196,1038,196,672
3.38,6,4,176,2,0,3380,0,88,2,0,1009,0,88
0.004,6,2,1460,1,0,0,0,40,1,1368,0,1368,1420
1792.157,17,180,14040,180,50,10012,50,14040,0,0,0,0,0
7.917,17,6,528,3,48,3951,48,228,3,72,3951,72,300
62.61,6,17,5266,7,150,10435,174,584,10,611,4082,1452,4682
5.42,17,27,13808,12,480,492,1350,6103,15,485,257,1350,7705
258.727,17,4,352,2,60,258726,60,176,2,60,258725,60,176
3.272,17,4,304,2,48,2981,48,152,2,48,2983,48,152
1793.689,1,58,4872,0,0,0,0,0,58,56,31468,56,4872
16.723,6,9,527,5,43,4180,43,311,4,0,5573,0,216
8.196,6,18,6871,9,275,1024,275,643,9,1171,987,1440,6228
15.912,6,1902,1744326,1221,1375,13,1380,1708047,681,387,23,1923,36279
14.942,6,7,400,2,0,14942,0,100,5,0,3722,0,300
1.294,6,12,1144,5,146,322,146,350,7,170,214,506,794
1796.908,17,449,39928,404,35,4458,288,25708,45,288,40021,288,14220
141.843,17,14,1064,14,48,10911,48,1064,0,0,0,0,0
669.813,17,203,17776,154,37,4377,288,10104,49,128,12515,288,7672
24.624,6,21,6876,4,156,813,267,638,17,426,1538,1420,6238
164.321,6,24,10054,13,532,69,1360,2682,11,1153,16415,2574,7372
1648.368,6,178,20876,111,80,14985,267,9573,67,143,24975,1460,11303
0.085,6,9,1343,5,145,21,145,349,4,830,21,830,994
7.661,6,10,787,5,275,1915,275,479,5,96,1346,96,308
1.538,6,47,19498,27,915,59,1460,13922,20,433,60,1460,5576
1772.338,6,180,15480,120,69,14893,69,8940,60,69,30035,69,6540
21.276,6,3459,3380899,2336,1372,9,1408,3317839,1123,776,18,1408,63060
0.357,6,51,22021,28,1047,13,1380,16859,23,421,14,1923,5162
5.714,6,42,7389,22,218,272,314,3503,20,513,284,1179,3886
2.869,6,57,20429,31,929,95,1460,14317,26,361,100,1460,6112
280.043,6,27,7312,13,158,23336,267,1317,14,775,21538,2800,5995
280.046,6,28,7352,13,158,23337,267,1317,15,678,20000,3436,6035
0.114,17,2,152,1,48,0,48,76,1,48,0,48,76
0.115,6,9,1002,5,213,28,213,417,4,421,29,421,585
1787.906,6,400,32151,223,137,8053,965,17885,177,83,10158,256,14266
2.024,6,26,8793,16,283,134,582,1494,10,985,202,1420,7299
1.144,6,30,6220,16,138,76,267,1755,14,650,78,1420,4465
1785.146,6,356,22520,208,69,8623,69,12460,148,69,12143,69,10060
0.561,6,15,1785,8,288,54,288,640,7,426,64,434,1145
109.463,2,6,240,6,16,21892,16,240,0,0,0,0,0
39.823,17,4,1328,4,304,13274,308,1328,0,0,0,0,0
1796.713,17,83,3480,82,14,22181,14,3444,1,8,0,8,36
0.164,6,25,7216,13,155,13,267,1301,12,678,14,3436,5915
1747.84,6,95,7203,63,38,28190,205,4476,32,33,56371,98,2727
0.055,17,4,344,2,47,0,47,150,2,69,0,75,194
0.919,6,27,8420,15,222,54,540,1964,12,1192,68,3151,6456
0.903,6,10,1687,7,100,150,100,384,3,1179,324,1179,1303
1797.027,6,356,22520,208,69,8681,69,12460,148,69,12221,69,10060
1.878,6,27,8851,16,286,125,591,1503,11,863,164,1380,7348
0.074,6,9,1242,5,145,18,145,349,4,729,19,729,893
74.698,6,25,10769,12,380,77,832,1665,13,952,6213,1460,9104
6.01,6,45,8409,23,227,273,314,4102,22,489,273,1179,4307
6.894,6,15,2609,7,152,210,267,742,8,308,949,1179,1867
134.477,17,4,240,2,32,134475,32,120,2,32,134476,32,120
1795.521,17,447,39864,402,35,4477,288,25644,45,288,40018,288,14220
598.636,6,46,6657,21,83,24563,273,1763,25,162,24939,278,4894
0.049,17,2,2754,2,1349,49,1349,2754,0,0,0,0,0
0.043,17,2,904,1,300,0,300,328,1,548,0,548,576
1003.866,6,160,20875,90,120,11279,469,9284,70,139,14545,1460,11591
21.013,6,1190,1057505,769,1300,27,1368,1030949,421,931,49,2736,26556
1794.466,17,180,11520,180,36,10024,36,11520,0,0,0,0,0
1784.33,6,104,8308,68,64,26631,64,4896,36,58,50978,58,3412
0.006,6,2,123,1,0,0,0,40,1,31,0,31,83
292.551,6,318,50939,178,304,1652,304,35672,140,83,2104,83,15267
62.58,6,13,772,3,106,31285,106,234,10,90,6952,90,538
1744.977,2,23,736,23,8,79317,8,736,0,0,0,0,0
40.73,17,6,528,3,48,20336,48,228,3,72,20356,72,300
4.003,6,10,420,6,0,800,0,248,4,0,990,0,172
2.697,6,49,17467,27,886,103,1460,11766,22,437,112,2615,5701
10.396,6,9,527,5,43,2599,43,311,4,0,3446,0,216
280.511,6,30,7432,13,158,23375,267,1317,17,603,17525,2076,6115
1790.991,1,58,4872,58,56,31420,56,4872,0,0,0,0,0
2.76,6,10,1387,5,145,690,145,349,5,830,687,830,1038
1756.76,6,107,6344,60,26,29774,26,3510,47,26,38189,26,2834
126.215,2,3,96,3,8,63107,8,96,0,0,0,0,0
281.166,6,29,7392,13,158,23430,267,1317,16,603,18741,1400,6075
491.14,6,46,8010,28,122,18190,516,2468,18,321,28884,1452,5542
1.369,6,51,19463,27,901,52,1460,13727,24,433,51,1460,5736
92.713,6,24,9833,12,465,78,1360,2374,12,1161,8413,2574,7459
1607.075,1,72,4032,72,28,22634,28,4032,0,0,0,0,0
1795.77,17,142,11360,71,48,25653,48,5396,71,56,25653,56,5964
240.22,6,55,19830,30,848,8283,1418,16849,25,209,10008,580,2981
2.657,6,64,24477,35,945,78,1460,13823,29,499,82,1460,10654
0.135,17,2,2380,2,1162,135,1162,2380,0,0,0,0,0
1799.599,17,768,46392,768,32,2346,37,46392,0,0,0,0,0
1794.784,6,129,13106,81,78,22426,511,6451,48,124,38183,1380,6655
300.825,6,38,9598,20,648,15832,1440,4076,18,399,508,1440,5522
300.226,6,28,11679,16,592,20015,1408,4408,12,948,22335,1578,7271
181.086,6,45,2697,22,69,8623,69,1294,23,34,8231,48,1403
20.101,6,20,5366,12,107,1827,159,1074,8,967,2870,1675,4292
0.419,6,10,968,5,256,103,256,460,5,304,103,304,508
4.593,17,42,13710,22,280,217,1350,6790,20,318,240,1350,6920
818.229,6,165,10533,96,69,8611,69,5910,69,69,12031,69,4623
116.143,6,46,13091,23,892,593,1360,7245,23,327,5270,2667,5846
4.265,6,10,1102,6,483,853,483,803,4,83,1418,83,299
1782.113,17,83,3480,82,14,22001,14,3444,1,8,0,8,36
291.863,6,286,46091,161,304,1824,304,32916,125,83,2350,83,13175
10.428,6,14,4784,9,290,1303,517,1057,5,1153,83,1461,3727
0.534,6,29,10419,15,439,38,1448,2547,14,792,40,1448,7872
11.744,6,52,15849,27,518,451,1460,5350,25,631,454,1934,10499
57.215,6,43,8924,21,401,741,889,2136,22,368,2717,3488,6788
1793.54,1,275,15400,275,28,6545,28,15400,0,0,0,0,0
0.11,17,2,152,1,48,0,48,76,1,48,0,48,76
1.181,17,2,154,1,33,0,33,61,1,65,0,65,93
1.252,6,8,342,4,0,417,0,164,4,7,273,7,178
8.723,6,83,24877,41,561,218,1152,19056,42,413,206,1152,5821
16.201,17,13,6552,7,613,2694,1350,4488,6,316,3233,1350,2064
1788.175,6,119,12537,74,83,24495,516,5958,45,129,40629,1452,6579
0.025,6,14,4044,8,88,3,88,452,6,1670,5,1880,3592
353.71,6,37,15833,25,236,14737,1360,3872,12,1638,43,4416,11961
1770.224,6,99,9306,66,66,27234,66,5610,33,60,55316,60,3696
908.86,6,58,4492,34,45,27536,205,2503,24,34,39508,98,1989
1789.032,17,31,32736,31,1028,59634,1028,32736,0,0,0,0,0
0.724,6,278,225632,124,226,5,253,8264,154,1395,4,1448,217368
0.077,6,14,5792,7,135,12,135,507,7,1228,12,1448,5285
60.445,6,11,2993,6,92,12089,92,400,5,1164,15061,1368,2593
110.163,6,36,8465,18,413,523,923,1991,18,478,6470,2128,6474
20.6,6,39,8531,15,333,42,685,1632,24,311,889,1360,6899
1779.094,1,86,7224,86,56,20930,56,7224,0,0,0,0,0
1670.741,1,7,742,7,78,278456,78,742,0,0,0,0,0
0.175,17,2,214,1,39,0,39,67,1,119,0,119,147
16.474,17,5,380,5,48,4118,48,380,0,0,0,0,0
280.278,6,30,7432,13,158,23356,267,1317,17,543,17512,1400,6115
10.018,6,85,24957,43,561,238,1152,19136,42,413,238,1152,5821
1.097,6,25,9553,14,350,84,1042,1993,11,1015,90,1460,7560
0.025,6,2,149,1,0,0,0,40,1,69,0,69,109
1681.356,17,14,1036,7,30,280223,30,406,7,62,280222,62,630
5.763,6,39,7269,20,218,303,314,3423,19,513,305,1179,3846
3.123,17,32,15405,17,709,193,1350,12539,15,163,220,1350,2866
1790.649,17,19,6276,19,302,99480,1438,6276,0,0,0,0,0
4.968,6,40,7309,20,218,261,314,3423,20,513,245,1179,3886
54.317,17,42,10878,42,231,1324,388,10878,0,0,0,0,0
1.35,1,2,684,2,314,1350,322,684,0,0,0,0,0
175.205,6,74,49627,46,1182,3893,1408,41436,28,961,2284,3847,8191
1699.731,17,12,498,11,14,169973,14,462,1,8,0,8,36
0.445,6,37,8718,18,293,26,517,1925,19,463,21,1420,6793
0.009,6,9,1556,5,515,2,515,783,4,557,3,557,773
243.137,6,75,19309,37,706,6753,1418,15357,38,123,6570,580,3952
0.608,6,12,1163,6,222,119,222,688,6,231,119,231,475
1682.772,17,18,1413,9,30,210339,37,529,9,70,210338,136,884
4.977,17,4,288,2,36,4976,36,128,2,52,4977,52,160
1000.376,1,5,280,5,28,250094,28,280,0,0,0,0,0
81.1,17,8,3148,8,365,11585,373,3148,0,0,0,0,0
437.39,6,81,5241,43,69,9311,69,2755,38,69,11821,69,2486
0.01,6,2,746,1,666,0,666,706,1,0,0,0,40
3.789,17,4,368,4,64,1263,64,368,0,0,0,0,0
30.967,17,6,468,6,50,6193,50,468,0,0,0,0,0
251.952,2,2,64,2,8,251952,8,64,0,0,0,0,0
65.165,6,39,9411,16,328,236,1189,2621,23,390,2960,1460,6790
1770.657,6,108,10004,70,65,25661,65,5939,38,59,47853,59,4065
1139.804,6,300767,318397200,103282,838,11,1448,6067979,197485,1531,5,5792,312329221
1.094,6,23,7952,12,164,85,267,1288,11,1216,93,3819,6664
316.937,6,100,35402,54,590,5979,1360,24625,46,371,7040,4649,10777
2.47,6,26,6055,14,338,190,1314,2254,12,473,222,2673,3801
1798.504,6,210,24253,134,93,13522,469,11693,76,133,23974,2006,12560
289.179,6,51,8265,25,129,12047,517,2265,26,356,11565,1418,6000
1787.155,6,102,8364,68,66,26673,66,4964,34,60,54151,60,3400
12.317,6,1905,1720126,1211,1365,10,1380,1685756,694,421,17,1923,34370
481.32,2,7,224,7,8,80220,8,224,0,0,0,0,0
12.78,6,22,6436,10,274,1415,517,1350,12,744,1155,1408,5086
1792.782,1,58,4872,0,0,0,0,0,58,56,31452,56,4872
5.385,6,39,8010,20,218,283,314,3423,19,546,284,1179,4587
0.154,17,4,350,2,34,0,34,124,2,85,0,91,226
1742.265,1,162,9072,162,28,10821,28,9072,0,0,0,0,0
155.003,6,21,4660,7,267,163,501,1085,14,273,11916,1420,3575
223.128,6,36,8212,13,147,18593,267,1710,23,348,10141,1420,6502
2.077,6,14,2351,8,188,296,245,700,6,703,362,1152,1651
115.673,6,23,10014,13,532,82,1360,2682,10,1384,12833,2720,7332
39.893,2,4,128,4,8,13297,8,128,0,0,0,0,0
12.253,17,3,984,3,300,6126,300,984,0,0,0,0,0
1772.011,6,180,15480,120,69,14890,69,8940,60,69,30033,69,6540
1740.517,17,29,6699,29,203,62161,203,6699,0,0,0,0,0
1764.143,2,15,480,15,8,126010,8,480,0,0,0,0,0
4.255,6,38,7229,19,218,236,314,3383,19,513,222,1179,3846
84.293,17,4,352,2,60,84292,60,176,2,60,84292,60,176
1772.651,1,234,13104,234,28,7607,28,13104,0,0,0,0,0
1776.334,6,184,15916,120,69,14927,69,8940,64,69,28186,69,6976
1.311,6,48,19360,27,902,50,1360,13744,21,476,56,2715,5616
0.007,17,2,586,1,46,0,46,74,1,484,0,484,512
1792.741,17,142,11360,71,48,25609,48,5396,71,56,25609,56,5964
300.882,6,45,10135,23,433,13676,910,3142,22,435,451,2720,6993
1.525,6,41,8264,21,293,76,998,2643,20,400,69,1360,5621
1740.456,17,30,31680,30,1028,60015,1028,31680,0,0,0,0,0
3.513,17,24,9409,10,380,390,1350,4084,14,352,186,1350,5325
0.143,17,4,588,2,48,136,48,152,2,190,135,308,436
1740.367,17,29,30624,29,1028,62155,1028,30624,0,0,0,0,0
280.463,6,30,7432,13,158,23371,267,1317,17,603,17526,2760,6115
63.416,6,29,11962,7,156,10569,267,758,22,606,3014,1997,11204
1.803,17,4,368,2,32,1802,32,120,2,96,1789,96,248
1771.953,6,180,15480,120,69,14890,69,8940,60,69,30032,69,6540
643.784,6,190,31386,111,304,5852,304,22332,79,83,8253,83,9054
1786.537,6,102,8296,68,65,26664,65,4930,34,59,54133,59,3366
28.77,17,4,352,2,60,28769,60,176,2,60,28769,60,176
214.269,17,4,352,2,60,214268,60,176,2,60,214268,60,176
280.257,6,30,7432,13,158,23354,267,1317,17,543,17511,1400,6115
174.001,6,20769,19967361,13498,1399,12,1448,19582237,7271,776,23,1448,385124
1773.551,6,180,15480,120,69,14903,69,8940,60,69,30053,69,6540
38.826,6,19,2260,6,184,99,184,456,13,424,3215,434,1804
1.446,17,22,10580,10,663,160,1350,6915,12,277,114,1350,3665
4.658,6,39,7285,20,218,245,314,3423,19,516,244,1179,3862
0.19,17,2,152,1,48,0,48,76,1,48,0,48,76
0.548,6,23,7394,13,335,45,668,2026,10,968,55,1946,5368
2.172,6,51,20564,29,874,77,1360,13503,22,474,94,1360,7061
12.188,17,20,4295,10,37,1353,37,650,10,336,1353,348,3645
10.763,6,94,29905,48,569,229,1152,23583,46,447,232,1179,6322
910.836,6,128,15810,66,101,13889,721,7297,62,274,14928,1440,8513
300.321,6,43,26768,27,1149,11550,1440,20960,16,828,2117,1440,5808
1.44,6,41,10367,23,478,65,1460,4826,18,437,73,2615,5541
6.756,6,16,7496,8,857,965,917,7176,8,0,935,0,320
1796.422,1,152,8512,152,28,11896,28,8512,0,0,0,0,0
0.305,6,20,7229,12,334,27,663,1969,8,1209,42,1906,5260
1787.128,6,367,23236,212,69,8469,69,12896,155,69,11603,69,10340
31.942,6,7,396,1,0,0,0,60,6,0,6292,0,336
1038.293,17,204,15504,204,48,5114,48,15504,0,0,0,0,0
1797.696,17,448,39896,403,35,4471,288,25676,45,288,40016,288,14220
4.533,6,38,7213,20,218,238,314,3423,18,511,250,1179,3790
9.76,17,4,352,2,60,9758,60,176,2,60,9759,60,176
1681.363,17,14,3843,7,30,280224,30,406,7,463,280225,463,3437
0.435,6,3,160,2,0,435,0,100,1,0,0,0,60
153.681,1,10,560,10,28,17075,28,560,0,0,0,0,0
126.626,6,9,528,2,112,126616,112,200,7,0,21102,0,328
0.924,6,126,87274,73,131,12,232,3449,53,1738,17,4242,83825
240.451,6,34,6344,18,138,14143,517,1912,16,718,16029,2683,4432
1783.896,1,94,5264,94,28,19181,28,5264,0,0,0,0,0
0.518,6,23,7385,13,334,43,663,2021,10,1209,53,1946,5364
1.51,17,3,1170,3,362,755,362,1170,0,0,0,0,0
4.062,17,15,15478,4,708,1354,1350,2945,11,1111,369,1350,12533
965.882,6,179,11852,98,70,9957,138,6404,81,69,12073,69,5448
100.795,17,4,5488,4,1344,33598,1347,5488,0,0,0,0,0
1798.113,17,142,11360,71,48,25687,48,5396,71,56,25687,56,5964
188.87,6,29,7392,13,158,15739,267,1317,16,543,12590,1400,6075
1.835,6,2,80,0,0,0,0,0,2,0,0,0,80
30.359,6,1937,1776999,1164,1441,25,1448,1728459,773,776,38,1448,48540
2.869,6,12,507,7,0,478,0,288,5,7,662,7,219
0.415,17,8,2758,8,316,59,355,2758,0,0,0,0,0
1.804,2,2,64,2,8,1804,8,64,0,0,0,0,0
0.942,6,24,9812,14,350,72,1041,1992,10,1481,86,3930,7820
2.94,17,3,201,3,39,1470,39,201,0,0,0,0,0
3.077,6,12,507,7,0,512,0,288,5,7,717,7,219
0.082,6,9,1002,5,213,20,213,417,4,421,25,421,585
5.26,17,50,41149,21,482,261,1350,10715,29,1021,186,1350,30434
2.707,6,25,6085,14,108,208,147,1003,11,773,100,1608,5082
1790.2,6,356,22520,208,69,8648,69,12460,148,69,12177,69,10060
1773.139,6,180,15480,120,69,14900,69,8940,60,69,30049,69,6540
1792.159,6,356,22520,208,69,8657,69,12460,148,69,12191,69,10060
1746.13,6,97,7307,63,38,28163,205,4476,34,33,52903,98,2831
12.113,6,6,340,2,0,12113,0,100,4,0,2120,0,240
1772.152,6,180,15480,120,69,14892,69,8940,60,69,30033,69,6540
0.016,17,2,366,1,36,0,36,64,1,274,0,274,302
1798.002,1,58,4872,0,0,0,0,0,58,56,31543,56,4872
0.42,17,2,152,1,48,0,48,76,1,48,0,48,76
142.826,6,28,14322,15,803,65,1360,4647,13,1306,11892,2720,9675
1789.067,17,142,11360,71,48,25558,48,5396,71,56,25558,56,5964
1.847,6,27,8869,16,289,123,599,1511,11,987,166,1452,7358
1796.816,6,4350,3654753,1924,140,934,354,114429,2426,1450,740,2816,3540324
1796.427,1,58,4872,0,0,0,0,0,58,56,31516,56,4872
1771.964,6,180,15480,120,69,14890,69,8940,60,69,30031,69,6540
1798.712,6,366,25610,213,99,8484,469,15005,153,69,11832,69,10605
1.551,6,14,2351,8,188,221,245,700,6,703,255,1152,1651
316.718,6,74,19495,39,335,8334,1360,9976,35,386,9310,4649,9519
192.881,1,8,448,8,28,27554,28,448,0,0,0,0,0
6.004,17,3,1008,3,308,3002,308,1008,0,0,0,0,0
1776.779,1,58,4872,0,0,0,0,0,58,56,31171,56,4872
1784.256,6,102,8296,68,65,26630,65,4930,34,59,54065,59,3366
108.108,6,23,10009,12,531,61,1360,2637,11,1384,10798,3934,7372
1797.379,17,447,39580,403,35,4471,288,25676,44,288,40952,288,13904
1787.907,6,366,25541,213,100,8433,469,14936,153,69,11762,69,10605
95.659,6,132,104219,85,1274,1138,1368,93648,47,676,2074,1368,10571
1772.402,6,180,15480,120,69,14894,69,8940,60,69,30037,69,6540
1.344,6,25,9757,14,386,103,844,1776,11,1254,121,2720,7981
33.649,6,28,4936,14,180,2588,722,1806,14,399,2561,1408,3130
793.106,6,134,21707,65,181,12392,1360,10411,69,198,7858,2720,11296
1740.583,17,30,6930,30,203,60020,203,6930,0,0,0,0,0
280.184,6,28,7352,13,158,23348,267,1317,15,678,20011,2800,6035
976.804,1,8,873,8,81,139543,105,873,0,0,0,0,0
1.614,6,50,20866,28,936,59,1360,15210,22,433,68,1360,5656
4.842,2,2,64,2,8,4842,8,64,0,0,0,0,0
8.828,6,1460,1224807,866,1362,10,1380,1196814,594,467,14,1923,27993
75.579,6,31,7613,12,155,28,267,1266,19,398,4198,3417,6347
112.797,6,21,8718,11,316,64,640,1421,10,1147,12519,2720,7297
4.637,6,1150,1771982,185,636,25,1396,13531,965,1779,4,6980,1758451
0.379,17,2,180,1,30,0,30,58,1,94,0,94,122
1220.615,6,148,10188,55,46,22603,46,4260,93,46,13267,46,5928
1770.834,6,101,9278,66,64,27243,64,5544,35,58,52081,58,3734
8.934,6,2,120,2,0,0,0,120,0,0,0,0,0
1443.874,2,14,448,14,8,111067,8,448,0,0,0,0,0
240.229,6,58,18792,31,744,8007,1418,15769,27,201,9239,580,3023
0.161,17,2,154,1,33,0,33,61,1,65,0,65,93
34.727,17,20,1760,10,48,3851,48,760,10,72,3847,72,1000
0.599,6,14,2067,7,288,68,288,600,7,293,68,434,1467
1.205,6,23,7952,12,164,93,267,1288,11,1216,102,3819,6664
31.843,6,7,308,1,0,0,0,44,6,0,6320,0,264
39.228,17,22,1936,11,48,3922,48,836,11,72,3921,72,1100
0.485,6,10,968,5,256,107,256,460,5,304,110,304,508
86.835,17,4,824,2,48,86828,48,152,2,308,86828,308,672
1779.366,1,122,6832,122,28,14705,28,6832,0,0,0,0,0
1431.174,6,177,13686,67,71,21682,330,6611,110,48,13130,78,7075
0.094,17,4,368,2,32,40,32,120,2,96,49,96,248
1785.628,6,102,8296,68,65,26651,65,4930,34,59,54107,59,3366
0.896,6,26,9002,14,208,68,475,1426,12,1012,65,1360,7576
0.17,6,12,3462,6,75,34,75,395,6,1373,33,1448,3067
22.55,17,40,11006,21,220,1125,1350,5226,19,276,1250,1350,5780
2.915,17,2,1430,2,687,2915,687,1430,0,0,0,0,0
1.708,17,4,288,2,36,1468,36,128,2,52,1373,52,160
1.238,6,55,22092,31,939,41,1360,16311,24,437,46,2715,5781
1796.986,1,271,15176,271,28,6655,28,15176,0,0,0,0,0
254.372,6,10,568,3,112,127179,112,240,7,0,42392,0,328
7.982,6,18,6791,9,275,997,275,643,9,1155,637,1420,6148
0.257,6,23,4494,11,165,25,456,1394,12,493,22,888,3100
1648.761,1,7,392,7,28,274793,28,392,0,0,0,0,0
1793.9,17,180,14040,180,50,10021,50,14040,0,0,0,0,0
11.031,6,20,4442,11,275,1103,275,998,9,768,777,1440,3444
1781.945,6,360,24156,210,88,8526,469,13878,150,69,11959,69,10278
1785.821,6,114,9136,71,65,25511,65,5115,43,59,42517,59,4021
1.056,2,2,64,2,8,1056,8,64,0,0,0,0,0
0.103,6,21,13148,13,138,8,138,822,8,1983,1,4344,12326
0.021,6,12,3462,6,75,4,75,395,6,1373,3,1448,3067
195.042,17,81,3330,41,13,4876,58,1686,40,13,4924,56,1644
0.113,17,2,152,1,48,0,48,76,1,48,0,48,76
1696.649,1,8,448,8,28,242378,28,448,0,0,0,0,0
1796.164,17,29,10005,29,317,64148,317,10005,0,0,0,0,0
0.19,17,2,574,1,32,0,32,60,1,486,0,486,514
1772.275,1,59,4956,0,0,0,0,0,59,56,30556,56,4956
1747.9,6,95,7203,63,38,28191,205,4476,32,33,56371,98,2727
182.148,6,20,9181,11,514,86,1236,2014,9,1359,22745,3639,7167
0.037,17,6,552,3,32,6,32,180,3,96,0,96,372
7.717,6,1742,1519078,993,1438,7,1448,1470458,749,776,10,1448,48620
1786.569,6,104,8444,68,66,26665,66,4964,36,60,51042,60,3480
1786.296,17,87,3648,86,14,21015,14,3612,1,8,0,8,36
1797.799,17,140,11200,70,48,26054,48,5320,70,56,26054,56,5880
174.107,6,25,6269,9,266,94,500,1164,16,343,11601,1420,5105
1789.749,17,142,11360,71,48,25567,48,5396,71,56,25567,56,5964
5.084,6,40,7325,21,218,254,314,3463,19,516,268,1179,3862
1796.417,17,142,11360,71,48,25662,48,5396,71,56,25662,56,5964
1792.507,6,375,29621,211,75,8535,267,13573,164,133,10996,1420,16048
0.144,17,2,176,1,60,0,60,88,1,60,0,60,88
10.558,6,1593,1470971,989,1408,10,1448,1434899,604,776,17,1448,36072
0.023,6,2,100,1,0,0,0,60,1,0,0,0,40
58.806,6,8,432,5,0,14701,0,268,3,0,29397,0,164
1795.133,17,447,39864,402,35,4476,288,25644,45,288,40023,288,14220
0.211,17,4,859,2,37,201,37,130,2,336,199,348,729
1793.795,1,58,4872,0,0,0,0,0,58,56,31470,56,4872
141.514,17,4,352,2,60,141513,60,176,2,60,141513,60,176
0.301,6,28,9123,13,247,25,624,1672,15,832,20,1408,7451
1778.803,1,70,7420,70,78,25779,78,7420,0,0,0,0,0
20.13,6,23,6033,13,107,1677,159,1138,10,873,2236,1669,4895
1793.591,17,144,11520,72,48,25261,48,5472,72,56,25261,56,6048
1785.715,6,356,22520,208,69,8626,69,12460,148,69,12147,69,10060
1793.85,17,87,3648,86,14,21104,14,3612,1,8,0,8,36
38.03,17,44,6468,22,48,1810,48,1672,22,190,1810,308,4796
2.669,6,31,8912,14,158,205,267,1357,17,763,163,2076,7555
1740.485,17,29,6815,29,207,62160,207,6815,0,0,0,0,0
0.056,17,2,588,1,39,0,39,67,1,493,0,493,521
1551.003,6,196,15669,74,78,20835,375,7737,122,50,12818,174,7932
246.771,17,4,352,2,60,246770,60,176,2,60,246770,60,176
1.125,17,4,934,2,40,1109,40,136,2,371,1115,379,798
1.165,6,16,2690,8,288,153,288,652,8,568,140,853,2038
1776.29,6,104,8308,68,64,26511,64,4896,36,58,50749,58,3412
55.891,6,4,3000,1,0,0,0,40,3,1420,27922,1420,2960
27.183,6,28,7352,13,158,2265,267,1317,15,603,1941,2036,6035
0.261,17,2,588,1,39,0,39,67,1,493,0,493,521
210.182,17,4,772,2,33,210177,34,123,2,296,210176,299,649
1787.643,6,364,23047,211,69,8512,69,12787,153,69,11757,69,10260
1194.104,6,15,910,10,31,132678,31,555,5,31,298519,31,355
249.199,17,8,608,8,48,35599,48,608,0,0,0,0,0
2.622,17,2,784,2,364,2622,364,784,0,0,0,0,0
207.242,6,30,7432,13,158,17270,267,1317,17,543,12947,1300,6115
1798.17,17,450,39960,405,35,4450,288,25740,45,288,40463,288,14220
2.358,6,32,8952,14,158,181,267,1357,18,624,134,1400,7595
0.257,17,3,451,2,39,206,39,134,1,289,0,289,317
0.025,6,2,80,2,0,0,0,80,0,0,0,0,0
1787.033,6,104,8376,68,65,26672,65,4930,36,59,51054,59,3446
22.335,17,5,1881,5,348,5583,993,1881,0,0,0,0,0
0.147,17,2,255,1,43,0,43,71,1,156,0,156,184
10.421,6,9,527,5,43,2605,43,311,4,0,3449,0,216
841.657,6,87,7482,56,69,15302,69,4241,31,69,28054,69,3241
1781.115,6,136,15638,82,72,21989,722,7207,54,122,33598,2026,8431
19.972,17,27,9435,12,452,1813,1350,5771,15,216,1424,1350,3664
240.317,6,44,8848,23,524,10922,1418,5921,21,228,12014,618,2927
0.108,6,9,1338,5,145,27,145,349,4,825,28,825,989
6.496,6,1157,1053712,704,1418,8,1448,1025480,453,776,13,1448,28232
1795.645,6,356,22520,208,69,8674,69,12460,148,69,12215,69,10060
1786.224,6,366,25541,213,100,8425,469,14936,153,69,11748,69,10605
2.516,17,19,16976,8,856,359,1350,7074,11,872,109,1350,9902
1786.499,6,102,8364,68,66,26664,66,4964,34,60,54133,60,3400
20.16,6,23,6179,14,117,1550,159,1337,9,873,2518,1658,4842
1745.053,6,100,7702,66,40,26846,205,4730,34,35,52869,108,2972
0.072,6,12,3462,6,75,14,75,395,6,1373,14,1448,3067
34.935,17,20,1760,10,48,3880,48,760,10,72,3880,72,1000
348.158,1,8,448,8,28,49736,28,448,0,0,0,0,0
13.378,6,29,7392,13,158,1114,267,1317,16,603,888,1400,6075
3.03,6,17,2085,10,304,336,304,1452,7,83,496,83,633
0.59,6,4,222,2,31,161,31,111,2,31,9,31,111
0.014,17,2,437,1,40,0,40,68,1,341,0,341,369
34.006,17,20,1760,10,48,3777,48,760,10,72,3777,72,1000
6.112,17,24,6996,9,276,764,1350,2736,15,256,232,1350,4260
2.017,17,6,966,3,33,1002,33,183,3,233,1002,233,783
10.908,6,20,4442,11,275,1090,275,998,9,768,766,1440,3444
1772.453,6,180,15480,120,69,14894,69,8940,60,69,30033,69,6540
0.325,6,25,8873,13,239,27,597,1642,12,1099,28,2804,7231
1770.391,6,101,9410,66,66,27236,66,5610,35,60,52067,60,3800
40.2,17,44,6468,22,48,1913,48,1672,22,190,1913,308,4796
1764.086,2,12,384,12,8,160371,8,384,0,0,0,0,0
1761.617,1,96,10176,96,78,18543,78,10176,0,0,0,0,0
2.94,6,21,6367,10,268,321,517,1333,11,744,289,1418,5034
241.596,6,45,6243,20,213,12713,585,2973,25,177,10065,580,3270
21.08,17,22,11847,12,738,1913,1350,9194,10,237,2338,1350,2653
17.901,6,8,440,5,0,4475,0,268,3,0,8126,0,172
1.05,17,4,308,2,33,885,33,122,2,65,0,65,186
157.651,6,10,725,9,31,19684,31,685,1,0,0,0,40
175.225,17,8,1176,4,48,58405,48,304,4,190,58405,308,872
1770.196,6,104,9648,68,65,26420,65,5758,36,59,50574,59,3890
0.004,6,6,362,3,31,2,31,175,3,31,0,31,187
0.346,17,2,196,1,62,0,62,90,1,78,0,78,106
1790.193,1,57,4788,57,56,31967,56,4788,0,0,0,0,0
1.979,6,9,527,5,43,494,43,311,4,0,624,0,216
10.437,6,16,1402,9,275,1304,275,918,7,96,1037,96,484
1716.808,1,8,448,8,28,245258,28,448,0,0,0,0,0
1780.215,6,217,16601,82,69,21975,363,7974,135,48,13285,78,8627
1772.955,6,118,14642,77,86,23328,478,7209,41,139,44321,1408,7433
0.007,17,2,519,1,40,0,40,68,1,423,0,423,451
15.667,1,12,1248,0,0,0,0,0,12,76,1424,76,1248
12.203,17,10,2240,5,46,3047,46,370,5,346,3047,346,1870
0.041,6,36,21313,18,133,2,133,1077,18,1286,2,1448,20236
212.893,17,4,352,2,60,212892,60,176,2,60,212892,60,176
0.62,6,21,5000,11,137,62,267,1132,10,692,65,1467,3868
0.172,6,46,20979,26,1064,6,1420,15958,20,467,8,1883,5021
2.03,17,2,148,2,46,2030,46,148,0,0,0,0,0
726.342,17,9,966,9,79,90792,346,966,0,0,0,0,0
40.536,2,4,128,4,8,13512,8,128,0,0,0,0,0
9.121,6,40,12680,21,892,456,1460,7118,19,399,491,1460,5562
1778.149,17,305,50452,305,137,5849,366,50452,0,0,0,0,0
1720.585,17,12,498,11,14,172058,14,462,1,8,0,8,36
7.908,6,1218,1039286,735,1363,10,1380,1015443,483,421,16,1924,23843
26.632,17,4,1312,4,300,8877,300,1312,0,0,0,0,0
228.037,17,8,2688,8,308,32576,308,2688,0,0,0,0,0
2.877,17,2,312,2,128,2877,128,312,0,0,0,0,0
79.75,6,32,5157,20,180,4197,721,2129,12,480,1412,2026,3028
1786.481,6,102,8296,68,65,26663,65,4930,34,59,54133,59,3366
552.715,6,27,14347,8,211,78936,241,1203,19,774,30697,958,13144
1795.042,17,448,39896,403,35,4465,288,25676,45,288,40019,288,14220
29.656,6,10,536,4,0,9885,0,216,6,0,5928,0,320
3.494,17,8,980,4,31,1161,31,236,4,158,1159,164,744
280.563,6,29,7392,13,158,23380,267,1317,16,543,18701,1380,6075
0.613,6,10,924,5,283,102,283,551,5,105,104,105,373
2.092,6,29,10365,17,367,130,833,1785,12,1012,181,1420,8580
1745.444,6,95,7203,63,38,28152,205,4476,32,33,56291,98,2727
18.432,6,7,380,4,0,6144,0,216,3,0,9198,0,164
25.626,6,27,7202,14,137,975,182,1027,13,909,2134,1438,6175
1787.906,6,393,30125,225,126,7981,469,18644,168,69,10706,69,11481
27.755,6,49,13387,23,188,1261,722,2811,26,733,1101,1380,10576
1744.925,6,94,7151,62,38,28605,205,4424,32,33,56276,98,2727
7.435,6,24,7383,15,318,531,600,2086,9,803,50,1448,5297
2.973,6,2,88,2,0,0,0,88,0,0,0,0,0
1685.04,6,83,4432,42,26,41097,26,2248,41,26,42125,26,2184
0.062,6,9,1340,5,145,15,145,349,4,827,13,827,991
5.094,6,43,8329,22,227,242,314,4062,21,489,241,1179,4267
0.071,6,11,912,6,181,14,181,489,5,77,9,134,423
0.005,17,4,300,2,39,1,39,134,2,55,1,55,166
1798.632,17,367,50190,179,190,10104,1350,39067,188,31,9618,60,11123
1.407,6,47,20060,27,955,54,1460,14484,20,476,64,2615,5576
0.446,6,12,1653,6,288,85,288,548,6,426,55,434,1105
62.863,6,27,11838,14,741,4835,1460,3558,13,1106,5226,1460,8280
8.566,6,22,9302,11,275,856,275,723,11,1161,792,1380,8579
721.931,2,8,256,8,8,103133,8,256,0,0,0,0,0
0.015,17,2,2752,2,1348,15,1348,2752,0,0,0,0,0
0.895,6,10,1687,7,100,149,100,384,3,1179,317,1179,1303
280.03,6,29,7392,13,158,23335,267,1317,16,603,18666,1400,6075
1745.216,6,95,7203,63,38,28148,205,4476,32,33,56285,98,2727
300.576,6,16,1123,5,177,75099,177,445,11,110,30039,110,678
62.96,6,17,8865,17,498,3935,1402,8865,0,0,0,0,0
0.967,6,2,1235,1,0,0,0,40,1,1155,0,1155,1195
0.307,6,26,8804,13,211,25,483,1528,13,1098,25,2816,7276
0.046,6,10,1982,6,666,9,666,986,4,780,15,780,996
41.659,6,5514,5191757,3588,1368,11,1408,5086941,1926,931,21,2816,104816
176.422,17,2,368,2,156,176422,156,368,0,0,0,0,0
4.955,6,40,7325,20,201,260,314,3423,20,442,247,1152,3902
0.021,17,2,283,1,31,0,31,59,1,196,0,196,224
240.421,2,2,64,2,8,240421,8,64,0,0,0,0,0
0.019,17,3,704,2,60,10,60,176,1,500,0,500,528
0.159,6,26,7256,13,155,13,267,1301,13,678,12,3436,5955
14.26,6,2312,2138614,1477,1369,9,1408,2090530,835,931,16,2801,48084
0.159,17,5,4254,3,909,79,1350,2812,2,693,43,1350,1442
280.5,6,31,7472,13,158,23375,267,1317,18,603,16496,2076,6155
0.249,6,25,6098,12,181,22,537,1526,13,648,20,2176,4572
1799.579,6,357,22629,209,69,8651,69,12569,148,69,12241,69,10060
9.263,17,6,528,3,48,4625,48,228,3,72,4624,72,300
38.902,17,22,1672,22,48,1852,48,1672,0,0,0,0,0
1.35,6,48,19953,27,944,51,1460,14337,21,433,58,1460,5616
202.852,17,4,352,2,60,202851,60,176,2,60,202851,60,176
300.169,6,42,10144,23,593,13636,1360,4537,19,402,16666,2667,5607
0.241,17,8,2758,8,316,34,355,2758,0,0,0,0,0
307.232,6,31,7476,13,158,25602,267,1317,18,543,18070,1400,6159
1772.597,6,180,15480,120,69,14895,69,8940,60,69,30037,69,6540
5.214,6,38,7229,19,218,289,314,3383,19,513,271,1179,3846
0.012,17,2,378,1,39,0,39,67,1,283,0,283,311
215.919,17,4,352,2,60,215917,60,176,2,60,215918,60,176
0.706,6,32,8952,14,158,54,267,1357,18,624,39,1400,7595
33.728,6,32,5192,15,180,2409,722,1858,17,271,2095,1402,3334
1744.714,2,24,768,24,8,75857,8,768,0,0,0,0,0
0.015,17,8,2446,8,277,2,316,2446,0,0,0,0,0
354.964,2,3,96,3,8,177482,8,96,0,0,0,0,0
304.884,1,44,2464,44,28,7090,28,2464,0,0,0,0,0
1082.936,2,13,416,13,8,90244,8,416,0,0,0,0,0
1.559,6,50,19821,28,867,57,1360,14165,22,433,63,1360,5656
1380.893,2,11,352,11,8,138089,8,352,0,0,0,0,0
1323.007,6,115,14835,65,160,20671,819,9317,50,76,26613,222,5518
1786.19,17,87,3648,86,14,21014,14,3612,1,8,0,8,36
630.347,2,6,192,6,8,126069,8,192,0,0,0,0,0
1789.946,6,355,22480,207,69,8689,69,12420,148,69,12176,69,10060
0.121,17,2,2752,2,1348,121,1348,2752,0,0,0,0,0
7.953,6,22,6689,10,265,878,517,1591,12,744,719,1408,5098
10.811,17,15,17706,15,1152,772,1449,17706,0,0,0,0,0
5.44,6,37,7664,19,350,302,1152,4615,18,465,302,1179,3049
1786.516,6,57,4064,27,33,68704,36,1550,30,235,61604,445,2514
1680.764,17,13,534,11,14,168057,14,462,2,8,1680578,8,72
39.655,17,4,352,2,60,39654,60,176,2,60,39654,60,176
98.739,6,46,12156,18,384,1890,1189,4571,28,269,3656,1420,7585
252.086,2,3,96,3,8,126043,8,96,0,0,0,0,0
1778.302,1,55,6381,55,88,32931,125,6381,0,0,0,0,0
704.257,1,5,580,5,88,176064,88,580,0,0,0,0,0
1786.68,6,104,8435,69,65,26274,65,4970,35,59,52545,59,3465
1.288,6,11,1661,6,106,257,106,426,5,967,322,967,1235
1784.864,6,104,8376,68,65,26639,65,4930,36,59,50993,59,3446
1776.408,17,140,11200,70,48,25744,48,5320,70,56,25744,56,5880
470.367,6,32,8194,15,143,33597,267,1466,17,549,29397,1400,6728
1755.733,6,105,6240,60,26,29757,26,3510,45,26,39902,26,2730
2.391,17,2,778,2,361,2391,361,778,0,0,0,0,0
280.03,6,27,7312,13,158,23335,267,1317,14,775,21537,4836,5995
240.209,6,54,17482,29,779,8578,1402,14771,25,175,10008,580,2711
93.9,6,37,8551,14,154,7223,267,1954,23,333,4263,1460,6597
0.009,6,2,162,1,0,0,0,40,1,82,0,82,122
1.28,6,46,18124,26,882,51,1360,12548,20,433,58,1360,5576
33.606,6,33,5408,15,180,2400,722,1872,18,259,1966,1402,3536
5.037,17,4,288,2,36,5004,36,128,2,52,5006,52,160
8.987,6,3,180,3,0,0,0,180,0,0,0,0,0
1591.892,1,8,448,8,28,227413,28,448,0,0,0,0,0
33.437,6,32,5158,16,154,2229,722,1923,16,342,1038,1408,3235
90.601,6,21,9373,11,425,61,966,1748,10,1202,10053,2590,7625
1797.617,17,448,39896,403,35,4471,288,25676,45,288,40019,288,14220
1778.626,1,58,4872,0,0,0,0,0,58,56,31203,56,4872
33.09,6,11,856,3,106,16545,106,234,8,90,4700,90,622
0.01,17,2,574,1,41,0,41,69,1,477,0,477,505
280.191,6,30,7432,14,158,21553,267,1357,16,603,18677,2036,6075
1153.988,17,193,14668,193,48,6010,48,14668,0,0,0,0,0
1624.274,2,17,544,17,8,101517,8,544,0,0,0,0,0
5.012,17,3,208,2,36,4990,36,128,1,52,0,52,80
17.984,6,31,5305,15,154,1284,721,1869,16,371,1183,2026,3436
125.478,2,2,64,2,8,125478,8,64,0,0,0,0,0
1772.88,6,180,15480,120,69,14898,69,8940,60,69,30041,69,6540
437.756,17,8,480,4,32,145918,32,240,4,32,145918,32,240
1776.638,17,140,11200,70,48,25748,48,5320,70,56,25748,56,5880
379.488,1,4,240,4,32,126496,32,240,0,0,0,0,0
764.449,1,7,664,7,66,127408,88,664,0,0,0,0,0
280.245,6,29,7392,13,158,23353,267,1317,16,603,18680,2036,6075
1772.529,6,180,15480,120,69,14895,69,8940,60,69,30037,69,6540
280.681,6,30,7432,13,158,23390,267,1317,17,543,17539,1400,6115
1.354,6,49,20341,27,969,52,1440,14685,22,433,55,1440,5656
3.634,6,2,88,2,0,0,0,88,0,0,0,0,0
317.047,6,69,18825,37,325,8806,1360,9656,32,437,10222,1360,9169
961.927,6,65,5331,41,58,24048,154,3170,24,39,41815,79,2161
1744.594,2,30,960,30,8,60158,8,960,0,0,0,0,0
1772.477,6,180,15480,120,69,14894,69,8940,60,69,30041,69,6540
91.415,6,22,8961,11,514,84,1236,2014,11,1082,9123,2079,6947
0.434,6,25,7711,16,339,28,949,3017,9,721,51,1460,4694
201.152,6,25,6724,12,217,18282,517,1512,13,504,16758,1418,5212
110.313,6,22,4654,10,272,174,516,1220,12,327,10019,1452,3434
1769.312,6,99,9240,66,65,27220,65,5577,33,59,55287,59,3663
0.205,17,4,368,2,32,9,32,120,2,96,12,96,248
1789.806,6,361,22858,210,69,8563,69,12678,151,69,11931,69,10180
240.227,6,52,18187,27,820,9239,1402,15355,25,190,10009,580,2832
1785.924,6,106,8524,68,66,26655,66,4964,38,60,48265,60,3560
0.077,17,2,390,1,46,0,46,74,1,288,0,288,316
1.666,6,13,2311,8,188,238,245,700,5,1407,355,1407,1611
280.21,6,29,7392,14,158,21554,267,1357,15,678,20012,3436,6035
2.645,17,34,6945,15,207,186,1350,3531,19,151,145,1350,3414
240.184,6,53,17357,28,764,8895,1402,14467,25,197,10007,580,2890
0.016,17,2,393,1,32,0,32,60,1,305,0,305,333
0.496,6,22,7345,13,334,41,663,2021,9,1209,57,2736,5324
9.344,6,2266,2154359,1476,1383,6,1408,2108615,790,931,11,2816,45744
0.471,6,22,7354,13,335,39,668,2026,9,1210,52,1946,5328
1.449,6,49,19034,28,939,53,1460,13373,21,437,63,2615,5661
3.843,17,26,8660,10,248,427,1350,2761,16,340,214,1350,5899
1798.085,6,367,24712,213,87,8481,469,14136,154,69,11751,69,10576
280.174,6,28,7352,12,158,25470,267,1277,16,603,18677,1400,6075
1785.896,6,104,8494,68,65,26655,65,4930,36,59,51022,59,3564
11.887,6,1886,1642539,1142,1384,10,1420,1608558,744,467,15,1883,33981
0.314,17,2,172,1,50,0,50,78,1,66,0,66,94
1799.996,6,213,17028,79,76,23076,375,8337,134,49,13532,143,8691
170.774,6,25,10829,12,380,78,832,1665,13,959,14219,1440,9164
1.77,6,5,280,3,0,885,0,160,2,0,969,0,120
8.043,6,77,24850,39,568,211,1152,19189,38,459,210,1179,5661
90.287,6,17,1315,7,332,15047,332,704,10,83,9969,83,611
0.078,17,2,245,1,32,0,32,60,1,157,0,157,185
1772.869,1,198,11088,198,28,8999,28,11088,0,0,0,0,0
0.14,6,28,21261,20,215,7,215,1263,8,4893,19,9033,19998
280.229,6,30,7432,14,158,21556,267,1357,16,603,18679,2036,6075
1794.343,17,144,11520,72,48,25272,48,5472,72,56,25272,56,6048
1786.371,6,102,8296,68,65,26662,65,4930,34,59,54128,59,3366
282.135,6,242,202445,159,1306,1785,1368,187219,83,641,1980,2519,15226
37.889,17,11,836,11,48,3788,48,836,0,0,0,0,0
148.338,17,4,240,2,32,148337,32,120,2,32,148337,32,120
4.284,6,39,7269,19,218,238,314,3383,20,440,212,1152,3886
0.535,6,28,9199,13,263,44,688,1736,15,832,35,1368,7463
201.081,17,4,352,2,60,201080,60,176,2,60,201080,60,176
1700.28,17,18,1300,10,30,188916,30,580,8,62,242892,62,720
1789.84,6,357,22629,208,69,8646,69,12460,149,69,12093,69,10169
1688.606,1,8,448,8,28,241229,28,448,0,0,0,0,0
0.017,6,12,3462,6,75,3,75,395,6,1373,2,1448,3067
5.763,6,40,7309,21,218,288,314,3463,19,513,304,1179,3846
1741.13,1,56,4704,0,0,0,0,0,56,56,31656,56,4704
38.268,17,44,6468,22,48,1821,48,1672,22,190,1821,308,4796
1764.468,2,14,448,14,8,135728,8,448,0,0,0,0,0
629.906,2,4,128,4,8,209968,8,128,0,0,0,0,0
5.011,1,10,280,10,0,0,0,280,0,0,0,0,0
1747.971,2,30,960,30,8,60274,8,960,0,0,0,0,0
597.835,6,11,657,7,31,99639,31,373,4,31,199274,31,284
1796.196,17,448,39896,403,35,4468,288,25676,45,288,40012,288,14220
1.356,6,50,20018,27,943,52,1440,14322,23,433,53,1440,5696
10.975,17,3,223,2,41,9984,41,138,1,57,0,57,85
280.483,6,29,7392,13,158,23373,267,1317,16,543,18695,1400,6075
0.086,6,12,3462,6,75,17,75,395,6,1373,17,1448,3067
1770.978,6,102,9396,66,65,27245,65,5577,36,59,50596,59,3819
1755.774,1,26,1456,26,28,70230,28,1456,0,0,0,0,0
0.616,6,22,7312,13,325,51,626,1984,9,1210,70,1946,5328
1703.748,6,198,21883,125,77,13739,267,9788,73,136,23662,1917,12095
0.588,6,14,1745,7,288,69,288,600,7,426,69,434,1145
280.789,6,30,7432,13,158,23399,267,1317,17,543,17540,1400,6115
1789.59,17,142,11360,71,48,25565,48,5396,71,56,25565,56,5964
0.183,17,2,2756,2,1350,183,1350,2756,0,0,0,0,0
1740.442,17,30,31620,30,1026,60015,1026,31620,0,0,0,0,0
0.857,6,10,1687,7,100,142,100,384,3,1179,306,1179,1303
0.396,6,2,149,1,0,0,0,40,1,69,0,69,109
1788.177,6,443,44346,206,140,8722,1360,20675,237,87,7576,3289,23671
0.134,6,11,1703,6,314,26,500,948,5,487,33,487,755
154.399,6,99,70329,62,1239,2531,1408,60267,37,677,2483,1408,10062
1.694,6,13,2311,8,188,242,245,700,5,1407,358,1407,1611
1793.692,6,741,55036,368,38,4887,1448,26301,373,50,4821,1448,28735
56.926,6,24,7054,11,181,5692,267,1168,13,670,4739,2036,5886
1771.101,6,101,9410,66,66,27247,66,5610,35,60,52088,60,3800
3.446,6,2,88,2,0,0,0,88,0,0,0,0,0
4.513,6,3,132,3,0,0,0,132,0,0,0,0,0
47.585,6,37,9416,22,118,2265,353,1863,15,771,2745,4662,7553
1794.455,6,220,17908,135,69,13391,69,9609,85,69,21362,69,8299
1549.582,6,356,24554,196,111,7946,469,14173,160,53,9745,69,10381
7.872,6,78,24890,40,568,201,1152,19229,38,459,206,1179,5661
17.212,17,26,7622,11,359,1718,1350,4266,15,195,1227,1350,3356
0.513,6,5,280,3,0,256,0,160,2,0,6,0,120
2.807,17,4,624,4,128,935,128,624,0,0,0,0,0
12.031,6,14,5731,9,290,1503,517,1057,5,1468,140,2458,4674
1786.535,6,356,22520,208,69,8630,69,12460,148,69,12150,69,10060
0.006,17,2,459,1,40,0,40,68,1,363,0,363,391
125.084,2,2,64,2,8,125084,8,64,0,0,0,0,0
21.197,17,26,13183,15,688,1511,1350,10744,11,193,2116,1350,2439
3.674,17,4,368,4,64,1224,64,368,0,0,0,0,0
0.016,17,2,166,1,39,0,39,67,1,71,0,71,99
0.01,17,3,474,2,36,0,36,128,1,318,0,318,346
1590.519,1,8,448,8,28,227217,28,448,0,0,0,0,0
0.086,17,4,420,2,33,1,33,122,2,121,0,145,298
240.226,6,54,19428,29,842,8579,1418,16686,25,179,10009,580,2742
1.296,6,47,19573,27,920,49,1360,13997,20,476,59,2715,5576
9.876,6,1606,1367174,949,1387,10,1420,1336649,657,420,15,1420,30525
0.185,1,2,112,2,28,185,28,112,0,0,0,0,0
1788.12,6,356,22520,208,69,8638,69,12460,148,69,12163,69,10060
0.34,17,2,162,1,36,0,36,64,1,70,0,70,98
0.135,17,2,255,1,43,0,43,71,1,156,0,156,184
0.07,17,4,420,2,33,33,33,122,2,121,39,145,298
1782.753,6,356,22520,208,69,8612,69,12460,148,69,12127,69,10060
100.143,17,4,288,2,36,100127,36,128,2,52,100127,52,160
41.606,17,4,824,2,48,41589,48,152,2,308,41585,308,672
180.479,2,2,64,2,8,180479,8,64,0,0,0,0,0
1.567,6,37,8214,19,321,87,1164,2718,18,476,80,2715,5496
0.208,6,10,1514,5,503,52,503,771,5,475,51,475,743
12.275,1,9,756,9,56,1534,56,756,0,0,0,0,0
64.54,6,32,14678,16,514,153,1236,2274,16,979,4269,1460,12404
1776.449,1,62,5208,62,56,29122,56,5208,0,0,0,0,0
1797.496,6,144,9895,79,64,23044,208,6241,65,31,28082,31,3654
193.371,17,4,352,2,60,193370,60,176,2,60,193370,60,176
10.429,6,96,29687,49,592,217,1152,23309,47,449,221,1179,6378
1783.808,6,357,22629,208,69,8617,69,12460,149,69,12052,69,10169
1747.245,6,96,7286,63,38,28181,205,4476,33,33,54591,98,2810
240.319,6,41,8770,20,524,12647,1418,5766,21,211,12015,638,3004
31.543,6,8,348,2,0,26,0,84,6,0,6305,0,264
60.648,6,29,7392,13,158,5054,267,1317,16,603,4041,2036,6075
10.963,6,18,5610,10,275,1218,275,958,8,1440,850,1440,4652
11.765,17,8,608,8,48,1680,48,608,0,0,0,0,0
0.509,17,3,451,2,39,416,39,134,1,289,0,289,317
19.783,6,19,5902,9,272,2472,517,1181,10,539,1148,1420,4721
13.853,6,10,436,4,0,4617,0,172,6,0,1743,0,264
280.85,6,30,7432,13,158,23404,267,1317,17,543,17550,1400,6115
15.199,6,36,8182,19,318,844,639,1747,17,478,599,2920,6435
8.251,1,9,756,9,56,1031,56,756,0,0,0,0,0
0.038,17,2,136,1,32,0,32,60,1,48,0,48,76
1797.797,17,449,39928,404,35,4461,288,25708,45,288,40020,288,14220
283.285,1,4,224,4,28,94428,28,224,0,0,0,0,0
0.605,6,14,1745,7,288,71,288,600,7,426,68,434,1145
1793.841,6,239,22639,119,135,15200,208,16692,120,31,15072,31,5947
301.005,6,51,20233,28,1027,11148,1460,14511,23,399,401,1460,5722
1786.001,17,86,3606,85,14,21261,14,3570,1,8,0,8,36
57.281,17,8,2688,8,308,8183,308,2688,0,0,0,0,0
65.563,6,41,12883,18,319,3856,1189,2962,23,499,2974,1420,9921
0.014,17,2,596,1,39,0,39,67,1,501,0,501,529
1777.12,17,140,11200,70,48,25755,48,5320,70,56,25755,56,5880
13.063,6,2251,2003208,1310,1439,9,1448,1943396,941,776,13,1448,59812
38.41,1,44,4576,0,0,0,0,0,44,76,893,76,4576
1782.612,1,216,12096,216,28,8291,28,12096,0,0,0,0,0
918.188,1,60,3360,60,28,15562,28,3360,0,0,0,0,0
7.971,6,14,1029,7,222,1326,222,506,7,231,1327,231,523
4.924,6,41,7365,22,218,234,314,3503,19,516,259,1179,3862
3.594,6,14,3143,8,49,513,92,511,6,579,41,1448,2632
1796.531,17,447,39296,404,35,4457,288,25708,43,288,41924,288,13588
4.221,6,40,7309,20,218,222,314,3423,20,513,209,1179,3886
21.468,17,4,240,2,32,21467,32,120,2,32,21467,32,120
0.094,17,2,152,1,48,0,48,76,1,48,0,48,76
20.679,6,19,2432,10,189,2297,517,1298,9,323,2529,499,1134
276.377,17,6,528,3,60,138188,60,264,3,60,138188,60,264
43.798,6,35,10227,16,450,113,1189,3804,19,514,2432,1997,6423
0.024,17,2,550,2,247,24,247,550,0,0,0,0,0
1790.575,6,169,21635,97,304,18651,304,15108,72,83,25219,83,6527
1786.674,6,108,8595,69,65,26274,65,4970,39,59,47008,59,3625
1776.51,17,140,11200,70,48,25746,48,5320,70,56,25746,56,5880
1.346,6,38,9127,20,399,70,1360,3631,18,433,67,1360,5496
0.037,6,3,151,1,0,0,0,40,2,31,6,31,111
240.203,6,95,79849,33,211,7505,645,3203,62,1439,3937,2836,76646
0.021,17,2,452,2,198,21,348,452,0,0,0,0,0
1794.588,17,142,11360,71,48,25636,48,5396,71,56,25636,56,5964
159.923,6,22,8758,11,316,66,640,1421,11,983,15979,1360,7337
23.011,17,26,3704,13,48,1916,48,988,13,180,1915,308,2716
52.624,17,4,240,2,32,52623,32,120,2,32,52622,32,120
1792.295,1,58,4872,58,56,31443,56,4872,0,0,0,0,0
1734.884,6,178,15469,114,70,15352,138,8631,64,69,27537,69,6838
135.518,17,6,2016,6,308,27103,308,2016,0,0,0,0,0
617.447,6,68,8259,38,98,16683,722,3755,30,164,21285,2329,4504
0.121,6,3,151,2,31,0,31,111,1,0,0,0,40
1.576,17,26,17194,15,760,112,1350,11825,11,460,117,1350,5369
0.629,6,9,859,5,304,157,304,560,4,83,66,83,299
899.385,6,12,728,8,31,128483,31,444,4,31,299750,31,284
0.009,6,4,160,1,0,0,0,40,3,0,1,0,120
0.371,6,5,272,2,0,371,0,104,3,0,183,0,168
20.514,17,6,1236,3,48,10252,48,228,3,308,10250,308,1008
1740.489,17,29,6815,29,207,62160,207,6815,0,0,0,0,0
1748.23,6,96,7286,63,38,28197,205,4476,33,33,54618,98,2810
6.85,6,41,7349,22,201,326,314,3503,19,513,364,1179,3846
1773.828,6,181,15589,120,69,14906,69,8940,61,69,29561,69,6649
240.664,2,5,160,5,8,60166,8,160,0,0,0,0,0
1.309,6,38,8254,19,321,72,1164,2718,19,433,63,1360,5536
1783.388,17,83,3480,82,14,22017,14,3444,1,8,0,8,36
119.26,6,1080,547461,600,847,199,1152,523129,480,427,248,1179,24332
0.279,6,27,8951,13,232,23,567,1612,14,943,21,2816,7339
415.936,17,4,1620,4,377,138645,548,1620,0,0,0,0,0
262.449,17,4,352,2,60,262448,60,176,2,60,262448,60,176
11.241,6,1749,1535231,1085,1363,10,1380,1502506,664,558,16,1923,32725
2.3,17,4,558,2,36,2296,36,128,2,187,2295,187,430
0.058,17,7,2172,7,282,9,316,2172,0,0,0,0,0
0.022,6,2,116,1,0,0,0,64,1,0,0,0,52
2.52,6,13,2311,8,188,360,245,700,5,1407,565,1407,1611
1681.535,17,14,1036,7,30,280253,30,406,7,62,280253,62,630
11.44,6,1807,1580494,1096,1388,10,1420,1547833,711,467,16,1883,32661
35.023,6,37,8510,18,414,505,928,1996,19,441,1938,1460,6514
300.859,6,49,14751,26,868,12034,1360,8936,23,325,414,1360,5815
175.978,6,24,10168,13,549,70,1360,2749,11,1161,17580,2574,7419
0.061,17,2,373,1,34,0,34,62,1,283,0,283,311
1798.418,17,138,11040,69,48,26447,48,5244,69,56,26447,56,5796
1795.254,17,447,39864,402,35,4476,288,25644,45,288,40018,288,14220
1785.894,6,103,8464,68,66,26655,66,4964,35,60,52523,60,3500
1771.977,6,180,15480,120,69,14890,69,8940,60,69,30032,69,6540
1740.34,6,87,6322,58,31,30532,31,3915,29,31,62154,31,2407
19.346,17,17,6420,8,440,2758,1350,3747,9,269,2413,1350,2673
54.72,17,4,352,2,60,54719,60,176,2,60,54718,60,176
4.997,17,2,128,2,36,4997,36,128,0,0,0,0,0
4.232,17,5,295,5,31,1058,31,295,0,0,0,0,0
301.724,6,48,16402,28,623,11174,1408,8952,20,492,3547,2688,7450
1793.095,1,58,4872,0,0,0,0,0,58,56,31457,56,4872
1798.526,17,142,11360,71,48,25693,48,5396,71,56,25693,56,5964
0.225,17,4,588,2,48,142,48,152,2,190,142,308,436
1797.453,17,448,39896,403,35,4471,288,25676,45,288,40021,288,14220
0.262,6,10,1379,6,145,52,145,389,4,826,71,826,990
8.685,6,39,8562,18,371,510,797,1877,21,364,425,1360,6685
39.942,17,3,228,3,48,19971,48,228,0,0,0,0,0
1786.155,6,152,19818,91,304,19846,304,14156,61,83,29769,83,5662
1785.938,17,140,11200,70,48,25883,48,5320,70,56,25883,56,5880
300.893,6,47,13892,25,892,12537,1460,8210,22,399,527,1460,5682
37.86,17,22,1936,11,48,3785,48,836,11,72,3785,72,1100
60.058,17,2,2078,2,1011,60058,1011,2078,0,0,0,0,0
3.481,17,5,295,5,31,870,31,295,0,0,0,0,0
18.737,6,116,37663,59,606,323,1152,30885,57,449,297,1179,6778
280.189,6,28,7352,13,158,23349,267,1317,15,678,20011,3536,6035
1783.969,6,136,16599,78,89,23168,721,8339,58,312,13420,2535,8260
300.711,6,37,8577,20,322,15826,941,2144,17,478,534,1968,6433
241.061,6,47,8547,23,430,10955,1368,5956,24,262,10478,580,2591
0.488,17,3,451,2,39,360,39,134,1,289,0,289,317
9.859,6,1450,1343922,950,1364,10,1432,1319631,500,427,19,1432,24291
77.896,17,4,352,2,60,77894,60,176,2,60,77894,60,176
318.235,17,11,2287,11,179,31823,207,2287,0,0,0,0,0
1035.481,6,124,16267,67,304,15689,304,11144,57,83,18464,83,5123
280.338,6,30,7432,13,158,23361,267,1317,17,543,17514,1400,6115
0.034,17,2,214,1,39,0,39,67,1,119,0,119,147
0.001,17,4,368,2,32,0,32,120,2,96,0,96,248
1.315,6,48,19480,27,910,50,1460,13864,21,433,56,1460,5616
1793.902,17,87,3648,86,14,21104,14,3612,1,8,0,8,36
769.656,1,34,3604,34,78,23322,78,3604,0,0,0,0,0
1797.378,6,369,25799,215,99,8398,469,15154,154,69,11747,69,10645
1662.578,1,7,742,7,78,277096,78,742,0,0,0,0,0
6.114,6,1557,1469999,1007,1384,5,1408,1436735,550,931,10,2816,33264
2.358,6,49,19273,27,888,90,1360,13566,22,401,102,2720,5707
0.608,17,2,136,1,32,0,32,60,1,48,0,48,76
1772.631,6,180,15480,120,69,14896,69,8940,60,69,30036,69,6540
60.118,17,28,2339,26,30,2404,37,1515,2,384,363,463,824
1764.548,6,27,4077,18,241,103796,241,2889,9,92,220545,92,1188
0.018,17,2,169,1,34,0,34,62,1,79,0,79,107
0.395,17,2,178,1,29,0,29,57,1,93,0,93,121
280.419,6,30,7432,13,158,23368,267,1317,17,603,17524,2076,6115
0.143,6,44,21282,26,1091,5,1420,16341,18,467,7,1883,4941
0.06,17,2,230,1,40,0,40,68,1,134,0,134,162
0.774,17,2,178,1,29,0,29,57,1,93,0,93,121
0.195,6,2,170,1,0,0,0,40,1,90,0,90,130
11.042,6,6,312,0,0,0,0,0,6,0,0,0,312
1.357,6,225,182699,138,1333,9,1432,174928,87,475,15,1871,7771
12.57,17,6,528,3,48,6277,48,228,3,72,6278,72,300
0.146,6,47,21716,27,1038,5,1420,16695,20,420,7,1420,5021
0.395,6,12,1653,6,288,76,288,548,6,426,42,434,1105
7.178,6,1705,1586431,1086,1383,6,1408,1549579,619,931,11,2801,36852
1770.236,6,81,4302,41,26,44251,26,2184,40,26,45386,26,2118
0.233,17,4,344,2,47,226,47,150,2,69,224,75,194
114.761,2,2,64,2,8,114761,8,64,0,0,0,0,0
81.195,6,20,820,9,0,6188,0,364,11,0,8117,0,456
10.59,6,17,2422,10,210,1176,210,964,7,545,914,904,1458
61.551,6,27,8211,14,461,4733,1258,2590,13,705,5127,1448,5621
0.356,6,27,9069,13,261,29,683,1728,14,943,26,1408,7341
0.04,6,9,1340,5,145,10,145,349,4,827,10,827,991
1789.75,17,140,11200,70,48,25938,48,5320,70,56,25938,56,5880
1772.482,1,58,4872,0,0,0,0,0,58,56,31096,56,4872
1800.0,6,211,16349,79,69,23076,313,7841,132,48,13739,78,8508
262.207,6,51,7382,26,366,10488,1370,4658,25,128,10925,679,2724
127.741,6,38,5517,22,180,6082,722,2235,16,271,1024,1408,3282
3.004,17,4,272,2,32,3002,32,120,2,48,2989,48,152
97.187,6,851,418169,468,830,208,1152,397328,383,424,253,1179,20841
1383.712,2,12,384,12,8,125792,8,384,0,0,0,0,0
113.009,17,4,352,2,60,113008,60,176,2,60,113008,60,176
0.021,17,2,266,1,41,0,41,69,1,169,0,169,197
382.695,6,26,1703,17,177,23918,177,1117,9,110,8255,110,586
1791.694,17,87,3648,86,14,21078,14,3612,1,8,0,8,36
804.722,6,76,8861,38,100,21745,722,3890,38,107,21744,1408,4971
1795.713,1,272,15232,272,28,6626,28,15232,0,0,0,0,0
42.291,17,36,9753,16,350,2817,1350,6057,20,156,2224,1350,3696
300.815,6,48,10357,24,564,13078,1460,4440,24,290,643,1460,5917
61.329,6,37,15840,22,791,2920,1440,9062,15,665,4362,1440,6778
5.045,17,4,288,2,36,5013,36,128,2,52,5000,52,160
1.591,17,2,178,1,29,0,29,57,1,93,0,93,121
1772.548,6,180,15480,120,69,14895,69,8940,60,69,30040,69,6540
1787.669,17,87,3648,86,14,21031,14,3612,1,8,0,8,36
0.503,6,9,1348,5,145,125,145,349,4,835,98,835,999
18.148,17,4,352,2,48,18139,48,152,2,72,18137,72,200
0.016,17,4,916,2,33,0,33,122,2,369,1,393,794
0.024,17,2,425,1,36,0,36,64,1,333,0,333,361
281.586,6,28,7352,13,158,23465,267,1317,15,678,20089,2045,6035
0.178,6,24,7176,12,155,16,267,1261,12,678,15,2800,5915
1686.627,1,7,392,7,28,281104,28,392,0,0,0,0,0
1749.208,6,222,16569,111,82,15901,208,11230,111,31,15899,31,5339
0.05,17,4,304,2,37,0,37,130,2,59,10,65,174
0.517,6,20,7229,13,334,43,663,2021,7,1209,76,1946,5208
1.22,6,25,8056,12,164,93,267,1288,13,869,86,1440,6768
0.986,6,26,9893,14,350,75,1042,1993,12,1058,72,1360,7900
31.026,17,6,798,6,105,6205,118,798,0,0,0,0,0
1700.618,17,13,534,11,14,170044,14,462,2,8,1700444,8,72
0.875,6,20,5948,11,281,87,544,1288,9,716,95,1420,4660
154.466,6,13,532,4,0,3912,0,164,9,0,19306,0,368
8.704,6,18,1415,9,222,1087,222,808,9,231,1087,231,607
1797.268,6,192,18650,127,99,14264,469,11565,65,69,28080,69,7085
3.171,17,2,656,2,300,3171,300,656,0,0,0,0,0
378.527,6,19,1306,14,180,29117,180,928,5,110,15167,110,378
1.354,6,37,8212,19,320,75,1162,2716,18,476,68,2720,5496
169.543,6,127,100393,85,1276,2018,1408,88672,42,635,3142,1408,11721
36.198,17,40,5880,20,48,1904,48,1520,20,190,1904,308,4360
0.518,6,10,968,5,256,127,256,460,5,304,127,304,508
1773.858,6,184,15847,121,69,14782,69,8980,63,69,28604,69,6867
1779.042,17,140,11200,70,48,25783,48,5320,70,56,25783,56,5880
3.868,17,10,2387,5,40,964,40,340,5,381,963,407,2047
1795.116,1,244,13664,244,28,7387,28,13664,0,0,0,0,0
1786.893,6,104,8444,68,66,26670,66,4964,36,60,51050,60,3480
1680.538,1,15,840,15,28,120038,28,840,0,0,0,0,0
1.994,17,2,237,1,72,0,72,100,1,109,0,109,137
0.458,6,14,1733,7,288,72,288,588,7,426,43,434,1145
1772.185,6,180,15480,120,69,14892,69,8940,60,69,30033,69,6540
1798.619,17,450,39960,405,35,4452,288,25740,45,288,40013,288,14220
1.14,6,23,7952,13,164,80,267,1340,10,1216,107,3819,6612
33.694,17,4,240,2,32,33692,32,120,2,32,33693,32,120
9.575,17,4,377,2,33,9544,37,123,2,99,9543,136,254
4.05,17,4,240,4,32,1350,32,240,0,0,0,0,0
13.148,17,4,824,2,48,13131,48,152,2,308,13125,308,672
1.191,6,24,8004,12,164,92,267,1288,12,1014,91,2331,6716
18.001,17,20,5714,10,303,1997,1350,3313,10,212,1996,1350,2401
1108.09,1,38,2128,38,28,29948,28,2128,0,0,0,0,0
0.942,6,10,1687,7,100,157,100,384,3,1179,339,1179,1303
260.641,17,4,352,2,60,260640,60,176,2,60,260640,60,176
1784.988,17,138,11040,69,48,26249,48,5244,69,56,26249,56,5796
167.774,6,15,3409,5,92,41943,92,348,10,317,18613,1408,3061
1780.077,6,199,35563,125,304,14355,304,26260,74,83,24384,83,9303
32.3,6,1920,1710427,1243,1298,25,1368,1668071,677,776,47,2736,42356
5.033,17,4,288,2,36,5002,36,128,2,52,5002,52,160
1680.159,17,12,498,11,14,168015,14,462,1,8,0,8,36
58.655,6,16,2431,7,188,240,245,660,9,1407,7301,1407,1771
368.764,6,25,1651,17,177,23047,177,1117,8,110,9196,110,534
17.053,6,44,10225,26,133,682,375,2452,18,586,260,2720,7773
0.142,6,11,1971,6,451,28,500,1222,5,481,35,481,749
1.515,6,31,6498,15,149,108,267,1953,16,650,88,1380,4545
50.958,6,2952,2678488,1848,1364,27,1368,2607320,1104,776,46,1473,71168
240.301,6,45,9051,23,519,10922,1402,5876,22,224,11442,619,3175
365.49,17,6,2016,6,308,73098,308,2016,0,0,0,0,0
1799.561,6,452,26616,240,69,7529,69,13740,212,35,8528,64,12876
20.366,6,25,5669,14,92,1566,159,1209,11,967,2030,1709,4460
38.762,17,22,1936,11,48,3873,48,836,11,72,3870,72,1100
4.001,17,8,1320,4,33,1329,33,244,4,241,1330,249,1076
1771.265,1,58,4872,58,56,31074,56,4872,0,0,0,0,0
0.28,6,28,9147,13,247,23,624,1696,15,832,19,1408,7451
1.029,17,4,306,2,40,1008,41,137,2,56,1000,57,169
1681.949,17,14,1036,7,30,280319,30,406,7,62,280319,62,630
1772.694,6,180,15480,120,69,14896,69,8940,60,69,30041,69,6540
1779.371,1,8,448,8,28,254195,28,448,0,0,0,0,0
0.457,17,4,624,2,64,455,64,184,2,192,338,192,440
280.508,6,29,7392,13,158,23375,267,1317,16,678,18692,3456,6075
0.044,17,2,186,1,33,0,33,61,1,97,0,97,125
280.291,6,30,7432,13,158,23357,267,1317,17,543,17515,1400,6115
1775.041,6,180,15480,120,69,14916,69,8940,60,69,30077,69,6540
5.031,17,4,558,2,36,5021,36,128,2,187,5019,187,430
1780.874,6,353,22400,206,69,8687,69,12380,147,69,12197,69,10020
300.585,6,47,9036,23,286,13662,766,2168,24,327,650,1460,6868
79.636,6,78,49550,46,1174,1769,1448,41156,32,746,1987,1448,8394
1.464,17,24,9808,12,368,130,1350,4758,12,392,129,1350,5050
1794.498,17,142,11360,71,48,25635,48,5396,71,56,25635,56,5964
158.219,6,22,3604,7,92,26369,92,452,15,197,11281,1408,3152
20.63,6,29,7297,9,154,2578,267,832,20,402,1078,1420,6465
1799.141,17,448,39896,403,35,4475,288,25676,45,288,40020,288,14220
300.281,6,26,8199,14,409,23098,1050,2386,12,740,4297,1491,5813
1775.21,17,140,11200,70,48,25727,48,5320,70,56,25727,56,5880
1798.862,6,367,25650,214,99,8445,469,15045,153,69,11833,69,10605
14.587,6,24,6993,13,275,1215,275,1078,11,910,957,1440,5915
1.776,17,20,5180,20,231,93,388,5180,0,0,0,0,0
4.629,6,35,6209,17,206,289,314,2744,18,456,256,1152,3465
1.686,6,39,8456,19,320,93,1162,2784,20,405,78,1360,5672
8.803,6,78,24874,41,568,220,1152,19253,37,459,237,1179,5621
1645.86,1,7,392,7,28,274310,28,392,0,0,0,0,0
8.33,17,4,824,2,48,8312,48,152,2,308,8307,308,672
1775.348,6,182,15629,121,69,14794,69,9049,61,69,29585,69,6580
1798.554,17,142,11360,71,48,25693,48,5396,71,56,25693,56,5964
1790.55,17,140,11200,70,48,25949,48,5320,70,56,25949,56,5880
1754.976,6,2518,2353198,896,128,1960,347,54423,1622,1429,1082,2836,2298775
0.291,17,2,368,1,36,0,36,64,1,276,0,276,304
0.646,6,4,220,2,0,646,0,100,2,0,306,0,120
1784.535,6,361,24196,211,88,8497,469,13918,150,69,11976,69,10278
0.009,17,2,467,1,43,0,43,71,1,368,0,368,396
0.886,6,11,1727,7,100,147,100,384,4,589,210,1152,1343
6.946,6,32,7584,13,155,578,267,1306,19,367,385,1420,6278
55.016,6,24,996,13,0,4584,0,536,11,0,4912,0,460
0.928,17,2,466,2,205,928,205,466,0,0,0,0,0
0.454,17,8,2750,8,315,64,354,2750,0,0,0,0,0
1739.338,6,87,6322,58,31,30514,31,3915,29,31,62118,31,2407
0.39,6,13,2133,7,324,65,585,1009,6,396,70,580,1124
562.913,6,7,556,1,46,0,46,86,6,46,112545,46,470
2.375,6,15,2391,9,125,296,245,740,6,1407,425,1407,1651
27.22,6,958,822140,571,1359,47,1368,795126,387,749,69,1368,27014
0.064,17,2,517,1,34,0,34,62,1,427,0,427,455
4.302,6,22,6506,11,293,421,517,1461,11,893,424,2452,5045
11.576,6,24,8413,13,275,964,275,1078,11,1147,830,2840,7335
0.55,6,20,7229,13,334,45,663,2021,7,1209,83,1946,5208
89.15,6,23,8122,12,419,70,954,1781,11,841,8901,2720,6341
1785.472,6,463,26938,251,69,7141,69,14318,212,34,8460,64,12620
1742.224,1,56,4704,56,56,31676,56,4704,0,0,0,0,0
86.744,6,22,6826,5,156,16130,267,678,17,420,5420,1460,6148
9.175,6,82,24805,40,560,235,1152,18968,42,415,217,1152,5837
1.469,17,4,396,2,39,999,39,134,2,103,0,103,262
115.834,6,984,506722,556,850,208,1152,485818,428,472,270,1179,20904
220.272,17,4,240,2,32,220271,32,120,2,32,220271,32,120
300.639,6,44,8883,23,291,13665,786,2165,21,366,473,2720,6718
1.672,6,24,8004,12,164,135,267,1288,12,1014,135,2411,6716
10.991,6,20,4442,11,275,1099,275,998,9,768,776,1440,3444
0.122,17,2,410,1,46,0,46,74,1,308,0,308,336
0.054,17,2,435,1,41,0,41,69,1,338,0,338,366
1.481,6,9,527,5,43,370,43,311,4,0,492,0,216
168.232,6,29,8832,13,158,14019,267,1317,16,858,11211,2085,7515
5.191,6,43,7429,22,201,247,314,3503,21,440,247,1152,3926
164.973,6,44,13301,20,155,8682,721,2358,24,665,7165,2840,10943
0.923,6,5,2190,3,995,461,1460,2110,2,0,0,0,80
13.307,6,799,696825,507,1303,25,1368,676977,292,776,45,1473,19848
1.01,17,2,116,2,30,1010,30,116,0,0,0,0,0
0.262,17,2,152,1,48,0,48,76,1,48,0,48,76
75.538,17,4,1344,4,308,25179,308,1344,0,0,0,0,0
280.321,6,28,7352,12,158,25483,267,1277,16,603,18682,1400,6075
91.828,6,14,3888,8,127,13118,127,467,6,1056,18346,1704,3421
0.337,6,25,8943,13,252,28,647,1692,12,1103,29,2816,7251
0.146,17,2,672,2,308,146,308,672,0,0,0,0,0
1794.13,1,59,4956,59,56,30933,56,4956,0,0,0,0,0
0.106,6,4,212,2,0,103,0,112,2,0,4,0,100
61.978,17,53,4035,28,40,2295,41,1920,25,56,2579,57,2115
4.335,6,39,7269,19,218,240,314,3383,20,440,214,1152,3886
1772.911,6,180,15480,120,69,14898,69,8940,60,69,30046,69,6540
1771.512,6,270,44662,154,304,11578,304,31620,116,83,15402,83,13042
84.383,6,29,14022,16,836,5625,1460,5691,13,1299,7015,2885,8331
33.534,6,30,5040,15,154,2395,721,1858,15,399,2382,2026,3182
1796.146,17,449,39928,404,35,4456,288,25708,45,288,40019,288,14220
665.028,6,163,17492,88,126,7644,1189,7311,75,217,8986,1420,10181
1253.709,17,94,7504,49,48,26118,48,3724,45,56,26153,56,3780
210.728,17,10,880,5,48,52679,48,380,5,72,52679,72,500
282.787,2,4,128,4,8,94262,8,128,0,0,0,0,0
26.923,6,2,708,2,302,26923,302,708,0,0,0,0,0
4.936,6,38,7229,19,218,274,314,3383,19,440,260,1152,3846
633.307,17,31,2643,31,57,21110,352,2643,0,0,0,0,0
0.064,17,3,208,2,36,4,36,128,1,52,0,52,80
1679.258,1,21,2510,21,91,83962,125,2510,0,0,0,0,0
0.146,6,12,2818,7,610,24,684,1592,5,479,35,939,1226
0.67,6,38,11727,22,597,31,1188,7709,16,353,38,1048,4018
1781.763,6,359,22778,209,69,8566,69,12569,150,69,11958,69,10209
1785.858,6,368,25759,213,100,8423,469,14936,155,69,11596,69,10823
0.0,17,1,668,1,640,0,640,668,0,0,0,0,0
74.463,6,28,8683,11,335,7446,661,1574,17,478,4643,1408,7109
213.507,17,4,240,2,32,213505,32,120,2,32,213506,32,120
172.204,17,3,120,2,14,172023,14,84,1,8,0,8,36
17.722,17,26,13271,14,750,1360,1350,10900,12,169,1607,1350,2371
994.846,6,57,13856,35,231,29260,1440,5759,22,433,47364,1440,8097
1750.293,17,12,498,11,14,175029,14,462,1,8,0,8,36
4.094,6,38,7229,19,218,227,314,3383,19,513,213,1179,3846
1780.869,17,142,11360,71,48,25440,48,5396,71,56,25440,56,5964
240.365,6,46,9149,24,524,10450,1418,5986,22,201,11445,617,3163
0.017,17,4,344,2,47,9,47,150,2,69,9,75,194
13.14,6,24,6993,13,275,1095,275,1078,11,910,813,1440,5915
280.308,6,31,7472,14,158,21562,267,1357,17,543,17513,1400,6115
1795.904,17,144,11520,72,48,25294,48,5472,72,56,25294,56,6048
0.841,6,20,5948,11,281,84,544,1288,9,716,94,1420,4660
1777.884,17,142,11360,71,48,25397,48,5396,71,56,25397,56,5964
0.482,6,22,7333,12,334,43,663,1969,10,1209,52,2816,5364
7.221,6,1604,1518007,1042,1381,6,1408,1484119,562,931,12,2816,33888
1750.767,6,95,7203,63,38,28238,205,4476,32,33,56464,98,2727
181.114,6,12,16056,12,1298,16464,1298,16056,0,0,0,0,0
4.609,6,42,7389,22,218,219,314,3503,20,440,229,1152,3886
727.12,17,10,2566,5,31,181777,37,297,5,425,181777,463,2269
64.114,6,21,9086,12,304,71,597,1425,9,1457,7993,4441,7661
6.213,6,37,7189,19,218,345,314,3383,18,513,350,1179,3806
280.352,6,29,7392,13,158,23362,267,1317,16,603,18688,2036,6075
0.297,6,42,17629,23,975,13,1420,12648,19,467,15,1883,4981
1644.288,1,8,448,8,28,234898,28,448,0,0,0,0,0
0.244,17,2,152,1,48,0,48,76,1,48,0,48,76
18.602,6,6,595,5,71,4639,71,555,1,0,0,0,40
1786.578,6,103,8404,68,66,26665,66,4964,35,60,52543,60,3440
6.587,6,4,172,2,0,6094,0,84,2,0,501,0,88
1785.855,6,366,25541,213,100,8423,469,14936,153,69,11749,69,10605
1770.526,6,99,9240,66,65,27238,65,5577,33,59,55324,59,3663
1.63,6,43,12008,24,602,70,1360,6427,19,400,79,1360,5581
1.403,6,51,19469,27,901,53,1440,13733,24,433,52,1440,5736
1785.919,6,102,8164,68,63,26655,64,4864,34,57,54114,58,3300
280.498,6,31,7472,13,158,23374,267,1317,18,543,16492,1380,6155
88.071,6,45,27019,24,538,3829,1066,2944,21,1435,1596,4224,24075
1788.122,6,356,22520,208,69,8638,69,12460,148,69,12164,69,10060
1799.316,6,369,24792,214,87,8447,469,14245,155,69,11681,69,10547
192.579,6,28,6515,11,216,6316,501,1310,17,322,12030,1420,5205
0.156,17,2,190,1,59,0,59,87,1,75,0,75,103
300.663,6,36,10692,18,298,17686,831,2210,18,579,4272,1448,8482
0.002,6,2,111,1,0,0,0,40,1,31,0,31,71
4.036,6,6,6205,5,1193,968,1193,6165,1,0,0,0,40
2.867,6,31,15567,18,692,168,1360,5624,13,1344,224,2720,9943
55.739,17,4,352,2,60,55738,60,176,2,60,55738,60,176
0.027,17,2,410,1,36,0,36,64,1,318,0,318,346
1.303,6,47,19022,27,881,50,1360,13446,20,476,59,2715,5576
1782.266,17,83,3480,82,14,22003,14,3444,1,8,0,8,36
8.036,6,80,24757,41,561,200,1152,19056,39,413,204,1152,5701
29.967,6,3207,3046161,2020,1426,14,1448,2977089,1187,776,25,1448,69072
1796.599,6,356,22589,207,69,8721,69,12420,149,69,12138,69,10169
1761.008,6,110,7948,68,31,26283,31,4650,42,31,42951,31,3298
18.78,6,31,10385,11,155,1878,267,1226,20,595,971,1460,9159
1744.272,1,57,4788,57,56,31147,56,4788,0,0,0,0,0
1781.806,6,356,22520,208,69,8607,69,12460,148,69,12120,69,10060
157.894,6,21,9086,12,304,72,597,1425,9,1457,19714,4441,7661
8.834,6,76,24810,39,568,232,1152,19189,37,459,238,1179,5621
26.223,17,14,8004,7,285,4365,1350,2196,7,801,4365,1350,5808
1793.743,6,267,32168,110,129,16455,1360,15181,157,137,11497,4662,16987
1780.741,17,140,11200,70,48,25807,48,5320,70,56,25807,56,5880
68.63,6,128,127991,86,430,807,647,5890,42,3074,1628,14080,122101
1110.292,6,97,10460,50,79,20724,722,4596,47,103,24133,2328,5864
145.141,17,4,352,2,60,145140,60,176,2,60,145140,60,176
0.008,6,4,4540,3,1448,0,1448,4500,1,0,0,0,40
15.344,6,28,7217,13,155,1278,267,1306,15,482,1095,1420,5911
0.035,17,2,461,1,34,0,34,62,1,371,0,371,399
1.412,6,50,19485,27,905,54,1460,13789,23,433,55,1460,5696
1790.207,17,163,10432,163,36,11050,36,10432,0,0,0,0,0
50.032,17,4,558,2,36,50022,36,128,2,187,50022,187,430
1.261,6,48,19366,27,901,48,1360,13750,21,433,54,1360,5616
1786.248,17,87,3648,86,14,21014,14,3612,1,8,0,8,36
2.79,6,25,10129,14,276,214,560,1392,11,1036,260,1420,8737
1791.184,17,142,11360,71,48,25588,48,5396,71,56,25588,56,5964
0.469,6,3,120,2,0,348,0,80,1,0,0,0,40
0.455,6,51,22506,29,1012,16,1380,17384,22,421,19,1923,5122
298.54,17,4,352,2,60,298539,60,176,2,60,298539,60,176
0.862,6,3,144,2,0,862,0,92,1,0,0,0,52
1770.525,6,130,7920,70,26,25659,26,4206,60,26,30008,26,3714
1.39,6,7,295,4,0,463,0,164,3,7,184,7,131
0.005,17,3,1007,1,137,0,137,165,2,393,5,393,842
69.14,6,27,7177,13,155,5761,267,1306,14,530,5317,3417,5871
1770.274,6,104,9577,67,65,26822,65,5694,37,59,49170,59,3883
1.318,6,54,21458,31,902,43,1360,15717,23,400,51,1360,5741
60.549,17,4,352,2,60,60548,60,176,2,60,60547,60,176
1798.355,6,132,8614,74,52,24635,208,5116,58,31,31542,31,3498
25.043,6,2656,2450390,1655,1400,15,1448,2393674,1001,776,24,1448,56716
0.561,6,6,324,4,0,187,0,216,2,0,343,0,108
596.589,6,89,14955,50,170,12175,469,6433,39,210,15698,4837,8522
7.744,6,113,91857,44,131,180,232,2289,69,1377,113,2633,89568
30.963,6,59,20762,26,1022,1238,1460,14382,33,311,957,2615,6380
4.581,6,14,2854,8,242,654,598,1150,6,457,59,580,1704
530.564,17,18,1684,9,33,66318,37,550,9,98,66317,155,1134
33.771,6,33,5208,16,154,2238,721,1922,17,342,2097,1368,3286
0.008,17,2,904,2,424,8,548,904,0,0,0,0,0
0.366,6,13,1693,7,288,60,288,588,6,426,40,434,1105
0.22,6,12,3705,6,171,42,171,491,6,964,41,1448,3214
16.434,6,23,6601,7,156,2739,267,758,16,472,1093,1420,5843
36.825,17,14,1064,14,48,2832,48,1064,0,0,0,0,0
381.689,6,47,8459,24,135,16595,517,2226,23,455,13044,1418,6233
1788.741,1,59,4956,0,0,0,0,0,59,56,30840,56,4956
1797.276,17,617,224380,617,335,2917,376,224380,0,0,0,0,0
165.715,17,16,1408,8,48,23672,48,608,8,72,23672,72,800
10.081,6,84,24933,43,561,240,1152,19136,41,461,245,1179,5797
0.882,6,10,1687,7,100,147,100,384,3,1179,314,1179,1303
0.228,17,2,144,1,36,0,36,64,1,52,0,52,80
379.115,6,50,3837,25,90,15796,208,2620,25,31,15789,31,1217
1799.756,17,459,57713,219,164,8222,1350,42214,240,36,7530,1350,15499
9.383,6,9,527,5,43,2345,43,311,4,0,3123,0,216
133.307,6,45,9915,17,239,812,314,3314,28,390,4928,1152,6601
5.819,6,4,619,1,304,0,304,356,3,83,2909,83,263
240.198,6,57,19754,31,793,8006,1408,16703,26,211,9607,580,3051
17.933,17,20,6788,10,388,1989,1350,4160,10,234,1989,1350,2628
1740.439,17,28,29568,28,1028,64460,1028,29568,0,0,0,0,0
1.801,17,3,1480,1,300,0,300,328,2,548,110,548,1152
1778.145,17,142,11360,71,48,25401,48,5396,71,56,25401,56,5964
1786.541,6,364,23047,211,69,8507,69,12787,153,69,11753,69,10260
0.004,6,2,200,1,108,0,108,160,1,0,0,0,40
0.232,6,9,1339,5,145,58,145,349,4,826,67,826,990
373.453,6,18,1242,14,180,28727,180,916,4,110,20059,110,326
1741.367,6,101,7918,66,45,26790,205,4902,35,35,51208,98,3016
0.203,17,2,158,1,37,0,37,65,1,65,0,65,93
280.226,6,32,7512,15,158,20016,267,1397,17,543,17511,1400,6115
377.504,2,3,96,3,8,188752,8,96,0,0,0,0,0
1780.162,1,342,28728,342,56,5220,56,28728,0,0,0,0,0
16.063,17,10,880,5,48,4013,48,380,5,72,4013,72,500
0.218,1,2,112,2,28,218,28,112,0,0,0,0,0
56.849,6,48,14756,24,977,461,1360,8870,24,327,2464,2667,5886
28.197,17,32,4704,16,48,1879,48,1216,16,190,1879,308,3488
1781.945,1,84,8904,84,78,21469,78,8904,0,0,0,0,0
9.827,17,4,352,2,60,9826,60,176,2,60,9826,60,176
16.848,6,22,6478,9,154,2106,267,832,13,568,1389,1452,5646
0.405,6,13,1693,7,288,66,288,588,6,426,42,434,1105
34.992,6,33,5196,16,154,2332,722,1910,17,299,2148,1448,3286
1786.089,6,106,8456,68,65,26658,65,4930,38,59,48269,59,3526
1.101,17,22,5963,9,287,137,1350,2836,13,212,65,1350,3127
1022.713,2,9,288,9,8,127839,8,288,0,0,0,0,0
280.253,6,30,7432,13,158,23354,267,1317,17,543,17509,1400,6115
58.586,6,42,8642,20,333,458,685,1916,22,388,2784,2720,6726
4.331,17,13,10154,8,827,618,1350,6846,5,633,848,1350,3308
1700.627,17,13,534,11,14,170044,14,462,2,8,1700446,8,72
84.672,6,25,5164,11,288,8467,722,2009,14,299,6498,1408,3155
65.406,6,49,12127,18,257,3847,1189,3306,31,398,2175,1460,8821
368.536,6,26,6280,14,497,28348,842,3722,12,484,33502,592,2558
1.531,6,51,22993,29,1009,54,1440,17337,22,433,64,1440,5656
3.659,17,5,295,5,31,914,31,295,0,0,0,0,0
0.588,6,6,378,3,69,294,69,189,3,69,282,69,189
1772.601,6,180,15480,120,69,14895,69,8940,60,69,30042,69,6540
18.059,17,34,9700,16,339,1202,1350,5882,18,184,1060,1350,3818
1.627,17,4,524,2,39,1575,39,134,2,167,1579,167,390
0.32,6,20,4960,10,137,35,267,1092,10,692,33,1467,3868
1742.897,6,95,7203,63,38,28111,205,4476,32,33,56212,98,2727
1772.351,6,180,15480,120,69,14893,69,8940,60,69,30036,69,6540
0.702,6,27,9076,13,252,58,647,1692,14,831,49,1448,7384
468.076,1,3,168,3,28,234038,28,168,0,0,0,0,0
9.137,6,82,24485,41,550,228,1152,18704,41,459,222,1179,5781
1771.37,6,106,9681,67,65,26838,65,5694,39,59,46612,59,3987
284.949,6,29,7392,13,158,23745,267,1317,16,678,18994,2760,6075
1789.848,6,295,37628,122,142,14790,1360,17876,173,147,10405,2720,19752
630.0,2,4,128,4,8,210000,8,128,0,0,0,0,0
1794.239,6,123,14166,80,83,22711,517,6203,43,163,42717,1452,7963
11.785,6,1872,1628463,1138,1377,10,1420,1594882,734,467,16,1883,33581
0.406,6,12,1653,6,288,76,288,548,6,426,48,434,1105
0.013,17,2,382,1,32,0,32,60,1,294,0,294,322
3.735,17,2,656,2,300,3735,300,656,0,0,0,0,0
5.918,6,40,7576,20,222,311,314,3690,20,440,298,1152,3886
11.018,6,20,4402,11,275,1101,275,998,9,758,782,1420,3404
0.027,17,2,212,1,46,0,46,74,1,110,0,110,138
7.63,6,21,4374,12,213,693,597,1689,9,552,930,1767,2685
485.458,17,19,6413,19,309,26969,329,6413,0,0,0,0,0
1.107,6,24,5600,11,121,110,267,1175,13,780,85,1460,4425
1017.315,6,196,12394,113,69,8599,69,6797,83,69,12405,69,5597
1.524,6,50,19302,27,892,58,1360,13606,23,433,59,1360,5696
1.147,17,2,784,2,364,1147,364,784,0,0,0,0,0
1791.157,1,120,6720,120,28,15051,28,6720,0,0,0,0,0
29.993,6,12,1313,7,185,4998,185,557,5,244,7495,476,756
1745.641,6,95,7203,63,38,28155,205,4476,32,33,56301,98,2727
0.705,6,10,924,5,283,115,283,551,5,105,126,105,373
4.898,6,40,7325,22,218,233,314,3503,18,516,273,1179,3822
541.434,2,7,224,7,8,90239,8,224,0,0,0,0,0
1785.769,6,120,9923,76,71,23810,294,5674,44,63,41527,247,4249
80.447,6,32,8952,14,158,6188,267,1357,18,624,4727,1400,7595
811.521,17,86,19427,86,197,9547,392,19427,0,0,0,0,0
962.627,2,8,256,8,8,137518,8,256,0,0,0,0,0
82.787,6,17,692,7,0,8214,0,284,10,0,9197,0,408
2.029,17,31,17901,15,793,141,1350,12322,16,320,132,1350,5579
1750.176,17,45,18373,45,380,39776,548,18373,0,0,0,0,0
121.349,6,26,6797,12,181,11031,267,1212,14,627,9333,1400,5585
0.621,17,3,451,2,39,9,39,134,1,289,0,289,317
88.765,6,27,9469,13,425,77,1360,2252,14,830,6814,2720,7217
1793.486,1,60,5040,60,56,30398,56,5040,0,0,0,0,0
1543.286,6,93,7406,59,65,26608,65,4245,34,58,46762,59,3161
1730.324,6,31,6239,20,300,91069,413,4109,11,153,173014,269,2130
0.149,17,2,154,1,33,0,33,61,1,65,0,65,93
0.016,6,10,1514,5,503,4,503,771,5,475,3,475,743
1.112,6,15,3602,9,113,139,113,594,6,1380,115,1380,3008
284.581,17,22,1760,11,48,28457,48,836,11,56,28457,56,924
0.073,6,4,196,3,0,4,0,156,1,0,0,0,40
17.47,17,18,9090,10,669,1934,1350,6973,8,236,2483,1350,2117
5.978,6,253,185236,129,1023,46,1460,22641,124,1407,47,1607,162595
0.028,6,11,912,6,181,5,181,489,5,77,5,134,423
174.455,6,20861,20000405,13964,1354,12,1408,19637097,6897,776,25,1408,363308
3.867,6,21,3961,11,200,386,564,1568,10,463,410,1343,2393
370.847,6,25,1654,17,180,23177,180,1120,8,110,9259,110,534
123.167,6,45,8946,22,367,1083,787,2086,23,348,5592,3488,6860
1787.111,6,102,8364,68,66,26673,66,4964,34,60,54152,60,3400
10.759,6,20,4442,11,275,1075,275,998,9,768,755,1440,3444
1.541,17,415,433358,83,148,18,1350,14672,332,1233,4,1350,418686
1772.438,6,180,15480,120,69,14894,69,8940,60,69,30034,69,6540
1744.683,2,15,480,15,8,124620,8,480,0,0,0,0,0
240.313,6,55,17747,30,783,8286,1408,14883,25,194,10012,580,2864
3.435,6,65,15747,33,285,107,619,3194,32,469,105,1440,12553
0.084,17,2,558,1,32,0,32,60,1,470,0,470,498
4.227,17,5,290,5,30,1056,30,290,0,0,0,0,0
1743.06,6,95,7203,63,38,28113,205,4476,32,33,56217,98,2727
1771.256,6,99,9174,66,64,27250,64,5544,33,58,55349,58,3630
1773.436,6,181,15589,120,69,14902,69,8940,61,69,29548,69,6649
2.656,6,57,22034,31,930,88,1460,16173,26,400,93,1460,5861
0.512,17,3,451,2,39,461,39,134,1,289,0,289,317
0.009,17,4,384,2,36,0,36,128,2,100,1,106,256
28.407,6,10,628,4,106,9466,106,274,6,90,5679,90,354
1799.951,17,140,11200,70,48,26085,48,5320,70,56,26085,56,5880
1.33,6,38,8254,19,321,73,1164,2718,19,433,63,1460,5536
15.408,6,30,7648,11,156,13,267,1232,19,376,855,3417,6416
1764.792,2,13,416,13,8,147066,8,416,0,0,0,0,0
11.013,6,18,4266,10,275,1223,275,958,8,992,887,1440,3308
1799.007,17,449,39928,404,35,4464,288,25708,45,288,40018,288,14220
0.706,17,2,120,2,32,706,32,120,0,0,0,0,0
1793.333,6,356,22520,208,69,8663,69,12460,148,69,12199,69,10060
113.234,6,137,104109,86,1269,1332,1368,93334,51,676,1664,1368,10775
0.137,6,2,112,1,0,0,0,60,1,0,0,0,52
2.953,1,3,168,3,28,1476,28,168,0,0,0,0,0
96.899,6,9,500,2,0,31720,0,112,7,0,16119,0,388
95.189,6,38,8715,12,152,8652,267,1412,26,312,3807,1460,7303
214.224,17,3,365,2,114,214224,156,284,1,53,0,53,81
0.5,17,3,451,2,39,2,39,134,1,289,0,289,317
0.051,17,4,364,2,52,1,52,160,2,74,37,80,204
1779.254,17,142,11360,71,48,25417,48,5396,71,56,25417,56,5964
1667.511,1,7,392,7,28,277918,28,392,0,0,0,0,0
0.203,6,3,120,2,0,203,0,80,1,0,0,0,40
0.537,6,29,7520,16,306,35,1087,2786,13,601,43,1420,4734
1772.901,6,180,15480,120,69,14898,69,8940,60,69,30046,69,6540
19.266,6,2134,1802735,1215,1393,15,1448,1746703,919,776,20,1448,56032
5.008,17,4,288,2,36,4976,36,128,2,52,4977,52,160
0.192,6,4,172,2,0,192,0,92,2,0,5,0,80
3.034,1,4,304,4,48,1011,48,304,0,0,0,0,0
212.675,1,2,120,2,32,212675,32,120,0,0,0,0,0
1769.814,6,81,4340,41,26,44244,26,2196,40,26,45378,26,2144
1751.745,6,96,7255,62,38,28717,205,4424,34,33,53075,98,2831
9.892,6,28,7352,12,158,899,267,1277,16,603,651,1400,6075
1778.083,17,79,3312,78,14,23091,14,3276,1,8,0,8,36
2.151,6,12,3462,6,75,430,75,395,6,1373,430,1448,3067
0.51,17,3,1164,3,360,255,360,1164,0,0,0,0,0
1014.779,17,200,15200,200,48,5099,48,15200,0,0,0,0,0
1786.386,6,106,8656,70,66,25889,66,5176,36,60,51036,60,3480
5.075,6,40,7309,21,218,253,314,3463,19,440,267,1152,3846
9.728,6,2,1232,0,0,0,0,0,2,1152,9728,1152,1232
19.133,17,67,47542,29,311,681,1350,9844,38,964,516,1350,37698
1780.209,17,140,11200,70,48,25800,48,5320,70,56,25800,56,5880
1770.138,6,101,9344,66,65,27232,65,5577,35,59,52060,59,3767
0.175,17,3,1008,3,308,87,308,1008,0,0,0,0,0
1779.711,6,131,8010,71,26,25424,26,4270,60,26,30163,26,3740
1799.454,17,87,3648,86,14,21170,14,3612,1,8,0,8,36
127.66,17,4,352,2,60,127659,60,176,2,60,127659,60,176
2.892,17,4,240,2,32,2891,32,120,2,32,2891,32,120
3.711,6,23,6465,11,262,366,517,1368,12,744,333,1418,5097
91.816,6,21,5735,12,124,8344,159,1404,9,966,11469,2736,4331
1787.151,6,102,8364,68,66,26673,66,4964,34,60,54152,60,3400
1680.46,1,15,870,15,30,120032,30,870,0,0,0,0,0
1756.177,6,389,40098,186,122,9492,528,21841,203,111,8692,448,18257
69.816,6,16,9280,5,174,17454,174,378,11,1408,6971,1452,8902
6.27,6,17,2691,9,179,783,194,858,8,469,839,905,1833
0.044,17,2,904,1,300,0,300,328,1,548,0,548,576
125.754,6,18,1950,8,186,86,290,912,10,156,13959,350,1038
1787.608,6,102,8228,68,64,26680,64,4896,34,58,54167,58,3332
9.915,6,16,3911,9,275,1239,275,643,7,992,860,1440,3268
1796.102,6,356,22520,208,69,8676,69,12460,148,69,12217,69,10060
1741.457,1,15,870,15,30,124389,30,870,0,0,0,0,0
4.429,6,33,6145,17,206,276,314,2744,16,551,278,1179,3401
5.347,6,55,20368,27,946,205,1440,14368,28,433,191,1440,6000
338.726,6,72,48753,45,1195,7698,1448,40619,27,746,2368,1448,8134
0.34,6,27,9090,13,262,28,690,1735,14,945,25,1408,7355
240.274,6,39,5274,19,247,13348,835,2730,20,187,12645,651,2544
0.854,6,24,5755,14,158,65,370,1355,10,999,94,1737,4400
151.983,6,1462,722905,797,842,190,1152,688381,665,377,228,1152,34524
15.573,6,57,20142,30,977,531,1360,13969,27,317,592,1360,6173
1771.331,6,95,8784,62,65,29038,65,5239,33,59,55351,59,3545
54.969,6,29,7257,13,155,4580,267,1306,16,441,3664,1420,5951
1.44,6,36,8174,19,321,80,1164,2718,17,529,78,4075,5456
1741.331,17,30,7050,30,207,60045,207,7050,0,0,0,0,0
0.129,17,4,420,2,33,0,33,122,2,121,125,145,298
1797.749,1,274,29044,274,78,6585,78,29044,0,0,0,0,0
181.109,17,8,608,8,48,25872,48,608,0,0,0,0,0
0.24,17,7,2102,7,272,40,316,2102,0,0,0,0,0
1791.615,17,180,14040,180,50,10009,50,14040,0,0,0,0,0
7.857,6,2,1175,1,0,0,0,40,1,1095,0,1095,1135
1786.515,6,104,8308,68,64,26664,64,4896,36,58,51040,58,3412
1785.905,6,102,8364,68,66,26655,66,4964,34,60,54115,60,3400
1271.746,6,120,10872,84,74,15322,138,6948,36,69,30040,69,3924
82.541,2,4,128,4,8,27513,8,128,0,0,0,0,0
0.57,6,27,9145,13,277,47,747,1792,14,943,40,1368,7353
1.107,17,26,17733,12,779,100,1350,9687,14,546,63,1350,8046
0.149,6,2,80,1,0,0,0,40,1,0,0,0,40
309.052,2,6,240,6,16,61810,16,240,0,0,0,0,0
319.582,6,10,562,4,106,106527,106,274,6,0,6301,0,288
10.599,6,51,17377,24,280,453,561,3049,27,942,401,1440,14328
705.341,6,35,2287,22,332,33587,332,1520,13,83,20383,83,767
315.908,6,74,19207,39,329,8313,1360,9826,35,398,9287,4649,9381
1744.41,6,95,7203,63,38,28135,205,4476,32,33,56260,98,2727
1741.394,17,30,31620,30,1026,60048,1026,31620,0,0,0,0,0
249.808,6,509,399623,222,695,1130,1418,21091,287,1346,873,1418,378532
1.308,6,50,20385,27,969,50,1460,14689,23,433,50,1460,5696
0.243,17,4,420,2,33,0,33,122,2,121,0,145,298
5.999,6,48,8529,25,227,249,314,4182,23,427,261,1152,4347
5.033,17,4,288,2,36,5002,36,128,2,52,4997,52,160
1756.059,6,105,6270,60,27,29762,27,3525,45,27,39909,27,2745
1713.904,1,8,848,8,78,244843,78,848,0,0,0,0,0
1777.568,17,386,129696,386,308,4617,422,129696,0,0,0,0,0
1193.803,1,6,336,6,28,238760,28,336,0,0,0,0,0
367.055,6,18,1242,14,180,28235,180,916,4,110,20062,110,326
4.771,6,40,7309,21,218,238,314,3463,19,513,250,1179,3846
280.261,6,26,7272,13,158,23355,267,1317,13,905,23350,4845,5955
240.214,6,54,18768,29,795,8578,1418,15838,25,202,10008,580,2930
1772.553,6,180,15480,120,69,14895,69,8940,60,69,30038,69,6540
0.25,6,10,1671,6,552,50,948,1348,4,159,83,159,323
15.786,6,30,7504,14,152,1214,267,1484,16,488,1051,3417,6020
1787.064,6,104,8376,68,65,26672,65,4930,36,59,51055,59,3446
1773.476,6,182,15629,121,69,14778,69,8980,61,69,29557,69,6649
0.036,6,10,1514,5,503,8,503,771,5,475,8,475,743
300.784,6,45,9075,20,308,15823,889,2091,25,331,12526,3488,6984
0.034,6,11,912,6,181,6,181,489,5,77,4,134,423
411.555,6,59,12388,28,298,15242,1189,5002,31,341,4520,1917,7386
0.388,6,27,9047,14,252,29,647,1744,13,945,31,1438,7303
0.014,17,2,431,1,65,0,65,93,1,310,0,310,338
15.036,17,15,9090,8,832,2143,1350,6880,7,287,2501,1350,2210
4.088,6,2,88,2,0,0,0,88,0,0,0,0,0
5.375,6,913,743314,520,1381,10,1420,722641,393,420,13,1420,20673
4.121,6,39,7269,20,218,216,314,3423,19,440,215,1152,3846
0.251,17,2,2380,2,1162,251,1162,2380,0,0,0,0,0
1794.047,17,144,11520,72,48,25268,48,5472,72,56,25268,56,6048
409.064,6,79,11446,41,100,10222,721,4149,38,360,11050,2828,7297
10.891,6,104,38644,55,651,201,1152,32186,49,449,221,1179,6458
1779.867,6,189,11921,95,52,18934,208,7231,94,31,19135,31,4690
33.614,6,36,5564,18,154,1977,721,2026,18,288,1966,2026,3538
1798.39,6,382,26995,219,103,8249,469,15990,163,69,11100,69,11005
1789.587,6,368,25621,213,99,8441,469,15005,155,69,11619,69,10616
2.936,6,29,10596,15,695,209,1360,3427,14,824,211,2241,7169
0.061,6,2,80,1,0,0,0,40,1,0,0,0,40
258.23,17,4,352,2,60,258229,60,176,2,60,258228,60,176
0.041,17,2,456,1,60,0,60,88,1,340,0,340,368
1795.071,17,80,3354,79,14,23013,14,3318,1,8,0,8,36
0.221,17,2,144,1,36,0,36,64,1,52,0,52,80
33.828,6,31,5093,15,154,2416,721,1858,16,399,2241,1368,3235
2.017,6,47,18769,26,929,80,1460,13153,21,433,89,1460,5616
1681.398,17,14,3843,7,30,280231,30,406,7,463,280231,463,3437
153.862,6,98,71512,63,1239,2481,1408,61552,35,739,3143,2439,9960
481.298,2,7,224,7,8,80216,8,224,0,0,0,0,0
1.718,6,25,8759,15,284,122,585,1457,10,985,170,1420,7302
58.623,6,27,7177,13,155,4885,267,1306,14,530,4508,3417,5871
280.415,6,29,7392,13,158,23367,267,1317,16,603,18684,2800,6075
2.902,17,3,468,3,128,1451,128,468,0,0,0,0,0
1739.951,1,55,4620,55,56,32221,56,4620,0,0,0,0,0
0.951,6,27,8506,15,229,57,583,2007,12,1201,70,3151,6499
171.056,6,20657,19645793,13652,1360,12,1408,19276809,7005,931,24,2801,368984
1.019,6,13,1175,7,146,169,146,430,6,250,202,499,745
1733.21,6,72,5236,47,33,37678,33,3230,25,31,72208,31,2006
1773.37,6,181,15589,120,69,14902,69,8940,61,69,29554,69,6649
2.662,6,56,14439,27,551,102,1429,5020,29,434,89,1986,9419
300.849,6,39,9638,21,540,15042,1360,4116,18,399,509,1360,5522
1770.613,6,104,9654,68,65,26427,65,5811,36,59,50585,59,3843
0.848,6,10,1687,7,100,141,100,384,3,1179,274,1179,1303
11.622,6,1848,1606909,1117,1383,10,1420,1573448,731,420,15,1420,33461
368.854,6,25,1651,17,177,23053,177,1117,8,110,9208,110,534
0.096,17,2,390,1,46,0,46,74,1,288,0,288,316
111.827,1,20,2120,20,78,5885,78,2120,0,0,0,0,0
1785.87,6,439,28530,218,99,8229,469,15205,221,34,8117,64,13325
1770.865,6,106,9538,66,64,27244,64,5544,40,58,45404,58,3994
0.009,1,2,112,2,28,9,28,112,0,0,0,0,0
1787.32,6,356,22520,208,69,8634,69,12460,148,69,12158,69,10060
0.46,6,23,7722,14,318,35,600,2022,9,870,53,1471,5700
300.6,6,36,8276,20,262,15821,671,1882,16,522,565,4080,6394
1772.39,6,180,15480,120,69,14894,69,8940,60,69,30039,69,6540
37.958,17,44,6468,22,48,1807,48,1672,22,190,1806,308,4796
0.266,6,26,8990,13,247,22,624,1672,13,1105,21,2816,7318
15.457,17,13,6494,7,613,2564,1350,4490,6,306,3073,1350,2004
1786.549,6,108,8536,68,65,26664,65,4930,40,59,45805,59,3606
398.831,6,37,7658,17,182,6892,502,1960,20,287,20986,1420,5698
4.102,17,2,656,2,300,4102,300,656,0,0,0,0,0
0.082,17,2,237,1,72,0,72,100,1,109,0,109,137
1681.258,1,14,784,14,28,129327,28,784,0,0,0,0,0
3.265,6,74,18703,38,551,88,1429,5556,36,433,82,1986,13147
0.005,17,2,387,1,39,0,39,67,1,292,0,292,320
752.784,17,7,2268,7,296,125464,304,2268,0,0,0,0,0
4.947,6,129,91072,62,131,81,232,3009,67,1377,71,2860,88063
1786.895,6,102,8296,68,65,26670,65,4930,34,59,54143,59,3366
548.737,6,140,18632,68,131,8190,1189,6006,72,256,7728,1420,12626
1787.088,6,104,8435,69,65,26280,65,4970,35,59,52553,59,3465
1773.286,6,182,15698,120,69,14901,69,8940,62,69,29066,69,6758
300.891,6,48,14953,26,904,12035,1460,9226,22,371,411,1460,5727
0.029,17,4,344,2,47,17,47,150,2,69,16,75,194
1798.569,17,449,39928,404,35,4462,288,25708,45,288,40023,288,14220
0.011,17,2,350,1,40,0,40,68,1,254,0,254,282
978.113,17,191,14516,191,48,5147,48,14516,0,0,0,0,0
0.752,6,3,189,2,0,752,0,80,1,69,0,69,109
1.278,6,41,12001,22,617,60,1360,6465,19,476,60,2720,5536
0.049,6,3,2960,1,0,0,0,40,2,1408,0,1408,2920
1791.114,1,104,5824,104,28,17389,28,5824,0,0,0,0,0
1732.192,6,77,5636,48,33,36855,33,3336,29,31,61857,31,2300
1697.184,17,394,35328,354,36,4807,288,22688,40,288,43101,288,12640
280.192,6,26,7272,13,158,23349,267,1317,13,905,23346,4845,5955
1740.613,17,29,6815,29,207,62164,207,6815,0,0,0,0,0
1743.354,6,97,7307,63,38,28118,205,4476,34,33,52816,98,2831
91.432,6,24,9578,12,301,69,595,1464,12,952,8300,2568,8114
1785.054,17,140,11200,70,48,25870,48,5320,70,56,25870,56,5880
3.826,1,5,420,5,56,956,56,420,0,0,0,0,0
1798.482,6,379,26806,218,103,8287,469,15881,161,69,11239,69,10925
1752.036,6,169,10165,86,43,20612,208,5915,83,31,21363,31,4250
1703.453,1,72,4032,72,28,23992,28,4032,0,0,0,0,0
128.033,6,38,8552,12,131,11638,267,1542,26,283,5120,1452,7010
1785.858,6,367,25581,213,99,8423,469,15005,154,69,11672,69,10576
1779.704,17,140,11200,70,48,25792,48,5320,70,56,25792,56,5880
1.37,6,28,10483,16,618,77,1360,3776,12,887,108,3494,6707
1.68,6,48,18567,27,845,64,1360,12951,21,476,72,2715,5616
1681.616,1,15,840,15,28,120115,28,840,0,0,0,0,0
100.359,17,4,240,2,32,100358,32,120,2,32,100358,32,120
1.85,17,2,178,1,29,0,29,57,1,93,0,93,121
1641.064,1,56,3136,56,28,29837,28,3136,0,0,0,0,0
0.901,6,10,1687,7,100,150,100,384,3,1179,321,1179,1303
1769.946,6,99,9306,66,66,27229,66,5610,33,60,55308,60,3696
29.439,6,52,13468,26,188,1177,721,2932,26,678,1136,2840,10536
4.534,6,38,7245,20,218,238,314,3423,18,516,250,1179,3822
0.14,6,9,1002,5,213,35,213,417,4,421,43,421,585
15.211,6,29,6892,15,299,1085,1001,2404,14,979,1169,1731,4488
88.044,6,18,1203,8,92,12577,138,596,10,69,9781,69,607
280.04,6,26,7272,13,158,23336,267,1317,13,905,23333,4845,5955
97.051,6,41,10320,13,287,8086,1189,2831,28,289,3594,1420,7489
1795.694,1,58,4872,58,56,31503,56,4872,0,0,0,0,0
0.76,17,2,576,1,33,0,33,61,1,487,0,487,515
1796.289,17,449,39928,404,35,4457,288,25708,45,288,40022,288,14220
1773.616,6,180,15480,120,69,14904,69,8940,60,69,30058,69,6540
1799.717,17,142,11360,71,48,25710,48,5396,71,56,25710,56,5964
1.886,17,5,1208,3,32,933,32,180,2,486,0,486,1028
104.625,1,6,504,0,0,0,0,0,6,56,20925,56,504
1.56,17,2,144,1,36,0,36,64,1,52,0,52,80
0.082,6,9,1002,5,213,20,213,417,4,421,20,421,585
5.071,17,4,288,2,36,5018,36,128,2,52,5039,52,160
6.4,6,12,2271,7,188,1066,245,660,5,1407,1510,1407,1611
0.647,6,4,220,2,0,647,0,100,2,0,301,0,120
0.029,6,2,116,1,0,0,0,64,1,0,0,0,52
1773.117,6,180,15480,120,69,14900,69,8940,60,69,30049,69,6540
1792.27,17,85,3564,84,14,21593,14,3528,1,8,0,8,36
21.858,6,9,527,5,43,5464,43,311,4,0,7248,0,216
38.229,6,17,4044,4,92,12743,92,296,13,278,3171,1408,3748
1782.25,6,365,25501,212,100,8446,469,14896,153,69,11722,69,10605
1772.931,6,180,15480,120,69,14898,69,8940,60,69,30049,69,6540
4.644,17,8,1248,4,64,1547,64,368,4,192,1499,192,880
256.036,17,4,352,2,60,256035,60,176,2,60,256035,60,176
14.516,6,2579,2416791,1666,1372,8,1408,2364651,913,931,15,2816,52140
2.054,6,52,20426,29,962,73,1460,14685,23,437,81,2615,5741
0.018,6,16,7160,9,132,2,132,608,7,1545,2,3182,6552
1729.209,6,61,4452,40,33,44338,33,2740,21,31,86451,31,1712
1785.979,6,245,25701,149,88,12067,965,12058,96,139,18796,2760,13643
2.259,6,7,280,4,0,753,0,160,3,0,592,0,120
73.909,6,15,628,7,0,2098,0,288,8,0,10556,0,340
227.401,6,20,4292,10,407,813,722,1390,10,339,25247,2026,2902
5.49,6,38,7229,19,218,305,314,3383,19,513,288,1179,3846
2.02,17,2,116,2,30,2020,30,116,0,0,0,0,0
0.079,17,2,586,1,46,0,46,74,1,484,0,484,512
3.084,6,37,9985,16,502,205,1440,4216,21,377,144,1440,5769
0.837,6,55,25396,31,1047,27,1380,20126,24,421,33,1923,5270
30.975,17,5,3575,5,687,7743,687,3575,0,0,0,0,0
242.299,17,4,352,2,60,242298,60,176,2,60,242298,60,176
19.913,6,24,1655,12,222,1807,222,928,12,231,1807,231,727
1740.652,17,29,6815,29,207,62166,207,6815,0,0,0,0,0
377.163,6,25,1639,16,177,25144,177,1053,9,110,8961,110,586
0.074,17,2,334,1,32,0,32,60,1,246,0,246,274
0.012,17,2,158,1,34,0,34,62,1,68,0,68,96
2.45,6,13,2311,8,188,350,245,700,5,1407,551,1407,1611
3.919,6,2,88,2,0,0,0,88,0,0,0,0,0
0.078,17,2,334,1,32,0,32,60,1,246,0,246,274
1782.34,17,83,3480,82,14,22004,14,3444,1,8,0,8,36
261.71,17,4,240,2,32,261709,32,120,2,32,261709,32,120
60.916,6,28,7217,13,155,5076,267,1306,15,482,4350,1997,5911
0.275,6,26,6066,13,164,22,453,1494,13,555,22,1542,4572
20.101,6,21,5418,12,107,1827,159,1074,9,773,2511,1402,4344
240.227,6,53,17570,28,776,8897,1408,14658,25,200,10009,580,2912
1785.868,6,104,8376,68,65,26654,65,4930,36,59,51022,59,3446
1789.133,1,168,9408,168,28,10713,28,9408,0,0,0,0,0
1798.125,17,449,39928,404,35,4461,288,25708,45,288,40024,288,14220
0.444,6,2,80,1,0,0,0,40,1,0,0,0,40
1770.219,6,99,9240,66,65,27234,65,5577,33,59,55315,59,3663
6.297,1,4,224,4,28,2099,28,224,0,0,0,0,0
1786.484,6,104,8240,68,63,26663,63,4862,36,57,51040,57,3378
928.963,6,56,4608,38,65,25105,65,2885,18,59,54637,59,1723
33.117,17,18,1584,9,48,4138,48,684,9,72,4138,72,900
149.173,17,14,1064,14,48,11474,48,1064,0,0,0,0,0
0.026,17,2,503,1,65,0,65,93,1,382,0,382,410
1773.421,6,181,15589,120,69,14902,69,8940,61,69,29549,69,6649
1.344,6,11,1727,7,100,224,100,384,4,589,362,1152,1343
1684.009,17,14,1036,7,30,280659,30,406,7,62,280657,62,630
1770.409,6,101,9410,66,66,27237,66,5610,35,60,52068,60,3800
1.23,6,4,184,2,0,1230,0,88,2,0,1018,0,96
1749.3,1,8,448,8,28,249900,28,448,0,0,0,0,0
1.261,6,12,3462,6,75,252,75,395,6,1373,252,1448,3067
1795.065,17,448,39896,403,35,4465,288,25676,45,288,40020,288,14220
1700.405,17,12,498,11,14,170040,14,462,1,8,0,8,36
23.318,6,28,4786,15,213,1665,597,1877,13,441,1745,1440,2909
0.014,6,3,307,2,163,0,163,267,1,0,0,0,40
1785.34,6,104,8308,68,64,26646,64,4896,36,58,51007,58,3412
572.683,17,16,5376,16,308,38178,308,5376,0,0,0,0,0
1787.159,1,270,15120,270,28,6643,28,15120,0,0,0,0,0
0.072,1,2,112,2,28,72,28,112,0,0,0,0,0
0.22,17,2,184,1,32,0,32,60,1,96,0,96,124
1761.835,6,95,7203,63,38,28416,205,4476,32,33,56823,98,2727
61.593,6,11,851,11,31,6159,31,851,0,0,0,0,0
1793.892,6,356,22520,208,69,8666,69,12460,148,69,12203,69,10060
16.11,17,10,880,5,48,4024,48,380,5,72,4024,72,500
0.257,6,27,6202,13,181,21,537,1578,14,555,19,1542,4624
651.02,1,18,1008,18,28,38295,28,1008,0,0,0,0,0
365.899,6,23,1535,16,177,24393,177,1053,7,110,10361,110,482
0.483,6,12,3884,7,170,76,170,712,5,1446,119,2675,3172
36.546,17,20,1520,20,48,1923,48,1520,0,0,0,0,0
280.383,6,30,7432,13,158,23365,267,1317,17,543,17513,1400,6115
1799.498,17,462,50711,202,146,8876,1350,35193,260,31,6947,60,15518
37.516,1,2,112,2,28,37516,28,112,0,0,0,0,0
0.125,17,2,396,1,39,0,39,67,1,301,0,301,329
5.475,6,22,4426,12,213,497,597,1689,10,552,589,1767,2737
147.654,17,4,352,2,60,147653,60,176,2,60,147653,60,176
0.328,17,2,154,1,33,0,33,61,1,65,0,65,93
3.913,17,4,3964,4,963,1304,1451,3964,0,0,0,0,0
0.142,17,2,586,1,46,0,46,74,1,484,0,484,512
1741.546,17,30,20190,30,645,60053,645,20190,0,0,0,0,0
7.819,6,1727,1517851,994,1437,7,1448,1470803,733,776,10,1448,47048
1.385,17,3,1167,3,361,692,361,1167,0,0,0,0,0
0.087,17,2,144,1,36,0,36,64,1,52,0,52,80
1.746,6,12,1304,6,256,348,256,756,6,304,347,304,548
10.635,6,94,30785,48,593,226,1152,24463,46,447,230,1179,6322
8.202,6,14,2242,8,210,1169,210,844,6,545,1635,904,1398
0.556,6,51,20773,27,1031,21,1380,15571,24,421,22,1923,5202
19.129,17,23,13375,12,849,1735,1350,10528,11,230,1908,1350,2847
137.233,17,4,240,2,32,137232,32,120,2,32,137232,32,120
31.691,6,7,308,1,0,0,0,44,6,0,6320,0,264
1.315,6,47,18763,26,928,52,1440,13147,21,433,56,1440,5616
1.431,6,24,8004,12,164,111,267,1288,12,1014,110,2491,6716
0.333,17,2,144,1,36,0,36,64,1,52,0,52,80
166.444,6,41,5911,20,214,8760,585,2979,21,182,8309,580,2932
0.214,17,2,172,1,50,0,50,78,1,66,0,66,94
1.705,6,29,8781,17,376,106,861,1813,12,810,142,1380,6968
15.818,17,29,24133,15,885,1127,1350,13708,14,716,1214,1350,10425
1679.553,17,12,498,11,14,167955,14,462,1,8,0,8,36
14.214,6,27,4867,13,154,1165,722,1768,14,394,1079,1408,3099
30.438,6,38,9884,19,706,488,1360,4322,19,399,1681,1360,5562
1793.784,17,144,11520,72,48,25264,48,5472,72,56,25264,56,6048
0.024,6,3,175,2,31,0,31,135,1,0,0,0,40
1799.226,17,448,39612,404,35,4464,288,25708,44,288,40948,288,13904
1798.164,1,126,7056,126,28,14385,28,7056,0,0,0,0,0
365.693,6,18,1288,14,226,28130,226,962,4,110,20055,110,326
1797.63,17,142,11360,71,48,25680,48,5396,71,56,25680,56,5964
377.876,2,4,128,4,8,125958,8,128,0,0,0,0,0
1749.173,6,97,7307,63,38,28212,205,4476,34,33,52993,98,2831
0.281,6,26,8892,13,227,23,547,1616,13,941,23,1408,7276
280.534,6,29,7392,13,158,23377,267,1317,16,603,18694,2076,6075
0.359,6,10,968,5,256,87,256,460,5,304,87,304,508
137.835,17,4,240,2,32,137834,32,120,2,32,137833,32,120
1680.576,17,12,498,11,14,168057,14,462,1,8,0,8,36
1795.303,17,448,39896,403,35,4465,288,25676,45,288,40016,288,14220
273.379,1,2,120,2,32,273379,32,120,0,0,0,0,0
5.814,6,40,7309,20,218,306,314,3423,20,513,291,1179,3886
1739.952,1,15,870,15,30,124282,30,870,0,0,0,0,0
1790.38,1,200,11200,200,28,8996,28,11200,0,0,0,0,0
1770.214,6,99,9174,66,64,27234,64,5544,33,58,55316,58,3630
1794.02,6,387,29879,220,75,8191,267,13886,167,132,10807,1460,15993
2.041,6,17,6337,9,141,255,275,646,8,894,145,1414,5691
0.06,17,4,368,2,32,10,32,120,2,96,0,96,248
67.579,6,543,241550,277,814,244,1152,225405,266,423,254,1179,16145
0.419,6,10,1992,5,288,96,288,508,5,424,59,434,1484
0.443,6,6,248,4,0,147,0,164,2,0,223,0,84
1784.434,17,148,13072,74,63,24443,952,6792,74,56,24443,72,6280
1781.761,6,357,22629,208,69,8607,69,12460,149,69,12038,69,10169
0.049,17,4,284,2,32,33,32,120,2,54,17,60,164
1.671,6,25,8757,15,284,119,584,1456,10,985,166,1420,7301
1.299,6,52,20834,28,928,48,1360,15074,24,433,48,1360,5760
0.55,6,14,1745,7,288,64,288,600,7,426,61,434,1145
10.637,6,1696,1465788,1019,1384,10,1420,1434487,677,467,15,1883,31301
1679.747,17,12,498,11,14,167974,14,462,1,8,0,8,36
1.459,6,25,8056,12,164,111,267,1288,13,869,103,1448,6768
1787.152,6,102,8364,68,66,26673,66,4964,34,60,54152,60,3400
0.485,6,15,5386,8,965,69,1360,3217,7,269,42,272,2169
1741.248,17,30,7050,30,207,60043,207,7050,0,0,0,0,0
1706.594,1,14,1141,14,53,131276,78,1141,0,0,0,0,0
367.019,6,18,1242,14,180,28232,180,916,4,110,20060,110,326
300.79,2,3,96,3,8,150395,8,96,0,0,0,0,0
19.282,6,3148,2991424,2061,1374,9,1408,2930236,1087,931,17,2801,61188
279.793,17,4,352,2,60,279792,60,176,2,60,279792,60,176
1690.78,1,8,448,8,28,241540,28,448,0,0,0,0,0
0.558,6,4,160,2,0,400,0,80,2,0,558,0,80
7.326,6,22,5521,10,288,810,288,752,12,710,649,853,4769
51.029,6,27,7827,7,166,498,267,955,20,379,2685,1452,6872
6.404,6,41,7349,21,218,320,314,3463,20,513,322,1179,3886
1784.09,17,83,3480,82,14,22025,14,3444,1,8,0,8,36
0.597,6,10,924,5,283,100,283,551,5,105,100,105,373
144.223,17,4,352,2,60,144222,60,176,2,60,144222,60,176
541.45,2,8,256,8,8,77350,8,256,0,0,0,0,0
31.886,6,176,169908,58,119,559,281,3375,118,1406,272,2836,166533
254.402,6,55,14526,24,168,11060,267,2485,31,568,8476,1400,12041
11.416,6,22,6817,12,275,1037,275,1038,10,1073,710,1420,5779
0.121,6,2,116,1,0,0,0,64,1,0,0,0,52
0.014,1,2,112,2,28,14,28,112,0,0,0,0,0
399.255,17,56,4722,52,30,7828,37,3030,4,395,113211,463,1692
3.221,17,4,1556,4,361,1073,361,1556,0,0,0,0,0
1785.119,6,102,8228,68,64,26643,64,4896,34,58,54091,58,3332
1.969,6,14,2351,8,188,281,245,700,6,703,344,1152,1651
40.776,17,12,1764,6,48,8152,48,456,6,190,8151,308,1308
1681.054,1,15,840,15,28,120075,28,840,0,0,0,0,0
750.186,17,19,6376,19,307,41677,308,6376,0,0,0,0,0
1.436,6,24,8004,12,164,110,267,1288,12,1014,110,2491,6716
1744.667,2,21,672,21,8,87233,8,672,0,0,0,0,0
300.353,6,38,15893,23,974,13652,1402,10026,15,634,4493,2905,5867
1.761,17,19,5783,9,328,215,1350,3207,10,229,191,1350,2576
0.009,6,3,120,2,0,9,0,80,1,0,0,0,40
0.81,6,11,818,6,185,161,185,505,5,45,138,45,313
1.319,6,48,19249,27,894,50,1440,13633,21,433,57,1440,5616
1682.721,17,14,1036,7,30,280446,30,406,7,62,280444,62,630
1792.7,6,274,33639,113,138,16005,1360,16311,161,135,11203,4662,17328
1771.338,6,99,9240,66,65,27251,65,5577,33,59,55351,59,3663
0.042,6,5,417,3,38,4,38,232,2,81,40,81,185
0.018,6,6,6566,5,1253,4,1448,6526,1,0,0,0,40
0.335,17,2,157,1,31,0,31,59,1,70,0,70,98
1786.711,6,102,8296,68,65,26667,65,4930,34,59,54139,59,3366
71.688,6,28,15440,15,664,48,1360,3289,13,1659,5962,4416,12151
1742.746,17,30,31680,30,1028,60094,1028,31680,0,0,0,0,0
0.634,6,14,1745,7,288,74,288,600,7,426,74,434,1145
1794.575,1,58,4872,58,56,31483,56,4872,0,0,0,0,0
0.529,17,3,451,2,39,63,39,134,1,289,0,289,317
1681.291,17,12,498,11,14,168129,14,462,1,8,0,8,36
1785.94,17,87,3648,86,14,21011,14,3612,1,8,0,8,36
240.197,6,57,19039,30,807,8282,1402,15314,27,231,9238,580,3725
0.057,17,3,231,3,49,28,49,231,0,0,0,0,0
739.829,17,84,7017,78,30,9607,37,4545,6,384,136013,463,2472
11.586,6,23,9480,13,275,965,275,1078,10,1598,926,2840,8402
1798.409,6,356,22520,208,69,8687,69,12460,148,69,12233,69,10060
1783.129,1,248,13888,248,28,7219,28,13888,0,0,0,0,0
0.538,17,2,136,1,32,0,32,60,1,48,0,48,76
3.998,17,4,268,4,39,1332,39,268,0,0,0,0,0
1781.703,1,127,7112,127,28,14140,28,7112,0,0,0,0,0
1787.327,6,104,8376,68,65,26676,65,4930,36,59,51062,59,3446
229.655,1,2,112,2,28,229655,28,112,0,0,0,0,0
3.991,17,4,244,4,33,1330,33,244,0,0,0,0,0
1788.631,6,123,14710,79,84,22931,502,6390,44,156,41593,1452,8320
1772.36,6,180,15480,120,69,14893,69,8940,60,69,30032,69,6540
4.004,17,4,268,4,39,1334,39,268,0,0,0,0,0
82.58,17,4,1344,4,308,27526,308,1344,0,0,0,0,0
842.262,2,8,256,8,8,120323,8,256,0,0,0,0,0
0.078,17,2,2754,2,1349,78,1349,2754,0,0,0,0,0
1776.209,17,140,11200,70,48,25742,48,5320,70,56,25742,56,5880
1744.575,2,27,864,27,8,67099,8,864,0,0,0,0,0
0.336,6,3,802,1,0,0,0,40,2,341,5,341,762
0.036,17,2,198,1,39,0,39,67,1,103,0,103,131
158.875,6,97,69066,61,1269,2647,1448,59032,36,679,2533,1448,10034
0.561,6,15,1785,8,288,55,288,640,7,426,65,434,1145
3.539,17,2,204,1,34,0,34,62,1,114,0,114,142
299.533,6,6,364,4,31,99844,31,222,2,31,299525,31,142
0.123,17,2,427,1,39,0,39,67,1,332,0,332,360
1.327,6,25,8056,12,164,102,267,1288,13,1014,95,2491,6768
0.514,17,8,656,4,37,169,37,260,4,71,166,89,396
1776.108,6,108,8666,70,65,25740,65,5140,38,59,47997,59,3526
0.621,17,3,1167,3,361,310,361,1167,0,0,0,0,0
0.151,17,2,304,1,60,0,60,88,1,188,0,188,216
78.674,6,26,4956,10,211,1889,722,1585,16,316,5227,1448,3371
74.46,6,43,9881,20,631,798,1360,4035,23,307,3375,1360,5846
2.446,6,3,216,1,0,0,0,40,2,96,189,96,176
1792.746,6,360,23025,207,69,8702,69,12420,153,69,11794,69,10605
241.211,6,58,7839,26,231,9646,585,3931,32,158,7779,580,3908
1797.545,6,367,25650,214,99,8439,469,15045,153,69,11822,69,10605
1008.141,2,7,224,7,8,168023,8,224,0,0,0,0,0
175.213,17,2,72,1,8,0,8,36,1,8,0,8,36
0.085,17,4,352,2,37,56,37,130,2,83,30,89,222
240.297,6,45,8988,23,519,10922,1402,5881,22,217,11442,617,3107
1134.058,2,10,320,10,8,126006,8,320,0,0,0,0,0
1785.222,17,87,3648,86,14,21002,14,3612,1,8,0,8,36
3.063,6,3,168,1,0,0,0,52,2,0,3063,0,116
138.524,17,4,352,2,60,138523,60,176,2,60,138523,60,176
543.217,6,21,6569,3,112,95602,112,240,18,350,31953,1452,6329
22.691,6,35,9273,19,158,1260,487,1741,16,860,1503,4662,7532
36.377,6,15,620,8,0,5192,0,324,7,0,6060,0,296
1788.443,17,87,3648,86,14,21040,14,3612,1,8,0,8,36
240.167,6,55,19034,30,811,8281,1408,16176,25,193,10006,580,2858
287.041,6,29,3017,15,324,20500,585,1437,14,282,22076,580,1580
1786.079,6,102,8296,68,65,26657,65,4930,34,59,54119,59,3366
1.315,17,17,6242,8,419,182,1350,3578,9,268,159,1350,2664
9.205,6,88,29756,45,604,209,1152,23554,43,447,213,1179,6202
6.64,6,40,7325,21,218,332,314,3463,19,516,355,1179,3862
1624.397,2,18,576,18,8,95552,8,576,0,0,0,0,0
353.349,6,20,6483,2,106,1340,106,194,18,370,20784,1420,6289
1787.901,17,73,3060,72,14,25181,14,3024,1,8,0,8,36
31.8,6,379,320503,169,123,189,292,10718,210,1450,152,2816,309785
2.292,6,115,88746,50,131,46,232,2529,65,1393,30,4290,86217
103.269,6,78,51447,47,1194,2244,1408,43100,31,747,2056,1408,8347
0.905,6,21,9222,11,514,90,1237,2015,10,970,75,1360,7207
300.645,6,38,8593,20,322,15823,941,2120,18,441,500,1360,6473
315.399,6,23,2585,7,242,52565,517,1111,16,323,21026,499,1474
1780.603,6,415,24928,208,69,8601,69,12460,207,34,8643,69,12468
1744.701,6,96,6962,62,31,28601,31,4247,34,31,52868,31,2715
61.595,6,36,15843,22,796,2933,1368,9117,14,748,4717,2519,6726
138.022,6,35,8092,13,140,5131,267,1513,22,334,6572,1420,6579
10.206,17,3,3249,3,1055,5103,1055,3249,0,0,0,0,0
1681.814,17,12,498,11,14,168181,14,462,1,8,0,8,36
0.357,17,2,180,1,30,0,30,58,1,94,0,94,122
0.0,17,1,1034,1,1006,0,1006,1034,0,0,0,0,0
153.345,6,44,13270,21,181,7667,267,2300,23,836,6969,3436,10970
0.025,17,2,158,1,34,0,34,62,1,68,0,68,96
430.929,17,6,1984,6,302,86185,308,1984,0,0,0,0,0
1638.616,2,10,320,10,8,182068,8,320,0,0,0,0,0
107.556,6,48,13420,24,926,485,1360,7534,24,327,4669,2667,5886
1079.674,17,112,9372,104,30,10482,37,6060,8,386,145859,463,3312
4.769,17,3,2049,3,655,2384,655,2049,0,0,0,0,0
74.971,6,21,860,10,0,6064,0,404,11,0,7495,0,456
6.526,6,66,20142,34,562,197,1152,15419,32,491,201,1179,4723
1756.348,6,374,58245,225,304,7840,304,42160,149,83,11867,83,16085
113.161,6,32,8952,14,158,8704,267,1357,18,624,6654,1400,7595
0.093,17,2,245,1,32,0,32,60,1,157,0,157,185
109.475,17,8,2688,8,308,15639,308,2688,0,0,0,0,0
280.329,6,30,7432,13,158,23360,267,1317,17,543,17516,1400,6115
1744.905,6,114,8463,70,38,25288,205,4902,44,32,40572,98,3561
7.342,17,41,13952,12,322,666,1350,4204,29,308,260,1350,9748
1187.106,1,10,815,10,53,131900,78,815,0,0,0,0,0
0.488,6,53,21705,30,1016,16,1380,16498,23,387,20,1923,5207
131.456,6,1015,510745,570,833,231,1152,488154,445,435,295,1179,22591
27.727,6,3179,3047849,1999,1443,13,1448,2979181,1180,776,23,1448,68668
1790.731,1,228,12768,228,28,7888,28,12768,0,0,0,0,0
1741.442,6,95,6929,63,31,28087,31,4273,32,31,56173,31,2656
300.744,6,39,9967,21,593,15037,1360,4445,18,399,505,1360,5522
1781.761,6,375,26108,217,98,8248,469,15303,158,69,11348,69,10805
240.252,6,57,20121,29,820,8580,1418,17111,28,193,8897,580,3010
4.132,6,10,1102,6,483,826,483,803,4,83,1375,83,299
1.07,6,31,12412,16,525,71,1440,3298,15,850,64,1440,9114
1773.453,6,180,15480,120,69,14902,69,8940,60,69,30056,69,6540
8.286,6,30,8342,14,256,637,721,1845,16,585,464,1420,6497
542.167,1,8,448,8,28,77452,28,448,0,0,0,0,0
1785.874,6,379,26737,217,103,8267,469,15841,162,69,11092,69,10896
8.901,6,740,650350,471,1311,18,1368,631698,269,776,32,1473,18652
1772.007,6,182,15629,121,69,14766,69,8980,61,69,29530,69,6649
6.099,17,274,173957,272,611,22,1472,173877,2,12,5004,12,80
1.368,6,50,19198,27,885,52,1360,13502,23,433,52,1360,5696
1.929,17,3,1173,3,363,964,363,1173,0,0,0,0,0
296.406,1,4,326,4,53,98802,78,326,0,0,0,0,0
196.732,17,4,240,2,32,196731,32,120,2,32,196731,32,120
1796.637,17,448,39896,403,35,4469,288,25676,45,288,40016,288,14220
1.469,6,39,8363,21,321,73,1164,2822,18,437,74,2715,5541
1.859,6,45,18869,26,943,74,1460,13333,19,529,90,4075,5536
489.03,1,10,560,10,28,54336,28,560,0,0,0,0,0
23.587,17,4,352,2,60,23586,60,176,2,60,23586,60,176
2.863,17,4,624,4,128,954,128,624,0,0,0,0,0
15.528,17,19,12098,11,882,1545,1350,10010,8,233,2207,1350,2088
0.235,6,10,1379,5,145,58,145,349,5,826,35,826,1030
1799.996,17,141,11276,71,48,25714,48,5396,70,56,25725,56,5880
0.21,17,2,180,1,30,0,30,58,1,94,0,94,122
2.937,17,15,8422,8,705,419,1350,5870,7,336,479,1350,2552
0.012,6,2,116,1,0,0,0,64,1,0,0,0,52
280.406,6,30,7432,13,158,23367,267,1317,17,543,17521,1400,6115
236.068,1,8,448,8,28,33724,28,448,0,0,0,0,0
0.975,6,29,8524,15,222,58,540,1988,14,852,60,1360,6536
8.18,6,1659,1544499,1060,1380,7,1408,1508687,599,931,13,2816,35812
4.571,6,5,260,2,0,4276,0,104,3,0,2151,0,156
61.319,6,47,9081,21,107,3065,267,2247,26,340,2406,3417,6834
32.938,6,31,7854,17,461,2058,1408,5502,14,230,2520,580,2352
1796.86,1,345,28980,345,56,5223,56,28980,0,0,0,0,0
4.953,6,37,7189,19,218,275,314,3383,18,513,276,1179,3806
0.853,6,11,1727,7,100,142,100,384,4,589,202,1152,1343
0.015,17,2,417,1,34,0,34,62,1,327,0,327,355
1796.901,17,448,39896,403,35,4469,288,25676,45,288,40015,288,14220
255.672,6,18,7844,3,106,1918,106,234,15,635,18261,1460,7610
0.116,6,9,1002,5,213,29,213,417,4,421,35,421,585
5.834,6,43,7429,23,201,265,314,3543,20,513,293,1179,3886
1773.607,6,184,15778,122,69,14657,69,9158,62,69,29071,69,6620
137.327,17,4,1344,4,308,45775,308,1344,0,0,0,0,0
51.138,6,43,9836,22,642,464,1360,4149,21,371,2547,1360,5687
1781.352,17,44,14784,44,308,41426,308,14784,0,0,0,0,0
1786.629,6,102,8296,68,65,26666,65,4930,34,59,54137,59,3366
1795.681,17,447,39864,402,35,4478,288,25644,45,288,40019,288,14220
1787.311,6,102,8296,68,65,26676,65,4930,34,59,54158,59,3366
9.214,6,67,26250,34,873,279,1380,20588,33,467,286,1924,5662
5.534,6,40,7325,20,218,291,314,3423,20,442,277,1152,3902
2.977,6,55,29908,31,949,99,1360,11857,24,1313,123,4727,18051
18.34,6,21,3585,13,211,1528,211,1178,8,665,2619,904,2407
1684.851,17,16,4232,8,30,240691,30,464,8,443,240691,463,3768
5.78,6,41,7365,21,218,289,314,3463,20,442,290,1152,3902
240.359,6,44,8447,22,449,11445,1418,5648,22,205,11444,580,2799
1.228,6,28,7647,15,108,87,147,1039,13,760,101,1581,6608
0.26,6,14,4824,9,290,32,517,1057,5,1166,51,1517,3767
1770.722,6,99,9306,66,66,27241,66,5610,33,60,55332,60,3696
0.531,17,2,167,1,39,0,39,67,1,72,0,72,100
284.689,6,70,15524,34,789,8626,1418,11300,36,89,8133,580,4224
0.128,6,2,100,1,0,0,0,60,1,0,0,0,40
280.2,6,28,7352,12,158,25472,267,1277,16,603,18678,1400,6075
0.05,17,4,284,2,32,1,32,120,2,54,2,60,164
0.31,6,26,7074,12,156,28,267,1272,14,523,23,2840,5802
177.342,6,219,174230,140,1286,1275,1408,157817,79,683,1981,2439,16413
0.509,6,50,20419,27,1008,19,1380,15257,23,421,20,1923,5162
258.905,1,10,840,10,56,28767,56,840,0,0,0,0,0
1681.433,17,14,1036,7,30,280235,30,406,7,62,280234,62,630
7.902,6,1904,1605041,1041,1439,7,1448,1544531,863,792,8,1448,60510
0.305,17,2,180,1,30,0,30,58,1,94,0,94,122
1.671,6,74,53557,46,1251,37,1408,46196,28,842,55,1408,7361
0.43,6,5,1564,3,413,215,413,946,2,269,180,269,618
491.248,6,64,8582,37,134,13645,721,4491,27,167,15701,1448,4091
1740.45,17,28,6468,28,203,64461,203,6468,0,0,0,0,0
1773.652,6,181,15589,121,69,14780,69,9049,60,69,30058,69,6540
6.21,6,38,7229,20,218,326,314,3423,18,513,349,1179,3806
12.596,6,25,4850,12,204,1128,722,1656,13,502,1034,1402,3194
0.884,6,10,1687,7,100,147,100,384,3,1179,313,1179,1303
1772.739,6,180,15480,120,69,14896,69,8940,60,69,30040,69,6540
281.406,6,31,7813,14,158,21646,267,1357,17,577,17583,2036,6456
185.944,17,21,1596,21,48,9297,48,1596,0,0,0,0,0
1793.226,6,461,26720,253,69,7115,69,14260,208,34,8662,64,12460
1744.501,6,117,11390,74,91,23897,205,7791,43,31,41527,33,3599
10.607,6,1734,1463995,1013,1387,10,1420,1430898,721,420,14,1420,33097
4.175,17,4,268,4,39,1391,39,268,0,0,0,0,0
1772.461,6,180,15480,120,69,14894,69,8940,60,69,30035,69,6540
1773.028,6,180,15480,120,69,14899,69,8940,60,69,30042,69,6540
281.419,6,31,7813,13,158,23451,267,1317,18,524,16526,1400,6496
0.129,17,2,263,1,36,0,36,64,1,171,0,171,199
0.356,6,14,1733,7,288,58,288,588,7,284,32,434,1145
42.535,17,12,912,12,48,3866,48,912,0,0,0,0,0
3.97,17,4,244,4,33,1323,33,244,0,0,0,0,0
1682.682,17,16,1265,8,30,240376,37,471,8,71,240379,136,794
240.354,6,43,9035,21,524,12017,1418,5818,22,229,11444,639,3217
280.199,6,28,7352,13,158,23349,267,1317,15,678,20012,3436,6035
131.883,6,28,14040,16,858,71,1360,5823,12,1287,11973,2720,8217
1622.581,1,7,392,7,28,270430,28,392,0,0,0,0,0
369.516,6,18,1242,14,180,28424,180,916,4,110,20064,110,326
818.746,1,10,560,10,28,90971,28,560,0,0,0,0,0
5.573,6,566,531995,377,1349,14,1368,517491,189,665,28,1368,14504
3.281,17,25,10713,11,306,320,1350,3684,14,474,249,1350,7029
0.587,6,27,7296,13,155,48,267,1301,14,603,39,2036,5995
16.317,17,22,10169,11,624,1631,1350,7177,11,244,1615,1350,2992
615.828,6,119,22852,52,284,12075,1360,10765,67,195,9328,1360,12087
2.686,6,32,9193,19,250,149,591,1765,13,863,207,1380,7428
368.935,6,49,13457,31,444,12297,1360,7935,18,435,506,2667,5522
706.887,1,8,448,8,28,100983,28,448,0,0,0,0,0
2.977,6,2,88,2,0,0,0,88,0,0,0,0,0
340.407,17,6,2000,6,305,68081,308,2000,0,0,0,0,0
1771.633,6,99,9306,66,66,27255,66,5610,33,60,55360,60,3696
1792.03,1,342,28728,342,56,5255,56,28728,0,0,0,0,0
3.825,6,39,13124,21,196,170,540,2297,18,1009,196,1591,10827
217.177,6,194,31330,109,304,2010,304,21932,85,83,2573,83,9398
11.615,6,1885,1604695,1131,1364,10,1380,1570293,754,421,15,1923,34402
26.253,6,38,8414,17,175,1640,722,2090,21,548,1289,1380,6324
79.281,6,13,1028,4,226,269,226,442,9,110,9887,110,586
2.488,6,13,2311,8,188,355,245,700,5,1407,559,1407,1611
1772.082,6,113,6830,63,27,28581,27,3747,50,27,36163,27,3083
1744.589,2,27,864,27,8,67099,8,864,0,0,0,0,0
1.002,17,2,925,1,548,0,548,576,1,321,0,321,349
44.771,6,37,10226,19,782,502,1360,4704,18,435,2620,2667,5522
0.475,6,50,20843,28,969,17,1380,15721,22,421,20,1923,5122
0.303,17,4,314,2,31,0,31,118,2,70,0,70,196
1787.341,6,102,8296,68,65,26676,65,4930,34,59,54157,59,3366
0.078,6,10,767,5,186,13,186,454,5,45,19,45,313
1791.151,17,179,13962,179,50,10062,50,13962,0,0,0,0,0
7.468,17,3,228,3,48,3734,48,228,0,0,0,0,0
181.802,17,4,352,2,60,181801,60,176,2,60,181801,60,176
300.742,6,44,9072,17,308,18787,889,1991,27,285,11561,1360,7081
1786.442,6,102,8296,68,65,26663,65,4930,34,59,54131,59,3366
41.983,6,15,1898,5,302,9668,302,872,10,83,4663,83,1026
33.577,6,31,5093,15,154,2398,722,1858,16,342,2226,1440,3235
363.167,6,18,1242,14,180,27935,180,916,4,110,20055,110,326
0.189,17,2,152,1,48,0,48,76,1,48,0,48,76
300.177,6,86,14680,41,317,7504,1408,7530,45,208,6822,1408,7150
1793.089,17,142,11360,71,48,25614,48,5396,71,56,25613,56,5964
292.511,17,4,352,2,60,292510,60,176,2,60,292510,60,176
1.339,6,25,8056,12,164,104,267,1288,13,869,95,1408,6768
1783.93,6,107,8624,68,66,26625,66,4964,39,60,46943,60,3660
2.413,17,2,152,1,48,0,48,76,1,48,0,48,76
43.644,6,29,7392,13,158,3637,267,1317,16,603,2907,2800,6075
230.6,6,10,2400,6,323,46120,413,1533,4,176,76784,269,867
34.746,6,34,6095,16,180,2304,722,1935,18,357,2032,2026,4160
0.509,6,17,4981,10,290,56,517,1109,7,875,82,1418,3872
0.163,6,27,7296,14,155,12,267,1341,13,678,12,3436,5955
1791.565,6,362,22898,210,69,8572,69,12678,152,69,11864,69,10220
1787.261,6,104,8376,68,65,26675,65,4930,36,59,51051,59,3446
1772.213,6,181,15589,120,69,14892,69,8940,61,69,29532,69,6649
0.035,6,10,1755,5,657,8,657,925,5,562,8,562,830
101.028,6,103,73083,64,1241,1603,1408,62918,39,677,2046,1408,10165
1784.949,6,360,24156,210,88,8540,469,13878,150,69,11977,69,10278
1770.703,6,104,10555,68,87,26428,798,6512,36,63,50588,191,4043
0.076,17,4,2876,2,689,76,1350,1434,2,693,42,1350,1442
148.332,6,26,7117,12,156,36,267,1272,14,527,11409,3417,5845
0.84,6,20,5948,11,281,84,544,1288,9,716,93,1420,4660
6.979,6,58,24171,28,870,258,1460,13344,30,506,224,4075,10827
1772.073,6,180,15480,120,69,14891,69,8940,60,69,30032,69,6540
0.035,17,2,152,2,48,35,48,152,0,0,0,0,0
7.675,6,1300,1162864,782,1407,9,1448,1131264,518,776,14,1448,31600
1729.207,6,69,4956,42,33,42175,33,2889,27,31,66500,31,2067
6.788,6,1609,1391933,907,1439,7,1448,1342349,702,776,9,1448,49584
1798.609,6,367,25650,214,99,8444,469,15045,153,69,11832,69,10605
1791.174,6,359,22709,209,69,8611,69,12569,150,69,12021,69,10140
1318.433,2,12,384,12,8,119857,8,384,0,0,0,0,0
1775.105,17,142,11360,71,48,25358,48,5396,71,56,25358,56,5964
1799.747,6,355,33947,173,486,10463,841,13348,182,64,9939,1418,20599
1116.421,6,66,5233,43,64,26581,64,3064,23,56,50742,58,2169
2.75,6,2,88,2,0,0,0,88,0,0,0,0,0
1786.445,6,114,11904,72,134,25161,1290,7704,42,70,43569,240,4200
1.39,6,50,19413,27,900,53,1460,13717,23,433,55,1460,5696
1670.071,1,7,392,7,28,278345,28,392,0,0,0,0,0
0.962,6,153,115527,92,1313,10,1432,108796,61,427,15,1432,6731
6.286,6,18,2761,11,125,628,245,1070,7,1407,1000,1407,1691
1.096,6,24,8004,12,164,85,267,1288,12,1014,85,2816,6716
1774.941,1,58,4872,58,56,31139,56,4872,0,0,0,0,0
1779.177,6,180,15480,120,69,14951,69,8940,60,69,30153,69,6540
0.171,17,2,308,1,34,0,34,62,1,218,0,218,246
1740.984,1,15,840,15,28,124356,28,840,0,0,0,0,0
1.24,6,50,13809,24,549,53,1429,4860,26,464,48,1986,8949
326.57,17,6,422,3,42,163284,47,211,3,42,163284,47,211
254.64,6,7,328,2,0,254640,0,88,5,0,3902,0,240
1771.83,6,99,9306,66,66,27258,66,5610,33,60,55366,60,3696
0.034,17,2,244,1,43,0,43,71,1,145,0,145,173
0.026,17,2,368,1,37,0,37,65,1,275,0,275,303
112.55,6,9,522,2,106,112540,106,194,7,0,18756,0,328
0.105,6,9,1340,5,145,26,145,349,4,827,26,827,991
0.094,6,9,1340,5,145,23,145,349,4,827,19,827,991
1754.346,6,112,8162,68,31,26184,31,4648,44,31,40798,31,3514
300.701,6,43,8983,17,315,18785,916,1974,26,297,12022,1360,7009
1742.7,6,104,7550,66,31,26810,31,4503,38,31,47099,31,3047
203.968,17,3,522,3,146,101984,346,522,0,0,0,0,0
1793.078,17,180,11520,180,36,10017,36,11520,0,0,0,0,0
5.721,6,39,7269,21,218,286,314,3463,18,513,321,1179,3806
1681.215,17,16,4213,8,30,240173,37,471,8,439,240173,463,3742
1793.435,17,140,11200,70,48,25991,48,5320,70,56,25991,56,5880
1795.321,17,80,3354,79,14,23016,14,3318,1,8,0,8,36
280.038,6,26,7272,12,158,25458,267,1277,14,775,21538,2800,5995
1792.615,17,172,11008,172,36,10483,36,11008,0,0,0,0,0
1787.91,6,356,22520,208,69,8637,69,12460,148,69,12162,69,10060
245.305,6,50,13104,26,512,9811,1408,5974,24,531,10665,1408,7130
278.331,1,4,326,4,53,92777,78,326,0,0,0,0,0
1796.974,1,58,4872,58,56,31525,56,4872,0,0,0,0,0
1795.48,6,158,20774,93,304,19515,304,14868,65,83,28053,83,5906
63.956,6,35,9038,15,327,207,1189,2575,20,471,3365,1420,6463
11.594,6,25,8453,13,275,966,275,1078,12,983,758,1420,7375
1621.4,1,7,392,7,28,270233,28,392,0,0,0,0,0
14.267,17,2,144,2,44,14267,44,144,0,0,0,0,0
0.872,6,10,1687,7,100,145,100,384,3,1179,311,1179,1303
28.332,17,34,11391,16,426,1886,1350,7270,18,200,1664,1350,4121
0.788,6,22,7315,13,261,65,602,1991,9,1209,95,1946,5324
0.56,6,13,3939,7,171,83,171,714,6,1446,102,2675,3225
0.005,17,2,319,1,31,0,31,59,1,232,0,232,260
373.867,6,19,1303,14,177,28759,177,925,5,110,17881,110,378
0.023,6,11,912,6,181,4,181,489,5,77,4,134,423
1787.154,6,104,8376,68,65,26673,65,4930,36,59,51057,59,3446
1787.215,1,59,4956,59,56,30814,56,4956,0,0,0,0,0
10.157,6,883,814309,577,1339,17,1368,792105,306,776,32,1473,22204
1791.142,6,371,25879,214,99,8409,469,15114,157,69,11481,69,10765
4.458,6,37,7205,19,218,247,314,3383,18,516,246,1179,3822
11.65,6,1722,1605378,1135,1364,10,1420,1577490,587,483,19,3303,27888
1796.3,1,58,4872,0,0,0,0,0,58,56,31514,56,4872
1772.398,6,181,15589,120,69,14894,69,8940,61,69,29533,69,6649
0.081,6,2,80,1,0,0,0,40,1,0,0,0,40
61.473,6,12,3153,12,252,5588,281,3153,0,0,0,0,0
72.423,6,32,14213,16,894,103,1460,6037,16,836,4816,1460,8176
369.517,6,27,1767,18,177,21736,177,1181,9,110,9209,110,586
1743.916,6,101,7912,65,45,27248,205,4844,36,35,49806,98,3068
0.01,17,2,375,1,51,0,51,79,1,268,0,268,296
1.3,6,25,8056,12,164,101,267,1288,13,869,92,1448,6768
173.753,6,22,9783,12,410,53,922,1742,10,1271,19291,4416,8041
1.679,17,23,7944,9,273,209,1350,2716,14,345,120,1350,5228
0.05,17,2,306,1,33,0,33,61,1,217,0,217,245
1786.518,17,87,3648,86,14,21017,14,3612,1,8,0,8,36
0.996,17,2,677,1,300,0,300,328,1,321,0,321,349
21.571,17,4,352,2,60,21569,60,176,2,60,21570,60,176
894.592,6,12,728,8,31,127798,31,444,4,31,298188,31,284
0.075,17,2,2386,2,1165,75,1165,2386,0,0,0,0,0
0.327,6,24,5980,12,164,29,453,1442,12,651,27,1448,4538
284.173,6,42,11547,20,149,14956,267,1702,22,597,13525,1400,9845
2.988,17,2,1430,2,687,2988,687,1430,0,0,0,0,0
125.414,6,20,4186,9,407,15676,722,1278,11,291,12521,1448,2908
8.018,17,3,228,3,48,4009,48,228,0,0,0,0,0
1.395,6,31,6467,15,164,99,267,1922,16,780,83,1460,4545
12.927,6,1789,1676463,1178,1370,10,1380,1644889,611,383,21,1380,31574
1770.813,6,105,9690,68,64,26430,64,5724,37,58,49186,58,3966
0.071,17,2,219,1,50,0,50,78,1,113,0,113,141
1.985,17,4,314,2,31,1951,31,118,2,70,1954,70,196
1782.972,17,142,11360,71,48,25470,48,5396,71,56,25470,56,5964
0.761,17,2,167,1,39,0,39,67,1,72,0,72,100
0.495,17,4,314,2,31,292,31,118,2,70,0,70,196
1.3,6,25,8056,12,164,101,267,1288,13,869,90,1448,6768
1798.293,17,448,39896,403,35,4473,288,25676,45,288,40022,288,14220
4.359,6,38,7229,19,218,242,314,3383,19,440,228,1152,3846
301.098,6,48,18425,26,1061,12043,1460,12743,22,399,422,1460,5682
1680.202,1,8,448,8,28,240028,28,448,0,0,0,0,0
0.012,17,4,384,2,36,0,36,128,2,100,0,106,256
280.494,6,27,7312,12,158,25499,267,1277,15,775,20032,3465,6035
1787.118,6,356,22520,208,69,8633,69,12460,148,69,12157,69,10060
240.226,6,61,21085,30,857,8283,1418,17859,31,200,8007,580,3226
0.008,17,2,128,1,36,0,36,64,1,36,0,36,64
1761.145,17,278,61423,278,192,6357,422,61423,0,0,0,0,0
1.261,6,6,340,3,0,630,0,160,3,0,514,0,180
1700.63,17,13,534,11,14,170045,14,462,2,8,1700460,8,72
20.136,6,17,4370,8,263,2876,722,1467,9,607,2476,1448,2903
1.893,17,2,134,2,39,1893,39,134,0,0,0,0,0
0.008,17,2,394,1,37,0,37,65,1,301,0,301,329
1741.079,6,87,6322,58,31,30545,31,3915,29,31,62180,31,2407
1383.705,2,13,416,13,8,115308,8,416,0,0,0,0,0
18.079,6,9,527,5,43,4519,43,311,4,0,6020,0,216
1.592,1,20,560,20,0,0,0,560,0,0,0,0,0
33.733,6,30,5044,15,154,2409,722,1860,15,400,2396,1448,3184
17.72,6,23,5096,7,256,2953,722,1384,16,261,1167,1408,3712
69.171,6,30,8778,16,434,4611,659,2190,14,650,5159,2688,6588
1791.332,17,87,3648,86,14,21074,14,3612,1,8,0,8,36
0.256,6,37,8848,18,277,15,517,1863,19,477,13,1432,6985
9.035,6,24,7596,12,402,821,721,1690,12,774,675,2840,5906
1.185,6,10,1687,7,100,197,100,384,3,1179,469,1179,1303
1772.04,6,180,15480,120,69,14891,69,8940,60,69,30034,69,6540
233.076,6,29,7392,13,158,19423,267,1317,16,603,15536,1400,6075
1796.092,6,350,29922,204,93,8847,469,14493,146,134,12386,4837,15429
0.038,17,2,283,1,31,0,31,59,1,196,0,196,224
1788.986,6,366,25472,212,100,8478,469,14896,154,69,11689,69,10576
27.456,6,450,449886,295,146,93,228,16235,155,2799,67,16896,433651
1.478,6,58,18034,29,707,52,1360,8965,29,438,52,1360,9069
11.8,17,8,608,8,48,1685,48,608,0,0,0,0,0
1797.263,1,345,28980,345,56,5224,56,28980,0,0,0,0,0
96.423,17,4,352,2,60,96422,60,176,2,60,96422,60,176
1775.295,1,56,4704,0,0,0,0,0,56,56,32278,56,4704
36.153,17,4,304,4,48,12051,48,304,0,0,0,0,0
1739.332,1,58,4872,58,56,30514,56,4872,0,0,0,0,0
1740.494,17,30,7050,30,207,60017,207,7050,0,0,0,0,0
302.779,6,61,26989,35,1082,8905,1360,20918,26,358,421,1360,6071
0.197,1,2,112,2,28,197,28,112,0,0,0,0,0
154.73,6,19,772,7,0,8198,0,284,12,0,14065,0,488
1770.76,6,101,9410,66,66,27242,66,5610,35,60,52078,60,3800
10.919,6,20,7026,11,275,1091,275,998,9,1414,764,1414,6028
0.001,6,3,1666,1,0,0,0,40,2,773,0,1460,1626
1779.743,6,102,8296,68,65,26563,65,4930,34,59,53928,59,3366
1.614,6,24,8725,15,285,115,588,1460,9,1150,180,2756,7265
2.518,17,2,136,1,32,0,32,60,1,48,0,48,76
0.104,17,2,152,1,48,0,48,76,1,48,0,48,76
8.686,6,1363,1206340,832,1370,10,1408,1174064,531,931,16,2801,32276
1782.818,17,177,13806,177,50,10129,50,13806,0,0,0,0,0
300.633,6,37,8378,19,278,16701,734,1905,18,441,498,1440,6473
139.525,17,15,1140,15,48,9966,48,1140,0,0,0,0,0
33.413,6,9,396,2,0,2943,0,88,7,0,5554,0,308
192.396,6,27,9084,7,154,32066,267,752,20,501,10124,1420,8332
2.036,17,25,18636,11,670,202,1350,7688,14,754,153,1350,10948
484.371,6,89,6246,44,73,11264,138,2933,45,65,11008,69,3313
20.16,6,24,6232,14,117,1550,159,1337,10,727,2238,1402,4895
299.94,17,5,1920,5,356,74985,356,1920,0,0,0,0,0
3.912,6,13,3086,7,92,652,92,452,6,579,43,1408,2634
192.982,17,4,240,2,32,192980,32,120,2,32,192981,32,120
108.312,6,72,47424,44,1191,2518,1408,39234,28,960,2284,3847,8190
317.755,6,104,35696,55,547,5884,1360,24707,49,322,6616,2720,10989
4.18,6,22,6410,10,262,456,517,1316,12,744,372,1368,5094
0.24,6,3,453,2,241,240,241,321,1,92,0,92,132
72.239,6,42,8815,20,378,744,787,2026,22,368,3433,3488,6789
1792.08,6,365,23087,211,69,8533,69,12787,154,69,11710,69,10300
139.235,6,32,7814,10,185,420,267,1344,22,348,6629,1460,6470
0.12,17,2,672,2,308,120,308,672,0,0,0,0,0
0.097,2,2,64,2,8,97,8,64,0,0,0,0,0
1385.736,2,11,352,11,8,138573,8,352,0,0,0,0,0
1791.67,17,144,11520,72,48,25234,48,5472,72,56,25234,56,6048
1798.904,17,448,39896,403,35,4474,288,25676,45,288,40018,288,14220
1786.85,6,102,8296,68,65,26669,65,4930,34,59,54143,59,3366
0.202,6,22,4467,12,165,18,456,1446,10,415,21,888,3021
296.859,1,4,224,4,28,98953,28,224,0,0,0,0,0
1.668,6,40,8425,21,320,83,1162,2844,19,437,81,2715,5581
240.483,6,59,24953,26,548,9618,1418,6299,33,846,7514,1418,18654
1747.162,6,90,14796,53,115,33599,1440,5562,37,269,48525,1440,9234
1239.02,17,14,1117,7,31,206498,37,413,7,72,206495,136,704
0.176,17,2,152,1,48,0,48,76,1,48,0,48,76
108.539,6,30,13476,15,488,339,1360,3075,15,1087,7741,2720,10401
0.04,17,2,334,1,39,0,39,67,1,239,0,239,267
1773.529,6,181,15589,120,69,14903,69,8940,61,69,29552,69,6649
1745.234,17,289,56280,289,166,6059,358,56280,0,0,0,0,0
1787.065,6,104,8444,68,66,26672,66,4964,36,60,51054,60,3480
0.093,6,5,260,0,0,0,0,0,5,0,0,0,260
1680.376,1,15,870,15,30,120026,30,870,0,0,0,0,0
1.064,6,2,120,2,0,0,0,120,0,0,0,0,0
0.051,6,35,19229,18,127,2,127,1071,17,1328,3,1448,18158
1772.911,6,180,15480,120,69,14898,69,8940,60,69,30041,69,6540
0.426,17,5,1696,5,311,106,354,1696,0,0,0,0,0
0.087,17,2,517,1,34,0,34,62,1,427,0,427,455
0.035,17,2,176,1,60,0,60,88,1,60,0,60,88
1.337,6,38,9848,20,502,70,1440,4352,18,433,67,1440,5496
1.128,6,27,9624,13,164,80,267,1396,14,936,73,1408,8228
11.963,6,1738,1632728,1152,1368,10,1432,1604632,586,389,20,1432,28096
1773.174,6,180,15480,120,69,14900,69,8940,60,69,30051,69,6540
0.173,17,2,214,1,39,0,39,67,1,119,0,119,147
20.131,6,22,5470,12,107,1830,159,1074,10,773,2236,1408,4396
98.411,17,2,146,2,45,98411,45,146,0,0,0,0,0
1744.271,6,145,9134,78,49,22652,208,5524,67,31,26423,31,3610
0.616,17,5,1740,5,320,154,355,1740,0,0,0,0,0
1.323,6,10,1687,7,100,220,100,384,3,1179,537,1179,1303
634.8,6,50,6995,26,115,19667,501,2430,24,171,27595,1420,4565
3.495,6,23,3545,13,167,291,293,1530,10,537,359,1179,2015
1.391,2,2,64,2,8,1391,8,64,0,0,0,0,0
0.928,6,16,4459,10,327,102,634,1836,6,767,183,1328,2623
79.417,6,18,1324,10,39,8823,39,559,8,49,11345,63,765
69.551,6,25,6757,12,181,6322,267,1212,13,717,5794,2036,5545
260.417,6,30,7432,14,158,20032,267,1357,16,603,17356,2800,6075
1636.91,1,8,848,8,78,233844,78,848,0,0,0,0,0
0.055,6,10,584,5,44,13,44,312,5,0,10,0,272
0.014,17,4,759,2,32,0,32,120,2,291,4,303,639
38.633,17,22,1672,22,48,1839,48,1672,0,0,0,0,0
0.374,6,27,9047,13,252,31,647,1692,14,945,25,1408,7355
1.055,17,31,18065,16,889,70,1350,14686,15,197,59,1350,3379
50.439,6,30,7297,14,155,3879,267,1346,16,441,3362,1420,5951
0.515,6,2,821,0,0,0,0,0,2,741,515,741,821
0.008,6,4,4516,1,0,0,0,40,3,1440,0,1440,4476
0.023,17,2,904,1,548,0,548,576,1,300,0,300,328
329.244,1,20,1680,20,56,17328,56,1680,0,0,0,0,0
2.534,6,60,25620,33,1017,79,1460,19671,27,400,88,1460,5949
280.208,6,29,7392,13,158,23350,267,1317,16,603,18679,2800,6075
1734.743,6,128,12965,66,64,26687,517,4736,62,191,28437,1418,8229
1.206,6,24,8028,12,164,93,267,1312,12,1014,93,2411,6716
0.334,17,2,179,1,43,0,43,71,1,80,0,80,108
0.271,6,3,207,2,0,271,0,104,1,51,0,51,103
1794.499,17,144,11520,72,48,25274,48,5472,72,56,25274,56,6048
4.553,17,11,929,6,47,864,47,450,5,67,456,75,479
11.55,17,59,19076,25,309,479,1350,8436,34,284,348,1350,10640
9.013,6,21,6601,9,275,1126,275,643,12,683,725,1380,5958
3.983,17,3,180,3,32,1991,32,180,0,0,0,0,0
1794.203,17,142,11360,71,48,25631,48,5396,71,56,25631,56,5964
9.274,6,35,8485,18,339,545,703,1771,17,501,566,1928,6714
660.227,2,4,128,4,8,220075,8,128,0,0,0,0,0
0.183,6,3,175,2,31,12,31,135,1,0,0,0,40
1784.709,17,138,11040,69,48,26245,48,5244,69,56,26245,56,5796
1.803,6,35,10382,17,135,112,267,1497,18,906,101,1420,8885
629.998,1,18,3423,18,162,37058,293,3423,0,0,0,0,0
23.137,6,3604,3379113,2328,1373,9,1408,3306680,1276,864,18,1408,72433
5.4,6,15,2108,7,120,899,197,890,8,445,771,799,1218
6.041,6,1382,1274213,873,1384,6,1408,1243081,509,931,11,2801,31132
1.222,6,53,20815,30,922,42,1360,15074,23,400,48,1360,5741
18.555,6,165,65728,87,705,215,1152,58499,78,456,237,1179,7229
1771.93,1,67,5628,67,56,26847,56,5628,0,0,0,0,0
1786.724,17,87,3648,86,14,21020,14,3612,1,8,0,8,36
1741.462,17,29,30624,29,1028,62195,1028,30624,0,0,0,0,0
1799.012,17,448,39896,403,35,4475,288,25676,45,288,40022,288,14220
1795.275,17,448,39612,404,35,4454,288,25708,44,288,40020,288,13904
18.263,17,6,456,6,48,3652,48,456,0,0,0,0,0
293.983,6,28,6566,11,220,6238,517,1327,17,325,18368,1452,5239
1774.452,17,140,11200,70,48,25716,48,5320,70,56,25716,56,5880
1788.352,17,87,3648,86,14,21039,14,3612,1,8,0,8,36
280.688,6,29,8037,12,158,25517,267,1277,17,607,17540,1400,6760
41.199,17,4,240,2,32,41198,32,120,2,32,41197,32,120
1750.69,17,12,498,11,14,175069,14,462,1,8,0,8,36
0.277,6,24,4571,12,165,25,456,1446,12,415,23,888,3125
13.15,6,1022,1010232,708,1357,18,1368,986968,314,776,41,1473,23264
1.409,6,24,8004,12,164,109,267,1288,12,1014,110,2491,6716
3.364,17,5,340,5,40,841,40,340,0,0,0,0,0
1.243,6,8,342,4,0,414,0,164,4,7,269,7,178
315.99,6,111,36044,59,522,5448,1360,24889,52,312,6192,3289,11155
3.985,17,4,240,4,32,1328,32,240,0,0,0,0,0
1747.8,6,124,16301,77,89,22997,267,7040,47,175,17798,1460,9261
1561.45,1,68,3808,68,28,23305,28,3808,0,0,0,0,0
317.051,6,73,19231,38,325,8568,1360,9712,35,368,9320,3289,9519
0.02,17,2,308,1,34,0,34,62,1,218,0,218,246
0.014,17,2,375,1,44,0,44,72,1,275,0,275,303
1681.646,1,15,840,15,28,120117,28,840,0,0,0,0,0
42.492,1,2,716,2,330,42492,336,716,0,0,0,0,0
1.689,6,50,21125,27,922,64,1360,14069,23,510,68,1360,7056
38.001,1,44,4576,0,0,0,0,0,44,76,883,76,4576
2.164,17,3,1167,3,361,1082,361,1167,0,0,0,0,0
155.051,17,4,352,2,60,155050,60,176,2,60,155050,60,176
328.247,1,6,336,6,28,65649,28,336,0,0,0,0,0
0.003,1,2,636,2,290,3,290,636,0,0,0,0,0
1795.081,1,152,8512,152,28,11887,28,8512,0,0,0,0,0
0.108,17,2,166,1,39,0,39,67,1,71,0,71,99
0.138,6,44,20577,26,1041,5,1420,15636,18,467,7,1883,4941
167.166,6,30,13476,16,488,333,1360,3115,14,1223,12849,2720,10361
241.582,6,54,6783,24,182,10502,585,3282,30,147,8329,580,3501
6.416,6,45,8409,23,227,291,314,4102,22,489,293,1179,4307
7.236,6,42,7405,23,218,328,314,3543,19,516,387,1179,3862
1787.908,1,234,13104,234,28,7673,28,13104,0,0,0,0,0
0.017,17,4,308,2,33,1,33,122,2,65,0,65,186
1793.471,17,180,11520,180,36,10019,36,11520,0,0,0,0,0
0.194,17,2,166,1,47,0,47,75,1,63,0,63,91
1234.569,6,250,18044,138,92,8289,693,9309,112,81,11122,421,8735
241.516,6,45,8900,21,248,12075,582,2889,24,432,10500,1279,6011
1.373,6,25,8056,12,164,107,267,1288,13,1014,96,2491,6768
60.265,6,8,432,5,0,15066,0,268,3,0,30020,0,164
1796.244,17,448,39896,403,35,4468,288,25676,45,288,40019,288,14220
11.556,6,21,6825,12,275,1050,275,1038,9,1353,815,1440,5787
0.201,17,2,172,1,50,0,50,78,1,66,0,66,94
82.691,6,34,7832,11,155,8269,267,1226,23,315,3757,1452,6606
10.117,6,1605,1402162,978,1382,10,1420,1372861,627,420,16,1420,29301
1.245,6,24,8004,12,164,96,267,1288,12,1014,96,2331,6716
0.937,17,2,176,2,60,937,60,176,0,0,0,0,0
1780.039,17,140,11200,70,48,25797,48,5320,70,56,25797,56,5880
280.449,6,30,7432,13,158,23370,267,1317,17,543,17524,1380,6115
395.372,6,23,1538,16,180,26358,180,1056,7,110,10499,110,482
41.496,6,18,744,10,0,4610,0,408,8,0,5099,0,336
10.772,6,20,4442,11,275,1077,275,998,9,768,741,1440,3444
1784.697,17,140,11200,70,48,25865,48,5320,70,56,25865,56,5880
280.181,6,29,7392,13,158,23348,267,1317,16,603,18676,2036,6075
0.344,6,22,5040,11,137,34,267,1132,11,692,33,1467,3908
3.065,17,4,842,2,47,3060,47,150,2,318,3060,318,692
1319.321,2,10,320,10,8,146591,8,320,0,0,0,0,0
0.182,6,30,14162,15,173,13,319,1480,15,1321,12,1627,12682
1746.015,6,95,7203,63,38,28161,205,4476,32,33,56310,98,2727
0.161,17,2,298,1,40,0,40,68,1,202,0,202,230
9.494,6,9,527,5,43,2373,43,311,4,0,3131,0,216
5.347,6,37,8481,19,401,297,889,2008,18,441,306,1360,6473
1735.192,6,82,5984,50,33,35412,33,3485,32,31,55968,31,2499
360.97,2,3,96,3,8,180485,8,96,0,0,0,0,0
1.564,6,50,19151,28,945,57,1460,13450,22,400,59,1460,5701
0.224,17,4,588,2,48,203,48,152,2,190,210,308,436
1624.395,2,19,608,19,8,90244,8,608,0,0,0,0,0
47.574,6,43,6526,22,214,2264,585,3146,21,206,2378,580,3380
0.182,17,2,1920,2,932,182,932,1920,0,0,0,0,0
15.358,6,24,6993,13,275,1279,275,1078,11,910,1034,1440,5915
19.341,6,3007,2883625,2000,1366,9,1408,2826597,1007,931,19,2801,57028
1781.148,17,142,11360,71,48,25444,48,5396,71,56,25444,56,5964
5.024,17,4,288,2,36,5006,36,128,2,52,5006,52,160
0.013,17,2,440,1,39,0,39,67,1,345,0,345,373
66.15,6,13,958,3,112,33075,112,240,10,90,7230,90,718
0.536,17,3,451,2,39,510,39,134,1,289,0,289,317
0.537,6,10,1689,5,288,91,288,556,5,432,90,446,1133
12.246,17,10,850,5,37,3060,37,325,5,77,3059,77,525
2.089,17,26,11342,10,438,232,1350,4661,16,389,111,1350,6681
4.947,6,29,12464,17,452,309,1360,2521,12,1350,438,2568,9943
0.4,6,12,1653,6,288,76,288,548,6,426,48,434,1105
0.05,17,2,401,1,34,0,34,62,1,311,0,311,339
1790.341,1,284,15904,284,28,6326,28,15904,0,0,0,0,0
31.459,17,7,604,4,48,10479,48,304,3,72,15721,72,300
1794.265,6,372,23574,213,69,8463,69,13005,159,69,11355,69,10569
1799.114,17,1070,359496,1070,307,1682,308,359496,0,0,0,0,0
1777.413,17,73,3060,72,14,25033,14,3024,1,8,0,8,36
42.354,17,46,6644,23,48,1924,48,1748,23,184,1924,308,4896
1795.304,17,449,39928,404,35,4454,288,25708,45,288,40019,288,14220
1772.489,6,180,15480,120,69,14894,69,8940,60,69,30039,69,6540
0.006,6,2,490,1,398,0,398,450,1,0,0,0,40
5.646,17,250,146925,248,564,22,1472,146845,2,12,4960,12,80
5.337,6,4,298,3,126,2383,126,258,1,0,0,0,40
1788.873,6,370,26708,216,111,8320,469,15994,154,69,11689,69,10714
1786.795,6,102,8296,68,65,26668,65,4930,34,59,54142,59,3366
1790.615,17,87,3648,86,14,21066,14,3612,1,8,0,8,36
0.009,6,4,196,2,0,9,0,92,2,0,2,0,104
1778.38,17,82,3438,81,14,22229,14,3402,1,8,0,8,36
0.031,17,2,2178,2,1061,31,1061,2178,0,0,0,0,0
175.641,6,23,8786,12,511,106,1194,2057,11,896,17547,1631,6729
0.024,17,4,276,3,33,0,33,183,1,65,0,65,93
0.005,17,3,388,2,30,0,30,116,1,244,0,244,272
1786.594,6,104,8308,68,64,26665,64,4896,36,58,51042,58,3412
1.414,6,40,9928,21,440,70,1360,4392,19,476,67,2720,5536
280.212,6,27,7312,12,158,25473,267,1277,15,678,20011,2800,6035
0.361,6,26,9012,14,252,27,646,1746,12,1105,31,2804,7266
51.404,6,46,12605,22,959,732,1360,6719,24,307,2226,1360,5886
3.814,6,40,9757,21,441,190,1164,4066,19,409,201,1440,5691
310.506,6,20,1379,13,177,25875,177,897,7,110,10396,110,482
10.44,6,33,10155,18,573,605,1360,3642,15,655,733,1360,6513
1.318,6,40,8403,21,321,65,1164,2822,19,437,63,2715,5581
20.27,17,26,8225,11,373,2023,1350,4418,15,225,1445,1350,3807
0.554,17,2,136,1,32,0,32,60,1,48,0,48,76
636.267,17,204,14102,198,40,3229,41,13595,6,56,0,57,507
40.84,17,11,836,11,48,4084,48,836,0,0,0,0,0
0.505,17,15,8539,8,705,72,1350,5869,7,353,73,1350,2670
9.534,6,79,24914,40,568,244,1152,19213,39,459,243,1179,5701
110.676,6,13249,12651396,8614,1389,12,1440,12405664,4635,776,23,1440,245732
3.492,17,5,295,5,31,873,31,295,0,0,0,0,0
0.037,6,3,327,2,103,0,138,287,1,0,0,0,40
17.96,6,30,9596,14,135,1381,416,1158,16,707,1006,1440,8438
128.004,6,21,6347,9,154,16000,267,832,12,628,11616,1420,5515
124.719,6,32,7717,12,155,11338,267,1266,20,376,6563,2006,6451
1383.773,2,14,448,14,8,106444,8,448,0,0,0,0,0
0.425,6,10,968,5,256,98,256,460,5,304,101,304,508
0.004,6,3,128,2,0,4,0,84,1,0,0,0,44
1.274,6,10,1687,7,100,212,100,384,3,1179,512,1179,1303
1795.116,17,449,39928,404,35,4454,288,25708,45,288,40021,288,14220
1738.526,6,87,6322,58,31,30500,31,3915,29,31,62089,31,2407
1680.58,1,15,840,15,28,120041,28,840,0,0,0,0,0
280.313,6,28,7352,13,158,23359,267,1317,15,678,20015,3436,6035
2.189,6,54,18605,29,882,78,1360,12688,25,377,84,1360,5917
37.648,17,21,1596,21,48,1882,48,1596,0,0,0,0,0
1797.473,1,58,4872,0,0,0,0,0,58,56,31534,56,4872
1772.904,6,180,15480,120,69,14898,69,8940,60,69,30040,69,6540
124.711,17,4,352,2,60,124710,60,176,2,60,124710,60,176
0.573,6,13,1693,7,288,65,288,588,6,426,78,434,1105
0.138,17,2,164,1,46,0,46,74,1,62,0,62,90
1796.279,17,449,39928,404,35,4457,288,25708,45,288,40017,288,14220
240.308,6,46,8603,24,449,10447,1408,5764,22,187,11443,580,2839
1.559,6,47,19115,27,887,59,1360,13539,20,433,71,1360,5576
240.246,6,109,85538,72,1281,3383,1408,75491,37,811,3034,3847,10047
0.267,6,4,1037,2,0,222,0,104,2,853,47,853,933
61.379,6,37,15989,22,805,2922,1408,9211,15,665,4365,1408,6778
9.546,6,2026,1917137,1313,1383,7,1408,1875397,713,931,13,2816,41740
59.967,17,9,9606,9,1039,7495,1045,9606,0,0,0,0,0
1765.868,1,70,3920,70,28,25592,28,3920,0,0,0,0,0
0.596,6,40,12048,23,559,27,1188,7908,17,359,32,1048,4140
1740.517,17,29,6815,29,207,62161,207,6815,0,0,0,0,0
47.111,6,25,7097,12,155,4282,267,1266,13,589,3925,3426,5831
11.118,17,6,362,3,32,5558,33,181,3,32,5558,33,181
1683.214,17,14,1036,7,30,280533,30,406,7,62,280533,62,630
202.631,6,31,7472,14,158,15587,267,1357,17,543,12662,1400,6115
1787.503,6,212,24402,135,92,13339,469,11802,77,133,23515,2006,12600
1.279,6,52,20245,30,886,44,1360,14544,22,437,52,2715,5701
1794.502,6,359,22709,209,69,8627,69,12569,150,69,12040,69,10140
0.423,17,8,2750,8,315,60,354,2750,0,0,0,0,0
301.075,6,53,23303,30,1089,10381,1360,17581,23,435,404,2667,5722
3.462,17,5,295,5,31,865,31,295,0,0,0,0,0
0.814,6,29,6149,15,154,58,267,1684,14,650,56,1452,4465
51.53,6,10,648,10,31,5725,31,648,0,0,0,0,0
80.957,6,19,784,8,0,6949,0,324,11,0,8094,0,460
0.074,17,2,394,1,128,0,128,156,1,210,0,210,238
97.309,17,4,1344,4,308,32436,308,1344,0,0,0,0,0
0.413,17,4,352,2,60,412,60,176,2,60,412,60,176
31.371,6,11,668,5,106,7839,106,314,6,90,6271,90,354
4.894,6,40,7309,20,201,257,314,3423,20,513,244,1179,3886
1793.007,17,142,11360,71,48,25613,48,5396,71,56,25613,56,5964
14.105,6,2396,2232441,1544,1368,9,1408,2183473,852,931,16,2816,48968
401.388,17,10,2060,5,48,100344,48,380,5,308,100344,308,1680
302.055,6,33,6397,17,286,18878,1314,2405,16,334,20134,1420,3992
0.317,6,28,9152,13,252,26,647,1716,15,831,22,1408,7436
1.386,6,32,11214,17,389,86,1360,3438,15,1432,86,3942,7776
0.191,6,9,1340,5,145,47,145,349,4,827,56,827,991
1.504,17,2,204,1,34,0,34,62,1,114,0,114,142
8.644,1,3,311,3,75,4322,114,311,0,0,0,0,0
0.019,17,2,516,1,34,0,34,62,1,426,0,426,454
71.256,1,8,832,0,0,0,0,0,8,76,10179,76,832
13.521,6,19,3442,10,210,1502,210,984,9,664,1689,904,2458
0.245,17,2,180,1,30,0,30,58,1,94,0,94,122
630.354,2,6,192,6,8,126070,8,192,0,0,0,0,0
1787.726,6,162,20848,94,304,19222,304,14624,68,83,26682,83,6224
0.492,17,2,384,1,39,0,39,67,1,289,0,289,317
13.663,6,37,16597,17,230,836,540,2119,20,976,709,1591,14478
15.538,6,5,216,4,0,5179,0,168,1,0,0,0,48
241.362,6,48,9287,24,528,10493,1368,6045,24,198,10492,580,3242
1501.461,6,104,6484,55,26,27804,27,3383,49,26,31279,27,3101
0.006,17,2,415,1,34,0,34,62,1,325,0,325,353
0.013,17,2,904,1,300,0,300,328,1,548,0,548,576
60.246,6,39,20411,19,131,3347,134,1520,20,991,3167,1448,18891
222.002,17,4,352,2,60,222001,60,176,2,60,222001,60,176
12.181,6,1942,1683340,1172,1380,10,1420,1648319,770,467,15,1883,35021
7.139,6,7,292,4,0,2379,0,164,3,0,3058,0,128
68.997,6,13,1028,4,226,119,226,442,9,110,8602,110,586
1080.074,17,112,9372,104,30,10485,37,6060,8,386,145772,463,3312
221.909,17,4,240,2,32,221907,32,120,2,32,221908,32,120
49.621,17,4,352,2,60,49620,60,176,2,60,49620,60,176
4.007,17,4,244,4,33,1335,33,244,0,0,0,0,0
1.061,6,25,6670,14,349,80,1083,2310,11,783,105,1420,4360
7.044,6,24,7400,13,161,587,318,1478,11,1326,684,2736,5922
42.952,17,6,2016,6,308,8590,308,2016,0,0,0,0,0
0.088,17,2,239,1,59,0,59,87,1,124,0,124,152
1790.114,6,362,22898,210,69,8565,69,12678,152,69,11853,69,10220
61.698,6,51,31338,32,1096,1990,1408,23607,19,841,3415,2816,7731
0.145,17,4,420,2,33,98,33,122,2,121,51,145,298
0.147,17,2,2386,2,1165,147,1165,2386,0,0,0,0,0
685.176,6,44,3533,26,65,23966,65,1950,18,50,40299,59,1583
0.904,6,24,6239,13,268,75,679,1865,11,786,89,1420,4374
25.439,1,4,224,4,28,8479,28,224,0,0,0,0,0
176.898,17,7,2328,7,304,29483,308,2328,0,0,0,0,0
10.855,6,18,5610,10,275,1206,275,958,8,1440,843,1440,4652
3.988,6,33,6145,17,206,249,314,2744,16,551,248,1179,3401
61.575,6,11,3134,11,232,6157,281,3134,0,0,0,0,0
0.155,6,9,1339,5,145,38,145,349,4,826,36,826,990
0.036,17,2,232,1,65,0,65,93,1,111,0,111,139
1781.928,17,142,11360,71,48,25455,48,5396,71,56,25455,56,5964
16.605,17,24,13503,13,836,1381,1350,11238,11,177,1657,1350,2265
117.192,6,29,6252,17,185,7324,499,1609,12,519,10644,1420,4643
5.087,6,40,7309,21,201,254,314,3463,19,513,267,1179,3846
22.243,6,3378,3265623,2257,1371,9,1408,3202643,1121,931,19,2801,62980
841.629,17,8,592,4,30,280525,30,232,4,62,280525,62,360
0.915,17,4,368,2,64,913,64,184,2,64,913,64,184
0.819,17,3,656,2,64,790,64,184,1,444,0,444,472
6.075,17,12,2427,6,33,1214,33,366,6,315,1214,327,2061
1700.633,17,13,534,11,14,170044,14,462,2,8,1700446,8,72
1790.085,6,325,26276,157,316,11472,515,11279,168,39,10711,138,14997
2.38,6,13,2311,8,188,340,245,700,5,1407,530,1407,1611
0.296,6,5,338,2,69,44,69,149,3,69,148,69,189
1772.125,6,168,14448,112,69,15965,69,8344,56,69,32217,69,6104
1793.712,1,212,11872,212,28,8501,28,11872,0,0,0,0,0
0.014,17,2,308,1,34,0,34,62,1,218,0,218,246
32.094,6,9,396,2,0,3483,0,88,7,0,5336,0,308
1.294,6,46,18743,26,930,51,1460,13167,20,433,58,1460,5576
1.353,6,51,19855,27,929,52,1440,14119,24,433,51,1440,5736
1786.583,6,102,8364,68,66,26665,66,4964,34,60,54136,60,3400
0.01,6,2,80,1,0,0,0,40,1,0,0,0,40
0.253,1,2,112,2,28,253,28,112,0,0,0,0,0
1785.854,1,341,28644,341,56,5252,56,28644,0,0,0,0,0
1794.343,17,87,3648,86,14,21109,14,3612,1,8,0,8,36
1794.751,17,80,3354,79,14,23009,14,3318,1,8,0,8,36
1794.756,1,218,12208,218,28,8270,28,12208,0,0,0,0,0
2.85,6,32,13726,17,685,178,1440,5507,15,1086,192,1440,8219
0.429,17,8,2750,8,315,61,354,2750,0,0,0,0,0
240.239,6,55,17647,28,782,8897,1418,14764,27,183,9239,580,2883
1798.85,1,192,10752,192,28,9418,28,10752,0,0,0,0,0
11.21,6,19,5134,7,152,1868,267,742,12,557,995,1152,4392
199.737,17,2,386,2,165,199737,165,386,0,0,0,0,0
0.038,17,2,912,1,308,0,308,336,1,548,0,548,576
1783.808,6,369,26130,214,105,8374,469,15514,155,69,11583,69,10616
419.111,17,13,4368,13,308,34925,308,4368,0,0,0,0,0
3.726,17,24,14601,14,822,284,1350,11907,10,241,410,1350,2694
0.976,6,29,12044,17,529,61,1360,3370,12,1022,72,3921,8674
0.113,6,12,3704,6,171,17,171,491,6,964,21,1448,3213
1763.406,6,41,9012,25,372,73475,996,6215,16,154,117548,269,2797
285.007,6,18,5839,10,784,31667,1360,3538,8,247,40685,272,2301
1.781,6,2,100,1,0,0,0,60,1,0,0,0,40
2.026,17,6,460,3,40,997,41,206,3,56,997,57,254
1737.604,2,28,896,28,8,64355,8,896,0,0,0,0,0
1771.032,6,99,9306,66,66,27246,66,5610,33,60,55342,60,3696
1744.583,6,95,7203,63,38,28138,205,4476,32,33,56270,98,2727
11.894,6,14,1247,7,222,1981,222,728,7,231,1981,231,519
1772.582,6,180,15480,120,69,14895,69,8940,60,69,30036,69,6540
61.542,6,8276,7797127,5406,1363,11,1408,7643223,2870,931,21,2801,153904
0.13,6,9,1002,5,213,32,213,417,4,421,38,421,585
1743.057,6,95,7203,63,38,28113,205,4476,32,33,56217,98,2727
104.409,6,29,13355,14,475,74,1360,2971,15,977,7447,1360,10384
0.083,17,2,252,1,128,0,128,156,1,68,0,68,96
4.077,17,4,296,4,46,1359,46,296,0,0,0,0,0
240.217,6,58,19468,32,825,7748,1408,16536,26,174,9608,580,2932
9.205,6,1745,1581235,1064,1405,8,1448,1541159,681,776,13,1448,40076
280.229,6,27,7312,13,158,23352,267,1317,14,775,21553,2800,5995
221.315,6,396,323151,247,1330,899,1408,300340,149,602,1483,3847,22811
4.08,6,15,2522,9,169,510,245,871,6,703,763,1152,1651
0.01,17,2,216,1,45,0,45,73,1,115,0,115,143
280.448,6,28,7352,13,158,23370,267,1317,15,775,20028,3465,6035
1792.568,17,143,11436,72,48,25243,48,5472,71,56,25607,56,5964
233.996,6,57,35971,36,1141,6685,1448,28125,21,843,3071,2359,7846
1637.879,2,10,320,10,8,181986,8,320,0,0,0,0,0
1.392,6,25,8056,12,164,108,267,1288,13,869,99,1368,6768
0.024,17,2,456,1,60,0,60,88,1,340,0,340,368
1799.503,17,448,39896,403,35,4476,288,25676,45,288,40020,288,14220
1782.302,17,83,3480,82,14,22003,14,3444,1,8,0,8,36
85.814,6,112,87736,75,1250,1159,1408,77689,37,811,2249,3847,10047
782.073,2,10,320,10,8,86897,8,320,0,0,0,0,0
119.994,6,48,25032,29,997,4283,1368,18484,19,463,6656,1368,6548
5.297,17,5,320,5,36,1324,36,320,0,0,0,0,0
0.017,6,10,2028,6,730,3,1303,1705,4,159,5,159,323
31.006,17,6,638,6,78,6201,84,638,0,0,0,0,0
70.417,6,100,72293,61,1253,1173,1368,63357,39,841,1666,2519,8936
33.607,6,34,5296,16,154,2240,722,1911,18,271,1965,1402,3385
8.936,6,1344,1225636,861,1372,10,1432,1201401,483,475,18,1871,24235
112.509,6,143,102493,84,1259,1355,1368,91285,59,738,1935,2519,11208
1745.522,6,96,7255,62,38,28615,205,4424,34,33,52883,98,2831
62.802,17,2,152,2,48,62802,48,152,0,0,0,0,0
280.469,6,27,7312,12,158,25497,267,1277,15,678,20028,2085,6035
1772.115,6,180,15480,120,69,14891,69,8940,60,69,30031,69,6540
0.0,17,1,1085,1,1057,0,1057,1085,0,0,0,0,0
1741.362,17,30,7050,30,207,60046,207,7050,0,0,0,0,0
1774.975,6,180,15480,120,69,14915,69,8940,60,69,30075,69,6540
0.505,6,25,6055,13,108,42,147,959,12,768,43,1581,5096
4.199,6,32,8056,16,188,279,721,1963,16,778,266,2840,6093
280.276,6,28,7352,12,158,25479,267,1277,16,603,18683,1400,6075
1282.583,1,24,1344,24,28,55764,28,1344,0,0,0,0,0
0.229,17,6,2123,6,325,45,355,2123,0,0,0,0,0
1798.935,17,364,53508,182,48,9938,48,13832,182,190,9938,308,39676
7.991,17,43,14559,16,564,532,1350,9477,27,160,306,1350,5082
0.478,6,50,20959,28,979,17,1380,15837,22,421,19,1923,5122
1739.899,1,75,6300,75,56,23512,56,6300,0,0,0,0,0
11.888,6,1786,1628280,1150,1363,10,1420,1598489,636,475,18,2840,29791
162.994,6,91,59488,52,1228,3195,1368,50640,39,747,1645,1368,8848
144.781,6,19,3452,6,92,168,92,412,13,236,12032,1448,3040
0.02,17,2,212,1,46,0,46,74,1,110,0,110,138
31.612,6,8,376,2,0,31612,0,88,6,0,6320,0,288
0.147,17,2,624,1,64,0,64,92,1,504,0,504,532
0.058,17,3,216,2,31,9,31,118,1,70,0,70,98
1773.412,6,121,14018,76,87,23645,470,7202,45,120,40302,1402,6816
5.007,17,4,530,2,36,5002,36,128,2,173,5001,187,402
1167.362,6,232,17326,127,117,8126,469,9909,105,68,11224,69,7417
1.052,6,472,536258,167,183,6,230,9241,305,1686,3,5472,527017
1255.087,1,6,336,6,28,251017,28,336,0,0,0,0,0
1744.728,2,30,960,30,8,60163,8,960,0,0,0,0,0
43.41,17,40,3015,23,40,1971,41,1577,17,56,2710,57,1438
0.007,17,2,116,1,30,0,30,58,1,30,0,30,58
300.646,6,43,8713,22,258,14316,688,1995,21,366,482,2128,6718
0.28,6,26,8862,13,231,23,563,1608,13,1095,22,2816,7254
1.511,6,46,18704,25,927,62,1440,13088,21,433,57,1440,5616
7.394,6,9,392,4,0,2464,0,172,5,0,1127,0,220
1745.184,6,97,7307,62,38,28609,205,4424,35,33,51318,98,2883
0.2,6,16,6653,8,138,28,138,562,8,1134,28,1448,6091
0.506,17,2,1427,2,685,506,1030,1427,0,0,0,0,0
3.097,17,3,228,2,48,3049,48,152,1,48,0,48,76
4.141,17,10,1450,5,40,1033,40,340,5,194,1032,194,1110
1786.88,6,105,8604,69,66,26277,66,5004,36,60,51050,60,3600
1796.865,17,448,39612,404,35,4458,288,25708,44,288,40034,288,13904
1788.892,17,82,3438,81,14,22361,14,3402,1,8,0,8,36
1739.049,6,145,16580,84,101,20952,721,7542,61,164,28977,1420,9038
1748.024,6,95,7203,63,38,28193,205,4476,32,33,56378,98,2727
2.111,17,2,122,2,33,2111,33,122,0,0,0,0,0
29.526,6,7,328,6,0,5905,0,280,1,0,0,0,48
149.278,6,25,11892,13,828,86,1360,4695,12,1117,13552,1792,7197
1.839,6,10,924,5,283,415,283,551,5,105,381,105,373
65.206,6,37,25375,20,840,36,1360,5935,17,1874,4067,8160,19440
291.71,17,4,352,2,60,291708,60,176,2,60,291709,60,176
280.089,6,29,7392,13,158,23340,267,1317,16,603,18666,2800,6075
1739.89,6,87,6322,58,31,30524,31,3915,29,31,62138,31,2407
1.539,17,2,154,1,33,0,33,61,1,65,0,65,93
140.61,6,1147,570127,629,840,223,1152,543200,518,413,271,1179,26927
317.005,6,74,19663,36,369,9057,1360,9978,38,326,8563,1360,9685
1741.509,6,87,6322,58,31,30552,31,3915,29,31,62196,31,2407
22.092,6,27,6661,15,117,1578,159,1401,12,771,2007,2816,5260
0.06,17,2,488,1,60,0,60,88,1,372,0,372,400
66.349,6,22,8223,13,434,5529,661,1988,9,959,8265,2688,6235
0.015,6,28,7783,17,131,0,131,1023,11,686,1,1500,6760
1786.909,6,416,24920,208,69,8632,69,12460,208,34,8632,48,12460
108.249,6,21,7979,11,525,82,1237,2048,10,919,12008,1591,5931
1762.599,6,128,7856,70,27,25544,27,4210,58,27,30921,27,3646
23.11,1,4,224,4,28,7703,28,224,0,0,0,0,0
32.079,6,9,396,2,0,3480,0,88,7,0,5333,0,308
4.975,6,40,7309,20,218,261,314,3423,20,513,245,1179,3886
0.901,6,10,1687,7,100,150,100,384,3,1179,326,1179,1303
2.94,17,3,1167,3,361,1470,361,1167,0,0,0,0,0
4.821,6,39,7269,20,218,253,314,3423,19,513,253,1179,3846
1799.856,6,356,22520,208,69,8694,69,12460,148,69,12243,69,10060
0.609,17,4,344,2,47,602,47,150,2,69,601,75,194
1790.479,6,244,35804,152,302,11857,302,26032,92,83,19675,83,9772
4.908,6,41,7349,21,218,245,314,3463,20,440,245,1152,3886
1781.223,17,142,11360,71,48,25445,48,5396,71,56,25445,56,5964
4.599,6,23,4958,13,233,383,613,1837,10,648,489,1767,3121
1765.371,17,120,22203,120,157,14835,422,22203,0,0,0,0,0
957.431,1,38,3192,38,56,25876,56,3192,0,0,0,0,0
26.081,6,37,9289,18,321,1534,721,2974,19,555,1437,2840,6315
1794.524,1,57,4788,57,56,32045,56,4788,0,0,0,0,0
10.899,17,28,8327,12,360,988,1350,4661,16,201,724,1350,3666
0.382,6,12,1653,6,288,74,288,548,6,426,44,434,1105
1792.13,17,180,14040,180,50,10011,50,14040,0,0,0,0,0
28.675,6,19,1714,9,275,3584,275,918,10,96,2690,96,796
70.656,17,4,352,2,60,70655,60,176,2,60,70655,60,176
1776.465,17,140,11200,70,48,25745,48,5320,70,56,25745,56,5880
180.485,2,3,96,3,8,90242,8,96,0,0,0,0,0
1419.069,1,15,2106,15,112,101362,173,2106,0,0,0,0,0
1789.796,6,295,29692,124,81,14550,594,12572,171,120,10527,1440,17120
1708.874,1,38,2128,38,28,46185,28,2128,0,0,0,0,0
1082.886,2,9,288,9,8,135360,8,288,0,0,0,0,0
1793.958,1,241,13496,241,28,7474,28,13496,0,0,0,0,0
1757.486,6,120,7284,66,27,27037,27,3954,54,27,33159,27,3330
3.986,17,8,1176,4,48,1326,48,304,4,190,1325,308,872
1.929,17,410,387269,84,79,22,1350,9044,326,1132,5,1350,378225
0.241,17,3,543,2,39,236,39,134,1,381,0,381,409
4.469,17,1047,643607,807,742,5,1108,621794,240,62,18,598,21813
2.814,6,21,6352,10,262,307,517,1316,11,744,276,1418,5036
806.18,1,26,1456,26,28,32247,28,1456,0,0,0,0,0
1778.7,1,244,13664,244,28,7319,28,13664,0,0,0,0,0
1754.175,6,185,11137,93,45,19067,208,6558,92,31,19273,31,4579
4.21,17,5,295,5,31,1052,31,295,0,0,0,0,0
280.6,6,29,7461,12,158,25509,267,1277,17,500,17532,1400,6184
1.574,6,30,10405,18,367,92,833,1825,12,1012,136,1420,8580
1082.882,2,10,320,10,8,120320,8,320,0,0,0,0,0
503.82,2,4,128,4,8,167940,8,128,0,0,0,0,0
1781.763,6,427,25572,212,69,8444,69,12827,215,34,8325,64,12745
1789.263,17,142,11360,71,48,25560,48,5396,71,56,25560,56,5964
0.096,17,2,245,1,32,0,32,60,1,157,0,157,185
61.768,17,6,1236,3,48,30878,48,228,3,308,30878,308,1008
1.321,6,76,32361,44,663,30,1360,23018,32,503,38,2720,9343
62.247,6,88,58597,51,1211,1244,1368,49911,37,750,1722,1368,8686
1745.123,6,97,7307,63,38,28147,205,4476,34,33,52871,98,2831
0.637,17,2,152,1,48,0,48,76,1,48,0,48,76
2.119,17,4,360,2,30,2103,30,116,2,94,2103,94,244
1.172,6,23,7952,12,164,90,267,1288,11,1216,99,3819,6664
1763.618,2,15,480,15,8,125972,8,480,0,0,0,0,0
1.273,6,48,18818,26,930,50,1460,13162,22,433,52,1460,5656
374.707,6,18,1242,14,180,28823,180,916,4,110,20072,110,326
753.813,1,77,4312,77,28,9918,28,4312,0,0,0,0,0
11.857,6,96,27874,49,543,247,1152,21512,47,447,251,1179,6362
11.191,6,2009,1890284,1266,1414,8,1448,1846960,743,776,14,1448,43324
364.462,6,18,1242,14,180,28035,180,916,4,110,20054,110,326
1.021,6,24,9219,14,350,78,1041,1992,10,1135,91,2920,7227
89.856,6,22,3217,11,324,8985,585,1249,11,457,8982,580,1968
8.588,6,21,6416,7,154,1431,267,752,14,566,644,1452,5664
1744.646,2,24,768,24,8,75854,8,768,0,0,0,0,0
12.601,17,16,3204,8,33,1798,33,488,8,311,1798,327,2716
2.076,1,2,112,2,28,2076,28,112,0,0,0,0,0
0.454,17,2,152,1,48,0,48,76,1,48,0,48,76
0.05,6,11,819,6,186,8,186,506,5,45,12,45,313
1800.0,6,211,16234,78,68,22987,294,7640,133,48,13636,78,8594
0.333,17,2,152,1,48,0,48,76,1,48,0,48,76
4.085,17,10,1472,5,40,1018,40,340,5,198,1018,216,1132
3.167,6,10,1102,6,483,633,483,803,4,83,1051,83,299
5.031,17,3,208,2,36,5002,36,128,1,52,0,52,80
236.573,17,4,272,2,32,236550,32,120,2,48,236545,48,152
1721.738,1,67,3752,67,28,26086,28,3752,0,0,0,0,0
1770.452,6,101,9344,66,65,27237,65,5577,35,59,52069,59,3767
1.553,6,10,2839,6,100,310,100,344,4,1165,434,1179,2495
0.059,6,15,5679,8,134,8,134,474,7,1637,9,1993,5205
920.953,6,69,4540,33,51,28774,208,2201,36,31,26308,31,2339
0.285,6,2,80,1,0,0,0,40,1,0,0,0,40
0.186,6,2,80,1,0,0,0,40,1,0,0,0,40
1798.109,6,374,26068,217,98,8324,469,15303,157,69,11523,69,10765
1738.789,6,87,6322,58,31,30505,31,3915,29,31,62099,31,2407
0.008,17,2,351,1,39,0,39,67,1,256,0,256,284
0.119,17,2,237,1,72,0,72,100,1,109,0,109,137
1.356,6,26,8108,12,164,105,267,1288,14,869,89,1368,6820
0.048,17,2,154,1,33,0,33,61,1,65,0,65,93
1526.724,6,303,19158,173,69,8876,69,10370,130,69,11834,69,8788
0.033,17,2,213,1,44,0,44,72,1,113,0,113,141
14.182,6,19,8472,7,106,2363,106,394,12,759,1288,3417,8078
1771.969,6,251,25498,103,67,17370,659,9558,148,133,12053,2720,15940
4.036,17,7,7079,2,723,4036,1350,1503,5,1087,595,1350,5576
280.383,6,30,7432,13,158,23365,267,1317,17,543,17521,1400,6115
0.07,17,2,154,1,33,0,33,61,1,65,0,65,93
1771.082,6,103,9519,67,65,26834,65,5641,36,59,50599,59,3878
2.13,6,2,92,1,0,0,0,48,1,0,0,0,44
1.012,17,2,685,1,308,0,308,336,1,321,0,321,349
280.228,6,27,7312,12,158,25475,267,1277,15,678,20012,2045,6035
1786.377,6,107,8564,68,66,26662,66,4964,39,60,47007,60,3600
313.82,6,73,34098,39,748,8258,1408,8920,34,1017,7788,4224,25178
1794.94,1,142,7952,142,28,12730,28,7952,0,0,0,0,0
51.839,17,4,240,2,32,51838,32,120,2,32,51838,32,120
0.36,6,10,968,5,256,87,256,460,5,304,87,304,508
1770.437,6,99,9306,66,66,27237,66,5610,33,60,55323,60,3696
1741.049,6,92,6668,60,31,29509,31,4062,32,31,56162,31,2606
10.855,6,81,24461,43,550,258,1152,18800,38,459,284,1179,5661
2.305,6,13,1371,7,283,311,283,938,6,105,366,105,433
11.805,6,1928,1634100,1153,1363,10,1380,1598858,775,421,15,1923,35242
1634.938,1,8,848,8,78,233562,78,848,0,0,0,0,0
3.297,6,14,1518,8,304,471,304,1032,6,83,630,83,486
1770.609,6,101,9410,66,66,27240,66,5610,35,60,52073,60,3800
81.839,6,129,99070,82,1257,1010,1368,88497,47,812,1774,3887,10573
0.039,17,2,367,1,33,0,33,61,1,278,0,278,306
1.314,6,50,18888,27,862,50,1360,13192,23,433,51,1360,5696
17.98,6,7,308,7,0,0,0,308,0,0,0,0,0
1749.137,6,109,8141,69,38,25722,205,4850,40,32,44842,98,3291
0.0,6,2,1500,1,0,0,0,40,1,1420,0,1420,1460
1787.445,6,102,8364,68,66,26678,66,4964,34,60,54161,60,3400
1439.929,2,14,448,14,8,110763,8,448,0,0,0,0,0
0.197,17,18,11671,10,881,21,1350,9093,8,294,23,1350,2578
0.186,6,6,5680,5,1360,0,1360,5640,1,0,0,0,40
1089.132,17,209,15884,209,48,5236,48,15884,0,0,0,0,0
93.618,6,35,8023,12,152,8509,267,1404,23,316,4254,1460,6619
0.014,17,4,1116,2,32,9,32,120,2,470,5,470,996
300.474,6,31,14709,19,929,16693,1368,9365,12,942,5581,2939,5344
10.631,6,88,26477,45,542,241,1152,20259,43,449,246,1179,6218
300.632,6,41,8569,18,286,17684,766,1896,23,521,2895,4080,6673
0.033,17,2,258,1,37,0,37,65,1,165,0,165,193
369.543,6,25,1654,17,180,23096,180,1120,8,110,9257,110,534
1682.833,17,14,1036,7,30,280464,30,406,7,62,280462,62,630
0.084,6,11,913,6,182,16,182,490,5,77,20,134,423
1795.399,17,448,39896,403,35,4466,288,25676,45,288,40017,288,14220
0.095,6,9,1339,5,145,23,145,349,4,826,29,826,990
1792.808,17,66,2766,65,14,28012,14,2730,1,8,0,8,36
1784.965,6,356,22520,208,69,8623,69,12460,148,69,12139,69,10060
2.143,6,13,2311,8,188,306,245,700,5,1407,469,1407,1611
0.196,6,27,7296,13,155,16,267,1301,14,603,14,1400,5995
1.453,6,50,21255,29,902,51,1360,15639,21,476,63,2715,5616
280.31,6,30,7432,13,158,23359,267,1317,17,543,17513,1400,6115
0.907,17,2,166,1,47,0,47,75,1,63,0,63,91
6.618,6,24,5410,12,383,601,885,2537,12,448,586,1440,2873
219.522,17,4,272,2,40,219520,47,136,2,40,219521,47,136
300.405,6,55,36370,32,1240,9690,1448,30198,23,828,2185,1448,6172
8.41,6,80,24757,41,561,210,1152,19056,39,413,214,1152,5701
1790.343,6,440,26615,218,69,8250,69,13067,222,36,8098,69,13548
0.773,6,3,199,1,31,0,31,83,2,0,773,0,116
0.326,17,2,198,1,39,0,39,67,1,103,0,103,131
1793.31,17,144,11520,72,48,25257,48,5472,72,56,25257,56,6048
1.796,6,14,2351,8,188,256,245,700,6,703,307,1152,1651
1757.837,6,2963,2865986,965,149,1823,951,60422,1998,1404,880,4035,2805564
280.567,6,29,7392,13,158,23380,267,1317,16,603,18698,2036,6075
0.894,6,10,1687,7,100,149,100,384,3,1179,323,1179,1303
1.288,6,26,8108,14,164,84,267,1392,12,1014,100,2331,6716
238.901,17,14,4672,14,305,18377,308,4672,0,0,0,0,0
1745.872,6,96,7300,63,38,28159,205,4488,33,33,54545,98,2812
1.073,6,28,6067,13,161,89,267,1491,15,567,71,1420,4576
360.737,6,31,6806,13,189,9136,516,1470,18,307,21214,1452,5336
1740.78,17,27,6237,27,203,66953,203,6237,0,0,0,0,0
1747.522,6,95,7203,63,38,28185,205,4476,32,33,56365,98,2727
1793.06,17,66,2766,65,14,28016,14,2730,1,8,0,8,36
618.027,6,95,21140,41,352,15450,1460,10157,54,231,11657,3089,10983
1794.641,17,180,14040,180,50,10025,50,14040,0,0,0,0,0
0.513,17,3,451,2,39,402,39,134,1,289,0,289,317
1784.069,1,110,11660,110,78,16367,78,11660,0,0,0,0,0
83.458,6,21,5257,15,483,5961,483,4676,6,83,111,83,581
115.311,17,2,702,2,323,115311,323,702,0,0,0,0,0
1.985,6,51,19243,27,882,76,1360,13462,24,400,78,1360,5781
1789.782,1,64,5376,0,0,0,0,0,64,56,28409,56,5376
5.121,6,40,7309,21,218,256,314,3463,19,513,271,1179,3846
300.297,6,39,20474,24,1025,13056,1408,14598,15,726,2487,2899,5876
1781.218,17,138,11040,69,48,26194,48,5244,69,56,26194,56,5796
1.269,6,38,8254,19,321,70,1164,2718,19,433,60,1360,5536
0.161,6,26,7256,13,155,13,267,1301,13,678,12,4200,5955
1791.061,17,179,13962,179,50,10062,50,13962,0,0,0,0,0
229.869,17,2,1084,2,514,229869,514,1084,0,0,0,0,0
1741.24,1,16,896,16,28,116082,28,896,0,0,0,0,0
1007.597,2,6,192,6,8,201519,8,192,0,0,0,0,0
328.847,6,10,586,7,31,54807,31,373,3,31,149872,31,213
0.015,17,3,392,2,60,4,60,176,1,188,0,188,216
1632.889,1,7,742,7,78,272148,78,742,0,0,0,0,0
12.023,17,10,850,5,37,3004,37,325,5,77,3004,77,525
72.25,1,6,336,6,28,14450,28,336,0,0,0,0,0
1793.096,1,58,4872,0,0,0,0,0,58,56,31457,56,4872
0.009,6,5,4031,0,0,0,0,0,5,1277,2,1440,4031
1107.426,17,48,7528,24,48,48148,48,1824,24,209,48148,308,5704
288.168,6,22,6089,9,267,119,501,1165,13,400,24006,1420,4924
1773.73,6,181,15589,120,69,14905,69,8940,61,69,29556,69,6649
1787.54,1,61,5124,61,56,29792,56,5124,0,0,0,0,0
1263.381,2,12,384,12,8,114852,8,384,0,0,0,0,0
1764.771,6,126,12867,79,68,22625,722,6775,47,93,38355,1408,6092
1798.553,17,173,13494,173,50,10456,50,13494,0,0,0,0,0
60.177,6,20,5656,11,267,6017,501,1245,9,674,7509,1420,4411
0.239,17,2,304,1,60,0,60,88,1,188,0,188,216
1680.732,17,13,534,11,14,168055,14,462,2,8,1680553,8,72
199.832,6,83,57606,51,1224,3996,1368,49207,32,747,2006,1368,8399
2.559,17,4,610,3,39,521,39,201,1,381,0,381,409
1766.743,6,185,11345,93,47,19201,208,6735,92,31,19412,31,4610
1750.199,1,68,5712,0,0,0,0,0,68,56,26122,56,5712
1499.135,1,142,7952,142,28,10632,28,7952,0,0,0,0,0
1745.204,6,94,7151,62,38,28609,205,4424,32,33,56288,98,2727
168.149,6,25,6318,9,272,99,516,1180,16,345,11204,1452,5138
1781.276,6,353,22400,206,69,8689,69,12380,147,69,12200,69,10020
0.618,6,10,766,5,185,152,185,453,5,45,108,45,313
0.14,6,9,1144,5,145,35,145,349,4,631,37,631,795
0.0,6,1,1957,0,0,0,0,0,1,1917,0,1917,1957
1772.579,6,180,15480,120,69,14895,69,8940,60,69,30038,69,6540
0.007,6,3,3020,1,0,0,0,40,2,1438,0,1438,2980
6.682,6,23,6843,13,150,556,174,824,10,802,704,1420,6019
1738.093,1,57,4788,57,56,31037,56,4788,0,0,0,0,0
280.465,6,27,7312,13,158,23372,267,1317,14,678,21570,2760,5995
1.348,6,24,8004,12,164,104,267,1288,12,1014,104,2491,6716
0.602,6,10,924,5,283,106,283,551,5,105,106,105,373
0.361,6,12,1653,6,288,65,288,548,6,426,40,434,1105
123.263,17,4,352,2,48,123255,48,152,2,72,123254,72,200
300.841,6,43,14222,24,852,13080,1440,8660,19,399,481,1440,5562
1794.068,17,66,2766,65,14,28032,14,2730,1,8,0,8,36
1797.289,6,356,22520,208,69,8682,69,12460,148,69,12226,69,10060
0.29,6,11,1864,6,262,58,517,844,5,752,72,752,1020
0.669,6,3,1232,3,1112,334,1112,1232,0,0,0,0,0
1740.408,17,30,31680,30,1028,60014,1028,31680,0,0,0,0,0
125.961,2,2,64,2,8,125961,8,64,0,0,0,0,0
1739.31,6,87,6322,58,31,30514,31,3915,29,31,62117,31,2407
0.145,17,2,198,1,37,0,37,65,1,105,0,105,133
0.876,6,23,5714,13,158,71,370,1315,10,998,95,1691,4399
1790.786,1,278,15568,278,28,6464,28,15568,0,0,0,0,0
1775.807,17,140,11200,70,48,25736,48,5320,70,56,25736,56,5880
238.28,17,24,8778,24,337,10360,360,8778,0,0,0,0,0
1740.733,17,30,31680,30,1028,60025,1028,31680,0,0,0,0,0
21.266,17,2,904,1,300,0,300,328,1,548,0,548,576
1790.628,1,210,11760,210,28,8567,28,11760,0,0,0,0,0
1792.766,6,357,22629,208,69,8660,69,12460,149,69,12113,69,10169
64.808,6,9,506,3,106,31788,106,234,6,0,12960,0,272
1.166,6,23,7952,12,164,90,267,1288,11,1216,99,2804,6664
0.575,17,4,908,2,39,561,39,134,2,359,63,381,774
60.583,6,10,544,6,0,12116,0,320,4,0,20181,0,224
9.572,1,9,756,9,56,1196,56,756,0,0,0,0,0
1773.109,6,204,22330,130,75,13745,267,10057,74,132,24283,1460,12273
316.943,6,113,36178,58,524,5560,1360,24903,55,302,5866,1929,11275
0.498,17,3,451,2,39,288,39,134,1,289,0,289,317
68.442,1,4,336,4,56,22814,56,336,0,0,0,0,0
4.041,17,5,295,5,31,1010,31,295,0,0,0,0,0
25.918,6,47,13777,22,299,1234,721,3281,25,632,1072,1420,10496
1.417,6,38,8254,19,321,78,1164,2718,19,433,68,1360,5536
1729.24,6,62,4504,40,33,44339,33,2740,22,31,82335,31,1764
1785.263,6,102,8364,68,66,26645,66,4964,34,60,54096,60,3400
1785.686,6,277,33733,113,134,15942,1360,16285,164,132,10954,1942,17448
1799.228,6,356,22520,208,69,8691,69,12460,148,69,12239,69,10060
240.198,6,53,17172,29,758,8578,1408,14413,24,187,10443,580,2759
1793.718,1,274,15344,274,28,6570,28,15344,0,0,0,0,0
1784.396,6,361,22858,210,69,8537,69,12678,151,69,11895,69,10180
0.014,17,4,420,2,33,2,33,122,2,121,1,145,298
0.16,6,3,189,1,0,0,0,40,2,69,123,69,149
300.611,6,38,8471,19,291,16700,786,1957,19,441,470,1440,6514
0.95,6,10,861,5,222,200,222,426,5,231,207,231,435
1770.144,6,236,19285,91,84,19666,295,9775,145,50,12292,78,9510
4.101,6,35,6225,19,206,227,314,2824,16,551,256,1179,3401
1.347,6,10,1687,7,100,224,100,384,3,1179,545,1179,1303
14.537,6,2124,2005762,1350,1407,10,1448,1960850,774,776,18,1448,44912
1740.076,6,87,6322,58,31,30527,31,3915,29,31,62145,31,2407
4.933,17,6,1421,3,40,2459,40,204,3,377,2459,407,1217
1.105,17,6,360,3,32,552,32,180,3,32,552,32,180
20.173,6,21,5417,12,107,1833,159,1074,9,773,2517,1418,4343
1772.252,6,180,15480,120,69,14892,69,8940,60,69,30033,69,6540
10.916,6,20,4442,11,275,1091,275,998,9,768,768,1440,3444
300.636,6,38,8450,20,286,15822,797,1976,18,441,498,1440,6474
256.042,6,17,6409,6,98,51206,106,445,11,689,25602,1452,5964
0.343,17,2,144,1,36,0,36,64,1,52,0,52,80
2.053,17,22,5709,22,231,97,389,5709,0,0,0,0,0
36.029,17,40,5880,20,48,1895,48,1520,20,190,1895,308,4360
0.004,17,2,258,1,60,0,60,88,1,142,0,142,170
35.744,6,31,5093,15,154,2553,722,1859,16,342,2349,1448,3234
1797.792,17,142,11360,71,48,25682,48,5396,71,56,25682,56,5964
367.067,6,18,1242,14,180,28235,180,916,4,110,20062,110,326
272.03,6,30,9005,9,154,34003,267,832,21,457,13594,1420,8173
6.167,6,1788,1703542,1133,1426,5,1448,1664818,655,776,9,1448,38724
3.792,17,5,295,5,31,948,31,295,0,0,0,0,0
0.931,6,11,1727,7,100,155,100,384,4,589,224,1152,1343
0.365,17,2,144,1,36,0,36,64,1,52,0,52,80
0.549,17,2,178,1,29,0,29,57,1,93,0,93,121
10.129,17,4,536,2,33,10113,33,122,2,179,10119,179,414
0.128,6,10,1569,5,627,32,627,895,5,406,32,406,674
3.414,6,11,1019,4,332,1138,332,536,7,83,565,83,483
300.727,2,3,96,3,8,150363,8,96,0,0,0,0,0
718.542,2,9,288,9,8,89817,8,288,0,0,0,0,0
85.194,2,4,128,4,8,28398,8,128,0,0,0,0,0
40.778,17,3,228,3,48,20389,48,228,0,0,0,0,0
240.213,6,55,17597,30,729,8283,1408,14697,25,199,10008,580,2900
0.131,17,3,634,2,32,0,32,120,1,486,0,486,514
0.189,17,2,167,1,39,0,39,67,1,72,0,72,100
0.26,6,37,26518,19,185,14,524,1912,18,1690,14,5632,24606
7.736,6,12,700,5,0,1934,0,280,7,0,1208,0,420
2.898,17,4,624,4,128,966,128,624,0,0,0,0,0
1747.503,6,95,7203,63,38,28185,205,4476,32,33,56359,98,2727
1785.759,6,106,8515,69,65,26261,65,4970,37,59,49601,59,3545
8.336,6,21,6439,10,292,921,517,1406,11,744,829,1418,5033
0.012,17,2,235,1,36,0,36,64,1,143,0,143,171
0.165,6,3,144,0,0,0,0,0,3,0,0,0,144
1700.383,17,12,498,11,14,170038,14,462,1,8,0,8,36
1787.322,6,107,8614,69,65,26284,65,4970,38,59,48303,59,3644
280.287,6,28,7352,12,158,25480,267,1277,16,603,18684,1400,6075
75.047,6,10,632,3,92,37455,92,256,7,0,12472,0,376
0.009,17,2,354,1,33,0,33,61,1,265,0,265,293
0.023,17,4,544,2,60,0,60,176,2,156,0,156,368
1753.573,1,67,5628,67,56,26569,56,5628,0,0,0,0,0
280.433,6,28,7352,12,158,25493,267,1277,16,678,18692,2085,6075
1796.117,6,489,28298,272,69,6627,69,15158,217,35,8315,64,13140
1772.553,6,180,15480,120,69,14895,69,8940,60,69,30036,69,6540
1.152,6,25,8056,12,164,88,267,1288,13,869,81,1440,6768
5.258,17,12,2595,6,47,1049,47,450,6,329,1044,341,2145
1770.618,17,185,43794,185,208,9622,422,43794,0,0,0,0,0
0.45,6,20,7196,12,325,40,626,1932,8,1210,63,1906,5264
344.383,6,28,6534,11,215,5621,500,1307,17,324,21519,1420,5227
0.957,17,2,176,2,60,957,60,176,0,0,0,0,0
1744.737,2,28,896,28,8,64619,8,896,0,0,0,0,0
5.093,2,2,64,2,8,5093,8,64,0,0,0,0,0
0.173,6,3,151,2,31,1,31,111,1,0,0,0,40
233.587,17,4,240,2,32,233585,32,120,2,32,233586,32,120
11.936,6,12,963,5,275,2984,275,479,7,96,1535,96,484
10.456,6,35,9917,15,333,746,764,2802,20,754,399,1418,7115
1764.568,2,15,480,15,8,126040,8,480,0,0,0,0,0
5.85,6,41,7349,21,218,292,314,3463,20,513,292,1179,3886
1.772,17,20,5180,20,231,93,388,5180,0,0,0,0,0
1680.468,1,14,784,14,28,129266,28,784,0,0,0,0,0
1671.162,1,7,392,7,28,278527,28,392,0,0,0,0,0
1.594,17,4,334,2,39,764,39,134,2,72,0,72,200
0.45,6,9,1340,5,145,112,145,349,4,827,148,827,991
280.881,6,33,7643,14,158,21606,267,1357,19,502,15596,1380,6286
0.971,17,5,1208,3,32,481,32,180,2,486,12,486,1028
104.018,17,4,352,2,60,104017,60,176,2,60,104017,60,176
3.783,17,4,244,4,33,1261,33,244,0,0,0,0,0
4.552,17,26,8718,10,248,505,1350,2762,16,344,214,1350,5956
0.49,17,3,451,2,39,168,39,134,1,289,0,289,317
1.112,6,34,10759,19,294,61,1305,3186,15,696,65,1360,7573
292.577,6,50,11992,24,135,12718,517,2237,26,645,11701,1418,9755
1769.001,1,82,6888,82,56,21839,56,6888,0,0,0,0,0
0.035,6,10,861,6,182,7,182,490,4,77,7,134,371
186.928,2,2,64,2,8,186928,8,64,0,0,0,0,0
20.196,6,18,2368,10,189,2244,517,1298,8,323,2880,499,1070
10.989,6,18,4266,10,275,1221,275,958,8,992,865,1440,3308
1789.089,6,365,25501,212,100,8479,469,14896,153,69,11767,69,10605
1.503,6,48,19220,27,888,57,1460,13604,21,529,65,4075,5616
0.615,6,11,999,6,332,123,332,640,5,83,88,83,359
298.038,1,4,224,4,28,99346,28,224,0,0,0,0,0
300.334,6,210,219460,144,162,2100,230,8686,66,3291,4620,11264,210774
0.151,17,4,284,2,32,14,32,120,2,54,138,60,164
1796.743,17,448,39896,403,35,4469,288,25676,45,288,40017,288,14220
191.996,6,4,574,4,103,63998,138,574,0,0,0,0,0
1798.36,17,448,39896,403,35,4473,288,25676,45,288,40021,288,14220
0.158,6,46,20430,26,1024,6,1420,15409,20,467,7,1883,5021
0.195,17,2,152,1,48,0,48,76,1,48,0,48,76
1.754,6,9,527,5,43,438,43,311,4,0,583,0,216
724.45,17,58,4640,29,48,25873,48,2204,29,56,25873,56,2436
1776.419,17,140,11200,70,48,25745,48,5320,70,56,25745,56,5880
104.194,6,21,1474,15,43,7442,43,1114,6,0,20026,0,360
0.017,6,10,1514,5,503,4,503,771,5,475,3,475,743
153.878,6,172,125210,101,1280,1538,1368,112829,71,737,1360,2519,12381
0.896,17,2,122,2,33,896,33,122,0,0,0,0,0
4.082,6,5,293,1,0,0,0,40,4,31,1360,31,253
1.699,17,30,20489,17,727,104,1350,12837,13,560,138,1350,7652
191.741,6,23,1675,17,43,11983,43,1315,6,0,38347,0,360
1443.815,2,14,448,14,8,111062,8,448,0,0,0,0,0
1787.525,6,102,8364,68,66,26679,66,4964,34,60,54163,60,3400
372.431,17,6,360,3,32,186215,32,180,3,32,186215,32,180
0.093,6,10,1671,6,552,18,948,1348,4,159,30,159,323
1771.297,6,99,9240,66,65,27250,65,5577,33,59,55348,59,3663
31.524,6,7,336,1,0,0,0,48,6,0,6302,0,288
22.635,6,52,19865,27,590,861,1360,5910,25,761,936,1360,13955
0.42,6,26,8911,13,237,35,590,1635,13,1098,34,2816,7276
1763.893,2,14,448,14,8,135684,8,448,0,0,0,0,0
9.038,6,26546,29291659,9962,280,0,280,524408,16584,1682,0,11216,28767251
1.451,6,54,22022,31,936,48,1360,16281,23,480,57,4075,5741
8.5,6,9,520,5,0,2125,0,280,4,0,1043,0,240
782.088,2,9,288,9,8,97761,8,288,0,0,0,0,0
240.499,6,62,24694,33,547,7515,1408,6647,29,1033,8589,2816,18047
10.848,6,20,1503,10,222,1203,222,852,10,231,1203,231,651
182.302,6,188,139480,111,1332,1657,1448,124344,77,580,2395,1448,15136
1793.465,17,142,11360,71,48,25617,48,5396,71,56,25620,56,5964
15.476,17,20,2940,10,48,1718,48,760,10,190,1715,308,2180
1797.397,17,449,39928,404,35,4460,288,25708,45,288,40021,288,14220
1750.51,17,12,498,11,14,175051,14,462,1,8,0,8,36
8.377,6,21,6693,5,140,2094,267,769,16,479,556,1420,5924
23.874,6,15,1450,4,112,7954,112,280,11,117,2386,256,1170
97.416,6,33,9061,14,158,7493,267,1357,19,578,5410,1400,7704
12.83,17,12,2571,6,45,2556,45,438,6,327,2564,339,2133
341.413,17,9,3024,9,308,42676,308,3024,0,0,0,0,0
0.09,17,2,154,1,41,0,41,69,1,57,0,57,85
481.357,2,5,160,5,8,120339,8,160,0,0,0,0,0
15.499,6,3,180,2,0,1080,0,120,1,0,0,0,60
280.437,6,29,7392,13,158,23369,267,1317,16,603,18692,2076,6075
0.001,17,2,180,1,30,0,30,58,1,94,0,94,122
1787.911,6,362,22898,210,69,8554,69,12678,152,69,11840,69,10220
1772.932,6,281,27585,118,67,15152,594,10229,163,118,10943,4658,17356
1720.504,1,8,448,8,28,245786,28,448,0,0,0,0,0
63.627,17,4,352,2,60,63626,60,176,2,60,63626,60,176
130.914,6,2530,2561050,1500,365,87,426,86250,1030,2362,102,14080,2474800
1786.531,6,104,8444,68,66,26664,66,4964,36,60,51040,60,3480
101.252,17,4,352,2,60,101251,60,176,2,60,101251,60,176
40.475,17,24,2112,12,48,3675,48,912,12,72,3677,72,1200
17.575,17,26,5828,13,238,1461,1350,3466,13,153,1460,1350,2362
34.61,6,35,6130,17,154,2163,721,1974,18,357,2025,2026,4156
3.145,17,8,1888,4,64,1046,64,368,4,352,1045,376,1520
103.972,6,30,14198,15,831,73,1460,5630,15,994,7413,2885,8568
0.03,17,2,251,1,31,0,31,59,1,164,0,164,192
0.407,6,10,967,5,256,99,256,460,5,303,98,303,507
7.382,6,5,220,1,0,0,0,44,4,0,2431,0,176
65.231,17,4,240,2,32,65230,32,120,2,32,65230,32,120
6.254,6,1279,1172601,781,1423,7,1448,1142041,498,776,12,1448,30560
5.305,17,3,208,2,36,4989,36,128,1,52,0,52,80
1790.04,17,144,11520,72,48,25211,48,5472,72,56,25211,56,6048
0.111,6,10,1677,6,555,19,951,1354,4,159,36,159,323
1751.58,6,95,7203,63,38,28251,205,4476,32,33,56483,98,2727
41.628,17,12,912,12,48,3784,48,912,0,0,0,0,0
161.007,6,38,25085,18,840,43,1460,5795,20,1231,8467,1460,19290
1796.435,17,144,11520,72,48,25301,48,5472,72,56,25301,56,6048
1.734,6,30,10202,16,606,97,1460,3715,14,657,114,1460,6487
300.69,6,40,8715,21,315,15034,882,2157,19,413,473,1360,6558
14.644,6,9,588,3,106,7319,106,234,6,90,2927,90,354
0.696,6,55,23966,30,1028,24,1380,18712,25,421,27,1923,5254
74.371,6,11,1346,6,302,14874,302,912,5,83,18589,83,434
0.058,17,2,157,1,31,0,31,59,1,70,0,70,98
15.859,17,13,6583,7,613,2637,1350,4487,6,321,3165,1350,2096
1.116,6,9,2074,6,596,213,1033,1437,3,513,69,513,637
1.189,6,24,8004,12,164,92,267,1288,12,1014,91,2411,6716
15.206,6,2719,2555680,1710,1414,8,1448,2498536,1009,776,14,1448,57144
11.559,6,21,6825,12,275,1050,275,1038,9,1353,819,1440,5787
1782.345,17,83,3480,82,14,22004,14,3444,1,8,0,8,36
1.306,6,50,21525,29,919,46,1360,15909,21,476,56,2715,5616
200.909,6,62,17839,29,474,7175,841,3022,33,451,6244,1408,14817
0.053,6,12,3462,6,75,10,75,395,6,1373,10,1448,3067
22.047,17,40,12440,18,305,1293,1350,6006,22,264,1047,1350,6434
356.986,6,38,3245,25,69,14874,69,1828,13,69,29747,69,1417
3.491,17,2,632,1,288,0,288,316,1,288,0,288,316
1799.93,17,450,39960,405,35,4455,288,25740,45,288,40018,288,14220
3.489,17,5,290,5,30,872,30,290,0,0,0,0,0
0.098,6,9,1002,5,213,24,213,417,4,421,23,421,585
6.898,17,18,16968,7,795,1149,1350,5765,11,990,562,1350,11203
11.264,6,37,7248,18,200,662,314,2933,19,507,611,1179,4315
617.849,6,138,38886,59,535,10652,1360,25409,79,210,7919,4649,13477
281.71,6,31,7476,13,158,23475,267,1317,18,543,16567,1400,6159
1786.639,6,108,8468,68,64,26666,64,4896,40,58,45808,58,3572
118.989,17,4,352,2,60,118987,60,176,2,60,118988,60,176
0.193,17,8,2758,8,316,27,355,2758,0,0,0,0,0
36.306,17,10,760,10,48,4034,48,760,0,0,0,0,0
76.279,17,8,704,4,48,25423,48,304,4,72,25423,72,400
4.114,17,4,244,4,33,1371,33,244,0,0,0,0,0
65.286,1,4,336,4,56,21762,56,336,0,0,0,0,0
0.229,17,2,362,1,46,0,46,74,1,260,0,260,288
1786.975,6,105,8664,68,66,26671,66,4964,37,60,49635,60,3700
1799.592,1,180,19080,180,78,10053,78,19080,0,0,0,0,0
299.206,1,4,326,4,53,99735,78,326,0,0,0,0,0
1798.551,6,213,19628,137,98,13224,469,12103,76,69,23976,69,7525
371.536,6,25,1651,17,177,23221,177,1117,8,110,9236,110,534
32.456,17,4,304,4,48,10818,48,304,0,0,0,0,0
3.913,17,5,295,5,31,978,31,295,0,0,0,0,0
1.28,6,45,18085,26,882,51,1360,12549,19,476,61,2715,5536
68.153,17,4,352,2,60,68152,60,176,2,60,68151,60,176
1785.592,6,360,22818,210,69,8543,69,12678,150,69,11983,69,10140
3.887,6,2,88,2,0,0,0,88,0,0,0,0,0
1003.005,1,86,7224,86,56,11800,56,7224,0,0,0,0,0
3.67,17,2,656,2,300,3670,300,656,0,0,0,0,0
431.873,1,6,636,6,78,86374,78,636,0,0,0,0,0
862.454,6,12,728,8,31,123207,31,444,4,31,287476,31,284
1663.162,1,8,448,8,28,237594,28,448,0,0,0,0,0
118.365,6,614,282596,310,839,383,1152,268480,304,488,389,1179,14116
252.232,2,3,96,3,8,126116,8,96,0,0,0,0,0
555.546,17,14,1064,14,48,42734,48,1064,0,0,0,0,0
1778.941,17,142,11360,71,48,25413,48,5396,71,56,25413,56,5964
240.205,6,53,18096,28,802,8896,1418,15101,25,210,10008,580,2995
9.204,6,81,25010,42,550,224,1152,19309,39,459,235,1179,5701
33.785,6,31,5096,15,154,2413,722,1860,16,342,2238,1448,3236
1.214,6,42,11418,23,547,55,1360,5882,19,433,58,1360,5536
1.713,6,18,3269,10,99,168,182,924,8,477,218,1343,2345
1682.61,17,16,1265,8,30,240364,37,471,8,71,240365,136,794
63.917,6,38,8598,13,136,5326,267,1481,25,321,2655,1460,7117
120.428,17,4,240,2,32,120427,32,120,2,32,120427,32,120
1261.986,6,78,6083,44,64,26446,64,3168,34,50,38239,58,2915
33.444,6,33,5209,17,154,2090,721,1973,16,342,1072,2026,3236
0.105,17,2,904,2,424,105,548,904,0,0,0,0,0
1774.732,6,182,15698,120,69,14913,69,8940,62,69,29091,69,6758
125.726,2,2,64,2,8,125726,8,64,0,0,0,0,0
1770.778,6,103,9708,70,65,25663,65,6045,33,59,55332,59,3663
1751.852,6,97,7307,63,38,28255,205,4476,34,33,53079,98,2831
1798.833,17,449,39928,404,35,4463,288,25708,45,288,40018,288,14220
33.743,6,28,4938,14,154,2595,722,1808,14,479,2580,1402,3130
14.006,6,22,6817,12,275,1273,275,1038,10,1073,998,1440,5779
179.706,6,25,8809,13,549,133,1308,2223,12,761,16321,1791,6586
1741.975,1,57,4788,57,56,31106,56,4788,0,0,0,0,0
0.03,6,2,92,1,0,0,0,52,1,0,0,0,40
6.072,17,6,1302,3,33,3031,33,183,3,345,3031,345,1119
1.11,6,23,8725,13,290,92,802,1713,10,1100,99,2370,7012
0.04,17,4,368,2,32,17,32,120,2,96,0,96,248
1.32,6,38,8258,19,321,73,1168,2722,19,433,63,1360,5536
125.853,2,2,64,2,8,125853,8,64,0,0,0,0,0
1779.298,1,216,12096,216,28,8275,28,12096,0,0,0,0,0
1800.0,6,203,14100,73,46,24580,46,5910,130,46,13953,46,8190
0.019,17,8,2446,8,277,2,316,2446,0,0,0,0,0
8.12,6,28,7835,14,241,624,721,1771,14,687,599,2840,6064
11.755,6,1872,1613889,1139,1362,10,1380,1580327,733,421,15,1923,33562
5.566,6,14,2351,7,188,927,245,660,7,1407,884,1407,1691
0.017,6,9,1878,5,666,4,666,934,4,728,5,728,944
0.116,17,2,279,1,36,0,36,64,1,187,0,187,215
0.004,6,2,1540,1,1448,0,1448,1500,1,0,0,0,40
1628.877,1,8,448,8,28,232696,28,448,0,0,0,0,0
1770.422,6,108,11614,70,106,25658,823,7369,38,64,47847,192,4245
1789.671,6,112,9221,73,55,24856,205,5721,39,37,47086,98,3500
142.013,17,6,2472,6,384,28402,394,2472,0,0,0,0,0
0.082,6,10,1673,6,553,16,949,1350,4,159,27,159,323
1772.271,6,180,15480,120,69,14893,69,8940,60,69,30037,69,6540
0.417,6,10,968,5,256,100,256,460,5,304,101,304,508
1728.034,17,13,534,11,14,172784,14,462,2,8,1727848,8,72
0.159,6,25,7216,13,155,13,267,1301,12,678,13,2800,5915
70.726,6,22,916,10,0,4942,0,416,12,0,6429,0,500
1789.542,6,5225,4797966,1969,127,909,353,121170,3256,1417,549,5672,4676796
137.193,6,38,25877,25,741,32,1360,3997,13,2668,11421,5440,21880
0.006,17,2,395,1,39,0,39,67,1,300,0,300,328
0.055,17,2,157,1,31,0,31,59,1,70,0,70,98
1785.9,6,450,27153,222,69,8055,69,13296,228,35,7867,48,13857
1797.5,17,142,11360,71,48,25678,48,5396,71,56,25678,56,5964
0.228,17,10,800,10,52,25,52,800,0,0,0,0,0
1793.299,6,365,25570,213,99,8458,469,15005,152,69,11874,69,10565
6.185,6,1750,1650056,1125,1390,5,1408,1612892,625,931,9,2816,37164
1772.12,1,58,4872,0,0,0,0,0,58,56,31089,56,4872
261.527,6,6,364,4,31,87175,31,222,2,31,261503,31,142
0.162,1,2,112,2,28,162,28,112,0,0,0,0,0
8.124,6,78,24677,39,561,213,1152,18976,39,413,207,1152,5701
0.112,6,9,1002,5,213,28,213,417,4,421,33,421,585
1.217,6,24,8016,12,164,93,267,1300,12,1014,93,2411,6716
547.681,6,64,8577,34,304,16596,304,5728,30,83,18883,83,2849
1771.935,6,99,9306,66,66,27260,66,5610,33,60,55369,60,3696
0.022,17,2,198,1,37,0,37,65,1,105,0,105,133
0.03,17,2,166,1,33,0,33,61,1,77,0,77,105
13.659,17,7,6602,7,915,2276,1451,6602,0,0,0,0,0
2.04,17,3,174,3,30,1020,30,174,0,0,0,0,0
4.453,6,37,7189,19,218,247,314,3383,18,513,245,1179,3806
0.163,2,3,96,3,8,81,8,96,0,0,0,0,0
101.076,6,875,445210,492,845,205,1152,423655,383,415,263,1179,21555
1788.111,1,269,15064,269,28,6672,28,15064,0,0,0,0,0
2.187,17,2,672,2,308,2187,308,672,0,0,0,0,0
1794.758,17,118,9440,59,48,30943,48,4484,59,56,30943,56,4956
0.278,17,2,677,1,300,0,300,328,1,321,0,321,349
148.905,1,12,1248,0,0,0,0,0,12,76,13536,76,1248
6.933,17,16,1216,8,37,989,37,520,8,59,989,65,696
869.26,6,86,10335,44,81,20214,517,3397,42,295,21200,1418,6938
184.115,17,4,558,2,36,184111,36,128,2,187,184110,187,430
32.423,6,314,273718,143,122,228,289,7959,171,1538,190,2816,265759
1.292,6,50,18817,27,857,49,1360,13121,23,433,50,1360,5696
1740.443,1,15,840,15,28,124317,28,840,0,0,0,0,0
0.026,17,4,284,2,32,18,32,120,2,54,17,60,164
55.483,17,86,6192,0,0,0,0,0,86,44,652,44,6192
8.875,1,9,756,9,56,1109,56,756,0,0,0,0,0
301.0,6,53,23303,30,1089,10379,1360,17581,23,399,403,1360,5722
300.599,6,39,8545,21,286,15029,797,2028,18,482,495,2720,6517
43.312,6,16,2297,9,324,5414,585,1125,7,396,7043,580,1172
1.965,6,71,47909,41,1235,49,1368,40444,30,842,60,1368,7465
1789.796,6,474,28641,246,69,7305,69,14325,228,39,7871,69,14316
1.469,6,37,8214,19,321,81,1164,2718,18,476,74,2615,5496
0.023,17,2,323,1,33,0,33,61,1,234,0,234,262
1789.514,6,293,28787,174,103,10344,469,14231,119,127,15161,1420,14556
1783.289,17,83,3480,82,14,22015,14,3444,1,8,0,8,36
351.972,17,26,2288,13,48,29330,48,988,13,72,29330,72,1300
6.256,6,18,6940,6,275,1251,275,794,12,629,474,2840,6146
18.939,6,2883,2777361,1926,1366,9,1408,2722933,957,776,19,1408,54428
1.316,6,48,19471,27,910,50,1360,13855,21,476,56,2715,5616
1786.343,6,104,8376,68,65,26661,65,4930,36,59,51035,59,3446
299.563,1,4,326,4,53,99854,78,326,0,0,0,0,0
5.059,17,4,288,2,36,5003,36,128,2,52,5020,52,160
29.617,17,5,390,5,50,7404,50,390,0,0,0,0,0
23.898,6,54,20263,25,1071,43,1460,13886,29,273,846,2920,6377
300.697,6,38,8566,20,315,15826,882,2093,18,441,498,1360,6473
1740.474,17,30,31680,30,1028,60016,1028,31680,0,0,0,0,0
192.119,6,24,6902,6,156,38423,267,718,18,419,11292,1420,6184
4.988,6,40,7309,21,218,249,314,3463,19,513,262,1179,3846
1772.164,6,180,15480,120,69,14892,69,8940,60,69,30032,69,6540
171.01,6,73,27963,38,877,4621,1440,17354,35,510,5022,1440,10609
3.031,6,4,192,1,0,0,0,48,3,0,1511,0,144
7.935,6,1540,1422563,976,1380,7,1408,1388571,564,931,13,2801,33992
163.381,6,40,12156,20,633,8599,1360,4647,20,558,8589,1360,7509
10.598,6,1544,1431952,1012,1364,10,1432,1406381,532,475,19,1871,25571
1796.531,17,448,39896,403,35,4468,288,25676,45,288,40023,288,14220
229.568,6,30,7432,13,158,19130,267,1317,17,543,14342,1400,6115
2.316,6,8,440,5,0,579,0,268,3,0,1152,0,172
241.11,6,41,8625,20,570,12689,1418,5615,21,238,12054,580,3010
1772.092,6,180,15480,120,69,14891,69,8940,60,69,30031,69,6540
1.046,6,30,12051,16,525,69,1360,3298,14,909,64,1379,8753
52.403,6,175,245257,86,294,616,945,6485,89,2787,513,7010,238772
86.521,6,43,8924,21,401,693,889,2136,22,368,4113,3488,6788
0.578,6,439,458462,139,183,4,230,7797,300,1459,1,2896,450665
1794.875,6,356,22520,208,69,8670,69,12460,148,69,12209,69,10060
1751.122,2,18,576,18,8,103007,8,576,0,0,0,0,0
1700.527,17,12,498,11,14,170052,14,462,1,8,0,8,36
1779.333,17,140,11200,70,48,25787,48,5320,70,56,25787,56,5880
24.525,6,31,8912,14,158,1886,267,1357,17,763,1527,2076,7555
1789.397,17,87,3648,86,14,21051,14,3612,1,8,0,8,36
0.202,17,4,284,2,32,1,32,120,2,54,0,60,164
0.064,17,2,255,1,43,0,43,71,1,156,0,156,184
11.232,6,1816,1541720,1088,1362,10,1380,1508346,728,383,15,1380,33374
4.529,6,37,7189,19,218,251,314,3383,18,513,250,1179,3806
11.512,17,6,1000,3,48,5751,48,228,3,229,5750,308,772
86.104,2,2,64,2,8,86104,8,64,0,0,0,0,0
0.049,17,2,322,1,33,0,33,61,1,233,0,233,261
1742.247,6,96,7255,63,38,28100,205,4476,33,33,54437,98,2779
1.594,17,6,471,3,31,653,31,177,3,70,0,70,294
30.59,6,4,176,3,0,15295,0,128,1,0,0,0,48
1797.671,6,356,22520,208,69,8684,69,12460,148,69,12228,69,10060
1655.895,1,8,448,8,28,236556,28,448,0,0,0,0,0
1795.677,17,448,39896,403,35,4466,288,25676,45,288,40018,288,14220
1755.982,6,105,6270,60,27,29761,27,3525,45,27,39907,27,2745
1794.258,6,357,22629,208,69,8667,69,12460,149,69,12123,69,10169
2.654,17,7,392,2,26,8,29,108,5,28,663,41,284
4.66,6,39,7269,19,218,258,314,3383,20,513,229,1179,3886
1713.701,1,8,448,8,28,244814,28,448,0,0,0,0,0
35.711,17,22,1936,11,48,3564,48,836,11,72,3563,72,1100
4.867,17,12,912,6,37,972,37,390,6,59,970,65,522
1230.266,6,165,27462,99,304,12553,304,20100,66,83,18880,83,7362
5.455,6,39,7269,20,218,287,314,3423,19,513,289,1179,3846
232.328,6,64,45481,43,1180,5531,1408,37654,21,961,3079,3847,7827
280.184,6,29,7392,13,158,23348,267,1317,16,603,18676,2600,6075
3.993,2,2,64,2,8,3993,8,64,0,0,0,0,0
0.337,17,7,2368,7,310,56,354,2368,0,0,0,0,0
124.695,6,23,10128,12,549,79,1360,2709,11,1393,12453,3934,7419
484.921,6,94,12607,46,96,10775,267,4065,48,220,10317,2840,8542
599.413,6,9,546,6,31,119882,31,333,3,31,299696,31,213
1771.797,6,101,9410,66,66,27258,66,5610,35,60,52108,60,3800
0.55,6,26,7927,16,364,36,1125,3193,10,721,59,1420,4734
7.72,17,6,528,3,48,3853,48,228,3,72,3854,72,300
300.666,6,14,1043,7,177,50083,177,573,7,110,50083,110,470
13.017,17,4,352,2,48,12998,48,152,2,72,13001,72,200
283.584,6,32,7779,14,176,21814,267,1624,18,543,16676,1400,6155
1792.311,6,240,35580,150,302,12028,302,25920,90,83,20138,83,9660
0.118,1,6,624,0,0,0,0,0,6,76,23,76,624
0.018,17,2,150,1,47,0,47,75,1,47,0,47,75
317.035,6,74,19510,40,337,8129,1360,10077,34,403,9603,4649,9433
2.577,6,18,3257,10,99,266,182,924,8,477,342,1343,2333
35.799,17,6,528,3,48,17862,48,228,3,72,17891,72,300
19.981,17,4,824,2,48,19974,48,152,2,308,19974,308,672
1755.547,17,12,498,11,14,175554,14,462,1,8,0,8,36
1794.522,17,140,11200,70,48,26007,48,5320,70,56,26007,56,5880
1782.291,17,79,3312,78,14,23146,14,3276,1,8,0,8,36
101.724,6,73,48310,45,1180,2311,1408,40119,28,840,2282,2439,8191
1789.477,1,244,13664,244,28,7364,28,13664,0,0,0,0,0
0.168,1,2,112,2,28,168,28,112,0,0,0,0,0
4.995,17,2,144,1,36,0,36,64,1,52,0,52,80
0.016,17,4,732,2,32,11,32,120,2,278,11,278,612
0.528,17,2,168,1,48,0,48,76,1,64,0,64,92
1799.741,17,447,39864,402,35,4488,288,25644,45,288,40017,288,14220
5.236,6,37,7189,19,218,290,314,3383,18,513,291,1179,3806
0.268,1,2,112,2,28,268,28,112,0,0,0,0,0
1800.0,6,338,23282,143,46,12464,46,9456,195,46,9278,46,13826
0.006,17,2,333,1,38,0,38,66,1,239,0,239,267
0.03,17,2,237,1,72,0,72,100,1,109,0,109,137
0.324,6,24,4571,12,165,29,456,1446,12,415,27,888,3125
4.13,6,146,131796,101,948,41,1360,15495,45,3271,90,14960,116301
0.217,17,2,146,1,37,0,37,65,1,53,0,53,81
91.018,17,4,240,2,32,91017,32,120,2,32,91017,32,120
1.14,6,25,8056,12,164,88,267,1288,13,869,80,1440,6768
41.674,17,6,528,3,48,20828,48,228,3,72,20827,72,300
5.006,17,4,288,2,36,5004,36,128,2,52,5005,52,160
56.462,6,13,778,3,112,28225,112,240,10,90,6272,90,538
1784.194,6,356,22520,208,69,8619,69,12460,148,69,12137,69,10060
1.243,6,37,8212,19,320,69,1162,2716,18,433,63,1360,5496
1799.999,6,601,102401,294,237,6136,1360,71986,307,169,5882,1062,30415
1795.816,6,369,25799,215,99,8391,469,15085,154,69,11734,69,10714
34.675,17,10,760,10,48,3852,48,760,0,0,0,0,0
0.205,17,2,152,1,48,0,48,76,1,48,0,48,76
6.097,6,44,8369,23,227,277,314,4102,21,489,291,1179,4267
258.345,17,4,352,2,60,258344,60,176,2,60,258344,60,176
1748.659,6,95,7203,63,38,28204,205,4476,32,33,56402,98,2727
17.495,6,2260,2091649,1414,1399,12,1448,2042969,846,776,20,1448,48680
0.914,6,30,8902,16,499,60,1381,2680,14,627,54,1460,6222
7.87,6,77,24285,39,550,207,1152,18624,38,459,205,1179,5661
0.418,6,27,9076,13,252,34,647,1692,14,831,30,1448,7384
2.841,17,4,624,4,128,947,128,624,0,0,0,0,0
0.412,6,12,1653,6,288,76,288,548,6,426,47,434,1105
131.969,1,2,232,2,88,131969,88,232,0,0,0,0,0
1772.924,6,180,15480,120,69,14898,69,8940,60,69,30044,69,6540
1772.716,6,181,15589,120,69,14896,69,8940,61,69,29544,69,6649
1795.742,17,449,39928,404,35,4455,288,25708,45,288,40021,288,14220
300.596,6,18,1275,9,177,37552,177,701,9,110,37552,110,574
300.787,6,30,15887,16,195,20052,431,1644,14,1350,5092,3891,14243
41.713,17,43,8323,18,209,2452,1350,4278,25,133,1736,1350,4045
2.737,17,2,154,1,33,0,33,61,1,65,0,65,93
10.942,6,18,4266,10,275,1215,275,958,8,992,882,1440,3308
1259.668,2,7,224,7,8,209944,8,224,0,0,0,0,0
19.654,17,4,352,2,48,19646,48,152,2,72,19637,72,200
240.305,6,42,8941,20,197,12645,751,2429,22,536,11441,2736,6512
1564.174,2,13,416,13,8,130347,8,416,0,0,0,0,0
34.447,17,18,1584,9,48,4304,48,684,9,72,4304,72,900
0.099,17,2,334,1,32,0,32,60,1,246,0,246,274
1770.504,6,93,8742,62,66,29024,66,5270,31,60,59013,60,3472
240.201,6,151,130134,50,219,4901,595,3922,101,1359,2401,2836,126212
72.585,1,8,448,8,28,10369,28,448,0,0,0,0,0
16.066,17,14,6078,7,533,2664,1350,3933,7,278,2665,1350,2145
0.095,6,8,10330,1,0,0,0,40,7,1418,4,1418,10290
223.044,17,4,240,2,32,223043,32,120,2,32,223043,32,120
0.21,6,3,802,2,413,210,413,493,1,269,0,269,309
1.667,6,52,19491,29,896,59,1360,13750,23,400,66,1360,5741
3.862,17,2,124,2,34,3862,34,124,0,0,0,0,0
240.339,6,43,8930,21,524,12016,1418,5820,22,217,11444,618,3110
1796.943,17,142,11360,71,48,25670,48,5396,71,56,25670,56,5964
377.289,6,18,1242,14,180,29022,180,916,4,110,20075,110,326
3.015,17,7,612,4,32,999,32,240,3,96,1494,96,372
1765.226,2,15,480,15,8,126087,8,480,0,0,0,0,0
1720.463,17,12,498,11,14,172046,14,462,1,8,0,8,36
0.057,17,2,234,1,41,0,41,69,1,137,0,137,165
1745.311,6,95,7203,63,38,28150,205,4476,32,33,56292,98,2727
5.572,6,39,7285,20,218,293,314,3423,19,516,292,1179,3862
2.13,6,89,56988,51,1286,42,1432,50972,38,389,52,1432,6016
39.237,17,22,1936,11,48,3922,48,836,11,72,3922,72,1100
1798.824,17,87,3648,86,14,21162,14,3612,1,8,0,8,36
0.032,17,2,362,1,41,0,41,69,1,265,0,265,293
1755.293,6,5490,5028235,2350,147,747,893,148729,3140,1538,559,11216,4879506
0.716,6,119,87681,52,131,13,232,2609,67,1350,10,1420,85072
0.035,17,2,519,1,44,0,44,72,1,419,0,419,447
8.05,6,17,5391,9,275,1006,275,643,8,1104,642,1440,4748
1790.694,1,339,28476,339,56,5297,56,28476,0,0,0,0,0
299.902,1,4,224,4,28,99967,28,224,0,0,0,0,0
240.219,6,53,17738,28,792,8896,1418,14930,25,187,10008,580,2808
300.235,6,38,29102,22,190,14296,444,1913,16,2395,16013,9856,27189
1781.692,17,140,11200,70,48,25821,48,5320,70,56,25821,56,5880
0.008,17,2,391,1,44,0,44,72,1,291,0,291,319
1787.908,6,376,26217,217,98,8277,469,15372,159,69,11315,69,10845
102.645,6,24,10168,12,549,61,1360,2709,12,1161,9319,2720,7459
1792.254,6,357,22629,208,69,8658,69,12460,149,69,12109,69,10169
0.077,17,4,284,2,32,38,32,120,2,54,40,60,164
2.99,17,3,174,3,30,1495,30,174,0,0,0,0,0
281.763,6,29,7392,13,158,23480,267,1317,16,603,18761,2036,6075
1740.454,17,29,6815,29,207,62159,207,6815,0,0,0,0,0
8.606,17,6,1236,3,48,4294,48,228,3,308,4293,308,1008
0.577,6,10,924,5,283,101,283,551,5,105,101,105,373
8.905,6,70,20782,36,538,254,1152,15995,34,427,261,1152,4787
1781.772,6,374,25999,216,98,8287,469,15263,158,69,11348,69,10736
1.183,17,3,216,2,31,1161,31,118,1,70,0,70,98
2.266,6,41,16215,21,400,113,1152,2935,20,959,100,1460,13280
1682.152,17,18,4639,9,31,210267,37,536,9,427,210267,463,4103
0.889,17,3,201,3,39,444,39,201,0,0,0,0,0
0.512,17,2,384,1,39,0,39,67,1,289,0,289,317
0.021,17,2,288,1,59,0,59,87,1,173,0,173,201
1799.304,6,372,25519,216,93,8368,469,14794,156,69,11605,69,10725
158.511,6,100,126847,52,423,3108,628,3983,48,2674,3368,9856,122864
1.655,6,21,6028,12,245,150,517,1846,9,1224,201,1726,4182
12.24,6,1949,1690853,1181,1377,10,1420,1655912,768,420,15,1420,34941
3.334,6,2,88,2,0,0,0,88,0,0,0,0,0
23.326,6,34,10163,17,164,1446,267,1743,17,1070,1446,2411,8420
1741.377,17,29,6815,29,207,62192,207,6815,0,0,0,0,0
3.777,17,5,295,5,31,944,31,295,0,0,0,0,0
1798.667,6,404,35504,229,111,7888,1189,16997,175,143,10335,1420,18507
0.023,17,3,634,2,32,0,32,120,1,486,0,486,514
1798.265,17,236,79296,236,308,7652,308,79296,0,0,0,0,0
280.681,6,32,7853,14,158,21590,267,1357,18,524,16509,1400,6496
2.662,17,4,624,4,128,887,128,624,0,0,0,0,0
3.658,6,2,88,2,0,0,0,88,0,0,0,0,0
11.833,6,1874,1634547,1133,1387,10,1420,1600686,741,467,15,1883,33861
1792.0,6,366,23127,211,69,8533,69,12787,155,69,11636,69,10340
7.509,6,1552,1426480,977,1384,7,1408,1391916,575,931,12,2816,34564
0.568,6,23,7428,14,273,43,663,2104,9,1209,64,1946,5324
100.44,6,11,719,11,31,10044,31,719,0,0,0,0,0
0.811,6,2,80,1,0,0,0,40,1,0,0,0,40
732.204,6,133,16369,55,86,13559,267,4642,78,119,9508,1452,11727
0.083,6,9,1098,5,309,20,309,513,4,421,24,421,585
1542.306,17,33,11054,33,306,48197,322,11054,0,0,0,0,0
1.681,6,13,2311,8,188,240,245,700,5,1407,355,1407,1611
1741.008,6,98,7066,62,31,28541,31,4247,36,31,49741,31,2819
1659.521,1,7,392,7,28,276586,28,392,0,0,0,0,0
1776.215,17,140,11200,70,48,25742,48,5320,70,56,25742,56,5880
1743.076,6,95,7203,63,38,28114,205,4476,32,33,56221,98,2727
272.989,17,4,352,2,60,272988,60,176,2,60,272988,60,176
66.542,6,11,851,11,31,6654,31,851,0,0,0,0,0
0.012,6,2,1235,1,0,0,0,40,1,1155,0,1155,1195
1.349,6,50,19136,27,880,51,1360,13440,23,433,53,1360,5696
1.74,17,4,240,2,32,1739,32,120,2,32,1739,32,120
1798.97,1,345,28980,345,56,5229,56,28980,0,0,0,0,0
6.455,6,38,7245,19,218,358,314,3383,19,516,344,1179,3862
11.803,6,1865,1631137,1107,1418,10,1432,1596584,758,420,15,1432,34553
300.15,6,22,6988,13,169,25012,336,1350,9,860,37516,1706,5638
0.289,6,27,9042,13,247,24,624,1672,14,947,21,1448,7370
0.415,6,14,1733,7,288,66,288,588,7,284,38,434,1145
0.34,17,2,412,1,33,0,33,61,1,323,0,323,351
1741.322,17,30,20190,30,645,60045,645,20190,0,0,0,0,0
1.504,17,6,594,3,39,751,39,201,3,103,746,103,393
12.329,6,29,4652,16,173,821,293,2378,13,437,1000,1179,2274
0.515,6,27,9141,13,268,42,710,1758,14,947,35,1368,7383
1746.899,6,95,7203,63,38,28175,205,4476,32,33,56344,98,2727
1791.614,17,180,14040,180,50,10009,50,14040,0,0,0,0,0
2.753,6,9,1340,5,145,688,145,349,4,827,912,827,991
1741.392,17,30,31680,30,1028,60048,1028,31680,0,0,0,0,0
15.241,6,4864,5708360,2198,297,6,297,115357,2666,2047,0,16416,5593003
0.045,17,4,344,2,47,6,47,150,2,69,41,75,194
1789.619,6,357,22629,209,69,8603,69,12569,148,69,12171,69,10060
1786.635,6,104,8376,68,65,26666,65,4930,36,59,51043,59,3446
1.18,6,24,8004,11,164,100,267,1236,13,869,83,1440,6768
300.882,6,46,10040,24,540,13081,1360,4296,22,373,595,2667,5744
1743.782,6,94,7151,62,38,28586,205,4424,32,33,56245,98,2727
280.243,6,28,7352,13,158,23353,267,1317,15,678,20015,2800,6035
0.125,17,2,467,1,33,0,33,61,1,378,0,378,406
1781.373,6,353,22883,199,69,8996,69,12100,154,69,11642,69,10783
1781.762,6,362,22898,210,69,8525,69,12678,152,69,11799,69,10220
0.025,17,2,198,1,39,0,39,67,1,103,0,103,131
1401.113,17,16,1265,8,30,200151,37,471,8,71,200107,136,794
1747.305,6,95,7203,63,38,28182,205,4476,32,33,56351,98,2727
107.106,17,4,240,2,32,107104,32,120,2,32,107105,32,120
0.389,6,27,9069,13,261,32,683,1728,14,943,27,1408,7341
1772.153,6,180,15480,120,69,14892,69,8940,60,69,30033,69,6540
1740.534,17,30,31680,30,1028,60018,1028,31680,0,0,0,0,0
4.096,6,637,563986,400,1376,10,1420,550273,237,467,17,1883,13713
5.009,17,4,542,2,36,5005,36,128,2,179,5004,187,414
0.124,6,9,1343,5,145,31,145,349,4,830,32,830,994
0.149,1,2,112,2,28,149,28,112,0,0,0,0,0
0.029,17,2,218,1,65,0,65,93,1,97,0,97,125
1772.408,1,58,4872,58,56,31094,56,4872,0,0,0,0,0
0.045,17,4,284,2,32,24,32,120,2,54,30,60,164
120.525,6,9,1647,6,100,24105,100,344,3,1179,60131,1179,1303
20.157,6,23,5773,13,107,1679,159,1138,10,684,2238,1418,4635
1788.23,6,105,7100,65,56,27941,208,4570,40,31,45844,31,2530
47.593,6,42,8740,21,367,516,787,2022,21,391,2373,3488,6718
1793.086,1,58,4872,0,0,0,0,0,58,56,31457,56,4872
12.931,6,24,6993,13,275,1077,275,1078,11,910,790,1420,5915
164.101,6,21,9840,11,380,74,832,1637,10,1298,18219,2568,8203
1740.723,17,29,30624,29,1028,62168,1028,30624,0,0,0,0,0
2.768,6,28,12277,15,771,197,1360,6035,13,1142,218,2099,6242
3.044,17,3,2906,3,940,1522,1451,2906,0,0,0,0,0
129.104,6,30,7432,13,158,10758,267,1317,17,543,8064,1400,6115
1770.282,17,283,54818,283,165,6277,358,54818,0,0,0,0,0
94.153,6,25,11358,12,433,91,990,1823,13,1000,7833,1360,9535
0.01,17,2,2752,2,1348,10,1348,2752,0,0,0,0,0
392.705,6,18,1242,14,180,30208,180,916,4,110,20076,110,326
120.361,2,2,64,2,8,120361,8,64,0,0,0,0,0
174.7,17,4,352,2,60,174699,60,176,2,60,174699,60,176
0.035,17,2,198,1,63,0,63,91,1,79,0,79,107
20.894,17,4,240,2,32,20893,32,120,2,32,20893,32,120
285.359,6,38,15940,23,795,12970,1448,9162,15,665,4360,1448,6778
1775.644,6,528,92366,331,304,5380,304,68132,197,83,9059,83,24234
3.402,17,5,514,4,32,1128,32,240,1,246,0,246,274
0.051,17,4,284,2,32,45,32,120,2,54,45,60,164
1.442,6,47,18775,27,863,55,1360,13199,20,476,67,2715,5576
43.394,6,5738,5487330,3820,1359,11,1408,5382930,1918,776,22,1408,104400
0.226,17,2,2754,2,1349,226,1349,2754,0,0,0,0,0
1749.169,1,54,4536,0,0,0,0,0,54,56,33003,56,4536
1764.237,2,15,480,15,8,126016,8,480,0,0,0,0,0
2.728,6,32,11540,19,374,151,855,1887,13,1014,177,1452,9653
0.046,17,4,288,2,33,0,33,122,2,55,36,61,166
6.866,17,4,240,2,32,6865,32,120,2,32,6865,32,120
1744.682,6,95,7203,63,38,28140,205,4476,32,33,56271,98,2727
0.035,6,14,4044,8,88,4,88,452,6,1670,7,1880,3592
0.034,6,12,3705,6,171,6,171,491,6,964,5,1448,3214
1.519,6,39,9888,21,440,75,1360,4392,18,433,77,1360,5496
0.102,17,2,245,1,32,0,32,60,1,157,0,157,185
280.44,6,29,7392,12,158,25494,267,1277,17,603,17525,1380,6115
1.273,6,50,18720,29,846,45,1360,13059,21,480,54,4075,5661
364.131,6,63,6569,24,91,15826,339,2518,39,118,9582,1062,4051
240.165,6,58,19502,32,778,7747,1402,16459,26,210,9606,580,3043
45.478,6,27,7177,13,155,3789,267,1306,14,530,3497,3417,5871
1769.701,6,101,9410,66,66,27226,66,5610,35,60,52046,60,3800
0.381,6,27,8951,13,232,31,567,1612,14,825,28,1438,7339
240.603,6,436,388087,160,519,1513,1418,11989,276,1370,874,1460,376098
1739.313,6,87,6322,58,31,30514,31,3915,29,31,62117,31,2407
1.074,17,6,552,3,32,503,32,180,3,96,469,96,372
15.48,17,21,10162,10,380,1716,1350,4087,11,524,1545,1350,6075
2.671,17,4,1556,4,361,890,361,1556,0,0,0,0,0
1787.906,6,376,26617,216,104,8315,469,15732,160,69,11244,69,10885
1.504,6,13,1096,7,283,221,283,663,6,105,265,105,433
1798.087,17,768,46392,768,32,2344,37,46392,0,0,0,0,0
1791.375,6,4488,3654188,2083,133,860,353,118428,2405,1461,745,2816,3535760
1773.253,6,180,15480,120,69,14901,69,8940,60,69,30048,69,6540
1788.527,1,77,6468,0,0,0,0,0,77,56,23533,56,6468
1797.545,6,360,22818,209,69,8642,69,12569,151,69,11983,69,10249
1.464,6,41,9968,21,440,73,1360,4392,20,433,67,1360,5576
240.168,6,53,17975,28,801,8894,1402,15089,25,197,10006,580,2886
0.381,6,20,7151,12,318,34,600,1906,8,964,52,1471,5245
1.023,6,10,1687,7,100,170,100,384,3,1179,382,1179,1303
198.307,17,4,352,2,60,198306,60,176,2,60,198306,60,176
0.21,17,2,152,1,48,0,48,76,1,48,0,48,76
1797.192,6,130,7994,73,43,24961,208,4784,57,31,32085,31,3210
1792.847,17,180,11520,180,36,10015,36,11520,0,0,0,0,0
3.965,6,23,3545,13,143,330,293,1530,10,537,411,1179,2015
1.161,6,10,861,5,222,287,222,426,5,231,286,231,435
54.704,6,27,7177,13,155,4558,267,1306,14,530,4207,3417,5871
1744.097,6,95,7203,63,38,28130,205,4476,32,33,56253,98,2727
1494.553,2,11,352,11,8,149455,8,352,0,0,0,0,0
1755.293,1,8,448,8,28,250756,28,448,0,0,0,0,0
0.049,17,4,588,2,48,44,48,152,2,190,42,308,436
0.069,17,2,154,1,33,0,33,61,1,65,0,65,93
63.803,6,13,1079,12,43,5800,43,1019,1,0,0,0,60
251.855,6,23,6642,13,230,145,500,1674,10,570,27975,1420,4968
0.886,6,23,6592,13,342,73,1053,2235,10,988,97,1731,4357
1788.62,1,97,5432,97,28,18631,28,5432,0,0,0,0,0
1781.76,6,416,24920,208,69,8607,69,12460,208,34,8607,48,12460
70.382,6,30,7435,13,155,5865,267,1306,17,418,4398,1997,6129
523.379,6,49,8078,24,248,22753,517,2263,25,642,21805,1418,5815
0.185,6,10,690,6,71,37,71,391,4,83,48,83,299
371.38,6,25,1651,17,177,23211,177,1117,8,110,9228,110,534
1.048,17,4,368,2,32,302,32,120,2,96,0,96,248
8.406,6,80,24725,39,560,221,1152,18928,41,461,203,1179,5797
188.466,6,11,3578,4,112,62813,112,280,7,1003,31407,1460,3298
1759.043,6,124,12392,77,63,23145,722,6371,47,91,38233,1408,6021
1.651,6,24,6040,13,108,137,147,959,11,772,140,1608,5081
587.89,1,6,336,6,28,117578,28,336,0,0,0,0,0
173.76,6,28,6519,11,217,6304,502,1312,17,323,10854,1420,5207
250.044,6,86,25452,41,539,575,1360,15739,45,292,5679,1929,9713
2.01,17,6,1058,3,32,699,32,180,3,264,0,274,878
1790.866,1,342,28728,342,56,5251,56,28728,0,0,0,0,0
1797.636,17,447,150168,447,307,4030,308,150168,0,0,0,0,0
1766.875,1,167,9352,167,28,10643,28,9352,0,0,0,0,0
2.705,6,10,541,4,0,901,0,204,6,7,505,7,337
1796.367,6,418,25064,209,69,8636,69,12500,209,34,8636,64,12564
1756.628,6,125,12568,69,66,25832,517,4791,56,231,31937,1418,7777
0.856,6,14,2021,8,288,118,288,916,6,426,132,434,1105
1007.713,2,5,160,5,8,251928,8,160,0,0,0,0,0
70.408,6,30,7435,13,155,5867,267,1306,17,418,4399,1997,6129
1771.938,6,180,15480,120,69,14890,69,8940,60,69,30032,69,6540
1794.083,17,80,3354,79,14,23001,14,3318,1,8,0,8,36
0.024,17,4,284,2,32,0,32,120,2,54,11,60,164
0.123,17,4,368,2,32,28,32,120,2,96,26,96,248
0.234,6,9,1339,5,145,58,145,349,4,826,63,826,990
19.009,6,7,399,1,0,0,0,52,6,7,3801,7,347
1772.943,6,180,15480,120,69,14898,69,8940,60,69,30041,69,6540
6.953,6,16,4662,9,290,869,517,1057,7,1077,1157,1408,3605
1.205,6,363,416189,170,213,7,255,11291,193,2078,6,12618,404898
127.774,17,4,352,2,60,127773,60,176,2,60,127773,60,176
1798.745,1,56,4704,56,56,32704,56,4704,0,0,0,0,0
6.052,6,9,484,4,0,2017,0,216,5,0,1445,0,268
0.028,17,2,904,1,300,0,300,328,1,548,0,548,576
3.846,17,4,3964,4,963,1282,1451,3964,0,0,0,0,0
1774.497,6,212,22857,134,75,13342,267,10355,78,132,23042,1452,12502
124.881,6,32,7786,11,155,31,267,1226,21,357,6243,2840,6560
3.929,17,5,295,5,31,982,31,295,0,0,0,0,0
281.905,6,32,8217,14,158,21685,267,1357,18,613,16579,1380,6860
1771.91,6,180,15480,120,69,14890,69,8940,60,69,30030,69,6540
1795.684,6,428,25730,212,69,8510,69,12689,216,34,8351,48,13041
64.592,17,2,150,2,47,64592,47,150,0,0,0,0,0
1120.77,17,12,3143,6,31,224153,37,355,6,436,224153,463,2788
132.085,6,22,10186,11,304,81,597,1385,11,1192,13190,1460,8801
0.017,17,2,410,1,36,0,36,64,1,318,0,318,346
1.148,6,22,7900,11,164,97,267,1236,11,1216,97,3819,6664
421.097,2,3,96,3,8,210548,8,96,0,0,0,0,0
75.141,6,17,1064,7,42,12500,46,449,10,43,8349,46,615
0.383,17,2,204,1,34,0,34,62,1,114,0,114,142
1684.537,2,17,544,17,8,105283,8,544,0,0,0,0,0
1770.213,6,99,9240,66,65,27234,65,5577,33,59,55314,59,3663
64.869,6,16,3976,7,407,10811,722,1174,9,1165,8061,1448,2802
1263.359,2,11,352,11,8,126335,8,352,0,0,0,0,0
0.414,17,2,152,1,48,0,48,76,1,48,0,48,76
1.626,6,4,208,4,24,542,24,208,0,0,0,0,0
1739.203,6,92,6668,60,31,29478,31,4062,32,31,56102,31,2606
0.176,17,2,178,1,29,0,29,57,1,93,0,93,121
1779.364,1,64,5376,0,0,0,0,0,64,56,28243,56,5376
20.739,6,2993,2812851,1945,1368,10,1408,2753691,1048,931,19,2801,59160
280.496,6,27,7312,12,158,25499,267,1277,15,678,20030,2045,6035
300.668,6,37,8340,20,268,15824,728,1906,17,478,531,1928,6434
0.016,17,2,218,1,65,0,65,93,1,97,0,97,125
0.736,17,2,167,1,39,0,39,67,1,72,0,72,100
0.019,6,2,218,1,138,0,138,178,1,0,0,0,40
37.044,17,4,352,2,60,37043,60,176,2,60,37042,60,176
15.586,17,13,6532,7,613,2587,1350,4490,6,312,3102,1350,2042
61.31,6,34,15930,22,815,2919,1408,9308,12,855,5550,3847,6622
142.779,6,22,9403,11,418,65,944,1738,11,1030,14265,1360,7665
1790.325,6,197,19057,129,99,13986,469,11645,68,69,26712,69,7412
0.013,17,2,397,1,53,0,53,81,1,288,0,288,316
2.318,6,13,2311,8,188,331,245,700,5,1407,516,1407,1611
0.065,6,9,1339,5,145,16,145,349,4,826,14,826,990
1795.195,17,448,39896,403,35,4465,288,25676,45,288,40020,288,14220
1761.41,1,120,6720,120,28,14801,28,6720,0,0,0,0,0
436.588,6,152,111925,96,1290,4595,1448,97964,56,552,3734,1448,13961
0.533,17,2,136,1,32,0,32,60,1,48,0,48,76
1772.371,6,180,15480,120,69,14893,69,8940,60,69,30032,69,6540
9.801,6,28,5845,15,111,700,267,1386,13,655,810,1420,4459
4.375,17,20,5804,9,323,541,1350,3161,11,212,433,1350,2643
1773.13,6,180,15480,120,69,14900,69,8940,60,69,30045,69,6540
156.191,6,139,128761,91,430,1735,647,6114,48,2669,1420,11264,122647
32.471,6,44,10581,21,769,544,1360,4766,23,325,1466,1360,5815
0.119,17,2,144,1,36,0,36,64,1,52,0,52,80
8.432,6,36,7165,18,218,496,314,3343,18,516,480,1179,3822
9.632,6,98,30993,48,593,204,1152,24495,50,408,191,1152,6498
1723.526,1,60,3360,60,28,29212,28,3360,0,0,0,0,0
0.05,17,4,680,2,33,0,33,122,2,251,0,323,558
84.337,6,34,8223,12,155,29,267,1266,22,357,4015,1917,6957
0.029,6,10,1723,6,578,5,997,1400,4,159,9,159,323
1773.044,6,180,15480,120,69,14899,69,8940,60,69,30048,69,6540
6.319,6,40,7309,21,218,315,314,3463,19,513,337,1179,3846
2.212,6,13,2311,8,188,316,245,700,5,1407,488,1407,1611
31.878,6,5,240,2,0,1500,0,96,3,0,11098,0,144
1785.992,6,102,8296,68,65,26656,65,4930,34,59,54118,59,3366
0.475,6,54,25431,31,1063,15,1380,18346,23,558,19,1923,7085
31.944,6,6,360,0,0,0,0,0,6,0,0,0,360
1783.811,6,361,22858,210,69,8534,69,12678,151,69,11892,69,10180
1.323,6,51,20028,29,937,47,1460,14327,22,400,54,1460,5701
0.064,17,4,368,2,32,32,32,120,2,96,32,96,248
1794.769,6,416,24920,208,69,8670,69,12460,208,34,8670,48,12460
1.365,17,27,14182,15,733,95,1350,11415,12,202,121,1350,2767
125.37,2,2,64,2,8,125370,8,64,0,0,0,0,0
3.875,17,4,352,2,48,3862,48,152,2,72,3863,72,200
0.189,6,46,22382,27,1086,7,1420,17401,19,467,10,1883,4981
6.215,6,38,7229,20,218,327,314,3423,18,513,349,1179,3806
0.944,6,28,8160,15,222,56,540,1964,13,944,64,1591,6196
2.25,6,27,8865,17,288,140,598,1550,10,987,229,1456,7315
3.529,6,33,6129,17,206,220,314,2744,16,456,218,1152,3385
1794.966,17,419,140784,419,308,4294,308,140784,0,0,0,0,0
19.769,1,25,2600,0,0,0,0,0,25,76,823,76,2600
1792.611,1,166,17596,166,78,10864,78,17596,0,0,0,0,0
0.021,17,2,201,1,40,0,40,68,1,105,0,105,133
88.965,6,23,11278,12,433,66,990,1823,11,1286,8885,3928,9455
1777.098,17,73,3060,72,14,25029,14,3024,1,8,0,8,36
1795.22,1,220,23320,220,78,8197,78,23320,0,0,0,0,0
17.247,6,2570,2411475,1669,1368,10,1408,2359959,901,931,18,2816,51516
0.257,17,6,1819,6,275,51,316,1819,0,0,0,0,0
1619.261,6,24,3624,16,241,107950,241,2568,8,92,231295,92,1056
1793.388,6,761,51642,379,31,4744,31,25858,382,31,4706,31,25784
8.351,6,1352,1156823,803,1390,10,1420,1130642,549,420,15,1420,26181
0.998,6,26,5700,13,125,83,267,1275,13,780,74,1460,4425
79.389,6,124,88314,73,1271,1102,1448,77557,51,674,1583,1448,10757
240.294,6,43,9061,21,519,12014,1402,5775,22,237,11442,618,3286
0.117,17,4,588,2,48,107,48,152,2,190,107,308,436
1800.0,6,221,18672,82,71,21851,301,8165,139,69,13043,1062,10507
122.685,6,42,18599,22,807,98,1360,6574,20,934,6447,2720,12025
3.377,6,13,2311,8,188,482,245,700,5,1407,776,1407,1611
0.098,6,9,1340,5,145,24,145,349,4,827,29,827,991
3.065,17,32,23367,15,630,218,1350,9882,17,765,127,1350,13485
10.854,6,1671,1497754,1044,1383,10,1420,1468453,627,467,17,1883,29301
1.359,6,25,8056,13,164,96,267,1340,12,1014,105,2736,6716
1791.917,6,356,22520,208,69,8656,69,12460,148,69,12189,69,10060
1.445,6,48,20372,28,908,53,1360,14796,20,476,64,2715,5576
0.074,17,4,360,2,30,0,30,116,2,94,32,94,244
1680.552,17,12,498,11,14,168055,14,462,1,8,0,8,36
0.216,6,3,453,2,241,216,241,321,1,92,0,92,132
1794.674,1,242,13552,242,28,7446,28,13552,0,0,0,0,0
88.647,6,25,12059,12,410,66,922,1754,13,1085,7376,1460,10305
0.14,6,7,423,4,43,28,43,259,3,0,66,0,164
1786.564,6,124,9742,76,66,23820,66,5482,48,60,38009,60,4260
20.09,17,27,7787,11,280,2005,1350,3390,16,246,1336,1350,4397
0.155,6,9,1340,5,145,38,145,349,4,827,28,827,991
0.169,6,43,17881,24,993,7,1420,12900,19,467,9,1883,4981
1785.477,6,415,24880,207,69,8667,69,12420,208,34,8625,48,12460
280.486,6,26,7272,12,158,25498,267,1277,14,678,21574,2045,5995
1791.347,6,367,23305,212,69,8489,69,12758,155,69,11632,69,10547
252.183,2,2,64,2,8,252183,8,64,0,0,0,0,0
0.003,17,2,144,1,36,0,36,64,1,52,0,52,80
29.934,6,12,1313,7,185,4989,185,557,5,244,7482,476,756
10.808,6,78,24341,39,550,284,1152,18640,39,459,277,1179,5701
1755.951,6,104,6218,60,27,29761,27,3525,44,27,40835,27,2693
0.253,2,2,80,2,16,253,16,80,0,0,0,0,0
0.034,17,2,904,1,300,0,300,328,1,548,0,548,576
1797.863,17,447,39580,403,35,4472,288,25676,44,288,40951,288,13904
113.84,1,6,336,6,28,22768,28,336,0,0,0,0,0
1773.396,6,183,15738,121,69,14778,69,8980,62,69,29063,69,6758
33.901,6,33,5244,16,154,2260,721,1910,17,305,2103,1368,3334
46.461,6,2,120,2,0,0,0,120,0,0,0,0,0
0.313,6,24,7446,13,335,26,668,2026,11,968,30,1475,5420
1799.608,17,767,46250,767,32,2349,37,46250,0,0,0,0,0
33.932,6,18,2511,7,188,365,245,660,11,703,3368,1152,1851
1787.016,6,102,8228,68,64,26671,64,4896,34,58,54149,58,3332
61.126,17,4,304,4,48,20375,48,304,0,0,0,0,0
1.227,6,49,18654,27,849,47,1360,12998,22,476,50,2720,5656
1744.578,2,28,896,28,8,64614,8,896,0,0,0,0,0
1773.358,6,181,15589,120,69,14902,69,8940,61,69,29547,69,6649
1.199,6,146,143461,72,226,16,255,5562,74,1914,15,5057,137899
52.549,6,30,7432,13,158,4379,267,1317,17,543,3281,1400,6115
115.068,17,4,514,2,36,115060,36,128,2,165,115063,187,386
3.498,6,2,88,2,0,0,0,88,0,0,0,0,0
299.525,6,6,364,4,31,99841,31,222,2,31,299514,31,142
756.946,2,6,192,6,8,151389,8,192,0,0,0,0,0
1094.444,17,216,16416,216,48,5090,48,16416,0,0,0,0,0
15.157,6,5,706,3,46,7578,46,166,2,460,15007,460,540
1.627,6,114,88220,53,131,31,232,2649,61,1511,26,4140,85571
192.825,17,8,704,4,48,64270,48,304,4,72,64270,72,400
280.463,6,27,7312,13,158,23371,267,1317,14,678,21570,3456,5995
12.514,6,101,32563,51,586,250,1152,26081,50,447,248,1179,6482
6.658,6,38,7245,19,218,369,314,3383,19,516,355,1179,3862
5.213,6,14,2351,8,188,744,245,700,6,703,993,1152,1651
42.619,17,24,2112,12,48,3869,48,912,12,72,3868,72,1200
1795.169,6,1323,142500,543,111,3312,332,65302,780,109,2304,132,77198
1.416,6,38,8254,19,321,78,1164,2718,19,433,67,1360,5536
17.749,6,26,5779,13,275,1479,275,815,13,1104,1461,1440,4964
1.239,6,37,8214,19,321,68,1164,2718,18,476,63,2715,5496
5.009,17,24,7977,10,362,556,1350,3904,14,262,208,1350,4073
6.282,6,29,8832,14,158,483,267,1357,15,858,448,3436,7475
0.18,17,2,588,1,39,0,39,67,1,493,0,493,521
297.887,6,6,1225,4,319,99295,398,799,2,173,297719,254,426
1796.646,17,449,39928,404,35,4458,288,25708,45,288,40020,288,14220
1784.637,6,354,22440,207,69,8663,69,12420,147,69,12223,69,10020
363.212,6,18,1242,14,180,27939,180,916,4,110,20053,110,326
280.453,6,30,7432,13,158,23371,267,1317,17,603,17524,2760,6115
1796.284,17,140,11200,70,48,26033,48,5320,70,56,26033,56,5880
0.103,6,28,18353,15,171,7,241,1302,13,1487,7,2816,17051
316.959,6,102,35658,54,562,5980,1360,24709,48,322,6740,3289,10949
240.491,6,11,602,4,106,80160,106,274,7,0,40080,0,328
11.842,6,1880,1637860,1156,1363,10,1380,1604667,724,467,16,1923,33193
51.333,6,687,471648,333,338,154,339,22744,354,1233,145,1368,448904
63.769,6,72,50535,46,1175,1417,1448,42368,26,749,2536,1448,8167
0.359,6,11,1228,6,145,71,145,389,5,635,66,635,839
0.008,17,2,330,1,45,0,45,73,1,229,0,229,257
1681.293,1,7,392,7,28,280215,28,392,0,0,0,0,0
0.122,6,3,160,2,0,122,0,100,1,0,0,0,60
244.249,6,37,9463,15,322,40,974,2079,22,415,11630,1438,7384
49.429,6,28,7217,13,155,4119,267,1306,15,482,3530,1997,5911
360.971,2,4,128,4,8,120323,8,128,0,0,0,0,0
12.817,6,20,1495,10,222,1423,222,848,10,231,1423,231,647
5.011,17,4,514,2,36,5005,36,128,2,165,5007,171,386
1620.08,1,7,392,7,28,270013,28,392,0,0,0,0,0
139.205,6,35,8922,19,394,7733,867,1975,16,572,623,2720,6947
36.008,17,8,704,4,48,11982,48,304,4,72,11987,72,400
1684.486,2,18,576,18,8,99087,8,576,0,0,0,0,0
1.249,6,51,21325,29,904,44,1360,15669,22,433,51,1360,5656
1.073,6,116,87349,50,131,21,232,2529,66,1347,16,1430,84820
1798.761,17,448,39896,403,35,4474,288,25676,45,288,40018,288,14220
0.931,6,26,5700,13,125,77,267,1275,13,780,71,1460,4425
1.444,6,46,18923,26,944,57,1460,13347,20,476,65,2615,5576
77.989,17,15,5040,15,308,5570,308,5040,0,0,0,0,0
0.455,17,2,144,1,36,0,36,64,1,52,0,52,80
280.242,6,29,7392,13,158,23353,267,1317,16,603,18679,1400,6075
1781.757,6,366,23127,211,69,8484,69,12787,155,69,11569,69,10340
387.799,6,4791,4987330,2991,389,129,420,179262,1800,2632,215,18304,4808068
0.205,6,24,7176,12,155,18,267,1261,12,678,17,2045,5915
71.205,6,36,12743,17,410,4450,1360,2789,19,834,3945,1360,9954
7.962,6,1264,1093785,777,1361,10,1380,1070063,487,421,16,1923,23722
1771.216,17,140,46984,140,307,12742,312,46984,0,0,0,0,0
1743.223,6,96,7493,63,43,28116,205,4681,33,33,54467,98,2812
196.837,6,72,49816,46,1191,4374,1408,41730,26,747,2468,1408,8086
0.334,17,2,180,1,30,0,30,58,1,94,0,94,122
94.539,6,29,7687,7,155,15756,267,1066,22,318,4500,1420,6621
174.053,6,205,164298,133,1285,1318,1408,149654,72,605,1986,1408,14644
1775.757,17,136,10880,68,48,26503,48,5168,68,56,26503,56,5712
0.01,17,2,392,1,62,0,62,90,1,274,0,274,302
5.512,6,41,7365,22,218,262,314,3503,19,516,291,1179,3862
80.884,6,20,8238,11,525,91,1236,2047,9,1163,10086,3151,6191
1764.316,2,14,448,14,8,135716,8,448,0,0,0,0,0
0.098,17,2,2754,2,1349,98,1349,2754,0,0,0,0,0
1785.683,1,342,28728,342,56,5236,56,28728,0,0,0,0,0
23.318,1,12,4816,12,373,2119,404,4816,0,0,0,0,0
1776.79,17,142,11360,71,48,25382,48,5396,71,56,25382,56,5964
9.407,6,22,3957,12,234,855,564,1568,10,463,985,1343,2389
0.071,17,2,341,1,64,0,64,92,1,221,0,221,249
3.104,17,3,228,2,48,3049,48,152,1,48,0,48,76
8.49,6,1671,1523132,1043,1381,7,1408,1485812,628,931,13,2816,37320
437.028,6,79,14184,34,199,13243,1189,4154,45,283,9932,1420,10030
0.427,6,11,1503,6,213,85,213,457,5,421,104,421,1046
80.561,6,43,8803,21,401,555,888,2124,22,482,3829,3488,6679
0.507,17,4,768,2,39,502,39,134,2,289,11,289,634
73.081,6,49,14693,24,969,443,1360,8798,25,325,3037,1360,5895
1783.272,6,994,188926,487,321,3669,825,86196,507,244,3524,2380,102730
0.034,6,2,104,1,0,0,0,64,1,0,0,0,40
882.128,2,6,192,6,8,176425,8,192,0,0,0,0,0
0.072,17,2,380,1,41,0,41,69,1,283,0,283,311
1795.687,6,1102,124390,379,110,4750,114,55664,723,110,2487,110,68726
1799.667,6,367,25650,214,99,8449,469,15045,153,69,11836,69,10605
0.016,17,2,224,1,58,0,58,86,1,110,0,110,138
1.401,6,36,23931,21,840,70,1360,5915,15,1740,90,4080,18016
0.241,17,3,451,2,39,196,39,134,1,289,0,289,317
54.104,6,48,9914,23,450,587,766,2801,25,406,2249,1360,7113
0.024,17,2,206,1,44,0,44,72,1,106,0,106,134
0.608,6,10,924,5,283,107,283,551,5,105,106,105,373
213.819,6,30,8872,14,158,16447,267,1357,16,687,14253,1781,7515
315.24,6,21,2481,7,242,52539,517,1111,14,323,24248,499,1370
2.506,17,3,451,2,39,983,39,134,1,289,0,289,317
2.313,17,2,154,1,33,0,33,61,1,65,0,65,93
1755.12,6,108,8120,68,38,26195,205,4798,40,32,44994,98,3322
0.369,6,10,968,5,256,90,256,460,5,304,90,304,508
284.048,1,4,224,4,28,94682,28,224,0,0,0,0,0
0.884,6,10,1687,7,100,147,100,384,3,1179,312,1179,1303
1797.701,1,254,26924,254,78,7105,78,26924,0,0,0,0,0
4.343,6,19,3309,11,99,385,182,976,8,477,555,1343,2333
1788.715,1,251,14056,251,28,7154,28,14056,0,0,0,0,0
1771.107,6,103,9448,66,65,27247,65,5577,37,59,49195,59,3871
4.951,17,4,288,2,36,4949,36,128,2,52,4949,52,160
90.05,6,42,10279,21,727,787,1360,4544,21,348,4494,2667,5735
39.188,6,13,880,4,92,13062,92,296,9,92,4875,92,584
15.824,6,8,432,4,0,5274,0,216,4,0,5270,0,216
1773.024,6,180,15480,120,69,14899,69,8940,60,69,30046,69,6540
1798.188,1,345,28980,345,56,5227,56,28980,0,0,0,0,0
0.264,17,3,451,2,39,44,39,134,1,289,0,289,317
1741.515,6,116,13807,73,83,24187,516,5852,43,163,41457,1452,7955
1772.577,1,58,4872,0,0,0,0,0,58,56,31097,56,4872
1.322,6,46,18190,26,887,52,1460,12614,20,433,60,1460,5576
1764.1,2,15,480,15,8,126007,8,480,0,0,0,0,0
1797.486,1,67,5628,67,56,27234,56,5628,0,0,0,0,0
3.511,6,20,6301,9,262,429,517,1264,11,744,343,1368,5037
1752.487,6,186,11385,93,47,19048,208,6766,93,31,19046,31,4619
173.137,6,20889,20163584,14025,1360,12,1408,19801956,6864,931,25,2801,361628
101.104,6,23,9166,12,304,68,597,1425,11,1041,10093,1721,7741
253.228,17,6,1496,3,32,126611,37,181,3,410,126611,463,1315
1779.11,6,444,38192,210,66,8511,658,14867,234,87,7635,4649,23325
422.488,17,6,528,3,60,211243,60,264,3,60,211243,60,264
0.972,17,25,15038,12,553,88,1350,6983,13,591,65,1350,8055
75.644,6,31,7613,12,155,28,267,1266,19,398,4202,3417,6347
99.742,6,45,27236,24,746,38,1460,3976,21,1400,4979,2920,23260
4.786,6,39,7269,19,218,265,314,3383,20,513,236,1179,3886
0.045,6,12,965,7,182,7,182,542,5,77,4,134,423
0.349,6,3,120,2,0,349,0,80,1,0,0,0,40
9.607,6,11,856,3,106,4803,106,234,8,90,1347,90,622
1.618,6,25,8787,15,289,115,599,1471,10,987,160,1452,7316
1789.142,17,83,3480,82,14,22088,14,3444,1,8,0,8,36
72.709,6,21,9714,12,410,52,922,1742,9,1520,9074,4416,7972
1782.178,6,97,6302,62,47,29216,208,4003,35,31,52385,31,2299
1203.198,2,12,384,12,8,109381,8,384,0,0,0,0,0
168.868,6,15,1626,7,332,28144,332,1024,8,83,24122,83,602
1090.427,6,130,8904,48,46,22564,46,3738,82,46,13461,46,5166
1779.968,1,342,28728,342,56,5219,56,28728,0,0,0,0,0
239.901,2,2,64,2,8,239901,8,64,0,0,0,0,0
841.699,1,40,2240,40,28,21582,28,2240,0,0,0,0,0
0.192,6,46,20216,26,1009,7,1420,15195,20,467,9,1883,5021
1460.051,1,28,1568,28,28,54075,28,1568,0,0,0,0,0
127.824,17,11,4457,11,377,12782,462,4457,0,0,0,0,0
27.477,6,10,2940,5,92,6869,92,348,5,1164,6761,1448,2592
232.094,6,29,7630,20,321,12215,517,1691,9,910,8239,1408,5939
1776.352,17,136,10880,68,48,26512,48,5168,68,56,26512,56,5712
1791.012,1,59,4956,0,0,0,0,0,59,56,30879,56,4956
0.438,6,12,1653,6,288,85,288,548,6,426,50,434,1105
0.35,6,10,968,5,256,85,256,460,5,304,85,304,508
0.837,17,18,5722,8,362,119,1350,3120,10,232,89,1350,2602
0.116,17,2,194,1,61,0,61,89,1,77,0,77,105
1779.496,6,201,18727,103,63,17446,721,8242,98,152,18340,1414,10485
196.391,17,311,47918,153,137,1290,1209,25300,158,115,1250,425,22618
19.615,6,2861,2694434,1825,1397,10,1440,2635898,1036,776,18,1440,58536
1.449,6,24,8004,12,164,113,267,1288,12,1014,112,2491,6716
1746.624,6,143,8877,77,46,22981,208,5245,66,31,26865,31,3632
4.496,6,37,7189,19,218,249,314,3383,18,513,248,1179,3806
0.032,17,2,241,1,52,0,52,80,1,133,0,133,161
16.287,17,29,7647,13,317,1357,1350,4497,16,168,1083,1350,3150
240.288,6,55,19522,29,835,8581,1418,16557,26,200,9610,580,2965
0.17,6,46,21072,26,1070,6,1420,16051,20,467,8,1883,5021
10.994,17,15,17706,15,1152,785,1449,17706,0,0,0,0,0
1740.544,17,30,31680,30,1028,60018,1028,31680,0,0,0,0,0
7.1,6,194,215601,136,133,52,201,6307,58,3832,121,25452,209294
192.939,17,4,352,2,60,192937,60,176,2,60,192938,60,176
0.95,17,4,524,2,39,939,39,134,2,167,935,167,390
108.31,17,8,704,4,48,36100,48,304,4,72,36100,72,400
17.763,6,2780,2585562,1789,1367,9,1408,2529366,991,931,17,2816,56196
60.293,6,25,7097,12,155,5481,267,1266,13,589,5023,3426,5831
0.997,17,2,677,1,300,0,300,328,1,321,0,321,349
213.201,6,33,8964,15,158,15228,267,1401,18,683,12539,1400,7563
3.213,6,18,1423,9,222,400,222,816,9,231,400,231,607
241.439,6,30,7432,13,158,20119,267,1317,17,543,15088,1400,6115
51.379,6,40,8550,20,345,812,720,1903,20,416,2697,4080,6647
1771.68,1,56,4704,56,56,32212,56,4704,0,0,0,0,0
1.234,6,24,8004,11,164,104,267,1236,13,869,87,1448,6768
3.735,17,427,461641,93,144,40,1350,16052,334,1306,11,1350,445589
6.863,6,26,7158,10,165,7,267,1069,16,453,457,3417,6089
11.872,6,5,240,5,0,0,0,240,0,0,0,0,0
8.034,6,26,7661,15,238,573,602,2221,11,1209,798,1946,5440
0.093,17,2,362,1,46,0,46,74,1,260,0,260,288
300.304,6,44,29397,28,190,11122,444,2237,16,2392,16015,8448,27160
0.004,6,3,120,1,0,0,0,40,2,0,0,0,80
1.238,6,25,8068,12,164,95,267,1300,13,869,87,1408,6768
1789.232,1,52,4368,0,0,0,0,0,52,56,35082,56,4368
108.555,17,19,6078,19,291,6030,308,6078,0,0,0,0,0
1624.368,2,22,704,22,8,77350,8,704,0,0,0,0,0
1.519,6,2,100,1,0,0,0,60,1,0,0,0,40
4.785,17,5,5443,5,1060,1196,1451,5443,0,0,0,0,0
240.318,6,42,8697,21,524,12015,1418,5822,21,221,12015,639,2875
1747.535,6,94,7151,62,38,28648,205,4424,32,33,56365,98,2727
1.167,6,11,1727,7,100,194,100,384,4,589,303,1152,1343
0.098,17,4,352,2,37,49,37,130,2,83,50,89,222
2.994,6,5,418,4,105,998,105,374,1,0,0,0,44
131.076,6,27,8987,14,552,10075,1396,2947,13,1339,10909,2120,6040
22.874,17,49,13762,23,226,1038,1350,5862,26,275,913,1350,7900
83.685,6,30,7432,13,158,6973,267,1317,17,543,5228,1400,6115
0.19,6,46,21988,27,1060,7,1420,17007,19,467,10,1883,4981
2.849,6,2,80,1,0,0,0,40,1,0,0,0,40
3.589,6,2,1175,1,0,0,0,40,1,1095,0,1095,1135
30.965,17,4,352,2,60,30964,60,176,2,60,30964,60,176
1170.316,6,64,4928,42,42,28544,205,3031,22,34,55720,98,1897
0.291,6,26,8991,13,247,24,624,1672,13,947,22,1438,7319
92.646,17,2208,2196981,626,49,148,1350,48421,1582,1330,42,1350,2148560
1786.865,6,104,8444,68,66,26669,66,4964,36,60,51049,60,3480
0.134,6,3,973,1,0,0,0,40,2,853,21,853,933
1.035,6,21,5988,12,281,94,544,1328,9,716,117,1420,4660
1171.685,17,236,34692,118,48,10014,48,8968,118,190,10014,308,25724
0.107,1,2,112,2,28,107,28,112,0,0,0,0,0
0.898,6,10,1687,7,100,149,100,384,3,1179,324,1179,1303
15.69,17,30,6351,13,202,1304,1350,2999,17,169,978,1350,3352
1.023,17,3,286,2,46,998,46,148,1,110,0,110,138
8.708,6,77,24589,39,560,229,1152,18928,38,459,227,1179,5661
0.652,6,21,5000,11,137,65,267,1132,10,692,61,1467,3868
1.631,6,9,379,5,0,407,0,204,4,7,447,7,175
1748.363,6,97,7307,63,38,28199,205,4476,34,33,52970,98,2831
10.417,6,90,28887,48,577,221,1152,22725,42,447,246,1179,6162
119.313,17,26,3704,13,48,9942,48,988,13,180,9942,308,2716
37.927,17,22,1936,11,48,3791,48,836,11,72,3791,72,1100
0.12,17,2,602,1,46,0,46,74,1,500,0,500,528
2.534,17,14,8287,8,707,362,1350,5887,6,372,373,1350,2400
72.006,17,4,824,2,48,72000,48,152,2,308,71999,308,672
0.588,6,23,7406,13,335,49,668,2026,10,1210,60,1946,5380
37.813,17,4,352,2,60,37812,60,176,2,60,37812,60,176
1.985,6,116,87633,50,131,40,232,2529,66,1351,25,1430,85104
3.311,17,3,228,2,48,3034,48,152,1,48,0,48,76
0.002,17,2,912,1,308,0,308,336,1,548,0,548,576
1680.116,1,15,840,15,28,120008,28,840,0,0,0,0,0
1738.835,17,242,49583,242,176,7215,353,49583,0,0,0,0,0
8.293,17,4,352,2,60,8291,60,176,2,60,8292,60,176
10.363,6,11,640,5,0,2590,0,280,6,0,1400,0,360
233.937,6,1137,249557,599,239,390,1360,150664,538,729,435,4080,98893
1.292,17,6,1230,3,36,641,36,192,3,318,6,318,1038
1714.314,1,20,2872,20,115,90227,351,2872,0,0,0,0,0
132.507,6,25,12059,12,410,63,922,1754,13,1085,11031,1460,10305
0.407,6,14,2181,8,324,58,585,1061,6,396,80,580,1120
84.248,6,118,93189,77,1272,1108,1408,82933,41,676,2100,1408,10256
20.306,6,17,2347,10,157,2256,517,1329,7,323,3352,499,1018
2.116,17,3,543,2,39,976,39,134,1,381,0,381,409
6.386,6,39,7269,20,218,336,314,3423,19,513,340,1179,3846
5.004,17,4,558,2,36,4994,36,128,2,187,4990,187,430
1740.956,6,91,6604,59,31,30016,31,3998,32,31,56158,31,2606
275.403,17,6,528,3,60,137701,60,264,3,60,137701,60,264
300.906,6,49,10486,25,433,12537,910,3258,24,329,576,2128,7228
1773.22,6,180,15480,120,69,14901,69,8940,60,69,30051,69,6540
368.478,6,25,1651,17,177,23029,177,1117,8,110,9208,110,534
1796.356,6,5280,4832483,2020,135,889,353,132586,3260,1423,551,12762,4699897
11.825,6,1894,1635790,1133,1389,10,1420,1601117,761,467,15,1883,34673
0.533,6,2,92,1,0,0,0,40,1,0,0,0,52
377.411,6,25,1651,17,177,23588,177,1117,8,110,9331,110,534
1772.28,6,180,15480,120,69,14893,69,8940,60,69,30037,69,6540
1786.421,6,356,22520,208,69,8630,69,12460,148,69,12152,69,10060
223.475,6,27,8752,14,158,17190,267,1357,13,1145,18604,4845,7395
1.239,6,48,20984,28,950,45,1360,15408,20,476,56,2715,5576
368.584,6,25,1639,16,177,24572,177,1053,9,110,9252,110,586
1788.024,17,88,3684,86,14,21033,14,3612,2,8,1787846,8,72
2.292,6,23,3513,12,162,208,293,1458,11,537,203,1179,2055
31.963,6,9,396,2,0,3483,0,88,7,0,5312,0,308
61.48,6,43,21868,26,973,2459,1448,14986,17,665,3820,1448,6882
7.173,6,1643,1516267,1036,1385,6,1408,1480039,607,776,11,1408,36228
361.555,6,36,8696,21,93,18077,467,2133,15,481,4900,1402,6563
10.699,6,38,6563,20,200,563,314,3013,18,471,613,1179,3550
27.008,6,44,8937,20,147,1421,721,2422,24,504,1165,1440,6515
0.012,17,2,198,1,39,0,39,67,1,103,0,103,131
8.489,17,19,19673,4,693,818,1350,2884,15,1091,604,1350,16789
280.336,6,29,7392,13,158,23361,267,1317,16,603,18684,1400,6075
1746.15,6,90,6540,60,31,29595,31,4050,30,31,60202,31,2490
1773.371,6,180,15480,120,69,14902,69,8940,60,69,30051,69,6540
125.554,6,29,8832,14,158,9658,267,1357,15,858,8967,2800,7475
1787.061,6,107,9017,70,70,25899,274,5284,37,64,49638,247,3733
92.642,6,23,10009,12,531,57,1360,2637,11,1384,9251,3934,7372
0.001,17,2,158,1,34,0,34,62,1,68,0,68,96
0.196,6,2,100,1,0,0,0,60,1,0,0,0,40
0.167,17,2,167,1,39,0,39,67,1,72,0,72,100
6.417,6,41,7349,21,218,320,314,3463,20,513,322,1179,3886
61.764,6,32,7605,14,140,4751,267,1553,18,443,3632,1460,6052
1348.798,17,108,8640,54,48,25448,48,4104,54,56,25448,56,4536
1614.525,1,8,448,8,28,230646,28,448,0,0,0,0,0
1741.734,6,87,6322,58,31,30556,31,3915,29,31,62195,31,2407
2.12,6,26,5835,14,158,161,370,1355,12,799,190,1460,4480
8.238,6,29,7162,12,146,748,267,1218,17,477,505,1460,5944
0.048,6,11,912,6,181,9,181,489,5,77,4,134,423
8.522,17,4,240,2,32,8522,32,120,2,32,8522,32,120
10.655,6,30,7454,16,380,710,885,3491,14,537,806,1440,3963
34.508,6,28,4937,14,154,2654,722,1806,14,479,2612,1448,3131
280.485,6,29,7392,13,158,23373,267,1317,16,678,18693,2760,6075
1779.247,1,212,11872,212,28,8432,28,11872,0,0,0,0,0
0.005,17,2,219,1,35,0,35,63,1,128,0,128,156
382.873,17,14,2884,7,48,63810,48,532,7,308,63810,308,2352
300.895,6,37,10812,20,567,15836,1448,3886,17,502,545,1448,6926
1785.672,6,363,25352,211,100,8503,469,14856,152,69,11824,69,10496
63.004,6,51,38555,27,1200,2423,1448,19431,24,1116,2729,1448,19124
181.53,17,4,1344,4,308,60510,308,1344,0,0,0,0,0
4.002,6,11,467,6,0,800,0,248,5,7,770,7,219
0.275,6,9,1002,5,213,68,213,417,4,421,66,421,585
240.203,6,53,17455,27,781,9238,1418,14702,26,174,9607,580,2753
1785.043,17,83,3480,82,14,22037,14,3444,1,8,0,8,36
11.649,6,1837,1606477,1133,1363,10,1380,1572979,704,421,16,1923,33498
1740.768,17,30,7050,30,207,60026,207,7050,0,0,0,0,0
358.539,6,116,88947,76,1246,4780,1408,78744,40,811,1960,3847,10203
40.462,6,36,8328,17,367,988,787,1814,19,441,2240,1440,6514
0.29,6,20,7229,12,334,25,663,1969,8,1209,40,1906,5260
1756.011,17,326,52115,326,131,5403,391,52115,0,0,0,0,0
1744.769,2,29,928,29,8,62313,8,928,0,0,0,0,0
0.508,6,7,295,4,0,169,0,164,3,7,142,7,131
1787.345,6,102,8364,68,66,26676,66,4964,34,60,54158,60,3400
92.994,2,3,96,3,8,46497,8,96,0,0,0,0,0
0.152,17,2,290,1,40,0,40,68,1,194,0,194,222
0.61,2,3,128,3,18,305,24,128,0,0,0,0,0
7.276,6,32,16945,18,977,428,1360,8575,14,1114,544,2279,8370
1793.301,17,83,3480,82,14,22139,14,3444,1,8,0,8,36
0.269,17,2,196,1,62,0,62,90,1,78,0,78,106
2.111,17,3,1173,3,363,1055,363,1173,0,0,0,0,0
1.32,6,21,7848,11,164,132,267,1236,10,1216,120,3859,6612
340.285,17,5,1672,5,306,85071,308,1672,0,0,0,0,0
0.019,17,2,424,1,60,0,60,88,1,308,0,308,336
241.043,6,49,11347,23,429,10956,1418,5536,26,403,9641,1418,5811
55.275,6,40,8761,19,401,721,889,2044,21,391,2756,3488,6717
1770.169,6,210,16254,78,70,22987,311,7746,132,48,13512,78,8508
1797.936,17,450,39960,405,35,4450,288,25740,45,288,40024,288,14220
1799.814,6,244,35804,152,302,11919,302,26032,92,83,19778,83,9772
302.108,6,33,6397,17,286,18881,1314,2405,16,334,20136,1420,3992
23.846,17,28,4116,14,48,1833,48,1064,14,190,1833,308,3052
0.44,17,8,2758,8,316,62,355,2758,0,0,0,0,0
0.274,6,24,6064,12,181,24,537,1526,12,651,23,1408,4538
114.687,6,24,11138,12,397,78,884,1717,12,1116,10413,2368,9421
1728.324,17,201,47076,201,206,8641,422,47076,0,0,0,0,0
280.232,6,29,7392,13,158,23352,267,1317,16,603,18679,1400,6075
374.174,6,23,1535,16,177,24944,177,1053,7,110,10396,110,482
1681.299,1,15,840,15,28,120092,28,840,0,0,0,0,0
2.944,17,4,624,4,128,981,128,624,0,0,0,0,0
5.301,17,4,240,2,32,5300,32,120,2,32,5300,32,120
1791.132,6,370,25152,215,81,8369,501,13784,155,80,11630,469,11368
1786.639,6,102,8296,68,65,26666,65,4930,34,59,54137,59,3366
1797.415,17,186,17168,93,68,19537,136,9004,93,59,19536,72,8164
0.645,6,14,1745,7,288,79,288,600,7,426,79,434,1145
1756.353,6,100,7866,66,45,27020,205,4902,34,35,53214,98,2964
8.156,6,48,36471,32,1140,263,1368,29040,16,1318,525,2519,7431
1779.877,17,142,11360,71,48,25426,48,5396,71,56,25426,56,5964
172.261,6,30,7432,13,158,14355,267,1317,17,543,10762,1400,6115
0.154,17,2,136,1,32,0,32,60,1,48,0,48,76
267.107,17,14,4680,14,306,20546,308,4680,0,0,0,0,0
116.122,6,54,13676,24,187,5048,721,2835,30,507,3964,1440,10841
0.519,17,2,167,1,39,0,39,67,1,72,0,72,100
1.018,17,19,13252,11,986,101,1350,11154,8,234,96,1350,2098
1799.316,6,356,22658,206,69,8777,69,12380,150,69,12075,69,10278
1785.911,6,97,7579,58,63,26598,64,4148,39,51,46995,58,3431
44.96,6,435,195509,228,802,198,1152,182390,207,439,216,1179,13119
1.135,17,3,1164,3,360,567,360,1164,0,0,0,0,0
0.911,17,4,288,2,36,878,36,128,2,52,880,52,160
1741.261,6,97,7014,62,31,28545,31,4209,35,31,51213,31,2805
1786.559,6,161,21504,94,316,19210,316,15328,67,83,27069,83,6176
0.031,17,2,633,2,288,31,293,633,0,0,0,0,0
1788.61,6,356,22520,208,69,8640,69,12460,148,69,12166,69,10060
1745.494,6,94,7151,62,38,28614,205,4424,32,33,56298,98,2727
1763.823,2,13,416,13,8,146985,8,416,0,0,0,0,0
1774.978,6,180,15480,120,69,14915,69,8940,60,69,30077,69,6540
1773.473,6,180,15480,120,69,14903,69,8940,60,69,30054,69,6540
13.186,6,32,13417,15,542,941,721,3317,17,856,807,1414,10100
55.804,2,7,320,7,21,9300,32,320,0,0,0,0,0
190.335,6,30,7432,13,158,15861,267,1317,17,543,11893,1400,6115
1799.879,17,346,26296,346,48,5217,48,26296,0,0,0,0,0
1.182,6,24,8004,12,164,91,267,1288,12,1014,91,2896,6716
0.064,6,10,1495,5,507,16,507,727,5,556,16,556,768
1795.604,17,447,39580,403,35,4466,288,25676,44,288,40957,288,13904
1.443,6,25,8056,12,164,113,267,1288,13,869,103,1368,6768
35.759,17,40,5880,20,48,1881,48,1520,20,190,1881,308,4360
1786.346,6,103,8212,66,65,27482,65,4785,37,59,49618,59,3427
91.86,6,10,622,6,43,18372,43,394,4,0,30599,0,228
53.398,17,2,122,2,33,53398,33,122,0,0,0,0,0
1745.271,6,95,7203,63,38,28149,205,4476,32,33,56291,98,2727
1541.001,6,203,16158,77,78,20133,362,8124,126,49,12328,143,8034
1327.824,6,264,16701,153,69,8735,69,9225,111,69,12071,69,7476
300.751,6,54,10683,29,579,10741,1360,4743,25,328,362,2667,5940
0.137,1,2,163,2,53,137,78,163,0,0,0,0,0
159.628,17,4,304,2,48,159627,64,152,2,48,159626,64,152
0.254,6,24,7659,12,176,23,334,1339,12,948,21,1438,6320
1786.83,6,102,8296,68,65,26669,65,4930,34,59,54143,59,3366
0.014,17,2,442,1,35,0,35,63,1,351,0,351,379
29.451,6,50,9385,24,410,676,882,2306,26,317,1173,1460,7079
4.002,17,8,720,4,30,1333,30,232,4,94,1330,94,488
0.461,17,2,198,1,63,0,63,91,1,79,0,79,107
8.325,6,38,9533,17,218,520,314,3303,21,673,403,1179,6230
0.269,17,2,672,2,308,269,308,672,0,0,0,0,0
0.785,6,7,371,4,0,261,0,204,3,7,224,7,167
1773.327,6,180,15480,120,69,14901,69,8940,60,69,30049,69,6540
64.82,17,4,240,2,32,64819,32,120,2,32,64819,32,120
1.752,6,45,18765,26,935,70,1460,13229,19,529,85,4075,5536
1792.047,17,87,3648,86,14,21082,14,3612,1,8,0,8,36
240.215,6,53,17698,28,795,8896,1418,14979,25,176,10008,580,2719
0.476,6,49,20022,27,984,18,1380,14900,22,421,20,1923,5122
0.181,6,48,22063,27,1059,6,1414,16990,21,467,8,1889,5073
0.212,6,25,7216,13,155,17,267,1301,12,678,18,2800,5915
178.938,6,23,10014,12,532,61,1360,2642,11,1384,17879,3934,7372
254.535,6,30,7432,13,158,21211,267,1317,17,543,15903,1400,6115
0.997,17,4,624,2,64,995,64,184,2,192,880,192,440
1790.599,6,367,25581,213,99,8446,469,15005,154,69,11700,69,10576
1799.265,6,111,10126,70,80,26076,205,6763,41,31,44976,33,3363
1.345,6,46,16165,25,793,56,1360,10549,21,476,57,2715,5616
10.03,6,14,1247,7,222,1670,222,728,7,231,1670,231,519
1.358,6,54,21382,30,957,46,1460,15601,24,400,50,1460,5781
81.475,6,794,385060,432,827,189,1152,365789,362,398,225,1152,19271
11.137,6,2,1175,1,0,0,0,40,1,1095,0,1095,1135
0.988,6,10,1687,7,100,164,100,384,3,1179,358,1179,1303
0.993,6,53,14198,25,551,41,1429,4892,28,454,36,1986,9306
0.906,1,10,280,10,0,0,0,280,0,0,0,0,0
0.029,17,2,263,1,36,0,36,64,1,171,0,171,199
300.993,6,23,9643,13,416,25068,1330,2219,10,1402,33424,3639,7424
1070.91,6,47,12728,26,432,42836,1460,5406,21,462,53528,1460,7322
7.996,6,19,8221,9,275,999,275,643,10,1194,824,1414,7578
1774.018,6,180,15480,120,69,14907,69,8940,60,69,30066,69,6540
5.023,17,4,288,2,36,5003,36,128,2,52,5007,52,160
0.047,6,12,3704,6,171,7,171,491,6,964,8,1448,3213
31.97,6,341,321085,165,99,194,283,9320,176,1759,182,4224,311765
23.745,6,36,9102,15,340,1696,721,2644,21,401,1177,2840,6458
0.01,17,2,306,1,36,0,36,64,1,214,0,214,242
0.012,17,2,479,1,39,0,39,67,1,384,0,384,412
0.865,6,23,6423,13,313,71,903,2089,10,982,94,1731,4334
1785.363,1,8,448,8,28,255051,28,448,0,0,0,0,0
1791.115,6,356,22589,207,69,8694,69,12420,149,69,12101,69,10169
22.951,6,30,7432,13,158,1912,267,1317,17,543,1432,1400,6115
123.344,6,10,716,1,267,0,267,307,9,7,15416,7,409
1657.977,6,31,5651,20,286,87261,413,3952,11,125,165779,269,1699
1744.589,6,99,7411,63,38,28138,205,4476,36,33,49837,98,2935
5.019,17,3,208,2,36,5005,36,128,1,52,0,52,80
0.126,17,4,336,2,34,0,34,124,2,78,122,84,212
6.227,6,665,535032,371,1413,16,1432,512693,294,540,20,1871,22339
1.022,6,20,7151,12,318,92,600,1906,8,964,127,1471,5245
65.509,6,37,11145,14,297,263,1189,2652,23,581,2977,1420,8493
107.889,6,23,10128,13,549,62,1360,2749,10,1393,11970,3934,7379
1779.14,17,140,11200,70,48,25784,48,5320,70,56,25784,56,5880
1784.825,17,138,11040,69,48,26247,48,5244,69,56,26247,56,5796
0.705,6,17,5132,9,150,88,174,664,8,828,89,1420,4468
0.035,6,2,149,1,0,0,0,40,1,69,0,69,109
93.009,6,39,8416,15,132,6643,267,1800,24,332,4041,1420,6616
298.983,1,4,326,4,53,99661,78,326,0,0,0,0,0
75.656,6,19,780,9,0,5323,0,364,10,0,8405,0,416
56.037,6,27,7177,13,155,4669,267,1306,14,530,4309,3417,5871
38.648,17,22,1672,22,48,1840,48,1672,0,0,0,0,0
300.591,6,70,53602,47,1249,6534,1368,47430,23,828,2552,1571,6172
0.101,17,2,279,1,36,0,36,64,1,187,0,187,215
240.31,6,42,8856,21,528,12014,1418,5860,21,237,12014,617,2996
1.171,6,24,8004,11,164,98,267,1236,13,869,83,1402,6768
1.428,6,54,19580,29,896,51,1460,13759,25,400,51,1460,5821
2.11,17,17,10336,8,612,301,1350,5120,9,551,146,1350,5216
1794.119,17,80,3354,79,14,23001,14,3318,1,8,0,8,36
35.104,6,32,6026,16,180,2326,721,1934,16,407,2325,2026,4092
1775.423,6,114,6798,64,26,28179,26,3756,50,26,36231,26,3042
0.145,17,4,2876,2,689,145,1350,1434,2,693,46,1350,1442
10.104,1,9,756,0,0,0,0,0,9,56,1263,56,756
1646.47,1,7,392,7,28,274411,28,392,0,0,0,0,0
1754.193,6,96,7286,63,38,28293,205,4476,33,33,54807,98,2810
0.13,17,2,136,1,32,0,32,60,1,48,0,48,76
180.855,6,32,6289,16,240,12034,517,1862,16,539,12052,1611,4427
9.485,6,90,29015,46,580,210,1152,22757,44,408,214,1152,6258
240.261,6,55,19344,30,827,8284,1408,16470,25,195,10010,580,2874
1783.627,17,142,11360,71,48,25479,48,5396,71,56,25479,56,5964
1800.0,1,247,26182,247,78,7317,78,26182,0,0,0,0,0
12.346,6,61,42953,38,1186,333,1368,36389,23,893,551,1368,6564
2.061,6,24,5755,13,158,170,370,1315,11,999,203,1691,4440
1.543,17,17,6813,7,420,245,1350,3136,10,339,163,1350,3677
15.835,6,2,1235,1,0,0,0,40,1,1155,0,1155,1195
12.131,6,1777,1637036,1155,1366,10,1432,1607593,622,427,19,1432,29443
9.902,6,8,460,3,0,4951,0,160,5,0,2012,0,300
369.739,6,30,2712,16,184,24649,184,868,14,424,4167,434,1844
300.86,6,41,9779,22,540,14326,1360,4168,19,372,479,1360,5611
3.009,17,4,372,2,33,3001,33,122,2,97,3000,97,250
1799.919,17,138,11040,69,48,26469,48,5244,69,56,26469,56,5796
1784.503,6,356,22520,208,69,8620,69,12460,148,69,12139,69,10060
1740.473,17,28,6580,28,207,64461,207,6580,0,0,0,0,0
30.7,6,10,650,3,112,15350,112,240,7,90,5078,90,410
1795.303,17,448,39896,403,35,4465,288,25676,45,288,40019,288,14220
1771.82,6,99,9306,66,66,27258,66,5610,33,60,55366,60,3696
1796.208,6,382,27064,218,102,8277,469,16019,164,69,11016,69,11045
11.287,6,1785,1559801,1090,1378,10,1420,1527780,695,467,16,1883,32021
16.787,17,23,10216,10,363,1862,1350,3912,13,456,1396,1350,6304
31.441,6,38,9567,19,642,488,1360,4005,19,399,1737,1360,5562
65.53,6,44,8809,22,401,771,889,2176,22,521,3113,2720,6633
1743.918,1,60,5040,60,56,29557,56,5040,0,0,0,0,0
300.953,6,23,9197,14,236,23137,597,1536,9,1457,37597,4441,7661
142.295,6,26,7272,12,158,12935,267,1277,14,678,10941,2085,5995
0.113,17,2,672,2,308,113,308,672,0,0,0,0,0
1787.452,6,102,8296,68,65,26678,65,4930,34,59,54161,59,3366
280.193,6,28,7352,13,158,23349,267,1317,15,603,20013,2036,6035
340.554,6,92,30576,44,588,7919,1418,11128,48,677,7245,1418,19448
5.992,6,45,8425,23,227,272,314,4102,22,491,272,1179,4323
0.017,17,6,411,6,40,3,41,411,0,0,0,0,0
350.973,17,10,3389,10,310,38997,342,3389,0,0,0,0,0
94.608,6,43,8826,21,371,588,766,2069,22,366,4498,2720,6757
1770.342,6,99,9174,66,64,27236,64,5544,33,58,55320,58,3630
0.838,6,6,328,4,0,279,0,216,2,0,816,0,112
1.263,6,10,1687,7,100,210,100,384,3,1179,509,1179,1303
280.21,6,28,7352,13,158,23350,267,1317,15,678,20012,2800,6035
133.776,6,66,13871,30,320,4612,1189,6009,36,278,3821,1420,7862
1785.28,17,140,11200,70,48,25873,48,5320,70,56,25873,56,5880
1681.741,1,15,840,15,28,120124,28,840,0,0,0,0,0
0.552,6,223,234128,143,183,3,230,8017,80,2845,5,8412,226111
1745.434,17,21,6770,21,294,87271,895,6770,0,0,0,0,0
1799.943,17,492,45608,408,36,4422,288,26512,84,199,21684,308,19096
1785.643,6,104,8376,68,65,26651,65,4930,36,59,51015,59,3446
656.043,17,14,4728,14,309,50464,320,4728,0,0,0,0,0
1798.214,17,142,11360,71,48,25688,48,5396,71,56,25688,56,5964
179.823,6,28,7352,13,158,14985,267,1317,15,678,12842,2045,6035
280.21,6,28,7352,13,158,23350,267,1317,15,678,20010,3436,6035
0.23,6,24,7678,12,178,20,340,1345,12,950,19,1438,6333
4.995,17,4,558,2,36,4990,36,128,2,187,4991,187,430
1739.099,6,87,6322,58,31,30510,31,3915,29,31,62110,31,2407
1649.688,6,24,3624,16,241,109979,241,2568,8,92,235639,92,1056
1799.999,6,237,19790,90,88,20021,375,10097,147,51,12328,143,9693
854.843,17,124,9424,124,48,6949,48,9424,0,0,0,0,0
0.131,6,4,160,2,0,131,0,80,2,0,0,0,80
1796.528,17,449,39928,404,35,4457,288,25708,45,288,40023,288,14220
306.441,6,61,53757,45,103,6964,230,3282,16,3545,20428,11264,50475
0.229,6,4,493,2,241,229,241,321,2,92,3,92,172
0.008,17,4,288,2,33,2,33,122,2,55,1,61,166
280.03,6,28,7352,13,158,23335,267,1317,15,678,19999,4200,6035
300.829,6,43,14365,23,867,13674,1360,8763,20,399,453,1360,5602
1787.456,6,104,8376,68,65,26678,65,4930,36,59,51066,59,3446
0.002,17,2,134,1,31,0,31,59,1,47,0,47,75
1787.056,6,81,4743,41,31,44671,36,2194,40,234,45820,443,2549
0.037,6,11,913,6,182,7,182,490,5,77,7,134,423
0.025,17,2,439,1,39,0,39,67,1,344,0,344,372
1746.253,6,96,7286,63,38,28165,205,4476,33,33,54559,98,2810
2.565,17,27,13125,13,705,213,1350,9534,14,228,123,1350,3591
153.629,6,9814,9729766,3818,638,40,1368,244836,5996,1540,25,6840,9484930
34.844,6,29,6801,13,225,2903,314,2329,16,478,2015,1179,4472
1783.803,6,106,8456,68,65,26623,65,4930,38,59,48208,59,3526
1790.293,17,442,61183,204,188,8819,1350,44183,238,43,7553,1350,17000
0.034,17,2,459,1,40,0,40,68,1,363,0,363,391
1.45,6,14,3592,7,150,241,174,584,7,681,185,1452,3008
1745.532,6,90,6540,60,31,29585,31,4050,30,31,60182,31,2490
1786.18,6,104,8308,68,64,26659,64,4896,36,58,51031,58,3412
308.697,1,7,796,7,85,51449,105,796,0,0,0,0,0
1777.564,17,79,3312,78,14,23085,14,3276,1,8,0,8,36
0.012,6,3,120,2,0,12,0,80,1,0,0,0,40
0.005,17,2,452,1,40,0,40,68,1,356,0,356,384
69.67,6,34,7739,15,162,4976,267,1591,19,413,3862,1460,6148
0.287,17,2,152,1,48,0,48,76,1,48,0,48,76
1.274,6,56,17763,35,347,37,1360,9770,21,793,56,4649,7993
6.011,6,22,6412,11,262,593,517,1368,11,893,595,2451,5044
0.573,6,21,7302,12,335,51,668,1986,9,968,70,1475,5316
32.719,6,12,5276,4,92,4991,92,308,8,1135,4647,1448,4968
1783.516,6,365,25032,213,94,8412,469,14536,152,69,11810,69,10496
1793.536,6,359,22709,209,69,8622,69,12569,150,69,12037,69,10140
77.669,17,4,352,2,60,77668,60,176,2,60,77668,60,176
0.209,6,26,7256,13,155,17,267,1301,13,678,15,2800,5955
5.764,6,41,7349,20,218,303,314,3423,21,440,274,1152,3926
1787.363,6,106,8456,68,65,26677,65,4930,38,59,48303,59,3526
1770.989,6,105,9690,68,64,26432,64,5724,37,58,49191,58,3966
149.556,17,4,1344,4,308,49852,308,1344,0,0,0,0,0
1624.338,2,14,448,14,8,124949,8,448,0,0,0,0,0
1798.683,17,449,39928,404,35,4463,288,25708,45,288,40018,288,14220
1.565,6,30,10405,18,367,92,833,1825,12,1012,134,1420,8580
1680.503,1,15,840,15,28,120035,28,840,0,0,0,0,0
1785.994,6,102,8296,68,65,26656,65,4930,34,59,54118,59,3366
35.26,17,22,1936,11,48,3518,48,836,11,72,3520,72,1100
1800.0,6,205,14272,73,46,24582,46,5910,132,46,13740,46,8362
0.142,6,2,133,1,0,0,0,40,1,53,0,53,93
1744.747,2,28,896,28,8,64620,8,896,0,0,0,0,0
0.241,17,2,157,1,31,0,31,59,1,70,0,70,98
1.36,6,30,6427,15,164,97,267,1922,15,650,84,1452,4505
1796.08,17,449,39928,404,35,4456,288,25708,45,288,40020,288,14220
7.834,6,42,7698,22,224,373,314,3796,20,516,398,1179,3902
2.2,17,3,451,2,39,694,39,134,1,289,0,289,317
1793.899,6,356,22520,208,69,8666,69,12460,148,69,12203,69,10060
10.503,6,72,25146,35,856,308,1440,14347,37,543,285,1440,10799
1794.223,17,180,11520,180,36,10023,36,11520,0,0,0,0,0
94.876,6,29,8301,12,169,8625,516,1498,17,470,5450,1452,6803
126.509,6,18,1584,16,106,8433,106,1496,2,0,126500,0,88
314.308,6,8,602,8,31,44901,31,602,0,0,0,0,0
70.3,6,35,9970,13,174,5858,267,1573,22,441,3339,1420,8397
2.65,17,4,610,3,39,561,39,201,1,381,0,381,409
1779.075,17,142,11360,71,48,25415,48,5396,71,56,25415,56,5964
0.093,6,10,1853,5,127,23,127,395,5,1190,23,1190,1458
11.703,6,1864,1616653,1125,1382,10,1420,1582872,739,420,15,1420,33781
19.161,6,16,2357,9,211,2393,211,898,7,545,3159,904,1459
1792.842,17,167,10688,167,36,10800,36,10688,0,0,0,0,0
0.291,6,26,9017,13,261,24,683,1728,13,1100,22,2816,7289
1745.238,6,97,7307,63,38,28149,205,4476,34,33,52879,98,2831
3.972,17,8,668,4,39,1311,39,268,4,72,1308,72,400
280.572,6,28,7352,13,158,23381,267,1317,15,775,20029,3465,6035
2.781,6,24,7520,12,268,248,517,1449,12,778,248,1418,6071
1792.349,17,83,3480,82,14,22127,14,3444,1,8,0,8,36
1.301,6,10,1687,7,100,216,100,384,3,1179,516,1179,1303
10.706,6,11,780,4,92,3493,92,308,7,92,1753,92,472
5.832,6,29,6175,15,338,416,1314,2294,14,368,447,1420,3881
450.83,6,48,4128,32,69,14542,69,2384,16,69,30040,69,1744
61.298,6,35,16025,22,819,2918,1408,9351,13,855,5087,3847,6674
1.337,6,51,20085,28,882,49,1360,14389,23,433,52,1360,5696
0.391,6,240,375822,134,194,2,230,7755,106,3486,3,9856,368067
1778.928,6,104,8376,68,65,26551,65,4930,36,59,50824,59,3446
1.277,6,27,7556,15,269,91,780,1978,12,847,99,1538,5578
1.409,6,19,3781,10,234,156,564,1452,9,463,154,1343,2329
1798.735,17,449,39928,404,35,4463,288,25708,45,288,40023,288,14220
36.954,17,22,1936,11,48,3694,48,836,11,72,3693,72,1100
280.381,6,27,7312,12,158,25489,267,1277,15,603,20021,1400,6035
1748.416,6,120,15005,74,82,21522,517,5618,46,175,38851,1420,9387
1782.363,6,364,25392,212,100,8447,469,14896,152,69,11801,69,10496
62.276,6,24,1851,12,411,5661,411,1063,12,92,2901,92,788
1786.785,6,106,8454,68,64,26668,65,4929,38,58,48289,59,3525
0.274,6,24,5980,12,164,24,453,1442,12,651,23,1448,4538
142.247,17,4,240,2,32,142246,32,120,2,32,142246,32,120
69.094,6,28,7217,13,155,5757,267,1306,15,482,4934,1997,5911
0.021,17,2,467,1,33,0,33,61,1,378,0,378,406
1516.013,6,198,24550,72,124,21352,1305,6971,126,127,12126,1929,17579
50.384,17,4,352,2,60,50383,60,176,2,60,50383,60,176
1.037,17,2,780,2,362,1037,362,780,0,0,0,0,0
7.076,6,8,633,0,0,0,0,0,8,31,1010,31,633
133.802,6,1718,1851236,1078,1021,124,1390,68046,640,2760,209,16752,1783190
1796.104,1,26,3048,26,89,71844,125,3048,0,0,0,0,0
1762.794,1,90,5040,90,28,19806,28,5040,0,0,0,0,0
0.521,17,3,451,2,39,246,39,134,1,289,0,289,317
0.001,6,2,988,1,0,0,0,40,1,908,0,908,948
1752.981,6,99,7411,63,38,28273,205,4476,36,33,50078,98,2935
7.585,6,72,27364,38,835,205,1380,18358,34,630,228,3303,9006
116.981,17,3,531,3,149,58490,355,531,0,0,0,0,0
1772.194,6,180,15480,120,69,14892,69,8940,60,69,30031,69,6540
2.347,17,2,677,1,300,0,300,328,1,321,0,321,349
0.354,6,11,913,6,182,70,182,490,5,77,50,134,423
436.735,1,8,790,8,70,62390,88,790,0,0,0,0,0
4.412,6,39,7285,20,218,232,314,3423,19,516,230,1179,3862
1741.312,6,94,6815,61,31,29021,31,4126,33,31,54415,31,2689
0.441,6,9,527,5,43,110,43,311,4,0,144,0,216
379.503,1,4,240,4,32,126501,32,240,0,0,0,0,0
5.062,6,41,7349,21,218,253,314,3463,20,440,249,1152,3886
1785.788,6,356,22520,208,69,8626,69,12460,148,69,12145,69,10060
1.003,6,27,8420,15,222,59,540,1964,12,1192,73,3151,6456
32.891,17,20,1760,10,48,3652,48,760,10,72,3646,72,1000
21.484,6,26,6797,12,181,1953,267,1212,14,627,1651,1400,5585
10.189,6,11,640,5,0,2547,0,280,6,0,1402,0,360
31.529,6,6,360,0,0,0,0,0,6,0,0,0,360
0.021,17,2,376,1,41,0,41,69,1,279,0,279,307
216.026,17,4,352,2,60,216025,60,176,2,60,216025,60,176
430.727,6,11,657,6,31,86145,31,333,5,31,107613,31,324
193.917,1,3,348,3,88,96958,88,348,0,0,0,0,0
0.207,17,8,2758,8,316,29,355,2758,0,0,0,0,0
0.337,17,2,140,1,34,0,34,62,1,50,0,50,78
300.821,6,50,10433,25,433,12534,910,3258,25,362,471,1360,7175
1772.316,6,180,15480,120,69,14893,69,8940,60,69,30037,69,6540
280.092,6,26,7272,12,158,25462,267,1277,14,775,21538,3445,5995
1774.045,6,184,15778,122,69,14661,69,9089,62,69,29077,69,6689
0.031,17,2,158,1,34,0,34,62,1,68,0,68,96
3.009,17,4,370,2,45,3002,45,146,2,84,3000,84,224
1.993,17,2,672,2,308,1993,308,672,0,0,0,0,0
1798.408,6,369,25799,215,99,8403,469,15085,154,69,11754,69,10714
377.935,2,3,96,3,8,188967,8,96,0,0,0,0,0
0.523,6,9,1346,5,145,130,145,349,4,833,161,833,997
1781.121,1,342,28728,342,56,5223,56,28728,0,0,0,0,0
1763.017,1,59,4956,0,0,0,0,0,59,56,30396,56,4956
31.531,6,7,336,1,0,0,0,48,6,0,6303,0,288
1793.921,17,66,2766,65,14,28030,14,2730,1,8,0,8,36
0.789,6,119,87225,55,131,14,232,2729,64,1388,12,3901,84496
251.314,2,2,64,2,8,251314,8,64,0,0,0,0,0
1082.865,2,11,352,11,8,108286,8,352,0,0,0,0,0
1.048,6,23,6395,13,310,86,889,2075,10,979,115,2840,4320
30.036,17,45,9850,19,249,1666,1350,5275,26,147,1200,1350,4575
0.015,1,5,420,5,56,3,56,420,0,0,0,0,0
63.38,6,60,39953,38,1156,1712,1448,32054,22,843,2992,2359,7899
373.416,6,18,1242,14,180,28724,180,916,4,110,20064,110,326
75.776,6,32,7653,13,155,6314,267,1306,19,398,4209,3417,6347
1750.763,17,13,534,11,14,175058,14,462,2,8,1750580,8,72
0.253,17,3,451,2,39,103,39,134,1,289,0,289,317
1.449,6,48,15955,27,764,55,1360,10294,21,437,62,2720,5661
280.413,6,30,7432,14,158,21570,267,1357,16,678,18691,3456,6075
1744.67,2,28,896,28,8,64617,8,896,0,0,0,0,0
481.314,2,4,128,4,8,160438,8,128,0,0,0,0,0
161.518,17,4,352,2,60,161517,60,176,2,60,161517,60,176
5.94,17,5,514,4,32,1331,32,240,1,246,0,246,274
303.643,6,90,29567,47,927,6600,1101,17720,43,280,273,4848,11847
1794.578,17,29,9512,29,300,64092,300,9512,0,0,0,0,0
0.105,6,9,1342,5,145,26,145,349,4,829,31,829,993
30.518,6,12,2559,7,188,5086,188,572,5,859,7588,1368,1987
282.899,6,30,7432,13,158,23574,267,1317,17,603,17677,2076,6115
1744.617,2,26,832,26,8,69784,8,832,0,0,0,0,0
1741.057,6,87,6322,58,31,30544,31,3915,29,31,62177,31,2407
723.687,17,134,10184,134,48,5441,48,10184,0,0,0,0,0
0.385,6,23,6759,13,89,32,147,1076,10,859,41,1674,5683
10.392,17,4,352,2,48,10383,48,152,2,72,10382,72,200
1792.621,17,176,11264,176,36,10243,36,11264,0,0,0,0,0
79.398,6,21,9184,11,356,65,751,1542,10,1446,8807,3966,7642
125.69,2,2,64,2,8,125690,8,64,0,0,0,0,0
0.303,17,4,1336,4,306,101,354,1336,0,0,0,0,0
69.391,6,26,10689,13,525,100,1237,2151,13,889,5758,1460,8538
7.034,6,4,240,4,0,0,0,240,0,0,0,0,0
80.259,6,31,10312,13,158,6688,267,1317,18,751,4703,1400,8995
31.126,6,7,420,1,0,0,0,60,6,0,6223,0,360
1699.845,17,106,19115,106,152,16189,373,19115,0,0,0,0,0
3.152,17,3,392,2,60,2991,60,176,1,188,0,188,216
1739.119,6,87,6322,58,31,30510,31,3915,29,31,62110,31,2407
280.04,6,30,7432,14,158,21541,267,1357,16,603,18666,2800,6075
1785.861,6,364,25392,212,100,8463,469,14896,152,69,11826,69,10496
706.367,6,58,7757,29,107,18109,516,2772,29,159,25223,1452,4985
1.351,17,2,144,1,36,0,36,64,1,52,0,52,80
300.588,6,46,8946,24,315,13069,882,2313,22,478,708,2128,6633
0.026,6,9,1560,5,514,6,514,782,4,562,8,562,778
240.3,6,43,8625,22,519,11442,1402,5826,21,212,12014,620,2799
0.014,17,2,448,1,39,0,39,67,1,353,0,353,381
2.822,17,8,720,4,30,921,30,232,4,94,925,94,488
0.271,6,21,6086,11,316,26,592,1846,10,928,29,2007,4240
1772.996,6,181,15589,120,69,14899,69,8940,61,69,29543,69,6649
165.565,17,24,4000,12,48,15050,48,912,12,229,15050,308,3088
2.246,6,25,8092,12,164,182,267,1324,13,869,170,1368,6768
8.0,6,1916,1792701,1226,1383,6,1408,1752059,690,950,11,2816,40642
56.895,6,27,7177,13,155,4741,267,1306,14,530,4375,3417,5871
0.086,17,3,660,2,46,2,46,148,1,484,0,484,512
5.176,6,37,7189,19,218,287,314,3383,18,513,289,1179,3806
1789.648,1,58,4872,58,56,31397,56,4872,0,0,0,0,0
7.976,6,2,1175,1,0,0,0,40,1,1095,0,1095,1135
5.597,6,22,6412,10,262,614,517,1316,12,893,502,2451,5096
39.294,17,22,1936,11,48,3918,48,836,11,72,3927,72,1100
11.039,6,87,25005,44,526,256,1152,19128,43,461,256,1179,5877
0.348,6,19,7099,11,318,34,600,1854,8,1205,48,1891,5245
247.101,6,55,8682,27,139,9503,346,2342,28,304,9151,1408,6340
1787.908,6,375,26108,216,98,8315,469,15332,159,69,11315,69,10776
0.369,6,4,220,1,0,0,0,52,3,0,184,0,168
1776.218,17,73,3060,72,14,25017,14,3024,1,8,0,8,36
113.94,6,91,66392,57,1245,2034,1368,57783,34,747,1895,1368,8609
1777.433,17,79,3312,78,14,23083,14,3276,1,8,0,8,36
16.214,6,13,2133,8,324,2316,585,1073,5,396,4048,580,1060
366.33,6,22,2259,16,141,24422,141,813,6,398,4634,419,1446
70.244,6,11,460,5,0,283,0,208,6,0,14040,0,252
2.561,6,13,2311,8,188,365,245,700,5,1407,574,1407,1611
8.668,6,683,608326,436,1327,19,1368,590818,247,776,34,1473,17508
369.893,6,16,1138,12,180,33626,180,812,4,110,20236,110,326
0.122,6,9,1345,5,145,30,145,349,4,832,33,832,996
0.034,6,3,175,2,31,0,31,135,1,0,0,0,40
7.895,6,18,8085,9,275,986,275,643,9,1414,674,1414,7442
17.732,1,4,224,4,28,5910,28,224,0,0,0,0,0
1785.217,17,87,3648,86,14,21002,14,3612,1,8,0,8,36
1795.389,17,447,39864,402,35,4477,288,25644,45,288,40014,288,14220
7.384,6,22,6456,9,154,923,267,832,13,637,614,1997,5624
1744.649,2,24,768,24,8,75854,8,768,0,0,0,0,0
1772.809,6,180,15480,120,69,14897,69,8940,60,69,30045,69,6540
5.053,6,4,398,2,214,3966,214,306,2,0,5053,0,92
1.368,6,24,8004,12,164,105,267,1288,12,1014,107,2491,6716
300.763,6,38,8641,20,322,15829,941,2168,18,441,503,1360,6473
1799.993,1,58,4872,58,56,31578,56,4872,0,0,0,0,0
0.006,17,3,310,2,31,0,31,118,1,164,0,164,192
1681.509,17,16,4285,8,30,240212,37,471,8,448,240214,463,3814
1783.805,6,365,23087,211,69,8494,69,12787,154,69,11658,69,10300
0.192,6,49,23464,28,1078,7,1414,18391,21,467,9,1889,5073
1.36,6,26,8108,12,164,106,267,1288,14,869,89,1368,6820
0.836,17,35,24091,19,1003,46,1350,19598,16,252,41,1350,4493
3.304,17,5,340,5,40,826,40,340,0,0,0,0,0
240.239,6,55,18566,30,783,8283,1418,15673,25,198,10009,580,2893
1771.384,6,99,9306,66,66,27252,66,5610,33,60,55353,60,3696
1741.199,17,30,7050,30,207,60041,207,7050,0,0,0,0,0
481.282,6,5,750,5,110,120320,110,750,0,0,0,0,0
0.259,6,9,1346,5,145,64,145,349,4,833,37,833,997
10.785,17,15,17718,15,1153,770,1452,17718,0,0,0,0,0
1.479,6,50,19354,27,896,56,1460,13658,23,433,57,1460,5696
1773.78,6,143,9023,78,49,23036,208,5524,65,31,27710,31,3499
152.593,17,4,352,2,60,152592,60,176,2,60,152592,60,176
128.171,17,4,352,2,60,128170,60,176,2,60,128169,60,176
280.289,6,32,7512,15,158,20020,267,1397,17,543,17515,1400,6115
0.18,6,9,1338,5,145,45,145,349,4,825,36,825,989
0.5,1,2,200,2,72,500,72,200,0,0,0,0,0
0.226,17,2,152,2,48,226,48,152,0,0,0,0,0
2.593,6,27,8176,13,164,201,267,1348,14,869,185,1448,6828
1.096,17,2,204,1,34,0,34,62,1,114,0,114,142
9.341,6,222,178808,130,1328,72,1368,168874,92,1124,100,2841,9934
78.515,6,35,9250,13,155,283,267,1306,22,415,3738,1420,7944
4.32,17,4,824,2,48,4302,48,152,2,308,4295,308,672
31.652,6,13,5569,5,106,7910,106,314,8,1231,4520,1997,5255
1796.046,17,31,20863,31,645,59868,645,20863,0,0,0,0,0
1740.941,6,87,6322,58,31,30542,31,3915,29,31,62175,31,2407
77.505,6,22,7994,11,511,89,1194,2005,11,791,7732,1440,5989
1793.748,17,768,46308,768,32,2338,37,46308,0,0,0,0,0
1784.377,6,356,22520,208,69,8620,69,12460,148,69,12138,69,10060
0.042,6,13,4387,7,92,6,92,464,6,1201,8,2121,3923
52.812,2,2,64,2,8,52812,8,64,0,0,0,0,0
1779.767,1,58,4872,0,0,0,0,0,58,56,31223,56,4872
1797.347,1,70,3920,70,28,26048,28,3920,0,0,0,0,0
3.305,6,44,11537,22,617,157,1440,5869,22,433,136,1440,5668
1791.093,17,177,13806,177,50,10176,50,13806,0,0,0,0,0
1741.804,1,56,4704,56,56,31669,56,4704,0,0,0,0,0
1114.487,6,92,10106,50,79,20100,722,4595,42,107,27178,1408,5511
1782.955,17,85,3561,83,13,21741,14,3481,2,12,1782776,16,80
0.0,17,1,1083,1,1055,0,1055,1083,0,0,0,0,0
299.529,6,6,364,4,31,99843,31,222,2,31,299507,31,142
89.43,6,708,348181,385,840,232,1152,331493,323,470,276,1179,16688
244.299,6,65,21404,33,862,7634,1418,18103,32,179,7880,580,3301
0.149,17,2,152,1,48,0,48,76,1,48,0,48,76
0.487,17,4,588,2,48,337,48,152,2,190,343,308,436
4.168,6,39,7269,19,218,231,314,3383,20,440,206,1152,3886
134.55,6,187,143089,112,1316,1212,1448,129618,75,637,1815,1448,13471
1772.407,6,180,15480,120,69,14894,69,8940,60,69,30033,69,6540
0.127,6,12,3702,6,170,20,170,490,6,964,18,1448,3212
70.31,6,16,652,7,0,7910,0,284,9,0,8787,0,368
0.006,17,2,459,1,39,0,39,67,1,364,0,364,392
5.729,6,41,7365,21,218,286,314,3463,20,516,287,1179,3902
323.863,6,265,112068,130,797,2510,1152,101717,135,380,2414,1179,10351
157.314,6,44,10242,19,727,2415,1360,4440,25,399,6547,1360,5802
9.365,6,1696,1563689,1074,1378,8,1408,1526681,622,931,14,2801,37008
0.131,17,2,467,1,33,0,33,61,1,378,0,378,406
0.959,17,8,704,4,37,317,37,260,4,83,316,89,444
104.194,2,8,352,8,20,14884,32,352,0,0,0,0,0
668.034,6,89,11761,47,304,14522,304,8240,42,83,16248,83,3521
1759.554,6,123,12455,76,64,23460,722,6310,47,92,38243,1440,6145
1799.999,6,229,20107,86,82,21176,376,9265,143,70,12675,1062,10842
962.577,2,9,288,9,8,120322,8,288,0,0,0,0,0
280.277,6,29,7392,14,158,21559,267,1357,15,678,20010,3436,6035
1.331,6,16,7059,9,498,166,721,1360,7,1805,189,2828,5699
7.772,6,39,7269,19,218,431,314,3383,20,513,393,1179,3886
1742.131,6,112,8359,69,38,25619,205,4850,43,32,41469,98,3509
0.181,6,4,225,2,65,181,65,145,2,0,9,0,80
3.982,17,4,268,4,39,1327,39,268,0,0,0,0,0
1.084,6,10,924,5,283,226,283,551,5,105,226,105,373
1742.565,6,95,7203,63,38,28105,205,4476,32,33,56203,98,2727
0.045,6,21,10037,11,125,4,125,705,10,1467,4,1564,9332
1.497,17,2,178,1,29,0,29,57,1,93,0,93,121
0.04,17,2,351,1,33,0,33,61,1,262,0,262,290
0.087,6,33,20621,18,127,4,127,1119,15,1559,5,4068,19502
66.172,6,56,14341,24,403,259,1189,6218,32,310,2134,1997,8123
2.028,17,29,14717,14,761,156,1350,11047,15,216,115,1350,3670
11.419,6,89,26714,45,565,259,1152,20472,44,407,259,1152,6242
161.961,6,25,10004,12,290,98,568,1394,13,1009,13482,2571,8610
0.08,17,2,442,1,46,0,46,74,1,340,0,340,368
1720.451,17,12,498,11,14,172045,14,462,1,8,0,8,36
31.617,6,7,396,1,0,0,0,60,6,0,6289,0,336
1786.943,6,104,8376,68,65,26670,65,4930,36,59,51052,59,3446
1772.632,6,180,15480,120,69,14896,69,8940,60,69,30037,69,6540
19.311,17,873,560147,869,616,22,1472,559987,4,12,5017,12,160
168.902,17,8,704,4,48,56297,48,304,4,72,56297,72,400
1790.743,1,342,28728,342,56,5251,56,28728,0,0,0,0,0
1799.07,17,449,39928,404,35,4464,288,25708,45,288,40018,288,14220
0.136,6,44,20150,26,1010,5,1420,15209,18,467,7,1883,4941
0.209,17,2,198,1,39,0,39,67,1,103,0,103,131
64.251,6,20,6125,8,186,9176,267,701,12,822,5840,1420,5424
1746.376,6,96,7286,63,38,28167,205,4476,33,33,54566,98,2810
368.42,6,10,562,4,106,122806,106,274,6,0,6324,0,288
0.181,17,2,172,1,50,0,50,78,1,66,0,66,94
8.03,6,15,6105,4,186,2673,267,541,11,639,801,1460,5564
0.004,17,2,330,1,76,0,76,104,1,198,0,198,226
1741.072,6,90,6521,59,31,30018,31,3998,31,31,58034,31,2523
2.711,17,2,196,1,62,0,62,90,1,78,0,78,106
0.004,17,2,280,1,41,0,41,69,1,183,0,183,211
372.248,6,18,1242,14,180,28634,180,916,4,110,20062,110,326
1787.401,6,106,8456,68,65,26677,65,4930,38,59,48304,59,3526
401.586,17,6,528,3,60,200792,60,264,3,60,200792,60,264
99.51,17,6,528,3,48,49752,48,228,3,72,49749,72,300
1797.599,1,237,13272,237,28,7616,28,13272,0,0,0,0,0
4.021,6,11,467,6,0,804,0,248,5,7,746,7,219
377.526,2,4,128,4,8,125842,8,128,0,0,0,0,0
1794.086,1,267,14952,267,28,6744,28,14952,0,0,0,0,0
280.245,6,30,7432,13,158,23353,267,1317,17,543,17514,1400,6115
1798.496,6,370,25839,215,99,8404,469,15154,155,69,11678,69,10685
130.434,17,4,352,2,60,130433,60,176,2,60,130433,60,176
0.476,6,10,968,5,256,117,256,460,5,304,117,304,508
134.209,6,23,10014,12,532,57,1360,2642,11,1384,13409,3934,7372
1787.226,6,105,8481,69,65,26282,65,5035,36,59,51060,59,3446
0.211,6,10,1510,5,657,52,657,925,5,317,52,317,585
0.559,6,283,210303,142,183,3,230,8217,141,1401,2,2816,202086
720.805,1,46,4876,46,78,16017,78,4876,0,0,0,0,0
1773.621,6,181,15589,120,69,14904,69,8940,61,69,29556,69,6649
0.333,6,20,7151,11,318,32,600,1854,9,964,40,1471,5297
0.253,17,2,144,1,36,0,36,64,1,52,0,52,80
1794.162,17,393,50177,189,174,9541,1350,38178,204,30,8838,60,11999
0.314,17,2,198,1,39,0,39,67,1,103,0,103,131
382.376,6,18,1242,14,180,29413,180,916,4,110,20065,110,326
230.545,17,9,3030,9,308,28818,314,3030,0,0,0,0,0
1791.451,1,176,9856,176,28,10236,28,9856,0,0,0,0,0
1036.321,1,18,1008,18,28,60960,28,1008,0,0,0,0,0
0.109,6,2,123,1,31,0,31,83,1,0,0,0,40
1759.606,17,168,13990,156,30,11352,37,9090,12,380,154534,463,4900
4.49,6,14,5975,4,186,1493,267,541,10,718,491,1420,5434
1797.714,1,287,16072,287,28,6285,28,16072,0,0,0,0,0
0.216,17,2,376,1,39,0,39,67,1,281,0,281,309
1730.218,6,65,4750,42,33,42200,33,2910,23,31,78636,31,1840
225.829,17,4,1344,4,308,75276,308,1344,0,0,0,0,0
1564.099,2,15,480,15,8,111721,8,480,0,0,0,0,0
0.58,17,2,152,1,48,0,48,76,1,48,0,48,76
0.212,17,2,157,1,31,0,31,59,1,70,0,70,98
1697.788,17,16,1265,8,30,242536,37,471,8,71,242533,136,794
56.114,6,13,1079,12,43,5101,43,1019,1,0,0,0,60
0.031,17,4,336,2,34,0,34,124,2,78,1,84,212
0.454,6,50,21428,28,1010,16,1380,16306,22,421,19,1923,5122
0.077,17,4,284,2,32,44,32,120,2,54,34,60,164
0.347,6,17,2952,9,266,43,517,1542,8,493,46,828,1410
0.003,17,4,300,2,39,1,39,134,2,55,1,55,166
280.522,6,30,7432,13,158,23376,267,1317,17,603,17526,2076,6115
372.1,6,23,1538,16,180,24806,180,1056,7,110,10393,110,482
919.466,6,159,10638,82,69,11351,69,5281,77,69,12098,69,5357
32.419,6,353,278193,167,127,195,305,11667,186,1411,175,2836,266526
1729.656,1,46,2576,46,28,38436,28,2576,0,0,0,0,0
374.852,6,25,1651,17,177,23428,177,1117,8,110,9290,110,534
2.323,6,19,3781,10,234,258,564,1452,9,463,264,1343,2329
1.549,6,47,19169,27,891,59,1360,13593,20,433,72,1360,5576
881.592,2,6,192,6,8,176318,8,192,0,0,0,0,0
0.406,6,96,58783,51,1265,8,1432,52680,45,475,8,1871,6103
300.798,6,39,16292,16,195,20053,431,1620,23,673,5936,1448,14672
3.05,17,3,204,3,40,1525,40,204,0,0,0,0,0
125.781,2,2,64,2,8,125781,8,64,0,0,0,0,0
0.391,6,7,371,4,0,130,0,204,3,7,99,7,167
0.013,17,4,680,2,33,0,33,122,2,251,2,323,558
88.114,6,97,62514,55,1203,1631,1368,53449,42,747,1619,1368,9065
1787.174,1,342,28728,342,56,5240,56,28728,0,0,0,0,0
1741.532,6,87,6322,58,31,30553,31,3915,29,31,62195,31,2407
1793.574,6,410,25298,218,69,8265,69,12929,192,45,9390,69,12369
455.282,6,91,15168,42,312,11104,1368,7501,49,222,9483,1368,7667
0.288,6,21,5288,11,115,28,206,1040,10,930,31,1852,4248
1772.394,6,180,15480,120,69,14894,69,8940,60,69,30035,69,6540
1795.71,17,449,39928,404,35,4455,288,25708,45,288,40017,288,14220
82.532,6,37,8671,17,410,564,882,2022,20,449,4335,2720,6649
3.11,17,3,174,3,30,1555,30,174,0,0,0,0,0
220.146,17,4,288,2,36,220102,36,128,2,52,220145,52,160
0.021,17,2,158,1,34,0,34,62,1,68,0,68,96
6.531,6,9,588,3,106,3255,106,234,6,90,1300,90,354
1680.622,17,12,498,11,14,168062,14,462,1,8,0,8,36
1790.73,17,197,50698,197,229,9136,422,50698,0,0,0,0,0
1782.0,6,365,23156,211,69,8485,69,12856,154,69,11646,69,10300
1784.041,6,356,22520,208,69,8618,69,12460,148,69,12136,69,10060
240.186,6,52,17680,28,783,8895,1402,14788,24,233,10442,580,2892
0.272,17,2,167,1,39,0,39,67,1,72,0,72,100
0.178,6,12,3462,6,75,35,75,395,6,1373,35,1448,3067
26.261,6,16,2972,7,619,4375,1414,2142,9,231,3281,231,830
1797.788,17,170,57080,170,307,10637,308,57080,0,0,0,0,0
0.012,17,2,278,1,36,0,36,64,1,186,0,186,214
1799.245,17,449,39928,404,35,4464,288,25708,45,288,40022,288,14220
1757.732,6,185,11345,93,47,19105,208,6735,92,31,19312,31,4610
1798.178,1,210,11760,210,28,8603,28,11760,0,0,0,0,0
1788.365,6,354,22440,206,69,8723,69,12380,148,69,12165,69,10060
31.214,6,44,9890,21,631,492,1360,4075,23,325,1410,1360,5815
4.714,6,40,7309,20,218,248,314,3423,20,513,234,1179,3886
1621.868,1,7,392,7,28,270311,28,392,0,0,0,0,0
33.869,6,33,7410,16,180,2257,722,1946,17,508,2106,2026,5464
1799.969,17,142,11360,71,48,25713,48,5396,71,56,25713,56,5964
3.89,2,4,168,4,18,1296,24,168,0,0,0,0,0
328.96,1,5,496,5,71,82240,142,496,0,0,0,0,0
333.975,17,7,2342,7,306,55662,314,2342,0,0,0,0,0
2.258,17,4,610,3,39,865,39,201,1,381,0,381,409
0.055,17,2,367,1,33,0,33,61,1,278,0,278,306
197.696,6,85,57449,51,1218,3953,1368,48945,34,961,1873,3887,8504
21.29,6,38,8567,19,401,496,888,2008,19,445,1175,1928,6559
9.626,6,71,20326,36,540,275,1152,15499,35,489,273,1179,4827
26.072,6,28,19437,16,735,1738,1360,3603,12,2191,2355,6085,15834
0.119,17,2,182,1,39,0,39,67,1,87,0,87,115
1.147,6,22,7900,12,164,88,267,1288,10,1216,107,3819,6612
1413.124,6,287,18104,166,69,8564,69,10021,121,69,11776,69,8083
1780.339,17,140,11200,70,48,25801,48,5320,70,56,25801,56,5880
0.595,6,20,7238,13,335,49,668,2026,7,1210,90,1946,5212
1777.199,6,104,7752,54,33,33532,33,3930,50,31,36265,31,3822
215.385,6,29,7392,13,158,17948,267,1317,16,603,14356,2036,6075
1775.942,17,73,3060,72,14,25013,14,3024,1,8,0,8,36
19.132,6,35,18349,17,256,1195,517,2187,18,1383,1124,2808,16162
2.058,6,13,1344,7,256,343,256,796,6,304,409,304,548
213.164,6,54,11002,22,119,10150,267,2080,32,293,6874,1460,8922
48.554,6,6411,6198826,4315,1360,11,1408,6085170,2096,931,23,2801,113656
1792.043,1,303,25452,303,56,5933,56,25452,0,0,0,0,0
300.75,6,46,8907,23,266,13670,720,2078,23,327,601,1460,6829
418.634,17,20,1520,20,48,22033,48,1520,0,0,0,0,0
1744.889,6,95,7203,63,38,28143,205,4476,32,33,56273,98,2727
0.037,17,4,352,2,37,9,37,130,2,83,1,89,222
1.521,6,31,10844,17,558,95,1360,4065,14,775,98,2720,6779
0.066,17,2,2386,2,1165,66,1165,2386,0,0,0,0,0
1.806,17,2,122,2,33,1806,33,122,0,0,0,0,0
45.849,6,42,4160,22,210,2178,692,2490,20,117,2315,152,1670
1747.372,6,96,7255,62,38,28645,205,4424,34,33,52939,98,2831
0.47,6,4,1707,2,187,470,187,267,2,1360,31,1360,1440
1786.202,17,87,3648,86,14,21014,14,3612,1,8,0,8,36
1798.299,17,142,11360,71,48,25689,48,5396,71,56,25689,56,5964
6.175,6,1565,1429574,976,1386,6,1408,1394282,589,931,10,2816,35292
282.203,6,32,7512,13,158,23516,267,1317,19,543,15676,1400,6195
309.552,6,56,9829,22,108,14740,267,2080,34,227,9380,1460,7749
12.149,17,10,1965,5,33,3033,33,305,5,304,3033,304,1660
421.188,2,6,192,6,8,84237,8,192,0,0,0,0,0
1.94,17,2,122,2,33,1940,33,122,0,0,0,0,0
1787.923,17,86,3606,85,14,21284,14,3570,1,8,0,8,36
0.005,17,3,1007,1,137,0,137,165,2,393,1,393,842
1772.502,6,203,22290,130,75,13740,267,10057,73,134,24613,1997,12233
179.316,6,62,38255,39,1128,4718,1408,30286,23,751,2830,2439,7969
1798.005,6,376,23803,215,69,8401,69,13223,161,69,11236,69,10580
1745.934,6,96,7286,63,38,28160,205,4476,33,33,54548,98,2810
0.385,6,6,324,4,0,128,0,216,2,0,199,0,108
1787.906,6,386,27224,220,102,8163,469,16168,166,69,10835,69,11056
45.343,6,26,7137,12,155,4122,267,1266,14,530,3487,2006,5871
0.61,6,13,4542,6,125,121,125,445,7,931,101,1448,4097
282.031,6,30,7432,13,158,23502,267,1317,17,543,17608,1400,6115
16.08,6,38,8431,20,315,846,630,1825,18,451,502,1928,6606
1794.075,17,80,3354,79,14,23000,14,3318,1,8,0,8,36
39.124,17,22,1672,22,48,1863,48,1672,0,0,0,0,0
61.632,17,4,352,2,60,61630,60,176,2,60,61631,60,176
286.5,17,4,256,4,36,95500,47,256,0,0,0,0,0
0.001,17,2,144,1,36,0,36,64,1,52,0,52,80
281.802,6,32,7853,14,158,21677,267,1357,18,524,16576,1400,6496
3.988,17,8,1294,4,64,1326,64,368,4,203,1325,238,926
0.014,6,9,1560,5,514,3,514,782,4,562,4,562,778
1764.294,1,62,5208,0,0,0,0,0,62,56,28922,56,5208
1790.398,6,192,17984,102,129,17726,208,13392,90,31,20113,31,4592
1.144,6,24,5980,13,164,95,453,1494,11,781,104,2224,4486
34.47,6,35,5346,17,154,2154,722,1962,18,271,2006,1448,3384
117.341,6,21,9136,11,499,91,1193,1971,10,1350,13018,3639,7165
11.69,6,1806,1605219,1135,1363,10,1380,1572214,671,511,17,1923,33005
0.557,6,52,21163,28,1053,20,1380,15916,24,387,21,1923,5247
706.19,1,32,1792,32,28,22780,28,1792,0,0,0,0,0
0.324,6,22,7342,12,335,28,668,1974,10,1210,35,1906,5368
12.107,6,34,7235,17,213,756,314,3037,17,585,687,1179,4198
1782.299,6,226,19216,87,75,20722,339,8644,139,69,12914,1062,10572
272.723,17,2,148,2,46,272723,46,148,0,0,0,0,0
341.51,17,5,1672,5,306,85377,308,1672,0,0,0,0,0
11.016,6,18,4226,10,275,1224,275,958,8,978,891,1420,3268
22.28,1,11,1144,0,0,0,0,0,11,76,2228,76,1144
1741.964,1,56,4704,56,56,31672,56,4704,0,0,0,0,0
1383.714,2,13,416,13,8,115309,8,416,0,0,0,0,0
0.081,17,2,144,1,36,0,36,64,1,52,0,52,80
367.067,6,25,1651,17,177,22941,177,1117,8,110,9182,110,534
300.829,6,32,10444,16,221,20055,523,1774,16,652,4542,1448,8670
8.698,6,2,80,1,0,0,0,40,1,0,0,0,40
2.83,17,2,144,1,36,0,36,64,1,52,0,52,80
280.416,6,29,7392,13,158,23368,267,1317,16,678,18692,2085,6075
1744.331,6,95,7203,63,38,28134,205,4476,32,33,56262,98,2727
1789.956,6,381,26486,219,97,8210,469,15521,162,69,11117,69,10965
1750.525,17,12,498,11,14,175052,14,462,1,8,0,8,36
154.293,6,17,692,6,0,7287,0,244,11,0,15428,0,448
1796.136,17,447,39864,402,35,4479,288,25644,45,288,40022,288,14220
658.206,17,140,31892,92,40,7233,41,6308,48,505,13980,505,25584
0.932,6,8,335,4,0,310,0,164,4,7,67,7,171
30.673,1,35,3640,0,0,0,0,0,35,76,902,76,3640
1.426,6,35,11583,18,450,83,1352,3466,17,1060,78,3942,8117
24.649,6,35,8250,16,199,1643,721,2037,19,544,1358,1440,6213
0.076,17,2,152,1,48,0,48,76,1,48,0,48,76
63.004,6,37,8125,13,142,5250,267,1381,24,288,2737,1460,6744
153.492,17,4,352,2,60,153491,60,176,2,60,153490,60,176
0.886,6,2,1520,1,0,0,0,40,1,1440,0,1440,1480
1769.843,1,58,4872,0,0,0,0,0,58,56,31049,56,4872
30.911,6,36,8455,18,410,521,882,1982,18,478,1807,2720,6473
214.431,17,4,240,2,32,214430,32,120,2,32,214430,32,120
280.546,6,30,7432,13,158,23378,267,1317,17,603,17526,2076,6115
1780.76,17,142,11360,71,48,25439,48,5396,71,56,25439,56,5964
34.846,6,25,7097,12,155,3167,267,1266,13,589,2903,3426,5831
1681.592,17,14,1036,7,30,280259,30,406,7,62,280260,62,630
6.632,17,31,11186,13,415,552,1350,5761,18,273,386,1350,5425
299.559,6,6,364,4,31,99853,31,222,2,31,299545,31,142
44.337,6,2252,1976501,1455,1281,30,1368,1930393,797,776,55,1473,46108
0.065,6,2,123,1,0,0,0,40,1,31,0,31,83
1082.903,2,11,352,11,8,108290,8,352,0,0,0,0,0
0.023,6,11,937,6,182,4,182,514,5,77,4,134,423
0.048,17,2,323,1,33,0,33,61,1,234,0,234,262
1741.914,6,87,6322,58,31,30559,31,3915,29,31,62211,31,2407
1775.429,17,140,11200,70,48,25730,48,5320,70,56,25730,56,5880
4.55,6,20,2660,11,384,454,768,1988,9,304,567,304,672
1796.974,1,266,14896,266,28,6781,28,14896,0,0,0,0,0
1742.056,6,178,15331,118,69,14889,69,8791,60,69,29524,69,6540
2.014,17,3,174,3,30,1007,30,174,0,0,0,0,0
67.46,6,55,11879,21,266,3373,469,4316,34,238,2043,1460,7563
1740.161,1,15,870,15,30,124297,30,870,0,0,0,0,0
541.478,2,6,192,6,8,108295,8,192,0,0,0,0,0
192.828,1,4,224,4,28,64276,28,224,0,0,0,0,0
1764.054,2,14,448,14,8,135696,8,448,0,0,0,0,0
240.203,6,56,18443,30,771,8282,1402,15535,26,193,9607,580,2908
1.401,6,49,18810,27,860,53,1360,13154,22,433,56,1360,5656
1795.426,6,359,22709,209,69,8631,69,12569,150,69,12049,69,10140
0.075,6,2,92,1,0,0,0,40,1,0,0,0,52
0.633,6,5,248,3,0,316,0,144,2,0,438,0,104
1796.506,17,449,39928,404,35,4457,288,25708,45,288,40020,288,14220
193.259,6,22,6644,6,154,38651,267,712,16,527,12881,1917,5932
0.235,6,46,20397,26,1022,9,1420,15376,20,467,12,1883,5021
1792.319,6,368,24683,213,87,8454,469,14136,155,69,11637,69,10547
0.097,17,2,2748,2,1346,97,1346,2748,0,0,0,0,0
20.743,17,8,1648,4,48,6908,48,304,4,308,6906,308,1344
301.121,6,53,23283,30,1088,10383,1440,17561,23,399,406,1440,5722
255.898,17,805,860139,771,1085,332,1252,858779,34,12,4433,12,1360
1.304,6,36,11755,19,405,72,1360,3641,17,1060,71,3942,8114
0.541,6,114,75360,63,1278,8,1432,69029,51,475,10,1871,6331
0.023,17,2,427,1,39,0,39,67,1,332,0,332,360
2.633,6,33,10037,17,267,164,822,2289,16,888,174,1420,7748
9.975,6,75,22798,38,552,269,1152,17534,37,472,270,1179,5264
1.775,6,22,5960,12,108,161,147,919,10,927,159,1608,5041
16.183,17,2,152,2,48,16183,48,152,0,0,0,0,0
369.039,6,23,1535,16,177,24602,177,1053,7,110,10375,110,482
44.271,6,3,616,3,248,22135,248,616,0,0,0,0,0
0.106,17,2,152,1,48,0,48,76,1,48,0,48,76
1787.782,17,87,3648,86,14,21032,14,3612,1,8,0,8,36
15.434,17,21,8746,10,561,1714,1350,5891,11,231,1540,1350,2855
2.826,6,29,10010,17,288,176,598,1550,12,886,241,1336,8460
0.237,6,25,6123,12,181,21,537,1526,13,559,18,1408,4597
15.313,17,6,528,3,48,7652,48,228,3,72,7652,72,300
0.039,17,2,130,1,37,0,37,65,1,37,0,37,65
725.416,1,54,3024,54,28,13687,28,3024,0,0,0,0,0
11.323,6,1760,1563342,1083,1391,10,1420,1532041,677,467,16,1883,31301
15.365,6,36,19297,18,708,903,1460,4306,18,1096,895,1460,14991
240.2,6,53,17923,28,795,8895,1418,14991,25,203,10007,580,2932
1794.078,17,144,11520,72,48,25268,48,5472,72,56,25268,56,6048
0.022,17,4,368,2,32,21,32,120,2,96,8,96,248
13.241,6,963,897512,629,1359,21,1368,875444,334,776,39,2736,22068
126.393,2,2,64,2,8,126393,8,64,0,0,0,0,0
44.789,6,33,9102,13,328,191,1189,2501,20,445,2356,1420,6601
0.006,6,2,80,1,0,0,0,40,1,0,0,0,40
13.743,6,25,4654,14,275,1057,275,1122,11,768,897,1440,3532
3.79,17,5,295,5,31,947,31,295,0,0,0,0,0
0.009,6,11,3287,6,81,1,81,401,5,872,2,1448,2886
1773.574,6,180,15480,120,69,14903,69,8940,60,69,30052,69,6540
0.724,6,148,100858,81,1294,9,1420,93887,67,427,10,1420,6971
17.82,6,8,854,2,211,17678,211,323,6,187,3563,187,531
1778.708,1,76,6384,0,0,0,0,0,76,56,23716,56,6384
1795.838,1,250,14000,250,28,7212,28,14000,0,0,0,0,0
1699.423,17,12,498,11,14,169942,14,462,1,8,0,8,36
0.13,1,2,112,2,28,130,28,112,0,0,0,0,0
1788.884,17,83,3480,82,14,22084,14,3444,1,8,0,8,36
3.901,6,87,59548,49,963,81,1360,12588,38,1566,101,2720,46960
0.013,6,11,14940,1,0,0,0,40,10,1438,1,1438,14900
1772.452,6,180,15480,120,69,14894,69,8940,60,69,30032,69,6540
170.18,6,30,8872,14,158,13090,267,1357,16,763,11340,2076,7515
138.018,17,4,240,2,32,138017,32,120,2,32,138017,32,120
92.348,6,30,7432,13,158,7695,267,1317,17,543,5770,1400,6115
1.304,6,49,18634,29,843,46,1360,13013,20,400,59,1360,5621
8.327,6,1447,1320120,906,1379,9,1408,1287324,541,931,15,2801,32796
0.137,6,39,14546,21,874,6,1420,9605,18,420,7,1420,4941
3.131,6,2,88,2,0,0,0,88,0,0,0,0,0
89.29,17,4,240,2,32,89289,32,120,2,32,89289,32,120
15.183,17,4,304,2,48,14889,48,152,2,48,14888,48,152
1786.577,6,106,8524,68,66,26665,66,4964,38,60,48283,60,3560
1.572,6,14,2351,8,188,224,245,700,6,703,259,1152,1651
64.109,6,18,6383,3,98,32050,106,325,15,454,4578,1420,6058
1784.393,17,170,10880,170,36,10558,36,10880,0,0,0,0,0
370.803,6,18,1288,14,226,28523,226,962,4,110,20061,110,326
1793.374,17,87,3648,86,14,21098,14,3612,1,8,0,8,36
0.01,17,2,362,1,30,0,30,58,1,276,0,276,304
1785.864,6,378,26297,218,97,8229,469,15481,160,69,11231,69,10816
1799.513,17,448,39612,404,35,4465,288,25708,44,288,40952,288,13904
1.423,6,43,16742,25,851,59,1360,11246,18,476,72,2715,5496
0.049,17,4,420,2,33,0,33,122,2,121,5,145,298
0.412,17,2,140,1,34,0,34,62,1,50,0,50,78
1786.676,6,104,8308,68,64,26666,64,4896,36,58,51045,58,3412
0.344,6,17,3016,9,282,43,531,1606,8,493,47,828,1410
1792.115,6,361,22858,210,69,8574,69,12678,151,69,11947,69,10180
0.13,17,2,167,1,39,0,39,67,1,72,0,72,100
1777.613,6,104,8376,68,65,26531,65,4930,36,59,50786,59,3446
1786.81,6,104,8444,68,66,26668,66,4964,36,60,51048,60,3480
1763.532,17,150,25544,150,142,11835,389,25544,0,0,0,0,0
1797.074,6,402,93118,185,428,9764,1460,67965,217,159,8319,1638,25153
1756.666,6,99,7411,63,38,28333,205,4476,36,33,50184,98,2935
36.191,6,22,3234,13,183,3015,517,1613,9,381,4514,499,1621
1682.833,17,14,1036,7,30,280462,30,406,7,62,280462,62,630
3.117,6,4,176,1,0,0,0,44,3,0,1517,0,132
1.247,6,24,8004,12,164,96,267,1288,12,1014,96,2331,6716
3.098,17,4,304,2,48,3047,48,152,2,48,3054,48,152
126.866,2,3,96,3,8,63433,8,96,0,0,0,0,0
230.641,6,14872,13176714,7819,779,29,1396,446547,7053,1758,19,11168,12730167
1786.583,6,105,8416,68,65,26665,65,4930,37,59,49624,59,3486
0.013,17,2,368,1,36,0,36,64,1,276,0,276,304
0.019,17,2,362,1,53,0,53,81,1,253,0,253,281
0.415,17,2,152,1,48,0,48,76,1,48,0,48,76
3.964,17,8,1176,4,48,1317,48,304,4,190,1317,308,872
1752.897,6,95,7203,63,38,28272,205,4476,32,33,56533,98,2727
127.448,6,9,522,2,106,127439,106,194,7,0,21239,0,328
0.002,17,2,451,2,197,2,350,451,0,0,0,0,0
2.054,1,10,840,10,56,228,56,840,0,0,0,0,0
0.271,17,3,451,2,39,96,39,134,1,289,0,289,317
187.255,17,4,352,2,60,187253,60,176,2,60,187253,60,176
0.128,1,8,672,8,56,18,56,672,0,0,0,0,0
1789.508,1,58,4872,58,56,31394,56,4872,0,0,0,0,0
1689.895,17,14,3755,7,30,281647,30,406,7,450,281647,463,3349
3.807,17,10,785,5,31,944,31,295,5,70,940,70,490
0.323,17,21,16087,12,1017,29,1350,12548,9,365,28,1350,3539
1742.911,6,95,7203,63,38,28111,205,4476,32,33,56214,98,2727
0.291,17,2,237,1,72,0,72,100,1,109,0,109,137
0.216,17,2,212,1,46,0,46,74,1,110,0,110,138
0.041,17,2,664,1,308,0,308,336,1,300,0,300,328
1308.334,17,248,18848,248,48,5296,48,18848,0,0,0,0,0
67.311,6,35,8415,17,410,548,882,1942,18,478,3949,2128,6473
3.773,17,4,240,4,32,1257,32,240,0,0,0,0,0
71.182,6,27,8637,11,155,7118,267,1226,16,563,4730,1460,7411
1.492,6,49,20427,27,975,57,1440,14771,22,433,62,1440,5656
24.198,17,12,1056,6,48,4809,48,456,6,72,4819,72,600
1.005,6,27,8506,15,229,60,583,2007,12,1201,76,3151,6499
31.87,6,276,300962,83,131,388,315,4709,193,1514,165,2804,296253
1.588,17,4,896,2,46,1574,46,148,2,346,1576,346,748
0.149,6,2,149,1,0,0,0,40,1,69,0,69,109
20.987,6,9,527,5,43,5246,43,311,4,0,6993,0,216
280.567,6,30,7432,13,158,23380,267,1317,17,543,17525,1400,6115
140.946,6,24,12492,12,753,65,1360,3568,12,1405,12802,3940,8924
0.962,17,2,166,1,47,0,47,75,1,63,0,63,91
8.116,6,12,3341,7,170,1352,170,554,5,1259,1981,1368,2787
11.575,6,23,9480,13,275,964,275,1078,10,1598,924,2840,8402
1.476,6,39,10511,21,517,73,1440,5015,18,433,73,1440,5496
1.612,17,6,966,3,36,799,36,192,3,230,783,230,774
1.296,6,51,21372,29,907,46,1360,15716,22,476,53,2715,5656
66.32,6,22,8294,12,430,6029,647,1922,10,834,7331,1408,6372
0.101,17,2,176,1,48,0,48,76,1,72,0,72,100
3.017,17,3,222,3,46,1508,46,222,0,0,0,0,0
1753.198,17,170,32624,170,163,10373,422,32624,0,0,0,0,0
44.528,6,31,11415,13,557,3710,751,5129,18,481,2595,1546,6286
1775.455,6,178,15262,119,69,15046,69,8831,59,69,30606,69,6431
0.083,6,9,1339,5,145,20,145,349,4,826,21,826,990
1.262,6,38,10434,21,513,63,1360,4978,17,476,68,2715,5456
0.024,6,10,1823,6,108,4,108,428,4,1179,7,1179,1395
15.348,17,27,13972,13,623,1276,1350,8474,14,364,1177,1350,5498
1790.41,1,251,14056,251,28,7161,28,14056,0,0,0,0,0
5.038,1,10,280,10,0,0,0,280,0,0,0,0,0
10.289,6,13,9054,4,407,3357,722,1030,9,1258,1263,1448,8024
1.317,6,32,6507,15,164,94,267,1922,17,650,72,1452,4585
1786.146,6,102,8364,68,66,26658,66,4964,34,60,54123,60,3400
279.092,17,4,352,2,60,279091,60,176,2,60,279091,60,176
1760.623,1,56,4704,56,56,32011,56,4704,0,0,0,0,0
0.526,6,28,9193,13,268,43,710,1758,15,947,35,1368,7435
1.018,6,52,37615,32,1203,32,1360,28999,20,1114,44,3620,8616
0.02,17,2,672,2,308,20,308,672,0,0,0,0,0
51.808,6,27,7177,13,155,4317,267,1306,14,530,3984,3417,5871
31.513,6,8,474,2,106,31411,106,194,6,0,6297,0,280
1700.459,17,12,498,11,14,170045,14,462,1,8,0,8,36
27.254,17,8,608,8,48,3893,48,608,0,0,0,0,0
2.371,6,22,7284,13,319,197,602,1960,9,1209,292,1946,5324
0.183,6,3,175,2,31,13,31,135,1,0,0,0,40
14.183,6,19,4089,7,152,2363,267,742,12,409,1264,1179,3347
154.328,6,13,532,4,0,4026,0,164,9,0,19289,0,368
0.419,6,7,295,4,0,139,0,164,3,7,108,7,131
1.314,6,50,20134,28,888,48,1360,14478,22,476,53,2715,5656
1.149,6,23,7952,12,164,89,267,1288,11,1216,97,3819,6664
1784.225,6,356,22520,208,69,8619,69,12460,148,69,12137,69,10060
374.635,6,18,1242,14,180,28818,180,916,4,110,20063,110,326
1741.12,6,90,6521,59,31,30019,31,3998,31,31,58035,31,2523
0.0,1,1,462,1,434,0,434,462,0,0,0,0,0
14.52,6,11,3578,4,112,4836,112,280,7,1003,2418,1460,3298
4.003,17,8,616,4,33,1334,33,244,4,65,1333,65,372
1788.406,17,87,3648,86,14,21040,14,3612,1,8,0,8,36
11.864,6,25,8473,13,275,988,275,1078,12,986,877,1440,7395
1772.71,6,180,15480,120,69,14896,69,8940,60,69,30044,69,6540
0.929,6,21,9148,11,499,92,1193,1983,10,1125,78,2279,7165
5.449,6,661,576122,409,1342,12,1368,558354,252,776,20,1473,17768
1669.078,1,8,448,8,28,238439,28,448,0,0,0,0,0
1791.335,17,630,137962,302,348,5951,1350,113656,328,46,5477,1350,24306
1779.399,1,63,5292,0,0,0,0,0,63,56,28699,56,5292
47.884,17,5,1688,5,309,11971,316,1688,0,0,0,0,0
1792.028,17,142,11360,71,48,25599,48,5396,71,56,25599,56,5964
6.286,17,26,6645,10,260,698,1350,2888,16,206,259,1350,3757
1749.742,17,13,534,11,14,174954,14,462,2,8,1749537,8,72
1789.817,17,83,3480,82,14,22096,14,3444,1,8,0,8,36
1787.924,6,327,20670,191,69,9410,69,11435,136,69,13243,69,9235
17.835,17,4,1344,4,308,5945,308,1344,0,0,0,0,0
2.08,6,29,10365,17,367,130,833,1785,12,1012,180,1420,8580
3.618,6,51,19339,29,884,129,1360,13638,22,400,161,1360,5701
21.87,17,19,13889,11,909,2183,1350,10307,8,419,3119,1350,3582
0.004,17,2,590,1,43,0,43,71,1,491,0,491,519
1.309,6,47,20075,28,892,48,1360,14539,19,476,63,2715,5536
1789.009,6,340,29379,198,89,9081,981,13827,142,138,12686,3457,15552
0.157,17,8,2758,8,316,22,355,2758,0,0,0,0,0
1739.458,6,87,6322,58,31,30516,31,3915,29,31,62123,31,2407
166.685,6,24,7445,13,851,100,1360,5661,11,266,16652,626,1784
2.15,6,13,2311,8,188,307,245,700,5,1407,474,1407,1611
1794.144,17,180,11520,180,36,10023,36,11520,0,0,0,0,0
1785.08,1,216,12096,216,28,8302,28,12096,0,0,0,0,0
300.712,6,38,8604,20,315,15826,916,2130,18,478,501,1928,6474
1793.51,6,418,25005,209,69,8622,69,12500,209,34,8622,64,12505
0.08,6,9,527,5,43,20,43,311,4,0,25,0,216
48.225,6,2111,1890859,1328,1369,36,1380,1850250,783,561,61,1923,40609
0.762,6,10,924,5,283,163,283,551,5,105,147,105,373
5.323,17,4,240,2,32,5322,32,120,2,32,5322,32,120
90.197,6,12,824,6,92,18039,92,408,6,92,17366,92,416
0.143,6,29,7835,17,131,8,131,1023,12,618,12,1000,6812
0.563,6,14,1745,7,288,65,288,600,7,426,65,434,1145
1799.642,17,450,39960,405,35,4454,288,25740,45,288,40024,288,14220
30.274,17,6,528,3,48,15132,48,228,3,72,15132,72,300
1799.217,17,448,39896,403,35,4475,288,25676,45,288,40021,288,14220
0.011,17,2,338,1,33,0,33,61,1,249,0,249,277
11.782,6,1840,1629012,1141,1375,10,1420,1596831,699,467,16,1883,32181
1796.475,17,448,39896,403,35,4468,288,25676,45,288,40020,288,14220
96.961,6,18,1532,6,180,131,180,680,12,110,8796,110,852
1742.614,2,21,672,21,8,87130,8,672,0,0,0,0,0
1744.649,2,27,864,27,8,67101,8,864,0,0,0,0,0
10.804,6,9,527,5,43,2701,43,311,4,0,3600,0,216
126.793,2,2,64,2,8,126793,8,64,0,0,0,0,0
1031.583,17,493,34993,421,40,2456,41,28903,72,56,497,57,6090
328.514,6,8,475,6,31,65702,31,333,2,31,299514,31,142
295.305,6,350,286835,219,1362,1354,1448,263409,131,553,2176,1448,23426
360.026,17,7,2808,7,373,60004,548,2808,0,0,0,0,0
1.054,6,26,9592,14,350,81,1041,1992,12,1184,77,2370,7600
134.696,6,8,447,2,0,7500,0,112,6,7,26902,7,335
191.052,6,9,528,2,112,191043,112,200,7,0,31840,0,328
174.083,6,117,87657,75,1244,2352,1408,77348,42,811,1719,3847,10309
1.648,6,30,7432,13,158,137,267,1317,17,543,99,1400,6115
120.444,6,34,7808,15,142,2408,267,1461,19,371,6690,1997,6347
8.027,6,15,2636,9,155,1003,245,985,6,1407,1551,1407,1651
0.043,17,2,154,1,33,0,33,61,1,65,0,65,93
280.394,6,30,7432,13,158,23366,267,1317,17,543,17519,1400,6115
1.328,6,48,18817,26,929,53,1460,13161,22,433,54,1460,5656
1.848,6,54,19402,27,888,71,1440,13546,27,433,64,1440,5856
1.407,6,48,19610,27,920,54,1440,13994,21,433,61,1440,5616
316.982,6,125,37038,59,513,5465,1360,25001,66,234,4874,1360,12037
0.093,17,2,157,1,31,0,31,59,1,70,0,70,98
1.006,17,6,840,3,64,496,64,276,3,160,358,160,564
0.28,6,10,1379,5,145,70,145,349,5,826,45,826,1030
0.083,6,9,1339,5,145,20,145,349,4,826,16,826,990
0.801,6,10,1514,5,503,200,503,771,5,475,199,475,743
0.49,17,3,543,2,39,153,39,134,1,381,0,381,409
300.643,6,49,9118,24,283,13071,787,2209,25,327,650,1460,6909
240.274,6,43,9116,21,519,12013,1402,5774,22,243,11441,618,3342
72.18,6,33,19357,15,877,44,1360,5894,18,1060,4237,1360,13463
0.351,6,21,7215,11,318,34,600,1866,10,803,38,1408,5349
180.507,2,4,128,4,8,60169,8,128,0,0,0,0,0
1763.378,2,17,544,17,8,110211,8,544,0,0,0,0,0
36.582,6,43,8801,21,360,756,766,2013,22,393,1734,4848,6788
180.517,2,2,64,2,8,180517,8,64,0,0,0,0,0
2.425,6,785,888790,331,239,7,255,21056,454,1871,5,9856,867734
1.282,6,24,8004,12,164,100,267,1288,12,1014,99,2896,6716
1.194,6,23,7952,12,164,92,267,1288,11,1216,101,3825,6664
1741.196,6,93,6720,60,31,29511,31,4081,33,31,54410,31,2639
836.169,6,52,14957,29,445,29863,1360,6545,23,467,37998,2134,8412
1783.809,6,359,22709,209,69,8575,69,12569,150,69,11971,69,10140
1795.51,17,449,39928,404,35,4455,288,25708,45,288,40020,288,14220
280.527,6,29,7392,13,158,23377,267,1317,16,603,18694,2076,6075
70.181,6,30,7325,9,154,462,267,832,21,352,3508,1420,6493
7.524,17,50,20313,17,635,469,1350,11276,33,245,234,1350,9037
0.14,6,3,136,1,0,0,0,40,2,0,0,0,96
18.248,6,9,488,5,0,4562,0,280,4,0,2334,0,208
128.394,6,6,335,2,0,1203,0,112,4,7,42740,7,223
147.514,17,2,136,2,40,147514,47,136,0,0,0,0,0
1798.289,17,140,11200,70,48,26061,48,5320,70,56,26061,56,5880
3.514,6,8,428,4,0,1171,0,216,4,0,1104,0,212
1216.182,6,195,22972,78,98,15794,615,6998,117,126,10482,1629,15974
1799.448,1,16,896,16,28,119963,28,896,0,0,0,0,0
61.309,6,35,15881,22,805,2919,1408,9207,13,855,5089,3847,6674
1787.915,6,363,23352,206,69,8721,69,12449,157,69,11460,69,10903
1720.701,17,13,534,11,14,172051,14,462,2,8,1720504,8,72
0.004,17,2,308,1,34,0,34,62,1,218,0,218,246
5.577,6,13,3772,5,171,1393,171,439,8,964,796,1448,3333
1781.766,6,359,22709,209,69,8566,69,12569,150,69,11958,69,10140
237.447,17,4,240,2,32,237446,32,120,2,32,237446,32,120
0.505,6,15,5386,8,965,72,1360,3217,7,269,46,272,2169
1789.951,6,380,24032,216,69,8325,69,13332,164,69,10981,69,10700
1798.163,17,448,39896,403,35,4473,288,25676,45,288,40019,288,14220
1.372,6,49,19694,27,923,52,1460,14038,22,433,56,1460,5656
32.94,6,22,9104,13,278,2745,535,1387,9,1469,4095,4010,7717
282.185,17,15,2488,8,48,40310,48,608,7,240,45531,308,1880
1762.317,1,56,4704,56,56,32042,56,4704,0,0,0,0,0
0.58,17,4,368,2,64,578,64,184,2,64,579,64,184
1744.757,2,27,864,27,8,67106,8,864,0,0,0,0,0
1623.754,1,7,392,7,28,270625,28,392,0,0,0,0,0
1685.522,17,12,498,11,14,168552,14,462,1,8,0,8,36
5.423,6,42,7405,22,201,258,314,3503,20,516,271,1179,3902
18.902,6,17,5487,8,275,2700,275,603,9,902,1661,1440,4884
0.407,6,21,7203,13,318,33,600,1958,8,964,53,1471,5245
1.554,6,53,19657,29,905,55,1360,13876,24,400,59,1360,5781
63.911,6,46,13350,22,181,3043,267,2340,24,772,2777,3436,11010
85.122,6,21,8544,11,556,104,1329,2140,10,998,9435,2720,6404
280.2,6,27,7312,13,158,23350,267,1317,14,775,21550,4836,5995
1.05,17,8,568,4,32,346,32,240,4,54,346,60,328
377.453,6,25,1651,17,177,23590,177,1117,8,110,9266,110,534
1751.07,17,12,498,11,14,175107,14,462,1,8,0,8,36
3.957,1,30,840,30,0,0,0,840,0,0,0,0,0
1764.228,17,15,2910,15,166,126016,166,2910,0,0,0,0,0
160.832,6,29,5486,15,190,11488,722,2310,14,611,9553,2329,3176
0.009,17,2,433,1,34,0,34,62,1,343,0,343,371
1787.447,6,102,8364,68,66,26678,66,4964,34,60,54160,60,3400
1447.348,6,193,17215,73,84,20099,376,7892,120,74,12161,1062,9323
1.031,17,4,708,2,30,1018,30,116,2,268,12,292,592
346.973,6,63,11875,26,107,13878,267,2447,37,248,9637,1452,9428
0.435,6,7,295,4,0,145,0,164,3,7,120,7,131
1799.894,17,29,1653,29,29,64281,29,1653,0,0,0,0,0
252.347,2,3,96,3,8,126173,8,96,0,0,0,0,0
1779.84,6,193,21031,126,109,14238,965,12048,67,94,26960,917,8983
1799.494,17,245,46767,245,162,7374,353,46767,0,0,0,0,0
1786.22,6,367,23236,212,69,8465,69,12896,155,69,11595,69,10340
58.058,17,6,456,6,48,11611,48,456,0,0,0,0,0
0.188,6,9,1148,5,145,47,145,349,4,635,46,635,799
20.399,1,14,1456,0,0,0,0,0,14,76,1569,76,1456
0.008,6,3,478,2,179,4,267,438,1,0,0,0,40
6.703,6,26,7472,12,448,609,1230,2873,14,385,465,1296,4599
0.255,1,2,112,2,28,255,28,112,0,0,0,0,0
0.912,6,12,3656,6,124,182,124,444,6,964,181,1448,3212
0.523,17,4,352,2,60,520,60,176,2,60,522,60,176
14.108,17,2,152,2,48,14108,48,152,0,0,0,0,0
2.929,6,57,38684,26,702,117,1440,5991,31,1367,93,1835,32693
1797.531,17,448,39896,403,35,4471,288,25676,45,288,40014,288,14220
121.866,1,4,224,4,28,40622,28,224,0,0,0,0,0
1797.426,17,449,39928,404,35,4460,288,25708,45,288,40020,288,14220
20.015,6,14,2185,8,324,2859,585,1073,6,396,3955,580,1112
1.37,6,19,3781,10,234,152,564,1452,9,463,148,1343,2329
1.349,6,25,8056,12,164,104,267,1288,13,869,96,1368,6768
1742.805,6,87,6322,58,31,30575,31,3915,29,31,62242,31,2407
154.527,6,115,47003,56,736,2809,1152,37609,59,390,2659,1179,9394
1751.595,6,97,7307,63,38,28251,205,4476,34,33,53069,98,2831
0.048,17,3,203,3,39,24,40,203,0,0,0,0,0
3.804,17,4,352,2,48,3794,48,152,2,72,3791,72,200
22.087,17,2,152,2,48,22087,48,152,0,0,0,0,0
0.145,6,4,160,2,0,145,0,80,2,0,1,0,80
34.384,6,35,8415,18,410,515,882,1982,17,521,2138,3488,6433
2.881,17,4,268,4,39,960,39,268,0,0,0,0,0
1762.929,1,118,6608,118,28,15067,28,6608,0,0,0,0,0
0.226,6,3,144,2,0,2,0,92,1,0,0,0,52
0.086,17,2,586,1,46,0,46,74,1,484,0,484,512
1787.569,6,104,8308,68,64,26680,64,4896,36,58,51069,58,3412
16.606,2,2,64,2,8,16606,8,64,0,0,0,0,0
0.055,17,4,398,2,46,0,46,148,2,97,0,103,250
5.546,6,39,7291,22,160,264,267,2655,17,564,296,1420,4636
4.991,17,4,288,2,36,4991,36,128,2,52,4990,52,160
1684.501,2,26,832,26,8,67380,8,832,0,0,0,0,0
49.616,17,4,1344,4,308,16538,308,1344,0,0,0,0,0
0.043,6,28,18865,17,127,2,127,1019,11,2466,4,7240,17846
3.018,17,4,1568,4,364,1006,364,1568,0,0,0,0,0
0.358,17,2,152,1,48,0,48,76,1,48,0,48,76
1.329,17,6,432,3,36,664,36,192,3,52,664,52,240
1771.596,6,101,9410,66,66,27255,66,5610,35,60,52102,60,3800
2.788,6,52,19219,29,935,99,1460,13382,23,377,108,1460,5837
81.304,2,2,64,2,8,81304,8,64,0,0,0,0,0
3.007,17,6,450,3,37,1499,37,195,3,57,1499,65,255
18.361,6,3,189,2,69,18346,69,149,1,0,0,0,40
0.145,17,4,588,2,48,138,48,152,2,190,137,308,436
0.024,17,4,284,2,32,0,32,120,2,54,10,60,164
1799.626,17,1921,145900,1048,40,1718,41,71958,873,56,2063,57,73942
0.012,6,9,1612,5,636,3,636,904,4,492,3,492,708
240.205,6,57,18069,29,739,8578,1402,14829,28,222,8896,580,3240
33.782,6,34,5307,17,154,2100,722,1975,17,305,2100,1440,3332
7.138,6,14,1029,7,222,1187,222,506,7,231,1187,231,523
31.805,6,6,360,0,0,0,0,0,6,0,0,0,360
0.081,17,2,428,1,39,0,39,67,1,333,0,333,361
4.0,17,3,183,3,33,2000,33,183,0,0,0,0,0
185.049,6,53,9523,20,110,9739,267,2138,33,252,5776,1452,7385
9.872,2,2,64,2,8,9872,8,64,0,0,0,0,0
369.692,6,27,1767,18,177,21746,177,1181,9,110,8595,110,586
296.215,17,4,1344,4,308,98738,308,1344,0,0,0,0,0
367.369,6,25,1651,17,177,22960,177,1117,8,110,9173,110,534
280.225,6,28,7352,13,158,23352,267,1317,15,678,20012,4200,6035
4.868,6,39,7269,20,218,256,314,3423,19,513,256,1179,3846
1784.033,6,359,22709,209,69,8577,69,12569,150,69,11973,69,10140
1782.269,17,140,11200,70,48,25829,48,5320,70,56,25829,56,5880
368.369,6,18,1242,14,180,28336,180,916,4,110,20058,110,326
0.011,17,4,344,2,47,2,47,150,2,69,1,75,194
186.91,17,4,352,2,60,186909,60,176,2,60,186908,60,176
31.953,6,46,10114,24,289,1389,721,3575,22,627,1472,2431,6539
1777.92,17,73,3060,72,14,25041,14,3024,1,8,0,8,36
1793.23,1,162,9072,162,28,11138,28,9072,0,0,0,0,0
0.02,17,2,293,1,37,0,37,65,1,200,0,200,228
0.006,17,2,596,1,34,0,34,62,1,506,0,506,534
0.595,6,10,1383,5,145,148,145,349,5,830,70,830,1034
280.471,6,30,7432,13,158,23372,267,1317,17,603,17523,2076,6115
1792.174,6,359,22847,207,69,8699,69,12489,152,69,11868,69,10358
1791.778,17,144,11520,72,48,25235,48,5472,72,56,25236,56,6048
0.024,17,2,2728,2,1336,24,1336,2728,0,0,0,0,0
1788.881,17,142,11360,71,48,25555,48,5396,71,56,25555,56,5964
4.015,6,7,519,0,0,0,0,0,7,31,669,31,519
0.007,17,2,375,1,29,0,29,57,1,290,0,290,318
1792.144,6,356,22520,208,69,8657,69,12460,148,69,12191,69,10060
0.099,17,2,144,1,36,0,36,64,1,52,0,52,80
0.338,17,2,384,1,36,0,36,64,1,292,0,292,320
280.058,6,28,7352,13,158,23338,267,1317,15,678,20000,2800,6035
0.186,6,10,1752,6,592,36,1028,1429,4,159,55,159,323
97.56,6,31,11719,17,666,165,1360,3424,14,858,7491,3107,8295
1786.588,17,87,3648,86,14,21018,14,3612,1,8,0,8,36
1.117,6,7,295,4,0,372,0,164,3,7,423,7,131
560.93,17,6,444,3,30,280441,30,174,3,62,280440,62,270
1787.61,6,115,13683,75,81,24156,504,5920,40,162,45833,1452,7763
280.477,6,31,7472,13,158,23373,267,1317,18,603,16492,2760,6155
1638.499,2,13,416,13,8,136541,8,416,0,0,0,0,0
150.363,6,60,38624,38,1150,4063,1408,30737,22,841,2925,2439,7887
1075.533,17,212,16112,212,48,5097,48,16112,0,0,0,0,0
1791.32,17,192,64512,192,308,9378,308,64512,0,0,0,0,0
20.339,6,19,3078,11,183,2033,517,1509,8,381,2904,499,1569
1115.696,17,58,2438,56,13,20285,15,2348,2,17,391624,18,90
5.397,6,38,7229,20,218,284,314,3423,18,513,300,1179,3806
0.983,6,10,924,5,283,121,283,551,5,105,192,105,373
569.904,6,58,7314,28,100,16312,722,2870,30,151,19646,1408,4444
1795.59,17,449,39928,404,35,4455,288,25708,45,288,40018,288,14220
235.36,17,4,352,2,60,235359,60,176,2,60,235359,60,176
368.63,6,23,1535,16,177,24575,177,1053,7,110,10376,110,482
303.791,2,4,128,4,8,101263,8,128,0,0,0,0,0
0.397,6,30,6781,14,212,30,453,2011,16,489,25,1448,4770
1798.73,1,345,28980,345,56,5228,56,28980,0,0,0,0,0
1.908,6,36,13759,20,525,100,1360,3494,16,801,94,1380,10265
1.949,17,6,552,3,32,974,32,180,3,96,974,96,372
0.526,6,24,6042,13,108,43,147,959,11,773,42,1608,5083
0.086,17,2,268,1,54,0,54,82,1,158,0,158,186
1.514,6,19,3781,10,234,168,564,1452,9,463,166,1343,2329
10.989,6,18,5610,10,275,1221,275,958,8,1440,853,1440,4652
0.154,17,2,128,1,28,0,28,56,1,44,0,44,72
1788.611,17,140,11200,70,48,25921,48,5320,70,56,25921,56,5880
48.076,6,19,4426,9,264,6009,722,1521,10,793,5317,1448,2905
15.36,6,15,2245,9,324,1920,585,1125,6,396,2972,580,1120
1124.766,17,220,16720,220,48,5135,48,16720,0,0,0,0,0
8.496,6,18,8215,9,275,1062,275,643,9,1440,992,1440,7572
4.114,17,3,186,3,34,2057,34,186,0,0,0,0,0
9.774,6,82,24805,41,560,244,1152,19008,41,461,238,1179,5797
5.441,6,5,280,2,0,5441,0,100,3,0,1517,0,180
1747.616,6,100,7866,66,45,26886,205,4902,34,35,52945,98,2964
63.973,6,70,46671,44,1170,1487,1448,38591,26,746,2463,1448,8080
1.469,6,4,739,4,177,489,177,739,0,0,0,0,0
1.399,6,47,18090,26,877,55,1360,12474,21,433,60,1360,5616
15.119,17,21,8671,10,537,1676,1350,5654,11,246,1508,1350,3017
1775.792,6,204,22399,131,75,13659,267,10166,73,134,24660,1917,12233
240.612,6,64,24701,31,549,8020,1418,6573,33,820,7518,1418,18128
135.451,6,30,8872,14,158,10419,267,1357,16,763,9027,2045,7515
124.808,6,22,9310,11,304,103,610,1384,11,1245,12461,2720,7926
1777.521,17,140,11200,70,48,25761,48,5320,70,56,25761,56,5880
4.018,17,8,1288,4,33,1333,33,244,4,233,1336,233,1044
1773.334,6,180,15480,120,69,14901,69,8940,60,69,30050,69,6540
0.011,17,2,338,1,33,0,33,61,1,249,0,249,277
24.072,6,29,7392,13,158,2006,267,1317,16,603,1602,1400,6075
1778.634,6,90,6700,43,36,42347,36,2452,47,445,38664,445,4248
1755.269,1,8,448,8,28,250752,28,448,0,0,0,0,0
1773.34,6,180,15480,120,69,14902,69,8940,60,69,30048,69,6540
422.982,1,12,672,12,28,38452,28,672,0,0,0,0,0
58.426,6,29,7257,13,155,4868,267,1306,16,441,3894,1420,5951
152.744,6,23,10989,12,380,67,832,1665,11,1267,15262,3928,9324
0.13,6,2,80,1,0,0,0,40,1,0,0,0,40
45.077,6,6033,5729823,3857,1405,11,1448,5612007,2176,776,20,1448,117816
1744.906,6,109,8576,70,44,25288,150,5191,39,38,45918,163,3385
504.207,2,5,160,5,8,126051,8,160,0,0,0,0,0
0.334,6,27,9059,14,252,25,647,1744,13,1103,27,2816,7315
1775.071,17,166,14736,83,62,21647,136,7540,83,58,21647,72,7196
1745.858,1,150,8400,150,28,11717,28,8400,0,0,0,0,0
0.26,17,3,507,2,39,56,39,134,1,345,0,345,373
1786.634,6,102,8364,68,66,26666,66,4964,34,60,54137,60,3400
165.413,6,19,780,7,0,3038,0,284,12,0,15036,0,496
1.156,6,26,9564,13,164,82,267,1388,13,1070,81,2816,8176
184.259,1,6,336,6,28,36851,28,336,0,0,0,0,0
366.968,6,18,1242,14,180,28228,180,916,4,110,20065,110,326
240.763,6,437,386907,163,460,1486,1418,12165,274,1381,881,1418,374742
1741.632,6,85,6187,57,31,31100,31,3863,28,31,64503,31,2324
1769.908,6,103,9448,66,65,27229,65,5577,37,59,49161,59,3871
34.499,17,20,1760,10,48,3832,48,760,10,72,3831,72,1000
22.801,6,3,275,2,46,14507,62,173,1,62,0,62,102
4.839,6,39,7269,21,218,241,314,3463,18,513,270,1179,3806
1779.924,17,140,11200,70,48,25795,48,5320,70,56,25795,56,5880
1783.808,6,373,26428,215,104,8335,469,15623,158,69,11361,69,10805
0.417,6,2,80,1,0,0,0,40,1,0,0,0,40
436.186,17,12,1131,6,33,87233,37,369,6,99,87233,136,762
5.032,17,3,208,2,36,5002,36,128,1,52,0,52,80
1786.623,6,105,8484,68,66,26666,66,4964,37,60,49625,60,3520
7.436,6,11,1998,6,183,1439,267,611,5,1179,1800,1179,1387
2.92,6,2,88,2,0,0,0,88,0,0,0,0,0
1773.127,6,181,15589,120,69,14900,69,8940,61,69,29547,69,6649
9.206,6,2,87,0,0,0,0,0,2,7,9206,7,87
227.126,6,36,5721,17,331,14195,1056,3215,19,215,12617,580,2506
6.516,6,15,5673,5,106,1627,106,314,10,988,723,1997,5359
4.001,17,5,872,4,64,1327,64,368,1,476,0,476,504
0.038,6,10,767,5,186,9,186,454,5,45,9,45,313
61.798,6,68,48474,44,1193,1437,1408,40491,24,961,2677,3847,7983
11.715,6,38,8976,22,101,557,319,1829,16,649,564,1642,7147
1740.575,17,29,30595,29,1027,62163,1027,30595,0,0,0,0,0
240.199,6,64,20549,31,828,8006,1418,17357,33,183,7505,580,3192
0.066,17,2,136,1,32,0,32,60,1,48,0,48,76
291.499,6,54,8423,26,106,11658,517,2346,28,417,10794,1418,6077
11.169,6,27,11355,13,275,930,275,1078,14,1078,784,1414,10277
4.025,6,40,7309,21,218,201,314,3463,19,513,210,1179,3846
287.981,1,4,326,4,53,95993,78,326,0,0,0,0,0
300.804,6,31,8281,14,204,23138,467,1552,17,416,5734,1448,6729
0.156,17,2,904,2,424,156,548,904,0,0,0,0,0
215.032,17,4,352,2,60,215031,60,176,2,60,215031,60,176
721.972,2,10,320,10,8,80219,8,320,0,0,0,0,0
1790.41,6,365,23294,210,69,8566,69,12609,155,69,11625,69,10685
14.033,6,16,7770,7,275,2338,275,563,9,1367,1462,1420,7207
9.324,6,50,8629,24,227,405,314,4142,26,491,362,1179,4487
1.619,6,30,8649,14,141,111,267,1455,16,792,96,1448,7194
974.813,17,88,8096,80,30,12339,37,4668,8,400,130442,463,3428
0.231,6,28,7336,13,155,19,267,1301,15,543,15,1400,6035
1796.866,17,278,59061,278,184,6486,422,59061,0,0,0,0,0
1744.127,1,71,5964,0,0,0,0,0,71,56,24916,56,5964
294.976,1,4,224,4,28,98325,28,224,0,0,0,0,0
63.993,6,23,9001,11,514,85,1236,2014,12,927,5802,1460,6987
0.225,17,18,11698,10,886,25,1350,9148,8,290,22,1350,2550
1772.971,6,181,15589,120,69,14898,69,8940,61,69,29547,69,6649
62.171,6,26,7137,12,155,5651,267,1266,14,530,4781,2840,5871
661.531,17,48,3824,26,48,26461,48,1976,22,56,26665,56,1848
5.318,6,16,3276,6,92,1063,92,400,10,581,550,1408,2876
1744.668,2,27,864,27,8,67102,8,864,0,0,0,0,0
1798.14,17,447,39864,402,35,4484,288,25644,45,288,40019,288,14220
1783.102,17,79,3312,78,14,23157,14,3276,1,8,0,8,36
0.902,6,25,8718,14,254,69,658,1609,11,951,73,1460,7109
12.437,17,3,1035,3,317,6218,317,1035,0,0,0,0,0
432.056,17,36,2772,36,49,12344,49,2772,0,0,0,0,0
0.153,17,2,225,1,37,0,37,65,1,132,0,132,160
22.692,6,17,3336,7,92,3782,92,452,10,579,2499,1408,2884
1798.454,1,218,12208,218,28,8287,28,12208,0,0,0,0,0
0.194,6,5,5880,4,1408,0,1408,5840,1,0,0,0,40
4.569,17,32,15316,15,720,326,1350,11232,17,212,199,1350,4084
0.291,6,213,196730,80,278,3,517,5330,133,1430,2,1440,191400
644.799,1,16,896,16,28,42986,28,896,0,0,0,0,0
75.185,6,46,9384,22,510,724,1216,2515,24,346,3263,2720,6869
1792.732,1,8,448,8,28,256104,28,448,0,0,0,0,0
16.44,6,18,3856,8,171,2322,211,938,10,393,1805,1448,2918
4.032,17,6,5701,2,723,4032,1350,1503,4,1021,938,1350,4198
0.361,17,2,144,1,36,0,36,64,1,52,0,52,80
0.018,17,2,475,1,40,0,40,68,1,379,0,379,407
50.748,17,3,228,3,48,25374,48,228,0,0,0,0,0
1774.631,6,180,15480,120,69,14912,69,8940,60,69,30076,69,6540
230.336,17,4,1344,4,308,76778,308,1344,0,0,0,0,0
274.871,1,2,120,2,32,274871,32,120,0,0,0,0,0
21.426,17,4,824,2,48,21404,48,152,2,308,21414,308,672
1771.028,6,101,9410,66,66,27246,66,5610,35,60,52086,60,3800
0.442,6,13,1693,6,288,86,288,548,7,426,40,434,1145
19.632,6,6,328,4,0,6544,0,216,2,0,19391,0,112
1795.079,1,58,4872,0,0,0,0,0,58,56,31492,56,4872
1750.651,17,12,498,11,14,175065,14,462,1,8,0,8,36
1794.217,17,140,11200,70,48,26002,48,5320,70,56,26002,56,5880
1.373,6,50,19690,27,920,52,1360,13994,23,433,54,1360,5696
61.289,6,37,15948,22,801,2918,1448,9170,15,665,4360,1448,6778
1772.236,6,180,15480,120,69,14892,69,8940,60,69,30036,69,6540
1790.725,6,361,22927,209,69,8609,69,12569,152,69,11858,69,10358
1.728,6,187,178243,90,162,19,230,5930,97,1779,17,8208,172313
0.689,17,4,624,2,64,688,64,184,2,192,573,192,440
240.22,6,55,18681,30,784,8283,1418,15685,25,211,10008,580,2996
2.784,6,2,129,1,0,0,0,40,1,37,0,37,89
1786.265,6,104,8376,68,65,26660,65,4930,36,59,51033,59,3446
1681.546,17,14,1036,7,30,280255,30,406,7,62,280255,62,630
1740.514,17,30,31680,30,1028,60017,1028,31680,0,0,0,0,0
0.041,17,4,640,2,40,0,40,136,2,224,2,296,504
1791.796,1,208,11648,208,28,8656,28,11648,0,0,0,0,0
1386.132,2,8,256,8,8,198018,8,256,0,0,0,0,0
1796.953,17,449,39928,404,35,4458,288,25708,45,288,40020,288,14220
1594.113,1,8,448,8,28,227730,28,448,0,0,0,0,0
0.314,6,28,9146,13,257,26,669,1714,15,830,21,1402,7432
0.506,6,27,9037,16,274,33,668,2237,11,1034,45,1946,6800
172.328,6,19,8444,11,549,87,1309,2120,8,1498,24593,4511,6324
21.103,6,25,4746,10,256,2344,722,1540,15,342,1489,1448,3206
0.06,17,2,176,1,48,0,48,76,1,72,0,72,100
1.599,6,40,9928,21,440,79,1360,4392,19,476,75,2720,5536
0.089,17,4,284,2,32,52,32,120,2,54,40,60,164
0.187,6,26,7256,13,155,15,267,1301,13,678,13,2800,5955
1769.434,1,67,5628,67,56,26809,56,5628,0,0,0,0,0
1796.85,17,180,14040,180,50,10038,50,14040,0,0,0,0,0
142.625,6,804,389324,442,817,323,1152,370053,362,435,393,1179,19271
1757.43,6,100,7866,66,45,27037,205,4902,34,35,53245,98,2964
1.268,6,52,21355,29,904,45,1360,15659,23,433,50,1360,5696
0.89,17,2,122,2,33,890,33,122,0,0,0,0,0
0.546,6,14,1745,7,288,62,288,600,7,426,62,434,1145
0.087,17,2,154,1,33,0,33,61,1,65,0,65,93
125.361,6,14,3144,7,92,20893,92,452,7,464,20863,2026,2692
266.264,17,6,525,3,32,133116,37,181,3,86,133114,136,344
0.255,17,3,451,2,39,15,39,134,1,289,0,289,317
1783.281,17,83,3480,82,14,22015,14,3444,1,8,0,8,36
1772.39,6,184,32684,122,302,14647,302,24472,62,83,29055,83,8212
1774.474,17,142,11360,71,48,25349,48,5396,71,56,25349,56,5964
1.025,6,23,8853,14,203,78,458,1406,9,1415,101,3926,7447
24.468,6,3460,3342513,2324,1364,10,1408,3278777,1136,931,21,2801,63736
6.546,6,22,4426,12,213,595,597,1689,10,441,705,1402,2737
3.831,17,4,352,2,48,3820,48,152,2,72,3820,72,200
1762.95,17,285,63484,285,194,6207,422,63484,0,0,0,0,0
1777.461,1,62,5208,0,0,0,0,0,62,56,29138,56,5208
41.504,17,32,5412,16,48,2766,48,1216,16,234,2766,308,4196
280.256,6,28,7352,13,158,23354,267,1317,15,678,20014,2800,6035
1740.393,17,29,6815,29,207,62156,207,6815,0,0,0,0,0
377.274,2,4,128,4,8,125758,8,128,0,0,0,0,0
10.712,6,20,4442,11,275,1071,275,998,9,768,739,1440,3444
0.218,6,2,92,1,0,0,0,40,1,0,0,0,52
1796.01,17,140,11200,70,48,26029,48,5320,70,56,26029,56,5880
0.722,6,30,10101,17,639,45,1460,3919,13,627,46,1460,6182
842.204,2,7,224,7,8,140367,8,224,0,0,0,0,0
1795.82,17,446,39036,402,35,4478,288,25380,44,282,40950,288,13656
1780.054,6,365,23156,211,69,8476,69,12856,154,69,11634,69,10300
229.004,6,25,8534,11,181,22900,267,1168,14,755,17612,2036,7366
260.09,2,16,672,16,18,17339,24,672,0,0,0,0,0
482.351,1,10,560,10,28,53594,28,560,0,0,0,0,0
117.032,2,3,96,3,8,58516,8,96,0,0,0,0,0
1747.002,6,97,7307,63,38,28177,205,4476,34,33,52932,98,2831
1756.622,6,205,23718,102,80,17392,721,9161,103,231,17219,1414,14557
12.44,6,25,8473,13,275,1036,275,1078,12,986,1084,1440,7395
1790.794,1,342,28728,342,56,5251,56,28728,0,0,0,0,0
1.355,6,47,18836,26,934,54,1460,13220,21,433,58,1460,5616
1788.991,6,365,23087,211,69,8519,69,12787,154,69,11692,69,10300
5.169,17,4,288,2,36,5100,36,128,2,52,5120,52,160
38.702,17,44,6468,22,48,1842,48,1672,22,190,1842,308,4796
153.597,1,4,224,4,28,51199,28,224,0,0,0,0,0
0.075,17,2,588,1,39,0,39,67,1,493,0,493,521
6.49,6,23,4478,13,213,540,597,1741,10,441,700,1408,2737
1.303,6,53,19991,30,867,44,1360,14250,23,437,51,2715,5741
1784.663,6,244,24025,122,142,14747,239,18029,122,31,14747,31,5996
165.9,6,53,21398,27,1017,810,1360,11348,26,529,6628,1360,10050
3.844,6,247,227728,166,1001,23,1360,20114,81,2961,46,14960,207614
9.076,6,17,1811,9,222,1129,222,1252,8,231,1288,231,559
0.214,6,9,1338,5,549,53,549,753,4,421,56,421,585
5.035,17,4,288,2,36,5003,36,128,2,52,5003,52,160
1737.693,1,56,4704,0,0,0,0,0,56,56,31594,56,4704
1798.159,1,58,4872,58,56,31546,56,4872,0,0,0,0,0
1413.735,6,82,14449,51,147,28274,721,7523,31,472,6757,1440,6926
1785.837,6,106,8644,70,66,25881,66,5044,36,60,51021,60,3600
3.479,17,5,290,5,30,869,30,290,0,0,0,0,0
151.087,17,4,352,2,60,151086,60,176,2,60,151086,60,176
245.701,6,77,23216,34,638,7445,1418,15187,43,412,5849,1418,8029
238.3,6,30,7432,13,158,19858,267,1317,17,543,14889,1400,6115
1758.523,1,79,6636,79,56,22545,56,6636,0,0,0,0,0
0.043,17,2,158,1,34,0,34,62,1,68,0,68,96
0.508,17,2,476,1,39,0,39,67,1,381,0,381,409
19.7,6,25,6917,7,133,3283,267,821,18,447,1148,1452,6096
15.864,17,18,12230,11,886,1579,1350,10062,7,281,2631,1350,2168
1681.583,17,16,1265,8,30,240220,37,471,8,71,240221,136,794
242.6,6,106,9654,90,220,616,516,4486,16,348,16166,1452,5168
1772.6,6,180,15480,120,69,14895,69,8940,60,69,30035,69,6540
608.451,6,62,7500,33,89,19009,722,3161,29,149,21724,1408,4339
0.13,6,12,3462,6,75,26,75,395,6,1373,26,1448,3067
1.345,17,7,667,4,33,432,33,244,3,113,659,145,423
1.199,17,4,624,2,64,986,64,184,2,192,1045,192,440
0.16,17,2,164,1,46,0,46,74,1,62,0,62,90
0.893,6,10,1687,7,100,148,100,384,3,1179,322,1179,1303
20.011,6,32,9021,14,158,1539,267,1357,18,630,1158,1781,7664
1787.425,17,140,11200,70,48,25904,48,5320,70,56,25904,56,5880
1794.54,17,172,11008,172,36,10494,36,11008,0,0,0,0,0
4.075,17,5,295,5,31,1018,31,295,0,0,0,0,0
1797.207,1,258,14448,258,28,6993,28,14448,0,0,0,0,0
1793.668,17,87,3648,86,14,21101,14,3612,1,8,0,8,36
0.125,17,2,157,1,31,0,31,59,1,70,0,70,98
24.169,6,54,15029,25,889,81,1460,7317,29,311,843,2567,7712
1786.656,6,104,8376,68,65,26666,65,4930,36,59,51044,59,3446
71.153,6,36,8631,18,410,544,882,2062,18,486,4172,3488,6569
1781.764,6,362,24374,210,88,8525,469,13878,152,69,11799,69,10496
252.467,2,3,96,3,8,126233,8,96,0,0,0,0,0
1745.504,6,94,7151,62,38,28614,205,4424,32,33,56295,98,2727
9.194,6,1821,1621283,1063,1436,8,1448,1571170,758,852,11,1448,50113
4.251,6,41,7365,21,218,212,314,3463,20,516,210,1179,3902
0.252,17,2,180,1,30,0,30,58,1,94,0,94,122
287.478,6,28,2969,14,324,22111,585,1397,14,282,22110,580,1572
8.135,6,45,8425,23,227,369,314,4102,22,491,375,1179,4323
1794.515,6,355,22411,205,69,8796,69,12271,150,69,12043,69,10140
0.092,17,2,144,1,36,0,36,64,1,52,0,52,80
0.017,17,2,128,2,36,17,36,128,0,0,0,0,0
1796.225,1,62,5208,0,0,0,0,0,62,56,29446,56,5208
1789.458,6,358,22738,208,69,8644,69,12529,150,69,12009,69,10209
1756.66,6,295,42892,166,304,10646,304,30348,129,83,13723,83,12544
0.065,17,2,128,1,36,0,36,64,1,36,0,36,64
1795.805,6,116,7341,67,44,27205,208,4389,49,31,37408,31,2952
1792.067,6,358,22669,209,69,8615,69,12500,149,69,12108,69,10169
1720.409,17,12,498,11,14,172040,14,462,1,8,0,8,36
4.184,1,5,420,5,56,1046,56,420,0,0,0,0,0
1181.978,6,59,4296,37,31,32832,31,2470,22,31,56275,31,1826
1797.756,17,449,39928,404,35,4460,288,25708,45,288,40023,288,14220
1773.616,6,180,15480,120,69,14904,69,8940,60,69,30059,69,6540
82.666,6,32,8952,14,158,6358,267,1357,18,763,4858,2076,7595
1772.014,6,180,15480,120,69,14890,69,8940,60,69,30033,69,6540
1.93,17,3,1167,3,361,965,361,1167,0,0,0,0,0
1781.445,1,342,28728,342,56,5224,56,28728,0,0,0,0,0
1743.276,6,105,7645,67,31,26413,31,4567,38,31,47114,31,3078
0.141,17,2,312,1,64,0,64,92,1,192,0,192,220
9.194,17,8,1684,4,47,3060,47,300,4,318,3060,318,1384
1792.921,1,333,27972,333,56,5400,56,27972,0,0,0,0,0
1.143,6,25,8068,12,164,88,267,1300,13,869,80,1408,6768
1757.649,6,3192,2924952,1172,140,1500,889,75220,2020,1419,870,2836,2849732
241.261,6,50,6554,23,209,10966,585,3115,27,155,9278,580,3439
4.151,6,33,8992,14,158,319,267,1357,19,624,224,1380,7635
1789.016,17,142,11360,71,48,25557,48,5396,71,56,25557,56,5964
4.344,6,37,7189,19,218,241,314,3383,18,513,240,1179,3806
287.816,6,30,7432,13,158,23984,267,1317,17,603,17986,2760,6115
1770.688,1,58,4872,58,56,31064,56,4872,0,0,0,0,0
329.757,6,21,1603,13,64,27479,64,904,8,54,47096,58,699
0.624,17,20,11182,10,798,69,1350,8262,10,264,45,1350,2920
158.998,17,2,148,2,46,158998,46,148,0,0,0,0,0
0.456,6,27,9047,13,252,38,647,1692,14,945,34,1438,7355
15.056,1,4,383,4,67,5018,111,383,0,0,0,0,0
94.452,6,34,7950,10,155,10494,267,1194,24,321,4104,1452,6756
0.013,17,2,478,1,36,0,36,64,1,386,0,386,414
1796.055,17,144,11520,72,48,25296,48,5472,72,56,25296,56,6048
1.543,6,47,18768,26,929,61,1460,13152,21,433,65,1460,5616
280.673,6,32,7603,14,158,21590,267,1357,18,502,16507,1400,6246
250.068,6,25,6271,9,267,96,501,1165,16,343,16665,1420,5106
1228.054,1,6,336,6,28,245610,28,336,0,0,0,0,0
420.809,17,4,602,4,122,140269,352,602,0,0,0,0,0
1796.778,6,356,22520,208,69,8680,69,12460,148,69,12222,69,10060
92.434,6,30,7432,13,158,7702,267,1317,17,543,5772,1400,6115
1764.668,2,15,480,15,8,126047,8,480,0,0,0,0,0
300.195,6,46,10345,23,593,13637,1360,4561,23,346,13637,1360,5784
294.593,17,4,288,2,36,294562,36,128,2,52,294561,52,160
829.516,6,9,1240,9,110,103689,110,1240,0,0,0,0,0
15.478,17,21,6531,10,362,1715,1350,3902,11,211,1544,1350,2629
1754.629,1,16,896,16,28,116975,28,896,0,0,0,0,0
172.203,6,22,1478,8,46,24594,46,596,14,46,13243,46,882
2.394,17,22,14000,13,849,196,1350,11412,9,259,294,1350,2588
1783.818,6,367,23236,212,69,8454,69,12896,155,69,11583,69,10340
0.005,17,2,417,1,34,0,34,62,1,327,0,327,355
753.486,6,77,6599,50,69,15377,69,3794,27,69,28979,69,2805
280.021,6,29,7392,13,158,23335,267,1317,16,603,18666,2800,6075
160.209,6,25,11078,12,740,58,1360,3474,13,1010,13340,1360,7604
1785.935,17,247,78863,247,291,7259,422,78863,0,0,0,0,0
75.034,17,4,240,2,32,75033,32,120,2,32,75033,32,120
1799.184,17,142,11360,71,48,25702,48,5396,71,56,25702,56,5964
1.025,6,25,8805,14,290,78,802,1753,11,942,83,1460,7052
20.434,6,54,34289,22,533,754,1440,4720,32,1130,654,1685,29569
55.142,6,23,7038,6,165,927,267,909,17,418,3445,1997,6129
1770.287,17,46,15432,46,307,39339,308,15432,0,0,0,0,0
1771.553,6,99,9174,66,64,27254,64,5544,33,58,55357,58,3630
300.615,6,37,8431,20,291,15821,786,1997,17,522,530,4080,6434
150.04,17,70,10518,70,122,2174,357,10518,0,0,0,0,0
1768.157,1,58,4872,58,56,31020,56,4872,0,0,0,0,0
300.466,6,51,35298,32,1257,9692,1448,29334,19,828,3411,1448,5964
0.593,6,374,531685,190,233,3,255,12457,184,2800,2,11216,519228
290.923,1,4,224,4,28,96974,28,224,0,0,0,0,0
1767.903,6,180,32460,120,302,14856,302,24360,60,83,29964,83,8100
0.064,6,2,92,1,0,0,0,52,1,0,0,0,40
181.687,6,26,6308,10,266,87,500,1204,16,343,12107,1420,5104
1776.283,17,138,11040,69,48,26121,48,5244,69,56,26121,56,5796
1775.052,6,182,15560,120,69,14916,69,8940,62,69,29092,69,6620
280.518,6,24,7054,10,181,53,267,1128,14,595,21576,1400,5926
0.335,17,2,152,1,48,0,48,76,1,48,0,48,76
4.344,6,39,7269,19,218,241,314,3383,20,513,215,1179,3886
1723.417,17,80,3354,79,14,22095,14,3318,1,8,0,8,36
1798.53,17,142,11360,71,48,25693,48,5396,71,56,25693,56,5964
95.635,6,29,9113,7,145,408,267,1163,22,441,4553,1997,7950
0.087,6,2,446,1,354,0,354,406,1,0,0,0,40
1.416,6,54,21652,30,975,48,1440,15871,24,400,53,1440,5781
1799.76,1,9,504,9,28,224970,28,504,0,0,0,0,0
10.886,6,41,7547,19,218,604,314,3383,22,410,506,1179,4164
7.634,6,32,7515,14,152,587,267,1484,18,441,447,1420,6031
145.434,17,4,352,2,60,145433,60,176,2,60,145433,60,176
7.619,6,13,854,6,106,1499,106,460,7,90,1248,90,394
1.255,6,11,1727,7,100,209,100,384,4,589,330,1152,1343
50.572,6,10,648,10,31,5619,31,648,0,0,0,0,0
280.594,6,30,7432,12,158,25508,267,1277,18,603,16495,2076,6155
1783.103,1,188,19928,188,78,9535,78,19928,0,0,0,0,0
0.872,6,41,24143,24,840,37,1360,6035,17,1451,43,4080,18108
0.062,17,2,180,1,30,0,30,58,1,94,0,94,122
1.36,6,41,11378,22,547,64,1360,5842,19,433,64,1360,5536
1786.586,6,102,8228,68,64,26665,64,4896,34,58,54136,58,3332
10.264,6,39,18323,20,537,528,1360,4317,19,1102,561,1360,14006
124.246,6,34,7797,13,155,28,267,1306,21,352,6212,2840,6491
409.028,1,6,336,6,28,81805,28,336,0,0,0,0,0
314.611,6,9,685,9,31,39326,31,685,0,0,0,0,0
72.0,6,31,7682,10,155,8000,267,1186,21,332,3593,1460,6496
0.089,17,2,2380,2,1162,89,1162,2380,0,0,0,0,0
0.156,17,3,451,2,39,150,39,134,1,289,0,289,317
1.621,6,51,19482,29,898,57,1360,13781,22,437,67,2715,5701
1779.535,6,358,22738,208,69,8596,69,12529,150,69,11943,69,10209
0.156,17,2,152,1,48,0,48,76,1,48,0,48,76
0.1,17,2,334,1,32,0,32,60,1,246,0,246,274
1785.857,6,371,25810,215,99,8345,469,15154,156,69,11521,69,10656
62.413,6,33,15617,17,559,93,1360,3559,16,1267,4149,3595,12058
1772.85,1,66,6996,66,78,27274,78,6996,0,0,0,0,0
281.356,6,32,7516,14,158,21642,267,1357,18,543,16546,1400,6159
175.563,17,14,1940,7,48,29259,48,532,7,173,29259,308,1408
0.022,17,4,1223,4,277,7,316,1223,0,0,0,0,0
9.447,17,4,5482,4,1342,3149,1348,5482,0,0,0,0,0
1774.858,6,180,15480,120,69,14914,69,8940,60,69,30080,69,6540
111.783,6,132,103208,86,1260,1315,1368,92692,46,737,1867,2519,10516
138.944,17,4,240,2,32,138943,32,120,2,32,138943,32,120
1796.187,17,415,29184,404,35,4457,288,25708,11,288,40017,288,3476
20.268,6,25,6284,14,117,1559,159,1337,11,727,2025,1418,4947
1769.471,6,99,9240,66,65,27222,65,5577,33,59,55291,59,3663
2.298,6,14,2351,8,188,328,245,700,6,703,409,1152,1651
1770.792,6,102,9473,67,65,26830,65,5694,35,59,52079,59,3779
1773.345,6,180,15480,120,69,14902,69,8940,60,69,30051,69,6540
1.176,6,24,8004,12,164,91,267,1288,12,1014,91,2816,6716
50.56,6,19,4415,8,275,7222,275,603,11,480,4965,1440,3812
1.571,2,2,64,2,8,1571,8,64,0,0,0,0,0
1700.442,17,12,498,11,14,170044,14,462,1,8,0,8,36
0.391,6,12,1641,6,288,74,288,548,6,420,41,422,1093
1740.016,1,15,840,15,28,124286,28,840,0,0,0,0,0
367.122,6,18,1242,14,180,28240,180,916,4,110,20060,110,326
3.059,6,26,8275,13,164,230,267,1507,13,869,224,1448,6768
115.451,17,4,1344,4,308,38483,308,1344,0,0,0,0,0
126.604,2,2,64,2,8,126604,8,64,0,0,0,0,0
1787.119,17,87,3648,86,14,21024,14,3612,1,8,0,8,36
1786.209,17,87,3648,86,14,21014,14,3612,1,8,0,8,36
5.06,17,4,288,2,36,5005,36,128,2,52,5014,52,160
35.032,17,4,352,2,60,35031,60,176,2,60,35031,60,176
1772.377,6,180,15480,120,69,14893,69,8940,60,69,30039,69,6540
0.206,17,4,624,2,64,205,64,184,2,192,92,192,440
12.412,6,1948,1713424,1187,1389,10,1420,1678763,761,467,16,1883,34661
89.61,6,10,560,6,26,17883,26,338,4,26,29803,26,222
324.46,17,8,1412,4,48,108151,48,304,4,249,108152,308,1108
0.063,17,4,360,2,30,0,30,116,2,94,39,94,244
49.68,6,5,216,4,0,16560,0,172,1,0,0,0,44
395.243,6,20,1358,15,180,28231,180,980,5,110,15211,110,378
58.678,6,10,648,10,31,6519,31,648,0,0,0,0,0
1785.858,6,364,25461,211,100,8504,469,14856,153,69,11749,69,10605
280.462,6,29,7392,13,158,23371,267,1317,16,603,18693,1380,6075
1796.043,17,448,39896,403,35,4467,288,25676,45,288,40017,288,14220
1.601,6,37,8260,19,320,88,1162,2764,18,529,82,4075,5496
0.042,17,5,696,3,60,11,60,264,2,188,24,188,432
1799.562,17,449,39928,404,35,4465,288,25708,45,288,40021,288,14220
0.03,17,2,167,1,39,0,39,67,1,72,0,72,100
0.206,6,2,92,1,0,0,0,52,1,0,0,0,40
0.158,6,4,1037,2,0,134,0,104,2,853,37,853,933
1790.318,6,364,25392,212,100,8484,469,14896,152,69,11854,69,10496
65.867,17,4,352,2,60,65866,60,176,2,60,65865,60,176
177.549,6,49,27174,30,1050,6122,1448,19431,19,749,3405,1448,7743
1.006,6,10,1687,7,100,167,100,384,3,1179,373,1179,1303
1771.718,6,101,9410,66,66,27257,66,5610,35,60,52106,60,3800
0.182,6,46,20996,26,1065,7,1420,15975,20,467,9,1883,5021
63.699,6,34,8998,14,327,198,1189,2535,20,471,3352,1420,6463
5.405,6,40,7325,21,218,270,314,3463,19,516,286,1179,3862
0.799,17,19,7447,9,495,99,1350,4713,10,245,82,1350,2734
26.66,1,32,3328,0,0,0,0,0,32,76,860,76,3328
0.039,17,2,912,1,308,0,308,336,1,548,0,548,576
659.853,17,409,32725,399,40,1657,41,27397,10,504,1679,505,5328
1734.409,17,144,23706,144,136,12128,405,23706,0,0,0,0,0
360.968,2,4,128,4,8,120322,8,128,0,0,0,0,0
7.395,6,28,8768,12,155,672,267,1266,16,571,492,3426,7502
1798.168,17,450,39960,405,35,4450,288,25740,45,288,40018,288,14220
0.129,6,11,3410,5,75,32,75,343,6,1373,25,1448,3067
0.096,1,10,840,10,56,10,56,840,0,0,0,0,0
191.758,17,4,352,2,60,191757,60,176,2,60,191757,60,176
5.637,6,41,7349,22,218,268,314,3503,19,513,298,1179,3846
280.293,6,30,7432,13,158,23357,267,1317,17,543,17513,1400,6115
0.182,6,10,1378,5,549,45,549,753,5,421,37,421,625
4.329,6,4,1600,2,0,0,0,80,2,1440,271,1440,1520
0.014,17,2,294,1,36,0,36,64,1,202,0,202,230
1516.733,6,113,13434,68,83,22637,501,5410,45,159,33643,1420,8024
300.417,6,55,28457,33,1130,9388,1408,22152,22,468,1750,1491,6305
17.638,17,35,14197,16,448,1173,1350,7616,19,318,978,1350,6581
299.515,6,6,364,4,31,99838,31,222,2,31,299504,31,142
10.987,6,20,4442,11,275,1098,275,998,9,768,747,1440,3444
1792.146,6,362,22898,210,69,8574,69,12678,152,69,11868,69,10220
0.881,6,34,9211,19,306,48,677,2949,15,627,48,1460,6262
1795.503,17,448,39612,404,35,4455,288,25708,44,288,40018,288,13904
1250.071,1,18,1008,18,28,73533,28,1008,0,0,0,0,0
7.74,6,11,1739,5,100,1935,100,304,6,589,1491,1152,1435
1793.334,6,240,35580,150,302,12035,302,25920,90,83,20149,83,9660
1200.21,6,231,15568,121,69,9286,69,7531,110,67,11010,69,8037
12.248,17,10,850,5,37,3060,37,325,5,77,3050,77,525
1795.854,17,142,11360,71,48,25654,48,5396,71,56,25654,56,5964
368.914,6,27,1767,18,177,21700,177,1181,9,110,8893,110,586
1798.455,17,142,11360,71,48,25691,48,5396,71,56,25691,56,5964
140.569,6,14,3205,3,245,141,245,369,11,299,14031,299,2836
17.279,17,29,6344,14,223,1326,1350,3526,15,159,1231,1350,2818
19.757,6,29,4830,16,275,1317,275,1210,13,768,1248,1440,3620
0.374,17,3,543,2,39,369,39,134,1,381,0,381,409
0.364,6,21,7203,13,318,30,600,1958,8,964,49,1471,5245
1768.267,1,65,5460,65,56,27629,56,5460,0,0,0,0,0
0.25,6,12,3704,6,171,44,171,491,6,964,26,1448,3213
1.733,6,15,3632,8,150,247,174,624,7,681,248,1452,3008
1.438,6,47,19147,27,889,55,1460,13571,20,433,65,1460,5576
1774.746,6,180,15480,120,69,14913,69,8940,60,69,30077,69,6540
0.221,6,12,3704,6,171,44,171,491,6,964,44,1448,3213
105.849,6,23,10128,12,549,56,1360,2709,11,1393,10572,3934,7419
0.986,6,28,8160,15,222,59,540,1964,13,944,67,1591,6196
64.644,6,13,716,8,0,9234,0,432,5,0,15858,0,284
9.919,6,716,621228,452,1304,21,1368,602836,264,776,36,2736,18392
1.525,6,46,18993,27,881,58,1360,13457,19,476,73,2715,5536
1794.836,6,356,22520,208,69,8670,69,12460,148,69,12209,69,10060
69.32,6,26,7068,12,155,6301,267,1266,14,523,5319,1460,5802
1791.047,6,362,24774,211,94,8528,469,14387,151,69,11937,69,10387
12.345,6,1945,1704862,1179,1391,10,1420,1670001,766,467,16,2840,34861
18.266,17,29,19809,16,797,1215,1350,13200,13,480,1519,1350,6609
1781.238,6,102,8228,68,64,26585,64,4896,34,58,53973,58,3332
0.387,6,12,1653,6,288,71,288,548,6,426,41,434,1105
1798.454,17,448,39612,404,35,4462,288,25708,44,288,40947,288,13904
0.882,6,10,1687,7,100,147,100,384,3,1179,316,1179,1303
32.608,6,29,7392,14,158,2508,267,1357,15,678,2322,3436,6035
1787.978,6,369,25261,213,93,8433,469,14605,156,69,11532,69,10656
1.333,6,47,18071,26,875,53,1460,12455,21,433,57,1460,5616
32.047,6,37,9199,19,321,1780,721,3018,18,778,1824,1440,6181
1.071,6,11,1547,5,507,267,507,727,6,556,214,556,820
468.923,17,10,3360,10,308,52102,308,3360,0,0,0,0,0
11.578,6,25,8473,13,275,964,275,1078,12,986,757,1440,7395
0.158,17,4,368,2,32,39,32,120,2,96,41,96,248
1790.594,1,67,5628,67,56,27130,56,5628,0,0,0,0,0
1740.499,17,29,30566,29,1026,62160,1026,30566,0,0,0,0,0
100.171,6,34,13007,17,699,383,1360,4271,17,731,6238,1360,8736
2.744,6,48,18993,27,876,105,1360,13377,21,529,115,4075,5616
1786.685,6,102,8364,68,66,26666,66,4964,34,60,54139,60,3400
6.337,6,40,7325,21,218,316,314,3463,19,516,337,1179,3862
0.032,17,3,372,2,64,7,64,184,1,160,0,160,188
2.474,17,4,1560,4,362,824,362,1560,0,0,0,0,0
20.847,17,40,7254,17,138,1300,1350,2832,23,164,945,1350,4422
1745.844,6,97,7338,62,38,28620,205,4424,35,33,51339,98,2914
0.003,6,2,100,1,0,0,0,40,1,0,0,0,60
0.068,17,2,251,1,36,0,36,64,1,159,0,159,187
1773.389,1,58,4872,58,56,31112,56,4872,0,0,0,0,0
1740.521,17,28,29568,28,1028,64463,1028,29568,0,0,0,0,0
0.985,6,27,8771,14,208,75,475,1426,13,851,67,1460,7345
0.376,17,2,144,1,36,0,36,64,1,52,0,52,80
1.465,17,4,580,2,40,1433,40,136,2,194,1428,194,444
4.064,17,5,295,5,31,1016,31,295,0,0,0,0,0
0.061,1,2,112,2,28,61,28,112,0,0,0,0,0
73.208,6,10,648,10,31,8134,31,648,0,0,0,0,0
0.353,6,7,466,5,43,79,43,354,2,0,299,0,112
1772.621,6,240,17880,120,69,14895,69,8940,120,34,14895,48,8940
1.465,6,16,6056,9,70,181,133,504,7,1756,242,2828,5552
1795.119,17,80,3354,79,14,23014,14,3318,1,8,0,8,36
300.237,6,46,13814,20,863,15793,1360,7755,26,263,12002,1360,6059
1783.181,17,83,3480,82,14,22014,14,3444,1,8,0,8,36
2.957,17,2,204,1,34,0,34,62,1,114,0,114,142
0.625,6,3,127,1,0,0,0,40,2,7,4,7,87
1764.268,2,15,480,15,8,126019,8,480,0,0,0,0,0
2.354,6,116,87736,50,131,48,232,2529,66,1353,32,1430,85207
1787.296,6,106,8456,68,65,26676,65,4930,38,59,48301,59,3526
1799.944,6,367,25650,214,99,8450,469,15045,153,69,11840,69,10605
0.533,17,22,12143,11,805,53,1350,9163,11,242,40,1350,2980
1690.742,1,7,392,7,28,281790,28,392,0,0,0,0,0
10.841,6,20,7026,11,275,1084,275,998,9,1414,757,1414,6028
60.236,6,39,5402,22,134,2868,174,1688,17,303,3756,1452,3714
1622.121,1,7,392,7,28,270353,28,392,0,0,0,0,0
1796.45,17,449,39928,404,35,4457,288,25708,45,288,40020,288,14220
0.143,6,7,423,4,43,37,43,259,3,0,21,0,164
280.53,6,30,7432,13,158,23377,267,1317,17,603,17525,2076,6115
1692.307,1,8,848,8,78,241758,78,848,0,0,0,0,0
0.446,6,53,23199,29,1050,15,1380,17997,24,421,17,1923,5202
255.928,17,8,2688,8,308,36561,308,2688,0,0,0,0,0
1793.965,17,144,11520,72,48,25267,48,5472,72,56,25267,56,6048
109.888,6,32,8952,14,158,8452,267,1357,18,687,6460,2076,7595
39.962,17,4,352,2,60,39961,60,176,2,60,39961,60,176
1796.52,6,244,46664,152,483,11897,483,36892,92,83,19741,83,9772
1786.964,6,414,24840,206,69,8716,69,12380,208,34,8632,48,12460
0.557,17,3,543,2,39,60,39,134,1,381,0,381,409
1.38,6,4,184,2,0,1380,0,88,2,0,1006,0,96
0.343,6,27,8965,13,242,28,610,1655,14,939,22,1408,7310
1785.615,6,102,8296,68,65,26650,65,4930,34,59,54106,59,3366
13.368,6,4,554,2,126,13368,126,356,2,82,591,82,198
1.396,6,19,5418,9,158,174,174,838,10,835,132,1452,4580
191.997,6,4,574,4,103,63999,138,574,0,0,0,0,0
1748.956,6,103,8151,67,45,26499,205,4954,36,36,49960,98,3197
40.049,17,5,380,5,48,10012,48,380,0,0,0,0,0
1329.911,17,252,19152,252,48,5298,48,19152,0,0,0,0,0
1789.01,6,221,24863,138,88,13058,965,11480,83,134,21816,1997,13383
168.353,6,53,17133,34,565,5101,1360,11571,19,399,480,1360,5562
1761.126,6,80,3680,40,0,45156,0,2080,40,0,45157,0,1600
1772.916,6,180,15480,120,69,14898,69,8940,60,69,30048,69,6540
1.787,17,2,144,1,36,0,36,64,1,52,0,52,80
1786.736,6,117,13597,77,81,23509,501,6030,40,156,45811,1420,7567
845.13,6,52,4127,34,66,25610,66,2416,18,58,49708,60,1711
1680.916,1,7,392,7,28,280152,28,392,0,0,0,0,0
96.164,6,45,9918,22,450,539,766,2761,23,366,4365,3488,7157
1786.851,6,102,8296,68,65,26669,65,4930,34,59,54143,59,3366
5.022,17,4,288,2,36,5006,36,128,2,52,5006,52,160
1323.592,2,12,384,12,8,120326,8,384,0,0,0,0,0
3.502,6,9,2892,4,92,1167,92,296,5,1164,754,1448,2596
0.564,6,25,6128,12,181,51,537,1526,13,651,44,1368,4602
0.147,17,4,284,2,32,75,32,120,2,54,73,60,164
1.406,6,51,19349,27,892,54,1460,13613,24,433,52,1460,5736
0.021,6,2,100,1,0,0,0,60,1,0,0,0,40
1700.653,17,118,25861,118,191,14535,422,25861,0,0,0,0,0
1.634,6,13,2311,8,188,233,245,700,5,1407,346,1407,1611
1.643,6,50,18338,28,882,60,1360,12637,22,437,68,2715,5701
5.047,17,3,257,2,37,5005,37,130,1,99,0,99,127
280.443,6,27,7312,12,158,25494,267,1277,15,775,20028,3465,6035
316.66,6,89,33485,51,591,6333,1360,23350,38,430,8554,1929,10135
0.194,17,2,184,1,32,0,32,60,1,96,0,96,124
1.364,6,45,18080,26,882,54,1360,12544,19,476,65,2715,5536
0.353,6,12,1653,6,288,69,288,548,6,426,39,434,1105
422.546,17,6,1968,6,300,84509,308,1968,0,0,0,0,0
0.261,6,9,1002,5,213,65,213,417,4,421,67,421,585
57.588,17,4,304,4,48,19196,48,304,0,0,0,0,0
1785.512,17,142,11360,71,48,25506,48,5396,71,56,25504,56,5964
6.367,17,27,12614,12,334,575,1350,4355,15,522,452,1350,8259
0.047,6,2,111,1,0,0,0,40,1,31,0,31,71
1781.495,17,142,11360,71,48,25449,48,5396,71,56,25449,56,5964
1.611,6,122,71960,65,1276,25,1432,61421,57,506,24,1432,10539
589.78,1,8,928,8,88,84254,88,928,0,0,0,0,0
5.032,17,4,558,2,36,5008,36,128,2,187,5022,187,430
0.263,17,2,614,1,46,0,46,74,1,512,0,512,540
280.431,6,28,7352,13,158,23369,267,1317,15,775,20028,3465,6035
2.873,17,29,10197,15,300,202,1350,4920,14,348,218,1350,5277
1787.149,6,104,8376,68,65,26673,65,4930,36,59,51058,59,3446
10.788,6,18,5610,10,275,1198,275,958,8,1440,825,1440,4652
300.668,6,39,8668,19,315,16703,882,2053,20,386,448,1460,6615
1740.758,17,30,31680,30,1028,60026,1028,31680,0,0,0,0,0
1681.856,1,15,840,15,28,120132,28,840,0,0,0,0,0
3.017,17,5,383,3,34,1502,34,186,2,70,14,91,197
0.849,17,4,1188,2,64,825,64,184,2,474,826,476,1004
0.978,6,28,8460,15,222,57,540,1964,13,994,66,1791,6496
41.711,17,44,6468,22,48,1985,48,1672,22,190,1985,308,4796
1798.741,17,550,106152,550,165,3276,336,106152,0,0,0,0,0
10.653,6,20,4442,11,275,1065,275,998,9,768,736,1440,3444
7.219,6,1575,1466113,981,1416,7,1448,1430561,594,776,11,1448,35552
377.424,6,22,1459,14,177,29032,177,925,8,110,11468,110,534
1740.519,17,30,31680,30,1028,60017,1028,31680,0,0,0,0,0
1504.022,2,16,512,16,8,100268,8,512,0,0,0,0,0
1782.194,17,224,62589,224,251,7991,422,62589,0,0,0,0,0
1744.599,2,15,480,15,8,124614,8,480,0,0,0,0,0
94.069,6,27,5355,15,194,6719,477,2134,12,515,8539,2301,3221
1786.742,6,117,13597,77,81,23509,501,6030,40,156,45811,1420,7567
2.22,6,10,1388,5,314,555,564,876,5,126,459,221,512
0.017,6,3,182,2,31,17,31,111,1,31,0,31,71
1777.076,17,73,3060,72,14,25029,14,3024,1,8,0,8,36
1776.457,17,73,3060,72,14,25020,14,3024,1,8,0,8,36
1756.216,6,105,6270,60,27,29765,27,3525,45,27,39913,27,2745
0.086,17,8,2750,8,315,12,354,2750,0,0,0,0,0
1776.401,17,75,3141,73,13,24669,14,3061,2,12,1776221,16,80
0.007,17,2,480,1,64,0,64,92,1,360,0,360,388
0.172,17,2,241,1,36,0,36,64,1,149,0,149,177
60.699,6,15,4641,9,290,7587,517,1057,6,1088,9122,1418,3584
1787.272,17,87,3648,86,14,21026,14,3612,1,8,0,8,36
11.011,17,4,704,2,37,10995,37,130,2,259,11001,275,574
0.412,6,12,1653,6,288,81,288,548,6,426,44,434,1105
1771.989,6,180,15480,120,69,14890,69,8940,60,69,30033,69,6540
4.998,17,4,558,2,36,4994,36,128,2,187,4989,187,430
1746.441,17,210,49330,210,206,8356,377,49330,0,0,0,0,0
1.459,6,37,8214,19,321,81,1164,2718,18,476,75,2715,5496
6.261,6,68,53150,25,341,260,341,1653,43,1406,148,1460,51497
1771.83,6,99,9240,66,65,27258,65,5577,33,59,55367,59,3663
1.405,6,39,9099,21,116,70,337,1807,18,656,73,1702,7292
1794.768,17,29,9512,29,300,64098,300,9512,0,0,0,0,0
33.87,6,30,5042,15,154,2419,722,1859,15,399,2404,1408,3183
142.175,6,82,56955,50,1241,2901,1448,48537,32,749,1990,1448,8418
1.649,6,49,19436,29,900,58,1360,13815,20,437,75,2715,5621
89.209,6,131,99812,82,1266,1101,1368,89135,49,676,1853,1368,10677
1740.621,17,30,7050,30,207,60021,207,7050,0,0,0,0,0
10.995,6,20,4442,11,275,1099,275,998,9,768,788,1440,3444
0.319,6,20,4960,10,137,35,267,1092,10,692,31,1467,3868
1441.259,6,87,5136,50,26,29411,26,2912,37,26,40033,26,2224
38.654,6,27,7046,16,124,2576,159,1600,11,811,3864,1675,5446
42.2,1,47,4888,0,0,0,0,0,47,76,917,76,4888
83.569,6,89,26605,41,607,2084,1360,15130,48,462,1774,1360,11475
0.924,6,12,1163,6,222,181,222,688,6,231,181,231,475
1.567,17,3,1173,3,363,783,363,1173,0,0,0,0,0
11.657,6,2,1175,1,0,0,0,40,1,1095,0,1095,1135
0.116,17,2,213,1,44,0,44,72,1,113,0,113,141
11.887,6,1894,1644777,1140,1388,10,1420,1610384,754,467,15,1883,34393
0.986,17,4,368,2,64,983,64,184,2,64,985,64,184
253.337,17,4,304,2,48,253324,48,152,2,48,253324,48,152
1776.418,17,140,11200,70,48,25745,48,5320,70,56,25745,56,5880
0.04,17,3,996,3,304,20,333,996,0,0,0,0,0
46.659,1,6,336,6,28,9331,28,336,0,0,0,0,0
80.322,6,27,6345,11,139,8032,159,1138,16,727,5283,1402,5207
34.856,17,22,1936,11,48,3479,48,836,11,72,3477,72,1100
140.701,6,32,8952,15,158,10050,267,1397,17,687,8793,1781,7555
62.309,6,76,54746,49,1190,1298,1368,46606,27,841,2386,2519,8140
0.966,17,28,17189,16,725,62,1350,12063,12,399,84,1350,5126
1795.097,17,80,3354,79,14,23014,14,3318,1,8,0,8,36
1729.744,6,123,16044,71,101,24710,721,8223,52,318,9990,1440,7821
280.525,6,29,7392,13,158,23377,267,1317,16,678,18697,2085,6075
280.288,6,27,7312,13,158,23357,267,1317,14,775,21557,4836,5995
1780.13,6,354,22440,207,69,8641,69,12420,147,69,12184,69,10020
1.259,6,24,5754,13,158,103,370,1315,11,799,124,1460,4439
1.844,17,4,780,3,64,908,64,276,1,476,0,476,504
1745.888,6,97,7307,63,38,28159,205,4476,34,33,52897,98,2831
5.011,17,4,514,2,36,5006,36,128,2,165,5006,187,386
1733.141,6,213,16632,80,73,21936,375,8042,133,49,13128,143,8590
1793.761,17,66,2766,65,14,28027,14,2730,1,8,0,8,36
257.606,17,6,456,6,48,51521,48,456,0,0,0,0,0
259.701,6,352,420164,123,676,2128,1408,16294,229,1884,1139,5632,403870
0.051,6,9,1002,5,213,12,213,417,4,421,15,421,585
0.181,6,9,1339,5,145,45,145,349,4,826,40,826,990
0.541,6,10,968,5,256,131,256,460,5,304,131,304,508
1740.577,17,30,20190,30,645,60019,645,20190,0,0,0,0,0
0.851,17,2,776,2,360,851,360,776,0,0,0,0,0
1.034,6,16,2229,8,336,147,741,1349,8,274,121,396,880
2.596,1,3,168,3,28,1298,28,168,0,0,0,0,0
240.194,6,53,17598,28,784,8895,1402,14794,25,187,10007,580,2804
2.921,17,4,624,4,128,973,128,624,0,0,0,0,0
1.224,6,9,382,4,0,408,0,164,5,7,207,7,218
19.813,6,14,1025,7,222,3299,222,506,7,231,3299,231,519
1790.595,1,260,27560,260,78,6913,78,27560,0,0,0,0,0
10.76,6,20,7050,11,275,1076,275,998,9,1420,749,1420,6052
12.115,6,1918,1657969,1170,1362,10,1380,1623807,748,383,16,1380,34162
280.56,6,29,7392,13,158,23380,267,1317,16,603,18699,2036,6075
3.986,17,8,1176,4,48,1325,48,304,4,190,1325,308,872
9.211,6,14,2245,8,211,1315,211,846,6,545,1841,904,1399
0.983,6,28,6109,14,154,75,267,1644,14,650,70,1420,4465
0.43,6,49,20845,27,1043,16,1380,15723,22,421,18,1923,5122
0.056,6,3,120,2,0,56,0,80,1,0,0,0,40
0.027,17,4,420,2,33,13,33,122,2,121,15,145,298
11.742,6,1871,1619316,1143,1362,10,1380,1585954,728,421,16,1923,33362
2.093,17,23,8684,10,438,232,1350,4662,13,281,170,1350,4022
0.95,6,16,4454,8,111,135,111,543,8,869,135,1448,3911
0.291,6,28,9106,14,247,22,624,1724,14,947,21,1408,7382
0.414,6,5,284,1,0,0,0,52,4,0,138,0,232
1798.026,17,1533,516621,1533,309,1173,376,516621,0,0,0,0,0
1787.153,6,102,8228,68,64,26673,64,4896,34,58,54152,58,3332
280.194,6,28,7352,13,158,23349,267,1317,15,678,20013,2045,6035
617.611,6,122,23603,47,270,13426,1360,10828,75,177,8344,1360,12775
10.646,6,22,9934,11,275,1064,275,998,11,1414,923,1414,8936
0.178,6,43,19827,25,1066,7,1414,14886,18,467,9,1889,4941
280.184,6,29,7392,13,158,23348,267,1317,16,543,18677,1400,6075
0.1,6,2,80,0,0,0,0,0,2,0,0,0,80
240.193,6,55,20826,30,862,8282,1418,17955,25,223,10007,580,2871
0.057,17,2,588,1,39,0,39,67,1,493,0,493,521
0.281,17,8,2766,8,317,40,356,2766,0,0,0,0,0
300.825,6,47,10135,23,641,13673,1460,4218,24,290,637,1460,5917
676.221,1,30,1680,30,28,23317,28,1680,0,0,0,0,0
111.566,17,8,704,4,48,37186,48,304,4,72,37185,72,400
2.06,17,6,636,3,46,1000,46,222,3,110,0,110,414
1792.572,17,180,11520,180,36,10014,36,11520,0,0,0,0,0
1792.401,17,180,11520,180,36,10013,36,11520,0,0,0,0,0
48.542,6,63,14897,28,499,322,910,6683,35,294,1423,2720,8214
2.169,17,2,154,1,33,0,33,61,1,65,0,65,93
5.747,6,38,7245,20,218,302,314,3423,18,516,322,1179,3822
1.531,6,48,18988,27,875,58,1360,13372,21,433,67,1360,5616
14.03,6,48,13152,24,887,610,1460,7266,24,307,601,1460,5886
1795.766,17,448,39896,403,35,4467,288,25676,45,288,40018,288,14220
240.472,6,44,8447,22,449,11450,1402,5648,22,205,11450,580,2799
1772.071,6,180,15480,120,69,14891,69,8940,60,69,30033,69,6540
42.028,1,60,5040,60,56,712,56,5040,0,0,0,0,0
1.713,6,25,8705,15,275,122,558,1430,10,981,169,1420,7275
6.438,6,60,11725,29,242,229,314,6019,31,446,206,1179,5706
5.208,17,4,368,4,64,1736,64,368,0,0,0,0,0
0.203,6,10,1671,6,552,40,948,1348,4,159,67,159,323
4.832,6,5,1640,3,0,1,0,120,2,1440,1651,1440,1520
22.353,6,9,527,5,43,5588,43,311,4,0,7257,0,216
1779.476,17,141,11276,71,48,25420,48,5396,70,56,25789,56,5880
0.027,17,4,368,2,32,0,32,120,2,96,0,96,248
2.69,17,2,178,1,29,0,29,57,1,93,0,93,121
1797.056,17,399,49523,188,168,9609,1350,36986,211,31,8557,60,12537
1.83,17,2,322,1,33,0,33,61,1,233,0,233,261
0.039,17,2,180,1,30,0,30,58,1,94,0,94,122
1795.473,17,80,3354,79,14,23018,14,3318,1,8,0,8,36
0.161,6,11,1535,5,507,40,507,727,6,556,32,556,808
281.416,6,32,7650,13,158,23451,267,1317,19,464,15611,1400,6333
3.709,6,33,6129,17,206,231,314,2744,16,456,229,1152,3385
0.385,6,13,1693,7,288,64,288,588,6,284,36,434,1105
26.771,17,4,352,2,60,26770,60,176,2,60,26770,60,176
1781.766,6,442,26280,229,69,7814,69,13300,213,35,8404,64,12980
372.475,6,25,1651,17,177,23279,177,1117,8,110,9230,110,534
1732.314,6,85,15579,53,112,33313,1440,5487,32,311,55875,1440,10092
72.97,6,35,9314,16,300,4864,1189,2753,19,413,4043,1420,6561
1665.48,1,7,392,7,28,277580,28,392,0,0,0,0,0
1787.128,6,356,22520,208,69,8633,69,12460,148,69,12157,69,10060
0.87,6,11,1727,7,100,145,100,384,4,589,206,1152,1343
0.351,17,2,184,1,32,0,32,60,1,96,0,96,124
2.979,6,45,22395,22,686,141,1440,5730,23,1048,128,1687,16665
4.983,17,27,8663,11,332,498,1350,3960,16,265,215,1350,4703
403.689,1,10,1060,10,78,44854,78,1060,0,0,0,0,0
132.313,17,4,558,2,36,132309,36,128,2,187,132308,187,430
240.198,6,57,20805,31,852,8006,1418,17826,26,202,9607,580,2979
0.039,17,4,284,2,32,17,32,120,2,54,24,60,164
0.018,17,2,570,1,30,0,30,58,1,484,0,484,512
280.314,6,31,7472,13,158,23359,267,1317,18,543,16486,1400,6155
239.236,17,19,18523,19,946,13290,1451,18523,0,0,0,0,0
1.549,6,39,10971,21,575,77,1360,5475,18,433,78,1360,5496
1.595,6,44,13560,23,699,72,1360,7944,21,433,68,1360,5616
85.891,6,813,409422,453,839,190,1152,389890,360,427,238,1179,19532
256.521,6,27,7080,6,154,51304,267,712,21,345,12824,1420,6368
1788.882,6,364,23047,211,69,8518,69,12718,153,69,11768,69,10329
51.367,6,6687,6299083,4131,1438,12,1448,6148579,2556,776,19,1448,150504
0.08,6,13,3565,7,126,13,126,498,6,1373,16,1448,3067
1691.931,17,23,8476,23,340,76905,1336,8476,0,0,0,0,0
1740.533,17,29,30624,29,1028,62161,1028,30624,0,0,0,0,0
1794.11,17,175,37832,175,188,10310,377,37832,0,0,0,0,0
2.296,17,4,518,3,39,885,39,201,1,289,0,289,317
58.231,2,4,128,4,8,19410,8,128,0,0,0,0,0
0.013,17,2,235,1,36,0,36,64,1,143,0,143,171
8.75,6,41,13649,21,896,437,1360,8047,20,399,450,1360,5602
4.254,6,39,7269,20,218,223,314,3423,19,440,221,1152,3846
20.698,6,20,3130,12,183,1881,517,1561,8,381,2955,499,1569
41.388,1,43,4472,0,0,0,0,0,43,76,985,76,4472
1726.635,1,8,448,8,28,246662,28,448,0,0,0,0,0
1.606,6,48,19933,27,943,61,1460,14317,21,476,67,2615,5616
1778.481,17,139,11116,70,48,25774,48,5320,69,56,26153,56,5796
1744.589,1,57,4788,57,56,31153,56,4788,0,0,0,0,0
582.114,6,63,20334,22,534,3351,1360,9445,41,318,14549,1360,10889
1.54,6,48,18201,26,882,61,1360,12545,22,433,63,1360,5656
1785.744,1,204,11424,204,28,8796,28,11424,0,0,0,0,0
1512.15,2,11,352,11,8,151215,8,352,0,0,0,0,0
0.944,6,10,1687,7,100,157,100,384,3,1179,343,1179,1303
303.051,6,90,15396,32,179,8433,1189,3807,58,243,5316,2006,11589
1793.87,17,144,11520,72,48,25265,48,5472,72,56,25265,56,6048
124.547,6,120,86318,74,1240,1706,1408,75802,46,811,2346,3847,10516
1788.441,6,414,24840,206,69,8724,69,12380,208,34,8639,48,12460
1791.973,1,58,4872,58,56,31438,56,4872,0,0,0,0,0
0.12,6,10,1671,6,552,23,948,1348,4,159,39,159,323
10.552,6,11,1235,7,280,1758,517,860,4,101,102,142,375
40.894,6,17,1704,3,106,20441,106,234,14,98,3144,128,1470
12.045,6,1903,1633729,1151,1363,10,1380,1598071,752,421,15,1923,35658
1782.435,6,353,22400,206,69,8694,69,12380,147,69,12208,69,10020
120.302,2,3,96,3,8,60151,8,96,0,0,0,0,0
31.73,6,8,376,2,0,31730,0,88,6,0,6301,0,288
0.152,6,9,1002,5,213,38,213,417,4,421,40,421,585
0.073,6,9,1340,5,145,18,145,349,4,827,22,827,991
1.312,6,40,9928,21,440,65,1360,4392,19,476,63,2715,5536
3.307,6,33,7433,17,199,204,517,2087,16,500,218,1959,5346
5.654,17,4,352,2,60,5653,60,176,2,60,5652,60,176
284.797,17,4,352,2,60,284796,60,176,2,60,284796,60,176
13.212,6,30,7297,14,155,1016,267,1346,16,441,880,1420,5951
1.349,6,25,8056,12,164,104,267,1288,13,1014,95,2491,6768
124.646,6,22,9783,12,410,57,922,1742,10,1271,13834,4416,8041
1624.335,2,13,416,13,8,135361,8,416,0,0,0,0,0
1.377,17,2,136,1,32,0,32,60,1,48,0,48,76
1791.42,17,142,11352,72,48,25231,48,5472,70,56,25958,56,5880
1799.069,6,356,22520,208,69,8691,69,12460,148,69,12238,69,10060
35.291,17,3,365,2,114,35291,156,284,1,53,0,53,81
0.004,17,2,455,1,43,0,43,71,1,356,0,356,384
156.697,6,37,23997,21,840,26,1360,5927,16,1935,10438,5432,18070
4.021,6,39,7269,20,218,211,314,3423,19,513,209,1179,3846
1741.31,6,87,6322,58,31,30549,31,3915,29,31,62187,31,2407
0.082,17,2,146,1,37,0,37,65,1,53,0,53,81
135.252,6,21,8730,11,316,81,640,1433,10,1147,15014,2568,7297
1.088,6,29,5851,14,111,83,267,1346,15,650,70,1380,4505
2.492,6,13,2311,8,188,356,245,700,5,1407,553,1407,1611
11.43,1,8,832,0,0,0,0,0,8,76,1632,76,832
30.764,17,4,352,2,60,30763,60,176,2,60,30763,60,176
1795.12,17,80,3354,79,14,23014,14,3318,1,8,0,8,36
124.321,6,24,11723,12,353,71,741,1584,12,1378,11289,3966,10139
0.946,6,28,8160,15,222,55,540,1964,13,944,64,1591,6196
0.034,17,2,547,1,40,0,40,68,1,451,0,451,479
257.611,17,10,880,5,48,64400,48,380,5,72,64400,72,500
0.612,17,6,2069,6,316,122,354,2069,0,0,0,0,0
1624.426,2,16,512,16,8,108295,8,512,0,0,0,0,0
0.165,6,9,1342,5,145,41,145,349,4,829,38,829,993
0.546,6,10,767,5,186,130,186,454,5,45,136,45,313
103.141,6,46,13815,24,996,454,1360,8040,22,348,4903,2667,5775
4.429,6,38,7229,20,218,233,314,3423,18,513,245,1179,3806
576.002,6,8,1148,8,103,82286,138,1148,0,0,0,0,0
210.703,17,4,288,2,36,210671,36,128,2,52,210658,52,160
5.56,6,15,5768,4,112,1853,112,280,11,560,536,1300,5488
117.989,6,995,494310,547,839,216,1152,471599,448,435,263,1179,22711
0.101,6,9,1340,5,145,25,145,349,4,827,30,827,991
1783.641,17,140,11200,70,48,25849,48,5320,70,56,25849,56,5880
20.299,6,20,3130,12,183,1845,517,1561,8,381,2898,499,1569
1783.591,6,362,22898,210,69,8533,69,12678,152,69,11809,69,10220
26.51,17,32,4704,16,48,1766,48,1216,16,190,1766,308,3488
1795.973,17,448,39612,404,35,4456,288,25708,44,288,40949,288,13904
1772.074,6,180,15480,120,69,14891,69,8940,60,69,30032,69,6540
369.446,6,25,1651,17,177,23090,177,1117,8,110,9196,110,534
85.439,6,32,7584,12,155,7767,267,1266,20,367,4489,1460,6318
1700.406,17,12,498,11,14,170040,14,462,1,8,0,8,36
1224.742,6,247,15676,142,70,8686,138,8647,105,69,11776,69,7029
27.338,6,14,1246,3,106,13669,106,234,11,90,2727,90,1012
0.113,17,3,634,2,32,108,32,120,1,486,0,486,514
1786.295,6,102,8296,68,65,26661,65,4930,34,59,54127,59,3366
103.731,6,49,10342,19,247,3439,1189,2996,30,323,3576,1420,7346
13.026,17,4,824,2,48,13001,48,152,2,308,13009,308,672
1770.644,6,99,9240,66,65,27240,65,5577,33,59,55328,59,3663
940.854,6,141,19891,69,95,13833,721,6972,72,371,13249,1440,12919
1744.766,6,95,7203,63,38,28141,205,4476,32,33,56276,98,2727
11.041,6,20,4350,11,275,1104,275,998,9,992,781,1440,3352
280.089,6,27,7312,13,158,23340,267,1317,14,775,21541,4836,5995
0.08,17,2,390,1,46,0,46,74,1,288,0,288,316
5.995,6,40,7309,20,218,315,314,3423,20,513,300,1179,3886
14.642,6,2608,2437642,1677,1375,8,1408,2384566,931,776,15,1408,53076
1784.921,6,130,8171,73,47,24790,208,4992,57,31,31865,31,3179
111.011,6,42,8816,20,410,736,915,2122,22,446,5280,3488,6694
8.425,6,702,637937,458,1326,17,1368,620585,244,776,33,2736,17352
37.52,17,22,1936,11,48,3751,48,836,11,72,3751,72,1100
25.772,6,37,8452,17,164,1610,722,2168,20,608,1341,1380,6284
0.914,6,20,5733,12,286,83,559,1343,8,677,116,1452,4390
1779.46,17,140,11200,70,48,25789,48,5320,70,56,25789,56,5880
0.883,6,11,1727,7,100,147,100,384,4,589,208,1152,1343
93.078,6,22,900,9,0,7068,0,364,13,0,7753,0,536
16.711,17,31,13486,16,606,1111,1350,10156,15,194,1191,1350,3330
1.371,6,50,18653,27,846,52,1360,12957,23,433,54,1360,5696
1799.09,1,270,15120,270,28,6688,28,15120,0,0,0,0,0
1772.514,6,204,22399,130,75,13740,267,10057,74,133,24277,2840,12342
126.422,2,2,64,2,8,126422,8,64,0,0,0,0,0
59.354,6,45,9037,21,412,725,922,2170,24,327,2574,1360,6867
0.188,17,2,2756,2,1350,188,1350,2756,0,0,0,0,0
1769.358,6,104,9644,67,66,26808,66,5728,37,60,49145,60,3916
6.844,6,517,463640,336,1316,19,1368,449408,181,776,36,2736,14232
10.584,6,2119,1953272,1342,1377,7,1408,1908204,777,931,13,2801,45068
1784.307,17,83,3480,82,14,22028,14,3444,1,8,0,8,36
1785.672,1,342,28728,342,56,5236,56,28728,0,0,0,0,0
240.475,6,58,24296,26,542,9618,1418,6241,32,862,7756,1418,18055
56.327,6,11,851,11,31,5632,31,851,0,0,0,0,0
31.781,17,3,1000,3,305,15890,308,1000,0,0,0,0,0
45.731,6,37,9453,20,158,2406,490,1820,17,631,2469,2720,7633
15.266,6,12,716,4,106,5086,106,274,8,90,2180,90,442
0.185,6,9,1339,5,145,46,145,349,4,826,40,826,990
1700.437,17,13,534,11,14,170043,14,462,2,8,170028,8,72
0.0,17,1,67,1,39,0,39,67,0,0,0,0,0
7.107,6,37,10968,19,601,378,1460,3847,18,532,405,1460,7121
144.401,6,28,6562,11,220,5504,516,1325,17,325,9019,1452,5237
1794.698,6,245,23702,122,141,14832,208,17790,123,31,14707,31,5912
0.012,17,2,374,1,43,0,43,71,1,275,0,275,303
1795.884,17,448,39896,403,35,4467,288,25676,45,288,40017,288,14220
30.494,17,16,2352,8,48,4355,48,608,8,190,4355,308,1744
1772.553,6,180,15480,120,69,14895,69,8940,60,69,30037,69,6540
89.319,6,26,1076,12,0,8119,0,492,14,0,6869,0,584
7.548,6,21,3558,12,210,685,210,1100,9,664,937,904,2458
1740.856,1,56,4704,56,56,31651,56,4704,0,0,0,0,0
245.958,17,4,352,2,60,245957,60,176,2,60,245957,60,176
1701.879,1,8,448,8,28,243125,28,448,0,0,0,0,0
177.657,6,25,9840,13,457,64,1360,2381,12,995,16136,1360,7459
0.244,17,160,146343,57,139,4,1350,9542,103,1300,2,1350,136801
1745.377,6,98,7390,63,38,28151,205,4476,35,33,51322,98,2914
1795.19,17,447,39068,403,35,4465,288,25412,44,282,40951,288,13656
12.496,6,95,28346,48,542,265,1152,21984,47,447,266,1179,6362
241.222,2,4,128,4,8,80407,8,128,0,0,0,0,0
1740.989,6,92,6668,60,31,29508,31,4062,32,31,56160,31,2606
0.927,17,4,580,2,40,895,40,136,2,194,777,194,444
240.216,6,55,19629,30,798,8283,1418,16743,25,197,10008,580,2886
0.849,6,19,5912,10,282,94,548,1252,9,716,95,1420,4660
0.01,17,2,395,1,33,0,33,61,1,306,0,306,334
217.691,17,4,240,2,32,217690,32,120,2,32,217690,32,120
11.734,6,1857,1622872,1148,1363,10,1380,1588302,709,475,16,1923,34570
98.017,6,15,3356,7,524,163,1309,1873,8,575,13977,999,1483
1788.937,17,142,11360,71,48,25556,48,5396,71,56,25556,56,5964
1787.334,6,357,22698,207,69,8676,69,12489,150,69,11994,69,10209
258.811,17,6,528,3,60,129405,60,264,3,60,129405,60,264
4.204,6,38,7229,19,218,233,314,3383,19,513,219,1179,3846
1774.236,6,182,15698,120,69,14909,69,8940,62,69,29083,69,6758
1789.195,17,142,11360,71,48,25559,48,5396,71,56,25559,56,5964
0.082,6,16,5000,9,321,10,517,1107,7,880,11,1440,3893
0.032,17,2,912,1,308,0,308,336,1,548,0,548,576
1786.499,6,106,8584,69,66,26272,66,5004,37,60,49621,60,3580
0.903,6,26,5649,13,140,75,267,1224,13,650,68,1452,4425
71.09,6,27,7315,12,155,6462,267,1266,15,544,5077,4846,6049
1795.363,6,362,22898,210,69,8590,69,12678,152,69,11888,69,10220
1.773,6,40,8391,20,321,93,1164,2770,20,400,82,1460,5621
1343.278,6,80,6300,46,65,26467,65,3335,34,51,40702,59,2965
0.885,6,10,1687,7,100,147,100,384,3,1179,315,1179,1303
1740.454,6,87,6322,58,31,30534,31,3915,29,31,62158,31,2407
1682.965,17,14,1036,7,30,280488,30,406,7,62,280488,62,630
1795.037,6,356,22520,208,69,8671,69,12460,148,69,12211,69,10060
1754.266,1,62,5208,0,0,0,0,0,62,56,28758,56,5208
962.555,2,8,256,8,8,137507,8,256,0,0,0,0,0
1792.966,6,160,26072,95,483,19071,483,19945,65,83,28013,83,6127
1776.637,17,73,3060,72,14,25023,14,3024,1,8,0,8,36
8.219,6,2,1175,1,0,0,0,40,1,1095,0,1095,1135
4.447,6,39,8447,18,321,261,1164,2690,21,377,203,1440,5757
1794.898,1,120,12720,120,78,15083,78,12720,0,0,0,0,0
0.014,17,4,352,2,60,13,60,176,2,60,14,60,176
5.204,6,853,724327,511,1377,10,1420,706414,342,467,15,1883,17913
1.08,17,2,677,1,300,0,300,328,1,321,0,321,349
2.307,6,13,2311,8,188,329,245,700,5,1407,509,1407,1611
0.397,6,10,968,5,256,95,256,460,5,304,95,304,508
162.593,6,8,416,8,0,0,0,416,0,0,0,0,0
1681.289,17,14,3843,7,30,280211,30,406,7,463,280213,463,3437
1786.915,6,105,8416,68,65,26670,65,4930,37,59,49634,59,3486
0.009,17,8,2446,8,277,1,316,2446,0,0,0,0,0
300.807,6,42,9819,23,537,13673,1360,4212,19,371,480,1360,5607
0.408,6,39,24202,25,171,17,313,1994,14,3067,31,13536,22208
8.247,6,53,19976,19,966,379,1440,13381,34,324,244,1440,6595
1773.107,6,180,15480,120,69,14900,69,8940,60,69,30049,69,6540
774.305,6,64,10212,33,245,24194,517,3230,31,668,25807,1368,6982
1774.841,6,180,15480,120,69,14914,69,8940,60,69,30078,69,6540
1786.598,6,104,8444,68,66,26665,66,4964,36,60,51043,60,3480
536.086,1,12,672,12,28,48735,28,672,0,0,0,0,0
1787.636,6,368,24683,213,87,8432,469,14205,155,69,11606,69,10478
1.296,6,16,1785,8,222,184,222,768,8,231,184,231,1017
14.264,6,29,8832,14,158,1097,267,1357,15,858,1017,3436,7475
2.987,17,4,610,3,39,734,39,201,1,381,0,381,409
1799.146,17,449,39928,404,35,4464,288,25708,45,288,40021,288,14220
0.694,6,24,5755,13,158,57,370,1315,11,799,68,1420,4440
1796.721,6,280,36026,116,157,15622,1360,18578,164,132,11022,1942,17448
0.281,17,3,507,2,39,151,39,134,1,345,0,345,373
240.173,6,53,18396,28,827,8895,1408,15525,25,195,10007,580,2871
1328.441,6,79,5968,45,41,30191,205,3261,34,33,37903,98,2707
1750.187,6,97,7307,63,38,28228,205,4476,34,33,53023,98,2831
4.006,17,8,616,4,33,1332,33,244,4,65,1329,65,372
1794.103,17,80,3354,79,14,23001,14,3318,1,8,0,8,36
79.956,6,37,5420,21,154,3997,722,2184,16,342,1185,1448,3236
1796.868,6,384,24162,220,69,8204,69,13078,164,61,11023,69,11084
1786.842,6,357,22629,208,69,8632,69,12460,149,69,12073,69,10169
169.86,17,4,352,2,60,169858,60,176,2,60,169859,60,176
0.04,6,2,111,1,0,0,0,40,1,31,0,31,71
0.488,17,2,672,2,308,488,308,672,0,0,0,0,0
3.996,6,2,88,2,0,0,0,88,0,0,0,0,0
77.984,17,42,10878,42,231,1902,388,10878,0,0,0,0,0
1343.034,17,337,42005,167,155,8090,1350,30673,170,38,7685,1350,11332
1737.287,1,56,4704,56,56,31587,56,4704,0,0,0,0,0
1745.018,6,95,7203,63,38,28145,205,4476,32,33,56280,98,2727
1782.833,1,204,21624,204,78,8782,78,21624,0,0,0,0,0
300.097,6,50,11449,25,731,12496,1460,5492,25,290,12496,1460,5957
1796.597,17,142,11360,71,48,25665,48,5396,71,56,25665,56,5964
229.582,17,4,1344,4,308,76527,308,1344,0,0,0,0,0
0.023,17,4,352,2,37,18,37,130,2,83,18,89,222
1793.218,1,59,4956,59,56,30917,56,4956,0,0,0,0,0
3.134,17,4,1556,4,361,1044,361,1556,0,0,0,0,0
1799.256,17,4520,216960,2260,20,796,20,108480,2260,20,796,20,108480
0.894,6,10,1687,7,100,149,100,384,3,1179,316,1179,1303
147.037,6,25,12052,13,493,138,832,2525,12,1129,13355,1360,9527
0.0,2,1,32,1,8,0,8,32,0,0,0,0,0
15.038,6,6,563,5,105,3759,105,519,1,0,0,0,44
31.033,6,7,420,1,0,0,0,60,6,0,6205,0,360
280.868,6,30,7432,13,158,23405,267,1317,17,603,17548,2760,6115
1680.697,17,13,534,11,14,168050,14,462,2,8,1680512,8,72
1796.101,6,428,28953,220,98,8201,469,15492,208,45,8676,69,13461
24.366,6,2083,1816988,1272,1370,19,1380,1776606,811,421,30,1923,40382
240.818,6,45,9037,21,520,12037,1418,5788,24,221,10467,617,3249
304.591,17,22,1744,13,48,25382,48,988,9,56,25436,56,756
240.166,6,54,19638,29,845,8577,1408,16728,25,200,10006,580,2910
280.434,6,30,7432,12,158,25494,267,1277,18,603,16494,1380,6155
6.129,6,266,195406,133,947,46,1460,15767,133,1428,45,1607,179639
0.134,6,10,2114,6,596,26,1033,1437,4,513,43,513,677
1707.767,17,19,6008,19,288,94875,1451,6008,0,0,0,0,0
1.358,6,51,19213,29,878,48,1360,13512,22,437,56,2720,5701
384.992,6,18,1242,14,180,29614,180,916,4,110,20061,110,326
0.086,17,2,176,1,48,0,48,76,1,72,0,72,100
12.336,6,1954,1704489,1182,1387,10,1420,1669376,772,467,15,2840,35113
126.482,2,2,64,2,8,126482,8,64,0,0,0,0,0
7.194,6,11,1003,6,332,1438,332,652,5,83,1791,83,351
1744.632,1,59,4956,59,56,30079,56,4956,0,0,0,0,0
240.199,6,55,19861,30,851,8282,1418,16893,25,207,10007,580,2968
4.008,17,8,616,4,33,1333,33,244,4,65,1333,65,372
1.772,6,13,2311,8,188,253,245,700,5,1407,378,1407,1611
2.186,17,4,978,2,40,2176,40,136,2,393,2172,407,842
1775.532,17,140,11200,70,48,25732,48,5320,70,56,25732,56,5880
1383.72,2,11,352,11,8,138372,8,352,0,0,0,0,0
0.38,17,4,560,2,64,379,64,184,2,160,260,160,376
34.09,17,20,1760,10,48,3786,48,760,10,72,3786,72,1000
280.214,6,28,7352,12,158,25474,267,1277,16,603,18677,1400,6075
1795.31,17,448,39896,403,35,4465,288,25676,45,288,40019,288,14220
2.369,17,4,1568,4,364,789,364,1568,0,0,0,0,0
164.073,1,4,224,4,28,54691,28,224,0,0,0,0,0
74.799,6,21,8524,11,549,79,1309,2120,10,998,8292,2720,6404
1.549,6,26,9003,13,164,114,267,1352,13,870,113,1448,7651
124.012,6,181,81947,90,917,1393,1418,68981,91,316,1377,1418,12966
0.331,17,2,154,1,41,0,41,69,1,57,0,57,85
0.22,6,47,20347,26,1016,8,1420,15286,21,420,10,1420,5061
105.696,6,23,11725,12,367,95,783,1626,11,1378,10552,2720,10099
1767.009,6,120,12089,75,63,23878,722,6266,45,96,40150,1408,5823
1740.401,17,30,31680,30,1028,60013,1028,31680,0,0,0,0,0
0.11,17,2,136,1,32,0,32,60,1,48,0,48,76
7.992,6,1380,1196141,785,1433,9,1448,1155949,595,776,13,1448,40192
1795.802,17,447,39580,403,35,4467,288,25676,44,288,40950,288,13904
1.057,17,4,314,2,31,959,31,118,2,70,1024,70,196
1789.182,1,97,5432,97,28,18637,28,5432,0,0,0,0,0
300.556,6,18,1227,5,177,75097,177,445,13,110,25031,110,782
0.142,6,9,1002,5,213,35,213,417,4,421,26,421,585
0.366,17,8,2774,8,318,52,357,2774,0,0,0,0,0
0.057,6,19,9136,10,127,5,127,655,9,1334,6,2048,8481
0.555,17,2,167,1,39,0,39,67,1,72,0,72,100
1761.787,6,132,8636,74,54,24134,208,5417,58,31,30900,31,3219
504.466,2,3,96,3,8,252233,8,96,0,0,0,0,0
15.433,6,5,300,5,0,0,0,300,0,0,0,0,0
1790.615,6,355,22480,207,69,8692,69,12420,148,69,12180,69,10060
0.045,17,2,144,1,36,0,36,64,1,52,0,52,80
240.22,6,56,20830,30,861,8283,1418,17933,26,192,9608,580,2897
20.123,6,21,5418,12,107,1829,159,1074,9,967,2514,2816,4344
1783.518,6,108,8536,68,65,26619,65,4930,40,59,45728,59,3606
265.361,6,31,8912,14,158,20412,267,1357,17,687,16582,1781,7555
1772.653,6,180,15480,120,69,14896,69,8940,60,69,30037,69,6540
0.006,17,2,390,1,46,0,46,74,1,288,0,288,316
1233.103,17,94,7504,49,48,25689,48,3724,45,56,25665,56,3780
0.018,6,2,133,1,0,0,0,40,1,53,0,53,93
7.155,6,1602,1461930,1000,1383,6,1408,1425962,602,931,11,2816,35968
1772.221,6,180,15480,120,69,14892,69,8940,60,69,30036,69,6540
2.56,17,4,1568,4,364,853,364,1568,0,0,0,0,0
127.276,6,7,418,4,106,42425,106,274,3,0,1517,0,144
47.228,6,2593,2423106,1592,1438,29,1448,2363426,1001,931,46,2896,59680
379.83,6,18,1242,14,180,29217,180,916,4,110,20063,110,326
1.661,6,27,10179,16,285,110,587,1499,11,1029,149,1420,8680
0.034,6,10,861,6,182,6,182,490,4,77,8,134,371
0.897,6,11,1727,7,100,149,100,384,4,589,212,1152,1343
0.494,17,2,384,1,39,0,39,67,1,289,0,289,317
0.32,6,26,8862,13,231,26,563,1608,13,1095,26,2816,7254
8.417,6,1574,1259180,823,1426,10,1448,1206804,751,776,10,1448,52376
1741.584,17,30,31620,30,1026,60054,1026,31620,0,0,0,0,0
10.251,6,1583,1417311,982,1392,10,1420,1389050,601,467,17,1883,28261
88.707,6,14,6038,9,596,11088,722,3444,5,2330,22117,2330,2594
1787.614,6,365,25032,213,94,8432,469,14536,152,69,11835,69,10496
1792.72,17,167,10688,167,36,10799,36,10688,0,0,0,0,0
280.311,6,28,7352,12,158,25482,267,1277,16,603,18683,1400,6075
1.498,6,5,200,2,0,1498,0,80,3,0,369,0,120
1.219,6,23,7952,12,164,94,267,1288,11,1216,103,3819,6664
0.283,6,872,809251,545,201,0,486,30653,327,2357,0,11264,778598
90.198,6,9,472,5,0,22549,0,256,4,0,30065,0,216
0.215,6,9,1346,5,145,53,145,349,4,833,48,833,997
299.357,17,7,291,6,13,59871,14,247,1,16,0,16,44
29.636,6,30,8872,14,158,2279,267,1357,16,763,1971,2036,7515
0.194,17,2,290,1,40,0,40,68,1,194,0,194,222
1751.269,1,58,4872,58,56,30724,56,4872,0,0,0,0,0
300.229,6,30,11773,17,593,18764,1408,4450,13,948,20015,1578,7323
0.052,17,2,180,1,30,0,30,58,1,94,0,94,122
11.013,6,20,7050,11,275,1101,275,998,9,1420,780,1420,6052
1.847,17,4,352,2,60,1846,60,176,2,60,1846,60,176
70.923,6,75,55366,50,1208,1447,1368,47329,25,841,2607,2519,8037
1795.176,1,200,11200,200,28,9020,28,11200,0,0,0,0,0
1797.635,17,448,39896,403,35,4471,288,25676,45,288,40017,288,14220
0.683,6,10,924,5,283,117,283,551,5,105,118,105,373
4.012,17,6,5695,3,930,2006,1350,2875,3,912,773,1350,2820
1780.233,1,342,28728,342,56,5220,56,28728,0,0,0,0,0
280.434,6,30,7432,13,158,23369,267,1317,17,603,17524,2760,6115
6.741,6,523,386493,279,1308,23,1368,369141,244,931,26,2736,17352
87.149,6,35,5313,20,154,4586,722,2130,15,342,1218,1448,3183
1740.617,6,87,6322,58,31,30537,31,3915,29,31,62164,31,2407
228.472,6,28,7352,13,158,19039,267,1317,15,678,16316,4200,6035
1797.608,1,345,28980,345,56,5225,56,28980,0,0,0,0,0
68.01,17,2,152,2,48,68010,48,152,0,0,0,0,0
177.794,6,25,10068,12,311,100,632,1458,13,1009,14799,2571,8610
0.059,17,2,904,1,300,0,300,328,1,548,0,548,576
1762.653,17,132,10560,66,48,27117,48,5016,66,56,27117,56,5544
67.61,17,6,2000,6,305,13522,308,2000,0,0,0,0,0
1595.015,1,14,1141,14,53,122693,78,1141,0,0,0,0,0
1771.424,6,107,6374,60,27,30023,27,3525,47,27,38508,27,2849
1.297,17,4,464,3,64,636,64,276,1,160,0,160,188
15.197,17,20,9655,11,614,1513,1350,7067,9,259,1889,1350,2588
1794.849,1,132,7392,132,28,13701,28,7392,0,0,0,0,0
0.277,17,2,180,1,30,0,30,58,1,94,0,94,122
63.63,6,30,7600,10,141,7070,267,1399,20,414,3335,1452,6201
1.139,6,29,8200,15,222,67,540,1964,14,944,71,1591,6236
1796.533,6,100,7525,65,38,28070,205,4611,35,33,52832,98,2914
294.768,1,4,224,4,28,98256,28,224,0,0,0,0,0
225.218,6,29,7392,13,158,18768,267,1317,16,603,15009,1400,6075
12.194,6,23,3721,11,162,1219,293,1418,12,363,1085,1179,2303
1797.799,6,368,23745,213,75,8480,469,13336,155,69,11671,69,10409
4.993,17,4,288,2,36,4993,36,128,2,52,4992,52,160
281.676,6,30,7432,13,158,23473,267,1317,17,543,17589,1400,6115
240.219,6,57,19469,31,815,8006,1418,16319,26,223,9608,580,3150
1772.17,6,180,15480,120,69,14892,69,8940,60,69,30032,69,6540
1786.944,6,106,8456,68,65,26670,65,4930,38,59,48293,59,3526
37.438,6,7,280,0,0,0,0,0,7,0,0,0,280
1773.595,6,181,15589,121,69,14779,69,9049,60,69,30058,69,6540
376.043,6,18,1242,14,180,28926,180,916,4,110,20061,110,326
1773.337,6,180,15480,120,69,14901,69,8940,60,69,30048,69,6540
1785.194,17,87,3648,86,14,21002,14,3612,1,8,0,8,36
1742.451,6,95,7203,63,38,28104,205,4476,32,33,56195,98,2727
0.642,6,27,12373,14,146,49,265,1310,13,1037,52,1448,11063
27.136,17,2,672,2,308,27136,308,672,0,0,0,0,0
0.008,6,2,80,1,0,0,0,40,1,0,0,0,40
0.415,6,12,1653,6,288,82,288,548,6,426,46,434,1105
19.633,17,4,352,2,48,19623,48,152,2,72,19618,72,200
1799.081,1,16,928,16,30,119938,30,928,0,0,0,0,0
23.136,6,34,8218,16,175,1542,721,2045,18,681,1348,1420,6173
103.691,6,35,8415,18,410,519,882,1982,17,521,6470,3488,6433
62.057,6,79,53197,47,1209,1349,1368,44796,32,747,1992,1368,8401
0.412,6,27,8942,14,232,31,569,1666,13,941,32,1438,7276
31.933,6,324,153776,174,827,184,1152,145106,150,380,212,1152,8670
0.031,17,4,284,2,32,27,32,120,2,54,26,60,164
1772.688,6,241,17920,121,69,14772,69,8980,120,34,14896,64,8940
65.415,6,16,1183,8,177,9345,177,649,8,110,9226,110,534
1700.587,17,13,534,11,14,170041,14,462,2,8,1700411,8,72
0.29,17,8,2758,8,316,41,355,2758,0,0,0,0,0
11.852,6,1877,1636154,1135,1387,10,1420,1602253,742,467,15,1883,33901
0.781,6,17,5164,9,150,97,174,664,8,835,96,1452,4500
0.017,17,4,352,2,37,9,37,130,2,83,10,89,222
0.232,17,3,1008,3,308,116,308,1008,0,0,0,0,0
2.08,17,3,1176,3,364,1040,364,1176,0,0,0,0,0
1782.363,6,354,22440,207,69,8652,69,12420,147,69,12207,69,10020
39.632,17,44,6468,22,48,1883,48,1672,22,190,1884,308,4796
1.673,6,40,11362,22,547,79,1360,5866,18,476,84,2715,5496
1741.019,6,91,6604,59,31,30017,31,3998,32,31,56161,31,2606
69.484,6,20,9096,11,499,102,1193,1971,9,1350,8664,3639,7125
6.79,6,45,8409,23,227,308,314,4102,22,489,311,1179,4307
11.128,6,90,26829,46,567,247,1152,20587,44,407,252,1152,6242
11.825,6,1901,1623598,1145,1363,10,1380,1589116,756,421,15,1923,34482
1752.204,6,95,7203,63,38,28261,205,4476,32,33,56508,98,2727
3.997,17,3,183,3,33,1998,33,183,0,0,0,0,0
12.253,6,100,29575,51,540,245,1152,23117,49,449,249,1179,6458
1793.33,6,142,10377,79,77,22991,208,6710,63,31,28917,31,3667
1.36,6,49,19723,26,923,54,1360,14027,23,433,53,1360,5696
52.807,6,31,8912,15,158,3771,267,1397,16,763,3517,2800,7515
272.61,6,31,8912,14,158,20970,267,1357,17,687,17032,1781,7555
1786.7,6,167,21902,95,304,19007,304,15288,72,83,25164,83,6614
44.734,1,44,4576,0,0,0,0,0,44,76,1040,76,4576
0.238,17,2,178,1,29,0,29,57,1,93,0,93,121
1740.767,6,87,6322,58,31,30539,31,3915,29,31,62170,31,2407
11.042,6,96,29932,49,583,230,1152,23570,47,407,234,1152,6362
1789.954,6,356,22520,208,69,8647,69,12460,148,69,12176,69,10060
108.327,6,22,10160,11,433,57,990,1771,11,1133,10820,2720,8389
1795.036,6,356,22520,208,69,8671,69,12460,148,69,12211,69,10060
2.867,1,2,270,2,107,2867,121,270,0,0,0,0,0
58.849,2,2,64,2,8,58849,8,64,0,0,0,0,0
138.2,6,20,5997,12,220,12563,516,1366,8,717,7831,1452,4631
120.666,6,44,8964,20,401,797,889,2096,24,327,5241,1360,6868
1786.473,6,215,50459,124,510,14524,1291,35060,91,186,19848,1420,15399
1788.873,6,365,23156,212,69,8478,69,12689,153,69,11766,69,10467
0.194,17,2,152,1,48,0,48,76,1,48,0,48,76
1260.309,2,11,352,11,8,126030,8,352,0,0,0,0,0
20.163,6,23,6180,14,117,1551,159,1337,9,873,2518,1659,4843
1771.638,6,85,5900,41,36,44289,36,2252,44,449,41199,458,3648
1775.714,1,8,448,8,28,253673,28,448,0,0,0,0,0
111.523,6,28,8861,13,158,9293,267,1317,15,867,7926,3445,7544
1665.173,1,7,392,7,28,277528,28,392,0,0,0,0,0
1795.608,6,353,22469,206,69,8759,69,12380,147,69,12298,69,10089
1748.233,2,26,832,26,8,69929,8,832,0,0,0,0,0
1794.99,6,356,22520,208,69,8671,69,12460,148,69,12210,69,10060
10.053,6,84,25482,43,544,239,1152,19701,41,459,244,1179,5781
10.816,6,1753,1459080,965,1417,11,1448,1408600,788,776,13,1448,50480
300.568,6,11,863,6,177,60078,177,497,5,110,75097,110,366
128.604,17,4,352,2,60,128603,60,176,2,60,128603,60,176
1787.474,1,108,6048,108,28,16705,28,6048,0,0,0,0,0
14.854,6,2527,2401276,1608,1414,9,1448,2348800,919,776,15,1448,52476
1775.888,6,106,8456,68,65,26505,65,4930,38,59,47994,59,3526
370.897,6,25,1654,17,180,23181,180,1120,8,110,9248,110,534
1.45,6,51,20478,27,973,55,1460,14742,24,433,55,1460,5736
0.012,6,4,222,2,31,12,31,111,2,31,2,31,111
1786.17,17,87,3648,86,14,21013,14,3612,1,8,0,8,36
240.312,6,47,9039,25,524,10012,1418,6037,22,185,11442,618,3002
36.72,17,22,1672,22,48,1748,48,1672,0,0,0,0,0
1783.462,1,29,2436,29,56,63695,56,2436,0,0,0,0,0
5.014,17,4,558,2,36,5004,36,128,2,187,5002,187,430
3.912,6,10,427,5,0,978,0,208,5,7,749,7,219
941.021,6,159,10914,98,76,9701,138,6749,61,69,12174,69,4165
1769.024,6,195,11931,96,47,18621,208,6948,99,31,18048,31,4983
227.951,17,8,2688,8,308,32564,308,2688,0,0,0,0,0
0.562,6,14,1745,7,288,64,288,600,7,426,66,434,1145
1.021,17,4,660,2,33,1000,33,122,2,241,0,249,538
54.255,6,32,8952,14,158,4173,267,1357,18,624,3188,1300,7595
15.624,6,11,764,5,92,3906,92,348,6,92,3082,92,416
240.194,6,52,17858,28,796,8895,1408,15009,24,227,10443,580,2849
1795.013,6,240,35580,150,302,12047,302,25920,90,83,20168,83,9660
127.891,6,23,1664,17,43,7993,43,1304,6,0,24922,0,360
1796.541,6,364,25392,212,100,8514,469,14896,152,69,11897,69,10496
0.337,17,2,148,1,32,0,32,60,1,60,0,60,88
1772.525,6,180,15480,120,69,14895,69,8940,60,69,30034,69,6540
3.017,17,8,568,4,32,1003,32,240,4,54,1002,60,328
280.522,6,30,7432,13,158,23376,267,1317,17,603,17522,2076,6115
9.119,6,1453,1245588,864,1388,10,1420,1217807,589,467,15,1883,27781
2.164,17,4,360,2,30,2151,30,116,2,94,2150,94,244
76.02,6,75,45065,46,938,180,1360,18758,29,1322,2710,5709,26307
1.646,6,52,21272,29,899,58,1360,15576,23,433,65,1360,5696
1786.654,17,140,11200,70,48,25892,48,5320,70,56,25892,56,5880
1740.494,17,30,31680,30,1028,60017,1028,31680,0,0,0,0,0
6.097,17,3,228,3,48,3048,48,228,0,0,0,0,0
1775.408,17,140,11200,70,48,25730,48,5320,70,56,25730,56,5880
0.012,6,13,3980,7,88,2,88,388,6,1670,2,1880,3592
0.396,6,25,8965,13,261,33,683,1728,12,1100,34,2896,7237
0.249,6,17,2952,9,266,31,517,1542,8,493,28,828,1410
0.765,17,20,12054,11,605,71,1350,6964,9,537,90,1350,5090
0.105,2,2,80,2,16,105,16,80,0,0,0,0,0
668.532,17,50,3984,27,48,25712,48,2052,23,56,25708,56,1932
1754.956,1,231,12936,231,28,7630,28,12936,0,0,0,0,0
1.577,6,30,10405,18,367,92,833,1825,12,1012,135,1420,8580
1770.58,6,99,9306,66,66,27239,66,5610,33,60,55327,60,3696
0.904,6,11,1727,7,100,150,100,384,4,589,220,1152,1343
1673.76,1,8,448,8,28,239108,28,448,0,0,0,0,0
26.482,6,18,788,8,0,3783,0,348,10,0,2466,0,440
520.101,1,58,3248,0,0,0,0,0,58,28,9124,28,3248
0.252,6,10,1514,5,503,63,503,771,5,475,63,475,743
0.635,6,39,11828,22,601,30,1188,7758,17,317,34,524,4070
0.161,17,2,180,1,30,0,30,58,1,94,0,94,122
28.405,6,45,13909,23,289,1291,721,3533,22,862,1302,2840,10376
1740.056,17,29,2407,29,55,62144,55,2407,0,0,0,0,0
18.184,6,9,488,5,0,4546,0,280,4,0,2646,0,208
1799.547,1,216,12096,216,28,8369,28,12096,0,0,0,0,0
175.265,17,2,72,1,8,0,8,36,1,8,0,8,36
1778.866,17,138,11040,69,48,26159,48,5244,69,56,26159,56,5796
4.955,6,12,3063,6,49,991,92,419,6,1164,917,1448,2644
1781.825,17,140,11200,70,48,25823,48,5320,70,56,25823,56,5880
8.684,6,32,8952,14,158,668,267,1357,18,624,506,1400,7595
1.462,6,48,20013,28,885,54,1360,14437,20,476,68,2715,5576
1786.629,6,116,11964,74,132,24474,1267,7738,42,67,43573,193,4226
0.271,6,22,4442,11,165,27,456,1394,11,493,26,888,3048
11.246,6,34,14805,17,319,702,721,3240,17,1209,689,1414,11565
1.251,17,6,552,3,32,493,32,180,3,96,440,96,372
1687.571,6,139,16007,84,88,20332,498,7002,55,154,31249,1420,9005
0.643,6,14,1745,7,288,77,288,600,7,426,77,434,1145
1771.395,6,107,9863,68,65,26438,65,5758,39,59,46612,59,4105
10.749,6,18,5610,10,275,1194,275,958,8,1440,820,1440,4652
369.791,6,27,1767,18,177,21752,177,1181,9,110,8923,110,586
1.375,6,48,19012,26,944,55,1460,13356,22,476,56,2615,5656
97.399,6,16,2288,9,324,12174,584,1124,7,396,16226,580,1164
195.14,17,4,352,2,60,195139,60,176,2,60,195139,60,176
3.002,1,3,318,3,78,1501,78,318,0,0,0,0,0
41.206,6,17,8398,4,92,163,92,308,13,673,3419,1408,8090
240.311,6,37,4354,17,178,15019,585,1964,20,191,12647,580,2390
1791.302,6,130,12112,82,66,22114,130,7078,48,59,38110,59,5034
20.176,6,20,5366,12,107,1834,159,1074,8,967,2874,1669,4292
33.553,6,30,5242,15,180,2396,722,1858,15,371,2382,2026,3384
4.473,6,22,4426,12,213,406,597,1689,10,441,475,1402,2737
11.915,6,1867,1644133,1142,1386,10,1420,1610912,725,467,16,1883,33221
8.097,6,1302,1125521,784,1386,10,1420,1100568,518,467,15,2840,24953
1.308,6,54,19907,29,920,46,1360,14086,25,400,47,1360,5821
1.348,6,9,1202,5,304,336,304,880,4,102,447,102,322
1757.794,6,204,22691,106,84,16740,721,9389,98,223,18118,1414,13302
0.157,6,12,3462,6,75,31,75,395,6,1373,31,1448,3067
1.437,6,38,9848,20,502,75,1460,4352,18,433,74,1460,5496
1680.525,1,15,840,15,28,120037,28,840,0,0,0,0,0
1749.197,6,145,9165,79,48,22425,208,5595,66,31,26906,31,3570
1.319,6,50,21288,28,965,48,1460,15632,22,433,53,1460,5656
881.519,2,7,224,7,8,146919,8,224,0,0,0,0,0
34.854,6,55,14412,30,1014,431,1360,8441,25,309,1445,2667,5971
0.007,6,2,80,0,0,0,0,0,2,0,0,0,80
3.49,6,2,88,2,0,0,0,88,0,0,0,0,0
0.17,6,2,112,1,0,0,0,60,1,0,0,0,52
1772.209,6,27,4077,18,241,104247,241,2889,9,92,221502,92,1188
0.351,6,26,8995,13,252,29,647,1692,13,945,26,1438,7303
6.515,6,66,20206,34,543,197,1152,15499,32,489,201,1179,4707
4.963,6,4,258,3,31,2414,31,218,1,0,0,0,40
0.433,6,12,1653,6,288,83,288,548,6,426,48,434,1105
1746.635,6,94,7151,62,38,28633,205,4424,32,33,56336,98,2727
1559.173,6,197,16685,74,71,21356,339,7233,123,71,12780,1062,9452
263.418,17,4,514,2,36,263413,36,128,2,165,263413,171,386
280.501,6,29,7392,13,158,23375,267,1317,16,603,18695,2036,6075
1783.409,17,83,3480,82,14,22017,14,3444,1,8,0,8,36
62.909,17,4,1344,4,308,20969,308,1344,0,0,0,0,0
0.024,17,2,567,1,43,0,43,71,1,468,0,468,496
1795.688,17,66,2766,65,14,28057,14,2730,1,8,0,8,36
357.668,17,8,704,4,48,119220,48,304,4,72,119219,72,400
26.698,6,8,464,2,0,16641,0,112,6,0,5337,0,352
280.21,6,29,7392,13,158,23350,267,1317,16,543,18679,1400,6075
15.647,6,15,1971,6,222,1751,222,910,9,231,1953,231,1061
1743.0,6,95,7203,63,38,28112,205,4476,32,33,56218,98,2727
0.304,6,26,8892,13,237,25,589,1634,13,1095,24,2804,7258
5.26,6,40,7325,21,218,263,314,3463,19,516,278,1179,3862
233.965,1,16,896,16,28,15597,28,896,0,0,0,0,0
1798.972,6,373,26028,217,98,8328,469,15303,156,69,11605,69,10725
0.687,6,10,924,5,283,115,283,551,5,105,119,105,373
1743.616,6,97,7057,63,31,28122,31,4273,34,31,52826,31,2784
0.016,17,2,407,1,32,0,32,60,1,319,0,319,347
57.049,6,28,7223,13,156,4754,267,1312,15,482,4074,1420,5911
1.653,6,49,19249,27,891,63,1360,13593,22,433,68,1360,5656
7.155,17,4,304,2,48,7154,64,152,2,48,7154,64,152
0.746,17,2,782,2,363,746,363,782,0,0,0,0,0
0.019,6,9,1557,5,515,4,515,783,4,558,6,558,774
1681.841,1,15,840,15,28,120131,28,840,0,0,0,0,0
5.123,6,40,7309,21,218,256,314,3463,19,440,270,1152,3846
1682.667,17,14,1036,7,30,280437,30,406,7,62,280436,62,630
82.029,6,120,49409,67,692,1242,1360,36628,53,394,1574,1938,12781
0.028,17,2,192,1,37,0,37,65,1,99,0,99,127
1176.011,6,161,21354,90,129,13213,469,9684,71,142,16798,1452,11670
1.179,6,25,8056,12,164,91,267,1288,13,869,83,1402,6768
1.383,6,25,8056,12,164,107,267,1288,13,1014,99,2491,6768
137.111,6,30,8872,14,158,10547,267,1357,16,763,9133,2800,7515
4.818,17,5,320,5,36,1204,36,320,0,0,0,0,0
1753.247,6,181,10946,91,45,19480,208,6416,90,31,19696,31,4530
1791.107,6,355,22480,207,69,8694,69,12420,148,69,12184,69,10060
1771.575,6,99,9240,66,65,27255,65,5577,33,59,55358,59,3663
12.091,6,1899,1657439,1157,1377,10,1420,1623538,742,467,16,1883,33901
1787.981,6,102,8228,68,64,26686,64,4896,34,58,54179,58,3332
6.382,6,3,277,2,78,6382,126,237,1,0,0,0,40
1.371,6,24,8004,12,164,107,267,1288,12,1014,106,2491,6716
1685.503,17,12,498,11,14,168550,14,462,1,8,0,8,36
1.33,17,3,451,2,39,549,39,134,1,289,0,289,317
154.186,6,70,48741,45,1198,3504,1448,40711,25,746,2570,1448,8030
173.968,6,21,9988,11,395,67,875,1658,10,1319,19315,2574,8330
1.808,17,2,214,1,39,0,39,67,1,119,0,119,147
1747.844,6,95,7203,63,38,28191,205,4476,32,33,56375,98,2727
154.269,6,15,612,5,0,5883,0,204,10,0,17140,0,408
0.468,17,2,144,1,36,0,36,64,1,52,0,52,80
2.21,17,2,322,1,33,0,33,61,1,233,0,233,261
2.725,17,2,144,1,36,0,36,64,1,52,0,52,80
8.018,6,20,8291,10,275,890,275,683,10,1199,828,1420,7608
1787.959,1,270,15120,270,28,6646,28,15120,0,0,0,0,0
301.049,6,70,53768,46,1242,6689,1368,47150,24,670,1750,1571,6618
1.324,6,42,10651,23,513,60,1460,5070,19,400,63,1460,5581
37.902,17,22,1936,11,48,3789,48,836,11,72,3789,72,1100
0.015,17,2,192,1,37,0,37,65,1,99,0,99,127
1797.924,6,367,25650,214,99,8440,469,15045,153,69,11827,69,10605
372.104,6,23,1538,16,180,24806,180,1056,7,110,10396,110,482
1799.007,6,365,25032,213,94,8485,469,14536,152,69,11913,69,10496
0.112,6,16,4010,10,75,12,75,603,6,771,22,1000,3407
1.265,6,49,19655,27,920,48,1360,13999,22,476,52,2715,5656
266.068,17,62,16058,62,231,4361,388,16058,0,0,0,0,0
240.326,6,47,9221,25,197,10012,751,2689,22,538,11441,2378,6532
0.989,6,29,13714,15,138,70,138,1064,14,1190,69,1448,12650
1791.111,17,144,11520,72,48,25226,48,5472,72,56,25226,56,6048
5.139,17,4,288,2,36,5006,36,128,2,52,5056,52,160
1.633,6,53,21363,31,898,54,1360,15662,22,437,67,2715,5701
157.679,6,28,6226,17,186,9854,503,1617,11,520,15759,1420,4609
32.011,6,209,162605,100,131,323,315,5689,109,1440,296,2816,156916
61.857,17,2,1430,2,687,61857,687,1430,0,0,0,0,0
270.408,17,6,456,6,48,54081,48,456,0,0,0,0,0
1781.517,17,136,10864,70,48,25818,48,5320,66,56,27407,56,5544
0.28,6,10,1042,5,213,70,213,417,5,421,55,421,625
1770.498,6,99,9240,66,65,27238,65,5577,33,59,55324,59,3663
1309.317,6,134,11501,88,69,15049,69,6625,46,69,29095,69,4876
7.635,17,6,528,3,48,3813,48,228,3,72,3813,72,300
0.823,6,31,9373,15,208,58,646,1841,16,833,50,1438,7532
0.084,17,2,216,1,45,0,45,73,1,115,0,115,143
1.048,6,14,1978,8,127,149,127,559,6,545,5,990,1419
1786.708,6,181,15589,121,69,14889,69,9049,60,69,30278,69,6540
1794.11,1,253,14168,253,28,7119,28,14168,0,0,0,0,0
0.243,17,2,782,2,363,243,363,782,0,0,0,0,0
1780.546,17,142,11360,71,48,25436,48,5396,71,56,25436,56,5964
369.624,6,18,1242,14,180,28432,180,916,4,110,20063,110,326
10.66,6,32,8952,14,158,820,267,1357,18,624,625,1400,7595
0.007,6,2,156,1,64,0,64,116,1,0,0,0,40
100.058,6,32,14730,16,488,330,1360,3127,16,1095,6661,2720,11603
0.093,6,9,1344,5,145,23,145,349,4,831,28,831,995
1776.646,1,58,4872,58,56,31169,56,4872,0,0,0,0,0
0.401,17,2,152,1,48,0,48,76,1,48,0,48,76
9.146,6,1322,1213169,840,1368,10,1408,1183441,482,931,18,2801,29728
0.013,17,2,378,1,50,0,50,78,1,272,0,272,300
254.233,17,12,4057,12,310,23112,342,4057,0,0,0,0,0
58.16,6,11,851,11,31,5816,31,851,0,0,0,0,0
3.859,17,4,368,4,64,1286,64,368,0,0,0,0,0
0.055,6,12,964,6,181,11,181,489,6,77,9,134,475
0.484,6,26,7256,12,155,44,267,1261,14,775,33,3465,5995
1795.154,17,449,39928,404,35,4454,288,25708,45,288,40024,288,14220
8.154,6,1667,1533779,1049,1384,7,1408,1496979,618,931,12,2816,36800
0.284,6,23,6019,12,181,25,537,1526,11,782,27,2231,4493
240.182,6,55,18051,30,804,8282,1408,15246,25,187,10007,580,2805
0.04,6,10,1514,5,503,10,503,771,5,475,9,475,743
1787.68,6,4885,5020097,1646,126,1086,341,96455,3239,1501,552,5608,4923642
300.608,6,43,8697,23,286,13664,766,2144,20,574,618,4848,6553
1386.562,2,8,256,8,8,198080,8,256,0,0,0,0,0
6.131,17,4,304,3,48,3050,48,228,1,48,0,48,76
1788.867,17,87,3648,86,14,21045,14,3612,1,8,0,8,36
4.562,6,39,7285,19,218,253,314,3383,20,516,226,1179,3902
1.219,6,46,18124,26,882,48,1360,12548,20,529,53,4075,5576
0.816,6,12,3705,6,171,159,171,491,6,964,163,1448,3214
65.761,17,4,352,2,60,65760,60,176,2,60,65760,60,176
75.594,6,34,7733,13,155,25,267,1306,21,348,3779,1420,6427
9.296,6,28,5502,14,197,715,314,2145,14,557,693,1179,3357
0.803,6,10,1687,7,100,133,100,384,3,1179,272,1179,1303
63.068,6,21,8770,11,333,70,692,1473,10,1147,6993,2568,7297
1.36,6,50,19286,27,891,52,1360,13590,23,433,54,1360,5696
3.733,6,12,2275,5,188,933,245,580,7,703,579,1152,1695
681.642,17,15,1140,15,48,48688,48,1140,0,0,0,0,0
4.084,17,15,16789,4,1036,1361,1350,4259,11,1111,371,1350,12530
11.218,6,1752,1530678,1081,1363,10,1380,1499608,671,421,16,1923,31070
1798.736,1,57,4788,0,0,0,0,0,57,56,32120,56,4788
1796.31,17,448,39896,403,35,4468,288,25676,45,288,40018,288,14220
0.783,6,31,8030,17,345,48,720,1747,14,571,39,3488,6283
280.273,6,27,7312,12,158,25479,267,1277,15,678,20016,2045,6035
1786.783,17,87,3648,86,14,21020,14,3612,1,8,0,8,36
0.019,6,9,1878,5,666,4,666,934,4,728,5,728,944
280.472,6,27,7312,12,158,25497,267,1277,15,678,20027,2085,6035
6.156,6,1917,1781064,1212,1392,4,1408,1739740,705,931,8,2816,41324
2.024,17,3,174,3,30,1012,30,174,0,0,0,0,0
1746.125,6,95,7203,63,38,28163,205,4476,32,33,56313,98,2727
13.514,6,122,41528,64,643,214,1152,34726,58,407,232,1152,6802
10.24,6,1564,1401375,992,1363,10,1380,1374253,572,421,17,1923,27122
1772.514,6,203,22290,130,75,13740,267,10057,73,134,24616,1997,12233
1758.91,1,62,5208,0,0,0,0,0,62,56,28834,56,5208
1.316,6,48,19766,27,931,50,1460,14150,21,433,57,1460,5616
63.153,6,7,420,7,0,0,0,420,0,0,0,0,0
0.845,1,30,840,30,0,0,0,840,0,0,0,0,0
777.716,2,12,384,12,8,70701,8,384,0,0,0,0,0
23.85,6,42,15845,24,698,1036,1408,13138,18,251,1402,580,2707
204.501,17,5,3416,5,655,51125,1284,3416,0,0,0,0,0
0.298,17,2,304,1,60,0,60,88,1,188,0,188,216
1.128,6,24,8016,12,164,87,267,1300,12,1014,87,2411,6716
0.689,6,23,4781,13,208,57,523,1714,10,507,66,1408,3067
348.136,6,79,5388,34,46,10293,46,2162,45,46,7912,46,3226
1780.305,17,138,11040,69,48,26180,48,5244,69,56,26180,56,5796
1763.677,2,13,416,13,8,146973,8,416,0,0,0,0,0
0.726,17,8,2750,8,315,103,354,2750,0,0,0,0,0
1.607,6,44,16954,26,798,64,1360,11458,18,529,81,4075,5496
0.483,17,4,352,2,60,482,60,176,2,60,482,60,176
300.829,6,48,10403,24,433,13079,910,3206,24,345,434,2128,7197
0.171,6,46,20320,26,1017,6,1420,15299,20,467,8,1883,5021
708.149,6,277,88461,136,595,5245,1460,64035,141,276,5057,1638,24426
3.648,17,6,1246,3,30,1819,30,174,3,329,1818,468,1072
1.63,6,32,10530,15,231,116,669,1956,17,850,96,1438,8574
1795.158,17,445,39516,401,35,4487,288,25612,44,288,40949,288,13904
1771.267,6,108,10016,70,65,25669,65,6045,38,59,47868,59,3971
182.365,6,45,10951,23,554,8289,1418,8409,22,198,8670,580,2542
3.011,17,3,468,3,128,1505,128,468,0,0,0,0,0
144.75,17,2,122,2,33,144750,33,122,0,0,0,0,0
1771.019,6,351,22182,205,69,8681,69,12271,146,69,12213,69,9911
1795.005,17,446,39264,403,35,4465,288,25676,43,288,41922,288,13588
192.821,17,8,704,4,48,64269,48,304,4,72,64269,72,400
53.434,6,60,29001,33,748,1669,1460,7473,27,1074,1769,1460,21528
3.497,6,26,6585,14,252,265,517,1492,12,744,314,1408,5093
2.339,6,20,3833,11,234,233,564,1504,9,463,268,1343,2329
280.6,6,28,7352,13,158,23383,267,1317,15,678,20034,2045,6035
280.261,6,26,7272,12,158,25478,267,1277,14,775,21549,3445,5995
8.142,6,78,24405,40,552,208,1152,18744,38,459,213,1179,5661
0.502,6,23,7307,13,318,41,600,1958,10,964,51,1471,5349
130.007,6,10,1348,2,0,3296,0,84,8,233,18538,233,1264
109.694,6,30,7432,13,158,9141,267,1317,17,543,6853,1400,6115
1786.457,6,102,8296,68,65,26663,65,4930,34,59,54132,59,3366
0.064,6,12,3705,6,171,9,171,491,6,964,9,1448,3214
184.736,6,31,15166,19,860,10259,1343,9605,12,705,16789,1571,5561
5.016,17,4,558,2,36,5002,36,128,2,187,5002,187,430
1789.858,17,140,11200,70,48,25939,48,5320,70,56,25939,56,5880
0.557,6,22,7284,13,319,46,602,1960,9,1209,65,1946,5324
1.185,17,15,8409,8,705,169,1350,5869,7,334,188,1350,2540
1.407,6,38,9848,21,440,70,1360,4392,17,529,76,4075,5456
0.667,6,112,87486,53,131,12,232,2649,59,1556,10,2760,84837
0.054,6,12,3462,6,75,10,75,395,6,1373,10,1448,3067
1797.768,17,448,39612,404,35,4460,288,25708,44,288,40947,288,13904
40.957,17,44,6468,22,48,1949,48,1672,22,190,1949,308,4796
1795.986,17,449,39928,404,35,4456,288,25708,45,288,40019,288,14220
7.657,6,42,9941,21,401,382,1152,6058,21,434,370,1179,3883
240.576,2,4,128,4,8,80192,8,128,0,0,0,0,0
45.257,2,3,96,3,8,22628,8,96,0,0,0,0,0
0.629,17,4,288,2,36,629,36,128,2,52,628,52,160
33.747,6,4983,4723737,3260,1371,10,1408,4629477,1723,931,19,2801,94260
0.363,6,25,6079,13,108,30,147,959,12,662,32,1420,5120
1798.514,17,450,39960,405,35,4451,288,25740,45,288,40016,288,14220
0.993,6,32,10235,18,209,58,517,2254,14,805,73,1408,7981
129.043,17,8,2688,8,308,18434,308,2688,0,0,0,0,0
4.082,17,14,14097,5,836,1020,1350,4323,9,1058,268,1350,9774
7.59,6,72,26509,34,891,230,1440,15722,38,543,196,1440,10787
0.893,6,37,8373,19,277,49,761,1900,18,478,43,2920,6473
0.541,6,12,1304,6,256,106,256,756,6,304,106,304,548
0.063,6,2,80,1,0,0,0,40,1,0,0,0,40
792.134,6,38,2871,22,63,25784,63,1573,16,54,52803,57,1298
587.254,17,74,16872,74,200,8044,200,16872,0,0,0,0,0
209.535,6,64,45625,43,1185,4988,1408,37799,21,960,3077,3847,7826
1.037,17,4,236,2,31,1016,31,118,2,31,665,31,118
3.79,17,10,2447,5,40,945,40,340,5,393,944,423,2107
1760.254,6,181,19638,99,97,17961,721,9937,82,160,21728,1420,9701
64.613,6,17,1020,6,0,12921,0,360,11,0,6460,0,660
289.254,6,31,7182,13,230,159,502,1676,18,318,17010,1420,5506
234.024,2,4,128,4,8,78008,8,128,0,0,0,0,0
6.073,6,581,481296,344,1328,17,1368,464308,237,776,24,2736,16988
10.93,6,1607,1493863,1055,1365,10,1432,1467492,552,475,19,1871,26371
8.281,6,2050,1890793,1295,1381,6,1408,1846869,755,931,10,2801,43924
23.695,6,27,7091,7,154,3949,267,752,20,368,1240,1460,6339
1785.907,6,105,8610,70,66,25882,66,5110,35,60,52520,60,3500
9.56,6,10,775,4,186,3185,186,402,6,45,1911,45,373
0.043,6,6,386,2,31,0,31,135,4,31,0,31,251
181.562,1,14,784,14,28,13966,28,784,0,0,0,0,0
1797.952,17,447,39864,402,35,4483,288,25644,45,288,40015,288,14220
240.366,6,7,416,5,112,60091,112,320,2,0,1011,0,96
1746.134,6,95,7203,63,38,28163,205,4476,32,33,56314,98,2727
1624.286,1,8,448,8,28,232040,28,448,0,0,0,0,0
1.32,6,52,19302,29,881,47,1360,13561,23,437,51,2715,5741
87.434,17,10,590,10,31,9714,31,590,0,0,0,0,0
210.947,17,3,494,2,179,210947,202,414,1,52,0,52,80
0.826,17,4,624,2,64,727,64,184,2,192,675,192,440
280.208,6,28,7352,13,158,23350,267,1317,15,678,20012,2045,6035
1680.704,17,13,534,11,14,168051,14,462,2,8,1680511,8,72
0.025,6,12,3462,6,75,5,75,395,6,1373,5,1448,3067
1796.766,6,359,22709,209,69,8638,69,12569,150,69,12058,69,10140
7.242,6,16,2965,10,288,802,288,1860,6,426,1404,434,1105
280.405,6,30,7432,13,158,23367,267,1317,17,543,17519,1400,6115
1796.813,17,448,39896,403,35,4469,288,25676,45,288,40023,288,14220
1.341,6,47,21629,27,1032,51,1380,16639,20,464,68,1380,4990
10.872,17,15,17682,15,1150,776,1451,17682,0,0,0,0,0
1793.794,17,144,11520,72,48,25264,48,5472,72,56,25264,56,6048
287.556,6,37,4549,18,237,16914,585,1693,19,308,15974,580,2856
125.917,2,2,64,2,8,125917,8,64,0,0,0,0,0
11.948,6,1933,1646008,1160,1363,10,1380,1610366,773,421,15,1923,35642
377.885,2,3,96,3,8,188942,8,96,0,0,0,0,0
240.235,6,54,17877,29,794,8579,1418,15023,25,193,10009,580,2854
280.003,6,29,7392,14,158,21538,267,1357,15,678,19999,3436,6035
0.02,6,10,1510,5,657,5,657,925,5,317,5,317,585
1680.642,1,15,870,15,30,120045,30,870,0,0,0,0,0
2.429,6,12,1580,7,279,404,279,918,5,191,312,272,662
34.486,6,37,8627,19,329,1915,673,1780,18,470,513,1360,6847
1742.443,2,24,768,24,8,75758,8,768,0,0,0,0,0
1.397,6,24,8004,12,164,108,267,1288,12,1014,109,2736,6716
4.588,6,38,7245,19,218,254,314,3383,19,516,240,1179,3862
1.555,6,46,19123,27,891,59,1360,13587,19,529,75,4075,5536
33.242,17,18,1368,18,48,1955,48,1368,0,0,0,0,0
20.297,6,23,6162,13,147,1691,318,1285,10,1084,2248,1708,4877
24.63,17,4,352,2,60,24629,60,176,2,60,24629,60,176
1669.209,1,8,448,8,28,238458,28,448,0,0,0,0,0
7.162,6,5,240,1,0,0,0,48,4,0,2384,0,192
1797.008,17,448,39896,403,35,4470,288,25676,45,288,40021,288,14220
1760.933,6,119,7310,66,26,27090,26,3986,53,26,33863,26,3324
1739.331,6,100,7256,64,31,27608,31,4356,36,31,49694,31,2900
896.231,6,12,728,8,31,128033,31,444,4,31,298736,31,284
1.038,6,31,12874,15,529,74,1460,3290,16,812,56,1460,9584
1.162,6,10,1687,7,100,193,100,384,3,1179,455,1179,1303
69.923,6,73,51308,47,1199,1520,1408,43223,26,960,2464,3847,8085
15.429,17,8,608,8,48,2204,48,608,0,0,0,0,0
280.468,6,28,7352,13,158,23372,267,1317,15,678,20029,3456,6035
6.0,6,14,1247,7,222,999,222,728,7,231,999,231,519
23.129,6,32,8056,15,188,1652,721,1923,17,681,1432,1414,6133
1759.195,1,56,4704,0,0,0,0,0,56,56,31985,56,4704
5.034,17,4,288,2,36,4985,36,128,2,52,4990,52,160
1763.266,6,161,10137,84,50,21244,208,6127,77,31,23197,31,4010
280.457,6,26,7272,12,158,25496,267,1277,14,775,21569,3465,5995
0.139,17,4,284,2,32,0,32,120,2,54,120,60,164
1740.153,1,56,4704,0,0,0,0,0,56,56,31639,56,4704
240.25,6,53,17262,28,767,8897,1418,14507,25,180,10010,580,2755
11.607,6,28,7217,13,155,967,267,1306,15,482,828,2840,5911
0.009,17,2,262,1,36,0,36,64,1,170,0,170,198
280.629,6,29,7392,13,158,23385,267,1317,16,543,18703,1400,6075
0.521,17,3,451,2,39,400,39,134,1,289,0,289,317
3.28,6,2,88,2,0,0,0,88,0,0,0,0,0
1783.035,6,356,22520,208,69,8613,69,12460,148,69,12129,69,10060
1.102,6,26,9054,14,542,84,1287,2218,12,793,84,1591,6836
1799.864,6,354,22440,206,69,8779,69,12380,148,69,12243,69,10060
12.018,17,20,3400,10,33,1335,33,610,10,251,1335,323,2790
15.534,17,15,5045,7,354,2575,1350,2679,8,267,2206,1350,2366
0.058,6,4,160,2,0,58,0,80,2,0,5,0,80
300.602,6,36,8359,20,283,15821,787,1965,16,522,560,3488,6394
2.159,17,4,360,2,30,2143,30,116,2,94,2144,94,244
1787.909,6,360,22818,209,69,8595,69,12569,151,69,11919,69,10249
67.501,17,4,352,2,60,67500,60,176,2,60,67500,60,176
9.376,6,17,5391,9,275,1172,275,643,8,1104,1280,1440,4748
1741.21,1,56,4704,56,56,31658,56,4704,0,0,0,0,0
1772.433,6,180,15480,120,69,14894,69,8940,60,69,30039,69,6540
1785.929,17,142,11360,71,48,25513,48,5396,71,56,25513,56,5964
5.15,6,23,7700,13,247,429,398,1413,10,822,531,1448,6287
1791.111,6,122,13174,79,85,22962,510,6398,43,126,42593,1380,6776
7.645,17,6,528,3,60,3822,60,264,3,60,3822,60,264
15.16,6,30,5218,13,204,1263,722,1708,17,324,936,1408,3510
0.54,17,4,624,2,64,539,64,184,2,192,423,192,440
26.571,6,53,10639,25,533,653,910,3251,28,312,979,1460,7388
0.299,6,10,582,5,42,74,42,310,5,0,45,0,272
0.071,17,2,146,1,37,0,37,65,1,53,0,53,81
7.244,6,194,212737,137,133,53,201,6311,57,3851,125,31108,206426
24.021,6,54,19571,25,1013,42,1460,13194,29,260,851,1460,6377
1645.141,1,7,392,7,28,274190,28,392,0,0,0,0,0
1795.473,17,448,39896,403,35,4466,288,25676,45,288,40026,288,14220
33.595,6,34,5250,16,154,2239,722,1910,18,266,1965,1288,3340
1775.465,1,58,4872,58,56,31148,56,4872,0,0,0,0,0
1799.036,17,447,39580,403,35,4475,288,25676,44,288,40950,288,13904
54.259,6,42,12519,21,634,2712,1360,4700,21,535,2703,1360,7819
0.204,6,46,21484,26,1100,8,1420,16463,20,467,10,1883,5021
5.607,17,26,7157,10,230,623,1350,2581,16,258,211,1350,4576
302.209,6,46,9309,25,247,12592,755,2574,21,420,501,1928,6735
1670.891,1,7,392,7,28,278481,28,392,0,0,0,0,0
224.245,6,32,8952,14,158,17249,267,1357,18,624,13186,1400,7595
0.011,17,2,334,1,32,0,32,60,1,246,0,246,274
7.38,6,47,8489,22,227,351,314,4062,25,489,296,1179,4427
1799.824,17,142,11360,71,48,25711,48,5396,71,56,25710,56,5964
0.38,17,16,8474,8,706,54,1350,5874,8,297,45,1350,2600
134.402,6,5970,5207535,2968,745,45,1396,170431,3002,1634,44,6980,5037104
0.0,6,2,80,0,0,0,0,0,2,0,0,0,80
1781.765,6,415,24949,206,69,8691,69,12380,209,34,8566,64,12569
1786.378,6,102,8228,68,64,26662,64,4896,34,58,54128,58,3332
1786.619,6,103,8336,68,65,26665,65,4930,35,59,52545,59,3406
280.05,6,28,7352,13,158,23337,267,1317,15,678,20000,2800,6035
2.113,6,13,2311,8,188,301,245,700,5,1407,465,1407,1611
1.654,6,12,3705,6,171,330,171,491,6,964,329,1448,3214
1796.844,17,448,39896,403,35,4469,288,25676,45,288,40019,288,14220
1774.858,17,138,11040,69,48,26100,48,5244,69,56,26100,56,5796
14.065,17,2,672,2,308,14065,308,672,0,0,0,0,0
1787.399,6,106,8524,68,66,26677,66,4964,38,60,48304,60,3560
1773.264,6,181,15589,121,69,14777,69,9049,60,69,30053,69,6540
1741.464,17,30,31680,30,1028,60050,1028,31680,0,0,0,0,0
87.391,6,38,9125,12,207,396,469,1735,26,302,3494,1460,7390
1772.163,6,180,15480,120,69,14892,69,8940,60,69,30034,69,6540
0.308,6,22,7342,12,335,27,668,1974,10,1210,33,2816,5368
14.745,17,4,352,2,60,14744,60,176,2,60,14744,60,176
10.484,6,1912,1818562,1255,1375,8,1408,1779734,657,931,15,2801,38828
54.601,6,5192,4973145,3336,1410,16,1448,4870057,1856,776,29,1448,103088
1772.14,6,180,15480,120,69,14891,69,8940,60,69,30035,69,6540
0.047,17,2,517,1,34,0,34,62,1,427,0,427,455
4.483,6,1357,1293773,906,1380,4,1420,1271430,451,475,9,1883,22343
316.955,6,110,34696,60,471,5372,1360,23638,50,335,6465,4649,11058
1780.96,17,142,11360,71,48,25442,48,5396,71,56,25442,56,5964
1772.692,6,180,15480,120,69,14896,69,8940,60,69,30042,69,6540
4.049,17,10,1415,5,31,1009,31,295,5,196,1009,196,1120
366.818,6,23,1535,16,177,24454,177,1053,7,110,10371,110,482
1.7,6,14,2351,8,188,242,245,700,6,703,287,1152,1651
0.124,6,9,1346,5,145,31,145,349,4,833,32,833,997
219.463,17,4,240,2,32,219462,32,120,2,32,219462,32,120
321.753,1,10,560,10,28,35750,28,560,0,0,0,0,0
0.499,6,20,7229,13,334,41,663,2021,7,1209,76,2736,5208
1785.943,6,366,23196,211,69,8504,69,12787,155,69,11596,69,10409
1770.739,1,58,4872,58,56,31065,56,4872,0,0,0,0,0
47.444,6,46,9020,22,371,994,766,2121,24,348,2057,3488,6899
3.851,6,34,6169,17,206,240,314,2744,17,456,224,1152,3425
8.083,6,30,7947,13,215,673,721,1814,17,544,492,1420,6133
13.674,6,1881,1735721,1216,1374,11,1380,1698292,665,683,20,3303,37429
443.241,6,47,7680,23,134,14782,516,2130,24,241,19267,1452,5550
0.899,6,2,364,1,0,0,0,40,1,272,0,272,324
67.593,6,27,16114,7,402,6500,721,1490,20,863,3548,2840,14624
76.114,6,23,9178,12,304,78,597,1437,11,1041,7593,1721,7741
29.323,6,9,527,5,43,7330,43,311,4,0,9773,0,216
0.544,6,23,7428,14,273,41,663,2104,9,1209,61,1946,5324
1791.981,1,298,16688,298,28,6033,28,16688,0,0,0,0,0
300.357,6,36,9171,20,514,15808,1178,3178,16,468,4315,1491,5993
1.492,6,48,18994,27,876,57,1360,13378,21,433,65,1360,5616
374.113,6,134,109052,89,1269,4251,1368,98586,45,738,1738,2519,10466
1745.507,6,96,7286,63,38,28153,205,4476,33,33,54536,98,2810
0.119,17,4,284,2,32,112,32,120,2,54,111,60,164
1681.616,17,14,1036,7,30,280266,30,406,7,62,280267,62,630
1784.743,6,77,4054,39,26,46965,26,2054,38,24,46931,24,2000
23.694,6,18,3543,6,92,4738,92,400,12,415,2132,1408,3143
0.959,6,36,8204,19,241,53,619,1770,17,478,51,2128,6434
659.965,6,68,4252,38,44,17832,208,2680,30,31,22751,31,1572
491.608,1,18,1008,18,28,28918,28,1008,0,0,0,0,0
0.121,17,4,384,2,60,120,60,176,2,76,121,76,208
9.174,6,17,5313,9,275,1146,275,643,8,1084,1117,1414,4670
1790.043,6,418,25144,207,69,8689,69,12420,211,34,8523,48,12724
32.541,6,14,5798,4,106,10847,106,274,10,639,3597,1460,5524
0.006,17,2,396,1,39,0,39,67,1,301,0,301,329
1770.552,6,104,9883,68,70,26426,234,5948,36,60,50584,83,3935
280.52,6,31,7472,13,158,23376,267,1317,18,603,16493,2076,6155
0.767,6,27,5927,13,156,63,267,1462,14,650,54,1420,4465
1749.756,1,174,9744,174,28,10114,28,9744,0,0,0,0,0
280.472,6,27,7312,12,158,25497,267,1277,15,775,20030,3465,6035
0.391,6,28,9001,13,227,32,547,1592,15,827,27,1408,7409
1744.89,6,94,7151,62,38,28604,205,4424,32,33,56280,98,2727
0.209,17,2,2380,2,1162,209,1162,2380,0,0,0,0,0
1.015,17,2,677,1,300,0,300,328,1,321,0,321,349
1.379,6,48,18827,27,864,53,1360,13211,21,476,58,2715,5616
85.224,17,4,352,2,60,85223,60,176,2,60,85223,60,176
1.884,1,3,252,3,56,942,56,252,0,0,0,0,0
0.409,6,21,7203,12,318,37,600,1906,9,1205,48,1851,5297
1791.816,1,248,13888,248,28,7254,28,13888,0,0,0,0,0
3.311,17,5,306,4,30,1064,30,232,1,46,0,46,74
1749.768,17,13,534,11,14,174958,14,462,2,8,1749585,8,72
299.752,2,3,96,3,8,149876,8,96,0,0,0,0,0
0.053,17,2,168,1,48,0,48,76,1,64,0,64,92
16.173,6,8,506,0,0,0,0,0,8,31,2310,31,506
1744.621,2,19,608,19,8,96923,8,608,0,0,0,0,0
240.487,6,65,24827,32,548,7757,1418,6611,33,824,7514,1418,18216
77.144,6,82,55305,50,1197,1574,1368,46906,32,747,2004,1368,8399
1788.466,6,208,20344,110,74,16407,721,10156,98,184,16830,1440,10188
0.105,17,2,348,1,39,0,39,67,1,253,0,253,281
0.005,17,2,542,1,36,0,36,64,1,450,0,450,478
240.96,6,44,9056,21,521,12043,1418,5790,23,229,10950,618,3266
9.093,17,16,1136,8,32,1298,32,480,8,54,1298,60,656
0.075,17,2,586,1,46,0,46,74,1,484,0,484,512
1800.0,6,262,21251,103,81,17647,457,11178,159,50,11391,143,10073
1.337,6,10,1687,7,100,222,100,384,3,1179,537,1179,1303
0.104,17,2,198,1,39,0,39,67,1,103,0,103,131
0.938,17,4,624,2,64,936,64,184,2,192,822,192,440
57.157,17,4,352,2,60,57155,60,176,2,60,57156,60,176
1795.191,17,447,39864,402,35,4476,288,25644,45,288,40010,288,14220
1781.996,6,221,21475,111,84,16199,721,10481,110,164,16339,1440,10994
8.52,6,2,1175,1,0,0,0,40,1,1095,0,1095,1135
99.574,6,40,9995,21,593,4969,1460,4433,19,399,5521,1460,5562
3.299,6,23,5714,14,158,244,370,1355,9,1331,372,3151,4359
0.185,17,2,198,1,63,0,63,91,1,79,0,79,107
360.954,2,4,128,4,8,120318,8,128,0,0,0,0,0
102.925,17,4,240,2,32,102924,32,120,2,32,102924,32,120
1798.347,17,450,39960,405,35,4451,288,25740,45,288,40017,288,14220
199.176,6,32,8952,14,158,15321,267,1357,18,624,11712,1400,7595
0.412,6,25,7216,12,155,37,267,1261,13,678,33,2045,5955
130.238,17,4,240,2,32,130237,32,120,2,32,130237,32,120
10.921,6,1906,1749378,1203,1375,8,1408,1708134,703,776,15,1408,41244
4.07,6,6,1255,4,327,1356,413,814,2,180,3863,269,441
1773.076,6,181,15589,120,69,14899,69,8940,61,69,29545,69,6649
1.178,17,3,1173,3,363,589,363,1173,0,0,0,0,0
0.939,6,10,1687,7,100,156,100,384,3,1179,339,1179,1303
1795.891,17,448,39896,403,35,4467,288,25676,45,288,40020,288,14220
0.197,1,2,112,2,28,197,28,112,0,0,0,0,0
0.713,6,21,7290,13,335,59,668,2026,8,968,95,1475,5264
1735.921,1,56,4704,56,56,31562,56,4704,0,0,0,0,0
373.456,6,21,1422,15,180,26675,180,992,6,110,12273,110,430
14.264,6,109,35602,56,594,259,1152,28984,53,449,269,1179,6618
2.66,6,26,8138,12,326,237,517,1949,14,779,201,1418,6189
11.667,6,18,6775,10,275,1296,275,683,8,1440,968,1440,6092
2.3,6,26,8521,15,175,164,362,1666,11,896,181,1448,6855
0.881,6,11,1727,7,100,146,100,384,4,589,209,1152,1343
450.303,1,6,336,6,28,90060,28,336,0,0,0,0,0
0.119,17,2,222,1,30,0,30,58,1,136,0,136,164
0.072,17,2,185,1,31,0,31,59,1,98,0,98,126
1739.975,1,14,812,14,30,133844,30,812,0,0,0,0,0
0.875,6,21,9222,11,514,87,1237,2015,10,970,72,1360,7207
3.493,6,5,352,3,92,1707,92,256,2,0,207,0,96
317.061,6,53,12347,28,141,11743,615,3592,25,483,13204,2720,8755
1753.419,1,57,4788,57,56,31311,56,4788,0,0,0,0,0
61.792,6,66,44714,42,1151,1507,1448,36736,24,746,2676,1448,7978
1797.267,1,296,31376,296,78,6092,78,31376,0,0,0,0,0
1776.821,17,73,3060,72,14,25025,14,3024,1,8,0,8,36
0.119,17,2,288,1,59,0,59,87,1,173,0,173,201
0.017,17,4,352,2,60,11,60,176,2,60,16,60,176
2.324,17,3,174,3,30,1162,30,174,0,0,0,0,0
0.22,6,3,120,1,0,0,0,40,2,0,220,0,80
2.154,17,24,14151,13,879,177,1350,11798,11,185,212,1350,2353
1769.681,6,99,9240,66,65,27225,65,5577,33,59,55298,59,3663
1773.163,6,181,15589,120,69,14900,69,8940,61,69,29548,69,6649
1774.632,1,65,5460,65,56,27728,56,5460,0,0,0,0,0
0.429,6,50,17580,28,865,15,1380,12413,22,387,18,1923,5167
1786.372,6,104,8376,68,65,26662,65,4930,36,59,51036,59,3446
504.307,6,67,12043,34,170,15282,1189,4439,33,313,4706,1460,7604
1.289,6,50,20592,28,918,47,1360,14936,22,433,53,1360,5656
1783.163,17,83,3480,82,14,22014,14,3444,1,8,0,8,36
0.198,17,2,2754,2,1349,198,1349,2754,0,0,0,0,0
145.839,6,26,11166,13,518,50,1360,2624,13,1144,12143,3072,8542
1787.434,17,87,3648,86,14,21028,14,3612,1,8,0,8,36
137.858,6,22,4695,13,151,11488,722,1894,9,579,1765,1448,2801
3.817,17,5,295,5,31,954,31,295,0,0,0,0,0
1.221,6,5,248,3,0,610,0,144,2,0,828,0,104
1741.258,6,87,6322,58,31,30548,31,3915,29,31,62187,31,2407
1793.701,1,65,5460,65,56,28026,56,5460,0,0,0,0,0
1.435,2,3,96,3,8,717,8,96,0,0,0,0,0
280.493,6,30,7432,13,158,23374,267,1317,17,603,17523,2076,6115
0.062,17,2,154,1,33,0,33,61,1,65,0,65,93
0.845,6,24,6420,13,299,70,842,2023,11,988,83,1731,4397
0.028,17,2,456,1,60,0,60,88,1,340,0,340,368
105.17,6,38,8164,14,152,8090,267,1484,24,317,4566,1460,6680
1443.878,2,12,384,12,8,131261,8,384,0,0,0,0,0
0.016,17,2,460,1,39,0,39,67,1,365,0,365,393
0.563,6,10,1671,6,552,112,948,1348,4,159,187,159,323
0.379,6,22,4442,11,165,37,456,1394,11,493,34,888,3048
1758.744,6,107,8656,70,65,25489,65,5140,37,59,48850,89,3516
596.428,6,57,8532,28,116,22088,517,2399,29,385,21299,1418,6133
67.27,6,20,6495,5,154,16817,267,672,15,520,4785,1460,5823
147.994,17,4,352,2,60,147992,60,176,2,60,147993,60,176
29.967,17,18,1584,9,48,3744,48,684,9,72,3744,72,900
1.619,6,8,1607,5,100,404,100,304,3,1179,668,1179,1303
144.695,6,39,15926,19,665,140,1460,3538,20,826,7606,1460,12388
34.307,6,30,7297,14,155,2639,267,1346,16,441,2286,1420,5951
1194.394,6,15,910,10,31,132710,31,555,5,31,298591,31,355
1.192,6,23,7952,12,164,91,267,1288,11,1216,101,3819,6664
6.045,6,38,8365,20,318,318,638,1846,18,482,345,3388,6519
240.309,6,44,8448,22,449,11443,1402,5648,22,206,11443,580,2800
1681.621,17,14,3799,7,30,280267,30,406,7,456,280268,463,3393
1788.748,6,401,84220,179,382,10048,1460,54669,222,184,8093,1460,29551
1787.626,6,102,8228,68,64,26680,64,4896,34,58,54167,58,3332
1788.989,6,402,33333,227,102,7915,469,16606,175,129,10281,1420,16727
615.126,6,76,5423,29,56,21964,311,2468,47,46,13369,78,2955
4.692,17,30,10301,13,408,391,1350,5676,17,244,172,1350,4625
2.422,6,34,6599,18,164,142,267,2050,16,780,149,1459,4549
1744.336,6,95,7203,63,38,28134,205,4476,32,33,56258,98,2727
0.429,6,48,20416,27,1014,16,1380,15334,21,421,20,1923,5082
11.568,6,25,8473,13,275,964,275,1078,12,986,747,1440,7395
16.244,6,13,3116,8,49,2320,92,523,5,1164,4013,1448,2593
4.135,6,32,6089,17,206,258,314,2744,15,548,274,1179,3345
69.765,17,16,1216,16,48,4651,48,1216,0,0,0,0,0
2.857,6,162,106213,87,1342,33,1432,94882,75,506,35,1432,11331
31.992,6,292,297875,106,136,304,331,5921,186,1551,172,2804,291954
0.108,6,12,3644,6,99,15,99,419,6,968,13,1448,3225
61.697,6,36,15843,22,796,2937,1368,9117,14,748,4723,2519,6726
240.314,6,52,17549,27,792,9242,1408,14887,25,169,10012,580,2662
3.219,6,2,88,2,0,0,0,88,0,0,0,0,0
1596.508,6,85,6125,56,31,29026,31,3780,29,31,57016,31,2345
23.017,17,4,558,2,36,23012,36,128,2,187,23012,187,430
162.813,17,4,240,2,32,162812,32,120,2,32,162811,32,120
9.697,6,89,27770,44,580,225,1152,21488,45,447,214,1179,6282
300.828,6,46,13674,25,858,12534,1360,7939,21,325,772,1360,5735
4.065,17,2,656,2,300,4065,300,656,0,0,0,0,0
1.803,6,26,8811,16,286,120,591,1503,10,986,177,2760,7308
1746.212,6,96,7286,63,38,28164,205,4476,33,33,54558,98,2810
0.925,6,10,1687,7,100,154,100,384,3,1179,328,1179,1303
0.28,6,11,1170,6,135,50,135,379,5,587,58,587,791
382.57,6,26,1703,17,177,23910,177,1117,9,110,10036,110,586
280.223,6,26,7272,12,158,25474,267,1277,14,678,21554,2045,5995
256.483,6,29,7089,14,229,150,498,1712,15,397,18314,1420,5377
1786.713,6,102,8296,68,65,26667,65,4930,34,59,54139,59,3366
0.502,6,51,21767,29,965,17,1380,16645,22,421,21,1923,5122
5.163,6,9,529,5,45,1290,45,313,4,0,1719,0,216
1785.753,6,102,8228,68,64,26653,64,4896,34,58,54111,58,3332
280.42,6,27,7312,13,158,23368,267,1317,14,678,21567,3456,5995
1798.279,6,356,22520,208,69,8687,69,12460,148,69,12233,69,10060
1750.534,1,64,5376,64,56,27786,56,5376,0,0,0,0,0
16.588,17,16,8951,9,736,2064,1350,6882,7,267,2749,1350,2069
1795.751,17,447,39580,403,35,4467,288,25676,44,288,40025,288,13904
2.178,17,4,734,3,46,1000,46,222,1,484,0,484,512
0.008,17,2,389,1,34,0,34,62,1,299,0,299,327
3.098,17,4,332,2,47,3094,47,150,2,63,3093,63,182
368.294,6,18,1242,14,180,28330,180,916,4,110,20068,110,326
0.309,17,2,198,1,39,0,39,67,1,103,0,103,131
360.964,2,6,192,6,8,72192,8,192,0,0,0,0,0
0.064,6,10,861,6,182,12,182,490,4,77,20,134,371
1784.892,6,356,22520,208,69,8622,69,12460,148,69,12140,69,10060
10.986,6,20,4442,11,275,1098,275,998,9,768,772,1440,3444
201.414,17,2,672,2,308,201414,308,672,0,0,0,0,0
12.482,6,12,716,4,106,4156,106,274,8,90,1781,90,442
0.161,6,9,1002,5,213,40,213,417,4,421,43,421,585
1.623,6,105,151841,32,283,52,884,3374,73,2096,22,5632,148467
0.616,17,4,560,2,64,386,64,184,2,160,381,160,376
601.589,2,5,160,5,8,150397,8,160,0,0,0,0,0
0.227,17,2,2754,2,1349,227,1349,2754,0,0,0,0,0
270.543,6,3,120,3,0,0,0,120,0,0,0,0,0
311.878,6,84,52484,36,241,8910,444,3085,48,1172,6635,1461,49399
1778.616,6,102,8172,68,63,26546,64,4868,34,57,53894,58,3304
240.24,6,56,20578,30,850,8283,1418,17725,26,186,9609,580,2853
0.094,17,8,2446,8,277,13,316,2446,0,0,0,0,0
33.805,6,32,5144,16,154,2253,721,1909,16,342,2241,2026,3235
0.091,1,2,112,2,28,91,28,112,0,0,0,0,0
140.78,17,4,352,2,60,140778,60,176,2,60,140779,60,176
84.266,6,31,14690,16,488,334,1360,3127,15,1216,6009,2720,11563
1760.004,6,308,52565,195,304,9072,304,38748,113,83,15714,83,13817
300.768,6,46,10040,24,540,13076,1360,4296,22,373,576,2667,5744
1790.825,1,342,28728,342,56,5251,56,28728,0,0,0,0,0
0.508,17,3,451,2,39,2,39,134,1,289,0,289,317
0.491,17,3,451,2,39,429,39,134,1,289,0,289,317
1740.473,17,30,31620,30,1026,60016,1026,31620,0,0,0,0,0
1786.886,6,102,8228,68,64,26669,64,4896,34,58,54143,58,3332
1786.424,6,111,8969,73,65,24811,65,5325,38,59,48279,59,3644
7.357,6,29,7464,12,155,668,267,1266,17,423,459,4260,6198
8.771,17,4,272,2,32,8738,32,120,2,48,8736,48,152
204.282,6,27,3434,15,304,14591,304,2300,12,83,18535,83,1134
0.032,6,12,3704,6,171,5,171,491,6,964,6,1448,3213
70.291,17,2,368,2,156,70291,156,368,0,0,0,0,0
1760.999,6,257,27070,127,114,13976,721,15397,130,174,13649,2840,11673
6.021,17,4,914,2,41,6011,41,138,2,360,5202,382,776
4.907,6,38,7229,20,218,258,314,3423,18,513,273,1179,3806
1771.25,6,99,9240,66,65,27250,65,5577,33,59,55348,59,3663
1681.832,17,14,1036,7,30,280303,30,406,7,62,280303,62,630
1793.884,6,360,22887,208,69,8666,69,12529,152,69,11879,69,10358
1798.575,6,2416,2253234,968,149,1859,878,64984,1448,1538,1242,11216,2188250
6.178,6,41,7349,21,218,308,314,3463,20,513,310,1179,3886
3.317,6,56,39724,26,814,132,1460,6773,30,1322,109,1607,32951
3.611,6,2,88,2,0,0,0,88,0,0,0,0,0
5.002,17,4,250,3,27,2501,58,166,1,56,0,56,84
34.262,17,20,1760,10,48,3805,48,760,10,72,3805,72,1000
0.307,6,3,376,3,256,153,256,376,0,0,0,0,0
0.237,6,22,5040,11,137,23,267,1132,11,692,23,1467,3908
280.253,6,30,7432,13,158,23354,267,1317,17,543,17515,1300,6115
7.247,6,1579,1463550,1004,1380,7,1408,1428986,575,931,12,2816,34564
4.913,6,42,8289,21,227,245,314,4022,21,489,232,1179,4267
283.542,6,30,7432,13,158,23628,267,1317,17,543,17697,1400,6115
5.004,17,4,288,2,36,5003,36,128,2,52,4962,52,160
1785.606,6,355,22480,207,69,8667,69,12420,148,69,12146,69,10060
118.371,6,23,6148,13,220,9864,516,1406,10,619,13141,1452,4742
61.869,6,70,46232,43,1155,1473,1408,38094,27,840,2370,2439,8138
0.003,17,2,128,1,36,0,36,64,1,36,0,36,64
2.716,17,476,529573,94,111,29,1350,13080,382,1324,7,1350,516493
6.768,6,28,7424,11,155,676,267,1226,17,423,422,2840,6198
9.268,6,36,8296,19,352,514,743,1862,17,522,570,3488,6434
281.483,6,30,7773,14,158,21652,267,1357,16,577,18764,2036,6416
1665.488,1,7,392,7,28,277581,28,392,0,0,0,0,0
41.619,6,41,9744,21,642,442,1360,4097,20,371,2181,1360,5647
0.102,17,2,136,1,32,0,32,60,1,48,0,48,76
1790.637,17,116,9280,58,48,31414,48,4408,58,56,31414,56,4872
376.126,6,19,1303,14,177,28932,177,925,5,110,18443,110,378
3.011,17,3,222,3,46,1505,46,222,0,0,0,0,0
0.476,17,8,2750,8,315,68,354,2750,0,0,0,0,0
1793.632,17,209,48453,209,203,8623,422,48453,0,0,0,0,0
0.09,17,2,255,1,43,0,43,71,1,156,0,156,184
4.323,6,37,7189,19,218,240,314,3383,18,513,239,1179,3806
1779.126,6,180,15480,120,69,14950,69,8940,60,69,30148,69,6540
0.407,6,7,371,4,0,135,0,204,3,7,97,7,167
0.457,6,50,20538,27,1018,17,1380,15376,23,421,18,1923,5162
0.269,17,2,384,1,39,0,39,67,1,289,0,289,317
64.165,6,24,11058,12,745,57,1360,3494,12,1178,5821,2580,7564
0.655,17,4,368,2,32,429,32,120,2,96,423,96,248
0.427,6,12,1653,6,288,80,288,548,6,426,47,434,1105
290.541,1,4,224,4,28,96847,28,224,0,0,0,0,0
3.012,17,4,268,4,39,1004,39,268,0,0,0,0,0
1763.239,17,150,24194,150,133,11833,373,24194,0,0,0,0,0
1744.522,6,95,7203,63,38,28137,205,4476,32,33,56261,98,2727
2.315,6,20,3833,11,234,231,564,1504,9,463,267,1343,2329
0.191,17,2,144,1,36,0,36,64,1,52,0,52,80
16.174,6,12,1153,7,181,2695,181,553,5,166,4042,206,600
1799.786,17,449,39928,404,35,4465,288,25708,45,288,40015,288,14220
48.508,6,28,7217,13,155,4042,267,1306,15,482,3464,1997,5911
1781.525,6,354,22440,207,69,8648,69,12420,147,69,12201,69,10020
1748.655,6,95,7203,63,38,28204,205,4476,32,33,56395,98,2727
15.382,17,10,760,10,48,1709,48,760,0,0,0,0,0
1772.175,6,180,15480,120,69,14892,69,8940,60,69,30034,69,6540
0.883,6,10,1687,7,100,147,100,384,3,1179,314,1179,1303
1.225,17,23,8189,11,444,122,1350,5202,12,220,108,1350,2987
42.816,6,10,1114,3,483,21408,483,635,7,83,7133,83,479
0.047,17,2,150,1,39,0,39,67,1,55,0,55,83
381.097,6,18,1242,14,180,29315,180,916,4,110,20060,110,326
874.363,6,208,20374,110,112,8021,1189,8583,98,178,9013,1380,11791
1647.665,1,7,392,7,28,274610,28,392,0,0,0,0,0
1208.875,17,225,17100,225,48,5396,48,17100,0,0,0,0,0
1.72,6,13,2311,8,188,245,245,700,5,1407,363,1407,1611
1782.764,6,165,10390,86,49,20973,208,6238,79,31,22852,31,4152
7.028,6,281,233372,161,133,43,201,7487,120,1905,57,7070,225885
261.567,6,30,7432,13,158,21797,267,1317,17,543,16346,1400,6115
372.434,6,23,1511,14,177,28648,177,925,9,110,8671,110,586
1740.463,17,30,31680,30,1028,60015,1028,31680,0,0,0,0,0
10.748,6,18,5610,10,275,1194,275,958,8,1440,820,1440,4652
92.514,6,78,53324,48,1215,1968,1368,45029,30,747,2135,1368,8295
162.54,17,555,332727,317,836,514,1350,273892,238,219,685,1350,58835
10.486,6,89,28186,45,559,238,1152,21944,44,447,236,1179,6242
1.154,17,4,892,2,32,1013,32,120,2,358,0,470,772
91.478,17,4,1344,4,308,30492,308,1344,0,0,0,0,0
39.085,17,22,1672,22,48,1861,48,1672,0,0,0,0,0
1790.72,6,191,24822,106,304,17054,304,17144,85,83,21318,83,7678
1799.986,6,215,25224,81,183,22499,1360,16786,134,47,13532,142,8438
1.024,17,4,272,2,40,1013,40,136,2,40,1013,40,136
71.775,6,41,15530,13,300,5981,1189,2633,28,534,2651,1420,12897
11.761,6,1911,1629477,1150,1362,10,1380,1594783,761,421,15,1923,34694
12.042,17,6,456,6,48,2408,48,456,0,0,0,0,0
1721.77,17,12,498,11,14,172177,14,462,1,8,0,8,36
1789.216,17,142,11360,71,48,25560,48,5396,71,56,25560,56,5964
0.284,6,21,7281,12,334,25,663,1969,9,967,34,1912,5312
0.738,6,46,22507,24,717,32,1448,4845,22,1031,34,1492,17662
1795.821,17,448,39896,403,35,4467,288,25676,45,288,40021,288,14220
0.955,17,3,1167,3,361,477,361,1167,0,0,0,0,0
26.392,1,32,3328,0,0,0,0,0,32,76,851,76,3328
245.874,6,32,8952,14,158,18913,267,1357,18,624,14461,1400,7595
291.775,1,4,224,4,28,97258,28,224,0,0,0,0,0
280.408,6,29,7392,13,158,23367,267,1317,16,678,18689,3456,6075
0.216,17,8,2750,8,315,30,354,2750,0,0,0,0,0
95.419,6,15,1083,4,177,115,177,393,11,110,9524,110,690
1795.933,6,383,27173,218,103,8276,469,15950,165,69,10950,69,11223
1783.818,6,350,22142,204,69,8787,69,12231,146,69,12302,69,9911
1.15,17,2,306,1,33,0,33,61,1,217,0,217,245
1764.014,2,11,352,11,8,176401,8,352,0,0,0,0,0
15.25,6,6,288,1,0,0,0,48,5,0,3810,0,240
224.155,17,6,2016,6,308,44831,308,2016,0,0,0,0,0
1776.275,17,73,3060,72,14,25017,14,3024,1,8,0,8,36
280.213,6,27,7312,12,158,25473,267,1277,15,678,20013,2045,6035
1779.356,17,142,11360,71,48,25419,48,5396,71,56,25419,56,5964
1783.815,6,353,22400,205,69,8720,69,12340,148,69,12134,69,10060
240.181,6,54,18987,29,808,8577,1402,16060,25,202,10007,580,2927
80.924,6,20,820,9,0,6084,0,364,11,0,8090,0,456
300.804,6,41,13611,23,892,13672,1360,8089,18,399,508,1360,5522
15.411,17,5,337,4,33,1333,33,244,1,65,0,65,93
1799.034,17,459,42280,405,35,4453,288,25544,54,281,32469,308,16736
1798.342,17,446,39264,402,35,4484,288,25360,44,288,40949,288,13904
0.049,17,2,230,1,59,0,59,87,1,115,0,115,143
10.939,6,20,4442,11,275,1093,275,998,9,768,773,1440,3444
6.894,17,73,52870,28,274,255,1350,8467,45,958,155,1350,44403
0.616,6,550,512088,344,183,1,230,19893,206,2360,2,11264,492195
26.165,17,2,152,2,48,26165,48,152,0,0,0,0,0
0.92,6,30,7453,17,426,57,1125,2431,13,498,62,1384,5022
0.05,17,4,344,2,47,1,47,150,2,69,0,75,194
1740.797,17,30,7050,30,207,60027,207,7050,0,0,0,0,0
0.583,6,27,9018,13,248,48,633,1678,14,941,41,1368,7340
3.352,17,4,352,4,60,1117,60,352,0,0,0,0,0
32.896,6,200,189015,69,136,483,330,3996,131,1403,252,1418,185019
18.401,6,9,520,3,0,9200,0,160,6,0,3114,0,360
1785.49,1,59,4956,59,56,30784,56,4956,0,0,0,0,0
1752.188,6,186,11385,93,47,19045,208,6735,93,31,19042,31,4650
1772.282,6,180,15480,120,69,14893,69,8940,60,69,30032,69,6540
240.247,6,58,18433,29,770,8579,1418,15386,29,191,8579,580,3047
10.496,6,1642,1523395,1023,1410,10,1448,1486543,619,776,16,1448,36852
1764.466,2,15,480,15,8,126033,8,480,0,0,0,0,0
2.199,17,3,451,2,39,484,39,134,1,289,0,289,317
34.486,6,27,6849,12,268,3135,517,1450,15,384,2451,1418,5399
1786.117,6,349,22309,200,69,8911,69,12140,149,69,12068,69,10169
0.497,6,24,7489,14,274,38,668,2109,10,968,52,1946,5380
0.314,17,8,2774,8,318,44,357,2774,0,0,0,0,0
33.873,6,4,160,0,0,0,0,0,4,0,0,0,160
44.09,17,6,2016,6,308,8818,308,2016,0,0,0,0,0
11.93,6,1906,1647999,1163,1364,10,1380,1614037,743,421,16,1923,33962
1443.824,2,18,576,18,8,84930,8,576,0,0,0,0,0
1788.56,17,87,3648,86,14,21041,14,3612,1,8,0,8,36
300.633,6,38,8566,19,315,16701,882,2053,19,441,471,1440,6513
1798.836,6,368,25690,213,99,8485,469,15005,155,69,11680,69,10685
0.029,17,2,136,1,32,0,32,60,1,48,0,48,76
503.827,2,5,160,5,8,125956,8,160,0,0,0,0,0
19.945,17,19,6350,9,428,2488,1350,4109,10,196,2212,1350,2241
58.409,6,10,648,10,31,6489,31,648,0,0,0,0,0
362.427,17,4,605,4,123,120809,355,605,0,0,0,0,0
10.632,6,297,241812,173,1339,61,1368,229966,124,749,84,1368,11846
383.477,6,13,968,11,106,38347,106,872,2,0,1007,0,96
33.546,6,27,7177,13,155,2795,267,1306,14,530,2579,3417,5871
92.941,6,34,7839,14,127,7149,267,1590,20,388,4881,1460,6249
1681.176,17,14,3843,7,30,280195,30,406,7,463,280195,463,3437
1787.715,6,102,8228,68,64,26682,64,4896,34,58,54170,58,3332
80.585,6,2,166,2,31,80585,31,166,0,0,0,0,0
1682.148,17,14,1036,7,30,280355,30,406,7,62,280355,62,630
17.249,6,8,440,5,0,4312,0,268,3,0,8615,0,172
1772.353,6,180,15480,120,69,14893,69,8940,60,69,30033,69,6540
35.448,6,13,2133,8,324,5064,585,1073,5,396,8857,580,1060
40.238,6,5226,4904131,3308,1402,12,1448,4799719,1918,776,20,1448,104412
618.047,6,95,21050,44,301,14373,1460,10279,51,242,12358,3089,10771
2.733,6,13,3463,6,188,546,245,620,7,853,414,1152,2843
30.587,6,6,360,0,0,0,0,0,6,0,0,0,360
1787.925,6,361,22858,210,69,8554,69,12678,151,69,11919,69,10180
300.82,6,42,9829,23,543,13673,1360,4222,19,371,480,1360,5607
0.312,6,10,1677,6,555,62,951,1354,4,159,103,159,323
3.983,17,10,1450,5,40,985,40,340,5,194,987,194,1110
1.339,6,50,19617,27,914,51,1440,13921,23,433,52,1440,5696
1.581,6,29,10373,17,368,98,837,1789,12,1012,135,1420,8584
0.15,6,44,21422,26,1101,6,1420,16481,18,467,8,1883,4941
3.844,17,56,47496,22,341,183,1350,8126,34,1129,93,1350,39370
116.227,6,22,8343,11,525,80,1237,2072,11,831,11605,1360,6271
0.041,17,2,180,1,30,0,30,58,1,94,0,94,122
362.349,1,9,1139,9,98,45293,142,1139,0,0,0,0,0
93.521,6,22,9200,11,499,81,1193,1995,11,964,9334,1360,7205
0.072,17,4,284,2,32,24,32,120,2,54,49,60,164
240.179,6,52,17885,28,809,8895,1402,15219,24,201,10442,580,2666
280.274,6,29,7392,13,158,23356,267,1317,16,603,18681,1400,6075
1064.301,6,68,5355,42,65,25958,65,2980,26,53,42384,59,2375
1680.746,17,12,498,11,14,168074,14,462,1,8,0,8,36
12.729,6,25,2370,12,222,1156,222,1372,13,231,1060,231,998
299.549,6,6,364,4,31,99849,31,222,2,31,299529,31,142
1.82,17,4,240,2,32,1819,32,120,2,32,1818,32,120
243.81,17,4,1081,4,242,81270,687,1081,0,0,0,0,0
1797.046,17,449,39928,404,35,4459,288,25708,45,288,40022,288,14220
93.627,6,21,9221,11,514,84,1236,2014,10,1132,10382,2720,7207
118.923,6,28,8792,14,158,9147,267,1357,14,981,9145,3445,7435
5.489,6,59,46237,27,830,210,1143,6395,32,1363,176,2896,39842
2.024,6,14,2351,8,188,289,245,700,6,703,355,1152,1651
1744.904,6,95,7203,63,38,28143,205,4476,32,33,56273,98,2727
1797.03,17,142,11360,71,48,25671,48,5396,71,56,25671,56,5964
1792.09,17,180,14040,180,50,10011,50,14040,0,0,0,0,0
25.739,6,2096,1838046,1281,1376,20,1380,1796736,815,383,31,1380,41310
277.745,6,31,8912,14,158,21365,267,1357,17,687,17357,1781,7555
305.594,6,274,197985,163,1353,1886,1460,185308,111,195,136,1460,12677
1770.25,6,112,10354,71,66,25289,66,6038,41,60,44253,60,4316
1792.217,1,58,4872,58,56,31442,56,4872,0,0,0,0,0
0.884,17,2,152,1,48,0,48,76,1,48,0,48,76
280.64,6,30,7432,13,158,23386,267,1317,17,603,17529,2076,6115
1.457,6,10,1687,7,100,242,100,384,3,1179,604,1179,1303
1771.725,6,99,9240,66,65,27257,65,5577,33,59,55363,59,3663
280.384,6,30,7432,13,158,23365,267,1317,17,543,17519,1400,6115
11.854,6,16,4090,8,275,1693,275,878,8,1440,1431,1440,3212
1746.559,6,102,7970,66,45,26870,205,4902,36,35,49890,98,3068
0.059,6,10,1802,6,617,11,1077,1479,4,159,19,159,323
0.017,17,3,234,2,39,0,39,134,1,72,0,72,100
7.036,17,3,192,2,36,2982,36,128,1,36,0,36,64
10.492,6,10,634,6,43,2098,43,406,4,0,3494,0,228
1792.8,6,358,22669,209,69,8619,69,12500,149,69,12111,69,10169
1786.382,6,102,8296,68,65,26662,65,4930,34,59,54130,59,3366
1.269,6,10,1687,7,100,211,100,384,3,1179,502,1179,1303
8.141,6,42,8289,21,227,407,314,4022,21,489,394,1179,4267
0.008,17,2,382,1,33,0,33,61,1,293,0,293,321
82.617,6,33,23866,19,840,33,1360,5871,14,1935,6345,8157,17995
1.536,6,13,2311,8,188,219,245,700,5,1407,320,1407,1611
1786.411,6,104,8376,68,65,26662,65,4930,36,59,51037,59,3446
215.634,17,4,240,2,32,215633,32,120,2,32,215633,32,120
1795.486,6,375,26177,217,98,8312,469,15303,158,69,11435,69,10874
23.935,6,971,826735,573,1359,41,1368,797921,398,792,59,1473,28814
1793.896,17,142,11360,71,48,25626,48,5396,71,56,25626,56,5964
300.841,6,38,16625,23,195,13674,431,2044,15,1532,5136,7064,14581
1679.497,17,12,498,11,14,167949,14,462,1,8,0,8,36
65.09,6,27,7177,13,155,5424,267,1306,14,530,5006,3417,5871
1.937,6,8,335,4,0,645,0,164,4,7,311,7,171
25.682,6,38,9109,17,303,1605,722,2812,21,605,1273,1380,6297
368.434,6,23,1499,14,177,28341,177,913,9,110,9474,110,586
1.089,6,25,6675,13,350,89,1088,2275,12,783,98,1420,4400
1729.217,6,63,4601,41,33,43230,33,2825,22,31,82334,31,1776
240.639,2,4,128,4,8,80213,8,128,0,0,0,0,0
1644.885,1,7,392,7,28,274147,28,392,0,0,0,0,0
1772.372,6,180,15480,120,69,14893,69,8940,60,69,30039,69,6540
379.204,6,25,1651,17,177,23700,177,1117,8,110,9308,110,534
1082.991,6,225,14382,128,72,8527,138,8018,97,69,11281,69,6364
61.305,6,11,1583,11,127,6130,127,1583,0,0,0,0,0
1740.692,17,30,31680,30,1028,60023,1028,31680,0,0,0,0,0
1799.531,1,254,14224,254,28,7112,28,14224,0,0,0,0,0
134.441,2,4,128,4,8,44813,8,128,0,0,0,0,0
11.126,6,24,6832,12,275,1007,517,1735,12,744,1007,1408,5097
70.009,6,36,11010,15,182,5000,267,2067,21,539,3494,1460,8943
20.522,17,18,7888,8,480,2927,1350,4065,10,354,2276,1350,3823
1.441,6,4,172,2,0,1441,0,84,2,0,1027,0,88
17.654,17,33,13933,16,611,1175,1350,10238,17,189,1101,1350,3695
1.206,17,4,308,2,33,999,33,122,2,65,1014,65,186
16.885,17,27,8156,14,386,1296,1350,5805,13,152,1404,1350,2351
0.294,17,2,196,1,62,0,62,90,1,78,0,78,106
37.985,6,47,10557,23,723,685,1360,4640,24,309,1644,2667,5917
1799.253,1,57,4788,0,0,0,0,0,57,56,32129,56,4788
1797.56,1,345,28980,345,56,5225,56,28980,0,0,0,0,0
0.04,17,4,330,2,33,0,33,122,2,76,1,82,208
3.092,6,33,19316,18,783,181,1360,6223,15,1386,208,2720,13093
280.258,6,29,7392,13,158,23354,267,1317,16,603,18682,2036,6075
1772.147,6,180,15480,120,69,14891,69,8940,60,69,30031,69,6540
0.363,6,11,1007,6,256,70,256,500,5,303,87,303,507
20.144,6,21,5418,12,107,1831,159,1074,9,967,2516,1659,4344
1797.133,1,345,28980,345,56,5224,56,28980,0,0,0,0,0
62.633,6,27,5749,12,150,763,174,784,15,363,4467,1420,4965
2.515,6,14,2351,8,188,359,245,700,6,703,452,1152,1651
1797.014,17,763,46018,763,32,2358,37,46018,0,0,0,0,0
2.749,17,4,624,4,128,916,128,624,0,0,0,0,0
1772.51,6,212,24871,134,98,13327,469,12093,78,130,23014,1997,12778
1264.217,6,153,18013,91,78,13044,267,7186,62,151,20723,1917,10827
1717.813,1,8,448,8,28,245401,28,448,0,0,0,0,0
0.152,17,2,136,1,32,0,32,60,1,48,0,48,76
10.83,6,2190,2044804,1399,1383,7,1408,1998996,791,931,13,2816,45808
2.114,6,58,14345,28,499,78,1429,5158,30,398,70,1460,9187
11.362,6,1786,1571129,1070,1414,10,1432,1538244,716,420,15,1432,32885
179.068,6,25,8320,13,201,60,290,1167,12,832,16267,3068,7153
1.381,6,40,11338,21,616,69,1460,5802,19,476,66,2615,5536
1799.032,6,355,22480,207,69,8633,69,12420,148,69,12237,69,10060
414.554,1,12,672,12,28,37686,28,672,0,0,0,0,0
1630.16,1,8,848,8,78,232880,78,848,0,0,0,0,0
0.037,17,2,200,1,48,0,48,76,1,96,0,96,124
68.259,6,32,13131,16,0,4396,0,664,16,739,4550,966,12467
1565.661,1,21,2366,21,84,78283,125,2366,0,0,0,0,0
1763.401,1,98,10388,98,78,18179,78,10388,0,0,0,0,0
1777.865,1,58,4872,0,0,0,0,0,58,56,31190,56,4872
240.33,6,46,9048,24,524,10448,1418,5972,22,213,11443,617,3076
1790.329,1,58,4872,0,0,0,0,0,58,56,31409,56,4872
1797.08,17,144,11520,72,48,25310,48,5472,72,56,25310,56,6048
5.5,6,13,5758,3,106,2750,106,234,10,639,590,1452,5524
1.198,6,45,19134,27,894,46,1360,13638,18,529,60,4075,5496
0.051,17,2,290,1,40,0,40,68,1,194,0,194,222
1783.518,17,82,3438,81,14,22293,14,3402,1,8,0,8,36
93.643,6,65,43437,41,1189,2341,1448,35435,24,749,2673,1448,8002
1.34,17,25,15133,12,1000,121,1350,12336,13,187,108,1350,2797
1773.774,6,181,15589,121,69,14781,69,9049,60,69,30062,69,6540
0.442,6,26,7751,16,339,29,949,3017,10,721,46,1460,4734
114.211,1,20,1680,20,56,6011,56,1680,0,0,0,0,0
1.018,17,2,279,1,36,0,36,64,1,187,0,187,215
1785.591,6,362,22898,210,69,8543,69,12678,152,69,11825,69,10220
319.066,6,71,18468,34,342,9668,1460,9269,37,350,8852,1629,9199
1754.014,6,184,11305,92,47,19274,208,6695,92,31,19272,31,4610
4.254,6,21,3652,12,121,386,126,996,9,363,521,1140,2656
1783.308,6,127,15264,81,90,22291,502,6763,46,162,39627,1420,8501
1785.861,6,378,26697,217,103,8267,469,15841,161,69,11161,69,10856
1.232,6,29,11078,16,451,82,1360,3382,13,1432,88,3942,7696
1740.407,17,30,31680,30,1028,60014,1028,31680,0,0,0,0,0
0.025,17,4,764,3,60,5,60,264,1,472,0,472,500
1782.141,17,79,3312,78,14,23144,14,3276,1,8,0,8,36
23.43,17,43,10785,20,272,1231,1350,6010,23,179,1063,1350,4775
117.545,1,6,336,6,28,23509,28,336,0,0,0,0,0
1776.125,6,181,15589,120,69,14925,69,8940,61,69,29592,69,6649
0.209,6,46,22002,27,1061,8,1420,17021,19,467,11,1883,4981
41.139,6,28,7217,13,155,3428,267,1306,15,482,2937,1997,5911
292.011,6,34,7028,16,262,19464,517,1628,18,744,17174,1418,5400
299.159,17,4,352,2,60,299158,60,176,2,60,299157,60,176
369.434,6,46,4221,26,67,14777,96,2276,20,57,19090,59,1945
1792.86,17,179,11456,179,36,10072,36,11456,0,0,0,0,0
10.486,6,20,7026,11,275,1048,275,998,9,1414,716,1414,6028
0.495,17,22,15031,12,1014,44,1350,12511,10,224,51,1350,2520
349.845,1,12,1272,12,78,31804,78,1272,0,0,0,0,0
7.657,6,904,760545,530,1355,14,1408,736433,374,931,20,2816,24112
377.266,2,3,96,3,8,188633,8,96,0,0,0,0,0
0.02,17,2,358,1,30,0,30,58,1,272,0,272,300
60.61,6,8,376,2,0,60610,0,88,6,0,6312,0,288
23.342,6,3829,3615202,2489,1374,9,1408,3540858,1340,931,17,2816,74344
1792.333,1,58,4872,0,0,0,0,0,58,56,31444,56,4872
3.613,6,12,507,6,0,722,0,248,6,7,516,7,259
1681.314,17,14,1036,7,30,280215,30,406,7,62,280215,62,630
1773.69,1,58,4872,0,0,0,0,0,58,56,31117,56,4872
1.031,6,2,80,1,0,0,0,40,1,0,0,0,40
0.122,17,2,212,1,46,0,46,74,1,110,0,110,138
1794.932,1,58,4872,58,56,31490,56,4872,0,0,0,0,0
1786.573,17,87,3648,86,14,21018,14,3612,1,8,0,8,36
562.094,6,74,5516,29,67,20070,295,2655,45,48,12772,78,2861
369.555,6,19,1306,14,180,28427,180,928,5,110,15168,110,378
1795.131,17,448,39896,403,35,4465,288,25676,45,288,40019,288,14220
1786.911,6,104,8376,68,65,26670,65,4930,36,59,51050,59,3446
1796.234,6,415,24880,207,69,8719,69,12420,208,34,8677,48,12460
842.258,2,9,288,9,8,105282,8,288,0,0,0,0,0
0.308,17,2,157,1,31,0,31,59,1,70,0,70,98
1785.82,1,171,9576,171,28,10504,28,9576,0,0,0,0,0
1794.821,17,87,3648,86,14,21115,14,3612,1,8,0,8,36
2.201,1,9,756,9,56,275,56,756,0,0,0,0,0
0.995,17,4,368,2,64,993,64,184,2,64,993,64,184
125.902,2,2,64,2,8,125902,8,64,0,0,0,0,0
1799.955,17,140,11184,72,48,25350,48,5472,68,56,26863,56,5712
0.539,17,17,5678,7,316,89,1350,2413,10,298,50,1350,3265
1786.81,6,102,8364,68,66,26668,66,4964,34,60,54142,60,3400
2.988,6,12219,11063851,5991,265,0,265,319025,6228,1674,0,14080,10744826
1795.431,6,357,22629,209,69,8631,69,12569,148,69,12213,69,10060
1770.995,6,102,9396,66,65,27246,65,5577,36,59,50597,59,3819
505.985,6,4663,4486729,1670,477,303,522,102474,2993,1417,161,7190,4384255
0.088,17,2,279,1,36,0,36,64,1,187,0,187,215
2.565,6,35,13618,20,511,135,1360,3431,15,956,170,2720,10187
86.81,6,38,8302,20,317,4568,636,1795,18,444,499,2128,6507
1799.793,1,118,6608,118,28,15382,28,6608,0,0,0,0,0
3.064,17,4,332,2,47,3057,47,150,2,63,3055,63,182
10.805,6,18,5610,10,275,1200,275,958,8,1440,825,1440,4652
1740.541,17,30,31680,30,1028,60018,1028,31680,0,0,0,0,0
161.723,6,38,9497,19,450,3195,766,2593,19,438,8977,3488,6904
0.074,17,2,427,1,39,0,39,67,1,332,0,332,360
1.271,6,38,8356,19,336,70,1254,2820,19,476,61,2715,5536
1791.638,6,356,22520,208,69,8655,69,12460,148,69,12187,69,10060
264.574,6,246,50438,149,295,1787,1370,22536,97,240,2755,1328,27902
1298.688,17,82,27552,82,308,16033,308,27552,0,0,0,0,0
110.063,17,4,558,2,36,110057,36,128,2,187,110058,187,430
0.803,17,12,5557,6,490,160,1350,3113,6,379,119,1350,2444
0.803,6,354,274018,173,194,4,230,9939,181,1422,3,2816,264079
0.042,17,4,284,2,32,36,32,120,2,54,36,60,164
1770.048,6,101,9344,66,65,27231,65,5577,35,59,52055,59,3767
146.139,6,109,81772,70,1258,2117,1408,71622,39,811,2401,3847,10150
1.749,6,13,2311,8,188,249,245,700,5,1407,371,1407,1611
0.25,6,50,40610,21,180,12,250,1642,29,1387,4,1735,38968
187.586,6,36,8227,14,131,14428,267,1622,22,336,8932,1460,6605
1.436,6,12,1040,6,283,255,283,615,6,105,252,105,425
10.798,6,18,5610,10,275,1199,275,958,8,1440,824,1440,4652
1681.163,17,14,3815,7,30,280193,30,406,7,459,280193,463,3409
0.451,6,25,7711,16,339,30,949,3017,9,721,54,1420,4694
0.048,6,9,1348,5,145,12,145,349,4,835,13,835,999
1799.233,17,142,11360,71,48,25703,48,5396,71,56,25703,56,5964
1788.017,6,361,22858,210,69,8555,69,12678,151,69,11919,69,10180
2.397,6,14,2351,8,188,342,245,700,6,703,430,1152,1651
32.596,17,4,352,2,60,32595,60,176,2,60,32595,60,176
0.053,1,2,112,2,28,53,28,112,0,0,0,0,0
278.613,17,4,352,2,60,278612,60,176,2,60,278612,60,176
3.494,17,2,656,2,300,3494,300,656,0,0,0,0,0
0.147,17,2,672,2,308,147,308,672,0,0,0,0,0
3.234,17,2,656,2,300,3234,300,656,0,0,0,0,0
117.126,17,4,240,2,32,117125,32,120,2,32,117124,32,120
280.491,6,30,7432,13,158,23374,267,1317,17,603,17528,2760,6115
206.307,6,28,8792,13,158,17192,267,1317,15,858,14734,3436,7475
19.81,17,18,7831,8,484,2826,1350,4103,10,344,2197,1350,3728
21.031,17,4,288,2,36,21020,36,128,2,52,21015,52,160
55.155,6,43,8756,21,345,799,720,1967,22,368,2620,3488,6789
1745.331,6,95,7203,63,38,28150,205,4476,32,33,56287,98,2727
1772.339,6,180,15480,120,69,14893,69,8940,60,69,30035,69,6540
215.338,2,5,160,5,8,53834,8,160,0,0,0,0,0
1794.123,17,80,3354,79,14,23001,14,3318,1,8,0,8,36
0.064,17,2,180,1,30,0,30,58,1,94,0,94,122
12.508,6,1646,1498923,984,1438,12,1448,1456615,662,776,18,1448,42308
0.058,6,9,902,5,201,14,201,405,4,333,13,333,497
0.188,17,4,420,2,33,174,33,122,2,121,174,145,298
0.184,17,2,167,1,39,0,39,67,1,72,0,72,100
1635.319,1,7,392,7,28,272553,28,392,0,0,0,0,0
0.032,6,9,1612,5,636,8,636,904,4,492,10,492,708
78.036,1,4,224,4,28,26012,28,224,0,0,0,0,0
126.128,17,4,240,2,32,126127,32,120,2,32,126126,32,120
0.382,6,10,1992,5,288,89,288,508,5,424,50,434,1484
9.968,6,66,25010,34,845,302,1380,17517,32,558,320,1923,7493
1.094,17,2,154,1,33,0,33,61,1,65,0,65,93
2.967,6,2,88,2,0,0,0,88,0,0,0,0,0
76.873,6,68,48456,45,1193,1747,1408,40525,23,961,2800,3847,7931
1798.947,6,355,22480,207,69,8732,69,12420,148,69,12237,69,10060
37.681,6,28,7217,13,155,3140,267,1306,15,482,2690,1997,5911
43.645,6,22,6555,12,350,3967,1088,2235,10,979,4848,1731,4320
1774.915,17,200,50824,200,226,8919,422,50824,0,0,0,0,0
280.339,6,30,7432,13,158,23361,267,1317,17,543,17519,1400,6115
0.472,6,13,1693,7,288,75,288,588,6,426,54,434,1105
58.371,6,97,25258,45,529,1326,1440,15114,52,276,1141,1440,10144
1750.16,6,142,8629,77,42,23028,208,5099,65,31,27339,31,3530
1751.174,6,119,9542,75,66,23664,66,5442,44,60,40722,60,4100
0.013,17,2,296,1,28,0,28,56,1,212,0,212,240
17.011,6,1999,1650530,1155,1369,14,1380,1607445,844,558,20,1923,43085
1772.297,6,180,15480,120,69,14893,69,8940,60,69,30037,69,6540
1797.984,6,369,24792,214,87,8441,469,14245,155,69,11674,69,10547
7.525,6,1757,1709131,1173,1383,6,1408,1674099,584,776,12,1408,35032
240.002,1,2,240,2,92,240002,92,240,0,0,0,0,0
1785.77,6,102,8296,68,65,26653,65,4930,34,59,54111,59,3366
240.197,6,53,16302,28,698,8895,1402,13338,25,207,10007,580,2964
24.974,17,4,240,2,32,24974,32,120,2,32,24973,32,120
557.8,6,36,2786,18,64,25496,64,1296,18,45,32807,58,1490
10.508,17,4,352,2,48,10477,48,152,2,72,10480,72,200
459.964,6,120,44178,60,836,7795,1418,38263,60,163,7795,580,5915
0.028,17,2,189,1,30,0,30,58,1,103,0,103,131
1082.394,1,62,3472,62,28,17744,28,3472,0,0,0,0,0
385.064,6,18,1242,14,180,29620,180,916,4,110,20072,110,326
0.288,6,10,767,5,186,41,186,454,5,45,70,45,313
280.2,6,28,7352,13,158,23350,267,1317,15,678,20012,3436,6035
1796.279,17,449,39928,404,35,4457,288,25708,45,288,40016,288,14220
8.152,6,862,786053,557,1337,14,1368,763341,305,931,26,2841,22712
0.508,17,3,234,2,39,471,39,134,1,72,0,72,100
1742.087,6,95,7203,63,38,28098,205,4476,32,33,56189,98,2727
32.095,17,4,1344,4,308,10698,308,1344,0,0,0,0,0
1700.412,17,12,498,11,14,170041,14,462,1,8,0,8,36
1.564,6,47,18592,27,846,60,1360,13016,20,529,72,4075,5576
97.804,6,20,4572,8,271,176,515,1139,12,327,8881,1452,3433
0.009,6,6,464,3,136,2,136,300,3,0,4,0,164
1772.593,6,181,15589,120,69,14895,69,8940,61,69,29542,69,6649
1793.622,17,144,11520,72,48,25262,48,5472,72,56,25262,56,6048
1618.647,1,8,448,8,28,231235,28,448,0,0,0,0,0
27.617,6,48,13199,21,186,1269,722,2521,27,639,1053,1380,10678
1.127,17,19,8534,9,590,140,1350,5565,10,268,95,1350,2969
2.459,6,10,1347,4,299,819,299,515,6,246,434,459,832
280.678,6,30,7432,13,158,23389,267,1317,17,603,17540,2076,6115
1770.848,6,99,9306,66,66,27243,66,5610,33,60,55336,60,3696
1797.36,1,345,28980,345,56,5224,56,28980,0,0,0,0,0
256.435,17,4,304,2,48,256422,48,152,2,48,256421,48,152
1763.982,2,13,416,13,8,146998,8,416,0,0,0,0,0
0.03,6,10,861,6,182,6,182,490,4,77,8,134,371
0.064,17,4,284,2,32,0,32,120,2,54,2,60,164
11.328,17,3,228,3,48,5664,48,228,0,0,0,0,0
3.919,17,5,290,5,30,979,30,290,0,0,0,0,0
1780.513,17,138,11040,69,48,26183,48,5244,69,56,26183,56,5796
75.872,6,35,8268,13,159,6322,267,1642,22,318,3610,1460,6626
1740.543,17,30,31680,30,1028,60018,1028,31680,0,0,0,0,0
1.215,17,2,152,1,48,0,48,76,1,48,0,48,76
1773.259,6,181,15589,120,69,14901,69,8940,61,69,29550,69,6649
3.269,6,13,547,7,0,544,0,288,6,7,613,7,259
1775.258,1,60,5040,60,56,30089,56,5040,0,0,0,0,0
41.806,17,4,1356,4,311,13935,320,1356,0,0,0,0,0
1744.657,2,25,800,25,8,72694,8,800,0,0,0,0,0
0.03,17,2,261,1,30,0,30,58,1,175,0,175,203
239.937,1,36,3744,0,0,0,0,0,36,76,6855,76,3744
1787.125,6,359,22709,209,69,8591,69,12569,150,69,11994,69,10140
1742.483,17,29,6699,29,203,62231,203,6699,0,0,0,0,0
403.478,6,63,11735,27,115,14615,722,3028,36,297,11522,1448,8707
663.081,6,93,12859,55,87,12279,267,4579,38,204,17914,1420,8280
31.738,6,13,2133,8,324,4534,585,1073,5,396,7878,580,1060
1682.127,17,14,1036,7,30,280346,30,406,7,62,280347,62,630
1740.559,17,30,31919,30,1035,60019,1064,31919,0,0,0,0,0
1791.892,1,57,4788,0,0,0,0,0,57,56,31998,56,4788
5.279,2,2,64,2,8,5279,8,64,0,0,0,0,0
1736.669,1,66,6996,66,78,26717,78,6996,0,0,0,0,0
0.155,6,9,1339,5,145,38,145,349,4,826,30,826,990
366.856,6,18,1239,14,177,28219,177,913,4,110,20056,110,326
1793.183,6,393,25242,222,69,8113,69,13434,171,69,10548,69,11808
1772.231,6,180,15480,120,69,14892,69,8940,60,69,30032,69,6540
241.664,6,52,11416,24,461,10506,1418,5914,28,336,8950,780,5502
235.167,6,31,6765,13,186,9735,502,1458,18,305,13828,1420,5307
0.123,17,2,212,1,46,0,46,74,1,110,0,110,138
2.339,6,32,9065,20,288,123,598,1670,12,987,194,1456,7395
11.207,6,44,8385,22,227,533,314,4062,22,491,521,1179,4323
2.978,17,3,1167,3,361,1489,361,1167,0,0,0,0,0
1783.232,6,361,24265,210,88,8532,469,13878,151,69,11887,69,10387
1770.183,6,99,9240,66,65,27233,65,5577,33,59,55315,59,3663
0.871,6,10,1687,7,100,145,100,384,3,1179,309,1179,1303
3.016,17,4,292,2,37,3009,37,130,2,53,3009,53,162
1786.803,6,106,8456,68,65,26668,65,4930,38,59,48289,59,3526
4.091,6,39,7269,20,218,215,314,3423,19,440,213,1152,3846
40.343,17,4,824,2,48,40336,48,152,2,308,40335,308,672
0.1,17,2,166,1,47,0,47,75,1,63,0,63,91
1791.034,6,356,22520,208,69,8652,69,12460,148,69,12183,69,10060
0.104,1,2,112,2,28,104,28,112,0,0,0,0,0
0.499,6,7,295,4,0,166,0,164,3,7,102,7,131
5.678,6,40,7309,20,218,298,314,3423,20,513,284,1179,3886
18.143,17,4,824,2,48,18132,48,152,2,308,18130,308,672
0.024,17,2,537,1,32,0,32,60,1,449,0,449,477
2.232,17,3,1176,3,364,1116,364,1176,0,0,0,0,0
1783.859,6,104,8435,69,65,26233,65,4970,35,59,52463,59,3465
1793.798,6,123,7891,72,48,25264,208,4828,51,31,35869,31,3063
1741.546,6,87,6322,58,31,30553,31,3915,29,31,62197,31,2407
0.199,6,9,1340,5,145,49,145,349,4,827,58,827,991
0.039,17,4,284,2,32,18,32,120,2,54,24,60,164
1743.802,6,104,7550,66,31,26827,31,4503,38,31,47129,31,3047
81.03,6,110,85973,73,1243,1125,1408,75930,37,811,2244,3847,10043
0.514,6,28,9226,13,273,42,733,1778,15,831,33,1368,7448
60.685,6,27,7177,13,155,5057,267,1306,14,530,4667,3417,5871
216.161,17,4,240,2,32,216160,32,120,2,32,216160,32,120
0.027,17,4,284,2,32,0,32,120,2,54,14,60,164
0.024,17,2,304,1,49,0,49,77,1,199,0,199,227
0.016,17,2,167,1,31,0,31,59,1,80,0,80,108
0.396,6,2,126,1,0,0,0,40,1,46,0,46,86
5.052,17,4,288,2,36,5021,36,128,2,52,5020,52,160
0.44,6,9,1340,5,145,110,145,349,4,827,143,827,991
69.819,6,24,9050,12,649,94,1360,3109,12,908,6327,1747,5941
1700.576,17,13,534,11,14,170040,14,462,2,8,1700407,8,72
3.318,6,2,88,2,0,0,0,88,0,0,0,0,0
0.59,6,133,88221,72,1288,8,1420,81490,61,427,9,1420,6731
20.302,6,24,5586,13,107,1691,159,1126,11,773,2024,1368,4460
0.188,17,2,586,1,46,0,46,74,1,484,0,484,512
1.017,17,2,116,2,30,1017,30,116,0,0,0,0,0
1.441,6,49,20077,27,950,55,1460,14421,22,476,59,2920,5656
1798.172,17,448,39896,403,35,4473,288,25676,45,288,40019,288,14220
280.069,6,29,7392,13,158,23339,267,1317,16,603,18666,1400,6075
0.198,6,3,1536,2,708,0,1360,1496,1,0,0,0,40
15.665,17,22,15066,11,641,1563,1350,7368,11,671,1563,1350,7698
102.499,6,12,9831,3,100,146,100,224,9,1155,12781,1179,9607
1799.996,6,208,14392,76,46,23599,46,6076,132,46,13740,46,8316
660.739,17,50,3984,27,48,25413,48,2052,23,56,25384,56,1932
20.137,17,4,824,2,48,20131,48,152,2,308,20129,308,672
1769.894,6,101,9344,66,65,27229,65,5577,35,59,52052,59,3767
1794.433,17,144,11520,72,48,25273,48,5472,72,56,25273,56,6048
232.383,1,2,212,2,78,232383,78,212,0,0,0,0,0
11.674,6,1883,1612843,1140,1363,10,1380,1576925,743,475,15,1923,35918
63.355,6,83,53722,47,1211,1377,1408,44863,36,746,1801,1408,8859
1795.801,17,447,39864,402,35,4478,288,25644,45,288,40015,288,14220
1787.615,6,115,13762,75,82,24156,516,5965,40,162,45833,1452,7797
564.488,6,78,12483,38,181,15256,1189,4254,40,264,5872,1917,8229
195.841,17,4,352,2,60,195840,60,176,2,60,195839,60,176
5.415,6,39,7269,19,218,300,314,3383,20,513,268,1179,3886
68.573,6,14,3161,8,92,9796,92,516,6,2329,13675,2329,2645
4.967,6,37,10750,18,231,292,688,3031,19,832,272,1368,7719
421.146,2,3,96,3,8,210573,8,96,0,0,0,0,0
0.168,6,2,339,1,259,0,259,299,1,0,0,0,40
6.004,17,4,390,2,44,6000,44,144,2,95,5997,95,246
0.124,17,2,152,1,40,0,40,68,1,56,0,56,84
1787.236,6,102,8364,68,66,26675,66,4964,34,60,54155,60,3400
8.933,6,45,8409,24,227,388,314,4142,21,489,418,1179,4267
4.278,17,16,15542,6,703,855,1350,4387,10,1087,418,1350,11155
240.223,6,55,17755,30,738,8283,1402,14860,25,198,10009,580,2895
1796.656,17,449,39928,404,35,4458,288,25708,45,288,40021,288,14220
1795.823,1,260,14560,260,28,6933,28,14560,0,0,0,0,0
0.094,17,2,1920,2,932,94,932,1920,0,0,0,0,0
27.691,17,48,59016,9,1100,506,1350,10153,39,1224,727,1350,48863
0.597,6,12,1653,6,288,113,288,548,6,426,63,434,1105
0.961,6,10,1687,7,100,160,100,384,3,1179,353,1179,1303
256.122,17,4,352,2,60,256121,60,176,2,60,256121,60,176
1.353,6,50,20971,28,944,50,1440,15315,22,433,56,1440,5656
280.235,6,31,7472,14,158,21556,267,1357,17,543,17509,1400,6115
353.994,1,6,336,6,28,70798,28,336,0,0,0,0,0
0.226,6,22,5040,10,137,25,267,1092,12,577,20,1400,3948
1787.09,6,102,8228,68,64,26672,64,4896,34,58,54151,58,3332
300.983,6,57,24069,29,982,10749,1448,12386,28,537,531,1448,11683
1782.62,6,106,8456,68,65,26606,65,4930,38,59,48176,59,3526
0.171,17,4,352,2,37,167,37,130,2,83,167,89,222
1.347,6,41,8441,21,320,67,1162,2820,20,437,61,2715,5621
240.188,6,53,17441,28,763,8895,1408,14441,25,211,10007,580,3000
1788.387,6,356,22520,208,69,8639,69,12460,148,69,12165,69,10060
0.014,17,4,304,2,37,10,37,130,2,59,8,65,174
0.602,6,11,976,5,283,103,283,551,6,105,80,105,425
3.832,17,4,1564,4,363,1277,363,1564,0,0,0,0,0
0.437,17,4,502,2,31,428,31,118,2,164,424,164,384
7.324,6,976,838946,569,1394,12,1448,813118,407,776,17,1448,25828
639.168,17,12,4485,12,345,58106,357,4485,0,0,0,0,0
1729.255,6,62,4504,40,33,44339,33,2740,22,31,82332,31,1764
1796.098,17,448,39896,403,35,4467,288,25676,45,288,40020,288,14220
0.11,17,2,268,1,54,0,54,82,1,158,0,158,186
5.021,17,3,433,2,37,5009,37,130,1,275,0,275,303
1787.44,6,102,8228,68,64,26678,64,4896,34,58,54160,58,3332
1760.618,6,4278,3872986,1619,150,1088,963,101673,2659,1405,662,4254,3771313
0.005,17,2,316,1,30,0,30,58,1,230,0,230,258
0.259,17,3,451,2,39,18,39,134,1,289,0,289,317
6.292,6,1028,873435,612,1380,10,1420,852574,416,467,15,1883,20861
1791.119,6,635,49500,280,38,6419,1448,21717,355,50,5059,1448,27783
0.524,17,3,451,2,39,434,39,134,1,289,0,289,317
0.427,6,51,23519,29,1075,15,1380,18397,22,421,17,1923,5122
0.008,17,2,142,1,43,0,43,71,1,43,0,43,71
81.215,17,4,240,2,32,81211,32,120,2,32,81214,32,120
0.497,17,3,451,2,39,276,39,134,1,289,0,289,317
8.296,6,19,6831,10,275,921,275,683,9,1155,929,1420,6148
73.95,6,22,8585,11,556,91,1330,2141,11,856,7375,1360,6444
0.575,1,10,840,10,56,63,56,840,0,0,0,0,0
1741.573,6,96,7286,63,38,28089,205,4476,33,33,54412,98,2810
1796.188,17,83,3480,82,14,22175,14,3444,1,8,0,8,36
0.247,6,9,527,5,43,61,43,311,4,0,45,0,216
0.283,17,4,420,2,33,0,33,122,2,121,1,145,298
1705.979,1,8,448,8,28,243711,28,448,0,0,0,0,0
0.785,6,10,1687,7,100,130,100,384,3,1179,263,1179,1303
0.618,6,12,2084,6,288,99,288,560,6,424,88,434,1524
3.183,17,8,736,4,32,1054,32,240,4,96,1055,96,496
1.295,6,29,6120,14,150,99,267,1615,15,780,86,1460,4505
0.586,17,2,476,1,39,0,39,67,1,381,0,381,409
14.635,6,21,6825,12,275,1330,275,1038,9,1353,1203,1440,5787
9.746,6,1635,1479314,1017,1377,9,1408,1442514,618,931,15,2801,36800
284.068,6,36,10033,16,176,18937,267,1704,20,627,14944,1380,8329
31.682,1,16,896,16,28,2112,28,896,0,0,0,0,0
10.212,6,16,3536,9,123,1276,133,722,7,610,1695,1282,2814
1082.891,2,12,384,12,8,98444,8,384,0,0,0,0,0
34.108,6,31,5922,15,180,2436,722,1870,16,402,2261,2026,4052
5.073,17,4,304,4,48,1691,48,304,0,0,0,0,0
3.372,17,62,48786,26,325,134,1350,9196,36,1071,94,1350,39590
85.03,6,22,10186,11,304,79,597,1385,11,1192,8485,1460,8801
2.353,17,24,17006,14,1005,181,1350,14475,10,225,257,1350,2531
1770.435,6,99,9306,66,66,27237,66,5610,33,60,55323,60,3696
17.739,6,30,5055,15,154,1267,722,1872,15,399,1229,1448,3183
1.018,17,2,251,1,36,0,36,64,1,159,0,159,187
0.045,6,12,3462,6,75,9,75,395,6,1373,8,1448,3067
0.036,6,10,1671,6,552,7,948,1348,4,159,12,159,323
161.364,6,202,156180,126,1319,1290,1448,139828,76,619,1920,2359,16352
1681.309,17,14,3843,7,30,280216,30,406,7,463,280215,463,3437
4.125,6,2,88,2,0,0,0,88,0,0,0,0,0
1752.881,6,100,7525,65,38,27388,205,4611,35,33,51547,98,2914
1786.743,6,104,8444,68,66,26667,66,4964,36,60,51047,60,3480
4.115,17,3,222,3,46,2057,46,222,0,0,0,0,0
0.006,17,2,383,1,39,0,39,67,1,288,0,288,316
22.05,6,27,8992,9,154,2756,267,832,18,530,1263,1917,8160
1.572,6,30,10405,18,367,92,833,1825,12,1012,134,1420,8580
297.581,17,394,63990,197,38,1518,44,13104,197,230,1518,345,50886
13.234,6,1905,1794330,1253,1380,10,1432,1763947,652,475,20,2864,30383
0.945,6,10,1687,7,100,157,100,384,3,1179,343,1179,1303
1.124,6,27,8591,15,236,67,625,2049,12,1210,83,3151,6542
1772.51,6,203,22290,130,75,13740,267,10057,73,134,24614,1997,12233
5.571,6,39,7269,20,218,293,314,3423,19,513,294,1179,3846
1777.975,1,247,13832,247,28,7227,28,13832,0,0,0,0,0
1796.128,1,268,15008,268,28,6727,28,15008,0,0,0,0,0
1787.298,6,102,8296,68,65,26676,65,4930,34,59,54156,59,3366
31.595,6,7,396,1,0,0,0,60,6,0,6282,0,336
43.869,6,32,8987,13,327,150,1189,2495,19,477,2436,1420,6492
0.319,17,7,2390,7,313,53,354,2390,0,0,0,0,0
0.192,6,33,8400,17,277,12,517,1811,16,494,11,1432,6589
875.042,17,172,13072,172,48,5117,48,13072,0,0,0,0,0
1775.086,6,180,15480,120,69,14916,69,8940,60,69,30076,69,6540
829.668,6,61,9191,33,105,20204,518,2910,28,206,30725,1420,6281
1785.857,6,367,25719,213,99,8423,469,15005,154,69,11672,69,10714
282.327,6,28,7352,12,158,25666,267,1277,16,603,18815,1400,6075
0.019,17,2,396,1,40,0,40,68,1,300,0,300,328
300.653,6,38,8495,21,291,15032,786,2061,17,478,528,2128,6434
175.449,17,6,456,6,48,35089,48,456,0,0,0,0,0
1.623,6,32,8952,14,158,124,267,1357,18,624,88,1400,7595
1756.291,6,106,6322,60,27,29766,27,3525,46,27,39027,27,2797
1794.539,17,277,46311,277,139,6501,385,46311,0,0,0,0,0
25.775,6,31,4926,16,275,1718,275,1218,15,768,1499,1440,3708
4.227,6,38,7229,19,218,234,314,3383,19,513,220,1179,3846
300.142,6,44,10946,21,698,14998,1360,5086,23,308,13634,1360,5860
28.877,6,28,7352,13,158,2406,267,1317,15,678,2056,2800,6035
9.586,6,81,25010,41,568,239,1152,19269,40,459,239,1179,5741
10.237,6,87,25005,45,560,232,1152,19168,42,461,243,1179,5837
1741.358,6,88,6405,59,31,30023,31,3998,29,31,62189,31,2407
0.438,6,54,23293,29,1053,15,1380,18051,25,421,16,1923,5242
1786.841,6,102,8296,68,65,26669,65,4930,34,59,54141,59,3366
907.242,6,117,7834,49,46,18900,46,3550,68,46,13538,46,4284
379.304,17,24,8064,24,308,16491,308,8064,0,0,0,0,0
2.081,6,30,10405,18,367,122,833,1825,12,1012,181,1420,8580
1771.381,6,101,9410,66,66,27252,66,5610,35,60,52097,60,3800
63.18,6,14,5722,4,112,21060,112,280,10,718,7016,1460,5442
21.731,17,8,1176,4,48,7241,48,304,4,190,7240,308,872
0.437,6,53,22982,29,1043,15,1380,15857,24,511,16,1923,7125
0.12,17,8,2750,8,315,17,354,2750,0,0,0,0,0
1767.183,17,171,14529,158,30,11255,37,9220,13,380,142201,463,5309
35.259,17,22,1936,11,48,3518,48,836,11,72,3519,72,1100
257.61,1,23,2392,0,0,0,0,0,23,76,11709,76,2392
0.001,6,5,5832,1,0,0,0,40,4,1396,0,1396,5792
23.385,6,53,28766,30,860,806,1440,14141,23,855,1054,1468,14625
1769.16,6,4150,3745751,1575,158,1123,972,95822,2575,1404,687,2836,3649929
13.702,6,26,4815,13,154,1122,722,1766,13,473,1126,1408,3049
74.891,2,2,64,2,8,74891,8,64,0,0,0,0,0
1798.235,17,140,11200,70,48,26061,48,5320,70,56,26060,56,5880
1795.263,1,66,3696,66,28,27619,28,3696,0,0,0,0,0
112.364,6,14,5625,4,106,37451,106,274,10,706,12482,1420,5351
1754.923,6,161,11615,86,74,20646,208,7685,75,31,23712,31,3930
0.175,6,24,7660,12,176,15,334,1339,12,1137,14,1648,6321
4.011,17,4,304,4,48,1337,48,304,0,0,0,0,0
0.008,6,12,1867,7,125,1,125,497,5,367,1,500,1370
661.071,2,5,160,5,8,165267,8,160,0,0,0,0,0
19.891,6,21,3918,12,210,1808,210,1274,9,545,2486,904,2644
5.006,17,4,530,2,36,5001,36,128,2,173,5000,187,402
1.026,6,24,9512,14,350,78,1041,1992,10,1184,92,2920,7520
298.125,17,4,352,2,60,298124,60,176,2,60,298124,60,176
1777.706,17,73,3060,72,14,25038,14,3024,1,8,0,8,36
0.139,2,3,96,3,8,69,8,96,0,0,0,0,0
0.101,17,8,2446,8,277,14,316,2446,0,0,0,0,0
1.409,6,55,22672,29,979,50,1440,16856,26,433,49,1440,5816
378.253,2,4,128,4,8,126084,8,128,0,0,0,0,0
9.983,6,16,5255,9,275,1247,275,643,7,1440,812,1440,4612
1786.621,6,102,8228,68,64,26665,64,4896,34,58,54137,58,3332
28.06,6,51,13331,24,176,1220,721,2724,27,634,1064,1420,10607
1773.635,6,274,34353,110,148,16270,1360,16905,164,132,10880,1942,17448
1799.317,17,448,39896,403,35,4475,288,25676,45,288,40022,288,14220
842.576,17,8,1568,8,168,120368,168,1568,0,0,0,0,0
300.749,6,41,8877,18,308,17683,889,1987,23,350,13664,4848,6890
280.473,6,30,7432,14,158,21574,267,1357,16,678,18693,3456,6075
94.241,6,25,12059,12,410,68,922,1754,13,1085,7842,1460,10305
1798.259,17,470,58532,215,167,8403,1350,42094,255,36,7077,1350,16438
3.952,17,2,152,2,48,3952,48,152,0,0,0,0,0
179.287,17,4,240,2,32,179283,32,120,2,32,179286,32,120
1785.359,17,142,11360,71,48,25505,48,5396,71,56,25505,56,5964
0.085,17,2,136,1,32,0,32,60,1,48,0,48,76
0.0,17,1,75,1,47,0,47,75,0,0,0,0,0
4.432,6,37,7189,18,218,260,314,3343,19,513,232,1179,3846
3.938,17,10,2447,5,40,981,40,340,5,393,981,423,2107
1779.326,17,318,53331,318,139,5613,385,53331,0,0,0,0,0
1644.181,1,8,448,8,28,234883,28,448,0,0,0,0,0
1799.999,6,211,16340,78,70,22987,313,7746,133,48,13636,78,8594
1781.226,1,67,5628,67,56,26988,56,5628,0,0,0,0,0
1624.326,2,19,608,19,8,90240,8,608,0,0,0,0,0
1776.069,1,58,4872,58,56,31159,56,4872,0,0,0,0,0
1798.102,17,448,39896,403,35,4472,288,25676,45,288,40021,288,14220
0.156,6,16,2993,9,282,19,531,1606,7,338,23,777,1387
1772.229,6,180,15480,120,69,14892,69,8940,60,69,30037,69,6540
1786.644,6,102,8364,68,66,26666,66,4964,34,60,54137,60,3400
0.079,17,4,2876,2,689,79,1350,1434,2,693,43,1350,1442
11.117,6,13,6282,5,131,2777,136,466,8,1373,1587,1430,5816
1.935,17,2,204,1,34,0,34,62,1,114,0,114,142
0.032,17,4,865,2,47,0,47,150,2,329,0,341,715
293.936,1,4,224,4,28,97978,28,224,0,0,0,0,0
1243.402,6,251,18319,143,113,8756,469,10825,108,69,11620,69,7494
1794.289,6,356,22520,208,69,8668,69,12460,148,69,12204,69,10060
282.088,6,26,12901,14,873,21294,1192,3253,12,1018,25644,1591,9648
22.993,17,4,352,2,60,22992,60,176,2,60,22992,60,176
1.348,6,52,21505,29,913,48,1360,15809,23,433,53,1360,5696
315.87,6,82,19737,45,343,7178,1360,10138,37,352,8770,3289,9599
46.4,17,151,11536,77,40,610,41,5279,74,56,621,57,6257
280.233,6,28,7352,13,158,23352,267,1317,15,678,20015,2045,6035
20.919,1,4,224,4,28,6973,28,224,0,0,0,0,0
0.073,17,2,212,1,46,0,46,74,1,110,0,110,138
3.791,17,5,295,5,31,947,31,295,0,0,0,0,0
9.29,6,42,14587,20,451,488,1440,3589,22,672,413,1440,10998
541.29,6,59,5051,39,69,14244,69,2871,20,69,28488,69,2180
240.17,6,41,7695,20,163,12640,517,2194,21,489,12008,1517,5501
311.334,6,27,5494,14,298,23948,1382,2353,13,373,25923,1460,3141
272.789,1,4,326,4,53,90929,78,326,0,0,0,0,0
1797.176,6,367,25650,214,99,8437,469,15045,153,69,11822,69,10605
280.255,6,27,7312,12,158,25477,267,1277,15,603,20016,1400,6035
3.988,1,10,840,10,56,443,56,840,0,0,0,0,0
106.885,6,25,11825,12,765,59,1460,3575,13,1102,8895,1460,8250
286.079,6,28,2969,14,324,22005,585,1397,14,282,22005,580,1572
13.768,6,16,1327,8,222,1964,222,768,8,231,1964,231,559
5.041,17,3,208,2,36,5007,36,128,1,52,0,52,80
4.557,6,21,7290,10,357,488,721,1475,11,894,439,1420,5815
0.026,6,2,80,1,0,0,0,40,1,0,0,0,40
1781.388,6,395,33488,215,102,8324,469,16078,180,122,9951,1452,17410
1769.005,6,140,8636,74,27,24232,27,4511,66,27,27214,27,4125
247.944,6,70,21568,32,285,7998,1155,5413,38,707,6701,2816,16155
284.975,1,3,168,3,28,142487,28,168,0,0,0,0,0
1739.012,1,55,4620,0,0,0,0,0,55,56,32203,56,4620
99.459,6,11,719,11,31,9945,31,719,0,0,0,0,0
12.113,6,25,8473,13,275,1009,275,1078,12,986,949,1440,7395
1795.806,17,448,39896,403,35,4467,288,25676,45,288,40021,288,14220
2.813,17,2,214,1,39,0,39,67,1,119,0,119,147
25.175,6,22,1750,11,275,2517,275,1002,11,96,1494,96,748
2.675,6,25,7162,14,660,205,1418,5358,11,244,266,580,1804
128.258,6,22,10202,12,433,69,990,1823,10,1327,14236,3928,8379
234.635,17,4,352,2,60,234633,60,176,2,60,234634,60,176
4.993,17,4,502,2,36,4987,36,128,2,159,4988,159,374
5.253,6,40,7309,21,218,262,314,3463,19,513,277,1179,3846
240.156,6,51,16325,27,704,9236,1402,13382,24,241,10441,580,2943
120.005,17,28,1210,26,13,4800,58,1086,2,34,8524,56,124
1799.381,17,449,39928,404,35,4464,288,25708,45,288,40026,288,14220
1.741,17,400,423818,85,145,20,1350,14770,315,1270,5,1350,409048
1787.907,6,373,23614,214,69,8393,69,13114,159,69,11315,69,10500
1772.03,6,182,15629,121,69,14766,69,8980,61,69,29531,69,6649
10.962,6,21,6825,12,275,996,275,1038,9,1353,748,1440,5787
31.055,6,4055,3826862,2577,1405,11,1448,3745282,1478,776,20,1448,81580
197.238,6,24,2781,11,322,19723,581,1249,13,396,16435,580,1532
1790.807,6,356,22520,208,69,8651,69,12460,148,69,12180,69,10060
188.751,6,29,6653,11,220,5627,516,1325,18,306,11097,1452,5328
0.14,6,12,3462,6,75,27,75,395,6,1373,27,1448,3067
1794.797,6,287,39541,121,181,14955,1440,21423,166,138,10876,1440,18118
60.079,2,2,64,2,8,60079,8,64,0,0,0,0,0
273.147,17,14,588,14,14,21011,14,588,0,0,0,0,0
280.38,6,29,7392,13,158,23365,267,1317,16,603,18689,1400,6075
153.6,17,4,352,2,60,153598,60,176,2,60,153598,60,176
1.697,6,38,17930,21,658,84,1379,3088,17,996,82,1408,14842
1771.808,6,99,9240,66,65,27258,65,5577,33,59,55366,59,3663
1.229,6,53,21234,30,949,42,1360,15493,23,400,48,1360,5741
1740.446,17,30,7050,30,207,60015,207,7050,0,0,0,0,0
1775.831,17,140,11200,70,48,25736,48,5320,70,56,25736,56,5880
56.239,6,22,6974,10,181,6248,267,1128,12,766,5108,2045,5846
1799.962,6,364,25599,211,99,8570,469,14925,153,69,11841,69,10674
240.294,6,48,16574,21,511,12009,1418,5191,27,830,9240,1418,11383
300.12,6,39,9618,21,537,14998,1360,4096,18,435,17644,2667,5522
1677.397,1,8,848,8,78,239628,78,848,0,0,0,0,0
23.732,6,25,5252,9,341,2966,722,1488,16,244,1569,1408,3764
1783.619,17,288,55327,288,164,6214,353,55327,0,0,0,0,0
69.106,6,72,48859,45,1199,1570,1408,40721,27,960,2369,3847,8138
180.505,2,3,96,3,8,90252,8,96,0,0,0,0,0
14.522,17,4,352,2,48,14508,48,152,2,72,14512,72,200
0.146,6,9,1002,5,213,36,213,417,4,421,39,421,585
0.462,6,52,22341,29,998,16,1380,17167,23,421,19,1923,5174
1376.378,1,69,3864,69,28,20240,28,3864,0,0,0,0,0
0.188,6,27,7296,13,155,15,267,1301,14,543,12,1400,5995
1772.487,6,207,22871,132,75,13530,267,10137,75,136,23951,1420,12734
0.246,1,2,112,2,28,246,28,112,0,0,0,0,0
1.029,17,5,716,3,64,514,64,276,2,192,902,192,440
364.005,6,38,16925,24,90,15826,431,2253,14,1161,4817,2856,14672
300.551,6,50,9168,25,286,12522,766,2260,25,327,619,1460,6908
1786.436,6,102,8364,68,66,26663,66,4964,34,60,54131,60,3400
106.323,6,25,9849,11,531,134,1440,2585,14,954,8168,1440,7264
0.152,17,4,284,2,32,13,32,120,2,54,140,60,164
143.461,6,16,3480,4,92,1265,92,308,12,282,13025,1448,3172
308.914,6,73,14942,34,278,9360,1109,5396,39,395,8129,2347,9546
1679.953,1,15,840,15,28,119996,28,840,0,0,0,0,0
446.957,17,22,924,22,14,21283,14,924,0,0,0,0,0
1787.59,6,102,8296,68,65,26680,65,4930,34,59,54164,59,3366
0.91,6,24,9803,12,430,82,1360,2235,12,1010,61,1360,7568
1738.385,6,87,6322,58,31,30497,31,3915,29,31,62084,31,2407
226.904,6,30,8872,13,158,18908,267,1317,17,687,14177,1400,7555
0.405,6,12,1653,6,288,78,288,548,6,426,44,434,1105
1736.202,1,56,4704,56,56,31567,56,4704,0,0,0,0,0
4.155,17,4,352,2,48,4141,48,152,2,72,4141,72,200
10.99,6,18,5610,10,275,1221,275,958,8,1440,852,1440,4652
0.372,17,2,178,1,29,0,29,57,1,93,0,93,121
8.532,6,12,708,5,106,2130,106,314,7,90,1420,90,394
0.346,6,181,174582,115,183,3,230,6713,66,2569,3,11264,167869
0.092,17,2,462,2,203,92,360,462,0,0,0,0,0
0.29,17,4,1370,4,314,96,355,1370,0,0,0,0,0
1773.107,6,180,15480,120,69,14900,69,8940,60,69,30050,69,6540
1789.509,1,242,13552,242,28,7425,28,13552,0,0,0,0,0
1.202,6,24,8004,12,164,92,267,1288,12,1014,92,2816,6716
281.269,6,29,7392,13,158,23439,267,1317,16,543,18740,1400,6075
1.682,6,53,19138,29,868,60,1360,13357,24,400,62,1360,5781
9.036,6,8,625,4,177,3012,177,393,4,0,2935,0,232
0.524,17,2,152,1,48,0,48,76,1,48,0,48,76
1797.336,1,345,28980,345,56,5224,56,28980,0,0,0,0,0
249.595,17,6,456,6,48,49919,48,456,0,0,0,0,0
958.051,6,110,7540,41,46,23951,46,3216,69,46,14086,46,4324
3.325,6,13,1864,6,241,665,241,1216,7,92,304,92,648
0.309,6,21,7281,12,334,27,663,1969,9,967,37,2816,5312
1.908,17,3,468,3,128,954,128,468,0,0,0,0,0
5.008,17,4,288,2,36,4991,36,128,2,52,4989,52,160
1785.861,6,414,27914,224,99,8008,469,15514,190,48,9448,69,12400
0.013,6,3,172,2,0,13,0,112,1,0,0,0,60
2.523,6,22,6402,10,262,275,517,1316,12,744,225,1418,5086
5.716,17,14,8387,7,614,952,1350,4499,7,527,921,1350,3888
2.418,17,25,9808,12,529,219,1350,6689,13,211,195,1350,3119
5.845,6,744,644966,319,1153,18,1460,35856,425,1444,13,1607,609110
1799.82,17,144,11520,72,48,25349,48,5472,72,56,25349,56,6048
361.859,6,17,1190,13,180,30154,180,864,4,110,20087,110,326
4.734,6,39,7269,19,218,263,314,3383,20,513,234,1179,3886
78.539,6,4,574,4,138,26179,138,574,0,0,0,0,0
1.737,6,19,6424,11,141,173,275,726,8,895,215,2840,5698
4.491,6,56,22950,31,979,149,1440,16974,25,381,171,1440,5976
1798.734,17,448,39896,403,35,4474,288,25676,45,288,40018,288,14220
132.349,6,24,10657,13,741,56,1360,3517,11,1337,13221,4428,7140
0.145,6,46,22527,27,1096,5,1420,17546,19,467,7,1883,4981
1.394,6,42,11644,22,572,66,1460,6068,20,433,63,1460,5576
1.012,6,56,17525,34,352,30,1360,9492,22,793,42,4649,8033
21.428,17,4,824,2,48,21404,48,152,2,308,21414,308,672
1786.617,6,104,8444,68,66,26665,66,4964,36,60,51043,60,3480
7.972,6,18,6791,9,275,996,275,643,9,1155,687,1420,6148
9.826,6,82,25050,42,550,239,1152,19309,40,459,245,1179,5741
240.213,6,56,19077,30,766,8283,1408,16125,26,199,9608,580,2952
1770.955,6,99,9306,66,66,27245,66,5610,33,60,55339,60,3696
0.473,6,26,8884,13,236,39,585,1630,13,938,37,1438,7254
162.858,17,4,352,2,60,162857,60,176,2,60,162857,60,176
0.48,6,51,21204,27,1063,18,1380,16002,24,421,19,1923,5202
902.495,2,8,256,8,8,128927,8,256,0,0,0,0,0
0.15,17,2,152,1,48,0,48,76,1,48,0,48,76
0.45,6,13,1693,6,288,86,288,548,7,426,40,434,1145
13.864,6,2458,2305113,1587,1375,8,1408,2255157,871,931,15,2816,49956
1756.7,6,233,26982,115,93,15409,721,11916,118,235,15012,1440,15066
8.197,6,18,6791,9,275,1024,275,643,9,1155,667,1420,6148
4.817,17,4,240,2,32,4816,32,120,2,32,4816,32,120
33.528,6,28,4937,14,180,2579,721,1806,14,399,2562,2026,3131
3.392,17,3,1173,3,363,1696,363,1173,0,0,0,0,0
309.75,6,26,6293,11,139,30974,159,1150,15,873,22124,2816,5143
41.513,1,44,4576,0,0,0,0,0,44,76,965,76,4576
383.297,6,13,894,7,106,63882,106,606,6,0,6309,0,288
1781.76,6,361,24734,211,94,8484,469,14387,150,69,11958,69,10347
1781.282,1,86,9116,86,78,20956,78,9116,0,0,0,0,0
0.047,6,10,1514,5,503,11,503,771,5,475,11,475,743
1750.085,17,12,498,11,14,175008,14,462,1,8,0,8,36
1792.902,6,363,23145,211,69,8537,69,12718,152,69,11870,69,10427
33.654,6,33,5198,16,154,2243,722,1912,17,299,2091,1408,3286
0.362,6,26,9017,13,261,30,683,1728,13,1100,28,2816,7289
1.959,6,28,9116,14,252,150,646,1746,14,947,149,1438,7370
1.311,6,40,9928,21,440,65,1360,4392,19,476,62,2715,5536
5.03,6,9,392,4,0,1676,0,172,5,0,1129,0,220
10.765,6,18,4266,10,275,1196,275,958,8,992,854,1440,3308
2.662,6,13,2311,8,188,380,245,700,5,1407,599,1407,1611
390.815,6,22,1483,15,177,27915,177,1001,7,110,10853,110,482
1676.179,1,7,392,7,28,279363,28,392,0,0,0,0,0
10.616,6,790,678606,489,1315,21,1368,658290,301,776,34,2736,20316
1785.858,1,158,16748,158,78,11374,78,16748,0,0,0,0,0
0.076,17,2,362,1,46,0,46,74,1,260,0,260,288
1776.685,6,77,4056,39,26,46753,26,2054,38,26,48017,26,2002
1.008,6,28,13143,15,529,72,1360,3290,13,1165,69,2720,9853
102.372,1,3,84,3,0,0,0,84,0,0,0,0,0
148.059,6,32,14754,18,488,287,1360,3231,14,1216,11378,2568,11523
328.641,6,54,7435,26,126,13138,722,3008,28,184,12165,1448,4427
55.559,6,47,18796,21,257,2777,484,1757,26,798,2036,1360,17039
0.959,6,28,8582,15,229,58,583,2043,13,1001,64,2720,6539
0.0,17,1,397,1,369,0,369,397,0,0,0,0,0
0.011,17,2,390,1,32,0,32,60,1,302,0,302,330
0.189,6,9,1339,5,145,47,145,349,4,826,52,826,990
373.433,6,18,1242,14,180,28725,180,916,4,110,20075,110,326
120.344,6,10,1294,6,302,24068,302,912,4,83,40111,83,382
0.012,6,4,208,2,0,9,0,104,2,0,9,0,104
12.586,6,1973,1727831,1204,1379,10,1420,1692826,769,467,16,2840,35005
0.539,17,3,451,2,39,319,39,134,1,289,0,289,317
0.086,1,2,112,2,28,86,28,112,0,0,0,0,0
0.388,17,2,152,1,48,0,48,76,1,48,0,48,76
156.251,6,25,6275,9,268,100,505,1169,16,343,10410,1420,5106
0.124,6,4,191,3,31,61,31,151,1,0,0,0,40
5.173,6,14,3177,6,92,1034,92,400,8,1164,665,1448,2777
34.084,17,20,1760,10,48,3786,48,760,10,72,3786,72,1000
0.589,6,27,17458,16,708,39,1360,4214,11,1827,45,4887,13244
0.927,6,23,7940,13,164,77,267,1328,10,1216,83,3819,6612
1775.24,17,73,3060,72,14,25003,14,3024,1,8,0,8,36
17.108,17,2,672,2,308,17108,308,672,0,0,0,0,0
348.89,6,16,6397,6,140,69778,267,809,10,740,38745,4260,5588
1772.19,6,336,49130,184,304,9684,304,33832,152,83,11736,83,15298
251.624,2,3,96,3,8,125812,8,96,0,0,0,0,0
280.29,6,29,7392,14,158,21560,267,1357,15,678,20010,3436,6035
353.775,6,98,6484,47,46,7626,46,2788,51,46,7075,46,3696
0.063,6,10,861,6,182,12,182,490,4,77,19,134,371
161.532,6,27,10210,14,391,195,1194,2563,13,1185,13445,3151,7647
1216.984,6,48,13415,28,416,45073,1360,5747,20,489,64042,2134,7668
3.071,17,2,186,1,41,0,41,69,1,89,0,89,117
1779.666,1,342,28728,342,56,5218,56,28728,0,0,0,0,0
0.325,6,28,9146,13,252,27,646,1694,15,833,21,1438,7452
40.453,17,44,6468,22,48,1925,48,1672,22,190,1925,308,4796
38.806,17,22,1936,11,48,3879,48,836,11,72,3879,72,1100
0.042,17,2,187,1,46,0,46,74,1,85,0,85,113
0.26,6,46,20697,26,1044,10,1420,15676,20,467,13,1883,5021
6.139,6,38,7245,19,218,341,314,3383,19,516,326,1179,3862
1797.833,6,358,22738,209,69,8643,69,12569,149,69,12147,69,10169
366.163,6,25,1651,17,177,22885,177,1117,8,110,9160,110,534
19.558,6,27,7177,13,155,1629,267,1306,14,530,1503,3417,5871
1745.373,6,95,7203,63,38,28151,205,4476,32,33,56292,98,2727
10.155,6,1495,1396045,988,1363,10,1420,1371426,507,475,20,1883,24619
1778.095,1,180,10080,180,28,9933,28,10080,0,0,0,0,0
7.716,1,12,1248,0,0,0,0,0,12,76,701,76,1248
1.63,6,9,527,5,43,407,43,311,4,0,542,0,216
1797.781,17,449,39928,404,35,4460,288,25708,45,288,40018,288,14220
0.402,6,14,1733,7,288,65,288,588,7,284,37,434,1145
57.221,6,49,14458,24,1064,659,1460,8501,25,290,2376,1460,5957
0.206,6,11,913,6,182,41,182,490,5,77,27,134,423
15.833,17,38,22988,21,931,789,1350,20154,17,138,987,1350,2834
2.88,6,31,5942,16,125,192,267,1399,15,787,187,1460,4543
12.508,6,11,676,3,106,6245,106,234,8,90,1784,90,442
0.064,17,4,284,2,32,14,32,120,2,54,52,60,164
332.113,6,171,136098,111,1278,3019,1408,123466,60,633,2125,1408,12632
10.734,17,19,8557,10,569,1188,1350,5975,9,258,1337,1350,2582
1699.507,1,8,448,8,28,242786,28,448,0,0,0,0,0
7.695,6,68,20702,34,559,233,1152,15915,34,427,225,1152,4787
1783.588,17,83,3480,82,14,22019,14,3444,1,8,0,8,36
1788.119,1,264,14784,264,28,6798,28,14784,0,0,0,0,0
0.038,17,2,417,1,44,0,44,72,1,317,0,317,345
299.545,6,6,364,4,31,99848,31,222,2,31,299532,31,142
8.083,1,9,756,9,56,1010,56,756,0,0,0,0,0
839.702,2,8,256,8,8,119957,8,256,0,0,0,0,0
196.182,17,4,352,2,60,196181,60,176,2,60,196181,60,176
1.367,6,41,8429,21,320,68,1162,2808,20,400,62,1440,5621
0.099,17,2,574,1,32,0,32,60,1,486,0,486,514
61.419,6,31,10688,19,341,3412,1272,3045,12,1001,5559,3847,7643
0.372,17,2,225,1,37,0,37,65,1,132,0,132,160
300.809,6,77,72800,36,221,8594,517,2988,41,1933,6017,4206,69812
0.936,6,24,7437,13,334,78,663,2021,11,806,88,1368,5416
0.004,6,2,1675,1,0,0,0,40,1,1583,0,1583,1635
86.215,6,32,9165,9,155,445,267,1146,23,393,3918,3377,8019
1777.037,17,140,11200,70,48,25753,48,5320,70,56,25753,56,5880
38.107,6,1771,1583258,1097,1359,34,1368,1537090,674,776,56,1473,46168
8.324,6,16,3672,9,150,1040,174,664,7,681,1365,1452,3008
0.369,6,48,20647,27,1030,14,1380,15565,21,421,16,1923,5082
0.017,17,2,367,1,39,0,39,67,1,272,0,272,300
10.631,6,81,24733,40,559,272,1152,18952,41,459,259,1179,5781
271.857,6,42,11081,20,235,14308,517,2958,22,771,12943,3815,8123
1759.673,6,78,3588,39,0,46307,0,2028,39,0,46307,0,1560
1788.634,6,356,22520,208,69,8640,69,12460,148,69,12167,69,10060
1786.74,6,106,8456,68,65,26667,65,4930,38,59,48287,59,3526
2.598,6,21,6366,10,268,283,517,1334,11,744,255,1418,5032
1796.203,17,66,2766,65,14,28065,14,2730,1,8,0,8,36
10.829,6,97,31454,49,576,225,1152,25036,48,449,224,1179,6418
305.045,6,54,15761,30,735,10518,1408,8257,24,480,3595,1408,7504
447.067,1,3,312,3,76,223533,76,312,0,0,0,0,0
71.102,6,31,7475,13,155,5925,267,1306,18,418,4181,1997,6169
3.906,17,5,295,5,31,976,31,295,0,0,0,0,0
0.047,17,4,336,2,34,0,34,124,2,78,15,84,212
280.339,6,30,7432,13,158,23361,267,1317,17,543,17517,1400,6115
241.054,6,40,5820,19,248,13390,582,2749,21,246,12049,580,3071
280.414,6,30,7432,14,158,21570,267,1357,16,678,18691,3456,6075
1786.316,17,87,3648,86,14,21015,14,3612,1,8,0,8,36
1.888,17,4,624,4,128,629,128,624,0,0,0,0,0
1638.321,1,52,5512,52,78,32123,78,5512,0,0,0,0,0
0.483,6,13,1693,6,288,91,288,548,7,426,45,434,1145
195.785,17,4,240,2,32,195784,32,120,2,32,195784,32,120
0.131,6,41,19880,24,1076,5,1420,14979,17,526,7,3303,4901
1771.235,6,103,9382,66,64,27249,64,5544,37,58,49198,58,3838
2.095,17,4,580,2,40,2064,40,136,2,194,2051,194,444
1742.9,6,94,7120,62,38,28572,205,4393,32,33,56208,98,2727
1795.221,17,80,3354,79,14,23015,14,3318,1,8,0,8,36
280.528,6,28,7352,13,158,23377,267,1317,15,603,20034,2076,6035
0.16,6,3,144,2,0,153,0,104,1,0,0,0,40
2.847,17,4,624,4,128,949,128,624,0,0,0,0,0
0.302,17,2,280,1,64,0,64,92,1,160,0,160,188
1681.261,17,14,1036,7,30,280206,30,406,7,62,280205,62,630
240.213,6,54,18326,29,823,8578,1418,15522,25,187,10008,580,2804
68.401,17,4,240,2,32,68400,32,120,2,32,68400,32,120
0.536,6,21,7290,12,335,48,668,1974,9,968,66,1475,5316
18.772,17,19,6709,9,433,2346,1350,4153,10,227,1987,1350,2556
4.199,6,13,712,8,0,599,0,452,5,0,853,0,260
1786.61,6,102,8364,68,66,26665,66,4964,34,60,54137,60,3400
172.375,17,4,352,2,60,172374,60,176,2,60,172374,60,176
21.433,6,19,2432,10,189,2381,517,1298,9,323,2614,499,1134
1799.481,1,345,28980,345,56,5231,56,28980,0,0,0,0,0
1741.406,17,30,31680,30,1028,60048,1028,31680,0,0,0,0,0
0.19,17,2,213,1,44,0,44,72,1,113,0,113,141
242.365,17,4,352,2,60,242363,60,176,2,60,242364,60,176
11.709,6,1840,1606776,1113,1388,10,1420,1573475,727,467,16,1883,33301
1.516,6,26,7495,16,302,101,693,2761,10,721,137,1460,4734
183.473,2,4,128,4,8,61157,8,128,0,0,0,0,0
1.455,6,38,8252,19,320,80,1162,2716,19,433,70,1360,5536
1786.424,1,146,8176,146,28,12320,28,8176,0,0,0,0,0
1800.0,6,214,16840,79,73,22692,375,8063,135,49,13432,143,8777
1796.023,1,58,4872,58,56,31509,56,4872,0,0,0,0,0
187.724,17,4,352,2,60,187723,60,176,2,60,187723,60,176
381.006,6,19,1306,14,180,29308,180,928,5,110,15167,110,378
5.42,6,7,434,4,122,1724,122,302,3,0,2638,0,132
336.402,6,74,53249,49,1184,7008,1368,45214,25,840,2574,2519,8035
67.093,17,4,240,2,32,67092,32,120,2,32,67092,32,120
1718.351,1,8,848,8,78,245478,78,848,0,0,0,0,0
61.848,6,75,48521,44,1183,1438,1448,40182,31,746,2054,1448,8339
284.048,6,32,7621,15,149,20289,267,1502,17,603,17733,2036,6119
5.07,6,40,7309,20,218,266,314,3423,20,513,253,1179,3886
1773.526,6,180,15480,120,69,14903,69,8940,60,69,30054,69,6540
219.762,6,22,2601,12,324,19978,585,1281,10,396,24413,580,1320
1679.617,17,12,498,11,14,167961,14,462,1,8,0,8,36
0.881,17,2,362,1,46,0,46,74,1,260,0,260,288
8.018,6,17,6751,9,275,1002,275,643,8,1444,737,2840,6108
1793.226,17,144,11520,72,48,25256,48,5472,72,56,25256,56,6048
1770.03,6,99,9306,66,66,27231,66,5610,33,60,55309,60,3696
0.464,6,12,1653,6,288,89,288,548,6,426,50,434,1105
68.293,6,29,8726,15,434,4878,659,2138,14,650,5167,2688,6588
9.381,6,1979,1880234,1288,1383,7,1408,1839638,691,931,13,2801,40596
61.309,6,35,15833,22,800,2919,1408,9159,13,855,5088,3847,6674
1740.393,17,30,31680,30,1028,60013,1028,31680,0,0,0,0,0
0.616,17,2,152,1,48,0,48,76,1,48,0,48,76
1.86,17,6,1230,3,36,928,36,192,3,318,928,318,1038
1772.173,6,180,15480,120,69,14892,69,8940,60,69,30031,69,6540
9.459,6,1767,1637709,1125,1378,8,1408,1599661,642,931,14,2801,38048
300.83,6,51,18510,29,961,10743,1360,12783,22,371,411,1360,5727
93.872,2,3,96,3,8,46936,8,96,0,0,0,0,0
298.693,1,4,224,4,28,99564,28,224,0,0,0,0,0
1.219,17,24,8932,10,363,135,1350,3910,14,330,75,1350,5022
1744.694,6,96,7255,63,38,28140,205,4476,33,33,54512,98,2779
1.543,6,53,19530,29,896,55,1360,13749,24,400,58,1360,5781
1739.276,6,92,6699,59,31,29987,31,4010,33,31,54351,31,2689
10.984,17,4,304,4,48,3661,48,304,0,0,0,0,0
0.012,17,7,2172,7,282,2,316,2172,0,0,0,0,0
0.463,17,4,352,2,60,462,60,176,2,60,462,60,176
1796.384,17,142,11360,71,48,25662,48,5396,71,56,25662,56,5964
0.153,6,41,17394,24,959,6,1420,12493,17,467,9,1883,4901
132.275,6,11,2993,6,92,26455,92,400,5,1164,33018,1408,2593
0.913,6,10,1687,7,100,152,100,384,3,1179,324,1179,1303
280.59,6,30,7432,13,158,23382,267,1317,17,603,17531,2076,6115
285.616,6,29,3021,15,324,20398,585,1449,14,282,21967,580,1572
74.453,6,201,141497,99,451,759,647,7215,102,1357,715,1408,134282
1.066,6,35,12181,21,779,53,1360,7119,14,561,69,2744,5062
0.002,17,3,1007,1,137,0,137,165,2,393,2,393,842
9.902,6,580,453381,305,1404,31,1448,434309,275,776,35,1448,19072
716.223,6,53,15206,34,365,21703,1360,7609,19,568,39780,3494,7597
1788.014,6,4537,3895727,2093,129,854,350,126385,2444,1534,731,5632,3769342
10.631,6,81,25378,41,579,265,1152,19621,40,461,265,1179,5757
286.16,6,34,8956,13,158,23846,267,1317,21,485,14307,1400,7639
0.608,17,2,170,1,37,0,37,65,1,77,0,77,105
1780.086,17,142,11360,71,48,25429,48,5396,71,56,25429,56,5964
128.736,6,37,6246,22,180,6130,722,2246,15,459,1520,2026,4000
2.911,17,4,464,3,64,1441,64,276,1,160,0,160,188
0.915,6,5,1026,3,0,449,0,156,2,754,685,754,870
0.028,17,2,403,1,65,0,65,93,1,282,0,282,310
1771.929,6,180,15480,120,69,14890,69,8940,60,69,30030,69,6540
635.822,17,48,3824,26,48,25432,48,1976,22,56,25463,56,1848
15.301,6,24,5653,12,216,1391,314,1996,12,634,1367,1179,3657
11.797,17,8,704,4,48,3928,48,304,4,72,3922,72,400
1786.484,6,102,8228,68,64,26663,64,4896,34,58,54133,58,3332
1792.379,6,355,22480,207,69,8700,69,12420,148,69,12192,69,10060
0.222,17,2,290,1,40,0,40,68,1,194,0,194,222
1.664,6,20,7168,12,319,150,602,1908,8,1209,236,1906,5260
8.078,6,26,7747,13,256,673,721,1805,13,774,520,1414,5942
108.554,17,4,1344,4,308,36184,308,1344,0,0,0,0,0
240.217,6,53,17723,28,798,8896,1402,15031,25,173,10008,580,2692
4.942,6,3,120,1,0,0,0,40,2,0,4942,0,80
0.018,17,2,198,1,39,0,39,67,1,103,0,103,131
0.5,17,2,384,1,39,0,39,67,1,289,0,289,317
1614.918,1,8,448,8,28,230702,28,448,0,0,0,0,0
0.012,17,3,244,2,32,1,32,120,1,96,0,96,124
0.424,17,2,192,1,60,0,60,88,1,76,0,76,104
240.172,6,53,15697,28,667,8895,1402,12807,25,197,10006,580,2890
0.004,17,2,380,1,39,0,39,67,1,285,0,285,313
45.06,6,47,10819,23,773,707,1360,4902,24,309,1951,2667,5917
34.871,6,31,4420,16,179,2324,517,1944,15,411,2489,499,2476
0.357,17,2,136,1,32,0,32,60,1,48,0,48,76
240.186,6,55,17876,29,785,8577,1408,14887,26,181,9607,580,2989
61.806,6,78,54033,48,1200,1315,1408,45726,30,842,2123,2439,8307
1796.79,6,188,22864,99,81,18332,721,8912,89,241,20416,1414,13952
1.231,6,48,21030,28,953,45,1360,15454,20,476,56,2715,5576
1796.112,6,427,25594,213,69,8472,69,12729,214,34,8432,48,12865
239.201,2,2,64,2,8,239201,8,64,0,0,0,0,0
3.066,17,4,304,2,48,3043,48,152,2,48,3050,48,152
1745.389,1,61,5124,61,56,29089,56,5124,0,0,0,0,0
29.875,6,2123,1961569,1284,1442,23,1448,1909105,839,776,35,1448,52464
0.817,6,30,7560,17,306,51,1087,2826,13,601,67,1420,4734
1747.134,17,276,53611,276,166,6353,377,53611,0,0,0,0,0
12.756,6,2204,2120576,1411,1426,9,1448,2074652,793,776,15,1448,45924
4.812,17,10,1918,5,36,1202,36,320,5,291,1202,318,1598
0.034,17,2,178,1,29,0,29,57,1,93,0,93,121
1752.402,6,97,7307,63,38,28264,205,4476,34,33,53093,98,2831
0.024,6,10,1671,6,552,4,948,1348,4,159,8,159,323
1776.666,17,73,3060,72,14,25023,14,3024,1,8,0,8,36
378.488,6,18,1242,14,180,29114,180,916,4,110,20060,110,326
132.436,6,7,395,2,0,7255,0,112,5,7,33067,7,283
31.67,6,16,2435,8,188,4524,245,700,8,1407,4471,1407,1735
11.041,6,81,24525,41,552,276,1152,18784,40,459,276,1179,5741
1741.423,17,30,20190,30,645,60049,645,20190,0,0,0,0,0
20.767,6,3075,2969389,2057,1368,10,1408,2911789,1018,776,20,1408,57600
1770.835,6,99,9306,66,66,27243,66,5610,33,60,55335,60,3696
1793.693,17,66,2766,65,14,28026,14,2730,1,8,0,8,36
0.102,17,2,146,1,37,0,37,65,1,53,0,53,81
0.018,6,14,4308,7,85,3,85,457,7,869,3,1448,3851
376.48,6,15,1178,10,106,41831,106,938,5,0,3866,0,240
280.493,6,27,7312,12,158,25499,267,1277,15,775,20031,3465,6035
14.943,6,2401,2220362,1532,1371,9,1408,2170510,869,931,17,2801,49852
12.05,17,3,1035,3,317,6025,317,1035,0,0,0,0,0
1772.417,6,180,15480,120,69,14894,69,8940,60,69,30033,69,6540
990.779,1,50,2800,50,28,20219,28,2800,0,0,0,0,0
1771.145,1,73,6132,73,56,24599,56,6132,0,0,0,0,0
1798.275,17,449,39928,404,35,4462,288,25708,45,288,40020,288,14220
0.021,17,2,384,1,39,0,39,67,1,289,0,289,317
54.102,2,6,272,6,21,10820,32,272,0,0,0,0,0
1.318,6,39,9888,20,502,69,1440,4352,19,433,63,1440,5536
1772.273,6,183,15738,121,69,14768,69,8980,62,69,29053,69,6758
1769.923,6,101,9354,67,64,26817,64,5660,34,58,53631,58,3694
1792.085,17,87,3648,86,14,21083,14,3612,1,8,0,8,36
11.447,1,9,756,9,56,1430,56,756,0,0,0,0,0
1.163,6,23,7952,12,164,90,267,1288,11,1216,99,3819,6664
1794.711,17,66,2766,65,14,28042,14,2730,1,8,0,8,36
142.912,6,97,30769,54,722,536,826,13072,43,431,3399,3932,17697
39.444,6,21,3812,8,92,5634,92,540,13,235,3270,1408,3272
137.42,6,1922,2352427,817,783,159,1396,71887,1105,2058,124,5584,2280540
0.301,6,20,7238,13,335,25,668,2026,7,1210,48,1906,5212
1.957,17,22,5698,22,231,93,388,5698,0,0,0,0,0
0.016,6,10,1903,5,657,3,657,925,5,710,3,710,978
1794.612,17,144,11520,72,48,25276,48,5472,72,56,25276,56,6048
1.468,6,37,8212,19,320,81,1162,2716,18,476,74,2720,5496
358.248,6,51,4368,25,151,14926,681,2223,26,55,14329,74,2145
1785.86,6,362,24774,211,94,8504,469,14387,151,69,11905,69,10387
1792.554,1,342,28728,342,56,5256,56,28728,0,0,0,0,0
1740.952,1,11,638,11,30,174095,30,638,0,0,0,0,0
3.999,17,4,240,4,32,1333,32,240,0,0,0,0,0
0.006,17,4,352,2,60,1,60,176,2,60,1,60,176
139.861,17,4,240,2,32,139860,32,120,2,32,139860,32,120
1.267,6,50,20444,28,909,46,1360,14788,22,476,52,2715,5656
4.864,6,40,7309,20,218,256,314,3423,20,440,242,1152,3886
365.958,6,23,1535,16,177,24397,177,1053,7,110,10356,110,482
0.381,17,2,152,1,48,0,48,76,1,48,0,48,76
1792.339,6,432,26529,231,69,7792,69,13725,201,44,8961,69,12804
7.007,6,4,240,4,0,0,0,240,0,0,0,0,0
0.85,6,4,220,2,0,850,0,100,2,0,303,0,120
1796.781,17,448,39896,403,35,4469,288,25676,45,288,40020,288,14220
1744.964,6,95,7203,63,38,28144,205,4476,32,33,56276,98,2727
0.036,17,2,304,1,60,0,60,88,1,188,0,188,216
1799.082,6,144,19222,84,69,21672,722,6425,60,247,30489,2391,12797
8.163,17,16,16914,3,932,2044,1350,2881,13,1051,677,1350,14033
583.416,6,41,3298,22,54,27781,205,1681,19,34,32402,98,1617
1795.838,1,77,6468,0,0,0,0,0,77,56,23629,56,6468
1138.149,6,127,8760,46,46,25292,46,3680,81,46,14225,46,5080
159.709,6,24,12220,14,549,48,1360,2789,10,1803,17730,3934,9431
57.335,6,2475,2229998,1616,1302,35,1368,2177730,859,931,66,2841,52268
1783.186,6,185,15887,122,69,14737,69,9020,63,69,28751,69,6867
1789.729,17,142,11360,71,48,25567,48,5396,71,56,25566,56,5964
1797.849,17,763,46018,763,32,2359,37,46018,0,0,0,0,0
4.037,17,9,9835,2,723,4037,1350,1503,7,1162,611,1350,8332
0.018,17,2,570,1,30,0,30,58,1,484,0,484,512
1669.057,1,8,448,8,28,238436,28,448,0,0,0,0,0
0.745,6,18,6589,11,213,74,321,1101,7,1039,91,1576,5488
240.625,2,2,64,2,8,240625,8,64,0,0,0,0,0
1773.426,6,124,7570,68,27,26469,27,4082,56,27,32238,27,3488
4.663,6,55,21859,27,580,179,1440,6393,28,841,157,1440,15466
64.697,6,12,976,4,226,113,226,442,8,110,9218,110,534
1782.432,1,76,6384,76,56,23765,56,6384,0,0,0,0,0
0.518,6,20,7238,13,335,43,668,2026,7,1210,76,1946,5212
241.399,6,53,13440,27,610,9283,1368,10586,26,185,9654,580,2854
197.812,6,11,2960,6,543,39562,996,2415,5,172,49398,253,545
0.658,17,2,152,1,48,0,48,76,1,48,0,48,76
1681.701,17,16,1265,8,30,240240,37,471,8,71,240238,136,794
1789.954,6,358,22738,208,69,8647,69,12460,150,69,12013,69,10278
0.285,17,2,440,1,39,0,39,67,1,345,0,345,373
0.935,6,26,5895,14,138,71,517,1716,12,591,84,1408,4179
11.605,6,24,8413,13,275,967,275,1078,11,1147,839,2840,7335
44.179,17,15,7808,8,655,6311,1350,5466,7,306,2520,1350,2342
126.221,2,2,64,2,8,126221,8,64,0,0,0,0,0
12.448,6,1839,1655955,1165,1369,10,1380,1623769,674,421,18,1923,32186
381.352,6,25,1651,17,177,23834,177,1117,8,110,9351,110,534
1680.473,1,15,840,15,28,120033,28,840,0,0,0,0,0
0.179,6,27,7296,13,155,14,267,1301,14,603,13,2036,5995
1783.402,17,84,3516,82,14,22015,14,3444,2,8,1783221,8,72
1.434,6,46,18953,26,946,57,1460,13377,20,476,64,2615,5576
1671.188,1,7,392,7,28,278531,28,392,0,0,0,0,0
0.88,6,10,1687,7,100,146,100,384,3,1179,316,1179,1303
416.691,1,36,2016,36,28,11905,28,2016,0,0,0,0,0
2.781,6,2,88,2,0,0,0,88,0,0,0,0,0
1799.021,6,432,38133,194,73,9320,1305,14280,238,85,7590,4649,23853
1742.801,6,87,6322,58,31,30575,31,3915,29,31,62242,31,2407
2.121,6,25,5795,13,158,174,370,1315,12,799,190,1460,4480
0.25,6,23,5080,11,137,25,267,1132,12,577,21,1400,3948
1786.375,6,102,8364,68,66,26662,66,4964,34,60,54130,60,3400
5.86,6,30,8108,14,124,450,126,990,16,646,355,1440,7118
0.037,1,2,112,2,28,37,28,112,0,0,0,0,0
1759.466,17,120,23658,120,169,14785,422,23658,0,0,0,0,0
0.909,17,2,602,1,46,0,46,74,1,500,0,500,528
1745.069,6,99,7814,65,45,27266,205,4850,34,35,52872,98,2964
626.12,1,10,560,10,28,69568,28,560,0,0,0,0,0
1.18,6,2,364,1,0,0,0,40,1,272,0,272,324
1.462,6,50,19107,28,941,54,1460,13406,22,437,60,2615,5701
1704.402,17,16,1265,8,30,243459,37,471,8,71,243483,136,794
1.31,6,47,19650,27,925,50,1360,14074,20,529,59,4075,5576
0.773,6,12,1653,6,288,153,288,548,6,426,99,434,1105
1741.779,6,87,6322,58,31,30557,31,3915,29,31,62205,31,2407
280.42,6,29,7392,13,158,23368,267,1317,16,678,18690,3456,6075
1785.537,6,122,14660,77,87,23493,500,6310,45,159,40578,1420,8350
0.513,6,26,8868,13,227,42,547,1592,13,941,39,1448,7276
0.377,6,6,328,4,0,125,0,216,2,0,337,0,112
1750.512,17,12,498,11,14,175051,14,462,1,8,0,8,36
300.645,6,38,8580,20,318,15823,928,2107,18,478,500,2720,6473
240.266,6,42,8666,20,523,12645,1408,5760,22,194,11441,618,2906
1.184,6,47,19440,27,910,45,1360,13864,20,476,53,2720,5576
260.11,6,36,9364,21,117,13005,334,1811,15,694,18566,2720,7553
1.014,17,2,677,1,300,0,300,328,1,321,0,321,349
0.068,6,12,976,7,181,11,181,553,5,77,16,134,423
1201.994,17,14,4542,14,296,92461,1238,4542,0,0,0,0,0
3.373,17,3,1167,3,361,1686,361,1167,0,0,0,0,0
1770.555,6,101,9344,66,65,27239,65,5577,35,59,52072,59,3767
1772.141,6,99,9240,66,65,27263,65,5577,33,59,55375,59,3663
1773.343,1,60,5040,0,0,0,0,0,60,56,30056,56,5040
1626.586,6,119,9659,71,57,23236,205,5538,48,38,34565,98,4121
2.484,6,22,3497,12,324,225,585,1329,10,273,273,580,2168
0.015,17,2,354,1,36,0,36,64,1,262,0,262,290
1322.935,6,288,27742,164,109,8116,469,13486,124,145,10755,1460,14256
0.011,17,2,144,1,44,0,44,72,1,44,0,44,72
2.14,6,13,2311,8,188,305,245,700,5,1407,470,1407,1611
1792.002,6,355,22411,206,69,8741,69,12449,149,69,12108,69,9962
329.13,6,8,416,8,0,0,0,416,0,0,0,0,0
0.505,17,5,1687,5,309,126,354,1687,0,0,0,0,0
1700.51,17,12,498,11,14,170051,14,462,1,8,0,8,36
1791.016,6,403,33678,228,107,7889,469,17089,175,129,10293,1452,16589
1.478,6,47,18763,26,928,59,1460,13147,21,433,64,1460,5616
240.366,6,41,8605,20,561,12650,1408,5537,21,218,12017,580,3068
0.927,6,28,7336,13,155,77,267,1301,15,543,58,1400,6035
303.242,6,54,19992,29,1002,10830,1372,11586,25,372,3053,2688,8406
1792.9,17,66,2766,65,14,28014,14,2730,1,8,0,8,36
782.171,2,7,224,7,8,130361,8,224,0,0,0,0,0
1.15,6,4,172,3,0,575,0,132,1,0,0,0,40
1775.333,1,58,4872,58,56,31146,56,4872,0,0,0,0,0
1791.524,6,244,35804,152,302,11864,302,26032,92,83,19687,83,9772
1740.624,17,30,7050,30,207,60021,207,7050,0,0,0,0,0
0.422,6,22,7255,12,318,37,600,1906,10,803,44,1448,5349
0.054,6,7,423,4,43,4,43,259,3,0,26,0,164
1794.867,17,87,3648,86,14,21116,14,3612,1,8,0,8,36
240.11,6,39,5105,19,247,13339,833,2728,20,166,12637,481,2377
0.074,17,2,362,1,46,0,46,74,1,260,0,260,288
3.053,17,2,1430,2,687,3053,687,1430,0,0,0,0,0
1.317,6,32,6507,15,164,94,267,1922,17,650,71,1452,4585
166.385,17,4,352,2,60,166383,60,176,2,60,166384,60,176
0.116,17,4,368,2,32,116,32,120,2,96,62,96,248
1793.362,17,87,3648,86,14,21098,14,3612,1,8,0,8,36
1793.776,1,151,8456,151,28,11958,28,8456,0,0,0,0,0
1799.124,6,363,24952,212,94,8526,469,14496,151,69,11991,69,10456
1.783,6,27,10195,16,287,118,595,1507,11,1030,160,1420,8688
1795.802,6,358,22669,209,69,8633,69,12500,149,69,12133,69,10169
153.783,6,80,16207,35,390,4098,1189,8054,45,288,3494,1460,8153
1.94,6,9,1002,5,213,485,213,417,4,421,237,421,585
599.722,6,9,546,6,31,119944,31,333,3,31,299782,31,213
1786.181,6,104,8444,68,66,26659,66,4964,36,60,51030,60,3480
1763.781,2,15,480,15,8,125984,8,480,0,0,0,0,0
1781.725,6,355,23781,184,69,9736,69,11638,171,64,10480,69,12143
74.063,17,4,352,2,60,74062,60,176,2,60,74062,60,176
2.059,6,20,3833,11,234,205,564,1504,9,463,234,1343,2329
1.283,6,41,11964,22,612,61,1460,6428,19,433,61,1460,5536
1799.16,6,367,25650,214,99,8446,469,15045,153,69,11836,69,10605
1711.388,1,8,448,8,28,244484,28,448,0,0,0,0,0
1786.492,6,105,8544,68,66,26664,66,4964,37,60,49622,60,3580
282.629,6,32,7991,13,143,23552,267,1386,19,486,15650,1400,6605
125.998,1,2,112,2,28,125998,28,112,0,0,0,0,0
6.578,17,23,8127,11,451,657,1350,5272,12,209,594,1350,2855
15.035,6,2359,2271033,1572,1369,9,1408,2225433,787,776,18,1408,45600
1793.057,6,429,25818,214,69,8418,69,12838,215,35,8378,69,12980
64.447,6,36,9195,16,297,114,1189,2732,20,514,3391,1917,6463
1761.997,6,105,8529,69,52,25911,205,5328,36,36,50337,98,3201
845.628,17,8,592,4,30,281822,30,232,4,62,281818,62,360
1799.997,6,217,16959,80,71,22404,336,8148,137,49,13235,143,8811
154.777,6,158,24202,85,304,1842,304,16756,73,83,2141,83,7446
1786.807,1,105,5880,105,28,17180,28,5880,0,0,0,0,0
13.41,6,14,2245,8,211,1913,211,846,6,545,2666,904,1399
17.526,17,33,14347,15,356,1249,1350,5773,18,448,1028,1350,8574
0.038,17,2,616,1,60,0,60,88,1,500,0,500,528
11.903,6,1909,1643971,1161,1362,10,1380,1609809,748,421,15,1923,34162
0.115,17,2,180,1,30,0,30,58,1,94,0,94,122
3.342,17,5,295,5,31,835,31,295,0,0,0,0,0
1763.988,2,15,480,15,8,125999,8,480,0,0,0,0,0
240.204,6,54,17489,29,776,8578,1408,14713,25,183,10008,580,2776
165.221,6,19,4571,8,271,494,515,1139,11,373,16481,1452,3432
151.426,6,20,8672,11,314,81,634,1415,9,1377,18910,3928,7257
11.87,6,1875,1639048,1134,1391,10,1420,1605187,741,467,16,1883,33861
0.475,6,13,1693,7,288,75,288,588,6,426,50,434,1105
1.212,6,46,17717,26,851,48,1360,12141,20,476,55,2715,5576
0.046,17,2,235,1,36,0,36,64,1,143,0,143,171
94.015,6,9,6255,3,100,141,100,224,6,1157,18750,1179,6031
31.621,6,7,396,1,0,0,0,60,6,0,6290,0,336
175.944,1,4,224,4,28,58648,28,224,0,0,0,0,0
11.455,6,1817,1578126,1116,1362,10,1380,1545844,701,383,16,1380,32282
7.381,6,790,667781,459,1376,15,1448,645905,331,776,21,1448,21876
1790.102,6,4195,3967893,1465,132,1222,350,85327,2730,1409,655,2836,3882566
280.213,6,30,7432,14,158,21554,267,1357,16,603,18678,2036,6075
95.2,17,2,136,2,40,95200,47,136,0,0,0,0,0
1788.335,17,87,3648,86,14,21039,14,3612,1,8,0,8,36
2.075,6,32,6433,18,154,122,267,1964,14,780,138,1531,4469
8.508,6,15,7863,5,189,2125,267,587,10,981,944,1997,7276
282.114,6,30,7432,13,158,23509,267,1317,17,543,17608,1400,6115
0.185,6,9,1050,5,261,46,261,465,4,421,40,421,585
1784.787,17,336,52923,336,129,5327,376,52923,0,0,0,0,0
0.993,2,3,128,3,18,496,24,128,0,0,0,0,0
291.542,6,29,8037,12,158,26503,267,1277,17,607,18218,1400,6760
191.937,6,32,12172,7,154,31989,267,752,25,520,7996,1420,11420
76.218,6,29,14863,15,585,63,1360,3557,14,1341,5852,3928,11306
1786.391,6,123,14329,78,83,23199,516,6118,45,156,40597,1452,8211
0.956,6,13,1981,7,288,154,288,876,6,426,150,434,1105
243.483,6,89,22631,44,181,5662,267,3944,45,625,5533,3436,18687
0.604,17,2,152,1,48,0,48,76,1,48,0,48,76
59.392,6,31,8912,14,158,4568,267,1357,17,687,3708,1781,7555
242.751,6,35,4183,15,180,17338,595,1868,20,181,12775,580,2315
1684.486,2,19,608,19,8,93582,8,608,0,0,0,0,0
1.888,17,22,7688,10,460,209,1350,4886,12,205,149,1350,2802
61.299,6,36,15924,22,804,2919,1408,9198,14,748,4696,2439,6726
247.205,17,4,240,2,32,247204,32,120,2,32,247203,32,120
2.061,17,2,144,1,36,0,36,64,1,52,0,52,80
8.545,6,26,11201,12,275,776,275,1034,14,873,522,1380,10167
1680.436,1,15,870,15,30,120031,30,870,0,0,0,0,0
1772.035,6,180,15480,120,69,14891,69,8940,60,69,30032,69,6540
1745.394,6,97,7307,63,38,28151,205,4476,34,33,52880,98,2831
1740.447,1,16,896,16,28,116029,28,896,0,0,0,0,0
2.038,6,25,8769,15,286,145,590,1462,10,986,207,1420,7307
0.017,17,2,467,1,41,0,41,69,1,370,0,370,398
0.005,6,2,92,1,0,0,0,40,1,0,0,0,52
11.417,6,1722,1394418,919,1415,12,1448,1340398,803,776,14,1448,54020
280.428,6,29,7392,13,158,23369,267,1317,16,678,18692,3456,6075
0.053,6,3,587,2,221,2,412,547,1,0,0,0,40
1230.866,17,215,16340,215,48,5751,48,16340,0,0,0,0,0
1795.752,17,448,39612,404,35,4455,288,25708,44,288,40948,288,13904
1774.294,6,181,15589,120,69,14910,69,8940,61,69,29567,69,6649
167.032,17,4,240,2,32,167031,32,120,2,32,167031,32,120
0.929,6,33,8071,17,241,58,619,1677,16,522,53,3488,6394
25.918,6,6,336,1,0,0,0,52,5,0,6479,0,284
1787.34,6,102,8212,68,63,26676,64,4888,34,57,54158,58,3324
266.135,17,4,304,2,48,266134,64,152,2,48,266134,64,152
1787.159,6,422,25277,211,69,8510,69,12580,211,34,8510,48,12697
15.195,17,3,228,2,48,15120,48,152,1,48,0,48,76
240.165,6,54,19112,29,772,8577,1408,16197,25,229,10006,580,2915
1779.975,17,142,11360,71,48,25428,48,5396,71,56,25428,56,5964
0.109,6,16,4818,8,215,12,215,639,8,938,13,1438,4179
