flow_duration,protocol,TotPackets,TotBytes,tot_fwd_pkts,totlen_fwd_pkts,fwd_iat_mean,fwd_pkt_len_max,fwd_pkt_len_mean,tot_bwd_pkts,totlen_bwd_pkts,bwd_iat_mean,bwd_pkt_len_max,bwd_pkt_len_mean
75.362,6,25,1028,12,0,4876,0,488,13,0,6277,0,540
0.891,6,11,1727,7,100,148,100,384,4,589,212,1152,1343
62.892,6,25,7097,12,155,5717,267,1266,13,589,5240,3426,5831
722.133,6,74,6341,48,69,15364,69,3645,26,69,28884,69,2696
0.465,6,6,398,2,0,2,0,128,4,31,112,31,270
6.034,17,4,428,2,47,6003,47,150,2,111,6003,111,278
0.012,17,2,912,1,308,0,308,336,1,548,0,548,576
1038.769,6,161,26869,94,201,11169,981,13433,67,176,15738,1420,13436
1785.923,6,102,8296,68,65,26655,65,4930,34,59,54116,59,3366
300.512,6,18,1227,5,177,75086,177,445,13,110,25028,110,782
1765.295,6,105,8188,68,45,26347,205,5037,37,35,49027,98,3151
0.521,6,16,5714,8,106,74,106,442,8,987,30,1917,5272
63.817,1,40,1120,40,0,0,0,1120,0,0,0,0,0
0.0,6,2,80,1,0,0,0,40,1,0,0,0,40
0.015,17,2,364,1,33,0,33,61,1,275,0,275,303
0.627,17,2,144,1,36,0,36,64,1,52,0,52,80
865.551,6,76,14172,32,165,7949,684,4013,44,254,20125,1360,10159
0.78,6,17,5164,9,150,97,174,664,8,835,97,1452,4500
0.006,17,2,223,1,36,0,36,64,1,131,0,131,159
1.391,6,37,8212,19,320,77,1162,2716,18,476,70,2715,5496
0.018,17,2,475,1,39,0,39,67,1,380,0,380,408
1787.001,6,104,8504,69,66,26279,66,5004,35,60,52555,60,3500
1792.761,6,356,22520,208,69,8660,69,12460,148,69,12194,69,10060
402.654,1,8,448,8,28,57522,28,448,0,0,0,0,0
1772.426,6,180,15480,120,69,14894,69,8940,60,69,30037,69,6540
209.86,6,49,10857,20,114,11044,267,2069,29,317,7494,2006,8788
300.85,6,45,10272,23,439,13675,910,3186,22,364,706,2128,7086
33.806,6,30,5042,15,154,2414,722,1859,15,399,2400,1440,3183
0.372,6,13,1693,7,288,58,288,588,6,426,40,434,1105
0.065,17,4,1379,4,316,21,355,1379,0,0,0,0,0
72.897,17,6,528,3,60,36446,60,264,3,60,36448,60,264
253.744,17,4,352,2,60,253743,60,176,2,60,253743,60,176
1796.278,6,371,26417,216,105,8354,469,15594,155,69,11661,69,10823
0.013,17,4,768,2,39,9,39,134,2,289,9,289,634
1781.335,17,142,11360,71,48,25447,48,5396,71,56,25447,56,5964
0.033,17,2,176,1,60,0,60,88,1,60,0,60,88
0.926,6,11,1727,7,100,154,100,384,4,589,215,1152,1343
2.53,6,15,5164,7,517,421,517,897,8,1913,357,2419,4267
0.18,1,2,112,2,28,180,28,112,0,0,0,0,0
1788.157,1,60,3360,60,28,30307,28,3360,0,0,0,0,0
1769.619,6,104,9648,68,65,26412,65,5758,36,59,50557,59,3890
299.526,6,6,364,4,31,99842,31,222,2,31,299509,31,142
1773.052,6,180,15480,120,69,14899,69,8940,60,69,30045,69,6540
1786.278,6,104,8376,68,65,26660,65,4930,36,59,51033,59,3446
9.607,6,1866,1751309,1170,1418,8,1448,1710453,696,776,13,1448,40856
0.01,17,2,382,1,32,0,32,60,1,294,0,294,322
1793.515,17,29,9512,29,300,64054,300,9512,0,0,0,0,0
14.83,6,13,5586,4,106,4943,106,274,9,822,1814,1460,5312
1795.655,6,356,22520,208,69,8674,69,12460,148,69,12215,69,10060
1742.408,6,94,7151,62,38,28564,205,4424,32,33,56199,98,2727
299.191,17,4,240,2,32,299190,32,120,2,32,299190,32,120
15.134,17,4,824,2,48,15118,48,152,2,308,15118,308,672
313.667,6,159,122707,99,1311,3200,1448,110086,60,632,2153,1448,12621
4.033,17,7,7079,2,723,4033,1350,1503,5,1087,866,1350,5576
21.214,17,12,1056,6,48,4240,48,456,6,72,4240,72,600
8.342,6,11,676,4,106,2777,106,274,7,90,1388,90,402
177.648,6,50,29777,29,1095,2880,1360,19810,21,911,8873,2720,9967
118.348,1,8,448,8,28,16906,28,448,0,0,0,0,0
1799.453,17,762,46002,762,32,2364,37,46002,0,0,0,0,0
1787.712,6,104,8441,69,65,26289,65,5035,35,59,52570,59,3406
1243.537,17,66,22176,66,308,19131,308,22176,0,0,0,0,0
1796.41,17,448,39896,403,35,4468,288,25676,45,288,40016,288,14220
0.498,17,3,234,2,39,232,39,134,1,72,0,72,100
5.751,6,39,7269,21,218,287,314,3463,18,513,322,1179,3806
1786.399,6,104,8308,68,64,26662,64,4896,36,58,51037,58,3412
1772.214,6,182,15629,121,69,14768,69,8980,61,69,29529,69,6649
300.938,6,42,11876,23,563,13679,1408,4634,19,446,636,2816,7242
1744.11,6,95,7203,63,38,28130,205,4476,32,33,56252,98,2727
0.254,6,20,4960,10,137,28,267,1092,10,692,27,1467,3868
0.792,6,12,1665,7,288,102,288,600,5,426,154,434,1065
60.936,6,8,432,5,0,15234,0,268,3,0,30462,0,164
255.612,17,4,352,2,60,255611,60,176,2,60,255611,60,176
1796.498,6,356,22520,208,69,8678,69,12460,148,69,12220,69,10060
1681.222,17,14,3843,7,30,280202,30,406,7,463,280203,463,3437
141.369,6,13,3814,7,407,23561,722,1174,6,774,28234,1440,2640
5.7,6,39,7269,19,218,316,314,3383,20,513,285,1179,3886
1683.088,17,14,1036,7,30,280501,30,406,7,62,280512,62,630
1680.408,1,15,870,15,30,120029,30,870,0,0,0,0,0
1776.338,17,140,11200,70,48,25743,48,5320,70,56,25743,56,5880
12.246,17,20,4563,10,46,1360,46,740,10,354,1360,369,3823
117.94,1,6,336,6,28,23588,28,336,0,0,0,0,0
1.896,6,9,527,5,43,474,43,311,4,0,597,0,216
3.079,17,4,842,2,47,3065,47,150,2,318,3058,318,692
10.614,6,18,4266,10,275,1179,275,958,8,992,833,1440,3308
25.55,6,3817,3680877,2551,1366,10,1408,3610283,1266,792,20,1408,70594
1798.422,6,375,26177,217,98,8326,469,15303,158,69,11453,69,10874
1.229,6,23,7952,12,164,94,267,1288,11,1216,104,3819,6664
22.722,17,7,532,7,48,3787,48,532,0,0,0,0,0
240.228,6,55,19787,30,851,8283,1418,16899,25,197,10009,580,2888
1.03,17,7,5688,3,468,515,1350,1490,4,1021,226,1350,4198
0.25,17,2,136,1,32,0,32,60,1,48,0,48,76
2.662,17,4,768,2,32,2650,32,120,2,296,2636,296,648
1740.475,17,30,31680,30,1028,60016,1028,31680,0,0,0,0,0
1799.414,17,769,46429,769,32,2342,37,46429,0,0,0,0,0
38.068,6,37,8495,17,410,580,882,1942,20,441,1995,1440,6553
1786.768,6,102,8228,68,64,26668,64,4896,34,58,54141,58,3332
48.989,6,37,8495,18,410,510,882,1982,19,441,2714,1460,6513
1771.895,6,99,9306,66,66,27259,66,5610,33,60,55368,60,3696
4.335,6,38,7229,19,218,240,314,3383,19,440,226,1152,3846
1783.802,6,359,22778,209,69,8575,69,12638,150,69,11971,69,10140
300.141,6,25,17629,15,213,21438,517,1628,10,3094,33348,8448,16001
140.607,6,32,8952,14,158,10815,267,1357,18,624,8267,1400,7595
1.43,6,21,9672,8,186,204,267,701,13,844,75,1420,8971
1744.828,6,95,7203,63,38,28142,205,4476,32,33,56278,98,2727
9.004,6,3,180,3,0,0,0,180,0,0,0,0,0
1781.498,1,232,12992,232,28,7712,28,12992,0,0,0,0,0
255.517,6,26,11485,9,140,31939,267,929,17,822,15968,1997,10556
0.102,1,2,112,2,28,102,28,112,0,0,0,0,0
0.109,17,4,588,2,48,96,48,152,2,190,90,308,436
0.519,6,17,6337,9,141,64,275,646,8,894,29,1414,5691
1744.953,6,108,7844,68,31,26044,31,4650,40,31,44741,31,3194
0.017,17,2,225,1,31,0,31,59,1,138,0,138,166
0.132,17,2,586,1,46,0,46,74,1,484,0,484,512
595.066,6,9,546,6,31,119013,31,333,3,31,297525,31,213
374.175,6,21,1419,15,177,26726,177,989,6,110,12251,110,430
0.061,17,2,396,1,40,0,40,68,1,300,0,300,328
9.989,6,14,2046,8,211,1424,211,635,6,545,1997,904,1411
50.942,17,2,672,2,308,50942,308,672,0,0,0,0,0
45.9,6,30,7297,14,155,3530,267,1346,16,441,3059,1420,5951
0.006,17,2,417,1,34,0,34,62,1,327,0,327,355
0.751,17,4,288,2,36,719,36,128,2,52,718,52,160
280.298,6,30,7432,13,158,23358,267,1317,17,543,17513,1300,6115
1797.382,17,87,3648,86,14,21145,14,3612,1,8,0,8,36
1.033,6,29,8512,15,222,61,540,1976,14,852,64,1360,6536
7.898,17,6,456,6,48,1579,48,456,0,0,0,0,0
0.065,17,2,262,1,39,0,39,67,1,167,0,167,195
39.883,17,4,352,2,60,39882,60,176,2,60,39881,60,176
4.535,6,64,22087,32,847,146,1440,11552,32,543,140,1440,10535
362.602,6,258,263959,72,791,5107,982,10438,186,1409,1959,2880,253521
66.02,6,37,19524,21,1053,3301,1448,11658,16,702,4388,1448,7866
300.328,6,51,29823,22,190,14301,444,1925,29,1147,8606,1551,27898
1795.44,17,449,39928,404,35,4455,288,25708,45,288,40020,288,14220
0.818,6,3,258,1,0,0,0,40,2,69,500,69,218
2.376,6,29,10374,17,368,148,837,1789,12,1012,208,1420,8585
1.159,6,24,8004,12,164,89,267,1288,12,1014,89,2816,6716
1797.106,1,216,22896,216,78,8358,78,22896,0,0,0,0,0
1776.923,17,73,3060,72,14,25027,14,3024,1,8,0,8,36
131.485,17,4,240,2,32,131484,32,120,2,32,131484,32,120
0.543,6,10,1671,6,552,108,948,1348,4,159,180,159,323
1750.604,17,12,498,11,14,175060,14,462,1,8,0,8,36
8.596,6,812,709979,497,1347,17,1368,686203,315,776,26,1473,23776
0.219,17,2,170,1,37,0,37,65,1,77,0,77,105
1793.862,1,86,7224,86,56,21104,56,7224,0,0,0,0,0
1794.014,17,144,11520,72,48,25267,48,5472,72,56,25267,56,6048
266.328,17,15,2632,15,147,19023,207,2632,0,0,0,0,0
1769.394,1,58,4872,0,0,0,0,0,58,56,31042,56,4872
213.858,6,6,1255,4,327,71286,413,814,2,180,213666,269,441
280.223,6,26,7272,12,158,25474,267,1277,14,775,21552,2800,5995
8.302,6,1668,1546632,1063,1378,7,1408,1510508,605,931,13,2801,36124
1773.365,17,140,11200,70,48,25700,48,5320,70,56,25700,56,5880
1742.866,6,109,7896,68,31,26012,31,4650,41,31,43571,31,3246
84.564,6,24,13245,12,279,77,527,1349,12,1425,7671,2720,11896
253.108,6,21,5102,8,272,292,516,1140,13,312,21063,1452,3962
194.671,6,34,8211,11,130,7639,267,1364,23,311,8848,2006,6847
1680.686,1,15,840,15,28,120049,28,840,0,0,0,0,0
0.623,6,24,5980,12,164,56,453,1442,12,651,51,1448,4538
1796.82,1,345,28980,345,56,5223,56,28980,0,0,0,0,0
0.248,17,2,136,1,32,0,32,60,1,48,0,48,76
1796.151,17,448,39896,403,35,4468,288,25676,45,288,40019,288,14220
0.003,17,8,2750,8,315,0,354,2750,0,0,0,0,0
280.628,6,28,7352,13,158,23385,267,1317,15,678,20039,2800,6035
1776.945,6,276,33699,111,141,16152,1440,16531,165,128,10834,1702,17168
10.562,6,85,25170,43,550,251,1152,19349,42,459,251,1179,5821
89.472,6,698,318975,355,829,247,1152,299409,343,417,260,1179,19566
221.87,6,29,7392,13,158,18489,267,1317,16,603,14788,2036,6075
1792.014,6,356,22520,208,69,8657,69,12460,148,69,12188,69,10060
43.261,6,45,14761,24,1011,508,1360,9119,21,435,2154,2720,5642
1788.093,6,5514,5061645,2279,130,784,333,134805,3235,1504,552,4224,4926840
1743.62,6,108,8058,67,38,26418,205,4746,41,33,43582,98,3312
1786.933,1,140,7840,140,28,12855,28,7840,0,0,0,0,0
5.109,6,40,7309,21,218,255,314,3463,19,513,269,1179,3846
1772.481,1,58,4872,58,56,31096,56,4872,0,0,0,0,0
9.628,6,86,24645,44,550,223,1152,18824,42,413,228,1152,5821
122.858,6,30,10435,11,216,239,314,1956,19,701,6811,1179,8479
1783.813,6,366,25541,213,99,8414,469,15005,153,69,11735,69,10536
1.709,6,9,527,5,43,427,43,311,4,0,566,0,216
240.174,6,53,17645,28,783,8895,1408,14786,25,193,10007,580,2859
1799.513,17,448,39896,403,35,4476,288,25676,45,288,40021,288,14220
0.314,17,4,608,2,60,1,60,176,2,188,0,188,432
1799.472,17,180,14040,180,50,10052,50,14040,0,0,0,0,0
338.685,6,32,2520,17,65,21156,205,1340,15,37,24177,98,1180
1.354,6,49,20474,28,913,50,1360,14858,21,433,58,1360,5616
367.086,6,25,1651,17,177,22942,177,1117,8,110,9175,110,534
51.522,17,4,352,2,60,51520,60,176,2,60,51521,60,176
1649.333,1,7,392,7,28,274888,28,392,0,0,0,0,0
12.176,6,1918,1672021,1163,1382,10,1420,1637600,755,467,16,1883,34421
1773.79,1,61,5124,61,56,29563,56,5124,0,0,0,0,0
51.108,6,6417,6196619,4321,1357,11,1408,6082865,2096,950,24,2801,113754
281.431,6,33,7552,14,158,21648,267,1357,19,543,15634,1400,6195
5.274,17,4,288,2,36,5009,36,128,2,52,4934,52,160
3.268,17,2,668,2,306,3268,306,668,0,0,0,0,0
295.131,1,4,224,4,28,98377,28,224,0,0,0,0,0
232.941,6,32,8952,14,158,17918,267,1357,18,624,13698,1400,7595
1794.995,6,132,12807,80,62,22721,722,6561,52,84,35189,1408,6246
300.154,6,26,6862,12,158,27285,267,1277,14,627,23088,1400,5585
5.904,6,40,7325,21,218,295,314,3463,19,516,313,1179,3862
1624.322,2,18,576,18,8,95548,8,576,0,0,0,0,0
4.194,6,40,7309,20,218,220,314,3423,20,440,207,1152,3886
6.944,6,1289,1138970,783,1375,8,1408,1107982,506,931,13,2816,30988
240.203,6,55,17604,30,735,8282,1402,14809,25,185,10008,580,2795
1770.689,6,101,9344,66,65,27241,65,5577,35,59,52075,59,3767
1260.614,2,11,352,11,8,126061,8,352,0,0,0,0,0
139.924,17,12,1056,6,48,27983,48,456,6,72,27983,72,600
0.687,17,2,158,1,34,0,34,62,1,68,0,68,96
0.153,17,2,2380,2,1162,153,1162,2380,0,0,0,0,0
186.897,6,179,142261,113,1340,1668,1448,127849,66,645,2307,2896,14412
1.639,6,26,5680,14,121,126,267,1295,12,650,143,1420,4385
0.203,6,25,7216,12,155,18,267,1261,13,678,15,2800,5955
124.62,6,9,408,4,0,41540,0,168,5,0,3811,0,240
0.244,17,2,144,1,36,0,36,64,1,52,0,52,80
76.536,6,89,46365,41,892,1913,1354,8412,48,908,1627,1491,37953
0.69,6,2,80,1,0,0,0,40,1,0,0,0,40
101.904,6,31,13370,16,555,73,928,4004,15,795,7269,2720,9366
1785.861,6,383,26635,218,97,8229,469,15619,165,69,10889,69,11016
1082.968,2,9,288,9,8,135371,8,288,0,0,0,0,0
0.238,17,3,451,2,39,21,39,134,1,289,0,289,317
64.488,6,8202,7994203,5536,1367,11,1408,7850785,2666,792,24,1408,143418
1790.214,6,363,23007,210,69,8565,69,12747,153,69,11777,69,10260
38.208,17,22,1936,11,48,3816,48,836,11,72,3817,72,1100
0.032,17,2,214,1,39,0,39,67,1,119,0,119,147
0.303,6,22,5040,11,137,30,267,1132,11,577,28,1400,3908
16.51,6,6,328,4,0,5503,0,216,2,0,16502,0,112
300.81,6,48,10574,26,619,12032,1360,4847,22,402,612,2667,5727
120.363,6,9,520,3,112,60178,112,240,6,0,24070,0,280
11.302,6,1795,1561405,1086,1384,10,1420,1528824,709,420,15,1420,32581
1.656,6,25,8056,12,164,126,267,1288,13,869,117,1448,6768
1745.551,6,95,7203,63,38,28154,205,4476,32,33,56297,98,2727
0.5,17,3,451,2,39,230,39,134,1,289,0,289,317
0.26,6,7,466,5,43,56,43,354,2,0,254,0,112
0.014,17,2,393,1,32,0,32,60,1,305,0,305,333
33.634,6,31,5107,16,154,2230,722,1924,15,399,2390,1448,3183
151.796,17,968,46464,484,20,314,20,23232,484,20,314,20,23232
0.012,17,2,216,1,45,0,45,73,1,115,0,115,143
0.247,6,17,4062,10,75,27,75,603,7,771,41,1500,3459
371.307,6,25,1651,17,177,23206,177,1117,8,110,9223,110,534
1739.546,6,224,24509,113,118,15531,721,13431,111,147,15811,2840,11078
1.655,6,13,2311,8,188,236,245,700,5,1407,350,1407,1611
1764.505,2,15,480,15,8,126036,8,480,0,0,0,0,0
1383.665,2,12,384,12,8,125787,8,384,0,0,0,0,0
505.22,17,15,5512,15,339,36087,548,5512,0,0,0,0,0
1.122,6,12,1653,6,288,220,288,548,6,426,114,434,1105
1787.571,17,87,3648,86,14,21030,14,3612,1,8,0,8,36
19.56,17,21,8186,9,483,2445,1350,4607,12,270,1608,1350,3579
0.51,6,127,88131,59,131,8,232,2889,68,1330,7,2471,85242
2.18,17,4,314,2,31,2149,31,118,2,70,2143,70,196
364.287,6,25,1639,16,177,24285,177,1053,9,110,8499,110,586
0.337,6,20,7151,12,318,30,600,1906,8,964,45,1471,5245
51.139,6,31,5470,10,204,2183,722,1552,21,234,2548,1408,3918
0.101,17,2,1918,2,931,101,931,1918,0,0,0,0,0
144.865,17,4,352,2,60,144864,60,176,2,60,144864,60,176
0.181,6,2,92,1,0,0,0,52,1,0,0,0,40
0.005,17,2,366,1,37,0,37,65,1,273,0,273,301
40.189,17,6,1968,6,300,8037,300,1968,0,0,0,0,0
66.026,17,4,352,2,60,66025,60,176,2,60,66025,60,176
1.376,6,50,20576,27,983,52,1460,14880,23,433,54,1460,5696
0.122,6,2,92,1,0,0,0,52,1,0,0,0,40
1785.598,17,19,6276,19,302,99199,1438,6276,0,0,0,0,0
0.496,6,59,24802,32,1075,16,1380,17512,27,515,17,1923,7290
240.317,6,43,9005,21,524,12015,1418,5816,22,226,11442,639,3189
0.529,6,21,5000,11,137,52,267,1132,10,692,57,1467,3868
337.566,6,205,164680,129,1337,2637,1448,149847,76,604,1709,1448,14833
81.245,6,29,5176,15,170,5803,722,1966,14,495,6233,2329,3210
1629.845,17,21,6770,21,294,81492,1115,6770,0,0,0,0,0
0.037,17,2,158,1,34,0,34,62,1,68,0,68,96
300.56,6,18,1227,5,177,75096,177,445,13,110,25032,110,782
280.016,6,30,7432,13,158,23334,267,1317,17,543,17498,1300,6115
1680.138,1,7,392,7,28,280023,28,392,0,0,0,0,0
0.043,17,4,304,2,37,0,37,130,2,59,0,65,174
1750.893,17,12,498,11,14,175089,14,462,1,8,0,8,36
1787.726,6,104,8308,68,64,26682,64,4896,36,58,51075,58,3412
9.024,6,16,4090,8,275,1289,275,878,8,1440,1146,1440,3212
1776.603,17,140,11200,70,48,25747,48,5320,70,56,25747,56,5880
125.429,6,5,267,3,0,62714,0,152,2,7,125198,7,115
20.146,6,23,6033,13,107,1678,159,1138,10,727,2237,1418,4895
0.033,17,2,236,1,43,0,43,71,1,137,0,137,165
365.058,6,72,4669,38,69,8302,69,2279,34,68,11062,69,2390
2.96,6,11,976,5,283,697,283,551,6,105,558,105,425
1.931,6,16,2431,9,125,241,245,740,7,703,278,1152,1691
252.521,2,2,64,2,8,252521,8,64,0,0,0,0,0
12.233,17,5,5022,5,976,3058,1451,5022,0,0,0,0,0
3.092,6,2,88,2,0,0,0,88,0,0,0,0,0
0.779,6,148,96266,77,1303,10,1420,89135,71,427,10,1420,7131
213.175,17,4,240,2,32,213173,32,120,2,32,213174,32,120
180.515,2,2,64,2,8,180515,8,64,0,0,0,0,0
0.411,6,12,1653,6,288,80,288,548,6,426,45,434,1105
72.211,6,29,7464,12,155,6564,267,1266,17,459,4512,3426,6198
0.458,17,2,178,1,47,0,47,75,1,75,0,75,103
0.472,6,20,4960,10,137,52,267,1092,10,692,50,1467,3868
1077.73,6,222,14055,127,69,8553,69,7771,95,69,11465,69,6284
2.427,6,10,1687,7,100,404,100,384,3,1179,1082,1179,1303
0.428,6,27,8942,13,232,35,569,1614,14,941,31,1438,7328
20.19,6,18,2368,10,189,2243,517,1298,8,323,2879,499,1070
3.2,6,190,199558,129,133,25,201,5727,61,3479,50,14140,193831
1799.949,1,16,896,16,28,119996,28,896,0,0,0,0,0
989.255,17,703,49463,628,40,1577,41,43118,75,56,562,57,6345
1797.226,6,367,23236,212,69,8517,69,12896,155,69,11670,69,10340
0.01,17,2,318,1,39,0,39,67,1,223,0,223,251
21.879,6,556,430048,276,1218,79,1460,70794,280,1392,77,2920,359254
31.044,17,6,638,6,78,6208,84,638,0,0,0,0,0
0.044,6,2,111,1,0,0,0,40,1,31,0,31,71
0.664,17,4,556,2,36,659,36,128,2,186,659,186,428
1773.417,6,180,15480,120,69,14902,69,8940,60,69,30049,69,6540
5.339,6,43,8345,21,227,266,314,4022,22,491,241,1179,4323
8.765,6,24,8313,12,481,796,721,2411,12,774,567,1440,5902
1319.683,17,2913,139824,1457,20,906,20,69936,1456,20,906,20,69888
1.822,6,28,8889,17,286,113,590,1542,11,862,162,1380,7347
1785.83,1,58,4872,58,56,31330,56,4872,0,0,0,0,0
809.114,17,10,821,5,31,202274,37,297,5,76,202275,136,524
33.752,6,30,5043,15,180,2410,722,1859,15,342,2396,1408,3184
967.219,17,48,2010,47,14,21026,14,1974,1,8,0,8,36
1789.301,6,356,22520,208,69,8643,69,12460,148,69,12172,69,10060
3.543,6,90,48141,46,872,78,1368,10255,44,1078,81,1368,37886
1787.145,6,151,21296,90,239,20080,1294,14360,61,99,29783,268,6936
1750.633,6,102,7703,66,38,26932,205,4663,36,33,49973,98,3040
33.544,6,32,5157,15,154,2396,722,1870,17,299,2085,1408,3287
1.383,6,23,5779,13,184,114,385,1446,10,982,151,1691,4333
0.161,6,44,20771,26,1055,6,1420,15830,18,467,9,1883,4941
300.643,6,39,8325,21,245,15032,633,1852,18,441,500,1360,6473
334.678,1,18,1008,18,28,19686,28,1008,0,0,0,0,0
1744.615,2,27,864,27,8,67100,8,864,0,0,0,0,0
1787.805,1,342,28728,342,56,5242,56,28728,0,0,0,0,0
37.846,17,11,836,11,48,3784,48,836,0,0,0,0,0
1779.905,1,341,28644,341,56,5235,56,28644,0,0,0,0,0
1303.19,2,39,1624,39,17,34294,24,1624,0,0,0,0,0
1.288,6,49,19468,27,907,49,1440,13812,22,433,53,1440,5656
1138.452,6,78,23121,43,504,27106,1360,11352,35,517,33479,3494,11769
1786.9,6,110,8746,70,65,25897,65,5140,40,59,45814,59,3606
1747.143,6,24,3624,16,241,116476,241,2568,8,92,249562,92,1056
11.439,6,26,9953,13,275,953,275,1078,13,1042,870,1440,8875
175.853,17,4,352,2,60,175852,60,176,2,60,175852,60,176
1.014,17,4,1140,2,30,1000,30,116,2,484,999,484,1024
0.123,17,2,382,1,32,0,32,60,1,294,0,294,322
0.694,6,25,6080,13,108,57,147,959,12,662,62,1420,5121
1741.618,17,30,31680,30,1028,60055,1028,31680,0,0,0,0,0
38.406,6,46,9033,25,414,394,927,2346,21,448,1913,4848,6687
1680.604,17,12,498,11,14,168060,14,462,1,8,0,8,36
1799.81,17,450,39960,405,35,4454,288,25740,45,288,40017,288,14220
25.811,6,62,23780,34,1165,420,1360,17782,28,374,949,2667,5998
5.24,6,39,7269,19,218,291,314,3383,20,513,260,1179,3886
1746.484,17,327,57000,327,146,5357,392,57000,0,0,0,0,0
1798.137,6,368,25690,215,99,8402,469,15085,153,69,11827,69,10605
3.206,17,5,295,5,31,801,31,295,0,0,0,0,0
0.03,17,2,251,1,36,0,36,64,1,159,0,159,187
281.727,1,3,180,3,32,140863,32,180,0,0,0,0,0
1765.346,6,103,8084,68,45,26348,205,5037,35,35,51913,98,3047
1.336,6,38,8254,19,321,74,1164,2718,19,433,64,1360,5536
783.551,1,4,224,4,28,261183,28,224,0,0,0,0,0
0.921,6,31,12112,17,522,57,1360,3358,14,818,57,1370,8754
1784.147,17,73,3060,72,14,25128,14,3024,1,8,0,8,36
26.514,6,24,3286,13,171,2209,171,1197,11,251,2649,476,2089
124.908,6,34,7935,12,155,34,267,1266,22,340,5947,3417,6669
0.334,6,22,4467,11,165,33,456,1394,11,498,31,888,3073
16.426,6,411,327438,231,1346,70,1368,312298,180,776,90,2736,15140
300.709,6,44,8681,22,241,14319,618,1925,22,344,484,1440,6756
191.121,17,14,2226,10,31,21235,37,594,4,380,54481,463,1632
280.03,6,28,7352,13,158,23335,267,1317,15,678,20000,2045,6035
1.742,6,3,127,1,0,0,0,40,2,7,0,7,87
300.781,6,50,10526,25,433,12532,910,3258,25,312,530,1460,7268
0.225,6,28,7336,13,155,18,267,1301,15,543,15,1400,6035
8.386,6,22,9875,11,275,838,275,723,11,1242,751,1440,9152
1796.014,6,207,37441,119,327,15210,1294,24424,88,160,20642,1380,13017
0.006,17,2,415,1,65,0,65,93,1,294,0,294,322
2.021,17,4,668,2,39,2010,39,134,2,239,3,239,534
99.253,6,15,1471,5,275,688,275,483,10,96,11007,96,988
3.014,17,4,292,2,37,3007,37,130,2,53,3006,53,162
1771.945,6,180,15480,120,69,14890,69,8940,60,69,30030,69,6540
1786.902,6,106,8456,68,65,26670,65,4930,38,59,48291,59,3526
1785.606,6,102,8296,68,65,26650,65,4930,34,59,54103,59,3366
280.379,6,28,7352,12,158,25489,267,1277,16,603,18685,1400,6075
7.301,6,14,1844,8,514,1042,514,946,6,562,1460,562,898
280.634,6,29,7392,13,158,23386,267,1317,16,603,18703,2076,6075
31.908,6,234,224281,81,133,398,323,4613,153,1411,209,2836,219668
16.36,6,35,7574,18,201,962,314,3549,17,417,999,643,4025
9.585,6,9,527,5,43,2396,43,311,4,0,3156,0,216
69.454,6,27,7108,12,155,6314,267,1266,15,475,4951,1460,5842
1779.884,6,371,23603,214,69,8356,69,13183,157,69,11409,69,10420
1794.426,17,87,3648,86,14,21110,14,3612,1,8,0,8,36
2.915,17,4,624,4,128,971,128,624,0,0,0,0,0
1741.787,6,87,6322,58,31,30557,31,3915,29,31,62201,31,2407
1798.725,6,372,25988,216,98,8366,469,15263,156,69,11604,69,10725
0.515,17,3,451,2,39,480,39,134,1,289,0,289,317
1756.037,6,107,6374,60,27,29762,27,3525,47,27,38173,27,2849
1134.704,2,8,256,8,8,162100,8,256,0,0,0,0,0
110.613,17,4,352,2,60,110612,60,176,2,60,110612,60,176
1772.311,6,180,15480,120,69,14893,69,8940,60,69,30036,69,6540
1744.659,2,15,480,15,8,124618,8,480,0,0,0,0,0
377.19,6,18,1242,14,180,29014,180,916,4,110,20062,110,326
17.977,6,3157,2987599,2006,1410,8,1448,2923083,1151,776,15,1448,64516
1683.785,17,14,1036,7,30,280625,30,406,7,62,280625,62,630
5.911,6,28,7062,16,282,394,613,2803,12,725,519,1767,4259
0.141,6,3,132,2,0,0,0,92,1,0,0,0,40
365.84,17,8,2688,8,308,52262,308,2688,0,0,0,0,0
61.701,1,5,140,5,0,0,0,140,0,0,0,0,0
57.678,6,6,240,0,0,0,0,0,6,0,0,0,240
0.308,6,28,9001,14,227,23,547,1644,14,827,23,1408,7357
1.39,6,32,8952,14,158,106,267,1357,18,624,76,1400,7595
1777.619,17,130,10400,65,48,27775,48,4940,65,56,27775,56,5460
0.227,6,4,1037,2,0,220,0,104,2,853,9,853,933
1797.179,17,448,39896,403,35,4470,288,25676,45,288,40015,288,14220
15.454,17,20,13678,12,919,1399,1350,11375,8,259,2195,1350,2303
1.864,6,20,3833,10,234,207,564,1452,10,463,184,1343,2381
11.62,6,36,7880,17,237,726,335,2824,19,476,630,1152,5056
16.769,17,32,7910,14,267,1287,1350,4131,18,181,984,1350,3779
1.409,6,19,3781,10,234,156,564,1452,9,463,153,1343,2329
1.292,6,38,9848,20,502,68,1440,4352,18,433,65,1440,5496
154.364,6,23,1675,17,43,9647,43,1315,6,0,30871,0,360
1788.001,6,102,8160,68,63,26686,63,4862,34,57,54179,57,3298
2.832,6,36,21413,20,687,149,1360,5658,16,2157,179,7184,15755
0.603,6,7,371,4,0,201,0,204,3,7,149,7,167
1.335,6,50,18882,27,862,51,1360,13186,23,433,52,1360,5696
0.989,6,27,8120,14,266,63,540,1924,13,944,66,1591,6196
531.513,17,61,70821,61,1133,8858,1451,70821,0,0,0,0,0
3.61,17,5,295,5,31,902,31,295,0,0,0,0,0
0.989,6,27,8420,15,222,58,540,1964,12,1192,75,3151,6456
1787.02,17,89,3729,87,13,20777,14,3649,2,12,1786837,16,80
1783.652,6,354,22440,207,69,8658,69,12420,147,69,12216,69,10020
242.698,2,3,96,3,8,121349,8,96,0,0,0,0,0
1783.358,17,83,3480,82,14,22016,14,3444,1,8,0,8,36
0.425,6,12,802,7,71,70,71,443,5,83,100,83,359
7.203,6,26,7500,12,357,654,721,1555,14,597,475,1420,5945
1772.661,6,181,15589,120,69,14896,69,8940,61,69,29540,69,6649
1.84,6,51,18866,28,920,68,1460,13125,23,400,71,1460,5741
0.47,6,19,6986,11,249,47,517,1458,8,866,53,1420,5528
1792.251,17,211,41732,211,169,8534,377,41732,0,0,0,0,0
0.009,6,4,222,2,31,9,31,111,2,31,2,31,111
72.106,6,30,7504,12,155,6555,267,1266,18,423,4241,2840,6238
1796.374,17,448,39612,404,35,4457,288,25708,44,288,40949,288,13904
1797.708,17,449,39928,404,35,4460,288,25708,45,288,40019,288,14220
97.176,6,49,21206,28,863,3599,1402,18716,21,198,4517,580,2490
280.2,6,27,7312,13,158,23350,267,1317,14,775,21549,4200,5995
0.372,17,2,152,1,48,0,48,76,1,48,0,48,76
156.633,2,3,96,3,8,78316,8,96,0,0,0,0,0
1770.777,6,99,9306,66,66,27242,66,5610,33,60,55334,60,3696
0.805,6,20,5962,11,286,80,558,1302,9,716,90,1420,4660
1796.55,1,54,4536,54,56,33897,56,4536,0,0,0,0,0
360.956,2,5,160,5,8,90239,8,160,0,0,0,0,0
280.505,6,29,7392,13,158,23375,267,1317,16,678,18696,2760,6075
110.3,6,38,9675,11,155,738,267,1226,27,367,4241,1452,8449
1790.091,6,378,23952,216,69,8326,69,13332,162,69,11118,69,10620
1.408,6,50,18942,29,862,50,1360,13281,21,437,61,2720,5661
4.584,6,38,7245,19,218,254,314,3383,19,516,240,1179,3862
280.301,6,28,7352,13,158,23358,267,1317,15,603,20019,2036,6035
55.35,6,31,8776,15,290,3953,965,2351,16,481,3689,3417,6425
0.265,17,2,237,1,72,0,72,100,1,109,0,109,137
97.007,6,44,9996,22,635,735,1360,4159,22,329,4611,4027,5837
62.972,6,62,37766,37,1158,1749,1408,29726,25,841,2558,2439,8040
12.722,6,25,5415,12,225,1156,383,2065,13,471,1038,1179,3350
1790.523,6,365,23087,211,69,8526,69,12787,154,69,11702,69,10300
1798.248,6,134,8778,77,54,23661,208,5568,57,31,32104,31,3210
32.317,6,35,8439,17,410,549,882,1966,18,478,1891,2128,6473
0.026,17,2,543,1,45,0,45,73,1,442,0,442,470
1523.695,6,321,26342,183,121,8117,965,14112,138,108,11121,485,12230
463.81,6,89,14370,44,370,10786,751,6474,45,145,10539,1540,7896
0.174,6,46,20880,26,1057,6,1420,15859,20,467,8,1883,5021
368.28,6,23,1538,16,180,24552,180,1056,7,110,10377,110,482
1.268,6,41,11378,22,547,60,1360,5842,19,433,60,1360,5536
0.109,17,2,2384,2,1164,109,1164,2384,0,0,0,0,0
62.554,6,35,5313,19,154,3475,722,2078,16,342,1136,1448,3235
3.753,6,94,78475,65,946,58,1360,13057,29,3381,129,14960,65418
189.753,17,4,1358,4,311,63251,329,1358,0,0,0,0,0
0.581,6,23,7394,13,335,48,668,2026,10,968,58,1946,5368
316.759,6,8,475,6,31,63351,31,333,2,31,299666,31,142
204.534,17,4,352,2,60,204533,60,176,2,60,204533,60,176
0.791,6,51,21264,28,992,29,1380,16102,23,383,34,1380,5162
1791.13,6,355,22480,207,69,8694,69,12420,148,69,12184,69,10060
0.893,6,11,1727,7,100,148,100,384,4,589,212,1152,1343
1.767,17,3,468,3,128,883,128,468,0,0,0,0,0
0.115,6,9,1002,5,213,28,213,417,4,421,33,421,585
13.858,17,4,824,2,48,13848,48,152,2,308,13847,308,672
1585.215,6,42,7420,29,241,56614,241,5980,13,92,132084,92,1440
1786.14,6,108,8536,68,65,26658,65,4930,40,59,45796,59,3606
58.56,6,30,8872,14,158,4504,267,1357,16,763,3891,2236,7515
0.608,6,20,4960,10,137,67,267,1092,10,692,57,1467,3868
316.978,6,74,18858,38,325,8566,1460,9699,36,321,9052,1460,9159
1796.049,6,356,22520,208,69,8676,69,12460,148,69,12217,69,10060
368.729,6,58,10280,26,100,14749,267,2654,32,234,11890,1460,7626
287.975,17,4,240,2,32,287974,32,120,2,32,287974,32,120
136.366,6,12,492,6,0,27273,0,244,6,0,27271,0,248
1744.769,6,95,7203,63,38,28141,205,4476,32,33,56274,98,2727
0.61,6,23,7324,13,319,50,602,1960,10,967,62,1946,5364
31.928,6,7,336,1,0,0,0,48,6,0,6321,0,288
284.368,17,4,352,2,60,284367,60,176,2,60,284367,60,176
1740.465,17,30,31680,30,1028,60016,1028,31680,0,0,0,0,0
0.41,6,22,7255,12,318,37,600,1906,10,964,43,1471,5349
1.604,6,19,3781,10,234,178,564,1452,9,463,177,1343,2329
366.334,6,27,1767,18,177,21549,177,1181,9,110,8533,110,586
1778.375,17,277,59103,277,185,6443,422,59103,0,0,0,0,0
0.171,6,3,151,2,31,0,31,111,1,0,0,0,40
15.881,17,15,5224,7,360,2634,1350,2716,8,285,2256,1350,2508
200.866,6,42,7744,19,153,11156,517,1952,23,417,9128,1408,5792
18.905,17,31,7256,14,284,1452,1350,4373,17,141,1179,1350,2883
3.348,6,2,88,2,0,0,0,88,0,0,0,0,0
7.537,6,25,7433,12,155,685,267,1266,13,626,627,3426,6167
41.613,17,3,228,3,48,20806,48,228,0,0,0,0,0
1795.033,17,80,3354,79,14,23013,14,3318,1,8,0,8,36
4.327,17,4,824,2,48,4302,48,152,2,308,4306,308,672
0.053,17,2,237,1,72,0,72,100,1,109,0,109,137
0.59,2,2,80,2,16,590,16,80,0,0,0,0,0
1779.025,6,185,17188,122,83,14702,965,9985,63,74,28691,405,7203
0.048,17,8,2446,8,277,6,316,2446,0,0,0,0,0
280.494,6,30,7432,13,158,23374,267,1317,17,543,17525,1400,6115
1798.143,1,162,9072,162,28,11168,28,9072,0,0,0,0,0
46.948,6,17,6252,4,106,15649,106,274,13,495,3909,1420,5978
41.862,6,6,328,4,0,13954,0,216,2,0,41852,0,112
68.867,6,32,7722,13,141,5738,267,1375,19,371,3815,1460,6347
0.108,6,55,47108,36,273,3,517,2773,19,2889,5,15488,44335
0.135,17,4,284,2,32,0,32,120,2,54,87,60,164
2.365,6,51,22442,29,974,84,1460,16786,22,476,97,2615,5656
233.511,17,4,352,2,60,233508,60,176,2,60,233510,60,176
19.049,6,17,3329,9,211,2380,211,922,8,665,2707,904,2407
0.05,17,2,347,1,29,0,29,57,1,262,0,262,290
9.975,17,18,11155,8,375,1425,1350,3229,10,764,900,1350,7926
61.46,6,550,249651,282,819,218,1152,233410,268,424,229,1179,16241
1782.329,17,83,3480,82,14,22004,14,3444,1,8,0,8,36
28.794,6,37,8564,18,408,852,910,1989,19,414,1592,2720,6575
1763.644,17,170,14432,157,30,11305,37,9155,13,377,141901,463,5277
1.478,6,48,19738,27,929,56,1460,14122,21,476,62,2920,5616
0.901,6,24,8893,14,203,69,458,1406,10,1415,81,3926,7487
1101.005,6,229,16887,132,116,8404,469,10178,97,69,11468,69,6709
553.395,1,6,336,6,28,110679,28,336,0,0,0,0,0
0.839,6,20,5948,11,281,83,544,1288,9,716,93,1420,4660
1.277,6,49,20187,28,894,47,1360,14571,21,433,55,1360,5616
45.753,2,3,96,3,8,22876,8,96,0,0,0,0,0
23.985,6,17,3082,10,187,2665,293,1155,7,547,3955,1179,1927
38.045,17,8,1864,8,205,5435,205,1864,0,0,0,0,0
1797.528,6,356,22520,208,69,8683,69,12460,148,69,12228,69,10060
0.159,6,24,18630,14,181,12,254,1328,10,2096,13,5632,17302
1744.176,1,75,6300,0,0,0,0,0,75,56,23569,56,6300
0.004,6,3,352,2,196,1,196,312,1,0,0,0,40
0.511,6,54,22619,29,1010,18,1380,17365,25,383,19,1380,5254
1790.01,17,179,26671,179,121,10056,121,26671,0,0,0,0,0
5.848,6,40,7325,20,201,307,314,3423,20,516,293,1179,3902
287.963,17,16,2760,8,40,41135,40,544,8,249,41135,249,2216
27.458,6,13,968,5,92,6864,92,440,8,92,3854,92,528
541.446,2,5,160,5,8,135361,8,160,0,0,0,0,0
3.088,17,6,420,3,34,1543,34,186,3,50,1543,50,234
34.075,17,20,1760,10,48,3785,48,760,10,72,3785,72,1000
1797.467,6,367,25650,214,99,8438,469,15045,153,69,11822,69,10605
58.536,6,141,29818,71,350,836,1080,13394,70,340,847,1420,16424
3.706,6,56,36247,33,961,115,1360,11984,23,1555,161,2720,24263
131.582,1,2,232,2,88,131582,88,232,0,0,0,0,0
1768.673,1,58,4872,58,56,31029,56,4872,0,0,0,0,0
17.545,17,29,20428,14,588,1344,1350,8636,15,758,1247,1350,11792
382.493,6,18,1242,14,180,29422,180,916,4,110,20065,110,326
1799.115,17,449,39928,404,35,4464,288,25708,45,288,40018,288,14220
1120.072,17,369,25338,369,40,3043,41,25338,0,0,0,0,0
0.035,17,4,284,2,32,24,32,120,2,54,17,60,164
0.084,17,2,137,2,40,84,41,137,0,0,0,0,0
1786.808,6,104,8308,68,64,26668,64,4896,36,58,51049,58,3412
0.415,6,51,21149,27,1059,15,1380,15947,24,383,15,1380,5202
1794.171,17,144,11520,72,48,25269,48,5472,72,56,25269,56,6048
68.11,6,9,468,9,0,0,0,468,0,0,0,0,0
2.752,17,4,1556,4,361,917,361,1556,0,0,0,0,0
42.231,6,1753,1962779,655,356,64,426,39814,1098,1708,38,14080,1922965
1.272,6,46,19678,28,868,47,1360,14182,18,529,64,4075,5496
1784.008,1,188,19928,188,78,9540,78,19928,0,0,0,0,0
0.404,6,93,62236,56,1260,7,1420,56475,37,467,10,2840,5761
304.5,6,12,632,5,112,76122,112,320,7,0,50748,0,312
0.234,17,2,290,1,40,0,40,68,1,194,0,194,222
0.005,17,2,548,2,246,5,246,548,0,0,0,0,0
21.955,1,4,224,4,28,7318,28,224,0,0,0,0,0
0.481,6,12,1653,6,288,92,288,548,6,426,55,434,1105
6.392,6,1372,1298357,893,1379,6,1408,1268785,479,931,13,2801,29572
245.244,6,6,364,4,31,81748,31,222,2,31,245234,31,142
1797.652,6,356,22520,208,69,8684,69,12460,148,69,12228,69,10060
0.265,6,24,4571,12,165,24,456,1446,12,415,23,888,3125
0.381,6,22,7342,13,335,31,668,2026,9,1210,46,1906,5316
2.041,17,2,780,2,362,2041,362,780,0,0,0,0,0
217.901,17,6,528,3,48,108945,48,228,3,72,108944,72,300
0.353,6,21,5000,10,137,39,267,1092,11,692,34,1467,3908
1789.503,6,356,22520,208,69,8644,69,12460,148,69,12173,69,10060
1787.429,17,87,3648,86,14,21028,14,3612,1,8,0,8,36
0.191,17,2,154,1,33,0,33,61,1,65,0,65,93
4.154,17,4,352,2,48,4143,48,152,2,72,4143,72,200
1795.027,17,144,11520,72,48,25282,48,5472,72,56,25282,56,6048
352.514,6,19,7307,3,112,530,112,240,16,458,23500,1460,7067
83.509,6,27,9217,13,563,89,1351,2254,14,710,6409,1591,6963
1753.308,6,187,11425,94,47,18852,208,6806,93,31,19054,31,4619
133.576,6,38,8164,14,141,3530,267,1415,24,304,5807,1452,6749
1741.729,17,29,30624,29,1028,62204,1028,30624,0,0,0,0,0
300.135,6,36,10193,19,658,16664,1440,4742,17,432,18747,1440,5451
59.714,6,28712,29304775,9587,0,6,0,498512,19125,1454,3,2896,28806263
1754.287,6,99,8722,46,36,38983,36,2764,53,450,33735,458,5958
1789.794,6,82,4354,41,26,44743,26,2170,41,26,44743,26,2184
1787.937,6,117,12387,76,82,23839,513,6002,41,128,44695,1380,6385
9.036,6,33,6129,18,206,531,314,2784,15,548,625,1179,3345
10.041,17,3,303,2,41,9991,41,138,1,137,0,137,165
1.652,6,47,18645,27,854,63,1360,13069,20,433,76,1360,5576
1793.798,17,144,11624,72,49,25264,136,5560,72,56,25264,72,6064
504.042,1,8,448,8,28,72006,28,448,0,0,0,0,0
250.057,17,4,352,2,60,250056,60,176,2,60,250056,60,176
0.373,6,20,7151,12,318,33,600,1906,8,964,50,1471,5245
0.039,17,4,330,2,33,0,33,122,2,76,35,82,208
1.609,6,25,8770,15,286,114,590,1462,10,986,158,1452,7308
1785.629,1,58,4872,0,0,0,0,0,58,56,31326,56,4872
58.538,6,24,7123,11,158,5853,267,1237,13,766,4877,2045,5886
69.091,6,29,7257,13,155,5757,267,1306,16,441,4605,1420,5951
126.011,6,23,11278,12,433,88,990,1823,11,1286,12586,3928,9455
33.777,6,28,7217,13,155,2814,267,1306,15,482,2411,1420,5911
1679.584,1,15,840,15,28,119970,28,840,0,0,0,0,0
10.796,6,26,10805,16,612,719,1360,3735,10,1331,1183,4428,7070
1022.757,2,10,320,10,8,113639,8,320,0,0,0,0,0
0.758,6,17,5132,9,150,94,174,664,8,828,95,1420,4468
1795.06,17,80,3354,79,14,23013,14,3318,1,8,0,8,36
0.013,17,2,200,1,64,0,64,92,1,80,0,80,108
1746.574,6,97,7338,62,38,28632,205,4424,35,33,51360,98,2914
10.708,6,85,26277,42,557,261,1152,20075,43,447,248,1179,6202
1740.932,17,30,7050,30,207,60032,207,7050,0,0,0,0,0
0.064,17,2,176,1,60,0,60,88,1,60,0,60,88
81.093,17,4,352,2,60,81092,60,176,2,60,81092,60,176
21.096,17,4,352,2,48,21087,48,152,2,72,21086,72,200
332.715,6,76,11902,33,309,10397,1111,5753,43,169,7921,1232,6149
17.428,17,26,6045,13,238,1449,1350,3466,13,170,1449,1350,2579
1.913,17,4,610,3,39,876,39,201,1,381,0,381,409
1750.547,17,12,498,11,14,175054,14,462,1,8,0,8,36
0.38,6,24,7323,11,257,36,748,1611,13,838,30,1418,5712
1.411,6,52,21471,31,907,47,1360,15810,21,437,59,2715,5661
1.009,17,2,677,1,300,0,300,328,1,321,0,321,349
1799.609,1,345,28980,345,56,5231,56,28980,0,0,0,0,0
1799.744,17,448,39896,403,35,4476,288,25676,45,288,40020,288,14220
0.776,6,162,108650,86,1304,9,1420,101319,76,427,10,1420,7331
60.196,2,2,64,2,8,60196,8,64,0,0,0,0,0
12.181,6,1952,1664802,1174,1363,10,1380,1627517,778,511,15,1923,37285
1741.393,17,30,31680,30,1028,60048,1028,31680,0,0,0,0,0
1794.033,6,373,25139,215,86,8383,1189,14205,158,74,11425,405,10934
198.593,17,4,352,2,60,198591,60,176,2,60,198592,60,176
0.307,6,22,7345,13,334,24,663,2033,9,967,37,1906,5312
26.56,17,38,12818,16,540,1770,1350,9101,22,140,1263,1350,3717
1.413,6,48,20703,28,931,52,1360,15127,20,476,64,2715,5576
4.142,6,2,88,2,0,0,0,88,0,0,0,0,0
0.398,6,8,335,4,0,132,0,164,4,7,67,7,171
291.534,1,4,326,4,53,97178,78,326,0,0,0,0,0
33.645,6,31,5092,15,154,2403,722,1858,16,342,2230,1402,3234
1785.544,6,102,8296,68,65,26649,65,4930,34,59,54104,59,3366
782.111,2,9,288,9,8,97763,8,288,0,0,0,0,0
240.242,6,53,17529,28,778,8897,1402,14691,25,191,10009,580,2838
1798.476,17,448,39896,403,35,4473,288,25676,45,288,40021,288,14220
1772.168,6,180,15480,120,69,14892,69,8940,60,69,30033,69,6540
1776.346,1,102,5712,102,28,17587,28,5712,0,0,0,0,0
1616.382,6,81,5886,54,31,30497,31,3645,27,31,62168,31,2241
256.864,17,4,352,2,60,256863,60,176,2,60,256863,60,176
1787.256,6,102,8296,68,65,26675,65,4930,34,59,54155,59,3366
298.01,6,8,506,4,31,99336,31,222,4,31,99332,31,284
662.228,1,11,660,11,32,66222,32,660,0,0,0,0,0
40.554,1,12,1248,0,0,0,0,0,12,76,3686,76,1248
0.073,17,4,284,2,32,60,32,120,2,54,52,60,164
64.8,6,18,9368,6,174,12960,174,422,12,1408,5875,1452,8946
17.848,6,7,308,7,0,0,0,308,0,0,0,0,0
1741.447,17,30,6930,30,203,60049,203,6930,0,0,0,0,0
28.443,6,16,3815,5,49,7110,92,355,11,320,1749,1448,3460
1.512,6,39,8294,19,321,84,1164,2718,20,433,70,1440,5576
1661.913,1,7,392,7,28,276985,28,392,0,0,0,0,0
279.679,6,31,7813,14,158,21513,267,1357,17,577,17468,2036,6456
13.056,6,28,7493,11,155,1305,267,1226,17,429,815,3426,6267
17.183,17,26,19159,11,520,1715,1350,6035,15,846,1225,1350,13124
0.5,6,21,7217,13,318,41,599,1957,8,1209,70,1906,5260
4.601,6,39,7269,19,218,255,314,3383,20,513,227,1179,3886
1772.587,6,180,15480,120,69,14895,69,8940,60,69,30037,69,6540
1.377,6,53,19391,27,890,52,1440,13575,26,433,48,1440,5816
1.294,6,45,16407,25,816,53,1360,10831,20,476,58,2715,5576
5.174,6,534,446453,321,1322,15,1368,430713,213,776,23,1473,15740
1788.339,17,142,11360,71,48,25547,48,5396,71,56,25547,56,5964
2.861,6,67,25158,34,937,86,1440,14595,33,543,83,1440,10563
2.984,17,3,468,3,128,1492,128,468,0,0,0,0,0
0.442,6,13,1693,6,288,84,288,548,7,426,40,434,1145
1797.03,17,449,39928,404,35,4459,288,25708,45,288,40015,288,14220
5.535,6,42,7389,22,218,263,314,3503,20,513,276,1179,3886
36.441,17,4,240,2,32,36440,32,120,2,32,36440,32,120
16.742,6,26,7080,13,275,1395,275,1078,13,781,1309,1440,6002
150.495,6,25,12686,14,519,61,884,2681,11,1364,15036,3928,10005
2.593,17,4,240,2,32,2592,32,120,2,32,2592,32,120
1303.605,6,254,17124,136,74,9656,138,9994,118,68,8207,69,7130
1.577,6,10,534,4,0,525,0,204,6,7,255,7,330
1799.282,17,771,46566,771,32,2336,37,46566,0,0,0,0,0
0.544,17,2,167,1,39,0,39,67,1,72,0,72,100
249.003,6,76,11920,35,184,7323,1189,3996,41,298,6224,1420,7924
127.445,6,18,7625,8,154,18206,267,792,10,917,14158,1420,6833
0.0,6,1,40,0,0,0,0,0,1,0,0,0,40
1787.476,1,342,28728,342,56,5241,56,28728,0,0,0,0,0
0.367,17,4,560,2,64,366,64,184,2,160,249,160,376
0.248,17,2,225,1,37,0,37,65,1,132,0,132,160
601.632,2,6,192,6,8,120326,8,192,0,0,0,0,0
61.749,6,62,44005,41,1173,1543,1408,36180,21,960,3076,3847,7825
240.228,6,54,17784,30,743,8283,1408,14952,24,197,10444,580,2832
100.917,6,38,18860,20,611,84,1460,4523,18,1236,5928,1731,14337
1.002,6,29,8200,15,222,60,540,1964,14,944,63,1591,6236
36.961,17,22,1936,11,48,3693,48,836,11,72,3692,72,1100
35.643,6,20,1487,10,222,3958,222,848,10,231,3958,231,639
40.307,17,23,2012,12,48,3661,48,912,11,72,4028,72,1100
140.52,6,24,10061,12,531,55,1360,2649,12,1153,12764,2574,7412
280.577,6,28,7352,12,158,25507,267,1277,16,678,18694,2085,6075
19.384,17,4,240,2,32,19383,32,120,2,32,19383,32,120
280.196,6,27,7312,12,158,25472,267,1277,15,678,20011,2800,6035
1794.324,1,213,11928,213,28,8463,28,11928,0,0,0,0,0
1778.9,6,102,8296,68,65,26550,65,4930,34,59,53902,59,3366
118.591,6,26,8950,13,379,60,828,1737,13,835,9873,4080,7213
1786.464,17,87,3648,86,14,21017,14,3612,1,8,0,8,36
0.598,17,22,15402,13,955,49,1350,12791,9,262,65,1350,2611
354.044,6,38,23005,30,195,12208,195,1763,8,4163,34286,8448,21242
1.664,6,26,8809,16,286,110,590,1502,10,986,165,1420,7307
0.013,17,3,634,2,32,8,32,120,1,486,0,486,514
86.199,2,2,64,2,8,86199,8,64,0,0,0,0,0
320.687,17,17,18392,17,1053,20042,1451,18392,0,0,0,0,0
525.992,17,149,19026,66,160,7203,1350,12470,83,50,6412,1350,6556
1775.311,6,183,15738,122,69,14671,69,9089,61,69,29584,69,6649
0.156,17,2,157,1,31,0,31,59,1,70,0,70,98
177.771,2,2,64,2,8,177771,8,64,0,0,0,0,0
5.06,6,16,2566,10,169,562,245,915,6,703,706,1152,1651
1781.842,6,102,8296,68,65,26594,65,4930,34,59,53990,59,3366
1794.953,6,356,22589,207,69,8713,69,12420,149,69,12127,69,10169
1.075,6,12,5895,3,186,530,267,501,9,837,132,1460,5394
300.806,6,36,8522,18,308,17685,889,1987,18,446,17685,2720,6535
280.382,6,31,7472,14,158,21567,267,1357,17,543,17519,1400,6115
1797.356,17,447,39580,403,35,4471,288,25676,44,288,40955,288,13904
0.259,1,10,840,10,56,28,56,840,0,0,0,0,0
1531.805,6,509,89334,318,304,4832,304,65816,191,83,8060,83,23518
1.545,6,40,10551,21,517,77,1360,5015,19,476,73,2715,5536
1788.081,6,356,22520,208,69,8638,69,12460,148,69,12163,69,10060
0.149,6,10,1800,6,616,27,1076,1477,4,159,49,159,323
0.05,17,2,570,1,30,0,30,58,1,484,0,484,512
15.359,6,10,2929,4,92,5119,92,296,6,579,2980,2026,2633
1784.887,6,104,8444,68,66,26640,66,4964,36,60,50993,60,3480
1203.258,2,8,256,8,8,171894,8,256,0,0,0,0,0
0.058,17,3,216,2,31,5,31,118,1,70,0,70,98
1794.924,6,729,49271,364,31,4944,31,24613,365,31,4930,31,24658
3.945,17,5,295,5,31,986,31,295,0,0,0,0,0
366.943,6,25,1651,17,177,22933,177,1117,8,110,9175,110,534
0.015,6,9,1612,5,636,3,636,904,4,492,4,492,708
61.679,6,60,40557,38,1179,1667,1448,32660,22,843,2925,2359,7897
0.238,6,10,2535,6,551,47,947,1346,4,1025,79,1025,1189
337.146,6,58,16442,34,527,10216,1360,10389,24,317,396,1360,6053
6.928,6,40,7325,22,218,329,314,3503,18,516,391,1179,3822
1797.729,6,365,25032,213,94,8479,469,14536,152,69,11903,69,10496
0.093,17,2,184,1,32,0,32,60,1,96,0,96,124
12.204,6,1897,1662695,1174,1363,10,1380,1627610,723,511,16,1923,35085
5.001,17,4,530,2,36,4988,36,128,2,173,4992,187,402
1.197,6,29,6180,16,138,79,267,1755,13,650,88,1452,4425
3.463,17,2,152,2,48,3463,48,152,0,0,0,0,0
0.08,17,2,158,1,34,0,34,62,1,68,0,68,96
280.473,6,31,7472,13,158,23372,267,1317,18,603,16495,2076,6155
1743.056,6,141,8974,80,49,22064,208,5573,61,31,29047,31,3401
1.01,17,4,1116,2,32,875,32,120,2,470,1,470,996
0.311,17,8,2750,8,315,44,354,2750,0,0,0,0,0
1.063,17,3,238,2,30,1026,30,116,1,94,0,94,122
1789.449,1,274,15344,274,28,6554,28,15344,0,0,0,0,0
1.758,17,4,518,3,39,620,39,201,1,289,0,289,317
14.661,6,31,5906,15,154,1032,722,1883,16,398,966,1408,4023
1792.617,6,411,35724,231,121,7793,1189,18445,180,134,10014,2760,17279
18.731,17,2,152,2,48,18731,48,152,0,0,0,0,0
421.127,2,6,192,6,8,84225,8,192,0,0,0,0,0
52.731,6,27,7177,13,155,4394,267,1306,14,530,4055,3417,5871
220.399,6,31,6407,13,210,4544,478,1365,18,287,12960,1452,5042
1751.664,6,95,7203,63,38,28252,205,4476,32,33,56492,98,2727
53.602,6,13,1079,12,43,4872,43,1019,1,0,0,0,60
0.046,6,5,322,3,31,23,31,187,2,31,0,31,135
280.472,6,30,7432,13,158,23372,267,1317,17,603,17527,2076,6115
1797.091,1,187,10472,187,28,9661,28,10472,0,0,0,0,0
33.808,6,29,5015,15,154,2414,722,1884,14,479,2584,2026,3131
143.356,6,27,7312,13,158,11946,267,1317,14,775,11024,4836,5995
1.446,6,47,19340,27,903,55,1360,13764,20,476,65,2715,5576
4.283,6,38,7245,19,218,237,314,3383,19,516,224,1179,3862
85.61,6,84,57838,53,1193,1646,1368,48099,31,676,2844,1368,9739
40.414,6,45,8836,21,345,766,720,1967,24,327,1751,1460,6869
0.269,17,2,2384,2,1164,269,1164,2384,0,0,0,0,0
1709.951,1,8,448,8,28,244278,28,448,0,0,0,0,0
0.842,6,7,388,4,0,280,0,216,3,0,405,0,172
1792.564,17,180,11520,180,36,10014,36,11520,0,0,0,0,0
1781.06,6,246,45734,120,866,14966,1402,33122,126,62,14248,580,12612
0.873,6,26,5700,13,125,72,267,1275,13,650,66,1420,4425
1798.31,1,58,4872,58,56,31549,56,4872,0,0,0,0,0
1787.361,6,104,8376,68,65,26677,65,4930,36,59,51064,59,3446
1236.38,6,101,10591,59,73,21316,721,5122,42,102,28574,1448,5469
0.735,6,22,4721,13,207,61,519,1710,9,633,79,2301,3011
69.979,6,21,8712,11,314,64,634,1415,10,1147,7762,2720,7297
240.206,6,59,20412,31,825,8006,1402,17303,28,205,8896,580,3109
2.005,17,3,215,2,33,1960,33,122,1,65,0,65,93
0.007,17,2,516,1,34,0,34,62,1,426,0,426,454
1775.174,17,73,3060,72,14,25002,14,3024,1,8,0,8,36
1763.861,6,76,3952,38,0,47664,0,1976,38,0,47670,0,1976
53.219,17,6,360,3,32,26608,32,180,3,32,26609,32,180
842.252,2,10,320,10,8,93583,8,320,0,0,0,0,0
7.461,6,43,19488,22,346,355,346,1734,21,876,370,1488,17754
1793.998,17,144,11520,72,48,25267,48,5472,72,56,25267,56,6048
1.292,17,8,704,4,37,429,37,260,4,83,429,89,444
1792.543,6,356,22520,208,69,8659,69,12460,148,69,12193,69,10060
1.956,17,4,464,3,64,967,64,276,1,160,0,160,188
1402.206,17,20,1885,10,33,155794,37,615,10,99,155795,136,1270
2.945,17,3,1021,2,308,1947,308,672,1,321,0,321,349
0.198,6,29,7376,14,155,15,267,1341,15,543,13,1400,6035
1798.458,6,369,24792,214,87,8443,469,14245,155,69,11675,69,10547
6.424,6,1451,1402645,959,1389,6,1408,1372397,492,931,12,2801,30248
0.271,17,4,768,2,39,266,39,134,2,289,6,289,634
1780.698,17,82,3438,81,14,22258,14,3402,1,8,0,8,36
96.945,6,15,1132,4,226,125,226,442,11,110,9675,110,690
0.601,17,4,502,2,31,590,31,118,2,164,587,164,384
15.26,17,5,380,5,48,3815,48,380,0,0,0,0,0
2.295,6,20,3833,11,234,229,564,1504,9,463,264,1343,2329
1799.379,1,59,4956,59,56,31023,56,4956,0,0,0,0,0
1794.613,17,87,3648,86,14,21113,14,3612,1,8,0,8,36
1720.421,17,12,498,11,14,172042,14,462,1,8,0,8,36
1740.482,17,28,29568,28,1028,64462,1028,29568,0,0,0,0,0
11.778,6,21,8224,11,275,1177,275,998,10,1362,1227,1440,7226
35.19,17,11,836,11,48,3519,48,836,0,0,0,0,0
1798.968,6,356,22520,208,69,8690,69,12460,148,69,12237,69,10060
1709.077,17,14,3827,7,30,284844,30,406,7,460,284843,463,3421
1785.891,1,71,5964,0,0,0,0,0,71,56,25512,56,5964
10.877,17,15,17710,15,1152,776,1450,17710,0,0,0,0,0
2.143,6,24,5755,13,158,178,370,1315,11,999,213,2840,4440
0.199,1,7,752,1,100,0,100,128,6,76,34,76,624
3.941,17,28,15978,15,858,278,1350,13302,13,177,325,1350,2676
114.642,6,46,13105,24,647,4984,1368,10337,22,202,5440,580,2768
102.47,6,44,10308,22,706,686,1360,4502,22,351,4871,4027,5806
1788.451,17,89,3729,87,13,20793,14,3649,2,12,1788270,16,80
1285.286,6,260,25111,147,79,8803,267,10392,113,178,11475,1460,14719
0.019,17,2,570,1,30,0,30,58,1,484,0,484,512
69.241,6,40,8761,17,205,4327,721,2122,23,381,2844,2840,6639
1762.202,1,8,848,8,78,251743,78,848,0,0,0,0,0
0.003,17,8,2446,8,277,0,316,2446,0,0,0,0,0
0.946,6,11,1727,7,100,157,100,384,4,589,229,1152,1343
0.022,6,5,260,2,0,5,0,104,3,0,11,0,156
1.233,6,114,86916,48,131,26,232,2449,66,1363,18,1430,84467
7.968,6,1524,1378558,905,1437,8,1448,1338250,619,776,12,1448,40308
12.239,6,17,7772,5,106,3057,106,314,12,993,1111,1460,7458
0.047,17,2,212,1,46,0,46,74,1,110,0,110,138
8.714,17,14,6742,7,605,1394,1350,4437,7,301,1400,1350,2305
8.194,6,22,9370,11,275,819,275,723,11,1170,558,1414,8647
119.856,17,4,352,2,60,119855,60,176,2,60,119855,60,176
18.056,6,30,5054,15,154,1289,721,1870,15,400,1275,1368,3184
1794.101,17,178,11392,178,36,10136,36,11392,0,0,0,0,0
1744.676,2,15,480,15,8,124619,8,480,0,0,0,0,0
1792.931,1,260,14560,260,28,6922,28,14560,0,0,0,0,0
92.122,6,724,349935,393,832,235,1152,331190,331,423,278,1179,18745
1786.301,6,115,12145,73,132,24809,1269,7702,42,74,43566,241,4443
1796.474,17,87,3648,86,14,21134,14,3612,1,8,0,8,36
280.205,6,28,7352,13,158,23350,267,1317,15,678,20011,2800,6035
0.004,17,2,306,1,33,0,33,61,1,217,0,217,245
0.398,6,27,8920,13,227,33,547,1592,14,941,29,1408,7328
0.523,6,12,1653,6,288,99,288,548,6,426,63,434,1105
284.369,17,4,240,2,32,284367,32,120,2,32,284368,32,120
371.564,6,27,1767,18,177,21856,177,1181,9,110,9384,110,586
240.157,6,55,19445,30,832,8281,1408,16555,25,197,10006,580,2890
281.318,6,32,7853,14,158,21639,267,1357,18,524,16545,1400,6496
1787.468,6,102,8296,68,65,26678,65,4930,34,59,54161,59,3366
0.954,17,19,6554,8,280,136,1350,2471,11,343,81,1350,4083
0.001,17,2,237,1,72,0,72,100,1,109,0,109,137
9.338,6,1925,1793007,1226,1383,7,1408,1751995,699,931,13,2816,41012
5.078,17,4,542,2,36,5073,36,128,2,179,5073,187,414
342.461,6,44,7226,27,302,13171,302,5326,17,83,21403,83,1900
280.427,6,30,7432,13,158,23368,267,1317,17,543,17517,1400,6115
0.072,1,10,840,10,56,8,56,840,0,0,0,0,0
21.589,17,47,15027,23,435,979,1350,10649,24,154,936,1350,4378
6.232,6,1523,1443174,986,1388,6,1408,1410586,537,776,11,1408,32588
5.005,17,4,558,2,36,4999,36,128,2,187,5001,187,430
1677.666,1,7,742,7,78,279611,78,742,0,0,0,0,0
1744.675,2,28,896,28,8,64617,8,896,0,0,0,0,0
35.298,6,26,8128,12,326,3205,517,1949,14,777,2711,1418,6179
0.592,6,24,7458,14,335,45,668,2090,10,968,60,1946,5368
1.814,6,27,8852,16,286,120,591,1503,11,863,160,1380,7349
280.474,6,29,7392,13,158,23372,267,1317,16,775,18695,4836,6075
126.381,1,4,224,4,28,42127,28,224,0,0,0,0,0
32.088,6,9,396,2,0,3482,0,88,7,0,5333,0,308
10.159,17,4,5488,4,1344,3386,1349,5488,0,0,0,0,0
11.989,6,38,8923,20,268,624,728,1906,18,571,698,3488,7017
6.243,6,39,7269,20,218,328,314,3423,19,513,332,1179,3846
1773.156,6,182,15629,121,69,14776,69,8980,61,69,29550,69,6649
71.067,6,31,8912,15,158,5076,267,1397,16,858,4734,3456,7515
1.276,6,54,22429,29,966,45,1360,16653,25,433,45,1360,5776
1772.457,6,191,11678,95,47,18855,208,6877,96,31,18653,31,4801
0.755,6,4,172,2,0,538,0,92,2,0,560,0,80
1793.249,6,123,12265,76,62,23909,722,6319,47,89,38979,1402,5946
61.943,17,29,2183,17,40,3865,41,1167,12,56,5627,57,1016
0.859,6,11,1727,7,100,143,100,384,4,589,204,1152,1343
0.028,17,4,420,2,33,1,33,122,2,121,0,145,298
244.434,17,4,304,2,48,244429,48,152,2,48,244429,48,152
7.289,6,1775,1647357,1122,1390,6,1408,1608737,653,931,10,2816,38620
3.331,17,4,1564,4,363,1110,363,1564,0,0,0,0,0
0.138,6,15,5933,8,128,19,128,552,7,1252,22,1472,5381
0.139,17,2,672,2,308,139,308,672,0,0,0,0,0
1606.039,6,63,18620,36,507,45886,1460,9108,27,495,61763,1934,9512
212.868,6,15,1009,9,31,26587,31,561,6,31,42536,31,448
1.486,6,51,19498,27,903,57,1460,13762,24,433,56,1460,5736
1.426,17,17,6844,8,479,203,1350,4062,9,281,139,1350,2782
11.681,6,20,3871,11,211,1166,211,1225,9,545,1456,904,2646
0.372,6,9,1339,5,145,93,145,349,4,826,113,826,990
14.946,6,23,6002,12,275,1358,275,1038,11,902,1230,1440,4964
175.354,6,7,384,3,0,87677,0,164,4,0,58388,0,220
1.18,6,25,8068,12,164,91,267,1300,13,869,83,1408,6768
1795.875,6,356,22520,208,69,8675,69,12460,148,69,12216,69,10060
240.265,6,47,7519,21,218,12012,590,2643,26,270,9609,670,4876
33.578,6,37,5466,17,154,2098,722,1976,20,222,1757,1408,3490
60.23,6,22,9050,12,715,5475,1448,3504,10,716,6686,1448,5546
1.423,6,50,19473,27,904,54,1460,13777,23,433,56,1460,5696
1791.61,17,180,14040,180,50,10008,50,14040,0,0,0,0,0
244.838,17,6,1468,3,32,122417,37,181,3,401,122416,463,1287
1.479,6,50,19272,28,954,54,1460,13571,22,437,60,2920,5701
1783.394,17,83,3480,82,14,22017,14,3444,1,8,0,8,36
195.099,17,4,352,2,60,195098,60,176,2,60,195098,60,176
502.406,1,20,1120,20,28,26442,28,1120,0,0,0,0,0
79.958,6,24,8962,12,467,87,1064,1927,12,817,7253,1791,7035
240.355,6,62,21025,30,859,8287,1418,17894,32,208,7752,580,3131
0.292,6,11,1599,6,136,58,136,396,5,999,66,999,1203
1796.691,17,448,39896,403,35,4469,288,25676,45,288,40013,288,14220
0.23,6,24,6780,12,110,20,176,1073,12,725,19,1408,5707
240.353,6,46,9131,22,524,11444,1418,5870,24,222,10449,618,3261
0.015,17,2,146,1,37,0,37,65,1,53,0,53,81
1777.997,1,95,5320,95,28,18914,28,5320,0,0,0,0,0
0.585,17,4,368,2,64,584,64,184,2,64,583,64,184
1795.399,17,447,39580,403,35,4466,288,25676,44,288,40957,288,13904
0.281,17,16,8507,8,706,39,1350,5872,8,301,35,1350,2635
267.459,17,64,67892,64,1032,4245,1450,67892,0,0,0,0,0
29.551,6,49,19284,26,923,1182,1360,9397,23,746,1335,2241,9887
149.995,6,24,5103,10,216,6175,501,1270,14,272,11531,1420,3833
1.372,17,4,352,2,60,1370,60,176,2,60,1371,60,176
1782.133,17,83,3480,82,14,22001,14,3444,1,8,0,8,36
159.428,17,12,1572,6,39,31882,39,402,6,167,31882,167,1170
0.256,6,21,5000,10,137,28,267,1092,11,692,25,1467,3908
292.319,6,35,3056,20,75,15385,138,1559,15,69,20878,69,1497
128.436,1,6,336,6,28,25687,28,336,0,0,0,0,0
5.526,6,40,7309,20,218,290,314,3423,20,440,276,1152,3886
2.286,6,13,2311,8,188,326,245,700,5,1407,502,1407,1611
202.699,6,67,46462,44,1168,4713,1408,38530,23,961,2800,3847,7932
1.214,6,23,7952,12,164,94,267,1288,11,1216,104,3819,6664
1.174,6,24,8004,12,164,91,267,1288,12,1014,91,2411,6716
183.808,6,34,5593,16,165,12253,722,1986,18,266,10798,1408,3607
2.115,6,34,13967,20,305,111,1041,2406,14,1098,142,2920,11561
0.359,6,27,8922,13,232,29,567,1612,14,939,26,1448,7310
28.903,6,25,6283,14,117,2223,159,1337,11,727,2889,1418,4946
18.028,17,28,10437,14,479,1384,1350,7109,14,209,1384,1350,3328
1799.598,6,359,22709,209,69,8651,69,12569,150,69,12075,69,10140
156.531,6,29,8533,11,181,15653,267,1168,18,510,9183,1400,7365
1782.215,17,83,3480,82,14,22002,14,3444,1,8,0,8,36
1740.39,17,30,31680,30,1028,60013,1028,31680,0,0,0,0,0
1773.585,6,205,22439,132,75,13538,267,10137,73,135,24628,3377,12302
1773.472,6,180,15480,120,69,14903,69,8940,60,69,30056,69,6540
61.649,6,60,39670,38,1145,1666,1448,31772,22,843,2924,2359,7898
270.867,17,4,352,2,60,270865,60,176,2,60,270866,60,176
1.735,6,14,2351,8,188,247,245,700,6,703,293,1152,1651
1798.098,17,442,39704,397,36,4540,288,25484,45,288,40020,288,14220
4.258,17,2,152,2,48,4258,48,152,0,0,0,0,0
1462.525,6,83,6623,55,63,27083,63,3964,28,57,54163,57,2659
1663.084,6,29,7795,18,366,97828,1247,3654,11,411,166308,1597,4141
0.017,17,3,244,2,32,9,32,120,1,96,0,96,124
20.538,6,3,152,2,0,20538,0,100,1,0,0,0,52
0.836,6,28,7336,13,155,69,267,1301,15,543,50,1300,6035
1740.444,1,15,870,15,30,124317,30,870,0,0,0,0,0
1741.391,17,29,30624,29,1028,62192,1028,30624,0,0,0,0,0
0.465,6,6,312,2,0,1,0,104,4,0,155,0,208
138.245,17,4,240,2,32,138243,32,120,2,32,138244,32,120
0.814,17,4,857,2,34,803,34,124,2,338,802,350,733
1797.775,6,380,26915,219,103,8246,469,15990,161,69,11232,69,10925
1720.576,17,12,498,11,14,172057,14,462,1,8,0,8,36
3.015,17,7,612,4,32,998,32,240,3,96,1501,96,372
29.399,17,15,7805,8,655,4199,1350,5471,7,305,48,1350,2334
240.891,1,6,336,6,28,48178,28,336,0,0,0,0,0
280.041,6,26,7272,12,158,25458,267,1277,14,775,21538,3445,5995
0.787,6,147,107186,86,1310,9,1432,100455,61,475,12,1871,6731
4.274,6,2,88,2,0,0,0,88,0,0,0,0,0
306.005,17,14,1940,7,48,50997,48,532,7,173,50998,308,1408
0.034,17,4,284,2,32,27,32,120,2,54,27,60,164
20.994,6,14,2676,6,821,4197,1420,1886,8,231,2998,231,790
1790.378,6,356,22520,208,69,8649,69,12460,148,69,12179,69,10060
1773.156,6,180,15480,120,69,14900,69,8940,60,69,30049,69,6540
10.768,6,18,5610,10,275,1196,275,958,8,1440,823,1440,4652
137.536,6,30,7432,13,158,11461,267,1317,17,543,8594,1400,6115
4.733,6,12,2275,6,188,946,245,620,6,1407,894,1407,1655
0.006,17,2,527,1,33,0,33,61,1,438,0,438,466
155.306,6,22,8807,11,332,75,657,1470,11,983,15514,1360,7337
0.036,17,5,428,3,32,5,32,180,2,96,18,96,248
2.769,6,18,3257,10,99,285,182,924,8,477,367,1343,2333
300.68,6,55,10760,25,192,8665,721,3885,30,405,10361,2007,6875
0.111,17,2,154,1,33,0,33,61,1,65,0,65,93
1786.499,6,410,93944,192,413,9352,1460,67387,218,176,8232,1638,26557
1789.277,17,142,11360,71,48,25560,48,5396,71,56,25560,56,5964
0.013,17,2,350,1,39,0,39,67,1,255,0,255,283
15.627,17,12,5130,6,490,3114,1350,3110,6,308,3110,1350,2020
0.297,17,4,334,2,39,179,39,134,2,72,0,72,200
231.938,17,4,240,2,32,231937,32,120,2,32,231936,32,120
0.282,17,4,288,2,36,235,36,128,2,52,234,52,160
101.889,17,8,640,4,48,33958,48,304,4,56,33958,56,336
0.175,17,2,2750,2,1347,175,1347,2750,0,0,0,0,0
27.477,17,32,4704,16,48,1830,48,1216,16,190,1830,308,3488
7.27,6,1355,1302131,895,1381,7,1408,1273547,460,931,15,2801,28584
1.413,6,28,5873,15,120,100,267,1448,13,780,104,1460,4425
1700.514,17,12,498,11,14,170051,14,462,1,8,0,8,36
11.745,6,15,2245,9,324,1468,585,1125,6,396,2214,580,1120
2.11,6,9,1651,5,100,527,100,304,4,1179,614,1179,1347
8.291,6,1188,1040587,702,1401,11,1448,1010651,486,776,16,1448,29936
7.446,6,5,264,3,0,3723,0,160,2,0,997,0,104
0.364,6,12,1653,6,288,69,288,548,6,426,39,434,1105
1772.64,6,171,14706,113,69,15827,69,8384,58,69,31093,69,6322
1799.853,17,142,11360,71,48,25712,48,5396,71,56,25712,56,5964
0.002,17,2,184,1,64,0,64,92,1,64,0,64,92
0.728,6,24,6041,13,108,60,147,959,11,773,62,1608,5082
0.21,17,2,144,1,36,0,36,64,1,52,0,52,80
1786.846,6,105,8610,70,66,25896,66,5110,35,60,52531,60,3500
0.04,17,2,200,1,64,0,64,92,1,80,0,80,108
8.776,6,16,1402,8,275,1253,275,878,8,96,1112,96,524
1787.66,6,104,8308,68,64,26681,64,4896,36,58,51073,58,3412
8.662,6,1041,873544,588,1395,14,1448,841396,453,931,18,2761,32148
1796.613,6,242,24966,97,68,18713,681,9248,145,135,12475,2720,15718
75.0,6,19,780,9,0,6838,0,364,10,0,8331,0,416
298.557,17,6,2052,2,300,3750,300,656,4,321,99185,321,1396
1.318,6,40,8389,21,320,65,1162,2808,19,437,63,2715,5581
1799.835,17,448,39896,403,35,4477,288,25676,45,288,40019,288,14220
54.097,17,4,304,2,48,54050,48,152,2,48,54046,48,152
0.035,17,2,417,1,34,0,34,62,1,327,0,327,355
1774.259,6,180,15480,120,69,14909,69,8940,60,69,30069,69,6540
0.948,17,2,178,1,29,0,29,57,1,93,0,93,121
1789.483,1,156,8736,156,28,11545,28,8736,0,0,0,0,0
280.244,6,30,7432,13,158,23353,267,1317,17,543,17514,1400,6115
122.485,6,1019,507097,555,850,221,1152,482350,464,412,263,1179,24747
0.061,6,10,1512,5,503,15,503,771,5,473,15,473,741
17.342,6,2,87,1,0,0,0,40,1,7,0,7,47
169.996,17,4,1370,2,308,169004,308,672,2,321,168998,321,698
68.492,6,29,4213,12,343,533,1189,2538,17,99,4274,421,1675
151.262,6,25,11069,12,380,79,832,1665,13,985,12593,1360,9404
19.403,6,29,5446,15,208,1385,314,2478,14,600,1269,1179,2968
1787.339,6,102,8228,68,64,26676,64,4896,34,58,54158,58,3332
0.629,2,2,64,2,8,629,8,64,0,0,0,0,0
1744.631,2,29,928,29,8,62308,8,928,0,0,0,0,0
1772.948,6,180,15480,120,69,14898,69,8940,60,69,30043,69,6540
0.004,17,3,612,2,30,0,30,116,1,468,0,468,496
280.476,6,29,7392,13,158,23373,267,1317,16,603,18689,1400,6075
184.401,1,24,1344,24,28,8017,28,1344,0,0,0,0,0
1777.216,17,73,3060,72,14,25031,14,3024,1,8,0,8,36
5.018,17,4,288,2,36,5002,36,128,2,52,5004,52,160
1.358,6,50,19662,27,918,52,1360,13966,23,433,53,1360,5696
0.007,17,6,411,6,40,1,41,411,0,0,0,0,0
1787.246,6,104,8435,69,65,26283,65,4970,35,59,52563,59,3465
2.927,17,4,1564,4,363,975,363,1564,0,0,0,0,0
8.113,17,6,528,3,48,4050,48,228,3,72,4048,72,300
1775.516,6,206,23881,132,89,13553,981,11118,74,141,24316,4837,12763
1750.886,6,95,7203,63,38,28240,205,4476,32,33,56468,98,2727
1739.714,1,78,4368,78,28,22593,28,4368,0,0,0,0,0
2.004,17,3,180,3,32,1002,32,180,0,0,0,0,0
0.03,17,2,184,1,32,0,32,60,1,96,0,96,124
4.207,17,5,290,5,30,1051,30,290,0,0,0,0,0
300.985,6,43,13666,24,881,13086,1460,8055,19,403,486,2567,5611
0.094,6,9,1002,5,213,23,213,417,4,421,22,421,585
300.809,6,42,8797,18,283,17686,787,1897,24,329,13072,2720,6900
1786.875,6,109,9029,70,70,25896,274,5250,39,63,47020,247,3779
0.431,17,8,2774,8,318,61,357,2774,0,0,0,0,0
3.978,6,20,5673,11,49,397,92,703,9,642,79,1408,4970
1798.031,6,1727,2142210,631,147,2854,850,40946,1096,1994,1642,9814,2101264
1797.531,17,448,39896,403,35,4471,288,25676,45,288,40013,288,14220
1786.971,6,104,8376,68,65,26671,65,4930,36,59,51053,59,3446
1794.247,1,222,12432,222,28,8118,28,12432,0,0,0,0,0
0.328,6,26,8991,13,247,27,624,1672,13,947,23,1438,7319
1.413,6,62,47967,41,1252,35,1408,40970,21,1179,62,3819,6997
851.99,6,52,3994,32,46,27483,205,2356,20,35,44831,98,1638
1744.443,6,100,7702,66,40,26837,205,4730,34,35,52852,108,2972
3.398,6,2,88,2,0,0,0,88,0,0,0,0,0
28.45,6,11,684,3,106,14220,106,234,8,90,4062,90,450
78.72,1,8,448,8,28,11245,28,448,0,0,0,0,0
383.27,6,23,6651,4,106,127756,106,274,19,350,21283,1452,6377
14.557,6,1940,1764905,1235,1375,11,1380,1727040,705,511,20,1923,37865
1798.446,6,372,25519,215,93,8403,469,14754,157,69,11526,69,10765
0.373,6,4,220,1,0,0,0,52,3,0,186,0,168
2.578,17,28,14695,14,758,198,1350,11013,14,235,123,1350,3682
1109.454,6,96,13098,56,100,18213,500,4557,40,238,28445,1420,8541
0.273,6,9,1346,5,145,68,145,349,4,833,87,833,997
0.345,17,2,304,1,60,0,60,88,1,188,0,188,216
300.794,6,42,13642,23,891,13672,1440,8080,19,399,479,1440,5562
1082.808,2,11,352,11,8,108280,8,352,0,0,0,0,0
0.042,17,2,268,1,33,0,33,61,1,179,0,179,207
1.491,6,50,19814,27,929,57,1460,14118,23,476,58,2615,5696
0.229,17,2,198,1,63,0,63,91,1,79,0,79,107
0.439,17,2,152,1,48,0,48,76,1,48,0,48,76
0.082,6,2,170,1,0,0,0,40,1,90,0,90,130
285.512,17,10,3477,1,308,0,308,336,9,321,35564,321,3141
536.248,6,63,5280,37,69,14895,69,2722,26,69,21449,69,2558
1773.488,6,180,15480,120,69,14903,69,8940,60,69,30054,69,6540
368.782,6,27,1767,18,177,21693,177,1181,9,110,8637,110,586
1.841,17,25,18977,12,669,167,1350,8365,13,788,137,1350,10612
1788.516,1,96,5376,96,28,18826,28,5376,0,0,0,0,0
1744.687,2,16,512,16,8,116312,8,512,0,0,0,0,0
0.381,17,4,240,2,32,380,32,120,2,32,380,32,120
1797.534,6,380,28929,221,126,8170,469,17670,159,69,11374,69,11259
3.224,17,5,290,5,30,806,30,290,0,0,0,0,0
2.779,6,9,527,5,43,694,43,311,4,0,925,0,216
370.874,6,18,1242,14,180,28528,180,916,4,110,20062,110,326
0.458,6,19,7113,13,318,38,599,1957,6,1612,90,3314,5156
1.13,6,212,155682,119,1322,9,1420,147659,93,427,12,1420,8023
120.807,6,111,86093,74,1244,1654,1408,76049,37,811,2605,3847,10044
0.14,6,11,1737,6,125,28,125,385,5,1148,32,1148,1352
0.524,6,29,7088,17,244,32,656,2394,12,601,46,1420,4694
1.852,6,13,2311,8,188,264,245,700,5,1407,395,1407,1611
1777.32,1,61,5124,61,56,29622,56,5124,0,0,0,0,0
1.762,6,13,2311,8,188,251,245,700,5,1407,375,1407,1611
0.004,17,2,225,1,38,0,38,66,1,131,0,131,159
1.305,6,50,18337,28,882,48,1360,12636,22,400,53,1360,5701
0.183,6,9,1050,5,261,45,261,465,4,421,48,421,585
1777.219,17,140,11200,70,48,25756,48,5320,70,56,25756,56,5880
3.994,17,4,240,2,32,3993,32,120,2,32,3993,32,120
128.724,6,4169,3685045,2662,1301,48,1368,3593299,1507,1240,85,2491,91746
34.998,17,10,490,9,17,4374,58,406,1,56,0,56,84
0.594,6,133,90813,73,1309,8,1432,84122,60,475,9,1871,6691
81.441,17,4,352,2,60,81440,60,176,2,60,81439,60,176
1791.807,17,142,11360,71,48,25597,48,5396,71,56,25597,56,5964
8.626,6,1400,1196833,848,1361,10,1380,1170511,552,421,15,1923,26322
163.612,17,4,1344,4,308,54537,308,1344,0,0,0,0,0
10.778,6,20,4442,11,275,1077,275,998,9,768,776,1440,3444
122.658,6,43,19860,23,1007,1656,1360,11022,20,802,6446,3601,8838
180.202,6,23,8359,11,525,110,1237,2048,12,969,16364,1791,6311
40.239,6,40,9236,23,538,1829,1228,5499,17,203,2514,1282,3737
1663.111,1,7,392,7,28,277185,28,392,0,0,0,0,0
131.063,6,6079,5658111,4225,1329,30,1360,5561267,1854,132,70,4027,96844
0.203,17,2,152,1,48,0,48,76,1,48,0,48,76
8.637,6,41,8514,21,175,431,721,2253,20,681,430,1440,6261
140.113,6,180,27602,95,304,1490,304,18832,85,83,1648,83,8770
1744.648,6,95,7203,63,38,28139,205,4476,32,33,56267,98,2727
1785.857,6,368,25621,213,99,8423,469,15005,155,69,11596,69,10616
4.97,6,39,7269,20,218,261,314,3423,19,513,261,1179,3846
0.0,6,2,135,2,31,0,31,135,0,0,0,0,0
372.038,6,21,1419,15,177,26574,177,989,6,110,13829,110,430
0.156,17,2,312,1,64,0,64,92,1,192,0,192,220
240.193,6,52,17660,28,793,8895,1402,14952,24,207,10442,580,2708
4.123,6,39,7269,19,218,229,314,3383,20,440,203,1152,3886
1366.274,17,50,9680,50,165,27883,362,9680,0,0,0,0,0
825.722,1,12,672,12,28,75065,28,672,0,0,0,0,0
1746.78,6,95,7203,63,38,28173,205,4476,32,33,56336,98,2727
32.432,17,20,8289,10,551,3595,1350,5790,10,221,3594,1350,2499
144.998,1,4,240,4,32,48332,32,240,0,0,0,0,0
0.029,17,2,154,1,33,0,33,61,1,65,0,65,93
1.222,6,24,8004,12,164,95,267,1288,12,1014,95,2804,6716
0.892,6,23,6393,13,309,73,887,2073,10,979,98,1791,4320
1728.603,17,150,27568,150,155,11601,422,27568,0,0,0,0,0
0.491,6,22,7342,13,335,40,668,2026,9,1210,57,1946,5316
1780.959,6,438,26364,215,69,8322,69,12809,223,35,8022,48,13555
1.574,6,48,19387,27,904,60,1360,13771,21,476,68,2715,5616
0.514,6,10,968,5,256,126,256,460,5,304,127,304,508
33.656,6,34,5262,17,154,2092,722,1974,17,300,2092,1440,3288
1.435,6,160,131598,96,204,15,258,7228,64,1984,22,7040,124370
1624.921,1,7,392,7,28,270820,28,392,0,0,0,0,0
182.177,17,4,240,2,32,182176,32,120,2,32,182176,32,120
1795.516,1,255,14280,255,28,7068,28,14280,0,0,0,0,0
11.674,6,1850,1612194,1120,1385,10,1420,1578773,730,467,16,1883,33421
1754.776,17,311,50927,311,135,5660,385,50927,0,0,0,0,0
1746.672,6,95,7203,63,38,28172,205,4476,32,33,56336,98,2727
122.633,6,45,8593,19,125,6812,267,1897,26,332,4797,1420,6696
220.58,6,6,906,4,241,73526,241,642,2,92,220399,92,264
1795.595,17,449,39928,404,35,4455,288,25708,45,288,40018,288,14220
1799.1,17,756,45598,756,32,2382,37,45598,0,0,0,0,0
1681.238,17,14,1036,7,30,280200,30,406,7,62,280203,62,630
1.45,6,51,19521,29,901,51,1460,13820,22,400,59,1460,5701
1788.426,6,360,22956,207,69,8681,69,12489,153,69,11765,69,10467
1764.389,2,14,448,14,8,135722,8,448,0,0,0,0,0
32.064,17,4,240,2,32,32063,32,120,2,32,32063,32,120
240.45,6,33,8694,20,214,12653,970,2777,13,749,20033,1571,5917
0.386,6,10,968,5,256,93,256,460,5,304,93,304,508
10.774,6,20,4442,11,275,1077,275,998,9,768,738,1440,3444
0.288,17,4,624,2,64,286,64,184,2,192,160,192,440
241.528,6,47,8601,23,470,10976,1368,5930,24,175,10499,580,2671
0.006,17,2,550,2,247,6,247,550,0,0,0,0,0
8.423,6,24,4550,12,213,765,597,1689,12,552,745,1767,2861
1744.693,2,18,576,18,8,102629,8,576,0,0,0,0,0
0.141,6,13,1029,8,182,20,182,606,5,77,21,134,423
0.008,17,4,352,2,60,7,60,176,2,60,7,60,176
1744.494,6,99,7411,63,38,28137,205,4476,36,33,49833,98,2935
1.88,6,13,2311,8,188,268,245,700,5,1407,406,1407,1611
1773.451,6,180,15480,120,69,14902,69,8940,60,69,30055,69,6540
1776.161,1,63,9191,63,117,28647,320,9191,0,0,0,0,0
4.109,17,2,116,2,30,4109,30,116,0,0,0,0,0
7.172,6,1268,1139858,786,1374,8,1408,1110130,482,931,14,2816,29728
1665.491,1,7,392,7,28,277581,28,392,0,0,0,0,0
37.627,6,21,8540,9,267,4703,501,1165,12,860,3407,1420,7375
159.505,17,4,352,2,60,159504,60,176,2,60,159504,60,176
29.497,17,34,14282,17,604,1841,1350,10758,17,179,1841,1350,3524
70.765,6,19,780,9,0,6210,0,368,10,0,7860,0,412
14.502,6,21,3572,11,162,1450,293,1418,10,437,1583,1179,2154
141.863,17,6,528,3,60,70931,60,264,3,60,70930,60,264
1792.575,17,180,11520,180,36,10014,36,11520,0,0,0,0,0
0.937,17,4,624,2,64,935,64,184,2,192,823,192,440
6.034,17,4,240,2,32,6032,32,120,2,32,6033,32,120
0.049,6,3,144,1,0,0,0,52,2,0,49,0,92
58.257,6,27,8504,10,520,6473,1087,3652,17,394,3640,611,4852
13.882,6,30,7573,12,155,1262,267,1266,18,398,816,3417,6307
0.459,6,7,376,4,0,153,0,216,3,0,123,0,160
31.07,6,857,741188,516,1357,59,1368,716460,341,776,90,2736,24728
1700.623,17,13,534,11,14,170045,14,462,2,8,1700448,8,72
1792.361,17,136,10880,68,48,26751,48,5168,68,56,26751,56,5712
0.612,6,14,2181,8,324,87,585,1061,6,396,120,580,1120
1605.85,6,21,3171,14,241,123526,241,2247,7,92,267609,92,924
1780.288,17,142,11360,71,48,25432,48,5396,71,56,25432,56,5964
187.661,6,778,372143,409,842,459,1103,356040,369,446,509,1179,16103
7.32,6,1656,1551592,1065,1380,6,1408,1516196,591,776,12,1408,35396
1082.95,2,10,320,10,8,120327,8,320,0,0,0,0,0
0.116,6,12,5538,6,106,23,106,354,6,1234,4,2840,5184
1720.771,17,12,498,11,14,172077,14,462,1,8,0,8,36
280.201,6,27,7312,12,158,25472,267,1277,15,678,20010,2800,6035
0.416,17,17,9479,9,483,52,1350,4603,8,581,54,1350,4876
1.325,6,48,16428,25,808,55,1460,10732,23,433,52,1460,5696
100.174,17,4,352,2,60,100172,60,176,2,60,100173,60,176
1746.887,6,95,7203,63,38,28175,205,4476,32,33,56342,98,2727
0.044,17,2,212,1,46,0,46,74,1,110,0,110,138
1790.234,17,141,11268,72,48,25214,48,5472,69,56,25212,56,5796
19.036,17,3,2532,3,816,9518,1448,2532,0,0,0,0,0
1.037,6,29,12012,15,525,74,1360,3258,14,909,65,1380,8754
33.021,6,9,396,2,0,2509,0,88,7,0,5487,0,308
1792.219,6,356,22520,208,69,8658,69,12460,148,69,12191,69,10060
1797.126,1,345,28980,345,56,5224,56,28980,0,0,0,0,0
0.338,6,25,8874,13,237,28,589,1634,12,1101,30,2816,7240
0.649,6,23,7406,13,335,54,668,2026,10,1210,67,1946,5380
126.431,6,17,3506,8,92,18061,92,504,9,361,15775,1408,3002
1681.603,17,14,1036,7,30,280265,30,406,7,62,280264,62,630
1744.559,6,95,7203,63,38,28138,205,4476,32,33,56266,98,2727
574.698,1,42,2352,42,28,14017,28,2352,0,0,0,0,0
9.349,6,1677,1530575,1030,1406,8,1448,1492267,647,776,14,1448,38308
1770.402,6,99,9240,66,65,27236,65,5577,33,59,55322,59,3663
280.49,6,27,7312,13,158,23374,267,1317,14,678,21573,2085,5995
0.48,6,5,1564,3,413,240,413,946,2,269,187,269,618
6.207,6,18,5301,9,113,300,113,598,9,1082,767,1420,4703
1782.189,17,140,11200,70,48,25828,48,5320,70,56,25828,56,5880
1619.019,1,7,392,7,28,269836,28,392,0,0,0,0,0
1780.271,6,196,21204,128,109,14017,965,12128,68,93,26565,485,9076
1795.537,17,87,3648,86,14,21123,14,3612,1,8,0,8,36
1792.006,17,140,11200,70,48,25970,48,5320,70,56,25970,56,5880
1.225,6,23,7952,12,164,95,267,1288,11,1216,104,3779,6664
0.237,6,9,1002,5,213,59,213,417,4,421,67,421,585
28.14,6,50,12940,24,165,1223,721,2449,26,629,1117,1420,10491
0.267,17,2,198,1,39,0,39,67,1,103,0,103,131
0.921,6,11,1727,7,100,153,100,384,4,589,216,1152,1343
98.634,6,23,10581,11,367,63,783,1574,12,1064,8954,1460,9007
1.165,6,31,6467,15,164,83,267,1922,16,650,70,1380,4545
15.656,17,20,13644,12,925,1417,1350,11445,8,246,2224,1350,2199
34.793,17,11,836,11,48,3479,48,836,0,0,0,0,0
1789.133,6,361,22789,209,69,8601,69,12569,152,69,11847,69,10220
125.465,6,13,3091,7,92,20910,92,452,6,580,25054,2026,2639
204.024,6,1138,581787,637,846,320,1152,559701,501,341,408,341,22086
15.702,6,5,407,0,0,0,0,0,5,69,3925,69,407
0.24,17,2,304,1,60,0,60,88,1,188,0,188,216
0.053,17,2,290,1,40,0,40,68,1,194,0,194,222
1790.329,1,342,28728,342,56,5250,56,28728,0,0,0,0,0
0.299,6,31,11289,20,583,15,1420,6635,11,701,29,2840,4654
0.216,6,4,1037,2,0,203,0,104,2,853,15,853,933
1741.056,1,57,4788,57,56,31090,56,4788,0,0,0,0,0
1786.595,6,108,8604,68,66,26665,66,4964,40,60,45807,60,3640
0.165,17,2,410,1,46,0,46,74,1,308,0,308,336
0.069,17,2,904,1,300,0,300,328,1,548,0,548,576
1762.958,17,18,1494,9,31,220367,37,536,9,78,220361,136,958
0.579,6,30,17609,18,708,34,1360,4342,12,1596,41,4416,13267
374.626,6,23,1535,16,177,24975,177,1053,7,110,10406,110,482
1770.096,6,111,10160,70,65,25653,65,5939,41,59,44249,59,4221
1785.522,6,104,8444,68,66,26649,66,4964,36,60,51012,60,3480
1784.128,6,366,25541,212,99,8455,469,14965,154,69,11659,69,10576
33.881,6,31,5129,16,154,2258,722,1946,15,399,2404,2026,3183
1.344,6,49,19376,27,900,51,1460,13720,22,433,55,1460,5656
40.382,6,27,7177,13,155,3365,267,1306,14,530,3105,3417,5871
12.212,17,20,4045,10,33,1356,33,610,10,315,1356,327,3435
1.58,6,20,3833,11,234,158,564,1504,9,463,172,1343,2329
74.19,6,31,7741,11,162,7419,267,1423,20,393,3880,1917,6318
0.428,6,12,1653,6,288,78,288,548,6,426,47,434,1105
0.048,17,4,284,2,32,0,32,120,2,54,14,60,164
11.029,6,18,5610,10,275,1225,275,958,8,1440,853,1440,4652
1782.897,17,73,3060,72,14,25111,14,3024,1,8,0,8,36
0.815,6,11,1727,7,100,135,100,384,4,589,181,1152,1343
61.973,17,4,240,2,32,61971,32,120,2,32,61972,32,120
1740.442,17,30,31680,30,1028,60015,1028,31680,0,0,0,0,0
0.199,17,4,288,2,36,167,36,128,2,52,167,52,160
0.503,6,24,7449,13,334,41,663,2021,11,806,47,1368,5428
0.538,6,25,6128,12,181,48,537,1526,13,781,41,2224,4602
1792.725,17,144,11520,72,48,25249,48,5472,72,56,25249,56,6048
2.033,17,3,174,3,30,1016,30,174,0,0,0,0,0
350.115,17,3,126,3,14,175057,14,126,0,0,0,0,0
17.911,6,5,1614,5,1414,4477,1414,1614,0,0,0,0,0
2.9,17,4,296,4,46,966,46,296,0,0,0,0,0
5.009,17,4,558,2,36,5005,36,128,2,187,5002,187,430
4.114,1,3,84,3,0,0,0,84,0,0,0,0,0
5.007,17,4,502,2,36,5003,36,128,2,159,5002,159,374
1785.191,6,370,25770,214,99,8381,469,15114,156,69,11515,69,10656
0.007,17,2,334,1,39,0,39,67,1,239,0,239,267
1.057,6,8,4564,4,174,352,174,338,4,2031,155,2642,4226
240.234,6,55,17872,29,781,8579,1418,14793,26,214,9608,580,3079
77.121,17,4,240,2,32,77120,32,120,2,32,77120,32,120
6.187,17,24,13678,11,478,618,1350,5570,13,595,426,1350,8108
1745.693,6,95,7203,63,38,28156,205,4476,32,33,56299,98,2727
503.639,2,3,96,3,8,251819,8,96,0,0,0,0,0
1786.54,6,104,8376,68,65,26664,65,4930,36,59,51041,59,3446
0.497,17,20,11369,10,795,55,1350,8237,10,285,38,1350,3132
63.459,6,42,10737,21,830,512,1360,5050,21,371,3163,1360,5687
1.168,6,25,8056,12,164,90,267,1288,13,869,82,1402,6768
1.451,6,11,1727,7,100,241,100,384,4,589,398,1152,1343
1772.309,6,182,15629,121,69,14769,69,8980,61,69,29531,69,6649
0.052,17,4,624,2,36,0,36,128,2,220,48,292,496
1631.705,1,7,392,7,28,271950,28,392,0,0,0,0,0
31.831,17,4,240,2,32,31830,32,120,2,32,31830,32,120
0.329,6,83,91532,38,183,8,230,2533,45,2015,5,5608,88999
300.513,6,52,27827,31,510,10017,1162,3746,21,1436,1564,9856,24081
1.756,6,14,1765,7,288,262,288,608,7,426,262,434,1157
1782.85,17,85,3561,83,13,21739,14,3481,2,12,1782665,16,80
11.959,6,2367,2232633,1534,1378,7,1408,2184653,833,931,14,2801,47980
1780.172,6,354,22509,206,69,8683,69,12380,148,69,12109,69,10129
280.447,6,30,7432,13,158,23370,267,1317,17,603,17523,2076,6115
0.033,17,2,323,1,33,0,33,61,1,234,0,234,262
0.326,17,2,168,1,48,0,48,76,1,64,0,64,92
1.147,6,24,8004,12,164,88,267,1288,12,1014,89,2804,6716
1799.195,17,450,39960,405,35,4453,288,25740,45,288,40025,288,14220
0.079,6,10,1327,5,299,18,299,567,5,246,18,459,760
0.398,6,10,968,5,256,97,256,460,5,304,97,304,508
414.423,17,10,2459,5,32,103604,37,304,5,403,103604,463,2155
1797.005,6,356,22520,208,69,8681,69,12460,148,69,12224,69,10060
0.52,6,24,6042,13,108,43,147,959,11,773,43,1608,5083
63.216,6,18,2515,7,188,10536,245,660,11,1407,6295,1407,1855
0.016,17,2,548,2,246,16,246,548,0,0,0,0,0
0.034,17,2,212,1,46,0,46,74,1,110,0,110,138
189.774,6,28,6618,11,220,5671,516,1325,17,329,11855,1452,5293
11.708,6,1863,1617240,1127,1381,10,1420,1583579,736,467,15,1883,33661
2.54,6,25,4990,13,344,211,1194,2310,12,362,202,784,2680
3.194,17,5,290,5,30,798,30,290,0,0,0,0,0
231.566,6,31,8912,14,158,17812,267,1357,17,687,14469,1781,7555
1797.549,17,449,39928,404,35,4460,288,25708,45,288,40023,288,14220
1.332,6,46,18121,26,882,53,1440,12545,20,433,60,1440,5576
1799.647,17,448,39896,403,35,4476,288,25676,45,288,40017,288,14220
0.025,17,2,144,1,36,0,36,64,1,52,0,52,80
0.616,6,21,7290,12,335,55,668,1974,9,968,75,1475,5316
16.301,17,18,2528,9,48,2035,48,684,9,176,2032,308,1844
12.382,6,37,9320,21,114,619,318,1788,16,688,816,1942,7532
62.027,17,28,2327,26,30,2480,37,1515,2,378,335,435,812
205.543,6,41,7167,18,231,12090,495,2783,23,187,9304,1408,4384
1.509,6,24,6408,13,297,125,830,2011,11,988,149,1731,4397
63.128,6,9,881,5,302,15777,302,570,4,83,21039,83,311
1798.247,6,136,13467,84,66,21665,722,7035,52,84,35251,1408,6432
47.543,6,30,7432,14,158,3657,267,1357,16,678,3166,3456,6075
0.012,17,2,393,1,33,0,33,61,1,304,0,304,332
3.582,6,34,6169,17,206,223,314,2744,17,456,208,1152,3425
1632.919,17,18,1494,9,31,204112,37,536,9,78,204112,136,958
1.274,6,25,8044,13,164,106,267,1328,12,869,93,1408,6716
54.066,6,29,7257,14,155,4158,267,1346,15,482,3861,2840,5911
300.85,6,19,3951,6,150,449,174,544,13,319,25063,1420,3407
1681.651,17,14,1036,7,30,280269,30,406,7,62,280269,62,630
12.037,17,2,204,1,34,0,34,62,1,114,0,114,142
1120.354,6,69,5448,40,64,26430,64,2880,29,50,40009,58,2568
363.205,6,18,1242,14,180,27938,180,916,4,110,20057,110,326
1798.61,6,356,22520,208,69,8688,69,12460,148,69,12234,69,10060
0.36,17,2,304,1,60,0,60,88,1,188,0,188,216
274.624,6,41,7570,21,147,13727,517,1984,20,567,14449,2449,5586
369.612,6,25,1651,17,177,23100,177,1117,8,110,9201,110,534
15.706,6,2414,2239882,1549,1368,10,1408,2190238,865,931,17,2801,49644
1744.922,1,56,4704,0,0,0,0,0,56,56,31725,56,4704
127.122,6,22,8764,11,314,68,634,1427,11,983,12699,1360,7337
1787.903,6,353,22538,203,69,8850,69,12260,150,69,11999,69,10278
1.276,6,47,18971,27,877,49,1360,13395,20,476,58,2715,5576
5.887,6,2,218,0,0,0,0,0,2,69,5887,69,218
810.806,6,163,10315,95,69,8625,69,5732,68,69,12101,69,4583
1.397,6,19,8379,11,286,139,832,1726,8,1038,67,1368,6653
135.807,1,4,224,4,28,45269,28,224,0,0,0,0,0
1781.958,6,363,24345,211,88,8485,469,13987,152,69,11801,69,10358
11.174,6,27,11253,13,275,931,275,1078,14,1067,838,1380,10175
7.823,17,4,1344,4,308,2607,308,1344,0,0,0,0,0
5.904,6,40,7309,21,218,295,314,3463,19,513,313,1179,3846
0.183,17,2,258,1,60,0,60,88,1,142,0,142,170
1751.413,6,95,7203,63,38,28248,205,4476,32,33,56489,98,2727
174.57,6,10,2097,6,355,34914,413,1307,4,210,58122,269,790
119.035,6,25,9218,12,377,70,798,1657,13,781,9908,1460,7561
9.04,6,1700,1436837,939,1432,9,1448,1384329,761,776,11,1448,52508
0.267,6,9,1002,5,213,66,213,417,4,421,74,421,585
1657.199,1,8,448,8,28,236742,28,448,0,0,0,0,0
117.693,2,2,64,2,8,117693,8,64,0,0,0,0,0
1796.347,1,58,4872,0,0,0,0,0,58,56,31514,56,4872
281.983,17,2,908,2,426,281983,687,908,0,0,0,0,0
29.531,1,10,280,10,0,0,0,280,0,0,0,0,0
842.284,2,10,320,10,8,93587,8,320,0,0,0,0,0
8.062,6,539,522290,370,1352,21,1368,508826,169,776,46,1473,13464
0.322,6,20,7229,13,334,26,663,2021,7,1209,52,1906,5208
1786.66,6,102,8364,68,66,26666,66,4964,34,60,54138,60,3400
0.304,6,25,8861,13,242,25,610,1655,12,1095,26,2804,7206
0.092,6,10,1542,5,505,23,505,773,5,501,23,501,769
287.679,1,4,224,4,28,95893,28,224,0,0,0,0,0
0.948,6,32,13143,19,698,52,1360,5691,13,865,64,3921,7452
0.005,17,2,451,1,39,0,39,67,1,356,0,356,384
12.154,6,18,1252,10,92,1350,92,708,8,92,1070,92,544
1631.726,6,196,13500,73,46,22662,46,5682,123,46,13373,46,7818
1740.511,17,28,6468,28,203,64463,203,6468,0,0,0,0,0
1798.307,17,140,11200,70,48,26062,48,5320,70,56,26062,56,5880
3.789,6,234,158689,123,1355,31,1432,145990,111,540,32,1871,12699
1789.995,1,58,4872,0,0,0,0,0,58,56,31403,56,4872
15.486,6,8,480,2,0,1053,0,120,6,0,3062,0,360
1787.915,6,458,26600,250,69,7180,69,14140,208,34,8637,64,12460
0.141,17,2,154,1,33,0,33,61,1,65,0,65,93
96.842,6,37,10933,13,290,8070,1189,2564,24,389,4196,1460,8369
122.951,6,55,14526,24,168,5345,267,2485,31,568,4097,1400,12041
1787.435,6,102,8364,68,66,26678,66,4964,34,60,54160,60,3400
0.489,17,3,451,2,39,353,39,134,1,289,0,289,317
285.112,6,26,2857,14,326,21931,589,1389,12,282,25918,580,1468
3.625,17,5,295,5,31,906,31,295,0,0,0,0,0
1744.929,6,95,7203,63,38,28144,205,4476,32,33,56276,98,2727
218.609,17,4,240,2,32,218608,32,120,2,32,218607,32,120
100.875,6,9,820,5,226,25218,226,494,4,110,33464,110,326
0.382,6,27,9078,13,263,31,691,1736,14,943,28,1448,7342
13.528,6,31,8912,14,158,1040,267,1357,17,687,839,1781,7555
15.169,17,15,7694,7,558,2522,1350,4108,8,420,2162,1350,3586
1794.896,17,144,11520,72,48,25280,48,5472,72,56,25280,56,6048
1771.302,17,207,50027,207,213,8598,422,50027,0,0,0,0,0
0.01,17,2,148,2,46,10,46,148,0,0,0,0,0
1795.907,17,142,11360,71,48,25655,48,5396,71,56,25655,56,5964
1634.56,1,8,848,8,78,233508,78,848,0,0,0,0,0
4.53,6,36,6249,19,206,251,314,2824,17,456,266,1152,3425
4.73,6,15,3543,7,125,788,245,660,8,853,638,1152,2883
1.264,6,15,2638,8,288,150,288,640,7,568,129,853,1998
713.642,17,551,39120,470,40,1521,41,32268,81,56,512,57,6852
10.08,6,16,5255,9,275,1260,275,643,7,1440,844,1440,4612
280.625,6,28,7352,12,158,25511,267,1277,16,678,18705,2760,6075
625.56,17,8,608,4,48,208514,48,304,4,48,208514,48,304
15.454,17,17,8790,8,739,2197,1350,6140,9,266,1920,1350,2650
609.179,6,43,3273,21,65,22471,65,1555,22,46,29004,59,1718
2.866,6,25,8056,12,164,221,267,1288,13,869,200,1448,6768
1.389,6,46,18120,26,882,55,1360,12544,20,433,62,1360,5576
294.371,17,4,352,2,60,294370,60,176,2,60,294370,60,176
0.054,17,2,200,1,64,0,64,92,1,80,0,80,108
16.829,6,34,8190,18,337,989,697,1765,16,524,1108,3488,6425
1082.826,2,11,352,11,8,108282,8,352,0,0,0,0,0
0.031,17,4,304,2,37,25,37,130,2,59,22,65,174
1749.684,1,64,5376,64,56,27772,56,5376,0,0,0,0,0
17.014,6,9,496,3,0,8505,0,164,6,0,3401,0,332
1780.968,17,321,75651,321,207,5565,422,75651,0,0,0,0,0
0.065,6,12,3705,6,171,12,171,491,6,964,8,1448,3214
1.296,6,50,18590,27,841,49,1360,12894,23,433,51,1360,5696
21.436,6,20,4775,11,211,2143,211,1225,9,617,2672,904,3550
0.063,1,2,112,2,28,63,28,112,0,0,0,0,0
40.198,6,31,10155,17,588,2509,1368,4432,14,555,3088,1571,5723
7.909,6,69,21179,36,575,225,1152,16416,33,491,239,1179,4763
895.348,17,176,13376,176,48,5116,48,13376,0,0,0,0,0
37.121,1,43,4472,0,0,0,0,0,43,76,883,76,4472
1744.677,2,16,512,16,8,116311,8,512,0,0,0,0,0
240.239,6,57,19675,31,837,8007,1418,16711,26,200,9609,580,2964
1740.991,6,87,6322,58,31,30543,31,3915,29,31,62177,31,2407
1772.603,6,180,15480,120,69,14895,69,8940,60,69,30037,69,6540
1.966,6,34,7319,17,138,122,267,1795,17,691,104,1452,5524
28.869,6,6,328,4,0,9623,0,216,2,0,28718,0,112
458.34,17,6,528,3,60,229169,60,264,3,60,229169,60,264
5.059,17,4,288,2,36,5027,36,128,2,52,5028,52,160
0.516,6,49,20660,27,961,19,1380,15538,22,421,21,1923,5122
0.578,6,14,1745,7,288,66,288,600,7,426,67,434,1145
1790.149,17,142,11360,71,48,25573,48,5396,71,56,25573,56,5964
1745.583,6,95,7203,63,38,28154,205,4476,32,33,56295,98,2727
9.179,6,27,13465,8,154,1311,267,792,19,850,504,1917,12673
7.381,6,4,168,3,0,3690,0,124,1,0,0,0,44
0.006,17,2,550,1,72,0,72,100,1,422,0,422,450
3.729,6,33,6145,17,206,233,314,2744,16,551,230,1179,3401
71.859,6,38,17160,20,1019,3782,1448,9248,18,871,4050,1448,7912
1781.664,6,102,8296,68,65,26592,65,4930,34,59,53987,59,3366
0.042,6,12,3462,6,75,8,75,395,6,1373,8,1448,3067
1786.741,6,104,8376,68,65,26667,65,4930,36,59,51046,59,3446
0.031,17,2,912,1,308,0,308,336,1,548,0,548,576
0.014,17,2,189,1,30,0,30,58,1,103,0,103,131
1795.54,17,142,11360,71,48,25650,48,5396,71,56,25650,56,5964
34.321,17,40,5880,20,48,1805,48,1520,20,190,1805,308,4360
11.027,6,18,5610,10,275,1225,275,958,8,1440,858,1440,4652
1764.77,1,156,8736,156,28,11385,28,8736,0,0,0,0,0
1.43,6,41,9968,21,440,71,1360,4392,20,433,64,1360,5576
1797.601,17,140,11200,70,48,26052,48,5320,70,56,26052,56,5880
2.859,6,25,7782,14,371,219,832,1851,11,891,285,2816,5931
157.263,6,21,856,8,0,6984,0,324,13,0,13104,0,532
1798.575,6,355,22480,207,69,8730,69,12420,148,69,12234,69,10060
0.653,6,29,9288,14,221,50,710,1841,15,947,41,1368,7447
64.286,6,15,612,7,0,8125,0,284,8,0,9181,0,328
0.325,17,2,144,1,36,0,36,64,1,52,0,52,80
0.961,6,10,1687,7,100,160,100,384,3,1179,349,1179,1303
1787.905,6,356,22589,208,69,8637,69,12529,148,69,12162,69,10060
560.497,17,6,1619,3,30,280212,30,174,3,453,280245,463,1445
1.672,6,52,20619,30,911,57,1360,14918,22,437,69,2715,5701
342.477,17,5,1672,5,306,85619,308,1672,0,0,0,0,0
255.332,6,69,45701,43,1179,6079,1408,37615,26,960,2461,3847,8086
0.002,17,4,240,2,32,0,32,120,2,32,1,32,120
1715.729,1,62,3472,62,28,28126,28,3472,0,0,0,0,0
1798.98,1,57,4788,0,0,0,0,0,57,56,32124,56,4788
30.876,6,20,5854,11,267,3087,502,1246,9,707,3846,1420,4608
1.78,17,26,10379,11,486,178,1350,5655,15,286,122,1350,4724
11.795,6,19,6745,10,275,1310,275,958,9,1353,1345,1440,5787
2.038,17,2,2517,2,1230,2038,1258,2517,0,0,0,0,0
0.045,17,2,146,1,37,0,37,65,1,53,0,53,81
0.216,17,4,284,2,32,140,32,120,2,54,86,60,164
1789.633,1,58,4872,58,56,31397,56,4872,0,0,0,0,0
0.531,6,20,7229,13,334,44,663,2021,7,1209,78,1946,5208
0.119,6,10,766,5,185,29,185,453,5,45,17,45,313
1788.586,1,342,28728,342,56,5245,56,28728,0,0,0,0,0
10.932,6,20,7026,11,275,1093,275,998,9,1414,767,1414,6028
1755.605,6,224,17065,112,86,15816,208,11655,112,31,15814,31,5410
165.686,17,11,836,11,48,16568,48,836,0,0,0,0,0
0.489,6,20,7229,13,334,40,663,2021,7,1209,77,1946,5208
11.455,6,26,9953,13,275,954,275,1078,13,1042,887,1440,8875
1772.636,6,180,15480,120,69,14896,69,8940,60,69,30038,69,6540
1.75,17,3,1480,1,300,0,300,328,2,548,100,548,1152
1.66,6,41,10025,23,440,75,1360,4484,18,437,84,2715,5541
0.752,6,26,5680,14,121,57,267,1295,12,650,61,1420,4385
806.134,6,11,657,8,31,115162,31,444,3,31,299529,31,213
0.284,6,4,1037,2,0,239,0,104,2,853,47,853,933
10.74,6,18,4266,10,275,1193,275,958,8,992,852,1440,3308
0.089,17,3,1540,3,485,44,513,1540,0,0,0,0,0
4.154,17,6,1350,6,197,830,206,1350,0,0,0,0,0
377.796,2,3,96,3,8,188898,8,96,0,0,0,0,0
386.655,6,18,1239,14,177,29742,177,913,4,110,20116,110,326
173.477,17,4,240,2,32,173476,32,120,2,32,173476,32,120
60.341,6,45,8410,25,132,2514,174,1934,20,472,3169,1452,6476
11.565,6,22,6817,12,275,1051,275,1038,10,1073,728,1440,5779
300.796,6,38,9612,20,651,15831,1440,4090,18,399,507,1440,5522
1798.001,6,377,26795,217,104,8324,469,15772,160,69,11307,69,11023
1679.068,1,15,840,15,28,119933,28,840,0,0,0,0,0
7.064,6,38,7229,19,218,392,314,3383,19,513,377,1179,3846
1772.569,6,180,15480,120,69,14895,69,8940,60,69,30036,69,6540
1794.974,17,144,11520,72,48,25281,48,5472,72,56,25281,56,6048
1741.243,17,30,31680,30,1028,60042,1028,31680,0,0,0,0,0
22.697,17,31,10860,14,463,1745,1350,6883,17,205,1416,1350,3977
2.888,17,24,12502,10,526,320,1350,5542,14,469,205,1350,6960
280.483,6,29,7392,14,158,21575,267,1357,15,678,20027,3456,6035
15.127,6,8,2516,8,274,2161,383,2516,0,0,0,0,0
20.194,17,14,8468,7,679,3360,1350,4949,7,474,3360,1350,3519
33.687,6,28,4937,14,154,2591,722,1806,14,479,2575,2118,3131
73.56,6,9,468,9,0,0,0,468,0,0,0,0,0
1778.793,1,59,4956,0,0,0,0,0,59,56,30668,56,4956
1745.28,6,95,7203,63,38,28149,205,4476,32,33,56289,98,2727
2.275,6,14,2351,8,188,325,245,700,6,703,402,1152,1651
5.389,6,39,7269,20,218,283,314,3423,19,513,285,1179,3846
11.96,6,1829,1621531,1148,1363,10,1380,1588081,681,475,17,1923,33450
37.356,6,93,25221,58,160,655,287,7538,35,565,1097,1708,17683
181.913,17,4,352,2,60,181912,60,176,2,60,181912,60,176
280.52,6,27,7312,12,158,25501,267,1277,15,678,20030,2045,6035
1765.438,17,338,78570,338,204,5238,379,78570,0,0,0,0,0
0.038,6,9,1340,5,145,9,145,349,4,827,10,827,991
0.018,6,12,963,7,181,3,181,541,5,77,3,133,422
428.439,6,61,8940,31,103,14275,722,3020,30,218,14767,2026,5920
0.025,17,2,198,1,37,0,37,65,1,105,0,105,133
1770.321,6,99,9240,66,65,27235,65,5577,33,59,55318,59,3663
6.568,6,992,847047,607,1357,10,1380,825435,385,515,16,1924,21612
0.391,6,3,189,1,0,0,0,40,2,69,227,69,149
8.388,6,30,7454,16,380,559,885,3491,14,645,631,1767,3963
2.934,17,3,228,2,48,2903,48,152,1,48,0,48,76
1793.204,1,258,27348,258,78,6977,78,27348,0,0,0,0,0
1715.481,1,72,4032,72,28,24161,28,4032,0,0,0,0,0
4.517,17,8,704,4,37,1354,37,260,4,83,465,89,444
126.647,6,2489,3093865,861,250,147,433,45519,1628,1826,77,12672,3048346
450.889,17,6,528,3,60,225443,60,264,3,60,225444,60,264
1772.552,6,180,15480,120,69,14895,69,8940,60,69,30036,69,6540
1.737,17,17,11517,8,743,226,1350,6172,9,565,212,1350,5345
0.936,6,26,8733,14,203,72,458,1406,12,976,67,1440,7327
1.614,6,52,18971,29,856,57,1360,13230,23,437,63,2715,5741
240.328,6,61,20787,31,800,8010,1418,17626,30,199,8286,580,3161
0.574,6,27,9030,13,248,47,633,1690,14,941,39,1368,7340
1775.646,6,181,15589,120,69,14921,69,8940,61,69,29592,69,6649
1.858,6,6,328,4,0,619,0,216,2,0,1834,0,112
0.932,6,10,1687,7,100,155,100,384,3,1179,336,1179,1303
1753.678,6,98,7390,63,38,28285,205,4476,35,33,51571,98,2914
143.397,17,4,352,2,60,143396,60,176,2,60,143396,60,176
366.235,6,25,1651,17,177,22889,177,1117,8,110,9160,110,534
97.116,6,31,7682,12,155,8828,267,1266,19,403,5394,2840,6416
2.11,6,13,2311,8,188,301,245,700,5,1407,463,1407,1611
0.24,17,2,390,1,46,0,46,74,1,288,0,288,316
15.289,6,24,6993,13,275,1274,275,1078,11,910,1027,1440,5915
11.55,17,3,2906,3,940,5775,1451,2906,0,0,0,0,0
0.205,6,20,4960,10,137,22,267,1092,10,692,21,1467,3868
0.057,6,17,3177,8,460,7,806,1805,9,224,6,694,1372
1784.864,6,112,9755,72,77,25138,292,5655,40,69,45763,247,4100
194.5,6,18,1656,3,106,97250,106,234,15,79,13880,90,1422
4.917,6,38,7229,20,218,258,314,3423,18,513,273,1179,3806
1680.3,1,7,392,7,28,280050,28,392,0,0,0,0,0
69.849,6,34,9034,15,290,4989,965,2351,19,394,3880,2840,6683
1663.641,1,7,392,7,28,277273,28,392,0,0,0,0,0
7.277,6,5,240,1,0,0,0,48,4,0,2422,0,192
1794.656,6,356,22520,208,69,8669,69,12460,148,69,12208,69,10060
883.555,6,84,9290,43,89,19104,722,4043,41,125,22084,1408,5247
50.757,17,4,1344,4,308,16919,308,1344,0,0,0,0,0
70.1,17,6,384,6,36,14020,36,384,0,0,0,0,0
1680.756,1,15,870,15,30,120054,30,870,0,0,0,0,0
1790.499,1,58,4872,58,56,31412,56,4872,0,0,0,0,0
832.282,6,120,15064,57,113,14859,721,6586,63,247,13421,1440,8478
1.34,6,46,19117,27,890,51,1360,13581,19,433,64,1360,5536
6.612,6,1073,919329,641,1384,10,1420,897828,432,420,15,1420,21501
1781.209,1,342,28728,342,56,5223,56,28728,0,0,0,0,0
49.654,6,52,11505,24,541,746,914,3757,28,300,1833,1460,7748
1751.507,1,77,6468,0,0,0,0,0,77,56,23046,56,6468
88.805,17,4,352,2,60,88804,60,176,2,60,88804,60,176
123.231,2,2,64,2,8,123231,8,64,0,0,0,0,0
0.028,6,3,180,2,0,17,0,128,1,0,0,0,52
22.782,6,2182,1973729,1344,1387,16,1448,1924673,838,776,26,1448,49056
1.264,6,34,11177,18,559,74,1360,4123,16,640,72,1360,7054
8.064,6,32,8127,15,191,576,721,1943,17,611,492,2828,6184
5.618,6,40,7309,21,218,280,314,3463,19,513,298,1179,3846
1795.432,17,448,39896,403,35,4466,288,25676,45,288,40018,288,14220
0.5,17,3,451,2,39,399,39,134,1,289,0,289,317
128.614,6,151,116379,97,1278,1339,1368,104790,54,626,1478,2519,11589
297.501,1,4,224,4,28,99167,28,224,0,0,0,0,0
1.084,6,29,8303,15,225,68,561,1985,14,957,69,1631,6318
1800.0,6,427,29510,186,46,9578,46,11728,241,46,7500,46,17782
1.636,6,835,932939,308,194,5,230,16803,527,1692,3,7240,916136
0.059,6,9,1928,5,666,14,666,934,4,778,19,778,994
1784.271,6,356,22520,208,69,8619,69,12460,148,69,12137,69,10060
0.101,17,2,245,1,32,0,32,60,1,157,0,157,185
0.861,6,10,968,5,256,212,256,460,5,304,212,304,508
466.566,6,214,71360,104,653,4528,1460,55175,110,235,4279,1642,16185
6.349,6,30,7432,13,158,529,267,1317,17,543,395,1400,6115
7.657,6,10,636,4,106,2552,106,274,6,90,1492,90,362
1740.248,17,30,1710,30,29,60008,29,1710,0,0,0,0,0
7.766,6,16,1402,9,275,970,275,918,7,96,969,96,484
112.237,6,13,3818,7,407,18706,722,1174,6,1164,22410,1408,2644
5.026,17,3,208,2,36,5003,36,128,1,52,0,52,80
1719.442,17,12,498,11,14,171944,14,462,1,8,0,8,36
2.153,17,7,2490,7,327,358,361,2490,0,0,0,0,0
1.45,6,243,188505,144,1331,10,1432,180233,99,389,13,1432,8272
64.617,6,35,7519,14,144,178,267,1437,21,475,3230,1420,6082
15.685,6,2343,2145074,1480,1370,10,1408,2095534,863,776,17,1408,49540
180.505,2,2,64,2,8,180505,8,64,0,0,0,0,0
1744.848,6,96,7286,63,38,28142,205,4476,33,33,54516,98,2810
3.89,17,4,240,4,32,1296,32,240,0,0,0,0,0
12.115,6,1910,1766709,1192,1403,10,1448,1724709,718,776,16,1448,42000
2.442,6,31,6734,16,176,162,267,2229,15,650,163,1380,4505
0.041,17,3,1007,1,137,0,137,165,2,393,40,393,842
1.14,6,11,1727,7,100,190,100,384,4,589,296,1152,1343
1786.44,6,102,8296,68,65,26663,65,4930,34,59,54131,59,3366
1756.208,6,86,6877,41,36,43903,36,2312,45,445,38865,445,4565
1781.76,6,363,23007,210,69,8525,69,12678,153,69,11722,69,10329
1792.09,17,142,11360,71,48,25601,48,5396,71,56,25601,56,5964
1.674,17,5,1709,5,313,418,354,1709,0,0,0,0,0
1787.722,6,3751,3881246,1277,130,1401,330,75792,2474,1532,722,8508,3805454
4.407,6,37,7205,19,218,244,314,3383,18,516,243,1179,3822
0.868,6,10,1687,7,100,144,100,384,3,1179,309,1179,1303
1741.368,6,87,6322,58,31,30550,31,3915,29,31,62190,31,2407
68.956,6,32,7098,15,171,4922,517,1669,17,504,4306,1418,5429
0.017,17,4,352,2,37,12,37,130,2,83,9,89,222
1799.215,17,450,39960,405,35,4453,288,25740,45,288,40017,288,14220
0.444,6,10,1992,5,288,108,288,508,5,424,63,434,1484
5.626,6,39,7285,20,218,296,314,3423,19,516,298,1179,3862
371.185,6,27,1767,18,177,21834,177,1181,9,110,9737,110,586
96.913,6,824,419713,470,833,206,1152,400421,354,427,273,1179,19292
1795.25,6,355,22480,207,69,8714,69,12420,148,69,12212,69,10060
2.412,6,13,2311,8,188,344,245,700,5,1407,527,1407,1611
1.604,6,47,18782,27,863,61,1360,13206,20,476,73,2715,5576
3.32,17,25,8117,12,416,298,1350,5334,13,186,273,1350,2783
1630.341,1,7,392,7,28,271723,28,392,0,0,0,0,0
18.623,6,20,7152,11,624,1667,1205,2452,9,706,2303,1368,4700
1.322,6,49,19389,27,901,50,1460,13733,22,433,54,1460,5656
0.536,17,2,152,1,48,0,48,76,1,48,0,48,76
70.55,6,14,572,6,0,6137,0,244,8,0,10063,0,328
27.982,6,24,7054,11,181,2798,267,1168,13,670,2329,2036,5886
1787.098,17,87,3648,86,14,21024,14,3612,1,8,0,8,36
9.421,6,1662,1502729,1036,1371,8,1408,1465513,626,931,14,2801,37216
0.832,17,2,148,2,46,832,46,148,0,0,0,0,0
1.409,6,47,18164,26,882,56,1360,12548,21,476,60,2715,5616
1780.482,17,142,11360,71,48,25435,48,5396,71,56,25435,56,5964
1785.211,6,373,28442,217,126,8264,469,17441,156,69,11516,69,11001
1786.602,6,102,8296,68,65,26665,65,4930,34,59,54136,59,3366
840.601,17,8,2196,4,30,280198,30,232,4,463,280198,463,1964
3.977,17,3,180,3,32,1988,32,180,0,0,0,0,0
1.598,6,43,10715,23,513,72,1360,5094,20,437,73,2715,5621
0.825,6,29,9292,17,451,51,1360,3421,12,896,60,3107,5871
1789.131,17,142,11360,71,48,25558,48,5396,71,56,25558,56,5964
130.267,6,23,6684,6,154,26053,267,712,17,479,8128,1452,5972
1.43,6,50,19702,27,921,55,1460,14006,23,433,56,1460,5696
1795.157,17,80,3354,79,14,23014,14,3318,1,8,0,8,36
1.452,6,10,1102,6,483,290,483,803,4,83,481,83,299
2.876,17,2,178,1,29,0,29,57,1,93,0,93,121
11.22,6,27,11433,13,275,935,275,1078,14,1087,829,1440,10355
1796.2,6,355,22480,207,69,8719,69,12420,148,69,12218,69,10060
0.071,6,14,4414,7,127,11,127,499,7,885,11,1448,3915
124.741,6,131,101626,85,1256,1485,1368,91113,46,676,1830,1368,10513
134.192,2,4,128,4,8,44730,8,128,0,0,0,0,0
1757.031,6,109,6556,62,27,28802,27,3653,47,27,38195,27,2903
0.977,17,4,624,2,64,935,64,184,2,192,812,192,440
1795.304,17,80,3354,79,14,23016,14,3318,1,8,0,8,36
1786.592,1,115,6440,115,28,15671,28,6440,0,0,0,0,0
1798.943,1,260,14560,260,28,6945,28,14560,0,0,0,0,0
162.822,17,6,2046,6,313,32564,329,2046,0,0,0,0,0
0.958,17,20,14414,12,969,86,1350,11974,8,277,132,1350,2440
5.121,6,40,7309,21,218,256,314,3463,19,440,270,1152,3846
12.04,17,10,830,5,47,3009,47,375,5,63,3009,63,455
3.897,17,4,296,4,46,1299,46,296,0,0,0,0,0
5.463,6,46,8449,22,227,260,314,4062,24,427,225,1152,4387
258.2,1,4,224,4,28,86066,28,224,0,0,0,0,0
300.18,6,46,13485,24,840,13044,1360,7741,22,346,14285,1360,5744
0.34,6,27,8914,13,231,28,563,1608,14,938,24,1408,7306
1787.116,6,102,8364,68,66,26673,66,4964,34,60,54151,60,3400
1773.86,6,180,15480,120,69,14906,69,8940,60,69,30057,69,6540
0.905,6,10,1687,7,100,150,100,384,3,1179,330,1179,1303
1749.953,6,105,8593,67,52,26514,205,5224,38,36,47286,98,3369
0.097,6,13,1015,7,181,16,181,541,6,77,11,133,474
39.153,6,17,7988,4,125,4319,245,540,13,1152,3241,1152,7448
882.485,2,7,224,7,8,147080,8,224,0,0,0,0,0
1773.225,6,180,15480,120,69,14901,69,8940,60,69,30049,69,6540
1498.013,6,49,3572,32,33,44040,33,2192,17,31,93615,31,1380
1654.247,1,7,392,7,28,275707,28,392,0,0,0,0,0
0.079,17,2,154,2,49,79,49,154,0,0,0,0,0
262.99,17,4,352,2,60,262989,60,176,2,60,262989,60,176
1007.851,2,6,192,6,8,201570,8,192,0,0,0,0,0
24.83,6,20,4462,9,341,3103,722,1487,11,342,2462,1408,2975
12.404,6,25,4851,12,204,1109,722,1655,13,503,1017,1402,3196
3.037,6,15,1208,8,283,406,283,715,7,105,474,105,493
1772.755,6,180,15480,120,69,14897,69,8940,60,69,30040,69,6540
0.908,6,10,1687,7,100,151,100,384,3,1179,322,1179,1303
8.35,6,14,4051,6,49,1634,92,419,8,1070,1167,1448,3632
1.737,6,44,10145,23,440,78,1360,4484,21,400,77,1360,5661
1786.292,17,142,11360,71,48,25518,48,5396,71,56,25518,56,5964
1793.779,6,253,37471,155,302,11647,302,27110,98,83,18492,83,10361
0.125,6,14,5513,7,121,20,121,493,7,1163,18,1448,5020
12.667,6,8,336,4,0,4221,0,164,4,0,4217,0,172
1773.228,6,181,15589,120,69,14901,69,8940,61,69,29553,69,6649
1.988,17,2,778,2,361,1988,361,778,0,0,0,0,0
280.2,6,29,7392,13,158,23350,267,1317,16,603,18677,1400,6075
166.706,6,22,8752,11,314,72,634,1415,11,983,16657,1360,7337
1785.351,17,86,3606,85,14,21254,14,3570,1,8,0,8,36
300.875,2,3,96,3,8,150437,8,96,0,0,0,0,0
0.014,6,16,6004,8,88,1,88,452,8,1305,2,1880,5552
60.433,6,9,820,5,226,15108,226,494,4,110,20059,110,326
1744.647,2,17,544,17,8,109040,8,544,0,0,0,0,0
3.866,6,24,8221,12,349,345,517,2042,12,924,345,2449,6179
1787.485,6,165,16959,95,69,19015,722,8054,70,92,25899,1408,8905
0.22,17,2,624,2,284,220,284,624,0,0,0,0,0
0.158,6,25,7216,12,155,14,267,1261,13,678,12,2045,5955
1797.474,6,356,22520,208,69,8683,69,12460,148,69,12227,69,10060
259.88,6,28,6456,11,216,7467,501,1310,17,343,16236,1420,5146
1794.93,17,89,3729,87,13,20869,14,3649,2,12,1794747,16,80
35.073,6,33,6081,17,180,2178,721,1987,16,465,2325,2026,4094
301.499,6,40,8736,20,322,15868,941,2132,20,386,492,1460,6604
1785.947,6,104,8444,68,66,26655,66,4964,36,60,51024,60,3480
1764.632,2,15,480,15,8,126045,8,480,0,0,0,0,0
9.209,17,4,352,2,60,9208,60,176,2,60,9208,60,176
0.466,6,13,1693,7,288,74,288,588,6,426,52,434,1105
0.251,6,10,1671,6,552,49,948,1348,4,159,83,159,323
1.798,6,26,10575,13,164,134,267,1396,13,1213,134,3819,9179
1.011,6,51,13813,24,549,43,1429,4824,27,464,37,1986,8989
1786.255,17,87,3648,86,14,21014,14,3612,1,8,0,8,36
364.239,6,23,1535,16,177,24282,177,1053,7,110,10395,110,482
0.49,17,16,10624,8,516,70,1350,4358,8,755,43,1350,6266
7.573,6,25,4594,13,213,631,597,1741,12,552,669,1767,2853
0.453,17,4,352,2,37,438,37,130,2,83,440,89,222
0.0,6,2,2359,1,0,0,0,40,1,2279,0,2279,2319
0.055,17,2,373,1,34,0,34,62,1,283,0,283,311
0.458,6,49,20913,27,1048,17,1380,15791,22,421,20,1923,5122
0.172,6,2,175,1,0,0,0,40,1,83,0,83,135
1771.72,6,103,9448,66,65,27257,65,5577,37,59,49211,59,3871
0.009,17,2,403,1,44,0,44,72,1,303,0,303,331
0.016,6,8,476,6,0,2,0,360,2,0,10,0,116
168.75,6,21,8134,11,520,96,1223,2034,10,948,18730,1631,6100
341.96,1,16,896,16,28,22797,28,896,0,0,0,0,0
2.037,17,2,116,2,30,2037,30,116,0,0,0,0,0
1799.75,1,148,15688,148,78,12243,78,15688,0,0,0,0,0
50.736,17,4,352,2,60,50735,60,176,2,60,50735,60,176
0.166,6,10,1514,5,503,41,503,771,5,475,41,475,743
4.148,17,8,848,4,46,1382,46,296,4,110,1382,110,552
1.041,6,10,1687,7,100,173,100,384,3,1179,386,1179,1303
0.788,6,25,10387,14,550,60,1344,2280,11,1093,66,3614,8107
9.989,6,45,8951,23,389,454,854,2193,22,391,469,2720,6758
1796.878,1,58,4872,58,56,31524,56,4872,0,0,0,0,0
17.004,17,27,9117,12,300,1543,1350,3947,15,316,1212,1350,5170
13.152,17,4,824,2,48,13135,48,152,2,308,13130,308,672
167.775,6,23,6177,9,272,106,516,1180,14,403,12898,1452,4997
0.173,17,2,152,1,48,0,48,76,1,48,0,48,76
1741.096,6,90,6521,59,31,30018,31,3998,31,31,58035,31,2523
3.29,17,25,11244,11,348,329,1350,4143,14,479,212,1350,7101
0.704,17,21,12108,11,846,67,1350,9624,10,220,74,1350,2484
1075.945,6,68,5349,42,65,26242,65,2980,26,57,43034,59,2369
1774.639,1,63,5292,63,56,28623,56,5292,0,0,0,0,0
104.869,6,32,5288,16,165,6991,722,1987,16,308,6979,1448,3301
0.167,6,3,132,2,0,6,0,92,1,0,0,0,40
2.347,6,13,2311,8,188,335,245,700,5,1407,521,1407,1611
21.702,17,4,824,2,48,21690,48,152,2,308,21690,308,672
1.299,6,232,177166,135,1329,9,1420,168995,97,534,13,3303,8171
22.072,6,19,3703,9,288,2759,288,708,10,639,2419,853,2995
44.661,6,36,8198,18,316,531,633,1725,18,478,2616,2128,6473
21.643,17,4,352,2,60,21641,60,176,2,60,21642,60,176
1747.965,6,95,7203,63,38,28192,205,4476,32,33,56372,98,2727
3.617,6,27,7124,12,295,325,517,1825,15,643,255,1418,5299
0.007,6,5,310,3,31,3,31,175,2,31,0,31,135
19.342,6,6,328,4,0,6447,0,216,2,0,19300,0,112
4.831,17,2,178,1,29,0,29,57,1,93,0,93,121
1791.437,17,140,11200,70,48,25962,48,5320,70,56,25962,56,5880
0.503,17,3,451,2,39,326,39,134,1,289,0,289,317
0.629,6,11,976,5,283,106,283,551,6,105,88,105,425
300.807,6,33,8390,17,204,18800,467,1744,16,446,5116,1448,6646
1786.676,6,103,8395,68,65,26666,65,4930,35,59,52546,59,3465
282.067,6,33,7552,14,158,21697,267,1357,19,543,15669,1400,6195
0.199,6,16,5127,9,133,24,159,887,7,773,24,1418,4240
1788.836,6,356,22589,207,69,8683,69,12420,149,69,12086,69,10169
1780.073,1,342,28728,342,56,5220,56,28728,0,0,0,0,0
1140.08,17,164,12464,164,48,6994,48,12464,0,0,0,0,0
1401.366,17,12,888,6,30,280266,30,348,6,62,280266,62,540
1795.009,17,447,39352,402,35,4476,288,25380,45,282,40021,288,13972
280.428,6,29,7392,13,158,23369,267,1317,16,603,18691,2760,6075
1773.158,6,181,15589,120,69,14900,69,8940,61,69,29544,69,6649
2.075,1,2,112,2,28,2075,28,112,0,0,0,0,0
665.783,6,71,10018,34,102,18313,501,3010,37,178,18491,1420,7008
1.687,6,16,2297,8,324,241,585,1061,8,396,189,580,1236
61.468,6,36,15844,22,796,2927,1368,9117,14,748,4707,2736,6727
242.767,17,4,240,2,32,242766,32,120,2,32,242765,32,120
4.098,17,6,5701,2,723,4098,1350,1503,4,1021,691,1350,4198
240.292,6,46,8959,24,523,10447,1408,5967,22,204,11442,618,2992
1.521,6,19,3781,10,234,169,564,1452,9,463,167,1343,2329
2.369,17,3,1167,3,361,1184,361,1167,0,0,0,0,0
1792.52,6,359,22709,209,69,8617,69,12569,150,69,12027,69,10140
106.491,6,27,12897,15,834,66,1360,5640,12,966,9662,2720,7257
0.186,1,2,112,2,28,186,28,112,0,0,0,0,0
1799.75,6,368,25690,215,99,8410,469,15085,153,69,11840,69,10605
2.691,6,40,18798,20,513,141,1440,3459,20,907,132,1440,15339
0.581,17,15,8337,8,705,83,1350,5871,7,324,88,1350,2466
0.524,17,3,451,2,39,468,39,134,1,289,0,289,317
18.195,6,1068,930107,682,1288,26,1368,904019,386,776,46,1473,26088
1.32,6,41,8429,21,320,66,1162,2808,20,400,60,1460,5621
1776.533,17,140,11200,70,48,25746,48,5320,70,56,25746,56,5880
177.979,6,28,7724,11,220,5649,516,1326,17,408,11117,1452,6398
0.209,17,2,196,1,62,0,62,90,1,78,0,78,106
2.278,6,13,2311,8,188,325,245,700,5,1407,504,1407,1611
0.4,6,21,7203,12,318,34,600,1906,9,964,47,1471,5297
222.188,17,4,240,2,32,222187,32,120,2,32,222187,32,120
193.554,6,35,11271,11,293,19350,1189,2799,24,469,8413,2077,8472
0.015,17,2,439,1,43,0,43,71,1,340,0,340,368
0.057,17,2,255,1,43,0,43,71,1,156,0,156,184
1792.687,6,356,22520,208,69,8660,69,12460,148,69,12195,69,10060
9.046,6,69,20246,36,540,258,1152,15499,33,489,274,1179,4747
240.181,6,54,18188,29,817,8577,1402,15416,25,183,10007,580,2772
6.453,6,45,8409,23,227,293,314,4102,22,427,295,1152,4307
0.222,17,8,2742,8,314,31,353,2742,0,0,0,0,0
27.004,17,4,1344,4,308,9001,308,1344,0,0,0,0,0
299.153,17,4,514,2,36,299147,36,128,2,165,299146,187,386
240.21,6,39,5289,19,248,13344,837,2732,20,188,12642,483,2557
197.585,17,4,304,4,48,65861,48,304,0,0,0,0,0
0.959,6,50,16917,31,368,31,1360,9004,19,793,46,4649,7913
0.011,17,2,214,1,39,0,39,67,1,119,0,119,147
32.178,6,202,222089,49,128,670,306,2932,153,1417,211,2836,219157
1787.038,6,3762,4151477,1347,128,1327,348,82225,2415,1682,740,4206,4069252
0.394,6,25,7552,14,334,29,663,2073,11,979,38,1906,5479
2.151,6,13,2311,8,188,307,245,700,5,1407,474,1407,1611
1786.763,17,87,3648,86,14,21020,14,3612,1,8,0,8,36
1762.225,6,200,13640,100,65,17800,208,8679,100,31,17797,31,4961
1797.025,1,342,28728,342,56,5269,56,28728,0,0,0,0,0
1781.41,17,140,11200,70,48,25817,48,5320,70,56,25817,56,5880
1798.527,17,449,39928,404,35,4462,288,25708,45,288,40017,288,14220
1796.569,17,448,39896,403,35,4469,288,25676,45,288,40019,288,14220
280.674,6,32,7853,14,158,21590,267,1357,18,524,16508,1400,6496
0.266,17,2,152,1,48,0,48,76,1,48,0,48,76
0.059,6,9,1348,5,145,14,145,349,4,835,14,835,999
1785.065,6,356,22520,208,69,8623,69,12460,148,69,12143,69,10060
280.239,6,30,7432,13,158,23353,267,1317,17,543,17512,1300,6115
2.735,6,13,2311,8,188,390,245,700,5,1407,620,1407,1611
1.471,6,41,11378,22,547,70,1360,5842,19,433,70,1360,5536
46.279,17,4,352,2,60,46277,60,176,2,60,46278,60,176
10.825,1,9,954,9,78,1353,78,954,0,0,0,0,0
38.061,17,4,1344,4,308,12687,308,1344,0,0,0,0,0
1.841,6,31,11898,14,197,141,569,1942,17,1004,112,1438,9956
1786.385,6,164,21348,95,316,19004,316,15072,69,83,26270,83,6276
0.761,6,27,8942,13,232,63,569,1614,14,941,54,1438,7328
61.307,6,37,15924,22,799,2919,1448,9146,15,665,4361,1448,6778
300.778,6,37,11516,20,590,15830,1408,4590,17,502,537,1408,6926
280.511,6,30,7432,13,158,23375,267,1317,17,603,17528,2760,6115
0.216,17,2,152,2,48,216,48,152,0,0,0,0,0
1781.271,17,138,11040,69,48,26195,48,5244,69,56,26195,56,5796
1742.314,6,97,7307,63,38,28101,205,4476,34,33,52789,98,2831
0.063,6,9,1339,5,145,15,145,349,4,826,14,826,990
0.198,6,7,423,4,43,43,43,259,3,0,94,0,164
14.204,6,69,20326,35,543,417,1152,15539,34,427,421,1152,4787
1.57,6,20,3833,11,234,157,564,1504,9,463,172,1343,2329
18.014,6,9,962,4,135,6004,208,700,5,62,2722,62,262
0.543,2,2,64,2,8,543,8,64,0,0,0,0,0
137.413,17,4,352,2,60,137412,60,176,2,60,137412,60,176
1793.087,17,179,13962,179,50,10073,50,13962,0,0,0,0,0
1793.103,6,355,22480,207,69,8704,69,12420,148,69,12197,69,10060
3.797,17,4,1568,4,364,1265,364,1568,0,0,0,0,0
1797.043,1,92,5152,92,28,19747,28,5152,0,0,0,0,0
0.314,6,26,8892,13,237,26,589,1634,13,1095,25,2804,7258
1.3,6,46,18294,26,895,52,1460,12718,20,433,58,1460,5576
300.617,6,37,8550,20,315,15821,882,2117,17,478,530,2128,6433
23.739,17,14,1232,7,48,3954,48,532,7,72,3954,72,700
11.781,6,1872,1629354,1134,1382,10,1420,1595601,738,467,15,1883,33753
52.304,17,6,456,6,48,10460,48,456,0,0,0,0,0
0.282,6,28,9007,13,231,23,563,1620,15,824,19,1408,7387
85.322,6,11225,10805516,4110,234,20,517,234474,7115,1436,11,4320,10571042
1783.741,1,80,8480,80,78,22579,78,8480,0,0,0,0,0
125.312,17,4,288,2,36,125281,36,128,2,52,125280,52,160
221.581,17,4,352,2,60,221580,60,176,2,60,221580,60,176
0.001,17,2,515,1,137,0,137,165,1,322,0,322,350
33.959,6,35,7364,17,154,2122,722,1998,18,491,1987,1408,5366
1786.578,6,102,8228,68,64,26665,64,4896,34,58,54135,58,3332
0.041,6,7,423,4,43,2,43,259,3,0,19,0,164
1787.637,6,273,33134,111,133,16250,1360,15947,162,137,11102,4662,17187
120.816,6,46,8489,19,123,3382,267,1753,27,353,4646,1997,6736
1.224,6,24,8028,12,164,94,267,1312,12,1014,94,2411,6716
1744.751,2,25,800,25,8,72697,8,800,0,0,0,0,0
1.484,6,50,19300,27,892,57,1460,13604,23,433,57,1460,5696
1766.359,6,212,14837,105,70,16984,208,9565,107,31,16661,31,5272
46.362,17,4,1344,4,308,15454,308,1344,0,0,0,0,0
0.506,17,3,451,2,39,118,39,134,1,289,0,289,317
1783.157,17,83,3480,82,14,22014,14,3444,1,8,0,8,36
16.68,6,12,5538,4,106,5560,106,274,8,822,2340,1460,5264
0.53,6,23,7437,14,274,40,668,2109,9,1210,61,1946,5328
0.031,6,9,1880,5,910,7,910,1178,4,486,10,486,702
0.037,6,18,7245,9,138,4,138,614,9,1026,4,1448,6631
878.932,6,394,71324,260,304,3393,304,54008,134,83,5997,83,17316
281.569,6,31,7813,13,158,23464,267,1317,18,524,16550,1400,6496
3.765,17,5,295,5,31,941,31,295,0,0,0,0,0
1714.834,1,14,1141,14,53,131910,78,1141,0,0,0,0,0
280.289,6,28,7352,12,158,25480,267,1277,16,603,18682,1400,6075
37.73,17,22,1936,11,48,3772,48,836,11,72,3771,72,1100
1.547,6,29,10277,17,368,96,837,1789,12,1000,133,1452,8488
1788.336,17,141,11276,71,48,25546,48,5396,70,56,25917,56,5880
249.037,17,4,240,2,32,249036,32,120,2,32,249036,32,120
15.15,6,5,706,3,46,7575,46,166,2,460,14986,460,540
1.783,17,20,5190,20,231,93,389,5190,0,0,0,0,0
1764.605,1,8,448,8,28,252086,28,448,0,0,0,0,0
6.517,6,43,7445,23,201,296,314,3543,20,516,329,1179,3902
19.487,6,27,9827,8,133,2783,267,861,19,630,1074,1460,8966
0.084,17,2,176,1,52,0,52,80,1,68,0,68,96
1201.544,2,9,288,9,8,150193,8,288,0,0,0,0,0
958.255,6,86,9545,48,83,20388,721,4428,38,125,23465,1448,5117
179.386,6,125,94396,79,1263,2299,1408,82475,46,793,1835,2816,11921
11.557,6,26,8513,14,275,889,275,1118,12,986,744,1440,7395
1.3,6,16,4689,8,290,185,517,993,8,1088,183,1418,3696
4.996,17,4,558,2,36,4985,36,128,2,187,4986,187,430
1755.73,6,3843,3785436,1388,147,1265,898,84524,2455,1499,715,7010,3700912
1772.679,6,180,15480,120,69,14896,69,8940,60,69,30044,69,6540
1.711,6,23,7727,14,282,131,578,1410,9,992,190,1452,6317
299.971,17,4,352,2,60,299970,60,176,2,60,299970,60,176
11.9,6,1902,1622618,1144,1363,10,1380,1587480,758,421,15,1923,35138
9.297,6,1942,1802386,1240,1377,7,1408,1761218,702,931,13,2816,41168
8.339,17,4,352,2,48,8317,48,152,2,72,8316,72,200
7.471,6,976,835517,564,1400,12,1448,809429,412,776,17,1448,26088
544.836,17,60,21885,60,336,9234,359,21885,0,0,0,0,0
121.112,17,4,352,2,60,121111,60,176,2,60,121110,60,176
3.201,6,27,5001,14,198,246,564,1924,13,394,250,1343,3077
5.0,17,4,288,2,36,4966,36,128,2,52,4967,52,160
11.628,6,1835,1605405,1113,1387,10,1420,1572304,722,467,16,1883,33101
1773.619,6,180,15480,120,69,14904,69,8940,60,69,30055,69,6540
310.976,6,72,4467,38,74,8404,138,2417,34,49,9423,69,2050
116.974,6,1007,488325,535,844,219,1152,463258,472,412,247,1179,25067
11.835,17,3,984,3,300,5917,300,984,0,0,0,0,0
164.948,17,7,2352,7,308,27491,308,2352,0,0,0,0,0
1787.14,17,142,11360,71,48,25530,48,5396,71,56,25530,56,5964
1.954,6,9,527,5,43,488,43,311,4,0,649,0,216
293.407,17,4,240,2,32,293406,32,120,2,32,293406,32,120
280.25,6,28,7352,13,158,23354,267,1317,15,678,20015,2045,6035
0.737,6,3,144,2,0,737,0,92,1,0,0,0,52
122.958,17,4,240,2,32,122957,32,120,2,32,122957,32,120
1800.0,17,5832,279936,2916,20,617,20,139968,2916,20,617,20,139968
160.966,17,28,4116,14,48,12381,48,1064,14,190,12381,308,3052
1796.146,1,58,4872,58,56,31511,56,4872,0,0,0,0,0
0.656,6,23,7451,13,275,54,674,2063,10,1212,68,1946,5388
186.524,6,20,4994,12,544,16956,1232,2808,8,293,8588,1284,2186
39.974,17,24,2112,12,48,3632,48,912,12,72,3626,72,1200
2.643,17,6,471,3,31,1089,31,177,3,70,0,70,294
1.579,17,4,240,2,32,1578,32,120,2,32,1578,32,120
1791.683,1,58,4872,58,56,31433,56,4872,0,0,0,0,0
10.669,6,20,4442,11,275,1066,275,998,9,768,732,1440,3444
280.241,6,28,7352,13,158,23353,267,1317,15,678,20014,2800,6035
1770.026,6,101,9344,66,65,27231,65,5577,35,59,52056,59,3767
101.075,6,54,23375,31,1089,3363,1360,17641,23,435,4586,2667,5734
1783.553,1,342,28728,342,56,5230,56,28728,0,0,0,0,0
366.447,6,21,1419,15,177,26174,177,989,6,110,12234,110,430
1771.251,6,99,9240,66,65,27250,65,5577,33,59,55347,59,3663
0.297,6,27,9115,13,262,24,690,1735,14,830,22,1402,7380
296.575,6,6,364,4,31,98858,31,222,2,31,296551,31,142
5.676,6,13,3089,5,92,1419,92,348,8,577,704,1448,2741
1795.846,17,448,39896,403,35,4467,288,25676,45,288,40022,288,14220
0.684,6,28,7336,13,155,57,267,1301,15,543,47,1400,6035
0.46,6,50,20531,27,1018,17,1380,15369,23,421,19,1923,5162
1772.515,6,180,15480,120,69,14895,69,8940,60,69,30035,69,6540
1775.394,1,62,5208,62,56,29104,56,5208,0,0,0,0,0
1745.912,6,92,6644,60,31,29591,31,4050,32,31,56310,31,2594
782.146,2,8,256,8,8,111735,8,256,0,0,0,0,0
0.484,17,3,451,2,39,420,39,134,1,289,0,289,317
3.694,6,33,6129,17,206,230,314,2744,16,548,228,1179,3385
0.027,17,8,1670,8,180,3,219,1670,0,0,0,0,0
1793.802,17,165,21630,165,103,10937,362,21630,0,0,0,0,0
1764.187,2,17,544,17,8,110261,8,544,0,0,0,0,0
240.181,6,53,18353,28,826,8895,1402,15511,25,191,10007,580,2842
1797.105,17,141,11276,71,48,25672,48,5396,70,56,26044,56,5880
240.335,6,44,8448,22,449,11444,1418,5648,22,206,11444,580,2800
1795.61,6,128,8215,73,48,24936,208,4899,55,31,33249,31,3316
37.881,6,30,7297,14,155,2913,267,1346,16,441,2524,1420,5951
1744.665,2,29,928,29,8,62309,8,928,0,0,0,0,0
0.065,17,2,168,1,32,0,32,60,1,80,0,80,108
1740.642,17,30,31680,30,1028,60022,1028,31680,0,0,0,0,0
1.418,6,38,8254,19,321,78,1164,2718,19,433,68,1360,5536
9.142,17,8,1672,4,37,3043,37,260,4,325,3043,325,1412
11.183,6,42,12928,20,241,588,721,2495,22,682,483,1414,10433
3.995,17,8,1004,4,31,1306,31,236,4,164,1327,164,768
10.608,6,89,28591,46,570,235,1152,22389,43,407,246,1152,6202
0.083,6,13,3041,7,695,13,860,1763,6,479,15,939,1278
1798.318,6,364,24454,213,88,8482,469,14067,151,69,11985,69,10387
122.032,6,50,21550,27,606,89,1360,7217,23,837,5539,1360,14333
564.887,17,24,2181,12,32,51350,37,731,12,92,51350,136,1450
320.803,6,909,436752,492,825,653,1152,410759,417,321,770,1179,25993
0.127,17,2,2382,2,1163,127,1163,2382,0,0,0,0,0
1797.821,6,356,22520,208,69,8685,69,12460,148,69,12229,69,10060
127.352,6,147,109551,90,1267,1430,1368,98461,57,676,2111,1368,11090
1.875,6,35,12757,16,479,125,764,4251,19,830,103,1418,8506
1209.885,6,37,6131,21,209,60494,1382,2726,16,251,80655,1460,3405
1789.178,6,382,26595,219,97,8207,469,15590,163,69,11044,69,11005
121.036,6,23,2550,9,196,15108,196,784,14,398,9297,419,1766
1682.923,17,14,1036,7,30,280479,30,406,7,62,280478,62,630
1776.4,17,140,11200,70,48,25744,48,5320,70,56,25744,56,5880
5.022,17,4,558,2,36,5017,36,128,2,187,5014,187,430
0.723,17,4,300,2,39,721,39,134,2,55,722,55,166
9.01,6,68,20206,36,520,257,1152,15499,32,489,281,1179,4707
1779.903,6,275,34738,113,147,15890,1360,17370,162,134,11054,2720,17368
86.844,6,41,9554,18,290,2058,1189,2764,23,418,3946,1917,6790
36.712,6,22,3234,13,183,3059,517,1613,9,381,4587,499,1621
0.946,17,28,21979,15,983,67,1350,15168,13,495,75,1350,6811
1388.373,6,323,19337,161,69,8677,69,9683,162,34,8623,64,9654
10.982,6,18,4266,10,275,1220,275,958,8,992,885,1440,3308
1777.279,1,57,4788,57,56,31737,56,4788,0,0,0,0,0
14.62,6,25,18315,8,196,2062,196,560,17,1217,903,1360,17755
5.015,17,4,288,2,36,4983,36,128,2,52,4984,52,160
1773.63,6,180,15480,120,69,14904,69,8940,60,69,30057,69,6540
1.408,6,47,18786,25,930,58,1460,13130,22,476,57,2615,5656
140.454,6,1118,563777,620,844,226,1152,537670,498,412,281,1179,26107
1745.819,6,103,7743,67,38,26451,205,4684,36,32,49870,98,3059
42.313,17,41,13248,16,329,2818,1350,5716,25,273,1761,1350,7532
1784.263,1,111,6216,111,28,16220,28,6216,0,0,0,0,0
6.463,6,5,216,2,0,6463,0,84,3,0,1519,0,132
64.218,17,4,352,2,60,64217,60,176,2,60,64217,60,176
2.783,6,16,1121,8,222,396,222,554,8,231,396,231,567
5.114,6,52,32652,31,952,170,1360,11785,21,1539,247,3956,20867
39.553,17,44,6468,22,48,1883,48,1672,22,190,1882,308,4796
1788.434,6,355,22480,207,69,8681,69,12420,148,69,12166,69,10060
1774.647,1,58,4872,58,56,31134,56,4872,0,0,0,0,0
5.208,17,3,208,2,36,5003,36,128,1,52,0,52,80
193.31,6,50,28338,31,1055,6443,1448,20626,19,746,3417,1448,7712
2.843,17,4,624,4,128,947,128,624,0,0,0,0,0
0.969,17,2,685,1,308,0,308,336,1,321,0,321,349
1796.917,6,365,25032,213,94,8476,469,14536,152,69,11899,69,10496
300.705,6,26,8450,14,364,23131,858,2205,12,801,5610,1448,6245
8.288,6,2032,1908614,1304,1386,6,1408,1866094,728,776,11,1408,42520
0.214,6,3,160,2,0,214,0,100,1,0,0,0,60
11.519,17,4,304,4,48,3839,48,304,0,0,0,0,0
281.205,6,29,7733,12,158,25564,267,1277,17,577,17570,1400,6456
1743.722,17,169,56968,169,309,10379,422,56968,0,0,0,0,0
1772.175,6,180,15480,120,69,14892,69,8940,60,69,30033,69,6540
0.313,6,27,8949,13,227,26,547,1592,14,827,23,1408,7357
2.316,6,14,2351,8,188,330,245,700,6,703,412,1152,1651
1776.968,17,140,11200,70,48,25753,48,5320,70,56,25753,56,5880
2.698,6,108,86737,55,131,49,232,2729,53,1742,51,2840,84008
0.34,17,3,543,2,39,334,39,134,1,381,0,381,409
366.78,6,18,1239,14,177,28213,177,913,4,110,20056,110,326
1739.818,6,87,6322,58,31,30523,31,3915,29,31,62136,31,2407
0.897,6,11,1727,7,100,149,100,384,4,589,211,1152,1343
280.316,6,30,7432,13,158,23359,267,1317,17,543,17513,1400,6115
0.007,17,2,162,1,36,0,36,64,1,70,0,70,98
1798.09,1,58,4872,58,56,31545,56,4872,0,0,0,0,0
280.513,6,32,7512,13,158,23376,267,1317,19,543,15581,1380,6195
4.052,17,5,290,5,30,1013,30,290,0,0,0,0,0
688.144,1,18,1008,18,28,40479,28,1008,0,0,0,0,0
7.184,17,186,248498,184,1322,39,1472,248418,2,12,5005,12,80
1790.629,17,178,13884,178,50,10116,50,13884,0,0,0,0,0
316.907,6,52,12123,24,245,13778,1305,3478,28,357,11371,2720,8645
1799.376,1,16,896,16,28,119958,28,896,0,0,0,0,0
1790.62,6,356,22520,208,69,8650,69,12460,148,69,12181,69,10060
1771.214,6,99,9240,66,65,27249,65,5577,33,59,55347,59,3663
4.312,6,38,7229,19,218,239,314,3383,19,440,224,1152,3846
45.597,6,11,2487,3,245,131,245,369,8,299,6477,299,2118
1738.731,6,134,17190,80,84,22009,876,7714,54,158,32805,1408,9476
1752.015,6,95,7203,63,38,28258,205,4476,32,33,56510,98,2727
1792.201,6,131,9158,74,68,24550,208,5886,57,31,31998,31,3272
300.953,6,37,10843,20,573,15839,1448,3917,17,502,543,1440,6926
1750.744,6,100,7866,66,45,26934,205,4902,34,35,53041,98,2964
1741.206,6,91,6647,59,31,30020,31,4010,32,31,56167,31,2637
280.226,6,27,7312,13,158,23352,267,1317,14,775,21552,4836,5995
152.609,6,31,14341,15,1001,74,1440,6651,16,782,10161,1440,7690
0.451,6,48,20876,27,1047,17,1380,15794,21,421,20,1923,5082
36.397,2,2,64,2,8,36397,8,64,0,0,0,0,0
0.045,17,3,244,2,32,30,32,120,1,96,0,96,124
41.403,6,49,16383,26,1057,375,1460,10616,23,371,1873,1460,5767
0.19,17,2,2380,2,1162,190,1162,2380,0,0,0,0,0
0.048,17,4,334,2,39,34,39,134,2,72,0,72,200
18.109,17,27,16702,12,480,1643,1350,6097,15,679,1291,1350,10605
0.889,6,45,20970,26,969,35,1360,15620,19,508,40,1360,5350
1681.337,17,14,1045,7,30,280219,30,406,7,63,280219,71,639
1795.284,1,281,15736,281,28,6411,28,15736,0,0,0,0,0
83.7,6,30,7432,13,158,6975,267,1317,17,543,5224,1400,6115
1773.516,6,180,15480,120,69,14903,69,8940,60,69,30052,69,6540
2.957,17,3,696,3,204,1478,204,696,0,0,0,0,0
0.093,6,22,20311,14,181,7,267,1280,8,3101,11,7668,19031
1743.542,6,95,7203,63,38,28121,205,4476,32,33,56235,98,2727
1798.081,17,448,39896,403,35,4472,288,25676,45,288,40021,288,14220
0.296,6,22,7333,13,334,24,663,2021,9,967,35,1912,5312
3.186,17,5,295,5,31,796,31,295,0,0,0,0,0
15.009,6,8,344,3,0,7504,0,124,5,0,3750,0,220
1798.808,6,355,22480,207,69,8732,69,12420,148,69,12236,69,10060
29.846,6,4140,3948034,2666,1402,11,1448,3866722,1474,776,20,1448,81312
50.862,17,4,352,2,60,50861,60,176,2,60,50861,60,176
10.29,6,18,5484,9,190,1286,370,1124,9,999,995,1691,4360
20.204,6,18,2897,10,255,2244,517,1815,8,323,2881,499,1082
1794.889,17,144,11520,72,48,25280,48,5472,72,56,25280,56,6048
3.615,6,13,2311,8,188,516,245,700,5,1407,837,1407,1611
33.665,6,29,4992,14,180,2589,722,1808,15,342,2390,1448,3184
1778.536,6,106,8515,69,65,26154,65,4970,37,59,49401,59,3545
1791.853,17,87,3648,86,14,21080,14,3612,1,8,0,8,36
1799.405,17,449,39928,404,35,4465,288,25708,45,288,40018,288,14220
8.281,6,33,8309,18,401,487,889,1956,15,521,466,2720,6353
1761.661,6,215,20675,107,79,16617,721,9963,108,172,16462,2007,10712
1.063,17,4,377,2,33,1051,37,123,2,99,1050,136,254
1771.975,6,180,15480,120,69,14890,69,8940,60,69,30031,69,6540
0.024,17,2,186,1,29,0,29,57,1,101,0,101,129
1.3,6,25,8056,12,164,100,267,1288,13,869,91,1448,6768
0.253,17,2,2384,2,1164,253,1164,2384,0,0,0,0,0
1776.028,6,27,4077,18,241,104472,241,2889,9,92,221981,92,1188
3.997,17,4,244,4,33,1332,33,244,0,0,0,0,0
51.71,6,29,2150,14,275,3977,275,1134,15,96,2632,96,1016
5.423,6,40,7325,21,218,271,314,3463,19,516,286,1179,3862
0.295,6,21,5000,10,137,32,267,1092,11,577,27,1400,3908
15.659,17,10,760,10,48,1739,48,760,0,0,0,0,0
368.258,6,18,1242,14,180,28327,180,916,4,110,20062,110,326
1772.766,6,180,15480,120,69,14897,69,8940,60,69,30042,69,6540
1774.111,1,92,5152,92,28,19495,28,5152,0,0,0,0,0
0.04,17,4,304,2,37,0,37,130,2,59,2,65,174
1637.777,2,24,768,24,8,71207,8,768,0,0,0,0,0
4.439,6,38,7229,19,218,246,314,3383,19,513,232,1179,3846
1682.796,17,14,1036,7,30,280454,30,406,7,62,280457,62,630
1769.106,6,101,9410,66,66,27217,66,5610,35,60,52028,60,3800
0.038,17,4,560,2,64,3,64,184,2,160,16,160,376
0.396,6,6,324,4,0,132,0,216,2,0,201,0,108
38.634,17,44,6468,22,48,1839,48,1672,22,190,1839,308,4796
43.236,6,44,8916,21,410,440,882,2150,23,388,1959,2128,6766
339.438,17,6,2000,6,305,67887,308,2000,0,0,0,0,0
1783.005,1,58,4872,58,56,31280,56,4872,0,0,0,0,0
16.712,17,4,240,2,32,16711,32,120,2,32,16711,32,120
126.141,2,2,64,2,8,126141,8,64,0,0,0,0,0
70.386,6,30,7435,13,155,5865,267,1306,17,418,4398,1997,6129
1785.997,6,105,8550,69,66,26264,66,5070,36,60,51024,60,3480
8.0,6,25,10019,8,138,1142,267,883,17,704,499,1420,9136
1798.997,6,355,22480,207,69,8732,69,12420,148,69,12237,69,10060
207.734,17,4,352,2,60,207733,60,176,2,60,207733,60,176
946.72,6,73,10493,50,87,19320,515,4379,23,247,39251,1452,6114
0.415,6,25,8816,13,227,34,547,1592,12,1098,35,2896,7224
1773.212,6,181,15589,121,69,14776,69,9049,60,69,30052,69,6540
221.665,6,129,91958,77,1263,2916,1408,81134,52,676,1678,1408,10824
1.242,6,72,57245,48,999,26,1360,13002,24,2403,48,8922,44243
1773.211,6,180,15480,120,69,14900,69,8940,60,69,30050,69,6540
696.038,1,93,5208,93,28,7565,28,5208,0,0,0,0,0
0.226,6,20,4960,10,137,25,267,1092,10,692,23,1467,3868
1.565,6,56,40606,36,1222,44,1408,33661,20,1179,73,3819,6945
0.053,17,2,384,1,32,0,32,60,1,296,0,296,324
1799.698,1,260,14560,260,28,6948,28,14560,0,0,0,0,0
61.351,6,38,19677,24,914,2667,1402,12225,14,959,4699,3853,7452
1783.125,17,83,3480,82,14,22013,14,3444,1,8,0,8,36
362.367,2,6,192,6,8,72473,8,192,0,0,0,0,0
1680.358,1,15,840,15,28,120025,28,840,0,0,0,0,0
0.081,17,2,157,1,31,0,31,59,1,70,0,70,98
1602.98,1,8,448,8,28,228997,28,448,0,0,0,0,0
1795.555,6,230,20593,114,120,15889,208,14837,116,31,15610,31,5756
134.611,6,24,10242,12,561,70,1360,2783,12,1161,12224,2574,7459
12.254,6,2279,2143054,1473,1377,8,1408,2096478,806,931,15,2801,46576
1771.149,6,99,9240,66,65,27248,65,5577,33,59,55345,59,3663
1789.374,6,360,22818,210,69,8561,69,12678,150,69,12009,69,10140
664.231,17,12,3143,6,31,132843,37,355,6,436,132844,463,2788
1602.048,17,124,9904,64,48,25429,48,4864,60,56,25420,56,5040
7.293,17,6,528,3,48,3578,48,228,3,72,3587,72,300
30.096,6,23,7863,11,504,3009,970,2093,12,734,2730,2899,5770
1787.596,6,104,8444,68,66,26680,66,4964,36,60,51070,60,3480
1.182,6,24,8004,12,164,91,267,1288,12,1014,91,2423,6716
0.504,6,20,7229,13,334,42,663,2021,7,1209,78,1946,5208
281.106,6,31,7813,14,158,21623,267,1357,17,524,17563,1400,6456
6.503,6,62,16788,35,381,191,743,5296,27,458,246,1544,11492
14.5,6,108,35322,55,616,268,1152,28704,53,449,273,1179,6618
1.451,6,233,184363,139,1333,10,1432,176312,94,475,15,1871,8051
1797.29,17,764,46104,764,32,2355,37,46104,0,0,0,0,0
3.593,6,13,2311,8,188,513,245,700,5,1407,835,1407,1611
1797.482,1,262,14672,262,28,6886,28,14672,0,0,0,0,0
481.258,2,7,224,7,8,80209,8,224,0,0,0,0,0
1.585,6,48,19295,27,897,60,1360,13679,21,433,68,1360,5616
1740.745,17,30,6930,30,203,60025,203,6930,0,0,0,0,0
0.009,17,2,367,1,64,0,64,92,1,247,0,247,275
0.041,17,8,2454,8,278,5,317,2454,0,0,0,0,0
0.583,6,10,1060,5,517,145,517,785,5,7,145,7,275
0.0,1,1,187,1,159,0,159,187,0,0,0,0,0
0.175,17,2,237,1,72,0,72,100,1,109,0,109,137
247.204,6,74,22620,35,754,7270,1402,14755,39,364,6505,1513,7865
228.844,17,8,2688,8,308,32692,308,2688,0,0,0,0,0
2.335,6,30,10318,18,368,137,837,1829,12,1000,203,1452,8489
1755.223,6,199,13184,99,61,17910,208,8254,100,31,17727,31,4930
1772.574,6,180,15480,120,69,14895,69,8940,60,69,30037,69,6540
5.01,17,4,530,2,36,5006,36,128,2,173,5005,187,402
1.892,17,2,312,2,128,1892,128,312,0,0,0,0,0
10.773,6,20,4402,11,275,1077,275,998,9,758,749,1420,3404
0.024,17,2,198,1,39,0,39,67,1,103,0,103,131
65.386,6,32,9035,12,297,270,1189,2572,20,565,3440,1926,6463
1.405,6,46,18716,27,862,54,1360,13180,19,476,68,2720,5536
1787.308,6,356,22520,208,69,8634,69,12460,148,69,12157,69,10060
1770.078,6,101,9410,66,66,27231,66,5610,35,60,52058,60,3800
246.549,6,59,11227,31,209,8218,834,3156,28,440,9131,2341,8071
75.834,2,2,64,2,8,75834,8,64,0,0,0,0,0
0.467,17,2,178,1,29,0,29,57,1,93,0,93,121
14.255,6,9,997,3,517,7125,517,681,6,0,2850,0,316
160.306,6,29,6808,14,274,12327,517,1560,15,744,11447,1418,5248
25.569,6,48,13076,23,186,1162,721,2600,25,676,1056,1440,10476
2.564,6,3,1560,2,0,2564,0,80,1,1440,0,1440,1480
281.431,6,29,7392,13,158,23452,267,1317,16,603,18742,2800,6075
852.607,1,46,2576,46,28,18946,28,2576,0,0,0,0,0
36.979,17,18,1368,18,48,2175,48,1368,0,0,0,0,0
1120.86,17,10,2685,5,30,280213,30,290,5,451,280213,463,2395
9.025,1,9,756,9,56,1128,56,756,0,0,0,0,0
0.529,17,3,451,2,39,230,39,134,1,289,0,289,317
0.773,6,12,1304,6,256,152,256,756,6,304,152,304,548
0.161,17,4,284,2,32,154,32,120,2,54,154,60,164
86.217,17,12,4156,12,318,7837,548,4156,0,0,0,0,0
53.838,6,20,5901,11,272,5383,516,1260,9,712,6714,1452,4641
1773.292,6,180,15480,120,69,14901,69,8940,60,69,30053,69,6540
1794.224,17,80,3354,79,14,23002,14,3318,1,8,0,8,36
3.471,17,2,656,2,300,3471,300,656,0,0,0,0,0
1786.113,6,104,8444,68,66,26658,66,4964,36,60,51029,60,3480
1782.728,17,83,3480,82,14,22008,14,3444,1,8,0,8,36
7.434,6,25,7097,12,155,675,267,1266,13,589,618,3426,5831
50.318,6,6455,6233902,4408,1339,11,1368,6122746,2047,776,24,1473,111156
0.796,17,2,162,1,36,0,36,64,1,70,0,70,98
341.772,17,14,4704,14,308,26290,308,4704,0,0,0,0,0
0.407,6,13,1693,7,288,64,288,588,6,426,45,434,1105
2.182,6,20,3833,11,234,218,564,1504,9,463,249,1343,2329
1788.129,1,196,10976,196,28,9169,28,10976,0,0,0,0,0
1796.114,17,449,39928,404,35,4456,288,25708,45,288,40019,288,14220
1749.496,6,96,7286,63,38,28217,205,4476,33,33,54658,98,2810
1.052,6,24,8004,12,164,81,267,1288,12,1014,81,2816,6716
1744.696,2,16,512,16,8,116313,8,512,0,0,0,0,0
72.728,6,1647,1752171,580,316,125,517,31749,1067,1563,68,5792,1720422
0.073,17,2,384,1,32,0,32,60,1,296,0,296,324
0.059,17,2,136,1,32,0,32,60,1,48,0,48,76
10.585,6,84,25466,42,561,258,1152,19645,42,459,251,1179,5821
1791.744,1,69,5796,69,56,26349,56,5796,0,0,0,0,0
1797.943,6,369,25799,215,99,8401,469,15154,154,69,11751,69,10645
1679.59,1,7,392,7,28,279931,28,392,0,0,0,0,0
1796.931,17,449,39928,404,35,4458,288,25708,45,288,40021,288,14220
280.215,6,27,7312,12,158,25474,267,1277,15,678,20013,2045,6035
0.549,17,4,624,2,64,547,64,184,2,192,431,192,440
1797.423,1,272,15232,272,28,6632,28,15232,0,0,0,0,0
1796.662,17,444,38632,403,35,4469,288,25676,41,288,42019,288,12956
615.184,6,119,8766,59,86,10584,86,3384,60,39,10426,63,5382
1742.677,6,95,7203,63,38,28107,205,4476,32,33,56203,98,2727
10.994,6,18,5610,10,275,1221,275,958,8,1440,870,1440,4652
0.571,17,4,352,2,60,570,60,176,2,60,570,60,176
596.793,17,85,7327,43,32,14209,37,2585,42,84,14507,136,4742
6.889,17,53,45417,21,419,344,1350,9399,32,1097,175,1350,36018
1747.232,6,95,7203,63,38,28181,205,4476,32,33,56354,98,2727
0.342,6,13,3514,7,75,57,75,447,6,1373,68,1448,3067
1793.172,17,142,11360,71,48,25616,48,5396,71,56,25616,56,5964
0.088,6,2,116,1,0,0,0,64,1,0,0,0,52
1.105,6,51,13829,24,551,48,1429,4840,27,464,41,1986,8989
61.339,6,36,15841,22,796,2920,1448,9115,14,748,4697,2359,6726
9.944,17,4,5480,4,1342,3314,1347,5480,0,0,0,0,0
0.666,6,39,11563,22,574,31,1188,7464,17,320,35,524,4099
0.041,17,2,160,1,48,0,48,76,1,56,0,56,84
0.224,6,3,120,1,0,0,0,40,2,0,224,0,80
14.761,1,8,448,8,28,2108,28,448,0,0,0,0,0
1786.354,17,87,3648,86,14,21015,14,3612,1,8,0,8,36
721.924,2,7,224,7,8,120320,8,224,0,0,0,0,0
0.035,17,2,225,1,37,0,37,65,1,132,0,132,160
1788.46,17,87,3648,86,14,21040,14,3612,1,8,0,8,36
1697.264,6,74,7238,50,84,34638,138,4691,24,69,25130,69,2547
0.179,6,28,7336,14,155,13,267,1341,14,603,12,2036,5995
1799.44,17,450,39960,405,35,4454,288,25740,45,288,40018,288,14220
0.656,6,10,1669,6,551,131,947,1346,4,159,218,159,323
1780.922,1,236,25016,236,78,7578,78,25016,0,0,0,0,0
240.216,6,52,15471,28,700,8896,1402,12667,24,193,10443,580,2804
1797.561,6,381,26955,219,103,8245,469,15990,162,69,11162,69,10965
1789.006,6,193,21752,120,78,15033,267,9588,73,135,22526,1917,12164
125.223,17,4,352,2,60,125221,60,176,2,60,125222,60,176
1799.999,1,345,28980,345,56,5232,56,28980,0,0,0,0,0
1785.722,1,156,16536,156,78,11520,78,16536,0,0,0,0,0
0.876,6,27,8420,15,222,52,540,1964,12,1192,65,3151,6456
1796.462,17,449,39928,404,35,4457,288,25708,45,288,40020,288,14220
161.958,6,169,131394,107,1285,1527,1408,118659,62,731,2072,3847,12735
0.08,6,6,897,3,483,18,483,639,3,102,22,102,258
4.971,6,40,7309,21,218,248,314,3463,19,513,262,1179,3846
1.652,6,14,4945,7,125,275,125,497,7,1019,272,1448,4448
39.133,17,14,2176,7,48,6520,48,532,7,206,6520,308,1644
10.033,6,557,507608,359,1349,27,1368,492252,198,776,49,1473,15356
1794.188,17,80,3354,79,14,23002,14,3318,1,8,0,8,36
4.696,17,6,684,4,36,1562,36,256,2,186,4683,186,428
1791.951,6,363,23007,210,69,8573,69,12678,153,69,11789,69,10329
4.307,17,2,690,2,317,4307,317,690,0,0,0,0,0
1742.838,6,95,7203,63,38,28110,205,4476,32,33,56210,98,2727
2.759,6,33,15219,18,1011,162,1360,7833,15,752,182,1360,7386
8.504,6,29,7392,14,158,654,267,1357,15,678,604,3436,6035
0.211,17,2,2380,2,1162,211,1162,2380,0,0,0,0,0
17.279,17,26,13924,14,744,1326,1350,10820,12,230,1568,1350,3104
4.12,6,6,340,3,0,2060,0,160,3,0,1004,0,180
1.031,17,4,288,2,36,982,36,128,2,52,1000,52,160
0.338,17,8,2766,8,317,48,356,2766,0,0,0,0,0
2.102,6,25,8704,15,275,150,557,1429,10,981,167,1420,7275
1787.707,6,102,8364,68,66,26682,66,4964,34,60,54169,60,3400
1795.288,2,31,992,31,8,59842,8,992,0,0,0,0,0
0.054,17,2,128,1,28,0,28,56,1,44,0,44,72
0.02,6,14,4044,8,88,2,88,452,6,1670,4,1880,3592
1.366,6,47,18787,27,864,52,1360,13211,20,433,62,1360,5576
2.827,6,142,66166,72,262,39,746,7189,70,1040,40,1735,58977
1665.436,1,8,448,8,28,237919,28,448,0,0,0,0,0
1796.833,17,442,38852,399,35,4514,288,25264,43,288,41926,288,13588
1.633,17,2,778,2,361,1633,361,778,0,0,0,0,0
160.588,2,4,128,4,8,53529,8,128,0,0,0,0,0
0.173,6,48,23870,28,1041,6,1420,18849,20,467,8,1883,5021
0.227,17,2,152,2,48,227,48,152,0,0,0,0,0
38.476,17,22,1936,11,48,3846,48,836,11,72,3846,72,1100
4.362,6,39,7269,20,218,229,314,3423,19,513,228,1179,3846
1680.476,1,15,840,15,28,120034,28,840,0,0,0,0,0
1.175,6,10,1687,7,100,195,100,384,3,1179,456,1179,1303
1787.416,17,87,3648,86,14,21028,14,3612,1,8,0,8,36
42.267,17,4,288,2,36,42252,36,128,2,52,42247,52,160
24.978,6,17,1704,3,106,12485,106,234,14,98,1920,128,1470
5.229,6,38,7245,19,218,290,314,3383,19,516,276,1179,3862
1402.517,17,12,888,6,30,280489,30,348,6,62,280498,62,540
0.021,17,4,344,2,47,0,47,150,2,69,0,75,194
0.904,6,24,6614,13,346,75,1067,2254,11,783,89,1420,4360
1620.001,1,7,392,7,28,270000,28,392,0,0,0,0,0
11.7,6,1860,1609151,1135,1363,10,1380,1575717,725,421,16,1923,33434
31.395,6,21,6041,9,150,3924,309,1269,12,714,2830,1179,4772
2.382,6,10,767,5,186,589,186,454,5,45,595,45,313
61.331,6,35,15997,22,817,2920,1408,9323,13,855,5089,3847,6674
27.447,17,4,352,2,60,27446,60,176,2,60,27445,60,176
310.607,6,146,99327,65,235,4853,517,5505,81,1262,3882,2876,93822
1770.11,6,99,9306,66,66,27232,66,5610,33,60,55313,60,3696
1789.82,6,336,52901,131,282,13518,1360,29048,205,102,8773,4649,23853
29.142,6,17,3644,6,95,5828,245,625,11,1279,2887,1407,3019
1772.344,6,180,15480,120,69,14893,69,8940,60,69,30035,69,6540
280.507,6,31,7472,13,158,23375,267,1317,18,603,16493,2760,6155
561.86,17,22,2033,11,33,56184,37,673,11,95,56182,136,1360
0.256,6,25,6116,12,181,23,537,1526,13,651,20,1448,4590
1749.724,6,183,11234,92,47,19227,208,6695,91,31,19438,31,4539
0.018,6,10,1369,5,134,4,134,402,5,351,4,380,967
0.014,17,2,324,1,30,0,30,58,1,238,0,238,266
2.108,17,2,685,1,308,0,308,336,1,321,0,321,349
76.653,6,741,349280,393,823,195,1152,329514,348,389,220,1152,19766
1788.496,6,355,22480,207,69,8682,69,12420,148,69,12166,69,10060
28.155,6,29,5572,18,174,1656,517,2350,11,440,2785,499,3222
280.463,6,30,7432,13,158,23371,267,1317,17,603,17526,2076,6115
312.279,6,61,11462,26,121,12491,267,2262,35,371,4353,1420,9200
762.775,6,55440,59739479,16803,824,45,1448,991500,38637,1471,8,5792,58747979
994.255,17,12,3143,6,31,198850,37,355,6,436,198850,463,2788
0.018,6,3,327,2,103,8,138,287,1,0,0,0,40
0.332,6,23,7397,13,334,27,663,2033,10,806,36,1408,5364
0.932,17,4,1148,2,32,927,32,120,2,486,927,486,1028
5.049,17,3,486,2,43,5037,43,142,1,316,0,316,344
772.276,17,17,1292,17,48,48267,48,1292,0,0,0,0,0
1.566,6,49,19432,29,897,55,1360,13811,20,437,71,2715,5621
0.047,6,3,136,2,0,47,0,88,1,0,0,0,48
1784.865,6,117,13529,77,80,23485,500,5996,40,156,45763,1420,7533
0.388,6,12,1653,6,288,73,288,548,6,426,40,434,1105
0.873,6,11,1727,7,100,145,100,384,4,589,207,1152,1343
1750.551,1,8,448,8,28,250078,28,448,0,0,0,0,0
357.617,6,152,122093,102,1261,3540,1408,109981,50,731,2467,3847,12112
1.145,6,31,12103,17,525,71,1360,3350,14,818,71,1360,8753
299.549,6,7,404,4,31,99849,31,222,3,31,149762,31,182
0.468,6,25,7711,16,339,31,949,3017,9,721,56,1460,4694
1.088,6,3,120,1,0,0,0,40,2,0,922,0,80
1797.66,6,367,25650,214,99,8439,469,15045,153,69,11823,69,10605
1441.043,17,25,5875,25,207,60043,207,5875,0,0,0,0,0
14.151,6,21,6825,12,275,1286,275,1038,9,1353,1143,1440,5787
1786.533,6,106,8456,68,65,26664,65,4930,38,59,48282,59,3526
6.906,6,495,422023,307,1309,21,1368,407583,188,776,35,2736,14440
1792.068,6,359,22709,209,69,8615,69,12569,150,69,12027,69,10140
9.2,6,15,2666,8,152,1314,267,782,7,400,1489,1179,1884
1.373,6,53,19750,29,911,49,1360,13969,24,400,51,1360,5781
1715.777,1,8,848,8,78,245111,78,848,0,0,0,0,0
370.829,6,18,1242,14,180,28525,180,916,4,110,20062,110,326
39.982,17,11,836,11,48,3998,48,836,0,0,0,0,0
4.164,17,4,352,2,48,4151,48,152,2,72,4151,72,200
0.006,17,8,2446,8,277,0,316,2446,0,0,0,0,0
1658.811,1,8,448,8,28,236973,28,448,0,0,0,0,0
0.087,6,2,149,1,69,0,69,109,1,0,0,0,40
319.149,6,909,799965,563,1410,567,1440,778563,346,209,78,1440,21402
31.666,6,15,6434,6,243,6292,722,1292,9,1164,3905,1448,5142
1777.493,17,73,3060,72,14,25035,14,3024,1,8,0,8,36
18.966,17,4,824,2,48,18910,48,152,2,308,18920,308,672
1775.04,17,140,11200,70,48,25725,48,5320,70,56,25725,56,5880
0.211,17,8,2750,8,315,30,354,2750,0,0,0,0,0
1752.891,1,8,848,8,78,250413,78,848,0,0,0,0,0
0.716,6,13,1096,7,283,90,283,663,6,105,108,105,433
24.364,6,18,2190,9,196,3045,196,624,9,398,3020,419,1566
0.008,17,4,248,2,34,6,34,124,2,34,6,34,124
0.265,17,2,602,1,46,0,46,74,1,500,0,500,528
5.022,6,39,7269,20,218,264,314,3423,19,513,264,1179,3846
60.209,6,7,526,4,214,19989,214,394,3,0,30037,0,132
1788.372,6,127,14827,79,84,22927,498,6386,48,155,38048,1414,8441
160.66,6,28,7352,12,158,14605,267,1277,16,603,10708,1400,6075
13.207,17,31,20498,14,654,1013,1350,9548,17,616,823,1350,10950
1.366,6,38,8252,19,320,75,1162,2716,19,433,66,1440,5536
1799.523,6,379,26406,218,97,8292,469,15481,161,69,11245,69,10925
1740.695,6,87,6322,58,31,30538,31,3915,29,31,62167,31,2407
10.059,17,4,5480,4,1342,3353,1347,5480,0,0,0,0,0
34.884,6,45,8914,21,371,777,766,2045,24,327,1510,1460,6869
231.012,6,49,9389,19,108,12833,267,1960,30,248,7965,1452,7429
1.275,17,18,8481,9,589,159,1350,5560,9,296,146,1350,2921
915.789,6,191,40879,85,399,10902,1360,25540,106,156,8706,3289,15339
1.4,6,45,15061,24,768,60,1460,9445,21,476,59,2615,5616
3.343,6,13,771,7,43,283,43,415,6,0,665,0,356
1.891,17,3,201,3,39,945,39,201,0,0,0,0,0
0.101,6,10,861,6,182,20,182,490,4,77,7,134,371
1.449,6,41,12205,22,639,69,1460,6669,19,476,69,2615,5536
1771.931,1,60,5040,60,56,30032,56,5040,0,0,0,0,0
0.089,17,2,348,1,39,0,39,67,1,253,0,253,281
1772.398,6,180,15480,120,69,14894,69,8940,60,69,30033,69,6540
1797.151,17,448,39896,403,35,4470,288,25676,45,288,40021,288,14220
292.284,17,4,352,2,60,292283,60,176,2,60,292283,60,176
1756.805,6,113,9069,72,52,24743,205,5515,41,36,43911,98,3554
354.726,6,22,1498,14,180,27286,180,948,8,110,9555,110,550
5.043,17,4,288,2,36,5027,36,128,2,52,4749,52,160
1786.974,1,58,4872,58,56,31350,56,4872,0,0,0,0,0
268.603,6,21,6556,4,106,89534,106,274,17,372,16787,1420,6282
0.166,17,2,672,2,308,166,308,672,0,0,0,0,0
3.058,17,2,214,1,39,0,39,67,1,119,0,119,147
1038.331,17,12,969,6,31,207654,37,355,6,74,207644,136,614
1777.99,6,185,33251,122,304,14694,304,24900,63,83,28675,83,8351
9.207,6,16,3911,9,275,1150,275,643,7,992,739,1440,3268
209.827,17,4,352,2,60,209826,60,176,2,60,209826,60,176
768.354,6,169,20683,88,142,8339,469,8504,81,198,9604,1420,12179
0.211,17,4,588,2,48,199,48,152,2,190,200,308,436
10.403,6,89,26709,45,548,236,1152,20467,44,447,236,1179,6242
137.012,2,5,160,5,8,34253,8,160,0,0,0,0,0
1.569,6,28,10325,17,367,98,833,1785,11,1156,149,2840,8540
20.32,6,25,6849,9,154,2540,267,832,16,447,1350,1460,6017
1775.972,17,73,3060,72,14,25013,14,3024,1,8,0,8,36
1796.739,17,449,39928,404,35,4458,288,25708,45,288,40019,288,14220
0.934,6,29,8303,15,225,55,561,1985,14,820,58,1440,6318
240.324,6,46,9346,23,524,10923,1418,5933,23,245,10923,639,3413
368.865,6,25,1651,17,177,23054,177,1117,8,110,9202,110,534
1795.025,17,448,39896,403,35,4465,288,25676,45,288,40019,288,14220
24.051,6,32,8087,15,188,1717,721,1923,17,685,1474,2840,6164
18.864,17,12,912,12,48,1714,48,912,0,0,0,0,0
280.481,6,28,7352,12,158,25498,267,1277,16,678,18693,2085,6075
1786.507,6,104,8444,68,66,26664,66,4964,36,60,51040,60,3480
7.377,17,40,18842,17,675,461,1350,11956,23,271,308,1350,6886
2.004,17,52,37899,21,353,100,1350,8011,31,936,59,1350,29888
8.211,1,9,756,9,56,1026,56,756,0,0,0,0,0
2.99,17,3,186,3,34,1495,34,186,0,0,0,0,0
21.226,6,24,6232,14,117,1632,159,1337,10,873,2357,1675,4895
1741.019,6,87,6322,58,31,30544,31,3915,29,31,62177,31,2407
271.21,6,31,8974,9,156,33901,267,838,22,426,12902,1452,8136
0.877,6,10,1687,7,100,146,100,384,3,1179,310,1179,1303
90.28,6,811,402444,447,841,202,1152,383093,364,398,248,1152,19351
7.745,17,6,528,3,48,3862,48,228,3,72,3867,72,300
1.703,6,13,2311,8,188,243,245,700,5,1407,363,1407,1611
0.984,1,4,224,4,28,328,28,224,0,0,0,0,0
125.863,2,2,64,2,8,125863,8,64,0,0,0,0,0
1795.158,17,142,11360,71,48,25645,48,5396,71,56,25645,56,5964
1738.235,2,20,640,20,8,91486,8,640,0,0,0,0,0
0.08,17,2,586,1,46,0,46,74,1,484,0,484,512
389.513,17,4,304,4,48,129837,48,304,0,0,0,0,0
4.713,6,38,7229,19,218,261,314,3383,19,513,246,1179,3846
17.213,17,24,13370,14,767,1321,1350,11135,10,195,1909,1350,2235
5.006,17,4,558,2,36,5002,36,128,2,187,5002,187,430
1738.705,6,87,6322,58,31,30503,31,3915,29,31,62091,31,2407
280.51,6,30,7432,13,158,23375,267,1317,17,603,17523,2076,6115
1779.839,17,140,11200,70,48,25794,48,5320,70,56,25794,56,5880
0.139,6,10,1379,6,145,27,145,389,4,826,42,826,990
0.089,6,9,1339,5,145,22,145,349,4,826,21,826,990
1682.524,2,18,576,18,8,98972,8,576,0,0,0,0,0
1699.538,17,12,498,11,14,169953,14,462,1,8,0,8,36
1796.431,17,449,39928,404,35,4457,288,25708,45,288,40021,288,14220
1781.556,17,142,11360,71,48,25450,48,5396,71,56,25450,56,5964
0.205,6,6,328,4,0,68,0,216,2,0,199,0,112
0.059,6,3,120,2,0,59,0,80,1,0,0,0,40
3.371,6,123,98386,67,203,51,231,4714,56,1680,60,4344,93672
1744.637,2,26,832,26,8,69785,8,832,0,0,0,0,0
630.121,2,5,160,5,8,157530,8,160,0,0,0,0,0
97.624,6,30,7432,13,158,8135,267,1317,17,543,6099,1400,6115
0.937,6,10,1687,7,100,156,100,384,3,1179,337,1179,1303
1788.553,1,339,28476,339,56,5291,56,28476,0,0,0,0,0
9.809,17,4,5484,4,1343,3269,1348,5484,0,0,0,0,0
165.696,17,4,352,2,60,165695,60,176,2,60,165695,60,176
39.701,17,22,1936,11,48,3969,48,836,11,72,3968,72,1100
0.33,2,2,112,2,32,330,32,112,0,0,0,0,0
1777.513,1,246,26076,246,78,7255,78,26076,0,0,0,0,0
0.535,6,22,7345,13,334,44,663,2021,9,1209,63,1946,5324
28.709,6,14,4164,7,352,4784,722,1417,7,793,4751,1448,2747
0.653,17,4,624,2,64,637,64,184,2,192,346,192,440
23.767,17,32,14368,16,522,1581,1350,8800,16,320,1581,1350,5568
280.401,6,30,7432,13,158,23366,267,1317,17,543,17521,1400,6115
1.657,6,14,2351,8,188,236,245,700,6,703,281,1152,1651
240.203,6,56,18983,30,764,8282,1408,16090,26,191,9607,580,2893
2.125,6,12,1767,7,100,354,100,384,5,589,387,1152,1383
1.997,17,3,201,3,39,998,39,201,0,0,0,0,0
25.985,17,32,14082,11,637,2598,1350,7316,21,294,1134,1350,6766
9.972,6,912,819243,541,1431,18,1448,793951,371,776,26,1448,25292
20.407,6,47,15959,26,522,816,1360,6848,21,916,1010,2720,9111
1785.85,6,102,8296,68,65,26654,65,4930,34,59,54113,59,3366
1739.458,1,65,5460,65,56,27179,56,5460,0,0,0,0,0
3.466,6,98,75401,59,957,59,1360,13062,39,1898,87,4080,62339
1796.434,1,57,4788,0,0,0,0,0,57,56,32079,56,4788
238.272,17,7,2352,7,308,39712,308,2352,0,0,0,0,0
1.824,6,43,12109,24,613,79,1360,6528,19,437,89,2715,5581
1781.766,6,392,24056,213,69,8404,69,12660,179,46,10009,69,11396
3.245,17,3,228,2,48,3008,48,152,1,48,0,48,76
1740.451,17,24,25296,24,1026,75671,1026,25296,0,0,0,0,0
1784.639,6,102,8364,68,66,26636,66,4964,34,60,54077,60,3400
280.409,6,26,7272,12,158,25491,267,1277,14,775,21567,3465,5995
1352.58,17,1506,238459,791,144,1712,1209,136664,715,114,809,1252,101795
281.104,6,32,7650,13,158,23425,267,1317,19,464,15593,1400,6333
1.321,6,50,19599,27,913,50,1360,13903,23,433,52,1360,5696
3.183,6,6,328,3,0,1591,0,164,3,0,1498,0,164
0.004,17,2,586,1,46,0,46,74,1,484,0,484,512
300.677,6,47,8990,24,266,13072,720,2130,23,348,959,2720,6860
307.207,17,26,2080,13,48,25599,48,988,13,56,25599,56,1092
0.31,6,3,144,2,0,310,0,92,1,0,0,0,52
260.889,17,4,352,2,60,260888,60,176,2,60,260888,60,176
295.072,1,4,224,4,28,98357,28,224,0,0,0,0,0
10.635,6,16,2443,7,188,1772,245,660,9,703,1298,1152,1783
1778.263,17,73,3060,72,14,25045,14,3024,1,8,0,8,36
3.715,6,15,3196,8,49,530,92,511,7,463,47,1408,2685
280.251,6,29,7392,13,158,23354,267,1317,16,603,18682,2800,6075
4.618,6,37,7189,19,218,256,314,3383,18,513,255,1179,3806
1375.415,6,653,133715,365,368,3778,1286,70214,288,331,4791,1420,63501
1788.954,1,216,12096,216,28,8320,28,12096,0,0,0,0,0
34.223,17,35,7106,16,218,2279,1350,3951,19,138,1899,1350,3155
1773.672,1,56,3136,56,28,32248,28,3136,0,0,0,0,0
240.188,6,54,17152,30,789,8282,1408,14204,24,211,10442,580,2948
0.366,6,51,21512,29,949,13,1380,16390,22,421,15,1923,5122
0.009,17,2,358,1,30,0,30,58,1,272,0,272,300
15.27,17,18,8314,9,483,1905,1350,4602,9,384,1904,1350,3712
5.54,6,44,8369,21,227,277,314,4022,23,489,239,1179,4347
31.917,6,231,266992,93,107,346,316,5265,138,1913,232,2804,261727
280.383,6,29,7392,13,158,23365,267,1317,16,603,18689,2036,6075
7.491,6,861,753439,535,1367,14,1380,735413,326,383,22,1380,18026
11.833,6,1872,1634643,1137,1383,10,1420,1601022,735,467,16,1883,33621
66.399,6,18,6382,4,106,22133,106,274,14,461,5106,1997,6108
1799.899,17,449,39928,404,35,4466,288,25708,45,288,40019,288,14220
16.425,6,2405,2220555,1493,1406,10,1448,2168443,912,776,17,1448,52112
0.478,6,56,23419,31,1061,15,1380,16209,25,475,17,1923,7210
10.583,6,18,4266,10,275,1175,275,958,8,992,831,1440,3308
0.348,17,8,2742,8,314,49,353,2742,0,0,0,0,0
0.27,6,23,5910,13,164,22,453,1494,10,555,29,1542,4416
1.277,6,38,9848,21,440,63,1360,4392,17,476,68,2715,5456
374.848,6,27,1767,18,177,22049,177,1181,9,110,8915,110,586
1797.745,17,449,39928,404,35,4460,288,25708,45,288,40013,288,14220
11.691,6,1859,1615907,1124,1383,10,1420,1582286,735,467,15,1883,33621
1789.626,1,58,4872,58,56,31396,56,4872,0,0,0,0,0
1776.507,17,140,11200,70,48,25746,48,5320,70,56,25746,56,5880
280.031,6,27,7312,13,158,23335,267,1317,14,775,21538,3445,5995
7.693,6,26,8387,14,184,576,267,1659,12,1216,680,2736,6728
4.645,6,39,7269,20,218,244,314,3423,19,513,243,1179,3846
0.357,6,12,1653,6,288,70,288,548,6,426,39,434,1105
1254.324,17,1406,106751,769,40,1633,41,52800,637,56,1972,57,53951
0.19,17,2,152,1,48,0,48,76,1,48,0,48,76
1773.014,6,201,22279,129,75,13851,267,10017,72,137,24968,2840,12262
1.704,6,118,87389,51,131,34,232,2569,67,1346,25,1420,84820
3.513,6,48,28462,27,842,135,1440,10395,21,1147,168,1440,18067
1744.589,2,16,512,16,8,116305,8,512,0,0,0,0,0
240.284,6,46,9044,24,519,10446,1402,5934,22,217,11441,618,3110
0.497,6,79,52403,47,1248,10,1432,46832,32,427,15,1432,5571
601.23,6,40,3134,25,52,25043,205,1880,15,36,42932,98,1254
0.0,6,1,83,0,0,0,0,0,1,31,0,31,83
1796.21,1,58,4872,58,56,31512,56,4872,0,0,0,0,0
0.948,17,2,312,2,128,948,128,312,0,0,0,0,0
0.177,17,2,138,1,33,0,33,61,1,49,0,49,77
71.788,6,22,10202,12,433,68,990,1823,10,1327,7961,3928,8379
377.225,2,3,96,3,8,188612,8,96,0,0,0,0,0
30.076,17,36,5292,18,48,1768,48,1368,18,190,1768,308,3924
369.641,6,18,1242,14,180,28433,180,916,4,110,20062,110,326
6.834,6,999,852097,591,1362,11,1402,826217,408,776,16,2804,25880
23.243,6,68,11122,35,260,683,673,2899,33,312,650,1440,8223
65.393,17,6,2016,6,308,13078,308,2016,0,0,0,0,0
0.105,6,20,9166,10,121,11,121,649,10,1141,10,1448,8517
1777.385,17,73,3060,72,14,25033,14,3024,1,8,0,8,36
11.834,6,17,3329,9,211,1477,211,922,8,665,1690,904,2407
28.933,6,614,529775,371,1354,78,1368,511097,243,899,118,1473,18678
0.333,6,36,17942,20,171,17,313,1806,16,1699,21,5632,16136
34.726,17,40,5880,20,48,1827,48,1520,20,190,1827,308,4360
1786.748,6,154,19574,92,302,19634,302,13852,62,83,29290,83,5722
1.371,6,11,1727,7,100,228,100,384,4,589,369,1152,1343
89.341,6,3857,2801218,1887,220,47,230,121189,1970,1311,45,2861,2680029
281.419,6,32,7650,13,158,23451,267,1317,19,464,15611,1400,6333
1796.099,6,400,27130,215,100,8392,469,15016,185,48,9761,69,12114
0.148,17,6,912,3,60,59,60,264,3,188,67,188,648
1788.914,17,71,2976,70,14,25926,14,2940,1,8,0,8,36
1773.072,6,180,15480,120,69,14899,69,8940,60,69,30043,69,6540
0.045,17,2,212,1,46,0,46,74,1,110,0,110,138
0.273,6,27,9067,13,247,22,624,1696,14,947,20,1408,7371
280.439,6,58,8552,27,158,10786,267,1877,31,543,9345,1300,6675
0.547,17,3,543,2,39,95,39,134,1,381,0,381,409
6.235,6,1495,1394769,956,1382,6,1408,1362077,539,931,11,2801,32692
1770.836,6,101,9410,66,66,27243,66,5610,35,60,52080,60,3800
10.956,6,18,5610,10,275,1217,275,958,8,1440,830,1440,4652
37.931,17,22,1936,11,48,3792,48,836,11,72,3792,72,1100
15.907,6,45,8756,22,318,757,639,1926,23,327,675,1360,6830
1787.272,6,102,8228,68,64,26675,64,4896,34,58,54155,58,3332
0.193,17,2,152,1,48,0,48,76,1,48,0,48,76
1772.236,6,180,15480,120,69,14892,69,8940,60,69,30031,69,6540
15.181,6,770,602201,369,322,41,420,21363,401,1407,8,4224,580838
0.681,6,18,7044,10,146,75,175,956,8,944,73,1368,6088
551.582,6,82,12893,42,154,13453,721,5390,40,327,14134,2391,7503
3.077,6,50,19790,29,919,109,1460,14129,21,480,132,4075,5661
1763.925,17,168,14006,156,30,11380,37,9090,12,381,154925,463,4916
132.092,6,1242,617872,683,839,193,1152,588643,559,381,236,1152,29229
1774.265,6,184,15709,121,69,14785,69,8980,63,69,28609,69,6729
43.285,17,4,352,2,60,43284,60,176,2,60,43284,60,176
252.184,2,3,96,3,8,126092,8,96,0,0,0,0,0
0.122,17,4,368,2,32,30,32,120,2,96,34,96,248
1629.919,1,8,448,8,28,232845,28,448,0,0,0,0,0
4.58,6,12,3462,6,75,915,75,395,6,1373,916,1448,3067
19.295,17,35,12409,19,487,1070,1350,9799,16,135,1284,1350,2610
1786.701,6,102,8296,68,65,26667,65,4930,34,59,54139,59,3366
1624.357,2,12,384,12,8,147668,8,384,0,0,0,0,0
0.88,6,10,1687,7,100,146,100,384,3,1179,312,1179,1303
0.331,6,266,230922,114,183,2,230,6485,152,1443,1,2896,224437
300.576,6,17,1175,6,177,60081,177,497,11,110,30040,110,678
1772.534,6,180,15480,120,69,14895,69,8940,60,69,30039,69,6540
9.159,6,1809,1688590,1159,1380,7,1408,1650126,650,931,13,2816,38464
5.016,17,4,288,2,36,4997,36,128,2,52,5003,52,160
1.566,6,17,5215,8,150,223,174,624,9,704,180,1452,4591
1.195,6,4,340,1,0,0,0,40,3,90,522,90,300
121.369,1,12,672,12,28,11033,28,672,0,0,0,0,0
1772.074,6,180,15480,120,69,14891,69,8940,60,69,30031,69,6540
12.273,6,1842,1625563,1149,1362,10,1380,1593601,693,421,17,1923,31962
1771.598,6,101,9344,66,65,27255,65,5577,35,59,52102,59,3767
300.91,6,58,27853,32,761,9706,1408,9359,26,1007,1380,5632,18494
0.612,6,21,7220,13,319,51,602,1960,8,967,80,1471,5260
49.589,6,27,7177,13,155,4132,267,1306,14,530,3814,3417,5871
1772.158,1,60,5040,60,56,30036,56,5040,0,0,0,0,0
662.367,1,22,1232,22,28,31541,28,1232,0,0,0,0,0
1741.552,6,95,7203,63,38,28089,205,4476,32,33,56165,98,2727
33.604,6,29,5027,15,154,2400,722,1896,14,479,2569,1408,3131
0.679,17,2,144,1,36,0,36,64,1,52,0,52,80
0.14,17,2,2386,2,1165,140,1165,2386,0,0,0,0,0
1747.664,6,95,7203,63,38,28188,205,4476,32,33,56368,98,2727
1789.078,17,140,11200,70,48,25928,48,5320,70,56,25928,56,5880
1773.361,6,181,15589,120,69,14902,69,8940,61,69,29555,69,6649
1791.999,1,45,5818,45,101,40727,320,5818,0,0,0,0,0
149.723,6,50,6924,24,139,6498,722,2826,26,183,5975,2026,4098
1793.706,17,144,11520,72,48,25263,48,5472,72,56,25263,56,6048
83.0,17,4,352,2,60,82999,60,176,2,60,82999,60,176
13.337,6,2215,2106895,1479,1350,8,1368,2063959,736,776,17,2736,42936
1740.615,17,29,19517,29,645,62164,645,19517,0,0,0,0,0
1783.108,17,142,11360,71,48,25472,48,5396,71,56,25472,56,5964
948.177,17,10,2594,5,31,237041,37,297,5,431,237040,463,2297
0.907,17,2,685,1,308,0,308,336,1,321,0,321,349
0.775,6,60,44466,24,213,33,517,2096,36,1306,21,1408,42370
12.926,6,1240,1116609,735,1436,17,1448,1083853,505,776,24,1448,32756
0.178,6,26,7256,13,155,14,267,1301,13,678,14,3436,5955
129.487,6,25,6318,9,272,96,516,1180,16,345,8626,1452,5138
1.397,6,24,8004,12,164,108,267,1288,12,1014,107,2491,6716
24.111,6,9,527,5,43,6027,43,311,4,0,8035,0,216
1719.474,17,12,498,11,14,171947,14,462,1,8,0,8,36
5.502,6,41,7365,22,218,262,314,3503,19,516,291,1179,3862
0.175,6,9,1339,5,145,43,145,349,4,826,39,826,990
1765.787,6,210,26953,114,304,15626,304,18248,96,83,18587,83,8705
280.201,6,30,7432,13,158,23350,267,1317,17,543,17510,1400,6115
0.011,6,2,123,1,0,0,0,40,1,31,0,31,83
1683.23,1,7,392,7,28,280538,28,392,0,0,0,0,0
1.368,6,49,19982,27,943,52,1460,14326,22,476,56,2615,5656
137.56,6,10,441,3,0,1564,0,128,7,7,22895,7,313
1744.63,2,23,736,23,8,79301,8,736,0,0,0,0,0
8.271,17,12,1764,6,48,1651,48,456,6,190,1651,308,1308
0.368,17,8,2750,8,315,52,354,2750,0,0,0,0,0
0.274,17,2,440,1,39,0,39,67,1,345,0,345,373
1796.99,1,59,4956,0,0,0,0,0,59,56,30982,56,4956
1781.77,6,373,26359,215,104,8326,469,15623,158,69,11348,69,10736
0.068,17,4,284,2,32,50,32,120,2,54,19,60,164
317.051,6,71,18044,37,386,8806,1360,8474,34,356,9603,4658,9570
7.976,6,5,453,3,245,3988,245,369,2,0,470,0,84
4.539,17,9,640,5,36,1127,36,320,4,52,1499,52,320
11.467,17,3,3183,3,1033,5733,1222,3183,0,0,0,0,0
160.348,6,33,14370,16,488,325,1460,3127,17,959,10013,1460,11243
1790.155,1,278,15568,278,28,6462,28,15568,0,0,0,0,0
241.947,6,63,21551,34,865,7331,1408,18223,29,197,8640,580,3328
1672.061,1,7,392,7,28,278676,28,392,0,0,0,0,0
1740.094,1,56,4704,56,56,31638,56,4704,0,0,0,0,0
7.066,17,27,20401,12,668,642,1350,8363,15,774,225,1350,12038
0.603,6,29,7520,17,306,37,1087,2826,12,601,53,1420,4694
1.135,17,8,704,4,37,377,37,260,4,83,376,89,444
1772.4,6,180,15480,120,69,14894,69,8940,60,69,30037,69,6540
1793.652,17,180,14040,180,50,10020,50,14040,0,0,0,0,0
1787.417,6,99,8118,66,66,27498,66,4818,33,60,55853,60,3300
0.025,17,2,548,2,246,25,246,548,0,0,0,0,0
1796.218,17,448,39896,403,35,4468,288,25676,45,288,40021,288,14220
1794.404,17,179,13962,179,50,10080,50,13962,0,0,0,0,0
2.154,6,12,1303,6,256,428,256,756,6,303,427,303,547
0.177,17,2,152,1,48,0,48,76,1,48,0,48,76
0.072,17,2,412,1,33,0,33,61,1,323,0,323,351
330.435,1,5,442,5,60,82608,88,442,0,0,0,0,0
1743.812,6,95,7203,63,38,28126,205,4476,32,33,56244,98,2727
0.198,6,16,6197,8,128,28,128,552,8,1044,28,1448,5645
0.379,6,7,376,4,0,126,0,216,3,0,99,0,160
1797.259,17,448,39896,403,35,4470,288,25676,45,288,40013,288,14220
2.554,17,2,476,1,39,0,39,67,1,381,0,381,409
0.192,6,9,1338,5,145,48,145,349,4,825,48,825,989
0.172,6,9,1339,5,145,43,145,349,4,826,40,826,990
280.465,6,29,7392,13,158,23372,267,1317,16,603,18694,2076,6075
11.444,6,1839,1582683,1105,1378,10,1420,1549102,734,467,15,1883,33581
75.069,6,15,620,7,0,2969,0,284,8,0,10722,0,336
1.279,6,50,20112,28,886,47,1360,14456,22,433,53,1360,5656
2.224,17,4,240,2,32,2222,32,120,2,32,2223,32,120
1619.812,17,107,36168,107,310,15281,548,36168,0,0,0,0,0
1380.043,17,24,1992,24,55,60001,55,1992,0,0,0,0,0
0.029,17,2,439,1,43,0,43,71,1,340,0,340,368
1744.704,2,29,928,29,8,62310,8,928,0,0,0,0,0
1790.31,6,366,26464,213,97,8444,773,14776,153,87,11777,645,11688
0.525,6,30,10269,15,266,37,705,1866,15,951,36,1438,8403
0.581,17,25,18585,13,1008,44,1350,13477,12,397,46,1350,5108
0.532,17,14,7750,7,747,88,1350,5425,7,304,46,1350,2325
1785.828,6,356,22520,208,69,8627,69,12460,148,69,12148,69,10060
0.391,6,12,1653,6,288,77,288,548,6,426,45,434,1105
1115.602,1,14,784,14,28,85815,28,784,0,0,0,0,0
0.963,6,27,8420,15,222,56,540,1964,12,1192,72,3151,6456
3.897,17,5,290,5,30,974,30,290,0,0,0,0,0
0.016,6,10,1510,5,657,3,657,925,5,317,4,317,585
0.175,6,46,22382,27,1086,6,1420,17401,19,467,9,1883,4981
282.218,17,4,352,2,60,282217,60,176,2,60,282217,60,176
0.015,17,3,634,2,32,15,32,120,1,486,0,486,514
240.12,6,42,5410,21,235,12005,752,2751,21,194,12005,656,2659
0.018,17,4,398,2,46,0,46,148,2,97,2,103,250
8.043,17,15,6618,7,605,1340,1350,4435,8,244,1145,1350,2183
280.227,6,29,7392,13,158,23352,267,1317,16,603,18679,2036,6075
0.217,6,20,4960,10,137,24,267,1092,10,692,23,1467,3868
1.323,6,50,19226,27,887,50,1360,13530,23,433,52,1360,5696
10.951,6,20,4442,11,275,1095,275,998,9,768,772,1440,3444
1794.944,6,356,22520,208,69,8671,69,12460,148,69,12210,69,10060
1.373,6,28,6109,14,154,105,267,1644,14,780,91,1460,4465
1625.702,6,106,12853,69,81,23907,498,5450,37,169,45156,1420,7403
15.358,17,13,6738,7,613,2554,1350,4487,6,347,3065,1350,2251
241.48,6,43,9722,20,126,12709,516,2448,23,423,9844,1452,7274
1.677,17,5,4317,2,720,1677,1350,1497,3,912,771,1350,2820
8.367,6,17,5391,9,275,1045,275,643,8,1104,828,1440,4748
1.573,17,18,6285,7,372,262,1350,2802,11,288,80,1350,3483
0.172,17,8,2934,8,338,24,361,2934,0,0,0,0,0
0.113,6,11,1703,6,314,22,500,948,5,487,28,487,755
1793.453,17,180,11520,180,36,10019,36,11520,0,0,0,0,0
14.726,6,20,4463,9,341,1840,722,1488,11,342,1454,1408,2975
2.038,17,3,174,3,30,1019,30,174,0,0,0,0,0
0.513,6,21,7293,13,334,42,663,2033,8,967,68,1471,5260
20.317,6,19,2432,10,189,2257,517,1298,9,323,2531,499,1134
1737.806,1,65,5460,65,56,27153,56,5460,0,0,0,0,0
1779.925,17,142,11360,71,48,25427,48,5396,71,56,25427,56,5964
1787.254,6,104,8444,68,66,26675,66,4964,36,60,51047,60,3480
1793.13,1,59,4956,59,56,30916,56,4956,0,0,0,0,0
0.595,6,7,376,4,0,198,0,216,3,0,174,0,160
1.21,17,2,782,2,363,1210,363,782,0,0,0,0,0
1744.742,2,30,960,30,8,60163,8,960,0,0,0,0,0
0.436,6,54,23649,29,1075,15,1380,18395,25,421,16,1923,5254
1740.808,6,135,8849,75,54,23524,208,5488,60,31,29501,31,3361
1798.592,17,448,39896,403,35,4474,288,25676,45,288,40021,288,14220
1796.389,17,142,11360,71,48,25662,48,5396,71,56,25662,56,5964
1786.905,6,102,8364,68,66,26670,66,4964,34,60,54144,60,3400
1789.778,6,356,22520,208,69,8646,69,12460,148,69,12175,69,10060
502.561,6,9,546,6,31,100512,31,333,3,31,251274,31,213
272.625,6,114,82905,71,1251,3894,1408,72547,43,676,2346,1408,10358
1781.03,6,104,8376,68,65,26582,65,4930,36,59,50884,59,3446
83.738,6,49,12964,22,373,1521,1189,5738,27,383,3219,4837,7226
0.045,17,2,412,1,48,0,48,76,1,308,0,308,336
61.683,6,10,648,10,31,6853,31,648,0,0,0,0,0
259.157,17,4,352,2,60,259156,60,176,2,60,259156,60,176
1783.01,17,85,3564,84,14,21482,14,3528,1,8,0,8,36
78.576,6,33,9884,10,162,8730,267,1383,23,420,3564,1460,8501
1797.068,17,448,39896,403,35,4470,288,25676,45,288,40013,288,14220
21.521,17,24,8851,11,491,2149,1350,5715,13,213,1790,1350,3136
9.773,6,84,25130,43,550,232,1152,19349,41,459,237,1179,5781
0.018,6,3,168,1,0,0,0,52,2,0,0,0,116
1652.696,1,7,742,7,78,275449,78,742,0,0,0,0,0
10.998,17,8,704,4,48,3663,48,304,4,72,3662,72,400
0.243,17,3,451,2,39,236,39,134,1,289,0,289,317
0.391,6,52,23259,30,994,13,1380,16214,22,558,15,1923,7045
1790.355,6,355,22480,207,69,8691,69,12420,148,69,12176,69,10060
1681.306,17,14,1036,7,30,280213,30,406,7,62,280209,62,630
1797.304,1,58,4872,0,0,0,0,0,58,56,31531,56,4872
0.082,6,2,100,1,0,0,0,60,1,0,0,0,40
12.1,6,1894,1670516,1157,1387,10,1420,1636815,737,467,16,1883,33701
1798.188,17,305,78836,305,230,5915,422,78836,0,0,0,0,0
8.326,6,35,7477,17,239,520,314,3314,18,491,474,1179,4163
0.878,17,2,166,1,47,0,47,75,1,63,0,63,91
0.05,17,4,284,2,32,1,32,120,2,54,10,60,164
1381.844,17,96,7680,48,48,29400,48,3648,48,56,29400,56,4032
1785.002,6,135,8337,73,27,24791,27,4417,62,27,29261,27,3920
0.398,6,10,968,5,256,97,256,460,5,304,96,304,508
810.171,6,104,9825,38,78,21891,339,4036,66,92,12462,1062,5789
0.086,17,2,180,1,30,0,30,58,1,94,0,94,122
1796.313,17,590,198232,590,307,3049,308,198232,0,0,0,0,0
114.639,6,21,9221,11,514,84,1236,2014,10,1132,12718,2720,7207
1.447,6,47,18622,26,918,57,1460,13006,21,433,62,1460,5616
1798.231,1,177,9912,177,28,10217,28,9912,0,0,0,0,0
2.221,17,3,984,3,300,1110,300,984,0,0,0,0,0
0.469,6,26,9054,13,263,39,688,1736,13,947,36,1368,7318
15.166,6,5,706,3,46,7583,46,166,2,460,14966,460,540
280.446,6,31,7733,14,175,21572,267,1618,17,678,17525,2760,6115
73.061,6,21,8134,11,520,90,1223,2034,10,948,8098,1631,6100
14.374,6,13,2133,8,324,2053,585,1073,5,396,3530,580,1060
144.406,6,20,9096,11,499,93,1193,1971,9,1350,18027,3639,7125
4.509,6,15,1208,8,283,618,283,715,7,105,721,105,493
88.587,1,4,224,4,28,29529,28,224,0,0,0,0,0
11.62,6,1827,1601201,1109,1389,10,1420,1568260,718,467,16,1883,32941
1799.988,1,68,5712,68,56,26865,56,5712,0,0,0,0,0
243.324,17,8,333,7,13,40554,14,289,1,16,0,16,44
14.115,6,21,6825,12,275,1283,275,1038,9,1353,1130,1440,5787
1797.484,1,342,28728,342,56,5271,56,28728,0,0,0,0,0
0.295,6,27,9093,13,252,24,646,1694,14,832,22,1402,7399
0.001,1,2,112,2,28,1,28,112,0,0,0,0,0
282.87,17,4,352,2,60,282869,60,176,2,60,282869,60,176
0.887,6,30,12052,16,525,59,1360,3298,14,909,54,1380,8754
87.046,6,39,10576,22,384,4145,1150,3076,17,550,5428,2736,7500
1749.094,1,54,4536,54,56,33001,56,4536,0,0,0,0,0
159.585,6,24,9428,12,372,59,808,1628,12,913,14495,1360,7800
0.372,6,25,6073,12,181,33,537,1526,13,551,27,1448,4547
1.046,6,54,13970,25,551,43,1429,4892,29,416,36,1460,9078
63.93,6,35,9038,15,327,146,1189,2575,20,471,3364,1420,6463
1.41,17,6,936,3,64,513,64,276,3,192,523,192,660
0.045,17,3,543,2,39,40,39,134,1,381,0,381,409
27.472,17,16,1216,16,48,1831,48,1216,0,0,0,0,0
10.984,6,20,5694,11,275,1098,275,998,9,1440,774,1440,4696
844.371,1,14,784,14,28,64951,28,784,0,0,0,0,0
28.766,17,4,352,2,60,28765,60,176,2,60,28765,60,176
1770.402,6,99,9240,66,65,27236,65,5577,33,59,55321,59,3663
1.005,6,25,9854,13,350,83,1043,1954,12,1058,73,1360,7900
1787.13,6,102,8296,68,65,26673,65,4930,34,59,54151,59,3366
1738.598,6,87,6322,58,31,30501,31,3915,29,31,62092,31,2407
1788.819,6,123,14710,79,84,22933,502,6390,44,156,41598,1452,8320
77.084,6,693,319004,356,834,217,1152,299678,337,389,228,1152,19326
321.909,6,23,6127,9,266,193,500,1164,14,399,24756,1420,4963
1772.653,6,180,15480,120,69,14896,69,8940,60,69,30036,69,6540
87.974,6,28,13550,13,279,70,527,1401,15,1048,6273,1460,12149
1547.746,6,500,122496,241,577,6448,1460,96031,259,117,5979,2920,26465
1786.199,6,105,8416,68,65,26659,65,4930,37,59,49614,59,3486
0.151,17,2,202,1,41,0,41,69,1,105,0,105,133
1791.646,1,255,14280,255,28,7053,28,14280,0,0,0,0,0
1776.9,17,140,11200,70,48,25752,48,5320,70,56,25752,56,5880
39.947,17,36,21415,15,385,2851,1350,6203,21,696,1995,1350,15212
0.013,17,2,471,1,40,0,40,68,1,375,0,375,403
151.128,6,24,10282,12,433,69,990,1823,12,995,13727,2568,8459
1785.871,6,117,13707,76,79,23811,497,5917,41,157,44644,1420,7790
1754.915,6,6054,6023428,2004,142,876,968,124573,4050,1434,433,11344,5898855
95.628,6,32,8952,15,158,6830,267,1397,17,687,5974,1781,7555
1785.083,6,183,16138,122,75,14752,469,9489,61,69,29751,69,6649
0.005,17,2,408,1,62,0,62,90,1,290,0,290,318
20.165,6,18,2368,10,189,2240,517,1298,8,323,2878,499,1070
123.88,6,158,123785,98,1325,1277,1448,111168,60,632,2096,1448,12617
240.44,6,45,8974,21,521,12021,1418,5792,24,214,10453,618,3182
12.065,6,19,3445,12,211,1096,211,1090,7,665,2010,904,2355
1779.288,6,278,32853,115,132,15606,1460,15811,163,125,10981,2920,17042
28.345,17,4,240,2,32,28343,32,120,2,32,28343,32,120
1783.518,6,102,8364,68,66,26619,66,4964,34,60,54036,60,3400
8.018,6,1852,1730544,1183,1385,6,1408,1691092,669,931,11,2801,39452
10.072,17,4,4328,4,1054,3357,1072,4328,0,0,0,0,0
848.904,1,8,652,8,53,121272,78,652,0,0,0,0,0
0.321,6,22,7354,13,335,26,668,2038,9,968,39,1906,5316
1.134,6,25,6587,13,332,93,1001,2187,12,783,102,1420,4400
4.85,6,39,7269,20,218,255,314,3423,19,513,254,1179,3846
1771.856,6,99,9306,66,66,27259,66,5610,33,60,55367,60,3696
0.537,1,2,112,2,28,537,28,112,0,0,0,0,0
0.291,6,24,6064,12,181,26,537,1526,12,651,25,1402,4538
307.795,6,41,7761,23,121,13990,516,2260,18,341,14568,1452,5501
1776.751,6,182,15698,120,69,14930,69,8940,62,69,29120,69,6758
0.13,6,10,1514,5,503,32,503,771,5,475,32,475,743
1789.946,17,86,3606,85,14,21308,14,3570,1,8,0,8,36
37.072,17,40,5880,20,48,1950,48,1520,20,190,1950,308,4360
0.015,17,2,433,1,34,0,34,62,1,343,0,343,371
0.006,17,3,442,2,32,1,32,120,1,294,0,294,322
9.602,6,72,20686,37,531,266,1152,15843,35,491,274,1179,4843
289.362,17,4,352,2,60,289361,60,176,2,60,289361,60,176
0.193,6,25,7216,13,155,16,267,1301,12,775,16,4836,5915
1786.703,17,87,3648,86,14,21020,14,3612,1,8,0,8,36
1772.326,6,182,15629,121,69,14769,69,8980,61,69,29532,69,6649
1787.685,1,169,9464,169,28,10640,28,9464,0,0,0,0,0
1795.669,17,449,39928,404,35,4455,288,25708,45,288,40015,288,14220
0.3,6,58,40454,30,333,10,333,2234,28,1413,3,1438,38220
1785.862,6,369,25261,214,94,8384,469,14576,155,69,11596,69,10685
287.189,6,22,1184,11,0,28717,0,616,11,0,28717,0,568
171.633,17,4,352,2,60,171631,60,176,2,60,171631,60,176
0.098,17,2,144,1,36,0,36,64,1,52,0,52,80
280.001,6,29,7392,13,158,23333,267,1317,16,603,18664,1400,6075
1.285,6,46,19022,26,951,51,1460,13446,20,433,58,1460,5576
1.619,6,27,8493,14,141,124,267,1455,13,1057,114,3819,7038
1.406,6,50,18473,27,833,54,1360,12777,23,433,55,1360,5696
1472.53,6,173,20248,110,84,13509,469,9036,63,147,23741,1926,11212
266.118,6,456,381895,291,1324,917,1368,356840,165,567,1621,2519,25055
1799.954,17,450,39448,405,34,4455,288,25476,45,282,40018,288,13972
127.084,6,24,8066,12,377,52,797,1656,12,739,11542,2720,6410
23.082,6,21,3182,12,183,2098,517,1561,9,381,2883,499,1621
1780.89,6,103,9580,68,64,26580,64,5776,35,58,52376,58,3804
1786.586,6,104,8308,68,64,26665,64,4896,36,58,51042,58,3412
12.206,6,11,864,8,106,1743,106,646,3,90,6079,90,218
1788.371,17,87,3648,86,14,21039,14,3612,1,8,0,8,36
302.511,6,41,11537,20,315,15921,882,2173,21,532,516,2128,9364
240.711,2,5,160,5,8,60177,8,160,0,0,0,0,0
0.286,6,9,1339,5,145,71,145,349,4,826,71,826,990
13.867,6,26,4814,13,154,1137,721,1767,13,473,1140,2026,3047
0.049,6,2,104,1,0,0,0,52,1,0,0,0,52
72.106,6,30,7504,12,155,6555,267,1266,18,423,4241,2006,6238
962.625,2,10,320,10,8,106958,8,320,0,0,0,0,0
0.545,17,2,179,1,43,0,43,71,1,80,0,80,108
1773.035,6,180,15480,120,69,14899,69,8940,60,69,30044,69,6540
1798.158,6,368,25759,214,99,8442,469,15045,154,69,11751,69,10714
1784.218,17,768,46308,768,32,2326,37,46308,0,0,0,0,0
98.563,17,4,352,2,60,98562,60,176,2,60,98562,60,176
1763.415,1,198,11088,198,28,8951,28,11088,0,0,0,0,0
139.159,6,138,21542,75,304,1880,304,14972,63,83,2241,83,6570
1791.742,6,355,22480,207,69,8697,69,12420,148,69,12188,69,10060
0.393,6,12,1653,6,288,73,288,548,6,426,43,434,1105
0.494,6,47,17720,25,963,20,1380,12598,22,383,20,1380,5122
300.254,6,54,32861,31,190,10008,444,2521,23,1618,10919,4224,30340
0.159,17,2,255,1,43,0,43,71,1,156,0,156,184
3.87,6,54,20661,27,975,148,1440,14769,27,433,141,1440,5892
2.943,17,2,1430,2,687,2943,687,1430,0,0,0,0,0
283.055,6,28,7352,11,158,28305,267,1237,17,543,17688,1400,6115
64.315,6,11,452,5,0,6390,0,204,6,0,12861,0,248
156.784,17,4634,5420312,703,58,223,1350,60800,3931,1335,39,1350,5359512
0.227,17,4,304,2,48,116,48,152,2,48,116,48,152
1772.225,6,181,15589,120,69,14892,69,8940,61,69,29530,69,6649
1757.405,6,5172,4733877,2358,151,745,975,144345,2814,1621,624,7040,4589532
1799.134,1,58,4872,58,56,31563,56,4872,0,0,0,0,0
1796.454,6,356,22520,208,69,8678,69,12460,148,69,12220,69,10060
176.927,6,26,2796,15,302,12637,302,1718,11,83,16597,83,1078
3.76,17,2,656,2,300,3760,300,656,0,0,0,0,0
0.308,6,20,4960,10,137,34,267,1092,10,692,31,1467,3868
300.428,6,82,14690,37,308,8344,1368,7172,45,224,6826,1368,7518
44.058,17,38,10070,17,357,2751,1350,6549,21,139,2201,1350,3521
1772.425,6,180,15480,120,69,14894,69,8940,60,69,30037,69,6540
0.019,17,2,212,1,46,0,46,74,1,110,0,110,138
1786.919,17,142,11360,71,48,25526,48,5396,71,56,25526,56,5964
1512.083,2,11,352,11,8,151208,8,352,0,0,0,0,0
1789.522,6,368,23276,212,69,8481,69,12896,156,69,11545,69,10380
1.404,6,2,111,1,0,0,0,40,1,31,0,31,71
1772.106,6,180,15480,120,69,14891,69,8940,60,69,30034,69,6540
10.836,6,23,6586,8,154,1548,267,792,15,518,772,1420,5794
1684.553,2,25,800,25,8,70189,8,800,0,0,0,0,0
1644.303,6,118,12136,66,68,25296,517,4610,52,241,32240,1418,7526
14.361,6,92,27341,46,547,319,1152,21019,46,447,313,1179,6322
127.913,17,4,352,2,60,127912,60,176,2,60,127911,60,176
292.548,6,48,9006,23,129,13294,517,2137,25,504,12186,1418,6869
79.875,6,37,5455,22,154,3803,722,2271,15,400,1120,2026,3184
67.541,6,32,8952,15,158,4824,267,1397,17,687,4217,1781,7555
0.889,6,10,1687,7,100,148,100,384,3,1179,320,1179,1303
0.299,6,23,7295,11,257,29,748,1635,12,838,26,1408,5660
0.361,17,2,180,1,30,0,30,58,1,94,0,94,122
1796.413,17,140,11200,70,48,26034,48,5320,70,56,26034,56,5880
61.311,6,34,15580,22,780,2919,1408,8958,12,855,5551,3847,6622
27.238,6,46,8946,22,371,629,797,2109,24,345,1177,1360,6837
0.499,17,3,543,2,39,132,39,134,1,381,0,381,409
289.944,6,75,51388,47,1198,6303,1368,43195,28,841,2298,2736,8193
120.913,17,4,1344,4,308,40304,308,1344,0,0,0,0,0
1777.482,17,79,3312,78,14,23084,14,3276,1,8,0,8,36
1777.02,17,73,3060,72,14,25028,14,3024,1,8,0,8,36
9.349,6,33,11180,18,617,549,1408,4033,15,793,667,2816,7147
1797.141,17,142,11360,71,48,25672,48,5396,71,56,25671,56,5964
338.859,17,13,6288,5,308,84714,308,1680,8,548,18176,548,4608
16.694,17,6,528,3,48,8343,48,228,3,72,8342,72,300
1.341,6,12,5628,3,106,670,106,234,9,718,134,1460,5394
6.236,17,4,240,2,32,6234,32,120,2,32,6235,32,120
28.266,6,14,2242,8,210,4037,210,844,6,545,5652,904,1398
2.228,6,8,440,5,0,557,0,268,3,0,1104,0,172
3.843,6,3,151,1,0,0,0,40,2,31,1,31,111
1799.188,1,336,28224,336,56,5370,56,28224,0,0,0,0,0
295.253,1,3,168,3,28,147626,28,168,0,0,0,0,0
6.597,6,530,482827,346,1333,18,1368,468595,184,776,34,1473,14232
1720.531,17,12,498,11,14,172053,14,462,1,8,0,8,36
855.552,17,10,2594,5,31,213886,37,297,5,431,213886,463,2297
0.026,6,11,1805,6,126,5,126,446,5,545,5,990,1359
0.274,17,8,2758,8,316,39,355,2758,0,0,0,0,0
369.292,6,30,7098,10,189,13140,516,1352,20,290,19431,1452,5746
1787.66,17,87,3648,86,14,21031,14,3612,1,8,0,8,36
253.75,6,63,8825,26,169,10149,630,3099,37,199,7048,580,5726
23.146,6,12,1049,4,302,7715,302,506,8,83,2957,83,543
0.037,6,14,4044,8,88,5,88,452,6,1670,7,1880,3592
262.583,17,4,352,2,60,262582,60,176,2,60,262581,60,176
424.902,6,58,13959,26,285,16996,1189,6188,32,270,2819,1460,7771
1771.268,6,103,9448,66,65,27250,65,5577,37,59,49199,59,3871
1786.155,17,87,3648,86,14,21013,14,3612,1,8,0,8,36
10.904,6,18,5532,10,275,1211,275,958,8,1414,877,1414,4574
360.981,6,170,52490,83,555,4402,1360,37800,87,287,4195,1938,14690
18.721,17,26,14590,14,812,1437,1350,11773,12,206,1699,1350,2817
1660.191,1,16,1868,16,88,110679,125,1868,0,0,0,0,0
241.165,6,50,6534,24,215,10480,725,3196,26,179,9639,807,3338
1793.439,6,163,12965,88,95,20614,208,9035,75,31,24228,31,3930
265.989,1,4,224,4,28,88663,28,224,0,0,0,0,0
14.183,6,19,6470,11,275,1418,275,723,8,1353,1309,1440,5747
0.444,6,20,7151,12,318,40,600,1906,8,964,58,1471,5245
9.034,17,35,7598,10,221,1003,1350,2496,25,176,375,1350,5102
1786.576,17,225,55625,225,219,7975,422,55625,0,0,0,0,0
161.767,6,9,558,6,43,32353,43,394,3,0,80879,0,164
0.033,6,10,1512,5,503,8,503,771,5,473,8,473,741
1.497,6,18,3257,10,99,146,182,924,8,477,188,1343,2333
840.661,6,55,4342,34,66,25474,66,2482,21,60,41567,60,1860
1750.716,17,13,534,11,14,175053,14,462,2,8,1750522,8,72
8.549,6,43,7429,20,218,449,314,3423,23,513,377,1179,4006
0.216,6,25,9611,11,621,21,1448,3687,14,741,16,1448,5924
1.001,17,24,12172,12,721,91,1350,8994,12,236,71,1350,3178
41.621,2,4,128,4,8,13873,8,128,0,0,0,0,0
232.712,17,3,1247,3,387,116356,548,1247,0,0,0,0,0
1.289,6,33,6547,16,164,85,267,1962,17,650,71,1452,4585
0.09,6,2,80,1,0,0,0,40,1,0,0,0,40
1773.213,6,180,15480,120,69,14900,69,8940,60,69,30047,69,6540
0.861,6,4,220,2,0,861,0,100,2,0,301,0,120
1.278,6,50,19926,28,874,47,1360,14270,22,433,52,1360,5656
0.004,17,2,459,1,40,0,40,68,1,363,0,363,391
1788.901,6,368,23276,212,69,8478,69,12896,156,69,11539,69,10380
0.12,17,4,1445,4,333,40,354,1445,0,0,0,0,0
1751.148,17,12,498,11,14,175114,14,462,1,8,0,8,36
0.497,17,3,451,2,39,431,39,134,1,289,0,289,317
150.84,6,31,8912,14,158,11603,267,1357,17,858,9419,2760,7555
661.782,2,8,256,8,8,94540,8,256,0,0,0,0,0
55.574,6,560,260580,294,822,189,1152,244435,266,423,208,1179,16145
76.966,17,4,1344,4,308,25655,308,1344,0,0,0,0,0
5.022,17,3,208,2,36,5005,36,128,1,52,0,52,80
4.044,17,4,240,4,32,1348,32,240,0,0,0,0,0
2.113,17,2,214,1,39,0,39,67,1,119,0,119,147
371.291,6,18,1239,14,177,28560,177,913,4,110,20061,110,326
0.008,17,2,245,1,32,0,32,60,1,157,0,157,185
8.235,6,1525,1449834,999,1376,8,1408,1417818,526,776,15,1408,32016
3.822,17,10,785,5,31,944,31,295,5,70,943,70,490
3.515,1,4,144,4,8,1171,8,144,0,0,0,0,0
0.469,6,13,1175,7,182,78,182,566,6,96,46,134,609
1771.829,6,99,9306,66,66,27258,66,5610,33,60,55366,60,3696
0.057,17,2,358,1,30,0,30,58,1,272,0,272,300
1774.007,6,184,15847,122,69,14661,69,9089,62,69,29078,69,6758
1787.815,17,87,3648,86,14,21033,14,3612,1,8,0,8,36
0.253,6,21,5000,10,137,28,267,1092,11,692,21,1467,3908
39.68,6,2034,1770302,1307,1277,30,1368,1727822,727,931,54,2736,42480
4.394,6,14,1143,7,304,732,304,672,7,83,603,83,471
1791.487,6,115,7478,68,50,26738,208,4575,47,31,38940,31,2903
3.956,6,37,6289,20,206,208,314,2864,17,456,231,1152,3425
0.197,17,2,152,1,48,0,48,76,1,48,0,48,76
147.268,17,4,288,2,36,147237,36,128,2,52,147236,52,160
300.576,6,16,1159,8,177,42914,177,637,8,110,42914,110,522
1740.461,17,30,6930,30,203,60015,203,6930,0,0,0,0,0
16.654,17,32,16589,15,444,1187,1350,7092,17,530,1038,1350,9497
1787.905,6,369,25261,213,93,8433,469,14605,156,69,11534,69,10656
11.58,6,24,8413,13,275,965,275,1078,11,1147,831,2840,7335
1.164,17,19,6708,8,375,166,1350,3227,11,288,87,1350,3481
1249.181,6,157,10674,60,46,21171,46,4540,97,46,13012,46,6134
99.317,17,4,352,2,60,99316,60,176,2,60,99316,60,176
0.011,6,2,92,1,0,0,0,40,1,0,0,0,52
373.565,6,18,1239,14,177,28735,177,913,4,110,20059,110,326
504.148,2,3,96,3,8,252074,8,96,0,0,0,0,0
60.17,6,34,9930,12,155,29,267,1266,22,432,2864,3417,8664
1743.365,6,104,7550,66,31,26821,31,4503,38,31,47117,31,3047
1784.657,6,117,13670,75,79,24116,478,5861,42,161,43526,1452,7809
1740.582,17,30,31650,30,1027,60020,1027,31650,0,0,0,0,0
1799.323,17,449,39928,404,35,4464,288,25708,45,288,40020,288,14220
0.935,17,4,678,3,32,461,32,180,1,470,0,470,498
338.456,1,5,439,5,59,84614,85,439,0,0,0,0,0
69.1,6,29,7257,14,155,5315,267,1346,15,482,4935,2840,5911
1781.31,6,103,8464,68,66,26586,66,4964,35,60,52388,60,3500
1798.936,17,449,39928,404,35,4463,288,25708,45,288,40016,288,14220
1274.711,1,106,5936,106,28,12140,28,5936,0,0,0,0,0
1766.366,1,58,4872,0,0,0,0,0,58,56,30988,56,4872
1755.88,1,178,18868,178,78,9920,78,18868,0,0,0,0,0
1.295,17,2,179,1,43,0,43,71,1,80,0,80,108
0.188,17,2,136,1,32,0,32,60,1,48,0,48,76
164.779,2,4,128,4,8,54926,8,128,0,0,0,0,0
0.025,17,2,495,1,39,0,39,67,1,400,0,400,428
0.009,17,4,300,2,39,6,39,134,2,55,7,55,166
4.91,17,2,2200,2,1072,4910,1072,2200,0,0,0,0,0
240.337,6,29,7366,15,498,17166,1408,5266,14,194,18487,580,2100
1.998,6,93,33047,52,530,39,1360,23344,41,536,46,4649,9703
6.203,6,15,6646,4,106,2067,106,274,11,739,610,1452,6372
0.168,6,2,104,1,0,0,0,52,1,0,0,0,52
19.36,6,15,10462,4,229,6453,229,409,11,1371,1342,1440,10053
0.055,17,2,1152,1,548,0,548,576,1,548,0,548,576
40.664,17,17,1292,17,48,2541,48,1292,0,0,0,0,0
1788.365,17,87,3648,86,14,21039,14,3612,1,8,0,8,36
12.97,6,24,6993,13,275,1080,275,1078,11,910,796,1440,5915
1.496,6,29,10362,16,613,70,1360,3753,13,759,107,2720,6609
1798.866,6,356,22520,208,69,8690,69,12460,148,69,12236,69,10060
300.89,6,44,13766,23,891,13676,1460,8093,21,370,432,1460,5673
300.963,6,45,9992,23,531,13680,1360,4186,22,307,539,1360,5806
3.859,17,4,1568,4,364,1286,364,1568,0,0,0,0,0
2.067,6,30,10413,18,368,121,837,1829,12,1012,180,1420,8584
1.667,6,48,18786,27,861,64,1360,13170,21,433,73,1360,5616
7.984,6,20,10696,8,275,1140,275,599,12,1067,654,1414,10097
197.879,17,4,240,2,32,197878,32,120,2,32,197878,32,120
1741.486,17,29,30624,29,1028,62195,1028,30624,0,0,0,0,0
7.846,6,77,24637,39,561,206,1152,18976,38,413,205,1152,5661
6.03,6,19,2553,11,211,602,211,1050,8,545,861,904,1503
1.795,17,20,5190,20,231,94,389,5190,0,0,0,0,0
0.004,6,3,136,1,0,0,0,40,2,0,1,0,96
0.169,17,2,199,1,37,0,37,65,1,106,0,106,134
0.254,17,2,167,1,39,0,39,67,1,72,0,72,100
240.32,6,43,8917,21,523,12015,1418,5815,22,216,11443,618,3102
0.188,6,3,175,2,31,16,31,135,1,0,0,0,40
1750.679,17,12,498,11,14,175067,14,462,1,8,0,8,36
1378.865,1,92,5152,92,28,15152,28,5152,0,0,0,0,0
0.925,6,29,8500,15,222,54,540,1964,14,852,58,1360,6536
0.339,6,21,5000,10,137,37,267,1092,11,692,31,1467,3908
0.455,6,52,22940,29,1043,16,1380,15855,23,511,16,1923,7085
280.547,6,29,7392,14,158,21580,267,1357,15,678,20030,3456,6035
1.949,17,2,118,2,31,1949,31,118,0,0,0,0,0
240.381,6,47,8604,24,449,10450,1402,5752,23,206,10926,580,2852
1699.51,17,12,498,11,14,169951,14,462,1,8,0,8,36
0.268,6,16,8980,10,127,20,127,655,6,2668,50,7240,8325
0.951,6,24,6636,13,350,78,1089,2276,11,783,94,1420,4360
2.373,6,36,8352,19,272,131,744,1918,17,478,127,1928,6434
1779.921,1,342,28728,342,56,5219,56,28728,0,0,0,0,0
5.493,17,25,7758,10,305,610,1350,3337,15,266,226,1350,4421
1785.492,6,137,8441,73,27,24797,27,4447,64,27,28340,27,3994
34.757,17,10,760,10,48,3861,48,760,0,0,0,0,0
8.267,6,1610,1455612,999,1378,8,1408,1419176,611,931,13,2801,36436
481.279,2,5,160,5,8,120319,8,160,0,0,0,0,0
0.307,6,22,7342,12,335,27,668,1974,10,1210,33,1906,5368
0.035,17,4,420,2,33,0,33,122,2,121,2,145,298
1682.148,1,15,840,15,28,120153,28,840,0,0,0,0,0
1.375,6,25,8056,12,164,106,267,1288,13,869,97,1368,6768
0.366,6,21,7281,12,334,32,663,1969,9,967,44,1912,5312
1775.449,17,150,24194,150,133,11915,373,24194,0,0,0,0,0
39.622,17,22,1936,11,48,3961,48,836,11,72,3961,72,1100
3.164,6,6,340,3,0,1582,0,160,3,0,957,0,180
7.027,6,45,8409,23,227,319,314,4102,22,489,322,1179,4307
67.102,17,4,352,2,60,67101,60,176,2,60,67100,60,176
1781.762,6,361,24265,210,88,8525,469,13878,151,69,11878,69,10387
1.598,6,25,8469,15,175,114,362,1666,10,1045,139,2491,6803
1794.035,1,58,4872,58,56,31474,56,4872,0,0,0,0,0
15.295,17,28,18370,15,838,1088,1350,12990,13,385,1269,1350,5380
1.361,6,48,19202,27,891,52,1460,13586,21,433,58,1460,5616
280.412,6,28,7352,12,158,25492,267,1277,16,678,18691,2085,6075
0.461,6,20,7229,13,334,38,663,2021,7,1209,70,1946,5208
446.731,1,6,336,6,28,89346,28,336,0,0,0,0,0
31.552,6,7,396,1,0,0,0,60,6,0,6274,0,336
5.007,17,4,558,2,36,5002,36,128,2,187,5001,187,430
300.831,6,39,9935,21,590,15041,1440,4413,18,399,508,1440,5522
296.721,6,48,8084,22,116,14127,517,2111,26,417,11867,1418,5973
0.489,6,121,87177,55,131,9,232,2729,66,1341,7,1420,84448
4.921,17,28,7929,11,241,492,1350,2967,17,263,291,1350,4962
1.317,6,23,7952,12,164,101,267,1288,11,1216,112,3819,6664
0.033,6,5,248,4,0,0,0,208,1,0,0,0,40
1674.371,1,7,392,7,28,279061,28,392,0,0,0,0,0
1738.435,6,87,6322,58,31,30498,31,3915,29,31,62086,31,2407
1794.361,17,144,11520,72,48,25272,48,5472,72,56,25272,56,6048
317.047,6,102,35698,55,549,5871,1360,24743,47,323,6889,3289,10955
1624.716,1,7,742,7,78,270786,78,742,0,0,0,0,0
368.664,6,25,1651,17,177,23041,177,1117,8,110,9397,110,534
74.429,6,735,342597,380,839,196,1152,322551,355,417,209,1179,20046
147.16,6,46,13963,23,633,6689,1360,6058,23,536,6681,1360,7905
1771.31,6,101,9344,66,65,27250,65,5577,35,59,52094,59,3767
0.501,17,3,451,2,39,469,39,134,1,289,0,289,317
0.108,17,2,410,1,46,0,46,74,1,308,0,308,336
400.991,17,8,901,8,84,57284,355,901,0,0,0,0,0
0.489,6,11,2032,5,288,119,288,508,6,424,53,434,1524
377.337,6,18,1242,14,180,29025,180,916,4,110,20068,110,326
39.801,6,39,10313,19,783,495,1360,4711,20,399,2085,1360,5602
10.955,6,85,24621,44,550,254,1152,18840,41,459,266,1179,5781
1794.859,17,87,3648,86,14,21115,14,3612,1,8,0,8,36
3.997,17,5,754,4,32,1014,32,240,1,486,0,486,514
156.306,17,21,3252,11,48,15626,48,836,10,213,15711,308,2416
847.793,6,62,5066,35,60,24930,205,2788,27,36,32600,98,2278
919.337,6,56,4719,36,65,26266,65,2610,20,68,48381,247,2109
1.138,6,58,18034,28,707,42,1360,8925,30,438,38,1360,9109
1.531,6,50,18990,28,929,56,1460,13289,22,437,62,2615,5701
371.537,6,25,1651,17,177,23221,177,1117,8,110,9243,110,534
288.647,17,4,352,2,60,288645,60,176,2,60,288646,60,176
5.017,17,4,558,2,36,5012,36,128,2,187,5012,187,430
2.749,17,31,9964,15,267,193,1350,4427,16,318,180,1350,5537
3.369,17,5,295,5,31,842,31,295,0,0,0,0,0
0.098,17,2,176,1,48,0,48,76,1,72,0,72,100
0.108,17,2,152,1,48,0,48,76,1,48,0,48,76
1790.732,1,266,14896,266,28,6757,28,14896,0,0,0,0,0
4.701,6,35,6209,19,206,261,314,2824,16,456,297,1152,3385
1787.327,6,104,8308,68,64,26676,64,4896,36,58,51064,58,3412
0.125,17,2,904,2,424,125,548,904,0,0,0,0,0
7.506,6,46,8465,24,227,326,314,4142,22,491,330,1179,4323
42.606,17,6,528,3,48,21298,48,228,3,72,21299,72,300
286.61,17,4,240,2,32,286609,32,120,2,32,286609,32,120
6.193,6,40,7309,21,218,309,314,3463,19,513,329,1179,3846
1796.865,1,345,28980,345,56,5223,56,28980,0,0,0,0,0
0.552,6,28,9248,13,282,46,769,1814,15,829,35,1368,7434
280.318,6,30,7432,13,158,23359,267,1317,17,543,17514,1300,6115
1.494,6,49,21357,28,972,55,1460,15741,21,476,62,2615,5616
100.011,6,918,454224,506,836,198,1152,432612,412,427,242,1179,21612
1.216,6,24,5211,12,137,110,267,1172,12,592,106,1467,4039
10.123,17,38,11694,12,447,919,1350,5705,26,202,403,1350,5989
49.744,6,57,22164,24,992,2162,1440,15909,33,368,1456,1440,6255
1740.505,17,29,30539,29,1025,62160,1028,30539,0,0,0,0,0
61.348,6,37,15834,22,790,2921,1448,9055,15,665,4362,1448,6779
380.23,6,17,1236,13,226,31685,226,910,4,110,20135,110,326
1.321,6,48,19667,27,924,50,1360,14051,21,476,57,2715,5616
5.029,17,4,288,2,36,4997,36,128,2,52,4996,52,160
21.219,6,17,3314,10,210,2356,210,960,7,664,3536,904,2354
1.236,6,8,342,4,0,412,0,164,4,7,268,7,178
1785.532,6,357,23957,208,84,8625,981,13372,149,75,12064,485,10585
4.558,6,3,144,2,0,4558,0,92,1,0,0,0,52
9.111,6,18,6242,8,152,1301,267,782,10,722,984,1179,5460
1.154,6,227,167120,125,1373,9,1432,158807,102,467,11,1871,8313
0.567,6,23,7451,14,275,43,674,2115,9,1212,66,1946,5336
174.333,6,65779,64723258,22363,334,7,338,1206306,43416,1411,4,4224,63516952
1.6,6,51,20253,28,893,59,1360,14557,23,433,63,1360,5696
1800.0,6,232,18216,89,74,20113,336,8857,143,49,12676,143,9359
359.744,6,150,120255,97,1319,3747,1448,107998,53,632,2447,1448,12257
1.554,6,26,7240,14,661,119,1408,5364,12,248,139,580,1876
2.932,6,27,4701,14,197,225,314,2145,13,508,223,1179,2556
0.251,17,2,2752,2,1348,251,1348,2752,0,0,0,0,0
106.773,6,24,9543,12,410,118,922,1742,12,913,9694,1456,7801
86.27,6,74,50998,47,1180,1875,1408,41455,27,903,2369,2816,9543
1726.861,17,12,498,11,14,172686,14,462,1,8,0,8,36
1773.23,6,180,15480,120,69,14901,69,8940,60,69,30052,69,6540
285.166,6,29,3092,12,321,25923,321,1607,17,83,17822,83,1485
20.92,6,24,6717,12,181,1901,267,1212,12,836,1900,3436,5505
300.862,6,48,10403,24,433,13080,910,3206,24,327,428,1460,7197
1763.426,2,14,448,14,8,135648,8,448,0,0,0,0,0
28.614,6,26,6994,16,124,1907,159,1600,10,811,3178,1675,5394
1772.184,6,181,15520,120,69,14892,69,8940,61,69,29535,69,6580
2.382,6,29,10389,17,373,148,851,1803,12,1012,208,1420,8586
1700.492,17,12,498,11,14,170049,14,462,1,8,0,8,36
1.006,6,29,6149,14,154,77,267,1644,15,780,66,1460,4505
65.99,6,12,492,6,0,13198,0,244,6,0,12900,0,248
23.464,17,4,488,4,94,7821,94,488,0,0,0,0,0
280.35,6,29,7392,13,158,23362,267,1317,16,603,18682,1400,6075
8.713,6,25,7707,13,256,726,721,1805,12,903,593,2840,5902
280.095,6,28,7352,13,158,23341,267,1317,15,678,19999,4200,6035
0.019,17,2,290,1,40,0,40,68,1,194,0,194,222
1781.001,6,115,13820,75,82,24067,507,5989,40,163,45663,1452,7831
1786.837,6,107,9036,70,71,25896,293,5303,37,64,49631,247,3733
5.237,6,13,6362,5,275,1309,275,479,8,926,399,2840,5883
60.201,2,2,64,2,8,60201,8,64,0,0,0,0,0
19.633,1,2,112,2,28,19633,28,112,0,0,0,0,0
0.01,17,3,507,2,39,4,39,134,1,345,0,345,373
1786.686,6,104,8376,68,65,26666,65,4930,36,59,51045,59,3446
1.773,6,27,8799,16,277,118,565,1477,11,859,157,1380,7322
0.017,17,4,352,2,37,0,37,130,2,83,3,89,222
191.643,17,6,528,3,60,95820,60,264,3,60,95821,60,264
15.13,17,4,240,2,32,15129,32,120,2,32,15129,32,120
2.746,6,2,88,2,0,0,0,88,0,0,0,0,0
7.232,6,1700,1591127,1090,1383,6,1408,1554743,610,931,11,2816,36384
822.526,1,46,2576,46,28,18278,28,2576,0,0,0,0,0
1797.915,6,195,19377,128,105,14156,469,12074,67,69,27234,69,7303
1719.6,17,13,534,11,14,171942,14,462,2,8,1719423,8,72
18.981,17,39,20988,18,754,1114,1350,14082,21,300,947,1350,6906
230.396,6,29,5170,15,166,16456,501,1600,14,375,17715,1420,3570
0.011,17,2,441,1,37,0,37,65,1,348,0,348,376
16.505,17,24,6015,10,257,1829,1350,2853,14,197,1266,1350,3162
70.283,6,36,8084,11,155,7028,267,1226,25,278,2918,1460,6858
1769.209,1,58,4872,58,56,31038,56,4872,0,0,0,0,0
0.776,6,4,340,1,0,0,0,40,3,90,346,90,300
1.14,6,25,8056,12,164,88,267,1288,13,869,80,1408,6768
131.94,17,6,2016,6,308,26388,308,2016,0,0,0,0,0
0.04,17,2,912,1,308,0,308,336,1,548,0,548,576
18.351,6,3343,3121160,2148,1374,8,1408,3054356,1195,776,15,1408,66804
1797.077,1,58,4872,58,56,31527,56,4872,0,0,0,0,0
3.926,17,5,290,5,30,981,30,290,0,0,0,0,0
1132.878,17,23,8009,23,320,51494,376,8009,0,0,0,0,0
1212.833,6,250,29969,125,181,9780,1133,24256,125,31,9776,31,5713
1772.846,6,180,15480,120,69,14897,69,8940,60,69,30046,69,6540
0.817,17,2,148,1,32,0,32,60,1,60,0,60,88
1798.194,6,276,26245,161,75,11238,267,11504,115,125,15740,1452,14741
38.838,6,53,13352,26,879,620,1360,7315,27,290,1487,1360,6037
28.143,6,14,6280,5,204,7035,204,460,9,1331,3515,1438,5820
24.066,6,9,372,5,0,6013,0,204,4,0,8012,0,168
607.443,6,6317,5501241,3268,392,185,420,192286,3049,1692,175,14080,5308955
282.014,6,29,7392,13,158,23501,267,1317,16,603,18779,2036,6075
1798.108,6,376,26217,217,98,8324,469,15372,159,69,11379,69,10845
0.51,6,27,8996,13,243,42,611,1656,14,941,36,1368,7340
1.014,17,4,368,2,32,970,32,120,2,96,933,96,248
1773.682,6,182,15698,120,69,14904,69,8940,62,69,29074,69,6758
1799.418,17,448,39896,403,35,4476,288,25676,45,288,40020,288,14220
1774.163,1,60,5040,60,56,30070,56,5040,0,0,0,0,0
5.014,6,39,7285,19,218,278,314,3383,20,516,250,1179,3902
0.122,17,2,410,1,46,0,46,74,1,308,0,308,336
77.75,6,36,7856,13,125,2657,267,1535,23,414,3533,1460,6321
0.186,17,2,245,1,32,0,32,60,1,157,0,157,185
280.159,6,26,7272,13,158,23346,267,1317,13,905,23346,4845,5955
1791.185,1,342,28728,342,56,5252,56,28728,0,0,0,0,0
300.884,6,42,13568,23,881,13676,1460,8006,19,399,483,1460,5562
0.431,6,10,1669,6,551,86,947,1346,4,159,143,159,323
39.35,6,26,6798,11,268,3935,517,1374,15,386,2744,2417,5424
39.084,17,4,352,2,60,39082,60,176,2,60,39083,60,176
665.271,6,78,10529,42,304,16226,304,7352,36,83,18973,83,3177
1783.972,6,375,26177,217,98,8259,469,15372,158,69,11362,69,10805
1741.429,6,89,6469,59,31,30024,31,3979,30,31,60037,31,2490
1784.431,6,356,22520,208,69,8620,69,12460,148,69,12137,69,10060
361.375,6,46,10135,29,266,12906,1360,4653,17,435,537,2667,5482
0.159,6,3,120,1,0,0,0,40,2,0,159,0,80
345.687,6,3387,1717016,1902,838,181,1152,1636233,1485,362,232,1179,80783
36.461,6,23,3294,14,183,2804,517,1673,9,381,4429,499,1621
499.391,6,23,2677,17,342,31211,342,1726,6,233,89079,233,951
1794.908,17,87,3648,86,14,21116,14,3612,1,8,0,8,36
1.021,6,24,6439,13,311,83,893,2079,11,783,100,1460,4360
0.89,6,27,6040,13,150,74,267,1575,14,780,61,1460,4465
1744.697,2,30,960,30,8,60161,8,960,0,0,0,0,0
41.645,17,16,1216,16,48,2776,48,1216,0,0,0,0,0
317.694,1,18,1008,18,28,18687,28,1008,0,0,0,0,0
1.445,17,20,12191,9,664,170,1350,6236,11,513,137,1350,5955
0.01,6,2,87,1,0,0,0,40,1,7,0,7,47
0.015,17,2,263,1,36,0,36,64,1,171,0,171,199
276.374,1,7,392,7,28,46062,28,392,0,0,0,0,0
0.009,6,2,104,1,0,0,0,40,1,0,0,0,64
541.497,2,9,288,9,8,67687,8,288,0,0,0,0,0
2.926,17,3,468,3,128,1463,128,468,0,0,0,0,0
31.605,6,7,336,1,0,0,0,48,6,0,6318,0,288
371.422,6,50,6671,25,112,15469,722,2653,25,194,15468,1408,4018
10.578,6,7,380,4,0,3526,0,216,3,0,5277,0,164
8.09,17,6,528,3,48,4038,48,228,3,72,4038,72,300
300.647,6,37,8612,19,336,16702,999,2138,18,441,499,1460,6474
365.871,2,4,128,4,8,121957,8,128,0,0,0,0,0
116.257,17,8,2688,8,308,16608,308,2688,0,0,0,0,0
1701.87,1,8,848,8,78,243124,78,848,0,0,0,0,0
1799.923,1,16,896,16,28,119994,28,896,0,0,0,0,0
1778.163,17,140,11200,70,48,25770,48,5320,70,56,25770,56,5880
2.14,6,21,3885,12,234,194,564,1556,9,463,245,1343,2329
1744.797,6,100,7866,66,45,26843,205,4902,34,35,52861,98,2964
1745.161,6,103,7755,66,38,26848,205,4663,37,33,48471,98,3092
1791.999,6,364,25392,212,100,8492,469,14896,152,69,11867,69,10496
1744.648,2,30,960,30,8,60160,8,960,0,0,0,0,0
1.511,6,48,18832,27,864,58,1360,13216,21,433,65,1360,5616
4.628,17,4,240,2,32,4627,32,120,2,32,4627,32,120
28.049,17,4,288,2,36,28038,36,128,2,52,28033,52,160
1772.583,6,180,15480,120,69,14895,69,8940,60,69,30035,69,6540
1799.465,6,347,22022,201,69,8997,69,12042,146,69,12410,69,9980
1796.057,6,361,22858,210,69,8593,69,12678,151,69,11973,69,10180
1792.046,1,58,4872,58,56,31439,56,4872,0,0,0,0,0
0.854,6,37,8351,19,271,47,739,1878,18,441,41,1360,6473
1787.699,6,356,22520,208,69,8636,69,12460,148,69,12147,69,10060
1752.724,6,98,7421,64,38,27821,205,4528,34,33,53102,98,2893
1787.139,6,110,8876,71,66,25530,66,5216,39,60,47027,60,3660
240.249,6,54,17785,29,746,8579,1418,14958,25,189,10009,580,2827
255.473,6,28,7306,6,154,51094,267,712,22,335,12163,2840,6594
7.667,6,50,17763,25,993,37,1360,9038,25,428,311,1360,8725
4.275,6,23,6554,11,293,419,517,1461,12,744,382,1368,5093
0.026,6,11,572,0,0,0,0,0,11,0,0,0,572
383.708,6,55,13303,25,473,2446,1270,6217,30,267,13228,1420,7086
1.055,17,2,170,1,37,0,37,65,1,77,0,77,105
22.397,6,24,4675,11,256,2239,722,1592,13,342,1505,1448,3083
101.729,17,3,984,3,300,50864,300,984,0,0,0,0,0
1.59,17,3,1176,3,364,795,364,1176,0,0,0,0,0
5.139,17,4,384,2,44,5007,44,144,2,92,5005,92,240
1775.607,6,169,13475,88,99,20409,208,9181,81,31,22189,31,4294
1781.941,6,354,22440,207,69,8650,69,12420,147,69,12204,69,10020
1719.415,17,12,498,11,14,171941,14,462,1,8,0,8,36
1790.18,6,156,16442,84,105,21568,722,9118,72,81,25207,1448,7324
0.118,17,4,284,2,32,59,32,120,2,54,62,60,164
254.435,6,32,8952,14,158,19571,267,1357,18,624,14963,1400,7595
1152.886,6,234,14811,136,69,8539,69,8200,98,69,11881,69,6611
1764.124,2,13,416,13,8,147010,8,416,0,0,0,0,0
21.233,6,27,7177,13,155,1769,267,1306,14,530,1632,3417,5871
1773.123,6,180,15480,120,69,14900,69,8940,60,69,30048,69,6540
4.885,6,40,7309,21,218,244,314,3463,19,513,256,1179,3846
1.864,6,2,87,1,0,0,0,40,1,7,0,7,47
34.133,17,3,228,3,48,17066,48,228,0,0,0,0,0
7.87,6,17,10597,6,275,1574,275,519,11,1070,765,2840,10078
64.199,1,4,336,0,0,0,0,0,4,56,21399,56,336
1738.615,6,87,6322,58,31,30502,31,3915,29,31,62092,31,2407
16.343,17,33,9893,13,363,1359,1350,5095,20,211,858,1350,4798
1.442,6,30,6149,15,141,103,267,1593,15,564,97,1420,4556
14.632,6,21,6825,12,275,1330,275,1038,9,1353,1198,1440,5787
81.722,6,33,18709,18,702,51,1360,4967,15,1313,5827,3527,13742
0.176,17,2,2754,2,1349,176,1349,2754,0,0,0,0,0
1795.075,17,447,39864,402,35,4476,288,25644,45,288,40020,288,14220
1740.525,17,29,6815,29,207,62161,207,6815,0,0,0,0,0
1777.424,17,73,3060,72,14,25034,14,3024,1,8,0,8,36
145.965,2,2,64,2,8,145965,8,64,0,0,0,0,0
1795.442,6,360,24156,210,88,8590,469,13878,150,69,12047,69,10278
240.211,6,56,20294,30,832,8282,1418,17386,26,193,9607,580,2908
29.282,6,36,9504,17,289,1830,721,3291,19,681,1570,1440,6213
1.56,6,47,19047,27,882,60,1360,13471,20,476,72,2715,5576
9.552,6,79,24365,41,533,238,1152,18704,38,459,250,1179,5661
293.321,17,7,2850,7,379,48886,392,2850,0,0,0,0,0
209.947,6,27,7312,13,158,17495,267,1317,14,775,16146,4836,5995
1794.106,17,80,3354,79,14,23001,14,3318,1,8,0,8,36
1747.333,6,172,10108,86,40,20556,208,5769,86,31,20553,31,4339
1.775,6,32,6084,16,111,118,267,1539,16,650,102,1380,4545
1.265,6,43,14685,24,741,55,1360,9149,19,476,60,2715,5536
312.46,6,10,554,5,106,78115,106,314,5,0,3847,0,240
1680.514,1,15,840,15,28,120036,28,840,0,0,0,0,0
1797.841,1,345,28980,345,56,5226,56,28980,0,0,0,0,0
0.279,6,21,4415,12,165,25,456,1446,9,415,31,888,2969
0.016,17,2,503,1,40,0,40,68,1,407,0,407,435
0.168,17,4,284,2,32,33,32,120,2,54,157,60,164
11.882,6,25,8453,13,275,990,275,1078,12,983,877,1420,7375
1120.964,17,10,2745,5,30,280238,30,290,5,463,280238,463,2455
85.914,2,2,64,2,8,85914,8,64,0,0,0,0,0
1.024,17,4,240,2,32,1023,32,120,2,32,1023,32,120
1782.723,6,104,8376,68,65,26607,65,4930,36,59,50932,59,3446
83.072,6,23,9502,12,301,81,595,1428,11,1088,8293,3928,8074
62.719,6,105,66550,43,722,1489,1448,12358,62,1040,1025,1448,54192
1680.502,17,12,498,11,14,168050,14,462,1,8,0,8,36
5.6,6,39,7285,21,218,280,314,3463,18,516,314,1179,3822
1624.401,6,148,31225,82,243,20054,1040,18886,66,461,6637,2007,12339
1796.888,1,241,13496,241,28,7487,28,13496,0,0,0,0,0
68.233,6,430,204223,228,836,300,1152,192359,202,420,338,1152,11864
1775.45,17,140,11200,70,48,25731,48,5320,70,56,25731,56,5880
81.912,6,22,10322,12,397,73,884,1717,10,1365,9084,3928,8605
1783.326,6,204,18369,123,70,14617,96,9769,81,56,22286,98,8600
38.22,17,127,19383,63,129,614,1177,9946,64,119,606,1252,9437
1.623,6,48,19274,27,896,62,1360,13658,21,476,71,2720,5616
0.311,6,13,1794,7,90,51,174,465,6,1085,62,1085,1329
1607.44,1,20,1120,20,28,84602,28,1120,0,0,0,0,0
1778.636,6,425,25379,213,69,8389,69,12660,212,33,8429,64,12719
19.567,6,38,10416,19,812,490,1460,4854,19,435,1077,2567,5562
1632.795,1,8,448,8,28,233256,28,448,0,0,0,0,0
48.334,6,32,8952,14,158,3718,267,1357,18,624,2840,1400,7595
1793.089,6,357,22836,205,69,8789,69,12340,152,69,11874,69,10496
6.28,1,4,224,4,28,2093,28,224,0,0,0,0,0
1226.158,1,30,2520,0,0,0,0,0,30,56,42281,56,2520
9.394,6,2080,1943678,1331,1382,6,1408,1900066,749,776,12,1408,43612
0.033,6,11,911,6,181,6,181,489,5,77,4,133,422
1797.823,17,447,39864,402,35,4483,288,25644,45,288,40023,288,14220
12.803,6,24,6993,13,275,1066,275,1078,11,910,780,1440,5915
0.857,6,10,1687,7,100,142,100,384,3,1179,307,1179,1303
240.281,6,46,9232,23,524,10921,1418,5934,23,209,10921,618,3298
0.541,6,23,7428,14,273,41,663,2104,9,1209,62,1946,5324
0.001,1,2,112,2,28,1,28,112,0,0,0,0,0
1740.471,17,29,19517,29,645,62159,645,19517,0,0,0,0,0
3.378,6,44,17639,22,525,160,1440,3586,22,774,150,1440,14053
1770.47,6,110,10026,70,64,25658,64,5904,40,58,45387,58,4122
1745.89,1,56,4704,56,56,31743,56,4704,0,0,0,0,0
0.139,6,7,423,4,43,33,43,259,3,0,40,0,164
1796.081,6,367,25650,214,99,8432,469,15045,153,69,11816,69,10605
1777.089,17,79,3312,78,14,23079,14,3276,1,8,0,8,36
1704.797,1,8,448,8,28,243542,28,448,0,0,0,0,0
20.173,6,22,5755,13,107,1681,159,1138,9,828,2519,1675,4617
0.138,17,2,132,1,30,0,30,58,1,46,0,46,74
127.693,6,17,4065,3,92,255,92,256,14,256,9808,1448,3809
0.818,6,20,5948,11,281,81,544,1288,9,716,92,1420,4660
1.543,6,47,19570,27,920,59,1360,13994,20,476,70,2715,5576
1756.377,6,135,8287,75,42,23734,208,4957,60,31,29763,31,3330
0.594,17,22,6525,9,330,71,1350,3225,13,225,46,1350,3300
6.226,6,1247,1136136,778,1383,7,1408,1107084,469,931,12,2816,29052
12.417,6,2069,1945287,1308,1408,9,1448,1901051,761,776,16,1448,44236
317.096,6,48,11941,20,267,16689,1305,3236,28,360,11737,1629,8705
208.205,6,31,6451,19,168,11566,516,1775,12,465,18917,1452,4676
126.101,2,2,64,2,8,126101,8,64,0,0,0,0,0
1751.898,6,97,7307,63,38,28256,205,4476,34,33,53078,98,2831
1785.523,6,367,25719,211,99,8502,469,14925,156,69,11517,69,10794
282.09,6,34,7661,15,143,20149,267,1466,19,543,15669,1380,6195
14.287,6,21,6825,12,275,1298,275,1038,9,1353,1159,1440,5787
129.011,17,4,352,2,60,129010,60,176,2,60,129010,60,176
1661.912,1,7,392,7,28,276985,28,392,0,0,0,0,0
6.282,6,42,7389,22,218,299,314,3503,20,513,315,1179,3886
1793.148,17,140,11200,70,48,25987,48,5320,70,56,25987,56,5880
19.919,6,29,12691,12,142,1810,174,910,17,1008,1239,1420,11781
1796.474,17,449,39928,404,35,4457,288,25708,45,288,40020,288,14220
5.149,6,33,6145,18,206,302,314,2784,15,551,347,1179,3361
1788.645,17,86,3606,85,14,21293,14,3570,1,8,0,8,36
1780.801,1,60,5040,60,56,30183,56,5040,0,0,0,0,0
1776.643,17,140,11200,70,48,25748,48,5320,70,56,25748,56,5880
70.398,6,32,7515,14,155,5415,267,1346,18,388,4140,1420,6169
0.777,6,25,8987,12,266,70,705,1698,13,943,57,1438,7289
4.345,17,3,2906,3,940,2172,1451,2906,0,0,0,0,0
0.169,6,10,1568,5,121,42,121,389,5,911,42,911,1179
1791.077,1,342,28728,342,56,5252,56,28728,0,0,0,0,0
7.9,17,6,456,6,48,1580,48,456,0,0,0,0,0
1.128,6,27,10234,15,616,63,1360,3716,12,1004,85,3494,6518
2.48,17,6,804,4,30,825,30,232,2,258,11,272,572
8.082,6,80,24757,41,561,202,1152,19056,39,413,206,1152,5701
1771.041,6,104,10567,68,87,26433,810,6524,36,63,50598,191,4043
1788.333,17,87,3648,86,14,21039,14,3612,1,8,0,8,36
2.556,6,45,9553,23,266,116,564,2576,22,404,114,1360,6977
2.714,17,23,6627,9,252,339,1350,2524,14,265,133,1350,4103
183.736,17,11,459,10,13,20415,14,415,1,16,0,16,44
260.908,17,2,908,2,426,260908,687,908,0,0,0,0,0
1783.402,6,104,8435,69,65,26226,65,4970,35,59,52450,59,3465
240.272,6,52,17576,27,786,9240,1418,14780,25,186,10010,580,2796
0.559,6,6,716,3,302,135,302,458,3,102,146,102,258
0.228,6,4,493,2,241,228,241,321,2,92,2,92,172
0.055,17,2,214,1,39,0,39,67,1,119,0,119,147
0.012,17,2,398,1,32,0,32,60,1,310,0,310,338
0.824,17,12,6505,6,615,164,1350,3860,6,412,87,1350,2645
20.328,6,22,5470,13,107,1694,159,1126,9,773,2539,1418,4344
40.062,17,5,4754,5,922,10015,1451,4754,0,0,0,0,0
56.752,6,39,13722,14,327,1027,1189,2535,25,565,2364,1420,11187
1769.913,1,56,4704,56,56,32180,56,4704,0,0,0,0,0
0.453,6,12,3462,6,75,90,75,395,6,1373,90,1448,3067
1795.764,17,142,11360,71,48,25653,48,5396,71,56,25653,56,5964
53.254,1,4,224,4,28,17751,28,224,0,0,0,0,0
1.966,6,14,2351,8,188,280,245,700,6,703,340,1152,1651
1688.202,1,8,448,8,28,241171,28,448,0,0,0,0,0
1743.763,6,99,7411,63,38,28125,205,4476,36,33,49812,98,2935
114.671,1,20,560,20,0,0,0,560,0,0,0,0,0
40.284,6,42,9340,24,538,1751,1228,5551,18,203,2367,1282,3789
691.079,6,29,1937,20,330,36372,330,1378,9,83,30003,83,559
1681.127,1,15,840,15,28,120080,28,840,0,0,0,0,0
0.765,6,2,92,1,0,0,0,52,1,0,0,0,40
3.987,17,3,696,3,204,1993,204,696,0,0,0,0,0
4.0,17,4,232,4,30,1333,30,232,0,0,0,0,0
0.142,1,2,163,2,53,142,78,163,0,0,0,0,0
507.906,6,12,976,12,41,46173,62,976,0,0,0,0,0
1786.854,6,104,8504,69,66,26277,66,5004,35,60,52551,60,3500
636.009,17,48,3824,26,48,25440,48,1976,22,56,25467,56,1848
1782.992,6,104,8376,68,65,26611,65,4930,36,59,50939,59,3446
12.096,6,9,376,5,0,3022,0,204,4,0,4027,0,172
1799.412,17,3320,159360,1660,20,1084,20,79680,1660,20,1084,20,79680
1.72,6,27,10178,16,284,114,586,1498,11,1029,155,1420,8680
1772.233,6,180,15480,120,69,14892,69,8940,60,69,30034,69,6540
1224.111,6,207,22757,87,171,14233,1440,14034,120,61,10265,521,8723
61.739,6,65,42802,40,1166,1583,1448,34749,25,749,2562,1448,8053
1740.935,6,87,6322,58,31,30542,31,3915,29,31,62174,31,2407
0.358,17,2,154,1,33,0,33,61,1,65,0,65,93
2.796,17,4,390,2,44,2773,44,144,2,95,2772,95,246
4.248,17,5,290,5,30,1062,30,290,0,0,0,0,0
2.322,17,3,174,3,30,1161,30,174,0,0,0,0,0
1786.816,17,87,3648,86,14,21021,14,3612,1,8,0,8,36
240.37,6,45,8586,23,456,10925,1418,5768,22,208,11445,580,2818
1681.447,1,15,840,15,28,120103,28,840,0,0,0,0,0
0.547,17,3,543,2,39,445,39,134,1,381,0,381,409
1789.294,6,5367,4633285,2351,130,761,353,138894,3016,1472,593,2816,4494391
0.012,17,2,224,1,52,0,52,80,1,116,0,116,144
13.026,6,25,7097,12,155,1184,267,1266,13,589,1084,3426,5831
1741.299,6,93,6763,61,31,29021,31,4164,32,31,56170,31,2599
3.987,17,3,183,3,33,1993,33,183,0,0,0,0,0
97.609,17,8,2688,8,308,13944,308,2688,0,0,0,0,0
294.45,6,49,9583,24,178,12800,517,2706,25,504,12266,1418,6877
0.651,6,25,6044,12,164,59,453,1442,13,781,50,2224,4602
1.041,6,25,9552,14,350,80,1041,1992,11,1015,84,1460,7560
18.918,17,26,13087,15,698,1348,1350,10895,11,171,1888,1350,2192
20.17,6,20,5366,12,107,1833,159,1074,8,967,2880,1659,4292
280.487,6,30,7432,13,158,23373,267,1317,17,678,17526,2085,6115
127.753,6,35,5315,22,180,6083,722,2236,13,399,1274,1448,3079
240.34,6,43,9206,21,521,12015,1418,5790,22,251,11444,617,3416
0.112,6,9,1340,5,145,28,145,349,4,827,29,827,991
5.512,6,556,480232,342,1341,16,1368,464428,214,776,24,1473,15804
0.647,6,8,440,5,0,161,0,268,3,0,315,0,172
5.005,17,4,288,2,36,5005,36,128,2,52,5004,52,160
13.715,6,16,2957,9,237,1714,585,1201,7,457,2258,580,1756
5.451,6,39,7269,21,218,272,314,3463,18,513,305,1179,3806
1740.491,17,29,30624,29,1028,62160,1028,30624,0,0,0,0,0
0.04,17,4,642,2,44,0,44,144,2,221,36,324,498
6.556,17,6,360,3,32,3277,32,180,3,32,3277,32,180
0.358,17,3,507,2,39,98,39,134,1,345,0,345,373
10.305,17,20,8000,9,513,1287,1350,4872,11,256,1027,1350,3128
1797.578,6,447,26224,238,69,7584,69,13660,209,34,8640,64,12564
1785.857,6,458,26664,249,69,7201,69,14100,209,34,8585,64,12564
0.065,6,10,1903,5,657,16,657,925,5,710,16,710,978
0.217,6,3,144,2,0,217,0,92,1,0,0,0,52
260.712,17,5,380,5,48,65178,48,380,0,0,0,0,0
1786.384,17,87,3648,86,14,21016,14,3612,1,8,0,8,36
1707.042,1,8,448,8,28,243863,28,448,0,0,0,0,0
0.315,17,4,314,2,31,145,31,118,2,70,0,70,196
26.157,1,4,224,4,28,8719,28,224,0,0,0,0,0
298.843,1,4,224,4,28,99614,28,224,0,0,0,0,0
100.382,6,21,7932,11,511,89,1194,2005,10,919,11134,1631,5927
1754.217,6,182,11017,91,45,19491,208,6447,91,31,19488,31,4570
300.814,6,38,11418,20,634,15832,1408,4281,18,442,702,2772,7137
1772.139,6,181,15589,120,69,14891,69,8940,61,69,29533,69,6649
3.329,17,5,295,5,31,832,31,295,0,0,0,0,0
1787.905,6,395,27632,224,102,8017,469,16328,171,67,10517,69,11304
1797.005,6,369,25799,215,99,8397,469,15085,154,69,11743,69,10714
1764.677,2,15,480,15,8,126048,8,480,0,0,0,0,0
167.955,6,28,7352,13,158,13996,267,1317,15,678,11994,3436,6035
11.498,6,1811,1580431,1098,1384,10,1420,1547261,713,459,16,1883,33170
0.089,17,2,259,1,53,0,53,81,1,150,0,150,178
3.37,6,5,232,2,0,3370,0,88,3,0,1524,0,144
1770.192,6,217,14892,82,46,21851,46,6318,135,46,13210,46,8574
1740.753,17,28,29568,28,1028,64472,1028,29568,0,0,0,0,0
80.495,1,6,336,6,28,16099,28,336,0,0,0,0,0
280.22,17,4,1098,2,30,280209,30,116,2,463,280210,463,982
0.906,17,2,685,1,308,0,308,336,1,321,0,321,349
232.022,17,12,1764,6,48,46403,48,456,6,190,46403,308,1308
180.535,2,2,64,2,8,180535,8,64,0,0,0,0,0
3.02,17,2,134,2,39,3020,39,134,0,0,0,0,0
37.771,17,11,836,11,48,3777,48,836,0,0,0,0,0
0.998,6,18,10930,11,134,99,134,758,7,3264,166,3448,10172
1679.527,17,12,498,11,14,167952,14,462,1,8,0,8,36
7.176,6,48,13096,23,186,326,721,2600,25,678,278,1420,10496
9.894,17,5,5602,5,1092,2473,1451,5602,0,0,0,0,0
1680.518,1,15,870,15,30,120037,30,870,0,0,0,0,0
316.98,6,127,36661,63,511,5112,1360,25072,64,310,5028,1929,11589
18.754,17,466,512731,95,113,199,1350,13428,371,1317,50,1350,499303
2.992,17,2,176,2,60,2992,60,176,0,0,0,0,0
1798.723,6,355,22480,207,69,8731,69,12420,148,69,12235,69,10060
1780.222,17,411,110089,411,239,4342,373,110089,0,0,0,0,0
300.791,6,29,8089,17,204,18799,467,1744,12,634,5993,2688,6345
0.705,6,129,102583,83,1331,8,1420,96522,46,467,15,1883,6061
16.03,17,33,14523,17,636,999,1350,11300,16,173,1066,1350,3223
3.2,17,5,456,4,60,1066,60,352,1,76,0,76,104
1744.684,2,30,960,30,8,60161,8,960,0,0,0,0,0
1772.348,6,180,15480,120,69,14893,69,8940,60,69,30037,69,6540
1798.677,17,449,39928,404,35,4463,288,25708,45,288,40018,288,14220
0.32,6,27,9067,13,252,26,647,1716,14,945,24,1408,7351
1772.976,6,180,15480,120,69,14898,69,8940,60,69,30048,69,6540
1740.418,17,30,31680,30,1028,60014,1028,31680,0,0,0,0,0
300.66,6,37,8526,20,315,15824,882,2093,17,478,532,2720,6433
14.356,17,4,352,2,48,14347,48,152,2,72,14347,72,200
1798.234,17,142,11360,71,48,25688,48,5396,71,56,25688,56,5964
3.049,17,8,1718,4,37,1012,37,260,4,336,1012,348,1458
587.923,17,5,1680,5,308,146980,308,1680,0,0,0,0,0
1.932,17,3,1167,3,361,966,361,1167,0,0,0,0,0
1791.108,6,356,22520,208,69,8652,69,12460,148,69,12184,69,10060
0.153,17,8,2454,8,278,21,317,2454,0,0,0,0,0
0.922,6,13,1553,8,177,131,177,955,5,110,184,110,598
5.419,17,2,1430,2,687,5419,687,1430,0,0,0,0,0
61.125,17,7,532,7,48,10187,48,532,0,0,0,0,0
1.198,6,10,1687,7,100,199,100,384,3,1179,463,1179,1303
1.066,6,207,160594,123,1339,8,1414,149710,84,682,12,3303,10884
294.773,6,34,8006,12,158,25479,267,1277,22,389,14035,2036,6729
135.861,17,80,20720,80,231,1719,388,20720,0,0,0,0,0
1771.564,6,84,4496,42,26,43207,26,2248,42,26,43207,26,2248
0.225,6,9,1343,5,145,56,145,349,4,830,44,830,994
1774.031,6,180,15480,120,69,14907,69,8940,60,69,30066,69,6540
1769.777,6,101,9278,66,64,27227,64,5544,35,58,52049,58,3734
76.258,6,9459,8944121,6204,1363,12,1408,8770149,3255,931,23,2801,173972
12.302,6,1934,1698939,1179,1387,10,1420,1664518,755,526,16,3303,34421
1.553,6,29,10370,17,367,97,835,1787,12,1012,133,1420,8583
1798.346,17,496,146446,496,267,3633,425,146446,0,0,0,0,0
13.293,6,25,17845,7,122,2215,122,446,18,1190,595,1360,17399
0.275,6,10,1669,6,551,54,947,1346,4,159,90,159,323
0.062,17,4,380,2,34,54,34,124,2,100,54,112,256
300.666,6,39,8511,20,291,15824,786,1997,19,441,473,1440,6514
252.644,2,3,96,3,8,126322,8,96,0,0,0,0,0
9.443,6,17,2425,9,211,1177,211,922,8,545,1343,904,1503
0.038,17,4,780,2,32,19,32,120,2,302,20,308,660
73.046,6,68,17796,34,187,2210,369,2212,34,592,2209,1360,15584
3.841,6,2,87,1,0,0,0,40,1,7,0,7,47
1.024,6,7,302,3,0,110,0,124,4,7,270,7,178
158.621,6,1437,754791,842,837,188,1152,724836,595,410,266,1179,29955
243.768,6,52,9046,24,326,10598,1021,3616,28,305,9028,748,5430
29.478,17,4,240,2,32,29477,32,120,2,32,29477,32,120
71.447,2,2,64,2,8,71447,8,64,0,0,0,0,0
7.009,6,70,27618,36,962,200,1440,16943,34,543,205,1440,10675
20.982,6,23,3298,12,183,1907,517,1561,11,381,2092,499,1737
6.908,6,31,3712,15,222,489,222,2602,16,231,456,231,1110
1787.914,6,356,22520,208,69,8637,69,12460,148,69,12162,69,10060
415.083,17,5,380,5,48,103770,48,380,0,0,0,0,0
0.0,1,1,36,1,8,0,8,36,0,0,0,0,0
0.425,6,80,95282,60,183,7,230,3737,20,5027,16,12672,91545
1794.327,6,379,26475,218,98,8268,469,15412,161,69,11214,69,11063
281.564,6,30,7432,13,158,23463,267,1317,17,543,17584,1400,6115
0.06,6,12,3704,6,171,10,171,491,6,964,11,1448,3213
280.45,6,30,7432,13,158,23370,267,1317,17,603,17522,2760,6115
0.445,6,9,1340,5,145,111,145,349,4,827,145,827,991
31.75,6,8,376,2,0,31750,0,88,6,0,6318,0,288
1564.535,17,122,9744,63,48,25234,48,4788,59,56,25224,56,4956
0.39,6,8,423,4,0,130,0,204,4,7,63,7,219
0.082,17,4,308,2,38,0,38,132,2,60,42,66,176
1775.81,6,181,15589,120,69,14922,69,8940,61,69,29587,69,6649
60.105,2,2,64,2,8,60105,8,64,0,0,0,0,0
11.766,6,1869,1609718,1136,1363,10,1380,1576156,733,421,16,1923,33562
21.277,17,18,5837,8,339,3039,1350,2943,10,261,2347,1350,2894
902.299,6,178,11329,104,69,8759,69,6299,74,69,12359,69,5030
0.907,6,37,8231,19,241,50,619,1757,18,441,45,1460,6474
1737.48,1,11,638,11,30,173748,30,638,0,0,0,0,0
0.081,17,2,154,1,33,0,33,61,1,65,0,65,93
0.031,6,10,690,6,71,6,71,391,4,83,5,83,299
1.632,6,42,8471,21,321,81,1164,2810,21,400,70,1460,5661
1798.045,17,180,14040,180,50,10044,50,14040,0,0,0,0,0
1783.667,1,69,5796,0,0,0,0,0,69,56,26230,56,5796
0.118,17,2,362,1,46,0,46,74,1,260,0,260,288
0.839,17,2,152,1,48,0,48,76,1,48,0,48,76
0.025,17,2,299,1,46,0,46,74,1,197,0,197,225
82.311,17,4,1344,4,308,27437,308,1344,0,0,0,0,0
3.061,17,8,1730,4,47,1018,47,300,4,329,1018,341,1430
1729.225,6,67,4852,42,33,42176,33,2889,25,31,72042,31,1963
369.539,6,23,1538,16,180,24635,180,1056,7,110,10382,110,482
1679.528,17,12,498,11,14,167952,14,462,1,8,0,8,36
377.787,2,3,96,3,8,188893,8,96,0,0,0,0,0
5.291,17,3,208,2,36,5004,36,128,1,52,0,52,80
9.18,6,20,13568,8,275,1311,275,874,12,1526,741,2760,12694
0.084,17,2,672,2,308,84,308,672,0,0,0,0,0
0.745,6,203,187668,98,190,7,230,5867,105,1711,6,8688,181801
1.106,6,39,11428,23,561,50,1188,7381,16,356,67,758,4047
0.043,17,4,624,2,64,42,64,184,2,192,5,192,440
229.352,6,28,7352,13,158,19112,267,1317,15,678,16379,2045,6035
1750.506,17,12,498,11,14,175050,14,462,1,8,0,8,36
0.051,6,6,272,3,0,20,0,136,3,0,20,0,136
240.265,6,55,19440,30,841,8284,1418,16723,25,176,10010,580,2717
1.413,6,24,8004,12,164,108,267,1288,12,1014,109,2491,6716
1784.532,17,351,56566,351,133,5098,391,56566,0,0,0,0,0
167.51,6,22,8563,11,549,79,1308,2119,11,856,16735,1360,6444
31.026,17,18,1584,9,48,3876,48,684,9,72,3876,72,900
1474.481,6,97,10835,58,88,23766,516,4790,39,131,38790,2642,6045
0.075,17,4,284,2,32,20,32,120,2,54,63,60,164
1770.3,6,103,9448,66,65,27235,65,5577,37,59,49172,59,3871
300.112,6,40,10384,21,658,14996,1440,4822,19,399,16663,1440,5562
1794.994,17,142,11360,71,48,25642,48,5396,71,56,25642,56,5964
618.979,6,140,39012,64,460,9825,1360,25609,76,207,8251,3289,13403
157.669,17,4,352,2,60,157668,60,176,2,60,157667,60,176
280.357,6,30,7432,13,158,23363,267,1317,17,543,17517,1300,6115
0.119,17,6,480,6,52,23,52,480,0,0,0,0,0
26.401,6,36,8333,18,369,521,792,1860,18,478,1543,2720,6473
0.034,17,2,184,1,32,0,32,60,1,96,0,96,124
1771.525,6,101,9410,66,66,27254,66,5610,35,60,52101,60,3800
0.897,17,4,560,2,64,895,64,184,2,160,777,160,376
1794.152,17,80,3354,79,14,23001,14,3318,1,8,0,8,36
74.778,6,32,8952,14,158,5752,267,1357,18,624,4396,1400,7595
371.195,6,23,1535,16,177,24746,177,1053,7,110,10383,110,482
28.363,6,11,3572,4,106,9449,106,274,7,1003,4723,1460,3298
780.834,6,76,8883,41,94,19516,722,3940,35,129,22960,1448,4943
1778.842,1,58,4872,0,0,0,0,0,58,56,31207,56,4872
28.153,6,1857,1493453,1040,1374,27,1380,1453426,817,387,34,1923,40027
155.078,6,40,8723,15,139,11076,267,1860,25,308,6461,1997,6863
1.432,6,47,19661,27,926,55,1360,14085,20,476,65,2715,5576
1772.843,6,182,15698,120,69,14897,69,8940,62,69,29057,69,6758
5.569,6,39,7269,21,218,278,314,3463,18,513,312,1179,3806
1783.968,6,381,24569,216,81,8297,469,13718,165,56,10877,69,10851
1791.888,17,400,49672,187,169,9633,1350,36893,213,31,8452,60,12779
15.497,6,13,5585,4,106,5161,106,274,9,823,1935,1420,5311
100.03,6,26,8384,13,201,60,290,1191,13,740,8324,1708,7193
8.189,6,13,3773,5,171,2045,171,439,8,964,1169,1448,3334
44.107,6,27,7177,13,155,3675,267,1306,14,530,3391,3417,5871
55.315,17,4,352,2,60,55314,60,176,2,60,55314,60,176
0.54,17,2,384,1,39,0,39,67,1,289,0,289,317
1133.829,2,7,224,7,8,188971,8,224,0,0,0,0,0
128.879,17,3,1000,3,305,64439,308,1000,0,0,0,0,0
18.368,6,1361,1218774,865,1329,21,1368,1184434,496,776,36,2736,34340
841.391,17,8,592,4,30,280446,30,232,4,62,280449,62,360
128.418,6,30,13489,15,488,361,1360,3087,15,1087,9162,2568,10402
0.123,17,2,2750,2,1347,123,1347,2750,0,0,0,0,0
7.688,6,713,670166,480,1331,15,1368,653386,233,776,32,1473,16780
1741.19,6,129,16877,79,86,22322,877,7652,50,169,35534,4023,9225
0.83,6,30,9475,17,451,51,1360,3421,13,788,53,1747,6054
28.831,17,4,352,2,60,28830,60,176,2,60,28830,60,176
5.149,6,36,6249,19,206,286,314,2824,17,548,301,1179,3425
4.314,6,37,7189,19,218,239,314,3383,18,513,238,1179,3806
1798.498,6,367,25650,214,99,8443,469,15045,153,69,11829,69,10605
3.065,6,8,339,4,0,1021,0,164,4,7,959,7,175
0.04,17,6,912,3,60,7,60,264,3,188,8,188,648
0.044,17,2,214,1,47,0,47,75,1,111,0,111,139
33.615,6,33,5245,16,154,2241,722,1911,17,305,2088,2026,3334
64.546,6,22,900,11,0,5546,0,448,11,0,6449,0,452
1743.564,6,97,7307,63,38,28122,205,4476,34,33,52821,98,2831
1790.919,6,362,22898,210,69,8568,69,12678,152,69,11860,69,10220
1782.682,6,123,9888,78,66,23151,66,5628,45,60,40510,60,4260
0.046,17,3,1552,3,489,23,517,1552,0,0,0,0,0
240.324,6,43,8395,22,449,11443,1402,5648,21,205,12015,580,2747
1.012,17,16,9264,8,468,144,1350,3972,8,633,106,1350,5292
1772.435,1,60,5040,60,56,30041,56,5040,0,0,0,0,0
120.137,17,4,240,2,32,120135,32,120,2,32,120136,32,120
1794.0,17,66,2766,65,14,28031,14,2730,1,8,0,8,36
79.756,6,32,8952,14,158,6135,267,1357,18,624,4682,1400,7595
1.659,6,8,335,4,0,553,0,164,4,7,289,7,171
1785.402,1,58,4872,58,56,31322,56,4872,0,0,0,0,0
3.418,17,10,1450,5,40,846,40,340,5,194,845,194,1110
0.486,6,12,1653,6,288,90,288,548,6,426,58,434,1105
41.614,17,4,240,2,32,41613,32,120,2,32,41613,32,120
0.074,17,4,420,2,33,0,33,122,2,121,1,145,298
152.127,6,42,9367,16,421,10132,685,2357,26,297,6079,1440,7010
1771.559,1,58,4872,58,56,31079,56,4872,0,0,0,0,0
4.364,6,35,6209,19,206,242,314,2824,16,548,274,1179,3385
171.14,6,38,15904,23,792,7779,1448,9126,15,665,4364,1448,6778
25.243,6,3564,3273901,2270,1362,11,1408,3201949,1294,776,19,1408,71952
1763.52,2,14,448,14,8,135655,8,448,0,0,0,0,0
0.006,17,2,403,1,29,0,29,57,1,318,0,318,346
1.498,6,53,23889,30,997,51,1460,18193,23,476,59,2615,5696
0.022,6,13,3980,7,88,3,88,388,6,1670,4,1880,3592
2.17,17,3,174,3,30,1085,30,174,0,0,0,0,0
1750.641,17,12,498,11,14,175064,14,462,1,8,0,8,36
214.571,17,4,352,2,60,214570,60,176,2,60,214570,60,176
1679.617,2,19,608,19,8,93312,8,608,0,0,0,0,0
1.458,1,10,840,10,56,162,56,840,0,0,0,0,0
36.307,17,10,760,10,48,4034,48,760,0,0,0,0,0
1781.654,1,66,5544,0,0,0,0,0,66,56,27410,56,5544
11.517,6,33,13901,17,282,719,721,2376,16,1209,633,1440,11525
0.489,6,55,22255,30,1048,16,1380,16968,25,387,19,1923,5287
1777.613,17,79,3312,78,14,23085,14,3276,1,8,0,8,36
2.37,6,13,2311,8,188,338,245,700,5,1407,527,1407,1611
0.035,17,2,904,1,300,0,300,328,1,548,0,548,576
0.528,6,121,74746,63,1260,8,1420,68111,58,427,9,1420,6635
0.512,6,29,10447,18,549,30,1420,5673,11,721,50,1420,4774
0.033,6,3,182,2,31,33,31,111,1,31,0,31,71
0.032,17,4,304,2,37,0,37,130,2,59,0,65,174
117.451,6,904,459481,514,830,228,1152,439090,390,435,301,1179,20391
1741.894,6,91,6616,60,31,29523,31,4062,31,31,58062,31,2554
305.24,6,71,14099,33,511,9529,1418,10433,38,126,8248,580,3666
0.17,17,2,178,1,29,0,29,57,1,93,0,93,121
1764.558,2,14,448,14,8,135735,8,448,0,0,0,0,0
1781.762,6,355,22480,207,69,8649,69,12420,148,69,12120,69,10060
0.008,17,2,142,1,29,0,29,57,1,57,0,57,85
10.89,6,20,4442,11,275,1089,275,998,9,768,764,1440,3444
1785.859,6,357,22629,208,69,8627,69,12529,149,69,12066,69,10100
0.034,17,6,462,6,49,6,49,462,0,0,0,0,0
5.033,17,3,208,2,36,5006,36,128,1,52,0,52,80
11.057,6,11,1003,6,332,2211,332,652,5,83,2762,83,351
504.174,2,4,128,4,8,168058,8,128,0,0,0,0,0
1777.268,6,128,9069,73,68,24684,208,5846,55,31,32907,31,3223
240.25,6,53,16977,28,711,8897,1402,14278,25,173,10010,580,2699
1680.586,17,12,498,11,14,168058,14,462,1,8,0,8,36
1.908,6,33,16301,17,430,119,1237,2495,16,1096,110,1360,13806
31.977,6,6,360,0,0,0,0,0,6,0,0,0,360
1.444,6,24,8004,12,164,112,267,1288,12,1014,112,2491,6716
299.563,6,6,364,4,31,99854,31,222,2,31,299532,31,142
1.53,6,39,8294,19,321,85,1164,2718,20,433,70,1460,5576
300.664,6,36,8368,20,286,15824,797,1976,16,521,564,3488,6392
0.064,6,10,1866,6,649,12,1142,1543,4,159,19,159,323
138.431,6,19,3451,6,92,167,92,412,13,235,11500,1448,3039
1777.364,1,67,5628,67,56,26929,56,5628,0,0,0,0,0
0.021,17,2,347,1,29,0,29,57,1,262,0,262,290
0.044,17,2,317,1,43,0,43,71,1,218,0,218,246
0.054,6,11,911,6,181,10,181,489,5,77,11,133,422
82.893,6,72,46799,44,1171,1927,1408,38611,28,960,2280,3847,8188
0.215,6,10,1669,6,551,43,947,1346,4,159,71,159,323
14.349,1,9,756,0,0,0,0,0,9,56,1793,56,756
0.026,6,14,19540,1,0,0,0,40,13,1448,2,1448,19500
1798.567,17,416,139566,416,307,4333,308,139566,0,0,0,0,0
1.323,6,49,18010,26,864,52,1440,12314,23,433,50,1440,5696
1729.298,6,62,4547,41,33,43232,33,2804,21,31,86449,31,1743
280.049,6,31,7472,13,158,23337,267,1317,18,543,16469,1380,6155
1799.336,17,449,39928,404,35,4464,288,25708,45,288,40019,288,14220
422.221,2,5,160,5,8,105555,8,160,0,0,0,0,0
24.18,17,11,836,11,48,2418,48,836,0,0,0,0,0
1794.066,6,372,26195,214,98,8422,469,15252,158,69,11426,69,10943
1.783,6,57,24120,32,998,57,1460,18299,25,400,64,1460,5821
300.797,6,43,12419,24,733,13078,1360,6857,19,399,477,1360,5562
80.261,17,9,2097,9,205,10032,205,2097,0,0,0,0,0
1740.45,17,30,31680,30,1028,60015,1028,31680,0,0,0,0,0
3.012,17,4,426,2,44,3005,44,144,2,113,3003,113,282
0.975,17,2,144,1,36,0,36,64,1,52,0,52,80
280.393,6,28,7352,13,158,23366,267,1317,15,603,20025,2076,6035
1.989,17,2,672,2,308,1989,308,672,0,0,0,0,0
300.777,6,23,7648,14,204,23136,467,1552,9,936,8252,2688,6096
481.31,2,6,192,6,8,96262,8,192,0,0,0,0,0
0.241,6,46,21175,26,1078,9,1420,16154,20,467,12,1883,5021
40.417,6,41,9309,24,541,1757,1244,5572,17,203,2524,1282,3737
9.356,6,42,7837,21,218,467,314,3463,21,441,454,1179,4374
219.449,6,32,9021,14,158,16880,267,1357,18,630,12899,1400,7664
17.218,6,25,4662,13,275,1434,275,1086,12,768,1113,1440,3576
0.057,17,2,362,1,32,0,32,60,1,274,0,274,302
1.296,6,50,20103,28,886,48,1360,14447,22,433,50,1360,5656
1786.104,6,102,8296,68,65,26658,65,4930,34,59,54121,59,3366
0.046,17,3,244,2,32,1,32,120,1,96,0,96,124
0.59,17,2,152,1,48,0,48,76,1,48,0,48,76
30.008,17,3,1008,3,308,15004,308,1008,0,0,0,0,0
0.255,17,3,451,2,39,252,39,134,1,289,0,289,317
1.317,6,52,22147,29,953,47,1440,16451,23,433,52,1440,5696
0.223,6,9,1338,5,549,55,549,753,4,421,59,421,585
15.446,17,13,6504,7,613,2562,1350,4487,6,308,3072,1350,2017
1699.468,17,12,498,11,14,169946,14,462,1,8,0,8,36
783.148,6,108,8507,41,76,19575,337,4171,67,50,11863,143,4336
11.939,6,1757,1627571,1148,1365,10,1432,1598908,609,475,19,1871,28663
378.578,6,18,1242,14,180,29121,180,916,4,110,20071,110,326
69.399,6,32,7580,14,163,5338,267,1549,18,441,4073,1460,6031
132.271,6,321,450581,132,284,1009,883,10840,189,2442,703,7307,439741
377.837,2,3,96,3,8,188918,8,96,0,0,0,0,0
1788.778,6,432,25938,215,69,8358,69,12809,217,35,8281,48,13129
1772.187,6,180,15480,120,69,14892,69,8940,60,69,30031,69,6540
0.002,17,2,140,1,34,0,34,62,1,50,0,50,78
278.881,1,49,5096,0,0,0,0,0,49,76,5810,76,5096
373.451,6,18,1242,14,180,28727,180,916,4,110,20063,110,326
541.45,2,5,160,5,8,135362,8,160,0,0,0,0,0
3.053,17,3,1176,3,364,1526,364,1176,0,0,0,0,0
31.172,17,4,240,2,32,31171,32,120,2,32,31171,32,120
1.99,6,53,21389,30,898,68,1360,15642,23,401,82,2715,5747
1120.136,17,164,12464,164,48,6872,48,12464,0,0,0,0,0
14.883,6,2212,2053045,1356,1428,10,1448,1998501,856,776,17,1448,54544
0.099,17,2,152,1,48,0,48,76,1,48,0,48,76
0.402,6,26,8884,13,236,33,585,1630,13,938,32,1438,7254
37.385,17,44,6468,22,48,1777,48,1672,22,190,1777,308,4796
62.439,6,75,51423,46,1199,1387,1368,43181,29,747,2219,1368,8242
1793.309,6,371,28054,214,95,8419,485,14640,157,103,11480,906,13414
3.046,17,4,304,2,48,3032,48,152,2,48,3032,48,152
2.561,6,49,18721,28,912,94,1460,13060,21,437,108,2615,5661
34.356,17,20,1760,10,48,3816,48,760,10,72,3816,72,1000
1790.732,17,87,3648,86,14,21067,14,3612,1,8,0,8,36
0.878,6,2,87,1,0,0,0,40,1,7,0,7,47
1.371,6,40,10551,21,517,68,1360,5015,19,433,66,1360,5536
229.538,6,72,46384,44,1158,5338,1408,38196,28,960,2283,3847,8188
61.839,6,67,47724,44,1171,1438,1408,39795,23,960,2800,3847,7929
109.12,6,848,425767,471,841,232,1152,405896,377,398,289,1152,19871
370.83,6,19,1306,14,180,28525,180,928,5,110,15167,110,378
0.051,6,12,3702,6,170,10,170,490,6,964,7,1448,3212
1786.586,6,107,8968,70,70,25892,293,5269,37,63,49624,247,3699
1787.428,6,104,8308,68,64,26678,64,4896,36,58,51065,58,3412
46.89,17,16,2588,8,48,6697,48,608,8,219,6697,308,1980
9.122,6,25,3829,18,211,536,211,1474,7,665,1519,904,2355
24.055,6,27,7177,13,155,2004,267,1306,14,530,1849,3417,5871
1789.026,17,138,11040,69,48,26309,48,5244,69,56,26309,56,5796
3.486,17,5,290,5,30,871,30,290,0,0,0,0,0
0.0,17,1,122,1,94,0,94,122,0,0,0,0,0
1769.005,6,135,8298,72,27,24914,27,4368,63,27,28531,27,3930
73.017,17,7,2312,7,302,12169,308,2312,0,0,0,0,0
1.311,6,38,9848,20,502,69,1440,4352,18,433,65,1440,5496
902.433,2,7,224,7,8,150405,8,224,0,0,0,0,0
3.181,17,8,1576,4,32,1058,32,240,4,306,650,486,1336
0.132,6,10,1569,5,627,33,627,895,5,406,33,406,674
237.071,6,62,11661,29,148,5171,722,3094,33,452,7402,2760,8567
28.208,6,40,18800,20,892,1484,1448,7305,20,869,1481,1448,11495
240.331,6,43,9040,21,524,12016,1418,5817,22,230,11443,618,3223
23.441,6,119,85730,52,583,459,777,5119,67,1217,117,2864,80611
0.22,17,4,2876,2,689,220,1350,1434,2,693,50,1350,1442
0.42,6,12,1653,6,288,78,288,548,6,426,49,434,1105
4.876,6,39,7269,19,218,270,314,3383,20,440,242,1152,3886
0.382,17,2,136,1,32,0,32,60,1,48,0,48,76
110.741,6,35,8439,17,410,549,882,1966,18,478,6505,2128,6473
23.524,6,28,6222,13,275,1960,275,1086,15,902,1391,1440,5136
136.034,6,159,124517,102,1285,1346,1408,112045,57,730,1963,3847,12472
0.467,6,20,7252,13,337,38,674,2032,7,1212,71,1946,5220
0.637,6,21,5000,11,137,63,267,1132,10,692,57,1467,3868
0.849,6,22,9404,12,372,77,808,1684,10,1044,74,2720,7720
3.945,6,23,6478,11,268,389,517,1385,12,744,354,1418,5093
1798.575,17,445,130324,445,264,4050,422,130324,0,0,0,0,0
1624.386,2,15,480,15,8,116027,8,480,0,0,0,0,0
127.156,6,17,3515,7,92,21192,92,452,10,317,14104,1448,3063
1777.063,6,113,9037,73,65,24681,65,5195,40,59,45563,59,3842
1531.474,6,96,13832,58,95,26867,721,6536,38,412,8634,1440,7296
1791.97,17,130,10384,67,48,27150,48,5092,63,56,28902,56,5292
1798.172,6,377,25857,217,92,8324,469,14972,160,69,11309,69,10885
1773.24,6,180,15480,120,69,14901,69,8940,60,69,30054,69,6540
1741.754,6,87,6322,58,31,30557,31,3915,29,31,62204,31,2407
45.27,17,12,912,12,48,4115,48,912,0,0,0,0,0
0.221,17,2,170,1,37,0,37,65,1,77,0,77,105
302.051,6,43,10613,22,545,14383,1460,4742,21,358,439,1460,5871
27.385,17,16,1408,8,48,3910,48,608,8,72,3910,72,800
1.017,6,10,924,5,283,211,283,551,5,105,211,105,373
1.76,6,9,527,5,43,440,43,311,4,0,585,0,216
3.348,17,5,290,5,30,837,30,290,0,0,0,0,0
1.604,6,19,3781,10,234,178,564,1452,9,463,176,1343,2329
0.028,6,11,924,6,181,5,181,501,5,77,6,134,423
240.182,6,53,17904,28,785,8895,1402,14822,25,221,10007,580,3082
0.476,6,13,1693,6,288,91,288,548,7,426,46,434,1145
970.812,17,207,28885,94,205,10438,1350,21918,113,33,8658,61,6967
0.035,17,3,244,2,32,19,32,120,1,96,0,96,124
1771.55,6,99,9240,66,65,27254,65,5577,33,59,55357,59,3663
16.159,6,16,4182,8,275,2308,275,874,8,992,1096,1440,3308
1792.732,17,180,11520,180,36,10015,36,11520,0,0,0,0,0
127.578,6,17,3971,3,92,28767,92,256,14,271,9799,1408,3715
6.791,6,47,8489,24,227,295,314,4142,23,489,295,1179,4347
1680.981,1,15,840,15,28,120070,28,840,0,0,0,0,0
1786.47,6,104,8376,68,65,26663,65,4930,36,59,51039,59,3446
0.749,6,58,22549,29,996,26,1380,17135,29,421,24,2760,5414
0.147,1,2,112,2,28,147,28,112,0,0,0,0,0
0.137,17,2,178,1,29,0,29,57,1,93,0,93,121
0.327,17,8,2742,8,314,46,353,2742,0,0,0,0,0
619.136,1,4,224,4,28,206378,28,224,0,0,0,0,0
0.074,6,9,1342,5,145,18,145,349,4,829,21,829,993
240.171,6,53,17573,28,775,8895,1408,14639,25,203,10006,580,2934
630.238,2,4,128,4,8,210079,8,128,0,0,0,0,0
0.012,17,2,322,1,36,0,36,64,1,230,0,230,258
66.866,17,4,352,2,60,66864,60,176,2,60,66865,60,176
240.637,2,2,64,2,8,240637,8,64,0,0,0,0,0
0.067,17,4,420,2,33,27,33,122,2,121,63,145,298
1210.148,6,270,17492,136,46,8964,46,8038,134,46,9098,46,9454
6.293,1,4,224,4,28,2097,28,224,0,0,0,0,0
0.038,17,2,198,1,39,0,39,67,1,103,0,103,131
1767.738,6,82,4354,41,26,44192,26,2184,41,26,44192,26,2170
15.482,17,16,7615,9,588,1927,1350,5552,7,266,2568,1350,2063
955.363,6,26828,21988988,11663,340,81,342,743494,15165,1365,62,4104,21245494
1743.979,6,146,9174,79,48,22358,208,5595,67,31,26420,31,3579
1771.606,6,101,9344,66,65,27255,65,5577,35,59,52103,59,3767
125.808,6,23,6148,13,220,10484,516,1406,10,619,13967,1452,4742
0.447,6,23,7451,14,275,34,674,2115,9,1212,52,1946,5336
8.0,6,19,6357,6,154,1600,267,712,13,568,644,1460,5645
0.03,17,2,290,1,40,0,40,68,1,194,0,194,222
5.024,17,4,288,2,36,4993,36,128,2,52,4992,52,160
280.521,6,29,7392,13,158,23376,267,1317,16,678,18695,3456,6075
1772.514,6,180,15480,120,69,14895,69,8940,60,69,30034,69,6540
1.683,6,50,20750,28,929,62,1360,15094,22,433,69,1360,5656
0.381,17,2,266,1,41,0,41,69,1,169,0,169,197
10.821,6,2,80,1,0,0,0,40,1,0,0,0,40
1790.749,6,356,22520,208,69,8650,69,12460,148,69,12181,69,10060
212.152,6,29,6637,16,166,14143,501,1640,13,447,17671,1420,4997
1799.162,1,345,28980,345,56,5230,56,28980,0,0,0,0,0
17.905,6,18,7050,9,275,2238,275,918,9,1440,2210,1440,6132
1795.038,1,96,5376,96,28,18895,28,5376,0,0,0,0,0
1796.269,6,353,22262,206,69,8762,69,12311,147,69,12203,69,9951
1772.368,6,180,15480,120,69,14893,69,8940,60,69,30033,69,6540
249.329,6,54,9972,22,235,11872,649,3519,32,318,8042,2816,6453
125.7,6,32,7717,12,155,28,267,1266,20,376,6615,3417,6451
10.139,17,50,32639,23,247,460,1350,6330,27,946,340,1350,26309
1796.363,17,449,39928,404,35,4457,288,25708,45,288,40019,288,14220
0.16,6,25,7216,13,155,13,267,1301,12,678,13,3436,5915
1799.234,17,449,39928,404,35,4464,288,25708,45,288,40017,288,14220
0.194,17,2,144,1,36,0,36,64,1,52,0,52,80
0.153,17,2,348,1,39,0,39,67,1,253,0,253,281
63.041,17,4,542,2,36,63034,36,128,2,179,63036,187,414
1792.307,6,319,37688,156,154,11563,721,24532,163,147,11061,2840,13156
0.008,17,2,422,1,46,0,46,74,1,320,0,320,348
0.113,6,2,92,1,0,0,0,52,1,0,0,0,40
0.012,6,9,1557,5,515,3,515,783,4,558,3,558,774
280.435,6,30,7432,13,158,23369,267,1317,17,543,17523,1400,6115
1788.393,6,373,26028,216,98,8318,469,15263,157,69,11461,69,10765
69.863,6,12,984,11,43,6986,43,924,1,0,0,0,60
3.924,17,2,176,2,60,3924,60,176,0,0,0,0,0
0.34,6,27,8922,13,232,28,567,1612,14,939,25,1408,7310
1225.859,17,208,15808,208,48,5922,48,15808,0,0,0,0,0
1787.466,6,104,8376,68,65,26678,65,4930,36,59,51066,59,3446
1779.483,17,130,10400,65,48,27804,48,4940,65,56,27804,56,5460
0.091,17,4,368,2,32,41,32,120,2,96,59,96,248
560.727,17,6,444,3,30,280357,30,174,3,62,280357,62,270
135.166,17,3,454,2,43,132443,43,142,1,284,0,284,312
212.368,17,4,240,2,32,212366,32,120,2,32,212367,32,120
180.52,2,2,64,2,8,180520,8,64,0,0,0,0,0
20.344,6,1919,1680798,1178,1372,17,1380,1644752,741,359,27,1923,36046
0.096,6,13,3876,7,124,15,124,496,6,1530,19,1612,3380
0.003,6,2,1460,1,0,0,0,40,1,1380,0,1380,1420
1798.784,17,449,39928,404,35,4463,288,25708,45,288,40022,288,14220
0.064,17,4,284,2,32,46,32,120,2,54,46,60,164
299.297,1,4,224,4,28,99765,28,224,0,0,0,0,0
0.01,6,6,718,2,304,6,304,408,4,102,2,102,310
1385.981,6,77,5949,46,45,30796,205,3481,31,31,46193,31,2468
446.933,6,43,7735,21,132,16270,501,2035,22,253,21278,1420,5700
1797.87,17,764,46076,764,32,2356,37,46076,0,0,0,0,0
287.486,6,5,293,4,31,95828,31,222,1,31,0,31,71
1.67,6,13,2311,8,188,238,245,700,5,1407,352,1407,1611
73.2,6,16,3253,6,92,14640,92,400,10,1164,8100,1408,2853
0.955,6,19,9141,11,514,95,1236,2014,8,1359,106,3639,7127
7.872,6,721,656059,468,1334,16,1368,638239,253,776,30,1473,17820
1787.596,6,102,8296,68,65,26680,65,4930,34,59,54157,59,3366
210.323,17,4,332,2,31,210311,33,118,2,79,210309,93,214
3.008,17,4,824,2,33,3005,33,122,2,323,3002,323,702
372.878,6,61,11192,37,284,10357,1360,5292,24,308,386,1360,5900
1798.699,1,130,13780,130,78,13943,78,13780,0,0,0,0,0
244.447,17,6,456,6,48,48889,48,456,0,0,0,0,0
377.86,2,3,96,3,8,188930,8,96,0,0,0,0,0
241.527,6,45,6311,19,213,13416,585,2921,26,184,9658,580,3390
0.104,6,2,149,1,0,0,0,40,1,69,0,69,109
126.294,6,10,628,4,106,42094,106,274,6,90,25256,90,354
1785.362,6,356,22520,208,69,8624,69,12460,148,69,12145,69,10060
1793.018,6,369,23385,212,69,8497,69,12896,157,69,11493,69,10489
0.043,6,17,6068,10,88,4,88,556,7,1740,7,1880,5512
0.876,6,10,1687,7,100,146,100,384,3,1179,288,1179,1303
0.734,6,22,7333,14,334,55,663,2073,8,1209,103,1912,5260
38.807,17,42,6056,21,48,1939,48,1596,21,184,1939,308,4460
1796.03,17,142,11360,71,48,25657,48,5396,71,56,25657,56,5964
8.971,17,2,156,2,50,8971,67,156,0,0,0,0,0
38.831,17,11,836,11,48,3883,48,836,0,0,0,0,0
1772.859,6,180,15480,120,69,14897,69,8940,60,69,30041,69,6540
4.902,6,38,7245,20,218,258,314,3423,18,516,273,1179,3822
11.32,6,1790,1566088,1106,1363,10,1380,1534486,684,468,16,3303,31602
521.937,6,103,16526,55,304,9665,304,11732,48,83,11085,83,4794
45.056,6,2407,2023970,1407,1375,32,1380,1973467,1000,387,45,1380,50503
280.26,6,27,7312,12,158,25478,267,1277,15,678,20016,2045,6035
0.049,17,2,212,1,46,0,46,74,1,110,0,110,138
0.145,17,2,180,1,30,0,30,58,1,94,0,94,122
1787.427,6,102,8296,68,65,26678,65,4930,34,59,54161,59,3366
6.598,17,16,3236,8,33,940,33,488,8,315,936,327,2748
10.827,6,18,5610,10,275,1203,275,958,8,1440,826,1440,4652
3.15,6,21,6369,10,268,345,517,1333,11,744,310,1418,5036
65.006,6,13,532,6,0,7486,0,244,7,0,10832,0,288
1799.834,6,388,35239,207,119,8737,1189,16740,181,129,9999,1420,18499
1778.693,6,276,28186,136,150,13175,208,21501,140,31,12793,31,6685
5.226,6,40,7325,21,218,261,314,3463,19,516,275,1179,3862
117.624,17,4,352,2,60,117623,60,176,2,60,117623,60,176
0.884,6,52,13853,24,549,38,1429,4824,28,438,31,1460,9029
0.987,6,10,1687,7,100,164,100,384,3,1179,361,1179,1303
486.594,1,18,1008,18,28,28623,28,1008,0,0,0,0,0
5.807,6,45,8409,22,227,276,314,4062,23,489,252,1179,4347
126.606,17,10,880,5,48,31649,48,380,5,72,31648,72,500
0.0,17,1,1035,1,1007,0,1007,1035,0,0,0,0,0
173.41,6,10,558,2,0,7341,0,112,8,7,24747,7,446
8.514,6,1732,1644066,1132,1377,7,1408,1608202,600,776,13,1408,35864
46.681,17,6,360,3,32,23340,32,180,3,32,23340,32,180
117.605,6,31,9557,14,158,9046,267,1357,17,751,7347,1781,8200
12.625,6,27,4801,13,204,1035,721,1707,14,393,955,1368,3094
0.012,17,4,368,2,32,11,32,120,2,96,11,96,248
93.665,6,23,948,10,0,5403,0,408,13,0,7803,0,540
372.254,6,21,1419,15,177,26589,177,989,6,110,12245,110,430
12.196,6,1991,1667520,1174,1363,10,1380,1630250,817,421,14,1923,37270
1.76,1,2,689,2,316,1760,327,689,0,0,0,0,0
1032.062,6,59,4556,38,44,27893,205,2773,21,34,43662,98,1783
1785.563,6,111,8878,68,64,26650,64,4896,43,58,42511,58,3982
102.502,17,4,244,2,33,102500,33,122,2,33,102501,33,122
0.392,6,19,7186,12,335,35,668,1974,7,1613,64,3314,5212
0.808,6,29,7253,17,386,50,965,2271,12,498,56,1384,4982
0.093,17,2,152,1,48,0,48,76,1,48,0,48,76
1141.204,6,226,14353,131,69,8773,69,7931,95,69,12139,69,6422
106.503,17,4,240,2,32,106502,32,120,2,32,106502,32,120
38.028,1,2,223,2,83,38028,91,223,0,0,0,0,0
1772.145,6,180,15480,120,69,14891,69,8940,60,69,30034,69,6540
115.249,17,2,72,1,8,0,8,36,1,8,0,8,36
18.803,6,17,12852,2,122,4272,122,222,15,1201,1333,1360,12630
0.529,17,2,476,1,39,0,39,67,1,381,0,381,409
15.117,17,12,5148,6,490,3017,1350,3108,6,312,3017,1350,2040
61.196,6,26,7137,12,155,5563,267,1266,14,530,4706,2840,5871
0.201,6,22,5040,11,137,20,267,1132,11,577,19,1400,3908
1774.203,6,182,15629,121,69,14785,69,8980,61,69,29565,69,6649
1.762,17,2,238,1,59,0,59,87,1,123,0,123,151
8.182,6,42,7489,21,209,409,314,3563,21,513,394,1179,3926
1771.455,6,99,9306,66,66,27253,66,5610,33,60,55355,60,3696
1443.904,2,10,320,10,8,160433,8,320,0,0,0,0,0
15.383,6,37,7040,20,205,809,314,3476,17,480,944,1179,3564
1787.136,6,108,8736,70,66,25900,66,5176,38,60,48298,60,3560
6.819,6,26,7158,10,165,8,267,1069,16,453,454,3417,6089
0.484,6,12,1653,6,288,92,288,548,6,426,55,434,1105
0.237,17,7,2368,7,310,39,354,2368,0,0,0,0,0
0.072,6,8,416,0,0,0,0,0,8,0,0,0,416
280.564,6,29,7392,12,158,25505,267,1277,17,543,17530,1400,6115
9.143,6,47,24670,27,840,351,1360,6167,20,1263,472,2720,18503
1781.584,17,456,125186,456,246,3915,422,125186,0,0,0,0,0
3.952,17,4,244,4,33,1317,33,244,0,0,0,0,0
241.068,6,59,15108,30,659,8311,1368,12131,29,161,8608,580,2977
33.58,6,32,5346,15,154,2398,722,1860,17,324,2086,1402,3486
1746.457,2,24,768,24,8,75932,8,768,0,0,0,0,0
1.22,6,24,8004,12,164,95,267,1288,12,1014,95,2331,6716
0.173,6,2,104,1,0,0,0,52,1,0,0,0,52
280.475,6,30,7432,14,158,21575,267,1357,16,678,18694,3456,6075
194.269,6,30,7432,13,158,16189,267,1317,17,543,12141,1400,6115
1786.738,6,106,8456,68,65,26667,65,4930,38,59,48287,59,3526
0.475,17,3,451,2,39,121,39,134,1,289,0,289,317
34.781,6,30,8872,13,158,2898,267,1317,17,687,2170,1400,7555
1791.923,6,115,7686,68,54,26745,208,4783,47,31,38948,31,2903
1772.982,6,180,15480,120,69,14899,69,8940,60,69,30046,69,6540
81.387,6,19,1243,10,69,9042,69,676,9,69,10173,69,567
1787.451,6,102,8364,68,66,26678,66,4964,34,60,54161,60,3400
1738.954,1,15,840,15,28,124211,28,840,0,0,0,0,0
166.961,17,4,352,2,60,166960,60,176,2,60,166960,60,176
4.799,6,33,6129,18,206,282,314,2784,15,548,323,1179,3345
1793.043,17,87,3648,86,14,21094,14,3612,1,8,0,8,36
33.767,6,30,5041,14,180,2597,722,1806,16,342,2239,1408,3235
125.565,6,27,10797,13,746,61,1360,3537,14,836,9648,1360,7260
299.537,6,6,364,4,31,99845,31,222,2,31,299525,31,142
1757.629,6,96,7286,63,38,28348,205,4476,33,33,54916,98,2810
1.909,6,39,9212,22,126,72,324,1808,17,671,98,3102,7404
2.561,6,10,924,5,283,595,283,551,5,105,595,105,373
1790.199,6,375,26177,217,98,8287,469,15372,158,69,11400,69,10805
378.455,6,25,1654,17,180,23653,180,1120,8,110,9226,110,534
1755.851,6,4051,4319968,1423,149,1234,877,87663,2628,1604,668,9814,4232305
1260.835,2,10,320,10,8,140092,8,320,0,0,0,0,0
1799.53,17,448,39896,403,35,4476,288,25676,45,288,40022,288,14220
32.289,6,9,388,3,0,16144,0,124,6,0,6232,0,264
1779.863,6,247,25290,98,67,18347,659,9368,149,132,12025,1360,15922
26.774,6,50,9445,21,227,772,314,4022,29,472,947,1179,5423
1643.309,1,8,448,8,28,234758,28,448,0,0,0,0,0
1619.461,1,7,392,7,28,269910,28,392,0,0,0,0,0
0.135,6,2,80,2,0,0,0,80,0,0,0,0,0
704.343,6,33,3226,22,323,33540,582,1798,11,282,24031,580,1428
152.788,17,14,1120,7,48,25463,48,532,7,56,25462,56,588
0.167,6,28,7336,14,155,12,267,1341,14,543,12,1400,5995
1792.605,1,250,14000,250,28,7199,28,14000,0,0,0,0,0
2.099,17,4,706,3,39,1001,39,201,1,477,0,477,505
297.758,17,4,240,2,32,297757,32,120,2,32,297756,32,120
1799.446,17,144,11520,72,48,25344,48,5472,72,56,25344,56,6048
1739.963,6,91,6604,59,31,29999,31,3998,32,31,56127,31,2606
0.039,17,2,180,1,30,0,30,58,1,94,0,94,122
1785.68,6,103,8464,68,66,26651,66,4964,35,60,52517,60,3500
0.162,17,4,420,2,33,0,33,122,2,121,82,145,298
6.975,6,19,2541,10,211,774,211,986,9,545,867,904,1555
1741.488,6,97,7307,63,38,28088,205,4476,34,33,52760,98,2831
242.449,6,68,28055,30,882,8360,1418,16592,38,663,6552,1418,11463
85.647,6,19,7406,10,220,9516,516,1285,9,822,10686,1452,6121
1769.506,6,99,9306,66,66,27223,66,5610,33,60,55292,60,3696
1748.754,1,68,5712,0,0,0,0,0,68,56,26100,56,5712
0.541,6,51,22227,28,1060,20,1380,17053,23,421,22,1923,5174
0.484,17,8,2742,8,314,69,353,2742,0,0,0,0,0
1773.478,6,313,19558,182,69,9798,69,10799,131,69,13638,69,8759
1792.037,17,87,3648,86,14,21082,14,3612,1,8,0,8,36
0.039,17,2,672,2,308,39,308,672,0,0,0,0,0
1744.92,6,102,7806,66,40,26844,205,4730,36,35,49843,108,3076
1795.773,1,57,4788,57,56,32067,56,4788,0,0,0,0,0
0.406,6,49,20548,26,1022,16,1380,15386,23,468,16,3303,5162
1280.708,6,82,11267,51,97,20610,498,4384,31,208,42687,1420,6883
1774.132,17,140,11200,70,48,25711,48,5320,70,56,25711,56,5880
61.71,6,12,1000,6,226,12342,226,570,6,110,12252,110,430
84.353,6,29,7392,13,158,7029,267,1317,16,603,5621,2036,6075
1780.171,1,220,12320,220,28,8128,28,12320,0,0,0,0,0
80.993,6,14,580,6,0,2384,0,244,8,0,11567,0,336
2.357,6,13,2311,8,188,336,245,700,5,1407,525,1407,1611
120.59,6,23,2709,11,324,12059,585,1245,12,396,10658,580,1464
629.945,2,6,192,6,8,125989,8,192,0,0,0,0,0
0.07,6,13,4361,7,126,10,126,498,6,1181,12,1930,3863
1732.72,17,30,20943,30,670,59748,1451,20943,0,0,0,0,0
0.213,6,46,20769,26,1049,8,1414,15748,20,467,10,1889,5021
2.285,6,19,6236,10,150,253,174,704,9,861,263,1420,5532
1787.0,6,104,8504,69,66,26279,66,5004,35,60,52555,60,3500
553.287,17,189,12978,189,40,2943,41,12978,0,0,0,0,0
0.948,6,23,4789,13,210,79,531,1722,10,507,94,1440,3067
5.516,6,39,7285,21,218,275,314,3463,18,516,309,1179,3822
0.756,6,22,7354,13,335,63,668,2026,9,1210,87,1946,5328
0.278,17,4,588,2,48,242,48,152,2,190,147,308,436
3.0,6,3,160,2,0,2995,0,120,1,0,0,0,40
13.886,6,954,869296,623,1322,21,1368,845568,331,776,41,2736,23728
11.784,6,20,8184,11,275,1178,275,998,9,1362,1344,1440,7186
6.938,17,16,3236,8,33,987,33,488,8,315,988,327,2748
1.231,6,8,423,4,0,410,0,204,4,7,305,7,219
240.333,6,56,18763,31,757,8010,1418,16020,25,179,10013,580,2743
1778.194,17,138,11040,69,48,26149,48,5244,69,56,26149,56,5796
1684.504,2,25,800,25,8,70187,8,800,0,0,0,0,0
0.228,6,9,1148,5,145,57,145,349,4,635,55,635,799
1787.607,6,125,9677,75,65,24147,65,5730,50,59,36479,59,3947
1.198,6,27,5927,13,156,99,267,1462,14,650,86,1452,4465
1787.749,6,127,15264,82,90,22070,502,6803,45,162,40628,1420,8461
2.95,6,2,104,1,0,0,0,40,1,0,0,0,64
1785.276,17,87,3648,86,14,21003,14,3612,1,8,0,8,36
0.164,1,2,112,2,28,164,28,112,0,0,0,0,0
2.462,6,14,2351,8,188,351,245,700,6,703,282,1152,1651
2.998,6,37,8884,19,398,166,1216,2410,18,441,167,1360,6474
1736.841,1,56,4704,56,56,31578,56,4704,0,0,0,0,0
1786.532,6,103,8326,68,64,26664,64,4896,35,58,52542,58,3430
1740.927,6,87,6322,58,31,30542,31,3915,29,31,62175,31,2407
1739.992,1,15,840,15,28,124285,28,840,0,0,0,0,0
0.56,6,3,120,2,0,560,0,80,1,0,0,0,40
1781.808,17,142,11360,71,48,25454,48,5396,71,56,25454,56,5964
9.93,6,6,328,4,0,3310,0,216,2,0,9847,0,112
25.892,6,29,7807,17,151,1618,318,1811,12,670,2352,1418,5996
0.387,6,10,1840,5,901,96,901,1169,5,403,96,403,671
1755.098,6,117,11933,75,63,23717,722,6267,42,96,42798,1408,5666
0.149,1,2,163,2,53,149,78,163,0,0,0,0,0
1777.171,6,222,41581,126,343,14217,827,27518,96,148,18706,1440,14063
44.1,1,2,759,2,351,44100,367,759,0,0,0,0,0
18.78,17,30,2927,15,91,1339,642,1796,15,47,1340,328,1131
1794.29,6,359,22709,209,69,8626,69,12569,150,69,12042,69,10140
1.347,6,50,18337,28,882,49,1360,12636,22,400,55,1360,5701
0.018,17,2,218,1,65,0,65,93,1,97,0,97,125
295.873,6,37,8126,15,158,21133,267,1397,22,389,14088,2036,6729
224.445,17,4,240,2,32,224444,32,120,2,32,224444,32,120
3.112,17,2,178,1,29,0,29,57,1,93,0,93,121
1793.387,6,356,22520,208,69,8663,69,12460,148,69,12199,69,10060
39.827,17,5,380,5,48,9956,48,380,0,0,0,0,0
280.616,6,29,7392,13,158,23384,267,1317,16,603,18700,2076,6075
1793.718,17,142,11360,71,48,25624,48,5396,71,56,25624,56,5964
0.042,17,3,208,2,36,28,36,128,1,52,0,52,80
1799.999,6,202,14060,72,46,25332,46,5870,130,46,13953,46,8190
0.367,17,2,362,1,46,0,46,74,1,260,0,260,288
34.982,6,1339,1218532,848,1360,41,1368,1187168,491,776,70,1473,31364
1799.379,17,142,11360,71,48,25705,48,5396,71,56,25705,56,5964
1745.219,6,133,13095,74,62,23907,722,6183,59,76,30086,1448,6912
298.846,17,4,352,2,60,298845,60,176,2,60,298844,60,176
59.95,17,11,3696,11,308,5995,308,3696,0,0,0,0,0
9.212,6,3,147,1,0,0,0,40,2,27,9204,27,107
280.771,6,29,7392,13,158,23397,267,1317,16,603,18712,2036,6075
5.032,6,12,3462,6,75,1006,75,395,6,1373,1006,1448,3067
0.888,6,10,1687,7,100,148,100,384,3,1179,321,1179,1303
0.476,6,12,1653,6,288,94,288,548,6,426,53,434,1105
70.744,6,25,8747,13,641,85,1460,3117,12,734,6412,1460,5630
2.683,17,21,15501,9,734,335,1350,6859,12,692,169,1350,8642
1743.243,6,98,7378,64,38,27670,205,4485,34,33,52819,98,2893
163.861,6,108,16672,61,304,2731,304,11484,47,83,3530,83,5188
1772.451,6,180,15480,120,69,14894,69,8940,60,69,30035,69,6540
0.0,6,1,211,1,159,0,159,211,0,0,0,0,0
127.073,6,29,4941,14,253,9774,585,2508,15,235,9075,580,2433
120.32,2,2,64,2,8,120320,8,64,0,0,0,0,0
1795.885,6,356,22520,208,69,8675,69,12460,148,69,12216,69,10060
48.976,6,22,16094,4,214,16325,214,426,18,1243,2836,1440,15668
72.294,6,34,7664,14,155,5561,267,1346,20,367,3796,1420,6318
0.763,6,25,8328,12,257,68,748,1675,13,852,62,1418,6653
1786.84,6,102,8364,68,66,26669,66,4964,34,60,54143,60,3400
16.391,6,10,634,4,112,5461,112,280,6,90,3276,90,354
240.22,6,53,16096,28,692,8896,1402,13238,25,193,10008,580,2858
1.114,17,19,15645,11,631,111,1350,7249,8,1021,148,1350,8396
0.227,17,4,284,2,32,0,32,120,2,54,1,60,164
1789.403,6,356,22520,208,69,8644,69,12460,148,69,12169,69,10060
0.548,17,19,11550,10,739,60,1350,7670,9,403,61,1350,3880
0.006,17,2,586,1,30,0,30,58,1,500,0,500,528
301.18,6,66,31403,37,1099,8366,1408,17407,29,656,817,3594,13996
0.238,17,2,2386,2,1165,238,1165,2386,0,0,0,0,0
367.218,6,25,1651,17,177,22951,177,1117,8,110,9204,110,534
1.453,6,20,9199,11,125,145,125,830,9,1576,181,2896,8369
91.113,1,6,336,6,28,18222,28,336,0,0,0,0,0
60.474,6,22,3305,12,180,5497,595,1712,10,266,6717,580,1593
0.349,17,4,608,2,60,334,60,176,2,188,335,188,432
0.607,17,2,685,1,308,0,308,336,1,321,0,321,349
178.053,6,58,37778,38,1120,4812,1408,29998,20,841,3229,2439,7780
0.067,17,2,185,1,45,0,45,73,1,84,0,84,112
1765.232,17,46,15456,46,308,39227,308,15456,0,0,0,0,0
292.716,6,21,7221,7,269,2660,517,1448,14,619,22516,1408,5773
1772.18,6,101,9344,66,65,27264,65,5577,35,59,52119,59,3767
0.345,6,26,8868,13,227,28,547,1592,13,941,28,1438,7276
758.743,17,28,1833,24,30,32988,37,1399,4,80,187310,136,434
1749.22,6,105,7890,67,38,26503,205,4715,38,32,47268,98,3175
0.159,6,13,3514,7,75,26,75,447,6,1373,31,1448,3067
1680.559,17,12,498,11,14,168055,14,462,1,8,0,8,36
0.048,6,2,80,1,0,0,0,40,1,0,0,0,40
0.113,6,2,116,1,0,0,0,64,1,0,0,0,52
37.794,17,44,6468,22,48,1799,48,1672,22,190,1799,308,4796
567.0,6,410,71940,263,304,2164,304,53568,147,83,3883,83,18372
92.467,6,801,400369,452,821,205,1152,380206,349,413,264,1179,20163
5.816,17,4,602,4,122,1938,352,602,0,0,0,0,0
0.041,17,6,552,3,32,0,32,180,3,96,0,96,372
1.29,6,4,220,2,0,1290,0,100,2,0,301,0,120
3.581,17,4,240,4,32,1193,32,240,0,0,0,0,0
9.456,17,4,1344,4,308,3152,308,1344,0,0,0,0,0
0.269,6,27,7296,13,155,22,267,1301,14,543,19,1400,5995
101.925,6,22,7219,12,168,9250,191,1138,10,1103,11305,1440,6081
0.91,6,10,1687,7,100,151,100,384,3,1179,320,1179,1303
292.143,6,35,7077,18,262,17182,517,1732,17,744,18256,1418,5345
6.604,6,21,3231,12,180,600,595,1712,9,347,824,580,1519
1.366,6,25,8056,12,164,105,267,1288,13,1014,96,2736,6768
280.572,6,28,7352,12,158,25506,267,1277,16,678,18697,2760,6075
291.325,17,6,360,3,32,145662,32,180,3,32,145662,32,180
1789.951,6,416,24920,208,69,8647,69,12460,208,34,8647,64,12460
7.574,17,36,8025,10,230,841,1350,2581,26,181,301,1350,5444
1.235,6,10,767,5,186,308,186,454,5,45,307,45,313
33.772,6,34,5297,16,154,2251,722,1912,18,271,1975,1440,3385
1769.741,17,18,1413,9,30,221215,37,529,9,70,221211,136,884
1720.637,17,13,534,11,14,172045,14,462,2,8,1720451,8,72
0.087,17,2,245,1,32,0,32,60,1,157,0,157,185
2.244,6,13,2311,8,188,320,245,700,5,1407,494,1407,1611
1645.75,17,16,5296,16,303,109716,308,5296,0,0,0,0,0
1787.537,17,87,3648,86,14,21029,14,3612,1,8,0,8,36
1794.024,1,114,6384,114,28,15876,28,6384,0,0,0,0,0
1794.085,17,80,3354,79,14,23001,14,3318,1,8,0,8,36
206.636,17,4,240,2,32,206635,32,120,2,32,206634,32,120
1772.384,6,180,15480,120,69,14893,69,8940,60,69,30035,69,6540
1.355,6,47,18741,26,927,54,1460,13125,21,433,58,1460,5616
0.188,17,4,352,2,60,187,60,176,2,60,180,60,176
292.41,17,36,38875,36,1051,8354,1451,38875,0,0,0,0,0
36.79,6,45,11410,23,289,1672,721,3533,22,776,1703,1440,7877
1786.499,6,104,8376,68,65,26664,65,4930,36,59,51040,59,3446
1740.997,6,87,6322,58,31,30543,31,3915,29,31,62176,31,2407
102.604,6,24,5546,9,133,65,159,879,15,966,7328,1658,4667
0.084,17,3,618,2,32,29,32,120,1,470,0,470,498
0.119,17,2,158,1,34,0,34,62,1,68,0,68,96
8.044,1,9,756,0,0,0,0,0,9,56,1005,56,756
1783.648,6,354,22440,207,69,8658,69,12420,147,69,12216,69,10020
0.01,17,2,528,1,38,0,38,66,1,434,0,434,462
0.948,6,10,1687,7,100,158,100,384,3,1179,340,1179,1303
1.227,6,26,8108,12,164,96,267,1288,14,869,81,1448,6820
0.165,17,2,136,1,32,0,32,60,1,48,0,48,76
5.095,6,41,7365,22,218,242,314,3503,19,516,269,1179,3862
0.479,6,10,1386,5,145,119,145,349,5,833,115,833,1037
54.804,6,33,4686,18,304,3223,304,3376,15,83,3889,83,1310
240.273,6,41,8903,20,523,12645,1408,5755,21,227,12013,638,3148
2.414,17,21,14063,12,937,219,1350,11582,9,247,297,1350,2481
1.438,6,19,3781,10,234,159,564,1452,9,463,157,1343,2329
238.597,6,30,7773,13,158,19883,267,1317,17,577,14911,1400,6456
0.884,6,29,8544,15,222,54,540,2008,14,852,55,1360,6536
16.49,6,24,4518,13,275,1374,275,1082,11,992,1389,1440,3436
1.174,6,25,8056,12,164,91,267,1288,13,869,83,1408,6768
2.586,6,11,913,7,182,431,182,542,4,77,310,134,371
93.063,17,12,1056,6,48,18611,48,456,6,72,18611,72,600
0.101,17,2,157,1,31,0,31,59,1,70,0,70,98
1758.017,6,185,10991,92,42,19318,208,6310,93,31,19106,31,4681
1744.7,6,142,8983,78,49,22658,208,5524,64,31,27689,31,3459
241.005,6,438,397080,167,214,1451,676,10251,271,1428,892,4254,386829
222.203,6,1404,686692,754,840,270,1152,653775,650,406,341,1179,32917
1.512,6,47,18774,26,929,60,1460,13158,21,433,64,1460,5616
0.228,17,2,588,1,39,0,39,67,1,493,0,493,521
1771.48,6,101,9278,66,64,27253,64,5544,35,58,52099,58,3734
120.272,2,3,96,3,8,60136,8,96,0,0,0,0,0
1800.0,6,223,19106,82,74,21968,301,8441,141,69,12857,1062,10665
1796.635,17,448,39896,403,35,4469,288,25676,45,288,40017,288,14220
1795.062,6,331,25772,159,259,11357,516,10408,172,39,10493,101,15364
5.006,17,4,530,2,36,5002,36,128,2,173,4997,187,402
0.004,17,2,471,1,29,0,29,57,1,386,0,386,414
0.105,6,9,1338,5,549,26,549,753,4,421,31,421,585
280.353,6,30,7432,13,158,23362,267,1317,17,543,17513,1400,6115
0.243,6,5,272,2,0,243,0,104,3,0,105,0,168
14.28,6,10,580,4,0,4760,0,220,6,0,1433,0,360
1.343,6,69,37902,40,1135,34,1380,32376,29,383,47,1380,5526
1793.289,17,180,11520,180,36,10018,36,11520,0,0,0,0,0
4.912,17,5,1165,5,205,1228,205,1165,0,0,0,0,0
1771.763,6,125,12369,77,62,23312,722,6370,48,87,37691,1408,5999
1740.631,17,30,31680,30,1028,60021,1028,31680,0,0,0,0,0
1741.422,17,29,6815,29,207,62193,207,6815,0,0,0,0,0
2.011,17,2,120,2,32,2011,32,120,0,0,0,0,0
1.113,17,4,368,2,32,794,32,120,2,96,800,96,248
481.325,2,7,224,7,8,80220,8,224,0,0,0,0,0
1.021,6,4,673,3,159,376,159,633,1,0,0,0,40
0.503,17,3,451,2,39,323,39,134,1,289,0,289,317
0.696,6,10,1840,5,901,174,901,1169,5,403,174,403,671
5.409,6,40,7325,21,218,270,314,3463,19,516,286,1179,3862
0.627,6,10,968,5,256,152,256,460,5,304,152,304,508
2.194,6,13,2311,8,188,313,245,700,5,1407,481,1407,1611
0.323,6,27,9042,14,247,24,624,1724,13,947,26,1448,7318
0.013,6,11,1686,6,131,2,131,451,5,967,3,967,1235
0.096,6,10,1321,5,585,24,585,841,5,212,15,212,480
1.852,17,2,178,1,29,0,29,57,1,93,0,93,121
1786.694,6,106,8456,68,65,26667,65,4930,38,59,48286,59,3526
0.204,17,2,192,1,60,0,60,88,1,76,0,76,104
0.018,17,2,358,1,30,0,30,58,1,272,0,272,300
2.097,17,3,174,3,30,1048,30,174,0,0,0,0,0
356.463,6,44,15121,25,271,14852,1402,5145,19,748,13726,2804,9976
1797.559,17,448,39896,403,35,4471,288,25676,45,288,40018,288,14220
300.583,6,38,8471,20,291,15820,786,1997,18,441,496,1360,6474
23.784,17,21,7431,10,458,2639,1350,4866,11,205,2375,1350,2565
247.072,17,4,240,2,32,247070,32,120,2,32,247071,32,120
1786.597,6,245,40935,139,290,12946,1294,24746,106,175,17013,383,16189
1785.863,6,362,22898,210,69,8544,69,12678,152,69,11826,69,10220
1679.308,1,14,784,14,28,129177,28,784,0,0,0,0,0
5.392,6,23,4478,13,213,449,597,1741,10,552,578,1767,2737
1768.969,1,58,4872,58,56,31034,56,4872,0,0,0,0,0
1797.544,6,356,22520,208,69,8683,69,12460,148,69,12227,69,10060
1.679,6,31,10669,16,419,111,1169,3191,15,980,105,1460,7478
1775.103,6,180,15480,120,69,14916,69,8940,60,69,30081,69,6540
65.381,6,18,7345,9,272,8172,516,1180,9,828,1411,1452,6165
1741.004,6,110,7948,68,31,25985,31,4650,42,31,42463,31,3298
280.477,6,30,7432,13,158,23373,267,1317,17,543,17524,1400,6115
1.221,6,26,8144,13,164,86,267,1376,13,869,86,1408,6768
84.072,6,24,6433,17,125,5254,504,1936,7,842,113,1420,4497
300.873,6,42,13016,23,812,13676,1360,7454,19,399,481,1360,5562
0.839,6,51,13829,24,551,36,1429,4840,27,464,31,2920,8989
280.258,6,28,7352,12,158,25478,267,1277,16,603,18681,1400,6075
8.926,6,82,24917,42,563,217,1152,19160,40,461,222,1179,5757
0.557,6,107,87166,60,131,9,232,2929,47,2008,11,5680,84237
661.77,2,9,288,9,8,82721,8,288,0,0,0,0,0
1.432,6,49,19273,27,893,55,1360,13617,22,476,59,2720,5656
0.929,6,633,482323,315,248,2,517,18696,318,1423,2,4224,463627
31.851,6,7,308,1,0,0,0,44,6,0,6308,0,264
1771.507,6,101,9344,66,65,27253,65,5577,35,59,52099,59,3767
69.48,6,15,3202,6,92,13896,92,400,9,2330,8662,2330,2802
1699.529,17,12,498,11,14,169952,14,462,1,8,0,8,36
1773.464,6,181,15589,120,69,14903,69,8940,61,69,29551,69,6649
0.444,6,23,7307,13,318,37,600,1958,10,964,47,1471,5349
1772.271,1,58,4872,58,56,31092,56,4872,0,0,0,0,0
1798.369,1,246,13776,246,28,7340,28,13776,0,0,0,0,0
356.211,2,4,128,4,8,118737,8,128,0,0,0,0,0
1772.034,6,180,15480,120,69,14891,69,8940,60,69,30033,69,6540
1796.675,1,56,4704,56,56,32666,56,4704,0,0,0,0,0
1771.186,6,106,9820,68,66,26435,66,5792,38,60,47867,60,4028
246.649,6,158,49741,67,923,3737,1418,41442,91,69,2740,580,8299
8.24,6,57,41603,36,1189,235,1368,35194,21,1327,401,2736,6409
1796.386,6,228,26808,137,104,13208,469,12682,91,120,19959,1420,14126
118.79,2,3,96,3,8,59395,8,96,0,0,0,0,0
1.152,6,25,8068,12,164,88,267,1300,13,869,81,1408,6768
1665.723,1,7,392,7,28,277620,28,392,0,0,0,0,0
1799.913,17,142,11360,71,48,25712,48,5396,71,56,25712,56,5964
148.751,6,46,12914,19,205,8263,722,2203,27,534,5710,1380,10711
96.177,6,42,9815,22,648,4571,1440,4168,20,371,5052,1440,5647
11.022,6,20,4442,11,275,1102,275,998,9,768,781,1440,3444
1742.994,6,95,7203,63,38,28112,205,4476,32,33,56216,98,2727
0.166,6,9,1340,5,145,41,145,349,4,827,52,827,991
42.628,17,4,352,2,48,42618,48,152,2,72,42619,72,200
0.582,6,6,324,4,0,194,0,216,2,0,338,0,108
881.454,2,5,160,5,8,220363,8,160,0,0,0,0,0
11.088,6,90,27101,44,559,257,1152,20779,46,447,239,1179,6322
1788.88,6,460,27148,242,69,7422,69,14096,218,35,8243,64,13052
725.313,6,152,10164,69,46,10592,46,4360,83,46,8845,46,5804
2.992,6,14,1640,7,256,497,256,1052,7,304,497,304,588
0.436,17,2,152,1,48,0,48,76,1,48,0,48,76
292.052,17,4,240,2,32,292050,32,120,2,32,292051,32,120
1797.292,17,447,39864,402,35,4482,288,25644,45,288,40018,288,14220
0.842,17,3,234,2,39,813,39,134,1,72,0,72,100
8.58,6,6,280,2,0,8580,0,88,4,0,2380,0,192
1785.457,17,140,11200,70,48,25875,48,5320,70,56,25876,56,5880
1607.467,1,16,896,16,28,107164,28,896,0,0,0,0,0
3.923,17,5,290,5,30,980,30,290,0,0,0,0,0
317.058,6,86,20337,40,313,8129,1360,10102,46,299,7042,4649,10235
1560.856,1,26,1456,26,28,62434,28,1456,0,0,0,0,0
0.319,6,27,8920,13,227,26,547,1592,14,941,24,1408,7328
35.218,6,3026,2828993,1852,1443,19,1448,2758671,1174,899,29,1448,70322
29.257,6,2078,1769891,1234,1374,23,1380,1727117,844,421,34,1923,42774
300.648,6,47,11565,24,241,13071,619,2078,23,475,386,1360,9487
6.008,17,4,454,2,44,6004,44,144,2,127,6003,127,310
0.013,17,2,378,1,42,0,42,70,1,280,0,280,308
0.014,17,2,313,1,36,0,36,64,1,221,0,221,249
17.728,17,34,6636,15,178,1264,1350,3103,19,157,983,1350,3533
1798.42,1,345,28980,345,56,5227,56,28980,0,0,0,0,0
1743.182,6,98,6373,62,47,28576,208,4003,36,31,49789,31,2370
3.014,17,4,340,2,37,3003,37,130,2,77,3006,77,210
97.584,6,32,14599,17,555,66,928,4056,15,902,6960,1577,10543
1786.672,6,108,8604,68,66,26666,66,4964,40,60,45809,60,3640
1771.364,6,99,9240,66,65,27251,65,5577,33,59,55351,59,3663
1783.893,6,358,22669,209,69,8576,69,12569,149,69,12053,69,10100
12.244,17,10,845,5,34,3059,34,310,5,79,3059,79,535
1741.129,2,24,768,24,8,75701,8,768,0,0,0,0,0
461.864,6,96,30997,50,593,9425,1408,11533,46,741,10263,2816,19464
1.535,6,38,9848,20,502,80,1460,4352,18,433,79,1460,5496
10.036,17,3,2906,3,940,5018,1451,2906,0,0,0,0,0
1273.656,6,70,5717,47,65,27688,65,3440,23,59,54102,59,2277
39.836,17,11,836,11,48,3983,48,836,0,0,0,0,0
13.615,1,4,224,4,28,4538,28,224,0,0,0,0,0
4.999,17,2,128,2,36,4999,36,128,0,0,0,0,0
1463.877,17,114,9104,59,48,25239,48,4484,55,56,25229,56,4620
5.864,6,1526,1432051,979,1388,5,1408,1398943,547,931,10,2816,33108
177.979,6,37,5704,16,165,11865,722,1987,21,218,8889,1408,3717
3.708,6,30,7687,14,140,285,267,1264,16,722,242,1420,6423
0.028,6,10,1514,5,503,6,503,771,5,475,6,475,743
230.189,17,4,352,2,48,230180,48,152,2,72,230180,72,200
1785.856,6,356,22520,208,69,8627,69,12460,148,69,12148,69,10060
0.481,6,88,90172,40,199,12,253,2884,48,1843,7,5472,87288
324.66,1,179,10024,179,28,1823,28,10024,0,0,0,0,0
2.587,17,2,152,1,48,0,48,76,1,48,0,48,76
1796.937,17,87,3648,86,14,21140,14,3612,1,8,0,8,36
0.454,6,10,1992,5,288,108,288,508,5,424,59,434,1484
38.523,17,22,1936,11,48,3848,48,836,11,72,3845,72,1100
240.252,6,54,18497,29,787,8580,1418,15684,25,188,10010,580,2813
0.595,6,24,6041,13,108,49,147,959,11,773,57,1608,5082
1737.697,1,55,4620,55,56,32179,56,4620,0,0,0,0,0
1772.581,6,180,15480,120,69,14895,69,8940,60,69,30041,69,6540
0.074,6,2,142,1,62,0,62,102,1,0,0,0,40
1.616,6,25,8719,15,277,115,565,1437,10,982,159,1420,7282
1798.359,6,372,25988,216,98,8364,469,15263,156,69,11601,69,10725
0.337,17,2,194,1,61,0,61,89,1,77,0,77,105
29.088,6,28,7352,13,158,2424,267,1317,15,603,2075,2236,6035
13.658,17,2,2195,2,1069,13658,1444,2195,0,0,0,0,0
280.466,6,29,7392,14,158,21574,267,1357,15,678,20030,3456,6035
96.361,6,47,7696,20,218,5071,314,3423,27,455,3696,1179,4273
1139.285,1,10,815,10,53,126587,78,815,0,0,0,0,0
8.476,6,84,25965,43,552,201,1152,19955,41,436,205,1179,6010
1775.245,17,73,3060,72,14,25003,14,3024,1,8,0,8,36
1779.769,17,142,11360,71,48,25425,48,5396,71,56,25425,56,5964
252.072,2,2,64,2,8,252072,8,64,0,0,0,0,0
7.838,6,2,1235,1,0,0,0,40,1,1155,0,1155,1195
0.358,6,10,968,5,256,88,256,460,5,304,88,304,508
1799.353,6,358,22669,209,69,8650,69,12569,149,69,12157,69,10100
1763.638,6,201,22979,104,69,17122,721,8600,97,233,18368,1414,14379
240.305,6,43,9028,21,519,12014,1402,5777,22,233,11442,618,3251
1791.563,6,365,25501,212,100,8490,469,14896,153,69,11786,69,10605
63.151,6,75,48228,46,1173,1403,1448,39962,29,675,2231,1448,8266
0.181,6,49,23824,27,1100,6,1420,18711,22,467,8,1883,5113
299.563,6,6,364,4,31,99854,31,222,2,31,299536,31,142
1773.013,6,204,22399,131,75,13638,267,10097,73,135,24621,2840,12302
140.516,6,43,8507,21,124,7025,267,1971,22,353,6690,1997,6536
141.92,6,21,3549,7,92,23653,92,452,14,215,10904,1408,3097
418.266,2,3,96,3,8,209133,8,96,0,0,0,0,0
0.128,17,2,197,1,41,0,41,69,1,100,0,100,128
0.632,6,4,220,2,0,632,0,100,2,0,303,0,120
1797.622,17,124,25199,124,175,14614,422,25199,0,0,0,0,0
5.673,6,40,7309,20,218,298,314,3423,20,513,284,1179,3886
300.803,6,31,15409,17,524,18791,1360,3335,14,1437,23127,3597,12074
1.234,6,10,1687,7,100,205,100,384,3,1179,485,1179,1303
182.743,17,4,352,2,60,182742,60,176,2,60,182742,60,176
95.027,6,29,7392,13,158,7918,267,1317,16,603,6331,2036,6075
8.775,6,85,26922,43,576,208,1152,20760,42,407,207,1152,6162
0.007,17,2,146,1,37,0,37,65,1,53,0,53,81
1.251,6,48,19205,27,891,48,1460,13589,21,433,54,1460,5616
0.0,6,1,1255,1,1203,0,1203,1255,0,0,0,0,0
0.159,6,9,468,0,0,0,0,0,9,0,0,0,468
221.473,6,37,4657,22,304,10546,304,3280,15,83,15818,83,1377
62.004,6,24,7057,12,155,5636,267,1266,12,662,5635,4846,5791
10.301,17,22,11007,10,603,1143,1350,6310,12,363,933,1350,4697
0.0,6,1,40,0,0,0,0,0,1,0,0,0,40
343.344,6,61,3889,34,69,10404,69,2050,27,69,13205,69,1839
368.593,6,27,1767,18,177,21681,177,1181,9,110,8591,110,586
421.607,2,4,128,4,8,140535,8,128,0,0,0,0,0
280.192,6,26,7272,12,158,25472,267,1277,14,775,21550,4200,5995
38.875,17,43,6132,22,48,1849,48,1672,21,184,1941,308,4460
3.08,17,4,292,2,37,3003,37,130,2,53,3073,53,162
1783.228,17,83,3480,82,14,22015,14,3444,1,8,0,8,36
0.357,6,27,9069,13,261,29,683,1728,14,943,26,1408,7341
0.001,17,2,158,1,34,0,34,62,1,68,0,68,96
3.537,6,25,8787,15,289,252,599,1471,10,987,361,1452,7316
1720.503,17,12,498,11,14,172050,14,462,1,8,0,8,36
1780.509,6,186,26628,102,167,17628,721,17289,84,284,9369,1440,9339
1796.046,6,367,25650,214,99,8432,469,15045,153,69,11813,69,10605
1.222,6,26,8108,12,164,94,267,1288,14,869,80,1448,6820
1788.813,17,87,3648,86,14,21044,14,3612,1,8,0,8,36
1787.486,6,127,14443,80,82,22626,502,6184,47,155,38856,1420,8259
0.014,17,2,203,1,46,0,46,74,1,101,0,101,129
1772.509,6,205,22439,131,75,13634,267,10097,74,133,24279,2840,12342
1763.875,2,12,384,12,8,160352,8,384,0,0,0,0,0
5.472,6,42,7389,22,218,260,314,3503,20,440,274,1152,3886
299.518,6,6,364,4,31,99839,31,222,2,31,299508,31,142
0.171,17,2,152,1,48,0,48,76,1,48,0,48,76
280.487,6,29,7392,13,158,23373,267,1317,16,678,18696,3456,6075
33.035,17,4,240,2,32,33034,32,120,2,32,33034,32,120
0.481,6,13,1968,7,262,80,517,896,6,752,59,752,1072
1745.558,17,299,68426,299,200,5857,422,68426,0,0,0,0,0
0.932,6,10,1687,7,100,155,100,384,3,1179,338,1179,1303
130.02,6,20,8730,11,333,68,692,1473,9,1377,16236,3928,7257
20.152,6,22,6128,13,147,1679,318,1285,9,873,2517,1659,4843
300.54,6,12,927,6,177,60074,177,509,6,110,60074,110,418
0.747,6,21,5000,11,137,74,267,1132,10,692,71,1467,3868
0.007,17,3,1007,1,137,0,137,165,2,393,2,393,842
7.01,6,30,7504,12,155,637,267,1266,18,393,411,1997,6238
0.951,17,6,540,3,30,452,30,174,3,94,423,94,366
280.298,6,30,7432,13,158,23358,267,1317,17,543,17515,1400,6115
0.013,17,2,192,1,42,0,42,70,1,94,0,94,122
10.992,6,20,4442,11,275,1099,275,998,9,768,784,1440,3444
280.47,6,30,7432,13,158,23372,267,1317,17,603,17524,2076,6115
113.248,6,44,8829,20,176,5960,721,2217,24,403,4675,1420,6612
0.356,17,4,317,2,39,355,39,134,2,63,343,72,183
1772.976,6,180,15480,120,69,14898,69,8940,60,69,30045,69,6540
0.957,6,4,191,1,0,0,0,40,3,31,478,31,151
0.279,6,9,1345,5,145,69,145,349,4,832,31,832,996
1619.744,2,24,768,24,8,70423,8,768,0,0,0,0,0
1.001,17,4,624,2,64,1000,64,184,2,192,882,192,440
149.64,17,48,7292,24,48,6502,48,1824,24,199,6503,308,5468
1.204,6,25,8056,12,164,93,267,1288,13,869,85,1440,6768
1769.958,6,103,9643,68,65,26417,65,5758,35,59,52053,59,3885
0.813,6,15,2670,7,288,105,288,632,8,568,91,853,2038
3.113,17,8,1988,4,40,1034,40,272,4,401,1033,423,1716
1661.08,1,8,448,8,28,237297,28,448,0,0,0,0,0
1783.797,6,122,7758,70,48,25852,208,4779,52,31,34966,31,2979
1624.398,2,18,576,18,8,95552,8,576,0,0,0,0,0
0.08,17,2,152,2,48,80,48,152,0,0,0,0,0
1.937,17,2,672,2,308,1937,308,672,0,0,0,0,0
0.647,6,49,20771,27,969,24,1432,15649,22,383,30,1432,5122
1792.142,17,180,14040,180,50,10011,50,14040,0,0,0,0,0
1697.151,17,16,1265,8,30,242445,37,471,8,71,242447,136,794
2.309,17,17,7955,8,577,324,1350,4845,9,317,283,1350,3110
112.992,17,4,244,2,33,112991,33,122,2,33,112991,33,122
1783.806,6,416,24920,208,69,8617,69,12460,208,34,8617,48,12460
37.268,1,4,336,4,56,12422,56,336,0,0,0,0,0
0.046,17,4,288,2,33,0,33,122,2,55,0,61,166
782.16,2,7,224,7,8,130360,8,224,0,0,0,0,0
1789.078,17,142,11360,71,48,25558,48,5396,71,56,25558,56,5964
240.291,6,43,9011,21,524,12014,1418,5817,22,226,11441,639,3194
0.208,17,2,290,1,40,0,40,68,1,194,0,194,222
1795.816,1,252,14112,252,28,7154,28,14112,0,0,0,0,0
845.036,1,10,560,10,28,93892,28,560,0,0,0,0,0
1798.506,17,87,3648,86,14,21158,14,3612,1,8,0,8,36
1.304,6,30,6427,15,164,93,267,1922,15,780,83,1460,4505
1.081,6,30,9712,16,222,67,540,2016,14,1017,68,1591,7696
66.487,6,11,1583,11,127,6648,127,1583,0,0,0,0,0
285.076,6,21,1509,11,330,28506,330,910,10,83,31673,83,599
14.15,6,24,7074,7,165,2358,267,949,17,418,873,1460,6125
26.646,17,8,608,8,48,3806,48,608,0,0,0,0,0
4.05,17,5,290,5,30,1012,30,290,0,0,0,0,0
15.687,6,6,328,4,0,5229,0,216,2,0,15333,0,112
0.651,6,9,1002,5,213,162,213,417,4,421,205,421,585
1799.697,1,16,896,16,28,119979,28,896,0,0,0,0,0
0.083,17,2,152,1,48,0,48,76,1,48,0,48,76
0.132,17,4,288,2,33,2,33,122,2,55,128,61,166
1797.091,17,448,39896,403,35,4470,288,25676,45,288,40020,288,14220
0.2,6,10,1669,6,551,40,947,1346,4,159,66,159,323
0.453,17,11,5261,6,491,90,1350,3115,5,401,83,1350,2146
29.538,6,20,3130,12,183,2685,517,1561,8,381,4218,499,1569
1.44,17,4,580,2,40,1377,40,136,2,194,1407,194,444
364.702,6,18,1239,14,177,28054,177,913,4,110,20055,110,326
1.282,17,14,5083,14,335,98,361,5083,0,0,0,0,0
1774.269,17,142,11360,71,48,25346,48,5396,71,56,25346,56,5964
0.25,17,2,144,1,36,0,36,64,1,52,0,52,80
0.277,17,2,396,1,39,0,39,67,1,301,0,301,329
1784.532,6,107,8561,69,65,26243,65,5035,38,59,48226,59,3526
0.269,6,2,191,1,0,0,0,40,1,99,0,99,151
7.09,6,9,685,8,31,1012,31,602,1,31,0,31,83
0.902,6,12,1653,6,288,175,288,548,6,426,94,434,1105
221.933,6,16,1144,9,34,27722,38,638,7,35,36963,40,506
12.013,6,20,4442,11,275,1201,275,998,9,768,1375,1440,3444
240.2,6,52,18307,27,827,9238,1418,15487,25,189,10007,580,2820
259.128,17,4,340,2,37,259122,37,130,2,77,259121,77,210
1789.531,6,410,35698,226,115,7953,1189,17845,184,127,9778,1420,17853
1.373,6,18,5945,8,290,196,517,993,10,1468,147,2456,4952
12.92,6,1936,1766908,1247,1363,10,1420,1734997,689,475,18,1883,31911
271.722,6,685,640208,275,143,991,352,16362,410,1510,664,4254,623846
240.962,6,28,7352,13,158,20080,267,1317,15,678,17206,3436,6035
11.804,6,1888,1626011,1148,1362,10,1380,1590246,740,558,15,1923,35765
62.851,6,21,8257,10,220,6983,516,1286,11,725,6261,1452,6971
0.271,6,21,5000,10,137,30,267,1092,11,692,25,1467,3908
1797.594,6,244,35807,151,302,11983,302,25972,93,83,19538,102,9835
1790.124,6,362,22967,211,69,8524,69,12787,151,69,11934,69,10180
1.968,6,12,5718,4,106,656,106,274,8,852,256,1926,5444
80.048,6,10141,9750716,6800,1357,11,1408,9572320,3341,931,23,2801,178396
270.107,17,4,240,2,32,270106,32,120,2,32,270106,32,120
1.158,17,2,1251,2,597,1158,1030,1251,0,0,0,0,0
92.59,6,35,7911,16,140,6172,267,1633,19,367,5132,1452,6278
1714.962,17,16,1265,8,30,244992,37,471,8,71,244992,136,794
134.448,17,8,704,4,48,44813,48,304,4,72,44812,72,400
11.462,6,833,756544,544,1321,20,1368,736852,289,776,39,1473,19692
243.341,6,76,21543,36,679,6952,1408,17500,40,162,6239,580,4043
8.135,6,13,7424,8,863,1162,869,7224,5,0,1958,0,200
1792.821,1,150,15900,150,78,12032,78,15900,0,0,0,0,0
73.006,17,4,240,2,32,73005,32,120,2,32,73005,32,120
27.347,1,4,224,4,28,9115,28,224,0,0,0,0,0
0.117,6,3,156,0,0,0,0,0,3,0,0,0,156
1797.08,17,448,39896,403,35,4470,288,25676,45,288,40019,288,14220
1.534,6,25,8056,13,164,109,267,1340,12,1014,120,2491,6716
0.012,17,2,235,1,36,0,36,64,1,143,0,143,171
1746.125,6,95,7203,63,38,28163,205,4476,32,33,56312,98,2727
280.208,6,26,7272,13,158,23350,267,1317,13,905,23347,4845,5955
26.116,6,35,8908,18,339,1536,721,2767,17,778,1619,1440,6141
76.005,1,2,112,2,28,76005,28,112,0,0,0,0,0
1754.737,6,187,11425,94,47,18868,208,6775,93,31,19070,31,4650
0.163,17,2,198,1,37,0,37,65,1,105,0,105,133
1681.576,17,14,1036,7,30,280257,30,406,7,62,280257,62,630
1.391,6,49,18984,27,872,53,1360,13328,22,433,57,1360,5656
240.257,6,58,21145,32,818,7749,1418,18041,26,218,9609,580,3104
1793.554,17,87,3648,86,14,21100,14,3612,1,8,0,8,36
1120.779,17,12,3127,6,31,224154,37,355,6,434,224154,463,2772
1795.08,17,80,3354,79,14,23013,14,3318,1,8,0,8,36
1782.93,1,134,7504,134,28,13405,28,7504,0,0,0,0,0
1744.452,6,95,7203,63,38,28136,205,4476,32,33,56265,98,2727
2.434,6,15,2391,9,188,304,245,740,6,703,434,1152,1651
5.57,6,39,7285,20,218,293,314,3423,19,516,294,1179,3862
2.592,17,4,1568,4,364,864,364,1568,0,0,0,0,0
1773.846,6,180,15480,120,69,14906,69,8940,60,69,30061,69,6540
1028.553,17,204,15504,204,48,5066,48,15504,0,0,0,0,0
0.147,6,9,1147,5,145,36,145,349,4,634,37,634,798
1789.966,1,60,5040,0,0,0,0,0,60,56,30338,56,5040
1765.195,2,16,512,16,8,117679,8,512,0,0,0,0,0
1791.886,6,356,22520,208,69,8656,69,12460,148,69,12189,69,10060
41.075,17,4,352,2,60,41073,60,176,2,60,41074,60,176
31.537,6,10,768,10,31,3504,31,768,0,0,0,0,0
0.708,6,28,5842,13,135,59,267,1337,15,650,46,1420,4505
10.814,6,20,4402,11,275,1081,275,998,9,758,750,1420,3404
280.31,6,29,7392,13,158,23359,267,1317,16,603,18679,1400,6075
61.797,6,70,48532,44,1191,1437,1408,40445,26,747,2462,1408,8087
3.302,17,5,588,4,64,1091,64,368,1,192,0,192,220
0.331,17,8,2774,8,318,47,357,2774,0,0,0,0,0
1772.406,6,180,15480,120,69,14894,69,8940,60,69,30037,69,6540
280.267,6,29,7392,13,158,23355,267,1317,16,603,18682,2036,6075
1770.227,6,210,16158,78,68,22986,295,7650,132,48,13513,78,8508
585.084,17,629,47776,343,40,1710,41,23552,286,56,2052,57,24224
0.0,6,1,52,0,0,0,0,0,1,0,0,0,52
0.024,6,13,1041,8,182,3,182,618,5,77,4,134,423
1794.432,17,144,11520,72,48,25273,48,5472,72,56,25273,56,6048
1740.908,1,15,840,15,28,124350,28,840,0,0,0,0,0
280.219,6,29,7392,13,158,23351,267,1317,16,603,18679,1400,6075
29.852,1,8,832,0,0,0,0,0,8,76,4264,76,832
1615.219,1,14,784,14,28,124247,28,784,0,0,0,0,0
0.496,17,4,624,2,64,495,64,184,2,192,376,192,440
1786.777,6,102,8296,68,65,26668,65,4930,34,59,54141,59,3366
9.489,6,1269,991575,662,1398,14,1448,950267,607,776,15,1448,41308
7.705,6,13,2133,8,324,1100,585,1073,5,396,1889,580,1060
560.409,17,6,444,3,30,280195,30,174,3,62,280195,62,270
0.01,17,2,146,1,37,0,37,65,1,53,0,53,81
3.345,6,25,6059,12,108,304,147,919,13,768,276,1581,5140
2.202,17,4,314,2,31,2182,31,118,2,70,2181,70,196
19.102,6,16,1327,8,222,2727,222,768,8,231,2727,231,559
6.555,6,38,7229,20,218,345,314,3423,18,513,348,1179,3806
1799.669,6,356,22520,208,69,8694,69,12460,148,69,12242,69,10060
1721.519,17,12,498,11,14,172151,14,462,1,8,0,8,36
57.37,17,8,2688,8,308,8195,308,2688,0,0,0,0,0
7.756,6,9,392,4,0,2585,0,172,5,0,1126,0,220
300.641,17,192,57066,94,486,3232,1350,48344,98,61,3092,1350,8722
1744.647,2,18,576,18,8,102626,8,576,0,0,0,0,0
161.55,6,23,9009,11,355,70,764,1539,12,872,14672,1460,7470
0.24,17,4,396,2,39,0,39,134,2,103,1,103,262
131.407,6,25,11758,12,741,79,1460,3478,13,1106,10938,1460,8280
1794.038,17,142,11360,71,48,25628,48,5396,71,56,25628,56,5964
3.963,17,8,668,4,39,1310,39,268,4,72,1310,72,400
0.014,17,2,475,1,40,0,40,68,1,379,0,379,407
1789.663,6,356,22520,208,69,8645,69,12460,148,69,12174,69,10060
739.446,17,85,7341,78,30,9603,37,4552,7,370,113461,463,2789
3.007,17,4,248,4,34,1002,34,248,0,0,0,0,0
1.361,6,41,12001,22,617,64,1360,6465,19,476,65,2715,5536
2.28,6,15,2391,9,188,285,245,740,6,703,407,1152,1651
0.815,6,15,2670,7,288,106,288,632,8,568,89,853,2038
4.997,17,4,558,2,36,4991,36,128,2,187,4992,187,430
24.54,6,21,4538,10,211,2726,722,1571,11,793,2433,1448,2967
582.901,1,46,4876,46,78,12953,78,4876,0,0,0,0,0
1796.023,17,142,11360,71,48,25656,48,5396,71,56,25656,56,5964
0.63,17,2,168,1,48,0,48,76,1,64,0,64,92
15.094,6,21,4540,9,256,1886,722,1513,12,342,1328,1408,3027
0.293,17,2,144,1,36,0,36,64,1,52,0,52,80
76.686,6,7,392,4,0,25562,0,216,3,0,1095,0,176
265.156,6,528,491675,179,565,1489,1408,21595,349,1407,761,2816,470080
0.162,6,13,2100,7,329,27,500,1030,6,375,32,500,1070
1771.068,6,99,9306,66,66,27247,66,5610,33,60,55342,60,3696
0.55,1,10,840,10,56,61,56,840,0,0,0,0,0
42.515,17,12,912,12,48,3865,48,912,0,0,0,0,0
53.937,17,16,18211,16,1110,3595,1451,18211,0,0,0,0,0
349.966,6,43,6178,24,119,15207,722,2571,19,289,19432,2330,3607
18.036,6,125,78700,63,716,290,1460,8366,62,1330,249,1460,70334
60.235,17,28,2339,26,30,2409,37,1515,2,384,374,463,824
1681.407,17,14,1045,7,30,280231,30,406,7,63,280231,71,639
0.07,1,2,112,2,28,70,28,112,0,0,0,0,0
1681.221,17,16,4213,8,30,240173,37,471,8,439,240173,463,3742
0.232,6,21,5000,10,137,25,267,1092,11,692,21,1467,3908
1798.229,1,262,14672,262,28,6889,28,14672,0,0,0,0,0
0.959,17,20,7147,8,303,137,1350,2649,12,346,74,1350,4498
0.033,17,2,201,1,50,0,50,78,1,95,0,95,123
1770.111,6,129,10805,76,57,23601,205,6038,53,41,34037,98,4767
60.882,1,16,1664,0,0,0,0,0,16,76,4058,76,1664
518.274,17,4,1572,4,365,172758,548,1572,0,0,0,0,0
0.038,17,2,198,1,37,0,37,65,1,105,0,105,133
1757.26,6,101,7639,63,38,28342,205,4476,38,32,47485,98,3163
0.155,17,2,196,1,46,0,46,74,1,94,0,94,122
1.212,17,4,560,2,64,862,64,184,2,160,938,160,376
1761.12,1,75,6300,0,0,0,0,0,75,56,23798,56,6300
240.345,6,45,9221,24,523,10449,1408,5963,21,239,12017,618,3258
94.714,6,36,9811,12,156,8609,267,1740,24,394,4117,1460,8071
0.074,17,2,290,1,40,0,40,68,1,194,0,194,222
1772.519,17,298,68089,298,200,5968,422,68089,0,0,0,0,0
64.677,6,24,13181,14,257,4975,463,1365,10,1900,7171,3950,11816
20.187,6,27,7046,15,124,1441,159,1548,12,695,1834,1418,5498
0.131,17,2,618,2,281,131,316,618,0,0,0,0,0
1782.125,17,83,3480,82,14,22001,14,3444,1,8,0,8,36
155.445,6,27,6155,11,267,74,502,1246,16,328,10357,1420,4909
0.074,17,2,136,1,32,0,32,60,1,48,0,48,76
1.758,17,18,5691,8,357,246,1350,3086,10,232,191,1350,2605
39.049,17,22,1936,11,48,3904,48,836,11,72,3903,72,1100
15.679,17,20,12452,11,902,1563,1350,10234,9,218,1954,1350,2218
1772.683,6,205,22439,130,75,13741,267,10057,75,132,23954,1452,12382
15.819,6,29,7392,13,158,1318,267,1317,16,603,1052,2036,6075
1.311,6,49,21377,29,913,46,1360,15801,20,476,59,2715,5576
70.908,17,4,352,2,60,70907,60,176,2,60,70907,60,176
0.896,6,10,1687,7,100,149,100,384,3,1179,320,1179,1303
0.12,6,2,111,1,0,0,0,40,1,31,0,31,71
39.551,17,22,1936,11,48,3953,48,836,11,72,3953,72,1100
1796.291,17,448,39612,404,35,4457,288,25708,44,288,40952,288,13904
28.998,6,9,2914,2,92,8997,92,204,7,1165,4800,1408,2710
0.245,6,22,5040,11,137,24,267,1132,11,692,23,2800,3908
11.543,6,71,20518,37,547,320,1152,15731,34,489,342,1179,4787
1605.384,1,7,392,7,28,267564,28,392,0,0,0,0,0
61.307,6,36,15919,22,804,2919,1402,9193,14,748,4697,2804,6726
7.215,2,2,64,2,8,7215,8,64,0,0,0,0,0
0.03,17,2,189,1,37,0,37,65,1,96,0,96,124
0.936,6,22,5040,11,137,93,267,1132,11,692,91,1467,3908
0.01,17,2,550,2,247,10,247,550,0,0,0,0,0
25.065,6,7,380,4,0,8355,0,216,3,0,12525,0,164
3.076,17,4,1556,4,361,1025,361,1556,0,0,0,0,0
127.659,6,1061,552320,610,841,209,1152,529473,451,400,283,1152,22847
0.0,17,1,1100,1,1072,0,1072,1100,0,0,0,0,0
1762.325,17,360,59760,360,138,4908,385,59760,0,0,0,0,0
1.738,6,14,2351,9,188,217,245,740,5,1407,366,1407,1611
1.479,6,51,18320,26,882,59,1440,12544,25,433,53,1440,5776
1789.297,17,83,3480,82,14,22090,14,3444,1,8,0,8,36
1.672,6,48,19329,29,892,59,1360,13748,19,480,81,4075,5581
1793.634,6,364,23047,211,69,8541,69,12787,153,69,11798,69,10260
303.794,6,38,8996,20,142,15989,516,1945,18,421,17865,1452,7051
3.018,6,2,332,2,126,3018,126,332,0,0,0,0,0
0.111,6,9,1346,5,145,27,145,349,4,833,32,833,997
229.43,6,31,8912,14,158,17648,267,1357,17,687,14335,1400,7555
31.025,17,4,240,2,32,31024,32,120,2,32,31024,32,120
0.488,6,22,5040,11,137,48,267,1132,11,577,48,1400,3908
1795.97,17,449,39928,404,35,4456,288,25708,45,288,40021,288,14220
1741.664,6,87,6322,58,31,30555,31,3915,29,31,62201,31,2407
1.395,6,49,20582,28,920,51,1360,14966,21,433,60,1360,5616
1747.545,6,96,7286,63,38,28186,205,4476,33,33,54604,98,2810
1235.28,17,34,2358,27,30,47510,37,1580,7,83,186882,136,778
0.023,17,4,284,2,32,19,32,120,2,54,16,60,164
1740.792,6,99,7516,64,38,27631,205,4590,35,33,50789,98,2926
1776.824,1,58,4872,0,0,0,0,0,58,56,31172,56,4872
1786.182,6,104,8444,68,66,26659,66,4964,36,60,51031,60,3480
1782.707,6,356,22589,208,69,8612,69,12529,148,69,12127,69,10060
1782.421,17,140,11200,70,48,25831,48,5320,70,56,25831,56,5880
10.5,6,9,527,5,43,2625,43,311,4,0,3498,0,216
1.044,6,5,364,3,92,522,92,236,2,0,46,0,128
1719.923,17,12,498,11,14,171992,14,462,1,8,0,8,36
0.49,6,55,23565,30,1004,16,1380,18311,25,383,19,1380,5254
3.843,6,2,88,2,0,0,0,88,0,0,0,0,0
91.037,17,4,240,2,32,91036,32,120,2,32,91036,32,120
61.167,17,28,2339,26,30,2446,37,1515,2,384,356,463,824
240.212,6,53,17616,28,779,8896,1402,14712,25,199,10008,580,2904
267.63,6,169,130266,104,1317,2598,1448,117384,65,632,2557,1448,12882
0.012,17,3,716,2,64,3,64,184,1,504,0,504,532
367.098,6,25,1651,17,177,22943,177,1117,8,110,9168,110,534
86.934,6,25,6318,9,272,104,516,1180,16,345,5789,1452,5138
79.649,6,14,1668,8,304,11378,304,1024,6,83,15606,83,644
3.601,6,14,3144,8,49,514,92,511,6,579,38,1408,2633
1788.89,17,142,11360,71,48,25555,48,5396,71,56,25555,56,5964
103.595,6,28,7352,13,158,8632,267,1317,15,678,7396,3436,6035
1739.74,1,56,4704,0,0,0,0,0,56,56,31631,56,4704
1791.464,1,262,14672,262,28,6863,28,14672,0,0,0,0,0
0.307,17,2,152,1,48,0,48,76,1,48,0,48,76
0.721,6,9,1560,5,514,180,514,782,4,562,240,562,778
276.003,6,70,47714,45,1166,6272,1408,39680,25,960,2567,3847,8034
1792.825,6,356,22520,208,69,8660,69,12460,148,69,12194,69,10060
276.761,17,19,6792,19,329,15375,548,6792,0,0,0,0,0
18.094,17,16,9030,9,745,2229,1350,6961,7,267,2975,1350,2069
1.058,2,3,144,3,24,529,32,144,0,0,0,0,0
317.03,6,63,18402,37,325,8806,1360,9657,26,641,12675,4649,8745
0.1,6,9,1343,5,145,25,145,349,4,830,29,830,994
1167.205,17,17,6152,17,333,72950,1114,6152,0,0,0,0,0
1787.491,6,104,8376,68,65,26678,65,4930,36,59,51067,59,3446
11.594,17,8,704,4,48,3861,48,304,4,72,3861,72,400
3.52,6,2,88,2,0,0,0,88,0,0,0,0,0
2.029,6,10,921,5,41,506,41,309,5,344,506,344,612
280.1,6,31,7472,14,158,21546,267,1357,17,543,17500,1400,6115
1780.878,6,249,25331,99,66,18172,594,9323,150,133,11951,2720,16008
1604.364,6,151,18252,83,99,19565,721,9605,68,257,11870,1440,8647
0.876,6,15,2670,7,288,110,288,632,8,568,96,853,2038
0.469,17,3,451,2,39,104,39,134,1,289,0,289,317
1741.036,6,91,6604,59,31,30017,31,3998,32,31,56162,31,2606
1.659,6,14,2351,8,188,237,245,700,6,703,281,1152,1651
3.414,6,15,1144,8,181,487,181,601,7,77,511,134,543
1773.339,6,209,22806,132,75,13536,267,10344,77,137,23329,3426,12462
0.593,6,28,9060,13,253,49,653,1698,15,939,39,1368,7362
1786.62,6,104,8376,68,65,26665,65,4930,36,59,51043,59,3446
1679.121,1,8,448,8,28,239874,28,448,0,0,0,0,0
0.614,6,27,9157,13,277,51,747,1804,14,943,43,1368,7353
5.284,6,40,7325,21,218,264,314,3463,19,516,278,1179,3862
102.279,6,28,14374,16,493,53,1360,2659,12,1603,9285,3928,11715
61.319,6,38,17535,23,809,2787,1408,9349,15,822,4361,2816,8186
85.109,6,46,7954,19,218,355,314,3383,27,498,3263,1179,4571
0.148,17,2,167,1,39,0,39,67,1,72,0,72,100
794.51,17,10,821,5,31,198624,37,297,5,76,198624,136,524
11.747,6,1755,1608701,1137,1363,10,1420,1579606,618,427,19,1420,29095
61.184,1,4,224,4,28,20394,28,224,0,0,0,0,0
1786.825,6,104,8308,68,64,26669,64,4896,36,58,51049,58,3412
10.773,6,18,5610,10,275,1197,275,958,8,1440,822,1440,4652
0.081,6,9,1344,5,145,20,145,349,4,831,22,831,995
157.008,6,10,547,3,0,78504,0,152,7,7,26121,7,395
1750.81,17,13,534,11,14,175061,14,462,2,8,1750621,8,72
14.348,6,109,36087,55,633,265,1152,29445,54,407,265,1152,6642
1799.498,1,58,4872,0,0,0,0,0,58,56,31570,56,4872
44.494,17,4,352,2,60,44493,60,176,2,60,44493,60,176
1792.518,17,455,52345,208,154,8659,1350,37870,247,30,7286,60,14475
1791.315,1,270,15120,270,28,6659,28,15120,0,0,0,0,0
146.537,17,4,352,2,60,146535,60,176,2,60,146536,60,176
1786.453,6,102,8296,68,65,26663,65,4930,34,59,54132,59,3366
0.135,17,2,488,1,45,0,45,73,1,387,0,387,415
61.558,6,19,772,10,0,6838,0,404,9,0,7693,0,368
0.457,17,5,1701,5,312,114,355,1701,0,0,0,0,0
10.735,6,84,24933,42,544,261,1152,19096,42,461,255,1179,5837
3.467,6,2,88,2,0,0,0,88,0,0,0,0,0
0.929,6,10,924,5,283,187,283,551,5,105,186,105,373
300.615,6,41,8815,21,315,15030,916,2170,20,388,822,2128,6645
96.743,17,4002,4876304,468,67,207,1350,44916,3534,1339,27,1350,4831388
62.488,6,12,732,3,106,31240,106,234,9,90,7809,90,498
1772.036,6,180,15480,120,69,14891,69,8940,60,69,30033,69,6540
565.565,6,89,11854,46,82,12500,721,4304,43,291,13461,1414,7550
1599.559,17,18,1413,9,30,199943,37,529,9,70,199943,136,884
41.068,6,42,8673,20,345,664,720,1915,22,366,1948,2128,6758
17.544,17,4,352,2,60,17543,60,176,2,60,17542,60,176
251.511,2,3,96,3,8,125755,8,96,0,0,0,0,0
376.148,6,23,1499,14,177,28934,177,913,9,110,9827,110,586
3.541,17,5,290,5,30,885,30,290,0,0,0,0,0
107.827,17,4,352,2,60,107826,60,176,2,60,107826,60,176
35.882,17,4,352,2,60,35881,60,176,2,60,35881,60,176
0.105,17,2,396,1,39,0,39,67,1,301,0,301,329
1748.212,6,95,7203,63,38,28196,205,4476,32,33,56380,98,2727
1772.745,6,180,15480,120,69,14897,69,8940,60,69,30042,69,6540
1734.891,17,48,16110,48,307,36912,329,16110,0,0,0,0,0
0.011,17,2,475,1,40,0,40,68,1,379,0,379,407
25.168,6,37,13555,18,219,1480,531,1885,19,1065,1396,1438,11670
20.402,6,24,6232,14,117,1569,159,1337,10,727,2265,1418,4895
1798.26,6,121,12203,77,62,23661,721,6400,44,97,41812,2330,5803
1611.605,1,24,1344,24,28,70069,28,1344,0,0,0,0,0
1784.856,6,358,22669,209,69,8581,69,12569,149,69,12056,69,10100
35.713,6,27,6388,15,117,2550,159,1389,12,727,3243,1418,4999
1772.231,6,180,15480,120,69,14892,69,8940,60,69,30031,69,6540
14.979,6,23,3713,16,211,997,211,1358,7,665,2496,904,2355
151.29,6,33,14370,16,488,320,1460,3127,17,959,9447,1460,11243
295.26,1,4,224,4,28,98420,28,224,0,0,0,0,0
8.812,6,1570,1420869,978,1374,8,1408,1385421,592,931,14,2816,35448
4.228,6,299,205793,152,1082,28,1360,23521,147,1367,27,4080,182272
0.386,17,2,152,1,48,0,48,76,1,48,0,48,76
1556.384,2,12,384,12,8,141489,8,384,0,0,0,0,0
243.943,17,6,360,3,32,121971,32,180,3,32,121971,32,180
1772.893,6,181,15589,120,69,14898,69,8940,61,69,29542,69,6649
0.968,6,22,7900,12,164,88,267,1288,10,1216,89,3819,6612
9.219,6,89,29764,46,603,204,1152,23562,43,447,213,1179,6202
1787.906,6,359,22709,209,69,8595,69,12569,150,69,11999,69,10140
0.98,17,4,282,3,34,440,34,186,1,68,0,68,96
1799.803,6,163,22183,113,138,16069,827,15967,50,88,35006,192,6216
37.576,17,22,1672,22,48,1789,48,1672,0,0,0,0,0
1775.111,17,354,55787,354,129,5028,376,55787,0,0,0,0,0
12.264,6,1899,1712287,1204,1367,10,1380,1678254,695,467,17,1923,34033
233.837,17,4,352,2,60,233836,60,176,2,60,233836,60,176
15.966,6,21,6617,6,154,3193,267,712,15,481,1139,1420,5905
1795.777,6,204,14140,74,46,24599,46,5950,130,46,13920,46,8190
0.055,6,12,3704,6,171,11,171,491,6,964,10,1448,3213
855.846,17,610,42959,542,40,1581,41,37210,68,56,559,57,5749
29.808,17,4,352,2,48,29800,48,152,2,72,29799,72,200
0.791,6,9,1880,5,910,197,910,1178,4,486,263,486,702
0.018,6,9,1612,5,636,4,636,904,4,492,5,492,708
22.679,6,8,336,2,0,3053,0,84,6,0,4511,0,252
1798.371,17,139,11116,70,48,26063,48,5320,69,56,26054,56,5796
1799.94,17,449,39928,404,35,4466,288,25708,45,288,40019,288,14220
6.88,6,583,498375,359,1320,18,1368,482063,224,776,29,1473,16312
40.667,17,17,1292,17,48,2541,48,1292,0,0,0,0,0
11.88,6,1894,1614551,1142,1362,10,1380,1578261,752,515,15,1923,36290
0.014,17,2,588,1,60,0,60,88,1,472,0,472,500
62.239,6,74,50585,46,1176,1383,1368,42395,28,840,2294,2736,8190
0.119,17,4,284,2,32,41,32,120,2,54,80,60,164
0.024,17,2,672,2,308,24,308,672,0,0,0,0,0
841.829,6,57,8232,29,262,30062,517,2304,28,893,31176,2736,5928
0.296,17,2,154,1,41,0,41,69,1,57,0,57,85
8.32,6,20,6643,9,182,1040,267,1099,11,728,805,1452,5544
8.12,1,9,756,0,0,0,0,0,9,56,1015,56,756
0.045,17,4,364,2,52,1,52,160,2,74,38,80,204
79.786,17,4,352,2,60,79785,60,176,2,60,79785,60,176
1797.435,1,290,16240,290,28,6219,28,16240,0,0,0,0,0
1636.438,17,130,10400,65,48,25569,48,4940,65,56,25569,56,5460
2.09,6,50,20454,28,906,77,1360,14753,22,437,90,2715,5701
0.379,6,6,324,4,0,126,0,216,2,0,196,0,108
0.012,17,4,284,2,32,7,32,120,2,54,8,60,164
9.673,6,21,7799,8,154,1381,267,792,13,719,784,1452,7007
0.011,17,2,322,1,33,0,33,61,1,233,0,233,261
0.113,17,4,524,2,39,0,39,134,2,167,51,167,390
1003.083,6,58,4535,36,45,28659,205,2638,22,34,47755,98,1897
8.574,6,79,24717,40,561,219,1152,19016,39,413,219,1152,5701
0.642,17,4,368,2,32,641,32,120,2,96,468,96,248
1794.378,17,80,3354,79,14,23004,14,3318,1,8,0,8,36
264.85,6,29,6726,18,153,15579,516,1800,11,498,21649,1452,4926
1.946,17,2,170,1,37,0,37,65,1,77,0,77,105
0.826,6,19,5912,11,282,82,548,1292,8,859,104,2642,4620
1782.117,6,429,25962,213,69,8406,69,12798,216,35,8288,69,13164
1792.366,6,356,22520,208,69,8658,69,12460,148,69,12192,69,10060
9.313,6,39,7658,20,218,490,314,3423,19,495,503,1179,4235
1.662,6,28,9443,17,274,103,556,1508,11,936,149,1420,7935
177.22,6,12,5544,4,112,59073,112,280,8,822,25208,1420,5264
0.033,17,3,234,2,39,13,39,134,1,72,0,72,100
1788.64,17,87,3648,86,14,21042,14,3612,1,8,0,8,36
0.499,17,3,451,2,39,453,39,134,1,289,0,289,317
1796.872,17,429,33892,403,35,4469,288,25676,26,288,48028,288,8216
1.143,6,27,8591,15,236,67,625,2049,12,1512,85,4511,6542
1797.151,1,258,14448,258,28,6992,28,14448,0,0,0,0,0
0.636,6,33,8597,19,425,35,1188,4813,14,381,42,758,3784
1740.435,6,87,6322,58,31,30533,31,3915,29,31,62156,31,2407
90.19,6,6,333,2,31,463,31,111,4,31,30000,31,222
1699.487,17,12,498,11,14,169948,14,462,1,8,0,8,36
104.191,6,30,7432,13,158,8682,267,1317,17,543,6509,1400,6115
150.812,6,24,10282,12,433,72,990,1823,12,995,13697,1390,8459
299.668,6,6,364,4,31,99889,31,222,2,31,299644,31,142
0.668,17,19,7724,9,502,83,1350,4771,10,267,68,1350,2953
11.956,6,97,28735,50,565,244,1152,22373,47,447,254,1179,6362
2.02,6,9,527,5,43,505,43,311,4,0,620,0,216
17.465,17,20,7326,9,477,2179,1350,4549,11,224,1743,1350,2777
1792.215,17,142,11360,71,48,25602,48,5396,71,56,25602,56,5964
11.715,17,4,824,2,48,11696,48,152,2,308,11694,308,672
252.487,2,3,96,3,8,126243,8,96,0,0,0,0,0
1.447,6,47,19234,27,896,55,1360,13658,20,476,66,2715,5576
6.021,6,28,7062,15,282,430,613,2751,13,725,485,1767,4311
123.85,6,30,7432,13,158,10320,267,1317,17,543,7738,1400,6115
280.189,6,29,7392,13,158,23349,267,1317,16,603,18677,2036,6075
0.648,6,23,6000,13,108,54,147,959,10,927,67,2600,5041
252.078,2,2,64,2,8,252078,8,64,0,0,0,0,0
0.349,6,26,8862,13,231,29,563,1608,13,938,28,1438,7254
818.193,1,9,975,9,80,102274,105,975,0,0,0,0,0
1681.277,17,14,1045,7,30,280209,30,406,7,63,280209,71,639
993.091,6,143,23688,82,304,12260,304,16772,61,83,16542,83,6916
1783.693,6,361,22927,209,69,8575,69,12569,152,69,11810,69,10358
3.948,17,5,1160,5,204,987,204,1160,0,0,0,0,0
1712.95,1,8,848,8,78,244707,78,848,0,0,0,0,0
33.582,6,35,5361,16,180,2238,722,1923,19,222,1854,1402,3438
1.455,6,50,19410,27,900,55,1460,13714,23,433,56,1460,5696
27.86,6,28,7217,13,155,2321,267,1306,15,482,1989,1997,5911
1786.584,6,102,8296,68,65,26665,65,4930,34,59,54135,59,3366
0.148,6,45,21720,26,1045,5,1420,16739,19,467,7,1883,4981
1799.318,1,345,28980,345,56,5230,56,28980,0,0,0,0,0
30.293,6,38,9586,18,289,1781,721,3329,20,681,1540,1440,6257
1798.124,17,450,39960,405,35,4450,288,25740,45,288,40023,288,14220
1784.376,6,79,4198,40,26,45752,26,2132,39,26,46956,26,2066
77.871,6,28,11764,13,670,128,1460,3915,15,904,5548,1460,7849
6.068,6,1517,1413094,964,1389,6,1408,1379674,553,931,10,2801,33420
300.192,6,40,9975,21,590,15000,1440,4413,19,399,16667,1440,5562
0.471,6,55,23691,30,1012,16,1380,18449,25,383,17,1380,5242
0.116,17,2,2752,2,1348,116,1348,2752,0,0,0,0,0
280.281,17,4,296,2,30,280269,30,116,2,62,280268,62,180
21.271,17,2,642,1,300,0,300,328,1,286,0,286,314
136.005,6,74,49273,46,1172,3022,1408,41084,28,960,2283,3847,8189
33.143,17,4,352,2,60,33142,60,176,2,60,33142,60,176
4.186,6,39,8448,19,175,232,721,2164,20,548,210,1420,6284
31.979,6,150,140584,51,131,639,315,3045,99,1393,326,2836,137539
3.794,17,8,736,4,32,1264,32,240,4,96,1247,96,496
20.614,6,35,7948,12,152,1874,267,1404,23,373,936,1460,6544
3.626,17,5,295,5,31,906,31,295,0,0,0,0,0
7.982,6,14,2570,9,275,997,275,918,5,1440,1485,1440,1652
300.567,6,36,8244,19,254,16698,671,1810,17,478,526,2720,6434
61.923,17,8,1176,4,48,20638,48,304,4,190,20637,308,872
33.043,6,974,870215,606,1359,54,1368,843211,368,753,89,1368,27004
39.339,17,8,608,8,48,5619,48,608,0,0,0,0,0
3.869,17,4,296,4,46,1289,46,296,0,0,0,0,0
1786.135,17,87,3648,86,14,21013,14,3612,1,8,0,8,36
372.07,6,17,1190,13,180,31005,180,864,4,110,20061,110,326
1755.961,6,105,6258,60,26,29762,27,3519,45,26,39907,27,2739
41.871,6,29,7150,18,124,2463,159,1704,11,811,4186,1659,5446
8.425,6,1602,1467231,1009,1376,8,1408,1431731,593,931,13,2801,35500
24.901,6,3587,3343252,2314,1366,10,1408,3272392,1273,776,19,1408,70860
1798.266,6,375,26177,217,98,8325,469,15303,158,69,11453,69,10874
339.097,17,16,5686,16,327,22606,548,5686,0,0,0,0,0
0.103,6,10,767,5,186,24,186,454,5,45,22,45,313
6.01,17,6,498,3,47,3003,47,225,3,63,3002,63,273
300.836,6,47,10395,23,439,13674,910,3198,24,327,417,1460,7197
0.375,17,2,152,1,48,0,48,76,1,48,0,48,76
22.247,6,3244,2930040,2019,1370,10,1408,2861640,1225,931,18,2816,68400
1799.309,17,462,42332,408,35,4420,288,26004,54,274,33220,308,16328
1.231,6,37,8212,19,320,68,1162,2716,18,476,62,2715,5496
146.255,6,27,10813,13,741,60,1360,3553,14,836,11238,1360,7260
14.12,6,27,10664,10,124,1568,124,832,17,1139,831,1460,9832
1.563,6,25,8759,15,284,111,585,1457,10,985,154,1420,7302
1744.088,6,155,13541,86,115,20518,208,9882,69,31,25641,31,3659
1774.17,6,183,15807,120,69,14908,69,8940,63,69,28608,69,6867
1794.685,17,144,11520,72,48,25277,48,5472,72,56,25277,56,6048
6.53,6,25,6481,14,263,481,559,1895,11,689,624,1895,4586
300.922,6,38,9622,18,534,17691,1360,3958,20,346,15829,1360,5664
75.819,6,99,62298,52,432,1486,986,5604,47,1291,1647,2736,56694
79.526,17,4,240,2,32,79525,32,120,2,32,79525,32,120
1773.012,6,180,15480,120,69,14899,69,8940,60,69,30046,69,6540
20.24,6,2333,2151494,1448,1404,13,1448,2099530,885,776,22,1448,51964
1793.791,1,208,11648,208,28,8665,28,11648,0,0,0,0,0
1741.125,6,87,6322,58,31,30546,31,3915,29,31,62181,31,2407
7.266,6,5,284,1,0,0,0,60,4,0,2364,0,224
292.202,6,55,9989,27,178,11236,517,2898,28,401,10820,1418,7091
0.173,6,45,21301,26,1088,6,1420,16320,19,420,9,1420,4981
0.019,17,2,186,1,29,0,29,57,1,101,0,101,129
164.706,6,24,10657,13,741,65,1360,3517,11,1337,16455,4428,7140
1793.198,1,190,10640,190,28,9487,28,10640,0,0,0,0,0
902.416,2,6,192,6,8,180483,8,192,0,0,0,0,0
0.191,6,26,7256,13,155,15,267,1301,13,603,15,2036,5955
261.239,17,40,3040,40,48,6698,48,3040,0,0,0,0,0
1744.738,2,30,960,30,8,60163,8,960,0,0,0,0,0
292.874,17,4,352,2,60,292873,60,176,2,60,292873,60,176
0.008,6,3,136,2,0,8,0,84,1,0,0,0,52
1.697,17,6,474,3,34,844,34,186,3,68,844,68,288
31.401,6,9,376,6,0,6280,0,244,3,0,1524,0,132
0.023,17,2,528,1,40,0,40,68,1,432,0,432,460
58.782,6,41,13575,21,1014,444,1360,7973,20,399,3084,1360,5602
1720.667,17,13,534,11,14,172049,14,462,2,8,1720491,8,72
190.47,6,7,432,2,112,190460,112,200,5,0,47615,0,232
1.423,6,46,18120,26,882,56,1360,12544,20,476,64,2715,5576
0.108,17,2,290,1,40,0,40,68,1,194,0,194,222
1085.785,6,197,21705,100,126,9899,469,9339,97,138,11310,1420,12366
661.81,2,7,224,7,8,110301,8,224,0,0,0,0,0
1638.044,2,13,416,13,8,136503,8,416,0,0,0,0,0
1.407,6,46,18266,26,893,56,1460,12690,20,433,63,1460,5576
1783.918,1,194,10864,194,28,9243,28,10864,0,0,0,0,0
1793.928,1,220,12320,220,28,8191,28,12320,0,0,0,0,0
1.899,6,131,197198,83,133,23,201,3887,48,4349,36,25452,193311
18.198,6,2655,2434952,1682,1367,10,1408,2379692,973,931,18,2801,55260
1784.898,6,102,8296,68,65,26640,65,4930,34,59,54085,59,3366
257.734,17,4,352,2,60,257733,60,176,2,60,257733,60,176
0.051,6,12,3704,6,171,9,171,491,6,964,10,1448,3213
159.428,6,14,945,9,31,19928,31,561,5,31,39810,31,384
298.394,1,4,224,4,28,99464,28,224,0,0,0,0,0
2.001,17,3,201,3,39,1000,39,201,0,0,0,0,0
0.021,17,2,280,1,43,0,43,71,1,181,0,181,209
1671.343,1,7,392,7,28,278557,28,392,0,0,0,0,0
1783.031,17,83,3480,82,14,22012,14,3444,1,8,0,8,36
6.02,17,29,11469,11,351,602,1350,4171,18,377,194,1350,7298
1787.036,6,77,4056,39,26,47026,26,2054,38,26,48297,26,2002
1797.293,17,445,38948,403,35,4470,288,25676,42,288,42950,288,13272
0.794,6,2,87,1,0,0,0,40,1,7,0,7,47
15.648,17,10,880,5,48,3908,48,380,5,72,3908,72,500
466.346,1,12,672,12,28,42395,28,672,0,0,0,0,0
42.548,17,24,2112,12,48,3867,48,912,12,72,3867,72,1200
18.042,17,22,8098,10,437,2001,1350,4658,12,258,1637,1350,3440
300.725,6,43,8886,22,308,14320,889,2231,21,446,585,2920,6655
11.815,6,25,8453,13,275,984,275,1078,12,983,850,1420,7375
8.113,6,12,3534,7,170,1352,170,530,5,1368,1975,1368,3004
34.671,17,10,760,10,48,3852,48,760,0,0,0,0,0
2.557,6,10,1102,6,483,511,483,803,4,83,850,83,299
520.664,1,10,560,10,28,57851,28,560,0,0,0,0,0
0.547,17,15,8453,8,705,78,1350,5871,7,340,82,1350,2582
149.358,17,4,352,2,60,149357,60,176,2,60,149357,60,176
299.527,6,6,364,4,31,99842,31,222,2,31,299516,31,142
1771.568,6,129,7894,70,26,25674,26,4206,59,26,30543,26,3688
12.312,6,35,8189,19,334,684,689,1796,16,521,567,3488,6393
365.822,6,25,1654,17,180,22863,180,1120,8,110,9287,110,534
1689.943,1,32,3392,32,78,54514,78,3392,0,0,0,0,0
296.548,1,4,224,4,28,98849,28,224,0,0,0,0,0
0.343,17,2,178,1,29,0,29,57,1,93,0,93,121
37.129,17,44,6468,22,48,1767,48,1672,22,190,1767,308,4796
70.263,17,4,352,2,60,70262,60,176,2,60,70262,60,176
0.12,17,3,2906,3,940,60,1451,2906,0,0,0,0,0
0.606,6,10,968,5,256,148,256,460,5,304,148,304,508
0.392,17,19,10212,8,532,56,1350,4486,11,492,32,1350,5726
281.799,6,28,7352,13,158,23483,267,1317,15,603,20109,2036,6035
0.929,6,11,1727,7,100,154,100,384,4,589,226,1152,1343
98.09,6,24,6299,8,272,207,516,1140,16,347,6532,1452,5159
0.112,17,7,3652,4,452,37,1350,1921,3,549,23,1350,1731
300.553,6,17,1199,7,177,50063,177,573,10,110,33375,110,626
1789.323,6,146,16762,84,92,21558,721,7622,62,179,29326,2840,9140
0.513,17,3,451,2,39,352,39,134,1,289,0,289,317
176.472,17,6,424,3,42,88235,64,212,3,42,88235,64,212
0.158,17,4,288,2,36,126,36,128,2,52,127,52,160
1.269,6,48,18786,27,861,48,1360,13170,21,433,55,1360,5616
560.844,17,6,444,3,30,280415,30,174,3,62,280414,62,270
493.568,6,108,6614,53,69,8385,69,3155,55,41,9140,69,3459
1618.308,1,126,13356,126,78,12946,78,13356,0,0,0,0,0
1799.996,6,213,14708,79,46,22692,46,6266,134,46,13532,46,8442
0.368,6,12,1653,6,288,69,288,548,6,426,41,434,1105
1799.631,6,362,25864,203,99,8909,469,14674,159,69,11389,69,11190
1746.587,1,56,4704,0,0,0,0,0,56,56,31756,56,4704
24.674,6,35,9013,16,303,1644,722,2769,19,608,1341,1380,6244
0.011,17,2,394,1,37,0,37,65,1,301,0,301,329
1.018,6,28,9312,16,208,67,475,1518,12,1043,75,3926,7794
1770.96,6,99,9174,66,64,27245,64,5544,33,58,55339,58,3630
0.068,17,4,352,2,37,63,37,130,2,83,64,89,222
1751.15,1,166,9296,166,28,10613,28,9296,0,0,0,0,0
1797.274,17,315,64072,315,175,5723,422,64072,0,0,0,0,0
0.914,6,15,3632,8,150,130,174,624,7,681,138,1452,3008
0.034,1,6,624,0,0,0,0,0,6,76,6,76,624
7.143,17,36,20090,18,724,420,1350,13547,18,335,302,1350,6543
0.798,1,10,840,10,56,88,56,840,0,0,0,0,0
26.302,6,20,14542,4,214,8767,214,406,16,1225,1635,1440,14136
1794.392,6,436,38824,236,124,7635,1189,19917,200,125,9016,1917,18907
2.88,17,6,420,3,34,1439,34,186,3,50,1439,50,234
1782.136,17,142,11360,71,48,25458,48,5396,71,56,25458,56,5964
2.235,6,20,3833,11,234,223,564,1504,9,463,256,1343,2329
345.459,17,11,3738,11,311,34545,326,3738,0,0,0,0,0
23.491,6,44,8960,20,414,688,927,2122,24,345,1015,1460,6838
295.893,17,4,352,2,60,295892,60,176,2,60,295892,60,176
1791.831,1,342,28728,342,56,5254,56,28728,0,0,0,0,0
20.042,17,25,15983,12,699,1818,1350,8735,13,529,1665,1350,7248
0.042,17,2,672,2,308,42,308,672,0,0,0,0,0
665.46,6,72,9394,41,316,16636,316,6276,31,83,22168,83,3118
1.051,6,3,160,2,0,986,0,120,1,0,0,0,40
348.542,6,553,121382,328,386,1065,1368,59975,225,229,1555,1328,61407
1744.342,6,121,11598,74,91,23895,205,7791,47,31,37913,33,3807
3.251,17,4,304,2,48,2963,48,152,2,48,2962,48,152
1.323,6,25,8056,12,164,103,267,1288,13,869,94,1448,6768
3.923,17,3,264,3,60,1961,60,264,0,0,0,0,0
1783.423,17,83,3480,82,14,22017,14,3444,1,8,0,8,36
6.46,6,18,6940,6,275,1292,275,794,12,629,474,2840,6146
10.601,6,1695,1468894,1015,1392,10,1420,1437413,680,467,15,1883,31481
0.311,6,10,1495,5,507,77,507,727,5,556,77,556,768
1786.631,6,102,8228,68,64,26666,64,4896,34,58,54137,58,3332
77.861,17,4,352,2,60,77860,60,176,2,60,77860,60,176
1786.335,6,104,8444,68,66,26661,66,4964,36,60,51030,60,3480
12.312,6,12,3705,6,171,2461,171,491,6,964,2461,1448,3214
4.014,17,2,656,2,300,4014,300,656,0,0,0,0,0
0.147,17,8,2446,8,277,21,316,2446,0,0,0,0,0
0.058,1,2,112,2,28,58,28,112,0,0,0,0,0
78.114,17,4,240,2,32,78113,32,120,2,32,78113,32,120
1789.783,1,342,28728,342,56,5248,56,28728,0,0,0,0,0
1772.775,6,180,15480,120,69,14897,69,8940,60,69,30044,69,6540
0.201,17,4,1349,4,309,67,331,1349,0,0,0,0,0
73.709,17,4,352,2,60,73708,60,176,2,60,73708,60,176
0.104,6,87,130488,1,0,0,0,40,86,1464,1,2896,130448
0.522,17,2,384,1,39,0,39,67,1,289,0,289,317
1777.903,17,79,3312,78,14,23089,14,3276,1,8,0,8,36
1785.383,6,381,31779,210,92,8542,1189,14584,171,130,10501,1917,17195
280.035,6,28,7352,13,158,23336,267,1317,15,678,19999,2800,6035
0.165,17,2,152,1,48,0,48,76,1,48,0,48,76
709.015,6,86,5798,33,46,21223,46,2482,53,46,13634,46,3316
1782.205,17,258,56771,258,192,6934,422,56771,0,0,0,0,0
1787.21,6,108,8468,68,64,26674,64,4896,40,58,45822,58,3572
1794.285,6,417,25024,208,69,8668,69,12460,209,34,8626,64,12564
187.453,17,12,2402,12,172,17041,247,2402,0,0,0,0,0
0.77,17,15,8483,8,705,110,1350,5871,7,345,119,1350,2612
1772.326,6,180,15480,120,69,14893,69,8940,60,69,30033,69,6540
21.353,17,2,642,1,300,0,300,328,1,286,0,286,314
14.322,6,36,8580,15,400,53,885,1832,21,368,708,3488,6748
0.176,6,25,7216,13,155,14,267,1301,12,775,15,4836,5915
1795.347,17,448,39896,403,35,4466,288,25676,45,288,40019,288,14220
367.403,6,25,1651,17,177,22962,177,1117,8,110,9173,110,534
48.427,6,30,7432,13,158,4035,267,1317,17,543,3024,1400,6115
31.747,1,16,896,16,28,2116,28,896,0,0,0,0,0
62.017,6,41,9692,18,256,3648,1189,3040,23,477,2817,1460,6652
85.918,17,4,240,2,32,85917,32,120,2,32,85917,32,120
1791.713,6,128,12813,75,63,24212,721,6203,53,83,34452,1448,6610
0.151,6,3,120,1,0,0,0,40,2,0,141,0,80
381.628,1,3,341,3,85,190814,88,341,0,0,0,0,0
0.029,17,2,279,1,36,0,36,64,1,187,0,187,215
11.802,6,1789,1624696,1147,1363,10,1420,1594653,642,427,18,1420,30043
85.064,6,27,13748,14,486,59,1360,2549,13,1523,7077,3928,11199
1785.955,6,102,8364,68,66,26656,66,4964,34,60,54117,60,3400
4.317,6,33,6145,17,206,269,314,2744,16,551,270,1179,3401
1787.392,6,102,8228,68,64,26677,64,4896,34,58,54160,58,3332
67.4,17,4,240,2,32,67399,32,120,2,32,67399,32,120
1792.918,17,66,2766,65,14,28014,14,2730,1,8,0,8,36
68.184,2,2,64,2,8,68184,8,64,0,0,0,0,0
0.034,17,2,152,2,48,34,48,152,0,0,0,0,0
1799.465,17,448,39896,403,35,4476,288,25676,45,288,40021,288,14220
116.658,6,31,12881,17,523,7291,1440,4571,14,1080,8958,1440,8310
280.269,6,29,7392,13,158,23355,267,1317,16,603,18677,2036,6075
493.381,6,62,11791,32,100,15915,267,2894,30,320,17012,3426,8897
0.047,17,4,284,2,32,36,32,120,2,54,33,60,164
91.434,6,20,1925,9,88,11429,157,956,11,53,9047,57,969
36.874,17,40,13937,19,476,2048,1350,9581,21,179,1841,1350,4356
240.224,6,54,17878,29,751,8579,1402,15038,25,191,10009,580,2840
1772.092,6,180,15480,120,69,14891,69,8940,60,69,30033,69,6540
30.686,6,4210,4067211,2828,1362,10,1408,3990683,1382,931,22,2801,76528
0.264,17,2,602,1,46,0,46,74,1,500,0,500,528
1788.514,1,337,28308,337,56,5322,56,28308,0,0,0,0,0
0.014,17,2,294,1,48,0,48,76,1,190,0,190,218
1775.35,6,182,15629,121,69,14794,69,9049,61,69,29583,69,6580
4.057,17,5,295,5,31,1014,31,295,0,0,0,0,0
0.476,6,54,23012,29,1033,17,1380,17758,25,421,18,1923,5254
0.034,17,3,1540,3,485,17,513,1540,0,0,0,0,0
136.477,6,63,43852,29,1052,147,1387,13825,34,955,4131,1460,30027
4.478,17,431,450901,109,146,41,1350,19066,322,1313,13,1350,431835
261.013,17,3,228,3,48,130506,48,228,0,0,0,0,0
31.782,6,9,540,2,0,961,0,120,7,0,5295,0,420
1.134,6,22,7900,11,164,96,267,1236,11,1216,96,3819,6664
1794.999,17,449,39928,404,35,4454,288,25708,45,288,40018,288,14220
2.659,6,96,86773,46,131,59,232,2369,50,1872,54,4260,84404
83.497,6,24,8973,12,698,77,1440,3304,12,862,7575,1593,5669
158.979,6,38,23974,19,840,42,1360,5835,19,1447,8823,2720,18139
0.821,6,10,1687,7,100,136,100,384,3,1179,283,1179,1303
0.535,6,22,7330,12,318,48,600,1918,10,814,56,1471,5412
1797.487,6,367,25650,214,99,8438,469,15045,153,69,11823,69,10605
1753.695,6,103,7755,66,38,26979,205,4663,37,33,48708,98,3092
10.576,6,2024,1992713,1363,1388,7,1408,1953677,661,931,15,2801,39036
32.778,6,448,410151,171,130,192,313,10639,277,1410,118,2836,399512
3.383,17,10,900,5,30,834,30,290,5,94,838,94,610
1785.279,6,102,8364,68,66,26645,66,4964,34,60,54096,60,3400
0.038,17,2,570,1,46,0,46,74,1,468,0,468,496
76.746,6,634,290580,332,816,231,1152,272995,302,392,254,1152,17585
0.057,17,2,304,1,60,0,60,88,1,188,0,188,216
1624.352,2,14,448,14,8,124950,8,448,0,0,0,0,0
0.118,17,2,272,1,60,0,60,88,1,156,0,156,184
95.083,6,32,13560,19,233,5282,285,2186,13,1186,5643,2170,11374
5.202,17,37,10184,15,322,369,1350,5264,22,195,246,1350,4920
74.382,6,14,580,6,0,4649,0,244,8,0,10624,0,336
1.5,6,4,184,2,0,1500,0,88,2,0,1018,0,96
29.243,17,4,1344,4,308,9747,308,1344,0,0,0,0,0
0.443,6,20,7252,13,337,36,674,2032,7,1212,67,1946,5220
1676.3,1,8,448,8,28,239471,28,448,0,0,0,0,0
9.021,17,2,778,2,361,9021,361,778,0,0,0,0,0
0.487,17,8,2750,8,315,69,354,2750,0,0,0,0,0
1744.7,2,27,864,27,8,67103,8,864,0,0,0,0,0
1786.674,6,102,8364,68,66,26666,66,4964,34,60,54138,60,3400
1.379,6,53,19756,29,912,49,1360,13975,24,400,51,1360,5781
15.217,6,2373,2215753,1528,1372,9,1408,2167149,845,931,17,2816,48604
40.196,6,28,7217,13,155,3349,267,1306,15,482,2870,2840,5911
280.193,6,26,7272,12,158,25472,267,1277,14,775,21550,2800,5995
14.687,6,19,1455,9,222,1833,222,808,10,231,1629,231,647
0.164,17,2,456,1,60,0,60,88,1,340,0,340,368
215.192,6,172,136993,108,1302,994,1360,122908,64,952,3412,1772,14085
1771.735,6,101,9415,67,65,26844,65,5641,34,59,53685,59,3774
421.102,2,5,160,5,8,105275,8,160,0,0,0,0,0
1788.374,6,365,23087,211,69,8516,69,12787,154,69,11688,69,10300
0.277,6,25,6116,12,181,25,537,1526,13,558,22,1408,4590
1775.181,6,180,15480,120,69,14917,69,8940,60,69,30083,69,6540
300.657,6,38,8566,20,315,15824,882,2093,18,441,496,1440,6473
23.087,6,47,16924,24,998,408,1440,10973,23,358,1041,1440,5951
216.468,6,32,8952,14,158,16651,267,1357,18,624,12731,1400,7595
192.579,6,63,10009,26,120,7703,267,2368,37,267,5348,1460,7641
241.8,6,181,127397,79,464,3099,1402,8784,102,1302,2393,1479,118613
11.447,6,26,9953,13,275,953,275,1078,13,1042,707,1440,8875
34.416,6,13,1807,7,100,5736,100,384,6,1179,6824,1179,1423
1.512,6,40,11338,22,547,72,1360,5842,18,476,77,2715,5496
11.988,6,25,8473,13,275,999,275,1078,12,986,919,1440,7395
0.009,17,2,384,1,39,0,39,67,1,289,0,289,317
58.661,6,13,1079,12,43,5332,43,1019,1,0,0,0,60
39.644,6,27,7177,13,155,3303,267,1306,14,530,3048,3417,5871
1.061,6,32,12986,17,529,66,1440,3370,15,818,61,1440,9616
0.06,17,4,352,2,37,0,37,130,2,83,0,89,222
214.599,6,257,219321,172,1308,1254,1368,202598,85,614,2551,2519,16723
300.872,6,45,13832,25,892,12536,1360,8185,20,371,456,1360,5647
1764.458,2,15,480,15,8,126032,8,480,0,0,0,0,0
140.449,6,27,12921,15,519,57,884,2733,12,1212,12756,3928,10188
0.013,17,2,299,1,59,0,59,87,1,184,0,184,212
1156.487,17,199,15124,199,48,5840,48,15124,0,0,0,0,0
1770.865,6,101,9278,66,64,27244,64,5544,35,58,52081,58,3734
741.838,17,84,7033,78,30,9634,37,4545,6,386,136424,463,2488
4.644,6,40,7309,20,218,244,314,3423,20,440,232,1152,3886
317.01,6,57,12563,29,141,11321,615,3596,28,460,11736,2720,8967
1681.356,17,14,1045,7,30,280223,30,406,7,63,280223,71,639
240.198,6,56,19407,30,830,8282,1402,16531,26,189,9607,580,2876
281.919,6,30,7432,13,158,23493,267,1317,17,543,17596,1400,6115
1770.57,6,101,9415,67,65,26826,65,5641,34,59,53645,59,3774
0.671,6,10,861,5,222,166,222,426,5,231,165,231,435
12.904,6,21,2657,11,211,1290,211,1050,10,545,1433,904,1607
2.551,6,10,1687,7,100,425,100,384,3,1179,1139,1179,1303
0.489,6,20,7252,13,337,40,674,2032,7,1212,73,1946,5220
0.092,6,36,21313,18,133,5,133,1077,18,1286,5,1448,20236
1796.373,6,394,24061,209,69,8636,69,12500,185,42,9762,69,11561
300.82,6,29,10271,13,221,25068,523,1570,16,655,8186,2804,8701
39.826,6,40,9633,20,635,536,1360,4031,20,435,2086,2667,5602
1444.377,6,346,41665,190,223,7357,1189,22158,156,167,9318,1420,19507
0.269,17,8,2774,8,318,38,357,2774,0,0,0,0,0
213.04,17,4,352,2,60,213039,60,176,2,60,213039,60,176
280.197,6,28,7352,13,158,23349,267,1317,15,678,20012,2800,6035
8.965,6,85,27615,43,580,213,1152,21453,42,447,212,1179,6162
0.045,17,2,138,1,33,0,33,61,1,49,0,49,77
17.126,17,24,5511,11,237,1709,1350,2923,13,171,1424,1350,2588
0.3,6,5,200,1,0,0,0,40,4,0,99,0,160
16.14,17,2122,804009,1383,508,11,1108,742551,739,55,21,598,61458
0.046,17,2,290,1,40,0,40,68,1,194,0,194,222
1789.254,6,198,23408,104,130,17371,721,13181,94,179,19236,2840,10227
1778.727,17,148,12360,74,53,24365,136,6064,74,57,24365,72,6296
1.042,6,23,7952,12,164,80,267,1288,11,1216,88,2816,6664
339.457,17,14,1232,7,48,56574,48,532,7,72,56574,72,700
280.454,6,29,7392,13,158,23371,267,1317,16,678,18692,2760,6075
1745.563,6,95,7203,63,38,28154,205,4476,32,33,56301,98,2727
108.118,6,22,4657,12,220,9828,516,1365,10,480,12003,1452,3292
39.28,17,40,10360,40,231,1007,388,10360,0,0,0,0,0
1772.696,17,189,43912,189,204,9429,422,43912,0,0,0,0,0
0.163,17,2,2380,2,1162,163,1162,2380,0,0,0,0,0
877.922,6,51,3675,28,31,32515,31,1890,23,31,34949,31,1785
0.705,6,120,88204,54,131,13,232,2689,66,1358,10,1488,85515
280.235,6,25,7094,11,181,28023,267,1168,14,595,21555,1400,5926
2.976,17,2,1430,2,687,2976,687,1430,0,0,0,0,0
0.359,6,27,8971,13,232,29,569,1614,14,827,27,1402,7357
1773.168,6,180,15480,120,69,14900,69,8940,60,69,30053,69,6540
0.303,17,2,144,1,36,0,36,64,1,52,0,52,80
11.012,6,19,4362,11,275,1101,275,998,8,1010,891,2840,3364
3.105,17,2,144,1,36,0,36,64,1,52,0,52,80
36.995,6,5452,5287976,3667,1365,10,1408,5190492,1785,931,20,2801,97484
0.006,17,2,443,1,40,0,40,68,1,347,0,347,375
1799.993,6,243,20360,94,73,19023,339,8947,149,68,12162,1062,11413
1752.619,6,95,7203,63,38,28268,205,4476,32,33,56526,98,2727
0.173,17,10,1385,10,110,19,220,1385,0,0,0,0,0
78.014,6,21,9308,12,372,76,808,1628,9,1461,9735,4416,7680
0.016,17,2,420,1,36,0,36,64,1,328,0,328,356
240.588,6,45,8754,24,571,10459,1418,5837,21,227,12028,580,2917
0.934,6,10,1687,7,100,155,100,384,3,1179,338,1179,1303
240.28,6,42,8803,20,197,12645,751,2429,22,522,11439,2382,6374
1745.497,6,95,7203,63,38,28153,205,4476,32,33,56300,98,2727
1793.158,6,360,24156,210,88,8579,469,13878,150,69,12033,69,10278
41.053,6,37,8085,17,236,2565,314,3048,20,423,2146,1152,5037
1786.615,6,104,8376,68,65,26665,65,4930,36,59,51043,59,3446
95.564,17,4,352,2,60,95563,60,176,2,60,95563,60,176
1786.149,17,87,3648,86,14,21013,14,3612,1,8,0,8,36
0.264,6,24,6064,12,181,24,537,1526,12,651,23,1408,4538
6.347,6,25,13916,11,239,634,416,1442,14,1190,412,1440,12474
1740.611,6,95,7203,63,38,28074,205,4476,32,33,56135,98,2727
1.02,6,32,12966,17,525,63,1440,3350,15,818,60,1440,9616
1786.569,6,108,8730,69,66,26273,66,5070,39,60,47011,60,3660
7.677,2,2,64,2,8,7677,8,64,0,0,0,0,0
0.147,6,2,302,1,210,0,210,262,1,0,0,0,40
1636.278,1,8,848,8,78,233754,78,848,0,0,0,0,0
1787.908,1,70,3920,70,28,25911,28,3920,0,0,0,0,0
62.392,6,7,292,4,0,20797,0,164,3,0,31070,0,128
1772.163,6,180,15480,120,69,14892,69,8940,60,69,30035,69,6540
1.369,6,38,9848,20,502,72,1460,4352,18,433,69,1460,5496
0.253,6,9,1050,5,261,63,261,465,4,421,74,421,585
0.058,17,4,420,2,33,1,33,122,2,121,37,145,298
1.332,6,46,18776,27,866,51,1360,13240,19,476,63,2715,5536
2.896,6,14,2351,8,188,413,245,700,6,703,526,1152,1651
1633.622,1,7,742,7,78,272270,78,742,0,0,0,0,0
1797.888,17,447,39296,403,35,4472,288,25392,44,288,40952,288,13904
32.007,6,36,8455,18,410,514,882,1982,18,478,1874,2720,6473
300.783,6,38,8566,20,315,15830,882,2093,18,441,503,1360,6473
400.312,17,16,1408,8,48,57186,48,608,8,72,57185,72,800
1679.605,17,12,498,11,14,167960,14,462,1,8,0,8,36
1.786,17,3,1164,3,360,893,360,1164,0,0,0,0,0
0.133,6,9,1002,5,213,33,213,417,4,421,41,421,585
167.683,6,27,13829,16,852,58,1360,6638,11,1347,16751,4445,7191
300.843,6,57,20407,30,1092,10367,1440,14401,27,307,11563,1440,6006
0.053,17,4,284,2,32,20,32,120,2,54,34,60,164
93.149,6,21,860,9,0,6093,0,364,12,0,8467,0,496
197.45,6,33,9739,10,182,21938,267,1139,23,479,8968,1420,8600
1682.763,17,14,1036,7,30,280451,30,406,7,62,280452,62,630
1777.703,17,73,3060,72,14,25038,14,3024,1,8,0,8,36
1.335,6,50,21104,28,953,49,1360,15448,22,433,55,1360,5656
12.084,6,13,2129,8,322,1726,581,1069,5,396,2946,580,1060
44.774,6,31,13722,19,640,2487,867,5469,12,846,4069,2084,8253
10.632,6,18,5610,10,275,1181,275,958,8,1440,806,1440,4652
9.267,6,12,3083,3,92,4633,92,244,9,393,1131,1408,2839
24.405,17,11,836,11,48,2440,48,836,0,0,0,0,0
359.775,6,17,1190,13,180,29981,180,864,4,110,20067,110,326
1786.623,6,104,8444,68,66,26666,66,4964,36,60,51043,60,3480
1064.898,6,58,4225,35,31,31320,31,2347,23,31,43322,31,1878
14.253,6,1137,962810,687,1320,20,1368,932146,450,776,31,1473,30664
3.768,17,5,295,5,31,942,31,295,0,0,0,0,0
694.249,17,7,532,7,48,115708,48,532,0,0,0,0,0
389.952,1,6,336,6,28,77990,28,336,0,0,0,0,0
1082.937,2,13,416,13,8,90244,8,416,0,0,0,0,0
0.08,6,10,1495,5,507,20,507,727,5,556,19,556,768
1792.163,1,58,4872,58,56,31441,56,4872,0,0,0,0,0
1729.2,6,60,4400,40,33,44338,33,2740,20,31,91001,31,1660
0.009,17,4,284,2,32,3,32,120,2,54,5,60,164
0.637,17,3,1164,3,360,318,360,1164,0,0,0,0,0
0.029,17,2,230,1,55,0,55,83,1,119,0,119,147
0.165,6,2,111,1,31,0,31,71,1,0,0,0,40
0.569,6,2,1175,1,0,0,0,40,1,1095,0,1095,1135
1792.774,17,42726,1709040,21363,8,83,8,769068,21363,16,83,16,939972
21.058,6,40,9704,20,803,466,1440,4057,20,371,1098,1440,5647
11.759,6,14,1156,7,283,1930,283,663,7,105,1930,105,493
240.165,6,54,19727,29,850,8577,1408,16833,25,198,10006,580,2894
0.053,17,2,322,1,33,0,33,61,1,233,0,233,261
5.015,17,4,558,2,36,5009,36,128,2,187,5010,187,430
1783.394,6,350,22625,199,69,9007,69,12169,151,69,11889,69,10456
6.52,6,41,7353,21,218,326,314,3463,20,440,329,1152,3890
0.022,17,2,200,1,64,0,64,92,1,80,0,80,108
11.697,6,68,46209,41,1198,292,1368,39281,27,893,440,1368,6928
728.411,6,111,14501,57,102,12836,721,6397,54,312,13739,1440,8104
257.299,6,11,851,11,31,25729,31,851,0,0,0,0,0
18.075,17,12,5773,6,575,3608,1350,3621,6,330,3608,1350,2152
0.214,6,6,328,4,0,71,0,216,2,0,204,0,112
1742.814,6,95,7203,63,38,28109,205,4476,32,33,56211,98,2727
1.111,1,10,840,10,56,123,56,840,0,0,0,0,0
4.147,6,40,7309,20,218,218,314,3423,20,440,204,1152,3886
126.743,6,30,7451,9,165,367,267,1029,21,348,6336,1460,6422
1758.548,1,88,4928,88,28,20213,28,4928,0,0,0,0,0
1754.924,6,115,6946,64,27,27855,27,3811,51,27,35097,27,3135
16.982,6,92,26674,46,517,377,1152,19963,46,442,371,1179,6711
1746.779,6,97,7307,63,38,28173,205,4476,34,33,52922,98,2831
286.503,6,112,64220,60,945,4855,1448,28715,52,885,1588,2581,35505
0.573,17,15,8357,8,706,80,1350,5873,7,326,82,1350,2484
414.756,1,24,1344,24,28,18032,28,1344,0,0,0,0,0
2.962,17,3,468,3,128,1481,128,468,0,0,0,0,0
377.3,6,18,1242,14,180,29023,180,916,4,110,20065,110,326
1717.761,6,169,10736,92,48,18876,208,6788,77,31,20556,31,3948
374.072,6,25,1651,17,177,23379,177,1117,8,110,9245,110,534
1786.748,6,102,8296,68,65,26667,65,4930,34,59,54140,59,3366
0.068,17,4,344,2,47,0,47,150,2,69,19,75,194
4.423,6,20,2696,10,256,490,256,1684,10,304,490,304,1012
219.06,17,5,352,3,36,109382,36,192,2,52,218730,52,160
1798.525,1,223,12488,223,28,8101,28,12488,0,0,0,0,0
280.202,6,29,7392,13,158,23350,267,1317,16,603,18677,2036,6075
1784.312,6,356,22520,208,69,8619,69,12460,148,69,12138,69,10060
0.356,6,74,86480,39,183,9,230,2649,35,2484,8,9814,83831
0.059,6,2,80,1,0,0,0,40,1,0,0,0,40
4.324,6,36,7165,17,218,270,314,3303,19,516,226,1179,3862
79.632,6,121,89904,75,1257,1076,1408,79392,46,676,1764,1408,10512
1.465,6,49,18833,28,920,54,1460,13172,21,437,63,2615,5661
0.104,17,2,211,1,43,0,43,71,1,112,0,112,140
360.956,2,3,96,3,8,180478,8,96,0,0,0,0,0
31.636,6,7,420,1,0,0,0,60,6,0,6290,0,360
0.035,17,2,426,1,50,0,50,78,1,320,0,320,348
46.427,6,15,2516,12,634,4220,1460,2388,3,0,6018,0,128
32.108,6,79,53818,40,115,823,269,2487,39,1408,844,2816,51331
5.553,6,40,7309,21,218,277,314,3463,19,513,294,1179,3846
0.287,6,4,288,1,112,0,112,152,3,0,143,0,136
1790.133,6,364,23900,212,75,8484,501,13190,152,74,11855,421,10710
661.84,2,7,224,7,8,110306,8,224,0,0,0,0,0
1.679,17,3,1167,3,361,839,361,1167,0,0,0,0,0
280.232,6,29,7392,14,158,21556,267,1357,15,678,20015,3436,6035
0.28,6,26,9019,13,247,23,624,1672,13,951,22,2816,7347
378.111,2,4,128,4,8,126037,8,128,0,0,0,0,0
0.379,6,12,1653,6,288,73,288,548,6,426,42,434,1105
283.08,6,28,7352,12,158,25734,267,1277,16,603,18867,1400,6075
1.298,17,20,7989,8,518,185,1350,4371,12,273,73,1350,3618
4.716,6,36,6249,18,206,277,314,2784,18,456,261,1152,3465
0.191,6,9,527,5,43,47,43,311,4,0,30,0,216
0.144,17,2,904,2,424,144,548,904,0,0,0,0,0
1772.404,6,180,15480,120,69,14894,69,8940,60,69,30035,69,6540
1.309,6,48,19964,27,945,50,1440,14348,21,433,56,1440,5616
0.133,17,2,152,1,48,0,48,76,1,48,0,48,76
122.408,6,15,820,6,0,24481,0,328,9,0,14335,0,492
1781.304,6,359,22778,209,69,8563,69,12569,150,69,11954,69,10209
1.619,6,13,2311,8,188,231,245,700,5,1407,343,1407,1611
8.36,6,36,9101,17,303,515,721,2806,19,502,454,1440,6295
89.863,6,28,9992,15,608,6418,1440,3066,13,913,7474,1476,6926
1796.578,17,448,39896,403,35,4469,288,25676,45,288,40015,288,14220
1788.397,6,356,22520,208,69,8639,69,12460,148,69,12165,69,10060
0.063,17,2,190,1,59,0,59,87,1,75,0,75,103
107.705,6,25,6271,9,267,100,501,1165,16,343,7174,1420,5106
1.044,6,29,8610,15,229,64,583,2031,14,858,65,1360,6579
0.016,17,2,358,1,32,0,32,60,1,270,0,270,298
1779.242,6,132,8062,71,26,25417,26,4284,61,26,29653,26,3778
1770.844,6,101,9410,66,66,27243,66,5610,35,60,52081,60,3800
453.488,6,85,5332,48,69,8341,69,2886,37,69,12596,69,2446
0.008,1,2,450,2,197,8,197,450,0,0,0,0,0
5.648,17,5,320,5,36,1412,36,320,0,0,0,0,0
1771.275,6,101,9220,66,63,27250,64,5515,35,57,52093,58,3705
1784.325,1,60,5040,60,56,30242,56,5040,0,0,0,0,0
625.956,17,22,7392,22,308,29807,308,7392,0,0,0,0,0
1796.161,17,142,11360,71,48,25659,48,5396,71,56,25659,56,5964
1786.117,6,107,8624,68,66,26658,66,4964,39,60,47000,60,3660
11.555,6,875,811881,586,1317,19,1368,792189,289,665,39,1368,19692
10.765,6,26,11194,10,190,1196,370,1164,16,853,711,1420,10030
1.798,6,50,21395,28,878,66,1360,14379,22,510,76,1360,7016
33.423,6,30,5243,15,180,2387,722,1859,15,371,2374,2026,3384
145.654,6,29,8832,14,158,11204,267,1357,15,858,10402,4836,7475
145.925,17,32,3286,28,30,5404,37,1638,4,384,29066,463,1648
0.076,1,2,112,2,28,76,28,112,0,0,0,0,0
5.036,17,4,288,2,36,5017,36,128,2,52,5016,52,160
37.929,6,32,5230,16,145,2528,722,1995,16,342,2495,1448,3235
1744.67,2,19,608,19,8,96926,8,608,0,0,0,0,0
1.384,6,46,19090,26,957,55,1460,13514,20,476,62,2615,5576
1741.344,17,29,6815,29,207,62190,207,6815,0,0,0,0,0
0.519,17,3,451,2,39,165,39,134,1,289,0,289,317
1785.178,6,113,9050,72,66,25143,66,5190,41,60,44627,60,3860
3.8,17,29,12745,13,636,316,1350,8640,16,228,214,1350,4105
0.766,6,17,5132,9,150,95,174,664,8,828,95,1420,4468
1.281,6,41,10554,21,513,64,1360,4978,20,476,58,2715,5576
40.161,1,12,1248,0,0,0,0,0,12,76,3651,76,1248
7.793,6,31,8912,14,158,599,267,1357,17,763,479,2076,7555
13.315,6,44,10786,23,462,605,891,4192,21,478,653,2128,6594
1786.554,6,102,8364,68,66,26664,66,4964,34,60,54135,60,3400
4.47,6,39,7269,21,218,223,314,3463,18,513,248,1179,3806
0.608,17,4,502,2,31,577,31,118,2,164,593,164,384
4.635,17,2,656,2,300,4635,300,656,0,0,0,0,0
0.059,17,2,152,1,48,0,48,76,1,48,0,48,76
1.025,17,4,976,2,60,975,60,176,2,372,0,372,800
240.433,6,64,21020,31,802,8014,1408,17671,33,203,7513,580,3349
1773.103,6,180,15480,120,69,14900,69,8940,60,69,30050,69,6540
22.824,6,18,4163,7,296,3804,722,1249,11,389,2261,1408,2914
0.456,6,10,1992,5,288,109,288,508,5,424,64,434,1484
201.621,6,23,4376,8,407,28803,722,1226,15,215,14365,1408,3150
0.496,17,3,451,2,39,188,39,134,1,289,0,289,317
1786.334,6,104,8444,68,66,26661,66,4964,36,60,51035,60,3480
0.185,6,10,583,5,43,46,43,311,5,0,45,0,272
64.405,6,11,5311,3,170,10,170,334,8,758,9199,1448,4977
566.342,1,10,560,10,28,62926,28,560,0,0,0,0,0
1778.09,17,79,3312,78,14,23092,14,3276,1,8,0,8,36
280.687,6,29,7392,13,158,23390,267,1317,16,678,18705,2085,6075
285.045,6,21,1509,11,330,28504,330,910,10,83,31671,83,599
1770.67,6,111,10062,67,66,26828,66,5674,44,60,41176,60,4388
67.291,6,27,10825,14,608,52,1360,3635,13,832,5596,1360,7190
240.636,2,4,128,4,8,80212,8,128,0,0,0,0,0
1798.515,6,356,22520,208,69,8688,69,12460,148,69,12234,69,10060
1786.577,6,356,22520,208,69,8630,69,12460,148,69,12152,69,10060
62.822,6,24,10306,12,433,71,990,1847,12,995,5699,1390,8459
0.863,6,23,7406,13,335,71,668,2026,10,1210,90,1946,5380
300.289,6,27,8061,15,173,21449,385,1483,12,849,21843,1408,6578
0.196,6,10,1514,5,503,49,503,771,5,475,49,475,743
4.787,17,5,320,5,36,1196,36,320,0,0,0,0,0
1799.898,17,3513,168624,1747,20,1030,20,83856,1766,20,1019,20,84768
0.162,6,10,1383,6,145,32,145,389,4,830,50,830,994
999.89,6,124,19209,67,271,15149,818,12473,57,106,17853,223,6736
1.867,6,38,8254,19,321,103,1164,2718,19,433,91,1360,5536
1799.328,1,56,4704,56,56,32715,56,4704,0,0,0,0,0
1790.798,1,283,15848,283,28,6350,28,15848,0,0,0,0,0
10.646,6,20,7026,11,275,1064,275,998,9,1414,739,1414,6028
1798.451,6,355,22480,207,69,8730,69,12420,148,69,12234,69,10060
1.572,6,49,19740,27,926,60,1360,14084,22,476,64,2715,5656
0.019,17,4,352,2,60,17,60,176,2,60,17,60,176
0.067,6,5,200,2,0,2,0,80,3,0,33,0,120
240.644,2,4,128,4,8,80214,8,128,0,0,0,0,0
10.764,6,19,4402,10,275,1196,275,958,9,768,745,1440,3444
0.191,6,10,1840,5,901,47,901,1169,5,403,47,403,671
1793.019,6,414,35789,230,115,7829,1189,18005,184,128,9797,1420,17784
1795.231,17,80,3354,79,14,23015,14,3318,1,8,0,8,36
126.526,17,5,380,5,48,31631,48,380,0,0,0,0,0
14.61,6,21,6825,12,275,1328,275,1038,9,1353,1198,1440,5787
1793.357,17,180,14040,180,50,10018,50,14040,0,0,0,0,0
1786.695,6,154,19574,92,302,19633,302,13852,62,83,29289,83,5722
1800.0,6,195,13642,68,46,26641,46,5618,127,46,14285,46,8024
0.912,6,11,1727,7,100,152,100,384,4,589,218,1152,1343
300.659,6,41,8829,22,336,14317,999,2270,19,413,472,1440,6559
63.199,6,7,420,7,0,0,0,420,0,0,0,0,0
1787.793,6,104,8376,68,65,26683,65,4930,36,59,51076,59,3446
0.162,17,4,368,2,35,0,35,126,2,93,123,99,242
1772.444,6,180,15480,120,69,14894,69,8940,60,69,30038,69,6540
1776.966,17,73,3060,72,14,25027,14,3024,1,8,0,8,36
42.609,17,6,528,3,48,21299,48,228,3,72,21299,72,300
34.283,6,9,396,2,0,5827,0,88,7,0,5698,0,308
81.356,6,33,7805,11,155,27,267,1226,22,316,3873,1460,6579
15.213,6,21,6745,5,189,3803,189,409,16,473,941,1360,6336
1797.61,17,447,39864,402,35,4482,288,25644,45,288,40023,288,14220
23.169,6,2324,2156740,1413,1441,16,1448,2100180,911,776,25,1448,56560
0.662,6,13,1693,6,288,126,288,548,7,426,63,434,1145
13.351,6,7,388,4,0,4450,0,216,3,0,6140,0,172
301.507,6,52,14067,28,881,11166,1460,8260,24,402,680,2567,5807
15.113,17,11,4741,5,505,3770,1350,2665,6,318,3015,1350,2076
1.453,6,54,23942,30,998,50,1460,18206,24,433,54,1460,5736
0.18,17,2,144,1,36,0,36,64,1,52,0,52,80
1729.292,6,62,4547,41,33,43232,33,2804,21,31,86446,31,1743
10.772,6,18,4266,10,275,1196,275,958,8,992,745,1440,3308
1.46,6,25,8056,13,164,104,267,1340,12,1014,113,2736,6716
17.216,17,34,13874,16,603,1145,1350,10100,18,181,1010,1350,3774
0.121,17,4,284,2,32,62,32,120,2,54,60,60,164
0.481,6,12,1653,6,288,94,288,548,6,426,53,434,1105
280.504,6,29,7392,13,158,23375,267,1317,16,603,18692,2076,6075
134.182,6,26,6409,9,272,226,516,1180,17,324,8381,1452,5229
280.301,6,26,7272,13,158,23358,267,1317,13,905,23355,4845,5955
40.831,17,8,728,4,52,13607,52,320,4,74,13607,80,408
0.115,6,6,718,3,304,52,304,460,3,102,46,102,258
4.661,6,35,6209,18,206,274,314,2784,17,548,273,1179,3425
1798.198,17,446,39832,401,35,4495,288,25612,45,288,40018,288,14220
1.232,6,24,5522,14,125,94,212,1066,10,675,136,1420,4456
1251.543,6,113,12431,71,78,17879,722,6619,42,109,25217,1402,5812
0.326,6,7,716,4,226,108,226,442,3,110,82,110,274
0.381,17,16,6154,7,342,63,1350,2594,9,367,37,1350,3560
1789.361,17,142,11360,71,48,25562,48,5396,71,56,25562,56,5964
28.035,6,26,6207,11,256,2803,722,1616,15,380,1987,1408,4591
1796.412,17,449,39928,404,35,4457,288,25708,45,288,40018,288,14220
1741.058,6,87,6322,58,31,30544,31,3915,29,31,62178,31,2407
0.007,17,2,167,1,39,0,39,67,1,72,0,72,100
13.639,6,28,7217,13,155,1136,267,1306,15,482,973,2840,5911
316.045,6,157,37412,78,428,4104,1360,24717,79,211,4049,1360,12695
192.043,6,12,917,8,65,27434,65,580,4,59,57422,59,337
1.66,6,13,2311,8,188,237,245,700,5,1407,351,1407,1611
125.378,6,17,3300,8,92,17911,92,504,9,332,15649,1448,2796
1745.657,6,95,7203,63,38,28155,205,4476,32,33,56302,98,2727
6.277,6,40,6433,21,206,313,314,2908,19,459,277,1152,3525
2.464,17,4,1564,4,363,821,363,1564,0,0,0,0,0
318.426,17,17,5712,17,308,19901,308,5712,0,0,0,0,0
0.035,6,11,572,0,0,0,0,0,11,0,0,0,572
0.621,6,11,976,5,283,103,283,551,6,105,83,105,425
146.68,17,4,1344,4,308,48893,308,1344,0,0,0,0,0
3.738,6,11,1727,6,100,747,100,344,5,589,867,1152,1383
1641.206,1,8,448,8,28,234458,28,448,0,0,0,0,0
1769.288,17,52,20777,52,371,34691,548,20777,0,0,0,0,0
5.962,6,1677,1543768,1029,1420,5,1448,1505408,648,776,8,1448,38360
0.005,17,2,410,1,42,0,42,70,1,312,0,312,340
0.001,17,7,2445,7,321,0,355,2445,0,0,0,0,0
1770.997,6,213,24249,131,87,13623,469,11035,82,128,21863,2840,13214
12.145,17,12,872,10,37,1349,37,650,2,83,1,89,222
387.244,6,26,2008,17,180,24202,180,1300,9,110,8187,110,708
26.194,6,3590,3377853,2281,1401,11,1448,3305109,1309,776,19,1448,72744
251.824,2,3,96,3,8,125912,8,96,0,0,0,0,0
38.176,17,10,760,10,48,4241,48,760,0,0,0,0,0
1568.185,1,32,1792,32,28,50586,28,1792,0,0,0,0,0
75.742,6,31,7619,12,156,29,267,1272,19,398,4207,3417,6347
11.018,6,18,4226,10,275,1224,275,958,8,978,892,1420,3268
1773.074,6,180,15480,120,69,14899,69,8940,60,69,30050,69,6540
1740.642,17,30,7050,30,207,60022,207,7050,0,0,0,0,0
1775.208,6,180,15480,120,69,14917,69,8940,60,69,30079,69,6540
5.429,6,19,6980,6,275,1085,275,794,13,566,434,1440,6186
0.338,6,10,860,5,222,80,222,426,5,230,80,230,434
280.241,6,28,7352,13,158,23353,267,1317,15,678,20011,4200,6035
19.707,1,4,224,4,28,6569,28,224,0,0,0,0,0
199.786,6,9,515,5,43,49946,43,299,4,0,66593,0,216
280.377,6,30,7432,13,158,23364,267,1317,17,603,17521,2076,6115
1772.359,6,180,15480,120,69,14893,69,8940,60,69,30038,69,6540
0.085,17,2,148,1,32,0,32,60,1,60,0,60,88
21.353,6,13,3089,5,92,5338,92,348,8,579,2984,1448,2741
1791.561,6,356,22520,208,69,8654,69,12460,148,69,12186,69,10060
61.212,17,16,2352,8,48,8743,48,608,8,190,8743,308,1744
0.411,6,6,324,4,0,137,0,216,2,0,194,0,108
1729.176,6,62,4504,40,33,44337,33,2740,22,31,82333,31,1764
10.125,17,748,798425,597,1271,16,1350,775721,151,122,67,1350,22704
1791.636,6,272,33667,109,142,16588,1360,16259,163,132,11058,2720,17408
1772.32,6,180,15480,120,69,14893,69,8940,60,69,30033,69,6540
0.077,17,2,180,1,30,0,30,58,1,94,0,94,122
3.531,6,11,1727,7,100,588,100,384,4,1179,1091,1179,1343
143.552,17,4,352,2,60,143550,60,176,2,60,143550,60,176
157.891,17,31,6654,31,186,5263,357,6654,0,0,0,0,0
242.412,6,52,15212,22,163,11537,517,2507,30,926,8357,1418,12705
3.749,6,31,8912,14,158,288,267,1357,17,687,230,1781,7555
1798.37,17,449,39928,404,35,4462,288,25708,45,288,40022,288,14220
1788.039,6,102,8228,68,64,26687,64,4896,34,58,54180,58,3332
0.036,6,3,120,2,0,36,0,80,1,0,0,0,40
1795.645,17,142,11360,71,48,25652,48,5396,71,56,25651,56,5964
4.301,6,39,7269,19,218,238,314,3383,20,513,212,1179,3886
175.355,17,2,72,1,8,0,8,36,1,8,0,8,36
0.521,17,3,451,2,39,193,39,134,1,289,0,289,317
3.054,6,51,13669,27,503,117,1460,4708,24,469,118,1460,8961
4.844,17,4,352,2,48,4831,48,152,2,72,4830,72,200
77.199,6,42,8916,20,412,731,889,2128,22,368,3669,3488,6788
1780.814,6,102,8296,68,65,26579,65,4930,34,59,53959,59,3366
0.047,17,2,167,1,39,0,39,67,1,72,0,72,100
12.057,6,18,4362,10,275,1339,275,958,8,768,1563,1440,3404
0.488,6,52,23090,29,1046,17,1380,17928,23,421,19,1923,5162
1800.0,6,237,17946,91,65,20000,456,8709,146,48,12412,143,9237
301.63,1,10,560,10,28,33514,28,560,0,0,0,0,0
1.361,6,45,10197,24,440,59,1360,4536,21,400,58,1360,5661
110.16,17,2,1086,2,515,110160,515,1086,0,0,0,0,0
300.153,6,40,9995,21,593,14999,1360,4433,19,399,16665,1360,5562
300.609,6,37,8526,19,315,16700,882,2053,18,441,497,1440,6473
0.442,17,2,152,1,48,0,48,76,1,48,0,48,76
75.981,6,34,19217,16,708,79,1460,4226,18,1096,4461,1460,14991
0.136,17,2,396,1,39,0,39,67,1,301,0,301,329
1.141,17,6,793,3,31,562,31,177,3,177,565,196,616
0.002,6,2,218,1,0,0,0,40,1,126,0,126,178
0.924,6,54,13970,25,551,38,1429,4892,29,416,32,1460,9078
1.291,6,58,18018,28,706,47,1360,8909,30,438,44,1360,9109
16.071,17,10,880,5,48,4015,48,380,5,72,4015,72,500
280.082,6,30,7432,13,158,23340,267,1317,17,543,17500,1400,6115
0.01,6,10,1792,6,612,2,1069,1469,4,159,3,159,323
4.258,17,10,900,5,30,1052,30,290,5,94,1056,94,610
404.2,1,17,952,17,28,25262,28,952,0,0,0,0,0
223.969,17,36,2736,36,48,6399,48,2736,0,0,0,0,0
1779.939,1,342,28728,342,56,5219,56,28728,0,0,0,0,0
1783.803,6,360,24694,210,94,8534,469,14347,150,69,11971,69,10347
1772.416,6,180,15480,120,69,14894,69,8940,60,69,30033,69,6540
740.696,6,85,15118,54,304,13975,304,11004,31,83,24648,83,4114
66.668,6,64,39621,39,1136,1754,1408,31578,25,841,2561,2439,8043
541.488,2,7,224,7,8,90248,8,224,0,0,0,0,0
1768.767,1,126,7056,126,28,14150,28,7056,0,0,0,0,0
27.476,17,6,528,3,48,13734,48,228,3,72,13734,72,300
70.471,6,14,596,6,0,292,0,256,8,0,10066,0,340
0.023,6,9,1878,5,908,5,908,1176,4,486,7,486,702
1619.229,2,14,448,14,8,124556,8,448,0,0,0,0,0
1280.509,6,80,11187,51,97,20605,498,4384,29,208,45729,1420,6803
60.14,17,28,2355,26,30,2405,37,1515,2,392,377,463,840
5.586,6,108,82405,69,1010,82,1360,18977,39,2379,143,8160,63428
0.856,6,11,1727,7,100,142,100,384,4,589,203,1152,1343
0.181,6,3,160,2,0,181,0,100,1,0,0,0,60
0.902,6,11,1727,7,100,150,100,384,4,589,213,1152,1343
0.382,6,12,1304,6,256,73,256,756,6,304,72,304,548
0.011,17,2,280,1,64,0,64,92,1,160,0,160,188
1791.17,1,170,9520,170,28,10598,28,9520,0,0,0,0,0
60.254,1,10,560,10,28,6694,28,560,0,0,0,0,0
1.122,6,23,6595,13,350,92,1088,2275,10,979,123,1731,4320
1744.598,6,97,7307,63,38,28138,205,4476,34,33,52854,98,2831
9.468,6,17,6735,9,275,1183,275,643,8,1440,1305,1440,6092
16.242,17,23,16119,12,892,1473,1350,11050,11,432,1620,1350,5069
1785.588,6,104,8444,68,66,26650,66,4964,36,60,51014,60,3480
291.653,1,4,224,4,28,97217,28,224,0,0,0,0,0
1774.046,17,140,11200,70,48,25710,48,5320,70,56,25710,56,5880
1772.179,6,180,15480,120,69,14892,69,8940,60,69,30036,69,6540
0.01,17,2,167,1,39,0,39,67,1,72,0,72,100
9.009,6,17,5391,9,275,1126,275,643,8,1104,1161,1440,4748
0.041,17,3,244,2,32,0,32,120,1,96,0,96,124
300.692,6,36,10204,15,201,21478,486,1438,21,527,5947,1460,8766
1633.931,1,8,448,8,28,233418,28,448,0,0,0,0,0
0.315,6,22,7342,12,335,28,668,1974,10,1210,34,1906,5368
70.878,6,29,7454,11,162,137,267,1423,18,441,4168,1420,6031
125.623,6,33,14370,16,488,319,1460,3127,17,959,7843,1460,11243
1784.92,6,382,23608,209,69,8581,69,12500,173,49,10377,69,11108
30.503,6,16,5705,6,106,6098,106,354,10,823,3387,1452,5351
2.326,6,13,2311,8,188,332,245,700,5,1407,520,1407,1611
0.741,6,148,101066,81,1297,9,1420,94095,67,427,11,1420,6971
1781.427,17,140,11200,70,48,25817,48,5320,70,56,25817,56,5880
1793.215,17,144,11520,72,48,25256,48,5472,72,56,25256,56,6048
265.739,17,4,352,2,60,265738,60,176,2,60,265738,60,176
847.26,17,32,2432,32,48,27330,48,2432,0,0,0,0,0
0.675,6,63,32290,36,1048,19,1380,23573,27,683,24,3303,8717
13.174,6,94,27956,49,564,274,1152,21706,45,444,292,1179,6250
1777.496,1,194,10864,194,28,9209,28,10864,0,0,0,0,0
0.354,17,8,2758,8,316,50,355,2758,0,0,0,0,0
0.222,6,22,5040,11,137,22,267,1132,11,692,21,1467,3908
1799.902,17,348,26448,348,48,5187,48,26448,0,0,0,0,0
280.441,6,29,7392,13,158,23370,267,1317,16,678,18693,3456,6075
90.58,6,40,15575,21,790,4529,1402,8990,19,508,5017,2426,6585
300.713,6,36,11800,20,646,15827,1402,4926,16,548,569,2170,6874
6.282,17,4,304,3,48,2976,48,228,1,48,0,48,76
0.127,6,9,1340,5,145,31,145,349,4,827,34,827,991
2.516,17,2,136,1,32,0,32,60,1,48,0,48,76
3.591,6,14,3144,8,49,513,92,511,6,579,46,1408,2633
1789.993,6,242,47039,151,483,11933,483,37315,91,83,19888,83,9724
1744.589,2,28,896,28,8,64614,8,896,0,0,0,0,0
1.389,17,6,360,3,32,693,32,180,3,32,694,32,180
0.13,17,7,2438,7,320,21,354,2438,0,0,0,0,0
70.106,6,19,5861,10,272,7789,516,1220,9,712,8752,1452,4641
25.077,17,43,12255,20,347,1318,1350,7513,23,178,1138,1350,4742
0.512,17,16,8910,7,506,85,1350,3742,9,546,55,1350,5168
1772.43,6,180,15480,120,69,14894,69,8940,60,69,30034,69,6540
4.196,17,373,406824,77,84,55,1350,8676,296,1317,14,1350,398148
0.739,6,148,102154,81,1313,9,1420,95183,67,427,11,1420,6971
1787.385,6,104,8308,68,64,26677,64,4896,36,58,51064,58,3412
0.258,17,2,348,1,39,0,39,67,1,253,0,253,281
0.977,6,16,4862,8,150,139,174,624,8,782,118,1452,4238
195.529,6,28,6519,11,217,5611,502,1312,17,323,12214,1420,5207
0.004,17,2,410,1,46,0,46,74,1,308,0,308,336
10.764,6,20,4390,11,275,1076,275,998,9,755,754,1414,3392
1.313,6,49,19279,27,893,50,1360,13623,22,433,54,1360,5656
163.91,17,4,352,2,60,163909,60,176,2,60,163908,60,176
0.511,17,2,167,1,39,0,39,67,1,72,0,72,100
1782.391,17,83,3480,82,14,22004,14,3444,1,8,0,8,36
0.495,17,3,451,2,39,308,39,134,1,289,0,289,317
1.264,6,47,18160,26,882,50,1460,12544,21,433,54,1460,5616
7.371,17,40,13006,12,369,669,1350,4773,28,266,271,1350,8233
1788.882,6,365,23087,211,69,8518,69,12787,154,69,11691,69,10300
38.228,1,44,4576,0,0,0,0,0,44,76,889,76,4576
281.239,6,32,7853,14,158,21633,267,1357,18,524,16537,1400,6496
4.972,6,43,8345,21,227,248,314,4022,22,491,224,1179,4323
1784.192,6,359,22709,209,69,8577,69,12569,150,69,11974,69,10140
0.119,6,10,584,5,44,29,44,312,5,0,27,0,272
176.116,17,4,824,2,48,176106,48,152,2,308,176105,308,672
71.088,6,30,7435,13,155,5924,267,1306,17,453,4442,3417,6129
1401.03,17,12,3294,6,30,280205,30,348,6,463,280205,463,2946
1796.615,6,356,22520,208,69,8679,69,12460,148,69,12221,69,10060
1783.786,6,104,8444,68,66,26623,66,4964,36,60,50962,60,3480
1720.009,17,12,498,11,14,172000,14,462,1,8,0,8,36
609.469,6,67,7820,34,89,18461,721,3213,33,126,19038,1448,4607
8.1,6,18,6407,5,154,2025,267,672,13,578,660,1997,5735
315.908,6,79,13914,34,154,9572,971,4083,45,250,7098,1929,9831
0.025,6,2,100,1,0,0,0,60,1,0,0,0,40
1.678,6,13,2311,8,188,239,245,700,5,1407,356,1407,1611
1792.939,6,365,25570,213,99,8457,469,15005,152,69,11872,69,10565
1.323,6,49,21274,29,906,47,1360,15698,20,529,60,4075,5576
1719.434,17,12,498,11,14,171943,14,462,1,8,0,8,36
20.171,6,22,5470,12,107,1833,159,1074,10,773,2237,1408,4396
2.969,6,13,2311,8,188,424,245,700,5,1407,676,1407,1611
12.492,6,1837,1702952,1200,1367,10,1432,1673172,637,428,19,1871,29780
1787.477,6,102,8296,68,65,26678,65,4930,34,59,54161,59,3366
7.103,6,18,6940,5,275,1316,275,754,13,566,577,1440,6186
10.942,6,18,5610,10,275,1215,275,958,8,1440,846,1440,4652
1786.712,6,104,8444,68,66,26667,66,4964,36,60,51046,60,3480
14.823,6,24,6993,13,275,1235,275,1078,11,910,981,1440,5915
1624.406,2,12,384,12,8,147673,8,384,0,0,0,0,0
1788.095,6,120,12639,79,81,22924,515,6254,41,128,44699,1452,6385
154.122,17,8,2688,8,308,22017,308,2688,0,0,0,0,0
0.625,6,21,5000,9,137,77,267,1052,12,577,56,1400,3948
302.948,17,6,2016,6,308,60589,308,2016,0,0,0,0,0
0.02,17,3,1007,1,137,0,137,165,2,393,19,393,842
1772.534,6,180,15480,120,69,14895,69,8940,60,69,30038,69,6540
10.292,6,1702,1559961,1074,1374,9,1408,1522641,628,931,16,2816,37320
1.461,6,51,19735,27,920,56,1360,13999,24,433,55,1360,5736
285.01,1,3,168,3,28,142505,28,168,0,0,0,0,0
0.352,6,10,968,5,256,86,256,460,5,304,86,304,508
236.58,17,3,3261,3,1059,118290,1427,3261,0,0,0,0,0
797.211,1,46,2576,46,28,17715,28,2576,0,0,0,0,0
1792.814,1,170,18020,170,78,10608,78,18020,0,0,0,0,0
240.188,6,54,16293,29,690,8577,1402,13253,25,216,10007,580,3040
1772.32,6,180,15480,120,69,14893,69,8940,60,69,30037,69,6540
304.218,2,9,288,9,8,38027,8,288,0,0,0,0,0
1676.731,1,8,448,8,28,239533,28,448,0,0,0,0,0
1263.429,2,11,352,11,8,126342,8,352,0,0,0,0,0
61.289,6,37,15909,22,797,2918,1402,9131,15,665,4360,1402,6778
0.434,6,12,1653,6,288,82,288,548,6,426,50,434,1105
1757.884,1,71,5964,0,0,0,0,0,71,56,25112,56,5964
6.186,6,5,272,3,0,3093,0,144,2,0,12,0,128
1.271,6,53,18970,29,856,45,1360,13189,24,400,48,1360,5781
16.758,6,24,5870,13,275,1396,275,1086,11,1440,1174,1440,4784
1.334,6,40,8401,21,320,66,1162,2820,19,437,63,2720,5581
1.586,6,38,8252,19,320,88,1162,2716,19,433,77,1360,5536
280.285,6,28,7352,12,158,25480,267,1277,16,603,18681,1400,6075
2.205,6,14,2351,8,188,315,245,700,6,703,389,1152,1651
1666.645,1,7,392,7,28,277774,28,392,0,0,0,0,0
1798.281,1,58,4872,58,56,31548,56,4872,0,0,0,0,0
1795.965,17,448,39896,403,35,4467,288,25676,45,288,40015,288,14220
3.889,17,5,720,4,60,1292,60,352,1,340,0,340,368
14.926,6,21,4751,10,309,1658,722,1752,11,479,1473,1408,2999
1769.634,6,99,9306,66,66,27225,66,5610,33,60,55289,60,3696
0.807,6,28,14455,16,980,53,1440,7535,12,918,53,1485,6920
56.217,6,11,3800,11,293,5621,387,3800,0,0,0,0,0
1684.507,2,25,800,25,8,70187,8,800,0,0,0,0,0
280.197,6,29,7392,13,158,23349,267,1317,16,603,18678,2036,6075
0.268,6,11,3652,6,171,51,171,491,5,1446,66,2675,3161
1.746,6,13,2311,8,188,249,245,700,5,1407,370,1407,1611
0.007,17,2,382,1,47,0,47,75,1,279,0,279,307
200.032,6,31,7472,14,158,15387,267,1357,17,543,12499,1400,6115
340.415,17,5,1672,5,306,85103,308,1672,0,0,0,0,0
1750.753,6,94,7151,62,38,28700,205,4424,32,33,56462,98,2727
3.99,17,3,1167,3,361,1995,361,1167,0,0,0,0,0
15.13,17,6,528,3,48,7561,48,228,3,72,7560,72,300
0.17,17,4,588,2,48,163,48,152,2,190,162,308,436
1771.31,6,104,9648,68,65,26437,65,5758,36,59,50606,59,3890
1680.571,17,12,498,11,14,168057,14,462,1,8,0,8,36
0.662,6,10,924,5,283,115,283,551,5,105,113,105,373
223.735,6,37,10855,16,271,14913,1189,3089,21,494,11183,2077,7766
1772.423,6,180,15480,120,69,14894,69,8940,60,69,30034,69,6540
1.372,6,52,13885,24,553,59,1429,4856,28,438,50,1460,9029
283.447,1,4,224,4,28,94482,28,224,0,0,0,0,0
20.189,6,22,5482,13,107,1682,159,1126,9,967,2521,1659,4356
1785.548,6,119,14049,76,83,23807,516,6038,43,161,42510,1452,8011
1795.466,17,448,39384,403,35,4466,288,25412,45,282,40020,288,13972
4.834,6,39,7285,21,218,241,314,3463,18,516,268,1179,3822
7.459,17,16,3436,8,37,1063,37,520,8,336,1052,348,2916
24.34,1,4,424,4,78,8113,78,424,0,0,0,0,0
0.068,6,9,1340,5,145,17,145,349,4,827,21,827,991
1742.074,1,109,6104,109,28,16130,28,6104,0,0,0,0,0
46.352,2,2,64,2,8,46352,8,64,0,0,0,0,0
1781.761,6,353,22400,205,69,8734,69,12340,148,69,12120,69,10060
6.72,6,39,7285,20,218,353,314,3423,19,516,358,1179,3862
6.202,6,1550,1424555,975,1383,6,1408,1389991,575,776,10,1408,34564
3.69,17,27,20424,12,558,335,1350,7035,15,864,250,1350,13389
7.563,6,69,20326,36,565,216,1152,15579,33,489,228,1179,4747
3.177,17,25,6381,10,257,353,1350,2853,15,207,114,1350,3528
1775.877,1,58,4872,58,56,31155,56,4872,0,0,0,0,0
18.062,17,6,528,3,48,9026,48,228,3,72,9026,72,300
0.807,6,20,5952,11,282,80,548,1292,9,716,91,1420,4660
1771.993,6,180,15480,120,69,14890,69,8940,60,69,30032,69,6540
15.875,17,19,12860,11,954,1584,1350,10812,8,228,2263,1350,2048
0.051,17,4,420,2,33,8,33,122,2,121,44,145,298
202.98,17,4,244,2,33,202978,33,122,2,33,202979,33,122
17.035,6,8,602,0,0,0,0,0,8,31,2433,31,602
0.098,17,2,399,1,39,0,39,67,1,304,0,304,332
6.388,6,9,588,3,106,3188,106,234,6,90,1275,90,354
3.067,17,4,240,4,32,1022,32,240,0,0,0,0,0
715.065,6,106,14132,57,85,11863,267,4584,49,168,14897,1420,9548
1796.489,6,357,22629,208,69,8678,69,12529,149,69,12138,69,10100
1789.95,6,374,23723,215,69,8364,69,13223,159,69,11328,69,10500
2.837,17,4,624,4,128,945,128,624,0,0,0,0,0
198.589,17,13,2912,13,196,16549,371,2912,0,0,0,0,0
0.032,17,2,279,1,36,0,36,64,1,187,0,187,215
1793.1,6,371,23672,212,69,8498,69,12758,159,69,11348,69,10914
1796.488,17,448,39896,403,35,4468,288,25676,45,288,40014,288,14220
0.113,17,2,417,1,34,0,34,62,1,327,0,327,355
598.71,17,16,5376,16,308,39914,308,5376,0,0,0,0,0
0.023,17,2,157,1,31,0,31,59,1,70,0,70,98
318.59,6,5,216,4,0,106196,0,168,1,0,0,0,48
1798.717,17,449,39928,404,35,4463,288,25708,45,288,40022,288,14220
1.577,6,25,8056,12,164,121,267,1288,13,869,111,1448,6768
1783.817,6,443,26735,220,69,8145,69,13147,223,36,8035,69,13588
29.581,6,10,745,10,69,3286,69,745,0,0,0,0,0
1797.252,17,144,11520,72,48,25313,48,5472,72,56,25313,56,6048
8.108,6,1723,1584869,1086,1381,7,1408,1547081,637,776,12,1408,37788
0.07,17,2,144,1,36,0,36,64,1,52,0,52,80
382.015,6,26,3946,16,342,25467,342,2370,10,232,30985,233,1576
116.445,6,26,1060,11,0,5322,0,444,15,0,8316,0,616
1793.435,1,58,4872,58,56,31463,56,4872,0,0,0,0,0
1.592,6,30,10425,18,372,93,850,1842,12,1012,137,1420,8583
0.012,6,12,3462,6,75,2,75,395,6,1373,2,1448,3067
240.201,6,55,17213,30,711,8282,1408,14368,25,192,10008,580,2845
135.437,6,28,11993,15,563,57,1360,2896,13,1070,11275,2574,9097
41.707,17,44,6468,22,48,1983,48,1672,22,190,1980,308,4796
1.366,6,10,1687,7,100,227,100,384,3,1179,556,1179,1303
35.93,6,17,6278,4,106,11976,106,274,13,497,2980,1933,6004
33.713,6,30,5041,15,154,2408,722,1859,15,399,2394,1440,3182
33.498,1,2,112,2,28,33498,28,112,0,0,0,0,0
1781.365,1,215,12040,215,28,8324,28,12040,0,0,0,0,0
0.524,17,3,543,2,39,73,39,134,1,381,0,381,409
11.6,6,1846,1591470,1122,1363,10,1380,1557360,724,421,15,1923,34110
93.181,17,4,240,2,32,93180,32,120,2,32,93179,32,120
272.756,17,4,352,2,60,272755,60,176,2,60,272755,60,176
300.783,6,37,9875,21,593,15039,1360,4433,16,479,574,4027,5442
0.451,6,2,80,1,0,0,0,40,1,0,0,0,40
4.083,17,5,290,5,30,1020,30,290,0,0,0,0,0
3.125,6,11,467,5,0,741,0,208,6,7,593,7,259
3.003,6,9,379,5,0,750,0,204,4,7,657,7,175
14.862,6,14,2242,8,210,2122,210,844,6,545,2965,904,1398
0.449,6,11,2032,5,288,106,288,508,6,424,49,434,1524
398.456,1,32,3392,32,78,12853,78,3392,0,0,0,0,0
1785.858,6,360,24156,210,88,8544,469,13878,150,69,11985,69,10278
1786.493,6,104,8444,68,66,26664,66,4964,36,60,51039,60,3480
1787.945,6,227,26423,141,102,12771,469,13049,86,127,21030,1452,13374
161.742,6,36,2374,16,46,10782,46,1022,20,46,8506,46,1352
7.039,17,4,488,4,94,2346,94,488,0,0,0,0,0
1785.881,6,104,8444,68,66,26654,66,4964,36,60,51021,60,3480
1786.681,6,362,22898,210,69,8548,69,12678,152,69,11830,69,10220
1681.671,17,16,1265,8,30,240236,37,471,8,71,240236,136,794
15.63,6,7,380,2,0,15630,0,100,5,0,3852,0,280
0.8,17,17,8024,9,518,99,1350,4920,8,360,109,1350,3104
8.273,6,40,7650,20,218,435,314,3423,20,489,421,1179,4227
1.178,17,4,708,2,30,1168,30,116,2,268,1153,292,592
27.178,17,16,1408,8,48,3873,48,608,8,72,3869,72,800
0.281,17,2,390,1,46,0,46,74,1,288,0,288,316
25.991,6,26,7623,16,151,1732,318,1759,10,889,2886,1659,5864
1.601,17,6,360,3,32,800,32,180,3,32,799,32,180
1.365,6,47,19003,26,947,54,1460,13387,21,433,57,1460,5616
240.315,6,43,9032,21,524,12015,1418,5819,22,229,11443,618,3213
0.864,6,21,5988,12,281,78,544,1328,9,716,97,1420,4660
1776.038,6,182,15629,121,69,14800,69,8980,61,69,29596,69,6649
0.452,6,4,220,2,0,452,0,100,2,0,302,0,120
280.257,6,29,7392,13,158,23354,267,1317,16,603,18677,2036,6075
1771.843,6,99,9240,66,65,27259,65,5577,33,59,55367,59,3663
1.298,6,47,20050,28,890,48,1360,14514,19,476,62,2715,5536
0.015,17,2,351,1,39,0,39,67,1,256,0,256,284
3.787,6,2,88,2,0,0,0,88,0,0,0,0,0
1782.272,17,83,3480,82,14,22003,14,3444,1,8,0,8,36
364.35,2,4,128,4,8,121450,8,128,0,0,0,0,0
126.463,2,2,64,2,8,126463,8,64,0,0,0,0,0
0.007,17,2,387,1,65,0,65,93,1,266,0,266,294
1793.402,17,144,11520,72,48,25259,48,5472,72,56,25259,56,6048
15.551,6,10,560,5,0,3843,0,300,5,0,3843,0,260
92.022,6,25,9876,12,541,67,1460,2677,13,952,7658,1460,7199
1.628,6,274,252786,97,330,16,331,8026,177,1402,9,2876,244760
1770.714,6,101,9278,66,64,27241,64,5544,35,58,52075,58,3734
0.0,17,1,1364,1,1336,0,1336,1364,0,0,0,0,0
1773.465,6,180,15480,120,69,14903,69,8940,60,69,30050,69,6540
0.14,1,2,112,2,28,140,28,112,0,0,0,0,0
1782.161,17,73,3060,72,14,25100,14,3024,1,8,0,8,36
36.205,17,3,228,3,48,18102,48,228,0,0,0,0,0
1770.366,1,58,4872,0,0,0,0,0,58,56,31059,56,4872
1785.947,6,104,8376,68,65,26655,65,4930,36,59,51024,59,3446
1795.485,6,363,23007,210,69,8590,69,12678,153,69,11812,69,10329
0.137,17,8,889,8,83,19,220,889,0,0,0,0,0
1793.119,1,284,15904,284,28,6336,28,15904,0,0,0,0,0
240.984,6,76,53000,48,1208,5127,1368,44809,28,840,2292,2519,8191
1790.557,6,369,28823,214,121,8406,1221,16320,155,94,11626,917,12503
108.502,17,4,352,2,60,108501,60,176,2,60,108501,60,176
0.316,17,2,157,1,31,0,31,59,1,70,0,70,98
0.062,6,13,3980,7,88,10,88,388,6,1670,12,1880,3592
165.03,2,3,96,3,8,82515,8,96,0,0,0,0,0
1681.637,17,14,1036,7,30,280271,30,406,7,62,280270,62,630
255.962,6,24,5954,11,272,73,517,1261,13,416,21324,1420,4693
1798.809,17,449,39928,404,35,4463,288,25708,45,288,40023,288,14220
9.291,17,20,6155,8,280,1327,1350,2471,12,279,561,1350,3684
240.257,6,43,4982,21,199,12012,610,2497,22,166,11440,843,2485
1793.43,17,144,11520,72,48,25259,48,5472,72,56,25259,56,6048
164.653,1,4,424,4,78,54884,78,424,0,0,0,0,0
0.27,6,7,423,4,43,38,43,259,3,0,83,0,164
378.508,6,21,1422,15,180,27036,180,992,6,110,12236,110,430
0.094,6,9,1340,5,145,23,145,349,4,827,22,827,991
9.544,6,40,7677,20,218,502,314,3423,20,431,482,1179,4254
1791.525,17,129,10316,65,48,27992,48,4940,64,56,28436,56,5376
496.379,17,10,3437,10,315,55153,376,3437,0,0,0,0,0
0.405,6,10,968,5,256,95,256,460,5,304,97,304,508
1786.319,17,87,3648,86,14,21015,14,3612,1,8,0,8,36
3.252,6,4,228,1,0,0,0,60,3,0,1519,0,168
0.789,6,27,5927,13,156,65,267,1462,14,650,55,1420,4465
0.243,6,24,5962,12,164,22,453,1442,12,777,21,2206,4520
1778.613,6,180,15480,120,69,14946,69,8940,60,69,30140,69,6540
1797.097,17,448,39896,403,35,4470,288,25676,45,288,40017,288,14220
270.567,6,54,9430,30,99,9329,267,2607,24,292,11761,1460,6823
630.793,2,5,160,5,8,157698,8,160,0,0,0,0,0
21.182,6,1123,1033407,498,338,42,339,33232,625,1612,33,7040,1000175
1772.567,6,180,15480,120,69,14895,69,8940,60,69,30037,69,6540
383.462,1,6,677,6,84,76692,105,677,0,0,0,0,0
1794.909,1,58,4872,0,0,0,0,0,58,56,31489,56,4872
0.341,6,27,9042,14,247,26,624,1724,13,947,27,1448,7318
1740.502,1,16,896,16,28,116033,28,896,0,0,0,0,0
0.42,17,2,312,2,128,420,128,312,0,0,0,0,0
354.112,1,12,672,12,28,32192,28,672,0,0,0,0,0
1.988,6,14,2351,8,188,284,245,700,6,703,346,1152,1651
60.328,6,14,3888,8,127,8618,127,467,6,1056,12057,1704,3421
1786.722,6,314,29840,134,67,13433,659,11160,180,107,9981,2720,18680
54.615,6,40,12268,21,833,447,1360,6706,19,435,3023,2667,5562
70.403,6,29,7395,13,155,5866,267,1306,16,453,4692,3417,6089
1741.998,6,103,7486,65,31,27218,31,4439,38,31,47065,31,3047
149.227,6,26,7849,10,272,269,516,1220,16,460,9942,1452,6629
0.135,6,9,1340,5,145,33,145,349,4,827,39,827,991
11.875,6,1885,1640674,1143,1381,10,1420,1606773,742,467,16,1883,33901
1774.987,17,140,11200,70,48,25724,48,5320,70,56,25724,56,5880
136.068,6,12,3248,2,92,8859,92,204,10,501,15097,1448,3044
0.022,6,10,2026,6,729,4,1302,1703,4,159,7,159,323
10.875,17,15,17682,15,1150,776,1451,17682,0,0,0,0,0
91.512,17,4,352,2,60,91511,60,176,2,60,91510,60,176
393.124,6,23,1535,16,177,26208,177,1053,7,110,10467,110,482
1.367,6,50,20092,27,948,52,1440,14396,23,433,54,1440,5696
31.518,6,54,15687,25,948,514,1360,9620,29,325,1119,1360,6067
1793.216,17,168,10752,168,36,10737,36,10752,0,0,0,0,0
280.528,6,29,7392,14,158,21579,267,1357,15,603,20033,2036,6035
1778.055,1,59,4956,0,0,0,0,0,59,56,30656,56,4956
109.99,17,2,125,2,34,109990,39,125,0,0,0,0,0
1.459,6,50,19404,27,899,56,1440,13708,23,433,57,1440,5696
1772.643,6,180,15480,120,69,14896,69,8940,60,69,30036,69,6540
0.021,17,2,290,1,40,0,40,68,1,194,0,194,222
0.452,6,21,7217,12,318,40,599,1905,9,967,55,1471,5312
1.118,17,26,18321,13,650,93,1350,8817,13,703,90,1350,9504
0.806,17,4,368,2,64,805,64,184,2,64,805,64,184
0.041,6,10,1609,5,106,10,106,374,5,967,10,967,1235
648.289,6,39,3048,20,65,25637,65,1450,19,46,36011,59,1598
0.434,17,2,152,1,48,0,48,76,1,48,0,48,76
1773.861,6,181,15589,120,69,14906,69,8940,61,69,29555,69,6649
8.773,6,44,8369,22,227,417,314,4062,22,489,405,1179,4307
3.137,6,111,86984,49,131,65,232,2489,62,1438,51,2860,84495
60.383,6,20,8857,11,738,6038,1448,3533,9,808,7540,1448,5324
1786.341,6,104,8504,69,66,26269,66,5004,35,60,52536,60,3500
277.932,6,38,8731,13,786,23160,1418,5405,25,200,11580,617,3326
1745.697,6,142,8952,77,49,22969,208,5453,65,31,27270,31,3499
315.531,6,20,2429,7,242,52587,517,1111,13,323,26293,499,1318
280.445,6,30,7432,14,158,21572,267,1357,16,678,18693,3536,6075
0.246,6,21,5000,10,137,27,267,1092,11,692,23,1467,3908
0.043,6,11,3653,6,171,5,171,491,5,1447,9,2676,3162
1769.75,6,99,9240,66,65,27226,65,5577,33,59,55300,59,3663
0.409,6,7,295,4,0,136,0,164,3,7,107,7,131
1772.441,6,180,15480,120,69,14894,69,8940,60,69,30039,69,6540
7.46,6,29,11599,10,138,828,267,963,19,759,413,1420,10636
0.404,6,28,8978,14,231,31,563,1660,14,938,30,1438,7318
1799.284,17,766,46192,766,32,2352,37,46192,0,0,0,0,0
1773.673,6,181,15589,120,69,14904,69,8940,61,69,29556,69,6649
87.112,6,10,632,3,92,43507,92,256,7,0,14488,0,376
165.926,6,28,7352,13,158,13827,267,1317,15,678,11849,2800,6035
0.082,17,2,390,1,46,0,46,74,1,288,0,288,316
3.405,17,14,8948,8,836,486,1350,6916,6,310,365,1350,2032
0.795,6,2,1175,1,0,0,0,40,1,1095,0,1095,1135
2.31,6,18,3635,9,288,266,288,704,9,639,266,853,2931
1785.489,6,117,13854,76,81,23806,501,5990,41,159,44633,1420,7864
1783.533,1,8,448,8,28,254790,28,448,0,0,0,0,0
49.009,6,886,732385,513,1434,95,1460,710419,373,212,131,1460,21966
1292.845,6,77,7107,45,45,29382,205,3285,32,67,41694,268,3822
4.943,17,4,542,2,36,4934,36,128,2,179,4931,187,414
96.97,6,23,9823,12,410,55,922,1742,11,1089,9683,3056,8081
9.555,6,22,6877,9,154,1194,267,832,13,613,786,1452,6045
666.915,17,10,3360,10,308,74101,308,3360,0,0,0,0,0
0.22,17,4,284,2,32,111,32,120,2,54,112,60,164
61.917,6,33,19177,16,708,47,1460,4226,17,1188,3861,1867,14951
1767.359,1,140,14840,140,78,12714,78,14840,0,0,0,0,0
60.86,6,7475,7077510,4781,1400,12,1448,6932758,2694,776,22,1448,144752
1782.395,17,83,3480,82,14,22004,14,3444,1,8,0,8,36
0.474,6,22,5961,12,108,43,147,919,10,927,52,1608,5042
1773.38,6,180,15480,120,69,14902,69,8940,60,69,30049,69,6540
1798.475,1,112,11872,112,78,16202,78,11872,0,0,0,0,0
317.553,6,76,18567,40,305,8142,1460,9868,36,329,9056,1629,8699
60.442,6,9,820,5,226,15110,226,494,4,110,20065,110,326
0.266,17,440,491019,88,101,2,1350,11380,352,1334,0,1350,479639
0.851,6,20,5984,11,282,85,548,1292,9,721,95,1452,4692
200.844,6,265,210997,167,1302,1209,1408,193612,98,646,1801,3847,17385
889.129,1,8,652,8,53,127018,78,652,0,0,0,0,0
38.065,6,27,7177,13,155,3172,267,1306,14,530,2927,3417,5871
1684.474,2,23,736,23,8,76567,8,736,0,0,0,0,0
1777.533,17,79,3312,78,14,23084,14,3276,1,8,0,8,36
1786.953,6,102,8364,68,66,26670,66,4964,34,60,54147,60,3400
0.275,6,21,5000,11,137,27,267,1132,10,692,29,1467,3868
1771.885,6,180,15480,120,69,14889,69,8940,60,69,30031,69,6540
1798.181,1,342,28728,342,56,5273,56,28728,0,0,0,0,0
1745.588,6,94,7151,62,38,28616,205,4424,32,33,56295,98,2727
238.672,17,4,352,2,60,238671,60,176,2,60,238670,60,176
5.012,17,4,530,2,36,5007,36,128,2,173,5007,187,402
236.326,6,9,515,5,43,59081,43,299,4,0,78773,0,216
124.86,6,1908,2012709,669,869,186,1385,39141,1239,1548,100,8376,1973568
67.698,17,4,352,2,60,67697,60,176,2,60,67697,60,176
35.764,17,6,1236,3,48,17853,48,228,3,308,17870,308,1008
1793.624,6,769,52239,384,31,4683,31,26242,385,31,4670,71,25997
1739.964,6,87,6322,58,31,30525,31,3915,29,31,62141,31,2407
20.48,17,8,1176,4,48,6824,48,304,4,190,6824,308,872
0.108,6,2,92,1,0,0,0,40,1,0,0,0,52
1780.543,17,140,11200,70,48,25804,48,5320,70,56,25804,56,5880
0.09,17,2,136,1,32,0,32,60,1,48,0,48,76
98.123,6,118,88970,75,1266,1325,1448,78619,43,675,2017,1448,10351
1772.645,6,190,16225,124,69,14411,69,9238,66,69,27267,69,6987
281.977,6,29,7392,13,158,23498,267,1317,16,603,18781,2036,6075
136.284,17,4,352,2,60,136283,60,176,2,60,136283,60,176
20.336,6,19,2432,10,189,2259,517,1298,9,323,2532,499,1134
9.039,6,87,27642,45,578,205,1152,21480,42,407,214,1152,6162
10.799,6,20,4442,11,275,1079,275,998,9,768,714,1440,3444
10.021,17,2,144,2,44,10021,44,144,0,0,0,0,0
2.216,6,13,2311,8,188,316,245,700,5,1407,492,1407,1611
1775.498,17,68,2850,67,14,26901,14,2814,1,8,0,8,36
0.166,1,2,163,2,53,166,78,163,0,0,0,0,0
0.542,17,3,451,2,39,401,39,134,1,289,0,289,317
275.628,17,4,352,2,60,275627,60,176,2,60,275627,60,176
0.054,6,10,1798,6,615,10,1075,1475,4,159,18,159,323
1772.008,6,205,22439,131,75,13630,267,10097,74,133,24272,1997,12342
6.442,6,15,2306,8,210,920,210,856,7,545,1056,904,1450
50.939,6,26,7137,12,155,4630,267,1266,14,530,3917,2840,5871
1.786,17,20,5180,20,231,94,388,5180,0,0,0,0,0
125.382,6,16,3969,8,407,17911,722,1226,8,464,17883,1440,2743
0.015,6,2,104,1,0,0,0,40,1,0,0,0,64
7.455,6,66,20206,34,543,225,1152,15499,32,427,205,1152,4707
252.2,2,2,64,2,8,252200,8,64,0,0,0,0,0
282.459,6,31,7679,12,158,25492,267,1277,19,512,15688,3456,6402
49.286,6,37,10347,20,386,2594,1048,4526,17,410,3074,1815,5821
93.87,6,39,8449,14,147,7220,267,1750,25,316,3910,1460,6699
0.349,6,26,7256,12,155,31,267,1261,14,603,24,1400,5995
3.341,17,10,2375,5,40,832,40,340,5,379,832,379,2035
20.297,6,22,5470,13,107,1691,159,1126,9,967,2530,1709,4344
1789.949,6,353,22400,206,69,8731,69,12380,147,69,12259,69,10020
1715.606,1,8,448,8,28,245086,28,448,0,0,0,0,0
1797.244,6,381,27024,220,103,8206,469,16030,161,69,11230,69,10994
249.649,6,55,10898,24,111,10853,267,2304,31,282,8321,1420,8594
371.552,6,26,1703,17,177,23222,177,1117,9,110,8902,110,586
1771.425,6,99,9240,66,65,27252,65,5577,33,59,55354,59,3663
0.102,17,4,352,2,37,0,37,130,2,83,3,89,222
1799.438,1,16,896,16,28,119962,28,896,0,0,0,0,0
1772.436,6,180,15480,120,69,14894,69,8940,60,69,30034,69,6540
88.536,6,35,20341,15,579,49,1440,2950,20,1184,4652,1440,17391
11.489,17,3,984,3,300,5744,300,984,0,0,0,0,0
1799.475,17,87,3648,86,14,21170,14,3612,1,8,0,8,36
1785.295,1,56,4704,56,56,32459,56,4704,0,0,0,0,0
1.626,6,50,18750,29,845,58,1360,13089,21,480,69,4075,5661
1770.613,6,109,10038,69,65,26038,65,5822,40,59,45397,59,4216
1775.26,6,180,15480,120,69,14918,69,8940,60,69,30079,69,6540
280.319,6,28,7352,12,158,25483,267,1277,16,543,18682,1400,6075
8.079,6,25,12388,10,275,897,275,954,15,902,395,1414,11434
11.985,6,99,30457,51,563,239,1152,24039,48,449,249,1179,6418
2.517,6,11,3285,6,80,503,80,400,5,872,629,1448,2885
0.341,6,27,9071,13,247,28,624,1672,14,832,25,1438,7399
79.881,6,24,11037,13,740,72,1360,3513,11,1178,7971,2580,7524
1772.186,6,180,15480,120,69,14892,69,8940,60,69,30036,69,6540
1796.922,1,345,28980,345,56,5223,56,28980,0,0,0,0,0
0.169,6,26,7256,13,155,14,267,1301,13,678,13,2800,5955
0.011,6,10,1755,5,657,2,657,925,5,562,2,562,830
95.372,17,4,352,2,60,95371,60,176,2,60,95370,60,176
249.207,6,54,12894,24,164,10834,517,2480,30,589,8593,1408,10414
1739.103,1,56,4704,0,0,0,0,0,56,56,31620,56,4704
12.157,17,10,2240,5,46,3034,46,370,5,346,3034,346,1870
1794.853,17,142,11360,71,48,25640,48,5396,71,56,25640,56,5964
1799.726,6,474,53864,266,200,6791,1189,29274,208,146,8694,1420,24590
1791.37,6,359,22778,208,69,8653,69,12529,151,69,11942,69,10249
13.637,17,20,1720,10,47,1514,47,750,10,69,1514,75,970
0.039,17,2,200,1,42,0,42,70,1,102,0,102,130
377.489,2,4,128,4,8,125829,8,128,0,0,0,0,0
8.171,6,1284,1140137,786,1371,10,1408,1109577,498,931,16,2816,30560
1773.343,6,180,15480,120,69,14902,69,8940,60,69,30051,69,6540
60.235,6,42,9984,20,533,519,910,2991,22,435,2861,2128,6993
8.216,6,77,24637,40,561,210,1152,19016,37,459,221,1179,5621
3.691,17,12,6271,6,615,738,1350,3860,6,373,263,1350,2411
0.163,6,46,22001,27,1061,6,1420,17020,19,467,8,1883,4981
592.192,1,6,336,6,28,118438,28,336,0,0,0,0,0
6.854,6,49,12536,26,464,274,1152,8946,23,444,299,1179,3590
1638.368,1,7,392,7,28,273061,28,392,0,0,0,0,0
1798.32,1,282,15792,282,28,6399,28,15792,0,0,0,0,0
190.473,17,4,240,2,32,190472,32,120,2,32,190472,32,120
5.387,6,894,751473,517,1411,10,1432,732148,377,420,14,1432,19325
2.799,17,6,1509,3,40,1393,40,204,3,407,1392,407,1305
0.053,6,7,423,4,43,5,43,259,3,0,24,0,164
1792.675,17,180,11520,180,36,10014,36,11520,0,0,0,0,0
1794.137,17,180,11520,180,36,10023,36,11520,0,0,0,0,0
124.425,6,36,8015,13,155,27,267,1306,23,321,5655,2840,6709
5.018,17,4,558,2,36,5013,36,128,2,187,5014,187,430
6.744,6,1247,1144391,785,1381,8,1408,1115703,462,931,14,2816,28688
40.811,17,7,6602,7,915,6801,1451,6602,0,0,0,0,0
1798.331,6,132,8490,75,50,24301,208,5280,57,31,32104,31,3210
1786.313,6,364,23047,211,69,8506,69,12787,153,69,11749,69,10260
2.115,6,30,10640,16,263,141,606,2158,14,704,160,1408,8482
2.984,17,3,1176,3,364,1492,364,1176,0,0,0,0,0
0.893,6,25,5876,14,161,68,267,1531,11,650,82,1414,4345
9.857,6,23,6677,13,170,821,170,870,10,1313,891,1408,5807
630.652,6,99,19209,52,117,12365,721,5731,47,504,13705,2828,13478
1.275,17,2,136,1,32,0,32,60,1,48,0,48,76
11.675,6,25,8473,13,275,972,275,1078,12,986,790,1440,7395
18.08,17,4,352,2,48,18072,48,152,2,72,18072,72,200
41.476,6,3,120,1,0,0,0,40,2,0,41468,0,80
77.026,6,168,140355,69,102,1132,296,4129,99,1409,785,2816,136226
0.0,1,1,225,1,197,0,197,225,0,0,0,0,0
1775.265,17,140,11200,70,48,25728,48,5320,70,56,25728,56,5880
0.504,17,3,451,2,39,143,39,134,1,289,0,289,317
1744.669,2,26,832,26,8,69786,8,832,0,0,0,0,0
0.302,6,25,8894,13,244,25,618,1663,12,1099,27,2816,7231
1788.221,1,60,5040,60,56,30308,56,5040,0,0,0,0,0
0.981,6,29,8343,15,263,60,586,2222,14,792,61,1360,6121
1796.161,1,58,4872,58,56,31511,56,4872,0,0,0,0,0
1684.027,17,40,16193,40,376,43180,548,16193,0,0,0,0,0
2.95,6,17,7099,9,498,368,721,1360,8,1353,391,1414,5739
314.818,6,24,5555,9,133,39351,159,911,15,773,22486,1408,4644
243.774,6,33,12134,14,727,22,1408,4375,19,614,13542,1578,7759
1783.566,17,83,3480,82,14,22019,14,3444,1,8,0,8,36
236.767,17,8,2688,8,308,33823,308,2688,0,0,0,0,0
280.248,6,27,7312,12,158,25477,267,1277,15,678,20015,2045,6035
0.074,17,8,2454,8,278,10,317,2454,0,0,0,0,0
9.404,6,58,18887,30,719,324,1380,13465,28,468,345,3303,5422
1740.472,17,30,20190,30,645,60016,645,20190,0,0,0,0,0
0.972,6,10,1687,7,100,162,100,384,3,1179,360,1179,1303
1786.623,6,359,22709,209,69,8589,69,12569,150,69,11990,69,10140
280.175,6,27,7312,13,158,23347,267,1317,14,775,21549,3445,5995
1740.723,17,30,7050,30,207,60024,207,7050,0,0,0,0,0
3.23,6,2,262,0,0,0,0,0,2,91,3230,91,262
1705.499,17,12,498,11,14,170549,14,462,1,8,0,8,36
15.647,6,24,6993,13,275,1303,275,1078,11,910,1063,1440,5915
0.981,6,7,295,4,0,327,0,164,3,7,134,7,131
0.504,6,3,387,2,267,251,267,347,1,0,0,0,40
1744.214,6,95,7203,63,38,28132,205,4476,32,33,56257,98,2727
5.766,6,13,2307,8,304,823,304,1944,5,83,1423,83,363
1.279,6,48,19678,27,925,49,1460,14062,21,433,55,1460,5616
1797.578,1,259,14504,259,28,6967,28,14504,0,0,0,0,0
240.186,6,50,16306,26,752,9607,1402,13405,24,205,10442,580,2901
1785.861,6,361,22858,209,69,8585,69,12638,152,69,11826,69,10220
1795.334,17,253,48385,253,163,7124,353,48385,0,0,0,0,0
61.89,6,70,46836,43,1175,1473,1408,38698,27,747,2371,1408,8138
1774.684,6,83,4444,42,26,43283,26,2248,41,26,44366,26,2196
2.006,6,2,84,1,0,0,0,44,1,0,0,0,40
1796.625,17,448,39896,403,35,4469,288,25676,45,288,40013,288,14220
0.07,17,2,184,1,32,0,32,60,1,96,0,96,124
10.703,6,86,27021,43,561,254,1152,20819,43,447,248,1179,6202
3.191,6,12,1767,6,100,128,100,344,6,589,590,1152,1423
1799.845,17,763,46018,763,32,2362,37,46018,0,0,0,0,0
1719.265,1,8,448,8,28,245609,28,448,0,0,0,0,0
1.534,6,50,19802,27,928,59,1360,14106,23,433,60,1360,5696
0.016,6,4,232,3,0,8,0,180,1,0,0,0,52
1785.858,6,365,25432,213,100,8423,469,14936,152,69,11826,69,10496
373.739,6,25,1651,17,177,23358,177,1117,8,110,9256,110,534
0.313,6,26,8913,13,242,26,610,1655,13,1095,25,2816,7258
1695.405,17,22,1758,12,31,154123,37,710,10,76,188353,136,1048
33.785,6,31,5093,15,154,2413,722,1859,16,342,2238,1448,3234
0.515,17,3,451,2,39,141,39,134,1,289,0,289,317
300.931,6,35,16500,15,195,21483,431,1568,20,868,15829,5453,14932
1778.992,17,140,11200,70,48,25781,48,5320,70,56,25781,56,5880
0.285,6,11,1971,6,451,56,500,1222,5,481,71,481,749
3.097,17,3,228,2,48,3050,48,152,1,48,0,48,76
1741.106,6,89,6426,58,31,30545,31,3915,31,31,58034,31,2511
0.371,17,8,2750,8,315,53,354,2750,0,0,0,0,0
1.201,17,2,338,1,33,0,33,61,1,249,0,249,277
43.422,17,4,352,2,60,43421,60,176,2,60,43421,60,176
0.256,17,2,144,1,36,0,36,64,1,52,0,52,80
0.175,17,4,284,2,32,154,32,120,2,54,27,60,164
374.617,6,18,1242,14,180,28816,180,916,4,110,20055,110,326
0.032,17,2,212,1,46,0,46,74,1,110,0,110,138
1783.853,1,339,28476,339,56,5277,56,28476,0,0,0,0,0
1745.512,6,90,6540,60,31,29584,31,4050,30,31,60181,31,2490
7.884,6,9,392,4,0,2628,0,172,5,0,1129,0,220
1.726,17,6,1722,3,32,861,32,180,3,486,860,486,1542
0.029,17,2,382,1,37,0,37,65,1,289,0,289,317
1.408,6,48,20585,28,923,52,1360,15009,20,476,64,2715,5576
300.621,6,43,8737,21,278,15031,734,1997,22,365,416,1360,6740
280.32,6,31,7472,13,158,23360,267,1317,18,543,16485,1400,6155
0.124,6,13,2100,7,329,20,500,1030,6,375,24,500,1070
194.107,6,24,1735,18,43,11418,43,1375,6,0,38215,0,360
1263.335,2,8,256,8,8,180476,8,256,0,0,0,0,0
2.034,6,2,1134,1,0,0,0,40,1,1054,0,1054,1094
202.504,17,4,352,2,60,202503,60,176,2,60,202503,60,176
0.263,6,21,5000,11,137,26,267,1132,10,692,27,1467,3868
226.749,17,4,352,2,60,226747,60,176,2,60,226748,60,176
1741.411,17,30,31680,30,1028,60048,1028,31680,0,0,0,0,0
12.626,17,4,352,2,48,12611,48,152,2,72,12606,72,200
1680.941,1,15,840,15,28,120067,28,840,0,0,0,0,0
0.044,17,4,304,2,37,0,37,130,2,59,19,65,174
0.012,17,3,1007,1,137,0,137,165,2,393,12,393,842
279.32,6,32,8952,14,158,21486,267,1357,18,624,16427,1400,7595
0.335,6,4,208,3,0,2,0,156,1,0,0,0,52
6.892,6,571,453677,327,1318,20,1368,436325,244,776,27,2736,17352
0.041,17,4,308,2,38,0,38,132,2,60,37,66,176
40.394,6,8,460,2,0,40394,0,100,6,0,6381,0,360
0.185,17,2,185,1,33,0,33,61,1,96,0,96,124
657.437,6,67,8329,34,102,19917,722,3515,33,129,20539,1408,4814
240.176,6,52,15727,28,679,8895,1402,13018,24,207,10442,580,2709
3.769,17,5,295,5,31,942,31,295,0,0,0,0,0
1684.29,17,15,1094,8,30,240610,30,464,7,62,280712,62,630
78.609,6,15,1928,9,483,9826,483,1442,6,83,15718,83,486
1781.786,1,342,28728,342,56,5225,56,28728,0,0,0,0,0
61.256,6,587,265673,302,820,203,1152,248427,285,389,214,1152,17246
0.014,17,2,219,1,52,0,52,80,1,111,0,111,139
99.124,6,934,459688,514,829,193,1152,437756,420,427,235,1179,21932
1774.852,6,180,15480,120,69,14914,69,8940,60,69,30077,69,6540
7.832,6,2,1134,1,0,0,0,40,1,1054,0,1054,1094
490.313,17,12,4060,12,310,44573,320,4060,0,0,0,0,0
2.984,6,12,507,7,0,497,0,288,5,7,693,7,219
1797.894,1,236,13216,236,28,7650,28,13216,0,0,0,0,0
1795.829,1,190,10640,190,28,9501,28,10640,0,0,0,0,0
1793.729,6,356,22520,208,69,8665,69,12460,148,69,12201,69,10060
11.288,6,1792,1560420,1092,1375,10,1420,1528199,700,467,16,1883,32221
1734.56,6,80,13978,50,111,35399,1440,5181,30,288,59806,1440,8797
0.2,6,46,20322,26,1017,8,1420,15301,20,467,10,1883,5021
46.289,17,4,1344,4,308,15429,308,1344,0,0,0,0,0
0.269,6,26,7256,13,155,22,267,1301,13,603,21,2036,5955
1787.411,6,102,8228,68,64,26677,64,4896,34,58,54161,58,3332
10.772,6,20,4442,11,275,1077,275,998,9,768,737,1440,3444
1786.317,6,405,37870,234,161,7666,1093,21282,171,116,10504,501,16588
1774.138,17,138,11040,69,48,26089,48,5244,69,56,26089,56,5796
296.875,6,38,7260,19,262,16490,517,1792,19,744,16490,1418,5468
1764.52,2,13,416,13,8,147043,8,416,0,0,0,0,0
0.872,17,4,360,2,30,871,30,116,2,94,835,94,244
477.592,1,66,3696,0,0,0,0,0,66,28,7347,28,3696
31.025,6,11,640,4,0,10341,0,220,7,0,2891,0,420
4.382,6,39,7285,20,218,230,314,3423,19,516,228,1179,3862
1621.863,1,46,2576,46,28,36041,28,2576,0,0,0,0,0
60.163,2,2,64,2,8,60163,8,64,0,0,0,0,0
119.621,17,4,272,2,40,119620,47,136,2,40,119620,47,136
87.702,17,4,1344,4,308,29234,308,1344,0,0,0,0,0
1552.785,1,81,4536,81,28,19409,28,4536,0,0,0,0,0
30.65,17,9,684,9,48,3831,48,684,0,0,0,0,0
382.779,6,18,1239,14,177,29444,177,913,4,110,20077,110,326
1773.654,6,180,15480,120,69,14904,69,8940,60,69,30053,69,6540
1635.923,1,7,742,7,78,272653,78,742,0,0,0,0,0
1.702,6,13,2311,8,188,243,245,700,5,1407,359,1407,1611
11.794,17,8,1176,4,48,3928,48,304,4,190,3927,308,872
240.187,6,53,17460,28,768,8895,1418,14535,25,202,10007,580,2925
1.29,6,31,6467,15,164,92,267,1922,16,650,75,1452,4545
1.052,6,10,1687,7,100,175,100,384,3,1179,393,1179,1303
0.808,6,117,87456,51,131,16,232,2569,66,1348,12,1430,84887
24.752,6,2066,1795520,1258,1371,19,1380,1754419,808,561,30,1923,41101
2.721,17,8,1640,4,36,905,36,256,4,318,905,318,1384
27.328,6,46,13218,22,200,1301,721,2688,24,597,584,1414,10530
1074.751,17,212,16112,212,48,5093,48,16112,0,0,0,0,0
1.09,17,20,6065,8,280,155,1350,2467,12,271,72,1350,3598
1790.17,17,176,11264,176,36,10229,36,11264,0,0,0,0,0
107.252,17,4,352,2,60,107251,60,176,2,60,107251,60,176
167.279,6,26,8765,9,267,93,501,1165,17,461,10449,1420,7600
20.452,6,20,3130,12,183,1859,517,1561,8,381,2920,499,1569
1798.122,6,376,26217,217,98,8324,469,15372,159,69,11379,69,10845
0.737,17,12,4377,12,336,67,359,4377,0,0,0,0,0
1.276,6,2,120,2,0,0,0,120,0,0,0,0,0
1679.865,1,15,840,15,28,119990,28,840,0,0,0,0,0
0.622,17,2,136,1,32,0,32,60,1,48,0,48,76
0.03,6,10,1673,6,553,5,949,1350,4,159,10,159,323
285.801,1,7,392,7,28,47633,28,392,0,0,0,0,0
1786.952,6,105,8544,68,66,26670,66,4964,37,60,49634,60,3580
22.518,6,20,3130,12,183,2047,517,1561,8,381,3215,499,1569
3.782,17,48,20595,24,659,164,1350,16499,24,142,151,1350,4096
301.307,6,38,8749,19,271,16739,739,1898,19,434,503,1460,6851
64.044,6,13,532,6,0,6992,0,244,7,0,10672,0,288
1638.448,1,8,448,8,28,234064,28,448,0,0,0,0,0
0.752,17,4,918,2,40,742,40,136,2,363,740,363,782
65.73,17,4,240,2,32,65729,32,120,2,32,65729,32,120
1783.443,17,83,3480,82,14,22017,14,3444,1,8,0,8,36
300.56,6,25,8423,15,385,21468,986,2341,10,925,3358,4307,6082
1771.718,6,99,9240,66,65,27257,65,5577,33,59,55362,59,3663
11.976,17,4,1344,4,308,3992,308,1344,0,0,0,0,0
33.617,6,28,4875,14,170,2585,722,1749,14,342,2571,1408,3126
0.45,17,3,1008,3,308,225,308,1008,0,0,0,0,0
166.578,17,4,352,2,60,166577,60,176,2,60,166577,60,176
0.256,17,2,170,1,37,0,37,65,1,77,0,77,105
10.015,17,3,3249,3,1055,5007,1055,3249,0,0,0,0,0
9.104,6,7,431,3,131,4552,131,255,4,0,2381,0,176
1.748,6,4,220,2,0,1748,0,100,2,0,302,0,120
280.201,6,29,7392,13,158,23350,267,1317,16,603,18678,2036,6075
1.664,6,13,2311,8,188,237,245,700,5,1407,354,1407,1611
0.501,17,3,451,2,39,382,39,134,1,289,0,289,317
0.435,17,17,8822,8,445,58,1350,3790,9,531,50,1350,5032
3.955,17,4,244,4,33,1318,33,244,0,0,0,0,0
52.711,6,34,8190,15,225,3765,314,2409,19,456,2914,1179,5781
1775.672,17,138,11040,69,48,26112,48,5244,69,56,26112,56,5796
1786.21,17,87,3648,86,14,21014,14,3612,1,8,0,8,36
0.037,17,5,696,3,60,6,60,264,2,188,16,188,432
372.533,6,25,1651,17,177,23283,177,1117,8,110,9228,110,534
0.012,17,4,288,2,33,8,33,122,2,55,8,61,166
52.923,17,8,3117,8,361,7560,371,3117,0,0,0,0,0
0.105,17,2,234,1,41,0,41,69,1,137,0,137,165
0.095,6,10,1671,6,552,18,948,1348,4,159,31,159,323
1.448,6,47,17959,26,867,57,1460,12343,21,433,62,1460,5616
1435.833,2,12,384,12,8,130530,8,384,0,0,0,0,0
99.976,6,78,18492,38,283,1316,1360,8957,40,282,2560,2720,9535
1785.86,6,374,26468,216,104,8306,469,15732,158,69,11374,69,10736
1797.861,17,353,86491,353,217,5107,422,86491,0,0,0,0,0
811.633,6,190,20927,92,138,8919,469,9079,98,134,8367,1452,11848
144.749,6,787,388820,442,819,328,1152,370229,345,435,419,1179,18591
0.168,6,45,28974,24,181,7,253,1847,21,1369,6,2816,27127
1785.454,6,102,8296,68,65,26648,65,4930,34,59,54101,59,3366
1790.192,6,355,22480,207,69,8690,69,12420,148,69,12177,69,10060
280.188,6,27,7312,13,158,23349,267,1317,14,775,21550,3445,5995
1775.082,6,180,15480,120,69,14916,69,8940,60,69,30077,69,6540
1.313,17,4,240,2,32,1312,32,120,2,32,1312,32,120
300.777,6,71,53462,46,1244,6683,1368,47186,25,828,1260,2736,6276
695.19,6,42,3324,26,50,27807,205,1963,16,36,46333,98,1361
0.037,17,2,904,1,300,0,300,328,1,548,0,548,576
75.495,17,4,352,2,60,75494,60,176,2,60,75494,60,176
80.131,6,33,9044,13,155,6677,267,1306,20,462,4205,1997,7738
87.88,6,31,7370,13,146,7322,159,1572,18,811,5168,1669,5798
280.547,6,28,7352,12,158,25504,267,1277,16,678,18694,2760,6075
0.679,6,21,5000,11,137,67,267,1132,10,692,62,1467,3868
180.473,2,4,128,4,8,60157,8,128,0,0,0,0,0
15.852,6,7,466,1,0,0,0,40,6,31,3144,31,426
0.382,6,8,423,4,0,127,0,204,4,7,61,7,219
1786.433,6,102,8364,68,66,26663,66,4964,34,60,54131,60,3400
149.763,6,28,9291,13,563,89,1351,2254,15,642,10684,1629,7037
1655.897,1,8,448,8,28,236556,28,448,0,0,0,0,0
0.745,17,16,8880,8,436,106,1350,3712,8,618,93,1350,5168
0.605,17,2,167,1,39,0,39,67,1,72,0,72,100
0.874,17,2,685,1,308,0,308,336,1,321,0,321,349
3.049,6,2,88,2,0,0,0,88,0,0,0,0,0
94.966,17,4,352,2,60,94965,60,176,2,60,94965,60,176
95.46,6,39,7735,23,154,4339,722,2323,16,572,1053,2026,5412
1771.781,6,107,9804,68,65,26444,65,5758,39,59,46623,59,4046
63.026,6,30,7499,10,165,26,267,1069,20,351,3316,1997,6430
240.241,6,55,19490,30,838,8283,1418,16660,25,190,10009,580,2830
0.042,17,4,350,2,34,0,34,124,2,85,0,91,226
0.323,6,2,116,1,0,0,0,64,1,0,0,0,52
240.316,6,41,9026,20,523,12648,1408,5758,21,240,12015,618,3268
0.004,6,2,1530,1,0,0,0,40,1,1438,0,1438,1490
0.116,17,4,368,2,32,49,32,120,2,96,64,96,248
61.499,6,52,15827,34,620,1863,1244,11779,18,220,1335,1282,4048
369.597,6,18,1242,14,180,28430,180,916,4,110,20059,110,326
252.614,2,2,64,2,8,252614,8,64,0,0,0,0,0
1759.916,6,95,7203,63,38,28385,205,4476,32,33,56761,98,2727
280.451,6,30,7523,13,158,23370,267,1317,17,552,17527,1400,6206
1791.906,1,90,5040,90,28,20133,28,5040,0,0,0,0,0
0.484,17,3,451,2,39,225,39,134,1,289,0,289,317
1780.153,1,39,3276,0,0,0,0,0,39,56,46846,56,3276
1777.942,6,135,8313,71,27,25398,27,4319,64,27,28220,27,3994
740.478,1,39,2184,39,28,19486,28,2184,0,0,0,0,0
0.881,6,10,1687,7,100,146,100,384,3,1179,320,1179,1303
1740.777,1,56,4704,56,56,31650,56,4704,0,0,0,0,0
1744.657,6,94,7151,62,38,28600,205,4424,32,33,56272,98,2727
0.259,6,27,9042,13,247,21,624,1672,14,947,19,1408,7370
1750.944,17,22,7392,22,308,83378,308,7392,0,0,0,0,0
11.456,6,26,9953,13,275,954,275,1078,13,1042,885,1440,8875
1.364,6,50,20146,28,889,50,1360,14490,22,476,57,2715,5656
34.64,17,6,528,3,48,17315,48,228,3,72,17316,72,300
54.59,6,49,10455,23,533,693,910,3147,26,312,2178,1460,7308
368.583,6,54,6866,25,109,15347,721,2621,29,152,13156,1448,4245
40.999,17,6,528,3,48,20494,48,228,3,72,20494,72,300
1757.468,6,4944,4544349,1850,149,950,957,112080,3094,1414,568,5672,4432269
125.739,17,4,352,2,60,125738,60,176,2,60,125737,60,176
1675.714,1,126,7056,126,28,13405,28,7056,0,0,0,0,0
0.025,17,2,491,1,44,0,44,72,1,391,0,391,419
120.298,2,2,64,2,8,120298,8,64,0,0,0,0,0
2.307,6,12,1036,6,283,427,283,603,6,105,427,105,433
1662.918,1,17,1627,17,67,103932,88,1627,0,0,0,0,0
0.515,17,3,543,2,39,222,39,134,1,381,0,381,409
0.412,6,10,968,5,256,99,256,460,5,304,96,304,508
0.299,6,22,7333,12,334,26,663,1969,10,806,32,1402,5364
1729.282,6,60,4400,40,33,44340,33,2740,20,31,91002,31,1660
1787.78,6,371,23465,213,69,8432,69,13005,158,69,11384,69,10460
3.467,17,5,290,5,30,866,30,290,0,0,0,0,0
454.21,6,59,15634,35,143,13359,721,5129,24,954,748,2535,10505
170.962,6,24,8407,12,549,98,1309,2172,12,820,15525,1591,6235
11.003,6,980,839434,587,1384,18,1420,819433,393,467,28,1883,20001
170.553,6,27,7312,12,158,15504,267,1277,15,678,12179,2045,6035
1.655,6,53,19609,29,901,59,1460,13828,24,400,61,1460,5781
1772.29,6,180,15480,120,69,14893,69,8940,60,69,30038,69,6540
300.263,6,58,30401,33,190,9383,444,2649,25,1391,10153,4975,27752
4.06,17,3,201,3,39,2030,39,201,0,0,0,0,0
432.91,6,9,1708,6,298,86582,413,1135,3,151,216353,269,573
11.058,6,20,4390,11,275,1105,275,998,9,755,784,1414,3392
0.096,17,2,218,1,34,0,34,62,1,128,0,128,156
0.022,17,4,284,2,32,4,32,120,2,54,5,60,164
1796.071,17,448,39612,404,35,4456,288,25708,44,288,40014,288,13904
1788.53,1,237,13272,237,28,7578,28,13272,0,0,0,0,0
1795.728,6,355,22480,207,69,8717,69,12420,148,69,12215,69,10060
1.288,6,25,8056,12,164,100,267,1288,13,869,92,1408,6768
0.014,17,2,375,1,44,0,44,72,1,275,0,275,303
0.17,6,14,4813,9,290,21,517,1045,5,1166,36,1502,3768
19.94,6,31,12095,16,387,1329,1408,2776,15,775,748,1408,9319
0.531,6,10,924,5,283,89,283,551,5,105,89,105,373
252.152,2,2,64,2,8,252152,8,64,0,0,0,0,0
3.013,17,8,688,4,47,1001,47,300,4,69,1001,75,388
0.222,6,10,1671,6,552,44,948,1348,4,159,74,159,323
280.274,6,28,7352,13,158,23356,267,1317,15,678,20010,3436,6035
1.59,6,61,21119,33,854,49,1360,13380,28,412,52,1360,7739
1.633,6,23,5779,13,184,132,385,1446,10,982,176,1771,4333
0.202,17,2,2382,2,1163,202,1163,2382,0,0,0,0,0
39.079,17,2,136,2,40,39079,47,136,0,0,0,0,0
1782.261,17,83,3480,82,14,22003,14,3444,1,8,0,8,36
1740.424,1,15,870,15,30,124316,30,870,0,0,0,0,0
1785.859,6,368,26090,213,105,8423,469,15405,155,69,11596,69,10685
1786.969,6,398,24722,210,69,8501,69,12678,188,47,9555,69,12044
242.749,2,2,64,2,8,242749,8,64,0,0,0,0,0
21.691,6,1359,1286080,852,1431,25,1448,1253988,507,931,42,2896,32092
1740.701,1,15,840,15,28,124335,28,840,0,0,0,0,0
240.222,6,41,5438,20,225,12642,752,2853,21,184,12010,656,2585
7.33,6,6,280,2,0,7330,0,88,4,0,2394,0,192
0.15,6,3,136,1,0,0,0,40,2,0,6,0,96
34.235,17,40,5880,20,48,1801,48,1520,20,190,1801,308,4360
1038.178,6,132,10250,51,75,20760,344,5057,81,48,12975,78,5193
165.426,6,31,6960,10,201,6465,516,1411,21,294,8266,1452,5549
1660.14,6,221,19329,85,83,19761,375,8914,136,71,12297,1062,10415
368.303,6,18,1242,14,180,28331,180,916,4,110,20067,110,326
1069.276,6,79,6155,48,65,22750,65,3350,31,57,35639,59,2805
14.969,6,1853,1677782,1121,1414,13,1448,1634274,732,776,20,1448,43508
126.5,6,6,368,5,112,31625,112,320,1,0,0,0,48
0.122,6,4,160,2,0,122,0,80,2,0,2,0,80
1.334,6,52,21338,29,903,47,1360,15642,23,433,53,1360,5696
1799.558,1,75,6300,75,56,24318,56,6300,0,0,0,0,0
0.369,6,10,968,5,256,91,256,460,5,304,91,304,508
2.099,6,26,6125,14,108,161,147,999,12,773,160,1608,5126
1764.347,2,14,448,14,8,135719,8,448,0,0,0,0,0
6.039,6,1857,1822175,1246,1387,4,1408,1785641,611,792,9,1408,36534
10.498,6,1664,1467582,970,1423,10,1448,1421390,694,776,14,1448,46192
0.002,6,9,40128,1,0,0,0,40,8,4959,0,6840,40088
0.033,17,4,308,2,33,1,33,122,2,65,1,65,186
0.007,6,2,80,2,0,0,0,80,0,0,0,0,0
0.227,1,2,112,2,28,227,28,112,0,0,0,0,0
8.286,6,1392,1269863,854,1408,9,1448,1237223,538,776,15,1448,32640
240.856,6,60,19747,33,830,7526,1418,16688,27,183,9263,580,3059
177.671,6,1680,838126,903,858,196,1152,798099,777,388,228,1179,40027
1787.759,6,356,22520,208,69,8636,69,12460,148,69,12161,69,10060
1741.545,6,87,6322,58,31,30553,31,3915,29,31,62197,31,2407
41.724,6,39,11291,18,294,56,1305,3110,21,458,2079,2720,8181
0.307,6,12,3462,6,75,61,75,395,6,1373,61,1448,3067
0.128,6,22,10013,11,136,12,136,716,11,1089,12,1448,9297
0.067,17,2,144,1,36,0,36,64,1,52,0,52,80
5.168,17,3,208,2,36,5003,36,128,1,52,0,52,80
33.963,6,29,4989,15,154,2425,721,1859,14,479,2598,2118,3130
2.567,17,2,136,1,32,0,32,60,1,48,0,48,76
1785.317,17,83,3480,82,14,22040,14,3444,1,8,0,8,36
896.308,2,11,352,11,8,89630,8,352,0,0,0,0,0
67.611,6,581,270473,305,816,222,1152,253928,276,423,244,1179,16545
1772.512,6,203,22365,130,75,13740,267,10063,73,135,24611,3417,12302
0.87,6,26,5887,13,156,72,267,1462,13,780,65,1460,4425
182.028,17,70,6420,47,42,3957,288,3312,23,107,7363,288,3108
0.046,6,7,423,4,43,4,43,259,3,0,18,0,164
1787.904,6,381,26886,218,103,8239,469,15950,163,69,11036,69,10936
149.089,6,265,223977,173,1309,866,1368,208026,92,605,1635,1368,15951
1745.959,6,95,7203,63,38,28160,205,4476,32,33,56312,98,2727
1.247,6,48,19610,27,920,47,1360,13994,21,476,54,2715,5616
11.482,6,25,9873,13,275,956,275,1078,12,1186,1011,2840,8795
292.03,6,25,7379,7,153,48671,267,1210,18,388,2512,1460,6169
11.608,6,1833,1595209,1112,1379,10,1420,1562124,721,467,16,1883,33085
197.242,6,31,6862,13,189,9192,516,1470,18,311,11597,1452,5392
1655.284,17,58,19488,58,308,29040,308,19488,0,0,0,0,0
346.784,17,14,4704,14,308,26675,308,4704,0,0,0,0,0
12.374,6,1883,1676949,1180,1367,10,1380,1643359,703,383,17,1380,33590
1787.324,6,104,8376,68,65,26676,65,4930,36,59,51062,59,3446
315.17,6,20,2429,7,242,52527,517,1111,13,323,26263,499,1318
0.623,17,4,766,2,39,614,39,134,2,288,612,288,632
1774.482,6,193,18759,127,99,14083,469,11565,66,69,27294,69,7194
0.062,6,12,3659,6,125,12,125,445,6,964,11,1448,3214
73.422,17,4,240,2,32,73421,32,120,2,32,73421,32,120
1771.615,6,99,9240,66,65,27255,65,5577,33,59,55360,59,3663
1.535,6,37,8214,19,321,85,1164,2718,18,476,78,2720,5496
168.864,17,4,352,2,60,168863,60,176,2,60,168863,60,176
367.55,6,21,1804,15,226,26253,226,1252,6,110,12040,110,552
1771.508,6,99,9306,66,66,27253,66,5610,33,60,55356,60,3696
0.588,6,22,7345,13,334,49,663,2021,9,1209,68,1946,5324
0.265,6,26,8990,13,247,22,624,1672,13,947,21,1408,7318
0.587,6,23,7367,14,261,45,602,2043,9,1209,68,1946,5324
12.506,6,8,440,5,0,3126,0,268,3,0,6116,0,172
5.032,17,2,2166,2,1055,5032,1055,2166,0,0,0,0,0
226.007,6,64,41334,40,1157,5795,1448,33333,24,749,2672,1448,8001
116.378,6,43,9800,22,450,5541,766,2785,21,385,448,2720,7015
0.327,6,5,260,2,0,225,0,104,3,0,163,0,156
523.729,17,14,1232,7,48,87287,48,532,7,72,87286,72,700
1787.906,6,356,22520,208,69,8637,69,12460,148,69,12162,69,10060
69.096,6,29,7257,14,155,5315,267,1346,15,482,4934,2840,5911
1798.33,1,220,23320,220,78,8211,78,23320,0,0,0,0,0
78.907,6,22,5593,13,238,6575,722,1877,9,1070,3873,1448,3716
0.547,17,2,167,1,39,0,39,67,1,72,0,72,100
141.102,6,39,10309,14,263,6233,1189,2673,25,315,5878,1420,7636
0.035,17,2,560,1,36,0,36,64,1,468,0,468,496
19.887,17,32,7010,13,206,1654,1350,3047,19,180,1102,1350,3963
0.705,6,8,440,5,0,176,0,268,3,0,344,0,172
1795.28,17,80,3354,79,14,23016,14,3318,1,8,0,8,36
457.53,6,60,9005,28,118,16944,517,2661,32,357,14757,1418,6344
1787.34,6,104,8376,68,65,26676,65,4930,36,59,51064,59,3446
3.995,17,4,240,4,32,1331,32,240,0,0,0,0,0
1793.561,6,356,22520,208,69,8664,69,12460,148,69,12201,69,10060
0.058,6,4,208,0,0,0,0,0,4,0,0,0,208
1787.321,17,270,25569,135,33,13337,37,8313,135,99,13337,136,17256
1.9,17,3,264,3,60,950,60,264,0,0,0,0,0
1791.743,6,135,14993,88,81,20594,501,6535,47,146,38948,1420,8458
14.642,6,15,5673,4,106,4874,106,274,11,706,1462,1460,5399
4.219,17,4,232,4,30,1406,30,232,0,0,0,0,0
1786.193,6,358,24076,209,88,8587,469,13838,149,69,12068,69,10238
11.64,17,8,704,4,48,3876,48,304,4,72,3876,72,400
454.426,1,10,560,10,28,50491,28,560,0,0,0,0,0
145.264,17,4,352,2,60,145263,60,176,2,60,145263,60,176
0.646,17,12,6004,6,585,129,1350,3679,6,359,76,1350,2325
1798.505,6,377,26657,217,104,8326,469,15772,160,69,11311,69,10885
1772.337,6,180,15480,120,69,14893,69,8940,60,69,30032,69,6540
27.739,6,37,8424,18,165,1631,721,2211,19,681,1484,1420,6213
1786.118,6,104,8376,68,65,26658,65,4930,36,59,51029,59,3446
11.668,6,1816,1606405,1135,1363,10,1380,1571620,681,683,17,3303,34785
1775.096,17,138,11040,69,48,26104,48,5244,69,56,26104,56,5796
0.926,17,4,668,2,32,922,32,120,2,246,921,246,548
0.216,17,2,136,1,32,0,32,60,1,48,0,48,76
0.031,17,2,602,1,46,0,46,74,1,500,0,500,528
176.04,17,6,528,3,60,88019,60,264,3,60,88019,60,264
0.523,6,23,5976,12,108,47,147,919,11,922,51,1581,5057
1773.123,6,180,15480,120,69,14900,69,8940,60,69,30046,69,6540
3.922,17,8,1856,4,60,1305,60,352,4,348,1305,356,1504
1790.255,17,120,9600,60,48,30343,48,4560,60,56,30343,56,5040
280.478,6,30,7432,13,158,23373,267,1317,17,543,17527,1400,6115
1.19,6,4,172,2,0,1190,0,92,2,0,1001,0,80
1.297,6,47,19322,27,902,49,1360,13746,20,433,58,1360,5576
4.234,6,38,7245,19,218,235,314,3383,19,516,221,1179,3862
1770.426,6,101,9344,66,65,27237,65,5577,35,59,52068,59,3767
69.337,6,32,10699,16,454,4622,659,2683,16,716,4567,1408,8016
1799.999,6,213,14696,79,46,22688,46,6254,134,46,13533,46,8442
40.902,2,4,128,4,8,13634,8,128,0,0,0,0,0
376.022,6,18,1242,14,180,28924,180,916,4,110,20074,110,326
1.65,6,34,14582,19,488,91,1360,4244,15,1215,104,4428,10338
1794.103,1,58,4872,58,56,31475,56,4872,0,0,0,0,0
1.353,6,10,1687,7,100,225,100,384,3,1179,546,1179,1303
3.596,6,55,22223,32,996,116,1460,16315,23,413,148,2615,5908
185.974,6,32,14286,19,764,10328,1183,8673,13,617,15493,1368,5613
1783.81,6,364,23116,211,69,8494,69,12649,153,69,11735,69,10467
1704.235,6,125,12920,78,83,22132,502,6230,47,126,37040,1420,6690
0.166,1,2,112,2,28,166,28,112,0,0,0,0,0
11.029,6,958,864262,615,1331,17,1368,840310,343,776,31,1473,23952
0.644,6,39,19569,22,698,30,1408,4644,17,1275,39,2816,14925
61.848,6,79,54327,48,1207,1315,1408,45980,31,747,2054,1408,8347
136.866,6,164,131696,107,1291,1291,1408,119221,57,731,1883,3847,12475
1792.482,6,363,25352,211,100,8535,469,14856,152,69,11869,69,10496
242.886,6,31,9676,14,326,18672,1279,2225,17,675,15171,1360,7451
0.81,6,28,5967,14,156,62,267,1502,14,650,56,1420,4465
1.216,6,25,8056,12,164,94,267,1288,13,869,86,1408,6768
121.953,6,44,8879,15,132,8710,267,1668,29,274,4354,1420,7211
1.015,17,21,7332,9,399,126,1350,3846,12,262,86,1350,3486
32.823,17,4,352,2,60,32822,60,176,2,60,32822,60,176
280.622,6,31,7813,14,158,21586,267,1357,17,577,17537,1400,6456
1772.715,6,180,15480,120,69,14896,69,8940,60,69,30043,69,6540
1796.375,17,448,39896,403,35,4468,288,25676,45,288,40020,288,14220
1740.664,17,29,30624,29,1028,62166,1028,30624,0,0,0,0,0
1764.028,2,15,480,15,8,126002,8,480,0,0,0,0,0
0.115,17,2,776,2,360,115,360,776,0,0,0,0,0
1.42,6,37,8214,19,321,78,1164,2718,18,476,70,2715,5496
962.323,17,14,3541,7,32,160385,37,420,7,417,160384,463,3121
1.979,17,4,644,2,33,1000,33,122,2,233,13,233,522
0.033,17,2,288,1,59,0,59,87,1,173,0,173,201
240.312,6,43,8925,21,523,12015,1408,5811,22,218,11443,617,3114
1740.109,6,87,6322,58,31,30528,31,3915,29,31,62146,31,2407
180.449,6,22,8174,11,520,89,1223,2034,11,812,18027,1440,6140
1772.452,17,231,54111,231,206,7706,422,54111,0,0,0,0,0
1779.422,17,86,3606,85,14,21183,14,3570,1,8,0,8,36
0.05,17,6,1850,6,280,10,316,1850,0,0,0,0,0
1799.956,6,271,18536,110,46,16238,46,7772,161,46,11249,46,10764
155.687,6,30,7432,13,158,12973,267,1317,17,543,9728,1400,6115
6.221,6,1605,1564394,1039,1430,5,1448,1530298,566,776,10,1448,34096
240.624,2,2,64,2,8,240624,8,64,0,0,0,0,0
0.103,6,9,1002,5,213,25,213,417,4,421,24,421,585
367.063,6,23,1538,16,180,24470,180,1056,7,110,10404,110,482
1749.395,6,97,30367,53,563,33642,1460,18548,44,478,40674,1934,11819
1750.75,17,13,534,11,14,175056,14,462,2,8,1750566,8,72
280.482,6,30,7432,13,158,23373,267,1317,17,603,17523,2076,6115
131.152,6,24,8507,12,394,198,847,1730,12,785,11907,2720,6777
1295.172,6,83,6763,48,47,27553,205,3547,35,45,38087,170,3216
61.102,6,22,5220,12,290,5554,517,1221,10,1151,6784,1467,3999
1743.858,6,99,7473,63,38,28126,205,4476,36,33,49815,98,2997
1786.485,6,111,11663,72,131,25161,1290,7615,39,69,47010,241,4048
63.019,6,9,1432,9,134,7877,134,1432,0,0,0,0,0
7.457,6,5,284,1,0,0,0,60,4,0,2420,0,224
0.849,17,2,348,1,39,0,39,67,1,253,0,253,281
1.728,6,27,8865,16,288,115,598,1510,11,863,153,1380,7355
1.063,17,3,215,2,33,1000,33,122,1,65,0,65,93
72.273,1,6,336,6,28,14454,28,336,0,0,0,0,0
7.236,6,57,37467,35,605,212,1242,3643,22,1815,342,4307,33824
0.051,17,2,254,1,34,0,34,62,1,164,0,164,192
1.009,17,5,1176,3,32,502,32,180,2,470,5,470,996
0.713,6,1183,946878,555,334,1,343,31561,628,1416,1,4224,915317
0.042,17,2,128,1,28,0,28,56,1,44,0,44,72
1.857,6,25,5795,14,158,142,370,1355,11,999,185,1737,4440
360.97,2,4,128,4,8,120323,8,128,0,0,0,0,0
1773.416,6,181,15589,120,69,14902,69,8940,61,69,29552,69,6649
4.668,6,39,7269,20,218,245,314,3423,19,513,245,1179,3846
1.814,17,2,198,1,63,0,63,91,1,79,0,79,107
109.684,17,2,152,2,48,109684,48,152,0,0,0,0,0
1059.149,17,12,969,6,31,211825,37,355,6,74,211825,136,614
0.75,6,2,170,1,0,0,0,40,1,90,0,90,130
0.011,17,2,558,1,32,0,32,60,1,470,0,470,498
1742.016,1,15,840,15,28,124429,28,840,0,0,0,0,0
5.019,17,4,288,2,36,5005,36,128,2,52,5000,52,160
1744.697,2,20,640,20,8,91826,8,640,0,0,0,0,0
2.908,17,3,1167,3,361,1454,361,1167,0,0,0,0,0
1791.995,6,365,25432,213,100,8452,469,14936,152,69,11867,69,10496
0.05,17,2,170,1,49,0,49,77,1,65,0,65,93
1637.463,1,8,448,8,28,233923,28,448,0,0,0,0,0
0.289,17,2,167,1,39,0,39,67,1,72,0,72,100
1.665,6,27,10169,16,283,111,582,1494,11,1028,149,1420,8675
76.02,6,28,7286,11,155,7602,267,1226,17,447,4742,1917,6060
1.36,1,7,2556,7,337,226,344,2556,0,0,0,0,0
11.41,17,33,8990,16,300,758,1350,5253,17,191,710,1350,3737
1742.966,6,94,7151,62,38,28573,205,4424,32,33,56212,98,2727
0.171,17,2,2754,2,1349,171,1349,2754,0,0,0,0,0
15.328,6,17,1308,9,283,1916,283,755,8,105,1586,105,553
271.603,17,4,352,2,60,271602,60,176,2,60,271602,60,176
0.777,6,160,104718,84,1305,9,1432,97375,76,475,10,1871,7343
46.068,6,29,12294,14,830,3543,1368,4047,15,932,3287,1368,8247
1788.59,1,58,4872,58,56,31378,56,4872,0,0,0,0,0
3.179,6,2,88,2,0,0,0,88,0,0,0,0,0
1794.288,17,144,11520,72,48,25271,48,5472,72,56,25271,56,6048
279.996,6,30,7432,14,158,21538,267,1357,16,603,18663,2036,6075
0.163,6,24,7176,12,155,14,267,1261,12,775,14,2800,5915
4.004,17,4,240,4,32,1334,32,240,0,0,0,0,0
0.245,17,2,152,1,48,0,48,76,1,48,0,48,76
0.073,17,4,284,2,32,54,32,120,2,54,58,60,164
0.291,17,3,451,2,39,204,39,134,1,289,0,289,317
4.249,6,13,3463,6,188,849,245,620,7,1279,666,1407,2843
1798.856,6,144,9448,79,56,23062,208,5918,65,31,28102,31,3530
1798.517,6,363,24414,212,88,8523,469,14027,151,69,11987,69,10387
280.649,6,30,7773,14,158,21588,267,1357,16,577,18708,2036,6416
3.424,6,12,1941,7,210,570,210,582,5,545,853,905,1359
1380.134,6,166,12624,61,66,23000,310,5873,105,48,13270,78,6751
0.023,17,2,570,1,30,0,30,58,1,484,0,484,512
26.777,17,5,1680,5,308,6694,308,1680,0,0,0,0,0
44.222,6,34,9488,14,327,151,1189,2535,20,472,2326,1460,6953
15.291,6,5,300,5,0,0,0,300,0,0,0,0,0
471.919,6,567,408742,285,196,1661,249,18502,282,1355,1679,2736,390240
1.356,6,50,19248,27,888,52,1360,13552,23,433,53,1360,5696
1776.0,6,109,8759,71,65,25371,65,5115,38,59,47997,59,3644
0.951,17,2,572,1,39,0,39,67,1,477,0,477,505
281.412,6,32,7650,13,158,23451,267,1317,19,464,15606,1400,6333
273.369,6,37,7271,15,168,11921,516,1615,22,280,13013,1452,5656
1.536,6,9,480,5,0,375,0,272,4,0,512,0,208
1789.683,17,142,11360,71,48,25566,48,5396,71,56,25566,56,5964
64.364,6,7,292,3,0,648,0,124,4,0,21451,0,168
13.494,17,50,3700,50,46,275,46,3700,0,0,0,0,0
56.5,6,471,211317,241,821,235,1152,196953,230,430,245,1179,14364
0.117,6,16,6172,8,103,16,103,527,8,1044,16,1448,5645
1.454,6,63,18764,32,707,46,1360,9121,31,419,48,1360,9643
116.585,6,27,10122,13,554,63,1355,2227,14,813,8957,1636,7895
160.551,6,10441,9136440,4962,770,32,1396,290736,5479,1568,29,6980,8845704
1799.652,1,345,28980,345,56,5231,56,28980,0,0,0,0,0
31.84,6,55,13193,25,855,572,1360,7055,30,326,1092,1360,6138
0.447,6,8,335,4,0,149,0,164,4,7,73,7,171
49.815,6,34,8896,16,290,3321,965,2391,18,412,2929,1420,6505
12.506,17,3,984,3,300,6253,300,984,0,0,0,0,0
1798.285,17,448,39896,403,35,4473,288,25676,45,288,40024,288,14220
1797.751,1,345,28980,345,56,5226,56,28980,0,0,0,0,0
26.941,6,45,13626,21,330,1347,721,3159,24,633,1155,1440,10467
152.425,6,30,7432,13,158,12702,267,1317,17,543,9524,1400,6115
1681.111,17,12,498,11,14,168111,14,462,1,8,0,8,36
3.354,17,5,340,5,40,838,40,340,0,0,0,0,0
1791.998,6,356,22520,208,69,8656,69,12460,148,69,12190,69,10060
1621.283,17,21,6792,21,295,81064,308,6792,0,0,0,0,0
1788.489,17,87,3648,86,14,21041,14,3612,1,8,0,8,36
1763.741,6,189,22073,101,127,17637,722,11939,88,150,20269,2007,10134
0.032,6,10,1512,5,503,8,503,771,5,473,7,473,741
0.073,17,4,588,2,48,62,48,152,2,190,54,308,436
1786.558,17,79,3312,78,14,23202,14,3276,1,8,0,8,36
0.013,6,12,3486,7,75,2,75,471,5,2747,3,2747,3015
0.087,17,4,284,2,32,52,32,120,2,54,49,60,164
0.139,17,2,389,1,34,0,34,62,1,299,0,299,327
2.672,17,4,1560,4,362,890,362,1560,0,0,0,0,0
37.111,17,20,1760,10,48,4121,48,760,10,72,4120,72,1000
0.497,17,3,451,2,39,339,39,134,1,289,0,289,317
367.373,6,31,9869,21,162,18368,1236,2662,10,970,72,1360,7207
1771.85,6,99,9174,66,64,27259,64,5544,33,58,55367,58,3630
0.286,6,26,8911,13,237,23,590,1635,13,1098,23,2816,7276
254.268,17,4,352,2,60,254267,60,176,2,60,254267,60,176
1799.453,17,449,39928,404,35,4465,288,25708,45,288,40017,288,14220
2.59,6,25,11541,13,274,215,556,1348,12,1078,219,1420,10193
3.219,6,5,232,2,0,3219,0,88,3,0,1521,0,144
1793.57,6,353,22262,206,69,8749,69,12311,147,69,12203,69,9951
103.863,6,16,1709,10,177,11540,177,1059,6,110,20727,110,650
1740.553,17,29,30624,29,1028,62162,1028,30624,0,0,0,0,0
56.641,6,37,8400,18,378,510,786,1886,19,441,3139,1360,6514
1745.241,1,72,6048,72,56,24580,56,6048,0,0,0,0,0
1047.173,17,73,24384,73,306,14544,548,24384,0,0,0,0,0
1800.0,6,205,14226,74,46,24515,46,5950,131,46,13846,46,8276
1783.416,6,104,8444,68,66,26618,66,4964,36,60,50952,60,3480
13.303,17,4,824,2,48,13294,48,152,2,308,13292,308,672
300.649,6,38,8566,20,315,15823,882,2093,18,441,495,1460,6473
1654.899,1,7,392,7,28,275816,28,392,0,0,0,0,0
3.798,17,5,290,5,30,949,30,290,0,0,0,0,0
11.43,6,1695,1565815,1105,1365,10,1432,1537888,590,427,19,1432,27927
1.409,6,54,23915,30,996,48,1460,18179,24,476,52,2615,5736
15.15,17,21,13794,12,943,1374,1350,11656,9,209,1889,1350,2138
310.689,6,111,28319,63,715,5011,1230,19764,48,153,6608,1296,8555
0.004,17,2,403,1,65,0,65,93,1,282,0,282,310
18.262,17,20,6626,10,393,1894,1350,4212,10,213,2020,1350,2414
0.0,6,2,144,1,0,0,0,40,1,64,0,64,104
0.641,17,20,12853,11,902,63,1350,10230,9,263,76,1350,2623
1700.452,17,12,498,11,14,170045,14,462,1,8,0,8,36
1683.361,17,18,5698,18,288,99021,1300,5698,0,0,0,0,0
11.03,6,20,4442,11,275,1103,275,998,9,768,777,1440,3444
1796.246,17,447,39864,402,35,4479,288,25644,45,288,40017,288,14220
0.867,6,11,1727,7,100,144,100,384,4,589,205,1152,1343
1.038,6,28,8160,15,222,61,540,1964,13,944,70,1591,6196
69.536,6,28,7286,13,155,5794,267,1306,15,488,4965,3417,5980
83.274,17,4,1344,4,308,27758,308,1344,0,0,0,0,0
82.329,17,4,240,2,32,82328,32,120,2,32,82327,32,120
119.065,6,976,493376,545,842,218,1152,469949,431,412,276,1179,23427
1763.986,2,13,416,13,8,146998,8,416,0,0,0,0,0
5.611,6,20,6327,9,268,691,517,1282,11,893,553,2736,5045
0.787,6,22,9943,12,648,71,1360,3106,10,1285,63,3595,6837
1779.386,17,142,11360,71,48,25419,48,5396,71,56,25419,56,5964
207.638,6,190,29768,104,304,2015,304,20784,86,83,2426,83,8984
71.707,6,3518,3087532,2283,1275,31,1368,3018648,1235,776,57,2736,68884
1785.347,6,356,22520,208,69,8624,69,12460,148,69,12145,69,10060
1772.94,6,180,15480,120,69,14898,69,8940,60,69,30048,69,6540
371.055,6,162,127848,105,1277,3567,1408,115372,57,731,1617,3847,12476
0.144,17,3,234,2,39,122,39,134,1,72,0,72,100
48.367,6,30,5041,15,154,3454,722,1859,15,399,3421,1448,3182
0.01,17,2,262,1,36,0,36,64,1,170,0,170,198
0.061,17,3,208,2,36,31,36,128,1,52,0,52,80
1797.753,1,345,28980,345,56,5226,56,28980,0,0,0,0,0
1.08,6,19,3105,10,324,120,585,1201,9,285,133,580,1904
1793.463,17,16,5576,16,320,119564,1449,5576,0,0,0,0,0
226.097,17,10,585,10,30,25121,31,585,0,0,0,0,0
1799.646,17,3506,168288,1739,20,1034,20,83472,1767,20,1018,20,84816
8.084,6,1505,1432889,944,1440,8,1448,1399041,561,776,14,1448,33848
5.392,6,38,7229,20,218,283,314,3423,18,513,300,1179,3806
1782.5,6,102,8296,68,65,26604,65,4930,34,59,54012,59,3366
948.445,17,76,6080,38,48,25633,48,2888,38,56,25633,56,3192
81.404,2,2,64,2,8,81404,8,64,0,0,0,0,0
1798.252,17,449,39928,404,35,4462,288,25708,45,288,40018,288,14220
372.248,6,18,1242,14,180,28634,180,916,4,110,20064,110,326
10.934,6,18,5610,10,275,1214,275,958,8,1440,845,1440,4652
3.025,17,3,183,3,33,1512,33,183,0,0,0,0,0
1751.973,6,185,11345,93,47,19043,208,6735,92,31,19249,31,4610
20.4,17,32,8771,15,350,1455,1350,5679,17,153,1273,1350,3092
0.058,17,2,373,1,34,0,34,62,1,283,0,283,311
1765.145,17,71,2976,70,14,25581,14,2940,1,8,0,8,36
0.66,17,2,152,1,48,0,48,76,1,48,0,48,76
0.014,17,2,157,1,31,0,31,59,1,70,0,70,98
7.382,17,34,8308,13,254,615,1350,3671,21,192,333,1350,4637
565.226,1,6,336,6,28,113045,28,336,0,0,0,0,0
0.307,17,2,152,2,48,307,48,152,0,0,0,0,0
20.371,6,28,7217,13,155,1697,267,1306,15,482,1454,1997,5911
7.354,6,31,8060,14,215,565,721,1856,17,552,438,1440,6204
0.999,17,2,677,1,300,0,300,328,1,321,0,321,349
1.048,6,28,8503,15,225,62,561,1985,13,997,71,1791,6518
3.911,6,11,2042,7,331,651,598,1034,4,396,209,580,1008
0.203,6,2,92,1,0,0,0,52,1,0,0,0,40
8.786,6,36,8423,18,399,516,882,1950,18,441,506,1440,6473
316.171,6,74,13784,35,202,9299,1305,4147,39,288,8316,1360,9637
0.004,17,2,412,1,40,0,40,68,1,316,0,316,344
1797.714,6,372,26388,215,104,8400,469,15623,157,69,11522,69,10765
1743.612,6,95,7203,63,38,28122,205,4476,32,33,56236,98,2727
149.695,6,30,7432,13,158,12474,267,1317,17,543,9352,1400,6115
1785.696,6,102,8364,68,66,26652,66,4964,34,60,54109,60,3400
1787.654,1,107,5992,107,28,16864,28,5992,0,0,0,0,0
17.946,17,2,778,2,361,17946,361,778,0,0,0,0,0
1737.367,1,56,4704,56,56,31588,56,4704,0,0,0,0,0
1772.494,6,180,15480,120,69,14894,69,8940,60,69,30034,69,6540
2.051,6,20,3833,11,234,205,564,1504,9,463,229,1343,2329
1136.842,6,74,5719,44,65,26438,65,3125,30,53,39165,59,2594
76.806,2,3,96,3,8,38403,8,96,0,0,0,0,0
1773.185,6,180,15480,120,69,14900,69,8940,60,69,30050,69,6540
61.34,6,10,754,10,26,6815,26,754,0,0,0,0,0
240.153,6,43,4993,22,181,11435,517,2255,21,182,12007,851,2738
5.055,17,4,390,2,44,5050,44,144,2,95,5050,95,246
1776.7,6,271,33221,112,136,16005,1360,16154,159,135,11244,3302,17067
27.895,17,4,352,2,60,27893,60,176,2,60,27894,60,176
1800.0,6,225,19664,82,79,22216,339,8816,143,70,12676,1062,10848
4.04,17,6,5701,2,723,4040,1350,1503,4,1021,1070,1350,4198
300.311,6,31,11838,18,593,17665,1408,4515,13,1106,20027,2816,7323
1.253,6,42,10065,23,440,56,1360,4484,19,400,60,1360,5581
0.043,6,69,103838,1,0,0,0,40,68,1474,0,2896,103798
1772.335,6,180,15480,120,69,14893,69,8940,60,69,30037,69,6540
1625.379,6,209,16257,80,73,20572,336,7919,129,49,12697,143,8338
4.787,6,39,7269,20,218,251,314,3423,19,440,251,1152,3846
0.475,17,2,384,1,39,0,39,67,1,289,0,289,317
1783.526,17,83,3480,82,14,22018,14,3444,1,8,0,8,36
73.233,6,4533,4229982,2763,1444,26,1448,4124990,1770,776,41,1448,104992
1.358,6,53,19473,29,892,48,1360,13692,24,400,51,1360,5781
214.313,6,20,3510,6,92,87,92,412,14,215,16472,1408,3098
280.259,6,30,7432,13,158,23354,267,1317,17,543,17511,1400,6115
57.184,6,28,7352,13,158,4765,267,1317,15,678,4081,4140,6035
1794.38,17,325,69374,325,185,5538,422,69374,0,0,0,0,0
1772.364,6,180,15480,120,69,14893,69,8940,60,69,30037,69,6540
1782.241,1,339,28476,339,56,5272,56,28476,0,0,0,0,0
1750.76,17,12,498,11,14,175076,14,462,1,8,0,8,36
1795.62,17,447,39864,402,35,4477,288,25644,45,288,40022,288,14220
639.853,6,61,8764,31,106,21326,517,2582,30,384,22061,1368,6182
0.188,6,10,1671,6,552,37,948,1348,4,159,62,159,323
154.179,6,22,2609,12,324,14016,585,1281,10,396,17091,580,1328
1788.644,17,472,59123,222,163,8093,1350,42560,250,38,7182,1350,16563
1799.775,17,3506,168288,1738,20,1036,20,83424,1768,20,1018,20,84864
1774.073,1,58,4872,58,56,31124,56,4872,0,0,0,0,0
872.208,6,126,18036,71,136,12459,469,7903,55,161,16151,1420,10133
3.879,17,4,240,4,32,1293,32,240,0,0,0,0,0
1716.107,1,8,448,8,28,245158,28,448,0,0,0,0,0
0.894,6,11,1727,7,100,149,100,384,4,589,214,1152,1343
1785.208,17,142,11360,71,48,25502,48,5396,71,56,25502,56,5964
0.82,6,26,6093,13,108,68,147,959,13,768,64,1581,5134
0.421,6,20,7165,12,318,37,599,1905,8,1209,59,1906,5260
46.065,6,38,9391,22,103,2193,334,1844,16,766,1896,2720,7547
0.027,6,17,6068,10,88,3,88,556,7,1740,4,1880,5512
292.538,6,52,8390,24,110,12717,517,2289,28,384,10833,1418,6101
2.047,6,29,10373,17,368,127,837,1789,12,1012,178,1420,8584
12.563,1,16,1664,0,0,0,0,0,16,76,837,76,1664
48.042,6,2,80,0,0,0,0,0,2,0,0,0,80
81.14,6,49,9268,24,412,653,889,2360,25,327,3375,1360,6908
4.069,17,5,295,5,31,1017,31,295,0,0,0,0,0
19.238,6,24,8130,12,275,1748,275,771,12,1371,1404,1440,7359
1781.781,6,252,25095,102,66,17640,594,9407,150,127,11957,1440,15688
4.05,17,4,304,4,48,1350,48,304,0,0,0,0,0
1.48,6,70,46267,40,1223,37,1408,38802,30,982,45,2411,7465
1.624,6,48,18564,27,845,62,1360,12948,21,433,70,1360,5616
1763.619,17,170,14164,158,30,11233,37,9220,12,384,154987,463,4944
300.243,6,27,8287,15,415,21445,1114,2474,12,740,3315,1491,5813
1776.383,6,180,15480,120,69,14927,69,8940,60,69,30102,69,6540
1782.904,6,354,22440,207,69,8654,69,12420,147,69,12211,69,10020
1680.403,1,15,840,15,28,120028,28,840,0,0,0,0,0
0.093,17,2,195,1,44,0,44,72,1,95,0,95,123
2.723,6,33,11600,19,539,151,1360,4567,14,807,196,3494,7033
260.364,17,3,914,3,276,130182,493,914,0,0,0,0,0
251.342,17,4,352,2,60,251341,60,176,2,60,251341,60,176
1197.991,2,11,352,11,8,119799,8,352,0,0,0,0,0
126.91,6,29,11089,10,216,713,314,1916,19,764,7037,1179,9173
1799.551,6,371,24941,215,87,8409,469,14354,156,69,11607,69,10587
125.201,17,4,352,2,60,125200,60,176,2,60,125200,60,176
13.364,17,4,352,2,48,13354,48,152,2,72,13354,72,200
378.041,2,3,96,3,8,189020,8,96,0,0,0,0,0
0.05,17,8,1670,8,180,7,219,1670,0,0,0,0,0
10.61,6,18,5610,10,275,1178,275,958,8,1440,798,1440,4652
1787.342,6,104,8376,68,65,26676,65,4930,36,59,51063,59,3446
63.688,6,24,10294,13,433,64,990,1875,11,1138,6355,3928,8419
1719.456,17,12,498,11,14,171945,14,462,1,8,0,8,36
6.124,17,4,1344,4,308,2041,308,1344,0,0,0,0,0
1789.234,1,277,15512,277,28,6482,28,15512,0,0,0,0,0
1798.083,17,448,39896,403,35,4472,288,25676,45,288,40017,288,14220
1776.104,17,73,3060,72,14,25015,14,3024,1,8,0,8,36
0.048,17,2,136,1,32,0,32,60,1,48,0,48,76
1.261,6,50,18350,28,882,46,1360,12649,22,400,51,1360,5701
541.487,2,4,128,4,8,180495,8,128,0,0,0,0,0
167.164,6,24,10306,12,433,72,990,1847,12,995,15185,1390,8459
1741.356,6,87,6322,58,31,30550,31,3915,29,31,62191,31,2407
6.014,17,32,11736,32,338,194,361,11736,0,0,0,0,0
1.46,6,31,6467,15,164,104,267,1922,16,650,86,1380,4545
1.009,6,31,9830,19,674,56,1360,4848,12,561,73,2744,4982
12.437,6,1830,1666133,1172,1368,10,1380,1633131,658,421,18,1923,33002
2.181,17,4,580,2,40,2136,40,136,2,194,2132,194,444
315.956,6,73,19214,38,325,8539,1360,9695,35,386,9288,4649,9519
1780.414,1,62,5208,0,0,0,0,0,62,56,29187,56,5208
265.669,17,2,148,2,46,265669,46,148,0,0,0,0,0
5.584,17,4,288,2,36,5008,36,128,2,52,5565,52,160
366.8,6,69,28358,43,817,8733,1360,22225,26,338,558,2667,6133
1794.195,17,83,3480,82,14,22150,14,3444,1,8,0,8,36
15.442,6,92,28678,46,569,343,1152,22356,46,447,336,1179,6322
1.31,6,39,11298,21,616,65,1460,5802,18,433,66,1460,5496
1773.152,6,181,15589,120,69,14900,69,8940,61,69,29545,69,6649
8.091,17,6,528,3,48,4038,48,228,3,72,4038,72,300
24.139,6,670,580666,406,1356,59,1368,560840,264,749,90,1368,19826
1787.373,17,450,50939,216,144,8313,1350,37247,234,30,7671,60,13692
16.057,6,6,328,4,0,5352,0,216,2,0,15844,0,112
1795.007,17,448,39896,403,35,4465,288,25676,45,288,40022,288,14220
31.836,6,215,204596,72,125,448,297,4119,143,1388,224,1418,200477
0.428,17,2,776,2,360,428,360,776,0,0,0,0,0
30.383,6,11,684,3,106,15187,106,234,8,90,4339,90,450
0.433,17,3,3972,3,1296,216,1452,3972,0,0,0,0,0
57.158,6,27,7177,13,155,4763,267,1306,14,530,4396,3417,5871
12.686,6,57,32028,36,727,362,1360,9482,21,1446,626,4416,22546
0.273,6,5,260,3,0,32,0,156,2,0,220,0,104
63.102,6,23,10014,13,532,55,1360,2682,10,1384,6995,3934,7332
0.023,6,13,3980,7,88,3,88,388,6,1670,4,2920,3592
1.219,6,23,7952,12,164,95,267,1288,11,1216,104,3819,6664
9.692,6,116,87196,47,131,210,232,2409,69,1322,141,1420,84787
1740.542,17,30,6930,30,203,60018,203,6930,0,0,0,0,0
0.047,17,4,368,2,32,12,32,120,2,96,0,96,248
1.222,6,27,8569,15,236,73,625,2049,12,1205,93,3151,6520
6.332,6,391,415714,96,674,66,1408,14737,295,1362,20,2763,400977
2.315,6,35,6729,17,152,144,267,2053,18,658,127,1460,4676
1785.323,6,104,8376,68,65,26646,65,4930,36,59,51006,59,3446
1789.591,17,142,11360,71,48,25565,48,5396,71,56,25565,56,5964
1772.228,6,180,15480,120,69,14892,69,8940,60,69,30037,69,6540
4.038,6,2,88,2,0,0,0,88,0,0,0,0,0
1.728,6,22,5962,12,108,157,147,919,10,927,166,1608,5043
1786.357,6,102,8228,68,64,26662,64,4896,34,58,54128,58,3332
0.17,17,2,176,1,48,0,48,76,1,72,0,72,100
237.778,17,4,352,2,60,237776,60,176,2,60,237777,60,176
1779.959,17,55,18400,55,306,32962,308,18400,0,0,0,0,0
0.012,17,4,288,2,33,7,33,122,2,55,8,61,166
27.913,17,60,15540,60,231,473,388,15540,0,0,0,0,0
1797.287,17,449,39928,404,35,4459,288,25708,45,288,40021,288,14220
1788.397,17,83,3480,82,14,22078,14,3444,1,8,0,8,36
25.092,6,33,12350,17,828,1568,1440,4867,16,757,1658,1440,7483
1785.18,6,104,8376,68,65,26644,65,4930,36,59,51002,59,3446
1795.48,6,339,37204,188,155,9601,1189,18391,151,141,11969,1452,18813
240.499,6,46,9349,23,519,10931,1402,5881,23,251,10931,617,3468
9.044,6,35,8316,18,377,532,817,1884,17,478,547,1928,6432
125.25,6,29,9710,15,545,8939,1396,2970,14,1199,9610,1396,6740
0.101,6,12,1697,7,253,16,500,878,5,551,25,551,819
1684.492,2,15,480,15,8,120320,8,480,0,0,0,0,0
73.564,17,6,528,3,60,36781,60,264,3,60,36781,60,264
6.103,6,1473,1350714,925,1382,6,1408,1317554,548,931,10,2816,33160
108.058,17,10,1005,5,38,26979,49,330,5,107,27013,136,675
38.098,17,22,1936,11,48,3808,48,836,11,72,3808,72,1100
1787.176,6,102,8296,68,65,26674,65,4930,34,59,54154,59,3366
0.927,6,10,1687,7,100,154,100,384,3,1179,328,1179,1303
768.377,6,29,7394,19,132,42687,267,1960,10,837,142,1917,5434
3.188,6,11,467,6,0,637,0,248,5,7,693,7,219
0.376,6,25,8838,13,232,31,569,1614,12,1098,32,2804,7224
222.927,6,24,2064,16,69,14861,69,1192,8,69,31831,69,872
1.022,6,11,1727,7,100,170,100,384,4,589,253,1152,1343
0.4,17,3,507,2,39,152,39,134,1,345,0,345,373
225.698,6,9,515,5,43,56424,43,299,4,0,75231,0,216
0.856,17,4,288,2,36,812,36,128,2,52,824,52,160
0.141,17,2,418,1,37,0,37,65,1,325,0,325,353
0.015,6,11,912,6,182,3,182,490,5,77,2,133,422
372.888,1,4,240,4,32,124296,32,240,0,0,0,0,0
1684.496,2,25,800,25,8,70187,8,800,0,0,0,0,0
4.25,6,10,1102,6,483,850,483,803,4,83,1414,83,299
11.752,6,1851,1613829,1139,1363,10,1380,1581107,712,421,16,1923,32722
1745.482,6,97,7307,63,38,28152,205,4476,34,33,52887,98,2831
0.112,17,2,152,1,48,0,48,76,1,48,0,48,76
1772.613,6,180,15480,120,69,14895,69,8940,60,69,30038,69,6540
1795.823,17,448,39896,403,35,4467,288,25676,45,288,40017,288,14220
1.334,6,10,1687,7,100,222,100,384,3,1179,545,1179,1303
238.141,6,32,2108,13,46,19845,46,934,19,46,13222,46,1174
3.377,17,2,128,2,36,3377,36,128,0,0,0,0,0
105.209,17,4,288,2,36,105176,36,128,2,52,105176,52,160
35.15,6,4921,4660501,3108,1417,11,1448,4556489,1813,776,19,1448,104012
19.55,6,98,30480,49,561,407,1152,23308,49,434,401,1179,7172
1799.945,17,450,39960,405,35,4455,288,25740,45,288,40018,288,14220
1.704,17,6,432,3,36,851,36,192,3,52,851,52,240
4.817,6,12,3049,6,92,963,92,400,6,1164,842,1448,2649
28.187,6,15,2309,8,211,4026,211,858,7,545,4653,904,1451
1786.234,6,104,8366,69,64,26268,64,4936,35,58,52533,58,3430
1.429,6,10,1687,7,100,238,100,384,3,1179,591,1179,1303
280.353,6,30,7432,13,158,23362,267,1317,17,543,17520,1400,6115
62.676,6,41,9744,21,642,443,1360,4097,20,402,3289,2667,5647
373.729,6,21,1419,15,177,26694,177,989,6,110,12254,110,430
0.174,17,4,288,2,36,125,36,128,2,52,127,52,160
103.713,17,6,1236,3,48,51853,48,228,3,308,51852,308,1008
1.379,17,4,360,2,30,1332,30,116,2,94,1348,94,244
280.507,6,30,7432,13,158,23375,267,1317,17,603,17524,2760,6115
300.464,6,414,421526,142,145,2130,230,7972,272,1484,1108,7240,413554
119.89,6,30,7432,13,158,9990,267,1317,17,543,7488,1400,6115
1779.062,1,342,28728,342,56,5217,56,28728,0,0,0,0,0
0.17,2,2,112,2,32,170,32,112,0,0,0,0,0
1796.129,17,1052,72237,1052,40,1708,41,72237,0,0,0,0,0
0.574,6,14,3977,8,273,82,517,971,6,1343,113,1402,3006
2.087,17,4,734,3,46,1000,46,222,1,484,0,484,512
170.665,6,30,8872,13,158,14222,267,1317,17,687,10665,1400,7555
1778.624,6,106,8386,69,42,26156,205,4976,37,40,49394,177,3410
140.785,6,1049,531647,583,847,241,1152,508200,466,436,302,1179,23447
2.298,6,13,2311,8,188,328,245,700,5,1407,512,1407,1611
8.32,6,17,5391,9,275,1040,275,643,8,1104,841,1440,4748
14.76,6,27,7522,10,155,12,267,1186,17,434,922,4846,6336
4.847,6,37,7189,19,218,269,314,3383,18,513,268,1179,3806
0.012,17,4,753,2,33,0,33,122,2,287,2,299,631
1.719,6,31,6260,16,138,114,267,1755,15,650,112,1452,4505
3.14,6,18,3857,10,126,348,126,670,8,1373,448,1448,3187
1648.378,1,8,448,8,28,235482,28,448,0,0,0,0,0
278.774,17,16,1408,8,48,39823,48,608,8,72,39823,72,800
1787.564,6,116,13874,75,82,24156,502,5984,41,160,44685,1420,7890
1.561,6,48,19306,27,898,60,1360,13690,21,476,68,2715,5616
1772.307,6,180,15480,120,69,14893,69,8940,60,69,30030,69,6540
0.191,6,9,1340,5,145,47,145,349,4,827,29,827,991
3.502,17,5,290,5,30,875,30,290,0,0,0,0,0
2.036,6,44,12167,23,612,92,1460,6500,21,370,93,1460,5667
516.637,6,69,5352,40,66,13247,66,3052,29,63,18313,120,2300
15.755,17,13,6558,7,613,2619,1350,4488,6,317,3142,1350,2070
207.87,6,56,19005,28,750,7698,1440,10165,28,513,7691,1440,8840
1772.532,6,160,13714,107,69,16722,69,7937,53,69,34082,69,5777
1.636,6,14,2351,8,188,233,245,700,6,703,277,1152,1651
0.364,6,21,7217,13,318,30,599,1957,8,967,50,1471,5260
0.012,17,2,231,1,34,0,34,62,1,141,0,141,169
8.977,6,697,655131,472,1323,18,1368,638767,225,776,39,2736,16364
1775.065,17,142,11360,71,48,25358,48,5396,71,56,25358,56,5964
3.531,17,10,2786,5,30,881,30,290,5,471,881,484,2496
601.638,2,5,160,5,8,150409,8,160,0,0,0,0,0
252.801,6,34,9032,15,158,18057,267,1397,19,687,14043,2036,7635
305.55,6,42,8800,23,291,13888,787,2193,19,416,467,3488,6607
28.974,6,40,13535,21,1014,443,1360,7973,19,435,1599,2667,5562
71.249,17,3,228,3,48,35624,48,228,0,0,0,0,0
1744.419,6,94,7151,62,38,28597,205,4424,32,33,56259,98,2727
1792.181,6,139,10195,77,77,23581,208,6630,62,31,29373,31,3565
90.528,6,32,8952,14,158,6963,267,1357,18,624,5322,1400,7595
1749.769,6,97,7307,63,38,28222,205,4476,34,33,53015,98,2831
1738.378,1,15,870,15,30,124169,30,870,0,0,0,0,0
0.17,17,4,588,2,48,156,48,152,2,190,155,308,436
0.507,6,23,7420,13,337,42,674,2032,10,969,51,1483,5388
104.006,17,12,912,12,48,9455,48,912,0,0,0,0,0
46.519,17,6,2022,6,309,9303,322,2022,0,0,0,0,0
0.004,17,8,2750,8,315,0,354,2750,0,0,0,0,0
1772.332,6,358,54758,153,204,11659,1440,27055,205,192,8687,1440,27703
1795.866,17,446,39264,402,35,4478,288,25360,44,288,40954,288,13904
378.49,2,4,128,4,8,126163,8,128,0,0,0,0,0
12.299,6,1816,1674088,1182,1363,10,1432,1644413,634,427,19,1432,29675
184.835,6,71,49562,46,1185,4107,1408,41519,25,748,2568,1408,8043
3.73,6,33,6129,17,206,233,314,2744,16,548,231,1179,3385
20.437,6,10,2516,9,256,2554,365,2412,1,64,0,64,104
1780.103,17,69,2892,68,14,26568,14,2856,1,8,0,8,36
0.247,6,26,6066,13,164,20,453,1494,13,555,20,1542,4572
1764.089,2,14,448,14,8,135699,8,448,0,0,0,0,0
0.216,17,2,152,1,48,0,48,76,1,48,0,48,76
0.023,17,2,239,1,59,0,59,87,1,124,0,124,152
3.625,6,27,6296,15,232,258,501,1765,12,674,328,1420,4531
6.375,6,1547,1488883,1022,1383,6,1408,1456919,525,776,11,1408,31964
1.387,17,6,840,3,64,559,64,276,3,160,579,160,564
289.229,6,44,6430,26,89,11569,722,2796,18,269,7940,2026,3634
1793.603,1,78,6552,0,0,0,0,0,78,56,23293,56,6552
301.025,6,45,13956,25,788,12542,1360,8125,20,386,463,2667,5831
0.023,17,2,489,1,34,0,34,62,1,399,0,399,427
1771.553,6,80,4250,40,26,45423,26,2132,40,26,45423,26,2118
33.937,6,34,5293,16,154,2262,721,1909,18,305,1982,1368,3384
1786.518,6,102,8228,68,64,26664,64,4896,34,58,54134,58,3332
1739.123,2,24,768,24,8,75614,8,768,0,0,0,0,0
657.45,2,8,256,8,8,93921,8,256,0,0,0,0,0
240.24,6,54,17964,29,756,8579,1408,15137,25,189,10009,580,2827
10.243,6,14,2245,8,211,1463,211,846,6,545,2048,904,1399
20.067,17,20,1534,10,40,2229,41,687,10,56,2225,57,847
1776.651,1,15,1860,15,96,126903,117,1860,0,0,0,0,0
3.354,17,10,1854,5,30,835,30,290,5,284,836,304,1564
1797.858,1,176,18656,176,78,10273,78,18656,0,0,0,0,0
0.165,6,19,7599,10,215,16,215,743,9,1276,18,1438,6856
0.291,6,9,1339,5,145,72,145,349,4,826,27,826,990
1.235,6,47,19601,27,922,47,1360,14025,20,476,56,2715,5576
1.332,6,47,18689,26,923,53,1460,13073,21,433,57,1460,5616
64.973,6,27,7177,13,155,5414,267,1306,14,530,4997,3417,5871
355.862,6,21,1706,15,177,25418,177,1154,6,110,12037,110,552
31.435,17,36,5292,18,48,1848,48,1368,18,190,1848,308,3924
1770.98,17,388,79007,388,175,4576,385,79007,0,0,0,0,0
1754.255,6,186,11385,93,47,19067,208,6766,93,31,19065,31,4619
0.49,6,9,1002,5,213,122,213,417,4,421,112,421,585
2.658,6,13,2311,8,188,379,245,700,5,1407,602,1407,1611
1755.583,6,105,6240,60,26,29754,26,3510,45,26,39898,26,2730
0.386,6,34,8102,18,289,22,517,1909,16,461,23,1420,6193
1793.041,17,144,11520,72,48,25254,48,5472,72,56,25254,56,6048
20.649,17,4,352,2,48,20633,48,152,2,72,20628,72,200
1739.465,6,99,7192,63,31,28055,31,4292,36,31,49698,31,2900
1790.34,1,58,4872,58,56,31409,56,4872,0,0,0,0,0
365.716,6,23,1538,16,180,24381,180,1056,7,110,10421,110,482
292.938,1,4,224,4,28,97646,28,224,0,0,0,0,0
0.645,17,2,152,1,48,0,48,76,1,48,0,48,76
1796.021,17,142,11360,71,48,25657,48,5396,71,56,25657,56,5964
1.9,6,35,6709,18,149,111,267,2073,17,564,109,1452,4636
1.199,6,8,335,4,0,399,0,164,4,7,332,7,171
322.651,17,11,3888,11,325,32265,548,3888,0,0,0,0,0
1782.649,6,97,7846,60,66,25700,66,4380,37,55,49509,60,3466
1785.86,6,371,26279,214,105,8384,469,15514,157,69,11447,69,10765
12.177,17,10,850,5,37,3042,37,325,5,77,3042,77,525
0.166,6,26,7256,13,155,13,267,1301,13,603,13,2036,5955
9.013,6,83,24845,42,560,219,1152,19048,41,461,218,1179,5797
88.763,6,26,8890,12,649,93,1440,3109,14,744,6814,1440,5781
1.944,17,2,312,2,128,1944,128,312,0,0,0,0,0
0.296,6,3,156,2,0,296,0,104,1,0,0,0,52
1749.54,17,12,498,11,14,174954,14,462,1,8,0,8,36
280.281,6,28,7352,12,158,25480,267,1277,16,603,18681,1400,6075
0.386,6,10,968,5,256,94,256,460,5,304,94,304,508
88.504,6,20,9856,11,380,68,832,1613,9,1574,11047,3928,8243
1757.048,6,101,7706,67,40,26621,205,4811,34,33,53237,98,2895
0.419,6,21,7203,13,318,34,600,1958,8,964,56,1471,5245
4.948,6,27,7312,13,158,412,267,1317,14,678,379,2800,5995
6.3,1,4,224,4,28,2100,28,224,0,0,0,0,0
61.669,6,60,39456,38,1137,1666,1408,31578,22,747,2926,1408,7878
1694.871,17,16,1265,8,30,242120,37,471,8,71,242119,136,794
5.031,17,4,488,4,94,1677,94,488,0,0,0,0,0
1164.048,17,815,57248,734,40,1588,41,50396,81,56,523,57,6852
1781.384,6,349,21964,204,69,8775,69,12162,145,69,12370,69,9802
0.735,6,152,108186,85,1321,8,1432,101215,67,475,10,2864,6971
1798.582,1,302,32012,302,78,5975,78,32012,0,0,0,0,0
0.236,6,25,6032,12,164,21,453,1442,13,651,18,2194,4590
1797.923,1,58,4872,58,56,31542,56,4872,0,0,0,0,0
0.006,6,2,92,1,0,0,0,40,1,0,0,0,52
1795.528,6,524,153134,241,565,7480,1460,103660,283,286,6366,1642,49474
0.943,17,2,466,2,205,943,205,466,0,0,0,0,0
1773.507,6,206,22548,131,75,13642,267,10097,75,133,23959,2009,12451
21.686,6,28,7098,16,124,1445,159,1600,12,695,1970,1418,5498
0.038,17,2,459,1,40,0,40,68,1,363,0,363,391
888.747,1,8,448,8,28,126963,28,448,0,0,0,0,0
1778.026,17,142,11360,71,48,25399,48,5396,71,56,25399,56,5964
3.192,17,5,574,4,32,1058,32,240,1,306,0,306,334
220.482,6,36,7207,21,184,11024,501,2132,15,447,15740,1420,5075
374.088,6,23,1535,16,177,24939,177,1053,7,110,10404,110,482
70.72,6,118,49460,66,737,1088,1360,36600,52,413,1384,1360,12860
17.465,6,1938,1750342,1223,1373,14,1380,1711928,715,421,24,1923,38414
426.77,17,21,1896,21,62,21338,348,1896,0,0,0,0,0
565.762,1,10,560,10,28,62862,28,560,0,0,0,0,0
195.598,1,5,839,5,139,48899,320,839,0,0,0,0,0
3.606,17,5,738,4,32,1197,32,240,1,470,0,470,498
60.052,17,28,2355,26,30,2401,37,1515,2,392,336,463,840
0.118,17,2,2752,2,1348,118,1348,2752,0,0,0,0,0
80.008,17,4,304,4,48,26669,48,304,0,0,0,0,0
1744.675,2,26,832,26,8,69787,8,832,0,0,0,0,0
1.275,17,6,936,3,64,637,64,276,3,192,604,192,660
293.46,17,4,240,2,32,293459,32,120,2,32,293458,32,120
0.011,17,3,560,2,60,0,60,176,1,356,0,356,384
6.288,6,1755,1563619,1105,1364,5,1380,1533377,650,421,9,1923,30242
0.191,17,2,178,1,29,0,29,57,1,93,0,93,121
12.751,6,1455,1265201,879,1357,14,1408,1230585,576,931,21,2801,34616
4.096,17,5,290,5,30,1024,30,290,0,0,0,0,0
6.205,6,1507,1379154,943,1384,6,1408,1345162,564,931,10,2801,33992
1796.048,17,447,39864,402,35,4478,288,25644,45,288,40021,288,14220
0.176,17,5,1735,5,319,44,354,1735,0,0,0,0,0
1799.425,17,449,39928,404,35,4465,288,25708,45,288,40019,288,14220
0.051,17,2,266,1,41,0,41,69,1,169,0,169,197
1798.601,17,449,39928,404,35,4463,288,25708,45,288,40021,288,14220
23.463,6,4,181,0,0,0,0,0,4,7,7821,7,181
1.652,6,35,11208,18,438,97,1279,3393,17,890,91,2382,7815
1760.086,6,97,7307,63,38,28388,205,4476,34,33,53328,98,2831
0.119,6,12,1945,7,329,19,500,1030,5,647,29,647,915
670.472,6,33,2544,16,64,25284,64,1152,17,44,41899,58,1392
0.242,17,3,451,2,39,179,39,134,1,289,0,289,317
2.234,6,6,340,3,0,1117,0,160,3,0,823,0,180
11.627,6,7,380,4,0,3875,0,216,3,0,5808,0,164
3.605,17,4,1564,4,363,1201,363,1564,0,0,0,0,0
0.373,17,2,152,1,48,0,48,76,1,48,0,48,76
0.01,17,2,278,1,36,0,36,64,1,186,0,186,214
1741.192,6,87,6322,58,31,30547,31,3915,29,31,62185,31,2407
1774.327,6,98,7421,65,38,27723,205,4611,33,33,55437,98,2810
1740.678,17,26,17498,26,645,69627,645,17498,0,0,0,0,0
1778.711,17,73,3060,72,14,25052,14,3024,1,8,0,8,36
1.862,6,19,4492,10,281,206,544,1248,9,575,221,1420,3244
1.036,17,18,5973,7,346,172,1350,2623,11,276,80,1350,3350
1.792,17,2,225,1,37,0,37,65,1,132,0,132,160
0.082,17,2,2754,2,1349,82,1349,2754,0,0,0,0,0
0.02,17,3,404,2,64,1,64,184,1,192,0,192,220
21.762,6,3438,3287778,2205,1412,9,1448,3218974,1233,776,17,1448,68804
1.334,6,47,19039,27,882,51,1360,13463,20,433,61,1360,5576
1792.401,1,192,20352,192,78,9384,78,20352,0,0,0,0,0
0.047,17,2,309,1,40,0,40,68,1,213,0,213,241
0.705,6,10,861,5,222,173,222,426,5,231,173,231,435
1.623,6,47,19175,27,891,62,1360,13599,20,476,73,2715,5576
251.205,2,2,64,2,8,251205,8,64,0,0,0,0,0
164.736,2,3,96,3,8,82368,8,96,0,0,0,0,0
7.605,6,1434,1185709,778,1425,9,1448,1139437,656,776,11,1448,46272
16.896,17,27,12019,13,545,1402,1350,7449,14,298,1294,1350,4570
4.064,17,2,178,1,29,0,29,57,1,93,0,93,121
256.731,17,22,1760,11,48,25672,48,836,11,56,25672,56,924
0.01,6,2,92,1,0,0,0,40,1,0,0,0,52
72.329,6,72,50556,47,1178,1572,1408,42520,25,961,2569,3847,8036
280.612,6,32,7853,14,158,21585,267,1357,18,524,16505,1300,6496
125.585,17,4,352,2,60,125584,60,176,2,60,125584,60,176
22.364,17,16,2588,8,48,3193,48,608,8,219,3193,308,1980
15.284,17,15,8701,7,564,2537,1350,4144,8,541,2170,1350,4557
33.687,6,8259,8612109,2788,650,12,652,164340,5471,1492,6,5792,8447769
0.009,6,2,80,1,0,0,0,40,1,0,0,0,40
280.212,6,30,7432,15,158,20015,267,1397,15,678,20012,3436,6035
0.385,17,2,180,1,30,0,30,58,1,94,0,94,122
15.49,17,15,8885,8,801,2206,1350,6639,7,292,2573,1350,2246
31.65,6,7,308,1,0,0,0,44,6,0,6312,0,264
1735.245,1,41,3444,41,56,43381,56,3444,0,0,0,0,0
6.781,6,607,571065,406,1340,16,1368,555949,201,776,32,1473,15116
1681.532,17,14,1036,7,30,280252,30,406,7,62,280253,62,630
503.934,2,4,128,4,8,167978,8,128,0,0,0,0,0
299.524,6,6,364,4,31,99841,31,222,2,31,299513,31,142
347.91,17,6,456,6,48,69582,48,456,0,0,0,0,0
0.014,17,2,358,1,30,0,30,58,1,272,0,272,300
0.016,17,4,420,2,33,0,33,122,2,121,1,145,298
10.484,6,37,13801,18,431,616,1024,3354,19,744,572,1360,10447
1786.249,6,103,8464,68,66,26660,66,4964,35,60,52534,60,3500
116.58,2,2,64,2,8,116580,8,64,0,0,0,0,0
1646.119,1,7,392,7,28,274353,28,392,0,0,0,0,0
1744.874,6,95,7203,63,38,28143,205,4476,32,33,56278,98,2727
9.421,6,66,20110,34,561,285,1152,15403,32,489,295,1179,4707
0.139,17,2,154,1,33,0,33,61,1,65,0,65,93
125.83,17,4,352,2,60,125828,60,176,2,60,125829,60,176
1794.809,17,211,60987,211,261,8546,422,60987,0,0,0,0,0
152.897,17,4,352,2,60,152895,60,176,2,60,152896,60,176
0.249,17,3,451,2,39,242,39,134,1,289,0,289,317
1.689,6,38,8252,19,320,93,1162,2716,19,476,82,2715,5536
0.54,6,27,9027,13,200,45,611,1687,14,941,39,1368,7340
0.291,6,26,8990,13,247,24,624,1672,13,947,23,1408,7318
101.605,17,4,352,2,60,101604,60,176,2,60,101603,60,176
1740.881,17,30,31680,30,1028,60030,1028,31680,0,0,0,0,0
1.422,6,49,18832,27,861,54,1360,13176,22,476,58,2715,5656
4.292,6,39,7269,19,218,238,314,3383,20,440,212,1152,3886
172.158,17,8,2688,8,308,24594,308,2688,0,0,0,0,0
2.334,17,2,778,2,361,2334,361,778,0,0,0,0,0
127.879,6,24,7098,6,154,25575,267,712,18,404,7521,4837,6386
5.865,6,28,6135,15,338,418,1314,2294,13,414,487,1414,3841
1.127,6,25,6448,13,297,93,830,2011,12,790,100,1420,4437
0.003,6,2,1500,1,0,0,0,40,1,1420,0,1420,1460
1796.82,1,342,28728,342,56,5269,56,28728,0,0,0,0,0
7.929,17,6,528,3,48,3960,48,228,3,72,3959,72,300
300.706,6,36,8493,20,317,15826,922,2101,16,521,567,3488,6392
0.065,17,2,1364,2,654,65,654,1364,0,0,0,0,0
121.669,6,24,10168,13,549,61,1360,2749,11,1161,12151,2720,7419
0.35,6,27,8920,14,227,26,547,1644,13,941,28,1438,7276
0.024,17,4,792,3,60,5,60,264,1,500,0,500,528
0.035,17,2,128,1,36,0,36,64,1,36,0,36,64
373.392,6,18,1242,14,180,28722,180,916,4,110,20059,110,326
1741.43,6,87,6322,58,31,30551,31,3915,29,31,62191,31,2407
300.849,6,38,8566,20,315,15834,882,2093,18,441,507,1360,6473
0.049,17,2,196,1,62,0,62,90,1,78,0,78,106
1772.516,6,180,15480,120,69,14895,69,8940,60,69,30034,69,6540
1786.461,6,359,22778,208,69,8630,69,12529,151,69,11909,69,10249
123.017,6,14,1518,8,304,17573,304,1032,6,83,24583,83,486
322.909,6,54,16726,27,567,2167,779,4843,27,802,12419,1438,11883
300.791,6,38,8414,20,277,15831,762,1940,18,478,505,1928,6474
1630.302,1,7,742,7,78,271717,78,742,0,0,0,0,0
94.7,6,30,8872,14,158,7284,267,1357,16,763,6304,2036,7515
96.282,6,35,7911,12,155,28,267,1266,23,317,4376,1420,6645
1799.668,17,426,54535,204,175,8827,1350,41612,222,30,8143,60,12923
1796.541,17,446,39832,401,35,4491,288,25612,45,288,40023,288,14220
36.215,6,20,6001,10,271,4023,515,1219,10,625,4012,1452,4782
1794.843,6,356,22520,208,69,8670,69,12460,148,69,12209,69,10060
126.742,2,2,64,2,8,126742,8,64,0,0,0,0,0
18.804,17,3,228,3,48,9402,48,228,0,0,0,0,0
0.09,6,10,1495,5,507,22,507,727,5,556,22,556,768
0.543,6,546,525455,342,183,1,230,19081,204,2454,2,11264,506374
280.498,6,30,7432,13,158,23374,267,1317,17,603,17528,2076,6115
0.072,17,4,288,2,33,1,33,122,2,55,1,61,166
78.112,6,9434,9027678,5897,1445,13,1448,8820550,3537,776,21,1448,207128
1781.767,6,374,25999,216,98,8287,469,15263,158,69,11348,69,10736
7.837,6,2,1235,1,0,0,0,40,1,1155,0,1155,1195
0.891,6,11,1727,7,100,148,100,384,4,589,210,1152,1343
0.128,17,4,414,2,40,0,40,136,2,111,39,117,278
16.106,17,10,880,5,48,4023,48,380,5,72,4022,72,500
1791.657,6,138,10217,79,77,22969,208,6710,59,31,30885,31,3507
1790.495,1,194,10864,194,28,9277,28,10864,0,0,0,0,0
78.576,6,24,10043,12,653,84,1360,3126,12,1070,7128,2235,6917
1613.282,17,16,1265,8,30,230467,37,471,8,71,230467,136,794
0.091,6,13,3565,7,126,15,126,498,6,1373,18,1448,3067
1793.102,17,180,11520,180,36,10017,36,11520,0,0,0,0,0
1789.63,6,387,26933,221,96,8134,469,15808,166,69,10845,69,11125
1772.558,6,180,15480,120,69,14895,69,8940,60,69,30041,69,6540
1792.029,6,180,15480,120,69,15059,69,8940,60,69,30371,69,6540
1787.399,6,102,8228,68,64,26677,64,4896,34,58,54159,58,3332
5.9,6,48,9445,24,233,256,314,4701,24,472,245,1179,4744
240.239,17,12,1056,6,48,48046,48,456,6,72,48046,72,600
0.075,17,2,198,1,63,0,63,91,1,79,0,79,107
1774.732,6,270,32537,109,138,16431,1460,15744,161,127,11091,1642,16793
1784.418,6,355,22480,207,69,8662,69,12420,148,69,12138,69,10060
9.461,6,691,562880,407,1308,22,1368,543448,284,776,32,1473,19432
3.261,6,2,88,2,0,0,0,88,0,0,0,0,0
240.222,6,53,17846,28,792,8896,1418,14934,25,200,10008,580,2912
0.567,17,455,506468,88,134,6,1350,14269,367,1313,1,1350,492199
2.976,17,8,736,4,32,992,32,240,4,96,239,96,496
756.453,2,5,160,5,8,189113,8,160,0,0,0,0,0
6.313,1,4,224,4,28,2104,28,224,0,0,0,0,0
3.41,6,41,8500,21,256,170,1164,2924,20,433,166,1460,5576
0.222,6,46,22051,27,1064,8,1420,17070,19,467,11,1883,4981
0.257,17,2,180,1,30,0,30,58,1,94,0,94,122
0.038,17,3,244,2,32,22,32,120,1,96,0,96,124
198.577,6,39,8460,20,352,10451,741,1901,19,413,488,1460,6559
685.155,17,3034,2879723,2973,939,230,1252,2877275,61,12,9624,16,2448
50.853,6,48,12601,22,327,2421,1305,3868,26,449,2010,1360,8733
278.082,6,99,127186,56,430,5056,647,4246,43,3017,1592,8448,122940
1739.822,6,87,6322,58,31,30523,31,3915,29,31,62136,31,2407
0.066,6,9,1002,5,213,16,213,417,4,421,16,421,585
1700.557,17,12,498,11,14,170055,14,462,1,8,0,8,36
1.184,6,28,5893,14,123,91,267,1428,14,780,77,1460,4465
249.429,6,27,4351,12,524,22674,1004,2264,15,163,17815,979,2087
1.24,17,4,560,2,64,975,64,184,2,160,998,160,376
280.2,6,27,7312,13,158,23350,267,1317,14,775,21553,4836,5995
1799.097,17,450,39960,405,35,4453,288,25740,45,288,40017,288,14220
0.171,1,2,112,2,28,171,28,112,0,0,0,0,0
1787.455,6,102,8296,68,65,26678,65,4930,34,59,54161,59,3366
8.783,6,16,1402,8,275,1254,275,878,8,96,1114,96,524
0.13,17,2,152,1,48,0,48,76,1,48,0,48,76
1796.526,6,390,26639,220,99,8203,469,15285,170,55,10630,69,11354
0.027,17,2,144,1,36,0,36,64,1,52,0,52,80
1664.379,1,7,392,7,28,277396,28,392,0,0,0,0,0
1791.773,6,356,22520,208,69,8655,69,12460,148,69,12188,69,10060
1772.708,6,180,15480,120,69,14896,69,8940,60,69,30040,69,6540
7.292,6,46,8790,23,227,331,314,4102,23,470,319,1179,4688
191.286,6,7,320,2,0,191276,0,88,5,0,47819,0,232
171.089,17,4,352,2,60,171088,60,176,2,60,171087,60,176
0.001,17,2,212,1,46,0,46,74,1,110,0,110,138
5.007,17,4,558,2,36,5003,36,128,2,187,5002,187,430
11.711,6,1917,1615290,1138,1363,10,1380,1579876,779,421,15,1923,35414
1741.318,17,30,31680,30,1028,60045,1028,31680,0,0,0,0,0
1771.4,6,99,9240,66,65,27252,65,5577,33,59,55353,59,3663
1784.721,1,170,18020,170,78,10560,78,18020,0,0,0,0,0
430.726,6,66,10930,31,104,14357,267,3120,35,228,12668,1420,7810
1795.123,17,80,3354,79,14,23014,14,3318,1,8,0,8,36
0.191,6,26,7256,13,155,15,267,1301,13,678,14,2800,5955
0.035,17,4,336,2,45,0,45,146,2,67,10,73,190
10.771,6,19,4282,11,275,1077,275,998,8,984,857,2760,3284
1794.921,6,176,14857,93,106,19508,208,10452,83,31,21887,31,4405
72.226,6,31,7544,13,155,6018,267,1306,18,423,4247,3417,6238
0.0,1,1,28,1,0,0,0,28,0,0,0,0,0
1394.269,6,110,7508,58,63,24457,208,4405,52,31,27335,31,3103
315.043,6,20,2429,7,242,52506,517,1111,13,323,26253,499,1318
1681.336,17,14,3811,7,30,280220,30,406,7,458,280221,463,3405
0.007,6,2,129,1,0,0,0,40,1,37,0,37,89
10.245,6,16,1127,9,275,1280,275,643,7,96,1303,96,484
251.804,2,3,96,3,8,125902,8,96,0,0,0,0,0
61.689,6,41,8513,20,319,807,643,1826,21,389,3076,2128,6687
163.13,17,4,240,2,32,163129,32,120,2,32,163129,32,120
5.841,6,2534,2648107,948,218,6,230,55351,1586,1584,3,5632,2592756
32.861,17,4,352,2,60,32860,60,176,2,60,32859,60,176
3.295,6,9,520,4,0,1098,0,220,5,0,764,0,300
0.001,17,2,146,1,37,0,37,65,1,53,0,53,81
103.871,6,18,4426,9,316,12961,722,1426,9,503,12962,1448,3000
31.962,6,7,308,1,0,0,0,44,6,0,6324,0,264
1.571,6,50,19987,27,941,60,1440,14291,23,433,62,1440,5696
2.388,17,2,136,1,32,0,32,60,1,48,0,48,76
1759.552,1,74,4144,74,28,24103,28,4144,0,0,0,0,0
1747.071,6,95,7203,63,38,28178,205,4476,32,33,56343,98,2727
25.137,6,9,577,0,0,0,0,0,9,31,3142,31,577
1.205,6,25,8056,12,164,94,267,1288,13,869,86,1448,6768
1794.292,17,274,59144,274,187,6572,422,59144,0,0,0,0,0
1774.768,6,130,14783,81,85,22184,475,7584,49,115,36972,1408,7199
0.982,6,28,6625,15,126,70,517,1925,13,501,77,1552,4700
0.204,17,8,2758,8,316,29,355,2758,0,0,0,0,0
0.184,17,4,588,2,48,174,48,152,2,190,172,308,436
1.069,6,54,13970,25,551,44,1429,4892,29,416,34,1460,9078
1.912,17,3,1173,3,363,956,363,1173,0,0,0,0,0
0.582,6,7,1567,5,100,145,100,304,2,1179,308,1179,1263
4.639,6,40,7309,20,218,244,314,3423,20,440,231,1152,3886
1788.221,6,356,22520,208,69,8638,69,12460,148,69,12164,69,10060
1783.809,6,358,22669,209,69,8575,69,12500,149,69,12052,69,10169
1.729,17,2,179,1,43,0,43,71,1,80,0,80,108
1796.425,17,764,46132,764,32,2354,37,46132,0,0,0,0,0
0.484,17,3,1167,3,361,242,361,1167,0,0,0,0,0
1769.361,6,104,9648,68,65,26408,65,5758,36,59,50550,59,3890
154.698,6,21,4633,7,267,671,501,1085,14,298,11892,1420,3548
240.194,6,55,17975,30,755,8282,1408,15176,25,186,10007,580,2799
1799.207,17,448,39896,403,35,4475,288,25676,45,288,40018,288,14220
0.225,6,8,530,5,43,55,43,354,3,0,111,0,176
0.022,17,4,420,2,33,19,33,122,2,121,17,145,298
15.579,6,6,264,1,0,0,0,44,5,0,3830,0,220
1698.669,1,8,448,8,28,242667,28,448,0,0,0,0,0
17.546,6,30,5769,16,186,1169,314,2325,14,480,1327,1179,3444
11.748,6,92,28935,45,576,267,1152,22557,47,449,250,1179,6378
3.96,6,2,88,2,0,0,0,88,0,0,0,0,0
280.3,6,29,7392,13,158,23358,267,1317,16,603,18684,1400,6075
0.879,6,51,13849,24,549,38,1429,4860,27,464,33,1986,8989
1798.125,6,354,22302,207,69,8728,69,12351,147,69,12259,69,9951
1800.0,6,205,14182,76,46,23618,46,6032,129,46,14062,46,8150
0.084,17,4,284,2,32,45,32,120,2,54,41,60,164
1.887,6,20,3833,11,234,188,564,1504,9,463,213,1343,2329
73.976,6,25,7201,6,154,156,267,712,19,381,4109,1460,6489
6.515,6,26,7080,15,185,465,275,1165,11,910,623,1380,5915
1772.099,6,182,15629,121,69,14767,69,8980,61,69,29530,69,6649
1.172,6,23,7952,11,164,99,267,1236,12,1014,90,2423,6716
0.038,17,6,552,3,32,6,32,180,3,96,7,96,372
14.452,6,24,6121,10,243,1584,722,1514,14,482,1097,2026,4607
1799.994,6,216,14864,81,46,22124,46,6244,135,46,13432,46,8620
658.199,2,7,224,7,8,109699,8,224,0,0,0,0,0
1765.499,6,231,26480,118,79,15089,721,10770,113,228,15760,1414,15710
5.029,17,4,288,2,36,5014,36,128,2,52,5013,52,160
0.658,17,2,166,1,47,0,47,75,1,63,0,63,91
1.401,6,47,19347,27,904,53,1460,13771,20,476,63,2615,5576
238.949,17,6,528,3,60,119474,60,264,3,60,119474,60,264
199.941,17,4,352,2,60,199940,60,176,2,60,199940,60,176
686.277,6,106,16775,49,90,12377,721,4498,57,356,12251,2007,12277
101.811,6,14,1887,8,302,14544,302,1318,6,83,20359,83,569
296.474,6,36,8086,13,158,24706,267,1317,23,365,13475,1400,6769
0.147,17,2,148,1,38,0,38,66,1,54,0,54,82
1795.011,1,224,23744,224,78,8049,78,23744,0,0,0,0,0
7.046,6,20,2605,11,211,684,211,1038,9,545,876,904,1567
2.342,6,13,2311,8,188,334,245,700,5,1407,523,1407,1611
241.623,6,50,9636,26,139,9664,346,2242,24,511,10505,2800,7394
75.934,2,2,64,2,8,75934,8,64,0,0,0,0,0
0.007,17,2,152,1,48,0,48,76,1,48,0,48,76
588.753,17,11,3696,11,308,58875,308,3696,0,0,0,0,0
116.529,6,25,10263,12,563,78,1360,2764,13,995,9696,1360,7499
1793.917,17,66,2766,65,14,28029,14,2730,1,8,0,8,36
0.37,6,7,376,4,0,123,0,216,3,0,94,0,160
251.767,2,2,64,2,8,251767,8,64,0,0,0,0,0
61.896,6,78,52914,47,1203,1345,1408,44566,31,961,2055,3847,8348
2.35,6,13,2311,8,188,335,245,700,5,1407,524,1407,1611
2.801,17,16,8448,9,631,349,1350,5937,7,330,461,1350,2511
6.035,6,3,180,3,0,0,0,180,0,0,0,0,0
300.607,6,38,8578,20,315,15821,882,2105,18,441,496,1360,6473
1764.794,6,100,7767,66,40,27150,205,4726,34,37,53466,177,3041
240.277,6,43,9071,21,515,12013,1402,5743,22,241,11441,638,3328
1.4,6,49,20852,28,938,51,1360,15236,21,433,60,1360,5616
1759.72,6,160,8320,80,0,22274,0,4160,80,0,22274,0,4160
1.58,17,27,13785,14,712,121,1350,10365,13,235,66,1350,3420
376.914,6,84,10846,42,157,9193,267,2948,42,442,9192,1536,7898
1795.848,17,29,9512,29,300,64137,300,9512,0,0,0,0,0
42.616,17,24,2112,12,48,3869,48,912,12,72,3867,72,1200
1787.11,6,104,8376,68,65,26673,65,4930,36,59,51056,59,3446
1798.801,17,449,39928,404,35,4463,288,25708,45,288,40019,288,14220
7.542,17,4,1344,4,308,2514,308,1344,0,0,0,0,0
1772.515,6,204,22405,130,75,13740,267,10063,74,133,24274,1997,12342
1789.241,17,142,11360,71,48,25560,48,5396,71,56,25560,56,5964
1.293,17,16,10515,8,987,179,1350,8125,8,270,179,1350,2390
300.696,6,37,8526,19,315,16705,882,2053,18,441,497,1460,6473
357.861,2,4,128,4,8,119287,8,128,0,0,0,0,0
335.524,6,66,40348,39,1160,8829,1408,32203,27,748,2360,1408,8145
300.245,6,30,11787,17,593,18765,1408,4464,13,1106,20021,2816,7323
69.553,6,26,7206,12,155,6323,267,1266,14,537,5349,3426,5940
15.327,17,22,16717,11,925,1529,1350,10483,11,538,1529,1350,6234
0.256,17,3,451,2,39,34,39,134,1,289,0,289,317
1759.634,17,120,25024,120,180,14786,422,25024,0,0,0,0,0
193.49,17,4,352,2,60,193489,60,176,2,60,193488,60,176
1789.888,6,357,22629,208,69,8646,69,12460,149,69,12093,69,10169
29.909,6,12,1313,7,185,4984,185,557,5,244,7472,476,756
92.932,6,23,940,10,0,5289,0,404,13,0,7743,0,536
0.089,17,2,2386,2,1165,89,1165,2386,0,0,0,0,0
6.146,6,1576,1471745,984,1417,6,1440,1436285,592,776,10,1440,35460
81.864,6,10,1588,10,106,9096,226,1588,0,0,0,0,0
560.509,17,6,1647,3,30,280215,30,174,3,463,280249,463,1473
1682.656,17,14,1036,7,30,280440,30,406,7,62,280440,62,630
1744.687,2,25,800,25,8,72695,8,800,0,0,0,0,0
12.25,17,15,17682,15,1150,875,1451,17682,0,0,0,0,0
7.409,6,568,798442,374,990,19,1360,26053,194,4178,37,42160,772389
1795.94,6,107,8695,70,52,26028,205,5411,37,36,49880,98,3284
1774.091,6,180,15480,120,69,14908,69,8940,60,69,30061,69,6540
1792.373,17,142,11360,71,48,25604,48,5396,71,56,25604,56,5964
5.801,6,5,220,5,0,0,0,220,0,0,0,0,0
9.066,6,7,837,3,45,4533,53,246,4,191,1668,346,591
3.622,17,5,295,5,31,905,31,295,0,0,0,0,0
20.606,6,21,2630,12,140,1873,517,1484,9,323,2568,499,1146
76.802,6,30,7533,16,660,5120,1418,5464,14,190,5906,580,2069
0.295,17,2,290,1,40,0,40,68,1,194,0,194,222
0.857,6,27,5927,13,156,71,267,1462,14,650,60,1420,4465
377.518,2,4,128,4,8,125839,8,128,0,0,0,0,0
20.133,6,24,6232,14,117,1548,159,1337,10,727,2235,1402,4895
90.457,6,64,33141,26,692,111,1360,6610,38,833,2440,1712,26531
284.129,6,39,7358,22,134,13529,516,2096,17,416,17752,1452,5262
1790.712,6,359,22709,209,69,8609,69,12569,150,69,12018,69,10140
1.558,6,48,19834,27,936,59,1460,14218,21,433,68,1460,5616
661.819,2,5,160,5,8,165454,8,160,0,0,0,0,0
1792.616,17,180,11520,180,36,10014,36,11520,0,0,0,0,0
0.075,17,2,348,1,39,0,39,67,1,253,0,253,281
1795.177,17,448,39896,403,35,4465,288,25676,45,288,40025,288,14220
4.42,6,37,7189,19,218,245,314,3383,18,513,243,1179,3806
0.442,1,2,112,2,28,442,28,112,0,0,0,0,0
0.187,17,2,152,1,48,0,48,76,1,48,0,48,76
1.211,6,24,6412,13,298,100,834,2015,11,988,120,1731,4397
22.95,6,3562,3447497,2376,1375,9,1408,3381149,1186,931,19,2801,66348
1.338,6,38,9848,20,502,70,1460,4352,18,433,68,1460,5496
1.082,6,24,5754,13,158,88,370,1315,11,799,106,1460,4439
10.789,17,15,17682,15,1150,770,1451,17682,0,0,0,0,0
5.076,17,2,179,1,43,0,43,71,1,80,0,80,108
0.134,17,2,417,1,44,0,44,72,1,317,0,317,345
0.17,6,26,7256,13,155,14,267,1301,13,603,13,1400,5955
0.313,6,24,7458,13,335,25,668,2038,11,968,30,1906,5420
0.269,17,2,167,1,39,0,39,67,1,72,0,72,100
1796.027,17,448,39896,403,35,4467,288,25676,45,288,40021,288,14220
1785.588,17,142,11360,71,48,25507,48,5396,71,56,25507,56,5964
1787.46,6,102,8228,68,64,26678,64,4896,34,58,54162,58,3332
1786.399,6,102,8364,68,66,26662,66,4964,34,60,54130,60,3400
0.031,17,2,138,1,33,0,33,61,1,49,0,49,77
898.919,6,77,17043,44,136,20905,721,6276,33,629,2218,1440,10767
1770.968,6,101,9344,66,65,27245,65,5577,35,59,52084,59,3767
306.143,6,45,3249,18,64,18000,297,1554,27,47,11769,78,1695
0.011,17,2,251,1,31,0,31,59,1,164,0,164,192
1777.417,17,73,3060,72,14,25034,14,3024,1,8,0,8,36
1.618,6,13,2311,8,188,231,245,700,5,1407,341,1407,1611
0.667,6,26,6095,13,108,55,147,959,13,768,52,1581,5136
5.05,17,4,288,2,36,5018,36,128,2,52,5018,52,160
0.007,17,2,253,1,29,0,29,57,1,168,0,168,196
0.338,17,2,237,1,72,0,72,100,1,109,0,109,137
75.663,6,33,7699,12,156,28,267,1272,21,348,3782,1420,6427
1772.203,6,180,15480,120,69,14892,69,8940,60,69,30036,69,6540
1783.81,6,364,24854,212,94,8454,469,14496,152,69,11813,69,10358
1797.339,17,449,39928,404,35,4459,288,25708,45,288,40015,288,14220
26.878,17,40,11575,16,350,1789,1350,6053,24,202,1167,1350,5522
0.036,17,2,602,1,46,0,46,74,1,500,0,500,528
0.011,17,2,912,1,308,0,308,336,1,548,0,548,576
131.183,17,4,1344,4,308,43727,308,1344,0,0,0,0,0
5.6,6,44,8385,22,227,266,314,4062,22,491,254,1179,4323
1680.424,1,15,840,15,28,120030,28,840,0,0,0,0,0
62.06,6,46,9056,21,401,840,889,2148,25,327,2580,1360,6908
0.201,17,2,456,2,200,201,352,456,0,0,0,0,0
1.686,6,25,4631,12,165,153,456,1446,13,415,139,888,3185
0.5,17,2,204,1,34,0,34,62,1,114,0,114,142
1.105,6,29,12044,17,529,69,1360,3370,12,1022,83,3921,8674
20.159,6,20,3130,11,183,2015,517,1509,9,381,2517,499,1621
316.967,6,109,36100,55,553,5869,1360,24911,54,322,5978,3289,11189
111.981,6,26,6409,9,272,242,516,1180,17,324,6993,1452,5229
2.688,6,29,11140,14,164,194,267,1444,15,1112,180,2816,9696
280.348,6,28,7352,12,158,25486,267,1277,16,603,18681,1400,6075
1750.407,6,95,7203,63,38,28232,205,4476,32,33,56457,98,2727
0.139,6,9,1343,5,145,34,145,349,4,830,41,830,994
0.389,6,10,1992,5,288,91,288,508,5,424,53,434,1484
1082.927,2,11,352,11,8,108292,8,352,0,0,0,0,0
0.263,17,2,152,1,48,0,48,76,1,48,0,48,76
14.694,17,6,528,3,48,7341,48,228,3,72,7342,72,300
1.237,6,50,20105,30,882,42,1360,14484,20,437,56,2715,5621
1792.608,6,356,22520,208,69,8659,69,12460,148,69,12194,69,10060
158.505,6,36,10617,15,271,11316,1189,2782,21,436,7924,1420,7835
1798.937,6,379,26406,218,97,8290,469,15481,161,69,11241,69,10925
1786.506,6,102,8296,68,65,26664,65,4930,34,59,54133,59,3366
1699.898,17,12,498,11,14,169989,14,462,1,8,0,8,36
1795.721,17,142,11360,71,48,25653,48,5396,71,56,25653,56,5964
0.284,6,22,4467,11,165,28,456,1394,11,498,26,888,3073
1797.888,6,334,23571,193,103,9363,469,13722,141,69,12839,69,9849
4.221,17,5,290,5,30,1055,30,290,0,0,0,0,0
4.868,17,5,4754,5,922,1217,1451,4754,0,0,0,0,0
1.044,17,4,352,2,37,0,37,130,2,83,0,89,222
0.561,6,13,1175,7,146,92,146,430,6,250,111,499,745
1741.274,1,30,1680,30,28,60043,28,1680,0,0,0,0,0
294.718,1,10,560,10,28,32746,28,560,0,0,0,0,0
20.288,6,20,3130,12,183,1844,517,1561,8,381,2896,499,1569
0.634,6,15,1785,8,288,63,288,640,7,426,74,434,1145
71.509,6,118,127716,77,430,940,647,5434,41,3533,1757,22528,122282
1787.374,6,102,8296,68,65,26677,65,4930,34,59,54158,59,3366
0.933,6,4,227,1,0,0,0,40,3,31,465,31,187
18.511,6,1871,1738652,1143,1438,16,1448,1694104,728,776,24,1448,44548
1785.896,6,433,26047,218,69,8229,69,12998,215,36,8345,69,13049
1795.842,17,449,39928,404,35,4456,288,25708,45,288,40017,288,14220
180.222,17,4,934,2,33,180198,33,122,2,378,180198,378,812
0.428,6,121,87139,55,131,7,232,2729,66,1362,6,2840,84410
5.047,17,3,208,2,36,5001,36,128,1,52,0,52,80
156.726,6,22,8784,11,325,83,634,1447,11,983,15655,1360,7337
784.298,17,1910,1063573,1033,819,745,1350,875869,877,186,895,1350,187704
300.251,6,31,11809,17,588,18765,1438,4434,14,948,18483,1488,7375
0.082,6,33,8043,17,131,5,131,1023,16,441,5,500,7020
24.501,6,21,3917,10,234,2702,564,1476,11,463,2432,1343,2441
1798.731,6,373,26097,216,98,8366,469,15263,157,69,11529,69,10834
1797.842,17,180,14040,180,50,10043,50,14040,0,0,0,0,0
47.323,17,3,1038,3,318,23661,329,1038,0,0,0,0,0
0.929,6,28,5967,13,156,77,267,1462,15,650,60,1420,4505
1741.347,17,28,29568,28,1028,64494,1028,29568,0,0,0,0,0
1742.348,1,69,5796,69,56,25622,56,5796,0,0,0,0,0
1797.537,17,453,40680,406,36,4438,288,26076,47,282,38285,288,14604
1791.495,17,87,3648,86,14,21076,14,3612,1,8,0,8,36
0.854,6,2,87,1,0,0,0,40,1,7,0,7,47
0.027,6,10,1671,6,552,4,948,1348,4,159,8,159,323
0.406,6,9,1343,5,145,101,145,349,4,830,132,830,994
22.835,6,39,13218,13,189,1902,189,1107,26,526,880,1360,12111
137.683,17,4,352,2,60,137682,60,176,2,60,137682,60,176
166.633,6,61,10859,28,212,4523,1189,3462,33,337,5207,1420,7397
113.88,6,19,5958,10,216,12653,501,1270,9,617,7005,1420,4688
5.904,6,40,8461,21,218,295,314,3463,19,604,313,1179,4998
1792.084,17,87,3648,86,14,21083,14,3612,1,8,0,8,36
1.656,6,27,9078,13,263,138,691,1736,14,943,108,1448,7342
12.627,6,15,1666,8,180,1803,180,952,7,110,2074,110,714
4.194,6,6,328,4,0,1398,0,216,2,0,4170,0,112
8.269,6,22,9422,11,275,826,275,723,11,1178,583,1440,8699
4.734,6,40,7309,19,218,263,314,3383,21,513,222,1179,3926
27.524,6,4,559,4,87,9174,128,559,0,0,0,0,0
0.04,17,2,279,1,36,0,36,64,1,187,0,187,215
0.241,6,43,17636,24,972,10,1420,12655,19,467,12,1883,4981
1791.138,1,342,28728,342,56,5252,56,28728,0,0,0,0,0
181.169,6,21,8903,11,356,72,767,1542,10,1158,20113,2521,7361
1786.807,6,102,8364,68,66,26668,66,4964,34,60,54141,60,3400
0.276,17,2,196,1,62,0,62,90,1,78,0,78,106
10.737,6,20,4390,11,275,1073,275,998,9,755,743,1414,3392
77.16,6,138,35618,68,455,1151,1440,21023,70,335,1111,1702,14595
1772.329,6,180,15480,120,69,14893,69,8940,60,69,30033,69,6540
1.429,6,54,23915,30,996,49,1460,18179,24,476,53,2615,5736
6.392,17,32,6507,12,222,581,1350,3008,20,146,234,1350,3499
127.368,6,23,9997,12,531,69,1360,2625,11,1384,12724,3934,7372
3.228,6,22,6401,10,262,353,517,1316,12,744,289,1418,5085
60.207,17,4,304,4,48,20069,48,304,0,0,0,0,0
1.619,6,13,2311,8,188,231,245,700,5,1407,344,1407,1611
1793.294,17,87,3648,86,14,21097,14,3612,1,8,0,8,36
0.024,17,2,439,1,39,0,39,67,1,344,0,344,372
33.577,6,32,5159,15,180,2385,722,1872,17,299,2087,1440,3287
10.827,6,20,4442,11,275,1082,275,998,9,768,745,1440,3444
0.478,17,3,451,2,39,449,39,134,1,289,0,289,317
0.379,6,10,968,5,256,92,256,460,5,304,92,304,508
1.432,6,38,8324,19,332,79,1234,2788,19,433,69,1460,5536
12.33,6,30,7432,13,158,1027,267,1317,17,543,769,1400,6115
4.834,17,2,656,2,300,4834,300,656,0,0,0,0,0
20.33,6,23,5534,13,107,1694,159,1126,10,967,2252,1709,4408
1789.143,6,4633,4347888,1652,128,1083,349,96565,2981,1409,600,2836,4251323
17.192,6,2739,2515573,1737,1369,9,1408,2458805,1002,931,16,2816,56768
1224.151,6,125,10727,83,69,14928,69,6149,42,69,29857,69,4578
0.401,6,10,968,5,256,96,256,460,5,304,96,304,508
1787.525,17,87,3648,86,14,21029,14,3612,1,8,0,8,36
0.015,6,2,113,1,21,0,21,73,1,0,0,0,40
381.923,6,51,6560,23,125,17360,722,2456,28,196,11168,1448,4104
0.001,6,2,5700,1,0,0,0,40,1,5608,0,5608,5660
1770.136,6,210,16257,78,70,22987,314,7749,132,48,13512,78,8508
16.404,17,29,13910,14,708,1259,1350,10311,15,211,1169,1350,3599
1778.267,6,141,8766,78,45,23091,208,5347,63,31,28678,31,3419
1792.55,6,356,22520,208,69,8659,69,12460,148,69,12193,69,10060
6.881,6,1070,892845,604,1394,11,1448,863949,466,776,14,1448,28896
1771.99,6,180,15480,120,69,14890,69,8940,60,69,30032,69,6540
53.145,6,27,7177,13,155,4428,267,1306,14,530,4087,3417,5871
111.302,6,17,4467,8,531,188,1329,1945,9,716,13884,999,2522
1798.428,17,140,11200,70,48,26064,48,5320,70,56,26064,56,5880
1742.215,1,57,4788,57,56,31110,56,4788,0,0,0,0,0
1682.119,17,14,1036,7,30,280347,30,406,7,62,280347,62,630
0.261,17,2,136,1,32,0,32,60,1,48,0,48,76
1749.572,6,95,7203,63,38,28218,205,4476,32,33,56428,98,2727
251.681,2,2,64,2,8,251681,8,64,0,0,0,0,0
1111.136,17,13,1271,13,69,92594,355,1271,0,0,0,0,0
2.089,17,4,706,3,39,1000,39,201,1,477,0,477,505
0.017,17,4,344,2,47,1,47,150,2,69,4,75,194
0.706,6,32,9725,19,649,39,1360,4703,13,498,45,1384,5022
250.698,6,59,30286,33,1028,4825,1360,19880,26,779,10021,3107,10406
1776.055,17,140,11200,70,48,25739,48,5320,70,56,25739,56,5880
1.951,6,27,10193,16,287,130,594,1506,11,1030,176,1420,8687
4.803,17,5,320,5,36,1200,36,320,0,0,0,0,0
1790.604,1,342,28728,342,56,5251,56,28728,0,0,0,0,0
8.266,6,66,20142,33,562,258,1152,15379,33,491,250,1179,4763
1.222,6,28,8160,15,222,73,540,1964,13,944,85,1591,6196
95.65,1,6,336,6,28,19130,28,336,0,0,0,0,0
14.26,6,25,7097,12,155,1296,267,1266,13,589,1187,3426,5831
132.324,17,4,240,2,32,132323,32,120,2,32,132322,32,120
1796.658,6,356,22520,208,69,8679,69,12460,148,69,12222,69,10060
240.21,6,54,17464,29,766,8578,1402,14541,25,201,10008,580,2923
0.8,17,2,144,1,36,0,36,64,1,52,0,52,80
0.9,6,11,1727,7,100,150,100,384,4,589,212,1152,1343
1791.588,6,364,24923,212,94,8490,469,14427,152,69,11864,69,10496
1766.365,1,86,4816,86,28,20780,28,4816,0,0,0,0,0
54.972,6,18,2515,6,188,1088,245,620,12,1407,4975,1407,1895
5.03,17,3,257,2,37,5007,37,130,1,99,0,99,127
316.665,6,69,12356,31,350,10555,1366,6525,38,213,8558,1389,5831
13.811,17,12,1008,6,45,2760,45,438,6,67,2760,73,570
1.658,6,13,2311,8,188,236,245,700,5,1407,352,1407,1611
0.462,17,2,778,2,361,462,361,778,0,0,0,0,0
1744.742,6,106,7973,67,38,26435,205,4715,39,32,45905,98,3258
1410.117,17,13,946,7,30,234975,30,406,6,62,281974,62,540
0.181,6,9,1339,5,145,45,145,349,4,826,36,826,990
270.263,17,42,11168,42,237,6591,464,11168,0,0,0,0,0
0.96,6,11,1727,7,100,160,100,384,4,589,239,1152,1343
0.196,17,2,152,1,48,0,48,76,1,48,0,48,76
0.238,17,2,218,1,65,0,65,93,1,97,0,97,125
0.784,6,17,5164,9,150,98,174,664,8,835,98,1452,4500
286.326,6,29,6564,15,290,20448,517,1369,14,1115,22023,2459,5195
556.469,1,50,5200,0,0,0,0,0,50,76,11356,76,5200
70.151,17,16,17302,16,1053,4676,1060,17302,0,0,0,0,0
301.118,6,50,25928,29,782,10754,1408,8657,21,1347,1782,6858,17271
32.817,6,11,1003,6,332,6563,332,652,5,83,8193,83,351
5.831,6,39,7285,21,218,291,314,3463,18,516,327,1179,3822
0.134,17,7,2368,7,310,22,354,2368,0,0,0,0,0
1773.004,6,203,22290,130,75,13744,267,10057,73,134,24621,1997,12233
0.768,6,37,8338,19,268,42,727,1865,18,441,36,1460,6473
217.583,6,30,7432,13,158,18131,267,1317,17,543,13594,1300,6115
621.726,1,20,1120,20,28,32722,28,1120,0,0,0,0,0
0.969,17,4,560,2,64,968,64,184,2,160,846,160,376
216.961,6,30,6817,11,189,11006,516,1390,19,291,12048,1452,5427
176.026,6,61,37398,37,1144,4889,1408,29409,24,748,2669,1408,7989
1799.69,17,449,39928,404,35,4465,288,25708,45,288,40017,288,14220
252.135,2,2,64,2,8,252135,8,64,0,0,0,0,0
0.096,17,2,198,1,39,0,39,67,1,103,0,103,131
33.859,6,28,4937,14,154,2604,722,1807,14,479,2585,1408,3130
81.014,6,147,121401,91,1319,899,1368,112932,56,625,1472,1368,8469
1772.548,6,180,15480,120,69,14895,69,8940,60,69,30034,69,6540
1787.559,6,102,8274,68,64,26679,65,4919,34,58,54164,59,3355
0.522,6,10,968,5,256,128,256,460,5,304,127,304,508
1781.37,17,213,55264,213,231,8402,422,55264,0,0,0,0,0
1797.7,1,345,28980,345,56,5225,56,28980,0,0,0,0,0
184.935,6,48,6804,22,155,8799,722,2707,26,172,7390,1408,4097
1795.692,1,58,4872,58,56,31503,56,4872,0,0,0,0,0
15.278,6,2416,2195784,1513,1364,9,1368,2132352,903,776,16,1473,63432
0.85,6,20,9025,10,121,94,121,649,10,1121,94,1448,8376
0.505,17,3,543,2,39,27,39,134,1,381,0,381,409
1.255,6,45,18084,26,882,50,1360,12548,19,476,60,2715,5536
0.02,6,10,1544,5,505,4,505,773,5,503,4,503,771
1190.157,6,147,11322,56,72,21635,347,5499,91,48,13222,78,5823
0.484,6,27,9064,13,252,40,646,1694,14,947,35,1438,7370
1795.89,1,254,26924,254,78,7098,78,26924,0,0,0,0,0
0.046,17,2,292,1,53,0,53,81,1,183,0,183,211
1.739,6,4,172,2,0,1739,0,84,2,0,307,0,88
107.084,6,20,8672,11,314,68,634,1415,9,1377,13370,3928,7257
69.9,17,2,150,2,47,69900,47,150,0,0,0,0,0
280.191,6,28,7352,13,158,23349,267,1317,15,678,20011,3436,6035
0.028,17,4,480,3,60,10,60,264,1,188,0,188,216
1787.441,17,87,3648,86,14,21028,14,3612,1,8,0,8,36
76.448,6,31,7816,9,155,2614,267,1146,22,321,3639,1420,6670
1680.805,1,15,840,15,28,120057,28,840,0,0,0,0,0
0.773,17,21,15177,12,1045,67,1350,12876,9,227,92,1350,2301
1795.22,17,87,3648,86,14,21120,14,3612,1,8,0,8,36
281.285,6,32,7650,13,158,23440,267,1317,19,464,15606,1400,6333
0.731,17,23,14511,11,589,73,1350,6791,12,615,60,1350,7720
72.005,1,2,112,2,28,72005,28,112,0,0,0,0,0
8.027,6,15,2391,8,188,1146,245,700,7,703,1295,1152,1691
1.22,17,6,1002,3,32,607,32,180,3,246,313,246,822
1796.221,17,142,11360,71,48,25660,48,5396,71,56,25660,56,5964
0.202,17,4,300,2,39,200,39,134,2,55,198,55,166
0.252,17,2,384,1,39,0,39,67,1,289,0,289,317
7.323,6,1467,1305883,895,1380,7,1408,1271475,572,931,12,2816,34408
69.082,6,30,7297,14,155,5314,267,1346,16,441,4604,1420,5951
0.244,6,9,527,5,43,61,43,311,4,0,38,0,216
78.101,6,22,8510,11,313,68,632,1413,11,949,7797,1440,7097
52.561,2,2,64,2,8,52561,8,64,0,0,0,0,0
1684.504,2,29,928,29,8,60160,8,928,0,0,0,0,0
2.872,17,15,7930,7,657,478,1350,4796,8,363,405,1350,3134
363.537,6,25,1651,17,177,22721,177,1117,8,110,9152,110,534
1.344,6,47,18993,26,946,53,1460,13377,21,433,58,1460,5616
1797.433,17,345,26220,345,48,5225,48,26220,0,0,0,0,0
755.971,2,4,128,4,8,251990,8,128,0,0,0,0,0
1.356,6,38,9848,20,502,71,1460,4352,18,433,68,1460,5496
99.631,6,187,138203,111,1292,905,1408,124714,76,680,1225,2439,13489
2.114,6,4,208,4,0,0,0,208,0,0,0,0,0
299.551,6,6,364,4,31,99850,31,222,2,31,299529,31,142
789.414,6,163,16173,80,139,9990,208,12295,83,31,9624,31,3878
0.479,6,55,21843,31,954,15,1380,16584,24,387,19,1923,5259
240.575,6,42,8692,21,577,12028,1402,5723,21,233,12028,580,2969
1.481,6,44,11556,23,616,67,1460,5895,21,437,64,2615,5661
1782.433,17,83,3480,82,14,22005,14,3444,1,8,0,8,36
1.996,6,13,2311,8,188,285,245,700,5,1407,437,1407,1611
1.231,17,4,352,2,60,1230,60,176,2,60,1230,60,176
9.258,2,3,96,3,8,4629,8,96,0,0,0,0,0
0.508,17,3,543,2,39,40,39,134,1,381,0,381,409
0.285,6,27,9064,13,252,23,646,1694,14,947,21,1402,7370
0.17,6,41,29976,18,180,10,250,1486,23,1299,6,1440,28490
280.168,6,30,7432,13,158,23347,267,1317,17,543,17510,1400,6115
1799.098,17,449,39928,404,35,4464,288,25708,45,288,40017,288,14220
1744.708,2,19,608,19,8,96928,8,608,0,0,0,0,0
1.079,17,2,144,1,36,0,36,64,1,52,0,52,80
1.517,6,43,11458,22,547,72,1360,5842,21,433,64,1360,5616
300.743,6,40,13572,23,892,13670,1360,8090,17,479,537,4027,5482
0.669,6,33,10798,16,322,44,652,1639,17,705,30,1928,9159
20.153,6,23,5805,13,107,1679,159,1138,10,827,2238,1674,4667
1795.919,17,80,3354,79,14,23024,14,3318,1,8,0,8,36
11.588,6,1814,1588759,1102,1387,10,1420,1556034,712,467,16,1883,32725
6.955,17,29,8994,14,374,532,1350,5632,15,196,494,1350,3362
3.643,17,5,295,5,31,910,31,295,0,0,0,0,0
1.384,6,49,19736,29,921,49,1360,14115,20,437,63,2715,5621
1.074,17,4,644,2,33,1000,33,122,2,233,0,233,522
0.511,6,10,1380,5,145,127,145,349,5,827,86,827,1031
21.383,17,31,16126,16,543,1423,1350,9136,15,438,1524,1350,6990
1796.157,6,356,22520,208,69,8677,69,12460,148,69,12218,69,10060
1799.883,6,393,34817,215,119,8410,1189,17066,178,126,10168,1420,17751
0.144,1,2,112,2,28,144,28,112,0,0,0,0,0
5.139,6,40,7325,22,218,244,314,3503,18,516,287,1179,3822
280.385,6,30,7432,13,158,23365,267,1317,17,543,17522,1400,6115
141.832,6,34,19894,19,702,1541,1360,5055,15,1422,10121,5223,14839
0.352,6,10,1386,5,145,88,145,349,5,833,83,833,1037
0.281,6,27,7296,13,155,23,267,1301,14,603,17,1400,5995
107.586,6,31,7182,13,230,159,502,1676,18,318,6323,1420,5506
1744.658,2,27,864,27,8,67102,8,864,0,0,0,0,0
0.229,6,3,120,2,0,229,0,80,1,0,0,0,40
5.722,6,40,7309,19,218,317,314,3383,21,440,272,1152,3926
59.876,6,76450,91302899,19738,184,3,214,1026937,56712,1540,1,11264,90275962
10.356,6,1845,1698523,1170,1373,8,1408,1658759,675,931,15,2816,39764
11.023,6,22,4526,12,275,1002,275,1038,10,768,687,1440,3488
2.454,6,10,541,4,0,818,0,204,6,7,452,7,337
1796.865,6,381,26555,219,97,8242,469,15590,162,69,11157,69,10965
1653.999,17,94,7520,47,48,35956,48,3572,47,56,35956,56,3948
1776.545,1,156,16536,156,78,11461,78,16536,0,0,0,0,0
0.068,17,8,2758,8,316,9,355,2758,0,0,0,0,0
0.735,6,13,3096,6,92,147,92,412,7,463,56,1408,2684
1797.475,6,356,22589,207,69,8725,69,12420,149,69,12145,69,10169
0.204,17,5,1752,5,322,51,353,1752,0,0,0,0,0
180.468,2,3,96,3,8,90234,8,96,0,0,0,0,0
1.846,17,4,756,2,30,1804,30,116,2,292,1834,292,640
4.295,6,2,92,1,0,0,0,40,1,0,0,0,52
1681.691,17,14,1036,7,30,280279,30,406,7,62,280280,62,630
1790.453,17,142,11360,71,48,25577,48,5396,71,56,25577,56,5964
1798.865,17,468,57541,210,172,8593,1350,42012,258,32,6999,60,15529
123.977,17,4,352,2,60,123976,60,176,2,60,123976,60,176
1781.747,6,173,9269,86,0,20961,0,4472,87,30,20717,31,4797
1790.729,1,342,28728,342,56,5251,56,28728,0,0,0,0,0
1791.484,1,106,5936,106,28,17061,28,5936,0,0,0,0,0
227.354,6,30,7432,13,158,18946,267,1317,17,603,14207,2076,6115
280.412,6,31,7472,13,158,23367,267,1317,18,543,16491,1380,6155
1022.746,2,11,352,11,8,102274,8,352,0,0,0,0,0
1681.938,1,15,840,15,28,120138,28,840,0,0,0,0,0
0.28,17,2,136,1,32,0,32,60,1,48,0,48,76
1787.005,6,102,8296,68,65,26671,65,4930,34,59,54148,59,3366
879.976,6,127,18827,67,91,13332,721,6608,60,408,14898,2391,12219
11.685,6,8,460,3,0,5842,0,160,5,0,2054,0,300
4.094,6,28,8931,13,231,341,764,1852,15,895,285,2366,7079
22.18,6,3181,2995350,2022,1402,10,1448,2930418,1159,776,19,1448,64932
0.031,17,4,320,2,44,0,44,144,2,60,8,60,176
1749.534,6,94,7151,62,38,28680,205,4424,32,33,56423,98,2727
1786.95,6,104,8308,68,64,26670,64,4896,36,58,51053,58,3412
1772.854,6,183,15738,121,69,14773,69,8980,62,69,29060,69,6758
1740.083,6,123,7652,70,43,25218,208,4633,53,31,33453,31,3019
0.112,6,12,3462,6,75,22,75,395,6,1373,22,1448,3067
60.475,17,21,2432,17,55,3779,288,1416,4,226,13488,288,1016
1776.332,6,81,4302,41,26,44407,26,2184,40,26,45545,26,2118
1789.439,17,86,3606,85,14,21302,14,3570,1,8,0,8,36
1799.998,6,271,18812,105,46,17012,46,7618,166,46,10909,46,11194
1.242,6,49,19179,27,886,47,1360,13523,22,433,50,1360,5656
280.306,6,30,7432,13,158,23358,267,1317,17,543,17515,1400,6115
82.439,6,17,692,7,0,7971,0,284,10,0,9158,0,408
329.218,6,41,7572,17,153,13566,516,1760,24,255,14310,1452,5812
0.08,17,2,572,1,39,0,39,67,1,477,0,477,505
0.395,6,2,100,1,0,0,0,60,1,0,0,0,40
1775.284,17,140,11200,70,48,25728,48,5320,70,56,25728,56,5880
11.631,6,1840,1602740,1113,1385,10,1420,1569439,727,467,16,1883,33301
598.186,6,9,546,6,31,119637,31,333,3,31,299081,31,213
1022.744,2,13,416,13,8,85228,8,416,0,0,0,0,0
1.471,17,6,840,3,64,605,64,276,3,160,605,160,564
1.443,6,39,8127,19,293,80,998,2551,20,433,66,1460,5576
3.475,17,5,556,4,64,1151,64,368,1,160,0,160,188
276.361,17,4,240,2,32,276360,32,120,2,32,276360,32,120
1788.634,1,342,28728,342,56,5245,56,28728,0,0,0,0,0
10.882,6,20,4402,11,275,1088,275,998,9,758,763,1420,3404
190.967,6,31,8912,14,158,14689,267,1357,17,687,11934,2036,7555
2.124,6,2,111,1,0,0,0,40,1,31,0,31,71
368.495,6,25,1651,17,177,23030,177,1117,8,110,9215,110,534
1.079,6,10,968,5,256,267,256,460,5,304,267,304,508
1022.156,6,131,8898,51,46,20443,46,3812,80,46,12936,46,5086
0.327,6,21,7281,11,334,32,663,1917,10,806,35,1408,5364
4.528,6,14,1247,7,222,753,222,728,7,231,752,231,519
175.214,17,2,72,1,8,0,8,36,1,8,0,8,36
0.036,17,2,279,1,36,0,36,64,1,187,0,187,215
1782.164,1,58,4872,58,56,31266,56,4872,0,0,0,0,0
1741.358,17,29,6815,29,207,62191,207,6815,0,0,0,0,0
39.141,17,4,1344,4,308,13047,308,1344,0,0,0,0,0
1798.805,17,449,39928,404,35,4463,288,25708,45,288,40018,288,14220
267.452,17,4,240,2,32,267451,32,120,2,32,267451,32,120
1783.01,17,142,11360,71,48,25470,48,5396,71,56,25470,56,5964
1798.151,1,345,28980,345,56,5227,56,28980,0,0,0,0,0
0.017,17,2,396,1,59,0,59,87,1,281,0,281,309
26.811,6,38,9327,18,321,1577,721,2972,20,504,1357,1440,6355
8.223,17,6,456,6,48,1644,48,456,0,0,0,0,0
183.699,6,240,199354,152,1352,1216,1448,183800,88,645,1960,2359,15554
523.327,17,31,10416,31,308,17444,308,10416,0,0,0,0,0
22.951,6,3426,3174707,2196,1366,10,1408,3106083,1230,931,18,2816,68624
1780.81,6,356,22589,208,69,8602,69,12460,148,69,12114,69,10129
381.201,6,18,1242,14,180,29323,180,916,4,110,20058,110,326
1788.012,6,106,7067,66,54,27507,208,4537,40,31,45838,31,2530
52.983,6,37,8495,18,410,508,882,1982,19,441,2936,1460,6513
1790.592,1,58,4872,58,56,31413,56,4872,0,0,0,0,0
1787.024,17,87,3648,86,14,21023,14,3612,1,8,0,8,36
0.041,17,2,144,1,44,0,44,72,1,44,0,44,72
0.593,17,15,8508,8,705,84,1350,5870,7,348,89,1350,2638
9.946,6,16,1113,8,222,1419,222,546,8,231,1419,231,567
1798.827,17,449,39928,404,35,4463,288,25708,45,288,40016,288,14220
1746.635,6,95,7203,63,38,28171,205,4476,32,33,56329,98,2727
1767.763,1,14,2219,14,130,135981,351,2219,0,0,0,0,0
1443.855,2,19,608,19,8,80214,8,608,0,0,0,0,0
1789.777,6,365,23225,211,69,8522,69,12718,154,69,11697,69,10507
14.97,6,15,3204,6,92,2994,92,400,9,577,1844,1408,2804
1682.728,17,16,1265,8,30,240378,37,471,8,71,240387,136,794
0.736,6,2,80,1,0,0,0,40,1,0,0,0,40
1684.307,17,17,4255,17,222,105269,1072,4255,0,0,0,0,0
0.329,6,21,6086,11,316,32,592,1846,10,928,35,1897,4240
1797.847,6,355,22480,207,69,8727,69,12420,148,69,12229,69,10060
7.977,6,19,8351,9,275,997,275,643,10,1216,864,1440,7708
116.636,6,40,22724,21,708,90,1460,4462,19,1249,6465,2856,18262
1793.949,6,356,22520,208,69,8666,69,12460,148,69,12200,69,10060
4.356,6,37,7189,19,218,242,314,3383,18,513,241,1179,3806
65.701,6,32,7963,10,174,62,267,1453,22,330,3128,1460,6510
1.164,17,2,178,1,29,0,29,57,1,93,0,93,121
300.896,6,50,20423,28,1045,11144,1460,14741,22,435,414,2920,5682
368.945,6,23,1535,16,177,24596,177,1053,7,110,10372,110,482
1.763,17,20,5190,20,231,92,389,5190,0,0,0,0,0
1794.394,17,140,11200,70,48,26005,48,5320,70,56,26005,56,5880
0.459,6,7,371,4,0,153,0,204,3,7,125,7,167
0.038,17,4,680,2,33,0,33,122,2,251,0,323,558
281.1,6,31,7610,13,158,23425,267,1317,18,506,16509,1400,6293
0.179,17,2,152,2,48,179,48,152,0,0,0,0,0
1782.703,1,14,784,14,28,137131,28,784,0,0,0,0,0
1787.57,6,107,8428,68,64,26680,64,4896,39,58,47039,58,3532
19.402,17,27,6758,13,307,1614,1350,4355,14,143,1489,1350,2403
1786.767,6,122,14349,76,83,23823,516,6038,46,153,39702,1452,8311
8.534,6,74,46110,46,1135,189,1460,32552,28,1035,310,1580,13558
2.575,17,4,624,4,128,858,128,624,0,0,0,0,0
1699.524,1,8,448,8,28,242789,28,448,0,0,0,0,0
1771.442,6,117,10931,73,70,24603,234,6376,44,60,41194,83,4555
1704.906,1,8,448,8,28,243558,28,448,0,0,0,0,0
659.375,17,170,18587,78,140,8563,1350,13133,92,31,7222,61,5454
68.368,6,580,271269,305,829,224,1152,254407,275,418,248,1179,16862
16.752,17,16,2588,8,48,2391,48,608,8,219,2390,308,1980
0.097,6,10,1495,5,507,24,507,727,5,556,18,556,768
6.863,6,23,4490,12,213,623,597,1689,11,552,664,1767,2801
300.683,6,42,8894,23,322,13667,941,2288,19,448,501,4848,6606
5.006,17,4,542,2,36,5001,36,128,2,179,5000,187,414
300.84,6,46,10095,23,641,13674,1460,4218,23,290,682,1460,5877
0.456,6,7,371,4,0,152,0,204,3,7,106,7,167
45.12,17,4,304,2,48,45109,48,152,2,48,45108,48,152
0.027,6,2,355,2,275,27,275,355,0,0,0,0,0
1772.253,6,180,15480,120,69,14892,69,8940,60,69,30032,69,6540
1787.203,6,115,13590,75,79,24151,478,5861,40,161,45823,1452,7729
93.109,17,8,2688,8,308,13301,308,2688,0,0,0,0,0
131.128,6,69,46361,44,1162,3049,1408,38326,25,961,2566,3847,8035
238.045,6,31,2034,12,43,18913,46,875,19,44,13224,46,1159
1798.804,6,367,25650,214,99,8445,469,15045,153,69,11830,69,10605
5.312,6,40,7309,21,218,265,314,3463,19,440,280,1152,3846
0.185,6,2,1175,1,0,0,0,40,1,1095,0,1095,1135
1726.464,17,12,498,11,14,172646,14,462,1,8,0,8,36
1772.19,6,180,15480,120,69,14892,69,8940,60,69,30036,69,6540
0.512,17,3,451,2,39,324,39,134,1,289,0,289,317
47.43,6,28,7217,13,155,3952,267,1306,15,482,3387,2840,5911
31.277,6,8,348,2,0,10,0,84,6,0,6253,0,264
5.603,6,55,19714,28,839,207,1360,13750,27,324,208,2720,5964
0.243,6,11,742,6,71,48,71,391,5,83,33,83,351
1.668,6,37,15750,19,301,92,708,2056,18,997,86,1360,13694
280.262,6,28,7352,12,158,25478,267,1277,16,603,18680,1400,6075
300.64,6,29,9386,16,156,20042,285,1491,13,721,5501,1408,7895
19.108,6,16,1327,8,222,2728,222,768,8,231,2728,231,559
1799.474,17,4200,201600,2100,20,857,20,100800,2100,20,857,20,100800
1744.709,2,27,864,27,8,67104,8,864,0,0,0,0,0
340.371,17,5,1672,5,306,85092,308,1672,0,0,0,0,0
9.959,17,3,267,2,44,9928,44,144,1,95,0,95,123
1794.108,17,80,3354,79,14,23001,14,3318,1,8,0,8,36
46.002,6,2929,2798476,1832,1444,25,1448,2732541,1097,1116,41,1448,65935
23.709,6,1799,1656688,1087,1439,21,1448,1611060,712,776,32,1448,45628
301.033,6,46,13158,21,783,15042,1360,7139,25,278,12535,2667,6019
0.02,17,4,398,2,46,0,46,148,2,97,0,103,250
0.479,17,2,776,2,360,479,360,776,0,0,0,0,0
1771.329,6,103,9514,66,66,27251,66,5610,37,60,49200,60,3904
175.183,17,2,72,1,8,0,8,36,1,8,0,8,36
0.083,6,9,1348,5,145,20,145,349,4,835,21,835,999
1717.316,1,18,1008,18,28,101018,28,1008,0,0,0,0,0
0.037,17,2,212,1,46,0,46,74,1,110,0,110,138
180.502,2,3,96,3,8,90251,8,96,0,0,0,0,0
43.007,17,45,6308,23,48,1951,48,1748,22,179,2045,308,4560
0.072,6,20,9141,10,96,7,96,624,10,1141,8,1448,8517
3.969,17,8,668,4,39,1315,39,268,4,72,1234,72,400
2.354,17,7,1532,4,64,783,64,368,3,360,1173,360,1164
0.918,17,4,960,2,64,913,64,184,2,360,912,360,776
240.298,6,43,9025,21,515,12014,1402,5742,22,236,11442,639,3283
3.347,6,21,6351,10,262,367,517,1316,11,744,330,1418,5035
1795.333,17,448,39896,403,35,4466,288,25676,45,288,40022,288,14220
1741.213,6,87,6322,58,31,30547,31,3915,29,31,62181,31,2407
0.234,6,19,4920,10,137,26,267,1092,9,866,28,2867,3828
79.959,6,93,65325,59,1205,1378,1368,56116,34,619,2414,2519,9209
310.274,6,23,2744,7,221,51711,517,1270,16,323,20684,499,1474
280.213,6,28,7352,13,158,23351,267,1317,15,678,20012,2045,6035
240.449,6,55,23877,25,539,10018,1402,6161,30,949,8291,2804,17716
0.025,6,3,182,2,31,25,31,111,1,31,0,31,71
1789.458,6,364,25392,212,100,8480,469,14896,152,69,11850,69,10496
13.449,6,25,4961,13,180,1102,722,1766,12,513,1206,2026,3195
29.337,17,14,7736,8,655,4191,1350,5471,6,349,54,1350,2265
159.272,17,4,352,2,60,159271,60,176,2,60,159271,60,176
1744.016,6,95,7203,63,38,28129,205,4476,32,33,56245,98,2727
240.205,6,56,20326,30,841,8282,1418,17554,26,176,9607,580,2772
6.863,6,613,519976,369,1334,18,1368,501048,244,931,27,2736,18928
0.138,1,2,112,2,28,138,28,112,0,0,0,0,0
1772.169,6,180,15480,120,69,14892,69,8940,60,69,30031,69,6540
3.493,17,5,290,5,30,873,30,290,0,0,0,0,0
6.272,6,39,7269,21,218,313,314,3463,18,513,350,1179,3806
280.436,6,30,7432,13,158,23369,267,1317,17,603,17524,2076,6115
1773.175,6,180,15480,120,69,14900,69,8940,60,69,30046,69,6540
1.574,6,10,924,5,283,347,283,551,5,105,347,105,373
1786.816,1,175,9800,175,28,10269,28,9800,0,0,0,0,0
1685.976,17,16,5621,16,323,112398,548,5621,0,0,0,0,0
0.487,6,51,21890,29,973,17,1380,16768,22,421,20,1923,5122
149.031,6,37,26634,20,665,54,1360,4157,17,1815,9302,6800,22477
1.459,6,19,3781,10,234,162,564,1452,9,463,159,1343,2329
5.697,6,40,7309,20,218,299,314,3423,20,513,284,1179,3886
0.505,17,3,451,2,39,121,39,134,1,289,0,289,317
1680.535,1,15,840,15,28,120038,28,840,0,0,0,0,0
0.139,17,2,239,1,59,0,59,87,1,124,0,124,152
319.359,6,20,6511,5,98,79837,106,405,15,458,22810,1997,6106
0.212,1,2,112,2,28,212,28,112,0,0,0,0,0
1.44,6,40,9928,21,440,72,1360,4392,19,433,68,1360,5536
1.319,6,36,8172,19,320,73,1162,2716,17,529,71,4075,5456
1789.822,6,360,23319,210,76,8563,501,13041,150,69,12012,69,10278
1780.531,17,138,11024,71,48,25436,48,5396,67,56,25442,56,5628
1602.603,1,8,448,8,28,228943,28,448,0,0,0,0,0
1787.404,6,102,8228,68,64,26677,64,4896,34,58,54160,58,3332
28.735,2,2,64,2,8,28735,8,64,0,0,0,0,0
10.791,6,18,1415,9,222,1347,222,808,9,231,1347,231,607
1778.704,6,245,25130,99,68,18148,681,9328,146,136,12266,2720,15802
66.651,6,7909,7362018,4873,1425,13,1448,7189606,3036,776,21,1448,172412
2.844,6,30,10327,18,372,167,848,1840,12,1000,250,1452,8487
240.299,6,63,18763,31,804,8009,1418,15296,32,224,7750,580,3467
282.028,6,30,7432,13,158,23502,267,1317,17,543,17606,1400,6115
5.036,17,4,428,2,39,5036,39,134,2,119,4984,119,294
7.06,6,70,21266,36,524,201,1152,16138,34,470,206,1179,5128
1741.214,6,89,6488,60,31,29512,31,4081,29,31,62184,31,2407
37.071,6,29,5572,18,174,2180,517,2350,11,440,3703,499,3222
0.428,6,12,1653,6,288,78,288,548,6,426,46,434,1105
192.078,1,3,168,3,28,96039,28,168,0,0,0,0,0
1770.207,6,181,16901,120,83,14875,965,9836,61,75,29502,485,7065
1770.601,6,101,9344,66,65,27240,65,5577,35,59,52072,59,3767
61.853,6,72,48262,44,1179,1438,1408,40070,28,747,2282,1408,8192
842.289,2,11,352,11,8,84228,8,352,0,0,0,0,0
0.185,6,338,322487,212,184,0,275,12040,126,2450,1,11264,310447
61.849,6,70,49076,45,1172,1405,1408,41044,25,960,2567,3847,8032
188.409,6,30,7432,14,158,14493,267,1357,16,603,12558,2036,6075
0.184,6,17,1284,12,181,16,181,861,5,77,41,134,423
1786.16,6,104,8444,68,66,26659,66,4964,36,60,51030,60,3480
0.328,17,2,198,1,39,0,39,67,1,103,0,103,131
11.35,6,1842,1565108,1105,1361,10,1380,1531374,737,421,15,1923,33734
2.66,17,2,154,1,33,0,33,61,1,65,0,65,93
1.136,17,2,148,1,32,0,32,60,1,60,0,60,88
0.038,17,2,152,1,48,0,48,76,1,48,0,48,76
20.172,6,23,6180,14,117,1551,159,1337,9,873,2518,1675,4843
280.466,6,30,7432,13,158,23372,267,1317,17,603,17524,2760,6115
281.772,6,29,7392,13,158,23481,267,1317,16,543,18760,1400,6075
324.087,6,28,4819,12,200,29462,517,1848,16,428,21605,499,2971
8.207,6,22,9370,11,275,820,275,723,11,1170,525,1414,8647
75.238,6,22,6435,10,274,8354,517,1350,12,744,6835,1408,5085
2.272,17,3,451,2,39,908,39,134,1,289,0,289,317
16.057,6,6,328,4,0,5352,0,216,2,0,16042,0,112
1783.887,6,354,22440,207,69,8659,69,12420,147,69,12218,69,10020
1789.614,1,205,11480,205,28,8772,28,11480,0,0,0,0,0
165.254,6,20,2199,12,302,15023,302,1526,8,83,23587,83,673
1744.618,2,26,832,26,8,69784,8,832,0,0,0,0,0
597.993,6,13,830,6,31,119598,31,333,7,31,99663,31,497
229.234,1,6,336,6,28,45846,28,336,0,0,0,0,0
281.204,6,30,7432,13,158,23433,267,1317,17,543,17563,1400,6115
0.062,17,4,308,2,38,1,38,132,2,60,9,66,176
0.101,17,4,284,2,32,90,32,120,2,54,12,60,164
0.009,17,2,214,1,35,0,35,63,1,123,0,123,151
1471.676,17,372,33032,333,35,4432,288,21204,39,275,37916,288,11828
2.59,17,6,2149,6,330,518,361,2149,0,0,0,0,0
152.039,6,112,46706,62,908,2489,1368,34115,50,269,3099,2736,12591
1786.825,6,102,8296,68,65,26669,65,4930,34,59,54141,59,3366
92.947,6,36,8312,18,362,522,739,1839,18,478,5458,2128,6473
103.692,1,4,224,4,28,34564,28,224,0,0,0,0,0
12.217,6,16,4692,10,301,1357,517,1042,6,849,79,1611,3650
1788.412,1,63,5292,63,56,28845,56,5292,0,0,0,0,0
7.637,6,1233,1049181,743,1359,10,1420,1025194,490,427,15,1420,23987
1677.686,1,7,392,7,28,279614,28,392,0,0,0,0,0
1.661,6,50,19231,27,887,63,1360,13535,23,433,65,1360,5696
1796.585,17,447,39580,403,35,4469,288,25676,44,288,40946,288,13904
0.07,6,2,133,1,0,0,0,40,1,53,0,53,93
1.648,6,12,1163,6,222,326,222,688,6,231,326,231,475
121.47,6,11956,11468110,7774,1395,15,1448,11245862,4182,776,29,1448,222248
5.047,17,4,288,2,36,5006,36,128,2,52,5016,52,160
73.208,17,4,352,2,60,73207,60,176,2,60,73206,60,176
5.01,17,4,486,2,36,4996,36,128,2,151,5000,159,358
0.558,6,3,144,2,0,8,0,92,1,0,0,0,52
0.105,17,2,363,1,29,0,29,57,1,278,0,278,306
6.069,6,40,7309,21,218,303,314,3463,19,513,322,1179,3846
53.629,6,11,851,11,31,5362,31,851,0,0,0,0,0
1.499,17,22,12351,10,569,159,1350,5979,12,503,130,1350,6372
1785.552,17,136,10880,68,48,26649,48,5168,68,56,26649,56,5712
82.019,17,4,352,2,60,82017,60,176,2,60,82018,60,176
1770.241,6,100,9358,66,66,27234,66,5610,34,60,53640,60,3748
0.511,6,17,6337,9,141,63,275,646,8,894,30,1420,5691
28.349,6,40,8451,19,188,1445,721,2088,21,551,1408,1440,6363
0.009,17,2,212,1,46,0,46,74,1,110,0,110,138
300.19,6,54,19935,25,961,12500,1360,13527,29,261,10714,2667,6408
27.419,6,3979,3813451,2647,1364,10,1408,3739523,1332,776,20,1408,73928
0.674,6,39,11788,23,543,30,1188,7712,16,359,38,1048,4076
17.332,17,27,9749,12,453,1573,1350,5778,15,236,1235,1350,3971
20.137,17,8,1176,4,48,6709,48,304,4,190,6708,308,872
19.577,6,7,472,4,64,6525,64,352,3,0,4847,0,120
231.436,6,38,11049,20,531,12171,1360,4032,18,628,13603,2720,7017
160.772,6,19,1132,11,31,16060,31,688,8,31,22943,31,444
87.171,6,651,534711,422,1317,206,1360,517772,229,204,381,1360,16939
1.339,6,49,19015,28,874,49,1360,13399,21,476,57,2720,5616
257.934,17,4,352,2,60,257933,60,176,2,60,257932,60,176
1.036,17,7,480,4,32,343,32,240,3,52,513,60,240
1744.644,2,16,512,16,8,116309,8,512,0,0,0,0,0
1744.733,2,14,448,14,8,134210,8,448,0,0,0,0,0
27.036,6,18,2474,11,210,2703,210,1016,7,545,3732,904,1458
1741.329,1,15,840,15,28,124380,28,840,0,0,0,0,0
2.482,6,27,8827,16,282,165,578,1490,11,984,224,1452,7337
3.302,17,5,738,4,32,1095,32,240,1,470,0,470,498
9.532,6,99,32142,51,592,190,1152,25740,48,407,197,1152,6402
1795.087,17,87,3648,86,14,21118,14,3612,1,8,0,8,36
1.875,6,17,6616,8,150,267,174,624,9,938,222,1452,5992
0.355,6,21,7290,12,335,31,668,1974,9,1613,43,3314,5316
0.052,17,4,420,2,33,0,33,122,2,121,35,145,298
60.392,6,11,2994,6,92,12078,92,400,5,1165,15051,1448,2594
1771.466,6,103,9514,66,66,27253,66,5610,37,60,49204,60,3904
280.527,6,31,7472,13,158,23377,267,1317,18,603,16492,2076,6155
1798.304,6,212,19209,106,125,17124,208,13884,106,31,17124,31,5325
0.007,6,3,120,2,0,2,0,80,1,0,0,0,40
2.309,6,9,527,5,43,577,43,311,4,0,767,0,216
0.414,6,49,21286,28,1003,15,1380,16204,21,421,18,1923,5082
1678.328,1,8,448,8,28,239761,28,448,0,0,0,0,0
1798.469,17,449,39928,404,35,4462,288,25708,45,288,40018,288,14220
58.868,6,18,2253,5,210,8,210,478,13,545,4905,905,1775
0.154,6,12,3462,6,75,30,75,395,6,1373,30,1448,3067
1786.97,6,358,22669,209,69,8591,69,12500,149,69,12074,69,10169
1797.209,6,197,25880,106,304,17116,304,18020,91,83,19968,83,7860
0.018,17,2,600,1,36,0,36,64,1,508,0,508,536
0.101,6,12,3462,6,75,20,75,395,6,1373,20,1448,3067
0.98,6,10,1687,7,100,163,100,384,3,1179,363,1179,1303
4.195,17,5,295,5,31,1048,31,295,0,0,0,0,0
4.019,17,8,1256,4,33,1335,33,244,4,225,1336,233,1012
1799.97,17,144,11520,72,48,25351,48,5472,72,56,25351,56,6048
1748.421,6,95,7203,63,38,28200,205,4476,32,33,56393,98,2727
1785.72,17,142,11360,71,48,25510,48,5396,71,56,25510,56,5964
0.192,17,2,195,1,44,0,44,72,1,95,0,95,123
1786.863,6,356,22520,208,69,8632,69,12460,148,69,12155,69,10060
5.266,6,40,7309,21,218,263,314,3463,19,513,277,1179,3846
1770.144,6,234,16090,89,46,20113,46,6886,145,46,12292,46,9204
1787.454,17,87,3648,86,14,21028,14,3612,1,8,0,8,36
1796.983,6,219,28428,117,304,15491,304,19308,102,83,17791,83,9120
2.549,17,51,37040,21,357,127,1350,8088,30,937,76,1350,28952
0.398,6,10,968,5,256,95,256,460,5,304,95,304,508
750.967,17,15,5416,15,333,53640,548,5416,0,0,0,0,0
0.196,6,46,20201,26,1008,7,1420,15180,20,467,9,1883,5021
1770.422,6,99,9306,66,66,27237,66,5610,33,60,55322,60,3696
15.208,6,11,764,5,92,3802,92,348,6,92,3007,92,416
0.366,17,2,152,1,48,0,48,76,1,48,0,48,76
1744.678,2,30,960,30,8,60161,8,960,0,0,0,0,0
1795.085,17,448,39896,403,35,4465,288,25676,45,288,40018,288,14220
0.0,6,2,84,1,0,0,0,44,1,0,0,0,40
5.13,6,42,8289,21,227,256,314,4022,21,489,242,1179,4267
1715.096,1,10,1080,10,80,190566,88,1080,0,0,0,0,0
0.032,17,6,460,3,40,0,41,206,3,56,8,57,254
28.541,17,27,8018,11,207,2854,1350,2588,16,311,1790,1350,5430
0.811,6,52,13757,24,535,35,1301,4728,28,438,29,1460,9029
280.211,6,28,7352,12,158,25473,267,1277,16,603,18678,1400,6075
3.128,17,3,1167,3,361,1564,361,1167,0,0,0,0,0
5.825,6,594,546038,389,1336,14,1368,530714,205,776,27,1473,15324
1787.098,6,102,8228,68,64,26673,64,4896,34,58,54151,58,3332
280.492,6,28,7352,13,158,23374,267,1317,15,775,20027,4836,6035
368.636,6,25,1651,17,177,23039,177,1117,8,110,9173,110,534
1.653,6,14,2351,8,188,236,245,700,6,703,280,1152,1651
10.281,17,3,433,2,37,10281,37,130,1,275,0,275,303
0.175,6,9,1340,5,145,43,145,349,4,827,27,827,991
1793.984,1,274,15344,274,28,6571,28,15344,0,0,0,0,0
11.647,17,8,704,4,48,3875,48,304,4,72,3875,72,400
1794.782,6,356,22520,208,69,8670,69,12460,148,69,12209,69,10060
0.016,17,2,443,1,40,0,40,68,1,347,0,347,375
0.249,6,27,6244,14,181,19,537,1654,13,651,20,2194,4590
0.006,17,3,552,2,64,0,64,184,1,340,0,340,368
280.262,2,4,128,4,8,93420,8,128,0,0,0,0,0
741.776,17,3889,186672,1972,20,376,20,94656,1917,20,371,20,92016
6.037,6,1834,1733271,1179,1393,4,1408,1694547,655,931,8,2816,38724
25.244,6,3843,3655711,2512,1377,9,1408,3581799,1331,931,18,2816,73912
0.261,17,2,384,1,39,0,39,67,1,289,0,289,317
908.793,2,11,352,11,8,90879,8,352,0,0,0,0,0
1772.23,6,180,15480,120,69,14892,69,8940,60,69,30032,69,6540
1796.271,1,58,4872,58,56,31513,56,4872,0,0,0,0,0
1611.344,1,8,448,8,28,230192,28,448,0,0,0,0,0
240.212,6,56,18232,29,762,8578,1418,15236,27,198,9238,580,2996
1795.343,17,180,14040,180,50,10029,50,14040,0,0,0,0,0
1384.602,17,76,25536,76,308,18461,308,25536,0,0,0,0,0
444.917,6,47,7680,23,134,15184,516,2130,24,241,19340,1452,5550
0.012,6,10,1609,5,106,3,106,374,5,967,3,967,1235
0.049,17,2,191,1,31,0,31,59,1,104,0,104,132
1772.927,6,180,15480,120,69,14898,69,8940,60,69,30048,69,6540
1795.94,17,29,9686,29,306,64140,306,9686,0,0,0,0,0
46.888,6,27,7177,13,155,3907,267,1306,14,530,3606,3417,5871
1789.427,1,212,11872,212,28,8480,28,11872,0,0,0,0,0
280.429,6,28,7352,13,158,23369,267,1317,15,775,20027,4836,6035
1790.819,6,374,29986,208,75,8651,267,13252,166,124,10853,1460,16734
0.007,17,2,410,1,36,0,36,64,1,318,0,318,346
1772.335,6,180,15480,120,69,14893,69,8940,60,69,30036,69,6540
1796.129,1,68,3808,68,28,26807,28,3808,0,0,0,0,0
280.04,6,29,7392,13,158,23336,267,1317,16,603,18666,1400,6075
0.268,17,8,2758,8,316,38,355,2758,0,0,0,0,0
6.092,17,4,428,2,46,6004,46,148,2,112,5993,112,280
105.509,6,130,99289,82,1259,1302,1368,88668,48,737,2239,2519,10621
300.081,6,40,10630,21,699,14995,1360,5068,19,399,16662,1360,5562
129.336,1,4,224,4,28,43112,28,224,0,0,0,0,0
0.92,6,95,74991,49,183,19,230,3141,46,1578,11,2816,71850
0.166,6,26,7256,13,155,13,267,1301,13,678,13,3900,5955
1772.215,6,180,15480,120,69,14892,69,8940,60,69,30036,69,6540
0.059,17,4,284,2,32,51,32,120,2,54,51,60,164
21.747,6,14,2254,8,210,3105,210,856,6,545,4349,904,1398
10.865,6,20,4442,11,275,1086,275,998,9,768,763,1440,3444
0.254,17,4,288,2,36,206,36,128,2,52,206,52,160
0.909,6,10,968,5,256,224,256,460,5,304,224,304,508
94.134,17,4,352,2,60,94133,60,176,2,60,94133,60,176
0.215,6,12,3462,6,75,43,75,395,6,1373,42,1448,3067
1762.675,17,415,139440,415,308,4257,308,139440,0,0,0,0,0
0.068,17,2,237,1,72,0,72,100,1,109,0,109,137
0.277,17,2,476,1,39,0,39,67,1,381,0,381,409
280.453,6,29,7392,13,158,23371,267,1317,16,678,18694,2760,6075
38.821,17,22,1672,22,48,1848,48,1672,0,0,0,0,0
76.393,6,32,7653,12,155,6944,267,1266,20,371,4013,1460,6387
1.148,6,25,8068,12,164,89,267,1300,13,869,81,1408,6768
1708.567,17,32,2611,16,31,113902,37,949,16,75,113902,136,1662
10.925,6,1609,1439481,969,1404,11,1448,1401537,640,931,16,2761,37944
3.743,17,3,1173,3,363,1871,363,1173,0,0,0,0,0
1773.011,6,182,15698,120,69,14899,69,8940,62,69,29062,69,6758
11.828,6,1880,1630349,1138,1378,10,1420,1596436,742,467,15,1883,33913
157.933,6,35,8311,12,159,5699,267,1602,23,321,7178,1420,6709
1787.518,17,79,3312,78,14,23214,14,3276,1,8,0,8,36
8.268,6,1320,1144446,796,1388,10,1420,1119265,524,420,15,1420,25181
0.089,6,13,3514,7,75,14,75,447,6,1373,17,1448,3067
0.008,6,3,144,2,0,1,0,104,1,0,0,0,40
96.49,17,4,1560,4,362,32163,548,1560,0,0,0,0,0
1741.347,6,87,6322,58,31,30549,31,3915,29,31,62189,31,2407
125.79,6,22,9754,12,410,53,922,1742,10,1266,13962,3056,8012
1.334,6,44,10145,23,440,60,1360,4484,21,400,56,1360,5661
250.62,17,4,352,2,60,250618,60,176,2,60,250619,60,176
9.418,6,6,312,6,0,0,0,312,0,0,0,0,0
280.433,6,27,7312,12,158,25493,267,1277,15,775,20028,3465,6035
0.027,17,2,417,1,44,0,44,72,1,317,0,317,345
280.445,6,29,7392,13,158,23370,267,1317,16,678,18693,2085,6075
0.466,6,26,8868,13,227,38,547,1592,13,941,37,1438,7276
1796.893,1,160,8960,160,28,11301,28,8960,0,0,0,0,0
1.198,6,7,376,4,0,399,0,216,3,0,486,0,160
598.409,17,60,8940,60,121,10142,121,8940,0,0,0,0,0
298.719,1,4,326,4,53,99573,78,326,0,0,0,0,0
1.241,6,46,18125,26,882,49,1360,12549,20,529,56,4075,5576
19.347,6,32,8952,14,158,1488,267,1357,18,624,1127,1400,7595
1771.714,6,110,10197,71,65,25310,65,6162,39,59,46621,59,4035
0.256,17,2,152,1,48,0,48,76,1,48,0,48,76
1740.674,17,30,31680,30,1028,60023,1028,31680,0,0,0,0,0
1784.536,1,342,28728,342,56,5233,56,28728,0,0,0,0,0
1785.389,6,102,8296,68,65,26647,65,4930,34,59,54100,59,3366
0.114,17,2,572,1,39,0,39,67,1,477,0,477,505
1681.082,1,15,840,15,28,120077,28,840,0,0,0,0,0
1785.008,17,127,42701,127,308,14166,342,42701,0,0,0,0,0
1773.006,6,183,15738,121,69,14775,69,8980,62,69,29061,69,6758
304.417,6,21,1376,10,173,33729,173,701,11,83,30441,83,675
34.165,17,20,1760,10,48,3795,48,760,10,72,3794,72,1000
321.633,6,9,546,6,31,64326,31,333,3,31,160811,31,213
0.893,6,24,9812,14,350,68,1041,1992,10,1481,80,3930,7820
300.305,6,24,8464,15,836,21450,1408,7482,9,168,6517,309,982
1781.651,6,274,33709,113,135,15906,1360,16381,161,135,11134,4662,17328
1745.631,6,90,6540,60,31,29586,31,4050,30,31,60183,31,2490
1.523,17,3,1173,3,363,761,363,1173,0,0,0,0,0
4.567,6,38,7245,19,218,253,314,3383,19,516,238,1179,3862
196.294,6,80,55766,50,1211,4006,1368,47446,30,750,2136,1368,8320
2.96,6,13,2311,7,188,493,245,660,6,1407,541,1407,1651
24.252,17,14,15353,3,912,51,1350,2820,11,1111,2421,1350,12533
4.565,6,13,1389,6,185,913,185,513,7,244,644,476,876
1.311,6,52,21183,30,946,45,1460,15482,22,480,53,4075,5701
1770.895,6,99,9306,66,66,27244,66,5610,33,60,55337,60,3696
240.251,6,50,15299,26,731,9609,1418,12336,24,213,10445,580,2963
1772.237,6,180,15480,120,69,14892,69,8940,60,69,30035,69,6540
0.03,17,2,912,1,308,0,308,336,1,548,0,548,576
33.115,17,18,1584,9,48,4137,48,684,9,72,4137,72,900
282.453,6,33,7561,15,158,20175,267,1397,18,544,16612,1300,6164
671.346,17,168,15032,151,35,4475,288,9660,17,288,40020,288,5372
79.13,6,15,3111,7,500,132,1237,1801,8,489,11280,826,1310
1.424,17,23,12604,11,613,138,1350,7051,12,434,126,1350,5553
840.741,17,8,592,4,30,280242,30,232,4,62,280240,62,360
11.359,17,4,352,2,60,11358,60,176,2,60,11358,60,176
1.395,6,50,19071,28,938,51,1460,13370,22,400,57,1460,5701
63.29,1,2,232,2,88,63290,88,232,0,0,0,0,0
0.155,6,31,7798,17,271,9,517,1785,14,544,11,1889,6013
1740.484,17,30,7050,30,207,60016,207,7050,0,0,0,0,0
3.713,6,10,2940,5,92,928,92,348,5,1164,802,1408,2592
1779.308,6,258,22094,102,82,17615,374,10496,156,68,11478,1062,11598
756.055,2,5,160,5,8,189013,8,160,0,0,0,0,0
1773.268,6,180,15480,120,69,14901,69,8940,60,69,30053,69,6540
0.498,17,3,451,2,39,47,39,134,1,289,0,289,317
1799.839,17,448,39896,403,35,4477,288,25676,45,288,40018,288,14220
30.199,6,47,9205,24,176,1313,721,2728,23,616,1363,1420,6477
1790.954,6,256,37848,156,304,11554,304,27300,100,83,18090,83,10548
1745.623,6,95,7203,63,38,28155,205,4476,32,33,56298,98,2727
1788.519,6,356,22520,208,69,8640,69,12460,148,69,12166,69,10060
277.212,6,49,6143,26,304,11088,304,4144,23,83,12567,83,1999
3.368,17,2,632,1,288,0,288,316,1,288,0,288,316
0.352,6,50,19153,28,985,13,1380,12063,22,515,15,1923,7090
275.86,17,4,240,2,32,275859,32,120,2,32,275859,32,120
377.187,6,18,1242,14,180,29014,180,916,4,110,20059,110,326
0.116,6,9,1346,5,145,29,145,349,4,833,28,833,997
1793.256,17,1749,132890,951,40,1887,41,65300,798,56,2249,57,67590
721.871,2,9,288,9,8,90233,8,288,0,0,0,0,0
1.102,6,25,8080,12,164,85,267,1312,13,869,77,1408,6768
0.432,6,4,1037,2,0,232,0,104,2,853,215,853,933
12.812,6,24,9462,13,275,1067,275,803,11,1172,778,1420,8659
1719.51,17,12,498,11,14,171951,14,462,1,8,0,8,36
1598.863,1,125,7000,125,28,12894,28,7000,0,0,0,0,0
0.052,17,3,234,2,39,0,39,134,1,72,0,72,100
0.163,6,25,7216,13,155,13,267,1301,12,775,14,3445,5915
362.814,6,55,17713,35,592,10671,1360,12111,20,435,454,2667,5602
161.134,17,3,228,3,48,80567,48,228,0,0,0,0,0
1795.084,1,268,15008,268,28,6723,28,15008,0,0,0,0,0
6.059,17,5,1935,5,359,1514,371,1935,0,0,0,0,0
1783.278,17,83,3480,82,14,22015,14,3444,1,8,0,8,36
1791.931,6,354,22440,207,69,8698,69,12420,147,69,12273,69,10020
248.896,17,4,352,2,60,248895,60,176,2,60,248895,60,176
1771.027,6,99,9306,66,66,27246,66,5610,33,60,55341,60,3696
15.43,6,14,3166,5,92,3857,92,348,9,772,1902,2026,2818
1.273,6,10,1687,7,100,212,100,384,3,1179,514,1179,1303
1791.641,1,108,6048,108,28,16744,28,6048,0,0,0,0,0
54.226,6,1594,1390109,961,1362,56,1368,1348891,633,899,85,2736,41218
589.837,17,26,10231,26,365,23593,373,10231,0,0,0,0,0
74.291,6,35,15732,18,894,79,1360,6141,17,889,4631,3639,9591
11.448,6,30,9042,16,402,763,721,3056,14,903,747,2007,5986
2.869,17,6,1322,3,32,1432,32,180,3,352,1432,470,1142
0.288,17,2,144,1,36,0,36,64,1,52,0,52,80
0.68,6,28,7048,17,244,42,656,2394,11,701,67,1728,4654
1780.207,17,142,11360,71,48,25431,48,5396,71,56,25431,56,5964
1780.994,6,355,22549,207,69,8645,69,12420,148,69,12115,69,10129
27.091,6,3888,3749696,2603,1365,10,1408,3678114,1285,792,20,1408,71582
1798.267,17,446,39832,401,35,4495,288,25612,45,288,40019,288,14220
6.024,17,4,684,2,32,6015,32,120,2,254,6013,270,564
1799.031,17,449,39928,404,35,4464,288,25708,45,288,40019,288,14220
0.074,17,2,196,1,62,0,62,90,1,78,0,78,106
0.034,17,2,574,1,32,0,32,60,1,486,0,486,514
0.274,17,4,624,2,64,176,64,184,2,192,185,192,440
0.019,17,4,368,2,32,17,32,120,2,96,5,96,248
31.939,6,256,270089,71,130,456,313,4083,185,1416,173,2836,266006
0.024,6,3,120,2,0,24,0,80,1,0,0,0,40
0.514,17,2,672,2,308,514,308,672,0,0,0,0,0
5.451,6,798,657466,452,1414,12,1432,636167,346,513,15,1871,21299
1754.7,6,124,8977,75,31,23712,31,5155,49,31,36556,31,3822
38.514,6,26,6336,15,117,2751,159,1389,11,727,3850,1402,4947
281.607,6,34,9637,15,158,20114,267,1397,19,623,15643,1400,8240
550.049,17,14,896,14,36,42311,36,896,0,0,0,0,0
1795.956,1,342,28728,342,56,5266,56,28728,0,0,0,0,0
15.282,17,15,5302,7,415,2541,1350,3107,8,246,2176,1350,2195
0.54,17,3,543,2,39,454,39,134,1,381,0,381,409
1.406,6,38,8254,19,321,78,1164,2718,19,433,67,1440,5536
59.571,17,8,2672,8,306,8510,308,2672,0,0,0,0,0
0.216,17,2,144,1,36,0,36,64,1,52,0,52,80
43.608,6,118,81307,73,1250,603,1360,74247,45,328,986,1360,7060
1792.661,17,180,11520,180,36,10014,36,11520,0,0,0,0,0
281.364,6,31,7610,13,158,23447,267,1317,18,506,16527,2036,6293
1773.426,1,8,448,8,28,253346,28,448,0,0,0,0,0
13.401,6,117,39446,59,643,231,1152,32628,58,449,230,1179,6818
1769.405,1,58,4872,58,56,31042,56,4872,0,0,0,0,0
1798.707,17,142,11360,71,48,25695,48,5396,71,56,25695,56,5964
73.413,6,35,9072,15,158,5243,267,1397,20,624,3862,1400,7675
0.015,17,2,142,1,35,0,35,63,1,51,0,51,79
0.032,17,2,904,1,300,0,300,328,1,548,0,548,576
5.53,6,42,7389,23,218,251,314,3543,19,513,293,1179,3846
3.249,2,2,64,2,8,3249,8,64,0,0,0,0,0
0.291,6,3,182,2,31,291,31,111,1,31,0,31,71
110.063,17,4,352,2,60,110062,60,176,2,60,110061,60,176
1787.35,6,377,26188,217,98,8274,469,15372,160,69,11239,69,10816
1714.121,1,8,448,8,28,244874,28,448,0,0,0,0,0
1765.401,1,8,448,8,28,252200,28,448,0,0,0,0,0
728.103,6,63,8722,37,304,20225,304,6188,26,83,29123,83,2534
1795.053,17,446,39832,401,35,4487,288,25612,45,288,40017,288,14220
1.47,6,37,8214,19,321,81,1164,2718,18,529,75,4075,5496
196.06,17,4,352,2,60,196059,60,176,2,60,196059,60,176
0.159,17,2,333,1,36,0,36,64,1,241,0,241,269
2.901,17,4,624,4,128,967,128,624,0,0,0,0,0
264.208,2,3,96,3,8,132104,8,96,0,0,0,0,0
1.835,6,50,18341,28,882,67,1460,12640,22,400,74,1460,5701
212.868,6,9,3476,5,716,53215,1192,1633,4,841,70955,1591,1843
3.115,6,2,88,2,0,0,0,88,0,0,0,0,0
1789.974,17,46,15486,46,308,39777,329,15486,0,0,0,0,0
3.925,17,5,290,5,30,981,30,290,0,0,0,0,0
1720.81,17,12,498,11,14,172081,14,462,1,8,0,8,36
0.434,6,48,18926,27,909,16,1380,13843,21,421,20,2760,5083
2.744,6,2,88,2,0,0,0,88,0,0,0,0,0
1775.523,17,137,10956,69,48,26110,48,5244,68,56,26500,56,5712
1790.792,6,356,22520,208,69,8651,69,12460,148,69,12179,69,10060
4.002,17,4,244,4,33,1334,33,244,0,0,0,0,0
1.66,6,13,2311,8,188,237,245,700,5,1407,350,1407,1611
1793.598,1,264,14784,264,28,6819,28,14784,0,0,0,0,0
13.901,17,16,2352,8,48,1984,48,608,8,190,1984,308,1744
554.237,6,132,8088,64,75,8796,138,4078,68,34,8272,48,4010
8.71,6,9,596,3,106,4355,106,234,6,90,1703,90,362
0.158,17,2,142,1,35,0,35,63,1,51,0,51,79
840.734,17,8,2196,4,30,280243,30,232,4,463,280243,463,1964
1786.692,6,110,8858,69,65,26274,65,5035,41,59,44664,59,3823
1740.668,17,29,30131,29,1011,62166,1011,30131,0,0,0,0,0
1785.858,6,375,26508,216,104,8306,469,15732,159,69,11302,69,10776
0.135,17,2,162,1,39,0,39,67,1,67,0,67,95
6.623,6,1495,1238710,807,1437,7,1448,1191778,688,776,9,1448,46932
0.335,17,2,212,1,46,0,46,74,1,110,0,110,138
45.59,6,32,8952,14,158,3506,267,1357,18,624,2678,1400,7595
0.476,6,20,7229,13,334,39,663,2021,7,1209,71,1946,5208
300.261,6,36,19133,23,1043,13648,1408,13725,13,942,2052,2899,5408
1772.151,6,180,15480,120,69,14892,69,8940,60,69,30034,69,6540
25.91,6,41,13454,20,330,1363,721,3118,21,791,1285,2840,10336
0.025,17,2,602,1,46,0,46,74,1,500,0,500,528
242.958,6,147,148600,60,272,4117,900,4801,87,1907,2825,5608,143799
0.183,6,10,1865,6,649,36,1141,1542,4,159,60,159,323
201.811,6,32,8952,14,158,15523,267,1357,18,624,11861,1400,7595
0.085,17,2,234,1,33,0,33,61,1,145,0,145,173
0.285,6,24,8939,11,261,28,683,1624,13,828,22,1408,7315
6.436,2,3,96,3,8,3218,8,96,0,0,0,0,0
240.312,6,42,8713,21,523,12015,1418,5814,21,199,12015,617,2899
1770.201,6,215,16444,81,68,22115,292,7810,134,48,13309,78,8634
0.002,6,2,80,1,0,0,0,40,1,0,0,0,40
41.015,1,10,1040,0,0,0,0,0,10,76,4557,76,1040
0.057,17,2,283,1,31,0,31,59,1,196,0,196,224
17.776,17,26,7352,11,279,1774,1350,3385,15,236,1267,1350,3967
1776.033,6,106,8586,70,65,25737,65,5140,36,59,50743,59,3446
1772.83,6,245,18149,123,69,14531,69,9060,122,34,14651,48,9089
1771.534,6,99,9306,66,66,27254,66,5610,33,60,55357,60,3696
6.018,17,4,424,2,46,6006,46,148,2,110,6005,110,276
188.772,17,8,2688,8,308,26967,308,2688,0,0,0,0,0
1785.86,6,371,23534,212,69,8463,69,12965,159,69,11302,69,10569
0.951,17,14,7870,7,716,158,1350,5214,7,351,149,1350,2656
124.428,6,53,12121,20,285,6548,1189,4517,33,313,3694,1917,7604
19.997,17,4,304,4,48,6665,48,304,0,0,0,0,0
1.564,6,14,2351,8,188,223,245,700,6,703,260,1152,1651
1747.293,6,96,7255,62,38,28644,205,4424,34,33,52940,98,2831
437.918,17,32,35750,32,1089,14126,1451,35750,0,0,0,0,0
8.606,6,80,24725,41,542,215,1152,19008,39,461,219,1179,5717
61.362,6,37,15936,22,800,2922,1408,9157,15,665,4363,1408,6779
4.825,6,40,7309,20,218,253,314,3423,20,513,239,1179,3886
33.858,6,31,5094,15,154,2418,721,1858,16,400,2242,1368,3236
1785.364,6,102,8364,68,66,26647,66,4964,34,60,54098,60,3400
1782.224,17,134,10720,67,48,27002,48,5092,67,56,27001,56,5628
152.352,17,4,352,2,60,152351,60,176,2,60,152351,60,176
30.583,6,23,5588,12,298,2776,517,1229,11,629,3055,1368,4359
253.98,17,6,750,6,97,50796,352,750,0,0,0,0,0
962.654,2,10,320,10,8,106961,8,320,0,0,0,0,0
607.132,6,79,5966,30,68,20931,328,2853,49,48,12646,78,3113
0.281,6,9,1340,5,145,70,145,349,4,827,27,827,991
5.029,17,4,288,2,36,5010,36,128,2,52,5012,52,160
301.521,6,38,21498,24,1038,13109,1408,15794,14,828,3190,1491,5704
1399.148,6,192,14599,73,69,19407,311,6784,119,48,11857,78,7815
35.109,6,31,5095,15,154,2507,722,1860,16,342,2306,1448,3235
1789.441,17,83,3480,82,14,22091,14,3444,1,8,0,8,36
1795.027,17,142,11360,71,48,25643,48,5396,71,56,25643,56,5964
1.359,6,37,8214,19,321,75,1164,2718,18,433,69,1360,5496
1795.008,17,142,11360,71,48,25642,48,5396,71,56,25642,56,5964
5.139,17,3,208,2,36,5002,36,128,1,52,0,52,80
7.56,6,49,22961,27,217,290,683,2512,22,1285,359,2896,20449
12.836,6,2129,2053735,1421,1370,8,1408,2012255,708,776,17,1408,41480
41.602,17,4,824,2,48,41585,48,152,2,308,41579,308,672
1742.698,6,95,7203,63,38,28108,205,4476,32,33,56207,98,2727
174.748,6,8662,7711551,5453,1329,32,1368,7525979,3209,931,54,2736,185572
1681.981,17,14,1036,7,30,280324,30,406,7,62,280324,62,630
387.143,6,43,7676,22,147,18431,517,2036,21,568,19353,2451,5640
0.011,17,2,904,1,300,0,300,328,1,548,0,548,576
3.486,6,2,88,2,0,0,0,88,0,0,0,0,0
4.747,6,11,2235,5,188,1186,245,580,6,703,897,1152,1655
300.839,2,3,96,3,8,150419,8,96,0,0,0,0,0
0.239,6,9,1346,5,145,59,145,349,4,833,24,833,997
170.149,6,57,8748,26,196,6805,585,3393,31,219,5671,580,5355
1787.196,6,356,22520,208,69,8633,69,12460,148,69,12157,69,10060
0.124,6,9,1002,5,213,31,213,417,4,421,32,421,585
0.405,6,26,8890,13,232,33,569,1614,13,941,32,1438,7276
0.172,6,9,1339,5,145,43,145,349,4,826,38,826,990
0.081,6,3,246,2,63,0,63,206,1,0,0,0,40
2.094,6,16,5057,8,125,277,125,549,8,1019,267,1448,4508
1792.59,17,142,11360,71,48,25607,48,5396,71,56,25596,56,5964
189.227,17,6,360,3,32,94613,32,180,3,32,94613,32,180
0.39,6,24,6014,13,108,32,147,959,11,922,38,2601,5055
68.39,6,28,7352,12,158,6217,267,1277,16,603,4557,1400,6075
823.489,6,178,21092,92,148,9049,469,10685,86,198,5657,1917,10407
1785.032,17,83,3480,82,14,22037,14,3444,1,8,0,8,36
0.008,17,2,572,1,39,0,39,67,1,477,0,477,505
0.026,17,4,694,3,32,5,32,180,1,486,0,486,514
1796.06,17,415,37136,373,35,4828,288,23864,42,288,42940,288,13272
1624.343,2,16,512,16,8,108289,8,512,0,0,0,0,0
224.143,17,6,360,3,32,112071,32,180,3,32,112071,32,180
1783.538,17,138,11040,69,48,26228,48,5244,69,56,26228,56,5796
1772.445,6,103,9649,69,65,26065,65,5875,34,59,53629,59,3774
0.011,17,2,306,1,36,0,36,64,1,214,0,214,242
1798.423,1,345,28980,345,56,5227,56,28980,0,0,0,0,0
25.112,17,4,240,2,32,25111,32,120,2,32,25111,32,120
11.755,6,2060,1880533,1289,1379,8,1408,1835777,771,931,15,2816,44756
1773.266,6,180,15480,120,69,14901,69,8940,60,69,30052,69,6540
1009.039,17,22,1936,11,48,100902,48,836,11,72,100902,72,1100
294.377,1,6,336,6,28,58875,28,336,0,0,0,0,0
29.12,6,40,11392,15,154,278,417,1274,25,479,1205,4075,10118
0.048,6,10,767,6,186,9,186,506,4,45,15,45,261
10.025,17,39,23773,16,838,668,1350,13859,23,403,452,1350,9914
36.995,17,22,1672,22,48,1761,48,1672,0,0,0,0,0
1.429,6,24,8004,12,164,111,267,1288,12,1216,111,2736,6716
0.084,6,9,1002,5,213,21,213,417,4,421,22,421,585
280.048,6,31,7472,14,158,21542,267,1357,17,543,17500,1400,6115
1786.527,6,104,8376,68,65,26664,65,4930,36,59,51039,59,3446
1799.606,17,140,11200,70,48,26080,48,5320,70,56,26080,56,5880
1772.468,6,180,15480,120,69,14894,69,8940,60,69,30037,69,6540
1786.714,6,102,8364,68,66,26667,66,4964,34,60,54140,60,3400
1.273,6,47,18161,26,882,50,1440,12545,21,433,55,1440,5616
5.007,17,4,530,2,36,5002,36,128,2,173,5002,187,402
12.059,6,1785,1645051,1161,1364,10,1420,1615764,624,475,19,1883,29287
2.05,6,24,5754,14,158,156,370,1355,10,998,225,1691,4399
61.75,6,68,45463,42,1172,1506,1408,37378,26,960,2461,3847,8085
1789.582,1,15,1734,15,87,127827,103,1734,0,0,0,0,0
1793.641,1,117,6552,117,28,15462,28,6552,0,0,0,0,0
0.009,17,2,391,1,44,0,44,72,1,291,0,291,319
1.565,6,47,19557,27,919,60,1440,13981,20,433,72,1440,5576
1797.652,1,134,7504,134,28,13516,28,7504,0,0,0,0,0
77.163,17,4,1328,4,304,25721,308,1328,0,0,0,0,0
1799.181,17,449,39928,404,35,4464,288,25708,45,288,40018,288,14220
0.45,6,8,423,4,0,150,0,204,4,7,76,7,219
0.016,6,17,6068,10,88,1,88,556,7,1740,2,1880,5512
1786.294,17,87,3648,86,14,21015,14,3612,1,8,0,8,36
1749.896,6,103,7817,64,38,27776,205,4559,39,32,46039,98,3258
0.421,6,27,6161,14,108,32,147,999,13,662,34,1430,5162
85.106,6,36,5101,24,267,1974,501,1765,12,356,7728,1420,3336
0.126,17,2,142,1,35,0,35,63,1,51,0,51,79
35.63,6,40,8916,20,306,586,738,2362,20,478,1864,2720,6554
0.005,17,2,409,1,36,0,36,64,1,317,0,317,345
9.618,6,81,24994,42,568,234,1152,19293,39,459,246,1179,5701
188.74,6,44,9025,16,120,12582,267,1978,28,281,6980,1460,7047
288.933,17,9,3016,9,307,36116,308,3016,0,0,0,0,0
1788.11,17,87,3648,86,14,21036,14,3612,1,8,0,8,36
24.558,17,44,8862,19,131,1361,1350,3035,25,205,1021,1350,5827
1796.455,17,448,39896,403,35,4468,288,25676,45,288,40020,288,14220
1797.486,6,379,26406,218,97,8283,469,15481,161,69,11233,69,10925
0.42,6,10,968,5,256,98,256,460,5,304,99,304,508
0.018,17,4,420,2,33,14,33,122,2,121,13,145,298
1786.655,6,104,8308,68,64,26666,64,4896,36,58,51044,58,3412
1.925,6,51,20749,27,926,74,1440,15013,24,433,76,1440,5736
281.77,6,61,12596,28,171,10435,517,3174,33,427,8804,1501,9422
84.716,6,20,4464,9,341,10589,722,1489,11,342,8442,1408,2975
23.66,6,2586,2406164,1630,1396,14,1448,2351752,956,776,24,1448,54412
0.807,6,120,87306,53,131,15,232,2649,67,1343,12,1420,84657
240.181,6,54,18311,29,813,8577,1402,15347,25,207,10007,580,2964
25.195,6,38,8464,18,165,1482,721,2211,20,605,1315,1420,6253
240.46,6,1197,1466777,589,210,408,210,30846,608,2321,396,9576,1435931
0.176,6,12,2081,7,324,29,585,1021,5,396,42,580,1060
1.635,6,24,8723,15,285,116,587,1459,9,1150,184,2840,7264
30.26,6,12,1317,7,174,5043,174,546,5,251,7517,476,771
1783.174,17,82,3438,81,14,22289,14,3402,1,8,0,8,36
11.831,6,42,21547,24,992,514,1368,15147,18,1072,683,2736,6400
1771.935,6,180,15480,120,69,14890,69,8940,60,69,30031,69,6540
1711.822,1,66,3696,66,28,26335,28,3696,0,0,0,0,0
106.465,6,20,812,8,0,6944,0,324,12,0,9677,0,488
207.681,17,4,352,2,60,207680,60,176,2,60,207679,60,176
1.74,6,30,7560,18,306,102,1087,2866,12,701,150,1728,4694
1680.527,1,15,870,15,30,120037,30,870,0,0,0,0,0
1680.616,17,12,498,11,14,168061,14,462,1,8,0,8,36
0.026,17,4,352,2,37,19,37,130,2,83,20,89,222
1799.718,6,355,22480,207,69,8736,69,12420,148,69,12242,69,10060
1740.522,17,29,30624,29,1028,62161,1028,30624,0,0,0,0,0
81.459,6,39,17525,23,985,3702,1360,8834,16,893,5419,3151,8691
106.667,6,26,13803,13,534,63,1288,2154,13,1389,8875,3069,11649
172.023,17,2,84,2,14,172023,14,84,0,0,0,0,0
1.65,6,48,18845,27,865,63,1360,13229,21,476,71,2715,5616
39.888,17,22,1936,11,48,3987,48,836,11,72,3987,72,1100
1794.991,6,356,22520,208,69,8671,69,12460,148,69,12210,69,10060
304.703,1,22,2332,22,78,14509,78,2332,0,0,0,0,0
21.647,17,27,8029,12,337,1965,1350,4382,15,215,1544,1350,3647
5.868,17,35,23051,15,487,418,1350,7736,20,737,307,1350,15315
31.857,6,8,348,2,0,31857,0,84,6,0,6319,0,264
0.174,6,14,3448,8,106,24,106,530,6,866,33,1448,2918
13.68,6,3,156,3,0,0,0,156,0,0,0,0,0
369.159,6,53,10934,32,302,11908,1360,5292,21,435,655,2667,5642
1741.369,6,100,7256,64,31,27640,31,4356,36,31,49752,31,2900
0.924,6,49,13793,24,549,40,1429,4884,25,526,37,4906,8909
5.951,17,3,228,3,48,2975,48,228,0,0,0,0,0
0.014,17,2,158,1,34,0,34,62,1,68,0,68,96
1517.518,6,106,14020,68,85,22649,507,5379,38,209,41009,1452,8641
429.206,6,42,7728,19,142,15105,516,1905,23,244,19505,1452,5823
1.585,6,29,10370,17,367,99,834,1786,12,1012,133,1420,8584
31.661,6,6,360,0,0,0,0,0,6,0,0,0,360
373.592,6,20,1355,15,177,26685,177,977,5,110,15165,110,378
1682.04,17,14,1036,7,30,280334,30,406,7,62,280334,62,630
1794.474,17,142,11360,71,48,25635,48,5396,71,56,25635,56,5964
0.02,6,10,1514,5,503,4,503,771,5,475,5,475,743
1793.395,1,58,4872,58,56,31463,56,4872,0,0,0,0,0
70.409,6,27,7315,12,155,6400,267,1266,15,494,5028,3426,6049
0.146,6,46,21741,27,1044,5,1420,16760,19,467,7,1883,4981
0.182,17,2,204,1,34,0,34,62,1,114,0,114,142
1.414,6,26,8108,12,164,108,267,1288,14,869,93,1368,6820
1743.089,6,94,7151,62,38,28575,205,4424,32,33,56219,98,2727
240.208,6,53,18490,29,791,8578,1402,15760,24,210,10443,580,2730
77.389,17,4,1344,4,308,25796,308,1344,0,0,0,0,0
303.624,6,298,310528,84,811,3658,982,12198,214,1414,1425,2880,298330
1.62,6,14,5798,4,106,540,106,274,10,639,157,1420,5524
1.205,6,24,8004,12,164,93,267,1288,12,1014,92,2331,6716
0.027,17,2,362,1,46,0,46,74,1,260,0,260,288
280.509,6,31,7472,13,158,23375,267,1317,18,543,16495,1380,6155
63.029,17,4,352,2,60,63028,60,176,2,60,63027,60,176
1787.907,6,372,25919,215,98,8354,469,15223,157,69,11460,69,10696
19.995,17,7,370,6,19,3999,58,286,1,56,0,56,84
1794.836,17,140,11200,70,48,26011,48,5320,70,56,26011,56,5880
1799.537,17,448,39896,403,35,4476,288,25676,45,288,40021,288,14220
1435.065,6,164,11264,60,46,23817,46,4712,104,46,13932,46,6552
1624.561,1,8,448,8,28,232080,28,448,0,0,0,0,0
109.178,17,4,240,2,32,109177,32,120,2,32,109176,32,120
369.806,6,23,1511,14,177,28446,177,925,9,110,9484,110,586
1745.261,6,95,7203,63,38,28149,205,4476,32,33,56292,98,2727
1785.517,17,390,110045,390,254,4590,422,110045,0,0,0,0,0
3.811,6,33,6145,17,206,238,314,2744,16,551,236,1179,3401
17.471,6,14,2185,8,324,2495,585,1073,6,396,3489,580,1112
29.616,6,2066,1866357,1303,1375,22,1380,1826519,763,468,38,3303,39838
1.74,6,14,5798,4,106,580,106,274,10,639,173,1452,5524
1794.533,6,356,22520,208,69,8669,69,12460,148,69,12206,69,10060
1740.424,17,30,31680,30,1028,60014,1028,31680,0,0,0,0,0
333.601,6,69,13021,34,225,10108,517,5176,35,458,9811,1662,7845
37.699,17,11,836,11,48,3769,48,836,0,0,0,0,0
115.403,6,21,2493,6,242,25,517,1059,15,323,8242,499,1434
252.535,2,3,96,3,8,126267,8,96,0,0,0,0,0
33.669,6,31,5105,15,180,2392,722,1870,16,342,2232,1448,3235
1799.741,17,448,39896,403,35,4476,288,25676,45,288,40016,288,14220
1789.238,17,142,11360,71,48,25560,48,5396,71,56,25560,56,5964
1.935,6,53,19609,29,901,69,1460,13828,24,400,74,1460,5781
1745.884,6,95,7203,63,38,28159,205,4476,32,33,56309,98,2727
10.194,6,1552,1393096,967,1389,10,1432,1364052,585,395,15,1432,29044
1791.284,6,126,12419,78,62,23263,722,6422,48,87,38103,1440,5997
0.043,6,10,859,6,181,8,181,489,4,77,3,133,370
125.502,6,21,8761,11,326,59,639,1464,10,1147,13931,2568,7297
5.005,6,39,7269,19,218,278,314,3383,20,513,248,1179,3886
1656.499,1,7,392,7,28,276083,28,392,0,0,0,0,0
0.552,17,2,136,1,32,0,32,60,1,48,0,48,76
150.354,6,21,8279,11,525,116,1237,2048,10,969,16682,1791,6231
144.39,6,50,10259,20,263,4434,1189,2913,30,341,4978,1997,7346
0.856,17,4,288,2,36,825,36,128,2,52,825,52,160
39.308,6,14,3144,5,92,9827,92,348,9,387,4874,1408,2796
1782.984,6,354,22440,207,69,8655,69,12420,147,69,12212,69,10020
1770.184,6,227,19340,87,74,20581,301,8669,140,71,12735,1062,10671
1696.032,17,16,1265,8,30,242288,37,471,8,71,242288,136,794
1786.92,6,104,8376,68,65,26670,65,4930,36,59,51051,59,3446
1.306,17,4,368,4,64,435,64,368,0,0,0,0,0
0.468,6,9,1343,5,145,117,145,349,4,830,152,830,994
0.037,17,2,503,1,40,0,40,68,1,407,0,407,435
0.084,6,10,1495,5,507,21,507,727,5,556,20,556,768
0.602,17,8,2758,8,316,86,355,2758,0,0,0,0,0
1775.948,1,59,4956,0,0,0,0,0,59,56,30619,56,4956
4.739,6,39,7269,19,218,263,314,3383,20,513,234,1179,3886
5.044,17,3,208,2,36,5008,36,128,1,52,0,52,80
720.178,6,68,9206,34,98,21822,517,2775,34,357,21822,1418,6431
1.059,6,180,138772,107,1325,9,1432,131561,73,427,14,1432,7211
1.318,6,52,21805,29,932,47,1360,16109,23,433,52,1360,5696
0.848,6,21,5987,12,281,77,543,1327,9,716,94,1420,4660
1787.906,6,387,26864,220,96,8163,469,15768,167,69,10770,69,11096
1.753,17,4,610,3,39,822,39,201,1,381,0,381,409
0.379,6,13,1693,7,288,58,288,588,6,426,42,434,1105
52.466,17,4,352,2,60,52465,60,176,2,60,52465,60,176
1781.336,17,140,11200,70,48,25816,48,5320,70,56,25816,56,5880
1793.424,6,362,22898,210,69,8580,69,12678,152,69,11876,69,10220
254.814,17,4,352,2,60,254813,60,176,2,60,254813,60,176
280.515,6,30,7432,13,158,23376,267,1317,17,603,17529,1380,6115
180.074,17,2,1084,2,514,180074,514,1084,0,0,0,0,0
1772.197,6,180,15480,120,69,14892,69,8940,60,69,30033,69,6540
0.129,6,16,4036,10,101,14,101,629,6,1029,25,1587,3407
1789.95,6,364,23047,211,69,8523,69,12787,153,69,11775,69,10260
7.465,17,12,1764,6,48,1491,48,456,6,190,1490,308,1308
1752.814,17,30,7050,30,207,60441,207,7050,0,0,0,0,0
0.066,6,3,136,2,0,66,0,88,1,0,0,0,48
1.059,17,2,144,1,36,0,36,64,1,52,0,52,80
0.017,17,2,176,1,52,0,52,80,1,68,0,68,96
289.908,17,5,1672,5,306,72477,308,1672,0,0,0,0,0
12.349,17,2,672,2,308,12349,308,672,0,0,0,0,0
1778.38,1,46,2576,46,28,39519,28,2576,0,0,0,0,0
1699.947,2,20,640,20,8,89470,8,640,0,0,0,0,0
1788.973,1,110,6160,110,28,16412,28,6160,0,0,0,0,0
1799.676,1,345,28980,345,56,5231,56,28980,0,0,0,0,0
0.6,6,10,924,5,283,104,283,551,5,105,104,105,373
5.768,6,13,1480,5,283,1396,283,834,8,105,798,105,646
1783.804,6,363,24883,211,94,8494,469,14387,152,69,11813,69,10496
8.243,6,81,25026,42,569,201,1152,19325,39,413,210,1152,5701
59.663,6,16,2431,8,188,8523,245,700,8,1407,8485,1407,1731
1787.446,6,113,9050,72,66,25175,66,5190,41,60,44671,60,3860
1790.703,6,356,22520,208,69,8650,69,12460,148,69,12181,69,10060
70.097,6,35,17633,11,537,7009,1360,3205,24,708,3039,1360,14428
1.368,6,50,20085,28,885,50,1360,14429,22,433,56,1360,5656
1749.138,6,220,18557,82,74,21592,339,8249,138,68,12766,1062,10308
1798.666,1,345,28980,345,56,5228,56,28980,0,0,0,0,0
1778.947,17,140,11200,70,48,25781,48,5320,70,56,25781,56,5880
0.077,17,4,304,2,37,39,37,130,2,59,39,65,174
1797.347,17,446,39548,402,35,4482,288,25644,44,288,40952,288,13904
5.905,17,26,7684,11,280,590,1350,3397,15,257,228,1350,4287
281.607,6,33,7552,14,158,21662,267,1357,19,543,15644,1400,6195
1797.537,17,448,39896,403,35,4471,288,25676,45,288,40018,288,14220
0.844,6,3,151,1,0,0,0,40,2,31,0,31,111
1789.036,6,370,28735,214,117,8399,981,15979,156,95,11540,453,12756
1112.966,1,14,784,14,28,85612,28,784,0,0,0,0,0
38.084,17,22,1936,11,48,3807,48,836,11,72,3807,72,1100
21.315,17,31,8538,15,332,1520,1350,5410,16,167,1418,1350,3128
1786.492,6,102,8364,68,66,26664,66,4964,34,60,54133,60,3400
1225.145,6,136,9396,49,46,25523,46,3938,87,46,14244,46,5458
66.458,6,45,12906,18,294,233,485,3675,27,387,2555,4380,9231
127.729,6,31,13190,15,488,353,1460,3073,16,946,8506,1460,10117
374.599,6,21,1419,15,177,26757,177,989,6,110,12251,110,430
1323.54,2,10,320,10,8,147060,8,320,0,0,0,0,0
0.026,17,2,225,1,37,0,37,65,1,132,0,132,160
280.075,6,29,7392,13,158,23339,267,1317,16,603,18665,2036,6075
896.319,6,106,13022,59,70,15453,721,5118,47,273,16842,1414,7904
503.361,1,48,4992,0,0,0,0,0,48,76,10709,76,4992
1794.351,1,58,4872,58,56,31479,56,4872,0,0,0,0,0
1781.814,6,364,25392,212,100,8444,469,14896,152,69,11800,69,10496
2.01,17,2,148,2,46,2010,46,148,0,0,0,0,0
8.204,6,78,24405,40,552,210,1152,18744,38,459,214,1179,5661
365.74,6,18,1242,14,180,28133,180,916,4,110,20061,110,326
6.116,6,42,7405,22,218,291,314,3503,20,516,307,1179,3902
231.668,17,4,352,2,60,231666,60,176,2,60,231667,60,176
1788.813,1,34,1904,34,28,54206,28,1904,0,0,0,0,0
1789.952,6,367,23236,212,69,8483,69,12896,155,69,11623,69,10340
13.764,17,5,4158,5,803,3441,1451,4158,0,0,0,0,0
0.061,17,2,383,1,39,0,39,67,1,288,0,288,316
49.994,6,16,2289,9,324,6249,585,1125,7,396,8330,580,1164
1680.878,17,197,44032,197,195,8575,422,44032,0,0,0,0,0
1796.609,6,150,16060,84,76,21645,722,6885,66,155,27634,2007,9175
0.137,17,4,2876,2,689,137,1350,1434,2,693,42,1350,1442
13.919,6,2369,2192607,1511,1372,9,1408,2143327,858,931,16,2816,49280
1.253,6,50,19555,27,910,48,1360,13859,23,433,48,1360,5696
251.98,2,3,96,3,8,125990,8,96,0,0,0,0,0
170.001,6,25,12059,12,410,67,922,1754,13,1085,14155,1460,10305
1796.575,17,449,39928,404,35,4458,288,25708,45,288,40018,288,14220
67.587,6,86,53708,49,1146,1408,1448,44958,37,843,1866,2359,8750
20.184,6,22,5755,13,107,1682,159,1138,9,828,2521,1675,4617
41.145,6,27,7177,13,155,3428,267,1306,14,530,3164,3417,5871
1787.307,6,104,8308,68,64,26676,64,4896,36,58,51063,58,3412
213.478,1,5,530,5,78,53369,78,530,0,0,0,0,0
5.022,17,4,558,2,36,5017,36,128,2,187,5017,187,430
15.888,6,25,9609,10,129,1765,267,1054,15,883,1133,1917,8555
1796.761,1,345,28980,345,56,5223,56,28980,0,0,0,0,0
0.039,6,2,80,1,0,0,0,40,1,0,0,0,40
0.139,17,2,148,1,32,0,32,60,1,60,0,60,88
49.369,6,44,8832,23,367,2244,787,2114,21,391,482,3488,6718
10.678,6,1453,1365115,950,1362,11,1408,1334295,503,776,20,1408,30820
5.165,17,2,778,2,361,5165,361,778,0,0,0,0,0
5.041,17,3,208,2,36,5009,36,128,1,52,0,52,80
1.461,6,46,18702,26,927,58,1460,13126,20,433,66,1460,5576
1792.06,6,363,23007,211,69,8533,69,12787,152,69,11867,69,10220
1721.246,17,182,43045,182,208,9509,422,43045,0,0,0,0,0
6.355,6,25,6996,12,150,166,174,784,13,568,523,1420,6212
0.014,17,2,401,1,44,0,44,72,1,301,0,301,329
125.872,2,2,64,2,8,125872,8,64,0,0,0,0,0
14.743,1,4,224,4,28,4914,28,224,0,0,0,0,0
0.022,6,3,144,2,0,22,0,92,1,0,0,0,52
3.02,17,24,14584,13,901,248,1350,12080,11,199,298,1350,2504
2.119,17,2,134,2,39,2119,39,134,0,0,0,0,0
66.608,6,38,8452,18,378,544,786,1898,20,441,3498,1360,6554
1740.313,6,87,6322,58,31,30531,31,3915,29,31,62153,31,2407
0.032,17,2,118,1,31,0,31,59,1,31,0,31,59
1772.007,6,180,15480,120,69,14890,69,8940,60,69,30030,69,6540
0.016,6,2,104,2,0,0,0,104,0,0,0,0,0
1782.445,17,83,3480,82,14,22005,14,3444,1,8,0,8,36
1793.44,17,180,11520,180,36,10019,36,11520,0,0,0,0,0
1799.953,1,58,4872,0,0,0,0,0,58,56,31578,56,4872
1.1,6,24,8004,12,164,85,267,1288,12,1014,85,2804,6716
75.424,6,21,868,10,0,5354,0,408,11,0,7541,0,460
1.489,17,2,782,2,363,1489,363,782,0,0,0,0,0
1.038,17,4,482,3,32,513,32,180,1,274,0,274,302
1773.229,6,180,15480,120,69,14901,69,8940,60,69,30047,69,6540
20.443,6,10,2516,9,256,2555,365,2412,1,64,0,64,104
374.622,6,18,1242,14,180,28817,180,916,4,110,20057,110,326
0.063,17,13,10005,7,742,10,1350,5390,6,741,3,1350,4615
117.811,17,17,18490,17,1059,7363,1451,18490,0,0,0,0,0
30.113,6,12,1317,7,174,5018,174,546,5,251,7507,476,771
0.166,6,24,7176,12,155,15,267,1261,12,775,14,3445,5915
288.488,6,26,7272,13,158,24040,267,1317,13,775,24038,4836,5955
1.433,6,10,1755,5,657,358,657,925,5,562,358,562,830
1771.345,6,105,6270,60,27,30021,27,3525,45,27,40256,27,2745
1108.902,17,241,35605,116,213,9642,1350,28013,125,32,8942,64,7592
240.176,6,54,17664,29,774,8577,1408,14687,25,208,10007,580,2977
1786.232,17,87,3648,86,14,21014,14,3612,1,8,0,8,36
1771.218,6,102,9396,66,65,27249,65,5577,36,59,50602,59,3819
0.067,17,8,2454,8,278,9,317,2454,0,0,0,0,0
0.055,17,2,588,1,39,0,39,67,1,493,0,493,521
34.257,6,34,5263,17,154,2141,722,1975,17,300,2125,1408,3288
0.486,17,2,152,1,48,0,48,76,1,48,0,48,76
1798.523,17,449,39928,404,35,4462,288,25708,45,288,40018,288,14220
1797.944,1,16,896,16,28,119862,28,896,0,0,0,0,0
1772.535,6,243,18064,122,69,14649,69,9020,121,34,14770,64,9044
1743.333,6,96,7286,64,38,27671,205,4559,32,33,56140,98,2727
1.171,6,10,1687,7,100,195,100,384,3,1179,458,1179,1303
12.968,17,4,240,2,32,12968,32,120,2,32,12968,32,120
324.989,6,21,1722,14,66,24999,66,1022,7,60,54146,60,700
126.036,2,2,64,2,8,126036,8,64,0,0,0,0,0
1.097,6,24,6408,12,297,98,830,1971,12,790,98,1420,4437
1795.662,17,447,39864,402,35,4477,288,25644,45,288,40022,288,14220
1.121,17,4,368,2,32,988,32,120,2,96,984,96,248
175.368,17,4,352,2,60,175366,60,176,2,60,175367,60,176
112.061,17,4,240,2,32,112060,32,120,2,32,112060,32,120
0.133,17,2,602,1,46,0,46,74,1,500,0,500,528
12.768,6,20,4310,11,275,1276,275,998,9,978,999,1420,3312
0.096,17,2,904,2,424,96,548,904,0,0,0,0,0
4.447,6,40,7309,20,218,234,314,3423,20,513,220,1179,3886
7.753,6,1125,1026671,711,1368,10,1408,1000479,414,931,18,2801,26192
1.998,17,4,308,2,33,1996,33,122,2,65,1976,65,186
1.453,6,31,12382,16,529,96,1460,3318,15,845,90,1460,9064
4.827,6,23,7388,9,357,295,722,1436,14,598,356,1380,5952
3.342,6,2,88,2,0,0,0,88,0,0,0,0,0
1789.064,6,504,68525,284,266,6321,1189,38020,220,163,8168,453,30505
899.825,6,12,728,8,31,128546,31,444,4,31,299812,31,284
63.352,6,42,8848,17,401,1916,889,1940,25,327,2633,1360,6908
193.964,6,1535,765236,836,848,232,1152,730066,699,400,277,1179,35170
144.098,17,651,467724,646,695,223,1252,467480,5,20,5638,56,244
1654.422,6,126,20824,67,98,25067,721,7109,59,472,12615,1440,13715
1.386,6,23,5482,13,125,115,212,1026,10,675,153,1420,4456
127.143,6,22,8807,11,332,72,657,1470,11,983,12699,1360,7337
1795.085,17,449,39928,404,35,4454,288,25708,45,288,40024,288,14220
1.049,6,28,10126,17,351,65,785,1737,11,993,97,1452,8389
1772.885,6,180,15480,120,69,14898,69,8940,60,69,30042,69,6540
10.16,17,3,3247,3,1054,5080,1060,3247,0,0,0,0,0
1778.129,6,124,10387,80,58,22507,205,6266,44,41,41343,108,4121
7.238,6,1811,1766330,1209,1387,5,1408,1730362,602,931,11,2801,35968
1784.921,17,142,11360,71,48,25498,48,5396,71,56,25498,56,5964
80.777,17,4,352,2,60,80776,60,176,2,60,80776,60,176
0.27,6,24,5980,12,164,24,453,1442,12,651,23,1448,4538
1740.681,17,30,31680,30,1028,60023,1028,31680,0,0,0,0,0
0.135,17,3,3140,3,1018,67,1438,3140,0,0,0,0,0
0.286,6,47,20639,27,1030,11,1414,15609,20,383,13,1414,5030
1.137,6,23,7952,12,164,88,267,1288,11,1216,97,3819,6664
0.726,6,24,5755,13,158,59,370,1315,11,799,71,1452,4440
147.618,6,25,11087,13,556,112,1329,2244,12,1043,13401,2720,8843
1773.056,6,180,15480,120,69,14899,69,8940,60,69,30048,69,6540
16.013,17,22,15094,10,702,1770,1350,7307,12,620,1448,1350,7787
280.01,6,29,7392,14,158,21539,267,1357,15,678,20000,3436,6035
1793.457,6,397,27346,172,46,10327,46,11032,225,46,8005,46,16314
76.858,6,7052,5506103,3261,341,23,343,226526,3791,1348,20,2736,5279577
17.184,6,36,13954,21,212,859,347,1761,15,1140,576,2053,12193
0.798,6,10,1687,7,100,133,100,384,3,1179,268,1179,1303
252.164,2,3,96,3,8,126082,8,96,0,0,0,0,0
1789.975,17,142,11360,71,48,25570,48,5396,71,56,25570,56,5964
12.234,1,4,224,4,28,4078,28,224,0,0,0,0,0
1775.745,17,138,11040,69,48,26113,48,5244,69,56,26113,56,5796
1750.528,17,12,498,11,14,175052,14,462,1,8,0,8,36
37.454,6,32,8188,11,182,3745,267,1179,21,410,1861,1420,7009
1797.085,17,449,39928,404,35,4459,288,25708,45,288,40016,288,14220
1799.83,6,99,7535,64,38,28562,205,4559,35,33,52929,98,2976
0.651,6,114,88148,53,131,12,232,2649,61,1538,10,2877,85499
186.836,17,32,30568,32,927,6026,1451,30568,0,0,0,0,0
1797.106,17,144,11520,72,48,25311,48,5472,72,56,25311,56,6048
1792.221,1,58,4872,58,56,31442,56,4872,0,0,0,0,0
1773.007,6,204,22399,130,75,13744,267,10057,74,133,24287,2009,12342
1787.314,6,102,8228,68,64,26676,64,4896,34,58,54157,58,3332
1793.974,17,66,2766,65,14,28030,14,2730,1,8,0,8,36
1740.095,1,14,812,14,30,133853,30,812,0,0,0,0,0
1788.924,17,140,11200,70,48,25926,48,5320,70,56,25926,56,5880
905.684,6,56,4276,36,45,25872,205,2607,20,34,47658,98,1669
1.105,17,20,12396,9,627,138,1350,5898,11,562,107,1350,6498
1682.886,17,14,1036,7,30,280472,30,406,7,62,280476,62,630
92.617,6,22,8752,11,314,73,634,1415,11,983,9248,1360,7337
1773.642,6,180,15480,120,69,14904,69,8940,60,69,30061,69,6540
1168.32,17,339,29488,264,35,4442,288,16728,75,142,14602,308,12760
1.439,6,38,8252,19,320,79,1162,2716,19,433,70,1440,5536
11.751,6,1855,1622869,1124,1390,10,1420,1589408,731,467,16,1883,33461
0.367,6,27,9047,13,252,30,647,1692,14,945,26,1448,7355
1797.911,6,370,25839,215,99,8401,469,15154,155,69,11674,69,10685
1781.768,6,366,25541,213,100,8404,469,14936,153,69,11722,69,10605
1775.787,1,58,4872,0,0,0,0,0,58,56,31154,56,4872
1788.578,17,87,3648,86,14,21042,14,3612,1,8,0,8,36
0.068,6,10,1495,5,507,17,507,727,5,556,17,556,768
1.06,6,25,8044,13,164,88,267,1328,12,869,76,1402,6716
281.92,6,151,129193,96,430,2967,647,6478,55,2349,1241,8448,122715
11.593,6,1791,1594510,1109,1384,10,1420,1563009,682,467,17,1883,31501
1800.0,1,334,28056,334,56,5405,56,28056,0,0,0,0,0
159.856,17,4,240,2,32,159854,32,120,2,32,159855,32,120
1742.852,6,95,7203,63,38,28110,205,4476,32,33,56212,98,2727
1.375,17,21,10039,9,587,171,1350,5537,12,347,83,1350,4502
1796.754,17,448,39896,403,35,4469,288,25676,45,288,40025,288,14220
259.869,6,59,11100,29,189,9267,721,4197,30,474,8954,1440,6903
0.427,6,12,1653,6,288,78,288,548,6,426,45,434,1105
1230.858,17,207,15732,207,48,5975,48,15732,0,0,0,0,0
0.889,6,15,1594,8,304,127,304,1044,7,83,144,83,550
3.79,17,4,1556,4,361,1263,361,1556,0,0,0,0,0
601.56,2,7,224,7,8,100260,8,224,0,0,0,0,0
80.328,6,99,74391,63,1272,1295,1448,64356,36,679,2288,1448,10035
1739.865,6,87,6322,58,31,30523,31,3915,29,31,62137,31,2407
4.003,17,3,183,3,33,2001,33,183,0,0,0,0,0
1770.614,6,99,9240,66,65,27240,65,5577,33,59,55329,59,3663
22.482,6,3348,3138986,2176,1364,10,1408,3073378,1172,931,19,2816,65608
0.128,6,11,819,6,186,25,186,506,5,45,31,45,313
283.254,17,4,240,2,32,283253,32,120,2,32,283253,32,120
1793.112,17,83,3480,82,14,22137,14,3444,1,8,0,8,36
282.07,6,28,7352,13,158,23505,267,1317,15,678,20125,2045,6035
842.288,2,10,320,10,8,93587,8,320,0,0,0,0,0
0.018,17,2,672,2,308,18,308,672,0,0,0,0,0
1795.177,17,447,39864,402,35,4476,288,25644,45,288,40024,288,14220
768.976,6,27,6951,17,114,48061,267,1607,10,822,1029,1460,5344
161.451,6,48,10381,19,263,8969,1189,2873,29,288,5758,1420,7508
1789.258,6,121,14499,79,85,22939,516,6404,42,160,43638,1420,8095
1771.928,6,180,15480,120,69,14890,69,8940,60,69,30031,69,6540
126.279,17,4,288,2,36,126244,36,128,2,52,126248,52,160
1784.072,6,356,22520,208,69,8618,69,12460,148,69,12136,69,10060
1738.07,6,126,12382,76,62,23174,721,6286,50,88,35465,1448,6096
0.074,17,2,362,1,32,0,32,60,1,274,0,274,302
11.472,6,8,440,5,0,2868,0,268,3,0,5715,0,172
0.106,6,10,1841,5,658,26,658,926,5,647,26,647,915
280.076,6,29,7392,14,158,21544,267,1357,15,678,20000,4200,6035
1.656,6,14,1640,7,256,274,256,1052,7,304,274,304,588
1783.235,17,83,3480,82,14,22015,14,3444,1,8,0,8,36
1042.997,17,205,15580,205,48,5112,48,15580,0,0,0,0,0
84.096,6,59,22296,32,1049,416,1360,16061,27,302,3227,2667,6235
74.911,6,37,10049,19,332,4154,1408,3322,18,482,4399,1639,6727
0.016,17,2,405,1,34,0,34,62,1,315,0,315,343
383.513,17,6,528,3,60,191756,60,264,3,60,191756,60,264
13.139,6,2018,1908896,1312,1379,9,1408,1867508,706,931,18,2816,41388
92.831,17,6,528,3,48,46411,48,228,3,72,46411,72,300
0.17,6,43,17382,24,951,7,1420,12401,19,467,8,1883,4981
15.946,17,19,6554,9,428,1982,1350,4109,10,216,1761,1350,2445
10.725,6,20,4390,11,275,1072,275,998,9,755,750,1414,3392
1786.117,6,150,19350,90,302,20068,302,13740,60,83,30273,83,5610
0.832,6,10,1687,7,100,138,100,384,3,1179,292,1179,1303
1.34,6,39,8298,19,321,74,1168,2722,20,433,60,1460,5576
0.535,17,4,368,2,32,191,32,120,2,96,204,96,248
7.182,6,1735,1613770,1104,1384,6,1408,1576294,631,931,11,2816,37476
0.197,6,11,819,6,186,39,186,506,5,45,43,45,313
1.682,6,26,6099,14,108,129,147,999,12,768,152,1581,5100
366.949,6,27,1767,18,177,21585,177,1181,9,110,8540,110,586
0.137,17,2,180,1,30,0,30,58,1,94,0,94,122
1741.509,6,87,6322,58,31,30552,31,3915,29,31,62195,31,2407
304.055,6,46,12373,20,158,16002,267,1597,26,540,12161,1400,10776
658.982,2,9,288,9,8,82372,8,288,0,0,0,0,0
560.476,6,64,16147,32,181,18079,267,2732,32,551,18077,1400,13415
241.357,6,50,10714,25,209,10056,834,2820,25,506,10056,2342,7894
0.895,6,23,15962,14,249,68,431,1509,9,1996,83,5813,14453
0.05,6,10,1512,5,503,12,503,771,5,473,12,473,741
300.224,6,45,22537,26,1053,12008,1408,16142,19,599,3108,1491,6395
9.835,6,16,5255,9,275,1229,275,643,7,1440,804,1440,4612
3.062,17,26,15746,13,648,252,1350,8794,13,506,252,1350,6952
280.335,6,29,7392,13,158,23361,267,1317,16,543,18687,1400,6075
0.086,6,10,1671,6,552,16,948,1348,4,159,28,159,323
5.13,6,43,8345,21,227,256,314,4022,22,491,231,1179,4323
1681.251,17,14,1036,7,30,280205,30,406,7,62,280205,62,630
7.983,17,4,352,2,60,7981,60,176,2,60,7982,60,176
1740.673,17,30,20190,30,645,60023,645,20190,0,0,0,0,0
19.55,6,6,328,4,0,6516,0,216,2,0,19537,0,112
0.041,17,2,303,1,53,0,53,81,1,194,0,194,222
0.217,6,11,1170,6,135,38,135,379,5,587,45,587,791
1750.685,17,12,498,11,14,175068,14,462,1,8,0,8,36
51.066,6,13,808,9,31,6383,31,554,4,34,14071,34,254
7.413,6,8,448,4,0,2415,0,240,4,0,2415,0,208
24.396,6,37,8340,18,175,1435,721,2127,19,605,1345,2840,6213
45.725,6,264,224202,174,1310,263,1360,215373,90,372,511,2667,8829
1.59,6,25,6081,13,108,132,147,959,12,773,136,1608,5122
631.621,6,43,7766,24,120,16568,501,2285,19,336,35085,1420,5481
1746.724,6,95,7203,63,38,28172,205,4476,32,33,56335,98,2727
1740.694,17,29,6815,29,207,62167,207,6815,0,0,0,0,0
358.638,6,49,10633,26,281,14345,1360,4725,23,292,997,2667,5908
1778.944,17,140,11200,70,48,25781,48,5320,70,56,25781,56,5880
0.519,17,2,384,1,39,0,39,67,1,289,0,289,317
92.467,6,12,1041,7,330,15411,330,690,5,83,22567,83,351
1.635,6,50,19749,29,917,58,1360,14088,21,437,71,2715,5661
1.337,6,52,20996,28,940,49,1460,15260,24,433,50,1460,5736
51.63,17,4,352,2,60,51629,60,176,2,60,51624,60,176
3.729,17,5,295,5,31,932,31,295,0,0,0,0,0
0.214,17,4,588,2,48,200,48,152,2,190,195,308,436
1740.688,1,15,840,15,28,124334,28,840,0,0,0,0,0
69.033,6,35,17206,19,1054,3835,1448,9467,16,862,4513,1448,7739
300.798,6,35,14489,18,223,17694,546,1875,17,976,3880,1562,12614
21.326,6,28,7705,12,181,1922,417,1055,16,663,1409,1440,6650
31.609,6,7,336,1,0,0,0,48,6,0,6320,0,288
10.197,6,10,436,4,0,3399,0,172,6,0,1935,0,264
1.053,17,2,144,1,36,0,36,64,1,52,0,52,80
1792.92,6,240,35580,150,302,12033,302,25920,90,83,20145,83,9660
1744.125,1,56,4704,56,56,31711,56,4704,0,0,0,0,0
0.223,17,2,2756,2,1350,223,1350,2756,0,0,0,0,0
1404.532,6,161,20755,87,80,16331,267,7026,74,158,19240,1460,13729
1788.904,17,83,3480,82,14,22085,14,3444,1,8,0,8,36
0.367,17,2,212,1,46,0,46,74,1,110,0,110,138
0.126,17,2,409,1,48,0,48,76,1,305,0,305,333
1797.412,17,142,11360,71,48,25677,48,5396,71,56,25677,56,5964
0.129,6,2,267,1,151,0,151,203,1,0,0,0,64
4.684,6,37,7205,19,218,260,314,3383,18,516,260,1179,3822
1784.132,6,354,22440,207,69,8660,69,12420,147,69,12219,69,10020
225.677,6,25,3814,18,173,13275,196,2328,7,398,3923,419,1486
0.067,17,2,152,1,48,0,48,76,1,48,0,48,76
3.354,17,5,295,5,31,838,31,295,0,0,0,0,0
0.013,17,2,382,1,36,0,36,64,1,290,0,290,318
378.347,2,4,128,4,8,126115,8,128,0,0,0,0,0
204.486,17,4,352,2,60,204485,60,176,2,60,204485,60,176
7.936,6,1977,1661574,1080,1440,7,1448,1602732,897,792,8,1448,58842
15.948,17,21,15870,13,1033,1310,1350,13794,8,231,2265,1350,2076
30.111,6,34,8287,18,133,1771,159,2058,16,670,2005,1408,6229
280.517,6,28,7352,12,158,25501,267,1277,16,678,18693,2085,6075
4.127,6,11,467,6,0,825,0,248,5,7,744,7,219
0.014,6,2,304,1,0,0,0,40,1,212,0,212,264
504.021,2,5,160,5,8,126005,8,160,0,0,0,0,0
1681.603,17,14,1036,7,30,280264,30,406,7,62,280264,62,630
1795.719,17,448,39896,403,35,4466,288,25676,45,288,40025,288,14220
1682.962,17,12,498,11,14,168296,14,462,1,8,0,8,36
7.531,6,22,4442,12,213,684,597,1689,10,445,814,1440,2753
1239.684,1,14,784,14,28,95360,28,784,0,0,0,0,0
1794.613,6,356,22520,208,69,8669,69,12460,148,69,12208,69,10060
2.474,6,29,6387,14,164,190,267,1882,15,650,162,1452,4505
0.56,6,3,120,2,0,560,0,80,1,0,0,0,40
1772.573,6,180,15480,120,69,14895,69,8940,60,69,30041,69,6540
10.006,17,16,1408,8,37,1428,37,520,8,83,1428,89,888
1.126,6,27,8420,15,222,69,540,1964,12,1192,85,3151,6456
1782.952,17,132,10560,66,48,27429,48,5016,66,56,27429,56,5544
34.933,6,16,2788,7,837,5819,1452,1958,9,231,4364,231,830
71.589,6,116,127328,79,430,917,647,5478,37,3997,1970,18304,121850
0.268,6,22,5040,11,137,26,267,1132,11,577,25,1400,3908
1.537,6,49,19784,28,867,56,1360,14168,21,476,65,2715,5616
12.597,6,9,588,3,106,6295,106,234,6,90,2518,90,354
18.297,17,49,37872,20,438,961,1350,9336,29,956,646,1350,28536
800.832,6,61,9174,39,99,21074,503,3249,22,252,38131,1420,5925
280.338,6,30,7432,13,158,23361,267,1317,17,543,17516,1300,6115
1789.797,6,367,25581,213,99,8442,469,15005,154,69,11697,69,10576
39.097,17,24,2112,12,48,3548,48,912,12,72,3546,72,1200
139.526,17,4,352,2,60,139525,60,176,2,60,139525,60,176
297.885,17,4,352,2,60,297884,60,176,2,60,297884,60,176
1772.246,6,180,15480,120,69,14892,69,8940,60,69,30033,69,6540
1794.004,17,144,11520,72,48,25267,48,5472,72,56,25267,56,6048
1.012,6,26,8758,13,254,84,658,1569,13,951,69,1460,7189
3.681,6,2,84,1,0,0,0,40,1,0,0,0,44
301.937,6,66,36186,39,1196,7945,1460,30304,27,399,369,1460,5882
1797.757,17,448,39896,403,35,4472,288,25676,45,288,40018,288,14220
240.279,6,41,5340,21,235,12012,751,2750,20,192,12644,625,2590
2.49,6,18,3257,10,99,257,182,924,8,477,330,1343,2333
1740.444,6,87,6322,58,31,30534,31,3915,29,31,62157,31,2407
5.955,6,5,220,5,0,0,0,220,0,0,0,0,0
0.348,6,6,324,4,0,116,0,216,2,0,182,0,108
1783.568,6,359,22709,209,69,8574,69,12569,150,69,11968,69,10140
3.056,6,4,220,3,0,1506,0,180,1,0,0,0,40
470.595,6,3015,2963011,1817,373,259,420,105546,1198,2352,317,14080,2857465
1.479,6,47,19031,26,949,59,1460,13415,21,476,64,2615,5616
617.084,6,85,14772,35,135,18149,615,4175,50,238,12590,1460,10597
71.213,6,2649,2277592,1566,1364,45,1368,2207966,1083,899,65,1473,69626
1787.335,6,102,8228,68,64,26676,64,4896,34,58,54156,58,3332
28.674,17,4,352,2,60,28673,60,176,2,60,28673,60,176
534.616,17,9,3016,9,307,66827,308,3016,0,0,0,0,0
4.969,17,2,656,2,300,4969,300,656,0,0,0,0,0
0.075,17,2,572,1,39,0,39,67,1,477,0,477,505
1796.068,17,447,39864,402,35,4478,288,25644,45,288,40017,288,14220
0.229,17,7,2368,7,310,38,354,2368,0,0,0,0,0
1771.049,6,99,9174,66,64,27246,64,5544,33,58,55342,58,3630
1.432,6,47,18787,26,930,57,1460,13171,21,433,61,1460,5616
0.004,17,3,1007,1,137,0,137,165,2,393,2,393,842
0.892,17,4,660,2,30,882,30,116,2,244,881,244,544
43.251,17,46,6384,24,48,1877,48,1824,22,179,2055,308,4560
280.04,6,29,7392,14,158,21541,267,1357,15,678,20000,2045,6035
0.062,6,4,208,0,0,0,0,0,4,0,0,0,208
0.117,17,4,284,2,32,76,32,120,2,54,80,60,164
0.018,6,7,770,3,304,5,304,460,4,102,3,102,310
1740.007,17,29,1653,29,29,62143,29,1653,0,0,0,0,0
1648.494,1,7,392,7,28,274749,28,392,0,0,0,0,0
37.028,6,10,1802,6,180,7405,180,500,4,1086,12340,1086,1302
1794.134,17,80,3354,79,14,23001,14,3318,1,8,0,8,36
1744.629,2,29,928,29,8,62308,8,928,0,0,0,0,0
1787.315,6,379,24475,216,69,8313,69,13125,163,69,11032,69,11350
8.042,1,6,336,6,28,1608,28,336,0,0,0,0,0
19.078,17,24,7505,11,202,1904,1350,2534,13,354,1587,1350,4971
1740.436,17,29,30660,29,1029,62158,1064,30660,0,0,0,0,0
1795.33,6,219,17365,82,75,22162,337,8476,137,50,13199,143,8889
1.092,6,27,8420,15,222,65,540,1964,12,1192,83,3151,6456
1680.434,1,15,840,15,28,120031,28,840,0,0,0,0,0
1783.293,17,83,3480,82,14,22015,14,3444,1,8,0,8,36
419.021,17,22,5151,22,206,19953,422,5151,0,0,0,0,0
143.033,17,4,240,2,32,143032,32,120,2,32,143032,32,120
240.126,6,44,5590,23,247,10914,836,2951,21,171,12006,540,2639
664.794,17,29,9946,29,314,23742,548,9946,0,0,0,0,0
20.428,6,43,10408,23,632,920,1440,4761,20,371,1065,1440,5647
1772.192,6,180,15480,120,69,14892,69,8940,60,69,30032,69,6540
0.011,17,2,136,1,32,0,32,60,1,48,0,48,76
1789.885,1,211,11816,211,28,8523,28,11816,0,0,0,0,0
0.049,6,10,1514,5,503,12,503,771,5,475,12,475,743
307.803,6,24,1651,15,31,21976,31,966,9,31,38453,31,685
9.587,6,1425,1378345,917,1428,10,1448,1347253,508,776,18,1448,31092
0.859,6,3,127,1,0,0,0,40,2,7,1,7,87
0.371,6,12,1653,6,288,69,288,548,6,426,42,434,1105
0.01,17,4,350,2,34,1,34,124,2,85,0,91,226
1789.748,17,142,11360,71,48,25567,48,5396,71,56,25567,56,5964
382.391,6,18,1242,14,180,29414,180,916,4,110,20059,110,326
3.635,17,5,290,5,30,908,30,290,0,0,0,0,0
0.146,17,2,204,1,34,0,34,62,1,114,0,114,142
27.904,6,51,10547,24,533,660,910,3199,27,312,1067,1460,7348
0.038,6,32,53636,1,0,0,0,40,31,1676,1,2736,53596
217.964,6,9,515,5,43,54491,43,299,4,0,72632,0,216
58.994,6,61,15173,28,793,568,1460,4459,33,407,1838,1460,10714
300.605,6,44,8885,22,286,14314,766,2128,22,345,458,1360,6757
1.363,6,25,8056,12,164,105,267,1288,13,1014,96,2491,6768
0.134,17,2,290,1,40,0,40,68,1,194,0,194,222
518.757,6,72,8744,35,115,15257,722,3787,37,115,14401,1448,4957
1795.334,17,80,3354,79,14,23017,14,3318,1,8,0,8,36
2.29,6,3,120,1,0,0,0,40,2,0,2,0,80
0.854,6,26,5887,13,156,71,267,1462,13,650,65,1420,4425
0.016,6,10,1544,5,505,4,505,773,5,503,3,503,771
374.888,6,27,1767,18,177,22052,177,1181,9,110,8681,110,586
431.633,17,7,448,7,36,71938,36,448,0,0,0,0,0
0.542,6,27,8922,13,232,45,567,1612,14,939,40,1408,7310
238.082,17,4,240,2,32,238081,32,120,2,32,238081,32,120
1780.1,17,418,72973,418,146,4268,372,72973,0,0,0,0,0
0.436,6,7,295,4,0,145,0,164,3,7,116,7,131
3.865,17,4,352,4,60,1288,60,352,0,0,0,0,0
1793.702,1,58,4872,0,0,0,0,0,58,56,31468,56,4872
281.249,6,29,7392,13,158,23437,267,1317,16,603,18744,1400,6075
1669.072,1,8,448,8,28,238438,28,448,0,0,0,0,0
1.336,6,37,8212,19,320,74,1162,2716,18,476,68,2715,5496
70.818,6,13,1028,4,226,313,226,442,9,110,8787,110,586
21.389,17,2,152,2,48,21389,48,152,0,0,0,0,0
0.053,17,2,167,1,39,0,39,67,1,72,0,72,100
102.94,6,39,22233,22,541,38,1360,3088,17,1677,6425,4587,19145
257.609,17,10,880,5,48,64399,48,380,5,72,64399,72,500
2.04,1,10,280,10,0,0,0,280,0,0,0,0,0
296.791,6,29,3457,10,324,32976,585,1165,19,117,16484,580,2292
902.374,2,8,256,8,8,128910,8,256,0,0,0,0,0
1795.706,6,354,22440,207,69,8717,69,12420,147,69,12299,69,10020
1795.067,17,80,3354,79,14,23013,14,3318,1,8,0,8,36
0.045,17,2,128,1,36,0,36,64,1,36,0,36,64
1789.14,6,356,22520,208,69,8643,69,12460,148,69,12170,69,10060
1796.866,1,345,28980,345,56,5223,56,28980,0,0,0,0,0
0.849,6,12,1653,6,288,161,288,548,6,426,92,434,1105
0.898,6,25,9075,13,351,74,711,1606,12,872,66,1360,7469
2.983,6,2,88,2,0,0,0,88,0,0,0,0,0
0.05,6,12,3704,6,171,6,171,491,6,964,8,1448,3213
0.116,17,2,586,1,46,0,46,74,1,484,0,484,512
2.423,17,2,784,2,364,2423,364,784,0,0,0,0,0
3.512,6,2,88,2,0,0,0,88,0,0,0,0,0
0.754,17,3,1164,3,360,377,360,1164,0,0,0,0,0
0.439,17,15,5947,6,395,87,1350,2538,9,350,48,1350,3409
0.816,17,27,13903,14,726,62,1350,10562,13,229,65,1350,3341
301.197,6,70,53554,45,1241,6845,1368,47038,25,651,1278,1571,6516
0.073,17,2,152,1,48,0,48,76,1,48,0,48,76
0.209,17,4,284,2,32,0,32,120,2,54,1,60,164
151.854,6,1443,721166,791,845,192,1152,687535,652,397,232,1179,33631
1781.766,6,364,23047,211,69,8484,69,12787,153,69,11722,69,10260
1683.92,17,14,3815,7,30,280651,30,406,7,459,280651,463,3409
1777.436,17,140,11200,70,48,25759,48,5320,70,56,25759,56,5880
335.147,6,81,4896,39,74,8819,138,2457,42,34,8173,64,2439
46.727,6,14,2352,6,92,9345,92,400,8,750,6651,1408,1952
403.169,6,20,1370,14,180,31013,180,924,6,110,12223,110,446
1774.005,17,138,11040,69,48,26088,48,5244,69,56,26088,56,5796
370.799,6,18,1242,14,180,28523,180,916,4,110,20060,110,326
0.006,17,2,338,1,33,0,33,61,1,249,0,249,277
0.004,17,3,949,3,288,2,316,949,0,0,0,0,0
1784.759,1,184,10304,184,28,9752,28,10304,0,0,0,0,0
6.882,6,64,20030,33,539,215,1152,15363,31,489,220,1179,4667
1771.936,6,182,15629,121,69,14766,69,8980,61,69,29530,69,6649
6.815,6,534,464559,334,1325,19,1368,449495,200,776,33,1473,15064
0.444,6,12,1653,6,288,83,288,548,6,426,49,434,1105
287.005,1,4,224,4,28,95668,28,224,0,0,0,0,0
103.579,6,11,2960,6,543,20715,996,2415,5,172,25836,253,545
5.745,6,642,560010,400,1331,13,1368,542762,242,776,22,1473,17248
0.024,17,2,147,1,32,0,32,60,1,59,0,59,87
35.832,6,47,12890,24,289,1557,721,3573,23,838,1582,1420,9317
41.34,6,5516,5067801,3388,1410,12,1448,4943245,2128,776,19,1448,124556
15.309,17,18,5365,8,314,2182,1350,2738,10,234,1697,1350,2627
299.557,6,6,364,4,31,99852,31,222,2,31,299532,31,142
280.573,6,30,7432,13,158,23381,267,1317,17,603,17527,2076,6115
1790.0,6,131,12881,79,60,22948,722,6474,52,90,35093,1448,6407
10.489,6,47,9171,24,231,456,314,4435,23,476,464,1179,4736
0.933,17,14,7339,7,665,155,1350,4854,7,327,146,1350,2485
1.349,6,38,8344,19,336,74,1254,2808,19,433,65,1460,5536
0.695,17,3,238,2,30,573,30,116,1,94,0,94,122
0.3,6,6,240,3,0,150,0,120,3,0,35,0,120
2.496,17,4,1568,4,364,832,364,1568,0,0,0,0,0
0.056,6,9,1343,5,145,14,145,349,4,830,13,830,994
27.708,6,32,7717,12,155,2518,267,1266,20,352,1457,1997,6451
280.231,6,28,7352,13,158,23352,267,1317,15,678,20013,2800,6035
368.317,6,19,1306,14,180,28332,180,928,5,110,15160,110,378
165.136,6,55,11158,24,243,3165,721,4139,31,384,5498,1440,7019
1.422,6,47,19076,27,884,54,1360,13500,20,529,65,4075,5576
11.305,6,85,24925,43,542,269,1152,19088,42,461,269,1179,5837
0.016,6,12,3940,7,88,2,88,388,5,3340,3,3340,3552
1207.068,6,190,30729,118,302,10316,302,22210,72,83,16990,83,8519
1780.778,17,73,3060,72,14,25081,14,3024,1,8,0,8,36
240.26,6,46,9089,24,523,10445,1408,5965,22,219,11440,618,3124
75.375,6,27,10451,13,648,169,1460,3158,14,960,5756,2035,7293
1772.946,6,180,15480,120,69,14898,69,8940,60,69,30043,69,6540
240.208,6,52,14998,28,667,8896,1402,12151,24,198,10443,580,2847
97.14,6,36,8249,11,142,3217,267,1301,25,282,4047,1460,6948
70.408,6,28,7355,12,155,6400,267,1266,16,453,4693,2840,6089
299.522,6,6,364,4,31,99840,31,222,2,31,299511,31,142
1795.743,17,449,39928,404,35,4455,288,25708,45,288,40019,288,14220
26.994,6,8,536,3,92,13497,92,256,5,0,3863,0,280
0.855,6,10,1687,7,100,142,100,384,3,1179,293,1179,1303
0.975,6,23,5715,13,158,80,370,1315,10,999,107,1731,4400
186.04,2,3,96,3,8,93020,8,96,0,0,0,0,0
0.01,17,2,384,1,32,0,32,60,1,296,0,296,324
1769.161,6,99,9240,66,65,27217,65,5577,33,59,55282,59,3663
89.731,6,44,10425,17,291,2769,1189,2730,27,367,3450,1420,7695
0.451,6,10,1992,5,288,105,288,508,5,424,67,434,1484
0.164,6,9,1346,5,145,41,145,349,4,833,30,833,997
1786.336,6,364,25392,212,100,8466,469,14896,152,69,11829,69,10496
0.222,17,2,2754,2,1349,222,1349,2754,0,0,0,0,0
126.79,2,2,64,2,8,126790,8,64,0,0,0,0,0
1791.052,1,278,15568,278,28,6465,28,15568,0,0,0,0,0
1684.516,2,17,544,17,8,105282,8,544,0,0,0,0,0
18.03,17,17,4909,8,313,2563,1350,2729,9,214,2246,1350,2180
1655.049,1,8,448,8,28,236435,28,448,0,0,0,0,0
103.054,6,20,5937,9,341,12881,722,1513,11,549,10280,2026,4424
545.95,1,3,168,3,28,272975,28,168,0,0,0,0,0
0.115,6,3,120,1,0,0,0,40,2,0,114,0,80
21.332,17,12,912,12,48,1939,48,912,0,0,0,0,0
0.047,17,2,222,1,51,0,51,79,1,115,0,115,143
0.004,17,2,344,1,41,0,41,69,1,247,0,247,275
0.173,6,9,1338,5,549,43,549,753,4,421,42,421,585
0.084,17,4,420,2,33,0,33,122,2,121,71,145,298
1744.695,2,19,608,19,8,96927,8,608,0,0,0,0,0
189.664,17,4,352,2,60,189662,60,176,2,60,189662,60,176
0.556,17,3,451,2,39,459,39,134,1,289,0,289,317
0.064,6,10,1495,5,507,15,507,727,5,556,15,556,768
1758.581,6,116,6998,64,27,27911,27,3811,52,27,34480,27,3187
17.641,6,29,5001,14,180,1357,722,1819,15,342,1247,1402,3182
5.041,6,39,7285,21,218,252,314,3463,18,516,280,1179,3822
161.301,17,4,1344,4,308,53767,308,1344,0,0,0,0,0
1740.157,1,15,840,15,28,124296,28,840,0,0,0,0,0
1.353,6,50,20578,28,916,50,1360,14922,22,433,55,1360,5656
280.398,6,30,7432,13,158,23366,267,1317,17,543,17522,1400,6115
240.214,6,54,19514,29,849,8578,1408,16802,25,175,10008,580,2712
42.281,6,19,5814,10,267,4697,501,1205,9,707,5273,1420,4609
0.256,6,10,767,5,186,61,186,454,5,45,63,45,313
1.056,17,4,628,2,33,1040,33,122,2,225,15,233,506
1.325,6,6,340,3,0,662,0,160,3,0,521,0,180
146.735,17,4,240,2,32,146734,32,120,2,32,146734,32,120
33.607,6,29,4989,14,180,2585,722,1807,15,342,2387,1408,3182
7.514,6,40,7309,21,218,375,314,3463,19,513,402,1179,3846
1795.788,17,142,11360,71,48,25654,48,5396,71,56,25654,56,5964
1781.765,6,376,26148,216,98,8287,469,15332,160,69,11206,69,10816
1797.263,17,448,39896,403,35,4470,288,25676,45,288,40021,288,14220
3.283,6,5,260,3,0,778,0,156,2,0,1897,0,104
365.725,6,18,1242,14,180,28132,180,916,4,110,20066,110,326
5.0,17,4,502,2,36,4990,36,128,2,159,4990,159,374
2.844,6,170,198758,75,133,38,201,3567,95,2080,28,7160,195191
1797.736,17,449,39928,404,35,4460,288,25708,45,288,40021,288,14220
1787.22,6,104,8424,68,64,26674,64,4896,36,58,51060,58,3528
1797.618,1,229,12824,229,28,7884,28,12824,0,0,0,0,0
0.064,6,3,168,2,0,64,0,104,1,0,0,0,64
1785.44,17,87,3648,86,14,21005,14,3612,1,8,0,8,36
1793.747,17,144,11520,72,48,25263,48,5472,72,56,25263,56,6048
0.402,6,21,7217,13,318,33,599,1957,8,1209,55,1874,5260
0.123,6,3,2037,2,0,6,0,80,1,1917,0,1917,1957
280.421,6,28,7352,12,158,25492,267,1277,16,678,18692,2085,6075
156.727,6,50,8149,26,304,6269,304,5920,24,83,6812,83,2229
629.093,1,12,672,12,28,57190,28,672,0,0,0,0,0
1.278,6,45,17704,25,853,53,1440,12128,20,433,57,1440,5576
367.038,6,25,1654,17,180,22939,180,1120,8,110,9204,110,534
1741.435,17,30,7050,30,207,60049,207,7050,0,0,0,0,0
5.037,6,38,7229,19,218,279,314,3383,19,513,265,1179,3846
33.788,6,31,5094,15,154,2413,722,1859,16,342,2239,1448,3235
0.424,6,10,968,5,256,98,256,460,5,304,97,304,508
3.244,17,2,178,1,29,0,29,57,1,93,0,93,121
1785.72,6,361,22858,210,69,8544,69,12678,151,69,11904,69,10180
1744.578,2,25,800,25,8,72690,8,800,0,0,0,0,0
3.051,17,2,656,2,300,3051,300,656,0,0,0,0,0
0.308,6,28,9003,13,232,25,567,1612,15,825,21,1408,7391
7.811,17,4,240,2,32,7810,32,120,2,32,7809,32,120
149.936,6,89,67142,51,1375,914,1460,57128,38,771,4047,1460,10014
601.659,6,97,13239,49,111,12530,721,5547,48,320,12797,1440,7692
242.425,6,32,8952,14,158,18648,267,1357,18,624,14252,1400,7595
93.831,6,28,8029,7,156,834,267,1072,21,359,4690,1460,6957
1773.707,6,181,15589,120,69,14905,69,8940,61,69,29557,69,6649
0.516,6,20,7229,13,334,43,663,2021,7,1209,79,1946,5208
1721.368,17,17,5484,17,294,107585,1101,5484,0,0,0,0,0
1781.757,6,359,22709,209,69,8566,69,12569,150,69,11958,69,10140
3.951,17,5,290,5,30,987,30,290,0,0,0,0,0
440.548,17,28,2464,14,48,33887,48,1064,14,72,33887,72,1400
0.031,17,2,193,1,43,0,43,71,1,94,0,94,122
1797.04,17,768,46364,768,32,2342,37,46364,0,0,0,0,0
6.364,6,38,7229,20,218,334,314,3423,18,513,339,1179,3806
13.753,6,38,9056,21,351,687,737,1937,17,535,537,3488,7119
1.025,17,7,599,4,37,339,37,260,3,85,503,89,339
1625.509,17,345,78404,345,199,4725,342,78404,0,0,0,0,0
207.706,6,29,7392,13,158,17308,267,1317,16,678,13844,3456,6075
1680.707,17,13,534,11,14,168051,14,462,2,8,1680515,8,72
1775.586,6,181,15589,120,69,14920,69,8940,61,69,29589,69,6649
74.042,17,6,528,3,60,37020,60,264,3,60,37020,60,264
1742.739,6,95,7203,63,38,28108,205,4476,32,33,56208,98,2727
0.071,17,2,348,1,39,0,39,67,1,253,0,253,281
811.383,6,84,7155,55,69,15024,69,4201,29,69,28976,69,2954
16.787,6,14,1025,7,222,2796,222,506,7,231,2796,231,519
1.734,6,14,2351,8,188,247,245,700,6,703,293,1152,1651
1.048,17,2,154,1,33,0,33,61,1,65,0,65,93
122.613,6,38,15993,23,796,5573,1368,9181,15,669,4373,2519,6812
35.957,17,22,1936,11,48,3591,48,836,11,72,3593,72,1100
1.291,6,44,15152,24,780,56,1460,9576,20,433,58,1460,5576
1795.007,6,246,36520,152,302,11887,302,26628,94,83,19301,83,9892
1796.545,6,325,29060,190,92,9505,469,14002,135,130,13406,2840,15058
76.033,6,71,47992,45,1173,1728,1408,39906,26,960,2465,3847,8086
3.588,17,2,144,1,36,0,36,64,1,52,0,52,80
1776.327,17,73,3060,72,14,25018,14,3024,1,8,0,8,36
1799.556,17,450,39960,405,35,4454,288,25740,45,288,40019,288,14220
19.435,17,80,62601,52,1084,380,1350,57847,28,141,718,1350,4754
280.47,6,28,7352,13,158,23372,267,1317,15,775,20030,4836,6035
842.274,2,12,384,12,8,76570,8,384,0,0,0,0,0
1793.732,17,66,2766,65,14,28027,14,2730,1,8,0,8,36
1785.49,1,251,14056,251,28,7141,28,14056,0,0,0,0,0
1787.907,6,362,22898,210,69,8554,69,12678,152,69,11838,69,10220
240.25,6,54,18395,29,819,8579,1418,15446,25,205,10010,580,2949
1.691,6,25,6727,14,350,129,1089,2316,11,793,168,1731,4411
0.21,6,9,1002,5,213,52,213,417,4,421,67,421,585
1772.129,6,180,15480,120,69,14891,69,8940,60,69,30032,69,6540
1.016,17,2,464,2,204,1016,204,464,0,0,0,0,0
1.407,6,47,19092,26,954,56,1460,13476,21,476,60,2615,5616
262.435,6,73,48672,45,1191,5964,1408,40482,28,960,2281,3847,8190
79.531,6,20,820,9,0,6056,0,364,11,0,7952,0,456
1747.908,6,99,7814,65,45,27311,205,4850,34,35,52955,98,2964
1787.382,6,102,8296,68,65,26677,65,4930,34,59,54159,59,3366
0.177,6,26,7256,13,155,14,267,1301,13,678,13,3436,5955
0.099,17,4,240,2,32,98,32,120,2,32,98,32,120
86.838,17,2,152,2,48,86838,48,152,0,0,0,0,0
1796.332,17,446,39264,402,35,4479,288,25360,44,288,40950,288,13904
0.136,17,2,672,2,308,136,308,672,0,0,0,0,0
1.803,6,19,3781,10,234,200,564,1452,9,463,199,1343,2329
1788.924,17,83,3480,82,14,22085,14,3444,1,8,0,8,36
3.045,17,2,672,2,308,3045,308,672,0,0,0,0,0
0.23,6,10,1728,5,101,57,101,369,5,545,57,990,1359
1785.018,6,165,18145,91,94,19833,721,8576,74,146,24446,2840,9569
1.612,6,14,2351,8,188,230,245,700,6,703,269,1152,1651
31.666,6,7,308,1,0,0,0,44,6,0,6283,0,264
11.7,6,89,27013,45,557,265,1152,20755,44,449,265,1179,6258
0.037,17,6,411,6,40,7,41,411,0,0,0,0,0
1757.768,1,57,4788,57,56,31388,56,4788,0,0,0,0,0
1783.438,6,361,22858,210,69,8533,69,12678,151,69,11888,69,10180
6.42,6,3,553,1,302,0,302,354,2,83,6420,83,199
268.626,17,14,5698,14,379,20663,403,5698,0,0,0,0,0
377.348,6,15,1170,10,275,41927,275,958,5,0,17672,0,212
47.632,17,4,240,2,32,47631,32,120,2,32,47631,32,120
102.068,17,6,462,6,49,20413,49,462,0,0,0,0,0
11.573,6,21,6825,12,275,1052,275,1038,9,1353,820,1440,5787
0.872,6,3,127,1,0,0,0,40,2,7,0,7,87
0.035,17,2,322,1,33,0,33,61,1,233,0,233,261
1771.719,6,189,18393,99,71,18078,721,8385,90,160,19902,1414,10008
1791.793,6,247,25275,100,66,18097,594,9387,147,135,12271,3298,15888
1525.952,17,122,9760,61,48,25432,48,4636,61,56,25432,56,5124
90.274,17,5,1672,5,306,22568,308,1672,0,0,0,0,0
0.797,6,25,5847,13,156,66,267,1462,12,650,66,1420,4385
1734.024,6,117,11934,75,63,23432,722,6267,42,96,42283,1408,5667
4.932,6,38,7229,19,218,274,314,3383,19,440,260,1152,3846
1790.168,6,105,6240,60,26,30341,26,3510,45,26,40684,26,2730
1774.763,6,180,15480,120,69,14913,69,8940,60,69,30079,69,6540
300.675,6,39,8649,20,315,15825,882,2105,19,412,474,1440,6544
915.23,1,40,2240,40,28,23467,28,2240,0,0,0,0,0
1792.518,6,136,14845,78,73,23279,721,6009,58,151,31440,1420,8836
1793.45,1,58,4872,58,56,31464,56,4872,0,0,0,0,0
9.848,6,19,2505,8,211,1406,211,846,11,545,984,904,1659
0.222,17,2,144,1,36,0,36,64,1,52,0,52,80
10.829,6,20,4442,11,275,1082,275,998,9,768,757,1440,3444
8.994,6,3,180,3,0,0,0,180,0,0,0,0,0
119.344,17,26,3704,13,48,9944,48,988,13,180,9944,308,2716
61.309,6,37,15989,22,805,2919,1448,9211,15,665,4359,1448,6778
0.493,6,10,1671,6,552,98,948,1348,4,159,164,159,323
0.586,17,2,144,1,36,0,36,64,1,52,0,52,80
132.099,17,4,288,2,36,132098,36,128,2,52,132098,52,160
4.039,17,7,7079,2,723,4039,1350,1503,5,1087,957,1350,5576
0.875,6,10,1687,7,100,145,100,384,3,1179,311,1179,1303
0.008,17,2,396,1,58,0,58,86,1,282,0,282,310
0.943,6,40,18943,21,702,47,1360,5087,19,1006,43,1360,13856
3.447,6,2,88,2,0,0,0,88,0,0,0,0,0
74.675,1,3,168,3,28,37337,28,168,0,0,0,0,0
4.91,6,39,7269,19,218,272,314,3383,20,513,242,1179,3886
1762.224,6,167,10240,90,42,19800,208,6261,77,31,23171,31,3979
0.169,6,9,1339,5,145,42,145,349,4,826,31,826,990
125.373,6,14,3145,7,92,20895,92,452,7,465,20864,1408,2693
0.014,17,2,383,1,39,0,39,67,1,288,0,288,316
4.017,17,8,608,4,37,1336,37,260,4,59,1335,65,348
0.094,6,5,310,3,31,47,31,175,2,31,0,31,135
1796.331,17,447,39580,403,35,4468,288,25676,44,288,40949,288,13904
0.144,17,7,2438,7,320,24,354,2438,0,0,0,0,0
280.229,6,26,7272,12,158,25475,267,1277,14,775,21553,2800,5995
311.019,6,35,2366,12,46,25558,46,940,23,46,14137,46,1426
86.871,17,2,152,2,48,86871,48,152,0,0,0,0,0
41.064,6,17,6906,3,275,101,275,399,14,495,3146,1420,6507
0.779,6,17,5132,9,150,97,174,664,8,828,97,1420,4468
1792.981,17,180,11520,180,36,10016,36,11520,0,0,0,0,0
15.388,17,10,880,5,48,3844,48,380,5,72,3837,72,500
10.661,6,56,19712,30,780,367,1360,13729,26,409,418,1360,5983
0.014,6,3,478,2,179,0,267,438,1,0,0,0,40
35.032,17,40,5880,20,48,1843,48,1520,20,190,1842,308,4360
1776.153,17,309,51054,309,137,5766,366,51054,0,0,0,0,0
0.4,17,8,2750,8,315,57,354,2750,0,0,0,0,0
4.065,17,5,290,5,30,1016,30,290,0,0,0,0,0
1794.102,1,58,4872,0,0,0,0,0,58,56,31475,56,4872
1784.717,17,83,3480,82,14,22033,14,3444,1,8,0,8,36
1799.211,17,448,39896,403,35,4475,288,25676,45,288,40023,288,14220
1799.64,17,448,39896,403,35,4476,288,25676,45,288,40021,288,14220
1666.847,1,130,7280,130,28,12921,28,7280,0,0,0,0,0
0.298,17,2,152,1,48,0,48,76,1,48,0,48,76
1678.345,1,8,448,8,28,239763,28,448,0,0,0,0,0
1770.855,6,99,9174,66,64,27243,64,5544,33,58,55336,58,3630
0.516,6,27,7296,13,155,43,267,1301,14,603,35,1400,5995
290.311,1,3,180,3,32,145155,32,180,0,0,0,0,0
1771.554,6,104,6218,60,27,30025,27,3525,44,27,41197,27,2693
0.056,17,2,357,1,37,0,37,65,1,264,0,264,292
0.02,17,2,203,1,39,0,39,67,1,108,0,108,136
3.817,6,2,80,1,0,0,0,40,1,0,0,0,40
1777.904,6,100,7767,66,40,27352,205,4726,34,37,53864,177,3041
996.664,1,55,5830,55,78,18456,78,5830,0,0,0,0,0
1786.132,17,87,3648,86,14,21013,14,3612,1,8,0,8,36
240.552,6,45,9169,21,520,12026,1418,5788,24,236,10457,617,3381
0.379,6,12,1653,6,288,73,288,548,6,426,41,434,1105
1772.284,6,180,15480,120,69,14893,69,8940,60,69,30034,69,6540
105.562,17,10,590,10,31,11729,31,590,0,0,0,0,0
3.0,17,8,736,4,32,960,32,240,4,96,801,96,496
18.094,17,4,352,2,48,18083,48,152,2,72,18083,72,200
0.239,17,2,180,1,30,0,30,58,1,94,0,94,122
1.178,6,27,9616,13,164,83,267,1388,14,936,77,1408,8228
97.469,6,36,8020,13,141,8122,267,1375,23,317,4422,1420,6645
0.008,6,2,190,2,110,8,110,190,0,0,0,0,0
1773.316,6,180,15480,120,69,14901,69,8940,60,69,30048,69,6540
10.105,17,2,1084,2,514,10105,514,1084,0,0,0,0,0
9.267,6,22,6835,7,165,1544,267,949,15,479,651,1460,5886
280.664,6,30,7432,13,158,23388,267,1317,17,603,17535,2076,6115
8.946,17,16,1152,8,33,1277,33,488,8,55,1277,61,664
0.026,6,10,1514,5,503,6,503,771,5,475,6,475,743
0.103,17,2,144,1,36,0,36,64,1,52,0,52,80
5.559,6,8,440,5,0,1389,0,268,3,0,2772,0,172
1.34,6,25,8056,12,164,104,267,1288,13,1014,94,2491,6768
1773.12,6,180,15480,120,69,14900,69,8940,60,69,30049,69,6540
63.703,6,22,2606,7,302,10617,302,976,15,83,4549,83,1630
197.388,17,4,352,2,60,197386,60,176,2,60,197387,60,176
68.164,17,4,352,2,60,68163,60,176,2,60,68163,60,176
8.102,17,6,528,3,48,4044,48,228,3,72,4044,72,300
10.731,6,20,4442,11,275,1073,275,998,9,768,749,1440,3444
45.6,17,8,2688,8,308,6514,308,2688,0,0,0,0,0
31.152,6,8,460,2,0,31152,0,100,6,0,6220,0,360
0.344,17,12,5942,6,585,68,1350,3678,6,349,53,1350,2264
180.424,2,2,64,2,8,180424,8,64,0,0,0,0,0
280.271,6,29,7392,13,158,23355,267,1317,16,603,18682,2800,6075
93.81,17,4,240,2,32,93808,32,120,2,32,93809,32,120
26.851,17,4,320,2,48,26842,48,152,2,56,26842,56,168
3.145,6,65,25063,35,918,92,1460,14378,30,526,94,1460,10685
40.057,17,5,380,5,48,10014,48,380,0,0,0,0,0
1682.089,1,8,448,8,28,240298,28,448,0,0,0,0,0
1799.502,17,756,45745,756,32,2383,37,45745,0,0,0,0,0
46.849,6,9,527,5,43,11712,43,311,4,0,15608,0,216
2.52,6,10,1102,6,483,504,483,803,4,83,838,83,299
0.34,6,21,7203,12,318,29,600,1906,9,964,41,1471,5297
755.54,2,4,128,4,8,251846,8,128,0,0,0,0,0
1788.47,6,359,22709,209,69,8598,69,12569,150,69,12002,69,10140
300.749,6,69,38684,39,479,7914,1306,4024,30,1323,1119,2804,34660
1788.009,17,140,11200,70,48,25913,48,5320,70,56,25913,56,5880
12.017,17,5,305,5,33,3004,33,305,0,0,0,0,0
0.62,17,4,240,2,32,619,32,120,2,32,618,32,120
689.426,2,9,288,9,8,86178,8,288,0,0,0,0,0
1777.817,17,73,3060,72,14,25039,14,3024,1,8,0,8,36
6.35,6,1046,818637,545,1405,11,1448,784385,501,931,12,2761,34252
1.234,17,414,419138,90,138,13,1350,14946,324,1219,3,1350,404192
1768.713,17,433,130397,433,273,4094,422,130397,0,0,0,0,0
8.521,6,927,787096,531,1401,15,1448,761828,396,776,21,1448,25268
274.67,17,4,240,2,32,274669,32,120,2,32,274669,32,120
1.774,17,6,471,3,31,871,31,177,3,70,871,70,294
1787.57,6,361,22858,210,69,8552,69,12678,151,69,11916,69,10180
0.071,6,4,160,1,0,0,0,40,3,0,0,0,120
1729.207,6,60,4400,40,33,44338,33,2740,20,31,90997,31,1660
9.888,6,1517,1358578,963,1363,10,1380,1332176,554,421,17,1923,26402
1625.429,6,374,34037,200,128,8167,1189,16515,174,127,9395,1460,17522
0.079,17,2,136,1,32,0,32,60,1,48,0,48,76
38.265,17,12,912,12,48,3478,48,912,0,0,0,0,0
17.47,17,41,9749,18,279,1026,1350,5541,23,154,792,1350,4208
1792.958,1,122,6832,122,28,14817,28,6832,0,0,0,0,0
0.625,6,25,6116,12,181,56,537,1526,13,651,48,1448,4590
1.291,6,56,13917,28,535,47,1301,4888,28,438,47,1460,9029
1780.139,17,142,11360,71,48,25430,48,5396,71,56,25429,56,5964
0.014,17,2,420,1,39,0,39,67,1,325,0,325,353
0.288,17,4,420,2,33,0,33,122,2,121,0,145,298
300.249,6,39,18541,20,969,15802,1440,12685,19,486,3596,1440,5856
351.239,6,53,6794,24,106,15271,722,2538,29,144,11392,1448,4256
1787.085,6,359,22709,209,69,8591,69,12569,150,69,11993,69,10140
4.457,6,40,7309,21,218,222,314,3463,19,513,234,1179,3846
1741.458,1,15,840,15,28,124389,28,840,0,0,0,0,0
1797.461,17,447,39580,403,35,4471,288,25676,44,288,40950,288,13904
71.105,6,22,10814,11,410,63,922,1702,11,1237,7097,1460,9112
573.603,17,114,8664,114,48,5076,48,8664,0,0,0,0,0
1680.699,17,13,534,11,14,168051,14,462,2,8,1680511,8,72
240.17,6,54,17502,29,771,8577,1408,14631,25,195,10006,580,2871
1777.357,17,79,3312,78,14,23082,14,3276,1,8,0,8,36
1749.367,1,106,5936,106,28,16660,28,5936,0,0,0,0,0
0.193,6,47,21867,27,1048,7,1420,16846,20,420,9,1420,5021
1772.273,6,180,15480,120,69,14893,69,8940,60,69,30031,69,6540
1743.023,6,95,7203,63,38,28113,205,4476,32,33,56215,98,2727
0.42,6,51,20694,28,958,15,1380,15532,23,383,16,1380,5162
372.172,6,19,1303,14,177,28628,177,925,5,110,18439,110,378
1750.591,6,97,7307,63,38,28235,205,4476,34,33,53034,98,2831
1680.97,1,15,870,15,30,120069,30,870,0,0,0,0,0
0.37,6,26,9017,13,261,30,683,1728,13,943,30,1438,7289
12.147,6,2,87,1,0,0,0,40,1,7,0,7,47
1788.879,17,307,68109,307,193,5846,422,68109,0,0,0,0,0
0.022,17,2,255,1,59,0,59,87,1,140,0,140,168
1799.905,1,16,896,16,28,119993,28,896,0,0,0,0,0
1786.377,6,106,8524,68,66,26662,66,4964,38,60,48278,60,3560
0.557,6,119,88112,53,131,10,232,2649,66,1380,8,1420,85463
6.147,6,36,24872,21,884,307,1360,6177,15,2260,428,8160,18695
14.154,6,24,6993,13,275,1179,275,1078,11,910,912,1440,5915
0.202,6,10,1840,5,901,50,901,1169,5,403,50,403,671
1771.667,6,110,11908,70,109,25676,823,7464,40,67,45425,192,4444
4.966,6,38,7229,19,218,275,314,3383,19,513,260,1179,3846
0.929,6,25,5660,13,125,77,267,1275,12,780,76,1460,4385
0.469,17,4,368,2,32,454,32,120,2,96,457,96,248
1.038,6,3,144,2,0,964,0,104,1,0,0,0,40
1.701,6,13,1203,7,222,282,222,728,6,231,338,231,475
282.377,6,35,7770,14,158,21721,267,1357,21,464,14113,1400,6413
1773.998,6,205,22439,130,75,13751,267,10057,75,132,23968,1460,12382
10.395,6,24,4530,13,213,866,597,1741,11,441,1021,1408,2789
1787.9,6,376,26148,217,98,8277,469,15372,159,69,11315,69,10776
0.04,6,14,5639,9,134,4,134,514,5,4913,10,4913,5125
0.154,17,3,3141,3,1019,77,1438,3141,0,0,0,0,0
1681.14,17,14,3843,7,30,280189,30,406,7,463,280189,463,3437
1796.977,1,146,8176,146,28,12392,28,8176,0,0,0,0,0
0.089,6,10,1569,5,627,22,627,895,5,406,22,406,674
300.716,6,31,8236,18,204,17689,467,1808,13,574,5502,2688,6428
5.013,17,3,343,2,36,5005,36,128,1,187,0,187,215
11.769,6,1862,1625151,1135,1378,10,1420,1591850,727,467,16,1883,33301
280.653,6,31,7813,14,158,21588,267,1357,17,577,17539,2036,6456
0.031,17,4,284,2,32,18,32,120,2,54,14,60,164
0.013,6,4,222,2,31,13,31,111,2,31,3,31,111
60.595,6,10,2953,5,92,15148,92,360,5,1164,15090,1448,2593
1775.2,6,111,10231,71,65,25360,65,6003,40,59,45423,59,4228
4.268,17,5,295,5,31,1067,31,295,0,0,0,0,0
16.24,6,8,506,0,0,0,0,0,8,31,2320,31,506
1787.832,6,102,8228,68,64,26684,64,4896,34,58,54174,58,3332
0.442,17,14,6642,6,541,75,1350,3416,8,375,54,1350,3226
280.257,6,26,7272,12,158,25477,267,1277,14,775,21555,3445,5995
7.445,6,1709,1602054,1095,1386,6,1408,1565462,614,931,11,2801,36592
1700.539,17,12,498,11,14,170053,14,462,1,8,0,8,36
3.943,6,427,374141,212,219,18,256,13984,215,1702,18,2736,360157
1776.68,17,73,3060,72,14,25023,14,3024,1,8,0,8,36
2.473,17,4,360,2,30,2130,30,116,2,94,2207,94,244
0.265,17,2,144,1,36,0,36,64,1,52,0,52,80
37.727,17,11,836,11,48,3772,48,836,0,0,0,0,0
1791.437,17,144,11520,72,48,25231,48,5472,72,56,25231,56,6048
0.909,17,4,368,2,64,908,64,184,2,64,908,64,184
125.403,6,14,3145,7,92,20900,92,452,7,465,20863,1408,2693
0.159,6,46,21435,26,1096,6,1420,16414,20,467,7,1883,5021
280.289,6,29,7392,13,158,23357,267,1317,16,603,18680,1400,6075
240.509,6,41,8661,21,583,12025,1402,5765,20,231,12658,580,2896
1437.357,1,60,5040,60,56,24361,56,5040,0,0,0,0,0
378.44,6,18,1242,14,180,29110,180,916,4,110,20058,110,326
280.2,6,23,7014,10,181,31133,267,1128,13,670,23348,1400,5886
188.918,6,9,592,3,92,94459,92,256,6,0,6280,0,336
1.319,6,50,19778,27,926,50,1440,14082,23,433,52,1440,5696
1681.562,17,16,1265,8,30,240221,37,471,8,71,240221,136,794
1787.087,17,87,3648,86,14,21024,14,3612,1,8,0,8,36
12.807,17,5,3293,5,630,3201,1451,3293,0,0,0,0,0
1770.425,6,101,9344,66,65,27237,65,5577,35,59,52068,59,3767
6.88,6,26,12440,13,283,573,583,1375,13,1054,557,1420,11065
0.631,6,3,127,1,0,0,0,40,2,7,0,7,87
53.633,6,44,8796,21,345,762,720,1967,23,346,2430,2128,6829
732.691,6,142,50471,84,645,6848,690,29326,58,437,12851,1440,21145
6.799,6,43,7429,22,218,323,314,3503,21,440,325,1152,3926
1744.597,6,94,7151,62,38,28599,205,4424,32,33,56270,98,2727
1370.205,6,140,12017,93,69,14893,69,6963,47,69,29786,69,5054
1.719,6,25,8757,15,284,122,584,1456,10,985,170,1420,7301
1744.628,2,27,864,27,8,67101,8,864,0,0,0,0,0
1741.094,6,87,6322,58,31,30545,31,3915,29,31,62180,31,2407
54.359,6,16,4735,9,290,6794,517,1057,7,1102,9057,1440,3678
1285.732,6,283,26955,121,318,10701,580,12219,162,42,7982,177,14736
1770.966,6,104,9566,66,66,27245,66,5610,38,60,47861,60,3956
369.649,6,18,1242,14,180,28434,180,916,4,110,20064,110,326
11.851,6,21,6825,12,275,1077,275,1038,9,1353,854,1440,5787
0.168,6,7,423,4,43,41,43,259,3,0,29,0,164
0.223,6,16,6827,7,290,37,517,953,9,1079,20,1418,5874
6.985,6,14,2626,7,152,1164,267,742,7,400,1122,1179,1884
1478.731,6,301,20352,174,83,8547,469,11231,127,76,11735,453,9121
1615.824,6,110,14470,67,83,24482,501,5370,43,204,38469,1420,9100
12.087,6,1887,1623080,1146,1362,10,1380,1589186,741,383,16,1380,33894
0.328,6,5,260,3,0,160,0,156,2,0,326,0,104
0.218,6,23,6673,10,181,18,267,1128,13,627,17,1400,5545
882.125,2,5,160,5,8,220531,8,160,0,0,0,0,0
1.376,6,10,1687,7,100,229,100,384,3,1179,557,1179,1303
789.678,6,80,10893,48,304,16801,304,7964,32,83,25472,83,2929
1800.0,6,222,18810,82,72,21851,339,8171,140,69,12949,1062,10639
155.98,17,6,528,3,60,77989,60,264,3,60,77989,60,264
3.361,6,2,88,2,0,0,0,88,0,0,0,0,0
1772.149,6,182,15629,121,69,14767,69,8980,61,69,29534,69,6649
1783.829,6,363,24345,211,88,8494,469,13987,152,69,11813,69,10358
9.973,17,4,5484,4,1343,3324,1348,5484,0,0,0,0,0
144.941,17,4,352,2,60,144940,60,176,2,60,144937,60,176
153.95,6,22,9322,11,304,81,610,1396,11,1067,15378,1360,7926
0.2,6,26,7256,13,155,16,267,1301,13,678,14,3436,5955
1791.492,6,356,22520,208,69,8654,69,12460,148,69,12186,69,10060
116.935,6,79,55559,50,1208,2386,1368,47315,29,841,2201,2519,8244
5.683,6,25,3024,12,222,515,222,2038,13,231,472,231,986
1797.242,17,449,39928,404,35,4459,288,25708,45,288,40017,288,14220
141.111,6,23,10009,12,531,60,1360,2637,11,1384,14098,3934,7372
280.467,6,30,7432,13,158,23372,267,1317,17,603,17525,1380,6115
317.042,6,72,18856,38,311,8568,1360,9331,34,388,9602,4649,9525
127.489,6,17,4157,2,92,285,92,204,15,243,9093,1448,3953
1799.174,17,449,39928,404,35,4464,288,25708,45,288,40016,288,14220
2.956,17,4,304,2,48,2942,48,152,2,48,2942,48,152
1.824,6,40,8197,21,356,91,1420,2628,19,436,100,2840,5569
1797.209,1,345,28980,345,56,5224,56,28980,0,0,0,0,0
66.56,6,26,10197,13,531,166,1360,2733,13,1153,5534,2720,7464
2.247,6,14,1156,7,283,344,283,663,7,105,344,105,493
0.3,6,25,4623,12,165,27,456,1446,13,415,24,888,3177
298.62,17,4,240,2,32,298619,32,120,2,32,298619,32,120
1798.547,1,16,896,16,28,119903,28,896,0,0,0,0,0
99.385,6,35,7911,13,155,8282,267,1306,22,336,4732,1997,6605
0.033,17,2,436,1,36,0,36,64,1,344,0,344,372
271.263,6,30,2580,20,69,14277,69,1490,10,69,30092,69,1090
1787.905,6,365,23087,211,69,8513,69,12787,154,69,11685,69,10300
1798.797,6,370,25839,215,99,8405,469,15154,155,69,11678,69,10685
1772.239,6,180,15480,120,69,14892,69,8940,60,69,30032,69,6540
1740.98,1,15,870,15,30,124355,30,870,0,0,0,0,0
4.675,1,6,336,6,28,935,28,336,0,0,0,0,0
1787.994,17,1004,324904,481,581,3719,1350,293365,523,32,3425,340,31539
1764.941,17,525,57586,251,132,7059,1350,40247,274,35,6464,1350,17339
0.114,17,4,544,2,60,9,60,176,2,156,1,156,368
1.384,6,48,19638,27,922,53,1460,14022,21,433,60,1460,5616
1743.769,6,134,8539,73,51,24218,208,5169,61,31,29059,31,3370
383.806,6,18,1242,14,180,29523,180,916,4,110,20059,110,326
3.03,6,2,88,2,0,0,0,88,0,0,0,0,0
181.58,17,4,352,2,60,181579,60,176,2,60,181579,60,176
1786.108,6,110,8548,68,64,26658,64,4896,42,58,43561,58,3652
2.903,6,36,17798,19,686,161,1440,5611,17,1045,172,1440,12187
0.037,17,4,352,2,37,31,37,130,2,83,29,89,222
16.103,6,26,6992,7,142,2683,267,858,19,447,871,1460,6134
1748.192,6,95,7203,63,38,28196,205,4476,32,33,56386,98,2727
4.578,17,33,18434,18,629,267,1350,11832,15,412,324,1350,6602
280.2,6,30,7432,14,158,21553,267,1357,16,603,18676,2800,6075
0.039,6,10,861,6,182,7,182,490,4,77,10,134,371
0.215,6,15,4072,8,88,30,88,440,7,1670,35,1880,3632
1740.461,17,30,31620,30,1026,60015,1026,31620,0,0,0,0,0
3.905,17,5,295,5,31,976,31,295,0,0,0,0,0
280.225,6,28,7352,12,158,25475,267,1277,16,603,18679,1400,6075
0.215,6,20,4960,10,137,23,267,1092,10,692,23,1467,3868
1794.904,6,355,22480,207,69,8713,69,12420,148,69,12209,69,10060
13.621,6,28,4919,13,154,1116,722,1767,15,338,960,1440,3152
1764.748,2,11,352,11,8,176474,8,352,0,0,0,0,0
2.892,17,3,222,3,46,1446,46,222,0,0,0,0,0
1744.624,2,29,928,29,8,62308,8,928,0,0,0,0,0
5.01,17,4,732,2,37,5005,37,130,2,273,4997,273,602
1739.947,17,314,59283,314,160,5558,358,59283,0,0,0,0,0
3.847,6,13,3116,7,49,641,92,471,6,1164,731,1408,2645
153.944,6,115,86933,73,1277,2138,1448,76632,42,675,2541,1448,10301
5.321,6,18,6933,6,275,1064,275,794,12,628,461,1380,6139
3.852,17,2,152,2,48,3852,48,152,0,0,0,0,0
0.069,6,13,5599,8,134,9,134,474,5,4913,17,4913,5125
0.373,6,26,8890,13,232,31,569,1614,13,941,30,1402,7276
1.62,6,48,19250,27,894,62,1360,13634,21,433,70,1360,5616
0.127,17,2,136,1,32,0,32,60,1,48,0,48,76
21.261,6,9,577,0,0,0,0,0,9,31,2657,31,577
1771.742,6,101,9410,66,66,27257,66,5610,35,60,52107,60,3800
1789.525,6,379,28889,218,126,8246,469,17550,161,69,11184,69,11339
106.956,1,8,848,8,78,15279,78,848,0,0,0,0,0
0.42,17,2,2384,2,1164,420,1164,2384,0,0,0,0,0
1798.311,1,274,15344,274,28,6587,28,15344,0,0,0,0,0
0.147,6,12,3704,6,171,28,171,491,6,964,29,1448,3213
1551.945,6,122,12238,72,66,21858,721,5966,50,89,29843,2026,6272
180.52,2,2,64,2,8,180520,8,64,0,0,0,0,0
1787.144,17,87,3648,86,14,21025,14,3612,1,8,0,8,36
0.973,6,26,5887,13,156,81,267,1462,13,780,73,1460,4425
35.502,6,22,3234,13,183,2958,517,1613,9,381,4436,499,1621
51.929,17,6,1998,6,305,10385,329,1998,0,0,0,0,0
0.245,17,3,451,2,39,101,39,134,1,289,0,289,317
4.383,6,3,136,1,0,0,0,40,2,0,4220,0,96
158.272,1,6,336,6,28,31654,28,336,0,0,0,0,0
0.077,17,2,305,1,40,0,40,68,1,209,0,209,237
309.869,1,10,560,10,28,34429,28,560,0,0,0,0,0
0.335,17,2,204,1,34,0,34,62,1,114,0,114,142
1783.667,6,363,28897,208,75,8616,267,13315,155,132,11582,1452,15582
4.993,17,2,2166,2,1055,4993,1055,2166,0,0,0,0,0
1799.145,17,448,39612,404,35,4464,288,25708,44,288,40946,288,13904
903.882,6,43,7037,22,222,43042,1314,2667,21,235,45185,1460,4370
1745.203,6,103,8022,65,45,27268,205,4850,38,35,47157,98,3172
0.399,6,7,364,3,0,15,0,156,4,0,133,0,208
1799.143,17,573,49628,405,36,4453,288,26024,168,112,10773,308,23604
0.121,17,2,778,2,361,121,361,778,0,0,0,0,0
28.747,17,20,1760,10,37,1353,37,650,10,83,1056,89,1110
1744.685,2,29,928,29,8,62310,8,928,0,0,0,0,0
0.114,17,2,586,1,46,0,46,74,1,484,0,484,512
0.017,17,2,351,1,33,0,33,61,1,262,0,262,290
0.002,6,2,837,1,0,0,0,40,1,757,0,757,797
0.05,6,12,3704,6,171,9,171,491,6,964,8,1448,3213
113.015,6,55,13701,26,179,4520,722,2840,29,570,4017,2760,10861
698.18,6,81,5586,29,46,24933,46,2310,52,46,13689,46,3276
1770.093,6,99,9240,66,65,27232,65,5577,33,59,55311,59,3663
10.018,17,4,392,2,46,10000,46,148,2,94,10004,94,244
1.688,6,13,2311,8,188,241,245,700,5,1407,356,1407,1611
0.38,17,3,543,2,39,375,39,134,1,381,0,381,409
0.827,6,20,5948,11,281,82,544,1288,9,716,93,1420,4660
1204.567,6,105,10769,61,73,20070,721,5227,44,104,28008,1448,5542
136.294,6,28,7352,13,158,11357,267,1317,15,678,9730,3456,6035
1787.007,6,106,8456,68,65,26671,65,4930,38,59,48293,59,3526
73.734,17,9,3040,9,309,9216,330,3040,0,0,0,0,0
0.555,17,19,6055,8,369,75,1350,3177,11,233,52,1350,2878
1785.499,6,359,24116,209,88,8584,469,13838,150,69,11980,69,10278
0.149,6,44,21135,26,1081,5,1420,16194,18,467,8,1883,4941
0.012,6,3,1411,2,1267,7,1267,1371,1,0,0,0,40
599.514,6,9,546,6,31,119902,31,333,3,31,299686,31,213
1786.887,6,356,22520,208,69,8632,69,12460,148,69,12153,69,10060
12.221,6,1943,1688602,1174,1382,10,1420,1653597,769,420,15,1420,35005
2.192,6,25,5795,13,158,181,370,1315,12,799,197,1460,4480
371.586,6,202,154605,117,1342,3203,1448,140323,85,683,1660,2359,14282
0.145,6,52,50099,24,180,6,250,1798,28,1801,4,8688,48301
2.968,17,2,204,1,34,0,34,62,1,114,0,114,142
16.146,6,580,498795,350,1350,45,1368,480195,230,776,69,1473,18600
138.176,6,27,2073,11,86,13800,347,1048,16,48,9211,78,1025
1797.326,1,342,28728,342,56,5270,56,28728,0,0,0,0,0
109.438,6,23,9877,11,295,67,579,1359,12,1146,9937,1460,8518
70.648,6,24,5156,13,321,5880,517,1363,11,535,7057,1454,3793
0.408,6,21,7203,12,318,35,600,1906,9,964,48,1471,5297
0.809,6,35,8151,19,241,44,619,1757,16,522,43,3488,6394
1795.137,17,87,3648,86,14,21119,14,3612,1,8,0,8,36
1797.343,1,268,15008,268,28,6731,28,15008,0,0,0,0,0
414.778,2,4,128,4,8,138259,8,128,0,0,0,0,0
107.665,6,29,13000,16,541,52,1360,2849,13,1202,8960,2720,10151
1794.072,6,365,23087,211,69,8543,69,12787,154,69,11724,69,10300
1739.078,1,15,840,15,28,124219,28,840,0,0,0,0,0
11.3,6,17,2362,8,130,1614,130,558,9,1296,1391,1296,1804
11.149,6,1663,1528876,1081,1362,10,1420,1501257,582,427,19,1420,27619
1786.349,6,376,23416,215,69,8347,69,12740,161,58,11164,69,10676
0.096,17,2,169,1,34,0,34,62,1,79,0,79,107
1.93,17,30,6881,13,236,158,1350,3434,17,174,118,1350,3447
47.7,17,47,18637,21,379,2383,1350,8564,26,359,1906,1350,10073
4.26,6,32,6089,17,206,266,314,2744,15,548,283,1179,3345
1748.414,6,104,8198,66,45,26898,205,4902,38,34,47246,98,3296
0.33,6,27,8920,13,227,27,547,1592,14,941,22,1438,7328
211.771,6,49,22663,26,653,8470,1438,5282,23,1078,9625,1473,17381
4.028,17,4,352,2,48,4016,48,152,2,72,4016,72,200
0.061,17,2,154,1,33,0,33,61,1,65,0,65,93
1787.486,6,106,8584,69,66,26286,66,5004,37,60,49649,60,3580
2.099,6,55,23710,30,979,72,1360,17886,25,476,78,2715,5824
240.184,6,54,18703,29,791,8577,1418,15760,25,204,10007,580,2943
370.878,6,18,1242,14,180,28529,180,916,4,110,20068,110,326
124.857,6,13,2311,6,125,362,245,620,7,1407,20767,1407,1691
5.032,17,4,288,2,36,5001,36,128,2,52,5000,52,160
210.572,17,4,288,2,36,210523,36,128,2,52,210519,52,160
0.391,17,2,154,1,33,0,33,61,1,65,0,65,93
0.047,17,2,144,1,36,0,36,64,1,52,0,52,80
293.955,1,3,269,3,61,146977,78,269,0,0,0,0,0
662.156,17,50,3984,27,48,25467,48,2052,23,56,25448,56,1932
0.482,6,12,1653,6,288,93,288,548,6,426,55,434,1105
7.29,6,1804,1746470,1194,1388,5,1408,1710086,610,776,11,1408,36384
0.064,17,4,680,2,33,57,33,122,2,251,56,323,558
0.0,17,5,1572,5,286,0,317,1572,0,0,0,0,0
42.498,2,8,352,8,20,6071,32,352,0,0,0,0,0
280.479,6,29,7392,13,158,23373,267,1317,16,603,18694,2076,6075
345.884,6,96,72008,61,1251,5764,1368,63271,35,747,1859,1368,8737
0.834,6,25,5660,13,125,69,267,1275,12,780,69,1460,4385
1749.125,6,95,7203,63,38,28211,205,4476,32,33,56411,98,2727
1.992,17,2,176,2,60,1992,60,176,0,0,0,0,0
11.933,6,19,4362,11,275,1193,275,998,8,1010,1557,2840,3364
5.478,17,2,1364,2,654,5478,654,1364,0,0,0,0,0
0.268,17,2,1922,2,933,268,933,1922,0,0,0,0,0
1790.38,6,240,35580,150,302,12015,302,25920,90,83,20116,83,9660
1785.859,6,372,28264,216,127,8306,469,17332,156,69,11521,69,10932
360.952,2,6,192,6,8,72190,8,192,0,0,0,0,0
5.053,17,4,288,2,36,5005,36,128,2,52,5005,52,160
0.008,6,13,3987,8,114,1,114,454,5,1660,1,1861,3533
1791.864,1,58,4872,0,0,0,0,0,58,56,31436,56,4872
300.963,6,42,13629,23,889,13680,1440,8067,19,399,480,1440,5562
17.544,6,18,4372,9,211,2193,722,1519,9,793,2133,1448,2853
1772.219,6,181,15589,120,69,14892,69,8940,61,69,29535,69,6649
1795.971,17,449,39928,404,35,4456,288,25708,45,288,40017,288,14220
222.996,17,6,528,3,48,111492,48,228,3,72,111492,72,300
0.024,17,2,251,1,31,0,31,59,1,164,0,164,192
280.461,6,29,7392,13,158,23371,267,1317,16,678,18692,3456,6075
15.79,6,13,1438,6,222,3101,222,688,7,231,2629,231,750
10.14,6,82,24805,42,542,247,1152,19048,40,461,253,1179,5757
1789.481,6,386,27569,218,101,8246,469,16295,168,69,10715,69,11274
1799.694,17,448,39896,403,35,4476,288,25676,45,288,40023,288,14220
440.073,17,97,19406,97,172,4584,361,19406,0,0,0,0,0
1795.714,17,447,39864,402,35,4478,288,25644,45,288,40017,288,14220
2.051,6,29,10365,17,367,128,833,1785,12,1012,179,1420,8580
1.002,6,26,9125,14,306,77,867,1818,12,1135,73,2920,7307
6.153,6,1526,1449034,985,1395,6,1408,1416226,541,931,11,2816,32808
0.024,6,10,1512,5,503,6,503,771,5,473,6,473,741
5.071,6,758,684980,489,1360,10,1432,669929,269,475,18,1871,15051
4.079,6,38,7229,19,218,226,314,3383,19,513,212,1179,3846
240.301,6,42,8744,21,515,12014,1402,5743,21,237,12014,617,3001
7.765,6,15,1362,8,275,1109,275,878,7,96,979,96,484
176.921,17,4,352,2,60,176919,60,176,2,60,176920,60,176
0.439,6,21,4957,11,89,43,147,936,10,870,44,1708,4021
7.068,6,207,200363,148,133,48,201,6583,59,3418,118,19880,193780
0.934,6,10,1687,7,100,155,100,384,3,1179,337,1179,1303
0.085,17,4,376,2,44,77,44,144,2,88,76,100,232
1792.023,17,142,11360,71,48,25599,48,5396,71,56,25599,56,5964
1787.244,6,104,8376,68,65,26675,65,4930,36,59,51060,59,3446
324.454,17,4,304,4,48,108151,48,304,0,0,0,0,0
1615.526,1,8,448,8,28,230789,28,448,0,0,0,0,0
1783.613,17,83,3480,82,14,22019,14,3444,1,8,0,8,36
682.562,17,11,3684,11,306,68256,320,3684,0,0,0,0,0
0.144,17,2,152,1,48,0,48,76,1,48,0,48,76
1775.316,17,136,10880,68,48,26497,48,5168,68,56,26497,56,5712
1.437,6,50,19134,28,943,53,1460,13433,22,437,59,2615,5701
34.76,6,41,10070,20,702,467,1440,4366,21,346,1729,1440,5704
0.092,6,13,4527,7,290,15,517,941,6,1088,16,1408,3586
1.276,6,82,32601,49,573,26,1360,23218,33,536,36,3289,9383
0.2,1,2,112,2,28,200,28,112,0,0,0,0,0
0.099,1,2,112,2,28,99,28,112,0,0,0,0,0
4.095,17,5,295,5,31,1023,31,295,0,0,0,0,0
252.155,2,2,64,2,8,252155,8,64,0,0,0,0,0
0.141,17,2,152,1,48,0,48,76,1,48,0,48,76
1.323,6,41,8431,21,321,66,1164,2810,20,437,60,2715,5621
76.56,6,31,7672,11,162,7656,267,1423,20,388,4021,1452,6249
104.038,17,24,3528,12,48,9456,48,912,12,190,9456,308,2616
125.96,2,2,64,2,8,125960,8,64,0,0,0,0,0
1740.663,17,29,30624,29,1028,62166,1028,30624,0,0,0,0,0
1778.825,17,73,3060,72,14,25053,14,3024,1,8,0,8,36
119.911,6,43,8835,18,131,7053,267,1782,25,355,4988,1460,7053
1773.19,6,180,15480,120,69,14900,69,8940,60,69,30045,69,6540
1778.775,17,140,11200,70,48,25779,48,5320,70,56,25779,56,5880
0.33,17,7,2390,7,313,55,354,2390,0,0,0,0,0
1683.642,1,15,840,15,28,120260,28,840,0,0,0,0,0
280.642,6,30,7432,13,158,23386,267,1317,17,543,17539,1400,6115
1736.904,1,56,4704,56,56,31580,56,4704,0,0,0,0,0
0.915,17,4,624,2,64,914,64,184,2,192,797,192,440
1.209,6,23,7952,12,164,93,267,1288,11,1216,102,4344,6664
1791.2,1,236,13216,236,28,7622,28,13216,0,0,0,0,0
311.732,6,22,3191,8,221,44532,517,1322,14,381,23979,499,1869
12.932,6,29,7392,13,158,1077,267,1317,16,603,859,1400,6075
193.045,17,4,352,2,60,193044,60,176,2,60,193044,60,176
1790.939,1,74,7844,74,78,24533,78,7844,0,0,0,0,0
1748.564,6,103,8145,67,45,26493,205,4948,36,36,49948,98,3197
1755.955,6,105,6240,60,26,29761,26,3510,45,26,39907,26,2730
1455.997,1,48,4032,0,0,0,0,0,48,56,30978,56,4032
369.029,6,25,1700,17,226,23064,226,1166,8,110,9189,110,534
0.015,6,10,1514,5,503,3,503,771,5,475,3,475,743
9.053,6,309,225988,156,332,58,332,10088,153,1377,59,2736,215900
1792.038,1,94,5264,94,28,19269,28,5264,0,0,0,0,0
0.404,6,55,23235,29,1047,14,1380,17953,26,421,14,2760,5282
1790.09,17,469,50992,211,141,8524,1350,35680,258,31,6965,60,15312
1.614,1,2,163,2,53,1614,78,163,0,0,0,0,0
1163.918,6,233,14771,136,69,8621,69,8200,97,69,12123,69,6571
0.214,17,2,2754,2,1349,214,1349,2754,0,0,0,0,0
1793.285,17,144,11520,72,48,25257,48,5472,72,56,25257,56,6048
2.269,17,2,1817,2,880,2269,1427,1817,0,0,0,0,0
0.393,6,10,968,5,256,93,256,460,5,304,94,304,508
1797.888,6,82,4354,41,26,44945,26,2170,41,26,44945,26,2184
1770.268,17,281,63278,281,197,6322,422,63278,0,0,0,0,0
0.819,17,2,904,2,424,819,548,904,0,0,0,0,0
587.628,1,6,336,6,28,117525,28,336,0,0,0,0,0
1738.217,17,151,26089,151,144,11588,392,26089,0,0,0,0,0
56.671,6,39,8328,20,576,2982,1418,5674,19,205,3113,580,2654
1785.631,6,104,8308,68,64,26651,64,4896,36,58,51015,58,3412
1791.327,6,356,22520,208,69,8653,69,12460,148,69,12185,69,10060
1.243,17,20,5995,8,280,177,1350,2470,12,265,73,1350,3525
126.213,6,22,9140,11,303,72,600,1381,11,1217,12607,2720,7759
0.376,6,12,1653,6,288,70,288,548,6,426,40,434,1105
14.858,6,23,6508,11,280,1480,517,1422,12,744,1345,1408,5086
1.24,6,31,6467,15,164,88,267,1922,16,650,74,1380,4545
1770.866,6,106,9616,68,63,26430,63,5690,38,57,47857,57,3926
1798.468,6,375,26246,217,99,8326,469,15234,158,69,11452,69,11012
113.36,17,4,240,2,32,113358,32,120,2,32,113359,32,120
1771.348,6,99,9306,66,66,27251,66,5610,33,60,55351,60,3696
368.78,6,25,1651,17,177,23048,177,1117,8,110,9225,110,534
324.72,6,3,156,3,0,0,0,156,0,0,0,0,0
7.909,6,77,24365,39,552,208,1152,18704,38,459,207,1179,5661
1795.857,6,156,11852,85,82,21379,208,7858,71,36,25649,112,3994
1789.955,6,354,22440,207,69,8689,69,12420,147,69,12259,69,10020
1794.397,17,142,11360,71,48,25634,48,5396,71,56,25634,56,5964
1.255,6,12,1767,8,100,179,100,424,4,589,333,1152,1343
1.97,17,4,360,2,30,1946,30,116,2,94,1946,94,244
1684.463,2,15,480,15,8,120318,8,480,0,0,0,0,0
1.327,6,48,19190,27,890,51,1360,13574,21,476,57,2715,5616
1784.741,1,70,7420,70,78,25865,78,7420,0,0,0,0,0
1771.445,6,101,9410,66,66,27253,66,5610,35,60,52098,60,3800
1.162,17,4,368,2,32,986,32,120,2,96,902,96,248
1768.986,6,135,8298,72,27,24914,27,4353,63,27,28531,27,3945
79.771,17,42,10878,42,231,1945,388,10878,0,0,0,0,0
1.777,6,115,87455,47,131,38,232,2409,68,1395,26,1465,85046
1787.28,6,339,22116,201,72,8935,138,12732,138,69,11985,69,9384
0.488,6,17,6992,10,146,54,175,956,7,1416,55,2816,6036
0.033,17,2,214,1,39,0,39,67,1,119,0,119,147
1512.006,2,12,384,12,8,137455,8,384,0,0,0,0,0
120.386,2,2,64,2,8,120386,8,64,0,0,0,0,0
79.262,1,9,954,9,78,9907,78,954,0,0,0,0,0
1746.609,1,64,5376,0,0,0,0,0,64,56,27723,56,5376
173.424,6,28,7352,13,158,14452,267,1317,15,678,12384,3436,6035
1791.73,1,130,7280,130,28,13889,28,7280,0,0,0,0,0
1.081,6,23,7952,12,164,83,267,1288,11,1216,92,3819,6664
1797.047,1,345,28980,345,56,5223,56,28980,0,0,0,0,0
1744.205,6,95,7203,63,38,28132,205,4476,32,33,56256,98,2727
184.879,6,5345,4689003,3225,1366,57,1368,4563677,2120,899,87,2736,125326
1786.549,6,156,25203,93,483,19418,483,19346,63,83,28815,83,5857
57.86,17,6,528,3,48,28925,48,228,3,72,28925,72,300
281.404,6,31,7476,14,158,21646,267,1357,17,678,17585,3456,6119
1787.772,17,87,3648,86,14,21032,14,3612,1,8,0,8,36
0.248,17,3,451,2,39,151,39,134,1,289,0,289,317
0.021,6,17,6068,10,88,2,88,556,7,1740,3,1880,5512
2.302,6,27,10294,15,368,164,837,1709,12,1012,202,1420,8585
70.652,6,11,1346,6,302,14130,302,912,5,83,17659,83,434
2.368,17,32,6789,14,220,179,1350,3483,18,155,137,1350,3306
57.496,6,28,7217,13,155,4791,267,1306,15,482,4106,2840,5911
0.049,17,4,420,2,33,0,33,122,2,121,38,145,298
213.73,17,4,1312,4,300,71243,308,1312,0,0,0,0,0
1741.303,6,87,6322,58,31,30549,31,3915,29,31,62185,31,2407
1700.478,17,12,498,11,14,170047,14,462,1,8,0,8,36
175.867,17,2,2059,2,1001,175867,1316,2059,0,0,0,0,0
10.881,17,15,17706,15,1152,777,1449,17706,0,0,0,0,0
1744.25,6,95,7203,63,38,28133,205,4476,32,33,56257,98,2727
2.19,6,19,3781,10,234,243,564,1452,9,463,249,1343,2329
1784.175,6,102,8228,68,64,26629,64,4896,34,58,54063,58,3332
10.963,6,21,4442,12,275,996,275,1038,9,758,773,1420,3404
1752.081,6,95,7203,63,38,28259,205,4476,32,33,56510,98,2727
79.494,17,3,3059,3,991,39747,1258,3059,0,0,0,0,0
1786.705,6,104,8376,68,65,26667,65,4930,36,59,51046,59,3446
11.311,6,1816,1565675,1096,1374,10,1420,1532378,720,467,15,1883,33297
3.122,17,28,13750,12,558,283,1350,7035,16,391,127,1350,6715
0.793,6,4,220,2,0,793,0,100,2,0,307,0,120
0.445,6,119,89320,63,131,7,232,3049,56,1680,8,5372,86271
7.22,17,8,616,4,33,1333,33,244,4,65,0,65,372
5.478,6,41,7349,21,218,273,314,3463,20,440,274,1152,3886
0.007,17,2,383,1,39,0,39,67,1,288,0,288,316
240.202,6,54,17737,30,735,8282,1402,14814,24,208,10443,580,2923
1789.638,6,373,25959,216,98,8323,469,15263,157,69,11470,69,10696
1789.818,6,357,22491,208,69,8646,69,12460,149,69,12066,69,10031
1740.708,1,12,696,12,30,158246,30,696,0,0,0,0,0
3.206,17,2,144,1,36,0,36,64,1,52,0,52,80
374.68,6,18,1242,14,180,28821,180,916,4,110,20064,110,326
9.436,6,43,11302,22,615,449,921,3990,21,403,459,2720,7312
1.579,6,38,9848,21,440,78,1360,4392,17,476,85,2715,5456
1.784,6,37,8325,18,339,104,1275,2789,19,433,88,1440,5536
97.688,6,45,9973,22,631,518,1360,4127,23,327,4432,2667,5846
124.562,6,40,8456,14,131,9580,267,1622,26,321,4981,1933,6834
0.108,17,2,194,1,61,0,61,89,1,77,0,77,105
5.745,6,568,509331,362,1339,15,1368,492899,206,776,26,2736,16432
1796.206,17,449,39928,404,35,4457,288,25708,45,288,40023,288,14220
23.429,6,20,5851,11,266,2342,500,1244,9,707,2918,1420,4607
1786.29,6,103,8326,68,64,26661,64,4896,35,58,52535,58,3430
1790.73,6,267,33121,109,138,16579,1360,16094,158,133,11405,2720,17027
1796.07,17,142,11360,71,48,25658,48,5396,71,56,25658,56,5964
41.817,1,47,4888,0,0,0,0,0,47,76,909,76,4888
1797.152,17,448,39896,403,35,4470,288,25676,45,288,40018,288,14220
1799.825,6,361,22858,210,69,8611,69,12678,151,69,11998,69,10180
276.448,1,9,954,9,78,34556,78,954,0,0,0,0,0
0.077,17,4,284,2,32,36,32,120,2,54,42,60,164
205.161,6,29,1924,11,44,20500,46,793,18,44,12068,46,1131
60.177,6,140,12159,121,132,501,174,5774,19,511,3337,1420,6385
0.314,17,2,180,1,30,0,30,58,1,94,0,94,122
0.859,6,10,1687,7,100,143,100,384,3,1179,306,1179,1303
38.629,17,22,1672,22,48,1839,48,1672,0,0,0,0,0
0.571,6,289,272930,185,183,3,230,10665,104,2518,5,11264,262265
1.4,6,48,19806,27,934,53,1440,14190,21,433,61,1440,5616
10.392,6,1321,1164056,786,1401,13,1448,1131572,535,776,19,1448,32484
1756.427,6,3763,4089855,1380,145,1273,913,82287,2383,1682,737,9926,4007568
1783.247,6,111,6578,63,26,28760,26,3692,48,26,37939,26,2886
99.034,6,32,8192,10,162,10965,267,1708,22,373,4699,1917,6484
1786.677,6,104,8376,68,65,26666,65,4930,36,59,51045,59,3446
31.391,6,9,432,2,0,0,0,96,7,0,5230,0,336
300.69,6,46,8907,23,266,13667,720,2078,23,327,627,1460,6829
12.604,6,1986,1731392,1198,1389,10,1420,1695423,788,467,16,2840,35969
0.15,17,4,284,2,32,14,32,120,2,54,137,60,164
0.077,17,2,122,1,33,0,33,61,1,33,0,33,61
0.954,6,27,8120,14,266,61,540,1924,13,944,65,1591,6196
0.032,17,2,330,1,30,0,30,58,1,244,0,244,272
1799.508,6,472,40216,222,66,8020,658,15469,250,83,7226,3289,24747
3.359,6,8,440,5,0,839,0,268,3,0,1657,0,172
1795.733,17,449,39928,404,35,4455,288,25708,45,288,40020,288,14220
1797.454,17,448,39612,404,35,4460,288,25708,44,288,40952,288,13904
165.786,6,33,9061,14,158,12752,267,1357,19,578,9200,1400,7704
69.938,6,25,7845,11,261,123,467,1365,14,522,5366,1408,6480
0.947,6,10,1687,7,100,157,100,384,3,1179,348,1179,1303
11.001,6,84,24885,42,560,268,1152,19048,42,461,262,1179,5837
1715.383,1,8,848,8,78,245054,78,848,0,0,0,0,0
39.618,17,4,1344,4,308,13206,308,1344,0,0,0,0,0
5.302,6,42,8289,21,227,265,314,4022,21,489,250,1179,4267
180.828,17,4,240,2,32,180827,32,120,2,32,180827,32,120
214.854,6,75,13409,34,198,6510,1189,3749,41,308,5370,1460,9660
1740.68,17,30,7050,30,207,60023,207,7050,0,0,0,0,0
2.98,17,2,124,2,34,2980,34,124,0,0,0,0,0
1787.794,6,216,18606,79,75,22918,339,8231,137,69,13144,1062,10375
1795.698,17,448,39896,403,35,4466,288,25676,45,288,40020,288,14220
1799.489,17,376,61638,376,135,4798,386,61638,0,0,0,0,0
9.432,6,22,3281,8,324,1347,585,1081,14,285,712,580,2200
250.771,17,4,240,2,32,250769,32,120,2,32,250770,32,120
302.482,6,75,10477,38,97,8175,267,2996,37,315,8402,4837,7481
1.313,6,41,11378,21,616,65,1460,5802,20,433,59,1460,5576
192.464,6,30,7432,13,158,16038,267,1317,17,543,12024,1400,6115
1781.44,6,354,22509,206,69,8689,69,12380,148,69,12118,69,10129
1.168,6,16,6056,10,70,129,133,544,6,1756,11,2440,5512
125.428,17,4,1344,4,308,41809,308,1344,0,0,0,0,0
0.284,6,27,8944,13,227,23,547,1616,14,941,21,1408,7328
4.348,17,2,668,2,306,4348,306,668,0,0,0,0,0
1700.525,17,12,498,11,14,170052,14,462,1,8,0,8,36
1.006,17,2,925,1,548,0,548,576,1,321,0,321,349
252.286,17,4,240,2,32,252285,32,120,2,32,252285,32,120
20.745,6,34,8280,17,378,542,786,1846,17,522,1287,3488,6434
36.952,6,5104,4781657,3318,1362,11,1408,4684121,1786,931,20,2801,97536
11.683,6,1847,1614670,1123,1384,10,1420,1581489,724,526,16,3303,33181
0.242,17,2,198,1,63,0,63,91,1,79,0,79,107
0.202,6,46,22576,27,1099,7,1420,17595,19,467,10,1883,4981
0.068,17,4,284,2,32,28,32,120,2,54,41,60,164
1773.086,6,180,15480,120,69,14899,69,8940,60,69,30050,69,6540
282.466,6,34,7661,14,158,21728,267,1357,20,500,14856,1400,6304
11.36,6,1827,1580597,1117,1363,10,1380,1546032,710,511,15,1923,34565
1786.973,6,108,8666,70,65,25898,65,5140,38,59,48293,59,3526
1786.302,6,154,20017,91,304,19847,304,14156,63,83,28811,83,5861
10.75,6,18,5610,10,275,1194,275,958,8,1440,818,1440,4652
1770.125,6,99,9232,66,64,27232,65,5573,33,58,55312,59,3659
1786.399,6,104,8444,68,66,26662,66,4964,36,60,51037,60,3480
0.147,6,10,1671,6,552,28,948,1348,4,159,48,159,323
1773.095,6,180,15480,120,69,14899,69,8940,60,69,30045,69,6540
1787.248,17,83,3480,82,14,22064,14,3444,1,8,0,8,36
0.054,1,5,420,5,56,13,56,420,0,0,0,0,0
0.047,17,4,352,2,37,39,37,130,2,83,38,89,222
1783.34,17,140,11200,70,48,25845,48,5320,70,56,25845,56,5880
1791.627,6,275,34294,112,143,16139,1360,16886,163,134,11058,2720,17408
0.068,6,12,3462,6,75,13,75,395,6,1373,13,1448,3067
10.115,17,4,5480,4,1342,3371,1347,5480,0,0,0,0,0
1.34,6,39,8294,19,321,74,1164,2718,20,433,61,1460,5576
280.231,6,27,7312,12,158,25475,267,1277,15,678,20013,2800,6035
6.553,6,20,10594,8,275,936,275,599,12,1188,553,2760,9995
0.486,6,20,7238,13,335,40,668,2026,7,1210,75,1946,5212
5.036,17,3,208,2,36,5013,36,128,1,52,0,52,80
1780.262,17,345,113502,345,300,5175,392,113502,0,0,0,0,0
0.359,17,8,2758,8,316,51,355,2758,0,0,0,0,0
0.013,17,4,352,2,37,8,37,130,2,83,7,89,222
1773.162,6,180,15480,120,69,14900,69,8940,60,69,30051,69,6540
1797.44,17,448,39896,403,35,4471,288,25676,45,288,40018,288,14220
298.51,1,4,224,4,28,99503,28,224,0,0,0,0,0
240.315,6,88,70662,36,310,6866,592,2871,52,1384,4709,2736,67791
4.982,6,38,7229,19,218,276,314,3383,19,440,262,1152,3846
1785.863,6,359,22709,209,69,8585,69,12569,150,69,11985,69,10140
15.606,17,31,11740,15,511,1114,1350,8097,16,199,1037,1350,3643
1744.693,2,28,896,28,8,64618,8,896,0,0,0,0,0
61.125,17,4,240,2,32,61124,32,120,2,32,61124,32,120
1744.22,1,56,4704,0,0,0,0,0,56,56,31713,56,4704
0.857,17,16,8553,8,706,122,1350,5872,8,307,114,1350,2681
8.893,6,89,28799,45,576,202,1152,22557,44,407,201,1152,6242
1.649,6,7,466,5,43,359,43,354,2,0,1596,0,112
0.167,6,45,21351,26,1093,6,1420,16370,19,467,8,1883,4981
1791.978,17,142,11360,71,48,25599,48,5396,71,56,25599,56,5964
0.229,6,52,24676,29,1079,8,1420,19523,23,467,10,1883,5153
14.395,6,24,6993,13,275,1199,275,1078,11,910,937,1420,5915
40.18,6,31,8912,14,158,3090,267,1357,17,687,2507,1781,7555
121.105,17,3,222,3,46,60552,46,222,0,0,0,0,0
280.206,6,24,7054,11,181,28020,267,1168,13,670,23349,1400,5886
1789.949,6,364,23047,211,69,8523,69,12787,153,69,11775,69,10260
281.89,6,31,7563,14,147,21683,267,1448,17,543,17615,1400,6115
2.175,17,29,6257,13,235,178,1350,3430,16,148,142,1350,2827
5.837,6,52,20296,28,893,216,1460,14560,24,433,245,1460,5736
392.816,6,360,302458,227,1356,1738,1440,281724,133,574,2010,1440,20734
35.049,6,44,12882,22,879,734,1360,7107,22,348,1660,2667,5775
1744.64,2,28,896,28,8,64616,8,896,0,0,0,0,0
14.555,6,13,5593,4,106,4846,106,274,9,988,1817,1933,5319
250.029,6,56,30191,31,243,8334,444,2422,25,1470,10417,5632,27769
8.275,6,29,5303,14,183,636,314,2214,15,497,573,1179,3089
1788.507,17,87,3648,86,14,21041,14,3612,1,8,0,8,36
12.21,6,1936,1680573,1186,1363,10,1380,1644408,750,558,16,1923,36165
0.146,6,34,21209,18,133,8,133,1077,16,1484,9,2648,20132
1789.224,17,83,3480,82,14,22089,14,3444,1,8,0,8,36
2.159,17,2,128,2,36,2159,36,128,0,0,0,0,0
0.049,6,15,4072,8,88,7,88,440,7,1670,8,1880,3632
1.187,6,23,7952,12,164,91,267,1288,11,1216,100,3819,6664
1.981,17,2,672,2,308,1981,308,672,0,0,0,0,0
21.124,17,42,7420,20,163,1110,1350,3834,22,135,1004,1350,3586
30.34,17,8,704,4,48,10110,48,304,4,72,10110,72,400
0.082,17,2,451,1,41,0,41,69,1,354,0,354,382
5.611,17,4,304,4,48,1870,48,304,0,0,0,0,0
28.2,6,2,708,2,302,28200,302,708,0,0,0,0,0
188.419,17,4,352,2,60,188418,60,176,2,60,188418,60,176
1.134,17,5,952,3,32,505,32,180,2,358,0,470,772
0.181,6,5,4892,4,1173,0,1460,4852,1,0,0,0,40
123.16,17,14,19244,14,1346,9473,1348,19244,0,0,0,0,0
79.547,17,3,528,3,148,39773,348,528,0,0,0,0,0
1771.915,6,101,9344,66,65,27260,65,5577,35,59,52110,59,3767
1.293,6,44,14490,24,719,56,1360,8914,20,433,58,1360,5576
0.062,6,10,1865,6,649,11,1141,1542,4,159,20,159,323
4.176,6,14,2351,8,188,596,245,700,6,703,784,1152,1651
1799.283,6,211,14297,106,65,17134,208,9136,105,31,17299,31,5161
1791.858,17,768,46308,768,32,2336,37,46308,0,0,0,0,0
0.487,6,15,5386,8,965,69,1360,3217,7,269,44,272,2169
1.414,6,50,21234,28,961,52,1460,15578,22,476,58,2615,5656
118.006,6,1099,529701,579,845,204,1152,502714,520,412,226,1179,26987
1777.206,1,334,28056,334,56,5336,56,28056,0,0,0,0,0
0.012,17,2,343,1,37,0,37,65,1,250,0,250,278
41.453,1,3,312,0,0,0,0,0,3,76,20726,76,312
0.425,6,21,7290,12,335,38,668,1974,9,968,52,1475,5316
1797.22,17,180,14040,180,50,10040,50,14040,0,0,0,0,0
0.012,17,2,140,1,34,0,34,62,1,50,0,50,78
0.345,6,25,6098,12,181,31,537,1526,13,555,27,1440,4572
1744.321,6,99,7411,63,38,28134,205,4476,36,33,49832,98,2935
1.781,6,31,6498,17,149,111,267,2033,14,780,123,1460,4465
17.871,17,53,39374,22,401,838,1350,9456,31,937,583,1350,29918
1.327,6,39,8292,19,320,73,1162,2716,20,433,61,1460,5576
300.181,6,48,10237,24,657,13043,1460,4337,24,308,13043,1460,5900
1745.246,6,99,7411,63,38,28149,205,4476,36,33,49853,98,2935
1796.122,17,142,11360,71,48,25658,48,5396,71,56,25658,56,5964
0.076,6,10,767,5,186,17,186,454,5,45,16,45,313
251.763,6,138,100711,85,1271,2997,1448,88372,53,796,1898,5255,12339
300.929,6,42,13568,23,881,13678,1460,8006,19,399,485,1460,5562
0.413,6,21,7203,12,318,36,600,1906,9,964,49,1471,5297
2.124,17,3,451,2,39,577,39,134,1,289,0,289,317
153.022,6,24,9227,12,701,78,1360,3319,12,902,13895,1753,5908
852.007,1,12,672,12,28,77455,28,672,0,0,0,0,0
1682.882,17,14,1036,7,30,280472,30,406,7,62,280473,62,630
20.76,6,17,744,8,0,2965,0,348,9,0,2233,0,396
421.205,2,5,160,5,8,105301,8,160,0,0,0,0,0
1799.54,17,449,39928,404,35,4465,288,25708,45,288,40015,288,14220
80.634,6,22,2564,8,189,11518,517,1194,14,323,6202,499,1370
68.493,6,65,43043,41,1175,1712,1448,35042,24,749,2677,1448,8001
1772.736,6,180,15480,120,69,14896,69,8940,60,69,30040,69,6540
1799.376,17,449,39928,404,35,4464,288,25708,45,288,40021,288,14220
565.203,1,8,448,8,28,80743,28,448,0,0,0,0,0
2.045,17,2,204,1,34,0,34,62,1,114,0,114,142
1780.393,1,122,6832,122,28,14713,28,6832,0,0,0,0,0
113.604,6,43,10958,20,855,563,1360,5143,23,325,5155,1360,5815
3.592,17,5,340,5,40,898,40,340,0,0,0,0,0
421.086,2,5,160,5,8,105271,8,160,0,0,0,0,0
18.66,17,12,1056,6,48,3729,48,456,6,72,3730,72,600
1605.672,1,8,448,8,28,229381,28,448,0,0,0,0,0
20.105,17,19,12900,12,880,1825,1350,10902,7,257,3345,1350,1998
0.826,6,10,1687,7,100,137,100,384,3,1179,276,1179,1303
1772.06,6,180,15480,120,69,14891,69,8940,60,69,30032,69,6540
110.94,6,1045,526708,581,841,191,1152,503016,464,427,239,1179,23692
3.428,6,51,14742,27,756,131,1460,8710,24,361,129,1460,6032
101.295,6,108,82422,69,1271,1489,1448,72231,39,679,2660,1448,10191
3.801,1,9,936,0,0,0,0,0,9,76,475,76,936
39.671,1,45,4680,0,0,0,0,0,45,76,901,76,4680
0.432,6,22,7255,12,318,39,600,1906,10,964,44,1851,5349
0.126,17,2,158,1,34,0,34,62,1,68,0,68,96
299.891,1,4,224,4,28,99963,28,224,0,0,0,0,0
1786.24,17,87,3648,86,14,21014,14,3612,1,8,0,8,36
82.904,6,23,4755,9,272,134,516,1180,14,273,6370,1452,3575
280.22,6,29,7392,13,158,23351,267,1317,16,603,18679,2036,6075
300.86,6,24,9724,14,297,23131,844,1783,10,1505,33412,4477,7941
0.739,17,2,778,2,361,739,361,778,0,0,0,0,0
241.084,6,53,9295,27,141,9269,517,2824,26,425,9641,1497,6471
0.074,6,9,1348,5,145,18,145,349,4,835,22,835,999
0.019,17,2,507,1,37,0,37,65,1,414,0,414,442
1782.159,1,58,4872,58,56,31265,56,4872,0,0,0,0,0
0.017,6,2,92,1,0,0,0,40,1,0,0,0,52
1799.173,17,142,11360,71,48,25702,48,5396,71,56,25702,56,5964
1798.663,17,180,14040,180,50,10048,50,14040,0,0,0,0,0
95.944,17,4,352,2,60,95942,60,176,2,60,95943,60,176
1791.326,17,141,11276,71,48,25571,48,5396,70,56,25936,56,5880
156.959,6,242,189378,150,1285,1053,1368,173671,92,605,1721,1368,15707
0.01,17,2,596,1,33,0,33,61,1,507,0,507,535
1786.19,6,102,8364,68,66,26659,66,4964,34,60,54124,60,3400
383.496,1,4,416,4,76,127832,76,416,0,0,0,0,0
1792.589,6,356,22520,208,69,8659,69,12460,148,69,12194,69,10060
1783.296,6,354,22440,207,69,8656,69,12420,147,69,12214,69,10020
1783.406,17,73,3060,72,14,25118,14,3024,1,8,0,8,36
394.466,1,22,1848,22,56,18784,56,1848,0,0,0,0,0
1787.022,6,104,8444,68,66,26671,66,4964,36,60,51053,60,3480
1.176,17,3,618,2,32,943,32,120,1,470,0,470,498
240.295,6,42,8946,21,524,12014,1418,5817,21,225,12014,639,3129
1795.42,17,140,11200,70,48,26020,48,5320,70,56,26020,56,5880
0.011,17,2,362,1,46,0,46,74,1,260,0,260,288
1741.286,6,95,7203,63,38,28085,205,4476,32,33,56160,98,2727
0.279,6,26,8991,13,247,23,624,1672,13,947,22,1438,7319
1799.859,17,449,39928,404,35,4466,288,25708,45,288,40020,288,14220
1671.374,1,7,392,7,28,278562,28,392,0,0,0,0,0
1.047,6,29,6067,15,142,74,267,1602,14,650,72,1452,4465
1772.74,1,61,5124,61,56,29545,56,5124,0,0,0,0,0
0.006,17,2,410,1,63,0,63,91,1,291,0,291,319
45.742,6,37,8301,18,345,510,721,1788,19,441,2533,1460,6513
0.431,6,10,968,5,256,102,256,460,5,304,104,304,508
1.49,6,57,14571,28,551,55,1429,5024,29,440,48,1986,9547
305.894,17,4,296,4,46,101964,46,296,0,0,0,0,0
0.494,6,28,7048,17,244,30,656,2394,11,701,48,1696,4654
1679.561,17,12,498,11,14,167956,14,462,1,8,0,8,36
38.629,17,22,1936,11,48,3862,48,836,11,72,3861,72,1100
0.007,17,3,401,2,39,1,39,134,1,239,0,239,267
241.913,6,40,13368,26,387,9676,1360,6497,14,787,18594,3494,6871
75.583,6,30,7573,11,155,32,267,1226,19,398,4198,2840,6347
315.585,6,70,47339,44,1192,7339,1448,39258,26,746,2463,1448,8081
1792.362,6,309,20709,184,69,9794,69,11569,125,69,14454,69,9140
2.217,6,41,9571,22,438,105,1460,3990,19,400,109,1460,5581
8.396,17,22,6251,9,276,1049,1350,2740,13,242,687,1350,3511
37.385,6,99,68429,51,544,65,1066,4292,48,1433,794,4344,64137
0.023,6,3,182,2,31,23,31,111,1,31,0,31,71
1783.325,17,83,3480,82,14,22016,14,3444,1,8,0,8,36
1787.521,6,102,8296,68,65,26679,65,4930,34,59,54163,59,3366
0.257,6,24,5937,12,164,23,453,1442,12,643,22,1542,4495
6.947,6,640,584927,415,1339,16,1368,566575,225,931,30,2736,18352
10.823,6,25,10982,13,275,901,275,803,12,1210,832,1440,10179
1511.433,6,91,7021,53,85,29066,138,4259,38,69,10960,69,2762
395.107,6,18,1242,14,180,30392,180,916,4,110,20058,110,326
1.896,6,2,1520,1,0,0,0,40,1,1440,0,1440,1480
1789.864,17,140,11200,70,48,25939,48,5320,70,56,25939,56,5880
2.152,6,13,2311,8,188,307,245,700,5,1407,472,1407,1611
1.331,6,12,3462,6,75,266,75,395,6,1373,266,1448,3067
8.832,6,36,8239,18,311,519,619,1734,18,444,508,2720,6505
193.539,6,35,8680,12,213,17590,469,2199,23,370,8794,2077,6481
1.366,6,24,8004,12,164,105,267,1288,12,1014,105,2491,6716
1791.15,17,142,11360,71,48,25587,48,5396,71,56,25587,56,5964
1075.538,17,212,16112,212,48,5097,48,16112,0,0,0,0,0
194.839,6,127,92302,77,1271,2563,1408,81580,50,811,1835,3847,10722
1.035,6,24,8016,12,164,94,267,1300,12,869,76,1408,6716
0.483,17,12,4377,12,336,43,359,4377,0,0,0,0,0
1.137,6,24,8004,12,164,88,267,1288,12,1014,87,2411,6716
300.448,6,51,21143,20,181,15812,604,2160,31,789,10014,1533,18983
1786.965,17,87,3648,86,14,21023,14,3612,1,8,0,8,36
252.56,6,11,790,8,106,36080,106,646,3,0,1508,0,144
1783.675,17,83,3480,82,14,22020,14,3444,1,8,0,8,36
103.683,6,25,12059,12,410,66,922,1754,13,1085,8629,1460,10305
1772.633,6,180,15480,120,69,14896,69,8940,60,69,30039,69,6540
1469.007,6,118,13878,68,91,19426,502,5383,50,144,29977,1452,8495
1.276,6,25,8056,12,164,98,267,1288,13,869,90,1408,6768
41.589,6,27,7177,13,155,3465,267,1306,14,530,3198,3417,5871
2.743,6,3,216,1,0,0,0,40,2,96,68,96,176
0.046,17,4,664,2,33,0,33,122,2,243,36,307,542
0.928,6,10,1687,7,100,154,100,384,3,1179,331,1179,1303
0.504,6,27,9130,13,263,42,688,1748,14,947,35,1368,7382
0.407,6,46,18366,25,942,16,1380,13284,21,421,17,1923,5082
61.28,6,10,838,5,180,15320,180,460,5,110,15211,110,378
0.266,17,2,382,1,32,0,32,60,1,294,0,294,322
1.795,6,5,280,3,0,897,0,160,2,0,975,0,120
240.3,6,43,9158,21,523,12014,1408,5810,22,244,11442,618,3348
1.157,6,11,1727,7,100,192,100,384,4,589,300,1152,1343
1798.307,17,450,39960,405,35,4451,288,25740,45,288,40019,288,14220
4.942,17,6,1392,6,204,988,204,1392,0,0,0,0,0
1797.739,6,356,22520,208,69,8684,69,12460,148,69,12229,69,10060
0.212,17,2,186,1,41,0,41,69,1,89,0,89,117
1788.452,6,232,20297,87,81,20793,336,9337,145,70,12418,1062,10960
1.2,6,4,184,2,0,1200,0,88,2,0,1029,0,96
1797.991,6,379,26806,218,103,8285,469,15881,161,69,11236,69,10925
1750.67,17,12,498,11,14,175067,14,462,1,8,0,8,36
102.401,6,26,7533,9,267,152,501,1165,17,406,6394,1420,6368
5.0,6,39,7269,19,218,277,314,3383,20,513,248,1179,3886
546.985,6,111,7131,62,72,8955,138,3860,49,69,11395,69,3271
0.259,6,46,22267,27,1079,9,1420,17286,19,467,13,1883,4981
1787.719,6,371,26279,214,105,8393,469,15514,157,69,11459,69,10765
151.144,6,38,19207,19,921,107,1460,10028,19,840,8387,1460,9179
60.413,17,4,240,2,32,60412,32,120,2,32,60412,32,120
3.968,6,32,8952,14,158,305,267,1357,18,624,231,1300,7595
35.716,1,41,4264,0,0,0,0,0,41,76,892,76,4264
1770.342,6,99,9306,66,66,27236,66,5610,33,60,55320,60,3696
0.612,17,2,204,1,34,0,34,62,1,114,0,114,142
509.988,6,51,4450,29,69,18213,69,2126,22,68,24093,69,2324
1.679,6,50,17301,28,800,62,1360,11600,22,437,70,2715,5701
4.762,6,30,11349,11,338,469,561,1837,19,793,254,1440,9512
2.235,6,14,2351,8,188,319,245,700,6,703,395,1152,1651
1164.357,6,233,14771,135,69,8689,69,8160,98,69,12003,69,6611
230.321,17,18,6044,18,307,13548,308,6044,0,0,0,0,0
1129.618,6,91,9581,50,68,23050,722,4324,41,115,28236,1408,5257
280.349,6,28,7352,13,158,23362,267,1317,15,678,20024,3436,6035
0.42,6,26,9026,13,263,35,691,1736,13,943,33,1448,7290
0.523,6,118,87039,53,131,10,232,2649,65,1363,7,2860,84390
20.664,6,37,8770,19,395,1148,872,1979,18,466,525,1460,6791
7.363,6,1183,1022210,718,1376,10,1420,999389,465,420,15,1420,22821
1788.513,17,87,3648,86,14,21041,14,3612,1,8,0,8,36
1.336,17,29,10266,12,363,118,1350,4703,17,299,81,1350,5563
0.01,17,2,383,1,39,0,39,67,1,288,0,288,316
0.735,17,2,685,1,308,0,308,336,1,321,0,321,349
1744.637,2,28,896,28,8,64616,8,896,0,0,0,0,0
280.292,6,29,7392,13,158,23357,267,1317,16,603,18682,1400,6075
63.65,6,29,7140,13,124,5304,267,1396,16,728,4242,2828,5744
33.607,6,29,4989,14,180,2585,722,1807,15,342,2386,1448,3182
1618.977,1,78,4368,78,28,21025,28,4368,0,0,0,0,0
125.62,6,34,7935,12,155,29,267,1266,22,340,5981,3417,6669
280.229,6,26,7272,12,158,25475,267,1277,14,775,21553,3445,5995
1.845,6,27,8850,16,286,123,590,1502,11,863,165,1380,7348
280.474,6,27,7312,12,158,25497,267,1277,15,678,20029,2760,6035
279.471,2,10,416,10,17,31052,24,416,0,0,0,0,0
0.015,17,2,394,1,37,0,37,65,1,301,0,301,329
378.826,6,19,1303,14,177,29140,177,925,5,110,15175,110,378
0.925,6,10,1687,7,100,154,100,384,3,1179,330,1179,1303
159.827,6,24,9340,12,201,81,290,1127,12,965,14517,2868,8213
3.153,17,2,168,1,48,0,48,76,1,64,0,64,92
290.162,1,4,224,4,28,96720,28,224,0,0,0,0,0
0.383,17,2,221,1,35,0,35,63,1,130,0,130,158
1.696,6,13,2311,8,188,242,245,700,5,1407,362,1407,1611
280.019,6,30,7432,13,158,23334,267,1317,17,543,17499,1400,6115
1.237,6,8,342,4,0,412,0,164,4,7,279,7,178
32.01,6,9,396,2,0,3457,0,88,7,0,5320,0,308
1793.152,6,81,4302,41,26,44827,26,2184,40,26,45977,26,2118
61.29,6,10,648,10,31,6810,31,648,0,0,0,0,0
1787.014,6,106,8515,69,65,26279,65,4970,37,59,49632,59,3545
33.626,6,33,5408,17,154,2101,721,1974,16,371,2228,2118,3434
1791.997,6,361,22858,210,69,8574,69,12678,151,69,11946,69,10180
1780.651,6,354,22440,207,69,8643,69,12420,147,69,12196,69,10020
1786.451,6,154,19574,92,302,19631,302,13852,62,83,29285,83,5722
300.635,6,44,8998,22,309,14315,891,2209,22,346,620,2720,6789
280.41,6,28,7352,12,158,25491,267,1277,16,678,18690,2085,6075
0.378,6,12,1653,7,288,63,288,588,5,426,50,434,1065
0.028,17,2,256,1,49,0,49,77,1,151,0,151,179
278.167,6,165,124998,102,1287,2754,1408,112208,63,731,2533,3847,12790
0.014,17,2,279,1,36,0,36,64,1,187,0,187,215
1795.305,17,366,59535,366,134,4918,366,59535,0,0,0,0,0
32.969,17,36,5292,18,48,1938,48,1368,18,190,1938,308,3924
1740.479,17,30,7050,30,207,60016,207,7050,0,0,0,0,0
1741.333,6,90,6552,59,31,30022,31,3998,31,31,58042,31,2554
4.029,2,2,64,2,8,4029,8,64,0,0,0,0,0
1789.031,6,418,25010,208,69,8642,69,12460,210,34,8559,64,12550
371.137,6,23,1535,16,177,24742,177,1053,7,110,10395,110,482
1765.047,17,167,13992,155,30,11461,37,9032,12,385,154856,463,4960
1792.201,6,356,22520,208,69,8657,69,12460,148,69,12191,69,10060
1789.504,6,222,17298,141,69,12782,69,9918,81,69,22368,69,7380
1696.776,17,15,3774,15,223,121198,1030,3774,0,0,0,0,0
1785.998,6,78,4108,39,26,46995,26,2054,39,26,46995,26,2054
8.566,6,26,7748,13,256,713,721,1806,13,774,562,1440,5942
313.961,6,23,2585,7,242,52326,517,1111,16,323,20930,499,1474
0.062,6,11,923,6,181,12,181,501,5,77,14,133,422
0.179,6,2,142,1,62,0,62,102,1,0,0,0,40
1779.986,17,138,11040,69,48,26176,48,5244,69,56,26176,56,5796
1785.221,17,83,3480,82,14,22039,14,3444,1,8,0,8,36
1786.45,6,104,8444,68,66,26663,66,4964,36,60,51038,60,3480
20.31,6,24,5827,14,107,1562,159,1190,10,821,2254,1659,4637
1.613,17,4,288,2,36,1280,36,128,2,52,1263,52,160
1793.102,1,274,29044,274,78,6568,78,29044,0,0,0,0,0
169.466,6,54,23282,28,1039,3242,1460,13632,26,537,6771,1460,9650
1082.884,2,11,352,11,8,108288,8,352,0,0,0,0,0
50.709,6,42,9910,20,672,638,1360,4228,22,399,2405,1360,5682
0.821,17,16,10516,8,822,117,1350,6806,8,435,88,1350,3710
106.57,6,27,14190,13,626,73,1460,3059,14,1319,8186,2470,11131
17.46,17,82,13887,44,144,403,1209,7610,38,137,471,1252,6277
1.801,17,4,946,2,40,1790,40,136,2,377,1790,407,810
0.792,6,10,968,5,256,196,256,460,5,304,196,304,508
11.003,6,20,4442,11,275,1100,275,998,9,768,777,1440,3444
37.424,6,36,8161,18,311,521,619,1687,18,478,2191,2720,6474
34.285,6,4633,4178018,2796,1406,12,1448,4068886,1837,776,18,1448,109132
1732.897,1,66,3696,66,28,26659,28,3696,0,0,0,0,0
1.37,6,44,15379,24,801,59,1360,9803,20,433,62,1360,5576
76.408,6,135,103578,85,1262,909,1368,92804,50,742,1554,2519,10774
1782.149,6,106,8524,68,66,26599,66,4964,38,60,48163,60,3560
243.512,6,58,29939,28,818,9018,1438,6423,30,1045,8368,2876,23516
2.073,6,58,17943,28,767,76,1460,8825,30,416,70,1460,9118
233.228,17,4,352,2,60,233227,60,176,2,60,233227,60,176
28.7,6,9,527,5,43,7175,43,311,4,0,9565,0,216
12.323,6,21,3558,11,210,1228,210,1048,10,664,1368,904,2510
1772.561,6,180,15480,120,69,14895,69,8940,60,69,30037,69,6540
1.182,6,23,7952,12,164,91,267,1288,11,1216,100,2804,6664
0.135,6,9,1002,5,213,33,213,417,4,421,38,421,585
11.029,6,85,24685,42,535,269,1152,18824,43,459,256,1179,5861
46.027,17,4,558,2,36,46022,36,128,2,187,46022,187,430
2.906,17,3,1021,2,308,1913,308,672,1,321,0,321,349
1790.121,6,358,22669,209,69,8606,69,12500,149,69,12092,69,10169
3.653,6,16,3357,7,92,608,92,544,9,579,411,1448,2813
1.635,6,13,2311,8,188,233,245,700,5,1407,347,1407,1611
7.325,6,8,460,3,0,3662,0,160,5,0,1775,0,300
7.141,6,5,240,1,0,0,0,48,4,0,2377,0,192
6.161,6,40,7309,20,218,324,314,3423,20,513,308,1179,3886
1793.743,17,180,11520,180,36,10020,36,11520,0,0,0,0,0
1740.493,17,30,7050,30,207,60017,207,7050,0,0,0,0,0
10.539,6,24,7964,9,154,1317,267,832,15,724,748,1997,7132
1097.977,6,73,39500,53,924,21114,1440,37902,20,31,57778,31,1598
10.66,6,20,4442,11,275,1066,275,998,9,768,735,1440,3444
95.664,6,25,11776,12,746,69,1460,3496,13,1106,7959,1460,8280
0.003,17,2,550,2,247,3,247,550,0,0,0,0,0
1.23,6,23,7952,12,164,96,267,1288,11,1216,105,3819,6664
0.034,17,2,586,1,41,0,41,69,1,489,0,489,517
2.033,17,6,460,3,40,1008,41,206,3,56,902,57,254
111.709,6,22,896,9,0,6836,0,364,13,0,9308,0,532
1679.562,17,12,498,11,14,167956,14,462,1,8,0,8,36
2.637,6,26,8108,13,164,191,267,1340,13,869,186,1448,6768
1798.896,17,448,39896,403,35,4474,288,25676,45,288,40020,288,14220
60.159,6,21,15938,7,142,38,142,426,14,1358,4621,1420,15512
1771.76,6,99,9240,66,65,27257,65,5577,33,59,55364,59,3663
1782.727,17,85,3569,83,14,21740,15,3487,2,13,313455,18,82
300.966,6,54,10730,26,439,12038,910,3342,28,312,557,1460,7388
0.071,17,2,184,1,32,0,32,60,1,96,0,96,124
39.394,17,44,6468,22,48,1870,48,1672,22,190,1874,308,4796
1.922,17,3,468,3,128,961,128,468,0,0,0,0,0
9.374,6,1667,1530074,1054,1374,8,1408,1493534,613,931,15,2801,36540
0.005,17,2,389,1,46,0,46,74,1,287,0,287,315
0.853,6,52,13853,24,549,37,1429,4824,28,438,30,1460,9029
1744.707,2,26,832,26,8,69788,8,832,0,0,0,0,0
1743.705,6,96,7286,63,38,28124,205,4476,33,33,54481,98,2810
281.155,6,34,7677,16,158,18743,267,1437,18,501,16535,1400,6240
1736.312,2,22,704,22,8,82681,8,704,0,0,0,0,0
48.687,6,27,7177,13,155,4057,267,1306,14,530,3744,3417,5871
1799.518,1,58,4872,0,0,0,0,0,58,56,31570,56,4872
1781.758,6,356,22520,208,69,8607,69,12460,148,69,12120,69,10060
1680.69,1,7,392,7,28,280115,28,392,0,0,0,0,0
1503.933,2,12,384,12,8,136721,8,384,0,0,0,0,0
0.189,6,46,21814,27,1048,7,1420,16833,19,467,10,1883,4981
270.943,17,4,240,2,32,270942,32,120,2,32,270942,32,120
310.134,6,54,12419,29,577,11076,1448,4465,25,332,636,1000,7954
1786.875,6,362,22898,210,69,8549,69,12678,152,69,11833,69,10220
0.042,17,2,150,1,39,0,39,67,1,55,0,55,83
1796.038,17,476,60154,226,167,7982,1350,44096,250,36,7212,1350,16058
2.467,17,2,677,1,300,0,300,328,1,321,0,321,349
1744.921,6,95,7203,63,38,28143,205,4476,32,33,56278,98,2727
1028.085,6,61,5760,39,70,27054,163,3433,22,58,48951,60,2327
1793.923,6,359,22709,209,69,8624,69,12569,150,69,12039,69,10140
7.26,6,1407,1296194,892,1376,7,1408,1264750,515,931,13,2801,31444
0.108,6,12,2069,7,324,18,585,1009,5,396,21,580,1060
6.197,6,12,945,6,222,1236,222,466,6,231,1236,231,479
290.807,6,61,9141,28,304,10770,1056,5144,33,161,9087,580,3997
1628.454,1,7,392,7,28,271409,28,392,0,0,0,0,0
89.895,6,30,8397,8,156,12842,267,1112,22,375,4276,1420,7285
14.565,6,2317,2266138,1491,1442,9,1448,2218498,826,776,17,1448,47640
0.022,6,2,1997,1,0,0,0,40,1,1917,0,1917,1957
3.217,17,2,656,2,300,3217,300,656,0,0,0,0,0
61.641,17,8,608,8,48,8805,48,608,0,0,0,0,0
4.489,6,23,6464,11,262,444,517,1368,12,744,404,1418,5096
4.051,17,5,290,5,30,1012,30,290,0,0,0,0,0
1782.148,17,83,3480,82,14,22001,14,3444,1,8,0,8,36
68.342,6,23,10178,12,561,59,1360,2759,11,1393,6821,3934,7419
0.793,6,10,1042,5,213,198,213,417,5,421,185,421,625
1797.473,6,230,20178,86,81,21144,375,9258,144,70,12568,1062,10920
606.541,2,7,224,7,8,101090,8,224,0,0,0,0,0
1782.282,17,140,11200,70,48,25830,48,5320,70,56,25830,56,5880
1778.139,1,59,4956,0,0,0,0,0,59,56,30657,56,4956
1781.764,6,365,23087,211,69,8484,69,12787,154,69,11645,69,10300
12.186,17,10,830,5,47,3044,47,375,5,63,3044,63,455
10.761,6,20,4442,11,275,1076,275,998,9,768,749,1440,3444
1788.487,6,370,31867,212,102,8476,469,15889,158,128,11389,1452,15978
1776.872,6,102,8296,68,65,26520,65,4930,34,59,53841,59,3366
0.978,17,12,5897,6,585,195,1350,3680,6,341,113,1350,2217
18.367,17,19,7576,9,482,2292,1350,4598,10,269,2037,1350,2978
1778.988,17,140,11200,70,48,25782,48,5320,70,56,25782,56,5880
1.216,6,47,18164,26,882,48,1360,12548,21,476,52,2715,5616
1.785,17,20,5180,20,231,93,388,5180,0,0,0,0,0
1.091,17,2,784,2,364,1091,364,784,0,0,0,0,0
3.754,6,249,242194,97,1009,39,1460,19051,152,1539,23,5840,223143
44.54,6,33,8958,14,327,93,1189,2535,19,471,2473,1420,6423
249.511,6,32,6830,19,151,13861,501,1825,13,448,20785,1420,5005
1789.22,17,270,53752,270,171,6651,358,53752,0,0,0,0,0
75.531,6,32,7653,12,155,28,267,1266,20,371,3975,1997,6387
2.475,17,2,384,1,39,0,39,67,1,289,0,289,317
47.568,6,41,5843,21,192,2378,585,3025,20,177,2490,580,2818
244.351,6,62,11700,28,329,9048,585,6111,34,234,7403,1050,5589
19.066,6,30,7255,13,153,1588,267,1303,17,525,1181,2077,5952
1794.047,6,370,25232,214,93,8422,469,14645,156,69,11574,69,10587
0.113,6,9,1343,5,145,28,145,349,4,830,31,830,994
1773.469,6,180,15480,120,69,14903,69,8940,60,69,30051,69,6540
76.871,6,15,2374,7,352,139,785,1358,8,342,10962,532,1016
0.088,6,9,1343,5,145,22,145,349,4,830,23,830,994
5.012,17,4,558,2,36,5002,36,128,2,187,4957,187,430
56.107,17,4,4186,4,1018,18702,1451,4186,0,0,0,0,0
0.651,17,4,1108,2,30,637,30,116,2,468,640,468,992
113.327,17,4,352,2,60,113326,60,176,2,60,113326,60,176
4.664,6,38,7229,20,218,245,314,3423,18,513,259,1179,3806
1786.888,17,138,11040,69,48,26277,48,5244,69,56,26277,56,5796
429.418,17,8,2688,8,308,61345,308,2688,0,0,0,0,0
1742.412,1,73,6132,0,0,0,0,0,73,56,24200,56,6132
1786.865,6,102,8364,68,66,26669,66,4964,34,60,54140,60,3400
0.012,17,3,1007,1,137,0,137,165,2,393,11,393,842
0.496,17,3,543,2,39,14,39,134,1,381,0,381,409
1.302,6,220,171134,130,1327,10,1420,163243,90,475,14,1883,7891
0.441,17,4,608,2,60,135,60,176,2,188,174,188,432
0.161,6,24,7176,12,155,14,267,1261,12,775,13,3445,5915
3.656,17,4,268,4,39,1218,39,268,0,0,0,0,0
0.058,17,2,148,1,32,0,32,60,1,60,0,60,88
1786.303,17,87,3648,86,14,21015,14,3612,1,8,0,8,36
260.54,6,54,10682,23,163,8363,469,3058,31,236,8684,3417,7624
1784.007,6,359,22709,209,69,8576,69,12569,150,69,11973,69,10140
1792.882,6,283,33709,116,137,15588,1460,16497,167,126,10799,1642,17212
471.883,6,21,1595,10,63,24030,63,715,11,44,47179,57,880
1781.229,6,435,117426,217,490,8245,1360,90819,218,194,8207,3298,26607
369.717,6,19,1303,14,177,28439,177,925,5,110,16067,110,378
240.213,6,54,18276,29,784,8578,1418,15643,25,165,10008,580,2633
0.194,17,2,180,1,30,0,30,58,1,94,0,94,122
0.17,17,2,290,1,40,0,40,68,1,194,0,194,222
381.261,6,27,1767,18,177,22427,177,1181,9,110,8612,110,586
1795.458,17,446,39264,403,35,4466,288,25676,43,288,41929,288,13588
1788.444,6,415,24880,208,69,8639,69,12460,207,34,8681,69,12420
0.061,17,3,1540,3,485,30,513,1540,0,0,0,0,0
18.957,17,4,824,2,48,18911,48,152,2,308,18919,308,672
1.094,6,27,9278,14,288,84,796,1747,13,1166,76,2720,7531
1772.264,6,180,15480,120,69,14892,69,8940,60,69,30037,69,6540
1740.179,6,87,6322,58,31,30529,31,3915,29,31,62148,31,2407
504.975,2,7,224,7,8,84162,8,224,0,0,0,0,0
0.02,17,2,235,1,36,0,36,64,1,143,0,143,171
1755.435,6,210,27233,113,304,15673,304,18480,97,83,18285,83,8753
1320.172,17,14,3664,7,31,220026,37,413,7,436,220026,463,3251
1386.284,2,8,256,8,8,198040,8,256,0,0,0,0,0
0.025,17,8,2454,8,278,3,317,2454,0,0,0,0,0
0.858,6,9,1346,5,145,214,145,349,4,833,173,833,997
280.576,6,28,7352,13,158,23381,267,1317,15,678,20035,3456,6035
1778.042,17,141,11276,71,48,25400,48,5396,70,56,25767,56,5880
1787.562,6,102,8364,68,66,26680,66,4964,34,60,54164,60,3400
1.327,6,44,16263,25,807,55,1360,10727,19,476,63,2715,5536
1.449,6,48,18663,26,918,57,1460,13007,22,433,59,1460,5656
0.012,17,2,152,1,48,0,48,76,1,48,0,48,76
2.282,6,61,28366,35,1046,67,1360,22425,26,480,82,4075,5941
189.627,1,4,424,4,78,63209,78,424,0,0,0,0,0
294.933,6,36,8086,13,158,24577,267,1317,23,365,13405,1400,6769
0.252,17,2,138,1,33,0,33,61,1,49,0,49,77
1799.581,17,448,39896,403,35,4476,288,25676,45,288,40019,288,14220
1.122,6,23,6590,13,349,93,1083,2270,10,979,123,1731,4320
1788.757,6,367,23305,213,69,8437,69,13005,154,69,11690,69,10300
2.62,17,2,778,2,361,2620,361,778,0,0,0,0,0
240.253,6,53,18508,28,823,8897,1418,15466,25,216,10010,580,3042
1.413,6,30,6427,15,164,100,267,1922,15,780,88,1460,4505
1782.109,17,83,3480,82,14,22001,14,3444,1,8,0,8,36
1.388,6,53,22597,29,979,49,1460,16861,24,433,52,1460,5736
1.163,6,10,1687,7,100,193,100,384,3,1179,440,1179,1303
300.242,6,31,11838,17,593,18765,1408,4463,14,948,18476,1578,7375
76.255,17,8,704,4,48,25415,48,304,4,72,25415,72,400
1746.703,6,95,7203,63,38,28172,205,4476,32,33,56331,98,2727
1795.863,1,58,4872,0,0,0,0,0,58,56,31506,56,4872
13.823,17,4,240,2,32,13823,32,120,2,32,13823,32,120
6.819,6,27,7384,11,155,681,267,1226,16,459,454,3426,6158
1727.496,17,313,65285,313,180,5536,422,65285,0,0,0,0,0
0.075,6,12,1761,8,227,10,517,1320,4,112,23,156,441
9.131,17,8,1684,4,47,3039,47,300,4,318,3039,318,1384
3.854,17,22,8915,10,380,424,1350,4086,12,374,347,1350,4829
5.018,17,4,288,2,36,5006,36,128,2,52,5005,52,160
14.777,6,83,23650,42,540,360,1152,17901,41,410,362,1152,5749
12.094,6,1921,1662793,1151,1388,10,1420,1627676,770,467,15,1883,35117
0.025,17,2,172,1,50,0,50,78,1,66,0,66,94
0.306,6,2,92,2,0,0,0,92,0,0,0,0,0
12.423,6,17,4322,8,275,1774,275,878,9,768,1395,1440,3444
1772.369,6,180,15480,120,69,14893,69,8940,60,69,30033,69,6540
7.458,6,5,220,1,0,0,0,44,4,0,2402,0,176
38.0,17,22,1936,11,48,3799,48,836,11,72,3798,72,1100
296.671,17,3,1008,3,308,148335,308,1008,0,0,0,0,0
0.435,6,35,7204,16,116,29,517,2032,19,378,23,1408,5172
587.518,1,16,896,16,28,39167,28,896,0,0,0,0,0
43.116,6,50,13816,24,965,675,1460,7819,26,290,1717,1460,5997
141.817,1,4,224,4,28,47272,28,224,0,0,0,0,0
148.633,6,31,8912,14,158,11433,267,1357,17,763,9283,2760,7555
0.012,17,2,375,1,44,0,44,72,1,275,0,275,303
1.532,6,50,19263,27,889,58,1360,13567,23,433,60,1360,5696
1743.101,1,58,4872,58,56,30580,56,4872,0,0,0,0,0
1797.854,6,2080,2043643,687,149,2620,840,43948,1393,1463,1291,7090,1999695
0.054,17,4,350,2,34,47,34,124,2,85,46,91,226
142.876,6,24,10049,13,531,53,1360,2677,11,1153,14274,2574,7372
1783.241,17,140,11200,70,48,25843,48,5320,70,56,25843,56,5880
61.087,6,46,14545,25,849,2538,1360,8674,21,386,3045,2667,5871
625.728,17,116,8816,116,48,5441,48,8816,0,0,0,0,0
1754.393,6,131,13062,80,67,22207,721,6794,51,87,35083,1448,6268
261.648,6,86,71168,56,621,4757,917,6194,30,2348,9022,8448,64974
240.195,6,54,17820,29,785,8578,1418,14868,25,205,10007,580,2952
1.665,17,2,136,1,32,0,32,60,1,48,0,48,76
0.009,1,2,192,2,68,9,68,192,0,0,0,0,0
0.097,6,2,116,1,0,0,0,64,1,0,0,0,52
0.227,6,22,5040,10,137,25,267,1092,12,577,20,1400,3948
43.77,6,24,8278,12,487,3979,1050,2581,12,721,3973,1491,5697
1741.19,6,93,6720,60,31,29511,31,4081,33,31,54410,31,2639
245.346,6,10,2109,6,355,49069,413,1319,4,210,81654,269,790
1798.315,17,73,3060,72,14,25328,14,3024,1,8,0,8,36
1742.378,1,57,4788,0,0,0,0,0,57,56,31113,56,4788
0.126,6,16,6172,8,103,17,103,527,8,1044,18,1448,5645
17.208,6,132,91054,58,145,301,232,3347,74,1366,235,1430,87707
4.976,17,2,130,2,37,4976,37,130,0,0,0,0,0
118.073,17,4,352,2,60,118071,60,176,2,60,118072,60,176
881.9,2,5,160,5,8,220475,8,160,0,0,0,0,0
1772.373,6,180,15480,120,69,14893,69,8940,60,69,30033,69,6540
1771.973,6,180,15480,120,69,14890,69,8940,60,69,30032,69,6540
3.31,17,2,312,2,128,3310,128,312,0,0,0,0,0
1796.717,17,142,11360,71,48,25667,48,5396,71,56,25667,56,5964
1725.521,17,12,498,11,14,172552,14,462,1,8,0,8,36
1292.165,1,6,336,6,28,258433,28,336,0,0,0,0,0
0.252,6,9,1338,5,549,63,549,753,4,421,60,421,585
151.257,6,22,8584,11,556,104,1329,2140,11,998,15107,1791,6444
1787.551,6,356,22520,208,69,8635,69,12460,148,69,12157,69,10060
1797.632,6,356,22520,208,69,8684,69,12460,148,69,12228,69,10060
297.328,17,4,352,2,60,297327,60,176,2,60,297327,60,176
1101.774,17,216,16416,216,48,5124,48,16416,0,0,0,0,0
1.383,6,46,18678,27,859,53,1360,13142,19,476,66,2715,5536
5.171,6,39,7269,20,218,272,314,3423,19,513,273,1179,3846
1.28,17,3,451,2,39,475,39,134,1,289,0,289,317
2.886,6,37,17853,19,779,160,1360,6258,18,1086,161,1472,11595
1761.494,6,126,12979,69,72,25902,517,5067,57,223,31453,2451,7912
293.273,17,4,240,2,32,293272,32,120,2,32,293272,32,120
1.041,17,11,4702,5,432,260,1350,2302,6,372,166,1350,2400
147.799,6,29,13436,15,488,347,1360,3075,14,1223,11359,3928,10361
1.07,6,10,5548,3,106,535,106,234,7,1005,145,3417,5314
0.554,6,27,9123,13,268,46,711,1756,14,945,39,1368,7367
0.155,17,8,2446,8,277,22,316,2446,0,0,0,0,0
180.451,2,3,96,3,8,90225,8,96,0,0,0,0,0
1700.936,17,12,498,11,14,170093,14,462,1,8,0,8,36
1798.365,17,450,39448,405,34,4451,288,25476,45,282,40019,288,13972
1795.534,17,447,39864,402,35,4477,288,25644,45,288,40018,288,14220
1789.935,6,356,22520,208,69,8647,69,12460,148,69,12176,69,10060
1.314,6,25,8056,12,164,102,267,1288,13,869,93,1448,6768
1798.444,17,450,39960,405,35,4451,288,25740,45,288,40018,288,14220
1.019,17,4,732,2,36,1015,36,128,2,274,1013,318,604
0.011,2,2,80,2,16,11,16,80,0,0,0,0,0
3.919,17,8,1120,4,64,1286,64,368,4,160,1269,160,752
2.109,6,9,527,5,43,527,43,311,4,0,683,0,216
0.257,17,2,212,1,46,0,46,74,1,110,0,110,138
2.872,6,27,8825,16,281,191,577,1489,11,984,260,1452,7336
4.976,6,39,7285,19,218,276,314,3383,20,516,247,1179,3902
0.672,17,19,7481,9,503,84,1350,4783,10,241,68,1350,2698
1795.984,17,449,39928,404,35,4456,288,25708,45,288,40015,288,14220
12.35,6,7,384,5,0,3087,0,280,2,0,3575,0,104
147.207,17,4,352,2,60,147206,60,176,2,60,147206,60,176
2.775,17,4,1556,4,361,925,361,1556,0,0,0,0,0
1741.303,17,30,31620,30,1026,60044,1026,31620,0,0,0,0,0
4.938,6,38,7245,20,218,259,314,3423,18,516,275,1179,3822
1792.076,1,204,11424,204,28,8827,28,11424,0,0,0,0,0
1.924,17,3,264,3,60,962,60,264,0,0,0,0,0
0.929,6,18,7289,10,256,103,517,1297,8,1113,130,1408,5992
1745.198,6,95,7203,63,38,28148,205,4476,32,33,56289,98,2727
40.971,17,14,1064,14,48,3151,48,1064,0,0,0,0,0
7.359,6,27,8165,15,314,525,663,2673,12,967,664,1471,5492
55.449,17,4,352,2,48,55440,48,152,2,72,55438,72,200
6.4,6,5,300,1,0,0,0,60,4,0,2131,0,240
12.039,1,9,756,9,56,1504,56,756,0,0,0,0,0
1752.185,6,219,21043,107,82,16530,721,10140,112,164,15783,1440,10903
0.054,6,2,92,1,0,0,0,40,1,0,0,0,52
1.315,6,50,19572,27,910,50,1360,13876,23,433,51,1360,5696
25.055,17,4,288,2,36,25034,36,128,2,52,25037,52,160
1791.479,1,342,28728,342,56,5253,56,28728,0,0,0,0,0
1010.782,1,71,3976,71,28,14439,28,3976,0,0,0,0,0
19.934,6,25,5918,13,275,1661,275,1090,12,1440,1356,1440,4828
3.725,17,4,360,2,30,2030,30,116,2,94,3665,94,244
18.223,17,3,228,3,48,9111,48,228,0,0,0,0,0
0.456,6,50,21949,28,1045,16,1380,16827,22,421,20,1923,5122
1.621,17,6,1674,3,32,769,32,180,3,470,803,470,1494
300.766,6,39,9638,21,540,15038,1360,4116,18,399,505,1360,5522
0.014,17,2,251,1,31,0,31,59,1,164,0,164,192
1.295,6,47,18817,26,933,51,1460,13201,21,433,55,1460,5616
1788.53,1,108,6048,108,28,16715,28,6048,0,0,0,0,0
300.561,6,13,979,7,177,50064,177,561,6,110,60077,110,418
560.53,17,6,1647,3,30,280226,30,174,3,463,280259,463,1473
0.45,6,14,1733,7,288,71,288,588,7,284,44,434,1145
1.465,6,12,3462,6,75,292,75,395,6,1373,292,1448,3067
280.237,6,28,7352,12,158,25476,267,1277,16,603,18679,2036,6075
1795.899,17,449,39928,404,35,4456,288,25708,45,288,40022,288,14220
1.297,6,48,19520,27,913,49,1460,13904,21,433,55,1460,5616
1744.589,2,23,736,23,8,79299,8,736,0,0,0,0,0
0.008,17,2,190,1,37,0,37,65,1,97,0,97,125
122.014,17,4,352,2,60,122012,60,176,2,60,122013,60,176
0.027,6,2,133,1,0,0,0,40,1,53,0,53,93
116.83,17,2,122,2,33,116830,33,122,0,0,0,0,0
1772.918,6,180,15480,120,69,14898,69,8940,60,69,30041,69,6540
1794.285,17,337,54352,337,133,5340,366,54352,0,0,0,0,0
0.085,17,2,144,1,36,0,36,64,1,52,0,52,80
0.45,6,26,8581,15,219,32,531,1665,11,1267,44,2816,6916
368.769,6,21,1419,15,177,26340,177,989,6,110,12237,110,430
1754.176,17,36,13933,36,359,50119,548,13933,0,0,0,0,0
1786.496,6,107,8949,70,70,25891,274,5250,37,63,49622,247,3699
2.35,17,4,580,2,40,2033,40,136,2,194,2104,194,444
1799.631,1,246,13776,246,28,7345,28,13776,0,0,0,0,0
0.25,6,21,5000,10,137,27,267,1092,11,577,23,1400,3908
2.234,17,27,12707,13,652,186,1350,8842,14,248,122,1350,3865
21.074,6,42,10501,21,769,485,1360,4766,21,375,1044,4027,5735
0.866,6,29,5820,14,125,66,267,1315,15,650,57,1420,4505
1786.6,17,87,3648,86,14,21018,14,3612,1,8,0,8,36
0.152,6,9,1340,5,145,38,145,349,4,827,36,827,991
292.077,6,54,8421,26,106,11681,517,2345,28,417,10815,1418,6076
280.528,6,30,7432,13,158,23377,267,1317,17,543,17529,1400,6115
4.524,6,38,7245,19,218,251,314,3383,19,516,236,1179,3862
14.47,17,4,1344,4,308,4823,308,1344,0,0,0,0,0
123.651,17,14,19190,14,1342,9511,1347,19190,0,0,0,0,0
367.44,6,25,1885,16,64,24496,64,1088,9,54,45917,58,797
2.264,6,14,5888,4,106,754,106,274,10,650,232,1420,5614
0.019,17,2,158,1,34,0,34,62,1,68,0,68,96
504.567,2,5,160,5,8,126141,8,160,0,0,0,0,0
74.617,1,8,448,8,28,10659,28,448,0,0,0,0,0
3.656,17,10,1287,5,31,912,31,295,5,170,912,196,992
0.452,17,2,144,1,36,0,36,64,1,52,0,52,80
4.127,17,4,900,4,197,1375,206,900,0,0,0,0,0
1786.444,6,102,8364,68,66,26663,66,4964,34,60,54131,60,3400
154.277,6,35,17761,18,708,9075,1360,4294,17,1064,9633,1696,13467
1744.716,2,26,832,26,8,69788,8,832,0,0,0,0,0
8.858,6,34,8347,18,400,521,885,1953,16,522,579,3488,6394
25.982,6,36,9251,17,321,1623,721,2936,19,555,1386,1440,6315
61.288,6,35,15923,22,809,2918,1408,9249,13,855,5088,3847,6674
1786.65,6,102,8296,68,65,26666,65,4930,34,59,54138,59,3366
8.37,6,1651,1513364,1039,1378,7,1408,1476876,612,776,13,1408,36488
459.187,6,67,13187,32,207,14812,721,6046,35,358,7098,1440,7141
246.264,6,47,9221,19,577,13680,1408,5638,28,168,9120,580,3583
240.202,6,53,17702,28,799,8896,1408,15048,25,168,10008,580,2654
1720.938,17,12,498,11,14,172093,14,462,1,8,0,8,36
3.238,17,3,985,3,300,1619,301,985,0,0,0,0,0
0.113,6,2,104,2,0,0,0,104,0,0,0,0,0
299.534,6,7,404,4,31,99844,31,222,3,31,149762,31,182
143.547,6,133,20528,69,304,2110,304,14052,64,83,2258,83,6476
360.945,2,3,96,3,8,180472,8,96,0,0,0,0,0
203.739,6,853,697901,420,748,486,1396,28133,433,1519,282,5584,669768
1796.982,2,27,864,27,8,69114,8,864,0,0,0,0,0
31.705,6,7,308,1,0,0,0,44,6,0,6317,0,264
0.073,17,2,2382,2,1163,73,1163,2382,0,0,0,0,0
0.0,17,1,592,1,564,0,564,592,0,0,0,0,0
1741.773,6,87,6322,58,31,30557,31,3915,29,31,62204,31,2407
35.989,6,27,7177,13,155,2999,267,1306,14,530,2767,3417,5871
1764.639,2,15,480,15,8,126045,8,480,0,0,0,0,0
1787.905,6,364,25392,211,100,8513,469,14856,153,69,11762,69,10536
10.784,6,18,4226,10,275,1198,275,958,8,978,856,1420,3268
0.45,6,24,6041,13,108,37,147,959,11,773,43,1608,5082
37.257,6,27,10468,14,643,2865,1460,3164,13,967,3088,1460,7304
1771.12,6,102,9711,68,69,26434,233,5914,34,59,53667,82,3797
1773.136,6,180,15480,120,69,14900,69,8940,60,69,30044,69,6540
1.323,6,48,18863,26,933,52,1460,13207,22,433,54,1460,5656
1235.372,17,30,2625,15,32,88239,37,905,15,86,88239,136,1720
113.21,6,13,5674,4,112,37736,112,280,9,718,14124,1420,5394
2.189,6,28,4892,14,223,168,584,2297,14,265,167,580,2595
1720.625,17,13,534,11,14,172044,14,462,2,8,1720440,8,72
138.982,17,4,240,2,32,138980,32,120,2,32,138981,32,120
38.096,17,44,6468,22,48,1813,48,1672,22,190,1813,308,4796
1681.597,17,14,1036,7,30,280262,30,406,7,62,280263,62,630
456.968,6,48,15264,30,405,15751,1360,7725,18,618,26869,2720,7539
195.508,17,3,228,3,48,97754,48,228,0,0,0,0,0
1791.982,1,58,4872,58,56,31438,56,4872,0,0,0,0,0
6.009,6,1446,1305106,893,1382,6,1408,1271686,553,931,10,2801,33420
2.015,6,50,20758,27,896,77,1360,13702,23,556,81,2715,7056
1798.969,6,365,25570,213,99,8485,469,15005,152,69,11911,69,10565
4.587,6,39,12320,21,567,229,1188,7910,18,575,255,1188,4410
2.758,6,11,1403,4,595,919,595,799,7,212,457,212,604
0.185,6,3,2840,2,1360,0,1360,2800,1,0,0,0,40
4.676,6,37,7189,19,218,259,314,3383,18,513,257,1179,3806
0.546,6,22,7345,13,334,45,663,2021,9,1209,63,1946,5324
4.999,17,4,530,2,36,4995,36,128,2,173,4994,187,402
9.888,6,82,25050,41,550,247,1152,19269,41,413,240,1152,5781
1800.0,6,217,15078,81,46,22125,46,6416,136,46,13333,46,8662
1.564,6,11,1727,7,100,260,100,384,4,589,438,1152,1343
2.516,6,13,2311,8,188,359,245,700,5,1407,561,1407,1611
1612.05,6,200,15486,77,73,21050,332,7583,123,48,13213,78,7903
23.177,6,3049,2868066,1933,1404,11,1448,2805358,1116,776,20,1448,62708
1313.269,6,100,10881,57,78,23451,721,5254,43,102,30179,1448,5627
1345.142,6,149,10330,53,46,25867,46,4282,96,46,14159,46,6048
1776.631,17,140,11200,70,48,25748,48,5320,70,56,25748,56,5880
0.322,6,27,9081,14,261,24,683,1780,13,1100,26,2816,7301
0.003,6,2,104,1,0,0,0,40,1,0,0,0,64
1787.641,1,272,28832,272,78,6596,78,28832,0,0,0,0,0
1798.119,1,62,5208,0,0,0,0,0,62,56,29477,56,5208
1.28,17,8,2750,8,315,182,354,2750,0,0,0,0,0
1777.025,17,140,11200,70,48,25753,48,5320,70,56,25753,56,5880
5.896,6,23,6643,11,317,585,517,1540,12,893,531,2410,5103
1744.667,2,28,896,28,8,64617,8,896,0,0,0,0,0
1704.164,6,24,3624,16,241,113610,241,2568,8,92,243426,92,1056
8.814,6,82,24805,41,560,220,1152,19008,41,461,213,1179,5797
1775.727,6,180,15480,120,69,14922,69,8940,60,69,30094,69,6540
2.199,6,13,2311,8,188,314,245,700,5,1407,483,1407,1611
261.248,17,3,1101,3,339,130624,687,1101,0,0,0,0,0
1557.528,1,28,1568,28,28,57686,28,1568,0,0,0,0,0
1785.507,6,104,8444,68,66,26649,66,4964,36,60,51012,60,3480
1.558,6,48,19292,27,897,59,1360,13676,21,433,67,1360,5616
1.142,6,24,8004,11,164,97,267,1236,13,869,80,1448,6768
0.899,17,26,15608,14,895,66,1350,12922,12,195,78,1350,2686
32.017,6,9,396,2,0,3483,0,88,7,0,5321,0,308
3.062,17,3,228,2,48,3009,48,152,1,48,0,48,76
561.028,17,6,444,3,30,280490,30,174,3,62,280497,62,270
280.578,6,28,7352,12,158,25507,267,1277,16,678,18692,2085,6075
1795.648,17,144,11520,72,48,25290,48,5472,72,56,25290,56,6048
252.504,17,37,2812,37,48,7014,48,2812,0,0,0,0,0
4.203,17,2,154,1,33,0,33,61,1,65,0,65,93
756.743,2,5,160,5,8,189185,8,160,0,0,0,0,0
0.011,17,8,1670,8,180,1,219,1670,0,0,0,0,0
1785.531,6,103,8395,68,65,26649,65,4930,35,59,52513,59,3465
372.187,6,18,1242,14,180,28629,180,916,4,110,20075,110,326
10.555,1,6,636,6,78,2111,78,636,0,0,0,0,0
0.233,17,2,167,1,39,0,39,67,1,72,0,72,100
0.88,6,25,5847,13,156,73,267,1462,12,780,72,1460,4385
0.06,6,2,100,1,0,0,0,60,1,0,0,0,40
1.955,17,3,180,3,32,977,32,180,0,0,0,0,0
0.122,6,2,80,2,0,0,0,80,0,0,0,0,0
0.242,6,25,4623,12,165,22,456,1446,13,415,19,888,3177
1779.575,17,142,11360,71,48,25422,48,5396,71,56,25422,56,5964
1794.966,6,356,22520,208,69,8671,69,12460,148,69,12209,69,10060
1786.507,17,87,3648,86,14,21017,14,3612,1,8,0,8,36
1795.546,17,448,39896,403,35,4466,288,25676,45,288,40018,288,14220
0.274,6,3,160,2,0,274,0,100,1,0,0,0,60
0.921,6,51,13829,24,551,40,1429,4840,27,464,34,1986,8989
0.331,6,24,5937,12,164,30,453,1442,12,643,28,1448,4495
1765.27,1,73,6132,0,0,0,0,0,73,56,24517,56,6132
1684.512,17,12,498,11,14,168451,14,462,1,8,0,8,36
54.545,6,29,7257,14,155,4195,267,1346,15,482,3895,1997,5911
0.216,6,10,767,5,186,53,186,454,5,45,52,45,313
42.35,17,24,2112,12,48,3849,48,912,12,72,3848,72,1200
0.245,17,2,2730,2,1337,245,1337,2730,0,0,0,0,0
0.012,6,10,1514,5,503,3,503,771,5,475,3,475,743
1776.713,6,118,13785,76,81,23689,518,5974,42,161,43332,1420,7811
2.225,6,13,2311,8,188,317,245,700,5,1407,490,1407,1611
403.263,6,48,9139,26,106,16130,685,2351,22,346,610,2720,6788
15.277,6,19,5842,9,275,1909,275,918,10,902,1368,1440,4924
1614.185,2,13,416,13,8,134515,8,416,0,0,0,0,0
596.354,1,6,336,6,28,119270,28,336,0,0,0,0,0
0.448,6,28,7336,13,155,37,267,1301,15,678,27,3456,6035
1798.368,6,365,24563,213,87,8482,469,14136,152,69,11909,69,10427
281.339,6,32,7650,13,158,23444,267,1317,19,464,15606,1400,6333
1734.725,17,173,15313,158,30,11049,37,9234,15,377,119639,463,6079
1637.06,1,8,848,8,78,233865,78,848,0,0,0,0,0
595.146,6,9,546,6,31,119029,31,333,3,31,297563,31,213
31.443,6,27,7177,13,155,2620,267,1306,14,530,2418,3417,5871
0.799,6,8,335,4,0,266,0,164,4,7,142,7,171
8.853,6,17,5331,9,275,1106,275,643,8,1089,1126,1420,4688
1.223,6,44,10157,23,440,55,1360,4496,21,437,52,2720,5661
1.05,6,25,5876,13,161,87,267,1491,12,650,89,1420,4385
15.122,6,30,7573,12,155,1374,267,1266,18,398,888,3417,6307
1795.493,1,276,15456,276,28,6529,28,15456,0,0,0,0,0
1795.649,6,116,13814,75,81,24265,501,5950,41,159,44887,1420,7864
0.044,6,2,104,1,0,0,0,52,1,0,0,0,52
3.994,17,3,174,3,30,1997,30,174,0,0,0,0,0
63.684,6,70,42417,40,1185,1632,1448,34102,30,749,2122,1448,8315
0.059,17,2,243,1,53,0,53,81,1,134,0,134,162
1.0,6,26,8380,14,266,64,540,1924,12,1192,74,3151,6456
0.589,17,3,244,2,32,525,32,120,1,96,0,96,124
69.096,6,27,7177,13,155,5758,267,1306,14,530,5314,3417,5871
16.414,6,11,2056,4,106,5454,106,274,7,495,2729,1380,1782
190.116,17,4,352,2,60,190115,60,176,2,60,190115,60,176
82.514,6,18,732,8,0,11787,0,324,10,0,9165,0,408
4.291,6,526,440488,229,917,18,1440,20248,297,1437,13,4320,420240
0.977,6,8,1607,5,100,244,100,304,3,589,140,1152,1303
3.662,17,10,785,5,31,907,31,295,5,70,904,70,490
374.974,6,57,7746,28,107,13887,516,2732,29,183,13386,1452,5014
0.043,17,2,167,1,39,0,39,67,1,72,0,72,100
14.011,6,20,1495,10,222,1555,222,848,10,231,1555,231,647
41.296,6,45,12441,27,141,1588,159,3138,18,643,2428,1669,9303
1794.179,17,80,3354,79,14,23002,14,3318,1,8,0,8,36
1797.406,1,58,4872,58,56,31533,56,4872,0,0,0,0,0
5.393,6,15,7577,6,517,1078,517,849,9,1248,326,1408,6728
218.91,17,4,352,2,60,218908,60,176,2,60,218909,60,176
52.625,6,19,5814,10,267,5847,501,1205,9,707,6566,1420,4609
0.486,6,23,7420,13,337,40,674,2032,10,1212,48,1946,5388
0.019,17,2,253,1,43,0,43,71,1,154,0,154,182
8.055,6,7,400,3,0,4027,0,160,4,0,1336,0,240
1772.165,6,181,15589,120,69,14892,69,8940,61,69,29531,69,6649
4.206,6,39,7269,20,218,221,314,3423,19,513,219,1179,3846
1738.635,6,87,6322,58,31,30502,31,3915,29,31,62093,31,2407
2.121,6,14,1368,7,185,335,185,927,7,45,329,45,441
1773.15,6,195,11900,97,47,18470,208,6957,98,31,18277,31,4943
23.243,6,35,8287,19,367,1291,787,1894,16,521,567,3488,6393
104.49,17,2031,1884040,673,46,155,1350,49870,1358,1322,76,1350,1834170
25.57,6,48,13076,23,186,1162,721,2600,25,676,1056,1440,10476
1785.859,6,367,25043,214,94,8384,469,14576,153,69,11749,69,10467
6.054,6,38,18428,18,104,356,186,1561,20,1054,318,1448,16867
460.892,6,657,649808,198,155,2339,703,12167,459,1401,1006,2836,637641
1768.994,6,136,8389,73,27,24568,27,4432,63,27,28531,27,3957
102.427,6,52,10553,18,327,6025,1189,2695,34,249,3103,1420,7858
1795.349,17,448,39896,403,35,4466,288,25676,45,288,40018,288,14220
1792.595,1,340,28560,340,56,5287,56,28560,0,0,0,0,0
1781.016,1,8,448,8,28,254430,28,448,0,0,0,0,0
1.127,6,24,8004,12,164,87,267,1288,12,1014,86,2816,6716
0.232,17,2,237,1,72,0,72,100,1,109,0,109,137
1771.59,6,103,9382,66,64,27255,64,5544,37,58,49208,58,3838
0.024,17,6,462,3,33,0,33,183,3,65,0,65,279
1.345,6,47,18825,26,933,53,1460,13209,21,433,58,1460,5616
1775.815,17,73,3060,72,14,25011,14,3024,1,8,0,8,36
80.229,6,33,13573,18,739,445,1327,3734,15,1025,5721,2720,9839
81.15,17,4,352,2,60,81149,60,176,2,60,81149,60,176
1772.623,6,180,15480,120,69,14895,69,8940,60,69,30039,69,6540
1781.761,6,360,22749,208,69,8607,69,12598,152,69,11799,69,10151
1744.698,6,104,7795,67,38,26434,205,4715,37,33,48454,98,3080
7.244,6,66,20142,34,541,219,1152,15435,32,489,223,1179,4707
4.2,6,38,7229,20,218,221,314,3423,18,513,232,1179,3806
300.304,1,4,224,4,28,100101,28,224,0,0,0,0,0
0.373,17,2,152,1,48,0,48,76,1,48,0,48,76
107.536,6,24,6359,10,272,223,516,1220,14,415,8264,1452,5139
4.192,6,2,88,2,0,0,0,88,0,0,0,0,0
6.016,17,3,1008,3,308,3008,308,1008,0,0,0,0,0
1744.044,6,97,7307,63,38,28129,205,4476,34,33,52843,98,2831
31.565,6,7,336,1,0,0,0,48,6,0,6311,0,288
84.039,6,22,10202,12,433,72,990,1823,10,1327,9322,3928,8379
1796.123,6,137,9668,78,67,23326,208,6378,59,31,30963,31,3290
2.963,6,28,14479,17,688,185,1360,5533,11,1415,280,2720,8946
1799.09,17,448,39896,403,35,4475,288,25676,45,288,40019,288,14220
1786.724,6,102,8364,68,66,26667,66,4964,34,60,54140,60,3400
1795.859,6,286,35338,117,145,15481,1440,17972,169,127,10688,1702,17366
11.641,17,8,704,4,48,3876,48,304,4,72,3876,72,400
1772.61,6,180,15480,120,69,14895,69,8940,60,69,30035,69,6540
1775.033,17,142,11360,71,48,25357,48,5396,71,56,25357,56,5964
240.206,6,56,17739,29,783,8578,1402,14843,27,185,9238,580,2896
1.143,6,25,8068,12,164,88,267,1300,13,869,81,1408,6768
3.945,17,4,244,4,33,1315,33,244,0,0,0,0,0
3.485,17,15,8008,7,613,570,1350,4488,8,412,488,1350,3520
1770.297,6,99,9306,66,66,27235,66,5610,33,60,55319,60,3696
8.523,6,79,24365,39,549,224,1152,18608,40,461,211,1179,5757
31.139,17,44,11418,44,231,724,389,11418,0,0,0,0,0
27.13,17,30,7346,13,305,2258,1350,4335,17,149,1693,1350,3011
300.181,6,40,10129,21,615,15000,1360,4567,19,399,16667,1360,5562
1772.707,6,180,15480,120,69,14896,69,8940,60,69,30038,69,6540
191.37,6,22,1606,12,34,17383,38,830,10,36,21247,40,776
0.151,17,2,154,1,33,0,33,61,1,65,0,65,93
0.019,17,2,150,1,39,0,39,67,1,55,0,55,83
1752.96,1,46,4876,46,78,38954,78,4876,0,0,0,0,0
14.921,6,1663,1511429,1061,1372,14,1380,1480926,602,387,24,1923,30503
240.37,6,43,8396,22,449,11445,1418,5648,21,206,12017,580,2748
37.658,17,4,352,2,60,37657,60,176,2,60,37657,60,176
909.279,1,13,1548,13,91,75773,173,1548,0,0,0,0,0
0.822,17,24,17649,14,864,63,1350,12495,10,487,67,1350,5154
1740.59,17,26,6006,26,203,69623,203,6006,0,0,0,0,0
1789.355,1,302,32012,302,78,5944,78,32012,0,0,0,0,0
67.547,6,13,3109,5,92,147,92,360,8,2329,9623,2329,2749
1792.512,17,141,11276,71,48,25607,48,5396,70,56,25978,56,5880
1787.032,6,104,8308,68,64,26672,64,4896,36,58,51053,58,3412
179.324,6,22,10186,11,304,77,597,1385,11,1192,17915,1460,8801
4.818,6,44,8369,21,227,240,314,4022,23,489,206,1179,4347
0.1,17,2,550,2,247,100,247,550,0,0,0,0,0
2.48,6,60,14425,30,499,85,1429,5238,30,419,84,1986,9187
0.058,17,2,517,1,34,0,34,62,1,427,0,427,455
201.519,6,16,10490,4,185,413,245,535,12,1183,18296,1407,9955
1799.37,17,142,11360,71,48,25705,48,5396,71,56,25705,56,5964
0.07,17,2,179,1,43,0,43,71,1,80,0,80,108
3.756,17,5,1170,5,206,939,206,1170,0,0,0,0,0
297.274,1,4,326,4,53,99091,78,326,0,0,0,0,0
39.676,1,45,4680,0,0,0,0,0,45,76,901,76,4680
1.218,6,50,18884,27,862,46,1360,13188,23,433,48,1360,5696
0.096,1,10,840,10,56,10,56,840,0,0,0,0,0
0.097,17,2,214,1,47,0,47,75,1,111,0,111,139
13.956,6,6,364,0,0,0,0,0,6,31,2791,31,364
0.889,6,7,388,4,0,296,0,216,3,0,436,0,172
7.973,6,1669,1541002,1026,1422,7,1448,1502890,643,776,12,1448,38112
7.642,6,1239,1059881,743,1376,10,1420,1035820,496,467,15,1883,24061
1796.912,6,368,25759,215,99,8396,469,15154,153,69,11818,69,10605
0.409,17,2,194,1,61,0,61,89,1,77,0,77,105
240.233,6,56,20928,30,873,8283,1418,18160,26,176,9608,580,2768
1784.761,17,83,3480,82,14,22034,14,3444,1,8,0,8,36
0.152,6,43,17504,24,960,6,1420,12523,19,420,8,1420,4981
1785.547,6,102,8296,68,65,26649,65,4930,34,59,54104,59,3366
179.458,17,20,1760,10,48,19938,48,760,10,72,19938,72,1000
1765.258,1,8,448,8,28,252179,28,448,0,0,0,0,0
240.398,6,43,8865,21,523,12018,1418,5813,22,211,11446,617,3052
1.71,6,14,2351,8,188,244,245,700,6,703,288,1152,1651
1757.396,1,8,848,8,78,251056,78,848,0,0,0,0,0
0.047,17,2,2754,2,1349,47,1349,2754,0,0,0,0,0
1.433,6,53,18871,29,849,51,1360,13090,24,400,54,1360,5781
0.007,17,4,248,2,34,5,34,124,2,34,5,34,124
5.991,6,30,8872,14,158,460,267,1357,16,981,391,4836,7515
8.225,6,1726,1440423,939,1437,8,1448,1388563,787,776,10,1448,51860
299.554,6,6,364,4,31,99851,31,222,2,31,299528,31,142
33.647,17,34,20845,14,525,2586,1350,7753,20,626,1769,1350,13092
758.121,17,56,4464,30,48,26142,48,2280,26,56,26103,56,2184
300.765,6,47,13931,26,892,12030,1360,8244,21,402,430,2720,5687
1794.139,17,144,11520,72,48,25269,48,5472,72,56,25269,56,6048
1773.414,6,180,15480,120,69,14902,69,8940,60,69,30052,69,6540
375.994,6,18,1288,14,226,28922,226,962,4,110,20070,110,326
232.079,17,4,352,2,60,232078,60,176,2,60,232078,60,176
6.055,6,46,8449,23,227,275,314,4102,23,427,264,1152,4347
1773.992,6,182,15629,121,69,14783,69,9049,61,69,29563,69,6580
0.027,17,2,154,1,33,0,33,61,1,65,0,65,93
242.399,6,58,23265,24,286,10538,776,3322,34,908,7345,1502,19943
1.247,6,26,8108,12,164,97,267,1288,14,869,82,1448,6820
302.571,6,145,90991,73,1172,4202,1448,62502,72,773,593,1448,28489
1790.102,6,188,24630,103,304,17549,304,16952,85,83,21310,83,7678
1798.268,17,449,39928,404,35,4462,288,25708,45,288,40016,288,14220
4.146,6,57,22669,29,973,148,1440,16773,28,433,146,1440,5896
0.439,17,4,288,2,36,408,36,128,2,52,407,52,160
1007.395,2,9,288,9,8,125924,8,288,0,0,0,0,0
255.719,17,4,352,2,60,255718,60,176,2,60,255717,60,176
0.23,6,12,1476,6,299,44,299,631,6,175,44,459,845
1.395,6,24,8004,12,164,108,267,1288,12,1014,108,2736,6716
1747.784,6,95,7203,63,38,28190,205,4476,32,33,56373,98,2727
9.946,6,87,25037,44,544,231,1152,19176,43,413,230,1152,5861
1771.632,6,106,9752,68,65,26442,65,5758,38,59,47879,59,3994
1655.035,1,7,392,7,28,275839,28,392,0,0,0,0,0
1.554,6,5,269,2,0,1554,0,80,3,69,227,69,189
0.032,17,2,166,1,39,0,39,67,1,71,0,71,99
187.254,6,32,8952,14,158,14404,267,1357,18,624,11014,1400,7595
1.304,6,15,1143,8,181,186,181,601,7,77,214,133,542
1744.618,2,23,736,23,8,79300,8,736,0,0,0,0,0
1799.918,17,448,39896,403,35,4477,288,25676,45,288,40020,288,14220
27.931,6,38,9884,19,706,494,1460,4322,19,399,1542,1460,5562
280.512,6,30,7432,13,158,23376,267,1317,17,543,17527,1400,6115
2.631,6,10,541,4,0,877,0,204,6,7,492,7,337
280.273,6,28,7352,12,158,25479,267,1277,16,603,18682,1400,6075
6.556,6,22,7609,11,336,655,722,1791,11,895,552,2760,5818
18.543,17,23,16336,13,649,1542,1350,8802,10,725,2056,1350,7534
0.533,6,28,9197,13,277,44,747,1792,15,943,32,1368,7405
0.385,6,53,24039,30,1044,13,1380,16954,23,558,15,1923,7085
0.375,6,12,1653,6,288,72,288,548,6,426,40,434,1105
0.181,6,31,8025,16,297,12,517,1849,15,556,11,1871,6176
15.974,17,4,352,2,60,15973,60,176,2,60,15973,60,176
10.743,6,1639,1480899,1017,1405,10,1432,1451798,622,420,17,1432,29101
51.564,6,35,8415,18,410,506,882,1982,17,521,3214,4080,6433
1740.524,17,30,31680,30,1028,60018,1028,31680,0,0,0,0,0
0.006,17,2,245,1,32,0,32,60,1,157,0,157,185
0.061,6,10,766,5,185,15,185,453,5,45,13,45,313
1799.79,6,402,35708,222,143,8143,1420,18894,180,111,10054,1024,16814
0.065,6,7,423,4,43,10,43,259,3,0,31,0,164
75.078,6,9352,9010226,6096,1399,12,1448,8836226,3256,776,23,1448,174000
1.127,17,21,16371,10,703,125,1350,7312,11,795,98,1350,9059
415.525,6,54,7109,25,109,17313,721,2620,29,148,13046,1448,4489
11.034,6,20,4442,11,275,1103,275,998,9,768,781,1440,3444
1.608,6,50,19208,29,879,57,1360,13547,21,437,69,2715,5661
1793.86,17,89,3729,87,13,20856,14,3649,2,12,1792723,16,80
369.547,6,21,1422,15,180,26396,180,992,6,110,12238,110,430
240.595,6,47,6253,22,213,11455,585,3097,25,168,10023,580,3156
0.431,6,58,26425,33,1092,13,1380,17835,25,630,15,3303,8590
0.011,17,2,492,1,43,0,43,71,1,393,0,393,421
1781.94,6,354,22440,207,69,8650,69,12420,147,69,12204,69,10020
902.397,2,6,192,6,8,180479,8,192,0,0,0,0,0
1727.8,1,110,6160,110,28,15851,28,6160,0,0,0,0,0
18.651,6,18,6578,10,290,2072,517,1121,8,1258,2647,1438,5457
29.553,6,1342,1175780,815,1360,36,1368,1140404,527,776,55,2736,35376
240.155,6,47,7863,24,124,10441,346,2140,23,409,10915,1408,5723
292.453,6,44,9681,21,133,14621,267,1775,23,498,13292,1400,7906
1680.405,1,14,784,14,28,129261,28,784,0,0,0,0,0
33.653,6,32,5158,16,154,2232,722,1923,16,342,2231,1402,3235
1771.035,6,101,9410,66,66,27246,66,5610,35,60,52086,60,3800
175.276,17,2,72,1,8,0,8,36,1,8,0,8,36
1799.975,1,218,12208,218,28,8294,28,12208,0,0,0,0,0
0.053,6,12,3462,6,75,10,75,395,6,1373,7,1448,3067
1.145,6,15,2626,7,288,162,288,588,8,568,139,853,2038
1684.547,2,13,416,13,8,140378,8,416,0,0,0,0,0
1344.45,17,10,414,9,14,168032,14,378,1,8,0,8,36
1.763,17,20,5180,20,231,92,388,5180,0,0,0,0,0
0.819,6,26,5916,13,161,68,267,1491,13,650,62,1452,4425
150.922,6,30,7432,13,158,12576,267,1317,17,543,9428,1400,6115
0.019,17,2,249,1,36,0,36,64,1,157,0,157,185
1773.318,6,180,15480,120,69,14901,69,8940,60,69,30046,69,6540
0.537,6,22,7300,12,325,48,626,1932,10,1210,59,1906,5368
0.309,6,20,9909,10,136,34,136,664,10,1245,34,1448,9245
77.162,6,43,16692,24,405,3354,1448,7780,19,876,48,2242,8912
5.085,17,3,211,2,37,5074,37,130,1,53,0,53,81
1.425,17,6,1409,3,40,707,40,204,3,373,707,379,1205
7.19,6,980,892574,621,1363,11,1408,869242,359,931,19,2801,23332
0.083,17,2,366,1,32,0,32,60,1,278,0,278,306
1773.747,6,180,15480,120,69,14905,69,8940,60,69,30054,69,6540
5.222,6,13,7873,6,275,1044,275,794,7,1698,575,2760,7079
1.795,6,25,8755,15,283,128,583,1455,10,985,179,1420,7300
1681.523,17,16,4002,8,31,240216,37,478,8,412,240216,463,3524
1799.787,17,142,11360,71,48,25711,48,5396,71,56,25711,56,5964
1681.082,17,13,534,11,14,168072,14,462,2,8,1680859,8,72
1786.377,6,102,8364,68,66,26662,66,4964,34,60,54129,60,3400
240.223,6,55,19836,30,860,8283,1418,17060,25,183,10008,580,2776
98.507,6,32,9251,11,141,3501,267,1295,21,418,4924,1917,7956
1681.525,17,14,1036,7,30,280252,30,406,7,62,280250,62,630
0.357,17,8,2750,8,315,51,354,2750,0,0,0,0,0
1680.452,1,15,870,15,30,120032,30,870,0,0,0,0,0
0.392,17,19,12453,11,883,39,1350,10030,8,274,40,1350,2423
240.614,17,4,352,2,60,240613,60,176,2,60,240612,60,176
258.12,6,210,170240,137,1312,1897,1408,154113,73,586,2175,1408,16127
2.368,6,60,41181,36,1236,67,1448,34028,24,842,91,1448,7153
8.771,6,5,264,3,0,4385,0,160,2,0,1012,0,104
1.832,17,3,468,3,128,916,128,468,0,0,0,0,0
1799.877,17,87,3648,86,14,21175,14,3612,1,8,0,8,36
2.457,6,31,6286,17,286,153,1314,2405,14,368,188,1414,3881
28.705,17,27,7036,12,318,2607,1350,4158,15,163,2048,1350,2878
1788.081,6,362,22898,210,69,8555,69,12678,152,69,11841,69,10220
1793.418,17,66,2766,65,14,28022,14,2730,1,8,0,8,36
1743.143,6,97,7307,63,38,28115,205,4476,34,33,52813,98,2831
1682.851,17,14,1036,7,30,280467,30,406,7,62,280465,62,630
280.3,6,28,7352,13,158,23358,267,1317,15,678,20018,2045,6035
20.168,6,21,5418,12,107,1833,159,1074,9,773,2517,1402,4344
1798.276,1,345,28980,345,56,5227,56,28980,0,0,0,0,0
1794.706,6,244,35804,152,302,11885,302,26032,92,83,19721,83,9772
1.21,17,4,502,2,31,1200,31,118,2,164,1166,164,384
4.175,6,23,6461,10,262,459,517,1316,13,744,344,1418,5145
1789.956,6,379,23992,216,69,8325,69,13332,163,69,11049,69,10660
240.214,6,53,17121,28,750,8896,1402,14228,25,198,10008,580,2893
164.739,6,79,12139,33,214,5148,802,6232,46,139,3659,580,5907
31.331,6,98,26451,50,498,639,1152,19953,48,457,660,1179,6498
4.268,17,10,2320,10,204,474,204,2320,0,0,0,0,0
0.17,17,4,336,2,48,53,48,152,2,64,18,64,184
10.782,6,20,4402,11,275,1078,275,998,9,758,748,1420,3404
0.07,6,10,1512,5,503,17,503,771,5,473,17,473,741
1.078,6,23,7952,12,164,83,267,1288,11,1216,92,4224,6664
1773.067,6,180,15480,120,69,14899,69,8940,60,69,30050,69,6540
1.073,6,12,3669,6,124,213,124,444,6,968,213,1448,3225
0.394,17,2,685,1,308,0,308,336,1,321,0,321,349
1786.894,6,103,8404,68,66,26670,66,4964,35,60,52553,60,3440
1.269,6,49,18240,26,882,50,1460,12544,23,433,49,1460,5696
124.755,6,20,2537,9,304,15594,304,1376,11,83,12415,83,1161
251.732,1,8,448,8,28,35961,28,448,0,0,0,0,0
0.918,6,10,1687,7,100,153,100,384,3,1179,330,1179,1303
1792.388,17,142,11360,71,48,25605,48,5396,71,56,25604,56,5964
1680.834,17,12,498,11,14,168083,14,462,1,8,0,8,36
1787.149,6,102,8296,68,65,26673,65,4930,34,59,54150,59,3366
196.686,17,4,352,2,60,196684,60,176,2,60,196685,60,176
0.016,17,2,378,1,30,0,30,58,1,292,0,292,320
0.054,17,4,284,2,32,47,32,120,2,54,48,60,164
181.161,17,7,2352,7,308,30193,308,2352,0,0,0,0,0
5.227,6,45,8409,23,227,237,314,4102,22,427,237,1152,4307
3.072,17,4,1568,4,364,1024,364,1568,0,0,0,0,0
0.088,6,18,9083,10,126,8,126,654,8,1601,11,3496,8429
0.025,6,10,1794,6,613,4,1070,1471,4,159,6,159,323
0.163,6,7,423,4,43,42,43,259,3,0,26,0,164
6.838,6,501,446279,321,1327,20,1368,432255,180,931,36,2736,14024
3.695,6,15,3197,8,49,527,92,511,7,463,37,1408,2686
1797.808,1,140,7840,140,28,12933,28,7840,0,0,0,0,0
33.681,6,32,5158,16,154,2233,722,1923,16,342,2233,1440,3235
1797.602,6,369,25799,215,99,8400,469,15154,154,69,11747,69,10645
1.123,17,15,8493,8,705,160,1350,5870,7,346,178,1350,2623
614.99,17,3948,189504,1974,20,311,20,94752,1974,20,311,20,94752
1782.269,17,309,63194,309,176,5786,373,63194,0,0,0,0,0
63.912,6,25,10509,12,658,81,1440,3145,13,976,5310,1440,7364
955.077,17,205,30047,111,118,8682,1209,16278,94,118,2177,1252,13769
2.377,17,3,1167,3,361,1188,361,1167,0,0,0,0,0
0.26,17,2,154,1,33,0,33,61,1,65,0,65,93
0.371,17,4,624,2,64,369,64,184,2,192,249,192,440
11.456,6,18,4362,9,275,1432,275,918,9,768,804,1440,3444
1785.122,6,102,8296,68,65,26643,65,4930,34,59,54091,59,3366
60.503,6,27,7177,13,155,5041,267,1306,14,530,4653,3417,5871
0.005,6,9,18240,1,0,0,0,40,8,2223,0,4104,18200
1789.653,6,127,14855,77,82,23548,516,6144,50,145,36519,1452,8711
1624.326,2,15,480,15,8,116023,8,480,0,0,0,0,0
0.369,17,2,152,1,48,0,48,76,1,48,0,48,76
69.13,6,116,127608,72,430,973,648,5139,44,2931,1582,11264,122469
0.258,6,2,104,1,0,0,0,40,1,0,0,0,64
1679.817,1,15,840,15,28,119986,28,840,0,0,0,0,0
64.706,6,17,700,8,0,7030,0,328,9,0,8086,0,372
280.502,6,31,7472,13,158,23375,267,1317,18,603,16498,2076,6155
0.137,6,40,14921,22,908,6,1420,9980,18,420,7,1420,4941
1783.814,6,363,23076,211,69,8494,69,12580,152,69,11813,69,10496
1750.47,6,99,7677,65,42,27351,205,4734,34,34,53035,98,2943
1784.432,6,129,10008,78,65,23174,65,5785,51,59,35623,59,4223
771.656,6,168,10860,97,71,8038,138,6157,71,69,11022,69,4703
1799.77,6,330,51810,210,302,8611,302,38100,120,83,15124,83,13710
1781.765,6,364,25392,212,100,8444,469,14896,152,69,11799,69,10496
3.772,17,5,290,5,30,943,30,290,0,0,0,0,0
0.398,6,10,767,5,186,98,186,454,5,45,97,45,313
0.454,6,6,324,4,0,151,0,216,2,0,195,0,108
0.041,1,6,624,0,0,0,0,0,6,76,8,76,624
518.608,1,12,672,12,28,47146,28,672,0,0,0,0,0
1775.394,1,62,5208,0,0,0,0,0,62,56,29104,56,5208
11.089,6,19,2541,10,211,1231,211,986,9,545,1385,904,1555
4.075,17,5,340,5,40,1018,40,340,0,0,0,0,0
52.05,6,13,1466,6,304,10410,304,916,7,83,8674,83,550
1.358,6,50,19449,29,898,48,1360,13788,21,437,58,2715,5661
301.274,6,42,8809,21,315,15063,882,2165,21,386,456,1460,6644
0.0,17,1,78,1,50,0,50,78,0,0,0,0,0
287.422,6,45,8295,20,211,15127,532,2777,25,300,11975,1408,5518
37.593,17,22,1672,22,48,1790,48,1672,0,0,0,0,0
1665.5,1,7,392,7,28,277583,28,392,0,0,0,0,0
2.316,6,16,2293,9,322,289,581,1121,7,396,383,580,1172
1799.22,17,449,39928,404,35,4464,288,25708,45,288,40019,288,14220
1751.797,6,95,7203,63,38,28254,205,4476,32,33,56495,98,2727
280.559,6,30,7432,13,158,23379,267,1317,17,603,17524,2760,6115
134.358,17,4,1344,4,308,44786,308,1344,0,0,0,0,0
1.383,6,50,19330,27,894,53,1460,13634,23,433,54,1460,5696
1770.853,6,99,9240,66,65,27243,65,5577,33,59,55334,59,3663
8.156,6,11,835,5,275,2039,275,483,6,96,1197,96,352
280.366,6,30,7432,13,158,23363,267,1317,17,543,17517,1400,6115
1743.825,6,94,7151,62,38,28587,205,4424,32,33,56245,98,2727
80.029,6,129,100838,83,1264,975,1368,90321,46,737,1773,2736,10517
1683.219,17,14,1036,7,30,280525,30,406,7,62,280527,62,630
22.065,6,2052,1899399,1246,1440,17,1448,1849283,806,776,27,1448,50116
0.452,6,26,9012,13,252,37,646,1694,13,947,34,1438,7318
1792.257,6,356,22520,208,69,8658,69,12460,148,69,12192,69,10060
0.024,17,4,284,2,32,1,32,120,2,54,6,60,164
1785.852,6,363,23007,210,69,8544,69,12747,153,69,11749,69,10260
300.969,6,52,23243,30,1088,10372,1440,17561,22,399,14323,1440,5682
3.154,6,21,6370,10,268,345,517,1333,11,744,310,1418,5037
7.958,6,75,23313,37,570,221,1152,18025,38,470,208,1179,5288
20.523,17,3,447,3,121,10261,121,447,0,0,0,0,0
1733.189,6,61,4495,40,33,44440,33,2752,21,31,86650,31,1743
0.756,6,17,5132,9,150,94,174,664,8,828,95,1420,4468
1744.43,6,95,7203,63,38,28135,205,4476,32,33,56262,98,2727
1.028,17,4,1188,2,64,985,64,184,2,474,0,476,1004
0.011,17,2,136,1,32,0,32,60,1,48,0,48,76
1.372,6,10,924,5,283,233,283,551,5,105,214,105,373
1.374,6,37,9808,21,440,68,1360,4392,16,529,77,4075,5416
1775.7,1,58,4872,0,0,0,0,0,58,56,31152,56,4872
0.025,17,4,284,2,32,17,32,120,2,54,10,60,164
7.168,6,1765,1607505,1099,1385,6,1408,1568209,666,931,10,2801,39296
134.093,6,14,1031,4,177,111,177,393,10,110,14881,110,638
0.436,6,52,21644,29,954,15,1380,16470,23,421,18,1923,5174
1786.705,6,106,8584,69,66,26275,66,5004,37,60,49628,60,3580
0.237,17,2,340,1,39,0,39,67,1,245,0,245,273
15.205,17,27,21768,18,1056,890,1350,19523,9,221,1891,1350,2245
120.097,6,55,30586,33,1005,3749,1408,23853,22,508,5713,3047,6733
17.892,17,14,6091,7,534,2976,1350,3936,7,279,2976,1350,2155
1772.811,6,180,15480,120,69,14897,69,8940,60,69,30043,69,6540
5.04,1,10,840,10,56,560,56,840,0,0,0,0,0
4.43,6,38,7245,19,218,246,314,3383,19,516,231,1179,3862
1.016,17,5,1340,3,64,501,64,276,2,504,989,504,1064
0.007,17,2,372,1,39,0,39,67,1,277,0,277,305
1146.411,2,9,288,9,8,143301,8,288,0,0,0,0,0
0.453,17,4,288,2,36,422,36,128,2,52,421,52,160
281.305,6,32,7719,13,143,23442,267,1386,19,464,15603,1400,6333
120.165,6,60,33126,34,1107,3639,1448,26146,26,402,4801,1448,6980
1.175,17,4,1038,4,231,391,389,1038,0,0,0,0,0
281.776,6,32,8217,14,158,21675,267,1357,18,613,16568,1380,6860
3.465,17,2,656,2,300,3465,300,656,0,0,0,0,0
1784.283,17,140,11200,70,48,25859,48,5320,70,56,25859,56,5880
0.232,17,2,154,1,33,0,33,61,1,65,0,65,93
8.489,6,1922,1837611,1248,1396,6,1408,1797887,674,776,12,1408,39724
11.089,6,1745,1534485,1064,1388,10,1414,1503012,681,420,16,1414,31473
1.337,6,47,19933,27,946,51,1460,14357,20,476,60,2615,5576
64.42,6,28,7355,11,140,6442,267,1433,17,523,4004,1917,5922
74.402,6,18,1299,9,177,9300,177,713,9,110,9274,110,586
1.51,6,16,2024,8,256,214,256,1092,8,304,214,304,932
5.004,17,4,288,2,36,5003,36,128,2,52,5002,52,160
1601.4,1,8,448,8,28,228771,28,448,0,0,0,0,0
242.115,17,4,352,2,60,242114,60,176,2,60,242114,60,176
85.607,6,35,8167,12,164,311,267,1639,23,373,3881,1917,6528
23.69,17,4,1344,4,308,7896,308,1344,0,0,0,0,0
10.426,17,4,352,2,48,10416,48,152,2,72,10415,72,200
1787.394,6,104,8328,68,64,26677,65,4906,36,58,51064,59,3422
33.886,6,34,5257,16,154,2259,721,1910,18,267,1981,1368,3347
79.72,6,40,8683,16,360,3974,766,1753,24,331,3460,3488,6930
0.014,17,2,172,1,50,0,50,78,1,66,0,66,94
0.09,17,2,152,1,48,0,48,76,1,48,0,48,76
82.497,6,34,7802,13,155,6874,267,1306,21,353,4124,1420,6496
247.214,17,4,240,2,32,247213,32,120,2,32,247213,32,120
1786.944,6,102,8364,68,66,26670,66,4964,34,60,54146,60,3400
732.171,6,69,8031,37,85,20333,722,3463,32,145,23613,1408,4568
16.641,17,20,6462,10,398,1845,1350,4267,10,191,1845,1350,2195
88.321,6,107,52761,55,1181,1632,1360,44808,52,234,1728,1360,7953
240.118,6,45,7842,24,139,10439,346,2102,21,464,12005,2801,5740
214.508,6,30,7432,13,158,17875,267,1317,17,543,13405,1400,6115
124.118,17,4,240,2,32,124117,32,120,2,32,124117,32,120
1770.274,6,137,8441,73,27,24586,27,4447,64,27,28098,27,3994
243.12,6,36,12116,19,689,13506,1368,4492,17,673,15148,2736,7624
585.114,6,85,19847,39,310,15397,1460,9966,46,259,12991,2920,9881
0.035,17,2,198,1,37,0,37,65,1,105,0,105,133
1.347,17,3,1167,3,361,673,361,1167,0,0,0,0,0
1.288,6,50,20313,28,900,47,1360,14657,22,476,52,2715,5656
2.006,6,13,2311,8,188,286,245,700,5,1407,437,1407,1611
11.273,6,92,28098,48,553,239,1152,21856,44,447,255,1179,6242
0.101,2,3,96,3,8,50,8,96,0,0,0,0,0
1772.134,6,180,15480,120,69,14891,69,8940,60,69,30032,69,6540
0.131,17,2,382,1,32,0,32,60,1,294,0,294,322
4.839,1,6,504,6,56,967,56,504,0,0,0,0,0
4.252,17,2,152,2,48,4252,48,152,0,0,0,0,0
29.248,17,4,1628,4,379,9749,379,1628,0,0,0,0,0
7.194,6,1654,1471251,1006,1383,7,1408,1432891,648,931,10,2816,38360
0.507,6,53,21134,30,976,17,1380,14004,23,515,20,1923,7130
3.929,17,5,290,5,30,982,30,290,0,0,0,0,0
5.012,17,4,824,2,48,4822,48,152,2,308,4859,308,672
170.437,6,65,42699,41,1162,4260,1448,34697,24,749,2745,1448,8002
100.803,6,18,3356,6,92,20160,92,400,12,1164,9147,1408,2956
1681.162,1,15,840,15,28,120083,28,840,0,0,0,0,0
8.09,6,78,24677,39,561,212,1152,18976,39,413,206,1152,5701
280.55,1,2,112,2,28,280550,28,112,0,0,0,0,0
94.0,6,25,10208,12,549,80,1360,2709,13,995,7819,1360,7499
1794.593,17,144,11520,72,48,25275,48,5472,72,56,25275,56,6048
302.322,6,26,5452,14,298,23255,1382,2353,12,435,27482,2432,3099
541.416,2,7,224,7,8,90236,8,224,0,0,0,0,0
1620.302,1,7,392,7,28,270050,28,392,0,0,0,0,0
588.834,1,6,489,6,53,117766,78,489,0,0,0,0,0
63.442,1,2,232,2,88,63442,88,232,0,0,0,0,0
4.841,6,40,7309,20,218,254,314,3423,20,440,241,1152,3886
1162.941,17,14,3676,7,31,193821,37,413,7,438,193821,463,3263
1798.344,6,143,9408,78,56,23352,208,5878,65,31,28095,31,3530
0.11,17,2,197,1,41,0,41,69,1,100,0,100,128
61.916,1,5,140,5,0,0,0,140,0,0,0,0,0
1781.317,17,142,11360,71,48,25447,48,5396,71,56,25447,56,5964
1789.26,6,415,24880,207,69,8685,69,12420,208,34,8643,48,12460
28.966,6,44,13005,19,889,51,1460,7017,25,276,1199,1460,5988
64.096,6,78,45594,43,1121,1526,1448,37019,35,843,1875,2359,8575
0.386,6,26,9013,13,257,32,669,1714,13,945,29,1438,7299
0.404,6,13,1705,7,288,64,288,600,6,426,45,434,1105
1.324,6,45,18844,27,874,50,1360,13348,18,529,67,4075,5496
9.135,6,23,4478,12,213,830,597,1689,11,441,896,1408,2789
1740.504,6,91,6604,59,31,30008,31,3998,32,31,56144,31,2606
165.525,17,4,352,2,60,165523,60,176,2,60,165524,60,176
3.565,17,5,738,4,32,1181,32,240,1,470,0,470,498
1769.599,6,103,9448,66,65,27224,65,5577,37,59,49151,59,3871
0.315,17,2,157,1,31,0,31,59,1,70,0,70,98
9.581,6,76,21942,39,539,252,1152,16678,37,472,258,1179,5264
1651.816,1,8,448,8,28,235973,28,448,0,0,0,0,0
1729.204,6,60,4400,40,33,44338,33,2740,20,31,91002,31,1660
2.944,6,2,88,2,0,0,0,88,0,0,0,0,0
1797.253,1,342,28728,342,56,5270,56,28728,0,0,0,0,0
6.161,6,3,180,3,0,0,0,180,0,0,0,0,0
1040.688,17,24,7984,24,304,45247,308,7984,0,0,0,0,0
1789.505,17,142,11360,71,48,25564,48,5396,71,56,25564,56,5964
1794.737,17,142,11360,71,48,25639,48,5396,71,56,25639,56,5964
3.872,17,4,352,2,48,3860,48,152,2,72,3859,72,200
89.373,17,6,456,3,48,44680,48,228,3,48,44679,48,228
0.19,17,2,214,1,39,0,39,67,1,119,0,119,147
0.099,17,2,2754,2,1349,99,1349,2754,0,0,0,0,0
1744.631,1,59,4956,0,0,0,0,0,59,56,30079,56,4956
115.176,6,9,515,6,31,23035,31,333,3,31,121,31,182
0.018,17,4,284,2,32,0,32,120,2,54,7,60,164
280.37,6,29,7392,13,158,23364,267,1317,16,603,18685,1400,6075
1.171,17,7,480,4,32,358,32,240,3,52,544,60,240
470.29,6,49,14475,30,369,16216,1360,7151,19,655,26117,3494,7324
1680.79,17,13,534,11,14,168059,14,462,2,8,1680597,8,72
1744.646,1,57,4788,57,56,31154,56,4788,0,0,0,0,0
0.186,6,27,7296,13,155,15,267,1301,14,543,13,1300,5995
0.216,17,2,180,1,30,0,30,58,1,94,0,94,122
75.746,6,35,7773,14,155,5826,267,1346,21,348,3786,1420,6427
280.711,6,30,7432,13,158,23392,267,1317,17,543,17538,1400,6115
9.565,6,40,8794,20,331,503,885,2195,20,413,491,1360,6599
1657.973,1,8,448,8,28,236853,28,448,0,0,0,0,0
38.751,17,40,5880,20,48,2038,48,1520,20,190,2038,308,4360
281.412,6,32,7516,15,158,20100,267,1397,17,678,17585,3456,6119
0.293,17,2,268,1,54,0,54,82,1,158,0,158,186
240.184,6,55,19350,29,833,8577,1402,16511,26,184,9607,580,2839
1745.771,6,102,7970,66,45,26858,205,4902,36,35,49873,98,3068
1783.123,17,83,3480,82,14,22013,14,3444,1,8,0,8,36
1.73,6,23,6368,13,297,144,830,2011,10,988,190,1731,4357
889.057,6,194,12098,98,69,9165,69,5852,96,46,9358,69,6246
1782.605,17,187,43767,187,206,9583,342,43767,0,0,0,0,0
569.435,17,11,734,8,30,81346,30,464,3,62,280218,62,270
8.466,6,3,432,0,0,0,0,0,3,156,4233,156,432
1.474,6,7,454,5,126,285,126,374,2,0,1474,0,80
1772.866,6,180,15480,120,69,14898,69,8940,60,69,30040,69,6540
1771.822,6,101,9410,66,66,27258,66,5610,35,60,52109,60,3800
11.825,6,25,8473,13,275,985,275,1078,12,986,855,1440,7395
360.58,6,17,1190,13,180,30048,180,864,4,110,20087,110,326
0.057,6,12,3462,6,75,11,75,395,6,1373,11,1448,3067
1798.646,6,368,25759,214,99,8444,469,15045,154,69,11753,69,10714
9.994,6,16,5255,9,275,1249,275,643,7,1440,829,1440,4612
0.035,17,2,412,1,48,0,48,76,1,308,0,308,336
6.443,6,18,6665,6,275,1288,275,519,12,566,474,1414,6146
5.792,6,45,8409,22,227,275,314,4062,23,489,250,1179,4347
30.364,17,5,3575,5,687,7591,687,3575,0,0,0,0,0
1789.585,1,252,26712,252,78,7129,78,26712,0,0,0,0,0
358.375,6,36,12296,24,271,15581,1402,5057,12,943,18,1402,7239
308.353,6,1376,1253948,801,88,385,517,49487,575,2228,537,9856,1204461
13.999,6,7,380,4,0,4666,0,216,3,0,6990,0,164
368.867,6,27,1767,18,177,21698,177,1181,9,110,8727,110,586
240.229,6,56,18260,29,806,8579,1402,15241,27,178,9239,580,3019
1799.797,6,364,23047,211,69,8570,69,12787,153,69,11840,69,10260
1.348,6,49,19713,29,920,48,1360,14092,20,437,61,2715,5621
71.32,6,35,9533,14,155,5486,267,1346,21,458,3559,1420,8187
1766.439,6,125,7572,67,26,26763,26,4042,58,26,30989,26,3530
56.345,6,12,3546,4,106,18765,106,274,8,978,8024,1460,3272
0.605,17,2,685,1,308,0,308,336,1,321,0,321,349
0.021,17,2,904,1,300,0,300,328,1,548,0,548,576
531.322,1,20,1680,0,0,0,0,0,20,56,27964,56,1680
1155.489,6,70,4180,40,27,29626,27,2350,30,27,39843,27,1830
0.047,17,4,284,2,32,1,32,120,2,54,14,60,164
4.978,6,40,7309,21,218,248,314,3463,19,513,261,1179,3846
0.02,17,2,570,1,30,0,30,58,1,484,0,484,512
294.039,17,22,3552,11,40,29402,40,748,11,226,29402,249,2804
3.65,17,5,290,5,30,912,30,290,0,0,0,0,0
9.341,6,27,7177,13,155,778,267,1306,14,530,717,3417,5871
6.064,6,40,7309,20,218,319,314,3423,20,440,305,1152,3886
5.602,6,46,8449,23,227,254,314,4102,23,427,243,1152,4347
1799.367,6,127,8051,73,47,24991,208,4961,54,31,33942,31,3090
0.71,1,4,224,4,28,236,28,224,0,0,0,0,0
1789.36,6,376,26548,216,104,8322,469,15732,160,69,11252,69,10816
0.289,6,11,1428,5,304,71,304,900,6,102,56,102,528
15.643,17,18,13266,11,985,1557,1350,11146,7,274,2595,1350,2120
1796.635,17,296,22496,296,48,6090,48,22496,0,0,0,0,0
5.903,6,531,477746,343,1329,16,1368,463306,188,776,30,2736,14440
7.75,6,922,781695,529,1396,14,1448,756595,393,776,19,1448,25100
0.011,17,2,410,1,36,0,36,64,1,318,0,318,346
69.86,6,47,8979,23,347,986,728,2079,24,348,3031,3488,6900
1.789,6,27,10221,16,292,119,608,1520,11,1032,161,1420,8701
299.565,6,7,435,5,31,74891,31,293,2,31,297969,31,142
0.351,17,14,5970,6,394,70,1350,2537,8,401,23,1350,3433
280.589,6,29,7392,13,158,23382,267,1317,16,603,18698,2036,6075
1787.123,1,342,28728,342,56,5240,56,28728,0,0,0,0,0
0.093,17,2,574,1,32,0,32,60,1,486,0,486,514
0.118,17,4,304,2,37,43,37,130,2,59,76,65,174
60.868,6,10,648,10,31,6763,31,648,0,0,0,0,0
276.966,17,4,352,2,60,276965,60,176,2,60,276965,60,176
12.097,6,1894,1657524,1153,1382,10,1420,1623663,741,467,16,1883,33861
130.16,6,37,13631,17,542,8135,721,3397,20,725,6729,1414,10234
0.201,17,2,237,1,72,0,72,100,1,109,0,109,137
372.24,6,25,1651,17,177,23265,177,1117,8,110,9248,110,534
0.372,6,7,1095,4,241,72,241,883,3,92,102,92,212
40.855,17,22,1936,11,48,4084,48,836,11,72,4084,72,1100
369.618,6,18,1242,14,180,28432,180,916,4,110,20069,110,326
81.976,6,26,10498,13,661,86,1360,3232,13,962,6817,1747,7266
61.745,6,61,42657,40,1168,1583,1408,34819,21,962,3075,3847,7838
1799.882,17,450,39960,405,35,4455,288,25740,45,288,40019,288,14220
11.993,17,4,824,2,48,11974,48,152,2,308,11975,308,672
0.005,17,3,588,2,60,0,60,176,1,384,0,384,412
63.618,6,32,7765,11,155,15,267,1226,21,334,3180,1997,6539
1.045,2,2,64,2,8,1045,8,64,0,0,0,0,0
1263.313,2,12,384,12,8,114846,8,384,0,0,0,0,0
0.052,6,10,1723,6,578,5,997,1400,4,159,16,159,323
1743.394,6,99,7411,63,38,28119,205,4476,36,33,49803,98,2935
1730.455,1,8,448,8,28,247207,28,448,0,0,0,0,0
2.059,17,4,580,2,40,2034,40,136,2,194,2020,194,444
280.339,6,28,7352,12,158,25485,267,1277,16,603,18682,1400,6075
0.067,17,2,912,1,308,0,308,336,1,548,0,548,576
0.023,17,2,383,1,33,0,33,61,1,294,0,294,322
85.296,6,59,20869,32,1129,593,1360,14942,27,402,3273,2667,5927
1772.277,6,180,15480,120,69,14893,69,8940,60,69,30034,69,6540
6.859,17,16,1216,8,37,979,37,520,8,59,978,65,696
1.951,17,22,5709,22,231,92,389,5709,0,0,0,0,0
8.204,6,81,25010,39,568,215,1152,19189,42,413,194,1152,5821
280.225,6,27,7312,12,158,25475,267,1277,15,678,20011,2045,6035
1797.394,6,367,25650,214,99,8438,469,15045,153,69,11823,69,10605
293.841,6,77,15451,35,544,8642,1408,10610,42,164,7166,580,4841
0.966,6,10,1687,7,100,161,100,384,3,1179,353,1179,1303
299.53,6,6,364,4,31,99843,31,222,2,31,299508,31,142
1798.305,17,450,39960,405,35,4451,288,25740,45,288,40025,288,14220
5.001,17,2,144,2,44,5001,44,144,0,0,0,0,0
1786.471,6,104,8376,68,65,26663,65,4930,36,59,51039,59,3446
1.326,6,51,20066,29,940,47,1460,14365,22,400,54,1460,5701
1781.756,6,417,24965,208,69,8607,69,12460,209,34,8566,64,12505
1789.272,17,134,10720,67,48,27110,48,5092,67,56,27110,56,5628
10.988,6,19,4402,11,275,1098,275,998,8,1024,891,2880,3404
0.013,6,3,3040,1,0,0,0,40,2,1448,0,1448,3000
1794.036,17,144,11520,72,48,25268,48,5472,72,56,25268,56,6048
5.17,6,4,176,3,0,2585,0,128,1,0,0,0,48
1.564,6,29,10373,17,368,97,837,1789,12,1012,134,1420,8584
1788.133,6,102,8296,68,65,26688,65,4930,34,59,54182,59,3366
0.193,6,34,8440,17,277,12,517,1811,17,539,11,1871,6629
1797.435,1,345,28980,345,56,5225,56,28980,0,0,0,0,0
1781.304,17,141,11276,71,48,25447,48,5396,70,56,25438,56,5880
0.992,17,4,314,2,31,722,31,118,2,70,1,70,196
0.85,17,32,20146,17,853,50,1350,14988,15,315,57,1350,5158
4.04,17,5,738,4,32,1342,32,240,1,470,0,470,498
1786.531,6,102,8228,68,64,26664,64,4896,34,58,54134,58,3332
252.554,2,3,96,3,8,126277,8,96,0,0,0,0,0
1793.891,17,66,2766,65,14,28029,14,2730,1,8,0,8,36
0.897,17,3,404,2,64,877,64,184,1,192,0,192,220
0.464,17,7,392,4,19,71,24,188,3,40,105,40,204
240.19,6,54,18453,29,819,8578,1402,15447,25,212,10007,580,3006
0.352,2,2,64,2,8,352,8,64,0,0,0,0,0
1795.067,17,448,39896,403,35,4465,288,25676,45,288,40022,288,14220
1784.862,17,141,11276,71,48,25497,48,5396,70,56,25867,56,5880
11.216,6,1737,1524905,1079,1363,10,1380,1492384,658,514,17,1923,32521
1782.546,6,379,30356,220,143,8139,1189,18681,159,74,11278,485,11675
270.738,6,27,12512,13,519,7520,884,2629,14,931,20815,1460,9883
1785.341,6,408,27317,222,100,8078,469,15296,186,46,9650,69,12021
1682.726,17,14,1036,7,30,280444,30,406,7,62,280445,62,630
10.46,6,16,3911,9,275,1307,275,643,7,992,911,1440,3268
1800.0,6,226,19701,83,79,21585,375,8853,143,70,12676,1062,10848
1791.542,6,358,22669,209,69,8613,69,12569,149,69,12104,69,10100
14.229,6,2482,2306938,1585,1377,8,1408,2255630,897,931,15,2816,51308
1796.838,17,447,39580,403,35,4469,288,25676,44,288,40952,288,13904
39.409,6,412,182139,210,802,188,1152,168879,202,431,194,1179,13260
1.336,6,52,18946,29,857,47,1360,13205,23,437,52,2715,5741
29.209,6,29,8832,14,158,2246,267,1357,15,858,2085,3436,7475
126.555,6,28,7352,12,158,11505,267,1277,16,678,8432,2085,6075
1741.763,6,95,7203,63,38,28092,205,4476,32,33,56173,98,2727
231.273,6,27,7312,12,158,21024,267,1277,15,678,16517,2045,6035
1791.067,6,356,22520,208,69,8652,69,12460,148,69,12184,69,10060
1786.621,6,102,8364,68,66,26665,66,4964,34,60,54137,60,3400
0.873,6,25,5847,12,156,79,267,1422,13,780,66,1460,4425
97.075,6,34,7871,13,155,8089,267,1306,21,357,4853,3417,6565
0.592,6,15,1785,8,288,62,288,640,7,426,68,434,1145
20.158,6,21,5417,12,107,1832,159,1074,9,773,2516,1418,4343
281.29,17,4,352,2,60,281288,60,176,2,60,281288,60,176
1709.418,17,12,498,11,14,170941,14,462,1,8,0,8,36
280.23,6,30,7432,13,158,23352,267,1317,17,543,17511,1300,6115
3.681,6,13,3096,4,92,1227,92,296,9,464,374,1448,2800
416.961,2,3,96,3,8,208480,8,96,0,0,0,0,0
1783.841,6,292,37080,121,139,14863,1360,17601,171,148,10492,4662,19479
4.247,6,35,6209,18,206,249,314,2784,17,456,249,1152,3425
188.283,6,41,8892,13,119,15690,267,1720,28,274,6972,1452,7172
1.791,6,30,10317,18,368,105,837,1829,12,1000,136,1452,8488
1681.307,17,14,3767,7,30,280216,30,406,7,452,280216,463,3361
1.58,17,2,782,2,363,1580,363,782,0,0,0,0,0
6.444,6,41,7349,21,218,322,314,3463,20,513,323,1179,3886
7.003,6,41,7349,22,218,333,314,3503,19,513,373,1179,3846
52.314,17,4,240,2,32,52313,32,120,2,32,52313,32,120
0.556,6,20,7252,13,337,46,674,2032,7,1212,85,1946,5220
0.001,17,2,214,1,39,0,39,67,1,119,0,119,147
1744.694,2,24,768,24,8,75856,8,768,0,0,0,0,0
1780.858,1,206,11536,206,28,8687,28,11536,0,0,0,0,0
2.883,17,3,201,3,39,1441,39,201,0,0,0,0,0
0.083,1,2,163,2,53,83,78,163,0,0,0,0,0
1766.757,1,58,4872,0,0,0,0,0,58,56,30995,56,4872
29.452,6,37,2428,23,66,1338,66,1448,14,60,1536,60,980
180.196,17,4,382,2,31,180184,34,119,2,103,180182,114,263
11.873,6,6,328,4,0,3957,0,216,2,0,11853,0,112
1787.949,6,356,22520,208,69,8637,69,12460,148,69,12162,69,10060
64.18,6,24,3610,11,302,6418,302,2392,13,83,5336,83,1218
1781.761,17,140,11200,70,48,25822,48,5320,70,56,25822,56,5880
23.207,6,35,8178,16,188,1547,722,1965,19,605,1277,1380,6213
1.425,6,52,23848,30,997,49,1360,18192,22,476,58,2715,5656
0.243,6,24,5980,12,164,22,453,1442,12,651,21,1402,4538
280.275,6,29,7392,13,158,23356,267,1317,16,603,18681,2036,6075
1795.765,1,58,4872,0,0,0,0,0,58,56,31504,56,4872
1793.029,17,760,45844,760,32,2362,37,45844,0,0,0,0,0
1543.468,1,62,6572,62,78,25302,78,6572,0,0,0,0,0
240.992,6,55,18292,29,806,8603,1418,15233,26,211,9635,580,3059
280.242,6,27,7312,13,158,23353,267,1317,14,775,21554,3445,5995
194.062,6,32,8399,12,189,10004,516,1430,20,362,10209,1452,6969
0.462,6,13,1693,6,288,89,288,548,7,426,43,434,1145
0.092,6,7,380,4,0,30,0,216,3,0,28,0,164
1795.91,17,142,11360,71,48,25655,48,5396,71,56,25655,56,5964
11.786,17,8,704,4,48,3924,48,304,4,72,3924,72,400
1788.974,6,5269,4457592,2368,139,755,361,137747,2901,1472,616,2816,4319845
0.943,6,28,8160,15,222,55,540,1964,13,944,63,1591,6196
0.11,6,9,2074,6,596,20,1033,1437,3,513,53,513,637
1689.144,1,7,392,7,28,281524,28,392,0,0,0,0,0
4.222,17,5,290,5,30,1055,30,290,0,0,0,0,0
84.246,6,24,9086,13,649,66,1360,3185,11,908,8408,2720,5901
375.048,6,23,1535,16,177,25003,177,1053,7,110,10403,110,482
1681.112,1,15,840,15,28,120079,28,840,0,0,0,0,0
0.047,6,12,3705,6,171,9,171,491,6,964,9,1448,3214
1.012,6,26,5680,14,121,77,267,1295,12,650,86,1420,4385
15.716,17,19,13772,12,936,1424,1350,11573,7,286,2607,1350,2199
1774.952,6,180,15480,120,69,14915,69,8940,60,69,30079,69,6540
318.04,6,72,19173,38,339,8595,1360,9694,34,386,9633,4649,9479
539.702,2,8,256,8,8,77100,8,256,0,0,0,0,0
1795.059,17,80,3354,79,14,23013,14,3318,1,8,0,8,36
12.015,17,10,2060,5,33,3002,33,305,5,323,3002,323,1755
285.062,6,21,1509,11,330,28505,330,910,10,83,31673,83,599
304.435,6,46,16492,21,936,15221,1414,8588,25,388,3637,1448,7904
1799.968,17,69496,2780008,34727,8,51,8,1250172,34769,16,51,16,1529836
20.585,6,80,18290,41,510,511,1216,4958,39,451,538,2128,13332
184.674,17,16,1408,8,48,26381,48,608,8,72,26381,72,800
1000.342,6,217,21355,110,110,9177,1189,8721,107,163,9437,1420,12634
461.44,6,72,12576,37,93,12817,267,3163,35,258,13565,1460,9413
0.494,6,6,248,4,0,164,0,164,2,0,224,0,84
6.601,6,66,20606,35,559,194,1152,15939,31,489,211,1179,4667
6.304,17,25,7215,10,269,700,1350,2975,15,254,228,1350,4240
1786.187,6,104,8376,68,65,26659,65,4930,36,59,51031,59,3446
1690.534,17,11,462,11,14,169053,14,462,0,0,0,0,0
20.175,6,23,5773,13,107,1681,159,1138,10,684,2237,1418,4635
1770.937,6,105,9783,69,65,26043,65,5928,36,59,50595,59,3855
1751.923,6,94,7151,62,38,28720,205,4424,32,33,56502,98,2727
3.782,17,10,1415,5,31,944,31,295,5,196,944,196,1120
366.849,6,18,1239,14,177,28219,177,913,4,110,20056,110,326
0.678,6,15,5386,8,965,96,1360,3217,7,269,61,272,2169
137.084,17,4,352,2,60,137083,60,176,2,60,137083,60,176
3.462,6,206,138151,104,962,33,1360,15782,102,1314,33,1360,122369
0.052,6,12,3702,6,170,9,170,490,6,964,9,1448,3212
1799.48,1,58,4872,58,56,31569,56,4872,0,0,0,0,0
1740.301,6,91,6604,59,31,30005,31,3998,32,31,56138,31,2606
1769.973,6,101,9410,66,66,27230,66,5610,35,60,52055,60,3800
3.469,6,2,88,2,0,0,0,88,0,0,0,0,0
280.288,6,28,7352,12,158,25480,267,1277,16,603,18683,1400,6075
25.224,6,61,20315,29,603,900,1152,15044,32,443,805,1179,5271
1.346,6,46,18120,26,882,53,1360,12544,20,476,59,2715,5576
248.5,6,5,224,3,0,124250,0,128,2,0,1006,0,96
1682.805,17,14,1036,7,30,280462,30,406,7,62,280461,62,630
4.096,6,35,6209,18,206,240,314,2784,17,548,239,1179,3425
4.02,6,2,92,1,0,0,0,40,1,0,0,0,52
0.251,17,2,2750,2,1347,251,1347,2750,0,0,0,0,0
5.936,6,40,7309,21,218,296,314,3463,19,513,315,1179,3846
54.999,6,16,660,11,0,5499,0,448,5,0,6274,0,212
1770.334,6,110,10285,73,65,24587,65,6343,37,59,49167,59,3942
6.869,6,569,516391,372,1324,17,1368,501483,197,776,33,2736,14908
1794.14,17,80,3354,79,14,23001,14,3318,1,8,0,8,36
12.229,6,1885,1676702,1184,1363,10,1380,1644420,701,421,17,1923,32282
1700.534,17,12,498,11,14,170053,14,462,1,8,0,8,36
10.193,6,16,9637,6,517,2038,517,849,10,1180,1112,1408,8788
15.191,6,9,376,5,0,3797,0,204,4,0,5061,0,172
0.176,6,26,7256,13,155,14,267,1301,13,603,13,1400,5955
5.019,17,4,288,2,36,5005,36,128,2,52,1,52,160
239.839,17,4,352,2,60,239838,60,176,2,60,239838,60,176
18.864,1,10,1060,10,78,2096,78,1060,0,0,0,0,0
1797.85,6,376,26686,217,104,8323,469,15772,159,69,11376,69,10914
11.978,6,7,292,4,0,3987,0,164,3,0,5981,0,128
1609.348,1,8,448,8,28,229906,28,448,0,0,0,0,0
1729.176,6,62,4547,41,33,43229,33,2804,21,31,86450,31,1743
85.605,6,12,4086,12,314,7782,413,4086,0,0,0,0,0
1620.141,1,7,392,7,28,270023,28,392,0,0,0,0,0
0.945,6,22,7900,12,164,85,267,1288,10,1216,86,3819,6612
0.189,17,4,352,2,37,88,37,130,2,83,106,89,222
111.957,6,78,52237,48,1184,2382,1408,43944,30,960,2122,3847,8293
0.1,6,11,911,6,181,20,181,489,5,77,15,133,422
296.907,6,6,364,4,31,98969,31,222,2,31,296496,31,142
0.047,17,2,198,1,39,0,39,67,1,103,0,103,131
17.329,17,26,14426,14,797,1330,1350,11556,12,211,1572,1350,2870
0.769,6,20,5948,11,281,76,544,1288,9,716,87,1420,4660
1781.131,1,337,28308,337,56,5300,56,28308,0,0,0,0,0
0.229,17,6,2008,6,306,45,354,2008,0,0,0,0,0
1790.13,17,446,50678,203,151,8861,1350,36377,243,30,7397,60,14301
1788.556,1,58,4872,0,0,0,0,0,58,56,31378,56,4872
4.1,6,37,7189,19,218,227,314,3383,18,513,226,1179,3806
2.794,17,32,9124,13,344,229,1350,4837,19,197,152,1350,4287
601.609,2,6,192,6,8,120321,8,192,0,0,0,0,0
129.974,17,10,590,10,31,14441,31,590,0,0,0,0,0
1781.092,1,246,13776,246,28,7269,28,13776,0,0,0,0,0
0.361,17,2,167,1,39,0,39,67,1,72,0,72,100
33.031,6,43,8746,20,371,459,797,1981,23,364,1495,1440,6765
1779.453,17,18,7347,18,380,104673,1441,7347,0,0,0,0,0
9.433,6,9,527,5,43,2358,43,311,4,0,3109,0,216
1774.821,6,180,15480,120,69,14914,69,8940,60,69,30074,69,6540
153.004,17,4,240,2,32,153003,32,120,2,32,153003,32,120
5.567,6,2,111,2,31,5567,31,111,0,0,0,0,0
0.489,17,3,451,2,39,172,39,134,1,289,0,289,317
131.504,6,17,3307,8,92,18786,92,504,9,333,16412,1408,2803
368.114,6,103,6880,56,74,6692,138,4103,47,69,8002,69,2777
69.107,6,28,7217,13,155,5758,267,1306,15,482,4935,2840,5911
0.995,6,28,8160,15,222,60,540,1964,13,944,68,1591,6196
1772.187,6,180,15480,120,69,14892,69,8940,60,69,30033,69,6540
1777.913,17,142,11360,71,48,25398,48,5396,71,56,25398,56,5964
369.959,6,25,1651,17,177,23122,177,1117,8,110,9212,110,534
0.586,6,15,1785,8,288,57,288,640,7,426,67,434,1145
256.732,6,29,7001,14,229,138,498,1712,15,390,18331,1420,5289
1792.154,6,83,4458,42,26,43710,26,2262,41,26,44802,26,2196
36.908,17,4,352,2,48,36899,48,152,2,72,36899,72,200
299.172,6,23,5589,8,150,303,174,624,15,363,21363,1420,4965
280.258,6,29,7392,13,158,23354,267,1317,16,543,18682,1300,6075
1668.741,1,8,448,8,28,238391,28,448,0,0,0,0,0
2.958,6,11,467,6,0,591,0,248,5,7,693,7,219
1772.265,6,180,15480,120,69,14892,69,8940,60,69,30032,69,6540
18.535,17,34,19652,17,641,1156,1350,11380,17,458,1156,1350,8272
1.758,6,27,8855,16,287,117,593,1505,11,863,155,1380,7350
1789.831,1,110,6160,110,28,16420,28,6160,0,0,0,0,0
0.688,6,8,3010,2,92,688,92,184,6,502,86,1408,2826
1626.418,1,8,448,8,28,232345,28,448,0,0,0,0,0
1742.643,17,30,20190,30,645,60091,645,20190,0,0,0,0,0
1763.779,1,66,3696,66,28,27135,28,3696,0,0,0,0,0
368.615,6,18,1239,14,177,28355,177,913,4,110,20058,110,326
1742.887,17,312,51952,312,138,5604,385,51952,0,0,0,0,0
0.908,6,10,1687,7,100,151,100,384,3,1179,323,1179,1303
472.579,6,49,8042,24,127,16646,516,2235,25,218,19687,1452,5807
1799.081,17,449,39928,404,35,4464,288,25708,45,288,40016,288,14220
0.413,6,27,9076,13,252,34,647,1692,14,831,30,1448,7384
0.04,17,4,352,2,37,35,37,130,2,83,35,89,222
1.012,6,10,1687,7,100,168,100,384,3,1179,360,1179,1303
3.146,6,10,427,5,0,742,0,208,5,7,742,7,219
0.432,1,10,840,10,56,48,56,840,0,0,0,0,0
1.531,6,14,2586,7,288,253,288,588,7,568,225,853,1998
336.243,17,18,6048,18,308,19779,308,6048,0,0,0,0,0
65.244,6,24,6978,6,156,2208,267,718,18,424,3837,1933,6260
1796.225,17,448,39896,403,35,4468,288,25676,45,288,40019,288,14220
1590.084,6,392,27097,173,103,9244,469,13129,219,37,7293,64,13968
660.346,6,64,7679,35,88,19417,722,3329,29,158,23577,1408,4350
1794.419,17,144,11520,72,48,25273,48,5472,72,56,25273,56,6048
4.233,6,652,547545,381,1403,11,1432,531893,271,428,15,1871,15652
5.83,6,40,7325,21,218,291,314,3463,19,516,309,1179,3862
2.992,17,3,264,3,60,1496,60,264,0,0,0,0,0
1681.257,17,14,3843,7,30,280208,30,406,7,463,280208,463,3437
1.219,6,50,19834,28,868,45,1360,14178,22,433,50,1360,5656
1772.319,6,180,15480,120,69,14893,69,8940,60,69,30033,69,6540
1788.652,6,356,22520,208,69,8640,69,12460,148,69,12164,69,10060
2.047,17,3,174,3,30,1023,30,174,0,0,0,0,0
0.0,6,2,120,2,0,0,0,120,0,0,0,0,0
14.7,6,24,6993,13,275,1225,275,1078,11,910,968,1440,5915
1780.1,1,342,28728,342,56,5220,56,28728,0,0,0,0,0
301.016,6,50,27288,26,804,12040,1448,8597,24,1025,2695,1448,18691
0.537,17,2,181,1,34,0,34,62,1,91,0,91,119
572.136,6,105,14546,56,89,10402,267,4475,49,253,11918,1420,10071
1.102,6,23,6510,13,333,90,1004,2190,10,979,121,1699,4320
1791.601,17,144,11520,72,48,25233,48,5472,72,56,25233,56,6048
286.576,6,34,8274,15,158,20469,267,1397,19,509,15897,1400,6877
67.554,6,14,1392,2,106,6500,106,194,12,86,6140,90,1198
1.178,6,25,8056,12,164,91,267,1288,13,869,84,1448,6768
12.058,6,2,1175,1,0,0,0,40,1,1095,0,1095,1135
574.158,1,6,336,6,28,114831,28,336,0,0,0,0,0
126.462,2,2,64,2,8,126462,8,64,0,0,0,0,0
0.378,6,10,1992,5,288,91,288,508,5,424,52,434,1484
1796.019,6,377,30030,210,75,8593,267,13533,167,127,10819,1452,16497
11.03,6,22,4474,12,275,1002,275,1038,10,755,694,1414,3436
1629.621,1,7,392,7,28,271603,28,392,0,0,0,0,0
3.078,6,21,6350,10,262,337,517,1316,11,744,303,1418,5034
0.016,17,2,146,1,37,0,37,65,1,53,0,53,81
80.75,6,32,7590,12,156,7340,267,1272,20,367,4239,1460,6318
0.155,17,2,198,1,39,0,39,67,1,103,0,103,131
1798.133,6,356,22520,208,69,8686,69,12460,148,69,12231,69,10060
217.211,17,4,352,2,60,217210,60,176,2,60,217210,60,176
1797.62,1,58,4872,58,56,31537,56,4872,0,0,0,0,0
1785.86,6,364,23116,211,69,8504,69,12718,153,69,11749,69,10398
0.095,17,2,136,1,32,0,32,60,1,48,0,48,76
0.136,17,2,217,1,50,0,50,78,1,111,0,111,139
13.19,6,21,6704,7,165,2198,267,949,14,518,999,1452,5755
280.616,6,174,119012,101,805,1871,1360,18576,73,1624,3895,5440,100436
1797.207,17,352,26752,352,48,5120,48,26752,0,0,0,0,0
0.737,17,4,1108,2,30,726,30,116,2,468,727,468,992
1771.352,6,105,6270,60,27,30022,27,3525,45,27,40256,27,2745
125.035,6,30,9555,15,547,8923,1396,2976,15,1156,8916,1396,6579
1772.841,6,180,15480,120,69,14897,69,8940,60,69,30040,69,6540
1475.624,6,328,28417,174,96,8529,1189,12454,154,137,9644,1420,15963
4.422,6,37,7189,19,218,245,314,3383,18,513,244,1179,3806
1699.112,6,24,3624,16,241,113274,241,2568,8,92,242705,92,1056
1.022,6,23,6397,13,310,84,891,2077,10,979,112,1699,4320
1783.813,6,376,26548,215,104,8335,469,15623,161,69,11148,69,10925
0.031,17,2,234,1,33,0,33,61,1,145,0,145,173
60.385,6,35,8740,20,138,3178,174,1356,15,616,2810,1452,7384
300.987,6,49,25924,26,804,12039,1448,8597,23,1007,2816,2896,17327
11.649,6,1860,1610990,1123,1379,10,1420,1577289,737,467,15,1883,33701
71.2,6,16,6058,4,106,23733,106,274,12,529,6458,1420,5784
0.014,17,2,383,1,33,0,33,61,1,294,0,294,322
317.15,6,54,9618,28,99,11746,267,2527,26,287,12680,1933,7091
1766.004,6,121,40520,62,506,28950,1460,14776,59,543,30445,1460,25744
199.417,17,4,352,2,60,199416,60,176,2,60,199416,60,176
0.051,6,48,48591,15,216,3,517,1653,33,1559,1,2816,46938
0.006,17,2,416,1,64,0,64,92,1,296,0,296,324
281.922,6,30,7432,13,158,23493,267,1317,17,543,17609,1400,6115
17.687,17,23,6742,9,295,2206,1350,2910,14,245,1357,1350,3832
1.275,6,49,20395,28,908,47,1360,14779,21,476,55,2720,5616
1693.383,17,18,5872,18,298,99610,1451,5872,0,0,0,0,0
51.741,17,2,268,1,54,0,54,82,1,158,0,158,186
1773.317,6,181,15589,120,69,14901,69,8940,61,69,29548,69,6649
514.471,6,1010,1203866,572,82,900,272,34110,438,2831,1177,9856,1169756
28.901,6,10,921,6,302,5780,302,622,4,83,9614,83,299
11.683,6,28,7920,13,268,973,721,1867,15,605,821,2840,6053
0.031,6,2,100,1,0,0,0,40,1,0,0,0,60
1770.52,6,107,9932,68,66,26425,66,5792,39,60,46590,60,4140
9.821,6,13,3114,4,92,3273,92,308,9,579,1177,1448,2806
0.045,17,2,268,1,33,0,33,61,1,179,0,179,207
1796.553,1,58,4872,0,0,0,0,0,58,56,31518,56,4872
704.47,1,20,1120,20,28,37077,28,1120,0,0,0,0,0
1777.318,17,140,11200,70,48,25758,48,5320,70,56,25758,56,5880
0.493,6,12,1653,6,288,91,288,548,6,426,55,434,1105
1771.702,6,101,9410,66,66,27256,66,5610,35,60,52106,60,3800
6.14,6,14,2351,8,188,877,245,700,6,1407,1177,1407,1651
1787.955,17,142,11360,71,48,25542,48,5396,71,56,25542,56,5964
0.897,6,28,5967,14,156,69,267,1502,14,650,62,1452,4465
1310.442,17,100,7984,52,48,25694,48,3952,48,56,25681,56,4032
0.13,17,2,586,1,46,0,46,74,1,484,0,484,512
0.742,1,10,840,10,56,82,56,840,0,0,0,0,0
28.321,6,20,4454,10,296,3146,722,1405,10,420,3126,1408,3049
1787.153,6,102,8296,68,65,26673,65,4930,34,59,54152,59,3366
1.544,6,43,14019,23,749,70,1360,8443,20,476,70,2715,5576
0.038,6,10,583,5,43,9,43,311,5,0,8,0,272
0.474,17,24,17375,13,804,39,1350,10828,11,567,40,1350,6547
0.85,6,114,88408,54,131,16,232,2689,60,1514,13,2760,85719
3.705,6,31,6175,16,145,247,267,1666,15,780,243,1460,4509
935.998,6,119,8978,44,68,21069,311,4149,75,48,12648,78,4829
1097.912,17,216,16416,216,48,5106,48,16416,0,0,0,0,0
61.5,6,39,9612,18,256,3617,1189,3040,21,440,3074,1420,6572
9.094,6,13,1007,7,275,1515,275,563,6,96,1219,96,444
168.373,6,9,558,6,43,33674,43,394,3,0,84183,0,164
71.103,6,29,7395,12,155,6463,267,1266,17,453,4443,2006,6129
1797.053,17,448,39896,403,35,4470,288,25676,45,288,40020,288,14220
14.014,6,24,6993,13,275,1167,275,1078,11,910,901,1440,5915
1785.811,6,356,22520,208,69,8627,69,12460,148,69,12148,69,10060
1786.177,6,104,8444,68,66,26659,66,4964,36,60,51031,60,3480
0.027,6,4,222,2,31,27,31,111,2,31,6,31,111
0.96,6,29,10755,17,522,60,1360,3338,12,865,71,3921,7417
16.198,6,21,3905,11,234,1619,564,1516,10,463,1593,1343,2389
0.793,17,2,144,1,36,0,36,64,1,52,0,52,80
0.032,17,3,244,2,32,9,32,120,1,96,0,96,124
39.439,17,44,6468,22,48,1874,48,1672,22,190,1873,308,4796
12.254,17,10,2090,5,37,3060,37,325,5,325,3060,325,1765
141.089,17,4,352,2,60,141087,60,176,2,60,141088,60,176
2.612,17,30,14598,14,750,200,1350,10893,16,203,107,1350,3705
1760.075,6,122,12151,76,62,23467,722,6288,46,91,39104,1408,5863
0.625,6,25,15094,14,648,48,1360,3184,11,1909,50,4416,11910
2.981,6,2,120,2,0,0,0,120,0,0,0,0,0
1773.63,6,99,9306,66,66,27286,66,5610,33,60,55423,60,3696
0.177,17,2,290,1,40,0,40,68,1,194,0,194,222
1792.577,17,87,3648,86,14,21089,14,3612,1,8,0,8,36
1788.947,17,142,11360,71,48,25556,48,5396,71,56,25556,56,5964
821.367,6,18,20584,2,174,562,174,258,16,1405,54752,1420,20326
7.674,17,6,528,3,48,3830,48,228,3,72,3830,72,300
5.266,6,38,7245,20,218,277,314,3423,18,516,293,1179,3822
1773.351,17,140,11200,70,48,25700,48,5320,70,56,25700,56,5880
223.611,6,35,9591,13,272,18633,1189,2708,22,352,10647,1420,6883
2.991,17,2,176,2,60,2991,60,176,0,0,0,0,0
1771.295,6,99,9240,66,65,27250,65,5577,33,59,55350,59,3663
1771.449,6,101,9410,66,66,27253,66,5610,35,60,52098,60,3800
182.382,6,43,7944,19,153,10129,517,1972,24,393,7927,1418,5972
1797.718,17,448,39896,403,35,4471,288,25676,45,288,40024,288,14220
15.565,17,18,11942,10,950,1722,1350,9786,8,241,2212,1350,2156
1761.873,17,303,49572,303,135,5834,366,49572,0,0,0,0,0
33.651,6,30,5040,15,154,2403,721,1858,15,399,2389,2026,3182
114.551,6,11,3671,5,191,28637,191,455,6,1440,22806,1440,3216
1737.862,1,55,4620,55,56,32182,56,4620,0,0,0,0,0
20.553,6,1103,957380,715,1327,28,1360,933908,388,189,52,2667,23472
39.774,17,22,1936,11,48,3976,48,836,11,72,3976,72,1100
10.765,6,21,4442,12,275,978,275,1038,9,758,748,1420,3404
1.407,6,19,3781,10,234,156,564,1452,9,463,154,1343,2329
249.074,17,5,380,5,48,62268,48,380,0,0,0,0,0
280.519,6,31,7472,13,158,23376,267,1317,18,543,16497,1380,6155
1552.576,1,130,7280,130,28,12035,28,7280,0,0,0,0,0
1792.791,6,368,23276,212,69,8496,69,12896,156,69,11566,69,10380
1.403,6,48,20371,28,909,51,1360,14795,20,529,64,4075,5576
535.992,6,63,7710,30,98,18482,721,2955,33,126,15236,1448,4755
1740.587,17,29,30131,29,1011,62163,1011,30131,0,0,0,0,0
0.124,17,2,417,1,44,0,44,72,1,317,0,317,345
1796.08,6,150,14681,89,79,20410,501,6965,61,114,29933,1420,7716
1781.76,6,419,25136,209,69,8566,69,12500,210,34,8525,48,12636
281.446,6,29,7392,13,158,23453,267,1317,16,603,18754,2036,6075
31.569,6,6,288,1,0,0,0,48,5,0,7888,0,240
1740.661,17,30,20190,30,645,60022,645,20190,0,0,0,0,0
0.209,6,2,80,1,0,0,0,40,1,0,0,0,40
0.018,6,10,1673,6,553,3,949,1350,4,159,5,159,323
15.38,17,10,880,5,48,3841,48,380,5,72,3840,72,500
0.04,6,10,912,5,121,9,121,389,5,259,9,259,523
155.399,6,52,13808,27,165,5976,267,2754,25,772,6472,3436,11054
11.435,6,1791,1578740,1098,1385,10,1420,1546799,693,467,16,1883,31941
0.22,6,25,7216,13,155,18,267,1301,12,775,17,4836,5915
75.856,17,2,672,2,308,75856,308,672,0,0,0,0,0
37.211,6,27,7177,13,155,3100,267,1306,14,530,2861,3417,5871
1786.48,6,102,8364,68,66,26663,66,4964,34,60,54132,60,3400
4.018,17,3,2906,3,940,2009,1451,2906,0,0,0,0,0
0.619,6,22,7345,13,334,51,663,2021,9,1209,74,1946,5324
1795.485,17,80,3354,79,14,23019,14,3318,1,8,0,8,36
1772.26,6,182,15629,121,69,14768,69,8980,61,69,29532,69,6649
4.032,17,8,736,4,32,1337,32,240,4,96,1337,96,496
205.593,6,54,13990,29,680,7342,1368,11060,25,202,8564,580,2930
0.985,1,2,168,0,0,0,0,0,2,56,985,56,168
206.097,6,28,7352,12,158,18736,267,1277,16,603,13736,1400,6075
86.399,6,82,54493,49,1207,1799,1368,46042,33,840,1926,2736,8451
1797.903,6,356,22520,208,69,8685,69,12460,148,69,12230,69,10060
282.559,6,67,13911,27,170,10867,1189,3814,40,292,7242,1460,10097
23.485,6,8,440,5,0,5871,0,268,3,0,11465,0,172
1785.72,6,111,8910,71,66,25510,66,5150,40,60,45785,60,3760
0.086,6,11,818,6,185,14,185,505,5,45,21,45,313
171.874,17,4,352,2,60,171873,60,176,2,60,171873,60,176
5.009,17,4,558,2,36,5004,36,128,2,187,5002,187,430
0.136,17,2,672,2,308,136,308,672,0,0,0,0,0
280.55,6,28,7352,13,158,23379,267,1317,15,775,20037,4836,6035
60.219,17,28,2339,26,30,2408,37,1515,2,384,358,463,824
2.124,17,20,10156,11,452,212,1350,5289,9,512,145,1350,4867
371.017,6,18,1242,14,180,28539,180,916,4,110,20066,110,326
1729.174,6,64,4684,41,33,43229,33,2825,23,31,78591,31,1859
18.629,17,12,1056,6,48,3721,48,456,6,72,3707,72,600
1739.492,1,65,5460,65,56,27179,56,5460,0,0,0,0,0
124.57,6,6,272,3,0,62285,0,128,3,0,1510,0,144
160.554,17,4,240,2,32,160553,32,120,2,32,160553,32,120
0.935,17,2,464,2,204,935,204,464,0,0,0,0,0
1.038,6,27,8120,14,266,65,540,1924,13,944,70,1591,6196
0.795,6,11,5059,5,885,90,1368,4687,6,0,159,0,372
1794.516,17,130,10400,65,48,28039,48,4940,65,56,28039,56,5460
0.758,6,23,6168,13,264,62,662,1848,10,979,83,1731,4320
4.349,2,4,192,4,24,1449,32,192,0,0,0,0,0
239.999,2,2,64,2,8,239999,8,64,0,0,0,0,0
15.642,17,22,12368,10,438,1726,1350,4665,12,613,1413,1350,7703
1775.55,6,103,13047,48,121,37776,517,3472,55,669,32878,2736,9575
258.734,1,24,2544,24,78,11249,78,2544,0,0,0,0,0
1787.146,6,367,23636,212,75,8469,469,13227,155,69,11602,69,10409
127.351,6,19,4106,3,92,99,92,256,16,215,8478,1408,3850
1774.076,17,140,11200,70,48,25711,48,5320,70,56,25711,56,5880
0.048,17,2,204,1,34,0,34,62,1,114,0,114,142
0.163,6,10,767,5,186,40,186,454,5,45,39,45,313
23.246,6,3350,3067820,2119,1367,10,1408,2999144,1231,931,18,2816,68676
1756.065,6,105,6270,60,27,29762,27,3525,45,27,39909,27,2745
0.025,6,10,1512,5,503,6,503,771,5,473,6,473,741
10.201,6,19,8221,8,275,1457,275,599,11,897,998,2840,7622
299.865,1,4,224,4,28,99955,28,224,0,0,0,0,0
1.153,6,27,9060,14,294,88,818,1769,13,965,81,1440,7291
62.689,6,93,60881,52,1230,1229,1368,51934,41,747,1561,1368,8947
1787.28,6,102,8228,68,64,26675,64,4896,34,58,54157,58,3332
46.119,17,6,456,6,48,9223,48,456,0,0,0,0,0
240.305,6,41,8729,21,519,12014,1402,5774,20,238,12647,618,2955
1799.998,6,211,14570,78,46,22987,46,6168,133,46,13636,46,8402
219.291,17,4,352,2,60,219290,60,176,2,60,219289,60,176
280.394,6,27,7312,12,158,25490,267,1277,15,775,20025,2760,6035
1738.63,6,87,6322,58,31,30502,31,3915,29,31,62093,31,2407
922.894,6,102,15512,57,93,16480,267,4721,45,236,14464,1917,10791
1774.837,6,250,25400,100,67,17925,659,9392,150,131,11910,1360,16008
378.395,2,4,128,4,8,126131,8,128,0,0,0,0,0
12.929,6,14,2242,8,210,1843,210,844,6,545,2585,904,1398
1770.276,6,133,8114,71,26,25288,26,4284,62,26,29020,26,3830
1786.32,17,87,3648,86,14,21015,14,3612,1,8,0,8,36
0.339,6,20,7151,12,318,29,600,1906,8,1205,47,1891,5245
0.086,17,2,172,1,50,0,50,78,1,66,0,66,94
6.903,6,40,7309,21,218,345,314,3463,19,513,369,1179,3846
29.924,17,18,1584,9,48,3739,48,684,9,72,3739,72,900
73.47,17,4,352,2,60,73469,60,176,2,60,73469,60,176
1786.586,6,103,8326,68,64,26665,64,4896,35,58,52543,58,3430
20.152,6,20,5366,12,107,1832,159,1074,8,967,2874,1669,4292
1793.904,1,341,28644,341,56,5276,56,28644,0,0,0,0,0
240.231,6,57,17573,29,733,8579,1418,14716,28,174,8896,580,2857
1216.882,17,70,23164,70,302,17635,548,23164,0,0,0,0,0
1698.484,17,16,1265,8,30,242638,37,471,8,71,242637,136,794
0.84,2,2,80,2,16,840,16,80,0,0,0,0,0
1787.454,6,102,8228,68,64,26678,64,4896,34,58,54161,58,3332
84.093,17,18,6070,18,309,4946,329,6070,0,0,0,0,0
1620.671,1,10,1090,10,81,180074,88,1090,0,0,0,0,0
41.242,6,32,11072,18,264,2426,624,1833,14,1236,3152,4398,9239
3.874,17,3,183,3,33,1937,33,183,0,0,0,0,0
3.055,6,10,419,5,0,763,0,204,5,7,501,7,215
1757.274,6,98,7421,64,38,27893,205,4528,34,33,53241,98,2893
1796.572,17,449,39928,404,35,4457,288,25708,45,288,40018,288,14220
298.17,1,4,224,4,28,99390,28,224,0,0,0,0,0
0.423,17,18,9236,9,419,52,1350,4025,9,551,48,1350,5211
280.97,6,28,7352,12,158,25542,267,1277,16,603,18724,1400,6075
0.0,6,2,80,0,0,0,0,0,2,0,0,0,80
12.715,6,32,15742,17,794,794,1460,4697,15,1159,899,1583,11045
6.402,6,41,7456,21,218,320,314,3463,20,455,323,1179,3993
1392.75,1,32,3392,32,78,44927,78,3392,0,0,0,0,0
16.208,6,8,470,4,39,5358,46,279,4,31,5358,31,191
1.446,6,37,8214,19,321,80,1164,2718,18,476,74,2715,5496
2.935,6,4,220,2,0,2935,0,100,2,0,1004,0,120
1.141,6,8,335,4,0,380,0,164,4,7,307,7,171
1.185,6,25,6452,13,298,98,834,2015,12,790,106,1420,4437
421.141,2,4,128,4,8,140380,8,128,0,0,0,0,0
6.265,6,40,7576,21,222,313,314,3730,19,513,333,1179,3846
1615.03,1,7,392,7,28,269171,28,392,0,0,0,0,0
3.337,6,13,3092,5,92,834,92,348,8,464,434,1448,2744
317.083,6,73,18819,37,339,8807,1460,9660,36,335,9055,1629,9159
0.007,6,2,120,1,0,0,0,60,1,0,0,0,60
0.159,17,4,560,2,64,157,64,184,2,160,41,160,376
0.233,2,2,80,2,16,233,16,80,0,0,0,0,0
5.009,17,4,288,2,36,5008,36,128,2,52,4997,52,160
22.473,6,3729,3586842,2486,1366,8,1408,3517542,1243,776,17,1408,69300
755.783,2,4,128,4,8,251927,8,128,0,0,0,0,0
7.154,6,38,7229,20,218,376,314,3423,18,513,405,1179,3806
196.123,6,29,8312,9,186,9221,501,1295,20,388,10318,1420,7017
137.633,6,22,8452,11,314,77,634,1415,11,940,13748,1460,7037
1746.735,6,95,7203,63,38,28173,205,4476,32,33,56336,98,2727
280.258,6,29,7392,13,158,23354,267,1317,16,603,18681,2036,6075
7.64,6,1820,1608345,1053,1437,7,1448,1558129,767,776,9,1448,50216
322.55,6,8,416,8,0,0,0,416,0,0,0,0,0
0.262,6,20,4960,10,137,29,267,1092,10,692,28,1467,3868
175.253,17,2,72,1,8,0,8,36,1,8,0,8,36
1772.628,6,180,15480,120,69,14896,69,8940,60,69,30036,69,6540
38.178,17,40,5880,20,48,2008,48,1520,20,190,2008,308,4360
1776.657,17,140,11200,70,48,25748,48,5320,70,56,25748,56,5880
1.405,6,50,20005,28,879,52,1360,14349,22,433,58,1360,5656
213.696,17,4,352,2,60,213695,60,176,2,60,213695,60,176
2.308,6,5,264,3,0,1154,0,160,2,0,999,0,104
50.628,6,15,8291,4,131,16876,131,295,11,1257,5056,1430,7996
1708.543,17,46,16398,46,328,37967,548,16398,0,0,0,0,0
1796.2,6,200,24200,129,135,14032,981,13949,71,104,25653,917,10251
8.962,6,30,5951,14,240,689,383,2731,16,429,579,1179,3220
31.559,6,12,738,3,112,15774,112,240,9,90,3943,90,498
1744.112,6,100,7568,65,38,27251,205,4611,35,33,51197,98,2957
0.168,6,27,7296,14,155,12,267,1341,13,603,13,2036,5955
34.892,6,12,3085,5,92,8723,92,372,7,1164,5786,1408,2713
180.66,17,31,35587,31,1119,6022,1450,35587,0,0,0,0,0
0.481,6,28,7317,17,282,30,925,2663,11,701,45,1688,4654
10.393,6,11,2044,7,332,1732,600,1036,4,396,104,580,1008
1407.14,1,18,1008,18,28,82772,28,1008,0,0,0,0,0
1744.741,2,26,832,26,8,69789,8,832,0,0,0,0,0
1.355,6,49,19599,29,912,48,1360,13978,20,437,61,2720,5621
114.046,17,3,231,3,49,57023,49,231,0,0,0,0,0
1773.994,1,52,5512,52,78,34784,78,5512,0,0,0,0,0
0.035,17,2,904,1,300,0,300,328,1,548,0,548,576
0.293,17,8,2758,8,316,41,355,2758,0,0,0,0,0
4.645,17,6,1392,6,204,929,204,1392,0,0,0,0,0
299.536,6,6,364,4,31,99845,31,222,2,31,299522,31,142
289.69,6,39,8355,19,274,16091,517,1840,20,778,15244,1418,6515
0.011,17,2,421,1,35,0,35,63,1,330,0,330,358
3.65,6,13,2311,8,188,521,245,700,5,1407,847,1407,1611
15.634,17,20,14467,12,996,1418,1350,12297,8,243,2228,1350,2170
0.309,6,10,1838,5,899,77,899,1167,5,403,77,403,671
33.484,6,29,5278,12,180,3044,722,1702,17,298,2081,1408,3576
1.887,17,2,134,2,39,1887,39,134,0,0,0,0,0
0.927,6,25,6056,13,108,77,147,959,12,768,83,1581,5097
0.519,17,4,350,2,34,511,34,124,2,85,509,91,226
1795.777,17,410,48884,193,158,9352,1350,36050,217,31,8313,60,12834
1784.132,6,110,8902,69,64,26237,64,5000,41,58,44601,58,3902
0.302,6,27,9043,13,247,25,624,1672,14,947,22,1438,7371
252.409,6,26,5745,11,142,459,174,870,15,355,18022,1452,4875
20.448,17,8,1412,4,48,6812,48,304,4,249,6812,308,1108
3.204,6,22,5307,11,159,320,267,1399,11,692,319,1467,3908
243.548,6,57,19800,29,836,8698,1408,16578,28,159,9020,580,3222
0.035,17,2,362,1,53,0,53,81,1,253,0,253,281
280.187,6,29,7392,14,158,21552,267,1357,15,678,20011,3436,6035
0.053,17,2,178,1,35,0,35,63,1,87,0,87,115
0.46,17,2,158,1,34,0,34,62,1,68,0,68,96
1794.704,6,359,22709,209,69,8628,69,12569,150,69,12044,69,10140
0.642,6,14,2598,7,288,103,288,600,7,568,75,853,1998
1743.092,6,97,7307,63,38,28114,205,4476,34,33,52814,98,2831
5.036,17,4,558,2,36,5031,36,128,2,187,5031,187,430
0.183,6,20,4363,11,165,18,456,1394,9,498,21,888,2969
1788.839,6,360,24156,210,88,8559,469,13878,150,69,12004,69,10278
1742.986,6,95,7203,63,38,28112,205,4476,32,33,56215,98,2727
300.674,6,37,8526,20,315,15824,882,2093,17,478,531,2128,6433
0.005,17,2,380,1,59,0,59,87,1,265,0,265,293
240.303,6,46,9093,24,524,10447,1418,5974,22,218,11442,618,3119
1744.233,1,8,448,8,28,249176,28,448,0,0,0,0,0
170.622,6,33,26507,18,729,122,1360,3671,15,2469,12174,6800,22836
0.162,6,29,7376,14,155,12,267,1341,15,543,11,1400,6035
20.446,17,8,1412,4,48,6812,48,304,4,249,6811,308,1108
239.097,2,4,128,4,8,79699,8,128,0,0,0,0,0
5.002,17,4,486,2,36,4998,36,128,2,151,4997,159,358
34.111,6,29,4932,14,170,2623,722,1748,15,342,2421,1408,3184
0.228,6,10,1669,6,551,45,947,1346,4,159,75,159,323
1773.163,6,180,15480,120,69,14900,69,8940,60,69,30050,69,6540
10.799,6,18,5430,10,275,1199,275,958,8,2070,851,2760,4472
21.164,17,2,152,2,48,21164,48,152,0,0,0,0,0
1786.251,17,87,3648,86,14,21014,14,3612,1,8,0,8,36
23.123,17,43,12322,21,277,1155,1350,6422,22,240,1099,1350,5900
1681.627,17,16,1265,8,30,240227,37,471,8,71,240229,136,794
1797.242,6,356,22520,208,69,8682,69,12460,148,69,12225,69,10060
287.073,6,34,8402,16,149,19138,267,1542,18,613,16883,2085,6860
0.865,6,2,92,1,0,0,0,40,1,0,0,0,52
1778.418,17,140,11200,70,48,25773,48,5320,70,56,25773,56,5880
20.186,6,21,5418,13,107,1682,159,1126,8,967,2881,1675,4292
0.287,6,4,227,2,0,287,0,92,2,31,0,31,135
1796.812,1,264,14784,264,28,6831,28,14784,0,0,0,0,0
0.952,17,2,348,1,39,0,39,67,1,253,0,253,281
317.311,6,70,19226,38,338,8575,1360,10011,32,440,10222,1929,9215
2.117,17,3,174,3,30,1058,30,174,0,0,0,0,0
0.127,6,15,16592,3,0,42,0,156,12,1317,11,1418,16436
3.545,17,10,900,5,30,871,30,290,5,94,876,94,610
1770.966,6,101,9344,66,65,27245,65,5577,35,59,52083,59,3767
1743.284,6,95,7203,63,38,28117,205,4476,32,33,56221,98,2727
7.56,6,15,5852,4,112,2520,112,280,11,639,738,1420,5572
240.754,6,66,24669,34,853,7293,1418,21417,32,182,7763,580,3252
1740.473,17,29,30624,29,1028,62159,1028,30624,0,0,0,0,0
488.827,6,50,4277,33,69,15275,69,2493,17,69,30549,69,1784
5.504,6,44,8369,23,227,250,314,4102,21,489,262,1179,4267
282.018,6,30,8114,12,158,25638,267,1277,18,555,16581,1400,6837
0.381,17,16,10057,8,497,54,1350,4206,8,703,46,1350,5851
0.221,6,9,3673,5,517,55,517,773,4,1342,44,1418,2900
0.247,17,2,2386,2,1165,247,1165,2386,0,0,0,0,0
0.31,6,21,7281,12,334,27,663,1969,9,967,37,1471,5312
72.085,6,9304,8915070,6043,1396,11,1448,8740822,3261,776,22,1448,174248
1741.731,6,87,6322,58,31,30556,31,3915,29,31,62204,31,2407
0.419,6,26,8862,13,231,34,563,1608,13,938,33,1448,7254
1740.183,6,69,3640,35,26,51180,26,1846,34,26,52731,26,1794
0.007,6,2,186,1,106,0,106,146,1,0,0,0,40
281.743,6,35,7650,15,158,20124,267,1397,20,495,14825,1380,6253
1787.129,6,104,8308,68,64,26673,64,4896,36,58,51058,58,3412
1741.693,6,87,6322,58,31,30556,31,3915,29,31,62201,31,2407
1786.39,17,87,3648,86,14,21016,14,3612,1,8,0,8,36
0.657,6,14,1745,7,288,79,288,600,7,426,79,434,1145
24.947,6,46,11132,24,726,1077,1460,5374,22,347,1179,1460,5758
1.602,6,36,14798,18,529,94,1460,3434,18,817,77,1460,11364
0.258,17,2,167,1,39,0,39,67,1,72,0,72,100
297.826,6,63,8335,29,181,10636,585,3565,34,176,9024,580,4770
31.391,6,10,436,3,0,321,0,128,7,0,5230,0,308
171.49,6,49,11348,19,290,2332,469,3966,30,246,5913,1460,7382
48.608,6,49,10300,24,533,692,910,3187,25,435,2019,2720,7113
280.185,6,28,7352,12,158,25471,267,1277,16,603,18676,1400,6075
19.803,17,2,152,2,48,19803,48,152,0,0,0,0,0
3.627,17,5,295,5,31,906,31,295,0,0,0,0,0
61.809,6,74,48165,44,1174,1437,1448,39877,30,746,2123,1448,8288
1779.291,17,140,11200,70,48,25786,48,5320,70,56,25786,56,5880
1782.32,6,354,22440,207,69,8652,69,12420,147,69,12207,69,10020
2.31,6,13,2311,8,188,330,245,700,5,1407,509,1407,1611
1.341,6,50,19504,27,906,51,1360,13808,23,433,53,1360,5696
0.059,17,4,368,2,32,7,32,120,2,96,0,96,248
280.245,6,29,7392,13,158,23353,267,1317,16,603,18681,1400,6075
1796.483,6,356,22520,208,69,8678,69,12460,148,69,12220,69,10060
280.379,6,28,7352,12,158,25489,267,1277,16,678,18689,2085,6075
4.907,17,2,656,2,300,4907,300,656,0,0,0,0,0
0.745,6,10,1687,7,100,124,100,384,3,1179,251,1179,1303
661.042,2,6,192,6,8,132208,8,192,0,0,0,0,0
1785.851,17,140,11200,70,48,25881,48,5320,70,56,25881,56,5880
0.495,6,21,4991,12,117,44,179,954,9,734,60,1688,4037
0.215,6,10,1673,6,553,42,949,1350,4,159,70,159,323
20.268,6,24,5574,13,107,1689,159,1126,11,773,2023,1418,4448
122.555,17,12,16492,12,1346,11141,1348,16492,0,0,0,0,0
1.012,17,2,677,1,300,0,300,328,1,321,0,321,349
143.105,17,4,377,2,34,143085,36,124,2,98,143084,149,253
8.578,6,39,14914,16,382,560,811,2618,23,810,381,1440,12296
70.789,6,47,10407,23,541,704,910,3179,24,347,3071,4080,7228
280.239,6,28,7352,13,158,23353,267,1317,15,678,20015,2045,6035
1776.638,17,73,3060,72,14,25023,14,3024,1,8,0,8,36
7.291,6,1665,1541149,1052,1387,6,1408,1504609,613,931,11,2801,36540
367.953,17,18,19761,18,1069,21644,1451,19761,0,0,0,0,0
1795.703,17,449,39928,404,35,4455,288,25708,45,288,40020,288,14220
1787.145,1,214,11984,214,28,8390,28,11984,0,0,0,0,0
1.044,6,28,8460,15,222,63,540,1964,13,994,72,1791,6496
0.754,6,22,5107,10,137,83,267,1092,12,588,67,1467,4015
22.877,17,14,1232,7,48,3810,48,532,7,72,3810,72,700
1692.758,17,15,2909,15,165,120911,166,2909,0,0,0,0,0
90.054,6,50,10347,25,309,501,1284,3787,25,277,3748,1420,6560
1.794,6,11,1727,7,100,299,100,384,4,1179,512,1179,1343
0.213,6,25,7216,13,155,17,267,1301,12,775,15,4836,5915
0.199,6,18,5990,11,550,19,1408,2782,7,945,30,2185,3208
0.187,6,9,527,5,43,46,43,311,4,0,26,0,216
6.211,6,1509,1432721,952,1428,6,1448,1399093,557,776,10,1448,33628
8.329,6,68,20222,34,540,252,1152,15419,34,491,244,1179,4803
1770.78,1,58,4872,0,0,0,0,0,58,56,31066,56,4872
1681.575,17,14,1036,7,30,280254,30,406,7,62,280249,62,630
1.244,6,23,7952,12,164,95,267,1288,11,1216,105,3819,6664
38.779,17,22,1936,11,48,3877,48,836,11,72,3876,72,1100
554.822,6,9,546,6,31,110964,31,333,3,31,277406,31,213
1781.658,6,277,36111,109,137,16495,1440,15946,168,158,10667,1702,20165
0.156,17,2,602,1,46,0,46,74,1,500,0,500,528
2.891,17,8,560,4,34,963,34,248,4,50,963,50,312
0.015,17,2,167,1,39,0,39,67,1,72,0,72,100
2.854,6,22,6436,11,274,281,517,1402,11,744,278,1408,5034
101.91,6,30,13464,15,489,353,1360,3080,15,1085,7267,2505,10384
3.008,6,2,88,2,0,0,0,88,0,0,0,0,0
0.119,6,2,112,1,0,0,0,60,1,0,0,0,52
10.606,6,7,487,3,69,5299,69,258,4,69,3535,69,229
0.594,17,4,1108,2,30,582,30,116,2,468,570,468,992
0.084,6,10,1794,6,613,16,1070,1471,4,159,27,159,323
1792.345,1,75,6300,75,56,24220,56,6300,0,0,0,0,0
566.64,1,3,168,3,28,283320,28,168,0,0,0,0,0
1773.351,6,180,15480,120,69,14902,69,8940,60,69,30048,69,6540
0.004,17,2,278,1,36,0,36,64,1,186,0,186,214
1795.971,17,142,11360,71,48,25656,48,5396,71,56,25656,56,5964
0.106,6,6,328,4,0,35,0,216,2,0,99,0,112
1760.99,1,56,4704,0,0,0,0,0,56,56,32018,56,4704
1.295,6,38,8252,19,320,71,1162,2716,19,433,62,1360,5536
0.291,6,24,7405,12,271,25,517,1717,12,842,25,1402,5688
1792.516,17,134,10720,67,48,27159,48,5092,67,56,27159,56,5628
131.691,17,4,240,2,32,131690,32,120,2,32,131690,32,120
0.05,17,2,235,1,36,0,36,64,1,143,0,143,171
0.504,6,52,20194,29,985,18,1380,14999,23,387,20,1923,5195
240.248,6,53,19046,29,820,8580,1402,16291,24,214,10445,580,2755
1742.086,6,135,8610,75,50,23541,208,5311,60,31,29522,31,3299
1.153,6,7,438,3,31,576,31,199,4,31,264,31,239
0.116,1,2,112,2,28,116,28,112,0,0,0,0,0
18.809,17,34,16540,16,561,1253,1350,9436,18,366,881,1350,7104
1.836,6,38,8254,19,321,102,1164,2718,19,433,90,1440,5536
1796.687,17,83,3480,82,14,22181,14,3444,1,8,0,8,36
17.341,17,31,12163,14,529,1329,1350,7803,17,228,1079,1350,4360
367.148,6,25,1651,17,177,22946,177,1117,8,110,9188,110,534
0.718,17,19,13193,11,941,71,1350,10660,8,288,98,1350,2533
1321.945,6,264,16701,153,69,8696,69,9225,111,69,12017,69,7476
1.363,6,8,423,4,0,454,0,204,4,7,379,7,219
19.377,6,98,32986,50,614,395,1152,26584,48,447,405,1179,6402
1775.432,6,180,15480,120,69,14919,69,8940,60,69,30083,69,6540
0.303,17,2,184,1,32,0,32,60,1,96,0,96,124
504.532,2,4,128,4,8,168177,8,128,0,0,0,0,0
1.455,6,12,1304,6,256,289,256,756,6,304,288,304,548
280.519,6,30,7432,13,158,23376,267,1317,17,603,17528,2760,6115
1799.156,6,143,9886,78,64,23365,208,6170,65,31,28105,31,3716
3.03,17,4,624,4,128,1010,128,624,0,0,0,0,0
4.794,6,38,7245,20,218,252,314,3423,18,516,266,1179,3822
1.028,6,28,10126,17,351,64,785,1737,11,993,95,1452,8389
421.076,2,3,96,3,8,210538,8,96,0,0,0,0,0
0.143,1,2,112,2,28,143,28,112,0,0,0,0,0
52.627,6,50,13577,25,930,630,1360,7620,25,309,2185,2720,5957
240.174,6,53,17729,28,780,8895,1402,14726,25,211,10007,580,3003
1.009,6,27,5960,14,161,77,267,1535,13,650,57,1420,4425
1798.169,17,448,39896,403,35,4473,288,25676,45,288,40020,288,14220
1796.161,6,364,24454,212,87,8512,469,14096,152,69,11894,69,10358
1.327,6,38,8254,19,321,73,1164,2718,19,433,62,1460,5536
1783.986,6,359,22709,209,69,8576,69,12569,150,69,11973,69,10140
3.672,6,9,492,1,0,0,0,40,8,0,337,0,452
5.052,17,3,208,2,36,5012,36,128,1,52,0,52,80
1776.094,17,138,11040,69,48,26118,48,5244,69,56,26118,56,5796
1795.335,6,374,25599,217,93,8311,469,14834,157,69,11508,69,10765
51.691,6,526,245332,277,819,187,1152,229867,249,423,207,1179,15465
1793.703,17,141,11276,71,48,25612,48,5396,70,56,25958,56,5880
5.856,6,535,519169,371,1340,15,1368,505977,164,776,34,2736,13192
489.21,17,19,1444,19,48,27178,48,1444,0,0,0,0,0
5.18,17,4,352,2,48,5036,48,152,2,72,5048,72,200
1772.664,6,180,15480,120,69,14896,69,8940,60,69,30037,69,6540
67.681,6,12,500,6,0,13536,0,248,6,0,12846,0,252
119.442,6,773,358678,392,843,305,1152,337933,381,423,313,1179,20745
227.662,17,4,352,2,60,227661,60,176,2,60,227661,60,176
1791.983,1,342,28728,342,56,5255,56,28728,0,0,0,0,0
0.522,17,2,167,1,39,0,39,67,1,72,0,72,100
1.839,6,2,111,1,0,0,0,40,1,31,0,31,71
261.236,17,6,360,3,32,130617,32,180,3,32,130617,32,180
0.059,6,14,1081,8,182,8,182,606,6,77,11,134,475
1773.029,6,129,13017,79,68,22731,722,6770,50,93,36179,1408,6247
0.633,6,2,1997,1,0,0,0,40,1,1917,0,1917,1957
823.723,1,8,448,8,28,117674,28,448,0,0,0,0,0
1747.98,1,56,4704,56,56,31781,56,4704,0,0,0,0,0
1786.39,6,104,8376,68,65,26662,65,4930,36,59,51037,59,3446
1777.923,17,140,11200,70,48,25766,48,5320,70,56,25766,56,5880
1793.798,6,288,37107,119,157,15200,1360,19132,169,133,10676,1942,17975
1744.664,2,17,544,17,8,109041,8,544,0,0,0,0,0
240.205,6,58,20971,32,824,7748,1418,18155,26,182,9607,580,2816
303.928,6,41,8774,22,308,14472,888,2215,19,413,649,1360,6559
155.065,17,4,824,2,48,155058,48,152,2,308,155058,308,672
6.201,6,4,240,4,0,0,0,240,0,0,0,0,0
53.73,17,3,228,3,48,26865,48,228,0,0,0,0,0
0.483,17,4,624,2,64,245,64,184,2,192,260,192,440
1716.205,17,328,70048,328,185,5248,422,70048,0,0,0,0,0
0.026,17,2,912,1,308,0,308,336,1,548,0,548,576
4.343,6,39,7285,19,218,241,314,3383,20,442,214,1152,3902
16.225,6,25,5522,7,308,2704,722,1592,18,247,943,1448,3930
0.053,17,2,182,1,34,0,34,62,1,92,0,92,120
0.713,17,13,7844,7,613,118,1350,4493,6,530,95,1350,3351
0.321,17,12,5987,6,584,64,1350,3675,6,357,45,1350,2312
504.247,2,5,160,5,8,126061,8,160,0,0,0,0,0
0.509,17,3,451,2,39,384,39,134,1,289,0,289,317
0.015,6,9,1557,5,515,3,515,783,4,558,4,558,774
37.055,17,40,5880,20,48,1949,48,1520,20,190,1949,308,4360
0.051,1,2,112,2,28,51,28,112,0,0,0,0,0
265.537,17,4,352,2,60,265536,60,176,2,60,265536,60,176
2.026,17,3,1008,3,308,1013,308,1008,0,0,0,0,0
1206.677,1,60,3360,60,28,20452,28,3360,0,0,0,0,0
661.68,2,9,288,9,8,82710,8,288,0,0,0,0,0
1.351,6,29,8023,15,286,96,866,2064,14,1077,89,3098,5959
2.089,6,20,3833,11,234,208,564,1504,9,463,238,1343,2329
0.487,17,3,451,2,39,33,39,134,1,289,0,289,317
0.441,6,13,1693,6,288,85,288,548,7,426,41,434,1145
0.246,6,10,1673,6,553,48,949,1350,4,159,81,159,323
0.022,17,4,368,2,32,21,32,120,2,96,10,96,248
1796.167,17,448,39896,403,35,4468,288,25676,45,288,40020,288,14220
61.208,6,13,1079,12,43,5564,43,1019,1,0,0,0,60
251.652,2,2,64,2,8,251652,8,64,0,0,0,0,0
10.523,6,1247,1098103,746,1391,13,1448,1067387,501,931,20,2761,30716
2.779,6,14,2355,7,188,463,245,660,7,703,420,1152,1695
0.109,6,9,1340,5,145,27,145,349,4,827,27,827,991
1799.349,17,455,40952,406,35,4442,288,25856,49,280,36826,308,15096
120.685,6,41,18224,20,926,385,1460,6400,21,844,6025,1590,11824
0.073,17,2,412,1,33,0,33,61,1,323,0,323,351
0.004,17,2,189,1,37,0,37,65,1,96,0,96,124
1773.918,6,100,9358,66,66,27291,66,5610,34,60,53752,60,3748
136.705,17,8,608,8,48,19529,48,608,0,0,0,0,0
1795.274,17,448,39896,403,35,4465,288,25676,45,288,40020,288,14220
83.962,6,24,6138,13,216,6996,501,1390,11,614,8382,1420,4748
1740.451,17,30,7050,30,207,60015,207,7050,0,0,0,0,0
0.439,6,48,21126,27,1067,16,1380,16056,21,421,20,1923,5070
0.073,17,4,344,2,47,0,47,150,2,69,0,75,194
1742.849,6,97,7307,63,38,28110,205,4476,34,33,52805,98,2831
1751.046,17,12,498,11,14,175104,14,462,1,8,0,8,36
1786.932,6,102,8296,68,65,26670,65,4930,34,59,54146,59,3366
65.967,6,23,9976,12,665,83,1360,3174,11,1270,6578,3595,6802
4.618,17,2,690,2,317,4618,317,690,0,0,0,0,0
35.47,17,20,1520,20,48,1866,48,1520,0,0,0,0,0
4.034,17,4,352,2,48,4021,48,152,2,72,4021,72,200
1791.12,1,266,28196,266,78,6758,78,28196,0,0,0,0,0
0.195,6,26,7256,13,155,16,267,1301,13,678,14,3436,5955
1799.727,6,64363,51380169,28888,339,62,342,1838621,35475,1359,50,4104,49541548
3.422,6,2,88,2,0,0,0,88,0,0,0,0,0
15.424,17,16,9138,9,741,1926,1350,6921,7,288,2564,1350,2217
33.585,17,3,228,3,48,16792,48,228,0,0,0,0,0
381.012,6,18,1242,14,180,29308,180,916,4,110,20061,110,326
1780.324,17,140,11200,70,48,25801,48,5320,70,56,25801,56,5880
0.062,17,2,157,1,31,0,31,59,1,70,0,70,98
158.219,6,24,5018,11,220,8447,516,1326,13,316,13176,1452,3692
9.654,6,44,8385,22,227,459,314,4062,22,491,447,1179,4323
280.471,6,31,7472,13,158,23372,267,1317,18,603,16492,2076,6155
1.412,6,18,6425,9,141,176,275,646,9,1353,134,1414,5779
0.109,6,6,328,4,0,36,0,216,2,0,42,0,112
23.201,17,37,18482,15,680,1655,1350,10621,22,329,1103,1350,7861
20.815,6,149,71363,78,844,270,1152,68182,71,341,290,341,3181
1799.65,17,449,39928,404,35,4465,288,25708,45,288,40018,288,14220
2.515,1,7,392,7,28,419,28,392,0,0,0,0,0
0.403,6,27,9064,13,252,33,646,1694,14,947,29,1438,7370
2.705,17,23,14861,10,549,297,1350,5777,13,670,222,1350,9084
280.025,6,30,7432,13,158,23335,267,1317,17,543,17499,1400,6115
1740.852,17,30,31680,30,1028,60029,1028,31680,0,0,0,0,0
727.734,6,55,3462,34,39,22047,208,2188,21,31,35818,31,1274
1.276,6,45,17492,26,837,51,1360,11956,19,476,61,2715,5536
2.758,6,18,3257,10,99,285,182,924,8,477,367,1343,2333
240.283,6,42,9118,20,523,12646,1408,5759,22,245,11441,638,3359
1785.872,6,355,22480,207,69,8669,69,12420,148,69,12148,69,10060
63.54,6,85,35227,44,710,1470,1448,10111,41,765,1585,1568,25116
6.935,6,653,629192,455,1321,14,1368,614232,198,776,34,2736,14960
1.36,6,50,21597,28,985,50,1460,15941,22,433,56,1460,5656
243.198,6,25,2813,14,324,18707,585,1385,11,282,24016,580,1428
1680.426,1,15,840,15,28,120030,28,840,0,0,0,0,0
1688.838,17,16,1184,8,30,241257,30,464,8,62,241258,62,720
21.312,6,22,5478,13,107,1776,159,1134,9,773,2540,1418,4344
38.849,6,11,600,4,0,12947,0,216,7,0,6473,0,384
1.086,6,23,7952,12,164,84,267,1288,11,1216,92,3819,6664
280.194,6,29,7392,13,158,23349,267,1317,16,603,18676,2800,6075
1795.674,17,449,39928,404,35,4455,288,25708,45,288,40018,288,14220
1.121,6,27,8506,15,229,68,583,2007,12,1201,84,3151,6499
0.018,17,2,391,1,29,0,29,57,1,306,0,306,334
1789.547,6,362,24305,211,88,8521,469,13987,151,69,11927,69,10318
63.58,6,25,6667,10,138,7064,267,963,15,566,4526,1452,5704
1799.638,17,450,39960,405,35,4454,288,25740,45,288,40023,288,14220
40.666,17,16,1216,16,48,2711,48,1216,0,0,0,0,0
1796.502,17,448,39896,403,35,4468,288,25676,45,288,40020,288,14220
1.173,6,26,8995,13,252,97,647,1692,13,945,82,1448,7303
61.309,6,36,15958,22,808,2919,1402,9232,14,748,4697,2804,6726
243.831,6,16,1006,6,27,33794,27,339,10,24,27087,27,667
6.293,17,28,15231,12,341,572,1350,4435,16,646,330,1350,10796
1740.606,1,35,2940,0,0,0,0,0,35,56,51194,56,2940
0.095,17,2,245,1,32,0,32,60,1,157,0,157,185
0.044,6,10,861,6,182,8,182,490,4,77,8,134,371
3.145,17,4,1556,4,361,1048,361,1556,0,0,0,0,0
14.438,6,3,151,1,31,0,31,71,2,0,14438,0,80
280.276,6,29,7392,13,158,23356,267,1317,16,603,18679,2036,6075
7.721,17,6,528,3,48,3854,48,228,3,72,3854,72,300
1757.135,6,4009,3804836,1404,149,1252,981,88744,2605,1413,674,5672,3716092
0.371,6,13,1693,7,288,56,288,588,6,426,42,434,1105
226.813,6,2677,2401376,1465,696,154,1396,86693,1212,1871,101,6980,2314683
9.151,6,14,3148,5,92,2287,92,348,9,464,1112,1408,2800
15.515,17,28,17961,16,941,1028,1350,15519,12,175,1402,1350,2442
0.503,17,2,384,1,39,0,39,67,1,289,0,289,317
0.21,17,5,1682,5,308,52,353,1682,0,0,0,0,0
284.173,17,4,352,2,60,284172,60,176,2,60,284172,60,176
0.005,17,2,452,1,40,0,40,68,1,356,0,356,384
367.139,6,18,1239,14,177,28241,177,913,4,110,20056,110,326
2.694,6,18,3257,10,99,278,182,924,8,477,357,1343,2333
64.208,17,4,352,2,60,64207,60,176,2,60,64207,60,176
55.849,6,30,7297,14,155,4296,267,1346,16,441,3722,1420,5951
241.232,6,42,5445,18,253,14189,585,2716,24,184,10487,580,2729
8.344,6,16,3277,9,211,1020,211,910,7,665,1373,904,2367
51.571,6,6850,6354702,4373,1373,11,1408,6221198,2477,776,20,1408,133504
1721.667,17,13,534,11,14,172148,14,462,2,8,1721480,8,72
8.128,6,1561,1463355,984,1409,8,1448,1428687,577,776,13,1448,34668
1789.431,1,268,15008,268,28,6701,28,15008,0,0,0,0,0
0.499,6,23,5885,12,164,45,453,1442,11,772,44,2181,4443
1681.629,17,14,1036,7,30,280268,30,406,7,62,280269,62,630
141.486,17,14,1232,7,48,23567,48,532,7,72,23572,72,700
0.199,6,3,144,2,0,199,0,92,1,0,0,0,52
11.61,6,1856,1600528,1129,1363,10,1380,1567206,727,421,15,1923,33322
0.062,6,9,1002,5,213,15,213,417,4,421,14,421,585
45.425,6,29,7392,14,158,3494,267,1357,15,678,3242,3436,6035
1669.679,1,8,448,8,28,238525,28,448,0,0,0,0,0
91.318,6,13,768,9,31,11414,31,546,4,31,20055,31,222
1780.232,1,59,4956,59,56,30693,56,4956,0,0,0,0,0
11.765,6,1864,1625258,1129,1385,10,1420,1591637,735,467,16,1883,33621
1.289,6,24,8004,13,164,91,267,1340,11,1014,110,2896,6664
0.322,6,27,8944,13,227,26,547,1616,14,941,24,1408,7328
1.894,6,53,18926,29,852,67,1360,13145,24,437,72,2715,5781
0.087,6,12,3462,6,75,17,75,395,6,1373,17,1448,3067
1.661,6,28,10161,17,275,103,558,1510,11,1025,149,1420,8651
1.146,6,26,5918,12,138,104,267,1453,14,650,82,1452,4465
1.042,6,28,5780,13,125,86,267,1275,15,650,67,1380,4505
4.01,17,2,148,2,46,4010,46,148,0,0,0,0,0
1680.75,17,13,534,11,14,168055,14,462,2,8,1680558,8,72
102.004,17,6,462,6,49,20400,49,462,0,0,0,0,0
0.306,6,26,8905,13,241,25,606,1651,13,938,25,1408,7254
1621.432,1,14,812,14,30,124725,30,812,0,0,0,0,0
1775.061,17,138,11040,69,48,26103,48,5244,69,56,26103,56,5796
17.545,6,16,1327,8,222,2505,222,768,8,231,2505,231,559
1738.021,1,82,4592,82,28,21457,28,4592,0,0,0,0,0
1790.886,17,142,11360,71,48,25583,48,5396,71,56,25583,56,5964
1.23,17,3,174,2,30,1195,30,116,1,30,0,30,58
1.99,17,2,116,2,30,1990,30,116,0,0,0,0,0
4.061,17,5,295,5,31,1015,31,295,0,0,0,0,0
2.09,17,2,685,1,308,0,308,336,1,321,0,321,349
1799.597,17,448,39896,403,35,4476,288,25676,45,288,40021,288,14220
1.302,6,49,19520,27,910,50,1360,13864,22,433,53,1360,5656
1773.927,6,180,15480,120,69,14906,69,8940,60,69,30065,69,6540
8.388,6,1339,1160484,806,1390,10,1420,1134943,533,467,15,1883,25541
126.082,6,168,132138,103,1337,1236,1448,119056,65,683,1962,2359,13082
10.969,6,18,5610,10,275,1218,275,958,8,1440,845,1440,4652
283.115,6,28,7352,13,158,23592,267,1317,15,603,20219,2076,6035
200.504,17,4,352,2,60,200503,60,176,2,60,200503,60,176
180.938,17,12,944,8,48,25848,48,608,4,56,25645,56,336
1.267,6,25,8056,12,164,98,267,1288,13,869,90,1408,6768
1778.67,6,90,5778,44,32,41363,36,2448,46,304,39524,445,3330
1744.65,2,24,768,24,8,75854,8,768,0,0,0,0,0
2.447,6,23,3545,12,167,222,293,1490,11,537,218,1179,2055
2.014,17,3,180,3,32,1007,32,180,0,0,0,0,0
1779.612,17,140,11200,70,48,25791,48,5320,70,56,25791,56,5880
1791.012,1,92,5152,92,28,19681,28,5152,0,0,0,0,0
282.689,6,212,22002,92,108,3106,110,10018,120,110,2375,110,11984
1.165,6,24,8004,13,164,82,267,1340,11,1014,98,2816,6664
1700.445,17,12,498,11,14,170044,14,462,1,8,0,8,36
0.878,6,51,13829,24,551,38,1429,4840,27,438,33,1460,8989
0.494,17,3,451,2,39,204,39,134,1,289,0,289,317
1800.0,6,406,26998,193,46,9216,46,11716,213,46,8490,46,15282
1.365,6,47,18160,26,882,54,1360,12544,21,433,59,1360,5616
138.072,17,4,542,2,36,138067,36,128,2,179,138064,187,414
0.354,6,10,968,5,256,86,256,460,5,304,86,304,508
7.911,6,701,578026,416,1315,18,1368,558542,285,931,27,2841,19484
1794.213,1,59,4956,59,56,30934,56,4956,0,0,0,0,0
4.624,6,39,7269,20,218,243,314,3423,19,440,243,1152,3846
1795.449,1,232,12992,232,28,7772,28,12992,0,0,0,0,0
20.143,6,22,6128,13,147,1678,318,1285,9,873,2516,1659,4843
3.413,6,2,88,2,0,0,0,88,0,0,0,0,0
0.009,17,2,124,2,34,9,34,124,0,0,0,0,0
240.3,6,61,19345,29,770,8581,1402,16155,32,189,7751,580,3190
0.294,6,28,9123,13,247,24,624,1672,15,832,20,1448,7451
55.258,17,4,304,4,48,18419,48,304,0,0,0,0,0
1763.712,17,50,16785,50,307,35994,308,16785,0,0,0,0,0
0.242,17,2,152,1,48,0,48,76,1,48,0,48,76
60.249,6,27,7177,13,155,5020,267,1306,14,530,4633,3417,5871
10.754,6,18,5610,10,275,1194,275,958,8,1440,821,1440,4652
280.189,6,27,7312,12,158,25471,267,1277,15,678,20010,2800,6035
240.202,6,57,17693,29,781,8578,1418,14797,28,179,8895,580,2896
280.331,6,27,7312,12,158,25484,267,1277,15,678,20020,2045,6035
0.179,17,2,586,1,46,0,46,74,1,484,0,484,512
0.055,6,3,160,2,0,55,0,100,1,0,0,0,60
0.004,6,2,84,1,0,0,0,44,1,0,0,0,40
0.493,6,11,3652,6,171,98,171,491,5,1446,97,2675,3161
61.318,6,37,16031,22,810,2919,1440,9253,15,665,4361,1440,6778
1765.667,6,125,10722,66,27,26906,27,4002,59,116,30433,430,6720
0.043,17,2,912,1,308,0,308,336,1,548,0,548,576
15.633,6,28,4917,14,154,1162,722,1818,14,394,1162,1448,3099
1781.757,6,372,25919,215,99,8325,469,15154,157,69,11421,69,10765
11.269,6,1818,1550985,1094,1363,10,1380,1517783,724,421,15,1923,33202
0.009,17,2,392,1,49,0,49,77,1,287,0,287,315
13.369,17,4,352,2,48,13361,48,152,2,72,13360,72,200
1787.277,6,364,25392,212,100,8470,469,14896,152,69,11834,69,10496
10.783,6,20,4442,11,275,1078,275,998,9,768,752,1440,3444
0.798,6,26,5887,13,156,66,267,1462,13,650,60,1420,4425
10.882,6,80,24421,39,550,286,1152,18640,41,459,264,1179,5781
1.361,6,39,8292,19,320,75,1162,2716,20,433,62,1360,5576
90.881,6,788,369042,411,834,221,1152,347775,377,386,240,1152,21267
1682.02,17,14,1036,7,30,280334,30,406,7,62,280334,62,630
1799.685,17,142,11360,71,48,25709,48,5396,71,56,25709,56,5964
1740.465,17,30,7050,30,207,60016,207,7050,0,0,0,0,0
1795.995,17,142,11360,71,48,25656,48,5396,71,56,25656,56,5964
22.433,17,4,352,2,48,22423,48,152,2,72,22421,72,200
1797.115,17,273,56487,273,178,6607,422,56487,0,0,0,0,0
0.129,17,4,272,2,29,0,29,114,2,51,45,57,158
1777.576,6,84,4458,42,26,43354,26,2236,42,26,43354,26,2222
0.128,17,2,198,1,39,0,39,67,1,103,0,103,131
11.778,6,1822,1624504,1148,1363,10,1380,1591379,674,511,17,1923,33125
68.13,17,2,672,2,308,68130,308,672,0,0,0,0,0
1773.776,6,180,15480,120,69,14905,69,8940,60,69,30057,69,6540
446.604,2,3,96,3,8,223302,8,96,0,0,0,0,0
1773.037,6,180,15480,120,69,14899,69,8940,60,69,30043,69,6540
1612.03,1,18,1008,18,28,94825,28,1008,0,0,0,0,0
1.402,6,136,92426,75,1333,18,1432,85686,61,428,21,1871,6740
0.0,1,2,716,2,330,0,336,716,0,0,0,0,0
20.972,6,24,6232,14,117,1613,159,1337,10,727,2329,1418,4895
0.538,17,3,451,2,39,129,39,134,1,289,0,289,317
8.527,6,699,621011,447,1321,18,1368,603243,252,776,33,1473,17768
6.742,6,557,436407,311,1329,21,1368,418939,246,776,26,2736,17468
18.398,17,31,8062,14,297,1415,1350,4557,17,178,1147,1350,3505
2.013,17,6,936,3,64,996,64,276,3,192,997,192,660
0.454,6,50,20281,27,1000,17,1380,15119,23,421,18,1923,5162
0.022,17,2,207,1,35,0,35,63,1,116,0,116,144
257.058,6,21,6416,7,154,42843,267,752,14,566,19772,1420,5664
240.739,2,3,96,3,8,120369,8,96,0,0,0,0,0
108.772,6,56,11758,23,343,2059,1189,4361,33,357,3394,1917,7397
0.259,17,3,234,2,39,125,39,134,1,72,0,72,100
30.621,6,6,360,0,0,0,0,0,6,0,0,0,360
5.972,6,5,220,5,0,0,0,220,0,0,0,0,0
27.879,6,48,13171,23,194,1267,721,2675,25,678,1121,2840,10496
371.588,6,17,1190,13,180,30965,180,864,4,110,20114,110,326
5.485,6,28,8096,15,184,391,318,2070,13,1061,440,1368,6026
49.87,1,2,112,2,28,49870,28,112,0,0,0,0,0
1772.603,6,180,15480,120,69,14895,69,8940,60,69,30039,69,6540
0.508,6,27,9179,13,282,42,769,1826,14,943,36,1368,7353
0.188,17,2,144,1,36,0,36,64,1,52,0,52,80
50.284,1,4,224,4,28,16761,28,224,0,0,0,0,0
73.46,17,7,581,4,37,24394,39,262,3,78,36706,91,319
1797.357,6,356,22520,208,69,8682,69,12460,148,69,12226,69,10060
1764.157,2,15,480,15,8,126011,8,480,0,0,0,0,0
0.044,17,2,383,1,39,0,39,67,1,288,0,288,316
0.464,17,8,2758,8,316,66,355,2758,0,0,0,0,0
1782.516,6,356,22520,208,69,8611,69,12460,148,69,12125,69,10060
2.233,6,14,2351,8,188,319,245,700,6,703,397,1152,1651
0.019,6,2,149,1,0,0,0,40,1,69,0,69,109
2.392,17,2,778,2,361,2392,361,778,0,0,0,0,0
1.306,6,55,20260,30,879,45,1360,14439,25,400,47,1360,5821
2.196,6,14,2351,8,188,313,245,700,6,703,387,1152,1651
0.184,17,4,284,2,32,177,32,120,2,54,175,60,164
0.936,17,2,144,1,36,0,36,64,1,52,0,52,80
1784.817,17,142,11360,71,48,25496,48,5396,71,56,25496,56,5964
2.423,6,14,2351,8,188,346,245,700,6,703,432,1152,1651
1772.971,6,180,15480,120,69,14898,69,8940,60,69,30046,69,6540
247.144,6,58,11314,26,318,9885,776,5202,32,398,7964,1418,6112
12.178,6,65,25533,30,745,419,1440,8037,35,730,351,1440,17496
51.024,6,19,8117,5,92,166,92,360,14,585,3910,1448,7757
1798.026,17,450,39960,405,35,4450,288,25740,45,288,40019,288,14220
1782.295,6,365,25432,213,100,8407,469,14936,152,69,11802,69,10496
1789.3,17,142,11360,71,48,25561,48,5396,71,56,25561,56,5964
3.544,6,2,88,2,0,0,0,88,0,0,0,0,0
299.533,6,6,364,4,31,99844,31,222,2,31,299517,31,142
1780.79,17,280,62555,280,195,6382,422,62555,0,0,0,0,0
0.486,17,3,451,2,39,188,39,134,1,289,0,289,317
122.8,6,31,14690,16,488,259,1360,3127,15,1216,8761,3928,11563
1.094,17,4,288,2,36,1046,36,128,2,52,1027,52,160
25.026,17,26,12917,13,704,2082,1350,9526,13,232,2082,1350,3391
0.708,6,5,353,0,0,0,0,0,5,31,177,31,353
20.027,17,3,447,3,121,10013,121,447,0,0,0,0,0
127.35,6,5,224,3,0,63675,0,128,2,0,1033,0,96
576.407,6,134,15689,69,136,8476,1189,6046,65,219,9005,1420,9643
1771.619,6,99,9240,66,65,27255,65,5577,33,59,55360,59,3663
0.344,17,2,168,1,48,0,48,76,1,64,0,64,92
7.615,6,15,1362,8,275,1087,275,878,7,96,963,96,484
0.066,6,13,3980,7,88,11,88,388,6,1670,13,1880,3592
1079.602,6,87,13708,41,169,26988,731,3704,46,584,23989,1408,10004
0.221,6,23,7313,12,176,20,331,1336,11,1079,20,1588,5977
1783.155,17,83,3480,82,14,22014,14,3444,1,8,0,8,36
0.502,17,2,476,1,39,0,39,67,1,381,0,381,409
1677.717,1,7,392,7,28,279619,28,392,0,0,0,0,0
0.009,17,4,284,2,32,1,32,120,2,54,2,60,164
0.062,17,4,284,2,32,50,32,120,2,54,15,60,164
1789.812,6,369,23385,213,69,8442,69,13005,156,69,11547,69,10380
280.208,6,26,7272,12,158,25473,267,1277,14,775,21549,2800,5995
2.889,17,2,312,2,128,2889,128,312,0,0,0,0,0
1785.93,6,106,8456,68,65,26655,65,4930,38,59,48265,59,3526
1781.426,17,142,11360,71,48,25448,48,5396,71,56,25448,56,5964
1792.476,17,180,14040,180,50,10013,50,14040,0,0,0,0,0
1.019,6,24,8004,12,164,92,267,1288,12,869,76,1448,6716
235.606,17,4,352,2,60,235605,60,176,2,60,235605,60,176
0.996,6,24,6548,13,332,82,1002,2188,11,783,98,1420,4360
3.137,6,10,4495,4,188,170,245,540,6,1237,578,1407,3955
280.452,6,28,7352,13,158,23371,267,1317,15,603,20028,2076,6035
0.092,17,2,232,1,65,0,65,93,1,111,0,111,139
0.513,17,2,167,1,39,0,39,67,1,72,0,72,100
280.267,6,30,7432,13,158,23355,267,1317,17,543,17515,1400,6115
0.242,6,43,16687,24,892,10,1420,11694,19,420,12,1420,4993
0.01,6,2,192,1,112,0,112,152,1,0,0,0,40
0.757,6,17,5132,9,150,94,174,664,8,828,94,1420,4468
1740.433,17,30,31680,30,1028,60014,1028,31680,0,0,0,0,0
256.701,6,27,6944,13,233,149,516,1690,14,426,19739,2642,5254
600.888,2,4,128,4,8,200296,8,128,0,0,0,0,0
319.23,6,10,636,8,106,45604,106,540,2,0,1011,0,96
1.214,6,23,7952,12,164,95,267,1288,11,1216,105,3819,6664
0.982,6,29,8500,15,222,58,540,1964,14,852,61,1360,6536
0.026,6,14,3436,8,106,3,106,518,6,866,4,1448,2918
0.142,17,2,180,1,30,0,30,58,1,94,0,94,122
280.299,6,28,7352,12,158,25481,267,1277,16,603,18680,1400,6075
59.373,6,21,7875,12,638,5397,1271,2534,9,973,7420,1684,5341
836.541,6,57,3750,35,47,24599,208,2405,22,31,39827,31,1345
39.945,6,4,174,1,0,0,0,40,3,7,19826,7,134
1.969,17,6,471,3,31,974,31,177,3,70,976,70,294
6.34,6,1144,1006865,694,1372,8,1408,978801,450,931,13,2816,28064
362.803,6,71,38082,32,677,11703,915,11150,39,956,9538,1440,26932
2.978,17,8,480,4,32,992,32,240,4,32,992,32,240
10.734,6,15,2307,8,210,1527,210,856,7,545,1788,905,1451
67.287,6,29,11805,16,500,409,690,3674,13,844,5595,2368,8131
257.351,17,4,352,2,60,257350,60,176,2,60,257349,60,176
0.359,6,10,968,5,256,88,256,460,5,304,88,304,508
95.103,6,32,14697,16,579,6340,1440,4339,16,951,6273,1440,10358
0.248,6,22,4442,11,165,24,456,1394,11,493,24,888,3048
5.859,6,36,7096,18,231,344,314,3274,18,516,279,1179,3822
1771.57,6,99,9240,66,65,27254,65,5577,33,59,55357,59,3663
2.896,6,37,11401,18,319,170,1189,2962,19,590,159,4837,8439
27.113,6,2080,1799676,1259,1373,21,1380,1755298,821,630,32,3303,44378
94.468,6,30,7728,8,155,854,267,1106,22,318,4498,1460,6622
285.039,6,21,1500,11,321,28503,321,901,10,83,31670,83,599
1773.018,6,181,15589,120,69,14899,69,8940,61,69,29543,69,6649
0.01,6,2,264,1,0,0,0,40,1,184,0,184,224
2.217,6,14,2351,8,188,316,245,700,6,703,393,1152,1651
0.297,6,30,11482,15,125,21,235,1540,15,832,20,1440,9942
39.757,6,72,29202,35,997,1169,1440,18457,37,538,1096,1440,10745
3.944,17,8,1176,4,48,1311,48,304,4,190,1311,308,872
10.049,6,42,9663,22,450,478,766,2749,20,435,517,1928,6914
36.344,17,4,352,2,60,36343,60,176,2,60,36343,60,176
142.595,17,6,528,3,60,71297,60,264,3,60,71297,60,264
279.456,6,231,185295,146,1309,1927,1408,169972,85,680,2103,3847,15323
1773.127,6,235,25584,114,77,15691,721,10367,121,230,14773,1440,15217
1.29,6,25,8056,12,164,99,267,1288,13,869,91,1408,6768
1693.184,6,212,16542,81,73,21163,375,8078,131,49,13023,143,8464
2.308,17,32,6878,14,218,175,1350,3446,18,162,133,1350,3432
1779.821,17,79,3312,78,14,23114,14,3276,1,8,0,8,36
1729.234,6,65,4748,42,33,42176,33,2889,23,31,78592,31,1859
0.709,17,6,660,3,78,354,84,320,3,85,240,104,340
1786.853,6,102,8296,68,65,26669,65,4930,34,59,54143,59,3366
1795.635,17,142,11360,71,48,25651,48,5396,71,56,25651,56,5964
0.135,6,20,9025,10,121,14,121,649,10,1121,14,1448,8376
0.101,17,2,237,1,72,0,72,100,1,109,0,109,137
1791.022,6,124,12315,78,62,23260,722,6422,46,92,39796,2026,5893
19.186,6,8,506,8,31,2740,31,506,0,0,0,0,0
17.343,17,17,7659,9,588,2163,1350,5548,8,235,2460,1350,2111
11.434,6,27,11355,13,275,952,275,1078,14,1078,846,1414,10277
1785.391,17,87,3648,86,14,21004,14,3612,1,8,0,8,36
1772.985,6,180,15480,120,69,14899,69,8940,60,69,30050,69,6540
5.911,6,642,568099,405,1335,14,1368,551111,237,776,24,2736,16988
240.111,6,53,37620,21,310,12005,592,2031,32,1256,7743,1663,35589
115.792,17,4,352,2,60,115790,60,176,2,60,115791,60,176
11.414,6,22,6817,12,275,1037,275,1038,10,1073,712,1440,5779
0.005,17,2,152,1,48,0,48,76,1,48,0,48,76
1745.201,6,100,7866,66,45,26849,205,4902,34,35,52872,98,2964
501.994,6,57,11954,22,110,23903,267,2218,35,287,14764,1460,9736
374.938,1,30,1680,30,28,12928,28,1680,0,0,0,0,0
156.581,2,5,200,5,16,39145,16,200,0,0,0,0,0
1775.6,17,308,68522,308,194,5783,364,68522,0,0,0,0,0
280.434,6,30,7432,14,158,21571,267,1357,16,678,18691,3456,6075
229.021,17,6,528,3,60,114510,60,264,3,60,114510,60,264
1787.028,6,102,8296,68,65,26672,65,4930,34,59,54148,59,3366
1.722,6,48,18687,27,854,66,1360,13071,21,433,75,1360,5616
7.674,6,20,7915,12,353,697,750,1691,8,1160,1078,2527,6224
159.498,6,33,9611,11,156,15946,267,1700,22,413,7591,2077,7911
35.78,17,10,760,10,48,3975,48,760,0,0,0,0,0
1763.244,6,127,7765,69,27,25929,27,4161,58,27,30933,27,3604
23.97,6,23,3327,10,302,2663,302,2026,13,83,1964,83,1301
1612.77,1,8,448,8,28,230395,28,448,0,0,0,0,0
39.575,17,44,6468,22,48,1884,48,1672,22,190,1883,308,4796
0.046,6,2,80,1,0,0,0,40,1,0,0,0,40
6.218,6,12,2275,5,188,1554,245,580,7,703,992,1152,1695
1776.654,17,73,3060,72,14,25023,14,3024,1,8,0,8,36
195.201,17,4,240,2,32,195200,32,120,2,32,195200,32,120
22.428,17,35,11990,17,330,1399,1350,6086,18,300,1317,1350,5904
1788.457,17,87,3648,86,14,21040,14,3612,1,8,0,8,36
8.322,6,79,24914,39,568,219,1152,19173,40,459,206,1179,5741
292.31,6,48,8003,23,147,13284,517,2111,25,417,12177,1418,5892
101.204,17,10,4102,10,382,11244,431,4102,0,0,0,0,0
17.735,17,19,11344,11,795,1770,1350,9053,8,258,2528,1350,2291
0.251,17,2,290,1,40,0,40,68,1,194,0,194,222
1786.846,17,87,3648,86,14,21021,14,3612,1,8,0,8,36
1120.003,17,164,12464,164,48,6871,48,12464,0,0,0,0,0
1796.618,6,376,26217,217,98,8317,469,15372,159,69,11367,69,10845
369.677,6,18,1242,14,180,28436,180,916,4,110,20067,110,326
1749.778,1,8,448,8,28,249968,28,448,0,0,0,0,0
0.113,6,13,3565,6,126,22,126,446,7,1373,18,1448,3119
283.006,17,4,352,2,60,283005,60,176,2,60,283005,60,176
292.0,6,44,7835,17,171,18247,517,1749,27,312,11229,1418,6086
0.447,6,9,1002,5,213,111,213,417,4,421,147,421,585
0.417,17,2,2380,2,1162,417,1162,2380,0,0,0,0,0
0.292,6,22,7333,12,334,25,663,1969,10,806,31,1408,5364
1775.375,17,142,11360,71,48,25362,48,5396,71,56,25361,56,5964
0.002,6,2,80,1,0,0,0,40,1,0,0,0,40
371.527,6,23,1535,16,177,24768,177,1053,7,110,10385,110,482
1799.488,17,144,11520,72,48,25344,48,5472,72,56,25344,56,6048
1796.005,17,448,39896,403,35,4467,288,25676,45,288,40020,288,14220
0.387,17,2,184,1,32,0,32,60,1,96,0,96,124
1796.913,6,378,26366,218,97,8280,469,15481,160,69,11301,69,10885
1.234,6,50,19925,28,874,45,1360,14269,22,476,50,2715,5656
0.024,17,2,304,1,60,0,60,88,1,188,0,188,216
1.656,6,26,10139,16,285,110,587,1499,10,1176,166,2840,8640
60.622,6,8,432,5,0,15155,0,268,3,0,30195,0,164
1700.617,2,16,512,16,8,113374,8,512,0,0,0,0,0
1683.043,17,16,1265,8,30,240432,37,471,8,71,240432,136,794
91.658,6,37,18869,22,702,34,1360,5127,15,1641,6538,4887,13742
0.015,17,2,443,1,45,0,45,73,1,342,0,342,370
1679.502,17,12,498,11,14,167950,14,462,1,8,0,8,36
33.518,6,32,5343,16,154,2234,722,1911,16,370,2221,2026,3432
1797.968,6,359,23178,210,75,8602,469,13009,149,69,12146,69,10169
62.065,6,28,14056,14,1001,71,1440,6601,14,983,4760,1440,7455
1.823,6,11,1516,7,279,303,279,918,4,191,257,272,598
1785.655,6,102,8296,68,65,26651,65,4930,34,59,54035,59,3366
0.194,6,9,1002,5,213,48,213,417,4,421,54,421,585
1795.126,6,356,22520,208,69,8672,69,12460,148,69,12211,69,10060
4.473,17,29,13161,14,620,344,1350,9073,15,244,227,1350,4088
1.379,6,50,19690,27,920,53,1440,13994,23,433,53,1440,5696
1761.967,17,168,14022,156,30,11367,37,9090,12,383,154748,463,4932
33.428,6,34,5310,16,180,2228,722,1924,18,244,1954,1408,3386
1680.461,1,14,784,14,28,129266,28,784,0,0,0,0,0
1.33,6,48,20093,28,891,49,1360,14517,20,476,60,2715,5576
238.069,17,4,352,2,60,238068,60,176,2,60,238068,60,176
93.542,6,561,262707,295,824,318,1152,246903,266,396,351,1152,15804
1.924,17,2,178,1,29,0,29,57,1,93,0,93,121
280.016,6,30,7432,13,158,23334,267,1317,17,543,17498,1400,6115
0.251,6,4,184,3,0,125,0,144,1,0,0,0,40
1.079,6,24,6505,13,324,88,959,2145,11,783,106,1452,4360
1787.691,6,104,8308,68,64,26681,64,4896,36,58,51074,58,3412
0.169,6,46,22181,27,1073,6,1420,17200,19,467,8,1883,4981
1.065,6,24,9045,14,306,81,867,1818,10,1135,92,2370,7227
90.629,17,4,352,2,60,90628,60,176,2,60,90628,60,176
1795.09,17,80,3354,79,14,23013,14,3318,1,8,0,8,36
125.96,6,25,5997,9,181,713,293,1269,16,408,8381,1179,4728
1744.067,6,140,8695,77,45,22948,208,5276,63,31,28125,31,3419
1785.855,6,369,25730,214,99,8384,469,15045,155,69,11596,69,10685
52.196,6,26,4028,14,186,3906,326,1505,12,465,3042,1408,2523
14.44,6,16,1327,8,222,2061,222,768,8,231,2061,231,559
61.179,6,11,452,6,0,12235,0,244,5,0,15268,0,208
70.465,6,27,7315,12,155,6405,267,1266,15,494,5032,3426,6049
1.68,6,51,18884,29,855,60,1360,13183,22,400,69,1360,5701
370.874,6,18,1242,14,180,28528,180,916,4,110,20061,110,326
280.291,6,29,7392,13,158,23357,267,1317,16,603,18681,1400,6075
0.051,17,2,259,1,53,0,53,81,1,150,0,150,178
229.631,17,4,352,2,60,229629,60,176,2,60,229629,60,176
0.637,6,25,8939,13,252,53,647,1692,12,1102,52,2876,7247
9.508,6,91,28266,46,559,211,1152,21968,45,449,210,1179,6298
1744.737,2,27,864,27,8,67105,8,864,0,0,0,0,0
0.046,17,2,134,1,31,0,31,59,1,47,0,47,75
280.232,6,29,7392,13,158,23352,267,1317,16,603,18680,1400,6075
1788.877,1,21,2690,21,100,89443,320,2690,0,0,0,0,0
126.722,2,2,64,2,8,126722,8,64,0,0,0,0,0
294.209,17,4,1344,4,308,98069,308,1344,0,0,0,0,0
0.409,17,4,352,2,37,402,37,130,2,83,400,89,222
0.181,17,2,290,1,40,0,40,68,1,194,0,194,222
0.303,6,9,1340,5,145,75,145,349,4,827,66,827,991
4.941,6,13,2311,8,188,705,245,700,5,1407,1165,1407,1611
85.658,6,30,14665,16,489,333,1360,3132,14,1370,6578,3928,11533
870.068,17,251,33649,122,172,7190,1350,24443,129,43,6780,1350,9206
3.92,17,5,295,5,31,980,31,295,0,0,0,0,0
134.697,6,25,10798,12,745,58,1460,3494,13,967,11213,1460,7304
20.554,6,6,585,3,103,2685,138,327,3,69,10277,69,258
8.993,6,3,180,3,0,0,0,180,0,0,0,0,0
0.973,6,4,160,2,0,423,0,80,2,0,600,0,80
1783.571,17,142,11360,71,48,25478,48,5396,71,56,25479,56,5964
39.66,6,25,4600,14,656,3050,1408,3409,11,101,364,335,1191
1775.412,6,128,7859,68,27,26497,27,4097,60,27,30090,27,3762
1784.791,6,243,25011,97,67,18590,594,9209,146,136,12308,4080,15802
97.144,6,15,1083,4,177,120,177,393,11,110,9696,110,690
327.376,6,351,292137,222,1355,1481,1448,270389,129,556,2416,1448,21748
1779.356,17,79,3312,78,14,23108,14,3276,1,8,0,8,36
0.005,17,2,592,1,44,0,44,72,1,492,0,492,520
317.081,6,73,18895,38,311,8569,1360,9330,35,388,9319,3289,9565
1787.251,6,102,8296,68,65,26675,65,4930,34,59,54155,59,3366
49.638,17,4,240,2,32,49637,32,120,2,32,49637,32,120
17.263,17,14,6088,7,504,2871,1350,3725,7,309,2870,1350,2363
1772.493,6,180,15480,120,69,14894,69,8940,60,69,30034,69,6540
0.58,6,24,6015,12,108,52,147,919,12,768,51,1581,5096
1791.836,1,58,4872,58,56,31435,56,4872,0,0,0,0,0
208.661,1,10,280,10,0,0,0,280,0,0,0,0,0
240.894,17,4,352,2,60,240893,60,176,2,60,240893,60,176
0.007,17,2,570,1,30,0,30,58,1,484,0,484,512
188.799,17,4,352,2,60,188798,60,176,2,60,188798,60,176
1740.926,1,13,754,13,30,145077,30,754,0,0,0,0,0
1740.991,1,15,840,15,28,124356,28,840,0,0,0,0,0
6.237,6,28,8160,15,222,432,540,1964,13,944,504,1591,6196
66.94,6,627,295115,329,834,204,1152,277690,298,392,224,1152,17425
1787.001,17,336,79883,336,209,5334,422,79883,0,0,0,0,0
5.301,6,15,2108,7,120,883,197,890,8,445,757,799,1218
1799.914,17,144,11520,72,48,25350,48,5472,72,56,25350,56,6048
0.929,6,15,2224,7,288,124,288,620,8,424,104,434,1604
216.267,17,4,240,2,32,216266,32,120,2,32,216265,32,120
1386.52,2,12,384,12,8,126047,8,384,0,0,0,0,0
269.493,17,4,240,2,32,269492,32,120,2,32,269492,32,120
11.491,6,1862,1587973,1121,1363,10,1380,1554091,741,421,15,1923,33882
115.84,17,4,352,2,60,115839,60,176,2,60,115838,60,176
10.969,6,19,4402,10,275,1218,275,958,9,768,769,1440,3444
54.244,6,2601,2275894,1681,1276,32,1368,2223390,920,776,58,2736,52504
68.757,6,16,1428,6,180,121,180,680,10,110,7619,110,748
1741.56,1,16,896,16,28,116104,28,896,0,0,0,0,0
0.044,17,4,368,2,32,36,32,120,2,96,0,96,248
1620.221,1,7,392,7,28,270036,28,392,0,0,0,0,0
0.047,17,6,2117,6,324,9,354,2117,0,0,0,0,0
5.686,6,39,7289,19,218,315,314,3383,20,516,285,1179,3906
225.271,1,2,813,2,378,225271,421,813,0,0,0,0,0
1792.91,17,142,11360,71,48,25612,48,5396,71,56,25612,56,5964
1296.665,6,294,27123,157,114,8311,469,12447,137,137,9534,1460,14676
1778.741,1,236,13216,236,28,7569,28,13216,0,0,0,0,0
1.568,2,2,64,2,8,1568,8,64,0,0,0,0,0
3.039,17,2,152,2,48,3039,48,152,0,0,0,0,0
56.257,6,7392,7064407,4777,1399,11,1448,6923751,2615,776,21,1448,140656
0.302,6,24,5937,12,164,27,453,1442,12,643,26,1542,4495
1770.133,6,210,16158,78,68,22987,296,7650,132,48,13512,78,8508
1.977,17,26,11918,12,670,179,1350,8376,14,225,103,1350,3542
46.025,17,4,530,2,36,46020,36,128,2,173,46020,187,402
433.931,17,122,12107,52,124,8508,1350,7926,70,31,6285,60,4181
1743.691,6,95,7203,63,38,28124,205,4476,32,33,56235,98,2727
128.855,6,31,8912,14,158,9911,267,1357,17,687,8046,1400,7555
5.012,17,4,558,2,36,5001,36,128,2,187,4997,187,430
10.001,17,5,290,4,23,3333,58,206,1,56,0,56,84
365.708,6,18,1242,14,180,28131,180,916,4,110,20057,110,326
38.384,17,22,1936,11,48,3837,48,836,11,72,3837,72,1100
1.834,6,31,10629,19,398,101,928,1960,12,1169,149,2504,8669
0.909,6,10,1687,7,100,151,100,384,3,1179,326,1179,1303
3.001,6,12,2271,7,188,500,245,660,5,1407,683,1407,1611
0.406,17,2,162,1,45,0,45,73,1,61,0,61,89
42.099,1,48,4992,0,0,0,0,0,48,76,895,76,4992
344.918,1,6,645,6,79,68983,142,645,0,0,0,0,0
1739.995,6,131,8388,73,51,24166,208,5169,58,31,30522,31,3219
12.108,6,7,380,4,0,4036,0,216,3,0,6033,0,164
1685.61,17,12,498,11,14,168561,14,462,1,8,0,8,36
610.345,17,32,10752,32,308,19688,308,10752,0,0,0,0,0
355.243,17,6,360,3,32,177621,32,180,3,32,177621,32,180
1.705,17,28,12775,13,660,142,1350,8953,15,226,113,1350,3822
367.078,6,27,1767,18,177,21592,177,1181,9,110,8556,110,586
1.857,6,16,5124,8,150,265,174,624,8,835,251,1452,4500
1768.958,6,101,9344,66,65,27214,65,5577,35,59,52024,59,3767
25.708,6,38,9585,17,184,1606,722,2161,21,658,1275,2760,7424
1748.795,6,125,14658,77,80,23010,501,6160,48,152,37206,1420,8498
300.503,6,72,12481,34,333,9104,1368,6443,38,225,8120,1368,6038
0.0,17,1,283,1,255,0,255,283,0,0,0,0,0
34.071,6,25,6284,14,117,2620,159,1337,11,727,3405,1418,4947
1783.918,6,102,8364,68,66,26625,66,4964,34,60,54055,60,3400
228.145,17,4,240,2,32,228144,32,120,2,32,228144,32,120
1.217,6,3,136,2,0,1217,0,88,1,0,0,0,48
15.947,6,1044,925008,644,1358,24,1368,897796,400,776,39,2736,27212
0.531,17,3,451,2,39,315,39,134,1,289,0,289,317
1.407,6,48,20274,27,967,54,1440,14658,21,433,61,1440,5616
6.934,6,566,493538,354,1327,19,1368,477850,212,776,31,1473,15688
279.088,6,263,93652,122,837,2306,1460,71185,141,264,1991,2385,22467
125.847,2,2,64,2,8,125847,8,64,0,0,0,0,0
0.933,6,25,6444,13,296,77,826,2007,12,790,84,1420,4437
1.866,6,12,2271,7,188,311,245,660,5,1407,398,1407,1611
106.307,6,43,8950,21,410,705,916,2163,22,368,5056,3488,6787
1770.124,6,99,9306,66,66,27232,66,5610,33,60,55313,60,3696
1773.042,6,180,15480,120,69,14899,69,8940,60,69,30047,69,6540
1.39,6,50,18755,27,853,53,1360,13059,23,433,54,1360,5696
1782.487,6,353,22607,203,69,8824,69,12260,150,69,11962,69,10347
1736.848,1,56,4704,0,0,0,0,0,56,56,31579,56,4704
1799.493,17,450,39960,405,35,4454,288,25740,45,288,40019,288,14220
1776.825,17,142,11360,71,48,25382,48,5396,71,56,25382,56,5964
1143.022,2,10,320,10,8,127002,8,320,0,0,0,0,0
1742.575,1,146,15476,146,78,12017,78,15476,0,0,0,0,0
13.253,6,23,6002,12,275,1204,275,1038,11,902,1222,1440,4964
1230.333,6,68,5218,39,63,25644,63,2820,29,51,43935,57,2398
252.302,6,29,7654,13,138,666,174,1076,16,494,16813,1452,6578
1741.459,17,29,6815,29,207,62194,207,6815,0,0,0,0,0
0.801,2,2,64,2,8,801,8,64,0,0,0,0,0
0.04,17,2,535,1,37,0,37,65,1,442,0,442,470
0.69,6,3,144,2,0,690,0,92,1,0,0,0,52
119.704,6,32,15020,15,585,68,1360,3557,17,979,7472,1360,11463
7.398,6,21,2657,11,211,739,211,1050,10,545,814,904,1607
19.276,6,23,6929,8,154,287,267,792,15,502,1375,3377,6137
1.084,6,27,8506,15,229,65,583,2007,12,1201,82,3151,6499
1799.445,6,731,49418,365,31,4943,31,24677,366,31,4929,31,24741
1.092,6,29,10532,16,617,67,1360,3785,13,776,75,2134,6747
35.19,6,33,5198,16,154,2346,722,1912,17,299,2174,1448,3286
0.013,17,2,459,1,40,0,40,68,1,363,0,363,391
0.149,6,12,2069,7,324,24,585,1009,5,396,33,580,1060
0.299,6,27,9054,13,247,24,624,1684,14,947,22,1408,7370
1787.875,6,183,23596,103,304,17528,304,16368,80,83,22631,83,7228
4.156,6,34,6169,17,206,259,314,2744,17,456,243,1152,3425
1791.958,17,87,3648,86,14,21081,14,3612,1,8,0,8,36
240.19,6,58,22700,32,903,7747,1402,19743,26,199,9607,580,2957
69.701,6,36,8455,17,410,553,882,1942,19,478,3861,2128,6513
58.293,17,6,390,3,37,29145,47,195,3,37,29146,47,195
1780.646,6,184,17079,122,83,14716,965,9985,62,74,29185,405,7094
32.741,6,9,540,2,0,998,0,120,7,0,5428,0,420
0.966,6,11,1727,7,100,161,100,384,4,589,240,1152,1343
144.411,6,30,7432,13,158,12034,267,1317,17,543,9023,1400,6115
240.334,6,56,18135,29,749,8581,1418,15010,27,214,9242,580,3125
0.01,17,3,484,2,46,1,46,148,1,308,0,308,336
421.123,2,7,224,7,8,70187,8,224,0,0,0,0,0
8.139,6,20,9296,6,154,1627,267,712,14,801,624,1917,8584
51.769,6,17,5751,10,272,5752,516,1220,7,849,147,1452,4531
1773.614,6,180,15480,120,69,14904,69,8940,60,69,30054,69,6540
1794.565,17,87,3648,86,14,21112,14,3612,1,8,0,8,36
371.125,6,25,1651,17,177,23195,177,1117,8,110,9243,110,534
0.735,6,36,8298,19,268,40,727,1865,17,478,38,2720,6433
21.274,17,3,992,3,302,10637,308,992,0,0,0,0,0
1.429,6,49,19650,27,920,54,1360,13994,22,476,59,2720,5656
11.488,6,11,440,6,0,2297,0,240,5,0,2378,0,200
16.642,17,17,9257,9,733,2068,1350,6849,8,273,2366,1350,2408
1776.386,17,140,11200,70,48,25744,48,5320,70,56,25744,56,5880
0.629,6,143,91405,74,1291,8,1420,84354,69,427,9,1420,7051
86.022,6,740,376174,418,839,206,1152,358503,322,398,267,1152,17671
0.278,17,7,2375,7,311,46,355,2375,0,0,0,0,0
1790.17,17,142,11360,71,48,25571,48,5396,71,56,25573,56,5964
1798.035,6,182,15243,96,107,18926,208,10811,86,31,21150,31,4432
2.551,6,11,2231,7,188,425,245,660,4,1407,183,1407,1571
541.344,6,100,17602,49,122,11274,721,5771,51,515,10823,1440,11831
218.919,17,4,352,2,60,218918,60,176,2,60,218918,60,176
1783.814,6,374,26468,216,104,8296,469,15732,158,69,11361,69,10736
1787.903,6,360,24156,210,88,8554,469,13878,150,69,11999,69,10278
5.19,6,24,7964,14,362,399,517,1824,10,801,560,2688,6140
75.689,6,13,540,6,0,2526,0,244,7,0,12613,0,296
1542.093,6,124,12407,66,67,23724,722,5611,58,77,26298,1448,6796
897.758,6,59,4575,34,45,27204,205,2491,25,34,37398,98,2084
1723.433,17,12,498,11,14,172343,14,462,1,8,0,8,36
1776.35,17,73,3060,72,14,25019,14,3024,1,8,0,8,36
1745.192,6,95,7203,63,38,28148,205,4476,32,33,56281,98,2727
0.421,6,14,5932,7,99,49,99,471,7,1017,59,1448,5461
0.225,6,20,4960,10,137,25,267,1092,10,866,24,2867,3868
127.885,6,171,131838,108,1274,1195,1408,119051,63,678,2020,2439,12787
0.404,17,8,2750,8,315,57,354,2750,0,0,0,0,0
1290.953,6,83,6740,50,65,26345,65,3560,33,58,40338,59,3180
1203.042,6,141,17114,84,79,13035,267,6630,57,157,21482,3417,10484
0.245,6,27,7296,13,155,20,267,1301,14,603,16,2036,5995
1792.255,17,132,10560,66,48,27572,48,5016,66,56,27572,56,5544
0.005,17,2,205,1,46,0,46,74,1,103,0,103,131
1.43,6,50,18660,27,846,55,1360,12964,23,433,55,1360,5696
105.42,1,2,120,2,32,105420,32,120,0,0,0,0,0
0.378,17,8,2758,8,316,54,355,2758,0,0,0,0,0
1.303,6,51,20983,28,942,48,1460,15287,23,433,51,1460,5696
1791.18,6,370,23425,213,69,8448,69,13005,157,69,11479,69,10420
3.202,6,9,527,5,43,800,43,311,4,0,1056,0,216
3.731,6,90,57605,47,871,81,1440,11497,43,1232,85,1440,46108
194.376,6,68,48785,45,1203,4417,1408,40858,23,960,2805,3847,7927
0.791,6,10,1687,7,100,131,100,384,3,1179,264,1179,1303
1799.026,17,450,39960,405,35,4453,288,25740,45,288,40019,288,14220
313.085,6,23,5479,9,133,39135,159,887,14,967,24083,1669,4592
69.607,6,40,10019,14,169,5354,267,1751,26,343,2781,1460,8268
0.176,6,43,18998,25,1002,7,1420,14057,18,467,9,1883,4941
0.069,17,2,212,1,46,0,46,74,1,110,0,110,138
1.236,6,25,8056,12,164,95,267,1288,13,869,88,1448,6768
1667.575,1,7,392,7,28,277929,28,392,0,0,0,0,0
0.191,17,2,152,1,48,0,48,76,1,48,0,48,76
1796.976,17,448,39896,403,35,4470,288,25676,45,288,40022,288,14220
559.77,17,91,35308,91,360,6219,360,35308,0,0,0,0,0
1773.434,6,180,15480,120,69,14902,69,8940,60,69,30050,69,6540
1794.684,17,144,11520,72,48,25277,48,5472,72,56,25277,56,6048
1773.68,6,223,19055,83,74,21628,301,8476,140,70,12759,1062,10579
240.602,6,41,6298,19,332,13364,1056,3321,22,228,11455,580,2977
1786.577,6,104,8376,68,65,26665,65,4930,36,59,51042,59,3446
1.026,17,4,314,2,31,978,31,118,2,70,994,70,196
0.31,6,24,6064,12,181,28,537,1526,12,651,26,1448,4538
1741.794,6,87,6322,58,31,30557,31,3915,29,31,62206,31,2407
0.122,17,2,376,1,39,0,39,67,1,281,0,281,309
0.358,6,22,4442,11,165,35,456,1394,11,493,33,888,3048
46.498,6,7,5150,2,131,990,131,342,5,1152,11308,1152,4808
0.316,6,10,1671,6,552,63,948,1348,4,159,105,159,323
313.631,2,4,128,4,8,104543,8,128,0,0,0,0,0
1740.672,17,28,29568,28,1028,64469,1028,29568,0,0,0,0,0
6.623,6,16,5713,5,106,1652,106,314,11,823,661,1452,5399
0.034,17,2,290,1,40,0,40,68,1,194,0,194,222
36.75,6,28,7217,13,155,3062,267,1306,15,482,2624,1997,5911
0.014,6,10,1568,5,121,2,121,389,5,911,3,911,1179
1793.292,1,67,5628,67,56,27171,56,5628,0,0,0,0,0
1740.676,6,87,6322,58,31,30538,31,3915,29,31,62165,31,2407
1779.821,6,241,24948,96,67,18733,659,9186,145,138,12358,4658,15762
1793.988,17,144,11520,72,48,25267,48,5472,72,56,25267,56,6048
0.275,6,21,5000,11,137,27,267,1132,10,692,28,1467,3868
1.486,6,38,8264,19,320,82,1162,2728,19,433,72,1360,5536
371.998,6,25,1651,17,177,23249,177,1117,8,110,9255,110,534
1791.873,6,356,22520,208,69,8656,69,12460,148,69,12189,69,10060
1.48,6,46,18800,26,934,59,1460,13224,20,476,65,2615,5576
1797.521,1,345,28980,345,56,5225,56,28980,0,0,0,0,0
280.404,6,30,7432,13,158,23367,267,1317,17,543,17524,1400,6115
1772.177,6,180,15480,120,69,14892,69,8940,60,69,30030,69,6540
269.455,1,12,672,12,28,24495,28,672,0,0,0,0,0
369.585,6,19,1294,14,180,28429,180,916,5,110,15170,110,378
2.893,17,3,468,3,128,1446,128,468,0,0,0,0,0
369.109,6,47,10881,29,320,13182,1360,5359,18,399,509,1360,5522
1787.693,6,358,22669,209,69,8594,69,12569,149,69,12077,69,10100
321.112,1,3,168,3,28,160556,28,168,0,0,0,0,0
120.995,1,25,1400,25,28,5041,28,1400,0,0,0,0,0
5.182,6,4,176,3,0,2591,0,128,1,0,0,0,48
1783.5,6,359,22709,209,69,8574,69,12569,150,69,11967,69,10140
415.02,17,18,2528,9,48,51875,48,684,9,176,51876,308,1844
8.103,6,24,3745,14,211,623,211,1226,10,665,693,904,2519
0.383,6,15,1773,8,288,53,288,628,7,284,34,434,1145
36.161,1,4,224,4,28,12053,28,224,0,0,0,0,0
1799.298,6,145,9352,79,49,22917,208,5589,66,36,27680,112,3763
0.0,1,2,163,2,53,0,78,163,0,0,0,0,0
7.413,6,11,3740,6,407,1440,722,1146,5,1165,1811,1408,2594
4.639,6,38,7229,20,218,244,314,3423,18,513,257,1179,3806
1.152,6,24,8004,12,164,89,267,1288,12,869,89,1402,6716
7.785,6,15,1362,8,275,1112,275,878,7,96,966,96,484
12.155,6,45,8702,24,231,528,314,4435,21,489,585,1179,4267
280.389,6,28,7352,12,158,25489,267,1277,16,603,18687,1400,6075
1744.72,2,27,864,27,8,67104,8,864,0,0,0,0,0
1792.001,6,377,26257,216,98,8334,469,15332,161,69,11199,69,10925
280.165,6,22,6974,11,181,28016,267,1168,11,893,28014,3445,5806
0.009,17,2,912,1,308,0,308,336,1,548,0,548,576
240.265,6,43,8953,21,523,12013,1408,5810,22,221,11441,617,3143
1747.186,1,86,7224,86,56,20555,56,7224,0,0,0,0,0
0.593,6,27,9020,15,337,42,674,2160,12,1036,48,1946,6860
1789.283,6,354,22440,207,69,8685,69,12420,147,69,12255,69,10020
1795.0,1,278,15568,278,28,6480,28,15568,0,0,0,0,0
0.11,17,7,1532,4,64,36,64,368,3,360,0,360,1164
0.742,6,5,260,3,0,78,0,156,2,0,631,0,104
1783.395,17,75,3141,73,13,24769,14,3061,2,12,381475,16,80
0.067,6,9,1339,5,145,16,145,349,4,826,17,826,990
0.079,6,7,423,4,43,6,43,259,3,0,38,0,164
11.232,6,82,24501,40,550,288,1152,18680,42,459,266,1179,5821
0.37,17,20,12382,9,759,46,1350,7084,11,453,33,1350,5298
1797.448,1,57,4788,0,0,0,0,0,57,56,32097,56,4788
1692.41,1,7,392,7,28,282068,28,392,0,0,0,0,0
1785.537,17,87,3648,86,14,21006,14,3612,1,8,0,8,36
1783.221,17,83,3480,82,14,22015,14,3444,1,8,0,8,36
1.01,17,4,792,3,60,493,60,264,1,500,0,500,528
146.472,6,65,11194,32,198,4064,1189,3866,33,375,4576,1917,7328
46.136,17,7,2352,7,308,7689,308,2352,0,0,0,0,0
1.007,17,4,732,2,32,898,32,120,2,278,0,278,612
118.875,17,4,352,2,60,118874,60,176,2,60,118874,60,176
112.999,6,4524,4053762,2788,1365,40,1368,3941754,1736,776,65,2736,112008
1.961,6,30,10994,17,350,122,1041,2136,13,925,132,1460,8858
71.65,6,44,10314,21,736,585,1360,4592,23,399,3249,1360,5722
1.524,6,47,18538,26,911,60,1440,12922,21,433,66,1440,5616
45.44,1,4,224,4,28,15146,28,224,0,0,0,0,0
2.466,6,113,87677,48,131,52,232,2449,65,1377,34,1430,85228
0.012,17,3,386,2,36,1,36,128,1,230,0,230,258
1735.522,6,130,12735,77,62,22835,721,6339,53,80,33369,1448,6396
5.353,6,45,8425,22,227,254,314,4062,23,491,231,1179,4363
1.615,6,3,280,1,0,0,0,40,2,160,1394,160,240
26.018,6,34,8172,16,188,1734,721,1964,18,685,1507,2840,6208
1.503,6,52,19164,28,939,55,1460,13383,24,400,56,1460,5781
1797.066,17,449,39928,404,35,4459,288,25708,45,288,40020,288,14220
294.965,17,2,908,2,426,294965,687,908,0,0,0,0,0
3.946,17,6,1444,3,60,1958,60,264,3,365,1968,384,1180
0.001,6,2,80,1,0,0,0,40,1,0,0,0,40
1773.129,6,180,15480,120,69,14900,69,8940,60,69,30045,69,6540
32.068,6,41,8760,16,372,40,802,1789,25,297,1330,1360,6971
1746.03,6,151,16390,87,126,20302,205,11328,64,32,27708,33,5062
0.36,17,2,685,1,308,0,308,336,1,321,0,321,349
111.367,6,1071,531699,593,829,188,1152,506765,478,415,232,1179,24934
45.18,17,18,1368,18,48,2657,48,1368,0,0,0,0,0
33.524,6,32,5359,15,180,2394,722,1871,17,288,2083,1402,3488
1780.306,17,86,3606,85,14,21194,14,3570,1,8,0,8,36
27.445,6,44,14624,22,172,1306,721,2611,22,1112,1296,2840,12013
1788.365,6,356,22520,208,69,8639,69,12460,148,69,12165,69,10060
11.707,17,3,984,3,300,5853,300,984,0,0,0,0,0
1796.952,6,448,38940,204,66,8689,658,14617,244,84,7394,4649,24323
0.015,17,2,246,1,45,0,45,73,1,145,0,145,173
85.155,6,21,4588,13,189,7096,516,1470,8,698,11489,1452,3118
1682.621,17,16,1265,8,30,240367,37,471,8,71,240365,136,794
1797.568,17,447,39580,403,35,4471,288,25676,44,288,40947,288,13904
0.234,17,2,312,1,64,0,64,92,1,192,0,192,220
9.802,6,1693,1584621,1044,1435,9,1448,1542957,649,776,14,1448,41664
289.499,1,4,224,4,28,96499,28,224,0,0,0,0,0
0.985,17,2,152,1,48,0,48,76,1,48,0,48,76
1741.27,17,30,31680,30,1028,60043,1028,31680,0,0,0,0,0
26.524,17,32,4704,16,48,1767,48,1216,16,190,1767,308,3488
1795.741,17,142,11360,71,48,25653,48,5396,71,56,25653,56,5964
0.014,17,2,548,2,246,14,246,548,0,0,0,0,0
1773.234,6,180,15480,120,69,14901,69,8940,60,69,30047,69,6540
4.938,6,37,7205,19,218,274,314,3383,18,516,273,1179,3822
280.05,6,32,7512,15,158,20003,267,1397,17,543,17500,1400,6115
1.226,6,25,8056,12,164,95,267,1288,13,869,87,1440,6768
0.051,6,3,136,2,0,51,0,88,1,0,0,0,48
0.011,17,2,572,1,39,0,39,67,1,477,0,477,505
1782.598,17,73,3060,72,14,25107,14,3024,1,8,0,8,36
1797.159,17,449,39928,404,35,4459,288,25708,45,288,40017,288,14220
1750.57,17,12,498,11,14,175057,14,462,1,8,0,8,36
1781.749,17,73,3060,72,14,25095,14,3024,1,8,0,8,36
333.285,17,5,679,5,107,83321,355,679,0,0,0,0,0
1786.378,6,102,8364,68,66,26662,66,4964,34,60,54129,60,3400
378.353,17,6,1984,6,302,75670,308,1984,0,0,0,0,0
1792.278,6,379,24130,218,69,8259,69,13343,161,69,11199,69,10787
119.664,6,1075,535518,591,840,202,1152,510328,484,416,247,1179,25190
0.017,17,4,352,2,60,16,60,176,2,60,16,60,176
234.149,17,4,352,2,60,234148,60,176,2,60,234148,60,176
302.365,6,42,13454,24,723,13146,1448,6326,18,561,584,2144,7128
57.589,6,26,7137,12,155,5235,267,1266,14,530,4429,2006,5871
360.13,17,252,18991,148,40,2449,41,10157,104,56,3496,76,8834
13.922,6,15,3958,10,75,1546,75,603,5,1029,3417,2000,3355
122.202,2,2,64,2,8,122202,8,64,0,0,0,0,0
313.246,6,1288,1176712,844,1394,371,1460,1147862,444,160,47,1460,28850
10.67,6,20,13083,6,161,2098,196,582,14,1192,807,1360,12501
239.58,1,20,2080,0,0,0,0,0,20,76,12609,76,2080
281.484,6,29,7392,13,158,23457,267,1317,16,603,18756,2036,6075
0.42,17,21,9401,10,393,43,1350,4210,11,443,38,1350,5191
1166.984,1,34,1904,34,28,35363,28,1904,0,0,0,0,0
1773.251,6,204,22399,130,75,13746,267,10057,74,133,24290,1997,12342
0.163,6,10,1514,5,503,40,503,771,5,475,40,475,743
0.088,17,2,362,1,32,0,32,60,1,274,0,274,302
0.008,6,2,287,1,207,0,207,247,1,0,0,0,40
1744.664,2,16,512,16,8,116310,8,512,0,0,0,0,0
1785.841,6,432,28112,216,100,8306,469,15056,216,34,8306,64,13056
1769.772,6,101,9344,66,65,27227,65,5577,35,59,52049,59,3767
6.217,6,1742,1609322,1098,1387,5,1408,1571170,644,931,9,2801,38152
149.902,6,21,8544,11,556,106,1329,2140,10,998,16632,1791,6404
5.036,17,4,288,2,36,5019,36,128,2,52,5012,52,160
0.872,6,29,6078,14,156,67,267,1502,15,567,57,1420,4576
0.257,17,2,384,1,39,0,39,67,1,289,0,289,317
0.179,6,13,5356,8,196,25,196,620,5,1489,11,2876,4736
787.502,6,46,3291,30,31,27155,31,2025,16,31,52499,31,1266
0.8,17,18,5660,8,362,113,1350,3126,10,225,85,1350,2534
10.959,6,20,4442,11,275,1095,275,998,9,768,771,1440,3444
1786.245,6,107,9016,70,70,25887,273,5283,37,64,49615,247,3733
1.284,6,47,18887,26,938,51,1460,13271,21,433,55,1460,5616
46.736,17,4,392,2,34,46677,39,124,2,106,46600,119,268
0.055,6,7,423,4,43,6,43,259,3,0,25,0,164
1710.377,17,465,62337,218,166,7881,1350,42391,247,52,6944,1350,19946
2.069,6,9,527,5,43,517,43,311,4,0,653,0,216
1.843,6,17,6552,8,150,263,174,624,9,927,217,1420,5928
287.76,6,34,3485,17,324,17984,585,1589,17,169,17984,580,1896
0.021,6,10,1544,5,505,5,505,773,5,503,5,503,771
1745.286,6,95,7203,63,38,28149,205,4476,32,33,56286,98,2727
366.082,6,99,16410,46,326,8135,1408,8342,53,196,7039,1408,8068
1776.44,17,140,11200,70,48,25745,48,5320,70,56,25745,56,5880
296.04,6,35,7088,17,262,18499,517,1680,18,744,17411,1418,5408
0.072,17,2,384,1,32,0,32,60,1,296,0,296,324
1772.545,6,240,17880,120,69,14895,69,8940,120,34,14895,64,8940
368.272,6,18,1242,14,180,28328,180,916,4,110,20202,110,326
1794.48,17,144,11520,72,48,25274,48,5472,72,56,25274,56,6048
0.958,2,3,96,3,8,479,8,96,0,0,0,0,0
19.156,17,4,352,2,60,19155,60,176,2,60,19151,60,176
1.253,6,46,19124,27,891,48,1360,13588,19,433,60,1360,5536
1681.718,17,14,1036,7,30,280284,30,406,7,62,280284,62,630
0.47,6,10,968,5,256,114,256,460,5,304,114,304,508
257.354,17,4,240,2,32,257353,32,120,2,32,257353,32,120
1781.223,17,73,3060,72,14,25087,14,3024,1,8,0,8,36
1793.524,1,182,19292,182,78,9908,78,19292,0,0,0,0,0
0.405,6,27,7296,13,155,33,267,1301,14,603,29,2036,5995
31.874,6,7,308,1,0,0,0,44,6,0,6323,0,264
50.443,6,6206,5822625,3857,1425,13,1448,5689347,2349,792,21,1448,133278
7.901,6,23,9513,7,140,1316,267,849,16,728,525,1460,8664
6.105,6,1504,1363250,904,1427,6,1448,1327374,600,776,9,1448,35876
416.141,6,113,14228,58,150,7300,1189,5330,55,247,7706,1420,8898
41.474,17,4,240,2,32,41473,32,120,2,32,41473,32,120
0.019,17,4,912,2,60,15,60,176,2,340,14,340,736
0.515,17,3,451,2,39,161,39,134,1,289,0,289,317
1.183,6,30,7999,15,269,84,780,2002,15,769,72,1360,5997
255.507,17,4,240,2,32,255506,32,120,2,32,255506,32,120
0.12,1,2,112,2,28,120,28,112,0,0,0,0,0
907.947,6,92,7889,61,69,15132,69,4510,31,69,30264,69,3379
1793.551,17,180,11520,180,36,10019,36,11520,0,0,0,0,0
0.059,17,2,290,1,40,0,40,68,1,194,0,194,222
1.503,6,38,8278,19,321,83,1164,2742,19,476,72,2615,5536
1.629,6,14,3451,5,288,364,288,520,9,639,181,853,2931
1738.699,6,87,6322,58,31,30503,31,3915,29,31,62096,31,2407
110.082,17,4,558,2,36,110077,36,128,2,187,110076,187,430
1771.563,6,99,9240,66,65,27254,65,5577,33,59,55351,59,3663
60.306,6,8,344,3,0,30153,0,124,5,0,3852,0,220
1072.182,6,122,8422,44,46,24934,46,3508,78,46,13924,46,4914
1755.222,17,411,138096,411,308,4281,308,138096,0,0,0,0,0
10.077,6,6,328,4,0,3359,0,216,2,0,10061,0,112
300.516,6,20,2269,10,195,33372,195,663,10,398,33372,419,1606
1799.277,1,57,4788,57,56,32129,56,4788,0,0,0,0,0
258.285,6,168,129732,105,1296,2483,1448,116957,63,632,2045,1448,12775
1666.265,1,8,448,8,28,238037,28,448,0,0,0,0,0
1772.561,6,180,15480,120,69,14895,69,8940,60,69,30041,69,6540
3.774,17,4,1556,4,361,1258,361,1556,0,0,0,0,0
0.808,2,2,80,2,16,808,16,80,0,0,0,0,0
1792.745,6,358,22669,208,69,8660,69,12529,150,69,12031,69,10140
48.377,17,6,2016,6,308,9675,308,2016,0,0,0,0,0
1788.494,17,87,3648,86,14,21041,14,3612,1,8,0,8,36
1.257,6,50,19204,27,885,48,1360,13508,23,433,49,1360,5696
193.849,17,4,352,2,60,193848,60,176,2,60,193848,60,176
0.537,17,8,2750,8,315,76,354,2750,0,0,0,0,0
1738.864,1,56,4704,56,56,31615,56,4704,0,0,0,0,0
0.281,6,27,7296,13,155,23,267,1301,14,603,20,1400,5995
3.848,17,4,240,4,32,1282,32,240,0,0,0,0,0
1770.197,6,99,9240,66,65,27233,65,5577,33,59,55315,59,3663
63.919,6,29,6736,12,154,5810,267,952,17,566,3994,1452,5784
3.681,6,32,9021,14,158,283,267,1357,18,630,205,2036,7664
68.876,6,73,25998,38,670,1856,1360,17684,35,627,2020,2720,8314
1765.922,6,128,15005,77,171,23235,1250,9765,51,84,35318,342,5240
7.052,6,41,7642,21,224,352,314,3756,20,513,355,1179,3886
1790.007,17,138,11040,69,48,26323,48,5244,69,56,26323,56,5796
1784.562,6,357,22629,208,69,8621,69,12460,149,69,12057,69,10169
4.115,6,38,7229,19,218,228,314,3383,19,440,214,1152,3846
169.076,6,257,208612,161,1335,1056,1448,191351,96,583,1777,1448,17261
11.502,6,25,8198,11,347,1149,1420,2182,14,681,884,1420,6016
0.429,17,12,4389,12,337,39,360,4389,0,0,0,0,0
2.937,6,22,6455,10,280,321,517,1370,12,744,262,1408,5085
278.415,6,64,12332,32,268,8979,1189,5044,32,400,8979,3457,7288
0.231,17,2,154,1,41,0,41,69,1,57,0,57,85
1.631,6,48,19611,27,920,62,1360,13995,21,433,71,1360,5616
280.397,6,29,7392,13,158,23366,267,1317,16,603,18688,2800,6075
0.403,6,12,1653,6,288,79,288,548,6,426,45,434,1105
1771.831,6,99,9240,66,65,27258,65,5577,33,59,55366,59,3663
56.236,6,8,432,4,0,18745,0,216,4,0,18690,0,216
1.272,6,24,8004,12,164,98,267,1288,12,1014,98,2331,6716
1787.174,6,102,8296,68,65,26674,65,4930,34,59,54154,59,3366
247.668,6,32,8036,13,189,10527,516,1470,19,362,13754,1452,6566
0.506,6,33,10709,17,439,31,1448,2651,16,656,32,1448,8058
0.005,17,2,375,1,44,0,44,72,1,275,0,275,303
1.256,6,50,18923,27,865,48,1360,13227,23,433,49,1360,5696
240.288,6,58,21075,31,863,8009,1418,18032,27,203,9241,580,3043
121.987,6,20,3535,7,152,286,267,742,13,226,10144,1179,2793
0.261,6,21,5908,12,181,23,537,1526,9,651,31,2194,4382
1786.295,17,87,3648,86,14,21015,14,3612,1,8,0,8,36
1794.362,6,244,35804,152,302,11883,302,26032,92,83,19718,83,9772
117.518,6,37,18502,18,549,104,1460,3009,19,1132,6521,1460,15493
280.441,6,30,7432,13,158,23370,267,1317,17,543,17525,1400,6115
2.248,6,2,111,1,0,0,0,40,1,31,0,31,71
0.03,17,2,338,1,33,0,33,61,1,249,0,249,277
761.89,6,99,13300,58,84,13366,267,4693,41,193,19043,1460,8607
0.4,6,93,59822,53,1278,7,1432,52060,40,559,9,1871,7762
0.14,17,2,602,1,46,0,46,74,1,500,0,500,528
1798.608,6,359,22778,209,69,8647,69,12500,150,69,12071,69,10278
0.274,17,2,290,1,40,0,40,68,1,194,0,194,222
1796.922,6,356,22520,208,69,8680,69,12460,148,69,12223,69,10060
1799.088,1,264,14784,264,28,6840,28,14784,0,0,0,0,0
1784.5,6,117,13597,77,81,23480,501,6030,40,156,45753,1420,7567
4.02,17,8,616,4,33,1334,33,244,4,65,1334,65,372
1786.477,6,359,22709,209,69,8588,69,12569,150,69,11989,69,10140
6.064,6,42,7389,21,201,303,314,3463,21,513,288,1179,3926
20.952,6,11,476,5,0,5235,0,216,6,0,4188,0,260
0.401,17,8,2766,8,317,57,356,2766,0,0,0,0,0
1716.473,17,134,10704,69,48,25242,48,5244,65,56,25238,56,5460
555.857,6,10,586,6,31,111171,31,333,4,31,185281,31,253
342.344,17,6,2248,6,346,68468,548,2248,0,0,0,0,0
69.089,6,25,7097,12,155,6280,267,1266,13,589,5756,3426,5831
7.037,6,1386,1277955,874,1385,7,1408,1246667,512,931,13,2816,31288
0.838,6,12,1653,6,288,164,288,548,6,426,88,434,1105
1770.674,6,99,9240,66,65,27241,65,5577,33,59,55330,59,3663
11.937,17,15,17710,15,1152,852,1450,17710,0,0,0,0,0
79.371,6,10346,9984658,6956,1358,11,1408,9803616,3390,792,23,1408,181042
1771.56,6,101,9410,66,66,27254,66,5610,35,60,52102,60,3800
1775.068,1,59,4956,59,56,30604,56,4956,0,0,0,0,0
0.11,17,2,152,1,48,0,48,76,1,48,0,48,76
364.928,6,48,3302,19,46,18366,46,1406,29,46,13033,46,1896
3.54,6,19,3615,11,49,354,92,679,8,419,184,2026,2936
85.301,17,4,352,2,60,85300,60,176,2,60,85300,60,176
19.99,6,17,3329,9,211,2498,211,922,8,665,2855,904,2407
1766.287,6,173,19889,94,111,18992,721,10248,79,161,22640,2840,9641
1793.509,6,404,25741,224,69,8042,69,13583,180,61,10019,69,12158
1793.589,1,60,7011,60,88,30399,351,7011,0,0,0,0,0
31.467,6,7,336,1,0,0,0,48,6,0,6291,0,288
842.263,2,9,288,9,8,105282,8,288,0,0,0,0,0
0.109,17,2,192,1,37,0,37,65,1,99,0,99,127
1.476,17,14,7766,7,716,246,1350,5210,7,337,236,1350,2556
1738.666,1,54,4536,0,0,0,0,0,54,56,32805,56,4536
0.0,17,8,2750,8,315,0,354,2750,0,0,0,0,0
3.647,6,20,3833,11,234,364,564,1504,9,463,403,1343,2329
379.605,6,22,1447,13,177,31633,177,861,9,110,11530,110,586
1.976,17,4,668,2,32,1972,32,120,2,246,5,246,548
1797.331,6,373,26028,217,98,8320,469,15303,156,69,11594,69,10725
0.36,6,12,1653,6,288,67,288,548,6,426,39,434,1105
0.741,6,28,5967,14,156,57,267,1502,14,650,51,1420,4465
0.259,17,2,144,1,36,0,36,64,1,52,0,52,80
1794.424,6,4597,4297336,1656,127,1084,351,100976,2941,1410,610,2836,4196360
190.508,6,22,2606,12,323,17318,582,1278,10,396,21148,580,1328
1787.492,6,102,8296,68,65,26678,65,4930,34,59,54158,59,3366
5.736,6,27,6739,13,280,474,517,1534,14,744,437,1408,5205
5.498,6,39,7269,19,218,305,314,3383,20,513,274,1179,3886
20.0,17,5,1680,5,308,5000,308,1680,0,0,0,0,0
1764.828,2,16,512,16,8,117655,8,512,0,0,0,0,0
1798.346,6,367,25650,214,99,8442,469,15045,153,69,11830,69,10605
1777.602,17,79,3312,78,14,23085,14,3276,1,8,0,8,36
0.033,17,4,284,2,32,27,32,120,2,54,24,60,164
0.069,17,2,1922,2,933,69,933,1922,0,0,0,0,0
0.011,17,2,124,1,34,0,34,62,1,34,0,34,62
0.131,6,10,766,5,185,25,185,453,5,45,26,45,313
3.538,17,3,1173,3,363,1769,363,1173,0,0,0,0,0
64.153,6,48,10384,22,533,734,910,3107,26,327,2560,1360,7277
118.725,1,2,112,2,28,118725,28,112,0,0,0,0,0
1792.019,17,180,14040,180,50,10011,50,14040,0,0,0,0,0
10.223,6,1463,1201483,800,1408,12,1448,1158639,663,776,15,1448,42844
3.99,17,3,201,3,39,1995,39,201,0,0,0,0,0
31.465,6,7,308,1,0,0,0,44,6,0,6274,0,264
0.166,17,2,144,1,36,0,36,64,1,52,0,52,80
1076.281,6,90,11089,50,89,21082,501,4235,40,141,27594,1420,6854
0.018,17,2,214,1,39,0,39,67,1,119,0,119,147
0.105,6,9,1339,5,145,26,145,349,4,826,32,826,990
7.26,6,6,280,2,0,7260,0,88,4,0,2378,0,192
415.404,6,530,239062,261,830,1597,1152,219701,269,409,1549,1179,19361
0.214,17,8,2758,8,316,30,355,2758,0,0,0,0,0
317.032,6,60,12847,30,143,10932,658,3679,30,397,10927,4649,9168
280.21,6,28,7352,13,158,23350,267,1317,15,678,20010,2800,6035
61.309,6,37,15941,22,801,2919,1448,9163,15,665,4360,1448,6778
0.395,17,6,1557,6,231,79,389,1557,0,0,0,0,0
6.014,6,44,8369,21,227,300,314,4022,23,427,261,1152,4347
1788.278,1,59,4956,59,56,30832,56,4956,0,0,0,0,0
0.052,6,9,1340,5,145,13,145,349,4,827,15,827,991
19.291,6,18,1407,9,222,2410,222,808,9,231,2410,231,599
8.138,6,46,8369,23,227,369,314,4102,23,417,351,1152,4267
0.12,6,9,1002,5,213,30,213,417,4,421,34,421,585
1752.041,6,95,7203,63,38,28258,205,4476,32,33,56507,98,2727
0.0,6,3,1978,2,917,0,1448,1938,1,0,0,0,40
368.434,6,18,1242,14,180,28341,180,916,4,110,20064,110,326
1796.082,17,463,41116,405,35,4445,288,25784,58,236,30887,288,15332
11.844,6,40,7309,20,218,623,314,3423,20,513,608,1179,3886
16.598,6,2442,2309739,1543,1417,10,1448,2256987,899,776,18,1448,52752
1747.71,1,8,448,8,28,249672,28,448,0,0,0,0,0
1.669,6,278,228093,170,1345,9,1420,219482,108,475,15,1883,8611
0.101,6,2,80,0,0,0,0,0,2,0,0,0,80
9.356,6,11,856,3,106,4678,106,234,8,90,1310,90,622
1777.815,1,58,4872,58,56,31189,56,4872,0,0,0,0,0
0.156,17,4,284,2,32,77,32,120,2,54,121,60,164
159.189,6,23,10989,12,380,69,832,1665,11,1267,15906,3928,9324
0.028,17,2,158,1,34,0,34,62,1,68,0,68,96
622.116,6,52,3519,32,48,20068,208,2347,20,33,32734,62,1172
0.377,17,7,2438,7,320,62,354,2438,0,0,0,0,0
166.445,6,38,8595,15,139,6819,267,1860,23,305,7565,1420,6735
1769.376,6,99,9240,66,65,27221,65,5577,33,59,55287,59,3663
1799.39,1,16,896,16,28,119959,28,896,0,0,0,0,0
5.041,17,4,288,2,36,5010,36,128,2,52,5010,52,160
1.491,6,48,20717,27,932,57,1440,15101,21,433,65,1440,5616
124.567,6,21,8321,11,532,84,1257,2068,10,973,13822,1791,6253
6.707,6,9,520,4,0,2235,0,220,5,0,1101,0,300
1.896,17,6,2016,6,308,379,308,2016,0,0,0,0,0
1797.623,17,449,39928,404,35,4460,288,25708,45,288,40021,288,14220
605.862,6,15634,15129509,5667,404,106,426,322788,9967,1439,60,7190,14806721
0.39,6,13,1693,7,288,62,288,588,6,426,40,434,1105
0.288,17,8,2750,8,315,41,354,2750,0,0,0,0,0
729.481,6,46,3682,24,50,31709,205,1859,22,34,34728,98,1823
1797.63,17,140,11200,70,48,26051,48,5320,70,56,26051,56,5880
1388.075,6,149,19596,82,304,17136,304,13696,67,83,21011,83,5900
0.16,6,9,1340,5,145,40,145,349,4,827,40,827,991
3.889,6,2,88,2,0,0,0,88,0,0,0,0,0
1789.915,6,339,28144,194,75,9274,267,12893,145,133,12429,1452,15251
1774.247,17,384,61714,384,132,4632,366,61714,0,0,0,0,0
62.176,6,40,14289,25,447,2590,1282,4938,15,856,4426,3847,9351
298.629,1,4,224,4,28,99543,28,224,0,0,0,0,0
1784.54,6,361,23327,210,75,8538,469,13078,151,69,11896,69,10249
0.79,6,10,924,5,283,136,283,551,5,105,133,105,373
61.317,6,35,16025,22,819,2919,1408,9351,13,855,5088,3847,6674
0.311,17,2,187,1,46,0,46,74,1,85,0,85,113
92.794,6,34,7733,13,155,7732,267,1306,21,348,4638,1460,6427
291.596,6,264,41812,148,304,1983,304,29248,116,83,2531,83,12564
11.271,6,1808,1558576,1089,1377,10,1420,1525595,719,467,15,1883,32981
0.535,17,2,384,1,39,0,39,67,1,289,0,289,317
3.675,6,34,6185,18,206,216,314,2784,16,551,228,1179,3401
106.204,6,75,49030,45,1199,2413,1408,40737,30,960,2123,3847,8293
1739.942,6,87,6322,58,31,30525,31,3915,29,31,62140,31,2407
1788.233,1,142,7952,142,28,12682,28,7952,0,0,0,0,0
280.391,6,30,7432,13,158,23365,267,1317,17,543,17521,1400,6115
118.576,6,1150,573188,628,847,189,1152,546462,522,417,227,1179,26726
0.279,17,2,152,1,48,0,48,76,1,48,0,48,76
77.693,17,2,672,2,308,77693,308,672,0,0,0,0,0
186.539,6,119,86207,75,929,114,1360,17096,44,1923,4335,10880,69111
281.317,6,32,7650,13,158,23443,267,1317,19,464,15600,1400,6333
1786.656,6,102,8364,68,66,26666,66,4964,34,60,54138,60,3400
1796.163,17,447,39580,403,35,4468,288,25676,44,288,40952,288,13904
280.622,6,37,6181,16,140,13474,501,1770,21,222,14027,1420,4411
1792.245,17,180,14040,180,50,10012,50,14040,0,0,0,0,0
0.954,6,10,1687,7,100,159,100,384,3,1179,346,1179,1303
569.11,6,70,4732,27,46,21888,46,2046,43,46,13547,46,2686
0.026,17,2,327,1,37,0,37,65,1,234,0,234,262
501.894,6,33,9370,11,181,14,267,1168,22,430,23899,3436,8202
5.522,6,41,7349,22,218,262,314,3503,19,440,292,1152,3846
299.156,6,1691,1757346,579,889,171,1009,40811,1112,1512,269,4314,1716535
0.234,17,2,2732,2,1338,234,1338,2732,0,0,0,0,0
1795.567,1,58,4872,58,56,31501,56,4872,0,0,0,0,0
307.647,1,4,1357,4,311,102549,327,1357,0,0,0,0,0
15.362,6,33,4502,22,150,731,267,2244,11,302,1391,1179,2258
0.745,17,12,5661,6,491,149,1350,3114,6,396,133,1350,2547
1.47,6,50,19938,27,937,56,1460,14242,23,433,58,1460,5696
280.215,6,27,7312,13,158,23351,267,1317,14,775,21552,3445,5995
14.769,6,7,380,4,0,4923,0,216,3,0,7374,0,164
1742.044,1,15,840,15,28,124431,28,840,0,0,0,0,0
61.774,6,49,28007,30,1038,2130,1448,20264,19,749,3412,1448,7743
12.826,6,1735,1606212,1133,1367,11,1432,1577424,602,425,21,1432,28788
1736.842,1,55,4620,0,0,0,0,0,55,56,32163,56,4620
280.273,6,30,7432,13,158,23356,267,1317,17,543,17514,1300,6115
5.894,6,489,419956,303,1321,18,1368,405620,186,776,30,1473,14336
1740.731,17,30,31680,30,1028,60025,1028,31680,0,0,0,0,0
30.047,6,4488,4204325,2891,1375,10,1408,4116617,1597,931,18,2801,87708
63.008,6,34,8347,17,400,537,885,1913,17,574,3930,4848,6434
35.541,6,32,5145,16,154,2369,722,1911,16,342,2338,1448,3234
1780.803,6,376,23872,215,69,8321,69,13292,161,69,11129,69,10580
1781.668,6,354,22440,207,69,8648,69,12420,147,69,12203,69,10020
384.457,17,13,4776,13,339,32038,548,4776,0,0,0,0,0
289.011,17,4,352,2,60,289010,60,176,2,60,289009,60,176
0.515,17,2,167,1,39,0,39,67,1,72,0,72,100
0.389,17,2,212,1,46,0,46,74,1,110,0,110,138
280.104,6,31,7472,14,158,21546,267,1357,17,543,17500,1400,6115
61.781,17,14,2884,7,48,10295,48,532,7,308,10294,308,2352
1789.951,6,356,22520,208,69,8647,69,12460,148,69,12176,69,10060
1744.536,6,97,7307,63,38,28137,205,4476,34,33,52857,98,2831
1795.758,17,447,39864,402,35,4478,288,25644,45,288,40020,288,14220
11.067,6,22,6554,6,154,2213,267,712,16,518,733,1460,5842
1772.287,6,180,15480,120,69,14893,69,8940,60,69,30032,69,6540
1772.432,6,180,15480,120,69,14894,69,8940,60,69,30033,69,6540
280.333,6,30,7432,13,158,23361,267,1317,17,543,17517,1300,6115
0.008,17,2,223,1,36,0,36,64,1,131,0,131,159
0.648,6,11,976,5,283,107,283,551,6,105,88,105,425
22.658,17,2,152,2,48,22658,48,152,0,0,0,0,0
7.442,6,4,176,3,0,3721,0,128,1,0,0,0,48
0.23,6,27,7296,13,155,19,267,1301,14,603,16,2036,5995
0.018,6,37,53513,1,0,0,0,40,36,1433,0,1448,53473
280.201,6,27,7312,12,158,25472,267,1277,15,678,20011,2800,6035
23.199,6,42,8731,19,360,684,734,1934,23,345,1048,1360,6797
1789.813,17,138,11040,69,48,26320,48,5244,69,56,26320,56,5796
1289.877,6,150,10348,55,46,23333,46,4294,95,46,13722,46,6054
252.403,2,3,96,3,8,126201,8,96,0,0,0,0,0
7.462,6,1077,1064650,712,1424,10,1448,1041006,365,776,20,1448,23644
169.889,6,45,6879,20,251,8941,585,3558,25,200,7076,580,3321
280.681,6,34,7677,16,158,18712,267,1437,18,501,16506,1400,6240
194.192,1,2,247,2,95,194192,100,247,0,0,0,0,0
374.093,6,23,1535,16,177,24939,177,1053,7,110,10396,110,482
0.085,17,2,180,1,30,0,30,58,1,94,0,94,122
300.964,6,36,8493,20,317,15840,922,2101,16,521,588,3488,6392
599.059,6,9,546,6,31,119811,31,333,3,31,299521,31,213
1661.849,1,8,448,8,28,237407,28,448,0,0,0,0,0
280.251,6,31,7472,14,158,21557,267,1357,17,543,17513,1400,6115
53.548,1,3,391,3,102,26774,121,391,0,0,0,0,0
0.034,17,2,553,1,36,0,36,64,1,461,0,461,489
0.686,6,27,9069,13,261,57,683,1728,14,943,45,1408,7341
27.719,6,11,592,5,0,6927,0,268,6,0,5542,0,324
0.476,6,23,7307,12,318,41,600,1906,11,964,45,1471,5401
2.992,17,3,1021,2,308,2000,308,672,1,321,0,321,349
181.981,6,6,604,3,241,90990,241,361,3,61,90895,92,243
6.437,6,44,8369,22,227,306,314,4062,22,489,293,1179,4307
175.54,2,3,96,3,8,87770,8,96,0,0,0,0,0
0.34,17,2,694,2,319,340,354,694,0,0,0,0,0
911.584,6,69,10483,38,109,18034,498,3486,31,198,30383,1420,6997
382.564,6,18,1242,14,180,29428,180,916,4,110,20080,110,326
1798.129,17,448,39896,403,35,4472,288,25676,45,288,40022,288,14220
1787.647,6,103,8395,68,65,26681,65,4930,35,59,52573,59,3465
128.997,6,25,6318,9,272,93,516,1180,16,345,8594,1452,5138
79.911,6,33,17758,18,708,32,1360,4354,15,1279,5699,2720,13404
0.004,17,2,255,1,43,0,43,71,1,156,0,156,184
141.107,1,10,1040,0,0,0,0,0,10,76,15678,76,1040
0.387,6,6,324,4,0,129,0,216,2,0,212,0,108
20.319,6,23,5533,13,107,1693,159,1126,10,966,2252,1708,4407
1787.412,6,104,8376,68,65,26677,65,4930,36,59,51065,59,3446
0.084,17,2,185,1,45,0,45,73,1,84,0,84,112
1.195,6,3,172,1,0,0,0,60,2,0,1003,0,112
80.671,6,31,12527,15,661,123,1360,3312,16,951,5365,1747,9215
48.661,6,17,5703,10,267,5406,501,1205,7,842,133,1420,4498
363.984,6,47,10175,29,266,12999,1360,4653,18,399,508,1360,5522
36.918,17,4,352,2,48,36910,48,152,2,72,36905,72,200
1794.451,1,124,6944,124,28,14589,28,6944,0,0,0,0,0
11.664,6,2421,2295540,1537,1415,7,1448,2244908,884,776,13,1448,50632
27.869,6,9,577,0,0,0,0,0,9,31,3483,31,577
1786.84,6,102,8296,68,65,26669,65,4930,34,59,54143,59,3366
0.087,6,9,1346,5,145,21,145,349,4,833,23,833,997
0.004,6,9,15372,1,0,0,0,40,8,1864,0,2736,15332
0.279,17,4,368,2,32,52,32,120,2,96,16,96,248
0.004,17,2,178,1,35,0,35,63,1,87,0,87,115
136.737,6,23,6550,8,133,19533,267,856,15,565,9764,1400,5694
56.353,6,4,3445,1,0,0,0,40,3,1095,25986,1095,3405
1787.647,6,103,8336,68,65,26681,65,4930,35,59,52574,59,3406
1680.52,1,15,840,15,28,120037,28,840,0,0,0,0,0
1720.614,17,13,534,11,14,172043,14,462,2,8,1720434,8,72
0.115,17,2,389,1,34,0,34,62,1,299,0,299,327
0.264,17,2,586,1,46,0,46,74,1,484,0,484,512
6.771,6,627,595662,429,1326,15,1368,580702,198,931,33,2736,14960
1794.267,17,464,50112,209,140,8614,1350,35149,255,30,7064,60,14963
3.889,17,3,222,3,46,1944,46,222,0,0,0,0,0
1784.684,6,110,8616,68,65,26637,65,4930,42,59,43526,59,3686
0.957,6,27,8223,14,270,61,561,1945,13,957,64,1631,6278
4.382,17,8,616,4,33,1333,33,244,4,65,0,65,372
35.474,17,40,5880,20,48,1866,48,1520,20,190,1866,308,4360
0.335,17,2,178,1,29,0,29,57,1,93,0,93,121
0.45,6,13,1693,6,288,86,288,548,7,426,41,434,1145
1.258,6,25,8056,12,164,97,267,1288,13,869,89,1408,6768
578.98,6,99,13667,46,89,12866,267,3916,53,162,11130,1452,9751
29.647,6,26,7137,12,155,2695,267,1266,14,530,2279,2006,5871
240.358,6,43,9063,21,523,12017,1418,5812,22,233,11445,618,3251
318.458,17,18,3708,9,48,39805,48,684,9,308,39805,308,3024
334.618,17,738,442691,410,855,818,1350,362232,328,217,1023,1350,80459
1740.44,17,30,31680,30,1028,60015,1028,31680,0,0,0,0,0
256.047,17,16,1256,11,48,25604,48,836,5,56,38252,56,420
1786.581,6,106,8524,68,66,26665,66,4964,38,60,48283,60,3560
1.35,6,38,9848,20,502,71,1460,4352,18,433,67,1460,5496
1792.394,6,361,22858,210,69,8575,69,12678,151,69,11948,69,10180
0.021,17,2,368,1,32,0,32,60,1,280,0,280,308
55.678,17,6,1271,3,38,27701,39,198,3,329,27832,381,1073
1770.466,6,106,9946,68,66,26424,66,5846,38,60,47847,60,4100
1777.333,1,94,9964,94,78,19111,78,9964,0,0,0,0,0
0.014,17,2,152,1,48,0,48,76,1,48,0,48,76
1781.022,6,346,28217,200,75,8949,267,13064,146,132,12282,1452,15153
1772.134,6,180,15480,120,69,14891,69,8940,60,69,30035,69,6540
0.196,6,3,144,2,0,196,0,92,1,0,0,0,52
1790.262,6,4121,3949514,1414,127,1266,348,80258,2707,1417,661,2836,3869256
0.013,6,2,149,1,69,0,69,109,1,0,0,0,40
1.499,6,26,8521,15,175,107,362,1666,11,896,111,1408,6855
1692.617,6,27,4426,18,260,99565,413,3061,9,111,211554,269,1365
2.347,6,65,38511,38,711,63,1408,6371,27,1707,89,3642,32140
0.016,17,2,308,1,34,0,34,62,1,218,0,218,246
92.051,6,26,6797,12,181,8368,267,1212,14,627,7077,1400,5585
1682.231,17,14,1036,7,30,280369,30,406,7,62,280369,62,630
1795.986,17,447,39864,402,35,4478,288,25644,45,288,40018,288,14220
64.642,6,48,27090,25,661,57,1360,4374,23,1210,2929,1731,22716
1795.367,17,448,39896,403,35,4466,288,25676,45,288,40019,288,14220
98.4,6,28,13367,15,488,353,1360,3075,13,1394,8186,2875,10292
233.944,1,16,1696,16,78,15596,78,1696,0,0,0,0,0
147.569,6,14,2351,4,188,293,245,540,10,1407,16369,1407,1811
112.883,6,29,7392,13,158,9406,267,1317,16,603,7522,2036,6075
13.753,17,4,824,2,48,13736,48,152,2,308,13731,308,672
344.057,17,3,126,3,14,172028,14,126,0,0,0,0,0
280.714,6,30,7432,13,158,23392,267,1317,17,603,17537,2076,6115
1755.815,6,4151,4390610,1439,150,1221,931,88743,2712,1575,647,7010,4301867
0.005,17,3,370,2,34,1,34,124,1,218,0,218,246
240.228,6,53,17534,28,784,8896,1418,14797,25,178,10008,580,2737
1230.443,1,31,2604,31,56,41014,56,2604,0,0,0,0,0
0.049,17,4,420,2,33,44,33,122,2,121,6,145,298
1763.109,17,295,51352,295,146,5996,385,51352,0,0,0,0,0
0.127,1,2,112,2,28,127,28,112,0,0,0,0,0
0.041,17,2,120,1,32,0,32,60,1,32,0,32,60
1782.74,17,138,11040,69,48,26216,48,5244,69,56,26216,56,5796
374.678,6,15,1098,10,180,41630,180,720,5,110,15290,110,378
0.539,17,2,384,1,39,0,39,67,1,289,0,289,317
0.574,17,15,5697,8,282,77,1350,2480,7,431,89,1350,3217
0.098,6,2,92,1,0,0,0,52,1,0,0,0,40
133.751,6,28,10431,13,543,64,1323,2195,15,762,9544,2720,8236
0.073,6,10,766,5,185,17,185,453,5,45,17,45,313
14.777,6,18,2477,11,211,1475,211,1018,7,545,1685,904,1459
302.326,6,70,41472,37,602,8397,1306,4946,33,1288,3139,7010,36526
1740.503,17,29,30566,29,1026,62160,1026,30566,0,0,0,0,0
0.055,17,4,344,2,47,2,47,150,2,69,0,75,194
62.241,6,73,50136,45,1208,1414,1448,41039,28,763,2297,1448,9097
1786.879,6,364,25392,212,100,8468,469,14896,152,69,11832,69,10496
0.516,17,3,451,2,39,277,39,134,1,289,0,289,317
1789.764,1,274,29044,274,78,6555,78,29044,0,0,0,0,0
46.686,6,6,316,4,0,15562,0,204,2,0,45136,0,112
1.15,17,3,220,2,34,999,34,124,1,68,0,68,96
280.354,6,28,7352,13,158,23362,267,1317,15,603,20023,2036,6035
9.806,6,61,22803,34,741,297,1440,11117,27,813,372,1440,11686
20.41,6,20,3130,12,183,1855,517,1561,8,381,2914,499,1569
316.922,6,98,35666,52,613,6214,1360,24797,46,310,7039,2720,10869
215.797,17,6,528,3,60,107897,60,264,3,60,107898,60,264
1.249,17,3,1164,3,360,624,360,1164,0,0,0,0,0
0.032,17,2,140,1,34,0,34,62,1,50,0,50,78
0.549,6,6,240,3,0,71,0,120,3,0,274,0,120
63.135,6,40,6580,17,251,3945,585,3405,23,195,2852,580,3175
1783.798,6,368,23276,211,69,8494,69,12787,157,69,11434,69,10489
4.999,17,4,288,2,36,4999,36,128,2,52,4998,52,160
0.07,17,2,2384,2,1164,70,1164,2384,0,0,0,0,0
1787.892,1,62,3472,62,28,29309,28,3472,0,0,0,0,0
0.321,17,8,2750,8,315,45,354,2750,0,0,0,0,0
0.203,17,5,1762,5,324,50,355,1762,0,0,0,0,0
1.808,6,9,527,5,43,452,43,311,4,0,600,0,216
280.191,6,29,7392,13,158,23349,267,1317,16,603,18676,2800,6075
0.605,17,8,2750,8,315,86,354,2750,0,0,0,0,0
139.593,6,59,8897,19,150,2673,722,2350,40,139,3574,1408,6547
1796.927,17,140,11200,70,48,26042,48,5320,70,56,26042,56,5880
31.668,6,8,348,2,0,69,0,84,6,0,6320,0,264
0.446,6,20,7151,12,318,40,600,1906,8,964,60,1471,5245
1.184,6,25,8080,12,164,91,267,1312,13,869,83,1408,6768
1798.681,17,194,19180,194,70,9319,346,19180,0,0,0,0,0
3.33,17,5,295,5,31,832,31,295,0,0,0,0,0
3.608,17,4,352,2,48,3600,48,152,2,72,3599,72,200
670.802,17,34,11424,34,308,20327,308,11424,0,0,0,0,0
3.645,17,5,295,5,31,911,31,295,0,0,0,0,0
17.878,6,2830,2659435,1831,1374,9,1408,2602823,999,931,17,2801,56612
1791.549,17,180,14040,180,50,10008,50,14040,0,0,0,0,0
4.47,6,38,7229,19,218,248,314,3383,19,513,234,1179,3846
0.137,6,14,6093,7,128,22,128,500,7,1305,22,1448,5593
127.213,6,18,6384,9,275,15901,275,639,9,768,15734,2840,5745
1756.253,1,56,4704,56,56,31931,56,4704,0,0,0,0,0
281.91,6,27,7312,12,158,25628,267,1277,15,678,20119,2045,6035
1798.146,6,365,23294,209,69,8644,69,12638,156,69,11600,69,10656
1747.638,1,56,4704,56,56,31775,56,4704,0,0,0,0,0
0.437,6,7,466,5,43,70,43,354,2,0,435,0,112
16.094,6,2067,2300194,696,647,23,652,39451,1371,1599,11,8688,2260743
425.524,6,10,1446,5,327,106381,413,854,5,130,106296,269,592
1787.428,17,87,3648,86,14,21028,14,3612,1,8,0,8,36
226.401,17,4,352,2,60,226400,60,176,2,60,226399,60,176
1789.433,6,370,23494,212,69,8480,69,12965,158,69,11397,69,10529
51.331,6,9,529,5,45,12832,45,313,4,0,17107,0,216
1741.044,6,87,6322,58,31,30544,31,3915,29,31,62179,31,2407
1.028,2,2,64,2,8,1028,8,64,0,0,0,0,0
1788.413,17,83,3480,82,14,22079,14,3444,1,8,0,8,36
119.107,6,21,2493,6,242,19,517,1059,15,323,8507,499,1434
35.583,6,32,5145,16,154,2372,722,1910,16,342,2340,1448,3235
95.846,17,4,352,2,60,95845,60,176,2,60,95845,60,176
0.007,17,2,182,1,39,0,39,67,1,87,0,87,115
1776.191,17,73,3060,72,14,25016,14,3024,1,8,0,8,36
1712.96,1,134,14204,134,78,12879,78,14204,0,0,0,0,0
11.241,6,27,11355,13,275,936,275,1078,14,1078,828,1414,10277
8.173,6,65,20086,33,540,255,1152,15379,32,489,253,1179,4707
1787.783,6,357,22629,208,69,8636,69,12460,149,69,12076,69,10169
1750.464,1,7,392,7,28,291744,28,392,0,0,0,0,0
0.008,6,3,226,2,106,0,106,186,1,0,0,0,40
1784.045,6,104,8376,68,65,26627,65,4930,36,59,50970,59,3446
4.009,17,4,268,4,39,1336,39,268,0,0,0,0,0
1.443,6,53,19510,29,893,51,1360,13729,24,400,54,1360,5781
1.497,6,19,3781,10,234,166,564,1452,9,463,163,1343,2329
3.964,6,2,88,2,0,0,0,88,0,0,0,0,0
0.034,17,2,384,1,32,0,32,60,1,296,0,296,324
292.848,17,4,352,2,60,292846,60,176,2,60,292847,60,176
1786.216,6,150,19350,90,302,20069,302,13740,60,83,30274,83,5610
35.702,1,41,4264,0,0,0,0,0,41,76,892,76,4264
1.27,17,21,7393,9,400,158,1350,3855,12,266,93,1350,3538
1740.445,17,28,6580,28,207,64460,207,6580,0,0,0,0,0
0.048,17,2,280,1,48,0,48,76,1,176,0,176,204
93.568,6,43,10113,15,290,2224,1189,2644,28,288,3465,1420,7469
74.784,6,18,740,8,0,5883,0,324,10,0,8308,0,416
1.097,6,23,7952,12,164,85,267,1288,11,1216,93,3819,6664
1787.982,6,100,6484,64,47,28380,208,4114,36,31,51071,31,2370
271.739,1,6,336,6,28,54347,28,336,0,0,0,0,0
0.016,17,2,157,1,31,0,31,59,1,70,0,70,98
0.047,17,2,475,1,40,0,40,68,1,379,0,379,407
1796.916,1,59,4956,59,56,30981,56,4956,0,0,0,0,0
1750.988,1,96,5376,96,28,18431,28,5376,0,0,0,0,0
1770.586,6,99,9240,66,65,27239,65,5577,33,59,55327,59,3663
1791.567,17,179,13962,179,50,10064,50,13962,0,0,0,0,0
300.662,6,37,8526,19,315,16703,882,2053,18,441,497,1460,6473
39.873,17,22,1672,22,48,1898,48,1672,0,0,0,0,0
392.326,17,16,5446,16,312,26155,548,5446,0,0,0,0,0
132.906,6,35,9454,13,131,5569,267,1450,22,444,6327,3377,8004
273.909,6,63,7990,29,314,9782,1077,3524,34,203,8300,580,4466
1790.886,1,222,12432,222,28,8103,28,12432,0,0,0,0,0
303.079,6,263,212857,171,1293,1782,1360,203459,92,300,119,2720,9398
240.234,6,60,24218,33,839,7507,1402,17675,27,570,9239,2426,6543
1750.978,6,95,7203,63,38,28241,205,4476,32,33,56475,98,2727
11.013,6,20,4442,11,275,1101,275,998,9,768,784,1440,3444
14.463,6,2017,1935580,1288,1425,10,1448,1892732,729,776,19,1448,42848
0.066,6,11,911,6,181,13,181,489,5,77,6,133,422
1755.687,1,76,6384,76,56,23409,56,6384,0,0,0,0,0
15.706,6,15,2294,9,210,1958,210,896,6,545,3138,904,1398
395.001,6,25,1639,16,177,26333,177,1053,9,110,8999,110,586
35.921,6,9,540,0,0,0,0,0,9,0,0,0,540
1785.396,6,361,23410,202,69,8882,69,12427,159,69,11299,69,10983
39.708,17,40,10360,40,231,1018,388,10360,0,0,0,0,0
0.141,17,2,1920,2,932,141,932,1920,0,0,0,0,0
0.032,6,10,1794,6,613,5,1070,1471,4,159,10,159,323
32.861,17,20,1760,10,48,3648,48,760,10,72,3643,72,1000
0.559,6,52,22108,28,1049,20,1380,16894,24,421,23,1923,5214
185.105,6,25,6239,10,267,127,501,1205,15,369,13216,1420,5034
0.13,6,10,1495,5,507,32,507,727,5,556,32,556,768
41.364,17,15,1140,15,48,2954,48,1140,0,0,0,0,0
33.784,17,10,2250,10,197,3753,206,2250,0,0,0,0,0
198.886,17,3,181,3,32,99443,33,181,0,0,0,0,0
0.405,6,27,9042,13,247,33,624,1672,14,947,29,1408,7370
280.562,6,30,7432,13,158,23380,267,1317,17,543,17525,1400,6115
1.549,6,49,19418,29,896,55,1360,13797,20,437,70,2715,5621
264.851,17,16,2679,8,40,37834,40,544,8,238,37833,249,2135
1789.953,6,360,24156,210,88,8564,469,13878,150,69,12013,69,10278
83.037,6,30,7642,11,155,32,267,1226,19,403,4612,3426,6416
240.376,6,43,8973,21,517,12018,1418,5759,22,229,11445,638,3214
1087.232,6,67,5291,38,66,26306,66,2774,29,52,38826,60,2517
18.542,6,1166,1019864,743,1298,24,1368,993204,423,776,43,1473,26660
5.948,6,1663,1538689,1048,1390,5,1408,1502045,615,931,9,2816,36644
0.068,17,4,284,2,32,31,32,120,2,54,38,60,164
143.182,6,25,10113,12,531,73,1360,2661,13,988,11920,1360,7452
69.083,6,27,7177,13,155,5756,267,1306,14,530,5313,3417,5871
378.092,2,4,128,4,8,126030,8,128,0,0,0,0,0
0.039,17,2,467,1,33,0,33,61,1,378,0,378,406
0.096,17,4,1116,2,32,91,32,120,2,470,12,470,996
0.481,6,12,1653,6,288,92,288,548,6,426,58,434,1105
1.661,6,59,41512,36,1251,47,1448,34411,23,842,66,1448,7101
1796.311,17,449,39928,404,35,4457,288,25708,45,288,40020,288,14220
1790.713,6,366,26251,213,97,8446,981,14542,153,85,11780,453,11709
61.719,6,73,49035,44,1194,1435,1408,39385,29,1016,2196,2816,9650
97.731,6,40,8793,19,412,648,889,2076,21,391,4878,3488,6717
384.936,6,21,1422,15,180,27495,180,992,6,110,12264,110,430
109.158,17,4,240,2,32,109157,32,120,2,32,109157,32,120
37.149,17,3,2954,3,956,18574,1442,2954,0,0,0,0,0
4.907,6,38,7229,19,218,272,314,3383,19,513,258,1179,3846
1783.643,6,106,8584,69,66,26230,66,5004,37,60,49542,60,3580
5.126,6,39,7285,20,218,269,314,3423,19,516,270,1179,3862
1684.478,2,28,896,28,8,62388,8,896,0,0,0,0,0
1788.704,17,87,3648,86,14,21043,14,3612,1,8,0,8,36
1790.531,17,323,83038,323,229,5560,422,83038,0,0,0,0,0
131.585,6,31,7733,14,175,10121,267,1618,17,543,8223,1400,6115
1682.85,17,14,1036,7,30,280464,30,406,7,62,280468,62,630
1771.166,6,101,9410,66,66,27248,66,5610,35,60,52090,60,3800
1782.059,17,86,3606,85,14,21214,14,3570,1,8,0,8,36
19.37,17,24,13495,14,771,1487,1350,11199,10,201,2148,1350,2296
3.745,6,2,88,2,0,0,0,88,0,0,0,0,0
1.273,6,39,11893,22,613,60,1360,6437,17,476,69,2715,5456
0.017,17,4,420,2,33,10,33,122,2,121,10,145,298
1773.3,6,180,15480,120,69,14901,69,8940,60,69,30050,69,6540
0.893,6,10,1687,7,100,148,100,384,3,1179,326,1179,1303
0.262,17,12,4401,12,338,23,361,4401,0,0,0,0,0
1.663,6,25,8709,15,276,118,560,1432,10,981,165,1420,7277
1777.203,1,78,8268,78,78,23080,78,8268,0,0,0,0,0
1.319,6,50,19057,27,874,50,1360,13361,23,433,51,1360,5696
280.271,6,28,7352,13,158,23355,267,1317,15,603,20017,2036,6035
1797.658,6,1611,2205631,683,147,2635,862,46601,928,2471,1939,11216,2159030
1769.279,6,99,9306,66,66,27219,66,5610,33,60,55285,60,3696
0.392,6,14,1733,7,288,62,288,588,7,284,36,434,1145
1762.806,6,99,7814,65,45,27543,205,4850,34,35,53408,98,2964
1787.143,17,142,11360,71,48,25530,48,5396,71,56,25529,56,5964
1.16,17,15,7377,7,666,183,1350,4860,8,286,159,1350,2517
4.334,17,34,10116,17,232,268,1350,4433,17,306,268,1350,5683
605.278,1,9,504,9,28,75659,28,504,0,0,0,0,0
1744.905,6,94,7151,62,38,28605,205,4424,32,33,56274,98,2727
2.931,17,4,624,4,128,977,128,624,0,0,0,0,0
618.082,6,108,19905,48,229,13150,1460,8407,60,201,10473,1638,11498
0.016,17,2,200,1,40,0,40,68,1,104,0,104,132
111.056,17,4,352,2,60,111055,60,176,2,60,111055,60,176
1775.822,1,234,13104,234,28,7621,28,13104,0,0,0,0,0
2.253,6,28,6080,15,150,160,267,1655,13,650,181,1420,4425
100.038,6,24,11318,12,433,97,990,1823,12,1125,9079,2720,9495
16.46,6,2904,2777130,1919,1371,8,1408,2721246,985,931,16,2801,55884
11.013,6,18,5610,10,275,1223,275,958,8,1440,840,1440,4652
1.471,6,24,8004,12,164,112,267,1288,12,1014,113,2331,6716
1782.296,6,233,20511,88,83,20484,375,9370,145,71,12376,1062,11141
540.135,17,19,6384,19,308,30007,308,6384,0,0,0,0,0
0.069,17,4,284,2,32,58,32,120,2,54,19,60,164
1795.216,17,80,3354,79,14,23015,14,3318,1,8,0,8,36
3.198,17,5,311,4,31,1065,31,236,1,47,0,47,75
1798.607,17,449,39928,404,35,4463,288,25708,45,288,40007,288,14220
1795.862,17,448,39896,403,35,4467,288,25676,45,288,40019,288,14220
193.111,17,12,1056,6,48,38620,48,456,6,72,38620,72,600
1740.565,17,19,20026,19,1026,96698,1026,20026,0,0,0,0,0
13.033,17,4,1344,4,308,4344,308,1344,0,0,0,0,0
1788.887,17,87,3648,86,14,21045,14,3612,1,8,0,8,36
1796.987,17,765,46162,765,32,2352,37,46162,0,0,0,0,0
24.801,6,17,6739,8,275,3543,275,603,9,1440,3067,1440,6136
0.035,6,12,3462,6,75,7,75,395,6,1373,7,1448,3067
0.186,6,21,5824,12,164,16,453,1442,9,781,22,2224,4382
0.029,17,2,411,1,33,0,33,61,1,322,0,322,350
2.407,17,2,204,1,34,0,34,62,1,114,0,114,142
0.022,17,2,214,1,39,0,39,67,1,119,0,119,147
1651.498,1,7,392,7,28,275249,28,392,0,0,0,0,0
300.252,6,31,11799,17,588,18765,1438,4425,14,948,18477,1488,7374
49.989,17,4,352,2,60,49988,60,176,2,60,49987,60,176
1768.228,1,104,5824,104,28,17167,28,5824,0,0,0,0,0
1772.036,6,180,15480,120,69,14891,69,8940,60,69,30031,69,6540
300.763,6,28,7975,16,204,20050,467,1692,12,807,6144,2694,6283
0.197,17,2,212,1,46,0,46,74,1,110,0,110,138
0.072,17,2,154,1,33,0,33,61,1,65,0,65,93
0.061,17,5,399,3,39,0,39,201,2,71,0,71,198
1753.443,1,28,3185,28,85,64942,173,3185,0,0,0,0,0
0.409,6,13,1693,7,288,68,288,588,6,426,45,434,1105
1156.488,17,201,15276,201,48,5782,48,15276,0,0,0,0,0
1758.477,17,36,14004,36,361,50242,361,14004,0,0,0,0,0
0.572,6,6,324,4,0,190,0,216,2,0,375,0,108
504.427,2,3,96,3,8,252213,8,96,0,0,0,0,0
1.166,6,47,14750,24,502,50,1368,7280,23,569,51,2459,7470
246.173,1,2,112,2,28,246173,28,112,0,0,0,0,0
143.895,6,20,6715,5,186,9003,267,581,15,502,10277,1420,6134
0.46,6,20,7165,12,318,41,599,1905,8,1209,64,1906,5260
300.257,6,37,15324,21,890,15012,1408,8281,16,689,2112,1408,7043
325.994,1,3,348,3,88,162997,88,348,0,0,0,0,0
5.593,6,40,7309,19,218,310,314,3383,21,440,266,1152,3926
4.23,6,38,7229,19,218,235,314,3383,19,513,220,1179,3846
0.172,17,2,198,1,39,0,39,67,1,103,0,103,131
1772.386,6,180,15480,120,69,14894,69,8940,60,69,30036,69,6540
0.038,17,4,352,2,37,0,37,130,2,83,1,89,222
3.322,6,10,923,6,304,664,304,624,4,83,1093,83,299
6.941,6,18,6233,5,186,1732,267,581,13,639,577,1452,5652
1778.789,17,443,78041,443,148,4024,378,78041,0,0,0,0,0
21.744,6,3031,2821991,1954,1366,11,1408,2761323,1077,931,20,2816,60668
3.004,17,4,340,2,37,2998,37,130,2,77,2998,77,210
3.249,6,407,318891,226,1396,14,1432,306423,181,389,17,1432,12468
1682.891,1,15,840,15,28,120206,28,840,0,0,0,0,0
53.568,6,13,1079,12,43,4869,43,1019,1,0,0,0,60
1790.39,6,333,21462,191,69,9423,69,11642,142,69,12696,69,9820
1741.131,6,87,6322,58,31,30546,31,3915,29,31,62181,31,2407
1797.642,1,166,17596,166,78,10894,78,17596,0,0,0,0,0
3.553,6,6,344,2,0,3368,0,112,4,0,1122,0,232
116.631,17,7,532,7,48,19438,48,532,0,0,0,0,0
250.129,6,107,33431,42,181,6100,267,4592,65,582,3908,3436,28839
369.566,6,18,1242,14,180,28428,180,916,4,110,20071,110,326
0.926,17,4,788,2,36,921,36,128,2,302,921,302,660
1779.978,6,349,22309,204,69,8768,69,12369,145,69,12360,69,9940
30.56,17,6,456,6,48,6112,48,456,0,0,0,0,0
280.032,6,28,7352,14,158,21540,267,1357,14,775,21538,4836,5995
0.157,6,28,7336,14,155,12,267,1341,14,603,11,2800,5995
1799.923,17,3939,189072,1970,20,914,20,94560,1969,20,914,20,94512
374.79,6,18,1242,14,180,28830,180,916,4,110,20064,110,326
1.29,6,47,18746,27,861,49,1360,13170,20,529,58,4075,5576
33.917,6,35,7517,17,154,2119,722,1999,18,508,1984,2026,5518
300.632,6,38,8617,20,328,15822,933,2144,18,441,499,1460,6473
6.262,6,21,4374,12,213,569,597,1689,9,552,758,1767,2685
374.045,6,25,1651,17,177,23377,177,1117,8,110,9243,110,534
0.043,17,2,464,1,43,0,43,71,1,365,0,365,393
1742.842,1,67,5628,67,56,26406,56,5628,0,0,0,0,0
1.26,6,47,18855,27,869,48,1360,13279,20,433,57,1360,5576
17.361,17,8,704,4,48,5783,48,304,4,72,5782,72,400
299.53,6,6,364,4,31,99843,31,222,2,31,299517,31,142
16.435,17,14,6171,7,534,2732,1350,3935,7,291,2733,1350,2236
180.481,2,3,96,3,8,90240,8,96,0,0,0,0,0
125.661,17,4,240,2,32,125660,32,120,2,32,125660,32,120
284.415,6,197,155849,124,1294,2312,1368,142430,73,565,2035,1368,13419
3.601,6,2,88,2,0,0,0,88,0,0,0,0,0
0.09,6,12,2048,7,329,14,500,1030,5,750,22,750,1018
9.444,6,28,4102,15,152,674,267,1978,13,400,761,1179,2124
235.111,6,48,10719,20,110,12374,267,2138,28,338,8704,1917,8581
0.818,6,10,1687,7,100,136,100,384,3,1179,270,1179,1303
0.18,6,2,104,1,0,0,0,52,1,0,0,0,52
6.442,6,17,2363,10,329,715,595,1183,7,396,668,580,1180
7.229,6,4,619,1,304,0,304,356,3,83,3614,83,263
372.235,6,18,1242,14,180,28633,180,916,4,110,20071,110,326
4.027,6,43,8664,22,279,191,1164,2881,21,409,183,1460,5783
29.558,6,4097,3623415,2370,1435,12,1448,3514863,1727,776,17,1448,108552
756.079,2,6,192,6,8,151215,8,192,0,0,0,0,0
1656.292,17,130,10400,65,48,25879,48,4940,65,56,25879,56,5460
1791.384,6,356,22520,208,69,8654,69,12460,148,69,12186,69,10060
1799.347,6,356,22520,208,69,8692,69,12460,148,69,12240,69,10060
5.059,17,3,208,2,36,4998,36,128,1,52,0,52,80
37.79,17,22,1936,11,48,3777,48,836,11,72,3777,72,1100
0.546,6,58,25440,32,961,17,1380,16804,26,582,20,3303,8636
1774.167,6,181,15589,120,69,14908,69,8940,61,69,29562,69,6649
0.638,6,8,440,5,0,159,0,268,3,0,314,0,172
1.451,6,59,18058,29,706,51,1360,8949,30,438,49,1360,9109
0.336,6,26,9038,13,262,28,690,1735,13,945,27,1408,7303
382.368,6,12,830,8,106,54622,106,646,4,0,127453,0,184
3.508,17,5,290,5,30,877,30,290,0,0,0,0,0
1778.978,17,86,3606,85,14,21178,14,3570,1,8,0,8,36
16.76,17,18,7981,8,485,2389,1350,4111,10,359,1858,1350,3870
5.025,17,4,288,2,36,4985,36,128,2,52,4992,52,160
0.969,17,4,314,2,31,584,31,118,2,70,0,70,196
108.685,17,3,531,3,149,54342,355,531,0,0,0,0,0
1284.128,6,253,15985,146,69,8854,69,8807,107,69,12114,69,7178
1786.174,6,102,8296,68,65,26659,65,4930,34,59,54123,59,3366
860.85,6,56,4318,30,64,25834,64,2160,26,48,34430,58,2158
1800.0,6,216,17068,79,73,22692,337,8165,137,49,13235,143,8903
280.47,6,27,7312,12,158,25497,267,1277,15,775,20030,3465,6035
1.747,6,37,13712,17,199,109,585,2138,20,953,89,1438,11574
300.547,6,18,1227,5,177,75092,177,445,13,110,25031,110,782
1.914,6,51,20582,29,847,68,1360,14771,22,409,81,1360,5811
22.688,6,29,16376,17,663,1418,1360,4039,12,1692,2050,3943,12337
300.592,6,11,912,6,226,60083,226,546,5,110,75104,110,366
1.929,6,35,12325,15,210,137,646,2086,20,832,85,1438,10239
81.238,6,34,3618,15,304,5802,304,1752,19,83,4440,83,1866
0.307,6,21,7290,12,335,27,668,1974,9,968,37,1475,5316
1789.173,17,142,11360,71,48,25559,48,5396,71,56,25559,56,5964
61.704,17,6,528,3,48,30845,48,228,3,72,30845,72,300
0.052,17,4,336,2,34,0,34,124,2,78,0,84,212
212.142,6,145,56421,69,736,3119,1152,46203,76,398,2825,1179,10218
1795.415,1,170,18020,170,78,10623,78,18020,0,0,0,0,0
253.586,6,25,6318,9,272,109,516,1180,16,345,16900,1452,5138
899.474,6,212,20879,112,112,8103,1189,8663,100,167,9085,1460,12216
1.343,6,49,19279,27,893,51,1440,13623,22,433,55,1440,5656
69.99,6,30,7366,13,155,5832,267,1306,17,413,4362,1460,6060
1610.845,1,56,3136,56,28,29288,28,3136,0,0,0,0,0
1443.898,2,19,608,19,8,80216,8,608,0,0,0,0,0
225.146,17,9,3038,9,309,28143,322,3038,0,0,0,0,0
1744.618,2,24,768,24,8,75852,8,768,0,0,0,0,0
0.95,6,11,1727,7,100,158,100,384,4,589,229,1152,1343
45.235,17,98,7588,15,47,3231,288,1132,83,49,530,288,6456
0.15,6,44,21322,26,1094,6,1420,16381,18,467,8,1883,4941
1772.321,6,180,15480,120,69,14893,69,8940,60,69,30031,69,6540
0.102,17,2,672,2,308,102,308,672,0,0,0,0,0
1.52,6,38,8252,19,320,84,1162,2716,19,433,75,1360,5536
1773.436,17,140,11200,70,48,25701,48,5320,70,56,25701,56,5880
541.479,2,4,128,4,8,180493,8,128,0,0,0,0,0
1790.057,6,419,25088,210,69,8564,69,12540,209,34,8605,48,12548
74.254,6,17,7814,5,407,4109,722,1082,12,1220,6729,1448,6732
3.248,17,2,668,2,306,3248,306,668,0,0,0,0,0
0.009,6,2,93,1,0,0,0,40,1,1,0,1,53
0.291,6,21,7281,13,334,23,663,2021,8,1209,40,1906,5260
1788.398,6,4046,4521982,1303,126,1373,353,76326,2743,1614,652,5608,4445656
0.655,6,15,1785,8,288,69,288,640,7,426,78,434,1145
1799.746,1,238,25228,238,78,7593,78,25228,0,0,0,0,0
0.396,6,26,9017,13,261,33,683,1728,13,943,31,1448,7289
61.862,6,70,45347,42,1165,1508,1448,37160,28,747,2282,1448,8187
45.702,6,5729,5346902,3594,1405,12,1448,5227446,2135,776,21,1448,119456
0.026,17,2,118,1,31,0,31,59,1,31,0,31,59
1773.41,6,180,15480,120,69,14902,69,8940,60,69,30049,69,6540
366.221,6,23,1535,16,177,24414,177,1053,7,110,10362,110,482
1772.242,6,180,15480,120,69,14892,69,8940,60,69,30031,69,6540
1797.954,6,356,22520,208,69,8685,69,12460,148,69,12230,69,10060
1779.487,1,56,4704,0,0,0,0,0,56,56,32354,56,4704
44.458,6,31,8912,15,158,3175,267,1397,16,858,2960,3456,7515
1799.153,17,756,45612,756,32,2382,37,45612,0,0,0,0,0
0.13,17,2,308,1,34,0,34,62,1,218,0,218,246
0.994,6,12,1653,6,288,195,288,548,6,426,105,434,1105
1796.489,6,378,24066,206,69,8763,69,12518,172,57,10505,69,11548
0.244,17,2,218,1,65,0,65,93,1,97,0,97,125
1799.991,6,238,26732,92,174,19467,1360,17354,146,49,12412,142,9378
1786.252,6,102,8228,68,64,26660,64,4896,34,58,54126,58,3332
0.427,6,10,968,5,256,103,256,460,5,304,103,304,508
367.166,6,18,1239,14,177,28243,177,913,4,110,20055,110,326
0.079,17,2,672,2,308,79,308,672,0,0,0,0,0
1.702,17,2,327,1,35,0,35,63,1,236,0,236,264
0.548,17,3,451,2,39,91,39,134,1,289,0,289,317
115.075,6,34,5499,17,152,7192,722,2101,17,358,7172,1408,3398
1.941,17,2,148,2,46,1941,46,148,0,0,0,0,0
4.479,6,37,7189,19,218,248,314,3383,18,513,247,1179,3806
1791.401,17,144,11520,72,48,25230,48,5472,72,56,25230,56,6048
1770.465,6,99,9240,66,65,27237,65,5577,33,59,55313,59,3663
1779.726,17,140,11200,70,48,25793,48,5320,70,56,25793,56,5880
1763.387,2,12,384,12,8,160307,8,384,0,0,0,0,0
0.313,6,26,8990,13,247,26,624,1672,13,947,25,1448,7318
0.527,6,28,9087,13,248,43,633,1678,15,827,35,1368,7409
56.751,6,30,7432,13,158,4729,267,1317,17,543,3544,1400,6115
1770.46,6,99,9306,66,66,27237,66,5610,33,60,55323,60,3696
15.575,17,16,5367,8,373,2220,1350,3214,8,241,2220,1350,2153
0.798,17,2,720,2,332,798,332,720,0,0,0,0,0
0.023,17,2,176,1,48,0,48,76,1,72,0,72,100
316.909,6,104,34403,56,518,5761,1360,23592,48,355,6740,4080,10811
1740.466,17,30,31680,30,1028,60016,1028,31680,0,0,0,0,0
504.144,2,4,128,4,8,168048,8,128,0,0,0,0,0
1780.236,1,58,4872,58,56,31232,56,4872,0,0,0,0,0
0.526,17,2,476,1,39,0,39,67,1,381,0,381,409
4.852,17,6,1356,6,198,970,207,1356,0,0,0,0,0
1791.193,6,356,22520,208,69,8653,69,12460,148,69,12184,69,10060
13.593,6,23,2784,12,304,1235,304,1844,11,83,1058,83,940
16.042,17,17,6404,8,484,2281,1350,4098,9,228,1994,1350,2306
1260.04,2,9,288,9,8,157505,8,288,0,0,0,0,0
1783.484,17,73,3060,72,14,25119,14,3024,1,8,0,8,36
0.958,6,29,13181,16,529,63,1360,3330,13,1164,65,3921,9851
60.555,6,12,4690,5,407,15138,722,1070,7,1084,10062,1408,3620
12.69,6,1996,1742669,1229,1363,10,1380,1707735,767,383,16,1380,34934
5.553,6,41,7349,21,218,277,314,3463,20,440,279,1152,3886
64.586,6,17,1761,8,177,140,177,955,9,110,8052,110,806
280.248,6,28,7352,12,158,25477,267,1277,16,603,18678,1400,6075
1.424,17,4,808,3,64,698,64,276,1,504,0,504,532
33.805,6,32,5146,15,154,2414,722,1858,17,300,2098,1408,3288
1790.448,6,356,22520,208,69,8649,69,12460,148,69,12179,69,10060
1744.715,2,15,480,15,8,124622,8,480,0,0,0,0,0
185.593,17,3,984,3,300,92796,300,984,0,0,0,0,0
1.942,17,3,1008,3,308,971,308,1008,0,0,0,0,0
11.924,6,1901,1647694,1145,1384,10,1420,1613233,756,467,15,1883,34461
7.28,6,6,280,2,0,7280,0,88,4,0,2375,0,192
127.182,6,68,48442,45,1192,2890,1408,40512,23,960,2799,3847,7930
0.011,17,2,328,1,32,0,32,60,1,240,0,240,268
240.62,2,3,96,3,8,120310,8,96,0,0,0,0,0
1788.324,6,123,14594,80,84,22637,502,6429,43,161,42576,1452,8165
0.01,17,2,421,1,32,0,32,60,1,333,0,333,361
1571.39,6,198,16407,121,70,13094,138,9325,77,69,20586,69,7082
26.912,6,197,75901,100,730,271,1152,66857,97,430,277,1179,9044
1781.83,6,356,22589,207,69,8649,69,12420,149,69,12038,69,10169
0.902,6,10,1687,7,100,150,100,384,3,1179,327,1179,1303
0.149,6,22,10013,11,136,14,136,716,11,1089,14,1448,9297
19.867,6,25,6757,12,181,1806,267,1212,13,717,1654,2036,5545
81.045,6,20,8672,11,314,76,634,1415,9,1377,10112,3928,7257
1149.983,17,801,56270,721,40,1597,41,49503,80,56,525,57,6767
1.147,17,29,10235,12,363,101,1350,4700,17,297,69,1350,5535
1.374,6,16,5124,8,150,196,174,624,8,835,165,1452,4500
11.586,6,104,35290,54,619,218,1152,28808,50,447,231,1179,6482
0.121,17,2,323,1,33,0,33,61,1,234,0,234,262
280.867,6,30,7432,14,158,21605,267,1357,16,678,18721,3456,6075
1754.266,6,184,11305,92,47,19277,208,6695,92,31,19274,31,4610
63.299,17,4,240,2,32,63298,32,120,2,32,63298,32,120
106.836,6,20,1482,10,39,11870,39,559,10,50,11870,63,923
294.579,17,4,288,2,36,294547,36,128,2,52,294532,52,160
51.576,17,36,15203,17,644,3219,1350,11429,19,170,2862,1350,3774
2.74,6,15,2646,8,188,391,245,700,7,554,414,1152,1946
280.861,6,30,7432,13,158,23405,267,1317,17,603,17549,2760,6115
1739.43,1,15,840,15,28,124245,28,840,0,0,0,0,0
1772.585,6,181,15589,120,69,14895,69,8940,61,69,29536,69,6649
31.71,6,4,184,2,0,31710,0,88,2,0,14006,0,96
1740.47,17,30,31620,30,1026,60016,1026,31620,0,0,0,0,0
0.307,6,26,8946,13,244,25,618,1663,13,1099,25,2816,7283
0.47,6,13,1693,6,288,90,288,548,7,426,43,434,1145
1785.983,6,102,8296,68,65,26656,65,4930,34,59,54117,59,3366
1748.489,1,8,448,8,28,249784,28,448,0,0,0,0,0
0.245,17,2,180,1,30,0,30,58,1,94,0,94,122
0.495,6,22,7354,13,335,41,668,2026,9,1210,55,1946,5328
8.088,6,24,4542,12,213,735,597,1689,12,552,716,1767,2853
5.018,17,4,288,2,36,4970,36,128,2,52,4974,52,160
1720.298,1,8,448,8,28,245756,28,448,0,0,0,0,0
579.448,6,26,3196,16,226,38629,226,2200,10,110,26025,110,996
1744.746,2,15,480,15,8,124624,8,480,0,0,0,0,0
1797.456,17,85,21163,85,220,21398,422,21163,0,0,0,0,0
0.034,17,2,2946,2,1445,34,1445,2946,0,0,0,0,0
1.969,6,13,2311,8,188,281,245,700,5,1407,426,1407,1611
1.058,6,25,6676,14,350,80,1089,2316,11,783,104,1420,4360
7.739,17,6,528,3,48,3863,48,228,3,72,3863,72,300
1.548,6,12,5805,3,186,770,267,501,9,822,192,1420,5304
6.834,6,43,7429,22,201,325,314,3503,21,513,326,1179,3926
0.558,17,19,10410,10,510,62,1350,5389,9,529,64,1350,5021
27.453,6,51,11363,26,847,503,1360,5392,25,309,1137,2667,5971
300.441,6,48,29634,22,190,14306,444,1925,26,1317,9621,2736,27709
358.466,6,77,12962,38,350,9688,1366,6890,39,223,9433,1365,6072
0.532,17,2,776,2,360,532,360,776,0,0,0,0,0
76.485,6,22,9613,12,386,64,844,1672,10,1505,8482,4477,7941
1779.004,17,140,11200,70,48,25782,48,5320,70,56,25782,56,5880
1782.572,17,195,36369,195,158,9188,422,36369,0,0,0,0,0
10.666,6,1900,1750316,1205,1375,8,1408,1709512,695,931,15,2816,40804
0.06,17,4,608,2,60,0,60,176,2,188,0,188,432
0.024,6,2,182,1,102,0,102,142,1,0,0,0,40
911.124,6,95,8147,63,69,14695,69,4659,32,69,29390,69,3488
8.978,6,9,520,4,0,2992,0,220,5,0,1256,0,300
280.685,6,29,7392,13,158,23390,267,1317,16,603,18708,2036,6075
1745.263,6,94,7151,62,38,28610,205,4424,32,33,56292,98,2727
0.014,17,2,253,1,49,0,49,77,1,148,0,148,176
0.008,17,2,466,1,31,0,31,59,1,379,0,379,407
300.794,6,42,10132,23,593,13672,1460,4525,19,371,478,1460,5607
0.032,17,4,284,2,32,19,32,120,2,54,14,60,164
377.655,6,82,54436,52,1198,7405,1448,44679,30,682,4106,2359,9757
0.059,6,9,1340,5,145,14,145,349,4,827,14,827,991
1397.179,6,97,12514,60,93,23681,477,5755,37,160,38807,1408,6759
115.71,17,4,1344,4,308,38570,308,1344,0,0,0,0,0
0.206,17,2,217,1,50,0,50,78,1,111,0,111,139
1681.529,17,14,1036,7,30,280249,30,406,7,62,280248,62,630
1781.195,17,142,11360,71,48,25445,48,5396,71,56,25445,56,5964
64.269,1,3,1007,3,307,32134,311,1007,0,0,0,0,0
421.156,2,4,128,4,8,140385,8,128,0,0,0,0,0
0.009,17,2,376,1,60,0,60,88,1,260,0,260,288
129.111,17,4,352,2,60,129110,60,176,2,60,129110,60,176
0.001,17,2,246,1,67,0,67,95,1,123,0,123,151
0.18,6,2,120,1,0,0,0,60,1,0,0,0,60
6.505,6,1589,1322340,861,1437,7,1448,1272072,728,776,8,1448,50268
1798.782,1,262,14672,262,28,6891,28,14672,0,0,0,0,0
302.997,6,62,33878,36,1010,8657,1408,17078,26,965,1320,2026,16800
0.753,6,26,5649,12,140,68,267,1184,14,650,52,1420,4465
116.695,1,6,336,6,28,23339,28,336,0,0,0,0,0
1.238,6,48,19182,27,889,47,1360,13566,21,476,53,2715,5616
15.761,6,928,798399,558,1351,27,1368,772343,370,776,42,2736,26056
171.435,17,4,352,2,60,171434,60,176,2,60,171434,60,176
0.201,6,40,15670,23,893,9,1420,10769,17,467,11,1883,4901
61.848,6,76,50833,45,1216,1405,1448,42491,31,746,2053,1448,8342
0.442,6,6,324,4,0,147,0,216,2,0,239,0,108
10.433,17,8,1176,4,48,3475,48,304,4,190,3474,308,872
280.475,6,30,7432,13,158,23372,267,1317,17,603,17524,2076,6115
1787.906,6,376,29688,217,115,8277,981,16157,159,101,11315,453,13531
1785.402,6,102,8296,68,65,26647,65,4930,34,59,54099,59,3366
1772.651,6,181,15589,120,69,14896,69,8940,61,69,29543,69,6649
1772.593,6,180,15480,120,69,14895,69,8940,60,69,30035,69,6540
3.652,17,8,2750,8,315,521,354,2750,0,0,0,0,0
1782.073,1,98,5488,98,28,18371,28,5488,0,0,0,0,0
1797.439,17,765,46134,765,32,2352,37,46134,0,0,0,0,0
89.713,17,6,525,3,32,44840,37,181,3,86,44840,136,344
204.202,17,2,2007,2,975,204202,1424,2007,0,0,0,0,0
994.924,17,194,14744,194,48,5155,48,14744,0,0,0,0,0
3.713,17,26,7229,10,230,412,1350,2582,16,262,213,1350,4647
11.898,6,1834,1644652,1162,1361,10,1420,1613373,672,475,17,1883,31279
427.194,6,225,15398,112,31,3848,31,7488,113,31,3814,31,7910
1740.979,6,87,6322,58,31,30543,31,3915,29,31,62176,31,2407
1771.381,6,101,9344,66,65,27252,65,5577,35,59,52096,59,3767
4.01,6,16,3452,8,49,572,92,511,8,420,533,1408,2941
288.344,1,4,224,4,28,96114,28,224,0,0,0,0,0
1790.834,1,226,12656,226,28,7959,28,12656,0,0,0,0,0
8.725,6,25,7920,9,402,1090,722,1570,16,518,526,1380,6350
167.321,6,25,6318,9,272,123,516,1180,16,345,11148,1452,5138
1771.009,6,99,9306,66,66,27246,66,5610,33,60,55341,60,3696
332.66,6,25,1452,14,0,25589,0,824,11,0,33244,0,628
1614.427,1,8,448,8,28,230632,28,448,0,0,0,0,0
134.576,6,46,13398,20,928,1211,1360,7370,26,276,5376,1360,6028
1795.9,6,385,30047,225,131,8017,981,17916,160,78,11294,256,12131
2.501,6,29,6175,15,338,178,1314,2294,14,368,191,1414,3881
35.823,17,20,1520,20,48,1885,48,1520,0,0,0,0,0
37.202,6,31,6937,17,127,2325,159,1799,14,873,2858,1708,5138
128.722,6,38,10265,19,779,500,1360,4691,19,435,7139,2720,5574
1.457,6,48,19386,27,904,56,1360,13770,21,476,63,2715,5616
1.609,6,50,19183,27,883,61,1360,13487,23,433,63,1360,5696
140.61,17,2,642,1,300,0,300,328,1,286,0,286,314
0.996,17,2,176,2,60,996,60,176,0,0,0,0,0
66.583,6,21,9596,11,380,85,832,1613,10,1261,7382,2368,7983
180.497,2,2,64,2,8,180497,8,64,0,0,0,0,0
1622.906,6,123,18119,75,184,21931,1268,9458,48,168,34527,1420,8661
2.916,17,4,304,2,48,2905,48,152,2,48,2904,48,152
95.672,6,21,8030,6,272,546,516,1060,15,489,6827,1452,6970
0.167,17,2,632,1,288,0,288,316,1,288,0,288,316
1699.458,17,12,498,11,14,169945,14,462,1,8,0,8,36
14.99,6,24,6993,13,275,1249,275,1078,11,910,997,1440,5915
0.053,17,2,574,1,32,0,32,60,1,486,0,486,514
380.387,6,17,1332,15,106,27170,106,1244,2,0,380381,0,88
1783.742,6,361,22858,210,69,8534,69,12678,151,69,11889,69,10180
99.35,6,23,9872,13,421,166,675,2237,10,1203,11020,3928,7635
1.301,6,44,10145,23,440,59,1360,4484,21,400,56,1360,5661
70.631,6,33,12811,16,420,4708,619,2162,17,975,4402,2736,10649
1676.677,1,7,392,7,28,279446,28,392,0,0,0,0,0
538.054,17,8,673,4,31,179346,37,239,4,80,179347,136,434
0.637,6,125,82397,68,1282,9,1420,75826,57,427,10,1420,6571
0.672,17,2,154,1,33,0,33,61,1,65,0,65,93
10.798,6,94,27021,47,521,234,1152,20659,47,447,229,1179,6362
0.774,6,30,10101,17,639,48,1460,3919,13,627,49,1460,6182
0.546,6,50,21450,28,947,20,1380,16328,22,421,23,1923,5122
326.371,6,38,8449,21,109,16318,636,2193,17,766,4689,1658,6256
0.317,17,2,180,1,30,0,30,58,1,94,0,94,122
121.082,6,13,1028,5,226,30270,226,494,8,110,17262,110,534
300.661,6,38,8566,20,315,15824,882,2093,18,441,500,1360,6473
0.027,17,2,564,1,64,0,64,92,1,444,0,444,472
372.249,6,18,1242,14,180,28634,180,916,4,110,20061,110,326
292.714,6,45,7818,22,129,13936,517,2061,23,505,13303,1418,5757
1008.317,2,7,224,7,8,168052,8,224,0,0,0,0,0
1778.694,6,106,8446,69,64,26157,64,4936,37,58,49405,58,3510
0.898,6,11,1727,7,100,149,100,384,4,589,214,1152,1343
5.555,6,39,7269,19,218,308,314,3383,20,513,277,1179,3886
77.507,6,21,8194,11,511,89,1194,2005,10,962,8592,1791,6189
13.191,6,92,26925,45,535,299,1152,20563,47,447,280,1179,6362
1796.52,6,418,25144,211,69,8554,69,12580,207,36,8720,69,12564
136.769,17,338,200433,193,822,712,1350,164231,145,221,949,1350,36202
240.279,6,42,8969,20,523,12646,1408,5767,22,205,11441,618,3202
5.69,6,40,7309,20,218,299,314,3423,20,513,284,1179,3886
38.192,17,22,1672,22,48,1818,48,1672,0,0,0,0,0
8.965,6,3,180,3,0,0,0,180,0,0,0,0,0
0.19,17,4,392,2,44,0,44,144,2,96,146,102,248
93.682,6,11,806,11,26,9368,26,806,0,0,0,0,0
28.944,6,18,788,8,0,4134,0,348,10,0,2439,0,440
1751.093,17,201,51160,201,226,8755,422,51160,0,0,0,0,0
0.819,6,4,220,2,0,819,0,100,2,0,307,0,120
1799.998,6,214,16590,79,69,22692,310,7838,135,49,13432,78,8752
0.178,6,47,23049,27,1128,6,1432,18028,20,420,8,1432,5021
0.891,17,4,368,2,64,889,64,184,2,64,889,64,184
249.947,17,4,352,2,60,249946,60,176,2,60,249946,60,176
52.943,17,9,684,9,48,6617,48,684,0,0,0,0,0
360.938,2,4,128,4,8,120312,8,128,0,0,0,0,0
0.032,17,4,284,2,32,0,32,120,2,54,10,60,164
0.308,6,26,8582,14,219,23,531,1613,12,1056,27,1408,6969
150.974,17,4,352,2,60,150972,60,176,2,60,150973,60,176
0.0,17,1,1282,1,1254,0,1254,1282,0,0,0,0,0
8.606,6,35,8436,13,152,717,267,1594,22,458,409,1420,6842
10.016,1,9,756,9,56,1252,56,756,0,0,0,0,0
2.004,17,6,460,3,40,992,41,206,3,56,992,57,254
1.128,17,8,608,4,37,375,37,260,4,59,375,65,348
604.939,17,22,7360,22,306,28806,308,7360,0,0,0,0,0
0.217,17,2,632,1,288,0,288,316,1,288,0,288,316
1.041,17,8,672,4,34,333,34,248,4,78,345,84,424
1744.419,6,99,7473,63,38,28135,205,4476,36,33,49830,98,2997
1764.603,2,15,480,15,8,126043,8,480,0,0,0,0,0
1.714,6,2,1520,1,0,0,0,40,1,1440,0,1440,1480
1.698,17,6,540,3,30,654,30,174,3,94,0,94,366
49.566,6,25,7094,11,181,4956,267,1168,14,595,3805,1400,5926
1787.393,6,104,8376,68,65,26677,65,4930,36,59,51066,59,3446
1744.638,2,30,960,30,8,60159,8,960,0,0,0,0,0
653.346,17,50,3850,50,49,13333,49,3850,0,0,0,0,0
0.367,17,2,154,1,33,0,33,61,1,65,0,65,93
73.293,17,10,880,5,48,18320,48,380,5,72,18320,72,500
1.369,6,27,6194,14,172,105,267,1769,13,780,100,1460,4425
19.238,17,4,824,2,48,19225,48,152,2,308,19225,308,672
6.115,6,15,1157,8,182,873,182,614,7,77,835,134,543
1770.726,6,99,9174,66,64,27241,64,5544,33,58,55332,58,3630
1743.665,6,95,7203,63,38,28123,205,4476,32,33,56239,98,2727
1.971,17,3,201,3,39,985,39,201,0,0,0,0,0
1786.528,6,102,8364,68,66,26664,66,4964,34,60,54134,60,3400
1.801,6,74,53340,44,1281,41,1440,45863,30,842,56,1440,7477
755.823,2,4,128,4,8,251941,8,128,0,0,0,0,0
12.109,17,3,1002,3,306,6054,306,1002,0,0,0,0,0
69.177,6,11,851,11,31,6917,31,851,0,0,0,0,0
0.888,17,2,122,2,33,888,33,122,0,0,0,0,0
6.629,6,39,7269,21,218,331,314,3463,18,513,372,1179,3806
7.121,6,625,575267,414,1325,16,1368,559631,211,776,32,1473,15636
50.316,6,36,8455,18,410,533,882,1982,18,478,2950,2720,6473
1.332,6,50,19980,27,940,51,1460,14284,23,433,52,1460,5696
5.692,6,35,5661,16,331,379,1418,3178,19,207,315,580,2483
1787.905,6,359,22709,209,69,8595,69,12569,150,69,11999,69,10140
1.017,6,24,6636,13,350,84,1089,2276,11,783,100,1420,4360
1773.34,1,58,4872,58,56,31111,56,4872,0,0,0,0,0
1744.723,2,27,864,27,8,67104,8,864,0,0,0,0,0
2.355,17,8,628,4,31,774,31,236,4,70,769,70,392
170.919,6,25,9920,12,514,121,1237,2067,13,915,14227,1460,7853
0.384,6,12,1653,6,288,71,288,548,6,426,45,434,1105
908.426,6,183,11864,100,69,8642,69,6139,83,66,11078,69,5725
1787.219,6,104,8376,68,65,26674,65,4930,36,59,51059,59,3446
0.03,17,4,420,2,33,19,33,122,2,121,14,145,298
1700.414,17,12,498,11,14,170041,14,462,1,8,0,8,36
0.41,6,47,18823,26,972,16,1380,13741,21,421,18,1923,5082
1792.964,17,144,11520,72,48,25252,48,5472,72,56,25252,56,6048
1770.752,6,99,9306,66,66,27242,66,5610,33,60,55333,60,3696
1.588,6,13,2311,8,188,226,245,700,5,1407,330,1407,1611
60.177,6,24,6284,13,413,5014,918,1937,11,470,6009,1448,4347
89.371,17,4,240,2,32,89370,32,120,2,32,89370,32,120
11.019,6,20,4442,11,275,1101,275,998,9,768,783,1440,3444
3.991,17,6,462,3,33,1995,33,183,3,65,1994,65,279
10.26,6,22,6726,5,154,2565,267,672,17,447,614,1452,6054
0.441,6,51,22207,29,993,15,1380,17085,22,421,18,1923,5122
22.685,6,20,5952,10,272,2520,516,1220,10,618,2510,1452,4732
1796.826,17,448,39896,403,35,4469,288,25676,45,288,40020,288,14220
0.305,1,2,668,2,306,305,306,668,0,0,0,0,0
2.92,17,4,232,4,30,973,30,232,0,0,0,0,0
0.26,6,2,80,1,0,0,0,40,1,0,0,0,40
1792.666,1,58,4872,0,0,0,0,0,58,56,31450,56,4872
10.77,6,20,4442,11,275,1077,275,998,9,768,738,1440,3444
364.525,6,18,1242,14,180,28040,180,916,4,110,20063,110,326
0.042,17,4,680,2,33,1,33,122,2,251,37,323,558
0.07,6,9,1002,5,213,17,213,417,4,421,19,421,585
1.969,17,2,122,2,33,1969,33,122,0,0,0,0,0
1635.206,1,8,848,8,78,233600,78,848,0,0,0,0,0
111.579,6,23,7460,8,155,751,267,1106,15,522,7969,2006,6354
2.152,17,6,460,3,40,998,41,206,3,56,1070,57,254
0.219,6,27,7296,13,155,18,267,1301,14,603,15,1400,5995
1740.746,17,29,30624,29,1028,62169,1028,30624,0,0,0,0,0
19.049,6,15,4639,9,290,2381,517,1057,6,1087,3763,1418,3582
280.496,6,28,7352,12,158,25499,267,1277,16,678,18696,2760,6075
20.664,17,4,240,2,32,20662,32,120,2,32,20663,32,120
64.288,6,9,380,4,0,406,0,168,5,0,16068,0,212
7.223,6,1713,1613992,1104,1385,6,1408,1577660,609,776,11,1408,36332
0.393,6,48,21067,27,1062,15,1380,15985,21,421,17,1923,5082
4.964,6,38,7229,19,218,275,314,3383,19,513,261,1179,3846
1.464,6,38,8254,19,321,81,1164,2718,19,433,71,1440,5536
1.308,6,85,53736,49,1277,27,1432,47996,36,428,30,1871,5740
0.662,6,133,97272,80,1309,8,1420,90931,53,526,12,3303,6341
8.295,6,12,700,5,0,2073,0,280,7,0,1194,0,420
14.349,6,2670,2559855,1714,1414,8,1448,2505479,956,776,14,1448,54376
1770.57,6,102,9462,66,66,27239,66,5610,36,60,50585,60,3852
0.043,1,2,163,2,53,43,78,163,0,0,0,0,0
0.32,6,28,9150,13,261,26,683,1728,15,829,22,1408,7422
0.993,17,4,560,2,64,992,64,184,2,160,179,160,376
32.628,17,4,352,2,60,32627,60,176,2,60,32627,60,176
105.765,17,4,240,2,32,105764,32,120,2,32,105764,32,120
1741.403,17,30,31663,30,1027,60048,1028,31663,0,0,0,0,0
0.209,17,8,2758,8,316,29,355,2758,0,0,0,0,0
5.643,17,16,9791,8,705,806,1350,5869,8,462,798,1350,3922
20.154,6,17,2316,10,189,2239,517,1298,7,323,3354,499,1018
3.84,6,2,88,2,0,0,0,88,0,0,0,0,0
128.797,6,13,5760,5,96,32199,106,496,8,987,9252,1917,5264
67.398,6,9,528,4,0,22466,0,216,5,0,16799,0,312
370.823,6,25,1654,17,180,23176,180,1120,8,110,9207,110,534
209.375,6,41,10456,16,271,631,618,3626,25,416,8714,1179,6830
20.236,6,18,2368,10,189,2248,517,1298,8,323,2889,499,1070
369.529,6,18,1242,14,180,28425,180,916,4,110,20062,110,326
321.031,6,781,662501,468,1405,687,1440,642889,313,221,93,1440,19612
280.03,6,30,7432,13,158,23335,267,1317,17,543,17499,1300,6115
1.807,6,38,17934,21,455,90,1360,3652,17,1132,101,2720,14282
0.381,6,48,20205,27,1000,14,1380,15123,21,421,17,1923,5082
0.238,6,26,7256,12,155,21,267,1261,14,603,17,1400,5995
4.034,17,2,656,2,300,4034,300,656,0,0,0,0,0
1782.062,6,354,22440,207,69,8650,69,12420,147,69,12205,69,10020
5.435,6,40,7325,21,218,271,314,3463,19,516,287,1179,3862
1773.414,17,47,15792,47,308,38552,308,15792,0,0,0,0,0
1.579,6,53,21865,30,992,54,1460,16124,23,437,63,2615,5741
1787.211,17,44,14784,44,308,41563,308,14784,0,0,0,0,0
1757.522,6,211,27692,114,304,15553,304,18852,97,83,18307,83,8840
0.485,6,9,527,5,43,121,43,311,4,0,159,0,216
0.054,17,4,284,2,32,1,32,120,2,54,36,60,164
63.964,17,26,4276,26,136,2558,354,4276,0,0,0,0,0
0.022,17,2,167,1,39,0,39,67,1,72,0,72,100
1773.655,6,180,15480,120,69,14904,69,8940,60,69,30052,69,6540
5.453,6,7,400,3,0,2726,0,160,4,0,1037,0,240
411.017,1,4,224,4,28,137005,28,224,0,0,0,0,0
1671.947,1,8,448,8,28,238849,28,448,0,0,0,0,0
0.512,17,2,476,1,39,0,39,67,1,381,0,381,409
0.065,17,4,420,2,33,53,33,122,2,121,14,145,298
1681.87,17,14,1036,7,30,280306,30,406,7,62,280306,62,630
63.032,6,604,285402,324,817,195,1152,268697,280,392,225,1152,16705
1770.844,6,99,9240,66,65,27243,65,5577,33,59,55335,59,3663
9.444,6,38,7229,20,218,497,314,3423,18,513,518,1179,3806
856.929,1,30,1680,30,28,29549,28,1680,0,0,0,0,0
3.403,6,26,5690,13,140,283,267,1224,13,563,277,1452,4466
1.678,6,25,8709,15,276,119,560,1432,10,981,166,1420,7277
2.654,17,4,240,2,32,2653,32,120,2,32,2653,32,120
1747.406,6,95,7203,63,38,28183,205,4476,32,33,56354,98,2727
0.013,6,10,1755,5,657,3,657,925,5,562,3,562,830
20.201,6,14,2245,8,211,2882,211,846,6,545,4029,904,1399
11.156,6,1763,1528902,1068,1377,10,1420,1496881,695,467,16,1883,32021
7.468,6,45,7776,22,198,355,314,3663,23,455,309,1179,4113
0.009,17,2,344,1,60,0,60,88,1,228,0,228,256
0.088,17,4,284,2,32,84,32,120,2,54,84,60,164
1793.154,17,180,11520,180,36,10017,36,11520,0,0,0,0,0
1740.205,6,74,5392,46,33,38671,33,3187,28,31,64444,31,2205
1795.89,1,58,4872,58,56,31506,56,4872,0,0,0,0,0
17.007,6,94,29692,47,579,369,1152,23330,47,447,363,1179,6362
151.109,6,25,10200,13,541,53,1360,2741,12,995,13725,1360,7459
1777.604,17,140,11200,70,48,25762,48,5320,70,56,25762,56,5880
0.055,6,13,4282,7,111,9,111,483,6,1159,10,1863,3799
0.163,6,26,7256,13,155,13,267,1301,13,678,13,2800,5955
1779.509,1,210,22260,210,78,8514,78,22260,0,0,0,0,0
0.023,17,2,136,1,32,0,32,60,1,48,0,48,76
1793.656,6,356,22520,208,69,8665,69,12460,148,69,12201,69,10060
1.257,6,23,5482,13,125,103,212,1026,10,810,138,1699,4456
0.039,17,2,740,2,342,39,353,740,0,0,0,0,0
1747.88,6,95,7203,63,38,28191,205,4476,32,33,56370,98,2727
2.408,17,2,677,1,300,0,300,328,1,321,0,321,349
0.258,17,12,6085,6,586,51,1350,3687,6,371,36,1350,2398
1379.165,1,14,784,14,28,106089,28,784,0,0,0,0,0
0.003,17,4,284,2,32,2,32,120,2,54,3,60,164
1795.404,6,354,22440,207,69,8715,69,12420,147,69,12296,69,10020
1749.856,17,130,10400,65,48,27341,48,4940,65,56,27341,56,5460
1.792,6,27,8851,16,286,119,591,1503,11,863,158,1380,7348
1789.984,6,354,22371,207,69,8689,69,12420,147,69,12260,69,9951
19.483,6,6,328,4,0,6494,0,216,2,0,19245,0,112
0.128,17,8,2446,8,277,18,316,2446,0,0,0,0,0
0.096,17,2,472,1,60,0,60,88,1,356,0,356,384
12.215,6,1936,1688819,1173,1385,10,1420,1654078,763,467,16,1883,34741
1740.733,17,29,30732,29,1031,62169,1064,30732,0,0,0,0,0
264.874,17,4,352,2,60,264872,60,176,2,60,264872,60,176
1794.39,17,80,3354,79,14,23005,14,3318,1,8,0,8,36
7.006,6,561,470770,340,1316,20,1368,454614,221,776,30,2736,16156
10.115,6,82,24501,41,550,252,1152,18720,41,459,246,1179,5781
11.422,6,27,11373,13,275,951,275,1078,14,1080,802,1420,10295
1797.455,6,351,50648,189,304,9560,304,34968,162,83,11164,83,15680
256.054,6,32,8952,14,158,19696,267,1357,18,624,15056,1400,7595
268.085,6,62,7924,24,119,9914,722,2808,38,108,7240,1408,5116
1.872,6,28,8839,17,277,117,565,1517,11,859,166,1380,7322
1770.352,6,181,16821,120,83,14876,965,9836,61,74,29499,405,6985
0.023,6,11,913,6,182,4,182,490,5,77,2,134,423
0.088,6,9,1050,5,261,22,261,465,4,421,25,421,585
1795.131,6,370,23425,213,69,8467,69,12936,157,69,11504,69,10489
1776.002,6,206,22479,131,75,13661,267,10097,75,132,23993,1460,12382
53.133,2,11,440,11,16,5313,16,440,0,0,0,0,0
101.068,6,19,4474,8,271,504,515,1139,11,412,10096,1452,3335
1793.272,1,58,4872,58,56,31460,56,4872,0,0,0,0,0
280.455,6,30,7432,13,158,23371,267,1317,17,603,17524,2076,6115
1770.729,6,99,9306,66,66,27241,66,5610,33,60,55332,60,3696
2.14,1,9,756,9,56,267,56,756,0,0,0,0,0
1.46,6,48,19161,26,956,58,1460,13505,22,433,60,1460,5656
1789.521,17,142,11360,71,48,25564,48,5396,71,56,25564,56,5964
0.055,17,2,182,1,44,0,44,72,1,82,0,82,110
1.17,6,54,13949,27,551,45,1429,4960,27,464,44,1986,8989
3.909,17,4,240,4,32,1303,32,240,0,0,0,0,0
1798.872,1,87,9222,87,78,20917,78,9222,0,0,0,0,0
0.146,17,2,2380,2,1162,146,1162,2380,0,0,0,0,0
1788.99,6,103,8404,68,66,26701,66,4964,35,60,52614,60,3440
1744.636,2,30,960,30,8,60159,8,960,0,0,0,0,0
0.189,17,2,136,1,32,0,32,60,1,48,0,48,76
0.104,6,10,1569,5,627,25,627,895,5,406,25,406,674
1665.766,1,94,5264,94,28,17911,28,5264,0,0,0,0,0
0.081,17,2,2752,2,1348,81,1348,2752,0,0,0,0,0
17.183,17,4,352,2,48,17171,48,152,2,72,17170,72,200
251.529,6,78,44949,41,129,6288,517,3446,37,1648,6986,9856,41503
0.776,6,17,5164,9,150,97,174,664,8,835,96,1452,4500
0.367,17,8,2758,8,316,52,355,2758,0,0,0,0,0
1794.45,17,141,11276,71,48,25634,48,5396,70,56,26006,56,5880
1772.882,6,180,15480,120,69,14898,69,8940,60,69,30044,69,6540
6.059,6,15,6025,4,101,2016,112,371,11,650,604,1460,5654
61.318,6,37,15792,22,786,2919,1440,9013,15,665,4361,1440,6779
8.282,6,44,8710,22,227,394,314,4062,22,470,382,1179,4648
241.118,6,45,8906,20,182,12687,517,2349,25,477,10045,1418,6557
15.775,17,16,9096,9,750,1963,1350,7006,7,270,2615,1350,2090
1680.667,1,15,840,15,28,120047,28,840,0,0,0,0,0
182.803,6,29,14696,14,507,114,1460,2644,15,1271,13047,1460,12052
4.253,6,15,2901,8,188,607,245,700,7,639,664,1407,2201
11.614,6,14,2193,8,324,1659,585,1073,6,396,2320,580,1120
1437.3,6,87,7164,61,64,23955,64,4616,26,58,54145,58,2548
15.01,6,24,4614,12,275,1364,275,1042,12,768,1325,1440,3572
0.358,6,27,9047,13,252,29,647,1692,14,945,26,1408,7355
0.637,6,14,1745,7,288,70,288,600,7,426,75,434,1145
1786.077,6,108,8536,68,65,26657,65,4930,40,59,45794,59,3606
0.37,6,12,1653,6,288,70,288,548,6,426,42,434,1105
1772.634,6,180,15480,120,69,14896,69,8940,60,69,30037,69,6540
1795.256,1,58,4872,58,56,31495,56,4872,0,0,0,0,0
0.091,17,2,2384,2,1164,91,1164,2384,0,0,0,0,0
1786.745,6,356,22520,208,69,8631,69,12460,148,69,12154,69,10060
1768.735,1,58,4872,58,56,31030,56,4872,0,0,0,0,0
1787.907,6,368,24821,214,88,8393,469,14107,154,69,11685,69,10714
384.978,6,18,1242,14,180,29613,180,916,4,110,20072,110,326
4.81,17,5,320,5,36,1202,36,320,0,0,0,0,0
0.516,6,13,1693,7,288,80,288,588,6,426,64,434,1105
0.507,17,3,451,2,39,367,39,134,1,289,0,289,317
2.062,1,2,112,2,28,2062,28,112,0,0,0,0,0
1.229,6,25,8056,12,164,94,267,1288,13,869,86,1448,6768
11.163,6,1775,1541114,1089,1362,10,1380,1509420,686,421,16,1923,31694
1740.506,17,30,31680,30,1028,60017,1028,31680,0,0,0,0,0
0.093,17,2,586,1,46,0,46,74,1,484,0,484,512
41.497,6,37,8496,18,410,516,917,1984,19,441,2298,1460,6512
1798.446,1,258,14448,258,28,6997,28,14448,0,0,0,0,0
11.169,6,21,6825,12,275,1015,275,1038,9,1353,769,1440,5787
172.088,6,23,9743,13,464,54,1360,2411,10,1384,19106,3934,7332
12.4,6,15,1444,4,106,4013,106,274,11,117,1238,256,1170
5.217,17,3,208,2,36,5003,36,128,1,52,0,52,80
0.931,17,3,305,2,32,472,32,120,1,157,0,157,185
3.489,6,2,88,2,0,0,0,88,0,0,0,0,0
6.288,6,956,864289,598,1370,10,1408,841009,358,931,17,2801,23280
240.448,17,4,352,2,60,240447,60,176,2,60,240447,60,176
38.716,17,22,1936,11,48,3870,48,836,11,72,3870,72,1100
74.841,6,22,7950,12,367,64,798,1649,10,981,8300,4080,6301
1643.573,1,7,392,7,28,273928,28,392,0,0,0,0,0
1799.681,1,185,19610,185,78,9780,78,19610,0,0,0,0,0
1787.897,6,102,8228,68,64,26685,64,4896,34,58,54176,58,3332
272.095,17,20,6781,20,311,14320,342,6781,0,0,0,0,0
5.02,17,4,288,2,36,5001,36,128,2,52,4992,52,160
61.505,6,47,26766,29,1033,2196,1408,19081,18,842,3605,2439,7685
300.338,6,79,54796,48,1326,6390,1448,47666,31,459,1176,1448,7130
5.128,17,4,514,2,36,5123,36,128,2,165,5107,187,386
11.987,17,19,6907,9,472,1498,1350,4504,10,212,1328,1350,2403
0.992,6,24,6404,13,296,82,826,2007,11,790,96,1460,4397
240.205,6,68,31530,37,913,6672,1402,24766,31,571,8006,2426,6764
299.665,6,6,364,4,31,99888,31,222,2,31,299615,31,142
1779.593,17,140,11200,70,48,25791,48,5320,70,56,25791,56,5880
240.245,6,56,19632,30,800,8284,1408,16770,26,187,9609,580,2862
0.033,17,3,244,2,32,6,32,120,1,96,0,96,124
4.097,6,39,7269,20,218,215,314,3423,19,440,214,1152,3846
0.023,6,16,6016,9,88,2,88,504,7,1740,3,1880,5512
0.091,17,2,417,1,45,0,45,73,1,316,0,316,344
0.021,6,2,84,1,0,0,0,44,1,0,0,0,40
1744.653,6,100,7702,66,40,26840,205,4730,34,35,52855,108,2972
1784.446,6,102,8364,68,66,26633,66,4964,34,60,54071,60,3400
86.013,6,16,2289,9,324,10751,585,1125,7,396,14310,580,1164
2.136,17,3,1071,3,329,1068,361,1071,0,0,0,0,0
143.305,6,161,125609,101,1313,1433,1448,112992,60,632,1933,1448,12617
1788.512,17,83,3480,82,14,22080,14,3444,1,8,0,8,36
1.041,17,4,798,2,39,1028,39,134,2,304,1030,304,664
1686.011,17,24,2019,12,31,153267,37,717,12,80,153269,136,1302
139.038,6,20,3497,7,92,207,92,464,13,235,11545,1448,3033
55.239,6,27,7177,13,155,4603,267,1306,14,530,4248,3417,5871
0.095,17,2,558,1,32,0,32,60,1,470,0,470,498
0.066,17,4,352,2,37,28,37,130,2,83,39,89,222
1.993,17,2,672,2,308,1993,308,672,0,0,0,0,0
0.194,1,2,112,2,28,194,28,112,0,0,0,0,0
38.749,6,27,7177,13,155,3229,267,1306,14,530,2980,3417,5871
61.609,6,56,35413,35,1119,1812,1440,27566,21,749,3068,1440,7847
76.688,17,36,9763,16,334,5110,1350,5803,20,170,4034,1350,3960
445.041,17,6,394,3,37,222520,47,197,3,37,222520,47,197
1798.023,1,342,28728,342,56,5272,56,28728,0,0,0,0,0
37.827,6,2,170,0,0,0,0,0,2,45,37827,59,170
1656.427,1,8,448,8,28,236632,28,448,0,0,0,0,0
0.027,17,2,231,1,34,0,34,62,1,141,0,141,169
0.556,6,113,86884,48,131,11,232,2449,65,1386,8,1420,84435
1.528,6,3,144,2,0,1360,0,104,1,0,0,0,40
1767.901,6,149,9710,81,54,22096,208,6091,68,31,26384,31,3619
8.229,6,18,6871,9,275,1028,275,643,9,1171,986,1440,6228
69.911,6,54,8445,27,304,2688,304,5716,27,83,2651,83,2729
1799.285,1,268,15008,268,28,6738,28,15008,0,0,0,0,0
4.345,6,13,1815,7,100,724,100,384,6,589,819,1152,1431
0.031,6,2,80,1,0,0,0,40,1,0,0,0,40
1772.501,6,180,15480,120,69,14894,69,8940,60,69,30037,69,6540
1774.805,1,16,896,16,28,118320,28,896,0,0,0,0,0
6.44,6,47,8505,24,227,280,314,4142,23,491,280,1179,4363
280.222,6,30,7432,13,158,23351,267,1317,17,543,17513,1400,6115
95.318,6,30,7432,13,158,7943,267,1317,17,543,5955,1400,6115
1781.102,6,356,22520,207,69,8646,69,12420,149,69,12034,69,10100
0.013,17,3,704,2,60,10,60,176,1,500,0,500,528
24.194,6,14,5984,2,112,520,112,200,12,529,2198,1420,5784
528.361,17,121,10605,55,95,9784,1350,6780,66,29,8116,60,3825
4.351,6,38,7229,19,218,241,314,3383,19,513,227,1179,3846
0.182,17,9,4213,4,521,60,1350,2198,5,375,19,1350,2015
15.841,17,24,8206,11,358,1580,1350,4250,13,276,1317,1350,3956
796.89,6,376,59601,203,304,3945,304,41640,173,83,4625,83,17961
72.309,6,45,10209,22,533,733,910,3083,23,364,3280,2128,7126
541.448,2,8,256,8,8,77349,8,256,0,0,0,0,0
315.877,6,88,20965,47,336,6866,1360,11068,41,329,7893,4649,9897
45.998,6,10,1078,5,275,11499,275,479,5,195,11433,384,599
1629.586,6,265,27978,141,108,11639,469,12497,124,108,13248,2840,15481
1.406,6,44,13673,23,710,63,1440,8057,21,433,61,1440,5616
1.273,17,34,21528,18,969,74,1350,17955,16,195,58,1350,3573
1786.152,17,140,11200,70,48,25886,48,5320,70,56,25886,56,5880
300.295,6,54,30075,24,190,13056,444,2065,30,1101,8340,1591,28010
240.307,6,44,8447,22,449,11442,1402,5648,22,205,11442,580,2799
1.429,6,222,169594,127,1347,11,1432,161443,95,475,14,1871,8151
1738.919,1,15,840,15,28,124208,28,840,0,0,0,0,0
0.399,6,22,7342,13,335,33,668,2026,9,1210,48,1906,5316
0.212,17,2,136,1,32,0,32,60,1,48,0,48,76
232.734,6,17,1151,9,31,29072,31,592,8,31,33224,31,559
0.425,6,5,248,3,0,212,0,144,2,0,423,0,104
31.091,1,37,3848,0,0,0,0,0,37,76,863,76,3848
8.112,17,6,528,3,48,4049,48,228,3,72,4049,72,300
0.0,17,1,80,0,0,0,0,0,1,52,0,52,80
1794.588,17,83,3480,82,14,22155,14,3444,1,8,0,8,36
65.29,6,82,60001,53,1224,1255,1368,51756,29,841,2207,2519,8245
288.471,1,4,224,4,28,96157,28,224,0,0,0,0,0
0.4,6,29,9188,14,252,30,647,1744,15,949,28,2816,7444
0.793,17,14,7282,7,665,132,1350,4856,7,318,123,1350,2426
1793.637,17,87,3648,86,14,21101,14,3612,1,8,0,8,36
183.241,1,6,336,6,28,36648,28,336,0,0,0,0,0
254.004,1,45,1980,45,16,5772,16,1980,0,0,0,0,0
122.757,17,4,240,2,32,122756,32,120,2,32,122755,32,120
250.028,1,8,448,8,28,35718,28,448,0,0,0,0,0
62.559,6,53,31297,33,1088,1954,1448,23503,20,749,3233,1448,7794
1797.924,1,234,13104,234,28,7716,28,13104,0,0,0,0,0
3.568,6,211,208609,132,237,27,517,9230,79,2711,45,9856,199379
0.587,6,14,1745,7,288,70,288,600,7,426,70,434,1145
1763.376,2,14,448,14,8,135644,8,448,0,0,0,0,0
10.601,6,36,13868,17,141,662,156,1328,19,978,558,1460,12540
0.312,6,27,9043,13,247,26,624,1672,14,947,23,1408,7371
226.653,6,31,11539,17,559,14165,1438,4248,14,1092,17430,1453,7291
1.129,6,24,6408,13,297,94,830,2011,11,988,111,1731,4397
3.075,17,4,332,2,47,3070,47,150,2,63,3070,63,182
87.801,6,21,856,9,0,6820,0,364,12,0,7980,0,492
0.016,17,2,192,1,60,0,60,88,1,76,0,76,104
21.073,17,2,152,2,48,21073,48,152,0,0,0,0,0
5.056,17,4,304,4,48,1685,48,304,0,0,0,0,0
0.021,17,2,291,1,72,0,72,100,1,163,0,163,191
2.151,6,20,3833,11,234,215,564,1504,9,463,242,1343,2329
1788.283,6,412,37510,229,120,7843,1189,18434,183,145,9825,1917,19076
0.135,17,2,396,1,39,0,39,67,1,301,0,301,329
280.271,6,28,7352,12,158,25479,267,1277,16,603,18679,1400,6075
17.876,17,24,7172,10,305,1982,1350,3332,14,246,1372,1350,3840
36.188,6,29,7392,13,158,3015,267,1317,16,603,2409,2036,6075
194.028,6,26,8398,10,348,81,735,1572,16,498,12925,1448,6826
240.605,2,4,128,4,8,80201,8,128,0,0,0,0,0
0.056,1,6,2232,6,344,11,344,2232,0,0,0,0,0
0.465,6,9,1340,5,145,116,145,349,4,827,85,827,991
63.193,6,14,5625,4,106,21060,106,274,10,706,7020,1420,5351
8.568,6,56,14453,27,364,329,469,7292,29,272,132,1460,7161
386.335,6,18,1242,14,180,29718,180,916,4,110,20074,110,326
1799.201,17,142,11360,71,48,25702,48,5396,71,56,25702,56,5964
0.02,17,3,244,2,32,1,32,120,1,96,0,96,124
0.072,6,12,1843,7,138,12,138,510,5,532,16,891,1333
1787.031,6,104,8376,68,65,26672,65,4930,36,59,51054,59,3446
1742.089,6,95,7203,63,38,28098,205,4476,32,33,56187,98,2727
382.912,17,12,912,12,48,34810,48,912,0,0,0,0,0
12.007,17,16,1376,8,47,1714,47,600,8,69,1714,75,776
2.914,6,15,3217,5,92,728,92,348,10,579,304,1408,2869
584.018,6,82,11605,41,93,14080,721,4163,41,289,14596,1414,7442
100.342,6,15,2060,7,312,107,673,1238,8,245,14315,338,822
65.152,6,20,5902,11,272,6515,516,1260,9,713,8132,1452,4642
208.356,17,12,4044,12,309,18941,320,4044,0,0,0,0,0
52.031,6,23,4725,10,272,87,516,1220,13,298,4327,1452,3505
281.216,17,4,240,2,32,281215,32,120,2,32,281214,32,120
23.633,6,2150,1770880,1200,1383,19,1448,1712628,950,776,24,1448,58252
1.169,6,56,17950,28,706,43,1360,8921,28,438,42,1360,9029
1783.643,17,140,11200,70,48,25849,48,5320,70,56,25849,56,5880
1764.178,2,13,416,13,8,147014,8,416,0,0,0,0,0
200.837,6,38,6795,15,135,6191,722,2008,23,275,9120,1408,4787
13.128,1,8,832,0,0,0,0,0,8,76,1875,76,832
0.073,6,11,911,6,181,14,181,489,5,77,8,133,422
443.648,17,36,2880,18,48,26096,48,1368,18,56,26096,56,1512
378.536,6,18,1242,14,180,29118,180,916,4,110,20072,110,326
20.98,6,39,8642,18,410,556,882,2018,21,444,1042,2720,6624
1783.909,6,370,25770,214,99,8375,469,15114,156,69,11508,69,10656
1797.118,1,345,28980,345,56,5224,56,28980,0,0,0,0,0
0.001,6,2,328,1,248,0,248,288,1,0,0,0,40
1786.547,6,102,8364,68,66,26664,66,4964,34,60,54134,60,3400
240.707,6,45,6839,20,227,12666,585,3318,25,200,10027,580,3521
251.374,2,3,96,3,8,125687,8,96,0,0,0,0,0
22.85,6,3057,2821555,1905,1400,11,1448,2756963,1152,776,19,1448,64592
6.01,6,1371,1253363,860,1380,6,1408,1222127,511,931,11,2816,31236
1790.792,6,403,32425,228,89,7888,1093,15484,175,137,10291,3457,16941
1788.62,17,88,3684,86,14,21040,14,3612,2,8,1788440,8,72
1.34,6,49,20288,26,965,53,1440,14592,23,433,52,1440,5696
1743.448,17,314,52647,314,139,5570,389,52647,0,0,0,0,0
4.516,6,22,4918,12,233,410,613,1797,10,518,481,1408,3121
5.119,6,32,14120,14,265,393,764,1871,18,1027,300,2375,12249
1799.028,6,356,22520,208,69,8690,69,12460,148,69,12237,69,10060
1795.891,17,444,38348,404,35,4456,288,25708,40,288,45149,288,12640
1739.463,6,87,6322,58,31,30516,31,3915,29,31,62123,31,2407
1740.488,17,30,31620,30,1026,60016,1026,31620,0,0,0,0,0
280.52,6,30,7432,13,158,23376,267,1317,17,603,17526,2236,6115
18.697,6,8,440,5,0,4674,0,268,3,0,9200,0,172
12.17,6,92,26946,46,536,270,1152,20624,46,407,264,1152,6322
26.15,6,27,9665,15,315,1867,922,1893,12,1040,2355,1456,7772
280.339,6,29,7392,13,158,23361,267,1317,16,543,18687,1400,6075
8.197,6,17,5164,9,150,1024,174,664,8,835,1156,1452,4500
0.012,6,2,123,1,0,0,0,40,1,31,0,31,83
0.101,6,10,1677,6,555,19,951,1354,4,159,32,159,323
1778.256,17,142,11360,71,48,25403,48,5396,71,56,25403,56,5964
1780.097,17,142,11360,71,48,25429,48,5396,71,56,25429,56,5964
62.513,6,16,5721,5,106,15625,106,322,11,706,6250,1460,5399
91.628,6,3,156,1,0,0,0,52,2,0,91459,0,104
1681.506,1,15,840,15,28,120107,28,840,0,0,0,0,0
1787.004,6,102,8296,68,65,26671,65,4930,34,59,54148,59,3366
62.968,6,72,47831,45,1167,1431,1448,39699,27,746,2368,1448,8132
35.941,6,4895,4675179,3252,1360,11,1408,4584981,1643,950,21,2801,90198
1788.643,6,373,23614,214,69,8397,69,13114,159,69,11319,69,10500
5.292,6,15,1437,6,177,1058,177,505,9,110,510,110,932
2.993,17,4,624,4,128,997,128,624,0,0,0,0,0
1784.95,6,102,8364,68,66,26641,66,4964,34,60,54077,60,3400
0.913,6,10,924,5,283,183,283,551,5,105,184,105,373
1747.013,6,95,7203,63,38,28177,205,4476,32,33,56341,98,2727
1772.693,6,180,15480,120,69,14896,69,8940,60,69,30039,69,6540
16.199,17,4,824,2,48,16188,48,152,2,308,16187,308,672
2.097,6,12,1036,6,283,384,283,603,6,105,383,105,433
1782.352,17,83,3480,82,14,22004,14,3444,1,8,0,8,36
43.757,17,45,14898,21,380,2186,1350,8585,24,235,1900,1350,6313
0.337,17,8,2774,8,318,48,357,2774,0,0,0,0,0
1786.913,6,355,22480,207,69,8674,69,12420,148,69,12155,69,10060
5.141,6,11,2879,6,100,1028,100,344,5,1165,1170,1179,2535
0.016,17,2,394,1,37,0,37,65,1,301,0,301,329
1.96,17,3,468,3,128,980,128,468,0,0,0,0,0
1787.585,17,138,11040,69,48,26287,48,5244,69,56,26287,56,5796
1759.687,6,76,3496,38,0,47559,0,1976,38,0,47559,0,1520
1.331,6,10,1687,7,100,221,100,384,3,1179,540,1179,1303
16.925,17,4,352,2,60,16924,60,176,2,60,16923,60,176
0.463,6,12,1653,6,288,85,288,548,6,426,52,434,1105
2.474,17,2,144,1,36,0,36,64,1,52,0,52,80
280.629,6,30,7432,13,158,23385,267,1317,17,543,17537,1400,6115
1786.673,6,365,24963,212,94,8467,469,14496,153,69,11752,69,10467
0.088,17,2,558,1,32,0,32,60,1,470,0,470,498
1787.139,6,102,8296,68,65,26673,65,4930,34,59,54151,59,3366
1744.409,6,95,7203,63,38,28135,205,4476,32,33,56260,98,2727
1.96,6,16,3672,9,150,245,174,664,7,681,310,1452,3008
66.939,6,27,7177,13,155,5578,267,1306,14,530,5148,3417,5871
0.33,17,8,2774,8,318,47,357,2774,0,0,0,0,0
9.493,6,1602,1436109,963,1410,9,1448,1398205,639,776,14,1448,37904
0.026,17,4,608,2,60,14,60,176,2,188,10,188,432
0.272,6,19,5832,11,275,26,517,1681,8,931,38,1906,4151
234.494,17,4,352,2,60,234492,60,176,2,60,234493,60,176
1788.017,6,106,7140,66,56,27507,208,4610,40,31,45836,31,2530
247.848,6,18,5839,10,784,27538,1360,3538,8,247,35374,272,2301
240.286,6,43,12440,20,507,12646,1402,5617,23,561,10921,2423,6823
0.7,17,2,144,1,36,0,36,64,1,52,0,52,80
784.374,6,48,2964,24,27,29359,27,1410,24,25,34100,27,1554
0.007,6,13,4282,7,111,1,111,483,6,1159,1,2896,3799
1743.921,6,95,7203,63,38,28127,205,4476,32,33,56247,98,2727
1.403,6,47,18610,27,851,53,1360,13034,20,476,64,2715,5576
0.499,6,29,7520,17,306,31,1087,2826,12,601,44,1420,4694
1789.107,17,142,11360,71,48,25558,48,5396,71,56,25558,56,5964
0.092,6,6,362,4,31,30,31,227,2,31,0,31,135
0.485,6,130,101963,68,131,7,232,3249,62,1688,7,5680,98714
10.982,6,19,4402,11,275,1098,275,998,8,1024,898,2880,3404
0.037,17,2,223,1,36,0,36,64,1,131,0,131,159
2.239,6,13,2311,8,188,319,245,700,5,1407,497,1407,1611
1794.147,17,80,3354,79,14,23001,14,3318,1,8,0,8,36
0.523,17,2,144,1,36,0,36,64,1,52,0,52,80
15.106,17,12,5157,6,490,3015,1350,3108,6,313,3015,1350,2049
0.03,17,2,350,1,33,0,33,61,1,261,0,261,289
1.505,6,53,36410,33,1206,47,1408,29465,20,1179,70,3819,6945
283.097,17,4,352,2,60,283096,60,176,2,60,283096,60,176
45.429,6,23,3291,12,302,4129,302,2130,11,83,4457,83,1161
55.472,17,16,18211,16,1110,3698,1451,18211,0,0,0,0,0
1772.373,6,180,15480,120,69,14893,69,8940,60,69,30035,69,6540
7.361,6,6,260,2,0,17,0,84,4,0,2450,0,176
1725.61,17,12,498,11,14,172561,14,462,1,8,0,8,36
0.024,6,2,149,1,0,0,0,40,1,69,0,69,109
14.61,6,14,1025,7,222,2432,222,506,7,231,2432,231,519
1383.667,2,13,416,13,8,115305,8,416,0,0,0,0,0
300.818,6,50,10526,25,433,12534,910,3258,25,312,524,1460,7268
0.192,17,2,204,1,34,0,34,62,1,114,0,114,142
0.313,17,2,904,2,424,313,548,904,0,0,0,0,0
1788.584,6,418,25685,217,69,8280,69,13096,201,42,8942,69,12589
1787.947,17,142,11360,71,48,25541,48,5396,71,56,25541,56,5964
1.538,6,242,199832,150,1336,10,1420,191861,92,475,16,1883,7971
519.686,6,74,12265,36,91,14848,267,3468,38,234,14045,3417,8797
1.23,6,25,8056,12,164,95,267,1288,13,869,87,1440,6768
1742.192,1,55,4620,0,0,0,0,0,55,56,32262,56,4620
0.114,17,2,2754,2,1349,114,1349,2754,0,0,0,0,0
126.06,6,32,7717,12,155,29,267,1266,20,376,6634,3417,6451
0.236,6,2,80,1,0,0,0,40,1,0,0,0,40
0.146,6,9,1340,5,145,36,145,349,4,827,46,827,991
1.175,6,24,8016,12,164,90,267,1300,12,1014,90,2411,6716
15.106,17,22,5991,9,287,1884,1350,2838,13,214,1256,1350,3153
1.206,6,25,8056,12,164,92,267,1288,13,869,85,1440,6768
0.015,6,12,3486,7,75,2,75,471,5,2747,3,2747,3015
10.689,6,2022,1744091,1144,1430,9,1448,1685511,878,776,11,1448,58580
1744.737,2,26,832,26,8,69789,8,832,0,0,0,0,0
14.916,17,2,1430,2,687,14916,687,1430,0,0,0,0,0
5.705,6,41,7349,20,218,300,314,3423,21,513,270,1179,3926
0.252,17,2,2384,2,1164,252,1164,2384,0,0,0,0,0
4.701,6,40,7309,20,218,247,314,3423,20,513,232,1179,3886
0.053,6,2,80,1,0,0,0,40,1,0,0,0,40
1791.009,6,390,32208,214,91,8408,1189,14813,176,130,10234,1420,17395
37.871,17,22,1672,22,48,1803,48,1672,0,0,0,0,0
3.113,17,2,656,2,300,3113,300,656,0,0,0,0,0
1724.429,1,8,448,8,28,246347,28,448,0,0,0,0,0
16.072,17,24,7968,13,411,1336,1350,5713,11,177,1603,1350,2255
5.146,17,28,15191,12,341,467,1350,4432,16,644,338,1350,10759
4.993,17,4,288,2,36,4944,36,128,2,52,4946,52,160
32.111,6,234,223055,80,128,406,308,4546,154,1403,209,1418,218509
1.328,6,47,18818,26,933,53,1460,13202,21,433,57,1460,5616
0.295,17,2,212,1,46,0,46,74,1,110,0,110,138
240.32,6,43,8780,21,523,12015,1408,5809,22,202,11443,639,2971
1798.894,17,449,39928,404,35,4463,288,25708,45,288,40018,288,14220
15.293,17,25,17340,14,863,1173,1350,12481,11,413,1525,1350,4859
372.216,6,18,1242,14,180,28632,180,916,4,110,20065,110,326
404.723,6,86,14162,40,308,10376,1368,7326,46,192,8993,1368,6836
1.84,17,25,11301,13,545,150,1350,7460,12,292,164,1350,3841
95.791,6,73,49971,46,1194,2128,1408,41834,27,960,2369,2816,8137
1772.192,6,182,15629,121,69,14768,69,8980,61,69,29532,69,6649
1.4,6,38,9848,20,502,73,1460,4352,18,433,70,1460,5496
157.476,6,164,132567,109,1272,1458,1408,120194,55,731,2244,3847,12373
0.009,17,2,308,1,34,0,34,62,1,218,0,218,246
0.024,6,13,3980,7,88,3,88,388,6,1670,4,2920,3592
39.354,17,11,836,11,48,3935,48,836,0,0,0,0,0
1795.062,6,359,22709,209,69,8630,69,12569,150,69,12047,69,10140
9.732,6,2116,1946041,1337,1376,7,1408,1900857,779,931,12,2801,45184
7.65,6,41,13450,20,199,395,561,2290,21,859,373,1440,11160
3.351,17,5,340,5,40,837,40,340,0,0,0,0,0
0.014,17,2,356,1,32,0,32,60,1,268,0,268,296
1775.877,17,73,3060,72,14,25012,14,3024,1,8,0,8,36
1.015,6,28,8460,14,266,67,540,1924,14,994,65,1791,6536
371.188,6,19,1303,14,177,28552,177,925,5,110,17674,110,378
9.3,6,42,20263,24,168,404,250,2146,18,1144,531,1400,18117
232.331,6,33,6986,15,169,12293,516,1618,18,309,13660,1452,5368
38.849,6,20,6397,8,154,5549,267,792,12,639,3515,1452,5605
0.852,6,11,1727,7,100,142,100,384,4,589,203,1152,1343
1785.798,6,371,23672,214,69,8384,69,12838,157,69,11447,69,10834
0.037,6,10,1634,5,131,9,131,399,5,967,9,967,1235
1796.868,6,356,22589,207,69,8722,69,12420,149,69,12138,69,10169
1771.008,6,100,9358,66,66,27246,66,5610,34,60,53664,60,3748
2.508,17,3,1167,3,361,1254,361,1167,0,0,0,0,0
0.409,6,54,24547,30,1075,14,1380,17422,24,511,15,1923,7125
1790.911,1,342,28728,342,56,5251,56,28728,0,0,0,0,0
1.984,17,2,672,2,308,1984,308,672,0,0,0,0,0
16.12,17,50,35635,22,552,766,1350,12773,28,788,595,1350,22862
90.151,6,9,472,5,0,22537,0,256,4,0,30049,0,216
75.918,6,31,7619,12,156,29,267,1272,19,398,4217,3417,6347
113.2,6,37983,40339222,13244,162,8,296,689345,24739,1551,4,7040,39649877
12.144,17,20,1720,10,47,1348,47,750,10,69,1348,75,970
317.64,6,75,19300,42,315,7747,1360,9953,33,421,9921,4649,9347
0.059,6,12,3704,6,171,10,171,491,6,964,6,1448,3213
7.767,6,15,1362,8,275,1109,275,878,7,96,998,96,484
0.039,17,8,1670,8,180,5,219,1670,0,0,0,0,0
0.095,6,10,1569,5,627,23,627,895,5,406,23,406,674
0.997,17,2,312,2,128,997,128,312,0,0,0,0,0
0.023,17,2,148,1,30,0,30,58,1,62,0,62,90
0.511,6,24,6076,12,181,46,537,1526,12,781,41,2224,4550
1766.102,1,44,3696,44,56,41072,56,3696,0,0,0,0,0
11.86,6,1881,1638673,1141,1382,10,1420,1604840,740,467,16,1883,33833
0.846,6,56,23011,29,1028,30,1380,17644,27,387,30,1923,5367
8.956,6,78,24325,39,550,235,1152,18624,39,459,227,1179,5701
2.914,6,2,88,2,0,0,0,88,0,0,0,0,0
0.013,17,2,326,1,36,0,36,64,1,234,0,234,262
1791.846,6,359,22778,209,69,8614,69,12500,150,69,12022,69,10278
13.749,6,26,4815,13,154,1127,722,1767,13,473,1130,2026,3048
1786.75,6,102,8228,68,64,26667,64,4896,34,58,54141,58,3332
1721.77,1,8,448,8,28,245967,28,448,0,0,0,0,0
1679.938,1,15,840,15,28,119995,28,840,0,0,0,0,0
35.86,17,40,5880,20,48,1886,48,1520,20,190,1886,308,4360
0.527,6,20,7229,13,334,43,663,2021,7,1209,83,1946,5208
1799.355,1,58,4872,58,56,31567,56,4872,0,0,0,0,0
1794.447,1,125,7000,125,28,14471,28,7000,0,0,0,0,0
1773.647,6,83,4440,41,26,44340,26,2196,42,24,43258,24,2244
9.114,6,84,26685,42,570,222,1152,20523,42,407,215,1152,6162
0.251,6,26,7256,13,155,20,267,1301,13,678,19,2045,5955
1781.432,17,142,11360,71,48,25448,48,5396,71,56,25448,56,5964
1040.608,17,220,24040,99,141,10618,1350,16796,121,31,8670,60,7244
0.828,17,22,14130,11,761,79,1350,8679,11,467,79,1350,5451
2.09,17,2,384,1,39,0,39,67,1,289,0,289,317
91.522,6,123,93325,79,1247,1173,1408,81506,44,865,1990,4224,11819
280.292,6,30,7432,13,158,23357,267,1317,17,543,17511,1400,6115
1.48,6,115,87620,50,131,30,232,2529,65,1374,20,2860,85091
490.657,1,12,672,12,28,44605,28,672,0,0,0,0,0
73.422,6,25,10090,12,579,66,1440,2831,13,961,6107,1440,7259
122.294,1,4,224,4,28,40764,28,224,0,0,0,0,0
80.038,6,5,200,5,0,0,0,200,0,0,0,0,0
187.022,6,136,102954,87,1269,2174,1408,90871,49,680,2831,2439,12083
3.005,17,2,1430,2,687,3005,687,1430,0,0,0,0,0
1788.405,17,140,11200,70,48,25918,48,5320,70,56,25918,56,5880
0.317,6,278,790496,132,158,2,324,7506,146,5384,1,35200,782990
44.113,17,36,2566,30,40,1517,41,2059,6,56,9,57,507
211.998,6,30,8941,14,158,16307,267,1357,16,771,14129,3436,7584
148.52,6,236,59982,120,472,1247,1368,43130,116,230,1290,1024,16852
1778.071,17,142,11360,71,48,25400,48,5396,71,56,25400,56,5964
180.732,6,45,13969,23,559,8210,1448,6798,22,547,8602,1448,7171
300.848,6,455,578230,165,145,1834,230,9156,290,1937,1040,8412,569074
0.039,17,2,904,1,300,0,300,328,1,548,0,548,576
14.446,17,4,352,2,48,14437,48,152,2,72,14436,72,200
1776.488,17,140,11200,70,48,25746,48,5320,70,56,25746,56,5880
1799.892,17,87,3648,86,14,21175,14,3612,1,8,0,8,36
561.968,17,25,1900,25,48,23415,48,1900,0,0,0,0,0
0.027,6,9,1878,5,666,6,666,934,4,728,7,728,944
8.29,6,1661,1500082,1025,1384,7,1408,1462346,636,931,12,2816,37736
49.192,6,29,7257,13,155,4099,267,1306,16,441,3278,1420,5951
145.111,1,4,224,4,28,48370,28,224,0,0,0,0,0
0.955,17,2,144,1,36,0,36,64,1,52,0,52,80
511.504,17,6,528,3,60,255751,60,264,3,60,255751,60,264
0.139,6,15,5908,8,103,19,103,527,7,1252,23,1472,5381
1795.947,17,449,39928,404,35,4456,288,25708,45,288,40019,288,14220
1.015,6,10,1687,7,100,169,100,384,3,1179,374,1179,1303
0.026,17,4,368,2,32,11,32,120,2,96,1,96,248
3.951,17,4,1556,4,361,1317,361,1556,0,0,0,0,0
0.804,6,35,8271,19,271,44,739,1878,16,574,44,4848,6393
1797.183,17,448,39896,403,35,4470,288,25676,45,288,40019,288,14220
2.079,6,9,527,5,43,519,43,311,4,0,691,0,216
162.176,6,11,3413,11,270,16217,383,3413,0,0,0,0,0
294.825,6,34,7028,16,262,19652,517,1628,18,744,17339,1418,5400
11.55,6,21,6825,12,275,1050,275,1038,9,1353,816,1440,5787
1.38,6,24,8004,12,164,107,267,1288,12,1014,105,2736,6716
39.867,17,22,1672,22,48,1898,48,1672,0,0,0,0,0
0.233,17,2,144,1,36,0,36,64,1,52,0,52,80
1790.773,1,234,13104,234,28,7685,28,13104,0,0,0,0,0
442.792,6,48,4197,29,73,15813,138,2264,19,69,24599,69,1933
0.265,6,24,7981,12,186,24,367,1378,12,995,23,1408,6603
1.565,6,44,15682,25,759,65,1360,10146,19,433,75,1360,5536
1788.434,6,367,25719,212,100,8475,469,14896,155,69,11609,69,10823
3.499,17,2,152,2,48,3499,48,152,0,0,0,0,0
117.439,6,25,6318,9,272,106,516,1180,16,345,7823,1452,5138
2.295,6,13,2311,8,188,327,245,700,5,1407,507,1407,1611
68.84,17,6,2248,6,346,13768,548,2248,0,0,0,0,0
31.78,6,7,396,1,0,0,0,60,6,0,6319,0,336
1770.657,6,110,10108,70,65,25661,65,5939,40,59,45399,59,4169
42.481,6,42,14293,22,972,421,1460,8691,20,399,2227,1460,5602
0.895,6,10,1687,7,100,149,100,384,3,1179,321,1179,1303
0.198,6,24,7377,13,177,16,337,1394,11,1080,18,1588,5983
1334.836,17,76,6080,38,48,36076,48,2888,38,56,36076,56,3192
0.068,2,2,80,2,16,68,16,80,0,0,0,0,0
0.661,1,4,1680,4,392,220,535,1680,0,0,0,0,0
4.013,17,8,616,4,33,1337,33,244,4,65,1337,65,372
1775.03,6,180,15480,120,69,14916,69,8940,60,69,30081,69,6540
0.169,6,46,21476,26,1099,6,1420,16455,20,467,8,2840,5021
0.206,17,2,127,1,30,0,30,58,1,41,0,41,69
0.033,1,5,140,5,0,0,0,140,0,0,0,0,0
293.358,6,36,8229,17,290,18334,517,1533,19,634,16297,2426,6696
7.511,6,677,596981,428,1326,17,1368,579369,249,776,29,2736,17612
0.548,17,4,624,2,64,547,64,184,2,192,422,192,440
217.988,1,18,1008,18,28,12822,28,1008,0,0,0,0,0
1787.727,17,324,24624,324,48,5534,48,24624,0,0,0,0,0
377.235,6,18,1242,14,180,29018,180,916,4,110,20061,110,326
9.179,17,16,3120,8,32,1309,32,480,8,302,1309,308,2640
1647.192,1,8,448,8,28,235313,28,448,0,0,0,0,0
228.099,6,40,5901,19,152,7582,722,2216,21,184,11396,1408,3685
16.984,6,3024,2849064,1957,1378,8,1408,2788916,1067,776,15,1408,60148
240.565,6,53,18061,29,759,8588,1418,15192,24,201,10455,580,2869
3.15,17,2,338,1,33,0,33,61,1,249,0,249,277
1745.255,1,65,5460,65,56,27269,56,5460,0,0,0,0,0
1786.449,6,156,19773,93,302,19417,302,13916,63,83,28813,83,5857
2.078,17,6,552,3,32,931,32,180,3,96,0,96,372
0.066,17,2,186,1,36,0,36,64,1,94,0,94,122
1.259,6,38,9848,20,502,66,1460,4352,18,433,64,1460,5496
0.206,1,2,112,2,28,206,28,112,0,0,0,0,0
1794.602,6,244,35804,152,302,11884,302,26032,92,83,19720,83,9772
30.429,17,8,704,4,48,10140,48,304,4,72,10139,72,400
157.048,17,4,605,4,123,52349,355,605,0,0,0,0,0
11.007,6,19,4362,11,275,1100,275,998,8,1010,890,2840,3364
125.48,2,2,64,2,8,125480,8,64,0,0,0,0,0
154.082,17,4,558,2,36,154078,36,128,2,187,154078,187,430
99.7,6,11,719,11,31,9970,31,719,0,0,0,0,0
3.701,6,16,3247,9,49,462,92,563,7,463,40,1448,2684
15.126,6,44,9098,27,213,581,314,4501,17,651,858,1179,4597
12.494,6,1885,1711970,1206,1369,10,1380,1678763,679,387,18,1923,33207
1776.582,17,140,11200,70,48,25747,48,5320,70,56,25747,56,5880
1793.715,17,66,2766,65,14,28026,14,2730,1,8,0,8,36
1.462,6,41,9968,21,440,73,1360,4392,20,433,68,1360,5576
337.293,6,83,30656,40,586,8648,1402,10889,43,796,8030,2804,19767
1763.891,2,15,480,15,8,125992,8,480,0,0,0,0,0
0.096,17,2,180,1,30,0,30,58,1,94,0,94,122
1763.833,6,162,9677,84,40,21251,208,5596,78,31,22903,31,4081
0.583,6,22,7354,13,335,48,668,2026,9,1210,66,1946,5328
155.196,17,7,2352,7,308,25866,308,2352,0,0,0,0,0
773.932,2,8,256,8,8,110561,8,256,0,0,0,0,0
3.462,6,35,8136,18,317,203,636,1703,17,478,206,2128,6433
1779.459,17,140,11200,70,48,25789,48,5320,70,56,25789,56,5880
29.957,6,4153,3938465,2642,1410,11,1448,3855061,1511,776,19,1448,83404
18.049,6,25,8316,9,154,2256,267,832,16,621,1197,1997,7484
300.993,6,53,23303,31,1021,10033,1360,17621,22,399,421,1360,5682
65.468,6,27,7177,13,155,5455,267,1306,14,530,5035,3417,5871
0.077,6,154,192251,18,137,4,334,1348,136,1382,0,2804,190903
136.633,6,47,10879,17,241,3914,1189,2862,30,309,4711,1420,8017
0.215,6,9,1338,5,145,53,145,349,4,825,46,825,989
1741.367,17,30,7050,30,207,60047,207,7050,0,0,0,0,0
11.765,17,8,704,4,48,3918,48,304,4,72,3918,72,400
1.434,6,48,18413,27,834,55,1360,12797,21,433,63,1360,5616
6.467,6,64,20366,33,552,202,1152,15683,31,491,207,1179,4683
1790.246,6,359,22709,209,69,8606,69,12569,150,69,12012,69,10140
787.157,6,47,3710,30,66,27143,66,2190,17,60,48586,60,1520
1738.186,6,74,5392,46,33,38626,33,3187,28,31,64370,31,2205
0.326,6,21,5000,10,137,36,267,1092,11,692,31,1467,3908
33.565,6,4,184,3,0,16782,0,136,1,0,0,0,48
5.282,6,37,7189,19,218,293,314,3383,18,513,293,1179,3806
1799.632,17,448,39896,403,35,4476,288,25676,45,288,40021,288,14220
1787.903,6,372,23574,213,69,8433,69,13005,159,69,11315,69,10569
0.381,6,7,1195,4,448,127,448,628,3,435,100,435,567
301.548,6,64,30400,31,585,10051,1354,4571,33,892,2057,1503,25829
0.441,6,20,7238,13,335,36,668,2026,7,1210,66,1946,5212
79.473,17,7,532,7,48,13245,48,532,0,0,0,0,0
1771.371,6,99,9306,66,66,27251,66,5610,33,60,55352,60,3696
1798.214,6,192,20277,126,107,14385,1221,11835,66,87,27659,485,8442
93.533,6,25,6318,9,272,105,516,1180,16,345,6229,1452,5138
15.643,6,14,5617,5,106,3906,106,314,9,985,1953,1460,5303
1780.268,6,379,29606,217,75,8241,267,13813,162,136,11057,3377,15793
1774.041,6,207,16762,120,69,14907,69,8940,87,49,20628,69,7822
280.444,6,28,7352,12,158,25494,267,1277,16,603,18684,1400,6075
1699.549,1,8,448,8,28,242792,28,448,0,0,0,0,0
661.599,17,132,10032,132,48,5050,48,10032,0,0,0,0,0
1740.294,6,87,6322,58,31,30531,31,3915,29,31,62153,31,2407
1795.989,6,118,7598,70,48,26028,208,4748,48,31,38206,31,2850
64.522,6,87,62661,55,1191,1194,1368,54130,32,840,2073,2736,8531
0.006,6,2,1460,1,0,0,0,40,1,1368,0,1368,1420
369.639,6,25,1651,17,177,23102,177,1117,8,110,9213,110,534
913.515,6,105,8252,54,78,17236,264,4820,51,63,18265,224,3432
0.886,17,2,122,2,33,886,33,122,0,0,0,0,0
280.891,6,34,8992,16,158,18726,267,1437,18,621,16522,1400,7555
25.494,17,5,2152,5,402,6373,548,2152,0,0,0,0,0
14.231,6,100,30375,50,552,290,1152,23536,50,439,284,1179,6839
0.005,17,2,441,1,36,0,36,64,1,349,0,349,377
7.727,17,6,528,3,48,3857,48,228,3,72,3857,72,300
3.487,6,2,88,2,0,0,0,88,0,0,0,0,0
1751.554,6,109,8160,69,38,25758,205,4819,40,32,44905,98,3341
154.115,17,4,352,2,60,154114,60,176,2,60,154114,60,176
300.018,6,43,12086,21,658,14992,1440,4858,22,421,14278,1440,7228
11.037,6,20,4442,11,275,1103,275,998,9,768,777,1440,3444
0.59,6,10,924,5,283,100,283,551,5,105,102,105,373
1796.116,6,356,22520,208,69,8676,69,12460,148,69,12218,69,10060
19.964,6,2026,1818743,1272,1375,15,1380,1779380,754,387,26,1923,39363
0.978,6,10,1687,7,100,163,100,384,3,1179,361,1179,1303
0.2,6,44,20530,25,1037,8,1420,15549,19,526,10,3303,4981
172.758,6,6,604,3,241,86379,241,361,3,61,86287,92,243
1.399,6,49,19278,27,893,53,1460,13622,22,433,57,1460,5656
0.701,6,15,2638,7,288,86,288,600,8,568,70,853,2038
0.035,17,4,284,2,32,18,32,120,2,54,21,60,164
0.063,1,2,163,2,53,63,78,163,0,0,0,0,0
1678.917,1,14,784,14,28,129147,28,784,0,0,0,0,0
5.09,6,38,7245,20,218,267,314,3423,18,516,284,1179,3822
414.036,6,59,4449,24,74,17147,294,2218,35,48,12177,78,2231
1759.232,1,8,448,8,28,251318,28,448,0,0,0,0,0
1796.796,1,342,28728,342,56,5269,56,28728,0,0,0,0,0
280.309,6,29,7392,13,158,23359,267,1317,16,603,18685,1400,6075
324.068,6,35,7192,16,154,11540,516,1724,19,294,17998,1452,5468
0.004,6,4,5828,1,0,0,0,40,3,1877,1,2816,5788
72.883,6,6,328,4,0,24294,0,216,2,0,72870,0,112
2.977,6,7,300,4,0,932,0,168,3,0,1396,0,132
1740.683,17,29,30624,29,1028,62167,1028,30624,0,0,0,0,0
148.366,6,69,46900,44,1179,3450,1408,38866,25,960,2566,3847,8034
2.817,17,3,1176,3,364,1408,364,1176,0,0,0,0,0
88.011,6,18,5709,10,316,9758,722,1512,8,941,12545,2026,4197
280.501,6,30,7432,13,158,23375,267,1317,17,543,17528,1400,6115
0.241,17,2,196,1,62,0,62,90,1,78,0,78,106
0.014,17,2,588,1,39,0,39,67,1,493,0,493,521
1741.626,6,158,11787,85,81,20733,208,7968,73,31,24185,31,3819
6.632,6,33,8968,14,155,510,267,1346,19,456,367,1420,7622
284.168,6,33,8575,13,158,23680,267,1317,20,496,14947,1400,7258
120.828,17,6,528,3,60,60413,60,264,3,60,60413,60,264
2.327,6,2,162,1,0,0,0,40,1,82,0,82,122
1.348,6,37,8218,18,321,79,1168,2682,19,433,65,1360,5536
0.013,17,2,664,1,308,0,308,336,1,300,0,300,328
1779.743,6,102,8228,68,64,26563,64,4896,34,58,53928,58,3332
0.639,6,120,83493,69,1282,9,1432,77162,51,475,12,1871,6331
0.028,17,2,378,1,50,0,50,78,1,272,0,272,300
280.218,17,4,296,2,30,280196,30,116,2,62,280199,62,180
0.017,17,2,602,1,46,0,46,74,1,500,0,500,528
465.877,1,6,336,6,28,93175,28,336,0,0,0,0,0
0.357,17,2,148,1,32,0,32,60,1,60,0,60,88
240.184,6,54,17745,29,785,8577,1402,14861,25,197,10007,580,2884
5.811,6,45,8409,23,227,264,314,4102,22,489,264,1179,4307
0.052,6,17,3176,8,460,6,805,1804,9,224,5,694,1372
6.968,17,5,766,4,32,1331,32,240,1,498,0,498,526
28.986,1,20,560,20,0,0,0,560,0,0,0,0,0
0.045,17,4,284,2,32,27,32,120,2,54,22,60,164
0.401,6,7,288,4,0,133,0,164,3,0,101,0,124
374.735,6,21,920,15,0,26766,0,680,6,0,766,0,240
297.781,6,39,7548,14,168,8542,516,1575,25,248,12403,1452,5973
0.415,6,5,1564,3,413,207,413,946,2,269,191,269,618
0.423,17,3,945,3,287,211,293,945,0,0,0,0,0
280.456,6,30,7432,13,158,23371,267,1317,17,603,17525,2760,6115
17.334,6,8,452,4,0,5778,0,228,4,0,4980,0,224
122.023,6,32,14730,16,488,330,1360,3127,16,1095,8123,2720,11603
240.719,2,3,96,3,8,120359,8,96,0,0,0,0,0
0.133,6,5,248,4,0,0,0,208,1,0,0,0,40
251.644,2,3,96,3,8,125822,8,96,0,0,0,0,0
1745.253,6,95,7203,63,38,28149,205,4476,32,33,56289,98,2727
1799.535,1,13,754,13,30,149961,30,754,0,0,0,0,0
14.747,6,23,5942,12,275,1340,275,1038,11,890,1213,1420,4904
7.093,6,1807,1669647,1144,1381,6,1408,1630507,663,931,10,2801,39140
130.647,17,74,19529,35,465,3842,1350,17261,39,30,3437,60,2268
1749.708,6,153,9339,81,44,21871,208,5560,72,31,24639,31,3779
0.023,6,2,80,1,0,0,0,40,1,0,0,0,40
0.422,6,26,9017,13,261,35,683,1728,13,943,33,1448,7289
226.985,6,125,99064,83,1260,2768,1368,88753,42,738,1919,2519,10311
7.315,2,3,96,3,8,3657,8,96,0,0,0,0,0
0.045,17,4,284,2,32,32,32,120,2,54,34,60,164
1.384,6,23,5975,11,108,138,147,879,12,768,121,1581,5096
1783.681,6,119,12619,76,80,23782,500,5956,43,120,42466,1420,6663
1797.778,1,58,4872,0,0,0,0,0,58,56,31539,56,4872
107.413,17,4,240,2,32,107412,32,120,2,32,107412,32,120
1748.95,6,97,7307,63,38,28208,205,4476,34,33,52989,98,2831
1749.987,17,13,534,11,14,174980,14,462,2,8,1743529,8,72
139.365,6,26,10785,14,608,61,1360,3635,12,951,12655,1708,7150
0.318,6,27,8926,13,231,26,563,1620,14,938,23,1408,7306
7.847,6,14,1247,7,222,1306,222,728,7,231,1305,231,519
280.611,6,28,7352,13,158,23384,267,1317,15,678,20040,3436,6035
0.859,6,14,2598,7,288,107,288,600,7,568,93,853,1998
0.47,1,9,756,9,56,58,56,756,0,0,0,0,0
571.497,1,6,489,6,53,114299,78,489,0,0,0,0,0
0.871,17,2,362,1,46,0,46,74,1,260,0,260,288
1771.061,6,86,8003,57,65,31626,65,4784,29,59,63248,59,3219
1793.717,6,288,37190,118,147,15329,1360,17751,170,146,10612,2720,19439
0.049,17,2,169,1,34,0,34,62,1,79,0,79,107
1796.161,17,449,39928,404,35,4456,288,25708,45,288,40022,288,14220
1.935,17,6,936,3,64,967,64,276,3,192,948,192,660
0.221,17,11,4971,5,474,55,1350,2512,6,381,31,1350,2459
35.299,6,68,53334,41,1356,882,1448,46917,27,715,1357,1448,6417
15.36,6,19,6540,6,154,3072,267,712,13,588,1266,1942,5828
0.628,6,16,1825,8,288,60,288,640,8,284,64,434,1185
1681.68,17,16,1265,8,30,240238,37,471,8,71,240237,136,794
256.988,6,40,4433,22,171,12237,595,2365,18,220,15116,580,2068
1772.987,6,181,15589,120,69,14899,69,8940,61,69,29546,69,6649
3.781,6,27,6945,13,248,307,517,1703,14,642,283,1368,5242
10.811,6,20,4390,11,275,1081,275,998,9,755,749,1414,3392
4.364,6,66,31961,37,1059,121,1460,25896,29,400,144,1460,6065
240.241,6,53,18037,28,819,8897,1418,15387,25,167,10009,580,2650
11.693,6,1855,1616114,1130,1376,10,1420,1582893,725,467,16,1883,33221
6.206,6,40,7309,21,218,310,314,3463,19,513,330,1179,3846
0.034,17,3,244,2,32,20,32,120,1,96,0,96,124
3.84,17,5,295,5,31,960,31,295,0,0,0,0,0
66.287,6,36,7882,14,155,5099,267,1346,22,332,3156,1420,6536
478.24,6,97,30878,50,586,9759,1402,11405,47,740,10396,2485,19473
5.599,6,39,7269,20,218,294,314,3423,19,513,297,1179,3846
0.795,6,27,5927,13,156,66,267,1462,14,650,56,1420,4465
57.621,6,27,7177,13,155,4801,267,1306,14,530,4431,3417,5871
82.056,17,4,352,2,60,82055,60,176,2,60,82055,60,176
1788.974,6,256,37643,157,302,11467,302,27222,99,83,18254,83,10421
280.182,6,29,7392,13,158,23348,267,1317,16,603,18678,2236,6075
46.404,17,8,608,8,48,6629,48,608,0,0,0,0,0
32.109,6,8,591,1,0,0,0,40,7,67,5332,69,551
4.415,17,2,656,2,300,4415,300,656,0,0,0,0,0
1.684,6,25,8711,15,276,120,561,1433,10,982,167,1420,7278
125.742,2,2,64,2,8,125742,8,64,0,0,0,0,0
0.282,17,4,560,2,64,172,64,184,2,160,190,160,376
0.917,17,4,624,2,64,916,64,184,2,192,798,192,440
1778.033,6,191,16265,125,69,14338,69,9278,66,69,27351,69,6987
705.395,6,38,3494,24,323,30669,582,1902,14,282,18658,580,1592
0.071,6,126,157614,29,143,2,352,1938,97,1602,0,2804,155676
369.044,6,25,1651,17,177,23065,177,1117,8,110,9220,110,534
0.576,17,4,624,2,64,345,64,184,2,192,351,192,440
0.48,17,3,451,2,39,308,39,134,1,289,0,289,317
6.306,6,32,7587,14,170,485,267,1763,18,566,368,1380,5824
161.698,6,20,3556,4,92,265,92,308,16,185,10768,1408,3248
72.836,17,8,10972,8,1343,10405,1346,10972,0,0,0,0,0
280.048,6,28,7352,13,158,23337,267,1317,15,678,20000,2045,6035
0.406,17,2,152,1,48,0,48,76,1,48,0,48,76
158.158,6,19,1865,9,177,19769,177,1007,10,110,17544,110,858
3.969,17,4,240,4,32,1323,32,240,0,0,0,0,0
535.728,1,18,1908,18,78,31513,78,1908,0,0,0,0,0
0.087,17,2,470,1,46,0,46,74,1,368,0,368,396
1772.122,6,182,15629,121,69,14767,69,8980,61,69,29531,69,6649
590.503,6,33,2386,19,31,32796,31,1267,14,31,45410,31,1119
1740.491,1,15,840,15,28,124320,28,840,0,0,0,0,0
240.317,6,54,17936,28,802,8900,1418,15098,26,184,9612,580,2838
1.303,6,50,21408,29,912,46,1360,15792,21,476,56,2715,5616
0.026,17,4,284,2,32,21,32,120,2,54,22,60,164
1797.109,1,198,11088,198,28,9122,28,11088,0,0,0,0,0
1773.16,6,180,15480,120,69,14900,69,8940,60,69,30050,69,6540
1720.41,17,12,498,11,14,172041,14,462,1,8,0,8,36
20.744,17,32,22007,14,671,1592,1350,9790,18,650,1214,1350,12217
0.225,1,2,112,2,28,225,28,112,0,0,0,0,0
560.435,17,8,2061,4,31,186808,37,239,4,427,186808,463,1822
1745.166,6,102,7995,67,45,26441,205,4948,35,35,51316,98,3047
185.76,1,10,560,10,28,20640,28,560,0,0,0,0,0
1.553,6,16,1237,10,182,172,182,754,6,77,227,134,483
0.151,6,12,3704,6,171,18,171,491,6,964,29,1448,3213
0.332,17,2,152,1,48,0,48,76,1,48,0,48,76
0.897,6,6,312,4,0,299,0,208,2,0,439,0,104
1745.623,6,95,7203,63,38,28155,205,4476,32,33,56297,98,2727
1764.559,2,14,448,14,8,135735,8,448,0,0,0,0,0
4.304,6,110,88341,47,131,93,232,2409,63,1463,69,2840,85932
1773.329,6,180,15480,120,69,14901,69,8940,60,69,30051,69,6540
1789.957,6,356,22520,208,69,8647,69,12460,148,69,12176,69,10060
3.727,17,5,295,5,31,931,31,295,0,0,0,0,0
241.581,6,30,7432,13,158,20131,267,1317,17,543,15097,1400,6115
0.161,17,2,158,1,34,0,34,62,1,68,0,68,96
11.838,6,25,8473,13,275,986,275,1078,12,986,862,1440,7395
0.137,17,4,284,2,32,0,32,120,2,54,0,60,164
0.771,6,2,80,2,0,0,0,80,0,0,0,0,0
367.553,6,41,7013,23,188,16706,517,4413,18,411,8109,499,2600
0.737,6,26,5680,14,121,56,267,1295,12,650,61,1420,4385
25.672,6,636,562805,395,1354,64,1368,544809,241,776,106,2736,17996
6.435,6,7,400,3,0,3217,0,160,4,0,1331,0,240
701.053,6,83,7003,32,88,22612,348,3749,51,48,14021,78,3254
0.221,17,2,154,1,33,0,33,61,1,65,0,65,93
1764.007,2,15,480,15,8,126000,8,480,0,0,0,0,0
0.024,17,2,192,1,60,0,60,88,1,76,0,76,104
357.219,17,6,528,3,60,178609,60,264,3,60,178608,60,264
1.761,6,24,5755,13,158,146,370,1315,11,799,175,1420,4440
105.117,6,48,11230,21,366,3146,1189,4142,27,400,4041,3457,7088
161.987,17,2,122,2,33,161987,33,122,0,0,0,0,0
0.194,6,46,21183,26,1078,7,1420,16162,20,467,9,1883,5021
192.489,6,212,170321,137,1290,1415,1408,155519,75,680,1746,2816,14802
0.335,17,11,7680,5,605,83,1350,3165,6,724,40,1350,4515
10.356,6,1870,1735854,1192,1378,8,1408,1695934,678,931,15,2801,39920
280.616,6,30,7773,14,158,21585,267,1357,16,577,18706,1400,6416
1.265,6,10,767,5,186,315,186,454,5,45,313,45,313
1790.835,1,266,14896,266,28,6757,28,14896,0,0,0,0,0
2.217,6,13,2311,8,188,316,245,700,5,1407,491,1407,1611
0.306,17,2,212,1,46,0,46,74,1,110,0,110,138
1752.154,6,99,7808,65,45,27377,205,4844,34,35,53087,98,2964
1785.527,1,58,4872,58,56,31325,56,4872,0,0,0,0,0
8.258,6,1691,1569682,1074,1384,7,1408,1532934,617,931,13,2816,36748
71.041,6,22,9920,11,433,74,990,1771,11,1099,7090,1440,8149
1779.486,6,217,25753,135,104,13279,469,12608,82,126,21964,1420,13145
1665.607,1,50,2800,50,28,33991,28,2800,0,0,0,0,0
2.51,6,14,2351,8,188,358,245,700,6,703,453,1152,1651
1681.321,17,14,3843,7,30,280219,30,406,7,463,280219,463,3437
0.005,17,2,408,1,59,0,59,87,1,293,0,293,321
0.479,17,2,152,1,48,0,48,76,1,48,0,48,76
10.465,6,2142,1992369,1323,1425,7,1448,1945081,819,776,12,1448,47288
0.025,17,2,136,1,32,0,32,60,1,48,0,48,76
1785.861,6,358,22669,209,69,8585,69,12500,149,69,12066,69,10169
1.323,6,26,5887,14,156,101,267,1502,12,650,113,1420,4385
0.442,17,18,9640,9,483,53,1350,4605,9,531,51,1350,5035
6.92,6,27,7390,11,156,692,267,1232,16,459,460,3426,6158
77.476,6,15,1071,5,177,19369,177,433,10,110,8589,110,638
0.656,17,2,146,1,37,0,37,65,1,53,0,53,81
1788.851,17,83,3480,82,14,22084,14,3444,1,8,0,8,36
261.349,6,1482,759453,833,845,314,1152,726624,649,403,402,1179,32829
4.256,6,40,7309,21,218,212,314,3463,19,440,222,1152,3846
1781.545,1,255,14280,255,28,7013,28,14280,0,0,0,0,0
2.453,17,24,9201,10,380,272,1350,4084,14,337,142,1350,5117
0.114,17,2,166,1,39,0,39,67,1,71,0,71,99
0.734,6,23,5974,12,108,66,147,919,11,922,68,1581,5055
1792.381,6,356,22520,208,69,8658,69,12460,148,69,12192,69,10060
5.96,6,40,7309,20,218,313,314,3423,20,513,297,1179,3886
8.249,6,8,578,5,125,2062,245,454,3,0,3169,0,124
254.388,6,12,724,4,106,84792,106,274,8,90,36339,90,450
3.816,17,10,1263,5,31,950,31,295,5,165,951,196,968
1798.216,17,447,39580,403,35,4473,288,25676,44,288,40952,288,13904
196.79,6,57,11086,23,224,8945,1189,3171,34,261,5953,1460,7915
8.207,6,22,6726,6,154,1641,267,712,16,447,541,1452,6014
1.35,6,46,18998,25,950,56,1460,13382,21,433,57,1460,5616
0.293,17,4,368,2,32,58,32,120,2,96,67,96,248
1772.185,6,180,15480,120,69,14892,69,8940,60,69,30035,69,6540
24.099,6,17,2365,9,324,3012,585,1133,8,396,3419,580,1232
7.871,2,3,96,3,8,3935,8,96,0,0,0,0,0
31.188,1,33,3432,0,0,0,0,0,33,76,974,76,3432
1687.921,1,7,742,7,78,281320,78,742,0,0,0,0,0
2.541,6,14,2351,8,188,363,245,700,6,703,456,1152,1651
1.741,6,29,8315,15,225,112,561,1997,14,957,120,1631,6318
0.994,17,2,925,1,548,0,548,576,1,321,0,321,349
0.237,17,3,451,2,39,113,39,134,1,289,0,289,317
1772.982,6,180,15480,120,69,14899,69,8940,60,69,30048,69,6540
1798.628,17,144,11520,72,48,25332,48,5472,72,56,25332,56,6048
1784.164,1,342,28728,342,56,5232,56,28728,0,0,0,0,0
0.314,17,12,6473,6,615,62,1350,3859,6,407,39,1350,2614
4.762,6,416,316001,204,884,23,1440,19568,212,1425,21,2880,296433
1790.07,17,87,3648,86,14,21059,14,3612,1,8,0,8,36
1.09,6,23,7952,12,164,84,267,1288,11,1216,93,3819,6664
2.078,17,2,677,1,300,0,300,328,1,321,0,321,349
0.424,6,24,6041,13,108,35,147,959,11,773,40,1608,5082
3.217,6,46,20596,23,525,146,1440,3650,23,889,131,1440,16946
73.798,6,22,6504,9,217,9218,517,1344,13,641,6145,1418,5160
1739.342,6,87,6322,58,31,30514,31,3915,29,31,62118,31,2407
1.024,6,10,861,5,222,251,222,426,5,231,251,231,435
1.128,6,25,8056,12,164,87,267,1288,13,869,79,1402,6768
240.208,6,56,17693,30,731,8282,1408,14732,26,200,9608,580,2961
381.238,17,28,4588,14,48,29325,48,1064,14,223,29325,308,3524
1.371,6,37,8214,19,321,76,1164,2718,18,476,70,2715,5496
628.234,6,269,59008,127,472,4985,1360,40438,142,169,4454,1360,18570
96.82,6,899,450678,493,846,196,1152,429647,406,435,238,1179,21031
1681.232,17,14,3843,7,30,280203,30,406,7,463,280203,463,3437
0.65,17,18,12954,9,740,81,1350,6919,9,642,62,1350,6035
11.641,6,1835,1601575,1108,1390,10,1420,1568262,727,467,16,1883,33313
66.292,6,9018,8557509,5601,1441,11,1448,8355849,3417,776,19,1448,201660
42.72,6,11,827,5,275,10680,275,479,6,96,8375,96,348
1.369,6,42,10065,23,440,62,1360,4484,19,437,65,2720,5581
1786.542,6,109,8706,70,65,25891,65,5140,39,59,47010,59,3566
5.008,17,4,530,2,36,5003,36,128,2,173,5002,187,402
300.737,6,41,13619,23,893,13669,1360,8097,18,435,505,2667,5522
3.92,6,24,5755,13,158,301,370,1315,11,799,359,1460,4440
0.103,6,11,913,6,182,20,182,490,5,77,17,134,423
1786.137,17,87,3648,86,14,21013,14,3612,1,8,0,8,36
12.303,6,3,242,0,0,0,0,0,3,61,6151,91,242
1794.037,6,1224,219122,802,304,2239,304,164004,422,83,4261,83,55118
1695.422,17,16,1265,8,30,242201,37,471,8,71,242201,136,794
1795.509,17,449,39928,404,35,4455,288,25708,45,288,40018,288,14220
1667.537,1,7,392,7,28,277922,28,392,0,0,0,0,0
280.423,6,31,7813,13,158,23368,267,1317,18,524,16494,1400,6496
0.046,6,3,327,2,103,0,138,287,1,0,0,0,40
1.062,17,2,244,2,94,1062,94,244,0,0,0,0,0
154.22,6,11,452,3,0,574,0,124,8,0,22029,0,328
204.07,17,2,148,2,46,204070,46,148,0,0,0,0,0
120.795,6,12,2271,7,188,20132,245,660,5,1407,30135,1407,1611
1794.874,6,240,46440,150,483,12046,483,36780,90,83,20166,83,9660
6.016,17,4,724,2,41,6009,41,138,2,265,6009,265,586
1776.907,17,73,3060,72,14,25026,14,3024,1,8,0,8,36
1795.686,17,448,39896,403,35,4466,288,25676,45,288,40019,288,14220
0.229,17,8,2758,8,316,32,355,2758,0,0,0,0,0
1779.62,6,354,22440,207,69,8638,69,12420,147,69,12189,69,10020
125.428,6,17,3347,8,92,17918,92,504,9,338,15652,1448,2843
364.444,6,21,1419,15,177,26031,177,989,6,110,12225,110,430
12.522,6,1765,1644943,1156,1372,10,1380,1614481,609,383,20,1380,30462
1673.228,1,8,448,8,28,239032,28,448,0,0,0,0,0
0.082,17,3,543,2,39,76,39,134,1,381,0,381,409
1786.706,6,106,8456,68,65,26667,65,4930,38,59,48285,59,3526
1789.272,17,142,11360,71,48,25560,48,5396,71,56,25560,56,5964
1.333,6,50,20022,28,880,49,1360,14366,22,476,55,2715,5656
1.182,6,24,6635,13,350,98,1088,2275,11,783,117,1420,4360
1773.561,6,188,16076,123,69,14537,69,9129,65,69,27710,69,6947
307.779,6,162,99044,89,1255,3497,1360,90338,73,303,216,1360,8706
840.643,17,8,592,4,30,280207,30,232,4,62,280205,62,360
231.608,17,4,288,2,36,231594,36,128,2,52,231234,52,160
230.259,17,8,1176,4,48,76750,48,304,4,190,76749,308,872
1791.118,1,228,12768,228,28,7890,28,12768,0,0,0,0,0
225.583,6,6606,7537975,1926,611,117,627,121083,4680,1535,44,20272,7416892
39.869,17,22,1936,11,48,3985,48,836,11,72,3985,72,1100
1.014,6,31,12061,18,517,59,1360,3364,13,907,70,3921,8697
1022.796,2,9,288,9,8,127849,8,288,0,0,0,0,0
1789.361,17,128,10240,64,48,28402,48,4864,64,56,28402,56,5376
280.212,6,27,7312,13,158,23351,267,1317,14,775,21551,4200,5995
2.366,6,13,2311,8,188,338,245,700,5,1407,532,1407,1611
6.169,6,42,7389,22,218,293,314,3503,20,513,311,1179,3886
59.067,17,6,2016,6,308,11813,308,2016,0,0,0,0,0
1776.304,17,139,11116,70,48,25743,48,5320,69,56,26121,56,5796
6.819,17,24,9286,10,381,757,1350,4093,14,342,366,1350,5193
1.327,6,47,19573,27,920,51,1460,13997,20,433,60,1460,5576
7.431,6,26,7137,12,155,675,267,1266,14,530,571,2006,5871
1.051,6,28,8160,15,222,62,540,1964,13,944,71,1591,6196
287.717,6,29,6801,13,274,23972,517,1508,16,744,19178,1418,5293
295.79,6,33,7966,12,158,26890,267,1277,21,417,14788,2045,6689
297.78,17,4,240,2,32,297779,32,120,2,32,297779,32,120
300.835,6,38,8593,20,322,15833,941,2120,18,441,504,1440,6473
1795.557,17,447,39580,403,35,4466,288,25676,44,288,40950,288,13904
1783.813,6,414,24840,208,69,8617,69,12460,206,35,8701,69,12380
300.829,6,48,20078,28,1024,11141,1360,14476,20,435,455,2720,5602
281.282,6,30,7432,14,158,21637,267,1357,16,603,18748,2036,6075
3.281,6,2,88,2,0,0,0,88,0,0,0,0,0
0.06,17,2,214,1,39,0,39,67,1,119,0,119,147
22.571,6,26,6335,14,117,1736,159,1337,12,727,2050,1418,4998
1735.845,6,411,26031,224,69,7784,69,14549,187,69,9331,69,11482
1799.206,17,448,39896,403,35,4475,288,25676,45,288,40017,288,14220
32.097,6,38,8535,18,410,649,882,1982,20,441,1682,1460,6553
12.782,6,2124,1906436,1309,1375,9,1408,1859392,815,776,15,1408,47044
97.51,17,8,641,5,31,24374,37,297,3,86,47680,136,344
300.579,6,55,41162,25,443,12524,1162,3080,30,1460,3207,4224,38082
1681.624,1,15,840,15,28,120116,28,840,0,0,0,0,0
1797.612,6,2099,2254798,749,145,2403,850,50288,1350,1672,1332,8412,2204510
0.008,17,2,168,1,48,0,48,76,1,64,0,64,92
1772.509,6,180,15480,120,69,14895,69,8940,60,69,30038,69,6540
300.807,6,40,8478,22,258,14324,688,1959,18,445,508,1928,6519
8.178,6,14,1247,7,222,1361,222,728,7,231,1361,231,519
1786.304,17,87,3648,86,14,21015,14,3612,1,8,0,8,36
0.153,17,2,348,1,39,0,39,67,1,253,0,253,281
300.666,6,57,21543,28,501,11135,1082,4055,29,694,1455,1491,17488
1787.54,17,140,11200,70,48,25906,48,5320,70,56,25906,56,5880
0.441,17,6,534,3,37,217,37,195,3,85,215,89,339
0.981,6,29,8360,16,263,54,586,2250,13,929,67,3132,6110
1781.703,1,274,15344,274,28,6526,28,15344,0,0,0,0,0
10.461,6,17,2779,10,411,1162,411,943,7,1440,1513,1440,1836
1.745,6,29,8722,14,135,134,267,1377,15,842,119,1420,7345
0.403,6,4,1037,2,0,211,0,104,2,853,195,853,933
4.642,6,40,7309,21,218,232,314,3463,19,440,244,1152,3846
1795.266,17,80,3354,79,14,23016,14,3318,1,8,0,8,36
280.404,6,31,7472,13,158,23367,267,1317,18,603,16491,2076,6155
192.116,6,36,10010,14,152,14776,267,1484,22,449,9147,1926,8526
0.087,6,12,1845,7,139,14,139,511,5,533,12,904,1334
133.823,6,31,8912,14,158,10294,267,1357,17,687,8360,1400,7555
804.317,6,16,2317,10,241,89368,241,1617,6,92,160826,92,700
0.157,6,46,22309,27,1081,6,1420,17328,19,467,8,1883,4981
0.299,6,10,1380,5,145,74,145,349,5,827,64,827,1031
0.004,17,2,120,1,32,0,32,60,1,32,0,32,60
1.195,17,2,154,1,33,0,33,61,1,65,0,65,93
0.687,17,2,925,1,548,0,548,576,1,321,0,321,349
12.66,6,11,676,3,106,6325,106,234,8,90,1807,90,442
0.423,17,2,178,1,29,0,29,57,1,93,0,93,121
1774.384,17,140,11200,70,48,25715,48,5320,70,56,25715,56,5880
1770.745,6,100,9424,67,66,26829,66,5728,33,60,55323,60,3696
1.694,6,14,2351,8,188,242,245,700,6,703,284,1152,1651
2.768,17,4,1560,4,362,922,362,1560,0,0,0,0,0
3.307,17,8,2750,8,315,472,354,2750,0,0,0,0,0
0.14,17,3,949,3,288,70,316,949,0,0,0,0,0
1796.206,17,449,39928,404,35,4457,288,25708,45,288,40009,288,14220
1798.023,17,450,39960,405,35,4450,288,25740,45,288,40021,288,14220
650.383,17,101,17844,51,48,13006,48,3876,50,251,13272,308,13968
1.973,6,52,14375,26,543,78,1429,5417,26,494,75,4906,8958
69.624,6,30,8814,16,481,73,1163,2140,14,678,5339,4080,6674
1786.366,6,142,19577,86,224,21016,1286,13082,56,98,32477,267,6495
18.911,6,870,724235,545,1255,34,1368,702671,325,776,57,2736,21564
0.508,6,15,5925,7,186,83,267,661,8,987,71,1997,5264
281.994,6,28,7352,12,158,25635,267,1277,16,603,18775,1400,6075
599.654,6,34,9410,21,283,29982,1408,5074,13,608,49954,1955,4336
4.833,6,37,7189,19,218,268,314,3383,18,513,255,1179,3806
4.999,17,2,672,2,308,4999,308,672,0,0,0,0,0
32.673,6,24,8026,12,523,2970,1050,2213,12,740,2960,1491,5813
16.301,17,16,6363,8,492,2324,1350,4165,8,246,2324,1350,2198
1773.152,17,308,70178,308,199,5775,422,70178,0,0,0,0,0
317.044,6,47,12301,22,267,15097,1305,3316,25,419,13204,4649,8985
240.293,6,41,8489,21,519,12014,1402,5778,20,237,12646,618,2711
1798.08,6,363,24414,212,88,8521,469,14027,151,69,11986,69,10387
2.001,6,325,270305,201,1338,10,1420,261042,124,534,16,3303,9263
1.002,6,37,8489,19,277,55,762,1900,18,450,51,1360,6589
6.091,6,14,2351,8,188,870,245,700,6,703,1162,1152,1651
10.769,6,3366,2656209,1625,221,6,230,91271,1741,1425,6,5632,2564938
3.206,17,10,1415,5,31,800,31,295,5,196,800,196,1120
0.319,6,27,9059,13,252,26,647,1704,14,945,24,1408,7355
280.437,6,30,7432,13,158,23369,267,1317,17,678,17523,3456,6115
317.029,6,73,18886,37,311,8806,1360,9327,36,352,9053,2720,9559
125.446,17,4,1344,4,308,41815,308,1344,0,0,0,0,0
0.379,17,2,154,1,33,0,33,61,1,65,0,65,93
1745.972,6,95,7203,63,38,28160,205,4476,32,33,56308,98,2727
0.119,17,2,136,1,32,0,32,60,1,48,0,48,76
1797.207,17,144,11520,72,48,25312,48,5472,72,56,25312,56,6048
0.833,6,11,1727,7,100,138,100,384,4,589,184,1152,1343
0.189,6,32,7909,17,278,11,517,1815,15,609,13,3303,6094
0.696,6,7,423,4,43,206,43,259,3,0,45,0,164
1772.308,6,180,15480,120,69,14893,69,8940,60,69,30032,69,6540
1769.751,6,100,9292,66,65,27226,65,5577,34,59,53625,59,3715
1786.286,17,87,3648,86,14,21015,14,3612,1,8,0,8,36
2.619,1,30,840,30,0,0,0,840,0,0,0,0,0
2.967,17,4,352,2,60,2966,60,176,2,60,2966,60,176
2.291,6,7,380,4,0,763,0,216,3,0,1091,0,164
1773.234,6,180,15480,120,69,14901,69,8940,60,69,30048,69,6540
11.364,6,1835,1572163,1110,1363,10,1380,1538921,725,421,15,1923,33242
4.75,6,37,7205,19,218,263,314,3383,18,516,264,1179,3822
3.707,17,5,340,5,40,926,40,340,0,0,0,0,0
504.635,2,4,128,4,8,168211,8,128,0,0,0,0,0
1.519,6,49,19270,27,893,58,1360,13614,22,433,62,1360,5656
1788.649,1,226,12656,226,28,7949,28,12656,0,0,0,0,0
17.171,17,11,13844,1,1350,0,1350,1378,10,1218,1904,1350,12466
251.695,6,57,13636,26,605,10067,1408,9868,31,214,8389,611,3768
1783.813,6,361,23290,210,75,8534,501,13110,151,69,11892,69,10180
1770.759,6,101,9278,66,64,27242,64,5544,35,58,52078,58,3734
1.86,6,37,13067,19,511,103,1460,3379,18,813,99,1460,9688
1681.328,17,16,1265,8,30,240187,37,471,8,71,240187,136,794
21.716,6,21,3182,12,183,1974,517,1561,9,381,2710,499,1621
245.04,17,4,352,2,60,245038,60,176,2,60,245038,60,176
464.118,17,115,11800,51,127,9282,1350,7928,64,32,6640,61,3872
75.617,1,9,504,9,28,9452,28,504,0,0,0,0,0
840.959,6,188,12738,84,46,10132,46,5266,104,46,8163,46,7472
5.774,6,40,7309,21,218,288,314,3463,19,513,305,1179,3846
316.643,6,79,17208,41,279,7916,1460,7832,38,313,8553,3098,9376
504.46,2,4,128,4,8,168153,8,128,0,0,0,0,0
9.58,6,25,7156,8,154,1368,267,792,17,516,585,1452,6364
340.203,6,23,6160,9,267,95,501,1165,14,369,26162,1420,4995
2.666,6,11,631,5,43,666,43,311,6,0,520,0,320
6.887,6,3,553,1,302,0,302,354,2,83,6887,83,199
0.421,6,8,335,4,0,140,0,164,4,7,68,7,171
0.003,17,8,1670,8,180,0,219,1670,0,0,0,0,0
15.348,17,18,10303,9,547,1910,1350,5179,9,541,1908,1350,5124
180.228,6,22,8019,11,525,90,1237,2048,11,919,18006,1591,5971
11.733,6,1854,1623205,1127,1386,10,1420,1589904,727,526,16,3303,33301
10.792,6,6,328,4,0,3597,0,216,2,0,10776,0,112
1587.404,1,30,1680,30,28,54738,28,1680,0,0,0,0,0
17.76,6,1974,1746924,1227,1368,14,1380,1710778,747,468,23,3303,36146
0.14,6,10,1677,6,555,27,951,1354,4,159,46,159,323
60.396,6,14,3888,8,127,8628,127,467,6,1056,12067,1704,3421
37.444,17,4,352,2,60,37443,60,176,2,60,37442,60,176
0.196,6,4,493,2,241,196,241,321,2,92,2,92,172
10.5,17,4,352,2,48,10472,48,152,2,72,10479,72,200
0.278,17,2,138,1,33,0,33,61,1,49,0,49,77
1.295,6,47,18410,27,837,49,1360,12834,20,476,59,2720,5576
1.001,6,28,5996,13,161,83,267,1491,15,650,66,1420,4505
1798.595,1,59,4956,0,0,0,0,0,59,56,31010,56,4956
0.205,17,2,154,1,33,0,33,61,1,65,0,65,93
3.313,17,4,240,4,32,1104,32,240,0,0,0,0,0
5.036,17,4,415,2,37,5001,37,130,2,114,5012,124,285
325.914,6,70,51519,47,1209,7085,1368,43587,23,841,2816,2736,7932
0.102,17,2,204,1,34,0,34,62,1,114,0,114,142
10.868,6,20,4442,11,275,1086,275,998,9,768,761,1440,3444
4.212,6,39,7269,19,218,234,314,3383,20,440,208,1152,3886
1741.165,6,84,6104,56,31,31657,31,3780,28,31,64487,31,2324
17.242,17,25,5530,12,225,1564,1350,3044,13,163,1434,1350,2486
0.024,17,4,284,2,32,16,32,120,2,54,15,60,164
1798.111,17,448,39612,404,35,4461,288,25708,44,288,40953,288,13904
0.09,17,2,2754,2,1349,90,1349,2754,0,0,0,0,0
1.695,17,5,625,3,31,845,31,177,2,196,99,196,448
0.535,6,12,1653,6,288,101,288,548,6,426,58,434,1105
191.218,17,4,352,2,60,191217,60,176,2,60,191217,60,176
1.307,6,41,11972,22,613,62,1360,6436,19,433,63,1360,5536
36.146,17,20,1760,10,48,4015,48,760,10,72,4015,72,1000
314.523,6,169,134842,109,1291,2912,1408,119394,60,724,2602,1408,15448
1788.414,6,416,24920,208,69,8639,69,12460,208,34,8639,48,12460
1.673,6,58,17922,29,767,59,1460,8853,29,438,58,1460,9069
1681.609,17,14,1036,7,30,280266,30,406,7,62,280265,62,630
1.453,6,12,971,6,248,289,248,492,6,231,289,231,479
280.301,6,30,7432,14,158,21561,267,1357,16,603,18682,2800,6075
0.021,17,2,229,1,48,0,48,76,1,125,0,125,153
240.246,6,56,17939,29,742,8579,1418,14888,27,204,9239,580,3051
1742.423,1,15,870,15,30,124458,30,870,0,0,0,0,0
1777.398,6,78,4108,39,26,46772,26,2054,39,26,46772,26,2054
0.155,1,2,112,2,28,155,28,112,0,0,0,0,0
1773.436,6,180,15480,120,69,14902,69,8940,60,69,30055,69,6540
1740.3,6,87,6322,58,31,30531,31,3915,29,31,62151,31,2407
6.974,6,30,7504,12,155,634,267,1266,18,393,409,1420,6238
317.035,6,72,19053,38,325,8568,1360,9712,34,398,9602,1929,9341
11.875,6,1764,1632382,1154,1363,10,1420,1603655,610,534,19,3303,28727
0.198,17,2,178,1,29,0,29,57,1,93,0,93,121
0.031,17,4,284,2,32,24,32,120,2,54,24,60,164
5.706,6,43,8345,21,227,285,314,4022,22,429,259,1152,4323
0.007,6,2,258,1,178,0,178,218,1,0,0,0,40
1788.605,17,83,3480,82,14,22081,14,3444,1,8,0,8,36
0.108,17,6,2117,6,324,21,354,2117,0,0,0,0,0
1794.627,6,244,35804,152,302,11884,302,26032,92,83,19721,83,9772
124.146,17,4,352,2,60,124145,60,176,2,60,124144,60,176
6.603,6,43,8329,22,227,314,314,4062,21,489,316,1179,4267
1721.456,17,277,53996,277,166,6237,422,53996,0,0,0,0,0
413.289,17,8,673,4,31,137752,37,239,4,80,137752,136,434
1799.337,1,57,4788,57,56,32131,56,4788,0,0,0,0,0
236.971,6,23,2653,13,324,19747,585,1333,10,396,26323,580,1320
1683.08,17,18,1494,9,31,210383,37,536,9,78,210383,136,958
0.185,6,46,20204,26,1008,7,1420,15183,20,467,9,1883,5021
264.074,1,2,112,2,28,264074,28,112,0,0,0,0,0
37.285,6,43,9794,22,289,1775,721,3493,21,681,1813,1440,6301
250.743,17,4,352,2,60,250742,60,176,2,60,250742,60,176
230.955,17,4,352,2,60,230954,60,176,2,60,230954,60,176
0.464,6,13,1693,7,288,74,288,588,6,426,50,434,1105
18.307,17,31,6956,14,236,1402,1350,3697,17,163,1139,1350,3259
1783.71,6,120,15138,76,193,23782,1291,10374,44,79,41479,241,4764
1.382,6,50,19382,27,898,53,1360,13686,23,433,54,1360,5696
1.018,6,18,6106,11,241,101,498,1411,7,882,157,2642,4695
37.748,17,22,1936,11,48,3773,48,836,11,72,3773,72,1100
316.586,6,64,4211,35,75,9311,138,2228,29,68,11306,69,1983
2.505,17,3,507,2,39,1977,39,134,1,345,0,345,373
15.821,17,19,11672,10,914,1753,1350,9424,9,221,1972,1350,2248
1784.866,6,359,22709,209,69,8581,69,12569,150,69,11978,69,10140
141.254,17,8,2704,8,310,20179,318,2704,0,0,0,0,0
280.175,6,27,7312,12,158,25470,267,1277,15,678,20010,2800,6035
3.99,17,4,240,4,32,1330,32,240,0,0,0,0,0
0.03,17,4,368,2,32,10,32,120,2,96,12,96,248
1.759,6,13,2311,8,188,251,245,700,5,1407,374,1407,1611
1081.011,17,212,16112,212,48,5123,48,16112,0,0,0,0,0
33.993,17,20,1760,10,48,3776,48,760,10,72,3776,72,1000
1785.203,6,344,21902,200,69,8970,69,12071,144,69,12482,69,9831
0.689,17,24,9532,11,359,65,1350,4259,13,377,54,1350,5273
53.633,17,6,456,6,48,10726,48,456,0,0,0,0,0
1798.125,17,449,39928,404,35,4461,288,25708,45,288,40017,288,14220
51.188,6,9,2889,5,92,12797,92,348,4,2329,17002,2329,2541
497.126,1,12,672,12,28,45193,28,672,0,0,0,0,0
0.017,17,2,189,1,30,0,30,58,1,103,0,103,131
1107.235,6,222,15201,127,77,8462,405,8038,95,84,11779,421,7163
36.566,6,27,7177,13,155,3047,267,1306,14,530,2812,3417,5871
0.233,17,2,170,1,37,0,37,65,1,77,0,77,105
1797.261,6,145,14033,85,64,21395,722,7086,60,78,30458,1408,6947
1790.575,6,4317,4010393,1930,137,928,358,122202,2387,1628,750,7040,3888191
1.303,6,25,9552,14,350,100,1041,1992,11,1015,107,1460,7560
53.373,2,2,64,2,8,53373,8,64,0,0,0,0,0
628.916,6,233,40581,153,304,4137,304,30180,80,83,7953,83,10401
79.978,6,28,11587,16,558,282,1360,4025,12,1010,7257,4428,7562
240.196,6,53,17982,28,796,8895,1402,14999,25,209,10007,580,2983
1771.671,6,101,9410,66,66,27256,66,5610,35,60,52105,60,3800
71.247,6,33,11245,14,700,140,1368,4236,19,400,3946,1368,7009
4.808,6,39,7269,20,218,253,314,3423,19,513,252,1179,3846
70.644,17,6,2000,6,305,14128,308,2000,0,0,0,0,0
1789.007,17,87,3648,86,14,21047,14,3612,1,8,0,8,36
0.892,6,170,124415,97,1317,9,1432,117204,73,475,12,1871,7211
0.011,17,3,560,2,60,4,60,176,1,356,0,356,384
89.503,6,44,8843,21,371,443,766,2077,23,364,4062,1360,6766
1772.313,6,182,15629,121,69,14769,69,8980,61,69,29532,69,6649
300.57,6,11,863,6,177,60078,177,497,5,110,75097,110,366
1739.576,1,65,5460,65,56,27180,56,5460,0,0,0,0,0
1740.73,6,87,6322,58,31,30539,31,3915,29,31,62168,31,2407
328.115,1,5,608,5,93,82028,103,608,0,0,0,0,0
0.751,6,23,8309,13,224,62,359,1236,10,951,68,3068,7073
0.012,17,2,180,1,30,0,30,58,1,94,0,94,122
23.887,6,26,7137,12,155,2171,267,1266,14,530,1836,2006,5871
0.133,6,9,1342,5,145,33,145,349,4,829,37,829,993
1.519,6,51,19351,29,889,54,1460,13650,22,400,63,1460,5701
69.825,6,7204,5979118,3247,231,21,246,178876,3957,1420,17,4224,5800242
1794.039,17,66,2766,65,14,28031,14,2730,1,8,0,8,36
5.848,6,39,7269,21,218,292,314,3463,18,513,328,1179,3806
1786.441,6,104,8444,68,66,26663,66,4964,36,60,51038,60,3480
61.391,6,37,15864,22,793,2923,1408,9086,15,665,4366,1408,6778
1.877,17,2,204,1,34,0,34,62,1,114,0,114,142
1.692,6,4,220,3,0,846,0,160,1,0,0,0,60
31.673,6,7,308,1,0,0,0,44,6,0,6282,0,264
1651.392,6,69,4788,45,46,37531,208,3580,24,31,19103,31,1208
1773.156,6,180,15480,120,69,14900,69,8940,60,69,30051,69,6540
11.04,6,27,9796,12,366,998,517,2123,15,859,785,1408,7673
280.236,6,30,7432,14,158,21556,267,1357,16,603,18679,2036,6075
317.12,6,55,7167,29,119,11325,722,3055,26,172,12676,1408,4112
768.006,6,10,1435,10,103,85334,138,1435,0,0,0,0,0
0.188,6,26,7256,13,155,15,267,1301,13,678,13,4200,5955
1786.491,6,104,8444,68,66,26664,66,4964,36,60,51039,60,3480
30.018,6,12,1313,7,185,5003,185,557,5,244,7498,476,756
1788.795,6,363,23076,210,69,8558,69,12678,153,69,11768,69,10398
0.078,17,2,198,1,37,0,37,65,1,105,0,105,133
92.602,6,824,390779,435,830,213,1152,370412,389,436,237,1179,20367
0.965,6,9,1647,6,100,193,100,344,3,1179,333,1179,1303
84.796,6,41,9761,15,327,527,1189,2575,26,341,3391,1917,7186
240.334,17,10,880,5,48,60081,48,380,5,72,60081,72,500
2.83,6,2,88,2,0,0,0,88,0,0,0,0,0
1796.73,17,449,39928,404,35,4458,288,25708,45,288,40019,288,14220
0.78,6,3,128,2,0,780,0,84,1,0,0,0,44
1784.422,6,356,22520,208,69,8620,69,12460,148,69,12138,69,10060
6.991,6,18,5072,11,321,687,517,1223,7,869,1146,1780,3849
1780.844,6,182,17075,99,127,18170,208,12856,83,31,21714,31,4219
0.012,6,10,1542,5,505,2,505,773,5,501,2,501,769
1.386,6,7,376,4,0,462,0,216,3,0,564,0,160
280.481,6,30,7432,13,158,23373,267,1317,17,678,17523,2760,6115
105.854,6,40,9790,14,290,4886,1189,2604,26,323,4233,1420,7186
77.129,6,29,9552,16,582,56,1360,3051,13,746,6414,4080,6501
20.561,17,29,2135,20,40,1081,41,1373,9,56,2080,57,762
9.599,6,8,460,3,0,4799,0,160,5,0,2033,0,300
1791.334,1,192,10752,192,28,9378,28,10752,0,0,0,0,0
150.783,6,37,11835,19,633,8376,1360,4595,18,591,8858,1360,7240
1.704,6,14,2351,8,188,243,245,700,6,703,285,1152,1651
8.342,6,18,6791,9,275,1042,275,643,9,1155,990,1420,6148
0.222,6,27,7296,13,155,18,267,1301,14,603,15,2036,5995
714.601,2,5,160,5,8,178650,8,160,0,0,0,0,0
1.444,6,23,4494,12,165,131,456,1446,11,493,127,888,3048
0.162,6,46,22031,27,1063,6,1420,17050,19,467,8,1883,4981
72.128,6,34,7664,14,155,5548,267,1346,20,367,3795,1420,6318
0.044,17,2,351,1,33,0,33,61,1,262,0,262,290
8.085,6,14,2242,8,210,1154,210,844,6,545,1615,904,1398
1795.729,17,448,39896,403,35,4466,288,25676,45,288,40018,288,14220
1767.76,6,130,7960,70,27,25618,27,4225,60,27,29959,27,3735
37.109,17,3,2906,3,940,18554,1451,2906,0,0,0,0,0
10.339,6,50,9087,25,153,430,721,2544,25,553,423,1420,6543
1780.875,6,110,8924,72,66,25082,66,5124,38,60,48128,60,3800
0.487,6,12,1304,6,256,92,256,756,6,304,85,304,548
232.335,6,171,127498,104,1283,2255,1408,114503,67,731,1781,3847,12995
5.191,6,310,257682,188,767,27,1360,13029,122,2084,41,9520,244653
369.494,6,23,1499,14,177,28422,177,913,9,110,8627,110,586
5.018,17,4,288,2,36,4986,36,128,2,52,4982,52,160
1770.799,6,101,9410,66,66,27243,66,5610,35,60,52079,60,3800
0.045,17,2,233,1,48,0,48,76,1,129,0,129,157
144.543,1,18,1908,18,78,8502,78,1908,0,0,0,0,0
280.416,6,30,7432,13,158,23368,267,1317,17,603,17523,2760,6115
0.258,17,2,152,1,48,0,48,76,1,48,0,48,76
16.79,17,23,11987,12,672,1523,1350,8402,11,297,1674,1350,3585
294.084,6,6,302,4,31,97999,31,191,2,31,2001,31,111
1.769,6,13,1096,7,283,264,283,663,6,105,317,105,433
1.155,6,223,163690,122,1355,9,1432,155405,101,420,11,1432,8285
240.304,6,43,8916,22,515,11442,1402,5793,21,252,12014,617,3123
1564.265,2,17,544,17,8,97766,8,544,0,0,0,0,0
3.534,6,2,88,2,0,0,0,88,0,0,0,0,0
1799.787,1,219,12264,219,28,8255,28,12264,0,0,0,0,0
1680.83,17,12,498,11,14,168083,14,462,1,8,0,8,36
3.306,6,48,27348,29,954,118,1360,11762,19,1646,175,5440,15586
1798.408,2,19,608,19,8,99911,8,608,0,0,0,0,0
5.545,6,30,7432,13,158,462,267,1317,17,543,343,1400,6115
365.197,6,24,2125,18,177,21482,177,1475,6,110,12136,110,650
1793.935,6,356,22520,208,69,8666,69,12460,148,69,12203,69,10060
15.491,17,10,880,5,48,3869,48,380,5,72,3869,72,500
1540.11,6,188,19022,97,80,16040,721,9097,91,202,17110,1440,9925
11.455,6,29,11439,14,275,881,275,1118,15,1078,767,1414,10321
1784.041,6,104,8308,68,64,26627,64,4896,36,58,50969,58,3412
16.402,1,21,2184,0,0,0,0,0,21,76,820,76,2184
1.25,6,47,19574,27,920,48,1360,13998,20,529,56,4075,5576
0.015,17,4,1116,2,32,11,32,120,2,470,10,470,996
1770.233,6,99,9240,66,65,27234,65,5577,33,59,55317,59,3663
3.537,17,4,352,2,48,3513,48,152,2,72,3517,72,200
281.041,6,29,7392,13,158,23420,267,1317,16,603,18727,2036,6075
0.113,17,7,641,7,63,18,220,641,0,0,0,0,0
220.151,17,4,240,2,32,220149,32,120,2,32,220149,32,120
0.414,6,7,295,4,0,138,0,164,3,7,103,7,131
1.682,6,14,2351,8,188,240,245,700,6,703,284,1152,1651
1788.956,6,116,7049,64,27,28396,27,3823,52,26,35050,27,3226
1792.916,6,358,22738,209,69,8619,69,12569,149,69,12106,69,10169
0.82,6,20,5952,11,282,82,548,1292,9,716,92,1420,4660
0.596,17,2,167,1,39,0,39,67,1,72,0,72,100
375.884,6,18,1242,14,180,28914,180,916,4,110,20059,110,326
1.044,6,25,5847,12,156,94,267,1422,13,780,81,1420,4425
5.235,6,890,732106,525,1358,9,1380,711308,365,515,14,1923,20798
1.176,17,21,13078,9,518,147,1350,4922,12,651,104,1350,8156
504.08,2,5,160,5,8,126020,8,160,0,0,0,0,0
1142.04,6,168,22573,84,98,13759,721,8776,84,306,13749,2391,13797
169.071,17,4,352,2,60,169070,60,176,2,60,169070,60,176
0.367,17,8,2766,8,317,52,356,2766,0,0,0,0,0
1740.822,17,30,7050,30,207,60028,207,7050,0,0,0,0,0
1772.779,6,180,15480,120,69,14897,69,8940,60,69,30040,69,6540
11.011,6,20,4442,11,275,1101,275,998,9,768,778,1440,3444
77.172,6,235,223142,79,105,989,308,4529,156,1403,497,1418,218613
0.327,6,21,5000,10,137,36,267,1092,11,692,30,1467,3908
1793.191,17,144,11520,72,48,25256,48,5472,72,56,25256,56,6048
1755.558,1,8,848,8,78,250794,78,848,0,0,0,0,0
1700.422,17,12,498,11,14,170042,14,462,1,8,0,8,36
0.236,17,4,304,2,48,121,48,152,2,48,118,48,152
0.988,6,24,4824,13,207,82,518,1709,11,507,89,1408,3115
36.767,17,22,1936,11,48,3674,48,836,11,72,3673,72,1100
1.955,17,6,471,3,31,959,31,177,3,70,961,70,294
0.833,6,51,13865,24,551,36,1429,4876,27,464,31,1986,8989
240.72,2,2,64,2,8,240720,8,64,0,0,0,0,0
108.604,17,4,352,2,60,108603,60,176,2,60,108603,60,176
0.343,6,28,9003,13,232,28,567,1612,15,825,22,1438,7391
1772.301,6,180,15480,120,69,14893,69,8940,60,69,30033,69,6540
240.096,17,5,679,5,107,60024,355,679,0,0,0,0,0
0.432,6,4,220,2,0,432,0,100,2,0,301,0,120
1793.764,6,364,23116,209,69,8623,69,12707,155,69,11647,69,10409
1.342,6,48,21053,28,955,49,1360,15477,20,476,61,2715,5576
0.905,6,20,5952,11,282,90,548,1292,9,716,102,1420,4660
0.225,17,8,2758,8,316,32,355,2758,0,0,0,0,0
0.045,6,10,1634,5,131,11,131,399,5,967,11,967,1235
0.049,17,2,588,1,39,0,39,67,1,493,0,493,521
1.278,6,26,8108,12,164,99,267,1288,14,869,84,1440,6820
0.492,17,3,451,2,39,27,39,134,1,289,0,289,317
0.081,17,2,167,1,39,0,39,67,1,72,0,72,100
236.395,17,4,352,2,60,236393,60,176,2,60,236394,60,176
72.132,6,31,7544,13,155,6011,267,1306,18,423,4242,3417,6238
10.988,6,20,4442,11,275,1098,275,998,9,768,781,1440,3444
0.101,6,14,3436,8,106,14,106,518,6,866,19,1448,2918
0.01,17,2,235,1,36,0,36,64,1,143,0,143,171
240.592,6,41,8744,20,555,12661,1418,5488,21,269,12028,620,3256
0.383,6,22,7342,12,335,34,668,1974,10,1210,41,1906,5368
11.883,6,1879,1641277,1135,1390,10,1420,1607296,744,467,15,1883,33981
0.292,6,10,1383,5,145,73,145,349,5,830,70,830,1034
240.308,6,33,20903,19,190,13350,190,1186,14,1725,18479,2736,19717
280.607,6,30,7432,13,158,23383,267,1317,17,603,17535,2076,6115
0.042,17,2,558,1,32,0,32,60,1,470,0,470,498
1789.379,6,467,33360,242,126,7424,469,18441,225,42,7987,69,14919
1745.573,6,90,6540,60,31,29585,31,4050,30,31,60183,31,2490
0.302,6,28,9123,13,247,25,624,1672,15,832,20,1448,7451
0.421,6,13,1096,7,256,67,256,544,6,304,78,304,552
2.076,6,3,258,2,126,1939,126,218,1,0,0,0,40
0.538,17,4,768,2,39,528,39,134,2,289,11,289,634
24.592,6,34,8219,16,200,1639,722,2046,18,605,1434,1380,6173
0.031,6,2,80,1,0,0,0,40,1,0,0,0,40
0.226,6,23,5994,13,181,18,537,1578,10,555,23,1542,4416
60.15,6,10,725,1,0,0,0,40,9,31,7518,31,685
1790.567,17,83,3480,82,14,22105,14,3444,1,8,0,8,36
1.543,6,2,175,1,0,0,0,40,1,83,0,83,135
122.255,6,25,9380,12,201,66,290,1127,13,857,10176,1460,8253
1.16,17,3,618,2,32,1144,32,120,1,470,0,470,498
1772.379,6,180,15480,120,69,14893,69,8940,60,69,30037,69,6540
0.155,6,7,423,4,43,37,43,259,3,0,27,0,164
369.574,6,25,1651,17,177,23098,177,1117,8,110,9221,110,534
240.242,6,57,18384,29,771,8579,1418,15400,28,190,8897,580,2984
15.148,6,27,7177,13,155,1262,267,1306,14,530,1164,3417,5871
75.324,6,21,860,10,0,6137,0,404,11,0,7531,0,456
9.698,17,2,126,2,35,9698,35,126,0,0,0,0,0
3.069,17,4,488,4,94,1023,94,488,0,0,0,0,0
1792.507,6,364,23047,211,69,8535,69,12787,153,69,11792,69,10260
160.123,6,26,7040,6,154,32024,267,712,20,368,8421,1420,6328
281.711,6,29,7392,14,158,21670,267,1357,15,678,20094,3436,6035
0.211,17,2,152,1,48,0,48,76,1,48,0,48,76
1.273,6,38,16545,21,525,63,1440,3546,17,946,65,1440,12999
0.047,17,2,180,1,30,0,30,58,1,94,0,94,122
11.971,17,3,984,3,300,5985,300,984,0,0,0,0,0
1755.892,6,105,6258,60,26,29760,27,3519,45,26,39905,27,2739
1.263,6,230,161190,123,1340,10,1432,152442,107,389,11,1432,8748
1741.321,6,95,6867,61,31,29022,31,4145,34,31,52766,31,2722
846.836,6,148,15605,83,82,9588,267,5969,65,195,13231,1460,9636
1.003,6,14,3633,7,126,167,126,506,7,1373,167,1448,3127
1020.27,17,200,15200,200,48,5126,48,15200,0,0,0,0,0
336.533,17,14,1232,7,48,56086,48,532,7,72,56086,72,700
3.378,17,5,290,5,30,844,30,290,0,0,0,0,0
1792.001,6,367,25581,213,99,8452,469,15005,154,69,11712,69,10576
1464.016,6,271,23104,141,78,10457,267,9277,130,141,11348,1460,13827
1792.687,1,55,4620,55,56,33197,56,4620,0,0,0,0,0
1.279,6,29,6180,16,138,85,267,1755,13,780,93,1460,4425
1775.171,1,267,14952,267,28,6673,28,14952,0,0,0,0,0
1773.668,17,139,11116,70,48,25705,48,5320,69,56,26083,56,5796
142.264,6,25,10208,12,549,57,1360,2709,13,995,11844,1360,7499
42.103,17,4,288,2,36,42072,36,128,2,52,42072,52,160
240.945,6,46,8299,22,527,11461,1418,5369,24,209,10470,652,2930
13.292,6,1632,1516839,996,1440,13,1448,1476115,636,776,20,1448,40724
1.456,6,38,8254,19,321,80,1164,2718,19,433,70,1460,5536
14.521,17,40,15202,17,530,907,1350,9489,23,220,408,1350,5713
1786.283,17,87,3648,86,14,21015,14,3612,1,8,0,8,36
1754.094,6,95,7203,63,38,28291,205,4476,32,33,56571,98,2727
1798.362,6,674,120368,435,304,4143,304,89560,239,83,7556,83,30808
9.984,17,606,402365,351,1019,28,1350,367605,255,108,39,1350,34760
291.347,6,71,15597,31,689,9711,1408,10698,40,227,7470,580,4899
1680.979,1,15,840,15,28,120069,28,840,0,0,0,0,0
41.512,17,4,352,2,60,41511,60,176,2,60,41511,60,176
29.304,6,16,660,9,0,3663,0,364,7,0,3939,0,296
1512.244,2,7,224,7,8,252040,8,224,0,0,0,0,0
781.064,17,14,4704,14,308,60081,308,4704,0,0,0,0,0
240.206,6,55,18082,30,745,8282,1418,14991,25,222,10008,580,3091
1799.618,17,142,11360,71,48,25708,48,5396,71,56,25708,56,5964
1798.276,17,524,45780,407,36,4429,288,26132,117,139,15492,288,19648
0.092,17,2,214,1,39,0,39,67,1,119,0,119,147
595.536,6,11,657,7,31,99256,31,373,4,31,198421,31,284
0.126,17,4,336,2,45,0,45,146,2,67,76,73,190
35.121,6,27,7183,13,156,2926,267,1312,14,530,2701,2840,5871
11.745,6,1853,1622250,1123,1390,10,1420,1588829,730,467,16,1883,33421
240.242,6,57,18155,29,756,8579,1418,15135,28,194,8897,580,3020
0.038,6,11,911,6,181,7,181,489,5,77,8,133,422
0.004,17,2,456,1,50,0,50,78,1,350,0,350,378
1792.05,6,85,4524,43,26,42666,26,2288,42,26,43707,26,2236
15.35,17,6,528,3,48,7671,48,228,3,72,7670,72,300
1740.452,17,29,6815,29,207,62159,207,6815,0,0,0,0,0
1652.067,1,8,448,8,28,236009,28,448,0,0,0,0,0
1796.854,6,365,25639,212,99,8515,469,14965,153,69,11819,69,10674
1795.425,17,449,39928,404,35,4455,288,25708,45,288,40017,288,14220
257.519,6,147,111900,89,1316,2926,1448,100721,58,679,1879,1448,11179
63.955,6,38,10507,15,450,182,1189,3764,23,415,2906,1460,6743
1799.817,17,449,39928,404,35,4466,288,25708,45,288,40018,288,14220
1793.653,6,204,26683,108,304,16763,304,18148,96,83,18880,83,8535
0.4,6,7,670,4,180,133,180,396,3,110,99,110,274
5.128,6,13,2193,7,211,853,211,794,6,545,1022,904,1399
290.794,6,36,3841,17,324,18174,585,1577,19,254,16154,580,2264
84.579,6,40,25787,19,840,41,1460,5847,21,1193,4222,1460,19940
1799.776,17,745,44974,745,32,2419,37,44974,0,0,0,0,0
236.882,17,8,2688,8,308,33840,308,2688,0,0,0,0,0
1786.039,6,104,8376,68,65,26657,65,4930,36,59,51027,59,3446
1799.547,17,773,46647,773,32,2331,37,46647,0,0,0,0,0
0.005,17,4,414,2,40,0,40,136,2,111,1,117,278
4.375,6,37,7189,19,218,243,314,3383,18,513,241,1179,3806
3.56,6,2,88,2,0,0,0,88,0,0,0,0,0
467.155,17,15,5614,15,346,33368,382,5614,0,0,0,0,0
0.131,17,2,372,1,44,0,44,72,1,272,0,272,300
16.032,6,2551,2409516,1627,1402,9,1440,2356780,924,776,17,1440,52736
15.893,17,23,13341,11,598,1585,1350,6886,12,509,1439,1350,6455
2.044,6,13,2311,8,188,292,245,700,5,1407,445,1407,1611
0.172,6,25,7216,12,155,15,267,1261,13,678,13,2045,5955
68.178,6,48,11891,22,136,3246,267,1849,26,472,2719,1917,10042
4.416,6,2,88,2,0,0,0,88,0,0,0,0,0
45.721,6,25,7097,12,155,4156,267,1266,13,589,3809,3426,5831
299.96,6,52,12919,26,825,11991,1460,6922,26,290,11991,1460,5997
4.518,6,3,132,3,0,0,0,132,0,0,0,0,0
1795.676,17,448,39896,403,35,4466,288,25676,45,288,40025,288,14220
1786.297,6,102,8228,68,64,26661,64,4896,34,58,54127,58,3332
1.635,6,14,2351,8,188,233,245,700,6,703,278,1152,1651
1796.172,17,144,11520,72,48,25298,48,5472,72,56,25298,56,6048
0.215,6,9,1339,5,145,53,145,349,4,826,55,826,990
280.692,6,29,7392,13,158,23391,267,1317,16,543,18707,1400,6075
11.028,17,2,680,2,312,11028,318,680,0,0,0,0,0
3.019,6,4,220,2,0,3001,0,120,2,0,3014,0,100
1798.555,17,449,39928,404,35,4462,288,25708,45,288,40023,288,14220
0.141,6,3,120,2,0,141,0,80,1,0,0,0,40
0.16,1,10,840,10,56,17,56,840,0,0,0,0,0
8.003,17,6,456,6,48,1600,48,456,0,0,0,0,0
0.303,6,9,1339,5,145,75,145,349,4,826,80,826,990
11.809,6,1857,1630301,1133,1385,10,1420,1597120,724,467,16,1883,33181
300.728,6,38,8428,20,274,15827,753,1955,18,441,503,1360,6473
300.884,6,42,13036,23,815,13676,1360,7474,19,399,481,1360,5562
0.004,17,4,344,2,36,0,36,128,2,80,1,92,216
0.566,6,10,2213,5,145,141,145,349,5,830,113,830,1864
112.826,6,31,13504,15,489,354,1360,3080,16,977,7511,1360,10424
1740.469,17,30,31680,30,1028,60016,1028,31680,0,0,0,0,0
341.666,6,39,7523,22,134,16269,516,2090,17,339,21348,1452,5433
259.901,6,35,4960,16,304,17326,304,2956,19,83,14428,83,2004
12.638,6,33,18841,19,708,702,1360,4346,14,1547,950,2720,14495
1.758,6,25,8755,15,283,125,583,1455,10,985,174,1420,7300
60.15,17,4,352,2,60,60149,60,176,2,60,60149,60,176
1790.99,1,59,4956,59,56,30879,56,4956,0,0,0,0,0
300.869,6,24,7795,15,193,21490,398,1560,9,959,8318,2688,6235
5.841,6,40,7309,21,218,292,314,3463,19,513,310,1179,3846
3.918,17,5,290,5,30,979,30,290,0,0,0,0,0
18.232,17,44,14427,22,452,866,1350,10577,22,147,866,1350,3850
2.192,17,4,314,2,31,2146,31,118,2,70,2160,70,196
1786.941,6,102,8228,68,64,26670,64,4896,34,58,54147,58,3332
1742.961,6,134,12007,74,90,23876,205,7555,60,31,29537,33,4452
1787.361,6,104,8308,68,64,26677,64,4896,36,58,51065,58,3412
15.164,17,21,15520,11,927,1513,1350,10515,10,472,1681,1350,5005
1750.532,17,12,498,11,14,175053,14,462,1,8,0,8,36
15.515,6,6,288,1,0,0,0,48,5,0,3874,0,240
601.59,2,9,288,9,8,75198,8,288,0,0,0,0,0
1797.598,6,378,26766,218,103,8283,469,15881,160,69,11303,69,10885
1744.968,1,126,7056,126,28,13959,28,7056,0,0,0,0,0
36.813,6,46,10518,22,727,533,1360,4632,24,327,1593,2667,5886
1.998,17,21,14202,12,934,181,1350,11545,9,267,245,1350,2657
1789.173,1,339,28476,339,56,5293,56,28476,0,0,0,0,0
8.465,17,4,1312,4,300,2821,308,1312,0,0,0,0,0
0.208,17,2,212,1,46,0,46,74,1,110,0,110,138
288.873,17,4,240,2,32,288872,32,120,2,32,288872,32,120
1745.548,6,95,7203,63,38,28154,205,4476,32,33,56301,98,2727
32.928,6,28,8792,14,158,2532,267,1357,14,1145,2530,4845,7435
0.275,17,4,916,2,39,15,39,134,2,363,261,381,782
1783.846,6,111,8839,71,65,25483,65,5115,40,59,45737,59,3724
61.859,6,73,50756,46,1182,1374,1408,42619,27,960,2370,3847,8137
7.403,6,44,8385,22,227,352,314,4062,22,491,340,1179,4323
1203.192,2,10,320,10,8,133688,8,320,0,0,0,0,0
1795.322,17,447,39864,402,35,4477,288,25644,45,288,40019,288,14220
1787.411,6,104,8444,68,66,26677,66,4964,36,60,51066,60,3480
1721.669,6,173,14855,113,69,15372,69,8384,60,69,29156,69,6471
1787.412,6,118,13949,76,83,23832,516,6038,42,163,43593,1452,7911
41.612,17,6,528,3,48,20797,48,228,3,72,20797,72,300
443.692,6,9,1708,6,298,88738,413,1135,3,151,221756,269,573
0.216,6,46,22006,27,1061,8,1420,17025,19,467,11,1883,4981
360.936,2,4,128,4,8,120312,8,128,0,0,0,0,0
1680.472,17,29,30624,29,1028,60016,1028,30624,0,0,0,0,0
10.893,6,14,1247,7,222,1814,222,728,7,231,1814,231,519
0.454,6,51,21452,29,946,16,1380,16330,22,421,19,1923,5122
281.468,17,7,2352,7,308,46911,308,2352,0,0,0,0,0
3.748,6,15,4695,7,188,624,245,660,8,927,497,1152,4035
1797.72,6,356,22520,208,69,8684,69,12460,148,69,12229,69,10060
6.007,17,4,358,2,43,6003,43,142,2,80,6003,80,216
29.331,17,15,7805,8,655,4190,1350,5471,7,305,46,1350,2334
1009.224,6,46,3701,30,64,26151,64,2160,16,56,67275,58,1541
1759.977,6,187,11487,93,47,19130,208,6766,94,31,18921,31,4721
300.817,6,50,10526,25,433,12534,910,3258,25,312,525,1460,7268
1789.96,6,362,22898,210,69,8564,69,12678,152,69,11854,69,10220
1.006,6,10,1687,7,100,167,100,384,3,1179,374,1179,1303
1023.455,17,598,44389,590,40,1737,41,40509,8,457,2590,505,3880
139.333,6,27,13301,15,488,349,1360,3073,12,1622,12654,3928,10228
1741.231,6,87,6322,58,31,30547,31,3915,29,31,62186,31,2407
68.915,6,26,10028,12,632,71,1360,3042,14,916,5288,1360,6986
1784.639,17,274,58521,274,185,6537,379,58521,0,0,0,0,0
3.929,6,61,25968,34,977,119,1360,20019,27,400,143,1360,5949
28.16,6,20,4254,10,296,3128,722,1405,10,387,3109,1408,2849
4.39,6,39,7269,19,218,243,314,3383,20,440,216,1152,3886
280.447,6,30,7432,14,158,21572,267,1357,16,678,18691,3456,6075
1.916,17,16,8333,8,675,269,1350,5629,8,310,268,1350,2704
1783.36,17,83,3480,82,14,22016,14,3444,1,8,0,8,36
340.007,6,854,420904,455,854,748,1152,403597,399,446,853,1179,17307
92.936,17,4,352,2,60,92934,60,176,2,60,92935,60,176
2.413,6,118,88567,53,151,46,232,2881,65,1408,36,2760,85686
0.011,17,2,166,1,39,0,39,67,1,71,0,71,99
0.299,17,2,196,1,62,0,62,90,1,78,0,78,106
1.304,6,37,8214,19,321,72,1164,2718,18,529,65,4075,5496
0.732,6,37,25693,18,840,43,1460,5795,19,1275,33,2920,19898
0.303,17,4,1006,2,40,297,40,136,2,407,298,407,870
1.626,6,5,1077,3,0,578,0,144,2,853,1414,853,933
0.087,17,2,279,1,36,0,36,64,1,187,0,187,215
0.183,6,31,7898,16,278,12,517,1775,15,612,12,3303,6123
1789.179,17,142,11360,71,48,25559,48,5396,71,56,25559,56,5964
280.444,6,31,7472,13,158,23370,267,1317,18,603,16493,2760,6155
1787.191,6,106,8584,69,66,26282,66,5004,37,60,49637,60,3580
242.91,6,73,11768,35,187,7144,1189,4033,38,310,6243,1420,7735
0.456,6,48,20847,27,978,17,1380,15774,21,467,20,1923,5073
1.174,17,4,534,2,31,1161,31,118,2,180,1157,196,416
1782.954,17,83,3480,82,14,22011,14,3444,1,8,0,8,36
290.444,17,6,360,3,32,145221,32,180,3,32,145221,32,180
0.01,17,2,366,1,33,0,33,61,1,277,0,277,305
50.218,17,3,984,3,300,25109,300,984,0,0,0,0,0
368.643,6,25,1651,17,177,23040,177,1117,8,110,9206,110,534
0.143,17,2,672,2,308,143,308,672,0,0,0,0,0
0.385,17,2,776,2,360,385,360,776,0,0,0,0,0
0.223,6,46,21473,26,1099,8,1420,16452,20,467,11,1883,5021
90.81,6,23,10989,12,380,70,832,1665,11,1267,9068,3928,9324
294.878,6,34,7070,16,262,19655,517,1640,18,642,17343,1418,5430
1784.541,6,367,24643,213,87,8417,469,14136,154,69,11662,69,10507
0.268,17,3,451,2,39,138,39,134,1,289,0,289,317
113.305,6,24,6561,14,603,8715,1360,4180,10,247,12268,272,2381
1746.939,6,116,9455,74,53,23930,205,5720,42,38,42603,98,3735
11.65,6,1858,1610329,1119,1383,10,1420,1576548,739,467,15,1883,33781
134.363,6,23,9218,11,406,78,908,1691,12,1005,12203,1360,7527
1.737,17,4,928,4,204,579,204,928,0,0,0,0,0
1793.018,17,180,14040,180,50,10016,50,14040,0,0,0,0,0
175.624,17,3,968,3,294,87812,300,968,0,0,0,0,0
0.968,17,21,12108,11,846,93,1350,9624,10,220,103,1350,2484
163.138,6,1597,827791,899,853,181,1152,793034,698,401,233,1179,34757
0.457,6,50,22074,28,1051,16,1380,16952,22,421,19,1923,5122
2.166,6,13,2076,7,329,361,500,1030,6,363,433,500,1046
1.856,6,27,8849,16,286,123,590,1502,11,862,165,1380,7347
0.868,6,10,1687,7,100,144,100,384,3,1179,310,1179,1303
252.335,6,14,5625,4,106,84108,106,274,10,823,28035,1460,5351
1.005,6,29,8500,15,222,60,540,1964,14,852,63,1360,6536
1775.609,17,140,11200,70,48,25733,48,5320,70,56,25733,56,5880
0.151,6,9,1002,5,213,37,213,417,4,421,31,421,585
240.844,6,56,15499,30,678,8304,1418,12429,26,212,9633,580,3070
1787.114,6,356,22520,208,69,8633,69,12460,148,69,12156,69,10060
121.24,6,33,15526,16,576,61,1360,3565,17,1024,7567,2001,11961
16.567,6,29,4980,14,154,1258,722,1827,15,338,961,1408,3153
377.566,2,3,96,3,8,188783,8,96,0,0,0,0,0
94.596,1,3,453,3,123,47298,176,453,0,0,0,0,0
294.628,6,6,364,4,31,98209,31,222,2,31,294477,31,142
0.685,17,12,4377,12,336,62,359,4377,0,0,0,0,0
2.165,6,65,33108,35,722,63,1408,6240,30,1150,74,3715,26868
0.084,17,2,390,1,46,0,46,74,1,288,0,288,316
1681.559,17,16,1265,8,30,240220,37,471,8,71,240220,136,794
1772.16,6,180,15480,120,69,14892,69,8940,60,69,30031,69,6540
1150.014,6,140,17074,82,81,14197,267,6619,58,156,20175,1997,10455
0.123,17,10,5408,5,618,30,1350,3233,5,407,22,1350,2175
38.338,17,22,1672,22,48,1825,48,1672,0,0,0,0,0
1794.879,6,375,23970,215,69,8387,69,13223,160,69,11288,69,10747
0.035,17,8,2454,8,278,5,317,2454,0,0,0,0,0
280.504,6,30,7432,14,158,21577,267,1357,16,678,18692,3456,6075
1799.533,17,449,39928,404,35,4465,288,25708,45,288,40018,288,14220
772.375,1,9,837,9,65,96546,88,837,0,0,0,0,0
86.141,6,47,8765,18,151,1469,267,2087,29,393,3064,1917,6678
4.914,17,4,514,2,36,4901,36,128,2,165,4903,187,386
0.312,17,8,2774,8,318,44,357,2774,0,0,0,0,0
0.213,17,8,2750,8,315,30,354,2750,0,0,0,0,0
1168.281,1,76,4256,76,28,15577,28,4256,0,0,0,0,0
504.247,2,3,96,3,8,252123,8,96,0,0,0,0,0
26.906,17,33,13439,14,334,2066,1350,5069,19,412,1492,1350,8370
21.482,6,23,5534,13,107,1790,159,1126,10,967,2347,1709,4408
7.151,6,1516,1387423,925,1420,7,1448,1352027,591,776,11,1448,35396
0.392,6,6,240,3,0,112,0,120,3,0,119,0,120
1773.662,6,180,15480,120,69,14904,69,8940,60,69,30053,69,6540
5.007,17,4,558,2,36,5001,36,128,2,187,5002,187,430
9.564,6,81,24461,42,550,233,1152,18744,39,461,245,1179,5717
1699.326,6,398,50503,174,195,9821,1360,37436,224,57,7619,291,13067
1658.89,1,8,448,8,28,236984,28,448,0,0,0,0,0
241.507,2,4,128,4,8,80502,8,128,0,0,0,0,0
0.29,17,4,1445,4,333,96,354,1445,0,0,0,0,0
1744.313,6,96,7286,63,38,28134,205,4476,33,33,54498,98,2810
1799.571,6,407,42667,204,146,8864,208,33524,203,31,8906,31,9143
66.993,6,52,10277,27,450,517,766,3009,25,347,2785,3488,7268
2.264,17,2,677,1,300,0,300,328,1,321,0,321,349
280.348,6,30,7432,13,158,23362,267,1317,17,543,17518,1400,6115
300.327,6,40,19102,22,417,14301,1114,2834,18,1094,1988,1491,16268
0.3,6,9,1343,5,145,75,145,349,4,830,32,830,994
588.56,1,12,672,12,28,53505,28,672,0,0,0,0,0
0.034,17,2,268,1,54,0,54,82,1,158,0,158,186
1777.865,17,142,11360,71,48,25397,48,5396,71,56,25397,56,5964
0.007,17,2,520,1,69,0,69,97,1,395,0,395,423
39.238,17,22,1936,11,48,3921,48,836,11,72,3918,72,1100
240.253,6,34,4145,17,178,15015,585,1964,17,257,15015,580,2181
300.721,6,37,8388,20,280,15827,775,1954,17,478,535,2128,6434
0.359,6,10,1669,6,551,71,947,1346,4,159,119,159,323
0.02,17,4,1293,4,295,6,316,1293,0,0,0,0,0
10.072,6,15,2294,9,210,1257,210,896,6,545,2014,904,1398
0.061,17,2,164,1,46,0,46,74,1,62,0,62,90
280.392,6,30,7432,13,158,23366,267,1317,17,543,17521,1300,6115
0.088,17,4,336,2,34,0,34,124,2,78,40,84,212
240.225,6,53,17907,28,794,8896,1418,14975,25,203,10008,580,2932
146.271,17,4,352,2,60,146270,60,176,2,60,146270,60,176
0.487,6,20,7238,13,335,40,668,2026,7,1210,75,1946,5212
0.174,6,27,7296,14,155,13,267,1341,13,678,13,3436,5955
1795.607,6,363,23076,209,69,8632,69,12638,154,69,11735,69,10438
956.664,6,150,30276,78,389,12424,1269,18328,72,188,13472,860,11948
0.037,6,9,1880,5,910,9,910,1178,4,486,12,486,702
8.879,6,38,9884,19,706,493,1460,4322,19,399,481,1460,5562
1776.145,17,73,3060,72,14,25016,14,3024,1,8,0,8,36
1.301,17,4,352,2,37,0,37,130,2,83,0,89,222
75.587,17,4,1344,4,308,25195,308,1344,0,0,0,0,0
1786.917,6,106,8524,68,66,26670,66,4964,38,60,48291,60,3560
1799.827,17,449,39928,404,35,4466,288,25708,45,288,40018,288,14220
352.391,6,16,6177,3,106,191,106,234,13,492,29365,3417,5943
41.911,17,3,228,3,48,20955,48,228,0,0,0,0,0
1.262,6,23,7952,12,164,97,267,1288,11,1216,106,3819,6664
234.535,6,346,280038,214,1317,1101,1368,260184,132,614,1292,2519,19854
54.234,6,25,7097,12,155,4930,267,1266,13,589,4518,3426,5831
1798.271,6,357,22629,208,69,8687,69,12460,149,69,12150,69,10169
5.491,6,39,7285,21,218,274,314,3463,18,516,307,1179,3822
0.024,17,4,344,2,47,14,47,150,2,69,14,75,194
118.571,17,4,240,2,32,118570,32,120,2,32,118570,32,120
97.879,6,80,12202,47,304,2127,304,8600,33,83,3058,83,3602
38.808,17,22,1672,22,48,1848,48,1672,0,0,0,0,0
125.267,17,8,2688,8,308,17895,308,2688,0,0,0,0,0
1785.894,1,342,28728,342,56,5237,56,28728,0,0,0,0,0
0.042,6,23,14097,13,126,3,126,810,10,1822,4,2896,13287
1795.249,6,368,25690,215,99,8389,469,15085,153,69,11808,69,10605
240.264,6,56,20542,30,848,8284,1418,17693,26,186,9610,580,2849
5.328,17,3,208,2,36,5006,36,128,1,52,0,52,80
1770.297,6,105,9762,68,66,26422,66,5738,37,60,49172,60,4024
0.061,17,2,192,1,37,0,37,65,1,99,0,99,127
240.326,6,60,21519,33,877,7509,1418,18415,27,188,9242,580,3104
0.76,6,23,9956,12,660,69,1360,3154,11,1058,55,2720,6802
0.57,6,10,967,5,256,130,256,460,5,303,130,303,507
7.977,6,80,24757,41,561,199,1152,19056,39,413,203,1152,5701
0.109,17,2,214,1,39,0,39,67,1,119,0,119,147
722.912,17,8,922,8,87,103273,355,922,0,0,0,0,0
280.383,6,28,7352,12,158,25489,267,1277,16,603,18686,1400,6075
1768.222,17,381,90375,381,209,4653,422,90375,0,0,0,0,0
10.777,6,19,4362,11,275,1077,275,998,8,1010,856,2840,3364
962.617,2,11,352,11,8,96261,8,352,0,0,0,0,0
0.269,6,27,6202,13,181,22,537,1578,14,555,20,1542,4624
1799.041,17,450,39960,405,35,4453,288,25740,45,288,40022,288,14220
1787.925,6,358,22669,209,69,8595,69,12569,149,69,12078,69,10100
3.954,17,5,4754,5,922,988,1451,4754,0,0,0,0,0
1775.072,6,278,45110,162,208,11025,981,23381,116,153,15434,453,21729
1215.03,6,152,11626,58,72,20789,347,5591,94,48,13064,78,6035
56.535,6,2407,2151385,1516,1337,37,1368,2095731,891,899,63,2736,55654
0.056,6,13,3565,7,126,9,126,498,6,1373,11,1448,3067
180.595,17,2,136,2,40,180595,47,136,0,0,0,0,0
3.191,17,5,295,5,31,797,31,295,0,0,0,0,0
282.132,6,33,7552,14,158,21702,267,1357,19,543,15672,1400,6195
21.0,6,25,7006,7,154,3500,267,752,18,425,1226,1460,6254
1741.608,6,89,6469,59,31,30027,31,3979,30,31,60047,31,2490
8.891,6,1445,1224478,806,1428,10,1448,1183278,639,776,13,1448,41200
1.944,17,23,6895,9,252,243,1350,2526,14,284,119,1350,4369
1.358,17,4,275,3,31,654,31,177,1,70,0,70,98
15.816,6,13,2133,8,324,2259,585,1073,5,396,3949,580,1060
201.201,6,74,49582,46,1181,4471,1408,41391,28,961,2281,3847,8191
737.328,6,77,6599,50,69,15047,69,3794,27,69,28358,69,2805
1745.803,1,54,4536,54,56,32939,56,4536,0,0,0,0,0
240.667,6,30,7432,14,158,18512,267,1357,16,603,16042,2600,6075
0.259,6,10,1673,6,553,51,949,1350,4,159,86,159,323
0.379,6,14,1733,7,288,59,288,588,7,284,35,434,1145
10.887,17,4,240,2,32,10886,32,120,2,32,10887,32,120
0.198,6,3,175,2,31,14,31,135,1,0,0,0,40
24.827,6,23,1528,13,92,2068,92,872,10,92,2315,92,656
280.411,6,30,7432,14,158,21570,267,1357,16,678,18690,3456,6075
0.194,6,28,7336,13,155,16,267,1301,15,543,13,1400,6035
1741.217,6,92,6668,60,31,29512,31,4081,32,31,56167,31,2587
1796.445,17,140,11200,70,48,26035,48,5320,70,56,26035,56,5880
1.326,6,25,8056,12,164,102,267,1288,13,1014,95,2491,6768
1.205,6,25,8056,12,164,93,267,1288,13,869,85,1448,6768
61.446,6,37,15895,22,796,2926,1368,9117,15,665,4369,1368,6778
96.14,6,33,9587,11,159,9614,267,1562,22,419,4570,2840,8025
1790.868,17,142,11360,71,48,25583,48,5396,71,56,25583,56,5964
1781.765,6,377,26657,217,103,8248,469,15841,160,69,11206,69,10816
8.274,6,1845,1712536,1145,1416,7,1448,1671460,700,776,11,1448,41076
1795.005,17,449,39928,404,35,4454,288,25708,45,288,40016,288,14220
370.865,6,29,2587,19,141,20603,141,981,10,398,2798,419,1606
153.604,6,28,7352,12,158,13964,267,1277,16,603,10237,1400,6075
760.278,6,36,3717,23,90,34558,138,2369,13,69,18128,69,1348
0.425,6,12,1653,6,288,78,288,548,6,426,48,434,1105
0.39,6,10,968,5,256,91,256,460,5,304,94,304,508
1744.725,2,12,384,12,8,158611,8,384,0,0,0,0,0
1773.267,6,204,22330,130,75,13746,267,10057,74,132,24290,1452,12273
0.06,6,2,116,1,0,0,0,64,1,0,0,0,52
1799.918,17,448,39896,403,35,4477,288,25676,45,288,40015,288,14220
0.062,17,4,284,2,32,19,32,120,2,54,44,60,164
33.714,6,33,5199,16,154,2247,722,1912,17,299,2095,1448,3287
0.152,6,10,1569,5,627,37,627,895,5,406,37,406,674
0.826,6,17,5164,9,150,103,174,664,8,835,104,1452,4500
126.957,2,2,64,2,8,126957,8,64,0,0,0,0,0
4.924,6,38,7245,19,218,273,314,3383,19,516,258,1179,3862
1794.332,1,58,4872,0,0,0,0,0,58,56,31479,56,4872
1786.733,6,104,8444,68,66,26667,66,4964,36,60,51046,60,3480
1775.151,17,140,11200,70,48,25726,48,5320,70,56,25726,56,5880
0.031,17,2,672,2,308,31,308,672,0,0,0,0,0
0.853,17,2,204,1,34,0,34,62,1,114,0,114,142
125.23,6,34,7797,13,155,10435,267,1306,21,352,6260,1997,6491
57.694,6,16,1475,6,523,11538,523,847,10,19,5831,19,628
1.489,6,31,6467,15,164,106,267,1922,16,650,87,1380,4545
0.385,6,12,1653,6,288,70,288,548,6,426,45,434,1105
4.504,6,37,7189,19,218,250,314,3383,18,513,247,1179,3806
5.119,6,37,7189,19,218,284,314,3383,18,513,283,1179,3806
9.092,6,6,312,6,0,0,0,312,0,0,0,0,0
62.4,6,63,43031,40,1178,1600,1448,35080,23,843,2821,2359,7951
341.704,6,256,204979,167,1298,2058,1408,185230,89,581,2913,2439,19749
12.177,17,20,1720,10,47,1352,47,750,10,69,1352,75,970
310.31,6,48,6735,29,302,11082,302,4826,19,83,17238,83,1909
25.157,6,14,4239,5,517,6289,517,797,9,1479,2258,1550,3442
203.618,17,4,352,2,60,203617,60,176,2,60,203617,60,176
0.642,6,14,1745,7,288,77,288,600,7,426,74,434,1145
0.0,17,2,363,2,153,0,158,363,0,0,0,0,0
281.262,6,30,7432,13,158,23438,267,1317,17,543,17576,1400,6115
1788.347,6,356,22520,208,69,8639,69,12460,148,69,12165,69,10060
4.565,6,38,7245,19,218,253,314,3383,19,516,238,1179,3862
1746.128,6,95,7203,63,38,28163,205,4476,32,33,56314,98,2727
1740.553,17,29,30566,29,1026,62162,1026,30566,0,0,0,0,0
1795.22,6,368,25759,215,99,8388,469,15154,153,69,11804,69,10605
879.002,6,111,8337,42,68,21021,297,3932,69,48,12926,78,4405
1760.868,6,124,12253,76,62,23478,721,6286,48,91,37456,2026,5967
300.724,6,41,13624,23,892,13669,1360,8102,18,435,504,2720,5522
8.598,6,501,446957,326,1308,25,1368,433169,175,931,48,2736,13788
215.344,6,75,53124,48,1213,4581,1408,44985,27,961,2370,3847,8139
1.965,17,4,1568,4,364,655,364,1568,0,0,0,0,0
221.66,6,27,7328,7,154,36943,267,752,20,412,11659,1420,6576
0.016,17,4,859,2,37,1,37,130,2,336,0,348,729
0.861,6,10,1687,7,100,143,100,384,3,1179,307,1179,1303
0.074,17,2,386,1,46,0,46,74,1,284,0,284,312
1798.929,1,188,10528,188,28,9619,28,10528,0,0,0,0,0
0.03,6,11,3287,6,81,6,81,401,5,872,7,1448,2886
1703.641,1,90,5040,90,28,19142,28,5040,0,0,0,0,0
32.041,6,9,396,2,0,3482,0,88,7,0,5324,0,308
5.091,17,6,1392,6,204,1018,204,1392,0,0,0,0,0
1796.209,17,87,3648,86,14,21131,14,3612,1,8,0,8,36
503.434,17,48,7056,24,48,21887,48,1824,24,190,21887,308,5232
0.353,6,21,7281,12,334,31,663,1969,9,967,43,1471,5312
1799.943,17,449,39928,404,35,4466,288,25708,45,288,40020,288,14220
1739.231,6,87,6322,58,31,30512,31,3915,29,31,62114,31,2407
1773.092,6,180,15480,120,69,14899,69,8940,60,69,30046,69,6540
1792.158,6,381,26762,217,97,8297,469,15510,164,69,10994,69,11252
105.654,17,4,352,2,60,105653,60,176,2,60,105652,60,176
0.062,6,2,80,1,0,0,0,40,1,0,0,0,40
1777.95,17,73,3060,72,14,25041,14,3024,1,8,0,8,36
1798.319,6,367,24712,213,87,8482,469,14205,154,69,11752,69,10507
16.543,6,13,8045,5,125,4135,125,381,8,1448,2361,1448,7664
0.379,6,20,6003,11,284,37,517,1716,9,762,46,1402,4287
347.546,6,385,339168,261,1321,1336,1368,317627,124,579,1734,2519,21541
2.942,6,40,8485,20,317,154,636,1795,20,419,142,1360,6690
146.222,6,33,8691,20,249,7692,1258,3078,13,617,12182,1368,5613
1786.802,6,102,8364,68,66,26668,66,4964,34,60,54142,60,3400
1745.939,6,95,7203,63,38,28160,205,4476,32,33,56305,98,2727
15.356,17,2,152,2,48,15356,48,152,0,0,0,0,0
2.012,17,3,174,3,30,1006,30,174,0,0,0,0,0
1799.275,6,364,23047,211,69,8567,69,12787,153,69,11837,69,10260
0.586,6,40,16557,25,750,24,1452,11512,15,634,40,1696,5045
1.529,2,3,96,3,8,764,8,96,0,0,0,0,0
569.863,17,8,2045,4,31,189947,37,239,4,423,189944,463,1806
54.005,6,14,6042,2,106,550,106,194,12,536,4908,1917,5848
13.797,6,27,4865,13,154,1129,721,1766,14,394,1046,1368,3099
0.014,17,2,144,1,36,0,36,64,1,52,0,52,80
1230.183,6,153,10400,60,46,20850,46,4518,93,46,13369,46,5882
1787.512,6,104,8376,68,65,26679,65,4930,36,59,51067,59,3446
1798.41,17,87,3648,86,14,21157,14,3612,1,8,0,8,36
300.639,6,42,8803,22,291,14316,787,2125,20,391,515,3488,6678
0.054,17,4,344,2,47,0,47,150,2,69,18,75,194
0.004,6,2,149,1,0,0,0,40,1,69,0,69,109
2.834,17,2,425,1,36,0,36,64,1,333,0,333,361
1651.884,17,68,2850,67,14,25028,14,2814,1,8,0,8,36
43.128,6,22,6374,10,280,4792,517,1366,12,1449,3584,2411,5008
10.916,6,18,5610,10,275,1212,275,958,8,1440,865,1440,4652
300.716,6,37,8536,21,317,15035,923,2142,16,522,572,2720,6394
4.184,6,39,7269,20,218,220,314,3423,19,513,218,1179,3846
30.488,6,10,628,4,106,10158,106,274,6,90,6094,90,354
60.354,17,4,5500,4,1347,20118,1347,5500,0,0,0,0,0
5.009,17,4,542,2,36,5002,36,128,2,179,5004,187,414
280.45,6,29,7392,12,158,25495,267,1277,17,603,17524,1380,6115
1799.462,6,367,25650,214,99,8448,469,15045,153,69,11838,69,10605
12.133,17,4,352,2,48,12114,48,152,2,72,12113,72,200
0.092,17,2,602,1,46,0,46,74,1,500,0,500,528
1.316,6,46,18902,26,942,52,1460,13326,20,476,59,2615,5576
33.605,6,34,5306,16,180,2226,721,1921,18,271,1964,1368,3385
378.205,2,3,96,3,8,189102,8,96,0,0,0,0,0
1786.193,6,106,8456,68,65,26659,65,4930,38,59,48273,59,3526
245.724,6,33,6647,15,186,8355,502,1538,18,292,14449,1420,5109
1120.883,17,10,2729,5,30,280218,30,290,5,459,280216,463,2439
1680.726,17,13,534,11,14,168052,14,462,2,8,1680534,8,72
0.067,17,2,148,1,32,0,32,60,1,60,0,60,88
1791.907,1,336,28224,336,56,5348,56,28224,0,0,0,0,0
1771.616,1,58,4872,0,0,0,0,0,58,56,31080,56,4872
178.719,6,24,10085,13,531,55,1360,2713,11,1153,17857,2720,7372
0.502,17,4,768,2,39,491,39,134,2,289,14,289,634
1799.358,17,763,46053,763,32,2361,37,46053,0,0,0,0,0
0.224,1,10,840,10,56,24,56,840,0,0,0,0,0
1785.046,6,362,22898,210,69,8540,69,12678,152,69,11821,69,10220
32.142,6,236,240516,71,134,459,324,4094,165,1415,195,2836,236422
280.468,6,30,7432,13,158,23372,267,1317,17,603,17520,2760,6115
0.609,6,5,272,3,0,163,0,156,2,0,83,0,116
1786.3,17,89,3729,87,13,20768,14,3649,2,12,1786136,16,80
1.223,6,39,10971,21,575,61,1360,5475,18,476,62,2715,5496
3.737,6,236,244092,183,989,20,1360,20229,53,5408,69,54400,223863
0.142,6,41,17204,24,943,6,1420,12303,17,420,8,1420,4901
35.261,6,23,6179,14,117,2712,159,1337,9,873,4405,1658,4842
1787.11,6,102,8364,68,66,26673,66,4964,34,60,54150,60,3400
1.154,6,23,6596,13,350,95,1089,2276,10,979,127,1731,4320
1744.627,6,97,7338,64,38,27692,205,4528,33,33,54509,98,2810
1789.799,1,58,4872,0,0,0,0,0,58,56,31399,56,4872
7.463,1,2,130,2,37,7463,37,130,0,0,0,0,0
1797.009,17,447,39580,403,35,4470,288,25676,44,288,40950,288,13904
135.444,17,260,49320,19,36,3936,288,1216,241,171,562,308,48104
1796.695,6,356,22520,208,69,8679,69,12460,148,69,12222,69,10060
300.857,6,37,11980,22,667,14326,1408,5158,15,603,617,3714,6822
1.346,6,50,20932,28,941,49,1460,15276,22,433,55,1460,5656
0.138,1,2,112,2,28,138,28,112,0,0,0,0,0
1797.941,1,345,28980,345,56,5226,56,28980,0,0,0,0,0
30.553,6,48,9280,20,350,79,734,1918,28,270,1126,1360,7362
0.045,6,2,149,1,0,0,0,40,1,69,0,69,109
0.097,6,12,3462,6,75,19,75,395,6,1373,19,1448,3067
243.235,1,22,1232,22,28,11582,28,1232,0,0,0,0,0
1793.023,6,360,22818,209,69,8620,69,12569,151,69,11953,69,10249
1719.635,17,13,534,11,14,171943,14,462,2,8,1719445,8,72
240.193,6,54,18334,29,824,8577,1418,15536,25,186,10007,580,2798
28.575,6,47,13186,22,200,1360,721,2690,25,678,1147,1420,10496
0.031,6,2,80,1,0,0,0,40,1,0,0,0,40
240.162,6,53,18069,28,815,8894,1408,15319,25,180,10006,580,2750
4.525,6,39,7269,19,218,251,314,3383,20,513,224,1179,3886
3.032,6,55,14075,27,549,116,1429,4968,28,419,104,1986,9107
106.142,6,17,708,6,0,8619,0,244,11,0,10613,0,464
0.202,6,9,1339,5,145,50,145,349,4,826,47,826,990
2.441,6,30,6135,16,145,162,267,1666,14,780,166,1460,4469
12.111,6,1898,1657766,1158,1376,10,1420,1623945,740,467,16,1883,33821
271.221,17,4,240,2,32,271220,32,120,2,32,271220,32,120
342.28,17,8,2624,8,300,48897,308,2624,0,0,0,0,0
0.0,6,1,40,0,0,0,0,0,1,0,0,0,40
16.453,6,17,2414,10,210,1827,210,956,7,545,2557,904,1458
1.741,6,13,2311,8,188,248,245,700,5,1407,368,1407,1611
126.345,6,37,8396,13,159,2706,267,1642,24,321,5492,1420,6754
150.318,17,4,352,2,60,150316,60,176,2,60,150317,60,176
1786.11,17,142,11360,71,48,25515,48,5396,71,56,25515,56,5964
1.321,6,48,19307,27,898,50,1360,13691,21,476,56,2715,5616
1771.403,6,106,9752,68,65,26438,65,5758,38,59,47873,59,3994
4.864,6,43,8345,21,227,243,314,4022,22,491,219,1179,4323
0.45,17,2,167,1,39,0,39,67,1,72,0,72,100
313.113,6,91,59915,56,1193,5692,1368,50674,35,617,3180,2519,9241
63.698,6,64,41380,40,1158,1633,1448,33378,24,749,2673,1448,8002
240.124,6,42,5071,22,181,11434,517,2254,20,196,12637,851,2817
171.509,17,8,2688,8,308,24501,308,2688,0,0,0,0,0
0.485,6,17,6612,10,138,53,183,931,7,1061,62,1448,5681
720.199,17,13,13507,13,1011,60016,1011,13507,0,0,0,0,0
6.273,6,1041,918676,634,1371,9,1408,892848,407,931,15,2801,25828
1.03,17,3,655,2,39,999,39,134,1,493,0,493,521
13.637,17,4,824,2,48,13621,48,152,2,308,13619,308,672
0.451,6,51,21592,28,954,16,1380,16430,23,383,18,1380,5162
0.506,6,12,1653,6,288,98,288,548,6,426,53,434,1105
157.61,6,30,7432,13,158,13134,267,1317,17,543,9845,1400,6115
4.955,17,4,288,2,36,4954,36,128,2,52,4941,52,160
0.014,17,2,614,1,58,0,58,86,1,500,0,500,528
1.008,6,26,5916,13,161,84,267,1491,13,650,75,1420,4425
16.098,6,6,585,0,0,0,0,0,6,69,3219,69,585
1769.421,6,99,9240,66,65,27221,65,5577,33,59,55291,59,3663
1796.454,1,339,28476,339,56,5314,56,28476,0,0,0,0,0
180.293,6,103,46034,50,709,3679,1460,13559,53,798,3463,1591,32475
46.4,17,8,608,8,48,6628,48,608,0,0,0,0,0
1781.432,1,124,6944,124,28,14483,28,6944,0,0,0,0,0
1793.377,1,59,4956,59,56,30920,56,4956,0,0,0,0,0
0.074,17,2,154,1,41,0,41,69,1,57,0,57,85
1383.658,2,15,480,15,8,98832,8,480,0,0,0,0,0
1.165,6,4,184,2,0,1165,0,88,2,0,1030,0,96
2.146,17,4,1564,4,363,715,363,1564,0,0,0,0,0
1746.622,6,95,7203,63,38,28171,205,4476,32,33,56331,98,2727
445.951,6,214,83148,114,696,3946,1360,64548,100,291,4502,2720,18600
0.986,6,52,13869,24,551,42,1429,4840,28,438,35,1460,9029
989.244,17,74,5904,39,48,26032,48,2964,35,56,26078,56,2940
29.205,6,4286,4072878,2796,1378,10,1408,3990650,1490,776,19,1408,82228
0.111,6,9,1340,5,145,27,145,349,4,827,32,827,991
60.387,6,10,636,3,106,30186,106,234,7,90,10062,90,402
240.188,6,53,17602,28,781,8895,1402,14757,25,192,10007,580,2845
31.544,6,11,480,4,0,10514,0,172,7,0,2791,0,308
43.405,6,26,7265,5,156,1755,267,678,21,358,2169,1420,6587
5.263,17,3,208,2,36,5004,36,128,1,52,0,52,80
1749.921,17,12,498,11,14,174992,14,462,1,8,0,8,36
1740.432,17,29,6815,29,207,62158,207,6815,0,0,0,0,0
1.149,6,23,7952,11,164,97,267,1236,12,1014,88,2411,6716
1637.432,1,7,392,7,28,272905,28,392,0,0,0,0,0
264.02,17,4,352,2,60,264019,60,176,2,60,264019,60,176
68.784,17,4,352,2,60,68783,60,176,2,60,68783,60,176
1798.569,6,363,24952,212,94,8524,469,14496,151,69,11988,69,10456
1785.159,6,354,22440,207,69,8665,69,12420,147,69,12227,69,10020
6.134,6,36,10937,20,266,322,572,3713,16,1056,407,1368,7224
71.854,17,6,525,3,32,35911,37,181,3,86,35891,136,344
9.234,6,35,12470,18,533,543,1360,3454,17,924,565,3113,9016
9.644,6,9,527,5,43,2411,43,311,4,0,3207,0,216
20.154,1,8,832,0,0,0,0,0,8,76,2879,76,832
60.436,6,18,13201,5,166,15109,241,601,13,1321,5019,1448,12600
64.644,6,14,2210,7,329,10774,594,1030,7,396,10772,580,1180
1.002,6,54,13954,25,549,41,1429,4876,29,416,33,1460,9078
280.379,6,28,7352,13,158,23364,267,1317,15,678,20025,2045,6035
1797.991,6,360,22818,210,69,8602,69,12540,150,69,12064,69,10278
1797.406,17,87,3648,86,14,21145,14,3612,1,8,0,8,36
1345.047,1,17,2040,17,92,84065,125,2040,0,0,0,0,0
3.992,6,11,467,6,0,798,0,248,5,7,743,7,219
1795.138,17,80,3354,79,14,23014,14,3318,1,8,0,8,36
0.087,1,2,112,2,28,87,28,112,0,0,0,0,0
313.658,6,27,6528,11,143,31365,159,1333,16,727,20910,1408,5195
1798.093,17,448,39896,403,35,4472,288,25676,45,288,40016,288,14220
1799.058,17,448,39896,403,35,4475,288,25676,45,288,40018,288,14220
0.036,17,2,348,1,39,0,39,67,1,253,0,253,281
0.477,6,48,20247,27,1003,18,1380,15165,21,421,22,1923,5082
41.109,17,2,672,2,308,41109,308,672,0,0,0,0,0
1.397,6,46,19514,27,917,53,1360,13978,19,476,67,2720,5536
0.308,6,20,5174,12,140,27,140,772,8,663,43,1000,4402
0.157,6,9,1340,5,145,39,145,349,4,827,21,827,991
5.034,6,21,8759,10,141,559,275,686,11,953,256,1380,8073
1789.003,17,142,11360,71,48,25557,48,5396,71,56,25557,56,5964
1194.185,6,593,174336,272,808,4406,1418,148421,321,67,3731,580,25915
1720.276,2,14,448,14,8,132328,8,448,0,0,0,0,0
1.085,6,55,14256,26,501,43,1429,5118,29,442,37,1986,9138
300.942,6,34,8971,15,201,21492,486,1438,19,563,16710,1701,7533
35.791,6,51,37455,25,610,31,1258,3163,26,1568,1431,5263,34292
1219.255,6,77,22045,48,255,25941,1440,11373,29,792,526,2391,10672
1778.917,17,79,3312,78,14,23102,14,3276,1,8,0,8,36
285.74,1,4,224,4,28,95246,28,224,0,0,0,0,0
12.292,6,16,6714,5,92,3073,92,348,11,643,1208,1408,6366
0.22,17,2,198,1,39,0,39,67,1,103,0,103,131
7.672,6,23,4478,13,213,639,597,1741,10,441,833,1408,2737
1.431,17,6,1230,3,36,713,36,192,3,318,713,318,1038
12.355,6,1924,1685800,1183,1370,10,1380,1644474,741,630,16,3303,41326
1787.636,17,140,11200,70,48,25907,48,5320,70,56,25907,56,5880
10.196,6,16,3911,9,275,1274,275,643,7,992,867,1440,3268
1780.907,17,140,11200,70,48,25810,48,5320,70,56,25810,56,5880
1.429,6,49,19606,27,917,54,1360,13950,22,433,59,1360,5656
1787.908,6,360,22818,209,69,8595,69,12569,151,69,11919,69,10249
1.695,6,28,10241,17,288,105,598,1550,11,1030,151,1420,8691
1798.602,6,373,26028,216,98,8365,469,15263,157,69,11527,69,10765
323.02,17,6,528,3,60,161509,60,264,3,60,161509,60,264
10.967,6,20,4442,11,275,1096,275,998,9,768,774,1440,3444
1742.42,17,516,156431,516,275,3383,425,156431,0,0,0,0,0
301.26,6,61,30778,36,1163,8607,1440,24747,25,358,373,1440,6031
0.028,17,4,368,2,32,27,32,120,2,96,14,96,248
280.251,6,30,7432,13,158,23354,267,1317,17,543,17514,1400,6115
25.13,17,16,1408,8,48,3588,48,608,8,72,3587,72,800
1774.08,6,203,22290,130,75,13752,267,10057,73,134,24639,1917,12233
0.276,6,21,5000,10,137,30,267,1092,11,692,23,1467,3908
2.362,17,25,6304,10,257,262,1350,2856,15,201,113,1350,3448
0.102,17,5,1559,5,283,25,317,1559,0,0,0,0,0
6.001,6,1745,1628914,1112,1387,5,1408,1591334,633,931,9,2801,37580
121.612,6,13,2311,7,188,20268,245,660,6,1407,24271,1407,1651
126.749,2,2,64,2,8,126749,8,64,0,0,0,0,0
65.29,6,42,8750,21,371,649,766,2033,21,391,3257,2720,6717
0.033,17,2,467,1,33,0,33,61,1,378,0,378,406
11.176,6,1769,1543630,1074,1384,10,1420,1511609,695,467,16,1883,32021
0.044,17,4,588,2,48,39,48,152,2,190,37,308,436
1.187,17,6,432,3,36,583,36,192,3,52,582,52,240
1799.14,6,362,24423,210,87,8608,1189,13798,152,74,11912,405,10625
1776.026,6,180,15480,120,69,14924,69,8940,60,69,30092,69,6540
2.0,1,3,252,3,56,1000,56,252,0,0,0,0,0
1639.255,1,7,392,7,28,273209,28,392,0,0,0,0,0
545.759,17,7,2336,7,305,90959,308,2336,0,0,0,0,0
360.951,2,4,128,4,8,120317,8,128,0,0,0,0,0
252.764,2,2,64,2,8,252764,8,64,0,0,0,0,0
1770.318,17,295,61272,295,179,6021,422,61272,0,0,0,0,0
761.598,1,35,2940,35,56,22399,56,2940,0,0,0,0,0
0.4,6,14,1733,7,288,63,288,588,7,284,35,434,1145
1740.086,1,8,448,8,28,248583,28,448,0,0,0,0,0
241.52,6,340,391493,61,462,4024,1418,6895,279,1401,868,2836,384598
240.303,6,45,9084,22,519,11442,1402,5836,23,204,10922,618,3248
11.404,6,1832,1584668,1119,1363,10,1380,1551906,713,421,15,1923,32762
97.003,6,27,7053,7,154,2035,267,752,20,391,5104,1460,6301
1796.011,17,447,39864,402,35,4478,288,25644,45,288,40019,288,14220
1782.85,6,356,22520,208,69,8612,69,12460,148,69,12128,69,10060
0.009,1,2,112,2,28,9,28,112,0,0,0,0,0
92.825,17,3,228,3,48,46412,48,228,0,0,0,0,0
93.141,6,22,8174,11,520,99,1223,2034,11,948,9295,1631,6140
1775.461,17,71,2976,70,14,25731,14,2940,1,8,0,8,36
0.225,6,2,157,1,0,0,0,40,1,77,0,77,117
1795.509,17,448,39896,403,35,4466,288,25676,45,288,40022,288,14220
1.757,6,68,50602,44,1247,40,1408,43449,24,1179,68,3819,7153
1796.861,1,226,12656,226,28,7986,28,12656,0,0,0,0,0
125.546,6,10,2839,4,100,448,100,264,6,1165,25059,1179,2575
8.929,2,2,64,2,8,8929,8,64,0,0,0,0,0
1777.574,17,140,11200,70,48,25761,48,5320,70,56,25761,56,5880
1.196,6,57,17150,35,320,35,1360,9117,22,793,48,4649,8033
0.04,6,3,160,2,0,40,0,100,1,0,0,0,60
50.932,6,26,7137,13,155,4244,267,1306,13,589,4243,4837,5831
1700.509,17,12,498,11,14,170050,14,462,1,8,0,8,36
1768.647,1,62,5208,62,56,28994,56,5208,0,0,0,0,0
1783.095,6,126,16481,76,87,23106,500,6185,50,180,36387,1420,10296
0.023,17,2,162,1,36,0,36,64,1,70,0,70,98
93.129,17,18,3000,9,48,11640,48,684,9,229,11639,308,2316
240.236,6,50,17269,26,823,9609,1418,14531,24,185,10444,580,2738
219.92,17,6,488,3,53,109959,64,244,3,53,109959,64,244
1759.057,6,117,8503,71,31,25129,31,4880,46,31,39089,31,3623
0.137,6,10,767,5,186,33,186,454,5,45,33,45,313
240.261,6,54,18117,29,798,8580,1418,15082,25,215,10010,580,3035
1.842,17,2,312,2,128,1842,128,312,0,0,0,0,0
131.922,17,4,352,2,60,131921,60,176,2,60,131921,60,176
61.339,6,35,15923,22,809,2920,1408,9249,13,855,5090,4224,6674
0.07,6,10,1677,6,555,6,951,1354,4,159,20,159,323
372.669,6,107,13789,53,155,7166,1189,4923,54,247,7027,1460,8866
1772.361,6,180,15480,120,69,14893,69,8940,60,69,30031,69,6540
0.024,17,2,540,1,64,0,64,92,1,420,0,420,448
3.638,17,5,295,5,31,909,31,295,0,0,0,0,0
1784.241,17,83,3480,82,14,22027,14,3444,1,8,0,8,36
1789.017,6,182,15698,121,69,14908,69,9049,61,69,29808,69,6649
0.054,6,2,92,1,0,0,0,52,1,0,0,0,40
300.83,6,54,10710,27,433,11570,910,3362,27,312,590,1460,7348
1787.858,1,67,5628,67,56,27088,56,5628,0,0,0,0,0
0.025,17,2,503,1,65,0,65,93,1,382,0,382,410
0.009,6,9,1556,5,515,2,515,783,4,557,2,557,773
39.949,17,22,1672,22,48,1902,48,1672,0,0,0,0,0
1794.169,17,80,3354,79,14,23002,14,3318,1,8,0,8,36
358.852,6,50,11058,31,320,11961,1360,5451,19,402,477,2720,5607
1784.407,1,58,4872,58,56,31305,56,4872,0,0,0,0,0
1791.62,6,356,22520,208,69,8655,69,12460,148,69,12187,69,10060
1656.012,1,7,392,7,28,276002,28,392,0,0,0,0,0
12.38,6,21,6825,12,275,1125,275,1038,9,1353,920,1440,5787
0.048,6,9,1340,5,145,12,145,349,4,827,13,827,991
1.613,6,50,19625,27,915,62,1360,13929,23,433,64,1360,5696
26.517,6,3923,3728972,2527,1396,10,1440,3651704,1396,776,18,1440,77268
1797.857,17,446,38980,404,35,4461,288,25708,42,288,42947,288,13272
1793.456,17,142,11360,71,48,25620,48,5396,71,56,25620,56,5964
3.311,6,2,1175,1,0,0,0,40,1,1095,0,1095,1135
251.124,6,43,8054,25,138,304,174,1556,18,412,14766,1452,6498
234.363,6,25,7691,8,267,266,501,1125,17,420,14642,1420,6566
4.9,6,42,7389,22,218,233,314,3503,20,440,244,1152,3886
133.334,1,6,336,6,28,26666,28,336,0,0,0,0,0
240.206,6,54,18420,29,813,8578,1402,15344,25,221,10008,580,3076
167.295,6,24,9022,12,661,116,1360,3156,12,895,15192,1747,5866
0.32,17,3,123,2,11,320,14,79,1,16,0,16,44
0.064,17,2,180,1,30,0,30,58,1,94,0,94,122
1785.857,6,369,24723,213,87,8423,469,14205,156,69,11521,69,10518
1789.592,1,272,28832,272,78,6603,78,28832,0,0,0,0,0
5.131,6,56,20057,28,860,190,1440,14065,28,433,183,1440,5992
1755.985,6,106,6322,60,27,29761,27,3525,46,27,39020,27,2797
301.057,6,53,23283,30,1088,10381,1440,17561,23,399,404,1440,5722
0.01,17,2,487,1,40,0,40,68,1,391,0,391,419
2.875,17,4,1552,4,360,958,360,1552,0,0,0,0,0
1739.57,6,148,9170,78,45,22591,208,5378,70,31,25206,31,3792
0.478,17,3,451,2,39,37,39,134,1,289,0,289,317
1787.292,6,117,13763,75,81,24152,504,5920,42,162,43590,1452,7843
2.178,17,4,314,2,31,2130,31,118,2,70,2135,70,196
17.264,17,31,14047,15,649,1231,1350,10167,16,214,1148,1350,3880
1.906,17,3,1170,3,362,953,362,1170,0,0,0,0,0
2.435,6,5,288,2,0,2265,0,112,3,0,1133,0,176
64.002,6,20,9213,11,524,75,1236,2046,9,1359,7980,2720,7167
280.231,6,26,7272,12,158,25475,267,1277,14,775,21553,3445,5995
627.648,6,63,9473,42,96,15308,504,3702,21,289,27203,1452,5771
7.571,6,591,507076,364,1328,20,1368,490608,227,776,32,1473,16468
133.188,17,4,304,2,48,133171,48,152,2,48,133172,48,152
504.307,2,4,128,4,8,168102,8,128,0,0,0,0,0
0.14,6,10,1568,5,121,34,121,389,5,911,34,911,1179
1787.561,6,106,8524,68,66,26680,66,4964,38,60,48309,60,3560
1774.053,6,80,4212,40,26,45487,26,2106,40,26,45487,26,2106
1788.595,6,1006,194031,497,332,3605,825,90033,509,246,3520,2736,103998
4.209,6,15,3236,7,92,701,92,452,8,394,115,1448,2784
585.957,17,112,8564,57,40,10463,41,3910,55,56,10849,57,4654
3.595,6,14,3168,9,49,449,92,587,5,772,50,2118,2581
8.55,6,10,5905,3,186,4275,267,501,7,1023,866,3426,5404
0.115,6,11,913,6,182,23,182,490,5,77,10,134,423
1.288,6,52,21287,29,898,46,1360,15591,23,476,49,2720,5696
0.533,17,3,543,2,39,502,39,134,1,381,0,381,409
13.707,6,28,4920,14,154,1037,722,1819,14,394,1041,1408,3101
139.944,6,72,20631,37,170,3887,404,3692,35,739,4112,1440,16939
1798.991,1,58,4872,58,56,31561,56,4872,0,0,0,0,0
281.235,6,32,7719,13,143,23436,267,1386,19,464,15604,1400,6333
0.004,17,2,330,1,30,0,30,58,1,244,0,244,272
0.653,17,29,19181,17,860,38,1350,15110,12,311,56,1350,4071
0.385,6,6,324,4,0,128,0,216,2,0,202,0,108
21.914,6,2034,1808383,1262,1375,17,1380,1768969,772,468,28,3303,39414
1781.76,6,360,22887,208,69,8607,69,12529,152,69,11799,69,10358
374.025,1,14,784,14,28,28771,28,784,0,0,0,0,0
58.891,17,32,7310,19,40,3271,41,1304,13,434,4906,505,6006
270.331,6,106,16265,46,409,6007,1064,10181,60,82,4581,760,6084
0.068,6,2,176,1,0,0,0,40,1,96,0,96,136
60.74,6,8,458,5,106,15185,106,314,3,0,1516,0,144
1.571,6,44,13298,23,673,71,1360,7682,21,433,67,1360,5616
289.994,1,4,224,4,28,96664,28,224,0,0,0,0,0
1800.0,6,217,18614,79,74,22692,339,8147,138,69,13138,1062,10467
0.009,6,3,3040,1,0,0,0,40,2,1448,1,1448,3000
240.208,6,55,17879,30,782,8282,1418,14874,25,212,10008,580,3005
1783.805,6,354,22578,206,69,8701,69,12380,148,69,12134,69,10198
5.009,17,4,558,2,36,5004,36,128,2,187,5005,187,430
280.483,6,26,7272,12,158,25498,267,1277,14,678,21572,2085,5995
0.707,17,3,1164,3,360,353,360,1164,0,0,0,0,0
0.557,6,4,220,2,0,557,0,100,2,0,308,0,120
4.049,6,501,473148,336,1348,11,1368,459904,165,931,23,2736,13244
1752.995,6,234,26039,121,125,14608,721,14990,113,167,15649,1414,11049
0.399,6,28,9172,13,266,33,705,1750,15,829,27,1438,7422
0.715,17,4,1344,4,308,238,308,1344,0,0,0,0,0
3.518,6,12,1036,6,283,667,283,603,6,105,667,105,433
300.798,6,35,16177,20,195,15831,431,1900,15,1124,4699,5170,14277
1777.295,17,140,11200,70,48,25757,48,5320,70,56,25757,56,5880
30.513,6,14,5617,5,106,7625,106,314,9,985,3812,1452,5303
1799.97,1,56,4704,0,0,0,0,0,56,56,32726,56,4704
16.996,17,26,13680,14,786,1304,1350,11402,12,161,1541,1350,2278
593.614,1,6,336,6,28,118722,28,336,0,0,0,0,0
280.239,6,29,7392,13,158,23353,267,1317,16,603,18678,2036,6075
0.061,17,2,266,1,41,0,41,69,1,169,0,169,197
1.442,6,48,18257,28,882,53,1360,12636,20,437,65,2720,5621
1790.959,17,349,44347,164,173,10987,1350,33126,185,32,9731,61,11221
47.849,6,28,7217,13,155,3987,267,1306,15,482,3417,1997,5911
10.22,6,27,9816,14,660,786,1460,3234,13,864,836,1460,6582
1745.237,6,95,7203,63,38,28148,205,4476,32,33,56291,98,2727
14.458,6,30,9005,14,153,1112,267,1639,16,839,935,1460,7366
1.462,17,6,817,3,31,725,31,177,3,185,725,196,640
1749.304,6,95,7203,63,38,28214,205,4476,32,33,56416,98,2727
80.4,6,17,8854,17,498,5025,1402,8854,0,0,0,0,0
112.047,6,17,12970,3,214,56023,214,354,14,1338,8253,1702,12616
0.085,6,7,414,3,31,42,31,175,4,31,0,31,239
0.439,17,2,152,1,48,0,48,76,1,48,0,48,76
1772.805,6,180,15480,120,69,14897,69,8940,60,69,30044,69,6540
31.688,6,8,376,2,0,31688,0,88,6,0,6311,0,288
1720.434,17,12,498,11,14,172043,14,462,1,8,0,8,36
31.219,17,36,5292,18,48,1835,48,1368,18,190,1835,308,3924
0.46,6,50,21345,29,941,16,1380,16263,21,468,20,3303,5082
1745.096,6,95,7203,63,38,28146,205,4476,32,33,56283,98,2727
6.463,6,43,7429,23,218,293,314,3543,20,440,327,1152,3886
81.38,6,22,900,10,0,6266,0,404,12,0,7397,0,496
11.615,6,21,6825,12,275,1055,275,1038,9,1353,781,1440,5787
0.183,6,33,15131,15,173,13,319,1480,18,1155,10,1588,13651
22.153,6,3276,3154265,2188,1365,10,1408,3093025,1088,931,20,2801,61240
1798.648,6,356,22520,208,69,8689,69,12460,148,69,12235,69,10060
1.585,17,2,778,2,361,1585,361,778,0,0,0,0,0
1796.042,17,449,39928,404,35,4456,288,25708,45,288,40021,288,14220
1.078,6,25,8080,12,164,83,267,1312,13,869,76,1408,6768
0.03,6,2,149,1,0,0,0,40,1,69,0,69,109
1200.955,1,68,3808,68,28,17924,28,3808,0,0,0,0,0
0.011,6,2,100,1,0,0,0,60,1,0,0,0,40
1667.018,1,7,392,7,28,277836,28,392,0,0,0,0,0
1773.461,6,182,15698,120,69,14903,69,8940,62,69,29065,69,6758
10.05,17,2,130,2,37,10050,37,130,0,0,0,0,0
7.3,6,1547,1440504,988,1381,7,1408,1406772,559,931,12,2801,33732
3.255,6,8,620,3,92,1627,92,256,5,92,766,92,364
1744.383,17,286,55195,286,164,6120,428,55195,0,0,0,0,0
10.761,6,7,380,4,0,3587,0,216,3,0,5372,0,164
2.279,6,14,2351,8,188,325,245,700,6,703,404,1152,1651
1687.073,1,8,448,8,28,241010,28,448,0,0,0,0,0
1741.195,1,39,3276,39,56,45820,56,3276,0,0,0,0,0
0.025,6,9,1878,5,908,5,908,1176,4,486,8,486,702
9.475,6,9,527,5,43,2368,43,311,4,0,3154,0,216
1647.863,1,8,448,8,28,235409,28,448,0,0,0,0,0
2.326,6,14,2351,8,188,332,245,700,6,703,415,1152,1651
1786.447,6,106,8524,68,66,26663,66,4964,38,60,48280,60,3560
1.514,6,40,9985,22,502,72,1460,4444,18,400,77,1460,5541
399.885,2,5,232,5,22,99971,32,232,0,0,0,0,0
0.246,17,12,4389,12,337,22,360,4389,0,0,0,0,0
0.612,6,30,10378,15,247,43,627,1788,15,973,41,1368,8590
1781.778,6,354,22440,207,69,8649,69,12420,147,69,12203,69,10020
0.405,6,23,5975,13,108,33,147,959,10,922,44,2602,5016
1795.302,17,441,39104,397,35,4533,288,25200,44,288,40954,288,13904
3.377,6,4,617,1,302,0,302,354,3,83,1688,83,263
5.313,6,38,7229,20,218,279,314,3423,18,513,297,1179,3806
1799.733,1,57,4788,0,0,0,0,0,57,56,32138,56,4788
7.247,6,6,280,2,0,7247,0,88,4,0,2395,0,192
20.089,6,31,12136,20,930,1057,1179,7559,11,444,904,1780,4577
192.403,1,8,448,8,28,27486,28,448,0,0,0,0,0
5.021,17,4,288,2,36,5004,36,128,2,52,5004,52,160
0.671,6,52,23508,29,1007,23,1380,18322,23,421,26,1923,5186
0.453,6,12,1653,6,288,84,288,548,6,426,51,434,1105
3.15,6,10,420,6,0,630,0,248,4,0,986,0,172
0.136,17,2,574,1,32,0,32,60,1,486,0,486,514
0.76,17,2,778,2,361,760,361,778,0,0,0,0,0
0.336,6,26,9041,13,261,28,683,1752,13,943,27,1408,7289
0.233,17,2,268,1,54,0,54,82,1,158,0,158,186
14.846,17,2,152,2,48,14846,48,152,0,0,0,0,0
0.181,6,46,21487,26,1100,7,1420,16466,20,467,9,1883,5021
0.015,17,2,586,1,46,0,46,74,1,484,0,484,512
11.896,6,1887,1642745,1139,1388,10,1420,1608604,748,467,15,1883,34141
0.53,6,24,7480,14,273,40,663,2104,10,967,54,1471,5376
10.103,17,3,216,2,44,10077,44,144,1,44,0,44,72
1758.484,17,235,58996,235,223,7514,422,58996,0,0,0,0,0
0.102,17,2,701,2,322,102,353,701,0,0,0,0,0
0.208,17,2,172,1,50,0,50,78,1,66,0,66,94
0.092,6,14,5792,7,135,15,135,507,7,1228,15,1448,5285
31.348,17,36,5292,18,48,1843,48,1368,18,190,1843,308,3924
0.01,17,8,2454,8,278,1,317,2454,0,0,0,0,0
1769.765,6,99,9306,66,66,27227,66,5610,33,60,55302,60,3696
1786.511,6,112,9823,72,78,25162,292,5689,40,70,45805,247,4134
7.496,6,48,10074,25,441,312,1164,4166,23,381,332,1460,5908
1708.554,6,92,6975,60,39,28958,205,4246,32,33,55109,98,2729
1785.865,6,356,22520,208,69,8627,69,12460,148,69,12148,69,10060
1680.481,1,15,870,15,30,120034,30,870,0,0,0,0,0
0.114,6,9,1342,5,145,28,145,349,4,829,28,829,993
1787.908,6,361,22996,208,69,8637,69,12598,153,69,11762,69,10398
6.985,6,67,20166,34,562,211,1152,15419,33,489,210,1179,4747
1797.753,6,157,16823,84,85,21659,721,7233,73,144,24964,2840,9590
0.064,6,9,1348,5,145,16,145,349,4,835,15,835,999
1781.934,6,463,80166,210,243,8525,1360,49994,253,189,7070,2720,30172
0.471,6,13,1693,6,288,88,288,548,7,426,44,434,1145
2.092,6,47,18165,26,882,83,1460,12549,21,433,86,1460,5616
38.565,6,15,5554,5,171,9640,171,451,10,911,4284,1448,5103
0.082,17,2,290,1,40,0,40,68,1,194,0,194,222
10.764,6,18,4226,10,275,1196,275,958,8,978,855,1420,3268
1190.405,1,5,280,5,28,297601,28,280,0,0,0,0,0
0.306,6,25,7216,12,155,27,267,1261,13,678,22,2800,5955
0.798,6,26,6892,13,164,66,453,1518,13,670,61,1440,5374
10.434,6,93,29231,48,568,222,1152,22949,45,407,231,1152,6282
57.704,6,45,9285,22,232,640,575,2330,23,430,2615,2128,6955
1785.822,1,58,4872,58,56,31330,56,4872,0,0,0,0,0
20.391,6,30,7860,18,129,1199,159,1863,12,670,1852,1418,5997
0.441,6,50,21374,28,1005,16,1380,16252,22,421,18,1923,5122
0.924,2,3,96,3,8,462,8,96,0,0,0,0,0
1744.577,2,29,928,29,8,62306,8,928,0,0,0,0,0
0.12,6,13,3768,7,171,19,171,555,6,964,22,1448,3213
302.43,2,4,128,4,8,100810,8,128,0,0,0,0,0
371.252,6,21,1419,15,177,26518,177,989,6,110,12239,110,430
7.094,6,1453,1334140,895,1412,7,1440,1300460,558,776,12,1440,33680
19.921,6,3333,3225226,2227,1372,8,1408,3163050,1106,776,17,1408,62176
0.183,6,46,22202,27,1074,7,1420,17221,19,467,9,1883,4981
370.825,6,18,1242,14,180,28525,180,916,4,110,20056,110,326
1789.954,6,376,23872,216,69,8325,69,13125,160,69,11257,69,10747
1795.636,17,448,39896,403,35,4466,288,25676,45,288,40023,288,14220
280.27,6,29,7392,13,158,23355,267,1317,16,603,18682,1400,6075
0.028,17,2,334,1,39,0,39,67,1,239,0,239,267
15.454,17,17,6452,8,488,2196,1350,4135,9,229,1923,1350,2317
11.705,6,24,6651,7,142,1948,267,858,17,510,730,1452,5793
0.131,6,5,1481,4,616,0,1202,1441,1,0,0,0,40
80.144,17,4,352,2,60,80143,60,176,2,60,80143,60,176
240.194,6,52,17805,28,800,8895,1402,15077,24,210,10442,580,2728
47.394,17,26,1976,26,48,1895,48,1976,0,0,0,0,0
0.013,17,3,392,2,60,1,60,176,1,188,0,188,216
1.385,17,2,640,2,292,1385,298,640,0,0,0,0,0
1795.163,6,356,22520,208,69,8672,69,12460,148,69,12211,69,10060
17.898,6,3085,2760040,1826,1423,9,1448,2682312,1259,776,14,1448,77728
1794.527,6,365,25501,212,100,8504,469,14896,153,69,11805,69,10605
1786.165,17,87,3648,86,14,21013,14,3612,1,8,0,8,36
0.137,17,2,586,1,46,0,46,74,1,484,0,484,512
0.08,6,2,104,1,0,0,0,40,1,0,0,0,64
550.672,6,95,16168,46,91,12237,267,3767,49,254,11469,1420,12401
14.136,6,30,7303,14,156,1087,267,1352,16,441,941,1420,5951
0.033,1,5,640,5,100,8,100,640,0,0,0,0,0
23.507,6,25,7031,8,154,85,267,792,17,427,1465,1460,6239
1741.29,6,87,6322,58,31,30548,31,3915,29,31,62188,31,2407
0.324,6,27,9042,13,247,27,624,1672,14,947,23,1438,7370
300.602,6,36,8567,20,335,15821,994,2173,16,522,560,3488,6394
1794.927,17,140,11200,70,48,26013,48,5320,70,56,26013,56,5880
1.537,17,22,6603,9,330,188,1350,3224,13,231,125,1350,3379
11.846,6,25,8473,13,275,987,275,1078,12,986,853,1440,7395
59.567,2,2,64,2,8,59567,8,64,0,0,0,0,0
1788.451,6,356,22520,208,69,8639,69,12460,148,69,12166,69,10060
1795.85,17,80,3354,79,14,23023,14,3318,1,8,0,8,36
6.877,6,42,7389,22,218,327,314,3503,20,513,346,1179,3886
10.92,6,18,4266,10,275,1213,275,958,8,992,857,1440,3308
62.099,6,6,436,4,31,20699,31,270,2,31,62086,31,166
1.347,6,37,8214,19,321,74,1164,2718,18,476,68,2720,5496
196.254,6,28,7352,13,158,16354,267,1317,15,678,14015,2045,6035
3.609,17,3,1167,3,361,1804,361,1167,0,0,0,0,0
0.038,6,9,1338,5,145,9,145,349,4,825,10,825,989
1790.105,6,3604,3445848,1341,133,1335,353,79736,2263,1485,791,5672,3366112
22.983,6,38,8607,16,371,51,800,1787,22,370,1086,4848,6820
0.268,6,24,6021,12,181,24,537,1526,12,772,23,2181,4495
0.282,6,3,160,2,0,282,0,100,1,0,0,0,60
299.878,6,6,364,4,31,99959,31,222,2,31,299853,31,142
1745.014,6,97,7307,63,38,28145,205,4476,34,33,52866,98,2831
0.241,17,2,339,1,33,0,33,61,1,250,0,250,278
1786.545,6,102,8364,68,66,26664,66,4964,34,60,54135,60,3400
1.286,6,46,18650,27,857,49,1360,13114,19,476,62,2715,5536
1787.265,6,106,8515,69,65,26283,65,4970,37,59,49642,59,3545
0.122,17,3,639,2,39,0,39,134,1,477,0,477,505
1785.865,6,356,22520,208,69,8627,69,12460,148,69,12148,69,10060
3.171,6,21,6370,10,268,346,517,1333,11,744,311,1418,5037
1763.823,2,15,480,15,8,125987,8,480,0,0,0,0,0
1796.038,6,354,22440,206,69,8761,69,12380,148,69,12217,69,10060
1775.395,1,59,4956,59,56,30610,56,4956,0,0,0,0,0
31.6,6,4,192,1,0,0,0,48,3,0,12160,0,144
1788.729,17,142,11360,71,48,25552,48,5396,71,56,25552,56,5964
0.084,6,9,1340,5,145,21,145,349,4,827,25,827,991
716.98,17,56,4480,28,48,26554,48,2128,28,56,26554,56,2352
1419.017,6,343,34521,182,160,7604,1189,17726,161,129,8868,1420,16795
0.108,17,2,329,1,45,0,45,73,1,228,0,228,256
0.028,6,3,136,2,0,28,0,88,1,0,0,0,48
0.822,6,30,7902,18,431,48,1360,2920,12,561,59,2744,4982
0.04,17,4,352,2,60,39,60,176,2,60,39,60,176
2.699,6,2,88,2,0,0,0,88,0,0,0,0,0
2.888,6,32,19257,22,763,137,1360,6259,10,2517,305,6027,12998
1799.444,17,449,39928,404,35,4465,288,25708,45,288,40022,288,14220
1323.502,2,14,448,14,8,101807,8,448,0,0,0,0,0
1799.166,17,449,39928,404,35,4464,288,25708,45,288,40021,288,14220
0.33,6,3,144,2,0,1,0,92,1,0,0,0,52
0.507,6,7,426,3,31,253,31,187,4,31,91,31,239
7.095,6,621,567053,405,1335,17,1368,551157,216,776,32,1473,15896
1798.485,17,449,39928,404,35,4462,288,25708,45,288,40019,288,14220
9.855,6,86,25210,44,534,229,1152,19389,42,459,234,1179,5821
16.708,1,9,504,9,28,2088,28,504,0,0,0,0,0
1.72,17,23,6670,9,252,215,1350,2524,14,268,120,1350,4146
39.055,17,22,1936,11,48,3904,48,836,11,72,3904,72,1100
1788.12,1,8,448,8,28,255445,28,448,0,0,0,0,0
1688.611,17,15,1094,8,30,241227,30,464,7,62,281382,62,630
79.165,6,37,8495,18,410,520,882,1982,19,478,4388,2720,6513
63.141,6,46,10547,20,256,3323,1189,3120,26,425,2525,1420,7427
0.103,17,2,152,1,48,0,48,76,1,48,0,48,76
1781.599,6,81,4302,41,26,44538,26,2184,40,26,45680,26,2118
106.651,6,41,9136,14,149,2430,267,1612,27,306,4101,1420,7524
359.17,6,42,8647,20,166,8679,501,1800,22,313,17098,1420,6847
0.41,6,13,1096,7,256,65,256,544,6,304,79,304,552
7.564,6,3,168,2,0,7437,0,116,1,0,0,0,52
8.081,6,18,1633,9,222,1008,222,1030,9,231,1008,231,603
17.241,6,9,527,5,43,4310,43,311,4,0,5744,0,216
2.197,17,3,174,3,30,1098,30,174,0,0,0,0,0
3.669,17,8,1536,4,39,1218,39,268,4,289,1057,289,1268
0.019,17,2,261,1,39,0,39,67,1,166,0,166,194
10.889,6,11,660,4,0,2282,0,240,7,0,1812,0,420
31.629,6,7,308,1,0,0,0,44,6,0,6304,0,264
23.687,6,19,2122,9,444,2959,666,1252,10,231,2630,231,870
5.777,6,734,667053,468,1352,11,1368,646693,266,776,21,1473,20360
1.629,1,9,756,9,56,203,56,756,0,0,0,0,0
0.021,17,2,672,2,308,21,308,672,0,0,0,0,0
0.142,17,2,136,1,32,0,32,60,1,48,0,48,76
0.041,6,3,136,2,0,0,0,96,1,0,0,0,40
1730.857,17,130,10400,65,48,27044,48,4940,65,56,27044,56,5460
240.254,6,54,14831,28,653,8897,1418,11925,26,193,9609,580,2906
770.932,17,152,11552,152,48,5105,48,11552,0,0,0,0,0
5.019,17,4,288,2,36,5003,36,128,2,52,5003,52,160
240.198,6,55,17274,29,763,8578,1408,14510,26,175,9607,580,2764
3.576,6,15,3197,8,49,510,92,511,7,463,32,1408,2686
1.617,6,29,6120,14,150,124,267,1615,15,650,106,1380,4505
350.39,6,22,6828,4,189,116796,267,547,18,370,20600,1420,6281
1773.207,6,180,15480,120,69,14900,69,8940,60,69,30047,69,6540
0.023,17,2,334,1,39,0,39,67,1,239,0,239,267
0.105,17,2,588,1,39,0,39,67,1,493,0,493,521
0.161,6,3,182,2,31,161,31,111,1,31,0,31,71
14.131,6,16,3262,9,210,1766,210,908,7,664,2350,904,2354
0.005,17,2,394,1,36,0,36,64,1,302,0,302,330
300.579,6,19,1279,6,177,60079,177,497,13,110,25033,110,782
280.52,6,29,7392,13,158,23376,267,1317,16,678,18695,3456,6075
4.391,6,41,7349,20,218,231,314,3423,21,440,206,1152,3926
0.152,17,2,212,1,46,0,46,74,1,110,0,110,138
35.784,17,20,1760,10,48,3975,48,760,10,72,3975,72,1000
19.53,6,38,9527,18,793,521,1460,3925,20,399,1018,1460,5602
63.215,6,12,1785,7,304,10535,304,1264,5,83,15802,83,521
1752.22,6,95,7203,63,38,28261,205,4476,32,33,56508,98,2727
10.778,6,20,4442,11,275,1077,275,998,9,768,752,1440,3444
1786.228,17,87,3648,86,14,21014,14,3612,1,8,0,8,36
1799.748,6,356,22520,208,69,8694,69,12460,148,69,12243,69,10060
0.327,6,4,1037,2,0,221,0,104,2,853,107,853,933
1.122,6,24,8004,12,164,86,267,1288,12,1014,86,2816,6716
280.363,6,30,7432,13,158,23363,267,1317,17,543,17518,1400,6115
280.507,6,28,7352,13,158,23375,267,1317,15,775,20027,4836,6035
1772.549,6,180,15480,120,69,14895,69,8940,60,69,30036,69,6540
0.0,17,1,76,1,48,0,48,76,0,0,0,0,0
0.212,6,11,1095,6,146,38,146,390,5,250,43,499,705
1795.549,1,279,15624,279,28,6458,28,15624,0,0,0,0,0
20.283,6,19,2432,10,189,2253,517,1298,9,323,2526,499,1134
1771.643,6,99,9240,66,65,27256,65,5577,33,59,55361,59,3663
1772.127,6,180,15480,120,69,14891,69,8940,60,69,30032,69,6540
1788.238,17,87,3648,86,14,21038,14,3612,1,8,0,8,36
3.101,17,15,5866,7,415,510,1350,3107,8,316,437,1350,2759
280.576,6,29,7392,13,158,23381,267,1317,16,603,18698,2036,6075
0.489,6,24,6016,13,108,40,147,959,11,768,48,1581,5057
59.343,6,35,8320,17,378,541,786,1846,18,478,3482,2720,6474
1776.139,17,73,3060,72,14,25016,14,3024,1,8,0,8,36
8.282,6,29,7874,14,214,637,721,1852,15,677,482,1414,6022
280.333,6,29,7392,13,158,23361,267,1317,16,603,18682,1400,6075
1.017,6,20,5926,11,286,101,559,1303,9,709,112,1380,4623
0.096,6,9,1339,5,145,24,145,349,4,826,23,826,990
4.262,6,114,88862,49,131,88,232,2489,65,1373,63,2860,86373
6.996,6,767,658817,467,1338,14,1368,638553,300,776,22,1473,20264
1779.939,17,142,11360,71,48,25427,48,5396,71,56,25427,56,5964
11.692,6,38,13527,17,402,730,722,3100,21,684,522,2760,10427
57.044,6,42,8675,20,360,794,766,1949,22,364,2710,1360,6726
1.009,6,8,521,4,31,336,31,270,4,31,218,31,251
8.231,6,40,7400,21,218,411,314,3463,19,453,442,1179,3937
1.315,6,48,19773,28,869,48,1360,14197,20,476,59,2715,5576
1744.181,6,97,7307,63,38,28131,205,4476,34,33,52843,98,2831
8.703,6,1313,1180555,838,1362,10,1380,1157313,475,383,18,1380,23242
0.363,6,6,324,4,0,121,0,216,2,0,195,0,108
63.706,6,26,13822,12,274,68,504,1454,14,1292,4890,4377,12368
240.381,6,44,8447,22,449,11445,1418,5648,22,205,11445,580,2799
0.113,17,2,251,1,36,0,36,64,1,159,0,159,187
1797.531,17,448,39896,403,35,4471,288,25676,45,288,40017,288,14220
95.417,6,18,5839,10,784,10601,1360,3538,8,247,13595,272,2301
1744.886,6,95,7203,63,38,28143,205,4476,32,33,56278,98,2727
0.196,17,2,2728,2,1336,196,1336,2728,0,0,0,0,0
7.617,6,1217,1051532,731,1388,10,1420,1027871,486,420,15,1420,23661
1777.402,17,73,3060,72,14,25033,14,3024,1,8,0,8,36
10.441,6,16,3911,9,275,1305,275,643,7,992,901,1440,3268
240.352,6,45,8895,22,524,11444,1418,5880,23,181,10924,617,3015
41.022,17,22,1672,22,48,1953,48,1672,0,0,0,0,0
101.971,17,4,352,2,60,101970,60,176,2,60,101970,60,176
281.532,6,40,7679,19,159,15638,517,1988,21,459,14074,2412,5691
86.41,17,7,532,7,48,14401,48,532,0,0,0,0,0
6.474,6,33,8932,16,303,431,722,2768,17,685,341,2760,6164
7.22,6,6,280,2,0,7220,0,88,4,0,2356,0,192
8.294,6,78,24890,39,568,218,1152,19189,39,413,211,1152,5701
1771.363,6,99,9306,66,66,27251,66,5610,33,60,55352,60,3696
1745.416,6,95,7203,63,38,28151,205,4476,32,33,56294,98,2727
28.426,6,1187,1096769,765,1359,37,1368,1067629,422,776,66,2736,29140
0.367,6,6,300,4,0,0,0,208,2,0,367,0,92
6.365,6,47,19105,26,955,254,1360,13489,21,433,308,1360,5616
0.081,17,2,174,1,45,0,45,73,1,73,0,73,101
67.541,6,27,7177,13,155,5628,267,1306,14,530,5194,3417,5871
1785.693,17,227,54228,227,210,7901,422,54228,0,0,0,0,0
280.28,6,28,7352,12,158,25480,267,1277,16,603,18678,1400,6075
375.91,6,23,1538,16,180,25060,180,1056,7,110,10401,110,482
39.842,17,44,6468,22,48,1896,48,1672,22,190,1896,308,4796
0.372,17,2,152,1,48,0,48,76,1,48,0,48,76
1772.352,6,180,15480,120,69,14893,69,8940,60,69,30034,69,6540
296.509,6,87,12567,44,172,6348,1189,4356,43,270,7059,1420,8211
1759.276,17,168,14066,156,30,11350,37,9090,12,386,154506,463,4976
341.02,6,78,11899,36,372,9743,841,4576,42,150,8309,1539,7323
1788.372,1,263,14728,263,28,6825,28,14728,0,0,0,0,0
1390.585,6,276,17457,161,69,8691,69,9614,115,69,12198,69,7843
629.7,2,4,128,4,8,209900,8,128,0,0,0,0,0
1680.499,1,15,840,15,28,120035,28,840,0,0,0,0,0
2.745,17,3,1167,3,361,1372,361,1167,0,0,0,0,0
1.497,6,41,11378,22,547,71,1360,5842,19,433,72,1360,5536
7.695,6,1440,1136157,743,1425,10,1448,1087985,697,776,10,1448,48172
1741.238,6,90,6521,59,31,30021,31,3998,31,31,58040,31,2523
198.373,1,6,336,6,28,39674,28,336,0,0,0,0,0
1.572,6,47,19364,27,905,60,1360,13788,20,433,70,1360,5576
1799.753,17,140,11200,70,48,26082,48,5320,70,56,26083,56,5880
280.272,6,29,7392,13,158,23356,267,1317,16,603,18680,1400,6075
12.196,6,32,6179,17,247,762,335,3159,15,604,853,1179,3020
1786.668,6,102,8364,68,66,26666,66,4964,34,60,54138,60,3400
0.052,17,2,144,1,36,0,36,64,1,52,0,52,80
1.133,6,25,8056,12,164,87,267,1288,13,869,80,1448,6768
1684.495,2,13,416,13,8,140374,8,416,0,0,0,0,0
367.031,6,18,1242,14,180,28233,180,916,4,110,20062,110,326
47.395,6,53,27681,31,935,1579,1402,24991,22,219,2155,580,2690
0.186,6,46,21449,26,1097,7,1420,16428,20,467,9,1883,5021
93.876,6,58,38576,38,1152,2537,1408,30796,20,961,3231,3847,7780
2.665,6,2,88,2,0,0,0,88,0,0,0,0,0
232.224,17,4,240,2,32,232223,32,120,2,32,232223,32,120
83.358,17,4,1344,4,308,27786,308,1344,0,0,0,0,0
1073.615,17,746,52427,670,40,1604,41,46000,76,56,528,57,6427
3.22,6,5,232,2,0,3220,0,88,3,0,1510,0,144
3.12,2,2,64,2,8,3120,8,64,0,0,0,0,0
280.463,6,28,7352,12,158,25496,267,1277,16,603,18690,1380,6075
1.136,6,57,17994,28,707,42,1360,8925,29,464,40,2186,9069
1787.538,6,102,8296,68,65,26679,65,4930,34,59,54164,59,3366
0.475,17,3,451,2,39,247,39,134,1,289,0,289,317
1789.038,17,144,11520,72,48,25197,48,5472,72,56,25197,56,6048
1.274,17,4,316,2,34,1001,34,124,2,68,1,68,192
1.414,6,4,172,2,0,1414,0,84,2,0,1032,0,88
19.011,17,18,12284,10,848,2108,1350,8768,8,411,2710,1350,3516
61.63,6,37,8028,16,136,4108,267,1877,21,441,3080,1460,6151
10.761,6,20,4390,11,275,1076,275,998,9,755,755,1414,3392
28.206,6,41,11883,22,688,1343,1408,4641,19,446,587,3534,7242
1771.344,6,99,9306,66,66,27251,66,5610,33,60,55351,60,3696
926.137,6,114,8593,43,66,22047,295,4062,71,48,13228,78,4531
31.905,6,9,396,2,0,3386,0,88,7,0,5302,0,308
1798.643,1,58,4872,58,56,31555,56,4872,0,0,0,0,0
1779.92,1,341,28644,341,56,5235,56,28644,0,0,0,0,0
2.532,17,15,5367,7,400,415,1350,3001,8,267,356,1350,2366
1796.515,6,356,22520,208,69,8678,69,12460,148,69,12220,69,10060
4.378,6,38,7229,19,218,243,314,3383,19,513,229,1179,3846
300.376,6,42,21987,24,1053,13059,1408,16038,18,625,1313,1408,5949
77.22,6,34,8423,16,401,37,889,1888,18,446,4534,3488,6535
0.429,17,4,566,2,31,418,31,118,2,196,416,196,448
3.368,17,4,1410,4,324,1122,376,1410,0,0,0,0,0
0.104,17,2,603,2,273,104,293,603,0,0,0,0,0
0.024,17,2,212,1,46,0,46,74,1,110,0,110,138
188.218,17,6,360,3,32,94108,32,180,3,32,94108,32,180
0.529,17,3,543,2,39,403,39,134,1,381,0,381,409
2.731,6,25,8056,12,164,229,267,1288,13,1216,211,3859,6768
280.233,6,28,7352,13,158,23352,267,1317,15,678,20014,4200,6035
1681.624,17,14,1036,7,30,280262,30,406,7,62,280262,62,630
6.067,17,12,1032,6,47,1212,47,450,6,69,1211,75,582
1.381,17,29,13745,15,660,98,1350,10322,14,216,63,1350,3423
1472.785,6,84,6290,54,40,27788,205,3822,30,33,50779,98,2468
20.126,6,22,5470,12,107,1829,159,1074,10,773,2235,1408,4396
290.383,6,36,3656,18,324,17081,584,1652,18,153,17081,580,2004
0.044,17,2,912,1,308,0,308,336,1,548,0,548,576
0.014,17,3,484,2,46,3,46,148,1,308,0,308,336
31.201,17,4,352,2,48,31190,48,152,2,72,31192,72,200
83.283,17,4,352,2,60,83282,60,176,2,60,83282,60,176
842.272,2,7,224,7,8,140378,8,224,0,0,0,0,0
11.783,6,1889,1631149,1142,1373,10,1420,1596856,747,467,15,1883,34293
174.959,17,10,417,9,13,21869,14,373,1,16,0,16,44
1.584,6,49,19651,27,920,60,1360,13995,22,433,65,1360,5656
23.668,17,7,2762,7,366,3944,373,2762,0,0,0,0,0
1223.957,6,185037,151651393,90070,742,13,1396,5145760,94967,1493,12,16752,146505633
0.664,6,10,924,5,283,112,283,551,5,105,110,105,373
0.418,6,6,324,4,0,139,0,216,2,0,205,0,108
1625.348,1,8,448,8,28,232192,28,448,0,0,0,0,0
145.014,6,104,77793,66,1284,2230,1448,67655,38,679,2393,1448,10138
15.729,17,20,9765,10,662,1743,1350,6905,10,258,1743,1350,2860
1.404,17,3,1164,3,360,702,360,1164,0,0,0,0,0
1779.667,6,180,15480,120,69,14955,69,8940,60,69,30157,69,6540
1.027,6,131,144211,58,268,18,517,4110,73,1975,14,9814,140101
4.001,17,4,244,4,33,1333,33,244,0,0,0,0,0
372.815,6,46,6476,22,119,17753,722,2466,24,183,16195,1448,4010
15.363,17,15,5452,7,411,2548,1350,3077,8,268,2183,1350,2375
15.555,6,2,104,1,0,0,0,40,1,0,0,0,64
0.275,6,2,88,2,0,0,0,88,0,0,0,0,0
271.023,1,4,224,4,28,90341,28,224,0,0,0,0,0
63.324,6,27,7177,13,155,5277,267,1306,14,530,4870,3417,5871
11.24,6,27,11355,13,275,936,275,1078,14,1078,834,1414,10277
1775.669,6,181,15589,120,69,14921,69,8940,61,69,29591,69,6649
1.951,17,2,672,2,308,1951,308,672,0,0,0,0,0
7.801,6,1152,996629,659,1425,11,1448,963925,493,776,15,1448,32704
6.017,17,4,358,2,32,6003,32,120,2,91,6008,91,238
64.959,6,7,420,7,0,0,0,420,0,0,0,0,0
1745.283,2,22,704,22,8,83108,8,704,0,0,0,0,0
1.618,6,19,3781,10,234,179,564,1452,9,463,174,1343,2329
1789.181,1,201,11256,201,28,8945,28,11256,0,0,0,0,0
1.534,6,54,20111,29,934,54,1460,14290,25,400,55,1460,5821
22.426,6,3197,2979316,2064,1365,10,1408,2915712,1133,931,19,2801,63604
299.9,1,4,224,4,28,99966,28,224,0,0,0,0,0
63.509,6,34,8998,15,327,134,1189,2575,19,514,3527,1917,6423
372.105,6,23,1535,16,177,24807,177,1053,7,110,10384,110,482
2.98,17,4,240,4,32,993,32,240,0,0,0,0,0
245.143,6,466,405812,160,766,1541,1418,26727,306,1315,803,1418,379085
1680.878,17,13,534,11,14,168069,14,462,2,8,1680697,8,72
1787.159,6,104,8444,68,66,26674,66,4964,36,60,51057,60,3480
1080.16,17,112,9356,104,30,10486,37,6060,8,384,145906,463,3296
0.783,6,20,5950,11,282,78,546,1290,9,716,88,1420,4660
250.078,6,23,11377,23,565,11367,1402,11377,0,0,0,0,0
176.255,6,19,1588,13,69,14687,69,934,6,69,30033,69,654
755.879,2,4,128,4,8,251959,8,128,0,0,0,0,0
1798.955,17,448,39896,403,35,4475,288,25676,45,288,40017,288,14220
1797.834,6,372,26526,218,104,8284,469,15812,154,69,11747,69,10714
31.042,17,6,1712,6,257,6208,604,1712,0,0,0,0,0
0.795,6,22,7333,13,334,66,663,2021,9,1209,94,1946,5312
152.35,17,19,7432,19,363,8463,462,7432,0,0,0,0,0
98.467,17,4,352,2,60,98466,60,176,2,60,98466,60,176
1785.186,17,140,11200,70,48,25872,48,5320,70,56,25872,56,5880
1.348,6,49,19683,27,922,51,1460,14027,22,476,55,2615,5656
0.353,17,4,420,2,33,336,33,122,2,121,340,145,298
0.272,6,21,5000,10,137,30,267,1092,11,577,26,1400,3908
0.02,17,4,420,2,33,0,33,122,2,121,3,145,298
1799.22,17,449,39928,404,35,4464,288,25708,45,288,40022,288,14220
4.226,6,39,7269,20,218,222,314,3423,19,513,221,1179,3846
21.387,6,27,4841,12,205,1944,722,1645,15,300,1504,1408,3196
1.36,6,50,19694,27,920,52,1460,13998,23,433,53,1460,5696
32.215,6,9,432,2,0,299,0,96,7,0,5317,0,336
0.432,6,13,1693,7,288,67,288,588,6,426,49,434,1105
9.434,6,1836,1631333,1071,1433,8,1448,1580501,765,776,12,1448,50832
157.736,17,4,352,2,60,157734,60,176,2,60,157735,60,176
280.462,6,30,7432,13,158,23371,267,1317,17,603,17526,2760,6115
1.736,6,14,2351,8,188,248,245,700,6,703,293,1152,1651
1795.086,17,80,3354,79,14,23013,14,3318,1,8,0,8,36
0.736,17,4,1574,4,365,245,373,1574,0,0,0,0,0
31.806,17,4,352,2,48,31796,48,152,2,72,31795,72,200
137.047,6,31,14175,16,997,70,1440,6654,15,863,9776,1440,7521
0.341,17,2,154,1,33,0,33,61,1,65,0,65,93
1751.091,17,12,498,11,14,175109,14,462,1,8,0,8,36
3.209,6,2,88,2,0,0,0,88,0,0,0,0,0
0.129,6,16,4925,10,290,14,517,1109,6,1165,22,1508,3816
19.457,6,11,612,6,0,3891,0,328,5,0,4700,0,284
1776.601,17,140,11200,70,48,25747,48,5320,70,56,25747,56,5880
280.268,6,30,7432,14,158,21559,267,1357,16,603,18681,2036,6075
1740.968,1,15,840,15,28,124354,28,840,0,0,0,0,0
263.465,1,12,672,12,28,23951,28,672,0,0,0,0,0
8.305,17,4,240,2,32,8303,32,120,2,32,8304,32,120
185.193,17,4,352,2,60,185192,60,176,2,60,185192,60,176
0.071,17,4,588,2,48,60,48,152,2,190,59,308,436
1789.245,6,414,35656,204,72,8813,1305,14533,210,94,8560,1929,21123
0.09,17,2,2750,2,1347,90,1347,2750,0,0,0,0,0
1795.488,17,176,13728,176,50,10259,50,13728,0,0,0,0,0
68.311,17,4,240,2,32,68310,32,120,2,32,68310,32,120
1788.638,1,247,13832,247,28,7270,28,13832,0,0,0,0,0
300.812,6,45,14486,26,866,12032,1360,8879,19,402,479,2667,5607
0.517,6,29,7522,17,306,32,1089,2828,12,701,46,1728,4694
102.492,6,11,1691,11,139,10249,139,1691,0,0,0,0,0
142.163,17,6,528,3,60,71081,60,264,3,60,71081,60,264
1782.84,6,356,22520,208,69,8612,69,12460,148,69,12128,69,10060
1532.54,6,128,8299,68,53,22873,208,4814,60,31,25972,31,3485
0.052,17,2,237,1,72,0,72,100,1,109,0,109,137
1.377,6,50,21065,28,950,51,1460,15409,22,476,55,2615,5656
11.326,6,18,5610,10,275,1258,275,958,8,1440,859,1440,4652
1783.366,17,83,3480,82,14,22016,14,3444,1,8,0,8,36
1794.247,17,144,11520,72,48,25270,48,5472,72,56,25271,56,6048
1774.796,6,180,15480,120,69,14914,69,8940,60,69,30075,69,6540
1796.284,1,186,10416,186,28,9709,28,10416,0,0,0,0,0
1782.32,17,83,3480,82,14,22003,14,3444,1,8,0,8,36
0.62,6,10,924,5,283,106,283,551,5,105,105,105,373
634.156,6,47,3111,29,42,22648,208,2019,18,31,35406,31,1092
376.778,6,23,1535,16,177,25118,177,1053,7,110,10425,110,482
175.798,6,25,9573,12,465,67,1460,2374,13,952,14638,1460,7199
81.617,6,21,868,10,0,3389,0,408,11,0,8156,0,460
280.322,6,29,7392,13,158,23360,267,1317,16,603,18683,1400,6075
1.003,17,2,677,1,300,0,300,328,1,321,0,321,349
240.305,6,43,9009,21,524,12014,1418,5819,22,226,11442,639,3190
240.191,6,55,18667,30,783,8282,1418,15671,25,211,10007,580,2996
2.345,6,2,80,1,0,0,0,40,1,0,0,0,40
1785.138,6,102,8364,68,66,26643,66,4964,34,60,54092,60,3400
1786.925,6,104,8376,68,65,26670,65,4930,36,59,51051,59,3446
1744.29,6,95,7203,63,38,28133,205,4476,32,33,56258,98,2727
1.995,17,8,1344,4,33,662,33,244,4,247,661,323,1100
1775.099,17,100,33200,100,304,17930,323,33200,0,0,0,0,0
280.262,6,52,8323,25,106,11675,517,2293,27,417,10777,1418,6030
1.13,6,3,210,1,0,0,0,40,2,90,58,90,170
0.069,17,2,167,1,39,0,39,67,1,72,0,72,100
527.544,6,71,11323,29,110,18840,267,3041,42,183,12866,1452,8282
1783.968,1,59,4956,59,56,30758,56,4956,0,0,0,0,0
280.241,6,27,7312,13,158,23353,267,1317,14,775,21550,2800,5995
0.291,17,2,157,1,31,0,31,59,1,70,0,70,98
1681.008,1,15,840,15,28,120072,28,840,0,0,0,0,0
1394.738,1,38,2128,38,28,37695,28,2128,0,0,0,0,0
1783.166,17,83,3480,82,14,22014,14,3444,1,8,0,8,36
241.0,6,60,15624,30,645,8310,1368,11930,30,192,8309,580,3694
1795.995,6,125,8033,71,48,25657,208,4788,54,31,33880,31,3245
838.037,6,96,6554,35,46,23769,46,2734,61,46,13967,46,3820
10.435,6,82,24805,41,560,260,1152,19008,41,461,254,1179,5797
280.26,6,31,7472,14,158,21558,267,1357,17,543,17511,1400,6115
1796.196,1,190,10640,190,28,9503,28,10640,0,0,0,0,0
1793.33,1,58,4872,0,0,0,0,0,58,56,31461,56,4872
254.924,6,41,7556,21,132,12746,501,2035,20,336,13411,1420,5521
1782.915,6,382,23800,218,69,8216,69,12860,164,57,10938,69,10940
1795.283,17,81,3390,79,14,23014,14,3318,2,8,1795110,8,72
22.122,6,9,577,0,0,0,0,0,9,31,2765,31,577
34.704,6,31,11555,16,150,2313,288,1588,15,917,2392,1718,9967
1787.104,6,102,8364,68,66,26673,66,4964,34,60,54151,60,3400
69.254,6,58,20602,30,667,2382,1460,12583,28,529,2558,1460,8019
0.058,6,2,1269,1,1189,0,1189,1229,1,0,0,0,40
300.669,6,38,8534,20,307,15824,882,2061,18,441,500,1360,6473
1750.695,6,97,7307,63,38,28237,205,4476,34,33,53038,98,2831
1771.638,6,99,9240,66,65,27255,65,5577,33,59,55360,59,3663
0.923,6,11,1727,7,100,153,100,384,4,589,217,1152,1343
1794.393,1,110,6160,110,28,16462,28,6160,0,0,0,0,0
1747.371,1,74,6216,74,56,23936,56,6216,0,0,0,0,0
10.358,6,80,24485,40,552,265,1152,18744,40,459,258,1179,5741
1772.804,6,181,15589,120,69,14897,69,8940,61,69,29542,69,6649
12.619,17,3,984,3,300,6309,300,984,0,0,0,0,0
145.851,2,2,64,2,8,145851,8,64,0,0,0,0,0
312.168,6,39,7286,22,262,14863,517,1940,17,744,19507,1418,5346
505.674,6,61,11182,29,199,18059,1189,3756,32,323,4523,1460,7426
15.682,17,14,6614,7,613,2601,1350,4487,7,275,2601,1350,2127
1782.497,17,83,3480,82,14,22006,14,3444,1,8,0,8,36
10.774,6,20,4350,11,275,1077,275,998,9,992,750,1440,3352
1789.909,1,238,13328,238,28,7552,28,13328,0,0,0,0,0
1680.73,17,12,498,11,14,168073,14,462,1,8,0,8,36
1684.478,2,13,416,13,8,140373,8,416,0,0,0,0,0
3.012,17,2,152,2,48,3012,48,152,0,0,0,0,0
12.383,6,1999,1714533,1187,1388,10,1420,1677796,812,420,15,1420,36737
56.827,6,27,7177,13,155,4735,267,1306,14,530,4370,3417,5871
92.335,6,32,8952,14,158,7102,267,1357,18,624,5429,1400,7595
0.169,17,2,588,1,39,0,39,67,1,493,0,493,521
30.995,6,27,8762,15,405,2211,1066,2422,12,817,2811,2736,6340
1791.061,1,276,29256,276,78,6512,78,29256,0,0,0,0,0
1795.92,17,446,38980,404,35,4456,288,25708,42,288,42951,288,13272
16.614,17,4,240,2,32,16613,32,120,2,32,16613,32,120
1796.05,6,364,65144,242,302,7452,302,48832,122,83,14843,83,16312
1789.293,1,225,23850,225,78,7987,78,23850,0,0,0,0,0
10.879,6,749,635375,459,1312,23,1368,615631,290,776,36,1473,19744
240.161,6,53,17680,28,795,8894,1402,14994,25,172,10006,580,2686
142.881,6,23,3244,12,409,12989,582,1860,11,396,14286,580,1384
280.196,17,4,1054,2,30,280192,30,116,2,441,280191,463,938
1776.137,17,140,11200,70,48,25741,48,5320,70,56,25741,56,5880
1.685,6,14,2351,8,188,240,245,700,6,703,285,1152,1651
280.553,6,31,7472,14,158,21581,267,1357,17,543,17527,1400,6115
1787.139,6,244,46664,152,483,11835,483,36892,92,83,19638,83,9772
1787.135,6,104,8376,68,65,26673,65,4930,36,59,51057,59,3446
15.823,17,15,9131,8,821,2250,1350,6798,7,305,2624,1350,2333
300.36,6,48,27968,30,1130,10357,1408,21936,18,636,1796,1491,6032
1.415,6,38,8276,19,320,78,1162,2740,19,433,68,1360,5536
15.475,17,15,4512,7,302,2574,1350,2316,8,246,2206,1350,2196
1798.039,6,374,26275,218,99,8285,469,15274,156,69,11598,69,11001
0.22,6,12,3704,6,171,43,171,491,6,964,43,1448,3213
3.136,17,4,624,4,128,1045,128,624,0,0,0,0,0
1684.129,6,221,19469,83,84,20536,376,8974,138,71,12292,1062,10495
280.33,6,30,7432,14,158,21563,267,1357,16,603,18683,1400,6075
1787.735,6,104,8376,68,65,26682,65,4930,36,59,51075,59,3446
3.081,17,3,228,2,48,3020,48,152,1,48,0,48,76
19.092,6,37,8495,18,410,511,882,1982,19,441,1053,1460,6513
75.602,6,33,7693,13,155,6300,267,1306,20,371,3978,1997,6387
280.838,6,28,7421,13,158,23403,267,1317,15,687,20056,3445,6104
0.501,6,24,6042,13,108,41,147,959,11,773,47,1608,5083
97.404,6,39,9562,19,463,528,808,2647,20,435,5116,2720,6915
1791.723,17,87,3648,86,14,21079,14,3612,1,8,0,8,36
0.132,17,4,304,2,37,0,37,130,2,59,58,65,174
758.742,1,8,977,8,94,108391,173,977,0,0,0,0,0
1772.527,6,180,15480,120,69,14895,69,8940,60,69,30034,69,6540
300.597,6,38,8566,20,315,15820,882,2093,18,441,497,1440,6473
1797.961,1,58,4872,0,0,0,0,0,58,56,31543,56,4872
1783.81,6,434,28197,217,100,8258,469,15096,217,34,8258,64,13101
1770.131,6,107,9722,66,66,27232,66,5610,41,60,44250,60,4112
1774.708,6,180,15480,120,69,14913,69,8940,60,69,30075,69,6540
280.34,6,29,7392,13,158,23361,267,1317,16,603,18685,1400,6075
432.973,6,9,1708,6,298,86594,413,1135,3,151,216394,269,573
240.664,6,55,18171,28,804,8911,1418,15132,27,232,9253,580,3039
0.859,6,2,1194,1,0,0,0,40,1,1114,0,1114,1154
1781.64,17,140,11200,70,48,25820,48,5320,70,56,25820,56,5880
0.05,6,14,5488,7,96,8,96,468,7,1163,8,1448,5020
0.24,6,3,199,1,31,0,31,83,2,0,240,0,116
0.09,1,2,112,2,28,90,28,112,0,0,0,0,0
1681.498,17,14,1036,7,30,280244,30,406,7,62,280244,62,630
0.064,17,2,323,1,33,0,33,61,1,234,0,234,262
300.808,6,37,8424,20,280,15832,775,1990,17,478,538,1928,6434
3.218,6,26,8696,14,220,247,543,1472,12,961,277,1360,7224
1758.246,17,312,68991,312,193,5653,479,68991,0,0,0,0,0
105.061,6,57,19813,30,702,3622,1360,11788,27,630,4032,3494,8025
14.001,6,21,3585,12,211,1272,211,1126,9,665,1749,904,2459
2.415,6,22,5961,13,108,201,147,959,9,773,145,1608,5002
0.008,17,4,350,2,34,0,34,124,2,85,3,91,226
1792.199,6,240,35580,150,302,12028,302,25920,90,83,20136,83,9660
84.812,6,21,7300,13,169,7067,517,1539,8,906,158,1452,5761
1780.898,17,142,11360,71,48,25441,48,5396,71,56,25441,56,5964
1773.217,6,180,15480,120,69,14900,69,8940,60,69,30052,69,6540
280.414,6,30,7432,14,158,21570,267,1357,16,678,18690,3456,6075
0.032,17,2,1152,1,548,0,548,576,1,548,0,548,576
5.603,6,39,7269,19,218,311,314,3383,20,513,280,1179,3886
0.015,17,2,426,1,37,0,37,65,1,333,0,333,361
12.242,17,3,228,3,48,6121,48,228,0,0,0,0,0
1787.895,6,370,25839,214,99,8393,469,15114,156,69,11532,69,10725
15.404,17,17,9261,9,765,1921,1350,7141,8,237,2196,1350,2120
0.504,6,27,9155,13,282,42,769,1814,14,943,35,1368,7341
0.916,17,2,122,2,33,916,33,122,0,0,0,0,0
4.834,6,35,6209,19,206,268,314,2824,16,548,304,1179,3385
10.51,6,21,6596,5,154,2627,267,672,16,479,671,1420,5924
1745.017,6,95,7203,63,38,28145,205,4476,32,33,56280,98,2727
3.884,17,4,268,4,39,1294,39,268,0,0,0,0,0
2.908,17,4,518,3,39,702,39,201,1,289,0,289,317
0.051,6,12,3704,6,171,7,171,491,6,964,8,1448,3213
280.429,6,29,7392,13,158,23369,267,1317,16,678,18691,4140,6075
10.461,6,1311,1204919,802,1420,12,1448,1171307,509,776,20,1448,33612
102.479,6,11,719,11,31,10247,31,719,0,0,0,0,0
1327.739,6,273,17268,156,69,8565,69,9552,117,69,11445,69,7716
0.458,6,4,1037,2,0,217,0,104,2,853,243,853,933
0.012,17,2,290,1,40,0,40,68,1,194,0,194,222
112.143,6,32,14701,18,489,294,1360,3212,14,1213,8615,3928,11489
1772.579,6,180,15480,120,69,14895,69,8940,60,69,30034,69,6540
1772.126,6,180,15480,120,69,14891,69,8940,60,69,30034,69,6540
83.909,6,3096,2296284,1541,219,54,230,96007,1555,1368,53,2736,2200277
237.946,6,70,12681,31,261,6238,1407,4913,39,248,6261,1460,7768
0.405,17,2,136,1,32,0,32,60,1,48,0,48,76
0.976,6,10,1687,7,100,162,100,384,3,1179,361,1179,1303
0.473,6,13,1693,7,288,76,288,588,6,426,60,434,1105
19.715,17,4,240,2,32,19714,32,120,2,32,19714,32,120
1772.348,6,180,15480,120,69,14893,69,8940,60,69,30035,69,6540
296.163,17,4,352,2,60,296162,60,176,2,60,296162,60,176
1789.956,6,364,25392,212,100,8483,469,14896,152,69,11854,69,10496
0.055,6,12,3702,6,170,9,170,490,6,964,10,1448,3212
5.852,17,4,408,2,51,3075,51,158,2,97,2030,97,250
1086.739,17,112,9340,104,30,10550,37,6060,8,382,146439,463,3280
68.007,17,2,152,2,48,68007,48,152,0,0,0,0,0
7.079,2,2,64,2,8,7079,8,64,0,0,0,0,0
661.302,17,12,3991,12,304,60118,696,3991,0,0,0,0,0
0.08,17,2,348,1,39,0,39,67,1,253,0,253,281
1769.935,6,99,9226,66,64,27229,65,5570,33,58,55307,59,3656
10.246,6,16,3911,9,275,1280,275,643,7,992,873,1440,3268
1798.662,17,448,39896,403,35,4474,288,25676,45,288,40022,288,14220
0.105,6,12,3704,6,171,18,171,491,6,964,7,1448,3213
1770.751,6,99,9306,66,66,27242,66,5610,33,60,55332,60,3696
0.849,6,10,1687,7,100,141,100,384,3,1179,301,1179,1303
0.182,17,2,178,1,29,0,29,57,1,93,0,93,121
1781.765,6,356,22520,208,69,8607,69,12460,148,69,12120,69,10060
1770.472,6,102,9396,66,65,27238,65,5577,36,59,50582,59,3819
1789.35,6,361,22858,210,69,8561,69,12678,151,69,11928,69,10180
0.106,17,2,1922,2,933,106,933,1922,0,0,0,0,0
0.023,17,2,904,1,300,0,300,328,1,548,0,548,576
0.583,6,10,924,5,283,99,283,551,5,105,98,105,373
1741.396,17,29,6815,29,207,62192,207,6815,0,0,0,0,0
2.07,17,4,601,4,122,690,354,601,0,0,0,0,0
1771.31,6,99,9240,66,65,27250,65,5577,33,59,55350,59,3663
9.728,6,25,4206,11,199,972,293,1641,14,285,728,1179,2565
0.088,17,7,2438,7,320,14,354,2438,0,0,0,0,0
1.403,6,55,17914,28,707,51,1360,8925,27,464,53,2186,8989
1719.458,17,12,498,11,14,171945,14,462,1,8,0,8,36
0.225,6,20,5856,12,181,20,537,1526,8,651,29,1402,4330
205.243,17,4,352,2,60,205242,60,176,2,60,205242,60,176
1772.944,6,181,15589,120,69,14898,69,8940,61,69,29544,69,6649
10.795,6,20,4442,11,275,1079,275,998,9,768,746,1440,3444
1799.101,17,180,14040,180,50,10050,50,14040,0,0,0,0,0
19.292,17,27,15656,11,349,1925,1350,4153,16,690,1283,1350,11503
750.725,17,20,1760,10,48,83413,48,760,10,72,83412,72,1000
0.028,17,2,290,1,40,0,40,68,1,194,0,194,222
41.117,6,27,7183,13,156,3426,267,1312,14,530,3162,3417,5871
2.373,17,4,1568,4,364,791,364,1568,0,0,0,0,0
142.161,6,22,9178,12,304,77,597,1425,10,1223,15775,4080,7753
0.045,17,2,396,1,39,0,39,67,1,301,0,301,329
280.208,6,27,7312,13,158,23350,267,1317,14,775,21551,2800,5995
1795.09,17,449,39928,404,35,4454,288,25708,45,288,40017,288,14220
1.249,6,40,8391,21,321,62,1164,2810,19,437,60,2715,5581
1612.965,1,8,448,8,28,230423,28,448,0,0,0,0,0
1797.25,1,342,28728,342,56,5270,56,28728,0,0,0,0,0
5.977,6,39,7285,21,218,298,314,3463,18,516,336,1179,3822
1.393,6,47,19117,25,956,58,1460,13461,22,433,57,1460,5656
1.342,6,39,11298,21,616,67,1440,5802,18,433,68,1440,5496
296.872,1,4,224,4,28,98957,28,224,0,0,0,0,0
150.371,17,4,352,2,60,150370,60,176,2,60,150370,60,176
0.007,17,2,379,1,33,0,33,61,1,290,0,290,318
2.36,6,13,2311,8,188,337,245,700,5,1407,514,1407,1611
1.196,6,25,8056,12,164,92,267,1288,13,869,85,1448,6768
11.135,6,1778,1538226,1074,1377,10,1420,1505845,704,467,15,2840,32381
1596.931,1,8,448,8,28,228133,28,448,0,0,0,0,0
1.962,6,13,2311,8,188,280,245,700,5,1407,428,1407,1611
20.677,17,35,5963,17,159,1290,1350,3191,18,126,1214,1350,2772
1779.752,17,138,11040,69,48,26172,48,5244,69,56,26172,56,5796
1798.885,17,142,11360,71,48,25698,48,5396,71,56,25698,56,5964
3.87,17,4,304,4,48,1290,48,304,0,0,0,0,0
1740.359,1,83,6972,83,56,21223,56,6972,0,0,0,0,0
0.557,6,24,6605,13,344,45,1058,2245,11,783,54,1420,4360
1740.123,1,15,840,15,28,124294,28,840,0,0,0,0,0
1799.801,17,449,39928,404,35,4466,288,25708,45,288,40016,288,14220
0.017,6,10,1510,5,657,4,657,925,5,317,4,317,585
1.671,6,49,19291,27,894,64,1360,13635,22,433,69,1360,5656
449.458,6,52,6870,25,112,18720,722,2654,27,176,17279,2330,4216
69.825,6,670,305316,344,824,203,1152,286755,326,424,214,1179,18561
282.42,6,31,7472,14,158,21724,267,1357,17,543,17648,1400,6115
280.226,6,28,7352,12,158,25475,267,1277,16,603,18679,1400,6075
8.007,6,15,1362,8,275,1143,275,878,7,96,1034,96,484
552.66,17,208,53872,208,231,2669,388,53872,0,0,0,0,0
0.755,6,16,5665,9,267,94,502,1166,7,843,110,1420,4499
171.687,6,25,11069,12,380,62,832,1665,13,985,14297,1360,9404
0.99,17,18,5657,8,368,139,1350,3173,10,220,105,1350,2484
11.302,17,15,17682,15,1150,807,1451,17682,0,0,0,0,0
1796.5,6,363,23007,210,69,8595,69,12747,153,69,11819,69,10260
1740.468,17,30,6930,30,203,60016,203,6930,0,0,0,0,0
1.569,6,46,19530,27,920,60,1360,13994,19,529,76,4075,5536
1797.563,1,345,28980,345,56,5225,56,28980,0,0,0,0,0
0.051,6,10,1794,6,613,10,1070,1471,4,159,16,159,323
9.923,6,26,4885,13,269,826,1152,2681,13,420,805,1179,2204
240.183,6,57,18365,29,767,8577,1408,15335,28,195,8895,580,3030
1785.873,6,368,25621,214,99,8384,469,15045,154,69,11672,69,10576
0.144,6,13,4526,8,290,20,517,993,5,1088,34,1408,3533
1798.27,17,142,11360,71,48,25689,48,5396,71,56,25688,56,5964
1800.0,6,412,27818,189,46,9414,46,11676,223,46,8108,46,16142
8.121,1,14,1456,0,0,0,0,0,14,76,624,76,1456
0.244,6,3,120,1,0,0,0,40,2,0,244,0,80
0.003,6,2,553,1,461,0,461,513,1,0,0,0,40
1411.26,6,83,13323,51,106,28225,721,6409,32,562,6444,1414,6914
9.939,6,81,24477,40,550,254,1152,18680,41,461,242,1179,5797
0.673,6,25,7544,14,273,51,663,2104,11,967,60,1471,5440
0.046,17,4,284,2,32,24,32,120,2,54,24,60,164
300.566,6,18,1227,5,177,75099,177,445,13,110,25033,110,782
0.05,17,2,180,1,30,0,30,58,1,94,0,94,122
1.652,6,47,19787,28,873,61,1360,14251,19,476,81,2715,5536
1772.216,6,180,15480,120,69,14892,69,8940,60,69,30031,69,6540
1.1,6,38,8317,20,227,57,564,1766,18,447,56,1360,6551
0.924,6,30,12084,16,525,61,1360,3310,14,820,57,1380,8774
2.481,6,51,19194,27,874,95,1360,13407,24,401,99,2715,5787
1783.318,1,59,4956,59,56,30746,56,4956,0,0,0,0,0
0.656,17,2,178,1,29,0,29,57,1,93,0,93,121
1.454,6,48,18677,26,919,58,1460,13021,22,433,59,1460,5656
69.099,6,27,7177,13,155,5758,267,1306,14,530,5314,2840,5871
1789.957,6,389,27413,220,101,8173,469,16237,169,69,10654,69,11176
31.389,6,6,288,1,0,0,0,48,5,0,7844,0,240
0.147,6,42,18235,23,1026,6,1420,13254,19,467,7,1883,4981
1.476,17,20,7014,8,303,210,1350,2649,12,335,72,1350,4365
299.539,6,26,5092,10,189,6261,516,1350,16,258,19963,1452,3742
1.251,6,51,20312,28,896,46,1360,14604,23,476,49,2715,5708
11.346,6,1797,1567561,1090,1384,10,1420,1535060,707,467,16,1883,32501
1.704,6,14,2351,8,188,243,245,700,6,703,289,1152,1651
0.152,6,9,1002,5,213,38,213,417,4,421,38,421,585
1793.249,6,365,25432,213,100,8458,469,14936,152,69,11874,69,10496
1.335,6,39,8292,19,320,74,1162,2716,20,433,60,1360,5576
11.882,6,38,13393,19,402,660,721,3176,19,787,592,2828,10217
0.077,6,12,3462,6,75,15,75,395,6,1373,15,1448,3067
0.467,17,3,451,2,39,34,39,134,1,289,0,289,317
2.97,17,8,736,4,32,990,32,240,4,96,621,96,496
276.147,17,4,352,2,60,276146,60,176,2,60,276145,60,176
1764.328,2,13,416,13,8,147027,8,416,0,0,0,0,0
60.325,6,35,7632,18,138,3548,174,1276,17,472,3764,1452,6356
300.591,6,44,8905,22,286,14313,766,2116,22,346,603,2128,6789
1.325,6,40,9952,21,440,66,1360,4416,19,433,63,1360,5536
1785.649,6,102,8296,68,65,26651,65,4930,34,59,54107,59,3366
2.052,6,13,2311,8,188,293,245,700,5,1407,450,1407,1611
3.614,6,22,6549,13,141,301,275,810,9,1073,423,1440,5739
368.339,6,18,1242,14,180,28333,180,916,4,110,20057,110,326
2.716,17,14,8783,7,695,452,1350,5062,7,503,178,1350,3721
49.351,17,4,352,2,60,49349,60,176,2,60,49350,60,176
190.375,6,9,514,3,106,95182,106,234,6,0,38073,0,280
1787.193,17,86,3606,85,14,21276,14,3570,1,8,0,8,36
1.196,17,7,480,4,32,370,32,240,3,52,545,60,240
1787.136,6,102,8364,68,66,26673,66,4964,34,60,54152,60,3400
415.099,6,40,12897,21,260,20754,1440,3220,19,665,23050,1440,9677
0.19,6,9,527,5,43,47,43,311,4,0,29,0,216
3.785,17,5,290,5,30,946,30,290,0,0,0,0,0
249.231,17,10,585,10,30,27692,31,585,0,0,0,0,0
1781.944,6,217,26095,130,104,13813,469,12402,87,124,20715,1452,13693
20.241,6,17,2316,10,189,2249,517,1298,7,323,3364,499,1018
1699.577,17,12,498,11,14,169957,14,462,1,8,0,8,36
1740.436,17,30,7050,30,207,60015,207,7050,0,0,0,0,0
139.328,1,4,224,4,28,46442,28,224,0,0,0,0,0
0.029,17,2,198,1,37,0,37,65,1,105,0,105,133
211.274,6,55,13800,28,253,7824,634,2514,27,509,381,2720,11286
0.443,6,10,1514,5,503,110,503,771,5,475,110,475,743
0.063,17,2,383,1,33,0,33,61,1,294,0,294,322
0.042,17,2,212,1,46,0,46,74,1,110,0,110,138
630.269,2,4,128,4,8,210089,8,128,0,0,0,0,0
0.171,6,16,6056,9,70,20,133,504,7,1756,27,2828,5552
1.845,6,32,9170,19,371,102,845,1877,13,846,143,1380,7293
4.242,17,8,792,4,39,1313,39,268,4,103,1413,103,524
565.59,6,71,9253,37,304,15710,304,6192,34,83,17118,83,3061
2.933,6,32,8952,15,158,209,267,1397,17,687,182,2800,7555
2.801,17,4,240,4,32,933,32,240,0,0,0,0,0
133.863,6,24,6233,9,267,100,502,1166,15,371,9554,2642,5067
1788.93,17,142,11360,71,48,25556,48,5396,71,56,25556,56,5964
0.15,6,44,20668,26,1047,6,1420,15727,18,467,8,1883,4941
5.085,17,4,288,2,36,5002,36,128,2,52,5020,52,160
0.407,6,21,5000,11,137,40,267,1132,10,692,42,1467,3868
0.674,6,22,7269,13,318,56,599,1957,9,967,82,1471,5312
1798.192,17,449,39416,404,34,4462,288,25444,45,282,40017,288,13972
5.968,6,40,7309,21,218,298,314,3463,19,513,315,1179,3846
1789.442,17,142,11360,71,48,25563,48,5396,71,56,25563,56,5964
1797.137,1,260,14560,260,28,6938,28,14560,0,0,0,0,0
277.177,17,4,352,2,60,277176,60,176,2,60,277176,60,176
0.054,17,2,185,1,45,0,45,73,1,84,0,84,112
1740.691,17,30,7050,30,207,60023,207,7050,0,0,0,0,0
5.09,6,41,7365,21,218,254,314,3463,20,516,253,1179,3902
0.053,6,2,1540,1,0,0,0,40,1,1460,0,1460,1500
1.051,6,25,9553,14,350,80,1042,1993,11,1015,83,1460,7560
1799.456,17,175,62806,175,330,10341,548,62806,0,0,0,0,0
1.636,17,3,1176,3,364,818,364,1176,0,0,0,0,0
1787.553,6,104,8308,68,64,26679,64,4896,36,58,51070,58,3412
8.573,6,25,11503,8,154,1224,267,792,17,771,530,1997,10711
33.855,6,31,5094,15,154,2418,721,1859,16,342,2242,1368,3235
0.286,1,2,112,2,28,286,28,112,0,0,0,0,0
1799.765,17,142,11360,71,48,25710,48,5396,71,56,25710,56,5964
1711.517,1,8,448,8,28,244502,28,448,0,0,0,0,0
261.554,6,26,8121,15,726,18682,1360,5688,11,247,26117,272,2433
1789.954,1,58,4872,58,56,31402,56,4872,0,0,0,0,0
1799.224,6,356,22589,207,69,8734,69,12420,149,69,12156,69,10169
0.239,6,23,5994,12,181,21,537,1526,11,777,23,2206,4468
1787.385,6,102,8364,68,66,26677,66,4964,34,60,54159,60,3400
1787.276,6,104,8376,68,65,26675,65,4930,36,59,51062,59,3446
280.223,6,29,7392,13,158,23351,267,1317,16,603,18679,2600,6075
15.968,6,92,44671,41,1270,399,1440,37299,51,301,315,1440,7372
1786.862,6,104,8444,68,66,26669,66,4964,36,60,51049,60,3480
1788.246,17,87,3648,86,14,21038,14,3612,1,8,0,8,36
1744.638,2,22,704,22,8,83078,8,704,0,0,0,0,0
0.977,17,4,352,2,60,976,60,176,2,60,976,60,176
0.459,6,22,4442,11,165,45,456,1394,11,493,43,888,3048
1799.305,2,24,768,24,8,78230,8,768,0,0,0,0,0
1.393,6,38,8252,19,320,77,1162,2716,19,433,66,1460,5536
1679.574,17,12,498,11,14,167957,14,462,1,8,0,8,36
1799.94,1,57,4788,0,0,0,0,0,57,56,32141,56,4788
0.524,17,3,543,2,39,109,39,134,1,381,0,381,409
1.352,6,49,18674,27,850,52,1360,13018,22,433,55,1360,5656
1750.53,17,12,498,11,14,175053,14,462,1,8,0,8,36
0.067,6,9,1339,5,145,16,145,349,4,826,14,826,990
316.944,6,103,34456,57,521,5659,1360,23679,46,343,7039,4080,10777
702.666,1,4,224,4,28,234222,28,224,0,0,0,0,0
0.903,6,5,1065,2,0,897,0,92,3,853,448,853,973
1.369,6,51,21670,29,926,48,1360,16014,22,433,55,1360,5656
181.115,17,12,4032,12,308,16465,308,4032,0,0,0,0,0
1799.495,17,764,46076,764,32,2358,37,46076,0,0,0,0,0
111.566,17,8,704,4,48,37186,48,304,4,72,37184,72,400
1.988,17,2,672,2,308,1988,308,672,0,0,0,0,0
17.655,17,57,40342,24,369,765,1350,9542,33,905,550,1350,30800
123.889,17,4,240,2,32,123887,32,120,2,32,123888,32,120
1786.113,17,158,14288,79,67,22898,952,7524,79,57,22898,72,6764
1791.098,17,179,13962,179,50,10062,50,13962,0,0,0,0,0
329.305,1,3,556,3,157,164652,320,556,0,0,0,0,0
1783.307,17,83,3480,82,14,22016,14,3444,1,8,0,8,36
1788.319,6,368,25621,214,99,8395,469,15045,154,69,11685,69,10576
1682.653,17,16,1265,8,30,240372,37,471,8,71,240375,136,794
1783.529,17,328,52825,328,133,5454,389,52825,0,0,0,0,0
0.065,17,2,144,1,44,0,44,72,1,44,0,44,72
0.413,6,7,295,4,0,137,0,164,3,7,105,7,131
73.761,6,25,9968,12,549,72,1440,2709,13,961,6135,1440,7259
0.033,17,2,603,1,40,0,40,68,1,507,0,507,535
0.25,17,2,376,1,39,0,39,67,1,281,0,281,309
0.006,17,4,284,2,32,2,32,120,2,54,3,60,164
12.527,6,25,10982,13,275,1043,275,803,12,1210,948,1440,10179
0.038,17,4,524,2,39,27,39,134,2,167,23,167,390
5.136,17,4,304,4,48,1712,48,304,0,0,0,0,0
174.634,6,22,9339,11,598,63,1451,2267,11,945,17450,1460,7072
10.784,6,20,4442,11,275,1078,275,998,9,768,751,1440,3444
1680.593,1,15,870,15,30,120042,30,870,0,0,0,0,0
0.017,17,2,304,1,28,0,28,56,1,220,0,220,248
1786.402,6,102,8364,68,66,26662,66,4964,34,60,54130,60,3400
0.336,17,7,2438,7,320,56,354,2438,0,0,0,0,0
1738.592,2,26,832,26,8,69543,8,832,0,0,0,0,0
599.654,6,9,546,6,31,119930,31,333,3,31,299816,31,213
1771.827,6,103,9514,66,66,27258,66,5610,37,60,49214,60,3904
1783.165,6,102,8296,68,65,26614,65,4930,34,59,54032,59,3366
1794.833,17,87,3648,86,14,21115,14,3612,1,8,0,8,36
2.013,17,3,174,3,30,1006,30,174,0,0,0,0,0
1782.275,17,83,3480,82,14,22003,14,3444,1,8,0,8,36
1782.414,17,83,3480,82,14,22005,14,3444,1,8,0,8,36
2.398,17,28,19410,13,632,199,1350,8584,15,693,143,1350,10826
0.086,2,2,64,2,8,86,8,64,0,0,0,0,0
0.105,17,2,144,1,36,0,36,64,1,52,0,52,80
208.472,17,4,240,2,32,208471,32,120,2,32,208471,32,120
1646.831,1,7,742,7,78,274471,78,742,0,0,0,0,0
1771.414,6,108,6465,61,27,29522,27,3604,47,27,38508,27,2861
4.876,6,21,4854,12,233,443,613,1785,9,648,585,1767,3069
61.182,6,28,13048,13,630,5098,939,3205,15,905,4354,1440,9843
0.003,6,2,111,1,0,0,0,40,1,31,0,31,71
1772.814,6,180,15480,120,69,14897,69,8940,60,69,30039,69,6540
0.191,6,7,423,4,43,36,43,259,3,0,45,0,164
1761.735,17,225,56751,225,224,7864,422,56751,0,0,0,0,0
0.32,6,28,9015,14,232,24,567,1664,14,943,24,2816,7351
172.6,6,20,8730,11,333,71,692,1473,9,1377,21557,3928,7257
1.389,6,25,8056,12,164,109,267,1288,13,869,100,1408,6768
2.027,17,2,683,1,306,0,306,334,1,321,0,321,349
1783.431,17,83,3480,82,14,22017,14,3444,1,8,0,8,36
33.761,6,34,5261,16,154,2239,722,1923,18,299,1975,1448,3338
1770.118,6,99,9240,66,65,27232,65,5577,33,59,55313,59,3663
1.363,6,49,20314,27,967,52,1460,14658,22,433,56,1460,5656
0.073,17,2,184,1,32,0,32,60,1,96,0,96,124
1772.394,6,180,15480,120,69,14894,69,8940,60,69,30037,69,6540
16.285,6,3,151,1,0,0,0,40,2,31,0,31,111
1791.918,1,166,9296,166,28,10860,28,9296,0,0,0,0,0
16.441,17,24,12168,10,389,1814,1350,4173,14,543,1256,1350,7995
113.852,6,36,16570,19,953,1385,1360,8418,17,828,7104,2241,8152
1776.503,17,140,11200,70,48,25745,48,5320,70,56,25745,56,5880
31.028,6,42,8842,21,412,437,889,2156,21,416,1543,3488,6686
11.066,6,12,945,6,222,2210,222,466,6,231,2209,231,479
9.563,6,1046,1584546,828,1144,11,1360,74095,218,7434,43,65280,1510451
1799.898,6,190,15926,97,108,18748,208,11059,93,31,19559,31,4867
1771.319,1,58,4872,58,56,31075,56,4872,0,0,0,0,0
435.463,6,29,2090,18,31,25615,31,1227,11,31,43544,31,863
270.546,17,4,240,2,32,270545,32,120,2,32,270545,32,120
0.304,17,4,360,2,30,0,30,116,2,94,1,94,244
8.029,17,6,528,3,48,4008,48,228,3,72,4004,72,300
125.905,2,2,64,2,8,125905,8,64,0,0,0,0,0
1798.774,6,356,22520,208,69,8689,69,12460,148,69,12236,69,10060
300.55,6,16,1135,6,177,60076,177,509,10,110,33375,110,626
1794.302,17,142,11360,71,48,25632,48,5396,71,56,25631,56,5964
280.19,6,25,7232,12,158,25471,267,1277,13,905,23345,4845,5955
61.34,6,37,15929,22,799,2920,1448,9151,15,665,4363,1448,6778
72.81,6,17,2349,10,324,8090,585,1177,7,396,12123,580,1172
0.048,6,13,3980,7,88,8,88,388,6,1670,9,1880,3592
1758.729,6,167,10501,86,49,20690,208,6238,81,31,21978,31,4263
280.393,6,30,7432,13,158,23366,267,1317,17,543,17522,1400,6115
27.334,6,26,6797,12,181,2484,267,1212,14,627,2096,1400,5585
1789.611,6,358,22669,209,69,8603,69,12500,149,69,12091,69,10169
251.75,2,3,96,3,8,125875,8,96,0,0,0,0,0
0.396,6,7,295,4,0,132,0,164,3,7,95,7,131
1757.755,6,97,7307,63,38,28350,205,4476,34,33,53255,98,2831
0.146,6,7,423,4,43,36,43,259,3,0,21,0,164
1.362,6,51,19788,29,920,48,1460,14087,22,400,56,1460,5701
5.038,17,4,288,2,36,5006,36,128,2,52,4995,52,160
229.909,17,36,2736,36,48,6568,48,2736,0,0,0,0,0
15.98,17,25,15104,10,394,1767,1350,4224,15,697,1136,1350,10880
1380.258,17,14,3513,7,32,230040,37,420,7,413,230041,463,3093
128.614,6,30,7432,13,158,10717,267,1317,17,603,8035,2076,6115
1.795,6,32,8955,15,132,128,267,1530,17,842,108,1420,7425
7.101,6,1558,1467319,1022,1362,6,1368,1434783,536,776,12,1473,32536
1.411,17,2,784,2,364,1411,364,784,0,0,0,0,0
300.844,6,47,10363,23,433,13674,910,3166,24,327,427,1460,7197
213.977,1,6,336,6,28,42795,28,336,0,0,0,0,0
0.017,17,4,865,2,47,1,47,150,2,329,3,341,715
1777.841,17,140,11200,70,48,25765,48,5320,70,56,25765,56,5880
203.859,17,4,240,2,32,203858,32,120,2,32,203858,32,120
4.367,17,5,300,5,32,1091,32,300,0,0,0,0,0
0.619,6,20,5869,11,275,61,517,1681,9,928,73,1851,4188
230.798,17,4,240,2,32,230797,32,120,2,32,230797,32,120
6.764,17,2,136,1,32,0,32,60,1,48,0,48,76
280.217,6,30,7432,14,158,21555,267,1357,16,603,18678,2036,6075
5.21,17,3,228,3,48,2605,48,228,0,0,0,0,0
23.969,6,15,2294,9,210,2965,210,896,6,545,4788,904,1398
0.434,6,12,1304,6,256,84,256,756,6,304,84,304,548
1698.67,1,8,848,8,78,242667,78,848,0,0,0,0,0
33.323,6,22,6760,8,182,4760,267,1067,14,568,2552,1420,5693
0.023,17,4,420,2,33,20,33,122,2,121,20,145,298
1796.706,17,448,39896,403,35,4469,288,25676,45,288,40015,288,14220
15.361,17,22,7010,10,388,1702,1350,4168,12,208,1392,1350,2842
0.152,6,23,7608,12,176,13,334,1339,11,1422,14,2816,6269
1.488,6,47,18736,26,926,59,1460,13120,21,433,64,1460,5616
0.665,6,41,12333,23,580,30,1188,8153,18,359,33,758,4180
274.319,17,4,240,2,32,274318,32,120,2,32,274318,32,120
1784.72,6,104,8376,68,65,26637,65,4930,36,59,50989,59,3446
0.103,6,9,1339,5,145,25,145,349,4,826,20,826,990
70.428,6,42,8815,20,378,885,787,2026,22,368,3347,3488,6789
0.072,17,3,394,2,32,13,32,120,1,246,0,246,274
1799.293,17,180,14040,180,50,10051,50,14040,0,0,0,0,0
280.465,6,30,7432,13,158,23372,267,1317,17,603,17526,2760,6115
11.609,6,92,27570,47,554,252,1152,21288,45,447,258,1179,6282
240.562,6,43,9067,21,523,12027,1408,5809,22,234,11455,619,3258
319.595,6,14,926,9,106,39949,106,686,5,0,3873,0,240
0.676,6,27,6159,13,108,56,147,959,14,662,49,1380,5200
64.689,6,32,16322,14,249,75,431,1485,18,868,3793,1550,14837
1740.489,17,30,7050,30,207,60016,207,7050,0,0,0,0,0
1782.832,17,140,11200,70,48,25837,48,5320,70,56,25838,56,5880
56.14,6,31,7725,11,155,9,267,1226,20,355,2954,3417,6499
662.162,2,10,320,10,8,73573,8,320,0,0,0,0,0
240.25,6,54,18603,29,828,8580,1418,15596,25,212,10010,580,3007
18.742,6,56,35632,31,259,624,259,2150,25,1532,780,2816,33482
10.884,6,2586,2272207,1482,1441,7,1448,2203439,1104,776,9,1448,68768
4.429,6,40,7309,20,218,233,314,3423,20,440,220,1152,3886
1.426,6,47,19566,27,919,54,1360,13990,20,476,64,2720,5576
10.031,17,3,434,2,40,10020,40,136,1,270,0,270,298
11.638,6,1800,1590889,1124,1363,10,1380,1559607,676,421,17,1923,31282
1789.809,1,58,4872,58,56,31400,56,4872,0,0,0,0,0
1793.401,6,356,22520,208,69,8663,69,12460,148,69,12199,69,10060
0.01,17,2,266,1,41,0,41,69,1,169,0,169,197
3.643,17,10,900,5,30,907,30,290,5,94,908,94,610
5.341,6,37,7136,19,231,296,314,3314,18,516,249,1179,3822
1790.231,6,217,20815,108,79,16731,721,10001,109,165,16573,2007,10814
161.75,1,6,336,6,28,32350,28,336,0,0,0,0,0
0.213,17,4,560,2,64,211,64,184,2,160,87,160,376
0.038,6,13,3514,7,75,6,75,447,6,1373,7,1448,3067
36.012,17,20,1760,10,48,4000,48,760,10,72,4000,72,1000
523.18,6,66,8120,34,106,15848,721,3482,32,149,16870,1448,4638
77.545,6,54,32448,34,1089,2349,1448,24654,20,843,3287,2359,7794
0.258,17,4,680,2,33,250,33,122,2,251,249,323,558
0.095,6,2,80,1,0,0,0,40,1,0,0,0,40
763.585,6,181,18742,93,119,8299,1189,7420,88,181,8774,1420,11322
1775.601,17,73,3060,72,14,25008,14,3024,1,8,0,8,36
1781.184,17,79,3312,78,14,23132,14,3276,1,8,0,8,36
0.501,6,20,4960,10,137,55,267,1092,10,692,53,1467,3868
5.132,6,34,6169,17,206,320,314,2744,17,548,299,1179,3425
0.784,6,12,1653,6,288,152,288,548,6,426,94,434,1105
423.134,6,28,2014,18,31,24890,31,1184,10,31,46969,31,830
1680.433,1,15,840,15,28,120030,28,840,0,0,0,0,0
30.107,6,46,10371,22,533,718,910,3143,24,329,1303,2720,7228
0.61,6,10,924,5,283,101,283,551,5,105,105,105,373
1792.762,6,357,23029,209,75,8619,469,12969,148,69,12195,69,10060
15.287,17,10,880,5,48,3818,48,380,5,72,3818,72,500
1788.351,6,356,22520,208,69,8639,69,12460,148,69,12165,69,10060
4.244,6,40,7309,20,218,223,314,3423,20,440,209,1152,3886
106.262,17,4,352,2,60,106261,60,176,2,60,106261,60,176
301.281,6,53,26655,27,804,11587,1440,8661,26,924,1877,1440,17994
1743.659,1,25,2921,25,88,72652,173,2921,0,0,0,0,0
154.752,6,26,6509,11,317,15475,517,1215,15,409,11028,1605,5294
1794.124,17,80,3354,79,14,23001,14,3318,1,8,0,8,36
133.73,6,13,1450,7,302,22288,302,964,6,83,26743,83,486
3.912,6,215,181336,84,287,47,907,6125,131,1336,29,1418,175211
1774.211,6,180,15480,120,69,14909,69,8940,60,69,30066,69,6540
280.463,6,28,7352,13,158,23371,267,1317,15,678,20030,3456,6035
378.666,2,4,128,4,8,126222,8,128,0,0,0,0,0
1.064,6,16,2678,8,288,128,288,640,8,568,127,853,2038
0.074,6,10,1863,5,105,18,105,325,5,1326,18,1326,1538
4.422,6,38,7229,19,218,245,314,3383,19,513,231,1179,3846
192.0,6,4,574,4,103,64000,138,574,0,0,0,0,0
128.484,6,20,6466,5,154,32117,267,672,15,518,9176,1452,5794
19.355,6,2819,2638346,1830,1365,10,1408,2582254,989,931,19,2816,56092
0.319,6,14,2719,7,121,53,121,525,7,911,53,911,2194
2.072,6,24,6045,13,108,172,147,959,11,927,166,1608,5086
0.315,17,2,152,1,48,0,48,76,1,48,0,48,76
238.031,2,3,96,3,8,119015,8,96,0,0,0,0,0
0.008,6,2,80,1,0,0,0,40,1,0,0,0,40
0.941,6,28,5780,13,125,78,267,1275,15,650,61,1420,4505
211.482,17,510,87850,461,157,459,172,85366,49,22,4374,172,2484
78.109,6,20,8154,11,511,85,1194,2005,9,1155,9742,3151,6149
6.373,6,41,7365,21,218,318,314,3463,20,516,321,1179,3902
0.713,6,36,11240,21,612,35,1188,7216,15,359,44,758,4024
1693.153,1,7,392,7,28,282192,28,392,0,0,0,0,0
0.198,6,3,258,2,69,198,69,149,1,69,0,69,109
0.344,6,27,8920,13,227,28,547,1592,14,941,26,1408,7328
46.258,17,8,704,4,48,15416,48,304,4,72,15416,72,400
1760.415,17,313,68093,313,189,5642,422,68093,0,0,0,0,0
28.44,6,46337,49379024,17639,160,1,322,927577,28698,1636,0,6840,48451447
0.52,6,11,988,6,283,70,283,615,5,105,88,105,373
0.03,17,2,912,1,308,0,308,336,1,548,0,548,576
240.304,17,2,660,2,302,240304,304,660,0,0,0,0,0
0.999,6,10,1687,7,100,166,100,384,3,1179,371,1179,1303
1787.088,6,356,22520,208,69,8633,69,12460,148,69,12157,69,10060
14.116,17,2,152,2,48,14116,48,152,0,0,0,0,0
1.076,6,24,8004,12,164,83,267,1288,12,1014,83,2804,6716
0.365,17,2,152,1,48,0,48,76,1,48,0,48,76
0.006,6,2,2552,1,0,0,0,40,1,2460,0,2460,2512
0.08,6,10,1671,6,552,16,948,1348,4,159,26,159,323
6.154,17,8,592,8,46,879,46,592,0,0,0,0,0
383.973,6,21,11401,6,186,76792,267,621,15,847,27424,1452,10780
0.347,6,22,7342,12,335,30,668,1974,10,1210,37,1906,5368
1773.201,6,181,15589,120,69,14900,69,8940,61,69,29548,69,6649
1740.023,17,16,4484,16,252,116001,1030,4484,0,0,0,0,0
31.536,6,7,336,1,0,0,0,48,6,0,6304,0,288
0.188,6,28,7336,13,155,15,267,1301,15,543,11,1400,6035
54.862,6,32,8952,15,158,3918,267,1397,17,687,3425,1781,7555
2.016,6,30,9314,16,291,122,625,2714,14,1004,138,1791,6600
0.143,6,17,6612,10,138,15,183,931,7,1061,22,1408,5681
119.779,17,4,352,2,60,119778,60,176,2,60,119778,60,176
6.198,17,4,352,2,60,6197,60,176,2,60,6197,60,176
0.766,17,4,1248,2,64,742,64,184,2,504,741,504,1064
6.155,6,902,864323,606,1354,9,1368,840247,296,776,20,1473,24076
121.009,1,40,1120,40,0,0,0,1120,0,0,0,0,0
240.267,6,54,18027,28,799,8898,1418,15056,26,201,9610,580,2971
20.158,6,18,2368,10,189,2239,517,1298,8,323,2878,499,1070
180.219,17,8,608,8,48,25745,48,608,0,0,0,0,0
1789.952,6,358,22807,207,69,8688,69,12420,151,69,11933,69,10387
1637.306,2,13,416,13,8,136442,8,416,0,0,0,0,0
7.37,6,1185,1021519,713,1385,10,1420,998418,472,467,15,1883,23101
0.513,17,99,86908,37,179,14,1350,7688,62,1249,7,1350,79220
3.975,6,13,2311,8,188,567,245,700,5,1407,931,1407,1611
10.172,6,1624,1408301,981,1383,10,1420,1378360,643,420,15,1420,29941
0.958,6,23,6395,13,310,79,889,2075,10,979,105,1731,4320
0.111,6,14,1897,8,132,15,132,556,6,510,21,521,1341
1.749,17,20,5180,20,231,92,388,5180,0,0,0,0,0
6.556,6,41,7706,22,218,312,314,3503,19,491,345,1179,4203
32.408,17,8,608,8,48,4629,48,608,0,0,0,0,0
0.012,17,2,500,1,60,0,60,88,1,384,0,384,412
1719.668,17,13,534,11,14,171948,14,462,2,8,1719482,8,72
267.539,6,18,5839,10,784,29726,1360,3538,8,247,38187,272,2301
1800.0,6,218,17726,81,81,22124,375,8791,137,50,13235,143,8935
4.096,17,10,2135,5,39,1021,39,335,5,332,1020,332,1800
8.585,17,6,1236,3,48,4283,48,228,3,308,4283,308,1008
230.732,17,3,1666,3,527,115366,1316,1666,0,0,0,0,0
256.418,1,5,280,5,28,64104,28,280,0,0,0,0,0
280.23,6,31,7472,14,158,21556,267,1357,17,543,17512,1400,6115
0.128,6,12,3702,6,170,24,170,490,6,964,22,1448,3212
0.009,17,2,212,1,46,0,46,74,1,110,0,110,138
0.839,6,10,1687,7,100,139,100,384,3,1179,284,1179,1303
1797.337,6,356,22520,208,69,8682,69,12460,148,69,12226,69,10060
1.012,17,2,144,1,36,0,36,64,1,52,0,52,80
1779.64,6,355,22549,207,69,8639,69,12420,148,69,12106,69,10129
0.279,17,3,451,2,39,41,39,134,1,289,0,289,317
280.483,17,4,296,2,30,280451,30,116,2,62,280428,62,180
3.575,6,2,88,2,0,0,0,88,0,0,0,0,0
66.594,6,26,8484,15,434,4756,659,2114,11,827,6642,2688,6370
1797.493,6,356,22520,208,69,8683,69,12460,148,69,12226,69,10060
1795.076,17,140,11200,70,48,26015,48,5320,70,56,26015,56,5880
299.863,1,4,326,4,53,99954,78,326,0,0,0,0,0
48.097,6,27,7177,13,155,4008,267,1306,14,530,3698,3417,5871
1.707,6,43,30740,26,259,68,259,1619,17,2016,105,2876,29121
11.218,6,6,604,1,0,0,0,40,5,91,2746,91,564
168.53,17,4,288,2,36,168491,36,128,2,52,168498,52,160
1474.242,6,320,27338,179,98,8282,1189,12585,141,149,10530,1917,14753
1799.745,6,356,22520,208,69,8694,69,12460,148,69,12241,69,10060
776.517,6,68,8042,37,85,21565,722,3464,31,135,25878,1402,4578
3.644,17,5,295,5,31,911,31,295,0,0,0,0,0
1783.812,6,366,23196,212,69,8454,69,12827,154,69,11658,69,10369
252.469,17,48,3648,48,48,5371,48,3648,0,0,0,0,0
18.451,6,2796,2453507,1597,1443,11,1448,2378447,1199,776,15,1448,75060
222.44,17,4,240,2,32,222439,32,120,2,32,222439,32,120
3.438,17,8,1216,4,60,1135,60,352,4,188,1134,188,864
1792.544,6,359,22709,209,69,8618,69,12569,150,69,12030,69,10140
280.387,6,30,7432,13,158,23365,267,1317,17,543,17515,1400,6115
1775.612,6,185,15956,121,69,14796,69,8980,64,69,28181,69,6976
504.822,17,5,1680,5,308,126205,308,1680,0,0,0,0,0
1.231,6,23,7952,12,164,95,267,1288,11,1216,104,3819,6664
297.059,1,3,168,3,28,148529,28,168,0,0,0,0,0
373.769,6,18,1239,14,177,28751,177,913,4,110,20061,110,326
1770.911,6,99,9240,66,65,27244,65,5577,33,59,55338,59,3663
1780.547,17,139,11116,70,48,25804,48,5320,69,56,26184,56,5796
62.992,17,4,240,2,32,62990,32,120,2,32,62991,32,120
0.356,6,3,128,2,0,356,0,84,1,0,0,0,44
1786.388,17,142,11360,71,48,25519,48,5396,71,56,25519,56,5964
6.683,6,44,8369,23,227,303,314,4102,21,489,320,1179,4267
483.788,2,11,352,11,8,48378,8,352,0,0,0,0,0
18.333,17,37,22050,20,707,963,1350,14713,17,403,1143,1350,7337
0.403,6,10,1992,5,288,94,288,508,5,424,56,434,1484
2.0,17,3,222,3,46,1000,46,222,0,0,0,0,0
0.2,17,2,158,1,34,0,34,62,1,68,0,68,96
0.05,17,8,2454,8,278,7,317,2454,0,0,0,0,0
387.573,6,18,1242,14,180,29813,180,916,4,110,20240,110,326
40.4,2,4,128,4,8,13466,8,128,0,0,0,0,0
0.005,17,2,558,1,32,0,32,60,1,470,0,470,498
1.092,6,25,8080,12,164,84,267,1312,13,869,77,1408,6768
6.208,6,585,507867,357,1350,16,1368,491335,228,665,26,1368,16532
1719.506,17,12,498,11,14,171950,14,462,1,8,0,8,36
1795.543,17,448,39896,403,35,4466,288,25676,45,288,40021,288,14220
240.225,6,55,19193,30,817,8283,1408,16290,25,199,10009,580,2903
66.497,6,55,28861,27,679,219,1460,4579,28,1102,2448,1460,24282
7.8,6,16,1113,8,222,1112,222,546,8,231,1112,231,567
2.087,6,53,19983,27,932,80,1440,14167,26,433,75,1440,5816
65.496,6,24,6641,8,156,9356,267,798,16,472,4365,1420,5843
0.271,6,20,4960,11,137,27,267,1132,9,866,32,2867,3828
1793.424,17,87,3648,86,14,21099,14,3612,1,8,0,8,36
6.609,6,41,7349,23,218,300,314,3543,18,513,374,1179,3806
161.843,6,29,13407,15,488,347,1360,3075,14,1220,12440,2568,10332
1786.662,6,104,8376,68,65,26666,65,4930,36,59,51044,59,3446
1790.261,6,366,23196,212,69,8484,69,12896,154,69,11700,69,10300
3.636,6,138,90835,79,1191,46,1408,62557,59,1050,62,2042,28278
0.592,6,20,7151,12,318,53,600,1906,8,964,81,1471,5245
508.038,1,50,5200,0,0,0,0,0,50,76,10368,76,5200
1682.343,1,14,784,14,28,129411,28,784,0,0,0,0,0
0.926,6,17,1808,9,256,114,256,876,8,304,130,304,932
366.507,6,18,1239,14,177,28192,177,913,4,110,20060,110,326
0.209,6,6,328,4,0,69,0,216,2,0,201,0,112
0.034,17,5,1032,3,60,11,60,264,2,356,22,356,768
280.239,6,27,7312,12,158,25476,267,1277,15,678,20014,2045,6035
3.942,6,45,20002,24,529,171,1360,3710,21,1029,156,2561,16292
19.477,17,38,10078,19,286,1080,1350,5982,19,187,1080,1350,4096
152.773,17,4,352,2,60,152772,60,176,2,60,152772,60,176
12.257,6,1800,1677462,1183,1366,10,1432,1648491,617,427,19,1432,28971
1.699,6,11,1727,7,100,283,100,384,4,1179,479,1179,1343
240.187,6,55,15690,30,667,8282,1402,12922,25,182,10007,580,2768
0.141,6,44,21294,26,1092,5,1420,16353,18,467,7,2840,4941
0.044,17,2,152,1,48,0,48,76,1,48,0,48,76
240.34,6,44,8468,22,449,11444,1418,5648,22,208,11443,580,2820
4.068,17,5,335,5,39,1017,39,335,0,0,0,0,0
10.411,6,786,667168,480,1317,21,1368,646592,306,776,33,2736,20576
1755.534,6,190,11607,95,47,18675,208,6877,95,31,18673,31,4730
1743.226,6,96,6962,62,31,28577,31,4247,34,31,52824,31,2715
1600.083,6,24,3973,16,262,106672,413,2740,8,114,228557,269,1233
958.923,17,78,6240,39,48,25234,48,2964,39,56,25234,56,3276
1683.069,1,8,448,8,28,240438,28,448,0,0,0,0,0
7.476,6,5,284,1,0,0,0,60,4,0,2429,0,224
4.443,6,37,7205,19,218,246,314,3383,18,516,245,1179,3822
1780.533,6,354,22440,207,69,8643,69,12420,147,69,12195,69,10020
36.324,1,40,4160,0,0,0,0,0,40,76,931,76,4160
379.897,6,18,1242,14,180,29222,180,916,4,110,20061,110,326
10.594,6,18,5610,10,275,1177,275,958,8,1440,797,1440,4652
31.963,6,7,308,1,0,0,0,44,6,0,6317,0,264
0.087,17,2,181,1,32,0,32,60,1,93,0,93,121
1772.07,6,180,15480,120,69,14891,69,8940,60,69,30033,69,6540
15.364,6,11,690,3,112,7677,112,240,8,90,2193,90,450
0.52,6,28,9187,13,268,43,711,1768,15,945,34,1368,7419
0.363,17,2,157,1,31,0,31,59,1,70,0,70,98
7.956,6,71,21259,36,554,227,1152,16416,35,491,226,1179,4843
1197.702,17,290,25468,263,36,4571,288,16936,27,288,40023,288,8532
280.304,6,29,7392,13,158,23358,267,1317,16,603,18683,1400,6075
10.986,6,20,4442,11,275,1098,275,998,9,768,780,1440,3444
1.18,17,25,17645,12,779,106,1350,9687,13,584,95,1350,7958
1638.005,2,11,352,11,8,163800,8,352,0,0,0,0,0
1794.287,17,163,38305,163,207,11075,358,38305,0,0,0,0,0
2.063,6,24,6064,12,181,187,537,1526,12,651,159,1448,4538
26.052,6,34,8294,16,184,1736,722,2121,18,681,1473,1380,6173
0.28,6,27,8992,13,237,23,590,1635,14,945,21,2816,7357
1796.773,17,328,82033,328,222,5494,422,82033,0,0,0,0,0
132.791,17,4,352,2,60,132789,60,176,2,60,132790,60,176
1799.333,17,449,39928,404,35,4464,288,25708,45,288,40019,288,14220
0.194,6,40,14544,22,870,9,1420,9603,18,420,10,1420,4941
10.054,6,80,24389,41,532,251,1152,18688,39,459,257,1179,5701
145.755,2,2,64,2,8,145755,8,64,0,0,0,0,0
2.054,6,26,10112,14,660,158,1360,3270,12,1058,171,2720,6842
13.879,6,15,1181,5,240,3469,240,444,10,333,1541,333,737
1786.934,6,122,14395,78,87,23206,501,6362,44,156,41554,1420,8033
0.004,17,2,384,1,32,0,32,60,1,296,0,296,324
0.842,6,16,6556,9,127,95,127,730,7,1814,115,3829,5826
1.283,6,50,18871,28,923,47,1460,13170,22,400,52,1460,5701
1.343,6,46,18774,27,866,51,1360,13238,19,529,64,4075,5536
1664.569,1,7,392,7,28,277428,28,392,0,0,0,0,0
15.649,6,8,440,5,0,3912,0,268,3,0,7038,0,172
0.028,17,2,154,1,33,0,33,61,1,65,0,65,93
1786.483,6,104,8308,68,64,26663,64,4896,36,58,51039,58,3412
18.924,1,4,224,4,28,6308,28,224,0,0,0,0,0
1796.617,6,379,26406,217,97,8317,469,15510,162,69,11158,69,10896
82.568,6,15,612,6,0,5787,0,244,9,0,10319,0,368
884.552,1,12,672,12,28,80413,28,672,0,0,0,0,0
0.526,17,3,451,2,39,442,39,134,1,289,0,289,317
11.302,6,1761,1561559,1062,1417,10,1432,1529378,699,420,16,1432,32181
180.422,2,3,96,3,8,90211,8,96,0,0,0,0,0
1.414,6,49,19366,27,899,54,1460,13710,22,433,58,1460,5656
0.892,6,10,1687,7,100,148,100,384,3,1179,316,1179,1303
1769.073,1,58,4872,0,0,0,0,0,58,56,31036,56,4872
227.79,17,4,352,2,60,227789,60,176,2,60,227789,60,176
1756.614,6,105,8523,69,52,25832,205,5322,36,36,50181,98,3201
1780.627,6,185,15956,123,69,14595,69,9198,62,69,29181,69,6758
155.855,6,23,1675,17,43,9740,43,1315,6,0,31167,0,360
160.208,17,4,352,2,60,160207,60,176,2,60,160206,60,176
1799.969,1,16,896,16,28,119997,28,896,0,0,0,0,0
1772.8,6,180,15480,120,69,14897,69,8940,60,69,30042,69,6540
239.268,17,4,352,2,60,239267,60,176,2,60,239267,60,176
144.55,6,25,8208,13,382,73,844,1747,12,746,13129,4080,6461
217.527,2,5,160,5,8,54381,8,160,0,0,0,0,0
1790.803,17,140,11200,70,48,25953,48,5320,70,56,25953,56,5880
14.056,6,14,1025,7,222,2340,222,506,7,231,2340,231,519
312.393,1,4,537,4,106,104131,173,537,0,0,0,0,0
1782.676,17,152,9728,152,36,11805,36,9728,0,0,0,0,0
159.063,17,4,352,2,60,159062,60,176,2,60,159061,60,176
6.414,6,559,479338,346,1318,18,1368,463598,213,776,29,1473,15740
0.361,6,166,152163,104,183,3,230,6241,62,2378,4,14080,145922
123.253,17,2,152,2,48,123253,48,152,0,0,0,0,0
143.711,2,3,96,3,8,71855,8,96,0,0,0,0,0
1788.671,1,58,4872,0,0,0,0,0,58,56,31380,56,4872
12.184,17,10,750,10,47,1353,47,750,0,0,0,0,0
0.06,17,2,376,1,41,0,41,69,1,279,0,279,307
278.301,6,29,3101,15,324,19878,585,1461,14,226,18557,580,1640
4.946,6,33,6129,18,206,290,314,2784,15,548,334,1179,3345
0.084,17,2,213,1,54,0,54,82,1,103,0,103,131
1.244,17,3,2906,3,940,622,1451,2906,0,0,0,0,0
280.038,6,30,7432,13,158,23336,267,1317,17,603,17497,2076,6115
5.03,17,20,12244,9,274,628,1350,2720,11,837,385,1350,9524
1401.165,17,12,3294,6,30,280217,30,348,6,463,280232,463,2946
0.072,17,2,378,1,50,0,50,78,1,272,0,272,300
1785.871,6,356,22520,208,69,8627,69,12460,148,69,12148,69,10060
1799.509,1,345,28980,345,56,5231,56,28980,0,0,0,0,0
40.012,17,4,244,2,33,40011,33,122,2,33,40011,33,122
2.878,17,4,624,4,128,959,128,624,0,0,0,0,0
105.542,17,6,390,3,37,52770,47,195,3,37,52770,47,195
36.455,6,28,7352,12,158,3314,267,1277,16,603,2426,1400,6075
162.046,6,31,15395,14,630,48,1440,3113,17,1053,10119,1440,12282
0.111,2,3,96,3,8,55,8,96,0,0,0,0,0
0.361,17,8,2766,8,317,51,356,2766,0,0,0,0,0
1.329,6,50,18353,28,882,49,1360,12652,22,437,54,2715,5701
300.562,6,35,8351,20,291,15819,786,1997,15,574,602,4848,6354
1785.548,17,140,11200,70,48,25877,48,5320,70,56,25877,56,5880
1791.121,1,342,28728,342,56,5252,56,28728,0,0,0,0,0
504.579,2,3,96,3,8,252289,8,96,0,0,0,0,0
0.027,17,4,284,2,32,0,32,120,2,54,10,60,164
12.148,17,10,690,5,33,3035,33,305,5,49,3035,49,385
253.484,6,68,28411,36,969,7242,1418,25151,32,176,8176,580,3260
1779.954,6,184,15778,122,69,14710,69,9020,62,69,29179,69,6758
4.993,6,38,7229,20,218,262,314,3423,18,513,278,1179,3806
3.937,17,5,290,5,30,984,30,290,0,0,0,0,0
17.353,17,8,704,4,48,5780,48,304,4,72,5780,72,400
1.015,17,2,784,2,364,1015,364,784,0,0,0,0,0
1798.66,6,357,22629,208,69,8689,69,12460,149,69,12152,69,10169
2.891,17,3,468,3,128,1445,128,468,0,0,0,0,0
280.57,6,30,7432,13,158,23380,267,1317,17,603,17528,2076,6115
1739.288,6,91,6604,59,31,29987,31,3998,32,31,56105,31,2606
0.424,6,18,3068,9,282,53,531,1606,9,493,45,828,1462
1323.566,2,14,448,14,8,101812,8,448,0,0,0,0,0
81.017,6,21,8279,11,525,83,1237,2048,10,969,8983,1791,6231
1770.948,6,103,9448,66,65,27245,65,5577,37,59,49190,59,3871
0.361,6,16,4692,8,290,51,517,993,8,1631,44,2683,3699
372.21,6,18,1242,14,180,28631,180,916,4,110,20074,110,326
1.483,17,2,237,1,72,0,72,100,1,109,0,109,137
171.308,17,2,460,2,202,171308,355,460,0,0,0,0,0
134.042,17,4,352,2,60,134041,60,176,2,60,134041,60,176
0.012,17,2,180,1,30,0,30,58,1,94,0,94,122
1799.175,1,57,4788,0,0,0,0,0,57,56,32128,56,4788
1621.009,1,14,812,14,30,124693,30,812,0,0,0,0,0
0.179,6,46,21370,26,1092,7,1420,16349,20,467,8,1883,5021
436.017,6,15,13570,2,174,3245,174,258,13,1420,36327,1420,13312
36.141,6,25,7097,12,155,3285,267,1266,13,589,3010,3426,5831
0.04,17,2,144,1,36,0,36,64,1,52,0,52,80
110.484,6,26,6797,12,181,10044,267,1212,14,627,8496,1400,5585
1193.883,2,11,352,11,8,119388,8,352,0,0,0,0,0
300.645,6,37,8351,20,271,15823,738,1917,17,478,531,2128,6434
6.404,17,2,672,2,308,6404,308,672,0,0,0,0,0
124.85,17,4,240,2,32,124849,32,120,2,32,124849,32,120
206.141,17,3,528,3,148,103070,352,528,0,0,0,0,0
65.576,6,13,979,5,177,16394,177,445,8,110,9335,110,534
0.038,17,4,308,2,33,22,33,122,2,65,23,65,186
15.329,6,19,1455,10,222,1702,222,852,9,231,1915,231,603
1412.444,6,3165,3004302,1097,128,1288,339,63465,2068,1411,683,2836,2940837
189.93,17,18,2520,18,112,11172,360,2520,0,0,0,0,0
3.419,6,2,88,2,0,0,0,88,0,0,0,0,0
280.11,6,28,7352,13,158,23342,267,1317,15,678,20000,2800,6035
1772.171,6,182,15629,121,69,14768,69,8980,61,69,29532,69,6649
1793.144,6,362,22967,210,69,8579,69,12609,152,69,11875,69,10358
1789.295,17,142,11360,71,48,25561,48,5396,71,56,25561,56,5964
11.651,6,1823,1595110,1106,1387,10,1420,1562209,717,467,16,1883,32901
7.137,6,1276,1166692,799,1383,8,1408,1137224,477,931,14,2816,29468
1772.103,6,182,15629,121,69,14767,69,8980,61,69,29531,69,6649
21.84,6,103,68331,53,996,420,1360,29088,50,1329,442,2720,39243
140.461,6,73,15393,33,355,4389,1189,7371,40,278,3600,1460,8022
0.349,17,2,214,1,39,0,39,67,1,119,0,119,147
300.705,6,37,8526,19,315,16705,882,2053,18,441,500,1360,6473
0.95,6,16,5124,9,150,118,174,664,7,1044,136,2642,4460
8.352,6,15,2297,8,211,1192,211,846,7,545,1391,904,1451
0.488,17,2,384,1,39,0,39,67,1,289,0,289,317
167.067,17,4,1344,4,308,55689,308,1344,0,0,0,0,0
1.454,6,48,19086,26,950,58,1460,13430,22,433,59,1460,5656
123.915,6,80,56278,50,1193,2528,1368,47958,30,964,2133,2736,8320
1497.849,6,92,7347,58,63,26278,64,4106,34,57,45386,58,3241
0.442,6,49,18050,27,979,17,1380,12883,22,387,19,1923,5167
142.828,6,21,3550,7,92,23804,92,452,14,215,10972,1408,3098
76.22,6,36,10329,13,327,375,1189,2495,23,363,3464,1420,7834
0.052,17,4,420,2,33,0,33,122,2,121,39,145,298
0.094,6,9,1345,5,145,23,145,349,4,832,27,832,996
1.167,17,4,368,2,32,978,32,120,2,96,976,96,248
70.035,6,58,37350,37,1148,1945,1440,29503,21,749,3071,1440,7847
300.331,6,32,8892,18,393,17666,1018,2565,14,621,2468,1491,6327
240.291,6,42,8584,21,519,12014,1402,5779,21,213,12014,618,2805
280.498,6,31,7472,14,158,21576,267,1357,17,603,17527,2076,6115
0.022,17,2,398,1,43,0,43,71,1,299,0,299,327
280.415,6,29,7392,13,158,23367,267,1317,16,603,18688,1400,6075
0.978,17,4,314,2,31,947,31,118,2,70,946,70,196
295.252,6,31,2103,15,332,21089,332,1192,16,83,19683,83,911
0.384,6,55,48687,22,274,18,517,1975,33,1551,8,4344,46712
1781.762,6,363,24345,211,88,8484,469,13987,152,69,11799,69,10358
11.44,6,25,10745,13,275,953,275,1078,12,1310,759,1414,9667
82.264,17,7,2344,7,306,13710,308,2344,0,0,0,0,0
9.165,6,1652,1502908,986,1440,9,1448,1461640,666,776,13,1448,41268
15.499,17,10,880,5,48,3872,48,380,5,72,3872,72,500
1798.303,1,345,28980,345,56,5227,56,28980,0,0,0,0,0
1.763,6,38,8254,19,321,97,1164,2718,19,433,86,1360,5536
6.87,6,6,340,2,0,6870,0,100,4,0,2131,0,240
1798.207,1,298,31588,298,78,6054,78,31588,0,0,0,0,0
280.043,6,27,7312,13,158,23336,267,1317,14,775,21536,3465,5995
1741.398,1,14,812,14,30,133953,30,812,0,0,0,0,0
0.241,17,2,184,1,32,0,32,60,1,96,0,96,124
1797.862,1,345,28980,345,56,5226,56,28980,0,0,0,0,0
280.394,6,30,7432,13,158,23366,267,1317,17,543,17515,1400,6115
0.624,6,22,7356,13,337,52,674,2032,9,1212,73,1946,5324
1793.886,17,144,11520,72,48,25265,48,5472,72,56,25265,56,6048
372.835,6,47,10881,29,320,13315,1360,5359,18,399,507,1360,5522
1795.05,1,342,28728,342,56,5264,56,28728,0,0,0,0,0
3.357,6,2,88,2,0,0,0,88,0,0,0,0,0
4.449,6,37,7205,19,218,247,314,3383,18,516,246,1179,3822
4.004,6,13,1780,7,307,667,551,975,6,242,782,461,805
921.317,6,55,3368,28,26,31182,26,1638,27,25,35426,26,1730
1.019,17,2,685,1,308,0,308,336,1,321,0,321,349
0.019,17,4,284,2,32,12,32,120,2,54,10,60,164
1772.956,6,180,15480,120,69,14898,69,8940,60,69,30048,69,6540
0.011,17,2,383,1,39,0,39,67,1,288,0,288,316
957.231,1,34,1904,34,28,29007,28,1904,0,0,0,0,0
0.488,6,12,1653,6,288,90,288,548,6,426,56,434,1105
1746.261,6,97,7369,63,38,28165,205,4476,34,33,52910,98,2893
233.301,17,4,352,2,60,233300,60,176,2,60,233300,60,176
0.118,6,9,1343,5,145,29,145,349,4,830,32,830,994
0.877,6,11,1727,7,100,146,100,384,4,589,207,1152,1343
1798.366,6,367,25650,214,99,8443,469,15045,153,69,11831,69,10605
1784.007,17,75,3141,73,13,24775,14,3061,2,12,1783824,16,80
280.525,17,4,296,2,30,280463,30,116,2,62,280460,62,180
2.0,17,2,1084,2,514,2000,514,1084,0,0,0,0,0
1622.738,1,7,392,7,28,270456,28,392,0,0,0,0,0
1.049,17,4,412,2,44,1017,44,144,2,106,1014,106,268
1281.467,6,79,11147,50,97,21046,498,4344,29,208,45763,1420,6803
0.09,1,2,112,2,28,90,28,112,0,0,0,0,0
300.905,6,41,10494,23,660,13677,1360,4927,18,439,515,4027,5567
1772.954,6,180,15480,120,69,14898,69,8940,60,69,30045,69,6540
1794.113,17,80,3354,79,14,23001,14,3318,1,8,0,8,36
7.402,6,5,284,1,0,0,0,60,4,0,2407,0,224
1800.0,6,277,18996,114,46,15929,46,8014,163,46,11110,46,10982
0.53,17,2,384,1,39,0,39,67,1,289,0,289,317
0.865,6,51,13849,24,549,37,1429,4860,27,464,32,1986,8989
1.418,6,46,19023,26,951,56,1460,13447,20,476,64,2615,5576
1787.465,17,142,11360,71,48,25535,48,5396,71,56,25535,56,5964
1771.517,6,101,9344,66,65,27254,65,5577,35,59,52100,59,3767
1789.047,6,354,22440,207,69,8684,69,12420,147,69,12251,69,10020
374.789,6,18,1242,14,180,28829,180,916,4,110,20075,110,326
7.432,6,1851,1678315,1146,1384,6,1408,1636991,705,931,10,2816,41324
2.261,6,33,10684,16,210,149,646,2114,17,956,140,1438,8570
0.485,17,3,451,2,39,213,39,134,1,289,0,289,317
12.885,6,6,328,4,0,4295,0,216,2,0,12866,0,112
0.889,17,2,376,1,39,0,39,67,1,281,0,281,309
0.049,17,2,214,1,47,0,47,75,1,111,0,111,139
5.113,17,158,213347,156,1339,30,1472,213267,2,12,4997,12,80
378.306,2,3,96,3,8,189153,8,96,0,0,0,0,0
0.584,6,23,7395,14,266,44,626,2067,9,1210,68,1946,5328
1425.456,6,101,12317,63,85,22991,502,5000,38,175,38522,1420,7317
240.183,6,54,17698,29,780,8577,1402,14779,25,201,10007,580,2919
0.776,6,25,5609,12,140,70,267,1184,13,650,58,1420,4425
155.85,6,24,10168,13,549,63,1360,2749,11,1161,15569,2574,7419
1777.544,6,181,15589,121,69,14812,69,9049,60,69,30122,69,6540
13.212,17,2,152,2,48,13212,48,152,0,0,0,0,0
0.514,6,27,9027,13,200,42,611,1687,14,941,36,1368,7340
0.522,6,20,7229,13,334,43,663,2021,7,1209,81,1946,5208
373.657,6,25,1651,17,177,23353,177,1117,8,110,9263,110,534
0.155,17,2,672,2,308,155,308,672,0,0,0,0,0
1.236,6,10,1687,7,100,206,100,384,3,1179,488,1179,1303
1798.284,17,448,39896,403,35,4473,288,25676,45,288,40020,288,14220
285.128,17,4,352,2,60,285127,60,176,2,60,285127,60,176
0.062,17,2,152,1,48,0,48,76,1,48,0,48,76
0.124,17,2,167,1,39,0,39,67,1,72,0,72,100
4.003,6,11,467,6,0,800,0,248,5,7,744,7,219
0.286,6,27,9071,13,247,23,624,1672,14,832,21,1408,7399
0.129,6,9,1340,5,145,32,145,349,4,827,35,827,991
840.642,17,8,2196,4,30,280212,30,232,4,463,280212,463,1964
0.015,17,4,825,2,37,0,37,130,2,319,3,331,695
1781.98,17,140,11200,70,48,25825,48,5320,70,56,25825,56,5880
0.109,6,2,116,1,0,0,0,64,1,0,0,0,52
1794.081,17,180,14040,180,50,10022,50,14040,0,0,0,0,0
5.143,6,38,7229,20,218,270,314,3423,18,513,286,1179,3806
1782.279,6,359,29217,204,78,8779,267,13359,155,128,11573,1420,15858
241.019,6,49,9514,25,139,10042,346,2190,24,505,10478,2798,7324
1772.894,6,180,15480,120,69,14898,69,8940,60,69,30045,69,6540
61.301,6,37,15983,22,805,2919,1440,9205,15,665,4359,1440,6778
0.045,17,4,352,2,37,2,37,130,2,83,10,89,222
1785.797,6,104,8444,68,66,26653,66,4964,36,60,51020,60,3480
212.984,1,10,280,10,0,0,0,280,0,0,0,0,0
1740.47,17,29,30624,29,1028,62159,1028,30624,0,0,0,0,0
0.012,6,4,160,2,0,3,0,80,2,0,1,0,80
1782.493,6,214,24283,139,140,12916,981,15414,75,80,24084,485,8869
1768.469,17,22,9496,22,403,84212,1445,9496,0,0,0,0,0
0.951,6,31,10450,17,511,59,1460,3280,14,659,59,1460,7170
1.046,17,36,29219,23,1124,47,1350,26503,13,180,64,1350,2716
0.208,6,26,7256,12,155,18,267,1261,14,603,14,1400,5995
241.554,6,32,8952,14,158,18581,267,1357,18,624,14205,1400,7595
1792.442,6,123,8599,70,65,25974,208,5487,53,31,34465,31,3112
1773.099,6,181,15589,120,69,14899,69,8940,61,69,29545,69,6649
240.182,6,55,19651,30,789,8282,1408,16570,25,253,10007,580,3081
1772.784,6,182,15629,121,69,14773,69,8980,61,69,29545,69,6649
5.912,17,2,672,2,308,5912,308,672,0,0,0,0,0
1770.554,6,99,9240,66,65,27239,65,5577,33,59,55325,59,3663
148.339,6,53,14119,27,867,5698,1460,8122,26,290,5926,1460,5997
6.028,6,3,180,3,0,0,0,180,0,0,0,0,0
1774.938,6,180,15480,120,69,14915,69,8940,60,69,30077,69,6540
266.668,6,66,46162,44,1160,6201,1408,38283,22,961,2938,3847,7879
1740.417,17,30,31680,30,1028,60014,1028,31680,0,0,0,0,0
137.484,6,15,4095,8,676,125,1360,3046,7,378,22883,605,1049
0.37,6,26,8903,13,234,30,575,1620,13,942,29,1438,7283
0.0,17,1,196,1,168,0,168,196,0,0,0,0,0
1680.787,17,13,534,11,14,168060,14,462,2,8,1680601,8,72
777.835,6,630,1016052,259,164,3014,845,17426,371,2871,1980,9814,998626
732.066,17,92,18244,46,48,16267,48,3496,46,292,16267,308,14748
5.833,17,28,14784,15,704,414,1350,10983,13,264,483,1350,3801
0.015,6,11,1566,6,503,2,503,823,5,475,3,475,743
0.538,17,2,152,1,48,0,48,76,1,48,0,48,76
1756.471,1,98,5488,98,28,18107,28,5488,0,0,0,0,0
210.114,17,4,240,2,32,210113,32,120,2,32,210113,32,120
58.602,6,18,2511,7,188,9767,245,660,11,1407,5833,1407,1851
1.337,6,38,9848,20,502,70,1440,4352,18,433,68,1440,5496
0.06,17,2,166,1,39,0,39,67,1,71,0,71,99
280.522,6,30,7432,13,158,23376,267,1317,17,603,17522,2760,6115
0.109,6,2,92,1,0,0,0,52,1,0,0,0,40
1770.933,1,58,4872,0,0,0,0,0,58,56,31069,56,4872
1786.138,6,154,19574,92,302,19627,302,13852,62,83,29280,83,5722
1783.109,17,83,3480,82,14,22013,14,3444,1,8,0,8,36
61.658,6,38,8259,13,123,5138,267,1513,25,337,2568,2828,6746
1789.943,6,4228,4012242,1467,130,1220,350,87466,2761,1407,648,4254,3924776
1787.78,6,356,22520,208,69,8636,69,12460,148,69,12161,69,10060
1782.279,6,139,8584,74,27,24414,27,4511,65,27,27847,27,4073
280.218,17,4,1098,2,30,280213,30,116,2,463,280213,463,982
1741.333,6,84,6104,56,31,31660,31,3780,28,31,64492,31,2324
1781.053,6,107,8614,68,65,26582,65,4930,39,59,46867,59,3684
121.836,6,46,16553,24,987,401,1360,10871,22,399,5792,1360,5682
1.425,6,52,18942,28,922,52,1460,13161,24,400,52,1460,5781
1122.481,17,771,54060,700,40,1605,41,48058,71,56,740,57,6002
0.013,17,2,487,1,40,0,40,68,1,391,0,391,419
281.336,17,6,456,3,48,140661,48,228,3,48,140660,48,228
1789.32,17,138,11024,71,48,25561,48,5396,67,56,27110,56,5628
5.036,17,4,288,2,36,5019,36,128,2,52,5019,52,160
1730.222,6,60,4400,40,33,44364,33,2740,20,31,91053,31,1660
173.558,6,24,8209,12,417,58,948,1799,12,739,15765,2720,6410
3.01,17,26,15645,11,643,300,1350,7389,15,522,212,1350,8256
1.28,6,53,21307,29,898,45,1360,15571,24,476,47,2715,5736
1794.999,17,144,11520,72,48,25281,48,5472,72,56,25281,56,6048
1684.54,2,25,800,25,8,70189,8,800,0,0,0,0,0
173.612,6,26,6394,10,220,8267,516,1286,16,372,11567,1452,5108
1.055,6,24,8004,12,164,81,267,1288,12,1014,81,2816,6716
0.013,17,3,663,2,39,7,39,134,1,501,0,501,529
0.98,6,7,376,4,0,326,0,216,3,0,399,0,160
485.835,6,68,10616,32,131,12594,721,3249,36,257,13876,2840,7367
4.994,17,4,502,2,36,4989,36,128,2,159,4989,159,374
0.025,17,2,279,1,36,0,36,64,1,187,0,187,215
71.278,6,20,4409,10,607,423,1343,2868,10,548,7918,941,1541
1.66,6,26,8743,16,275,110,557,1469,10,981,165,1420,7274
10.756,6,20,4390,11,275,1075,275,998,9,755,743,1414,3392
0.206,6,17,6873,8,290,29,517,1005,9,1078,24,1418,5868
240.251,6,40,4849,19,201,13347,621,2404,21,168,12012,855,2445
1785.497,6,183,15738,122,69,14756,69,9089,61,69,29753,69,6649
0.033,6,10,1514,5,503,8,503,771,5,475,8,475,743
4.236,6,2,88,2,0,0,0,88,0,0,0,0,0
125.055,6,9,680,6,92,25011,92,504,3,0,1228,0,176
43.706,17,48,7056,24,48,1898,48,1824,24,190,1899,308,5232
1681.394,17,14,1036,7,30,280229,30,406,7,62,280226,62,630
1.357,6,47,18787,27,864,52,1360,13211,20,476,61,2715,5576
0.052,17,2,152,1,48,0,48,76,1,48,0,48,76
1787.363,17,75,3141,73,13,24824,14,3061,2,12,225744,16,80
154.618,17,4,240,2,32,154617,32,120,2,32,154617,32,120
7.971,6,19,9695,9,275,996,275,643,10,1440,795,1440,9052
1786.508,6,102,8296,68,65,26664,65,4930,34,59,54133,59,3366
1.291,6,40,11338,22,547,61,1360,5842,18,476,65,2715,5496
34.789,6,4999,4844844,3363,1364,10,1408,4755010,1636,792,21,1408,89834
0.093,17,2,480,1,64,0,64,92,1,360,0,360,388
0.082,6,12,3704,6,171,15,171,491,6,964,16,1448,3213
1786.683,6,330,40427,140,146,12852,1360,19742,190,136,9452,1942,20685
1799.958,6,104,11255,49,163,37499,517,3398,55,498,32474,1418,7857
0.384,17,2,152,1,48,0,48,76,1,48,0,48,76
11.5,6,1819,1587115,1101,1387,10,1420,1554174,718,467,16,1883,32941
0.0,17,2,192,1,60,0,60,88,1,76,0,76,104
240.356,6,53,17781,27,804,9244,1402,15095,26,165,9614,580,2686
4.08,17,4,428,2,39,4070,39,134,2,119,4070,119,294
9.595,6,16,3265,9,211,1199,211,910,7,665,1598,904,2355
0.0,17,1,60,1,32,0,32,60,0,0,0,0,0
2.413,17,2,144,1,36,0,36,64,1,52,0,52,80
0.211,6,40,15190,22,934,10,1420,10249,18,420,11,1420,4941
1.274,6,50,21585,28,1019,47,1380,16451,22,421,58,1923,5134
0.413,6,12,1653,6,288,82,288,548,6,426,46,434,1105
13.073,17,20,9456,9,683,1630,1350,6401,11,249,1304,1350,3055
1439.747,6,287,18605,168,77,8621,501,10533,119,69,12201,69,8072
0.05,6,3,120,1,0,0,0,40,2,0,42,0,80
0.602,6,27,9047,13,252,50,647,1692,14,945,45,1408,7355
1777.005,1,270,15120,270,28,6605,28,15120,0,0,0,0,0
8.327,6,19,6671,9,275,1040,275,643,10,1123,765,1380,6028
1.216,6,47,19122,27,888,46,1360,13546,20,476,55,2715,5576
481.368,2,6,192,6,8,96273,8,192,0,0,0,0,0
0.06,17,2,190,1,35,0,35,63,1,99,0,99,127
1.126,6,12,949,6,222,222,222,470,6,231,222,231,479
1.096,17,4,1108,2,30,1079,30,116,2,468,1079,468,992
0.061,17,2,362,1,41,0,41,69,1,265,0,265,293
0.209,6,10,767,5,186,41,186,454,5,45,48,45,313
1.241,6,47,19038,27,882,47,1360,13462,20,476,56,2715,5576
5.672,6,40,7309,20,218,298,314,3423,20,513,282,1179,3886
31.232,6,41,8925,16,419,38,944,1955,25,297,1296,1360,6970
1.369,6,49,20053,27,948,52,1440,14397,22,433,56,1440,5656
10.651,17,4,352,2,60,10650,60,176,2,60,10650,60,176
0.191,6,35,19156,17,173,11,319,1584,18,1279,10,1588,17572
0.031,17,2,251,1,36,0,36,64,1,159,0,159,187
0.071,6,9,1340,5,145,17,145,349,4,827,21,827,991
1719.49,17,12,498,11,14,171949,14,462,1,8,0,8,36
1.306,6,11,1727,7,100,217,100,384,4,589,345,1152,1343
1797.382,17,448,39896,403,35,4471,288,25676,45,288,40022,288,14220
13.381,17,2,144,1,36,0,36,64,1,52,0,52,80
19.157,17,4,352,2,48,19148,48,152,2,72,19148,72,200
1768.373,1,58,4872,58,56,31024,56,4872,0,0,0,0,0
1759.185,17,64,21360,64,305,27923,308,21360,0,0,0,0,0
1.333,6,13,989,7,222,218,222,510,6,231,260,231,479
0.015,17,4,724,2,32,10,32,120,2,274,10,274,604
1.659,17,2,225,1,37,0,37,65,1,132,0,132,160
5.006,6,40,7309,20,218,263,314,3423,20,513,250,1179,3886
0.575,17,4,368,2,32,224,32,120,2,96,213,96,248
1791.436,6,398,35871,221,108,8142,469,16534,177,151,10178,1460,19337
1.368,6,51,20153,29,946,48,1460,14452,22,400,56,1460,5701
1796.417,17,448,39896,403,35,4468,288,25676,45,288,40019,288,14220
0.019,17,4,330,2,33,12,33,122,2,76,11,82,208
1773.034,6,191,16265,124,69,14414,69,9238,67,69,26863,69,7027
0.331,6,28,9166,13,257,27,667,1715,15,832,23,1408,7451
1101.575,6,220,14044,126,69,8812,69,7731,94,69,11844,69,6313
80.626,6,24,10168,13,549,68,1360,2749,11,1161,8047,2720,7419
5.02,17,4,288,2,36,5004,36,128,2,52,5009,52,160
19.662,17,4,240,2,32,19661,32,120,2,32,19661,32,120
0.489,17,3,451,2,39,388,39,134,1,289,0,289,317
281.293,6,31,7472,13,158,23441,267,1317,18,543,16544,1380,6155
121.498,6,25,9090,13,649,87,1360,3149,12,908,11025,1747,5941
1.665,6,20,3833,11,234,166,564,1504,9,463,185,1343,2329
195.884,1,8,448,8,28,27983,28,448,0,0,0,0,0
1664.912,1,7,742,7,78,277485,78,742,0,0,0,0,0
1739.694,1,15,870,15,30,124263,30,870,0,0,0,0,0
231.967,6,43,7751,30,155,7998,267,2202,13,836,19329,3436,5549
0.332,17,4,820,2,36,327,36,128,2,318,327,318,692
1116.5,1,5,280,5,28,279125,28,280,0,0,0,0,0
2.029,17,4,1344,4,308,676,308,1344,0,0,0,0,0
1770.569,6,99,9306,66,66,27239,66,5610,33,60,55327,60,3696
3.197,6,24,7503,14,275,245,674,2115,10,1212,349,1946,5388
0.104,17,2,904,2,424,104,548,904,0,0,0,0,0
0.007,17,8,1670,8,180,1,219,1670,0,0,0,0,0
1771.645,6,99,9240,66,65,27256,65,5577,33,59,55360,59,3663
1720.72,17,13,534,11,14,172053,14,462,2,8,1720535,8,72
8.694,6,66,20206,34,543,263,1152,15499,32,489,272,1179,4707
1.266,6,25,8056,12,164,99,267,1288,13,869,90,1440,6768
395.225,6,18,1242,14,180,30401,180,916,4,110,20068,110,326
1770.414,6,99,9306,66,66,27237,66,5610,33,60,55322,60,3696
210.389,17,4,352,2,60,210388,60,176,2,60,210388,60,176
76.135,6,15,612,7,0,12689,0,284,8,0,10052,0,328
0.006,17,3,821,1,137,0,137,165,2,300,5,300,656
1790.415,6,378,26366,217,98,8288,469,15303,161,69,11189,69,11063
1557.163,17,74,3108,74,14,21331,14,3108,0,0,0,0,0
1751.993,6,195,22308,100,68,17696,721,8052,95,237,18626,2828,14256
40.776,17,6,528,3,48,20383,48,228,3,72,20382,72,300
0.439,6,5,1564,3,413,219,413,946,2,269,198,269,618
1.263,6,39,10482,21,514,63,1360,4986,18,476,64,2715,5496
71.353,17,4,304,4,48,23784,48,304,0,0,0,0,0
1782.15,17,83,3480,82,14,22001,14,3444,1,8,0,8,36
43.28,6,35,9235,15,309,71,1189,2772,20,471,2276,1460,6463
1796.894,6,246,25184,99,67,18335,659,9340,147,138,12306,4658,15844
1790.45,6,367,25581,213,99,8445,469,15005,154,69,11701,69,10576
1781.811,17,82,3438,81,14,22272,14,3402,1,8,0,8,36
1.277,6,54,19083,29,927,45,1460,13262,25,400,45,1460,5821
0.496,6,10,887,5,248,120,248,452,5,231,120,231,435
0.996,6,29,13125,17,529,62,1360,3370,12,1157,73,3921,9755
66.218,6,21,8309,12,528,6019,1242,2218,9,935,8268,2648,6091
867.384,17,639,45196,556,40,1562,41,38174,83,56,521,57,7022
45.006,17,12,570,11,16,4500,58,486,1,56,0,56,84
0.54,6,10,924,5,283,94,283,551,5,105,94,105,373
1.562,6,29,10365,17,367,97,833,1785,12,1012,134,1420,8580
240.325,6,45,9328,24,523,10448,1408,5969,21,251,12016,639,3359
251.737,2,2,64,2,8,251737,8,64,0,0,0,0,0
1799.063,17,140,11200,70,48,26073,48,5320,70,56,26073,56,5880
1775.16,17,140,11200,70,48,25726,48,5320,70,56,25726,56,5880
1683.224,17,14,1036,7,30,280524,30,406,7,62,280523,62,630
1771.883,6,106,9604,66,65,27259,65,5577,40,59,45430,59,4027
1790.533,6,353,22538,203,69,8863,69,12260,150,69,12015,69,10278
1774.904,17,140,11200,70,48,25723,48,5320,70,56,25723,56,5880
1.241,6,41,11390,22,547,59,1360,5854,19,433,59,1360,5536
0.06,17,2,140,1,34,0,34,62,1,50,0,50,78
152.896,6,17,4894,9,681,120,1360,3118,8,481,21817,646,1776
82.982,6,33,7762,13,155,6915,267,1306,20,376,4367,3417,6456
1772.44,6,180,15480,120,69,14894,69,8940,60,69,30035,69,6540
0.012,6,17,7213,9,133,1,133,609,8,1236,1,1734,6604
40.683,1,45,4680,0,0,0,0,0,45,76,924,76,4680
378.29,2,4,128,4,8,126096,8,128,0,0,0,0,0
281.415,6,29,7392,13,158,23451,267,1317,16,603,18758,1400,6075
18.339,17,26,7573,11,356,1831,1350,4224,15,195,1307,1350,3349
151.674,6,25,8325,13,421,61,961,1864,12,746,13777,4080,6461
1681.411,17,14,3843,7,30,280233,30,406,7,463,280233,463,3437
67.166,6,28,8286,13,334,5593,517,2035,15,780,4794,1408,6251
134.136,6,58,10989,23,237,2885,1189,3305,35,298,3944,1460,7684
1771.025,6,108,9996,69,66,26044,66,5856,39,60,46603,60,4140
1.51,6,19,3781,10,234,167,564,1452,9,463,166,1343,2329
13.364,6,16,1327,8,222,1908,222,768,8,231,1908,231,559
10.019,17,4,804,2,41,10010,41,138,2,305,10009,305,666
164.218,17,4,240,2,32,164217,32,120,2,32,164216,32,120
1.754,6,14,4051,7,171,289,171,567,7,778,292,1448,3484
218.888,6,30,7432,13,158,18240,267,1317,17,543,13677,1400,6115
1799.116,17,450,39960,405,35,4453,288,25740,45,288,40017,288,14220
1.347,6,24,8004,12,164,103,267,1288,12,1216,105,3859,6716
11.804,17,3,984,3,300,5902,300,984,0,0,0,0,0
1745.328,1,56,4704,56,56,31733,56,4704,0,0,0,0,0
53.566,6,23,1699,17,43,3347,43,1339,6,0,6204,0,360
5.719,6,9,520,4,0,1906,0,220,5,0,1253,0,300
317.035,6,63,18451,38,325,8568,1360,9700,25,644,13203,4649,8751
215.374,17,2,908,2,426,215374,687,908,0,0,0,0,0
1787.478,6,103,8268,68,64,26678,64,4896,35,58,52570,58,3372
1680.728,17,13,534,11,14,168053,14,462,2,8,1680540,8,72
0.923,6,10,1687,7,100,153,100,384,3,1179,330,1179,1303
0.389,6,26,8868,13,227,32,547,1592,13,941,30,1438,7276
0.017,17,2,565,1,34,0,34,62,1,475,0,475,503
0.039,17,2,362,1,32,0,32,60,1,274,0,274,302
240.261,17,12,2796,12,205,21841,205,2796,0,0,0,0,0
0.263,17,3,451,2,39,5,39,134,1,289,0,289,317
0.92,6,10,1687,7,100,153,100,384,3,1179,324,1179,1303
44.825,6,44,13756,23,1015,423,1460,8069,21,371,2232,1460,5687
1146.142,6,150,11803,57,76,20464,338,5797,93,49,12458,143,6006
15.713,6,6,264,1,0,0,0,44,5,0,3865,0,220
1795.382,17,144,11520,72,48,25287,48,5472,72,56,25287,56,6048
1768.091,1,57,4788,0,0,0,0,0,57,56,31573,56,4788
11.608,6,1858,1604553,1121,1376,10,1420,1570852,737,467,15,1883,33701
240.189,6,53,17388,28,765,8895,1402,14482,25,199,10007,580,2906
1739.279,6,87,6322,58,31,30513,31,3915,29,31,62116,31,2407
0.004,17,2,449,1,45,0,45,73,1,348,0,348,376
280.233,6,28,7352,13,158,23352,267,1317,15,678,20013,2600,6035
0.017,17,2,198,1,37,0,37,65,1,105,0,105,133
1749.523,17,12,498,11,14,174952,14,462,1,8,0,8,36
280.483,6,28,7352,12,158,25498,267,1277,16,678,18695,2760,6075
1.16,6,26,9564,13,164,82,267,1388,13,1070,82,2816,8176
6.399,2,2,64,2,8,6399,8,64,0,0,0,0,0
64.977,17,4,352,2,60,64976,60,176,2,60,64976,60,176
5.888,6,39,7269,20,218,309,314,3423,19,513,312,1179,3846
11.313,6,1783,1532082,1081,1363,10,1380,1499748,702,421,16,1923,32334
1773.149,6,180,15480,120,69,14900,69,8940,60,69,30048,69,6540
277.618,6,55,4091,26,86,11099,86,1560,29,42,9914,63,2531
0.013,6,2,656,1,564,0,564,616,1,0,0,0,40
1797.856,1,234,24804,234,78,7716,78,24804,0,0,0,0,0
11.277,6,20,7546,11,215,1127,517,1249,9,1161,107,1368,6297
0.167,17,2,2752,2,1348,167,1348,2752,0,0,0,0,0
1.773,6,19,4259,11,273,177,517,1135,8,1342,252,1408,3124
1720.37,1,93,5208,93,28,18699,28,5208,0,0,0,0,0
1625.925,1,8,448,8,28,232275,28,448,0,0,0,0,0
0.122,17,2,656,2,300,122,300,656,0,0,0,0,0
6.775,6,491,414751,296,1339,22,1368,399935,195,776,33,2736,14816
182.291,6,271,200811,133,840,34,1460,11225,138,1437,1329,2920,189586
3.587,6,2,88,2,0,0,0,88,0,0,0,0,0
0.622,17,8,2758,8,316,88,355,2758,0,0,0,0,0
504.238,2,3,96,3,8,252119,8,96,0,0,0,0,0
1729.194,6,66,4831,42,33,42175,33,2889,24,31,75174,31,1942
33.533,6,30,5042,15,154,2395,722,1859,15,399,2382,2026,3183
1765.498,6,56,14228,33,378,55171,1460,6653,23,390,80241,1460,7575
1792.071,17,180,14040,180,50,10011,50,14040,0,0,0,0,0
0.388,6,5,1564,3,413,194,413,946,2,269,178,269,618
0.844,6,21,5982,12,281,76,544,1328,9,715,94,1414,4654
29.157,6,61,20798,28,889,1079,1440,14525,33,374,904,1440,6273
1795.485,17,449,39928,404,35,4455,288,25708,45,288,40017,288,14220
0.298,17,2,154,1,33,0,33,61,1,65,0,65,93
1.3,17,23,12860,11,606,130,1350,6974,12,462,99,1350,5886
732.126,17,47,3572,47,48,15915,48,3572,0,0,0,0,0
641.298,6,30771,30458516,10951,801,58,1448,646686,19820,1455,12,7240,29811830
1778.095,1,100,5600,100,28,17960,28,5600,0,0,0,0,0
0.348,6,22,7342,12,335,31,668,1974,10,1210,37,1906,5368
1781.778,17,142,11360,71,48,25453,48,5396,71,56,25453,56,5964
0.992,6,31,10750,16,511,66,1360,3240,15,689,57,1360,7510
1756.623,6,4172,4410474,1426,146,1232,923,84936,2746,1564,639,7010,4325538
0.811,17,2,144,1,36,0,36,64,1,52,0,52,80
0.172,6,24,7176,13,155,14,267,1301,11,905,16,4845,5875
0.094,6,9,1346,5,145,23,145,349,4,833,27,833,997
5.347,6,40,7325,21,218,267,314,3463,19,516,282,1179,3862
1797.08,17,448,39896,403,35,4470,288,25676,45,288,40021,288,14220
8.22,6,70,20286,36,562,234,1152,15499,34,489,241,1179,4787
280.419,6,28,7352,13,158,23368,267,1317,15,775,20027,4836,6035
6.052,17,3,228,3,48,3026,48,228,0,0,0,0,0
25.199,17,41,11950,18,445,1482,1350,8521,23,121,1141,1350,3429
1564.2,2,17,544,17,8,97762,8,544,0,0,0,0,0
230.117,17,4,558,2,36,230113,36,128,2,187,230112,187,430
1799.972,17,144,11520,72,48,25351,48,5472,72,56,25351,56,6048
1791.006,1,342,28728,342,56,5252,56,28728,0,0,0,0,0
18.563,17,32,14416,19,610,1029,1350,12127,13,148,1544,1350,2289
1774.724,6,284,36496,115,143,15566,1360,17110,169,148,10563,4662,19386
1765.149,2,15,480,15,8,126082,8,480,0,0,0,0,0
0.018,6,9,1547,5,515,4,515,783,4,548,5,548,764
11.782,6,1885,1630467,1139,1377,10,1420,1596370,746,467,15,1883,34097
1789.012,17,142,11360,71,48,25557,48,5396,71,56,25557,56,5964
0.209,6,44,17855,24,987,9,1420,12834,20,420,10,1420,5021
7.275,6,71,22142,37,554,202,1152,16998,34,472,212,1179,5144
0.316,6,6,240,3,0,145,0,120,3,0,22,0,120
0.789,6,27,5927,13,156,65,267,1462,14,650,55,1452,4465
0.106,17,2,136,1,32,0,32,60,1,48,0,48,76
7.454,6,980,857729,596,1364,12,1408,833097,384,931,19,2801,24632
0.629,6,126,88968,57,131,11,232,2809,69,1323,9,1430,86159
1795.941,17,448,39896,403,35,4467,288,25676,45,288,40017,288,14220
7.897,6,38,9389,19,259,438,464,1570,19,469,405,1374,7819
4.25,6,40,7309,21,218,212,314,3463,19,513,222,1179,3846
12.51,6,10,560,6,0,2502,0,328,4,0,4027,0,232
0.079,1,2,168,2,56,79,56,168,0,0,0,0,0
2.231,17,4,1568,4,364,743,364,1568,0,0,0,0,0
0.022,17,2,144,1,36,0,36,64,1,52,0,52,80
1003.607,17,42,37778,42,871,24478,1451,37778,0,0,0,0,0
1740.446,17,30,31680,30,1028,60015,1028,31680,0,0,0,0,0
11.709,6,33,12906,14,440,900,721,2766,19,721,589,1440,10140
1.13,6,22,7900,11,164,96,267,1236,11,1216,96,3819,6664
1786.555,6,102,8228,68,64,26665,64,4896,34,58,54135,58,3332
1787.071,6,108,8536,68,65,26672,65,4930,40,59,45820,59,3606
239.479,6,59,13688,29,156,8547,721,2733,30,464,8252,2840,10955
527.18,1,7,1304,7,158,87863,351,1304,0,0,0,0,0
1787.301,6,102,8364,68,66,26676,66,4964,34,60,54157,60,3400
1765.071,6,5042,4823311,1739,148,1015,966,100725,3303,1408,534,2836,4722586
7.379,6,1423,1300361,894,1377,8,1408,1268189,529,931,13,2816,32172
1797.565,1,342,28728,342,56,5271,56,28728,0,0,0,0,0
62.088,6,62,41088,39,1148,1633,1368,33050,23,840,2811,2519,8038
297.063,1,4,224,4,28,99021,28,224,0,0,0,0,0
1740.409,17,30,31680,30,1028,60014,1028,31680,0,0,0,0,0
100.653,6,20,5916,7,145,16744,194,902,13,745,8372,1360,5014
24.384,6,20,7863,12,279,2216,507,1471,8,1193,3426,2492,6392
39.419,17,42,6292,21,48,1970,48,1596,21,195,1970,308,4696
0.92,6,50,21006,27,1053,35,1380,15856,23,421,34,1923,5150
0.06,1,2,112,2,28,60,28,112,0,0,0,0,0
207.084,17,4,352,2,60,207083,60,176,2,60,207083,60,176
970.569,6,235,21214,120,81,8153,267,8474,115,153,8513,1460,12740
0.022,6,13,4282,7,111,3,111,483,6,1159,4,2896,3799
1786.565,6,102,8364,68,66,26665,66,4964,34,60,54135,60,3400
0.208,17,7,2172,7,282,34,316,2172,0,0,0,0,0
1781.143,6,354,22440,207,69,8646,69,12420,147,69,12199,69,10020
243.296,17,32,3270,28,30,9010,37,1638,4,380,61169,463,1632
1779.143,17,78,3270,77,14,23409,14,3234,1,8,0,8,36
7.195,6,24,4530,13,213,599,597,1741,11,441,699,1402,2789
11.015,6,18,5610,10,275,1223,275,958,8,1440,845,1440,4652
0.21,6,15,3660,8,101,30,101,533,7,1373,35,1448,3127
110.221,6,30,7432,13,158,9185,267,1317,17,543,6886,1400,6115
1795.844,17,448,39896,403,35,4467,288,25676,45,288,40019,288,14220
0.393,6,58,26687,32,1043,12,1380,18090,26,626,14,3303,8597
0.428,6,111,87288,61,131,7,232,2969,50,1829,8,5372,84319
650.387,17,78,5928,78,48,8446,48,5928,0,0,0,0,0
1795.15,1,59,4956,59,56,30950,56,4956,0,0,0,0,0
0.008,17,2,442,1,35,0,35,63,1,351,0,351,379
1796.916,17,448,39896,403,35,4469,288,25676,45,288,40016,288,14220
0.561,6,115,87613,50,131,11,232,2529,65,1374,8,2247,85084
6.004,17,3,1152,3,356,3002,356,1152,0,0,0,0,0
280.493,6,31,7472,13,158,23374,267,1317,18,603,16496,2076,6155
5.211,17,4,288,2,36,4995,36,128,2,52,5197,52,160
1.215,6,25,8056,12,164,94,267,1288,13,869,85,1448,6768
0.503,6,26,9026,13,263,41,691,1736,13,943,39,1448,7290
300.849,6,64,40524,39,467,7917,1258,4012,25,1760,1209,8448,36512
1759.712,6,128,6368,64,0,27931,0,3328,64,0,27931,0,3040
65.724,6,2124,1895448,1310,1364,50,1368,1843038,814,838,80,1368,52410
7.777,6,77,23745,39,563,204,1152,18457,38,470,203,1179,5288
0.355,6,4,1037,2,0,230,0,104,2,853,132,853,933
37.712,17,22,1936,11,48,3770,48,836,11,72,3770,72,1100
300.809,6,50,13249,26,884,12032,1460,7332,24,290,665,1460,5917
1746.436,6,95,7203,63,38,28168,205,4476,32,33,56325,98,2727
33.538,17,6,1236,3,48,16763,48,228,3,308,16763,308,1008
352.01,6,6,567,1,112,0,112,152,5,43,75271,64,415
0.508,6,47,21157,27,1072,19,1380,16127,20,421,24,1923,5030
1746.38,17,244,44026,244,152,7186,377,44026,0,0,0,0,0
0.185,6,46,20489,26,1029,7,1420,15468,20,467,9,1883,5021
630.115,2,5,160,5,8,157528,8,160,0,0,0,0,0
0.898,17,2,778,2,361,898,361,778,0,0,0,0,0
6.838,6,43,8329,22,227,325,314,4062,21,489,328,1179,4267
378.138,6,117,88612,76,1239,5041,1408,78357,41,811,2293,3847,10255
1778.099,17,142,11360,71,48,25400,48,5396,71,56,25400,56,5964
280.177,6,29,7392,13,158,23348,267,1317,16,543,18677,1400,6075
0.404,6,12,1304,6,256,77,256,756,6,304,78,304,548
10.959,6,20,5694,11,275,1095,275,998,9,1440,743,1440,4696
240.227,6,60,20684,34,791,7279,1408,17608,26,190,9608,580,3076
5.01,17,4,542,2,36,5005,36,128,2,179,5005,187,414
0.816,6,4,191,1,0,0,0,40,3,31,24,31,151
0.109,6,9,1050,5,261,27,261,465,4,421,33,421,585
0.095,17,4,420,2,33,47,33,122,2,121,49,145,298
0.078,17,4,284,2,32,67,32,120,2,54,67,60,164
3.074,17,8,1560,4,32,1020,32,240,4,302,1020,308,1320
11.826,6,25,8453,13,275,985,275,1078,12,983,857,1420,7375
0.036,17,2,136,1,32,0,32,60,1,48,0,48,76
280.256,6,28,7352,12,158,25477,267,1277,16,603,18681,1400,6075
10.245,6,45,7866,23,218,465,314,3543,22,491,475,1179,4323
0.295,17,4,588,2,48,282,48,152,2,190,282,308,436
1748.48,6,144,9240,78,52,22707,208,5701,66,31,26895,31,3539
481.311,2,5,160,5,8,120327,8,160,0,0,0,0,0
1797.284,6,356,22520,208,69,8682,69,12460,148,69,12226,69,10060
30.15,6,18,2401,9,324,3768,585,1125,9,396,3751,580,1276
1.587,6,10,923,6,304,317,304,624,4,83,366,83,299
281.308,6,30,7432,13,158,23442,267,1317,17,543,17570,1400,6115
156.53,6,25,9718,13,365,128,780,1660,12,1080,14215,2720,8058
1786.446,6,102,8364,68,66,26663,66,4964,34,60,54132,60,3400
5.825,6,21,6780,12,185,529,275,1045,9,1073,346,2760,5735
1765.866,6,98,7421,65,38,27591,205,4611,33,33,55176,98,2810
1740.457,17,30,6930,30,203,60015,203,6930,0,0,0,0,0
1799.94,17,480,134452,480,252,3757,422,134452,0,0,0,0,0
0.0,17,1,61,1,33,0,33,61,0,0,0,0,0
39.696,17,22,1672,22,48,1890,48,1672,0,0,0,0,0
0.003,6,6,6079,1,0,0,0,40,5,1459,0,2720,6039
0.021,17,2,459,1,40,0,40,68,1,363,0,363,391
88.226,17,4,352,2,60,88224,60,176,2,60,88224,60,176
1743.458,6,99,7411,63,38,28120,205,4476,36,33,49806,98,2935
1.23,6,8,339,4,0,410,0,164,4,7,338,7,175
1.242,6,5,260,2,0,644,0,104,3,0,621,0,156
1721.445,17,12,498,11,14,172144,14,462,1,8,0,8,36
20.355,6,23,5534,13,107,1696,159,1126,10,967,2246,1709,4408
0.424,6,26,9007,13,252,35,647,1704,13,945,33,1448,7303
304.314,6,35,15237,15,593,21736,1408,4363,20,818,12990,1578,10874
0.069,6,2,80,1,0,0,0,40,1,0,0,0,40
1741.743,6,87,6322,58,31,30556,31,3915,29,31,62204,31,2407
0.051,17,2,180,1,30,0,30,58,1,94,0,94,122
1744.663,2,19,608,19,8,96925,8,608,0,0,0,0,0
1741.121,6,87,6322,58,31,30545,31,3915,29,31,62182,31,2407
3.289,17,4,1560,4,362,1096,362,1560,0,0,0,0,0
1751.039,6,102,7460,68,31,26134,31,4745,34,31,53060,31,2715
0.012,17,4,352,2,37,6,37,130,2,83,7,89,222
300.251,6,31,11810,17,588,18765,1438,4435,14,948,18482,1488,7375
1719.731,1,8,448,8,28,245675,28,448,0,0,0,0,0
1799.276,1,176,9856,176,28,10281,28,9856,0,0,0,0,0
264.495,17,4,352,2,60,264494,60,176,2,60,264494,60,176
1.286,6,12,1767,8,100,183,100,424,4,589,349,1152,1343
582.606,1,6,336,6,28,116521,28,336,0,0,0,0,0
28.084,17,24,13408,13,786,2340,1350,10584,11,228,2793,1350,2824
69.711,6,23,10278,12,433,77,990,1859,11,1138,6956,2720,8419
0.018,17,8,1670,8,180,2,219,1670,0,0,0,0,0
1772.202,6,180,15480,120,69,14892,69,8940,60,69,30034,69,6540
0.215,17,2,157,1,31,0,31,59,1,70,0,70,98
3.312,17,10,1296,5,40,819,40,340,5,163,281,194,956
0.254,6,22,5040,11,137,25,267,1132,11,577,24,1400,3908
4.161,6,40,7309,19,218,231,314,3383,21,440,195,1152,3926
0.933,6,32,12825,17,511,58,1460,3279,15,812,54,1460,9546
1799.014,17,448,39896,403,35,4475,288,25676,45,288,40015,288,14220
1.991,17,3,468,3,128,995,128,468,0,0,0,0,0
7.41,6,5,220,1,0,0,0,44,4,0,2382,0,176
6.09,17,4,304,3,48,2979,48,228,1,48,0,48,76
0.009,17,2,180,1,30,0,30,58,1,94,0,94,122
1787.462,6,104,8420,68,65,26678,66,4952,36,59,51067,60,3468
0.294,17,2,152,1,48,0,48,76,1,48,0,48,76
1790.72,6,180,15480,120,69,15048,69,8940,60,69,30342,69,6540
1797.841,17,449,39928,404,35,4461,288,25708,45,288,40022,288,14220
73.998,17,4,352,2,60,73997,60,176,2,60,73997,60,176
0.001,17,2,206,1,44,0,44,72,1,106,0,106,134
1.366,6,25,8056,12,164,105,267,1288,13,1014,96,2491,6768
1772.764,6,180,15480,120,69,14897,69,8940,60,69,30041,69,6540
1681.55,1,7,742,7,78,280258,78,742,0,0,0,0,0
11.906,6,1841,1637062,1157,1360,10,1420,1605267,684,427,17,1420,31795
49.294,6,44,12513,21,957,765,1460,6667,23,307,2232,1460,5846
4.675,6,2,88,2,0,0,0,88,0,0,0,0,0
1774.293,6,180,15480,120,69,14910,69,8940,60,69,30072,69,6540
181.028,6,28,6562,11,220,5625,516,1325,17,325,11309,1452,5237
0.039,17,2,201,1,36,0,36,64,1,109,0,109,137
1.65,6,13,2311,8,188,235,245,700,5,1407,350,1407,1611
290.368,6,58,8910,28,164,10754,267,2275,30,775,10011,4836,6635
1790.78,6,359,22709,209,69,8609,69,12569,150,69,12018,69,10140
2.185,17,3,174,3,30,1092,30,174,0,0,0,0,0
1796.005,17,448,39896,403,35,4467,288,25676,45,288,40017,288,14220
1782.636,1,264,14784,264,28,6778,28,14784,0,0,0,0,0
0.297,6,32,21994,13,129,24,311,1065,19,1329,10,2836,20929
129.541,6,29,17521,16,708,48,1360,4214,13,1596,10783,4870,13307
4.374,6,35,6209,18,206,257,314,2784,17,456,257,1152,3425
0.629,6,7,295,4,0,209,0,164,3,7,201,7,131
1797.134,17,448,39896,403,35,4470,288,25676,45,288,40019,288,14220
0.365,17,2,152,1,48,0,48,76,1,48,0,48,76
1.254,6,40,9928,21,440,62,1360,4392,19,476,59,2720,5536
467.014,6,50,3045,28,41,17290,208,1917,22,31,22230,31,1128
87.621,6,32,24683,19,884,33,1360,6097,13,3009,7291,9171,18586
5.077,17,4,288,2,36,5045,36,128,2,52,5044,52,160
0.539,6,22,7368,13,337,44,674,2032,9,1212,62,1946,5336
1798.453,6,366,24603,213,87,8483,469,14136,153,69,11830,69,10467
27.096,6,40,12162,20,633,1426,1360,4647,20,558,1416,1360,7515
0.726,6,28,8988,14,236,55,585,1682,14,938,54,1438,7306
0.037,17,2,196,1,62,0,62,90,1,78,0,78,106
60.273,17,4,352,2,60,60272,60,176,2,60,60272,60,176
1746.711,1,56,4704,56,56,31758,56,4704,0,0,0,0,0
280.302,6,30,7432,13,158,23358,267,1317,17,543,17515,1400,6115
4.779,17,23,8176,11,444,477,1350,5202,12,219,430,1350,2974
0.065,17,4,368,2,32,45,32,120,2,96,0,96,248
25.262,6,38,8592,19,410,537,882,2034,19,445,1395,2128,6558
1780.42,6,354,22440,207,69,8642,69,12420,147,69,12194,69,10020
280.282,6,27,7312,12,158,25480,267,1277,15,678,20015,2045,6035
340.709,1,12,672,12,28,30973,28,672,0,0,0,0,0
1.196,17,6,360,3,32,597,32,180,3,32,597,32,180
692.204,6,75,6519,47,71,15047,138,3605,28,69,25636,69,2914
1791.891,6,360,22818,209,69,8614,69,12569,151,69,11945,69,10249
52.269,6,25,7097,12,155,4751,267,1266,13,589,4354,3426,5831
67.343,6,74,48701,45,1191,1530,1448,40463,29,746,2198,1448,8238
280.151,6,27,7312,13,158,23345,267,1317,14,775,21541,3445,5995
0.047,17,2,144,1,36,0,36,64,1,52,0,52,80
1796.204,6,356,22520,208,69,8677,69,12460,148,69,12219,69,10060
1357.06,1,72,4032,72,28,19113,28,4032,0,0,0,0,0
0.001,6,2,135,2,31,1,31,135,0,0,0,0,0
0.007,17,3,588,2,60,0,60,176,1,384,0,384,412
1383.701,2,16,512,16,8,92246,8,512,0,0,0,0,0
0.574,6,15,4407,9,327,68,634,1784,6,767,105,1328,2623
1.311,6,37,8214,18,321,77,1164,2678,19,433,61,1360,5536
1744.487,6,95,7203,63,38,28136,205,4476,32,33,56259,98,2727
0.383,6,27,8951,13,232,31,567,1612,14,825,28,1448,7339
1799.351,17,449,39928,404,35,4464,288,25708,45,288,40021,288,14220
1794.634,17,140,11200,70,48,26009,48,5320,70,56,26009,56,5880
3.354,17,10,900,5,30,835,30,290,5,94,835,94,610
1679.999,17,12,498,11,14,167999,14,462,1,8,0,8,36
1799.645,17,209,46386,209,193,8652,422,46386,0,0,0,0,0
0.205,6,7,468,4,124,68,124,284,3,32,0,33,184
1786.734,6,106,8456,68,65,26667,65,4930,38,59,48286,59,3526
0.028,6,10,1794,6,613,5,1070,1471,4,159,8,159,323
240.515,6,43,8672,22,575,11452,1418,5755,21,227,12025,580,2917
5.801,6,1387,1267878,844,1423,6,1448,1234966,543,776,10,1448,32912
1793.492,6,364,23047,211,69,8540,69,12787,153,69,11799,69,10260
2.401,17,2,685,1,308,0,308,336,1,321,0,321,349
9.021,6,37,8591,19,382,501,831,1987,18,451,514,1928,6604
240.27,6,43,8892,21,519,12013,1402,5773,22,218,11441,617,3119
0.057,17,4,284,2,32,1,32,120,2,54,11,60,164
0.043,17,2,912,1,308,0,308,336,1,548,0,548,576
1633.461,6,30,4450,19,241,90747,241,3182,11,92,163321,92,1268
196.524,17,3,1008,3,308,98262,308,1008,0,0,0,0,0
16.588,6,16,6055,5,186,4145,267,581,11,837,1657,1460,5474
10.147,6,16,5255,9,275,1268,275,643,7,1440,854,1440,4612
138.562,17,4,352,2,60,138561,60,176,2,60,138561,60,176
1740.271,6,87,6322,58,31,30531,31,3915,29,31,62150,31,2407
171.949,17,6,360,3,32,85974,32,180,3,32,85974,32,180
19.246,6,25,7005,13,275,1603,275,1086,12,1353,1524,1440,5919
158.536,6,22,9187,11,418,71,951,1726,11,1001,15840,1440,7461
11.013,17,16,17775,16,1082,734,1451,17775,0,0,0,0,0
1771.47,6,99,9306,66,66,27253,66,5610,33,60,55355,60,3696
9.345,2,2,64,2,8,9345,8,64,0,0,0,0,0
0.695,17,6,1674,3,32,345,32,180,3,470,307,470,1494
1739.551,6,87,6322,58,31,30518,31,3915,29,31,62126,31,2407
1798.555,17,769,46373,769,32,2341,37,46373,0,0,0,0,0
50.85,6,29,8832,14,158,3911,267,1357,15,858,3628,2800,7475
26.628,6,44,13606,21,330,1331,721,3159,23,680,1191,1420,10447
7.337,6,1468,1243558,817,1431,8,1448,1201894,651,776,11,1448,41664
300.658,6,39,8396,20,262,15824,671,1882,19,441,473,1460,6514
18.2,17,9,2088,9,204,2275,204,2088,0,0,0,0,0
1623.098,6,21,3171,14,241,124853,241,2247,7,92,270483,92,924
20.285,6,89,22655,43,421,482,1152,15214,46,430,445,1179,7441
0.465,6,22,7333,13,334,38,663,2021,9,1209,57,1906,5312
1785.174,6,354,22509,207,69,8665,69,12489,147,69,12227,69,10020
0.031,17,6,480,6,52,6,52,480,0,0,0,0,0
0.048,17,4,284,2,32,42,32,120,2,54,41,60,164
0.344,17,2,146,1,37,0,37,65,1,53,0,53,81
0.564,17,2,384,1,39,0,39,67,1,289,0,289,317
3.81,17,18,7982,10,503,411,1350,5319,8,304,525,1350,2663
1791.85,6,356,22520,208,69,8656,69,12460,148,69,12189,69,10060
0.01,17,2,383,1,39,0,39,67,1,288,0,288,316
100.837,6,861,410969,451,849,224,1152,389437,410,427,245,1179,21532
0.2,17,4,1423,4,327,66,354,1423,0,0,0,0,0
0.05,17,2,343,1,37,0,37,65,1,250,0,250,278
20.196,6,20,3130,11,183,2019,517,1509,9,381,2523,499,1621
1.232,6,25,8056,12,164,95,267,1288,13,869,87,1408,6768
59.31,6,10,648,10,31,6590,31,648,0,0,0,0,0
1749.462,6,100,7866,66,45,26914,205,4902,34,35,53003,98,2964
8.099,6,13,2190,7,210,1349,210,792,6,545,1618,904,1398
240.181,6,57,19859,31,841,8005,1402,16778,26,215,9607,580,3081
1771.269,6,112,10354,71,66,25303,66,6038,41,60,44279,60,4316
1799.635,17,449,39928,404,35,4465,288,25708,45,288,40021,288,14220
1794.576,17,87,3648,86,14,21112,14,3612,1,8,0,8,36
0.473,6,22,7354,12,335,43,668,1974,10,1210,48,1946,5380
1744.265,6,95,7203,63,38,28133,205,4476,32,33,56259,98,2727
6.583,2,2,64,2,8,6583,8,64,0,0,0,0,0
0.4,6,13,1693,7,288,63,288,588,6,426,43,434,1105
1.652,17,21,10441,9,484,206,1350,4613,12,457,118,1350,5828
1770.918,6,99,9108,66,63,27244,63,5511,33,57,55338,57,3597
1783.808,6,416,24920,208,69,8617,69,12460,208,34,8617,48,12460
1737.78,1,56,4704,0,0,0,0,0,56,56,31596,56,4704
1798.099,1,342,28728,342,56,5273,56,28728,0,0,0,0,0
1786.744,6,102,8228,68,64,26667,64,4896,34,58,54141,58,3332
1790.688,6,381,26555,218,97,8252,469,15550,163,69,11053,69,11005
0.799,6,15,2224,7,288,104,288,620,8,424,89,434,1604
1776.246,17,73,3060,72,14,25017,14,3024,1,8,0,8,36
252.604,2,2,64,2,8,252604,8,64,0,0,0,0,0
20.343,6,18,2368,10,189,2260,517,1298,8,323,2904,499,1070
1793.057,17,86,3606,85,14,21345,14,3570,1,8,0,8,36
367.306,6,58,7286,27,109,14120,722,2738,31,140,12238,1408,4548
1786.606,6,104,8376,68,65,26665,65,4930,36,59,51043,59,3446
54.519,6,35,8470,18,412,522,922,2038,17,521,3397,3488,6432
0.308,6,22,7333,12,334,27,663,1969,10,1209,33,1906,5364
244.772,6,52,10371,25,518,10198,1408,6045,27,242,9414,580,4326
252.164,2,2,64,2,8,252164,8,64,0,0,0,0,0
212.209,6,30,8872,13,158,17684,267,1317,17,687,13252,1400,7555
1772.418,6,180,15480,120,69,14894,69,8940,60,69,30034,69,6540
4.472,2,2,64,2,8,4472,8,64,0,0,0,0,0
142.607,17,4,352,2,60,142606,60,176,2,60,142606,60,176
4.01,17,8,792,4,39,1333,39,268,4,103,1333,103,524
661.84,2,6,192,6,8,132368,8,192,0,0,0,0,0
4.789,6,38,7229,19,218,266,314,3383,19,513,252,1179,3846
1017.04,1,16,896,16,28,67802,28,896,0,0,0,0,0
5.014,17,3,343,2,36,5009,36,128,1,187,0,187,215
2.903,17,4,304,2,48,2892,48,152,2,48,2892,48,152
1.011,6,6,300,3,0,360,0,144,3,0,335,0,156
2.029,17,6,966,3,33,995,33,183,3,233,0,233,783
164.124,6,28,4718,10,296,18236,722,1405,18,182,9644,1408,3313
36.52,17,22,1936,11,48,3646,48,836,11,72,3645,72,1100
5.47,6,43,8345,22,227,260,314,4062,21,491,260,1179,4283
10.584,6,25,9301,15,769,756,1408,4649,10,687,1161,1288,4652
1696.283,1,8,448,8,28,242326,28,448,0,0,0,0,0
302.043,6,35,6477,18,286,17767,1314,2445,17,304,18876,1420,4032
22.696,6,3368,3149046,2183,1364,10,1408,3082762,1185,931,19,2801,66284
0.1,17,2,154,1,41,0,41,69,1,57,0,57,85
240.238,6,56,15789,28,701,8897,1402,12696,28,203,8897,580,3093
1768.405,17,44,14784,44,308,41125,308,14784,0,0,0,0,0
1.384,6,50,20051,27,945,53,1460,14355,23,433,54,1460,5696
1787.316,6,104,8308,68,64,26676,64,4896,36,58,51063,58,3412
8.417,6,11,676,4,106,2803,106,274,7,90,1401,90,402
1.256,6,50,19865,28,870,46,1360,14209,22,433,51,1360,5656
0.399,6,3,144,2,0,1,0,92,1,0,0,0,52
74.938,6,21,860,10,0,5980,0,404,11,0,7493,0,456
97.505,6,11,3005,6,92,19501,92,412,5,2329,24324,2329,2593
1796.169,17,447,39296,404,35,4456,288,25708,43,288,41919,288,13588
217.564,17,4,240,2,32,217563,32,120,2,32,217563,32,120
299.911,17,4,352,2,60,299910,60,176,2,60,299910,60,176
0.997,6,10,1687,7,100,166,100,384,3,1179,364,1179,1303
7.663,17,6,528,3,48,3826,48,228,3,72,3826,72,300
1795.251,17,447,39864,402,35,4476,288,25644,45,288,40018,288,14220
10.467,6,12,1896,5,255,2615,595,1288,7,212,1743,212,608
0.728,6,3,132,2,0,538,0,92,1,0,0,0,40
61.312,6,37,15983,22,805,2919,1408,9205,15,665,4360,1408,6778
240.166,6,58,18605,30,769,8281,1402,15424,28,214,8894,580,3181
11.465,17,8,704,4,48,3818,48,304,4,72,3818,72,400
1796.723,17,449,39928,404,35,4458,288,25708,45,288,40016,288,14220
1789.34,17,83,3480,82,14,22090,14,3444,1,8,0,8,36
240.23,17,4,240,2,32,240229,32,120,2,32,240229,32,120
4.321,6,40,7309,20,218,227,314,3423,20,513,214,1179,3886
315.873,6,121,36531,61,512,5264,1360,25056,60,283,5351,1360,11475
1776.032,17,66,2769,65,13,27750,14,2725,1,16,0,16,44
121.613,6,34,7457,15,230,139,502,1756,19,308,6752,1452,5701
1742.073,6,94,7151,62,38,28558,205,4424,32,33,56190,98,2727
0.006,6,3,120,1,0,0,0,40,2,0,1,0,80
2.979,17,2,1430,2,687,2979,687,1430,0,0,0,0,0
3.317,17,16,2058,16,100,221,360,2058,0,0,0,0,0
1685.96,17,16,1265,8,30,240843,37,471,8,71,240845,136,794
3.43,17,4,932,2,30,3420,30,116,2,380,3420,468,816
1740.411,17,28,29568,28,1028,64459,1028,29568,0,0,0,0,0
12.44,6,1932,1713914,1210,1361,10,1420,1680611,722,427,17,1420,33303
0.276,17,2,144,1,36,0,36,64,1,52,0,52,80
3.095,17,3,228,2,48,2904,48,152,1,48,0,48,76
49.906,1,6,336,6,28,9981,28,336,0,0,0,0,0
1799.407,1,16,896,16,28,119960,28,896,0,0,0,0,0
240.179,6,52,17997,27,810,9237,1402,15188,25,187,10007,580,2809
0.028,17,4,284,2,32,25,32,120,2,54,24,60,164
1740.393,6,89,6469,59,31,30006,31,3979,30,31,60011,31,2490
1773.156,6,181,15589,120,69,14900,69,8940,61,69,29545,69,6649
131.967,6,65,35500,39,1076,3472,1448,25718,26,765,3610,2359,9782
240.303,6,41,8747,20,523,12647,1408,5757,21,236,12014,618,2990
340.503,6,31553,26003226,13631,341,24,343,834928,17922,1361,18,4104,25168298
1787.907,6,368,24683,213,87,8433,469,14205,155,69,11609,69,10478
23.22,1,4,224,4,28,7740,28,224,0,0,0,0,0
0.455,6,7,667,4,177,151,177,393,3,110,133,110,274
421.056,6,87,5550,51,69,8421,69,3075,36,69,12018,69,2475
24.953,6,38,8449,18,171,1467,721,2094,20,555,1301,1440,6355
0.092,17,2,672,2,308,92,308,672,0,0,0,0,0
1797.071,6,368,25759,214,99,8436,469,15045,154,69,11745,69,10714
242.328,6,32,8952,14,158,18640,267,1357,18,624,14251,1400,7595
1792.092,1,58,4872,0,0,0,0,0,58,56,31440,56,4872
1785.225,6,193,11643,95,44,18991,208,6700,98,31,18401,31,4943
2.455,17,2,677,1,300,0,300,328,1,321,0,321,349
756.1,2,5,160,5,8,189025,8,160,0,0,0,0,0
371.019,6,18,1239,14,177,28539,177,913,4,110,20060,110,326
300.66,6,36,13371,16,780,20044,1448,6306,20,462,10842,1448,7065
1783.932,6,106,8584,69,66,26234,66,5004,37,60,49550,60,3580
1796.487,17,275,58510,275,184,6556,356,58510,0,0,0,0,0
1763.469,2,13,416,13,8,146955,8,416,0,0,0,0,0
157.189,17,4,352,2,60,157188,60,176,2,60,157187,60,176
3.513,6,2,88,2,0,0,0,88,0,0,0,0,0
1752.495,6,98,7457,63,38,28266,205,4476,35,35,51533,98,2981
369.686,6,18,1242,14,180,28437,180,916,4,110,20060,110,326
22.214,17,19,7648,9,483,2772,1350,4602,10,276,2464,1350,3046
300.368,6,36,18854,17,415,18773,1114,2566,19,1092,1969,1855,16288
1798.496,17,449,39928,404,35,4462,288,25708,45,288,40020,288,14220
10.969,6,93,27173,47,557,238,1152,20835,46,449,238,1179,6338
0.494,17,3,451,2,39,401,39,134,1,289,0,289,317
3.793,17,5,290,5,30,948,30,290,0,0,0,0,0
0.113,17,2,157,1,31,0,31,59,1,70,0,70,98
0.744,6,17,5164,9,150,93,174,664,8,835,93,1452,4500
0.431,6,7,295,4,0,143,0,164,3,7,110,7,131
0.484,6,12,1653,6,288,95,288,548,6,426,52,434,1105
1798.465,17,413,45926,197,141,9175,1350,33397,216,30,8364,60,12529
374.616,6,23,1535,16,177,24974,177,1053,7,110,10406,110,482
1.084,6,23,6595,13,350,89,1088,2275,10,979,119,1731,4320
1234.888,1,6,336,6,28,246977,28,336,0,0,0,0,0
1.353,6,51,21364,28,967,50,1460,15668,23,433,53,1460,5696
4.987,6,37,7189,19,218,277,314,3383,18,513,276,1179,3806
1770.781,6,110,11706,70,106,25663,822,7363,40,64,45402,191,4343
536.398,17,8,2045,4,31,178795,37,239,4,423,178796,463,1806
1791.42,6,365,25501,212,100,8489,469,14896,153,69,11784,69,10605
32.198,6,318,289271,121,123,268,292,6914,197,1409,164,2836,282357
0.024,17,2,672,2,308,24,308,672,0,0,0,0,0
1212.689,6,153,10552,58,46,21159,46,4406,95,46,12900,46,6146
1793.079,17,344,26144,344,48,5227,48,26144,0,0,0,0,0
1786.48,17,87,3648,86,14,21017,14,3612,1,8,0,8,36
1782.744,17,140,11200,70,48,25836,48,5320,70,56,25836,56,5880
76.019,2,2,64,2,8,76019,8,64,0,0,0,0,0
0.114,6,9,1343,5,145,28,145,349,4,830,34,830,994
282.012,6,30,7432,14,158,21693,267,1357,16,603,18783,2036,6075
110.614,6,116,89407,74,1297,1515,1448,79106,42,675,1734,1448,10301
4.443,6,34,6185,18,206,261,314,2784,16,551,278,1179,3401
47.17,6,30,7432,14,158,3628,267,1357,16,603,3142,2036,6075
0.015,6,10,1514,5,503,3,503,771,5,475,2,475,743
10.63,6,18,4266,10,275,1181,275,958,8,992,832,1440,3308
1740.509,17,30,31680,30,1028,60017,1028,31680,0,0,0,0,0
0.134,17,2,194,1,61,0,61,89,1,77,0,77,105
1701.61,17,23,960,22,14,81029,14,924,1,8,0,8,36
2.752,6,11,975,6,304,550,304,624,5,83,678,83,351
1756.625,1,8,448,8,28,250946,28,448,0,0,0,0,0
0.186,6,2,112,1,0,0,0,60,1,0,0,0,52
280.195,6,30,7432,14,158,21553,267,1357,16,603,18676,2800,6075
1725.991,1,8,448,8,28,246570,28,448,0,0,0,0,0
300.638,6,36,8359,20,283,15823,786,1965,16,522,565,2720,6394
0.24,17,4,732,2,36,234,36,128,2,274,235,274,604
36.201,17,40,5880,20,48,1904,48,1520,20,190,1904,308,4360
14.251,6,36,8261,19,345,791,721,1828,17,478,539,2128,6433
0.002,17,2,140,1,34,0,34,62,1,50,0,50,78
1744.61,2,26,832,26,8,69784,8,832,0,0,0,0,0
240.388,6,47,8604,24,449,10451,1418,5752,23,206,10926,580,2852
1797.246,17,448,39896,403,35,4470,288,25676,45,288,40018,288,14220
9.337,6,15,2783,8,188,1333,245,1080,7,703,1247,1152,1703
1772.017,6,180,15480,120,69,14890,69,8940,60,69,30031,69,6540
267.749,17,4,352,2,60,267748,60,176,2,60,267748,60,176
1795.552,17,448,39612,404,35,4455,288,25708,44,288,40945,288,13904
1.74,6,14,2351,8,188,248,245,700,6,703,295,1152,1651
0.034,17,2,337,1,48,0,48,76,1,233,0,233,261
1787.987,6,354,22509,205,69,8764,69,12340,149,69,12080,69,10169
0.36,6,29,9163,14,252,27,647,1744,15,945,24,1438,7419
0.582,6,10,2213,5,145,145,145,349,5,830,122,830,1864
1790.983,1,236,13216,236,28,7621,28,13216,0,0,0,0,0
0.641,6,38,12096,22,507,30,1402,5722,16,614,42,2423,6374
94.937,6,35,5315,21,154,4746,722,2183,14,400,1184,2026,3132
1782.523,17,83,3480,82,14,22006,14,3444,1,8,0,8,36
1787.187,17,83,3480,82,14,22064,14,3444,1,8,0,8,36
96.28,6,11,719,11,31,9628,31,719,0,0,0,0,0
11.979,6,1708,1622706,1147,1366,10,1432,1595628,561,385,21,1432,27078
1774.202,6,183,15738,121,69,14785,69,8980,62,69,29080,69,6758
22.545,17,4,240,2,32,22544,32,120,2,32,22544,32,120
16.049,6,31,5106,15,154,1146,722,1871,16,342,1058,1402,3235
856.897,17,124,9424,124,48,6966,48,9424,0,0,0,0,0
1796.658,6,258,19359,157,69,11517,69,10558,101,69,17966,69,8801
4.669,6,39,7269,21,218,233,314,3463,18,513,258,1179,3806
296.072,6,42,7623,21,147,14795,517,1983,21,504,14795,1418,5640
0.483,6,5,248,3,0,241,0,144,2,0,480,0,104
20.125,6,22,5482,12,107,1829,159,1086,10,773,2235,1408,4396
0.064,17,2,148,1,32,0,32,60,1,60,0,60,88
0.044,17,2,198,1,39,0,39,67,1,103,0,103,131
58.09,6,28,7223,13,156,4840,267,1312,15,482,4148,1997,5911
1786.64,17,140,11200,70,48,25893,48,5320,70,56,25893,56,5880
0.925,6,11,1727,7,100,154,100,384,4,589,221,1152,1343
1754.416,6,184,11305,93,48,19069,208,6704,91,31,19490,31,4601
1.609,6,40,11338,21,616,80,1460,5802,19,476,77,2920,5536
1724.273,17,16,4213,8,30,246322,37,471,8,439,246323,463,3742
0.046,6,10,767,5,186,11,186,454,5,45,11,45,313
1.634,6,29,10277,17,368,102,837,1789,12,1000,140,1452,8488
0.254,17,2,152,1,48,0,48,76,1,48,0,48,76
180.65,6,269,203098,156,1329,1165,1448,186239,113,645,1326,2896,16859
1436.527,6,128,12912,67,62,21764,517,4794,61,232,23941,2411,8118
5.443,6,40,7309,20,218,286,314,3423,20,513,271,1179,3886
10.986,6,18,4266,10,275,1220,275,958,8,992,887,1440,3308
48.765,6,45,8991,18,218,550,314,3343,27,570,1866,1179,5648
36.012,17,8,704,4,48,11982,48,304,4,72,11988,72,400
16.537,17,22,8169,10,437,1833,1350,4657,12,264,1500,1350,3512
111.122,6,31,20293,16,549,49,1360,2880,15,1866,7928,5440,17413
1786.663,6,104,8444,68,66,26666,66,4964,36,60,51044,60,3480
1796.368,6,368,25690,215,99,8394,469,15085,153,69,11815,69,10605
1798.08,17,180,14040,180,50,10045,50,14040,0,0,0,0,0
0.093,1,2,112,2,28,93,28,112,0,0,0,0,0
43.877,6,9,527,5,43,10969,43,311,4,0,14623,0,216
10.989,17,8,704,4,48,3660,48,304,4,72,3659,72,400
0.502,6,21,7281,13,334,41,663,2021,8,1209,66,1946,5260
377.476,6,27,1767,18,177,22204,177,1181,9,110,8841,110,586
1796.681,17,449,39928,404,35,4458,288,25708,45,288,40018,288,14220
0.014,17,2,409,1,40,0,40,68,1,313,0,313,341
38.937,17,22,1672,22,48,1854,48,1672,0,0,0,0,0
0.194,6,28,7336,13,155,16,267,1301,15,543,13,1300,6035
0.077,1,2,112,2,28,77,28,112,0,0,0,0,0
0.369,6,23,5080,11,137,36,267,1132,12,577,32,1400,3948
0.49,2,3,96,3,8,245,8,96,0,0,0,0,0
300.873,6,46,10280,23,433,13676,910,3154,23,364,697,2720,7126
16.81,6,12,5538,4,106,5603,106,274,8,822,2358,1452,5264
1788.17,6,387,31536,220,92,8165,1189,14915,167,136,10772,1997,16621
1798.064,1,226,12656,226,28,7991,28,12656,0,0,0,0,0
0.13,17,2,2380,2,1162,130,1162,2380,0,0,0,0,0
1783.816,6,481,30072,265,100,6756,469,17016,216,34,8296,64,13056
5.364,6,44,8369,21,227,268,314,4022,23,489,230,1179,4347
0.576,6,10,1512,5,503,144,503,771,5,473,144,473,741
0.058,6,9,1002,5,213,14,213,417,4,421,12,421,585
1797.388,17,130,10400,65,48,28084,48,4940,65,56,28084,56,5460
4.007,6,12,507,6,0,801,0,248,6,7,593,7,259
1789.606,17,292,61821,292,183,6149,422,61821,0,0,0,0,0
1.817,6,15,1776,8,256,258,256,580,7,304,301,304,1196
372.13,6,18,1242,14,180,28625,180,916,4,110,20058,110,326
254.252,6,9,522,2,106,254241,106,194,7,0,42373,0,328
1797.769,17,449,39928,404,35,4460,288,25708,45,288,40016,288,14220
1799.919,17,450,39960,405,35,4455,288,25740,45,288,40014,288,14220
0.006,17,2,379,1,39,0,39,67,1,284,0,284,312
25.404,6,40,13086,17,340,1587,722,2726,23,725,1144,1380,10360
15.803,17,36,10816,16,256,1051,1350,4549,20,285,830,1350,6267
8.415,6,244,202422,106,198,80,253,7094,138,1393,61,1440,195328
0.058,17,2,160,1,48,0,48,76,1,56,0,56,84
0.126,6,10,766,5,185,31,185,453,5,45,29,45,313
243.771,6,42,7294,26,483,9750,483,5707,16,83,16250,83,1587
0.022,17,2,166,1,39,0,39,67,1,71,0,71,99
1.406,6,50,19140,27,880,54,1360,13444,23,433,56,1360,5696
0.124,17,2,184,1,32,0,32,60,1,96,0,96,124
0.027,17,4,284,2,32,2,32,120,2,54,13,60,164
0.093,17,4,284,2,32,14,32,120,2,54,81,60,164
1791.713,1,58,4872,58,56,31433,56,4872,0,0,0,0,0
218.607,17,4,240,2,32,218606,32,120,2,32,218606,32,120
1772.931,6,180,15480,120,69,14898,69,8940,60,69,30048,69,6540
240.639,2,5,160,5,8,60159,8,160,0,0,0,0,0
1753.393,1,8,848,8,78,250484,78,848,0,0,0,0,0
152.448,1,6,336,6,28,30489,28,336,0,0,0,0,0
5.677,6,40,7309,21,218,283,314,3463,19,440,301,1152,3846
1740.445,1,56,4704,56,56,31644,56,4704,0,0,0,0,0
62.985,6,53,12961,19,140,3499,267,1891,34,373,1907,1460,11070
0.008,6,2,80,1,0,0,0,40,1,0,0,0,40
18.938,1,4,224,4,28,6312,28,224,0,0,0,0,0
0.306,6,13,1794,7,90,50,174,465,6,1085,61,1085,1329
2.707,6,2,88,2,0,0,0,88,0,0,0,0,0
1789.664,1,342,28728,342,56,5248,56,28728,0,0,0,0,0
560.603,1,8,448,8,28,80086,28,448,0,0,0,0,0
18.541,6,24,4097,13,234,1530,564,1656,11,463,1837,1343,2441
71.015,6,31,14206,16,514,332,1460,3761,15,983,5061,2368,10445
92.424,6,41,8319,18,132,5436,267,1920,23,364,4196,1460,6399
10.016,6,15,1295,6,222,2001,222,688,9,231,1250,231,607
0.0,17,1,1190,1,1162,0,1162,1190,0,0,0,0,0
1786.775,6,104,10969,51,186,35734,517,3629,53,507,34360,2411,7340
0.036,6,12,3704,6,171,6,171,491,6,964,4,1448,3213
374.652,6,18,1242,14,180,28819,180,916,4,110,20063,110,326
0.016,17,2,485,1,45,0,45,73,1,384,0,384,412
3.01,17,2,148,2,46,3010,46,148,0,0,0,0,0
1680.689,1,15,840,15,28,120049,28,840,0,0,0,0,0
1781.78,6,367,25650,212,99,8444,469,15034,155,69,11569,69,10616
281.387,6,27,7312,12,158,25580,267,1277,15,678,20079,2045,6035
1786.872,6,104,8444,68,66,26669,66,4964,36,60,51051,60,3480
0.115,6,5,248,3,0,57,0,144,2,0,5,0,104
114.429,6,30,7432,13,158,9535,267,1317,17,543,7150,1400,6115
0.67,6,13,1087,7,304,111,304,676,6,83,126,83,411
1772.578,6,180,15480,120,69,14895,69,8940,60,69,30038,69,6540
1740.324,1,56,4704,56,56,31642,56,4704,0,0,0,0,0
1771.951,6,102,9396,66,65,27260,65,5577,36,59,50624,59,3819
314.923,6,24,5555,9,133,39364,159,911,15,773,22494,1408,4644
8.658,6,79,24717,41,561,216,1152,19056,38,413,226,1152,5661
1789.839,6,363,24345,211,88,8523,469,13987,152,69,11853,69,10358
0.325,17,2,198,1,39,0,39,67,1,103,0,103,131
42.036,6,35,8439,17,410,553,882,1966,18,478,2462,2128,6473
269.139,1,6,336,6,28,53827,28,336,0,0,0,0,0
1787.317,6,102,8228,68,64,26676,64,4896,34,58,54157,58,3332
274.688,2,3,120,3,16,137344,16,120,0,0,0,0,0
3.921,17,5,295,5,31,980,31,295,0,0,0,0,0
0.0,17,1,80,1,52,0,52,80,0,0,0,0,0
399.074,1,6,772,6,100,79814,173,772,0,0,0,0,0
368.267,6,18,1242,14,180,28328,180,916,4,110,20066,110,326
34.425,6,32,5801,16,154,2295,722,1948,16,431,2282,2026,3853
61.31,6,36,16028,22,814,2919,1402,9301,14,748,4696,2804,6727
76.662,6,22,9261,11,514,85,1236,2014,11,970,7648,1360,7247
240.21,6,55,18315,29,803,8578,1402,15191,26,196,9608,580,3124
0.006,17,4,284,2,32,3,32,120,2,54,3,60,164
0.316,6,22,5040,11,137,31,267,1132,11,577,30,1400,3908
1.831,6,31,10445,18,367,107,833,1825,13,1012,145,1420,8620
0.059,6,10,1903,5,657,14,657,925,5,710,14,710,978
1.757,17,20,5180,20,231,92,388,5180,0,0,0,0,0
0.476,17,6,2056,6,314,95,354,2056,0,0,0,0,0
3.992,17,8,1900,4,64,1328,64,368,4,355,1328,372,1532
0.024,6,3,151,1,0,0,0,40,2,31,1,31,111
1791.745,17,179,13962,179,50,10065,50,13962,0,0,0,0,0
158.542,6,36,20274,18,702,48,1460,4979,18,1120,9317,1850,15295
280.404,6,28,7352,13,158,23367,267,1317,15,775,20025,3465,6035
368.529,6,20,1355,15,177,26323,177,977,5,110,15159,110,378
15.882,6,20,3326,14,222,1221,245,1675,6,703,3104,1152,1651
1799.85,6,111,10745,71,90,25712,205,7399,40,31,44657,33,3346
28.196,1,14,1456,0,0,0,0,0,14,76,2168,76,1456
30.545,17,11,1488,9,67,3818,288,856,2,288,20539,288,632
1799.951,17,450,39960,405,35,4455,288,25740,45,288,40016,288,14220
560.548,17,6,1647,3,30,280234,30,174,3,463,280268,463,1473
8.631,6,17,2425,9,211,1076,211,922,8,545,1231,904,1503
118.729,6,123,90924,76,1252,1583,1368,80351,47,812,2575,3887,10573
0.012,17,4,398,2,46,8,46,148,2,97,8,103,250
0.171,17,2,157,1,31,0,31,59,1,70,0,70,98
1681.646,17,14,1036,7,30,280272,30,406,7,62,280272,62,630
5.925,6,42,7389,21,201,296,314,3463,21,513,282,1179,3926
1.099,6,23,7952,12,164,84,267,1288,11,1216,93,3819,6664
1681.479,17,14,1036,7,30,280243,30,406,7,62,280243,62,630
28.422,6,45,13825,22,315,1353,721,3409,23,791,1260,2840,10416
128.371,17,4,352,2,60,128370,60,176,2,60,128370,60,176
1798.385,1,246,13776,246,28,7340,28,13776,0,0,0,0,0
0.091,17,2,672,2,308,91,308,672,0,0,0,0,0
2.508,6,10,1514,5,503,626,503,771,5,475,627,475,743
0.042,6,13,3980,7,88,6,88,388,6,1670,8,1880,3592
1790.375,6,374,23654,214,69,8405,69,13114,160,69,11258,69,10540
4.083,17,5,295,5,31,1020,31,295,0,0,0,0,0
2.505,17,3,451,2,39,984,39,134,1,289,0,289,317
8.307,6,21,4573,10,214,895,383,1692,11,487,806,1179,2881
0.171,17,2,158,1,34,0,34,62,1,68,0,68,96
1.423,6,34,11176,18,559,83,1360,4122,16,640,82,1360,7054
14.226,6,65,20166,33,565,444,1152,15459,32,489,450,1179,4707
1786.174,6,102,8364,68,66,26659,66,4964,34,60,54123,60,3400
7.957,6,18,6767,9,275,994,275,643,9,1150,703,1414,6124
0.017,17,2,570,1,30,0,30,58,1,484,0,484,512
10.742,6,1425,1351318,918,1396,11,1408,1320266,507,931,20,2816,31052
1775.482,17,138,11040,69,48,26109,48,5244,69,56,26109,56,5796
300.714,6,34,14030,18,583,17688,1408,5055,16,1016,20047,1578,8975
1700.658,17,13,534,11,14,170046,14,462,2,8,1700483,8,72
1617.791,1,8,448,8,28,231113,28,448,0,0,0,0,0
0.049,17,2,602,1,46,0,46,74,1,500,0,500,528
10.843,6,18,4266,10,275,1204,275,958,8,992,869,1440,3308
38.431,6,31,14394,18,679,2260,1408,4377,13,1037,3198,1400,10017
0.2,17,2,2382,2,1163,200,1163,2382,0,0,0,0,0
700.138,6,110,7920,46,61,15555,298,3839,64,47,11111,78,4081
1446.772,17,15,5121,15,313,103340,1445,5121,0,0,0,0,0
0.066,17,2,180,1,30,0,30,58,1,94,0,94,122
1797.482,6,399,27164,220,98,8207,469,15423,179,50,10098,69,11741
1586.437,6,32,4634,20,241,83490,241,3234,12,92,144197,92,1400
186.253,6,61,12229,29,302,5268,1189,4803,32,341,6007,1420,7426
360.94,2,4,128,4,8,120313,8,128,0,0,0,0,0
1783.003,6,110,8864,71,66,25471,66,5084,39,60,46918,60,3780
0.368,17,2,152,1,48,0,48,76,1,48,0,48,76
902.443,2,10,320,10,8,100271,8,320,0,0,0,0,0
4.035,17,6,5701,2,723,4035,1350,1503,4,1021,1016,1350,4198
0.024,17,2,912,1,308,0,308,336,1,548,0,548,576
1785.702,6,144,8902,76,26,23808,26,4632,68,26,26651,26,4270
233.445,17,4,240,2,32,233444,32,120,2,32,233444,32,120
1795.887,1,72,6048,72,56,25294,56,6048,0,0,0,0,0
31.438,6,2,96,1,0,0,0,48,1,0,0,0,48
3.497,6,10,923,6,304,699,304,624,4,83,1145,83,299
10.982,6,55,37175,34,1157,332,1368,30715,21,1072,538,2519,6460
83.505,6,19,3151,9,371,189,842,1519,10,305,9248,458,1632
1788.342,1,80,8480,80,78,22637,78,8480,0,0,0,0,0
9.842,6,1581,1341685,948,1362,10,1380,1312122,633,421,15,1924,29563
240.249,6,56,18316,30,799,8284,1418,15165,26,199,9609,580,3151
300.158,6,40,10384,21,658,14999,1440,4822,19,399,16665,1440,5562
1683.536,17,14,1036,7,30,280568,30,406,7,62,280577,62,630
297.419,1,4,224,4,28,99139,28,224,0,0,0,0,0
67.139,6,16,656,7,0,8081,0,284,9,0,8391,0,372
155.5,6,33,18709,18,702,47,1360,4967,15,1313,11098,2720,13742
19.235,6,2022,1752485,1225,1372,15,1380,1712779,797,421,24,1923,39706
1786.697,6,121,15177,78,81,23203,501,6070,43,189,42538,1420,9107
28.987,17,4,1344,4,308,9662,308,1344,0,0,0,0,0
1681.594,17,14,1036,7,30,280263,30,406,7,62,280263,62,630
76.25,17,4,304,4,48,25416,48,304,0,0,0,0,0
1797.969,6,417,25024,208,69,8685,69,12460,209,34,8644,64,12564
1740.622,17,30,7050,30,207,60021,207,7050,0,0,0,0,0
280.452,6,28,7352,12,158,25495,267,1277,16,678,18693,2085,6075
1.773,17,20,5190,20,231,93,389,5190,0,0,0,0,0
1770.366,6,99,9240,66,65,27236,65,5577,33,59,55321,59,3663
0.4,6,25,6098,12,181,36,537,1526,13,555,29,1440,4572
5.115,6,990,777045,472,195,10,517,29061,518,1402,9,2736,747984
23.434,6,13,1954,7,196,3905,196,508,6,398,4639,419,1446
1.344,6,39,8294,19,321,74,1164,2718,20,433,61,1460,5576
0.006,17,2,308,1,34,0,34,62,1,218,0,218,246
629.28,2,5,160,5,8,157320,8,160,0,0,0,0,0
1771.933,6,99,9240,66,65,27260,65,5577,33,59,55370,59,3663
181.267,6,22,9860,11,433,78,990,1771,11,1091,18113,1460,8089
1588.746,1,32,3392,32,78,51249,78,3392,0,0,0,0,0
18.996,17,35,21369,16,537,1264,1350,9045,19,620,1053,1350,12324
1734.629,17,130,23346,130,151,13446,372,23346,0,0,0,0,0
0.062,17,4,284,2,32,51,32,120,2,54,16,60,164
1785.981,17,310,64521,310,180,5779,422,64521,0,0,0,0,0
19.369,17,38,14345,19,535,1074,1350,10699,19,163,1074,1350,3646
1673.742,1,8,448,8,28,239106,28,448,0,0,0,0,0
312.735,6,63,11241,26,214,12508,1189,3408,37,288,8686,1420,7833
0.336,6,26,9034,13,262,28,690,1735,13,945,27,1408,7299
521.561,6,45,7927,22,127,18497,516,2155,23,255,23703,1452,5772
0.037,6,12,3462,6,75,7,75,395,6,1373,7,1448,3067
78.804,6,101,67641,58,1231,1382,1368,58457,43,841,1493,2519,9184
15.378,17,21,7995,10,389,1704,1350,4172,11,319,1534,1350,3823
1782.621,6,356,22520,208,69,8611,69,12460,148,69,12126,69,10060
361.013,2,4,128,4,8,120337,8,128,0,0,0,0,0
1.349,6,6,829,2,259,1349,259,339,4,110,304,110,490
0.012,6,10,1755,5,657,3,657,925,5,562,3,562,830
48.133,6,29,7257,13,155,4011,267,1306,16,530,3207,3417,5951
0.241,6,69,64449,43,183,5,230,2937,26,2506,8,8448,61512
10.986,6,18,5610,10,275,1220,275,958,8,1440,850,1440,4652
300.131,6,43,10399,22,619,14283,1440,4651,21,348,14998,1440,5748
1779.502,6,105,8475,68,65,26559,65,4930,37,59,49427,59,3545
1764.388,1,8,448,8,28,252055,28,448,0,0,0,0,0
1.253,6,41,9980,21,440,62,1360,4404,20,476,56,2715,5576
0.776,6,20,5948,11,281,77,544,1288,9,716,88,1420,4660
228.638,17,4,352,2,60,228637,60,176,2,60,228637,60,176
1795.1,17,80,3354,79,14,23014,14,3318,1,8,0,8,36
7.245,17,42,15042,15,631,516,1350,9899,27,162,277,1350,5143
14.474,6,6,264,1,0,0,0,44,5,0,3617,0,220
1701.621,1,8,448,8,28,243088,28,448,0,0,0,0,0
11.868,6,1740,1619042,1142,1366,10,1432,1590831,598,427,19,1432,28211
1772.181,6,182,15629,121,69,14768,69,8980,61,69,29530,69,6649
1777.486,1,73,6132,0,0,0,0,0,73,56,24687,56,6132
125.599,6,17,4096,9,296,15699,722,1353,8,580,17901,1448,2743
150.014,6,58,36069,36,1143,4286,1448,28172,22,749,2925,1448,7897
3.12,17,3,1236,3,384,1560,394,1236,0,0,0,0,0
1671.45,1,8,448,8,28,238778,28,448,0,0,0,0,0
26.795,6,7,380,4,0,8931,0,216,3,0,13392,0,164
1799.495,17,449,39928,404,35,4465,288,25708,45,288,40018,288,14220
2.043,17,2,677,1,300,0,300,328,1,321,0,321,349
13.565,1,4,224,4,28,4521,28,224,0,0,0,0,0
0.091,17,2,157,1,31,0,31,59,1,70,0,70,98
8.538,6,24,6896,6,154,1707,267,712,18,419,499,1420,6184
1.12,6,25,8068,12,164,86,267,1300,13,869,79,1408,6768
1019.036,17,12,768,12,36,92639,36,768,0,0,0,0,0
162.004,17,4,240,2,32,162003,32,120,2,32,162003,32,120
280.449,6,26,7272,12,158,25495,267,1277,14,775,21569,3465,5995
0.085,17,4,284,2,32,69,32,120,2,54,65,60,164
601.416,2,6,192,6,8,120283,8,192,0,0,0,0,0
86.26,6,46,10382,17,327,5391,1189,2655,29,327,3073,1420,7727
278.079,6,11,896,11,81,27807,162,896,0,0,0,0,0
1776.326,17,73,3060,72,14,25018,14,3024,1,8,0,8,36
1.249,6,31,8277,17,278,78,824,2114,14,698,81,2720,6163
2.693,6,29,12218,17,754,168,1360,6030,12,1139,233,2720,6188
1799.361,17,449,39928,404,35,4464,288,25708,45,288,40021,288,14220
3.397,17,5,295,5,31,849,31,295,0,0,0,0,0
1772.874,6,180,15480,120,69,14898,69,8940,60,69,30040,69,6540
1785.672,1,60,5040,60,56,30265,56,5040,0,0,0,0,0
1786.761,6,104,8308,68,64,26668,64,4896,36,58,51046,58,3412
1772.563,6,180,15480,120,69,14895,69,8940,60,69,30037,69,6540
5.018,17,4,558,2,36,5009,36,128,2,187,5008,187,430
300.575,6,44,8961,23,318,13662,928,2275,21,388,434,2128,6686
206.032,17,4,240,2,32,206031,32,120,2,32,206031,32,120
0.061,17,2,146,1,37,0,37,65,1,53,0,53,81
53.603,17,5,380,5,48,13400,48,380,0,0,0,0,0
86.925,17,6,454,3,33,43458,37,185,3,61,43458,77,269
1787.0,6,102,8228,68,64,26671,64,4896,34,58,54147,58,3332
365.327,6,24,2125,18,177,21489,177,1475,6,110,12160,110,650
701.264,1,4,224,4,28,233754,28,224,0,0,0,0,0
1771.177,6,101,9344,66,65,27248,65,5577,35,59,52090,59,3767
0.016,6,3,144,1,0,0,0,52,2,0,0,0,92
4.984,17,4,558,2,36,4971,36,128,2,187,4974,187,430
29.53,6,32,8621,19,133,1640,159,2074,13,651,2459,1402,6547
0.793,6,25,10698,14,741,61,1360,3558,11,955,62,2720,7140
0.008,17,2,378,1,30,0,30,58,1,292,0,292,320
1799.622,1,55,4620,55,56,33326,56,4620,0,0,0,0,0
139.447,17,4,240,2,32,139446,32,120,2,32,139446,32,120
1786.894,6,104,8376,68,65,26670,65,4930,36,59,51051,59,3446
8.922,6,19,2541,10,211,991,211,986,9,545,1115,904,1555
101.239,6,110,79551,66,1287,1557,1448,69102,44,679,2349,1448,10449
1.276,6,41,10615,21,517,63,1360,5039,20,433,58,1360,5576
0.683,17,2,122,2,33,683,33,122,0,0,0,0,0
1681.047,17,12,498,11,14,168104,14,462,1,8,0,8,36
299.754,17,8,2688,8,308,42822,308,2688,0,0,0,0,0
2.218,6,10,1514,5,503,554,503,771,5,475,554,475,743
1.007,17,8,672,4,34,334,34,248,4,78,334,84,424
300.653,6,41,8621,22,266,14316,720,2014,19,416,857,2720,6607
12.123,17,9,1693,5,37,3029,37,325,4,314,4039,325,1368
187.231,6,211,168854,136,1311,1386,1408,152621,75,586,2299,1408,16233
4.906,17,2,204,1,34,0,34,62,1,114,0,114,142
8.495,6,76,24245,39,550,223,1152,18624,37,459,228,1179,5621
93.603,6,38,27070,25,667,41,1360,4370,13,2771,7786,10880,22700
26.524,6,45,13733,21,299,1326,721,3240,24,680,1136,1414,10493
1.374,6,48,19862,27,938,52,1460,14246,21,433,59,1460,5616
66.564,17,4,240,2,32,66563,32,120,2,32,66563,32,120
987.902,1,112,6272,112,28,8900,28,6272,0,0,0,0,0
0.073,17,2,2380,2,1162,73,1162,2380,0,0,0,0,0
1681.443,17,14,3843,7,30,280238,30,406,7,463,280238,463,3437
1798.205,17,142,11360,71,48,25688,48,5396,71,56,25688,56,5964
153.73,6,46,8916,13,141,2617,267,1375,33,221,4803,1460,7541
0.494,17,3,451,2,39,219,39,134,1,289,0,289,317
1747.653,6,97,7307,63,38,28187,205,4476,34,33,52952,98,2831
11.51,6,32,7626,12,152,1046,267,1404,20,416,590,1420,6222
247.824,6,42,6424,24,141,10774,722,2810,18,297,13606,2330,3614
1776.235,17,73,3060,72,14,25017,14,3024,1,8,0,8,36
0.947,6,11,1727,7,100,157,100,384,4,589,228,1152,1343
28.493,6,9,527,5,43,7123,43,311,4,0,9496,0,216
0.071,17,2,362,1,46,0,46,74,1,260,0,260,288
280.279,6,28,7352,13,158,23356,267,1317,15,678,20015,2045,6035
1682.807,17,14,1036,7,30,280458,30,406,7,62,280458,62,630
1770.86,1,58,4872,58,56,31067,56,4872,0,0,0,0,0
0.154,6,7,423,4,43,39,43,259,3,0,22,0,164
0.541,6,94,84788,63,183,8,230,4001,31,2729,13,14080,80787
178.089,17,4,352,2,60,178088,60,176,2,60,178088,60,176
1773.79,6,180,15480,120,69,14905,69,8940,60,69,30063,69,6540
842.274,2,10,320,10,8,93586,8,320,0,0,0,0,0
0.087,6,10,1514,5,503,21,503,771,5,475,21,475,743
1786.01,6,111,8970,72,66,25155,66,5190,39,60,46997,60,3780
3.201,17,2,214,1,39,0,39,67,1,119,0,119,147
369.858,6,31,8805,11,181,36985,267,1168,20,455,19346,1400,7637
1751.137,1,56,4704,56,56,31838,56,4704,0,0,0,0,0
279.025,17,3,1008,3,308,139512,308,1008,0,0,0,0,0
1681.554,1,15,840,15,28,120111,28,840,0,0,0,0,0
0.186,17,2,144,1,36,0,36,64,1,52,0,52,80
0.5,17,3,451,2,39,419,39,134,1,289,0,289,317
25.473,6,45,12894,22,199,1213,721,2478,23,730,1147,2840,10416
0.984,6,27,8273,15,266,58,608,2232,12,1109,73,2720,6041
1799.332,17,448,39896,403,35,4475,288,25676,45,288,40021,288,14220
61.359,6,37,15856,22,792,2921,1448,9078,15,665,4363,1448,6778
4.971,17,4,824,2,48,4774,48,152,2,308,4818,308,672
1770.109,6,101,9344,66,65,27232,65,5577,35,59,52059,59,3767
1773.605,6,181,15589,121,69,14780,69,9049,60,69,30054,69,6540
1772.382,6,180,15480,120,69,14893,69,8940,60,69,30038,69,6540
1744.689,2,16,512,16,8,116312,8,512,0,0,0,0,0
240.191,6,54,18313,29,807,8577,1418,15235,25,221,10007,580,3078
280.164,6,26,7272,13,158,23347,267,1317,13,775,23346,3445,5955
1.35,6,37,8224,19,320,75,1162,2728,18,476,69,2720,5496
1786.661,6,271,33867,110,144,16390,1360,16720,161,135,11165,3302,17147
11.578,6,25,8453,13,275,964,275,1078,12,983,754,1420,7375
3.652,17,5,290,5,30,913,30,290,0,0,0,0,0
0.054,17,2,363,1,32,0,32,60,1,275,0,275,303
1799.935,17,449,39928,404,35,4466,288,25708,45,288,40020,288,14220
44.897,6,27,7177,13,155,3741,267,1306,14,530,3453,3417,5871
1324.485,6,186,19954,105,78,12194,267,7953,81,143,16555,1460,12001
0.338,17,2,178,1,29,0,29,57,1,93,0,93,121
1.035,6,26,9039,13,266,86,705,1750,13,943,84,1438,7289
1786.621,6,120,12623,77,81,23508,501,6095,43,126,42536,1420,6528
0.628,17,2,170,1,37,0,37,65,1,77,0,77,105
194.149,17,6,360,3,32,97074,32,180,3,32,97074,32,180
1.194,17,4,314,2,31,1161,31,118,2,70,646,70,196
1785.74,17,142,11360,71,48,25509,48,5396,71,56,25509,56,5964
0.012,17,2,166,1,47,0,47,75,1,63,0,63,91
904.099,6,47,3647,26,65,25959,65,1885,21,51,45201,59,1762
1773.546,6,182,15629,121,69,14779,69,8980,61,69,29550,69,6649
129.357,6,24,11058,13,745,55,1360,3534,11,1178,12922,2580,7524
19.893,6,19,7396,11,290,1989,517,1161,8,1162,2839,1418,6235
280.359,6,28,7352,12,158,25487,267,1277,16,603,18686,1400,6075
0.635,6,22,7345,13,334,52,663,2021,9,1209,73,2736,5324
62.715,6,61,38174,38,1129,1695,1448,30225,23,749,2832,1448,7949
0.552,17,2,384,1,39,0,39,67,1,289,0,289,317
1750.409,6,97,7338,64,38,27784,205,4559,33,33,54689,98,2779
1.116,6,10,1687,7,100,186,100,384,3,1179,425,1179,1303
2.359,6,20,3833,11,234,235,564,1504,9,463,270,1343,2329
1.665,6,49,18605,27,842,64,1360,12949,22,476,68,2715,5656
0.006,17,2,136,1,40,0,40,68,1,40,0,40,68
0.203,17,2,362,1,41,0,41,69,1,265,0,265,293
1740.396,17,30,7050,30,207,60013,207,7050,0,0,0,0,0
1780.703,17,142,11360,71,48,25438,48,5396,71,56,25437,56,5964
1799.005,17,102,8160,51,48,35979,48,3876,51,56,35979,56,4284
192.618,17,4,240,2,32,192617,32,120,2,32,192612,32,120
1.663,6,4,208,2,0,990,0,104,2,0,1663,0,104
0.617,6,14,1745,7,288,72,288,600,7,426,74,434,1145
225.607,6,28,8792,14,158,17354,267,1357,14,981,17353,4836,7435
9.446,6,1597,1459458,982,1406,9,1448,1422814,615,776,15,1448,36644
11.897,6,1755,1627243,1148,1365,10,1432,1598516,607,427,19,1432,28727
3.773,17,5,290,5,30,943,30,290,0,0,0,0,0
962.585,2,10,320,10,8,106953,8,320,0,0,0,0,0
0.055,6,29,17637,13,133,4,197,1108,16,1206,2,1408,16529
100.916,6,141,22211,78,304,1310,304,15724,63,83,1621,83,6487
1775.829,17,138,11040,69,48,26114,48,5244,69,56,26114,56,5796
1786.957,6,112,8885,71,65,25527,65,5180,41,59,44670,59,3705
1775.414,17,140,11200,70,48,25730,48,5320,70,56,25730,56,5880
0.054,6,3,136,2,0,54,0,88,1,0,0,0,48
1786.775,6,220,54426,126,546,14294,1302,38409,94,194,19211,1452,16017
1747.119,6,95,7203,63,38,28179,205,4476,32,33,56344,98,2727
0.01,17,2,602,1,46,0,46,74,1,500,0,500,528
173.159,17,4,240,2,32,173158,32,120,2,32,173158,32,120
1793.857,6,244,35804,152,302,11879,302,26032,92,83,19712,83,9772
2.057,17,2,120,2,32,2057,32,120,0,0,0,0,0
0.313,17,8,2774,8,318,44,357,2774,0,0,0,0,0
77.101,6,28,12955,15,837,56,1360,5655,13,846,6411,1725,7300
42.486,17,3,228,3,48,21243,48,228,0,0,0,0,0
1765.607,1,110,6160,110,28,16198,28,6160,0,0,0,0,0
0.653,6,3,127,1,0,0,0,40,2,7,0,7,87
1439.51,6,104,10501,61,63,23988,721,5081,43,110,34268,1448,5420
169.884,6,59,10826,27,224,4724,1189,3331,32,326,5479,1917,7495
241.183,6,59,7729,27,215,9274,585,4033,32,142,7778,580,3696
280.293,6,30,7432,13,158,23357,267,1317,17,543,17515,1300,6115
23.872,6,21,9422,9,150,2984,174,664,12,1033,2145,1452,8758
0.006,6,2,480,1,388,0,388,440,1,0,0,0,40
1.01,17,7,2438,7,320,168,354,2438,0,0,0,0,0
0.091,17,4,284,2,32,45,32,120,2,54,47,60,164
1683.507,17,16,1184,8,30,240496,30,464,8,62,240496,62,720
246.438,6,58,21425,32,431,2912,1360,7358,26,1001,9851,3072,14067
1463.038,6,173,19710,106,77,13933,267,8200,67,142,22165,1917,11510
1799.4,6,356,22520,208,69,8692,69,12460,148,69,12240,69,10060
1734.52,17,434,69001,434,130,4005,357,69001,0,0,0,0,0
0.002,6,2,111,1,0,0,0,40,1,31,0,31,71
814.094,1,72,4032,72,28,11466,28,4032,0,0,0,0,0
1786.681,6,102,8228,68,64,26666,64,4896,34,58,54139,58,3332
4.623,6,38,7229,19,218,256,314,3383,19,513,242,1179,3846
301.252,6,51,26111,30,793,10388,1408,8757,21,1250,1355,5632,17354
299.765,1,4,224,4,28,99921,28,224,0,0,0,0,0
8.641,6,782,699056,489,1356,17,1368,677672,293,776,28,1473,21384
112.689,17,4,1344,4,308,37563,308,1344,0,0,0,0,0
1014.469,6,66,3926,38,26,27415,26,2222,28,26,37570,26,1704
1740.515,17,29,30624,29,1028,62161,1028,30624,0,0,0,0,0
6.465,6,66,20142,34,541,195,1152,15435,32,489,200,1179,4707
1776.355,17,140,11200,70,48,25744,48,5320,70,56,25744,56,5880
32.255,6,13,2133,8,324,4607,585,1073,5,396,8020,580,1060
1681.016,1,15,840,15,28,120072,28,840,0,0,0,0,0
13.859,17,4,824,2,48,13850,48,152,2,308,13848,308,672
0.842,6,2,1235,1,0,0,0,40,1,1155,0,1155,1195
4.504,6,39,7269,19,218,250,314,3383,20,440,223,1152,3886
1775.256,17,140,11200,70,48,25728,48,5320,70,56,25728,56,5880
899.728,6,12,728,8,31,128532,31,444,4,31,299806,31,284
48.536,6,49,16342,26,1055,655,1360,10620,23,435,2198,2667,5722
4.198,17,10,1450,5,40,1047,40,340,5,194,1047,194,1110
722.979,6,102,19716,55,123,13385,721,6278,47,550,15713,2840,13438
284.056,1,4,326,4,53,94685,78,326,0,0,0,0,0
1771.299,17,170,14432,157,30,11354,37,9155,13,377,142470,463,5277
3.318,6,10,1102,6,483,663,483,803,4,83,1104,83,299
1796.708,17,449,39928,404,35,4458,288,25708,45,288,40023,288,14220
1753.203,1,78,8268,78,78,22768,78,8268,0,0,0,0,0
6.301,6,36,11722,17,225,383,561,2121,19,881,340,1440,9601
1772.522,6,180,15480,120,69,14895,69,8940,60,69,30041,69,6540
1796.768,6,175,18469,94,84,19318,721,8742,81,175,22457,1414,9727
0.179,17,4,352,2,37,172,37,130,2,83,171,89,222
8.768,6,48,14063,25,432,343,1360,6684,23,644,388,2134,7379
1786.459,6,102,8364,68,66,26663,66,4964,34,60,54131,60,3400
1.331,6,47,19298,27,900,51,1360,13722,20,476,61,2715,5576
1782.458,17,83,3480,82,14,22005,14,3444,1,8,0,8,36
1709.996,17,14,3815,7,30,284997,30,406,7,459,284985,463,3409
81.705,6,69,22685,35,680,2403,1460,9712,34,609,2446,1460,12973
5.01,17,4,558,2,36,5003,36,128,2,187,5005,187,430
0.113,17,4,588,2,48,104,48,152,2,190,104,308,436
12.515,6,1859,1671339,1182,1363,10,1380,1638094,677,511,18,1923,33245
48.353,6,40,8839,16,410,1985,917,1940,24,329,2096,2720,6899
3.98,17,4,244,4,33,1326,33,244,0,0,0,0,0
0.303,17,8,2750,8,315,43,354,2750,0,0,0,0,0
1.309,6,42,11418,22,547,62,1360,5842,20,476,59,2715,5576
1.878,6,5,260,3,0,455,0,156,2,0,512,0,104
280.258,6,27,7312,12,158,25478,267,1277,15,678,20015,2045,6035
56.49,6,43,8801,21,360,746,766,2013,22,368,2683,2720,6788
2.841,17,17,5558,8,353,400,1350,3052,9,250,350,1350,2506
5.082,6,38,7229,19,218,282,314,3383,19,513,267,1179,3846
44.008,6,40,8670,19,410,561,882,2046,21,444,2193,2128,6624
15.588,17,10,880,5,48,3894,48,380,5,72,3894,72,500
2.932,17,4,624,4,128,977,128,624,0,0,0,0,0
1771.297,6,102,9711,68,69,26437,233,5914,34,59,53673,82,3797
11.754,17,8,704,4,48,3913,48,304,4,72,3913,72,400
1.248,6,2,331,1,0,0,0,40,1,239,0,239,291
1741.352,6,89,6426,58,31,30550,31,3915,31,31,58044,31,2511
1.352,6,24,8004,12,164,105,267,1288,12,1014,103,2491,6716
2.981,1,3,318,3,78,1490,78,318,0,0,0,0,0
1786.629,6,104,8308,68,64,26666,64,4896,36,58,51043,58,3412
1797.348,6,377,26726,218,103,8282,469,15881,159,69,11374,69,10845
174.658,17,4,352,2,60,174656,60,176,2,60,174657,60,176
9.447,6,90,29223,45,587,214,1152,22941,45,447,208,1179,6282
174.064,17,4,352,2,60,174063,60,176,2,60,174062,60,176
1.237,6,47,18809,27,865,47,1360,13233,20,476,56,2715,5576
80.443,2,6,192,6,8,16088,8,192,0,0,0,0,0
300.583,6,45,8799,23,291,13662,786,2165,22,478,552,2128,6634
1.594,6,51,21265,29,901,56,1360,15609,22,433,65,1360,5656
1.657,17,2,782,2,363,1657,363,782,0,0,0,0,0
1.249,6,20,4549,12,287,113,562,1346,8,575,162,1452,3203
8.792,6,77,22926,39,554,231,1152,17638,38,418,230,1152,5288
1.793,17,15,5390,7,356,298,1350,2689,8,309,241,1350,2701
30.786,17,3,181,3,32,15393,33,181,0,0,0,0,0
0.734,6,22,7342,13,335,61,668,2026,9,1210,87,1946,5316
421.108,2,6,192,6,8,84221,8,192,0,0,0,0,0
1763.417,2,15,480,15,8,125958,8,480,0,0,0,0,0
0.481,6,216,225258,147,194,3,230,8443,69,3182,4,15005,216815
207.631,17,7,2380,7,312,34605,318,2380,0,0,0,0,0
8.282,6,42,7794,23,218,376,314,3543,19,498,445,1179,4251
1745.008,6,104,8477,68,52,26044,205,5276,36,36,49849,98,3201
1.608,6,38,8252,19,320,89,1162,2716,19,433,76,1360,5536
182.904,6,30,7432,13,158,15242,267,1317,17,543,11423,1400,6115
173.393,17,4,240,2,32,173392,32,120,2,32,173391,32,120
0.2,6,29,7376,14,155,15,267,1341,15,543,13,1400,6035
0.836,6,20,5984,11,282,83,548,1292,9,721,92,1452,4692
3.993,6,5,200,5,0,0,0,200,0,0,0,0,0
1570.038,6,90,7320,60,65,26610,65,4350,30,59,54135,59,2970
0.114,17,2,193,1,46,0,46,74,1,91,0,91,119
1.258,6,49,19408,27,902,48,1360,13752,22,433,51,1360,5656
6.075,17,12,2340,6,32,1212,32,360,6,302,1212,308,1980
53.189,6,27,7177,13,155,4432,267,1306,14,530,4090,2840,5871
15.928,6,18,5946,9,290,1991,517,1057,9,1101,1958,1418,4889
2.593,6,3,720,2,564,2223,564,680,1,0,0,0,40
0.991,6,31,12124,17,525,61,1360,3350,14,820,63,1380,8774
0.886,6,14,3592,7,150,147,174,584,7,681,131,1420,3008
117.378,6,173,131952,107,1288,1107,1368,119002,66,679,1549,2736,12950
1796.757,6,244,35804,152,302,11899,302,26032,92,83,19744,83,9772
1.785,6,37,8212,18,320,105,1162,2676,19,433,85,1460,5536
0.461,6,53,22826,29,1032,16,1380,15701,24,558,18,1923,7125
1799.057,17,449,39928,404,35,4464,288,25708,45,288,40021,288,14220
247.652,6,32,7853,18,168,14567,517,2137,14,622,18483,1461,5716
0.556,17,4,1038,2,40,541,40,136,2,423,543,423,902
0.041,17,4,368,2,35,0,35,126,2,93,0,99,242
4.595,6,10,3600,4,171,1531,171,387,6,964,918,1448,3213
137.008,17,8,2688,8,308,19572,308,2688,0,0,0,0,0
10.763,6,1740,1489665,1034,1386,10,1420,1457168,706,420,15,1420,32497
1783.659,17,219,52049,219,209,8181,422,52049,0,0,0,0,0
0.934,6,10,1687,7,100,155,100,384,3,1179,334,1179,1303
11.755,6,1898,1616755,1140,1363,10,1380,1582193,758,421,15,1923,34562
3.81,17,3,1173,3,363,1905,363,1173,0,0,0,0,0
10.773,6,18,5610,10,275,1197,275,958,8,1440,837,1440,4652
5.974,6,5,220,5,0,0,0,220,0,0,0,0,0
1792.224,6,176,15503,93,118,19478,208,11160,83,31,21855,31,4343
65.468,6,44,9002,21,438,472,999,2235,23,364,2969,1360,6767
390.261,6,25,1654,17,180,24391,180,1120,8,110,9512,110,534
1745.966,6,95,7203,63,38,28160,205,4476,32,33,56313,98,2727
264.126,17,4,288,2,36,264125,36,128,2,52,264125,52,160
1794.043,17,66,2766,65,14,28031,14,2730,1,8,0,8,36
20.622,17,27,5562,13,201,1715,1350,2986,14,156,1583,1350,2576
10.426,17,4,352,2,48,10418,48,152,2,72,10415,72,200
10.197,6,94,28610,47,565,221,1152,22232,47,408,216,1152,6378
1.373,6,45,17499,26,837,54,1360,11963,19,476,66,2720,5536
1740.964,6,136,18133,82,72,21493,722,7171,54,181,32841,1448,10962
4.893,17,10,720,5,36,1223,36,320,5,52,1223,52,400
1797.559,17,96,47616,32,308,57985,308,10752,64,548,26670,548,36864
1750.616,6,142,8806,78,45,22735,208,5347,64,31,27783,31,3459
134.435,6,164,126600,104,1277,1305,1408,113969,60,731,2254,3847,12631
291.046,6,35,7632,15,158,20789,267,1397,20,603,15314,1400,6235
721.881,2,8,256,8,8,103125,8,256,0,0,0,0,0
3.202,6,96,78726,38,749,86,1460,6795,58,1391,52,1460,71931
18.912,1,4,224,4,28,6304,28,224,0,0,0,0,0
60.405,6,13,3819,7,407,10067,722,1174,6,1164,12039,1408,2645
1799.982,17,142,11360,71,48,25713,48,5396,71,56,25713,56,5964
16.631,17,35,16584,18,528,976,1350,10020,17,358,1037,1350,6564
70.617,6,38,12765,19,304,3923,597,1781,19,783,3872,1360,10984
29.631,6,10,943,3,304,14815,304,456,7,83,4936,83,487
16.077,6,2483,2326553,1609,1368,9,1408,2276441,874,931,18,2816,50112
1657.92,1,8,448,8,28,236845,28,448,0,0,0,0,0
1795.219,17,80,3354,79,14,23015,14,3318,1,8,0,8,36
0.256,6,23,6012,12,181,23,537,1526,11,781,24,2224,4486
0.001,17,3,3111,3,1009,0,1445,3111,0,0,0,0,0
5.882,6,599,533416,380,1341,14,1368,517364,219,776,26,2736,16052
294.763,6,31,7886,12,158,26796,267,1277,19,487,16352,4845,6609
2.67,6,2,88,2,0,0,0,88,0,0,0,0,0
0.072,17,2,152,1,48,0,48,76,1,48,0,48,76
1.648,6,25,8791,15,289,117,601,1473,10,987,164,1420,7318
1799.56,6,374,26137,216,98,8370,469,15263,158,69,11459,69,10874
877.208,6,74,10361,40,95,21540,501,3510,34,195,26579,1420,6851
1.001,17,2,122,2,33,1001,33,122,0,0,0,0,0
0.124,17,2,152,1,48,0,48,76,1,48,0,48,76
300.933,6,40,10056,21,593,15046,1460,4445,19,372,481,1460,5611
1739.009,6,87,6322,58,31,30508,31,3915,29,31,62106,31,2407
0.501,17,3,451,2,39,346,39,134,1,289,0,289,317
1.59,6,50,22024,29,940,56,1360,16312,21,441,71,2715,5712
1794.48,1,242,13552,242,28,7445,28,13552,0,0,0,0,0
43.654,17,5,1680,5,308,10913,308,1680,0,0,0,0,0
0.022,17,2,146,1,37,0,37,65,1,53,0,53,81
1799.526,6,367,23236,212,69,8528,69,12896,155,69,11684,69,10340
1787.329,6,102,8296,68,65,26676,65,4930,34,59,54157,59,3366
9.025,6,6,324,4,0,3008,0,216,2,0,8816,0,108
0.904,17,2,122,2,33,904,33,122,0,0,0,0,0
881.833,2,6,192,6,8,176366,8,192,0,0,0,0,0
0.486,6,54,23233,29,1049,17,1380,17991,25,421,18,1923,5242
1780.721,17,138,11040,69,48,26186,48,5244,69,56,26186,56,5796
1772.053,6,180,15480,120,69,14891,69,8940,60,69,30031,69,6540
1184.352,6,99,12433,57,180,21149,1249,7320,42,107,27711,248,5113
119.312,6,45,10783,18,263,3875,1189,2833,27,311,4588,1420,7950
0.133,6,9,1339,5,145,33,145,349,4,826,20,826,990
46.818,17,2,680,2,312,46818,312,680,0,0,0,0,0
169.607,6,31,13548,17,489,307,1360,3204,14,1085,13036,2505,10344
1794.09,17,144,11520,72,48,25268,48,5472,72,56,25268,56,6048
1681.942,17,14,1036,7,30,280318,30,406,7,62,280315,62,630
240.154,6,53,17793,28,783,8894,1408,14789,25,212,10006,580,3004
1734.303,17,144,23562,144,135,12127,391,23562,0,0,0,0,0
1797.405,6,360,22818,209,69,8641,69,12569,151,69,11982,69,10249
11.948,6,83,24541,42,550,291,1152,18760,41,459,291,1179,5781
0.011,17,2,372,1,39,0,39,67,1,277,0,277,305
1.326,17,4,947,2,33,1315,37,123,2,384,1313,463,824
0.854,6,11,1727,7,100,142,100,384,4,589,203,1152,1343
6.683,6,38,7245,20,218,351,314,3423,18,516,377,1179,3822
0.12,17,2,237,1,72,0,72,100,1,109,0,109,137
0.202,6,43,17515,24,962,8,1420,12534,19,467,10,1883,4981
60.066,17,13,13936,13,1044,5005,1044,13936,0,0,0,0,0
300.232,6,38,22389,25,1045,12509,1408,16993,13,785,2272,1491,5396
5.985,6,45,8409,23,227,272,314,4102,22,489,272,1179,4307
1786.984,6,102,8296,68,65,26671,65,4930,34,59,54147,59,3366
16.829,6,1512,1378610,905,1438,18,1448,1338850,607,776,27,1448,39760
352.502,6,20,7437,3,106,510,106,234,17,434,22030,1452,7203
0.047,17,4,588,2,48,37,48,152,2,190,36,308,436
11.787,6,1667,1521055,1078,1363,10,1380,1492716,589,387,19,1923,28339
0.008,17,2,548,2,246,8,246,548,0,0,0,0,0
280.233,6,29,7392,13,158,23352,267,1317,16,603,18681,1400,6075
2.654,6,2,88,2,0,0,0,88,0,0,0,0,0
72.713,17,20,1760,10,48,8078,48,760,10,72,8078,72,1000
180.012,6,20,10080,11,433,66,990,1771,9,1587,22486,3928,8309
316.951,6,87,33773,45,686,7203,1360,23110,42,358,7727,4649,10663
1799.155,1,58,4872,58,56,31564,56,4872,0,0,0,0,0
227.841,17,4,352,2,60,227840,60,176,2,60,227840,60,176
89.472,6,21,4608,6,256,648,256,1268,15,304,6390,304,3340
4.028,17,4,352,2,48,4015,48,152,2,72,4015,72,200
1794.909,6,358,22738,209,69,8629,69,12569,149,69,12127,69,10169
2.097,17,4,706,3,39,1000,39,201,1,477,0,477,505
97.97,6,14,3743,5,275,24492,275,479,9,1440,12010,1440,3264
1.212,6,51,19983,28,875,44,1360,14287,23,476,47,2715,5696
4.99,17,2,152,2,48,4990,48,152,0,0,0,0,0
0.014,17,2,152,2,48,14,48,152,0,0,0,0,0
240.216,6,53,17870,28,794,8896,1418,14978,25,198,10008,580,2892
8.016,6,39,10142,20,357,421,757,1928,19,496,394,1360,8214
3.128,6,65,16699,33,563,97,1429,5929,32,430,90,1986,10770
1.511,6,49,19284,27,894,58,1360,13628,22,433,62,1360,5656
289.013,17,4,352,2,60,289012,60,176,2,60,289012,60,176
1785.212,17,87,3648,86,14,21002,14,3612,1,8,0,8,36
3.013,6,24,5758,13,158,249,370,1315,11,998,268,1691,4443
1764.328,2,14,448,14,8,135717,8,448,0,0,0,0,0
1.313,6,50,19342,27,895,50,1360,13646,23,433,51,1360,5696
124.751,17,14,19244,14,1346,9596,1348,19244,0,0,0,0,0
7.763,6,15,1362,8,275,1109,275,878,7,96,991,96,484
1787.545,6,102,8296,68,65,26679,65,4930,34,59,54164,59,3366
1796.815,6,451,26512,240,69,7518,69,13740,211,35,8556,64,12772
1778.688,6,281,33835,114,137,15739,1460,16667,167,126,10714,1460,17168
1.562,6,289,231774,170,1352,9,1420,223169,119,477,13,1420,8605
421.116,2,4,128,4,8,140372,8,128,0,0,0,0,0
1237.201,6,281,18928,128,46,9731,46,7978,153,46,8139,46,10950
1644.389,1,7,392,7,28,274064,28,392,0,0,0,0,0
0.316,6,86,75102,55,265,5,517,4305,31,2562,9,8448,70797
0.914,17,14,7360,7,666,152,1350,4860,7,329,143,1350,2500
37.078,17,2,152,2,48,37078,48,152,0,0,0,0,0
93.12,6,13,1140,13,47,7760,62,1140,0,0,0,0,0
24.196,17,6,456,6,48,4839,48,456,0,0,0,0,0
1.506,6,12,971,6,248,299,248,492,6,231,299,231,479
230.946,2,3,96,3,8,115473,8,96,0,0,0,0,0
0.27,17,3,451,2,39,1,39,134,1,289,0,289,317
31.621,6,7,308,1,0,0,0,44,6,0,6303,0,264
2.558,17,26,16583,15,903,180,1350,13979,11,208,252,1350,2604
2.92,17,4,624,4,128,973,128,624,0,0,0,0,0
1.466,6,54,20907,31,918,48,1360,15070,23,408,58,2720,5837
12.159,17,10,965,5,46,3029,46,370,5,91,3038,91,595
540.042,2,5,160,5,8,135010,8,160,0,0,0,0,0
1555.122,17,367,42266,177,148,8835,1350,31267,190,29,8224,60,10999
9.299,6,1483,1287590,894,1389,10,1420,1259809,589,420,15,1420,27781
91.941,6,22,8484,11,325,61,634,1447,11,940,9180,1460,7037
1790.115,6,422,25352,211,69,8524,69,12580,211,35,8524,64,12772
0.952,6,17,5132,9,150,119,174,664,8,828,122,1420,4468
243.721,6,51,9257,23,279,11078,745,3218,28,326,9026,1408,6039
599.777,6,9,546,6,31,119955,31,333,3,31,299827,31,213
1792.815,1,250,26500,250,78,7200,78,26500,0,0,0,0,0
21.313,17,33,22856,17,767,1330,1350,13518,16,555,1418,1350,9338
1789.878,6,358,22669,209,69,8605,69,12500,149,69,12093,69,10169
1798.626,6,368,25690,214,100,8444,469,14976,154,69,11755,69,10714
1787.326,6,359,22709,209,69,8592,69,12569,150,69,11994,69,10140
0.72,6,20,2870,11,324,72,997,1769,9,182,71,374,1101
0.145,17,2,152,1,48,0,48,76,1,48,0,48,76
1.284,6,46,19302,27,903,49,1360,13766,19,476,61,2715,5536
20.471,6,25,6569,15,117,1462,159,1401,10,773,2273,1675,5168
16.519,17,4,352,2,48,16511,48,152,2,72,16509,72,200
33.206,6,29,7392,13,158,2767,267,1317,16,603,2210,2036,6075
0.33,17,2,2384,2,1164,330,1164,2384,0,0,0,0,0
1772.162,6,180,15480,120,69,14892,69,8940,60,69,30032,69,6540
0.059,17,2,1152,1,548,0,548,576,1,548,0,548,576
1.442,6,47,19593,27,921,55,1360,14017,20,476,65,2715,5576
1773.298,6,180,15480,120,69,14901,69,8940,60,69,30047,69,6540
1.145,17,3,1152,3,356,572,356,1152,0,0,0,0,0
0.094,6,10,1669,6,551,18,947,1346,4,159,31,159,323
1798.973,17,450,39960,405,35,4452,288,25740,45,288,40021,288,14220
1792.436,6,367,25581,213,99,8454,469,15005,154,69,11713,69,10576
0.139,6,9,1343,5,145,34,145,349,4,830,42,830,994
1.327,6,50,19690,27,920,51,1460,13994,23,433,51,1460,5696
304.292,6,186,116258,95,1164,3237,1448,51569,91,1110,473,1448,64689
1740.033,17,28,1596,28,29,64445,29,1596,0,0,0,0,0
0.081,17,2,136,1,32,0,32,60,1,48,0,48,76
1680.221,17,12,498,11,14,168022,14,462,1,8,0,8,36
699.011,1,5,280,5,28,174752,28,280,0,0,0,0,0
1755.422,1,8,448,8,28,250774,28,448,0,0,0,0,0
23.775,6,32,8987,14,327,195,1189,2535,18,477,1397,1420,6452
1.224,6,4,220,1,0,0,0,52,3,0,287,0,168
11.217,17,4,386,2,34,11210,34,124,2,103,11209,103,262
39.012,6,36,8108,13,152,3251,267,1444,23,337,1772,1420,6664
1795.679,17,271,56787,271,181,6650,422,56787,0,0,0,0,0
83.922,6,22,2564,8,189,11988,517,1194,14,323,6455,499,1370
26.771,6,37,9320,17,291,1673,721,3016,20,550,1355,1414,6304
1797.915,17,447,39580,403,35,4472,288,25676,44,288,40950,288,13904
1770.967,6,101,9344,66,65,27245,65,5577,35,59,52084,59,3767
1789.974,6,356,22520,208,69,8647,69,12460,148,69,12176,69,10060
5.938,17,12,2595,6,47,1184,47,450,6,329,1174,341,2145
151.602,6,46,10135,29,266,5414,1360,4653,17,435,536,2667,5482
266.507,17,4,352,2,60,266506,60,176,2,60,266506,60,176
0.358,6,24,5987,12,164,32,453,1442,12,652,28,1448,4545
0.288,17,2,384,1,39,0,39,67,1,289,0,289,317
1794.674,17,373,122539,373,300,4824,422,122539,0,0,0,0,0
0.226,17,2,144,1,36,0,36,64,1,52,0,52,80
1796.354,17,448,39896,403,35,4468,288,25676,45,288,40017,288,14220
15.66,17,13,7179,7,703,2597,1350,5120,6,315,3118,1350,2059
149.816,17,4,240,2,32,149815,32,120,2,32,149815,32,120
0.015,17,4,396,2,39,0,39,134,2,103,1,103,262
18.83,6,27,7177,13,155,1569,267,1306,14,530,1447,3417,5871
0.024,6,12,624,0,0,0,0,0,12,0,0,0,624
291.665,6,39,8808,18,326,17154,517,2261,21,778,14580,1418,6547
352.429,6,19,6435,2,106,420,106,194,17,370,22026,1420,6241
1787.247,6,104,8308,68,64,26675,64,4896,36,58,51061,58,3412
168.178,17,4,288,2,36,168163,36,128,2,52,168165,52,160
0.524,6,25,8343,12,264,47,677,1688,13,995,42,1408,6655
240.335,6,44,8447,22,449,11444,1408,5648,22,205,11444,580,2799
1790.848,17,89,3729,87,13,20821,14,3649,2,12,1790673,16,80
0.284,6,28,7336,13,155,23,267,1301,15,543,18,1300,6035
1746.198,6,94,7151,62,38,28626,205,4424,32,33,56317,98,2727
35.066,6,33,8028,19,129,1948,159,1915,14,670,2696,1402,6113
1.246,6,24,8004,11,164,105,267,1236,13,869,88,1448,6768
0.222,6,31,15264,15,171,15,313,1474,16,1295,14,1588,13790
1772.376,6,180,15480,120,69,14893,69,8940,60,69,30035,69,6540
14.125,17,4,352,2,48,14102,48,152,2,72,14106,72,200
281.737,6,30,7432,13,158,23478,267,1317,17,543,17591,1400,6115
127.118,6,13,772,5,106,31779,106,314,8,90,18155,90,458
1786.167,6,150,19350,90,302,20069,302,13740,60,83,30273,83,5610
497.282,17,6,756,6,98,99456,348,756,0,0,0,0,0
11.241,6,1761,1540103,1088,1363,10,1380,1508941,673,421,16,1923,31162
0.136,17,4,608,2,60,11,60,176,2,188,14,188,432
1756.538,6,107,6362,60,26,29771,27,3519,47,26,38184,27,2843
14.329,6,45,20669,24,857,623,1368,14131,21,902,706,2736,6538
169.507,1,4,224,4,28,56502,28,224,0,0,0,0,0
1.98,17,2,672,2,308,1980,308,672,0,0,0,0,0
1684.014,17,14,1036,7,30,280656,30,406,7,62,280665,62,630
1741.912,6,87,6322,58,31,30559,31,3915,29,31,62210,31,2407
1798.323,6,130,8410,74,51,24634,208,5178,56,31,32689,31,3232
777.163,17,10,821,5,31,194281,37,297,5,76,194280,136,524
1780.718,6,359,22778,208,69,8602,69,12598,151,69,11871,69,10180
0.101,17,2,198,1,39,0,39,67,1,103,0,103,131
32.286,6,46,10065,23,289,1467,721,3537,23,621,1437,1440,6528
369.612,6,21,1419,15,177,26400,177,989,6,110,12239,110,430
98.288,17,1119,1082312,248,255,397,1350,70262,871,1133,112,1350,1012050
1786.448,6,104,8444,68,66,26663,66,4964,36,60,51038,60,3480
300.729,6,43,8895,22,315,14320,882,2209,21,364,423,1440,6686
606.912,2,4,128,4,8,202304,8,128,0,0,0,0,0
1747.984,6,95,7203,63,38,28193,205,4476,32,33,56378,98,2727
300.574,6,43,8952,22,318,14313,928,2235,21,366,474,2128,6717
0.293,17,2,588,1,39,0,39,67,1,493,0,493,521
0.616,6,12,3462,6,75,123,75,395,6,1373,123,1448,3067
1786.086,6,105,8610,70,66,25885,66,5110,35,60,52528,60,3500
372.118,6,18,1239,14,177,28624,177,913,4,110,21794,110,326
1796.032,17,448,39612,404,35,4456,288,25708,44,288,40950,288,13904
0.173,6,28,7336,14,155,13,267,1341,14,603,12,2800,5995
0.28,6,26,8995,13,252,23,647,1692,13,1103,23,2816,7303
240.283,6,42,8910,21,523,12013,1408,5807,21,250,12014,618,3103
206.679,17,4,352,2,48,206671,48,152,2,72,206669,72,200
0.031,17,2,596,1,64,0,64,92,1,476,0,476,504
6.539,6,1258,1134727,779,1379,8,1408,1105155,479,931,13,2816,29572
1781.842,6,361,22858,210,69,8525,69,12678,151,69,11878,69,10180
3.021,6,3,168,3,0,0,0,168,0,0,0,0,0
371.165,6,18,1239,14,177,28551,177,913,4,110,20063,110,326
10.003,17,4,5484,4,1343,3334,1348,5484,0,0,0,0,0
1781.746,1,104,5824,104,28,17298,28,5824,0,0,0,0,0
0.21,17,2,142,1,35,0,35,63,1,51,0,51,79
125.124,6,69,46448,44,1165,2909,1408,38416,25,960,2566,3847,8032
280.443,6,29,7392,13,158,23370,267,1317,16,678,18693,3456,6075
411.752,6,5098,4779231,2693,393,152,426,157680,2405,1875,171,12672,4621551
10.904,6,44,16747,20,484,571,1360,6708,24,697,468,1360,10039
1.956,6,25,8794,15,290,139,602,1474,10,988,198,1420,7320
0.198,6,46,21778,27,1046,7,1420,16797,19,467,10,1883,4981
33.587,17,3,228,3,48,16793,48,228,0,0,0,0,0
63.929,6,11,1583,11,127,6392,127,1583,0,0,0,0,0
1.761,6,33,13083,17,584,110,1360,4230,16,820,79,1380,8853
1798.042,17,448,39896,403,35,4472,288,25676,45,288,40019,288,14220
7.786,17,6,528,3,48,3889,48,228,3,72,3888,72,300
1785.169,17,87,3648,86,14,21001,14,3612,1,8,0,8,36
64.91,6,23,8180,7,154,10818,267,752,16,616,4326,1420,7428
0.031,17,4,284,2,32,13,32,120,2,54,19,60,164
1.702,17,23,9495,10,531,189,1350,5593,13,272,79,1350,3902
273.146,6,25,2821,14,328,21011,593,1393,11,282,24035,580,1428
1799.703,6,344,26855,167,259,10841,515,10893,177,39,10144,76,15962
1799.958,6,206,14266,76,46,23999,46,6076,130,46,13952,46,8190
13.756,17,4,824,2,48,13738,48,152,2,308,13737,308,672
152.421,6,22,8174,11,520,84,1223,2034,11,948,15224,1631,6140
7.161,6,35,7040,18,231,421,314,3274,17,513,313,1179,3766
245.547,6,36,4290,16,181,16369,595,1918,20,147,12806,580,2372
2.257,17,5,428,3,32,972,32,180,2,96,1050,96,248
1.255,6,47,18835,27,867,48,1360,13259,20,476,56,2715,5576
10.127,6,1612,1400381,971,1388,10,1420,1370520,641,467,15,1883,29861
154.718,6,32,24712,19,884,38,1360,6097,13,2260,12881,5440,18615
0.473,6,52,21484,28,1008,17,1380,16282,24,421,18,1923,5202
0.142,2,2,80,2,16,142,16,80,0,0,0,0,0
122.712,6,41,8801,20,401,556,889,2084,21,391,6128,3488,6717
1793.607,17,144,11520,72,48,25262,48,5472,72,56,25262,56,6048
32.004,6,9,396,2,0,3481,0,88,7,0,5319,0,308
2.751,17,4,240,2,32,2750,32,120,2,32,2750,32,120
94.283,6,757,382333,430,828,219,1152,364462,327,435,288,1179,17871
1790.179,17,270,56788,270,182,6654,422,56788,0,0,0,0,0
12.708,6,1883,1734192,1169,1404,10,1448,1692400,714,776,17,1448,41792
1467.117,6,174,13094,65,65,22921,313,6137,109,48,13583,78,6957
569.156,1,6,336,6,28,113831,28,336,0,0,0,0,0
1790.747,1,342,28728,342,56,5251,56,28728,0,0,0,0,0
1022.677,2,9,288,9,8,127834,8,288,0,0,0,0,0
1773.252,6,182,15698,120,69,14901,69,8940,62,69,29064,69,6758
1483.213,6,184,14096,71,70,21186,329,6855,113,48,13241,78,7241
1.39,6,25,8056,12,164,107,267,1288,13,1014,98,2491,6768
0.029,17,2,672,2,308,29,308,672,0,0,0,0,0
5.23,6,19,6698,9,275,653,275,639,10,706,549,2760,6059
2.868,6,22,7004,12,185,260,275,1041,10,694,235,1414,5963
168.289,17,4,352,2,60,168288,60,176,2,60,168288,60,176
32.959,6,29,10078,14,411,2534,1002,2804,15,722,2353,1448,7274
76.99,6,9,468,9,0,0,0,468,0,0,0,0,0
677.838,17,50,3984,27,48,26070,48,2052,23,56,26038,56,1932
1792.754,6,356,22520,208,69,8660,69,12460,148,69,12193,69,10060
83.43,6,28,7568,7,171,13905,267,1146,21,348,4164,1460,6422
100.719,6,22,10160,11,433,76,990,1771,11,1133,10056,1390,8389
1783.517,17,83,3480,82,14,22018,14,3444,1,8,0,8,36
0.579,17,2,144,1,36,0,36,64,1,52,0,52,80
75.701,6,31,7613,12,155,28,267,1266,19,398,4205,3417,6347
297.869,17,4,352,2,60,297868,60,176,2,60,297868,60,176
1729.261,6,60,4400,40,33,44340,33,2740,20,31,91001,31,1660
0.023,17,2,507,1,37,0,37,65,1,414,0,414,442
1.383,6,48,19389,27,904,53,1460,13773,21,433,59,1460,5616
226.806,1,8,448,8,28,32400,28,448,0,0,0,0,0
2.91,6,7,300,4,0,923,0,168,3,0,1268,0,132
4.874,6,34,6169,19,206,270,314,2824,15,548,328,1179,3345
300.859,6,43,9926,20,531,15834,1360,4018,23,292,1931,2667,5908
3.942,17,5,556,4,64,1309,64,368,1,160,0,160,188
62.25,6,66,45680,42,1183,1518,1448,37702,24,746,2696,1448,7978
0.018,17,2,224,1,58,0,58,86,1,110,0,110,138
1787.906,6,367,25650,213,100,8433,469,14936,154,69,11685,69,10714
16.722,17,25,9619,11,401,1668,1350,4720,14,321,1283,1350,4899
300.97,6,37,8343,20,269,15840,730,1909,17,522,550,3488,6434
1786.649,6,367,23236,211,69,8507,69,12787,156,69,11526,69,10449
1792.095,6,266,26826,108,74,16748,616,10716,158,125,11413,1460,16110
16.984,6,7,484,4,92,5661,92,308,3,0,1258,0,176
0.146,6,25,11193,14,120,11,186,1459,11,1017,13,2235,9734
1.328,6,50,18817,27,857,51,1360,13121,23,433,52,1360,5696
10.696,17,2,780,2,362,10696,362,780,0,0,0,0,0
234.369,6,42,6099,19,135,7512,722,2216,23,191,10644,2026,3883
280.04,6,27,7312,12,158,25458,267,1277,15,678,19999,2800,6035
40.456,6,68,11539,35,410,681,882,4028,33,307,1260,1460,7511
1755.968,6,107,6362,60,26,29761,27,3519,47,26,38172,27,2843
5.086,17,25,7730,10,306,565,1350,3340,15,264,227,1350,4390
1798.963,1,345,28980,345,56,5229,56,28980,0,0,0,0,0
1.651,6,13,2311,8,188,235,245,700,5,1407,351,1407,1611
1681.158,17,16,4197,8,30,240164,37,471,8,437,240164,463,3726
3.487,17,5,295,5,31,871,31,295,0,0,0,0,0
0.868,6,20,5966,11,287,86,562,1306,9,716,97,1420,4660
300.511,6,54,29973,28,190,11130,444,2293,26,1253,9609,1551,27680
141.101,6,43,6486,20,162,2399,722,2531,23,196,6405,1408,3955
40.761,17,6,1236,3,48,20367,48,228,3,308,20372,308,1008
8.919,6,34,8153,18,332,524,689,1749,16,522,580,3502,6404
1793.305,1,254,26924,254,78,7088,78,26924,0,0,0,0,0
1786.739,17,87,3648,86,14,21020,14,3612,1,8,0,8,36
55.211,6,13,1811,7,100,9201,100,384,6,1179,10993,1179,1427
7.95,6,16,6145,5,186,1985,267,581,11,639,794,1460,5564
14.837,6,6,328,4,0,4945,0,216,2,0,14731,0,112
0.015,17,2,904,1,300,0,300,328,1,548,0,548,576
1003.733,17,14,1117,7,31,167283,37,413,7,72,167283,136,704
51.28,6,10,648,10,31,5697,31,648,0,0,0,0,0
0.046,6,12,3705,6,171,8,171,491,6,964,6,1448,3214
3.268,17,3,1176,3,364,1634,364,1176,0,0,0,0,0
80.153,6,43,8978,17,410,2235,917,1968,26,297,3201,1360,7010
3.644,6,157,120864,92,818,40,1360,10371,65,1926,54,5440,110493
1796.263,17,449,39928,404,35,4457,288,25708,45,288,40022,288,14220
1.386,6,49,20106,28,889,51,1360,14490,21,476,60,2715,5616
562.915,1,6,336,6,28,112583,28,336,0,0,0,0,0
15.047,17,10,880,5,48,3759,48,380,5,72,3759,72,500
3.623,6,3,168,1,0,0,0,52,2,0,3623,0,116
1797.876,1,345,28980,345,56,5226,56,28980,0,0,0,0,0
1.359,6,11,1727,7,100,226,100,384,4,589,368,1152,1343
1774.654,6,180,15480,120,69,14913,69,8940,60,69,30076,69,6540
165.572,6,119,70004,70,1185,2396,1360,62097,49,269,3445,1360,7907
0.458,17,4,624,2,64,456,64,184,2,192,331,192,440
0.024,17,2,672,2,308,24,308,672,0,0,0,0,0
1792.049,1,339,28476,339,56,5301,56,28476,0,0,0,0,0
298.588,1,4,224,4,28,99529,28,224,0,0,0,0,0
1789.013,17,144,11520,72,48,25197,48,5472,72,56,25197,56,6048
3.069,6,53,13914,25,549,127,1429,4876,28,439,103,1986,9038
0.222,6,46,21576,27,1033,8,1420,16595,19,467,11,1883,4981
1.36,6,38,8252,19,320,75,1162,2716,19,433,65,1360,5536
300.544,6,17,1187,6,177,60075,177,509,11,110,30037,110,678
0.022,17,2,360,1,128,0,128,156,1,176,0,176,204
7.786,17,14,5940,6,481,1557,1350,3054,8,332,1041,1350,2886
0.054,17,2,144,1,36,0,36,64,1,52,0,52,80
3.888,17,4,268,4,39,1296,39,268,0,0,0,0,0
240.222,6,54,17958,29,784,8579,1418,14854,25,224,10008,580,3104
1.591,6,25,8056,12,164,121,267,1288,13,869,111,1448,6768
153.819,6,100,15785,56,304,2796,304,11176,44,83,3573,83,4609
36.103,17,22,1672,22,48,1719,48,1672,0,0,0,0,0
1771.342,17,46,15456,46,308,39363,308,15456,0,0,0,0,0
1782.396,17,83,3480,82,14,22004,14,3444,1,8,0,8,36
1361.128,6,190,23281,92,91,14955,721,9201,98,274,14030,1440,14080
0.202,6,23,7325,12,177,18,337,1342,11,1080,19,1588,5983
599.84,6,9,546,6,31,119968,31,333,3,31,299871,31,213
240.45,6,59,18258,31,799,8014,1408,15218,28,175,8905,580,3040
297.985,6,40,8684,21,410,14899,882,2126,19,413,474,1360,6558
268.4,17,4,352,2,60,268399,60,176,2,60,268399,60,176
1.839,6,38,9848,20,502,96,1460,4352,18,433,92,1460,5496
33.574,6,34,5459,16,154,2238,722,1923,18,288,1963,2026,3536
1771.021,6,101,9344,66,65,27246,65,5577,35,59,52085,59,3767
0.084,17,2,195,1,44,0,44,72,1,95,0,95,123
84.552,6,21,9148,11,499,104,1193,1983,10,1125,9373,2279,7165
11.786,6,1850,1623584,1150,1362,10,1380,1587994,700,630,16,3303,35590
1645.282,1,54,4536,54,56,31043,56,4536,0,0,0,0,0
1787.904,6,362,22898,210,69,8554,69,12678,152,69,11840,69,10220
86.833,17,2,152,2,48,86833,48,152,0,0,0,0,0
7.264,6,1602,1444347,986,1385,7,1408,1407651,616,931,11,2816,36696
1786.717,6,98,7947,65,65,27917,65,4680,33,59,55831,59,3267
12.118,6,1857,1669870,1180,1361,10,1420,1638391,677,475,17,1883,31479
4.123,17,10,900,5,30,1018,30,290,5,94,1023,94,610
120.626,17,8,2688,8,308,17232,308,2688,0,0,0,0,0
58.969,6,363,402473,92,728,648,1408,14498,271,1466,218,2816,387975
12.166,17,20,1746,10,47,1350,47,750,10,71,1350,101,996
1789.839,1,274,15344,274,28,6556,28,15344,0,0,0,0,0
1785.379,6,113,11788,73,132,24796,1271,7706,40,67,45774,191,4082
292.926,6,33,6981,16,262,19525,517,1628,17,744,18305,1418,5353
1777.095,17,79,3312,78,14,23079,14,3276,1,8,0,8,36
12.411,6,1783,991840,985,168,12,168,39572,798,1156,15,2304,952268
372.395,6,25,1651,17,177,23274,177,1117,8,110,9237,110,534
2.287,17,2,237,1,72,0,72,100,1,109,0,109,137
1799.415,1,16,896,16,28,119961,28,896,0,0,0,0,0
1785.25,6,102,8364,68,66,26645,66,4964,34,60,54095,60,3400
15.496,17,28,8273,12,364,1406,1350,4714,16,194,1031,1350,3559
280.529,6,30,7432,13,158,23377,267,1317,17,603,17525,2076,6115
243.891,6,56,11206,24,218,10603,517,3272,32,519,7866,1418,7934
21.891,6,15,656,8,0,3127,0,348,7,0,2402,0,308
1.091,6,55,14220,26,501,43,1429,5082,29,442,38,1986,9138
1785.677,17,142,11360,71,48,25509,48,5396,71,56,25509,56,5964
295.726,1,4,326,4,53,98575,78,326,0,0,0,0,0
1.658,6,50,19785,29,922,59,1360,14124,21,400,70,1360,5661
1090.735,6,189,30414,108,179,10193,1093,13677,81,221,13634,1420,16737
11.947,6,1899,1654136,1156,1377,10,1420,1620195,743,467,16,1883,33941
115.929,6,121,86727,73,1246,1610,1368,76102,48,738,2461,2519,10625
24.382,6,2,605,0,0,0,0,0,2,262,24382,278,605
274.658,17,4,352,2,60,274657,60,176,2,60,274657,60,176
0.012,6,10,1544,5,505,3,505,773,5,503,3,503,771
0.237,6,9,1339,5,145,59,145,349,4,826,67,826,990
21.442,6,14,2245,8,211,3059,211,846,6,545,4288,904,1399
37.784,17,22,1936,11,48,3777,48,836,11,72,3777,72,1100
1790.048,6,362,22898,210,69,8564,69,12678,152,69,11854,69,10220
841.43,17,8,592,4,30,280459,30,232,4,62,280459,62,360
1739.361,1,64,5376,64,56,27608,56,5376,0,0,0,0,0
10.958,6,20,4442,11,275,1095,275,998,9,768,772,1440,3444
11.707,6,1866,1623215,1146,1363,10,1380,1590185,720,421,16,1923,33030
0.166,17,4,420,2,51,0,51,158,2,103,120,109,262
0.218,17,11,4665,5,434,54,1350,2312,6,364,31,1350,2353
3.581,17,5,290,5,30,895,30,290,0,0,0,0,0
1746.189,6,161,16910,88,126,20071,205,11380,73,32,24249,33,5530
367.362,6,18,1239,14,177,28258,177,913,4,110,24275,110,326
1756.476,6,125,9029,75,31,23736,31,5174,50,31,35846,31,3855
0.237,17,2,157,1,31,0,31,59,1,70,0,70,98
3.058,6,10,1102,6,483,611,483,803,4,83,1016,83,299
1746.666,6,99,7473,65,38,27291,205,4580,34,33,52915,98,2893
0.453,6,54,20280,29,919,16,1380,14993,25,355,16,1380,5287
1764.047,2,16,512,16,8,117603,8,512,0,0,0,0,0
80.036,6,23,9994,12,408,70,884,1749,11,1113,7989,2368,8245
0.341,6,13,1693,7,288,56,288,588,6,284,34,434,1105
294.892,1,4,224,4,28,98297,28,224,0,0,0,0,0
1.341,6,50,18589,27,841,51,1360,12893,23,433,51,1360,5696
1787.679,6,1936,2000001,738,128,2425,351,49539,1198,1679,1493,7010,1950462
130.88,17,4,352,2,60,130878,60,176,2,60,130878,60,176
0.22,6,42,30733,19,180,12,250,1538,23,1332,7,1735,29195
60.364,6,8,768,4,226,123,226,442,4,110,20061,110,326
18.278,6,2876,2694138,1863,1368,9,1408,2636798,1013,931,17,2816,57340
124.202,17,4,240,2,32,124200,32,120,2,32,124201,32,120
1792.188,17,180,14040,180,50,10012,50,14040,0,0,0,0,0
6.234,6,1582,1485710,1015,1387,5,1408,1451562,567,931,10,2816,34148
1681.505,17,16,1265,8,30,240213,37,471,8,71,240213,136,794
4.607,6,44,8369,22,227,219,314,4062,22,427,207,1152,4307
1775.173,6,180,15480,120,69,14917,69,8940,60,69,30082,69,6540
241.066,6,44,9019,19,307,13391,745,3468,25,423,10043,1501,5551
0.044,6,10,1514,5,503,10,503,771,5,475,11,475,743
1773.204,6,181,15589,120,69,14900,69,8940,61,69,29550,69,6649
0.302,17,2,184,1,32,0,32,60,1,96,0,96,124
1647.67,1,8,448,8,28,235381,28,448,0,0,0,0,0
61.639,6,60,40056,38,1161,1665,1448,32181,22,747,2924,1448,7875
1.568,6,47,20543,28,923,58,1360,15007,19,476,74,2715,5536
33.755,6,43,23872,18,204,1985,204,2052,25,1138,1343,1438,21820
1.419,6,24,8004,12,164,108,267,1288,12,1014,110,2331,6716
237.753,6,111,82488,70,1263,3445,1408,69418,41,780,2140,1408,13070
0.481,17,2,152,1,48,0,48,76,1,48,0,48,76
1786.357,6,147,24309,90,252,20071,1289,14471,57,167,31897,1420,9838
0.738,6,29,6007,14,156,56,267,1502,15,650,48,1420,4505
72.242,6,31,7550,13,156,6020,267,1312,18,423,4248,2840,6238
1771.749,6,103,9514,66,66,27257,66,5610,37,60,49212,60,3904
240.118,6,49,9440,26,210,9604,841,2843,23,490,10914,2816,6597
7.334,6,14,1247,7,222,1221,222,728,7,231,1221,231,519
1681.555,17,16,1265,8,30,240220,37,471,8,71,240220,136,794
0.018,17,4,344,2,47,0,47,150,2,69,9,75,194
0.032,17,3,392,2,60,10,60,176,1,188,0,188,216
1.027,6,26,8423,15,225,60,561,1985,11,1496,83,4511,6438
1792.035,1,339,28476,339,56,5301,56,28476,0,0,0,0,0
13.036,17,4,824,2,48,13009,48,152,2,308,13016,308,672
0.152,17,3,901,3,272,76,316,901,0,0,0,0,0
256.579,17,4,352,2,60,256578,60,176,2,60,256578,60,176
4.995,17,4,824,2,48,4806,48,152,2,308,4878,308,672
1796.187,17,449,39928,404,35,4457,288,25708,45,288,40018,288,14220
27.27,6,12,824,4,92,9090,92,296,8,92,3869,92,528
7.613,17,4,1344,4,308,2537,308,1344,0,0,0,0,0
0.199,6,9,1339,5,145,49,145,349,4,826,42,826,990
17.573,17,3,197,2,32,17573,33,121,1,48,0,48,76
0.939,6,2,302,1,210,0,210,262,1,0,0,0,40
97.197,6,25,10730,13,746,55,1360,3550,12,1114,8823,3068,7180
0.026,17,2,600,1,36,0,36,64,1,508,0,508,536
6.286,6,1686,1577402,1075,1390,5,1408,1540966,611,1164,10,4209,36436
0.368,6,11,913,6,182,73,182,490,5,77,62,134,423
240.179,6,55,19640,30,848,8281,1408,16840,25,186,10007,580,2800
8.676,6,71,22394,38,521,234,1152,16138,33,548,262,1179,6256
280.489,6,30,7432,14,158,21576,267,1357,16,678,18691,3456,6075
1772.3,1,76,6384,0,0,0,0,0,76,56,23630,56,6384
1791.883,1,200,11200,200,28,9004,28,11200,0,0,0,0,0
0.021,17,4,352,2,60,20,60,176,2,60,19,60,176
216.465,17,6,360,3,32,108231,32,180,3,32,108232,32,180
377.802,2,3,96,3,8,188901,8,96,0,0,0,0,0
1684.557,2,16,512,16,8,112303,8,512,0,0,0,0,0
43.65,6,26,7137,13,155,3637,267,1306,13,589,3636,4837,5831
34.308,17,20,1520,20,48,1805,48,1520,0,0,0,0,0
8.923,6,88,26477,44,559,207,1152,20235,44,447,201,1179,6242
1789.739,17,144,11520,72,48,25207,48,5472,72,56,25207,56,6048
1786.89,6,102,8296,68,65,26670,65,4930,34,59,54144,59,3366
1641.261,1,7,392,7,28,273543,28,392,0,0,0,0,0
1740.467,17,30,31680,30,1028,60016,1028,31680,0,0,0,0,0
0.486,6,51,21555,28,1016,18,1380,16393,23,383,19,1380,5162
4.07,17,8,736,4,32,1349,32,240,4,96,1346,96,496
0.258,17,3,543,2,39,241,39,134,1,381,0,381,409
240.258,6,54,17865,29,793,8580,1418,15010,25,193,10010,580,2855
1788.779,6,123,14564,79,84,22933,502,6390,44,160,41597,1420,8174
1772.499,6,180,15480,120,69,14894,69,8940,60,69,30037,69,6540
0.836,6,10,1687,7,100,139,100,384,3,1179,298,1179,1303
1792.854,6,356,22520,208,69,8661,69,12460,148,69,12196,69,10060
1799.773,6,127,12533,79,61,23074,722,6504,48,88,38286,1448,6029
1771.185,6,125,13903,76,118,23615,814,8450,49,74,36896,223,5453
240.218,6,54,17650,29,788,8578,1418,14914,25,178,10008,580,2736
3.123,17,3,174,3,30,1561,30,174,0,0,0,0,0
0.376,6,12,870,6,185,68,185,505,6,45,75,45,365
0.791,6,32,16290,18,1026,46,1360,8964,14,844,46,1360,7326
1796.707,17,449,39928,404,35,4458,288,25708,45,288,40021,288,14220
0.163,17,2,206,1,47,0,47,75,1,103,0,103,131
0.13,17,2,517,1,34,0,34,62,1,427,0,427,455
1794.481,6,356,22589,207,69,8711,69,12420,149,69,12124,69,10169
0.407,6,27,8920,13,227,33,547,1592,14,941,30,1408,7328
1796.232,6,356,22520,208,69,8677,69,12460,148,69,12219,69,10060
53.957,6,21,7801,11,177,5395,517,1301,10,1189,5511,1408,6500
1787.525,6,104,8376,68,65,26679,65,4930,36,59,51068,59,3446
2.351,17,14,7317,7,664,391,1350,4850,7,324,382,1350,2467
1771.588,6,102,9643,68,68,26441,232,5880,34,58,53681,81,3763
1793.408,1,269,15064,269,28,6691,28,15064,0,0,0,0,0
240.268,6,43,8953,21,519,12013,1402,5776,22,225,11441,618,3177
1.223,6,23,7952,12,164,95,267,1288,11,1216,104,3819,6664
1.28,17,6,1142,3,36,636,36,192,3,288,637,318,950
7.682,6,1676,1601004,1098,1383,6,1408,1566284,578,931,13,2801,34720
1745.003,6,95,7203,63,38,28145,205,4476,32,33,56280,98,2727
612.317,1,24,1344,24,28,26622,28,1344,0,0,0,0,0
189.199,17,4,288,2,36,189182,36,128,2,52,189177,52,160
21.113,6,44,15733,25,913,872,1360,10171,19,435,1162,2667,5562
33.704,6,27,4887,14,154,2592,722,1807,13,600,2789,1448,3080
0.253,17,3,234,2,39,24,39,134,1,72,0,72,100
0.015,17,2,596,1,39,0,39,67,1,501,0,501,529
101.799,6,179,143299,115,1283,892,1368,130455,64,679,1612,2519,12844
0.349,17,2,178,1,29,0,29,57,1,93,0,93,121
1770.136,6,99,9240,66,65,27232,65,5577,33,59,55313,59,3663
4.993,17,4,288,2,36,4992,36,128,2,52,4992,52,160
131.503,6,39,12116,20,633,6921,1360,4647,19,558,7296,1360,7469
5.15,17,3,208,2,36,5004,36,128,1,52,0,52,80
73.9,6,32,7584,13,152,6158,267,1444,19,413,4097,1460,6140
284.111,6,30,8344,14,176,21854,267,1624,16,675,18933,2045,6720
1791.21,1,8,848,8,78,255887,78,848,0,0,0,0,0
123.115,17,6,390,3,37,61556,47,195,3,37,61557,47,195
0.142,17,2,152,1,48,0,48,76,1,48,0,48,76
0.193,6,29,7376,14,155,14,267,1341,15,543,12,1400,6035
15.295,17,22,13563,12,910,1387,1350,11261,10,202,1695,1350,2302
1796.854,1,345,28980,345,56,5223,56,28980,0,0,0,0,0
42.088,6,33,9321,12,237,3826,335,2624,21,532,2091,1179,6697
1766.425,1,55,4620,0,0,0,0,0,55,56,32711,56,4620
0.509,2,2,80,2,16,509,16,80,0,0,0,0,0
1772.309,6,184,15847,121,69,14769,69,8980,63,69,28577,69,6867
16.336,6,892,758038,561,1278,28,1368,736162,331,931,48,2841,21876
1799.611,17,83,3480,82,14,22217,14,3444,1,8,0,8,36
1.587,17,53,38601,21,356,79,1350,8076,32,925,49,1350,30525
1770.196,6,116,10566,73,64,24586,64,6148,43,58,42144,58,4418
0.307,6,10,1838,5,899,76,899,1167,5,403,76,403,671
368.822,6,25,1651,17,177,23051,177,1117,8,110,9216,110,534
836.751,6,78,8636,40,80,21455,721,3618,38,108,21230,1448,5018
1776.854,1,72,6048,72,56,25026,56,6048,0,0,0,0,0
1741.264,6,88,6405,59,31,30021,31,3998,29,31,62185,31,2407
6.885,6,14,1029,7,222,1145,222,506,7,231,1145,231,523
4.969,17,4,288,2,36,4941,36,128,2,52,4945,52,160
104.259,17,12,920,6,40,20847,41,412,6,56,20848,57,508
3.908,6,66,25550,33,968,122,1440,14987,33,543,113,1440,10563
0.11,17,2,164,1,46,0,46,74,1,62,0,62,90
1795.885,6,335,30936,195,108,9257,469,15540,140,130,12916,3417,15396
1796.477,17,448,39896,403,35,4468,288,25676,45,288,40014,288,14220
17.929,6,2770,2667020,1844,1370,9,1408,2614204,926,776,19,1408,52816
269.3,17,4,304,2,48,269299,64,152,2,48,269299,64,152
0.496,6,14,3148,7,92,82,92,464,7,463,31,1408,2684
254.981,17,4,240,2,32,254979,32,120,2,32,254980,32,120
0.386,6,14,1733,7,288,62,288,588,7,284,36,434,1145
5.685,6,42,7389,22,218,270,314,3503,20,440,285,1152,3886
0.167,6,10,767,5,186,41,186,454,5,45,21,45,313
50.273,17,4,240,2,32,50272,32,120,2,32,50273,32,120
446.001,17,8,2688,8,308,63714,308,2688,0,0,0,0,0
1781.325,1,342,28728,342,56,5223,56,28728,0,0,0,0,0
294.927,6,51,8292,24,116,12820,517,2227,27,385,11341,1418,6065
1798.3,17,448,39612,404,35,4462,288,25708,44,288,40948,288,13904
1744.564,6,100,7568,64,38,27691,205,4559,36,33,49837,98,3009
33.477,6,30,5055,15,180,2378,722,1872,15,399,2378,1448,3183
1.308,17,6,840,3,64,511,64,276,3,160,475,160,564
0.456,6,14,4589,7,290,76,517,953,7,1088,40,1418,3636
1.305,6,4,224,2,0,1305,0,112,2,0,1031,0,112
0.154,17,2,148,1,32,0,32,60,1,60,0,60,88
1.491,17,2,782,2,363,1491,363,782,0,0,0,0,0
2.766,6,31,14060,17,769,172,1360,6095,14,1232,202,2574,7965
6.195,6,1718,1599813,1090,1390,5,1408,1562493,628,931,9,2816,37320
1781.169,6,353,22676,202,69,8861,69,12220,151,69,11874,69,10456
231.873,17,6,528,3,48,115932,48,228,3,72,115933,72,300
61.966,6,44,13948,20,181,3261,267,2256,24,766,2684,2800,11692
1777.261,1,78,6552,78,56,23081,56,6552,0,0,0,0,0
7.589,17,3,204,3,40,3794,40,204,0,0,0,0,0
1700.942,1,8,448,8,28,242991,28,448,0,0,0,0,0
93.894,6,36,18889,20,702,42,1360,5107,16,1193,6250,4080,13782
240.703,2,3,96,3,8,120351,8,96,0,0,0,0,0
4.614,17,21,12681,12,839,416,1350,10407,9,224,572,1350,2274
71.445,6,42,10469,21,783,552,1360,4827,21,435,3563,2667,5642
114.71,6,44,10151,21,677,568,1360,4305,23,307,5206,1360,5846
0.229,6,3,187,1,0,0,0,40,2,31,92,31,147
1798.078,17,447,39068,403,35,4472,288,25412,44,282,40946,288,13656
324.537,6,143,10093,75,33,4382,93,5312,68,33,4843,93,4781
12.602,6,1643,1554071,714,1122,17,1460,60710,929,1600,13,8760,1493361
128.313,6,23,4728,9,272,227,516,1180,14,298,9863,1452,3548
0.302,6,9,1340,5,145,75,145,349,4,827,31,827,991
1740.545,17,29,6815,29,207,62162,207,6815,0,0,0,0,0
5.011,6,40,7309,21,218,250,314,3463,19,513,263,1179,3846
1770.074,17,296,84692,296,258,6000,422,84692,0,0,0,0,0
479.097,6,60,10252,29,123,17104,721,3132,31,345,15964,2840,7120
445.731,6,1179,936645,577,240,773,1060,33389,602,1485,741,5632,903256
0.378,17,2,148,1,32,0,32,60,1,60,0,60,88
0.032,17,2,239,1,59,0,59,87,1,124,0,124,152
300.903,6,50,10538,26,433,12036,910,3310,24,347,656,3488,7228
1754.022,6,126,8157,72,52,24704,208,5067,54,31,33090,31,3090
228.086,6,31,8912,14,158,17545,267,1357,17,687,14250,1781,7555
0.016,17,2,172,1,50,0,50,78,1,66,0,66,94
1.364,6,48,19714,27,927,52,1460,14098,21,433,59,1460,5616
1772.073,6,180,15480,120,69,14891,69,8940,60,69,30034,69,6540
149.84,17,9,3480,9,358,18730,548,3480,0,0,0,0,0
0.09,17,8,2446,8,277,12,316,2446,0,0,0,0,0
1678.805,1,94,5264,94,28,18051,28,5264,0,0,0,0,0
2.451,6,24,7892,13,430,204,1017,1974,11,889,227,1438,5918
1795.626,17,448,39896,403,35,4466,288,25676,45,288,40017,288,14220
1263.391,2,12,384,12,8,114853,8,384,0,0,0,0,0
269.253,6,29,7392,13,158,22437,267,1317,16,603,17947,2800,6075
0.312,17,2,290,1,40,0,40,68,1,194,0,194,222
3.292,17,4,1556,4,361,1097,361,1556,0,0,0,0,0
1789.273,6,356,22520,208,69,8643,69,12460,148,69,12171,69,10060
1794.65,1,278,29468,278,78,6478,78,29468,0,0,0,0,0
0.186,1,2,112,2,28,186,28,112,0,0,0,0,0
0.27,17,2,180,1,30,0,30,58,1,94,0,94,122
1786.32,6,365,24494,212,87,8465,469,14096,153,69,11749,69,10398
1.679,6,49,19498,27,909,64,1360,13842,22,433,69,1360,5656
1.435,6,46,18525,26,913,57,1460,12949,20,433,65,1460,5576
280.535,6,29,7392,14,158,21579,267,1357,15,678,20030,3456,6035
1.38,6,46,18763,26,931,55,1460,13187,20,433,61,1460,5576
643.19,6,86,6356,34,64,19486,293,3031,52,47,12611,78,3325
2.341,6,58,28228,33,1130,73,1380,22893,25,387,95,1380,5335
281.484,6,32,7650,13,158,23457,267,1317,19,506,15624,2760,6333
1784.468,6,107,8486,68,64,26633,64,4896,39,58,46956,58,3590
0.604,6,10,924,5,283,101,283,551,5,105,104,105,373
249.466,6,51,7636,23,331,11339,1056,3585,28,199,9239,580,4051
1798.848,17,87,3648,86,14,21162,14,3612,1,8,0,8,36
12.392,6,679,508817,333,338,37,338,20790,346,1366,35,1368,488027
1771.435,6,152,25510,89,483,20129,483,19625,63,83,28571,83,5885
1.319,6,50,20125,28,886,48,1360,14469,22,433,54,1360,5656
1055.125,6,138,12068,51,70,21099,312,4994,87,81,12267,1062,7074
0.012,6,10,1542,5,505,3,505,773,5,501,2,501,769
71.701,6,45,8748,21,367,896,787,2034,24,441,3110,1360,6714
1637.876,2,26,832,26,8,65515,8,832,0,0,0,0,0
72.179,6,25,10089,12,531,55,1360,2637,13,988,6005,1360,7452
12.473,6,1480,1327430,894,1404,13,1448,1292294,586,776,20,1448,35136
337.879,6,285,227790,179,1303,1898,1368,209980,106,614,1539,2736,17810
11.8,17,38,9360,16,263,784,1350,4657,22,185,560,1350,4703
1351.032,6,108,11394,66,64,20785,722,5728,42,102,29187,1408,5666
1758.982,6,128,7854,70,26,25491,26,4218,58,26,30858,26,3636
0.005,17,2,278,1,36,0,36,64,1,186,0,186,214
1729.49,1,228,12768,228,28,7618,28,12768,0,0,0,0,0
149.809,6,3465,3000328,2065,1365,72,1368,2916354,1400,899,106,1473,83974
0.0,6,1,71,0,0,0,0,0,1,31,0,31,71
1664.177,1,7,392,7,28,277362,28,392,0,0,0,0,0
0.006,17,2,553,1,43,0,43,71,1,454,0,454,482
0.052,17,5,1562,5,284,13,315,1562,0,0,0,0,0
0.207,17,2,198,1,37,0,37,65,1,105,0,105,133
1790.047,6,360,22818,209,69,8605,69,12638,151,69,11930,69,10180
1800.0,6,705,282984,344,397,5160,1460,97349,361,815,5000,1460,185635
7.279,6,9,520,4,0,2426,0,220,5,0,1242,0,300
253.799,6,32,7853,14,158,19523,267,1357,18,524,14926,1400,6496
0.917,6,477,393906,215,183,4,230,11917,262,1416,3,4224,381989
1786.167,17,87,3648,86,14,21013,14,3612,1,8,0,8,36
0.481,6,10,1669,6,551,96,947,1346,4,159,160,159,323
1.426,6,44,10743,23,513,64,1360,5082,21,400,61,1360,5661
1020.552,6,49,2536,25,0,42519,0,1300,24,0,44368,0,1236
1771.643,1,58,4872,0,0,0,0,0,58,56,31081,56,4872
1788.269,6,356,22520,208,69,8638,69,12460,148,69,12164,69,10060
1795.971,17,448,39896,403,35,4467,288,25676,45,288,40020,288,14220
10.589,6,9,527,5,43,2647,43,311,4,0,3528,0,216
0.024,6,9,1880,5,910,6,910,1178,4,486,7,486,702
65.859,6,12,680,6,0,13171,0,328,6,0,6942,0,352
1794.092,6,356,22520,208,69,8667,69,12460,148,69,12204,69,10060
0.455,6,9,360,5,0,113,0,200,4,0,61,0,160
117.433,6,24,980,10,0,6144,0,404,14,0,9032,0,576
1743.12,6,94,7151,62,38,28575,205,4424,32,33,56219,98,2727
3.807,6,11,467,6,0,761,0,248,5,7,695,7,219
0.255,6,9,527,5,43,63,43,311,4,0,75,0,216
0.534,6,25,6081,13,108,44,147,959,12,773,43,1608,5122
0.251,17,2,158,1,34,0,34,62,1,68,0,68,96
1787.359,6,104,8376,68,65,26677,65,4930,36,59,51064,59,3446
0.079,17,2,396,1,39,0,39,67,1,301,0,301,329
2.98,17,2,122,2,33,2980,33,122,0,0,0,0,0
0.605,6,20,4960,10,137,67,267,1092,10,692,56,1467,3868
1704.875,17,15,4776,15,290,121776,1444,4776,0,0,0,0,0
1786.565,6,104,8444,68,66,26665,66,4964,36,60,51041,60,3480
3.826,2,2,64,2,8,3826,8,64,0,0,0,0,0
1787.906,6,390,27053,221,96,8126,469,15877,169,69,10642,69,11176
156.728,6,39,5818,14,154,4958,722,1819,25,158,6522,1448,3999
1700.508,17,12,498,11,14,170050,14,462,1,8,0,8,36
608.139,6,80,5940,31,66,20266,295,2827,49,48,12666,78,3113
0.052,6,3,210,1,0,0,0,40,2,90,38,90,170
13.449,6,21,3016,12,275,1222,275,1038,9,535,1553,1414,1978
1785.687,6,102,8296,68,65,26652,65,4930,34,59,54108,59,3366
560.952,17,6,444,3,30,280453,30,174,3,62,280448,62,270
1785.851,6,361,22858,210,69,8544,69,12678,151,69,11905,69,10180
1.2,17,14,7078,7,605,200,1350,4436,7,349,191,1350,2642
318.785,6,72,47526,44,1194,7413,1408,39336,28,747,2283,1408,8190
83.044,6,34,7802,13,155,27,267,1306,21,353,4151,1997,6496
7.284,6,5,240,1,0,0,0,48,4,0,2424,0,192
822.651,6,55,3964,30,31,28363,31,2025,25,31,34053,31,1939
280.472,6,31,7541,13,158,23372,267,1317,18,500,16497,1400,6224
1772.372,6,233,18216,91,73,19691,336,8989,142,49,12568,143,9227
18.482,17,37,8832,16,262,1230,1350,4654,21,170,922,1350,4178
4.009,17,8,736,4,32,1333,32,240,4,96,1333,96,496
316.059,6,84,14163,45,106,7183,615,4756,39,326,8313,2720,9407
221.304,6,24,2800,13,304,18442,304,1888,11,83,22129,83,912
257.427,17,6,528,3,60,128713,60,264,3,60,128713,60,264
0.649,6,21,7791,13,334,53,663,2033,8,1333,91,3314,5758
1740.468,17,30,31680,30,1028,60016,1028,31680,0,0,0,0,0
0.805,6,17,5132,9,150,100,174,664,8,828,100,1420,4468
0.532,6,37,8036,19,355,29,1432,2540,18,477,29,1473,5496
240.761,6,58,18395,30,769,8301,1418,15418,28,188,8916,580,2977
222.004,6,27,6479,10,217,7018,502,1272,17,323,13869,1420,5207
30.15,6,57,24090,31,1115,351,1460,18019,26,358,1198,1460,6071
1798.807,17,449,39928,404,35,4463,288,25708,45,288,40019,288,14220
1.537,6,44,13575,23,700,69,1460,7959,21,433,67,1460,5616
4.18,6,47,15292,26,422,167,1440,4538,21,707,198,1587,10754
1.908,6,9,527,5,43,477,43,311,4,0,632,0,216
0.885,6,10,1687,7,100,147,100,384,3,1179,308,1179,1303
1750.684,6,95,7203,63,38,28236,205,4476,32,33,56462,98,2727
3.666,17,4,4170,4,1014,1222,1444,4170,0,0,0,0,0
11.927,6,1874,1647138,1144,1386,10,1420,1613717,730,467,16,1883,33421
10.73,6,952,778506,534,1374,19,1448,752106,418,776,25,1448,26400
1748.104,2,23,736,23,8,79459,8,736,0,0,0,0,0
1681.99,17,16,1265,8,30,240277,37,471,8,71,240275,136,794
0.173,17,3,345,3,87,86,144,345,0,0,0,0,0
1750.518,17,12,498,11,14,175051,14,462,1,8,0,8,36
0.01,6,2,592,1,512,0,512,552,1,0,0,0,40
125.875,6,40,8249,17,130,7867,267,1604,23,317,5715,1420,6645
1.276,17,4,377,2,33,1264,37,123,2,99,1262,136,254
1682.768,17,14,1036,7,30,280455,30,406,7,62,280451,62,630
177.861,1,4,1457,4,336,59287,353,1457,0,0,0,0,0
66.679,6,9,468,9,0,0,0,468,0,0,0,0,0
1661.064,1,7,392,7,28,276844,28,392,0,0,0,0,0
1781.762,6,369,25730,214,99,8365,469,15045,155,69,11569,69,10685
0.359,1,2,163,2,53,359,78,163,0,0,0,0,0
0.929,17,4,232,2,30,875,30,116,2,30,882,30,116
0.61,6,14,1745,7,288,79,288,600,7,426,73,434,1145
280.621,6,30,7432,13,158,23385,267,1317,17,543,17532,1400,6115
33.543,6,31,5291,15,154,2395,722,1859,16,370,2224,1402,3432
280.211,6,31,7472,15,158,20015,267,1397,16,603,18677,2800,6075
756.982,1,6,696,6,88,151396,88,696,0,0,0,0,0
161.101,6,11,440,11,0,0,0,440,0,0,0,0,0
1749.809,17,317,51088,317,133,5537,391,51088,0,0,0,0,0
95.873,6,124,91929,77,1268,1261,1408,81362,47,811,1737,3847,10567
1.879,6,3,127,1,0,0,0,40,2,7,0,7,87
0.951,6,51,13813,24,549,41,1429,4824,27,438,35,1460,8989
10.778,6,20,7050,11,275,1077,275,998,9,1420,750,1420,6052
1.393,6,24,8004,12,164,108,267,1288,12,1014,109,2491,6716
331.89,1,18,1008,18,28,19522,28,1008,0,0,0,0,0
258.983,17,4,352,2,60,258982,60,176,2,60,258982,60,176
1772.01,6,203,22290,130,75,13736,267,10057,73,134,24610,1997,12233
32.103,6,9,396,2,0,3492,0,88,7,0,5335,0,308
30.987,17,6,1712,6,257,6197,604,1712,0,0,0,0,0
0.409,1,2,112,2,28,409,28,112,0,0,0,0,0
0.076,1,2,163,2,53,76,78,163,0,0,0,0,0
14.219,17,6,606,3,34,7101,37,188,3,111,7100,136,418
2.527,17,29,14002,14,697,194,1350,10151,15,228,115,1350,3851
1797.494,17,141,11276,71,48,25678,48,5396,70,56,26049,56,5880
7.476,6,22,7284,13,319,623,602,1960,9,1612,930,3314,5324
0.005,1,3,168,3,28,2,28,168,0,0,0,0,0
25.372,6,44,12834,21,199,1268,721,2438,23,728,1143,1440,10396
4.595,6,62,56956,45,191,104,255,3677,17,3741,286,11216,53279
288.745,6,226,36588,128,304,2273,304,26288,98,83,2976,83,10300
1787.088,6,102,8228,68,64,26672,64,4896,34,58,54151,58,3332
0.263,1,2,112,2,28,263,28,112,0,0,0,0,0
1680.975,1,15,840,15,28,120069,28,840,0,0,0,0,0
3.141,6,13,547,7,0,523,0,288,6,7,594,7,259
0.006,6,8,11988,1,0,0,0,40,7,1654,1,2896,11948
34.169,17,20,1760,10,48,3795,48,760,10,72,3795,72,1000
23.308,6,25,6284,14,117,1792,159,1337,11,727,2329,1418,4947
